Source,YOB,Age,NPA,Date,freq
SIM,1930,26,45-49,1956,7
SIM,1896,0,na,1896,7595
STAT,1868,71,na,1939,2564.8546066193194
SIM,1875,18,na,1893,5640
STAT,1839,17,35-39,1856,1.1207796268654042
STAT,1876,90,na,1966,439.88242856023527
STAT,1906,62,na,1968,5937.091133137386
STAT,1890,48,20-24,1938,0.016476971344212138
SIM,1867,4,na,1871,5780
STAT,1810,57,na,1867,2223.9287264045597
SIM,1905,65,na,1970,5632
SIM,1859,55,na,1914,3614
SIM,1907,17,30-34,1924,1
SIM,1931,19,15-19,1950,112
STAT,1838,30,15-19,1868,0.24451917688925565
SIM,1863,60,na,1923,3483
STAT,1871,18,50-100,1889,0.09835507324809539
SIM,1867,74,na,1941,2186
SIM,1901,51,na,1952,6216
SIM,1910,27,30-34,1937,101
STAT,1784,99,na,1883,0.5923224777634881
SIM,1941,16,na,1957,7755
STAT,1917,14,na,1931,8554.615856361645
STAT,1898,31,25-29,1929,28.108337161920527
STAT,1927,35,35-39,1962,6.0830540921076715
SIM,1902,49,50-100,1951,1
STAT,1934,25,25-29,1959,179.0077251948202
STAT,1925,27,25-29,1952,156.97580610702758
SIM,1907,9,na,1916,7831
STAT,1925,33,na,1958,9062.981049062635
SIM,1837,32,15-19,1869,1
SIM,1884,2,na,1886,6519
SIM,1909,25,40-44,1934,11
SIM,1933,27,25-29,1960,189
SIM,1920,41,25-29,1961,1
STAT,1907,36,20-24,1943,0.4962560491982781
SIM,1886,35,50-100,1921,4
SIM,1888,68,na,1956,3648
STAT,1902,27,30-34,1929,71.80231327408285
STAT,1855,21,na,1876,3793.8545683084203
STAT,1859,35,na,1894,3823.17539040887
SIM,1897,41,50-100,1938,1
STAT,1829,32,15-19,1861,0.2731630836730905
SIM,1860,40,50-100,1900,3
SIM,1872,47,50-100,1919,2
STAT,1942,24,20-24,1966,235.30520605569578
SIM,1797,62,na,1859,1828
STAT,1913,20,35-39,1933,18.54177941146619
STAT,1922,26,45-49,1948,3.960625406843241
SIM,1833,62,na,1895,2364
SIM,1878,16,25-29,1894,11
SIM,1915,36,20-24,1951,1
SIM,1858,41,50-100,1899,4
SIM,1924,7,na,1931,9994
STAT,1931,24,45-49,1955,2.92893569911725
STAT,1916,34,20-24,1950,5.0423455334783664
SIM,1876,35,na,1911,5141
SIM,1869,23,20-24,1892,144
SIM,1914,26,na,1940,7791
SIM,1940,17,15-19,1957,99
STAT,1932,17,15-19,1949,121.3767420111619
SIM,1912,22,35-39,1934,23
SIM,1821,40,50-100,1861,4
STAT,1893,70,na,1963,4028.7769180221703
STAT,1815,88,na,1903,127.60505705395136
STAT,1918,42,30-34,1960,0.27447522874114355
STAT,1900,19,20-24,1919,49.40232526917219
SIM,1908,46,30-34,1954,1
STAT,1844,69,na,1913,2369.956397385004
STAT,1923,19,15-19,1942,107.01570540619689
STAT,1909,44,30-34,1953,0.23866617455599873
SIM,1846,24,50-100,1870,1
SIM,1875,93,na,1968,148
STAT,1896,23,15-19,1919,8.76942953007635
SIM,1904,25,50-100,1929,3
STAT,1909,31,25-29,1940,17.89545220756728
STAT,1852,88,na,1940,218.8039910086304
SIM,1924,34,20-24,1958,6
SIM,1970,1,na,1971,10445
SIM,1875,20,40-44,1895,5
STAT,1907,23,15-19,1930,9.762439374907196
STAT,1940,30,50-100,1970,1.730261552873134
STAT,1941,15,15-19,1956,94.46233646129255
SIM,1832,36,50-100,1868,5
SIM,1858,38,na,1896,4033
STAT,1787,105,na,1892,0.021565696284678554
STAT,1912,41,25-29,1953,0.13993444795273113
SIM,1854,24,na,1878,4160
STAT,1849,24,40-44,1873,3.928141217277034
STAT,1826,40,na,1866,3328.437960190349
STAT,1904,22,35-39,1926,16.915537828384267
SIM,1860,6,na,1866,5048
STAT,1924,48,15-19,1972,8.830026519798864E-4
STAT,1801,96,na,1897,6.806358479649749
SIM,1927,38,50-100,1965,1
STAT,1958,3,na,1961,10432.658581107562
STAT,1855,101,na,1956,1.027788064474043
SIM,1850,10,na,1860,4684
SIM,1825,43,na,1868,2894
SIM,1829,57,na,1886,2580
SIM,1865,30,25-29,1895,30
SIM,1858,23,45-49,1881,3
SIM,1917,39,35-39,1956,8
SIM,1919,24,50-100,1943,1
SIM,1846,30,15-19,1876,3
STAT,1867,15,45-49,1882,0.12780897194236834
STAT,1829,101,na,1930,0.6753382133710498
STAT,1901,18,25-29,1919,15.979954862200602
STAT,1929,7,na,1936,10301.89982997651
SIM,1941,5,na,1946,8432
STAT,1943,23,25-29,1966,198.4057331476891
SIM,1915,23,15-19,1938,11
STAT,1867,20,40-44,1887,4.015053247216729
STAT,1920,18,35-39,1938,9.480914157672796
SIM,1836,34,50-100,1870,2
SIM,1884,54,na,1938,4505
SIM,1953,3,na,1956,9967
STAT,1841,48,25-29,1889,0.08288371764118857
STAT,1942,13,na,1955,8289.419883411412
SIM,1934,36,30-34,1970,7
SIM,1880,40,na,1920,5190
SIM,1939,28,30-34,1967,93
STAT,1838,41,na,1879,3370.526370384482
STAT,1903,26,35-39,1929,27.84131305142006
STAT,1905,34,45-49,1939,2.8995466079626113
SIM,1884,22,na,1906,5116
STAT,1899,18,45-49,1917,0.18028284718690116
STAT,1855,22,15-19,1877,5.811697739469311
STAT,1848,15,35-39,1863,1.128594792375317
SIM,1926,17,40-44,1943,3
STAT,1809,60,na,1869,2224.7530233197303
SIM,1863,22,15-19,1885,5
STAT,1929,43,45-49,1972,0.4345622708808291
SIM,1887,46,50-100,1933,2
SIM,1935,35,35-39,1970,8
STAT,1827,89,na,1916,127.03433124921591
STAT,1920,23,30-34,1943,64.31709789695817
STAT,1922,31,40-44,1953,8.96397699584057
STAT,1857,30,25-29,1887,16.56386341475655
SIM,1917,31,25-29,1948,25
SIM,1888,36,na,1924,5565
SIM,1912,35,40-44,1947,5
SIM,1905,36,50-100,1941,1
STAT,1904,35,40-44,1939,2.764872541834878
SIM,1892,73,na,1965,3965
SIM,1850,42,na,1892,3720
SIM,1857,24,40-44,1881,5
SIM,1839,20,30-34,1859,40
STAT,1910,33,15-19,1943,0.2492782154820926
SIM,1911,26,35-39,1937,43
SIM,1856,15,35-39,1871,3
SIM,1847,22,30-34,1869,46
STAT,1878,15,20-24,1893,37.56854507469812
STAT,1765,96,na,1861,2.726241575748606
SIM,1882,42,50-100,1924,5
STAT,1912,21,30-34,1933,55.812180804980315
STAT,1926,36,30-34,1962,4.501877287171398
SIM,1822,78,na,1900,770
SIM,1916,35,25-29,1951,2
SIM,1863,92,na,1955,78
STAT,1934,30,20-24,1964,6.734495509343623
STAT,1917,46,na,1963,7768.497795956401
STAT,1938,18,20-24,1956,270.0562065133187
SIM,1902,20,25-29,1922,183
SIM,1950,19,25-29,1969,139
STAT,1944,27,35-39,1971,32.76975636702527
STAT,1913,32,na,1945,7601.45838740877
SIM,1884,30,35-39,1914,36
STAT,1942,19,25-29,1961,91.40287862296258
SIM,1830,97,na,1927,7
SIM,1856,90,na,1946,94
SIM,1909,29,50-100,1938,2
SIM,1929,18,20-24,1947,377
SIM,1930,32,na,1962,10405
SIM,1925,38,30-34,1963,8
STAT,1932,20,45-49,1952,2.9996308473817233
SIM,1797,94,na,1891,7
STAT,1831,94,na,1925,25.804986311426106
SIM,1863,17,na,1880,4869
STAT,1914,32,45-49,1946,3.1995473966089567
STAT,1950,15,50-100,1965,0.8950955841877608
STAT,1915,25,15-19,1940,1.4642257014229123
SIM,1867,21,45-49,1888,1
STAT,1822,58,na,1880,2419.1044177615154
STAT,1910,16,25-29,1926,17.39089968207912
SIM,1913,34,45-49,1947,6
STAT,1919,41,35-39,1960,0.44125885390490077
STAT,1839,90,na,1929,123.10389621778717
SIM,1896,30,50-100,1926,1
STAT,1954,14,na,1968,9802.714241450149
STAT,1858,17,45-49,1875,0.12013656474153818
STAT,1894,2,na,1896,6915.779652166712
STAT,1944,18,50-100,1962,0.8139729346077503
STAT,1917,30,20-24,1947,5.199511798445121
STAT,1944,15,40-44,1959,3.0414175043936855
STAT,1877,4,na,1881,6065.189691731333
SIM,1905,32,45-49,1937,5
SIM,1936,31,35-39,1967,25
STAT,1897,52,na,1949,5781.995806565492
STAT,1903,39,40-44,1942,2.6896172395648903
STAT,1922,9,na,1931,9302.105381326424
STAT,1908,35,25-29,1943,1.8807303240825242
STAT,1934,38,30-34,1972,5.0751433333836635
SIM,1887,19,na,1906,6219
SIM,1911,23,30-34,1934,73
SIM,1923,25,15-19,1948,1
SIM,1920,21,30-34,1941,84
STAT,1899,23,40-44,1922,5.74837048272229
SIM,1793,80,na,1873,382
STAT,1917,38,30-34,1955,3.803948475170186
SIM,1907,37,25-29,1944,1
SIM,1880,72,na,1952,2760
SIM,1884,86,na,1970,1055
STAT,1905,13,na,1918,7531.251149719458
STAT,1772,98,na,1870,0.9111358625268411
STAT,1848,20,30-34,1868,36.07865648228017
STAT,1927,40,30-34,1967,0.3246697156749245
STAT,1839,22,30-34,1861,35.735897364376164
STAT,1871,46,45-49,1917,0.4748820053114558
SIM,1888,18,35-39,1906,1
SIM,1901,38,50-100,1939,1
STAT,1909,27,na,1936,7234.484705099318
STAT,1813,97,na,1910,4.773779015455713
STAT,1940,22,45-49,1962,2.315066532057753
SIM,1894,32,na,1926,6416
SIM,1804,81,na,1885,296
STAT,1882,49,25-29,1931,0.11095596966641229
STAT,1889,33,na,1922,5917.392953979327
STAT,1933,26,20-24,1959,48.9776891245269
STAT,1927,24,na,1951,9028.432364115157
STAT,1919,49,45-49,1968,0.4732026774286403
SIM,1898,25,40-44,1923,9
SIM,1935,15,40-44,1950,4
STAT,1885,83,na,1968,1448.4484746541425
STAT,1923,22,45-49,1945,2.6432096123901565
STAT,1864,20,15-19,1884,6.139377899169566
STAT,1865,49,25-29,1914,0.10347850157237613
STAT,1924,23,15-19,1947,12.643154662784701
SIM,1868,48,na,1916,4297
SIM,1952,15,40-44,1967,9
STAT,1913,28,45-49,1941,3.465217447967311
SIM,1833,47,50-100,1880,3
STAT,1845,43,na,1888,3580.544691253154
SIM,1904,33,40-44,1937,10
SIM,1941,26,20-24,1967,45
SIM,1872,53,na,1925,4428
SIM,1925,25,25-29,1950,168
STAT,1908,40,20-24,1948,0.03339523964688096
SIM,1916,48,30-34,1964,1
SIM,1843,40,na,1883,3597
SIM,1921,33,40-44,1954,13
STAT,1869,25,20-24,1894,23.113493692437793
SIM,1801,54,30-34,1855,1
STAT,1912,29,40-44,1941,9.212823205404893
SIM,1921,28,45-49,1949,10
SIM,1942,25,25-29,1967,147
SIM,1902,33,30-34,1935,2
STAT,1889,65,na,1954,4208.400174955694
SIM,1899,24,45-49,1923,2
STAT,1826,72,na,1898,1511.8178674198034
STAT,1837,24,na,1861,3845.1748772708984
SIM,1876,67,na,1943,3580
STAT,1806,105,na,1911,0.019964902509559325
SIM,1922,32,45-49,1954,6
STAT,1885,51,na,1936,4349.334230701523
STAT,1918,37,35-39,1955,5.147960770449078
SIM,1893,20,35-39,1913,21
SIM,1906,25,15-19,1931,1
STAT,1913,33,40-44,1946,7.832112498469388
SIM,1922,45,na,1967,8946
SIM,1901,16,25-29,1917,20
STAT,1859,21,45-49,1880,1.2872756346507797
STAT,1927,15,40-44,1942,3.5281700794035107
STAT,1920,43,25-29,1963,0.1589930138303423
STAT,1930,40,50-100,1970,0.313043062202362
SIM,1920,29,40-44,1949,14
SIM,1842,31,50-100,1873,3
SIM,1872,20,15-19,1892,8
STAT,1810,54,30-34,1864,0.03533740969561839
SIM,1922,13,na,1935,9752
STAT,1903,43,25-29,1946,0.12730279798020622
STAT,1940,19,15-19,1959,93.00724029372134
SIM,1839,35,na,1874,3602
SIM,1901,29,30-34,1930,79
SIM,1925,30,20-24,1955,10
SIM,1926,37,35-39,1963,7
STAT,1930,20,35-39,1950,24.506583915087248
SIM,1931,22,45-49,1953,1
STAT,1818,53,na,1871,2611.674017061279
STAT,1846,60,na,1906,2921.2445172915805
SIM,1835,21,na,1856,3792
STAT,1861,33,50-100,1894,1.5337167524232678
SIM,1887,23,15-19,1910,8
SIM,1901,21,20-24,1922,188
SIM,1902,28,35-39,1930,38
STAT,1800,79,na,1879,614.239594736025
STAT,1875,17,45-49,1892,0.13582845353000664
STAT,1780,85,na,1865,156.48673745953073
STAT,1876,15,na,1891,5300.148324312716
STAT,1822,106,na,1928,0.013708979707372466
SIM,1789,75,na,1864,791
SIM,1900,17,20-24,1917,45
STAT,1939,25,na,1964,7613.3947891042435
SIM,1926,27,na,1953,9269
STAT,1930,28,45-49,1958,4.434389941901927
STAT,1810,49,35-39,1859,0.8787227834376214
STAT,1858,22,40-44,1880,3.764240179283998
STAT,1860,45,30-34,1905,0.1603427877455268
STAT,1917,25,25-29,1942,140.34190914138625
SIM,1848,71,na,1919,1908
SIM,1946,18,20-24,1964,290
STAT,1877,32,na,1909,5004.471797991433
SIM,1866,22,40-44,1888,6
STAT,1876,30,35-39,1906,21.32405941938852
STAT,1935,11,na,1946,10957.966773732149
STAT,1808,54,50-100,1862,0.08603337408952766
STAT,1908,48,30-34,1956,0.16247845643978343
STAT,1924,36,20-24,1960,0.6281847041420563
SIM,1938,28,na,1966,7527
STAT,1926,44,30-34,1970,0.31719389060982256
STAT,1907,3,na,1910,7847.286233038629
SIM,1916,27,25-29,1943,150
SIM,1934,14,na,1948,10693
SIM,1856,40,25-29,1896,1
STAT,1910,21,20-24,1931,211.607709426867
SIM,1904,48,na,1952,6549
STAT,1835,103,na,1938,0.1858723100709877
SIM,1864,33,50-100,1897,2
STAT,1851,39,na,1890,3615.437149025018
STAT,1835,76,na,1911,1227.0221267054878
STAT,1875,22,40-44,1897,4.3329711894528735
SIM,1904,20,35-39,1924,18
STAT,1891,39,25-29,1930,7.115236523996649
STAT,1855,30,15-19,1885,0.22323937957561404
STAT,1902,31,15-19,1933,0.4077129666253577
SIM,1868,16,na,1884,5027
SIM,1889,31,25-29,1920,34
SIM,1857,27,45-49,1884,2
STAT,1858,18,na,1876,4196.750994903329
SIM,1885,71,na,1956,2768
STAT,1914,24,45-49,1938,2.3074820945486154
SIM,1881,9,na,1890,4485
STAT,1916,46,15-19,1962,7.649651644641904E-4
SIM,1832,48,25-29,1880,1
STAT,1931,21,40-44,1952,8.834279073181012
SIM,1834,36,na,1870,3536
SIM,1918,35,35-39,1953,10
STAT,1904,38,45-49,1942,1.2410734364760472
STAT,1864,20,50-100,1884,0.758884870946101
STAT,1942,27,25-29,1969,139.52200644327715
SIM,1848,21,35-39,1869,12
SIM,1930,23,40-44,1953,13
STAT,1809,103,na,1912,0.12755815340135243
STAT,1848,40,25-29,1888,1.0789483646631435
STAT,1922,43,35-39,1965,0.4659273774962994
SIM,1802,58,na,1860,2201
SIM,1872,16,30-34,1888,5
STAT,1846,32,15-19,1878,0.2577718748750635
SIM,1920,37,40-44,1957,7
SIM,1829,31,50-100,1860,3
SIM,1892,32,50-100,1924,5
STAT,1920,35,25-29,1955,2.180481255138859
SIM,1948,18,30-34,1966,33
SIM,1932,23,15-19,1955,14
STAT,1930,42,30-34,1972,0.33972152136386635
STAT,1885,20,35-39,1905,11.801037379491436
SIM,1826,60,na,1886,2219
SIM,1888,23,30-34,1911,51
SIM,1851,91,na,1942,55
STAT,1861,49,40-44,1910,0.28177982967657567
STAT,1886,9,na,1895,5531.608743044313
SIM,1901,33,15-19,1934,4
SIM,1931,30,45-49,1961,8
STAT,1849,27,45-49,1876,2.0818998713649255
SIM,1891,56,na,1947,5374
STAT,1901,43,15-19,1944,0.0026918119791145604
STAT,1922,23,40-44,1945,7.761194002301455
SIM,1855,20,15-19,1875,9
STAT,1879,87,na,1966,813.37511102721
STAT,1875,73,na,1948,2469.7553606659244
STAT,1864,16,30-34,1880,3.2904080798410082
STAT,1913,45,35-39,1958,0.255411545668047
STAT,1928,31,35-39,1959,23.087214632257435
SIM,1821,61,na,1882,2128
STAT,1935,37,35-39,1972,6.831984888858171
STAT,1921,22,35-39,1943,21.47369991744214
SIM,1898,46,na,1944,6333
STAT,1860,0,na,1860,6364.975579997142
STAT,1896,35,na,1931,6341.705551259652
STAT,1812,49,45-49,1861,1.5845482165748723
SIM,1858,20,40-44,1878,3
STAT,1907,19,30-34,1926,4.705809736921053
STAT,1905,31,40-44,1936,7.3028835572005795
STAT,1829,45,50-100,1874,0.39779751728792223
STAT,1933,22,50-100,1955,1.7629064246563002
SIM,1898,28,45-49,1926,2
STAT,1910,29,30-34,1939,75.89737502072312
SIM,1820,49,45-49,1869,2
STAT,1892,21,na,1913,5997.595453600635
STAT,1902,22,25-29,1924,163.22705521758445
SIM,1846,26,30-34,1872,70
STAT,1802,108,na,1910,0.0014058162294333643
STAT,1904,30,35-39,1934,29.591693951102187
STAT,1948,24,15-19,1972,12.334747076392832
SIM,1875,23,45-49,1898,1
STAT,1900,5,na,1905,7342.04512275882
SIM,1902,3,na,1905,7747
SIM,1937,28,50-100,1965,3
SIM,1922,24,45-49,1946,4
STAT,1829,37,na,1866,3240.0460653171936
STAT,1884,34,na,1918,4718.205437678931
SIM,1846,22,15-19,1868,5
STAT,1867,23,45-49,1890,1.3148556787162606
SIM,1915,19,30-34,1934,5
STAT,1903,23,30-34,1926,51.06206067671468
STAT,1850,27,50-100,1877,1.1542302747014306
STAT,1888,48,na,1936,5304.021706468057
STAT,1881,69,na,1950,2864.7639652353114
SIM,1904,28,45-49,1932,4
SIM,1910,22,25-29,1932,213
STAT,1918,45,35-39,1963,0.2783507221544316
STAT,1923,30,45-49,1953,3.6713980589438644
SIM,1879,25,30-34,1904,66
SIM,1901,37,30-34,1938,6
STAT,1922,34,45-49,1956,3.5722598342253336
SIM,1869,26,25-29,1895,90
STAT,1773,83,na,1856,233.82303692999994
SIM,1912,38,45-49,1950,4
STAT,1777,97,na,1874,1.6570698111295639
STAT,1854,25,50-100,1879,1.1461030574220823
SIM,1826,92,na,1918,30
STAT,1841,45,20-24,1886,0.017944038165349223
STAT,1824,48,25-29,1872,0.1375524846912408
STAT,1888,21,15-19,1909,7.898760482884152
SIM,1854,38,50-100,1892,5
SIM,1924,37,25-29,1961,5
SIM,1951,20,20-24,1971,269
SIM,1917,34,na,1951,8077
STAT,1925,24,20-24,1949,267.0722500331918
SIM,1913,20,na,1933,7626
STAT,1928,39,45-49,1967,1.7360387400114228
STAT,1830,45,45-49,1875,0.41805649952034
SIM,1912,30,35-39,1942,3
STAT,1838,26,30-34,1864,43.66657349703219
STAT,1918,17,40-44,1935,0.6167696341452074
SIM,1869,37,50-100,1906,6
STAT,1880,20,na,1900,5061.836257853844
STAT,1937,15,50-100,1952,0.7396754291403402
STAT,1852,56,na,1908,3250.789565462347
STAT,1829,40,15-19,1869,0.023445939052841498
STAT,1943,28,30-34,1971,84.23530566274692
STAT,1933,34,20-24,1967,6.630799975607887
SIM,1900,34,na,1934,6879
STAT,1916,37,25-29,1953,2.0363571692462648
SIM,1896,21,15-19,1917,9
STAT,1814,51,50-100,1865,0.07651101661243169
STAT,1943,20,20-24,1963,239.0853912855708
STAT,1908,27,25-29,1935,126.81499624511466
STAT,1911,42,20-24,1953,0.034052238709978776
STAT,1896,31,15-19,1927,0.3812716283954713
SIM,1903,4,na,1907,7784
SIM,1933,24,20-24,1957,307
STAT,1933,38,15-19,1971,0.05277797482503052
SIM,1930,34,45-49,1964,5
STAT,1921,51,na,1972,8255.735913844348
STAT,1934,7,na,1941,10921.239213055416
STAT,1904,27,40-44,1931,8.683360045574856
STAT,1903,40,20-24,1943,0.03203256392710552
SIM,1870,94,na,1964,122
STAT,1865,6,na,1871,5183.453393167161
STAT,1840,49,20-24,1889,0.017025250773275588
SIM,1871,36,50-100,1907,3
SIM,1887,27,30-34,1914,73
STAT,1839,15,na,1854,4744.336960173279
STAT,1935,21,25-29,1956,254.16709001173615
SIM,1943,21,25-29,1964,215
SIM,1897,72,na,1969,4061
STAT,1820,48,40-44,1868,0.6278932520865736
STAT,1872,39,15-19,1911,0.11283203897867926
STAT,1900,42,45-49,1942,0.290813695432382
STAT,1952,17,40-44,1969,3.384958435175021
STAT,1909,39,35-39,1948,4.579709902419698
SIM,1923,20,45-49,1943,4
SIM,1919,25,na,1944,8246
STAT,1798,59,na,1857,1907.2478172322376
STAT,1879,27,30-34,1906,53.19618687703476
STAT,1851,104,na,1955,0.10339724446709606
STAT,1856,70,na,1926,2186.320989872605
SIM,1915,11,na,1926,8440
STAT,1907,44,20-24,1951,0.03229412443970351
STAT,1944,24,30-34,1968,62.626699938482304
SIM,1842,23,na,1865,3931
SIM,1854,56,na,1910,3383
SIM,1903,24,35-39,1927,15
STAT,1934,17,25-29,1951,118.39765214514404
SIM,1917,23,25-29,1940,213
STAT,1864,57,na,1921,3628.005918431668
STAT,1913,41,40-44,1954,0.49558388969255124
STAT,1860,43,na,1903,3763.2420309384247
SIM,1840,75,na,1915,1569
SIM,1877,84,na,1961,857
SIM,1909,47,na,1956,6880
STAT,1860,22,50-100,1882,0.6894476122742039
SIM,1905,33,na,1938,7278
SIM,1846,37,na,1883,3806
SIM,1897,16,35-39,1913,2
STAT,1764,109,na,1873,0.004627972847799101
SIM,1888,7,na,1895,6100
SIM,1926,45,35-39,1971,1
STAT,1797,74,na,1871,903.1188931719049
STAT,1872,22,15-19,1894,6.696162712159267
SIM,1781,79,na,1860,470
STAT,1850,38,25-29,1888,4.438168583593537
STAT,1858,30,40-44,1888,6.971084654125604
STAT,1848,23,35-39,1871,11.566951346878872
STAT,1925,32,20-24,1957,5.8486208065193
SIM,1847,54,na,1901,3168
SIM,1838,24,30-34,1862,38
SIM,1932,28,20-24,1960,49
SIM,1934,19,40-44,1953,4
SIM,1838,93,na,1931,37
SIM,1916,49,na,1965,7683
STAT,1821,52,40-44,1873,0.02963959292338245
STAT,1871,16,na,1887,5130.614809394818
SIM,1912,27,40-44,1939,7
SIM,1853,39,na,1892,3871
SIM,1877,17,20-24,1894,34
SIM,1900,25,20-24,1925,39
SIM,1912,35,na,1947,7699
SIM,1933,32,20-24,1965,9
STAT,1869,17,20-24,1886,35.17408520205821
STAT,1897,15,30-34,1912,4.32286856862378
STAT,1929,35,45-49,1964,1.770484435912306
SIM,1775,83,na,1858,176
SIM,1898,20,35-39,1918,21
SIM,1925,33,25-29,1958,30
STAT,1889,16,35-39,1905,1.3697694703364118
STAT,1808,75,na,1883,899.1687327341117
STAT,1785,84,na,1869,228.25533935930002
SIM,1829,25,na,1854,3663
STAT,1789,98,na,1887,1.2434935268234437
SIM,1844,89,na,1933,103
SIM,1848,30,25-29,1878,28
STAT,1917,33,25-29,1950,19.462737009878005
STAT,1804,61,na,1865,1917.1937914561072
SIM,1866,30,40-44,1896,13
SIM,1913,31,40-44,1944,15
STAT,1924,28,20-24,1952,42.76160641030885
STAT,1926,19,40-44,1945,3.4442727278306045
SIM,1856,23,35-39,1879,16
SIM,1787,84,na,1871,181
SIM,1907,34,20-24,1941,7
SIM,1921,41,40-44,1962,3
STAT,1912,37,40-44,1949,2.9516238784307607
STAT,1934,26,na,1960,10183.921055392719
STAT,1889,41,25-29,1930,1.6063561837653335
SIM,1918,18,45-49,1936,2
SIM,1867,30,35-39,1897,30
STAT,1916,29,25-29,1945,136.46367687436603
STAT,1898,7,na,1905,7120.667016525095
STAT,1868,16,15-19,1884,11.678651232361787
STAT,1893,30,50-100,1923,2.364330156055215
STAT,1914,41,35-39,1955,0.40362691148231217
STAT,1930,12,na,1942,10345.585971475388
SIM,1878,21,20-24,1899,145
SIM,1818,73,na,1891,1109
SIM,1904,36,45-49,1940,3
SIM,1942,17,25-29,1959,123
STAT,1919,46,40-44,1965,0.3461548379803264
SIM,1908,29,40-44,1937,10
SIM,1926,34,30-34,1960,54
STAT,1868,50,50-100,1918,0.029437366110343956
SIM,1843,42,50-100,1885,3
SIM,1924,29,25-29,1953,164
STAT,1934,33,50-100,1967,2.278773843172325
SIM,1873,70,na,1943,2743
STAT,1950,18,20-24,1968,323.630078601434
STAT,1882,46,20-24,1928,0.023675790668255037
STAT,1930,25,40-44,1955,11.980014332840524
STAT,1862,53,40-44,1915,0.017881057154435772
STAT,1860,48,35-39,1908,0.22672651940366823
STAT,1849,68,na,1917,2417.300206457014
STAT,1911,25,30-34,1936,77.71878761740314
STAT,1830,77,na,1907,1193.624531909775
STAT,1810,50,15-19,1860,1.5831665490471984E-4
SIM,1869,33,na,1902,4579
STAT,1908,44,15-19,1952,0.002836118917981142
STAT,1816,62,na,1878,2146.1780561701335
SIM,1847,40,50-100,1887,3
SIM,1839,67,na,1906,2147
STAT,1839,40,50-100,1879,1.9601125547701073
SIM,1925,21,50-100,1946,2
STAT,1936,33,35-39,1969,17.919069290984485
SIM,1849,25,45-49,1874,4
SIM,1886,15,20-24,1901,29
STAT,1915,17,15-19,1932,19.184882568251023
SIM,1899,21,40-44,1920,5
STAT,1875,16,50-100,1891,0.10212153791539769
STAT,1918,34,30-34,1952,33.51723431284067
STAT,1899,31,40-44,1930,12.04933669938996
STAT,1901,35,15-19,1936,0.034594494974296994
SIM,1876,16,15-19,1892,12
SIM,1832,88,na,1920,194
STAT,1923,27,15-19,1950,1.6363996519495494
SIM,1862,43,na,1905,4170
SIM,1923,17,15-19,1940,96
SIM,1931,27,15-19,1958,2
STAT,1831,38,15-19,1869,0.09086087670270868
SIM,1819,90,na,1909,45
STAT,1935,29,35-39,1964,41.29919839012581
SIM,1815,48,25-29,1863,1
STAT,1914,21,40-44,1935,6.6786734186537595
STAT,1917,22,20-24,1939,238.65705731575056
SIM,1882,30,25-29,1912,24
STAT,1919,30,30-34,1949,34.59813644698354
STAT,1830,42,40-44,1872,4.031825622729158
STAT,1918,28,45-49,1946,3.6994847140480696
STAT,1856,48,20-24,1904,0.018463883364645946
STAT,1921,38,45-49,1959,1.5353960163999656
SIM,1859,37,20-24,1896,3
STAT,1887,16,25-29,1903,12.831401634331524
STAT,1940,31,35-39,1971,19.11369233182453
STAT,1836,18,na,1854,4028.5432494404645
SIM,1889,21,na,1910,5994
STAT,1840,23,na,1863,3896.624239814662
STAT,1874,39,25-29,1913,5.894010785646132
STAT,1844,37,na,1881,4020.522517464762
SIM,1918,32,30-34,1950,44
STAT,1914,40,45-49,1954,0.33544652976568623
STAT,1957,11,na,1968,10459.617168820656
STAT,1944,19,35-39,1963,9.113307782182115
SIM,1943,25,40-44,1968,11
STAT,1937,21,35-39,1958,18.528232846618366
SIM,1829,89,na,1918,105
SIM,1899,52,na,1951,5912
SIM,1927,12,na,1939,10217
STAT,1881,20,15-19,1901,6.478387521696011
SIM,1786,78,na,1864,661
STAT,1861,92,na,1953,70.01301426876257
STAT,1873,17,35-39,1890,1.125981956299674
SIM,1852,49,40-44,1901,1
STAT,1855,26,30-34,1881,39.866397917862244
SIM,1952,19,35-39,1971,11
STAT,1859,30,35-39,1889,16.51628925503678
STAT,1828,74,na,1902,1362.8821369694676
STAT,1906,48,20-24,1954,0.019670482777345094
STAT,1926,28,30-34,1954,94.5131291317714
STAT,1905,18,50-100,1923,0.14271962425382412
STAT,1921,19,40-44,1940,3.2019343384071934
SIM,1860,95,na,1955,18
STAT,1910,24,25-29,1934,174.1563109119747
SIM,1927,30,30-34,1957,45
STAT,1874,30,25-29,1904,21.351087743593755
STAT,1913,42,30-34,1955,0.2518554357529989
SIM,1827,77,na,1904,915
STAT,1807,48,25-29,1855,0.38879610576323154
STAT,1906,35,15-19,1941,0.03600862449921811
STAT,1857,87,na,1944,277.34324945974697
STAT,1876,47,na,1923,4677.692013364008
STAT,1853,73,na,1926,1879.2639859407313
STAT,1866,27,45-49,1893,2.069027352567757
STAT,1881,29,15-19,1910,0.879334224742891
SIM,1831,82,na,1913,469
STAT,1809,92,na,1901,37.018580313750114
SIM,1875,49,35-39,1924,1
STAT,1919,38,40-44,1957,3.2440470923023668
SIM,1934,28,30-34,1962,129
STAT,1932,38,20-24,1970,0.7146528512776998
SIM,1890,38,20-24,1928,5
STAT,1898,29,50-100,1927,1.735839738885344
SIM,1925,22,20-24,1947,281
STAT,1920,32,20-24,1952,5.39461165486535
STAT,1824,36,50-100,1860,3.892791276540385
SIM,1875,40,35-39,1915,8
SIM,1919,39,45-49,1958,3
SIM,1877,25,20-24,1902,25
SIM,1927,38,40-44,1965,7
SIM,1833,23,40-44,1856,4
STAT,1901,27,15-19,1928,1.2827844948784433
STAT,1842,49,30-34,1891,0.14110817634680772
STAT,1867,49,35-39,1916,0.2592706338574783
STAT,1886,22,50-100,1908,0.8693857316149278
SIM,1882,39,25-29,1921,7
STAT,1921,30,35-39,1951,20.69877769203916
STAT,1937,34,40-44,1971,7.810759956743821
SIM,1825,75,na,1900,1062
STAT,1910,37,30-34,1947,3.521693069203908
STAT,1804,93,na,1897,19.660474452450483
STAT,1831,62,na,1893,2359.871590485863
STAT,1832,23,50-100,1855,0.8016749324606364
SIM,1902,36,35-39,1938,5
STAT,1952,18,30-34,1970,29.488054561183336
SIM,1929,33,45-49,1962,5
STAT,1940,30,45-49,1970,3.2930784596672673
SIM,1896,25,30-34,1921,87
SIM,1810,45,na,1855,2886
STAT,1907,27,30-34,1934,74.74900382910705
STAT,1864,5,na,1869,5160.499720656782
STAT,1866,20,25-29,1886,109.10822664540956
STAT,1869,24,50-100,1893,0.7930254220794412
SIM,1814,59,na,1873,2224
SIM,1871,36,na,1907,4623
SIM,1879,21,15-19,1900,8
STAT,1917,42,15-19,1959,0.0032364077430747282
STAT,1930,36,45-49,1966,1.7974839820347055
SIM,1883,69,na,1952,2927
SIM,1848,37,45-49,1885,4
SIM,1841,38,25-29,1879,4
STAT,1926,20,20-24,1946,274.4080934589278
SIM,1922,16,45-49,1938,5
STAT,1836,53,50-100,1889,0.019923740256467155
SIM,1838,20,15-19,1858,6
SIM,1850,74,na,1924,1628
SIM,1925,17,25-29,1942,120
SIM,1902,17,30-34,1919,7
SIM,1944,22,30-34,1966,79
STAT,1937,29,45-49,1966,3.3984774344485325
STAT,1846,40,15-19,1886,0.021964371238862877
STAT,1924,43,45-49,1967,0.3990686605770268
STAT,1930,17,40-44,1947,3.652078217838744
STAT,1909,35,40-44,1944,2.890438789428671
STAT,1933,37,25-29,1970,2.7088062713418575
STAT,1829,69,na,1898,1736.8509508790426
STAT,1888,25,30-34,1913,60.51864636203158
SIM,1934,27,40-44,1961,18
STAT,1917,49,35-39,1966,0.27036117863769865
SIM,1895,16,25-29,1911,14
STAT,1833,38,25-29,1871,4.692039612554818
SIM,1767,96,na,1863,2
SIM,1903,16,35-39,1919,1
STAT,1828,34,50-100,1862,1.9343355455102706
STAT,1905,43,35-39,1948,0.36462517071861356
SIM,1899,31,na,1930,6660
STAT,1863,72,na,1935,2232.6727484028397
STAT,1878,35,50-100,1913,2.6142731390888785
STAT,1915,20,45-49,1935,2.267712242498054
STAT,1937,0,na,1937,8853.274419663285
STAT,1924,38,50-100,1962,0.998599268520428
SIM,1854,88,na,1942,183
SIM,1863,26,30-34,1889,61
STAT,1912,47,na,1959,7132.546147356937
SIM,1917,35,40-44,1952,7
SIM,1922,21,40-44,1943,10
STAT,1932,25,15-19,1957,1.869211320470326
STAT,1757,108,na,1865,0.016370799997463527
STAT,1928,30,na,1958,9560.250333934247
STAT,1900,14,na,1914,7211.797719555275
STAT,1950,4,na,1954,9424.551536375031
SIM,1846,69,na,1915,2218
SIM,1909,21,25-29,1930,186
STAT,1900,47,15-19,1947,6.291922203279164E-4
SIM,1940,4,na,1944,8447
SIM,1945,21,35-39,1966,30
STAT,1921,8,na,1929,9179.487333159721
STAT,1904,28,na,1932,6893.5586519649
STAT,1867,86,na,1953,419.6620719341683
STAT,1910,35,na,1945,7338.612166989899
STAT,1913,4,na,1917,8309.226032412023
STAT,1914,49,na,1963,7316.631269961742
STAT,1825,55,na,1880,2601.3348686689437
STAT,1856,1,na,1857,5849.075970055258
SIM,1857,21,na,1878,4415
STAT,1926,27,40-44,1953,11.282715912942976
STAT,1850,22,na,1872,3934.8197156480387
SIM,1829,34,30-34,1863,36
SIM,1881,57,na,1938,3422
STAT,1821,41,na,1862,3084.615407784958
STAT,1901,6,na,1907,7386.098035862342
SIM,1812,57,na,1869,2376
STAT,1874,42,50-100,1916,2.181962840493559
SIM,1930,18,45-49,1948,1
SIM,1933,35,25-29,1968,4
STAT,1823,49,20-24,1872,0.03603808534633716
STAT,1893,39,35-39,1932,17.923589429479367
SIM,1932,0,na,1932,11412
STAT,1824,92,na,1916,44.528886519448506
STAT,1856,25,35-39,1881,15.806184887852146
STAT,1947,12,na,1959,8936.051693935357
STAT,1907,47,25-29,1954,0.09599601108797949
STAT,1854,36,na,1890,3629.0662583837566
SIM,1856,58,na,1914,3332
STAT,1916,38,15-19,1954,0.039519198494286506
STAT,1779,77,na,1856,552.6481467132
STAT,1806,49,20-24,1855,0.0709041900691433
STAT,1902,19,30-34,1921,4.520301377007277
SIM,1892,20,40-44,1912,9
STAT,1836,102,na,1938,0.3898005312184837
SIM,1937,32,40-44,1969,13
STAT,1838,73,na,1911,1607.4653771864039
STAT,1836,26,20-24,1862,20.333797331100445
SIM,1910,19,30-34,1929,7
STAT,1846,49,15-19,1895,5.998907797503347E-4
STAT,1938,30,40-44,1968,7.9572201550222195
STAT,1806,63,na,1869,1768.6915723917316
STAT,1783,82,na,1865,281.32269074021355
STAT,1909,16,50-100,1925,0.14882891057724543
SIM,1821,93,na,1914,31
STAT,1795,62,na,1857,1906.3216670634977
STAT,1901,30,45-49,1931,4.970060289806186
SIM,1819,36,50-100,1855,6
SIM,1903,21,30-34,1924,67
STAT,1846,17,na,1863,4416.743199012886
STAT,1787,96,na,1883,3.0538920069516737
SIM,1944,13,na,1957,8687
STAT,1799,76,na,1875,780.3085894725867
SIM,1918,27,35-39,1945,46
STAT,1901,25,50-100,1926,1.8209168782681506
STAT,1905,18,45-49,1923,0.1902928323384322
SIM,1874,20,25-29,1894,124
STAT,1921,31,25-29,1952,20.852862314503362
STAT,1893,30,35-39,1923,26.13243522054909
STAT,1884,20,40-44,1904,4.180473577607459
STAT,1938,26,50-100,1964,1.9927660599415424
SIM,1919,31,35-39,1950,25
STAT,1838,22,15-19,1860,5.792773191873363
SIM,1841,81,na,1922,619
STAT,1903,47,50-100,1950,0.39651986147858953
STAT,1911,17,30-34,1928,4.927478655340804
STAT,1903,17,45-49,1920,0.18783893861102122
STAT,1904,44,50-100,1948,0.20978740110456687
STAT,1920,26,35-39,1946,33.368561146065424
STAT,1865,31,50-100,1896,1.6880078291628493
STAT,1815,56,na,1871,2415.555724138108
SIM,1878,90,na,1968,409
SIM,1919,44,40-44,1963,2
SIM,1903,45,40-44,1948,1
SIM,1903,29,40-44,1932,14
SIM,1924,38,15-19,1962,2
STAT,1815,47,20-24,1862,0.06448480027526826
STAT,1929,33,50-100,1962,2.119502696712572
STAT,1841,37,20-24,1878,1.3177512497367463
SIM,1900,66,na,1966,5296
SIM,1934,20,20-24,1954,278
STAT,1867,40,35-39,1907,3.4595773933972898
SIM,1868,5,na,1873,5481
SIM,1813,74,na,1887,938
SIM,1879,32,na,1911,4892
SIM,1824,37,na,1861,3487
STAT,1851,43,50-100,1894,1.6258630259556455
STAT,1882,54,na,1936,4119.756944300571
STAT,1814,82,na,1896,401.5546354452782
STAT,1821,39,45-49,1860,6.919242808716435
STAT,1846,92,na,1938,63.794787411055744
STAT,1909,40,15-19,1949,0.002935411365139328
STAT,1888,28,35-39,1916,22.951545780261117
SIM,1933,16,20-24,1949,378
SIM,1844,26,20-24,1870,20
STAT,1925,16,20-24,1941,331.5069633129945
STAT,1882,38,20-24,1920,1.5090433737245903
SIM,1877,20,na,1897,4915
STAT,1882,86,na,1968,955.9049519837724
STAT,1880,53,50-100,1933,0.03161628531251864
STAT,1830,52,50-100,1882,0.02292798537863561
STAT,1811,63,na,1874,1979.9325542970353
STAT,1815,77,na,1892,803.452247450325
STAT,1874,35,na,1909,4918.229678105924
STAT,1893,38,na,1931,6001.100410438319
SIM,1907,26,20-24,1933,32
STAT,1906,22,45-49,1928,2.0521784817704924
STAT,1884,40,35-39,1924,3.6476912916003035
STAT,1886,68,na,1954,3258.02940178946
SIM,1847,22,na,1869,3949
STAT,1862,55,na,1917,3569.2897218895687
STAT,1878,49,na,1927,4646.506364644422
STAT,1915,46,20-24,1961,0.022547808374489657
STAT,1866,69,na,1935,2734.737339752902
SIM,1871,15,25-29,1886,18
SIM,1947,18,15-19,1965,93
STAT,1862,16,20-24,1878,35.25731671161722
STAT,1853,51,50-100,1904,0.02400992358845499
STAT,1858,18,50-100,1876,0.08957172028140786
SIM,1911,29,na,1940,7449
STAT,1830,45,na,1875,3421.088947213215
STAT,1925,40,20-24,1965,0.04329301726507104
STAT,1834,59,na,1893,2582.743103483409
SIM,1947,23,50-100,1970,1
STAT,1920,13,na,1933,8962.097709445497
STAT,1935,30,15-19,1965,0.3595312716458621
STAT,1877,38,50-100,1915,2.5619999454144997
STAT,1844,40,50-100,1884,1.7926601398307278
STAT,1882,15,35-39,1897,1.0845441914985505
SIM,1914,22,45-49,1936,6
STAT,1924,27,na,1951,8806.72288753681
STAT,1901,26,25-29,1927,120.01216749142199
SIM,1908,37,40-44,1945,4
SIM,1958,9,na,1967,10840
STAT,1912,33,25-29,1945,18.29520222493575
SIM,1917,20,20-24,1937,8
SIM,1782,85,na,1867,138
SIM,1892,40,35-39,1932,11
SIM,1917,47,35-39,1964,1
STAT,1863,15,25-29,1878,11.567588254133307
SIM,1832,56,na,1888,2689
STAT,1939,18,15-19,1957,91.72746218109502
SIM,1859,24,15-19,1883,6
SIM,1861,58,na,1919,3769
STAT,1847,20,15-19,1867,6.254358099196485
STAT,1945,20,30-34,1965,63.656940135505444
SIM,1870,16,20-24,1886,34
STAT,1861,17,na,1878,4435.080873063955
STAT,1922,42,45-49,1964,0.3856990481113205
SIM,1933,35,50-100,1968,1
SIM,1833,49,30-34,1882,1
STAT,1911,16,40-44,1927,0.5668371438288511
STAT,1784,107,na,1891,0.00853023864342756
SIM,1920,33,25-29,1953,27
SIM,1938,31,45-49,1969,4
SIM,1929,24,na,1953,9486
STAT,1820,43,50-100,1863,4.154133927626128
STAT,1846,15,25-29,1861,11.033143959357792
STAT,1867,31,45-49,1898,3.311787164578256
SIM,1908,30,20-24,1938,6
STAT,1931,33,35-39,1964,24.16935231167954
STAT,1826,48,35-39,1874,0.27540290315110516
SIM,1925,10,na,1935,9710
STAT,1925,35,25-29,1960,2.390323705519012
STAT,1929,32,40-44,1961,10.038122055309605
SIM,1861,69,na,1930,2717
SIM,1906,50,na,1956,6445
STAT,1847,27,35-39,1874,17.67858415460289
STAT,1879,23,15-19,1902,6.947578198507867
SIM,1889,35,40-44,1924,18
STAT,1922,18,45-49,1940,1.1642189426619733
STAT,1935,25,40-44,1960,12.845443444527463
STAT,1881,16,30-34,1897,3.1190042593593645
SIM,1908,38,30-34,1946,7
SIM,1910,38,35-39,1948,8
SIM,1841,92,na,1933,34
SIM,1832,45,na,1877,3255
STAT,1894,41,50-100,1935,2.753257132260113
STAT,1908,42,50-100,1950,0.2196609750396138
STAT,1911,21,15-19,1932,10.229789167500483
STAT,1912,31,50-100,1943,1.6502376219960084
SIM,1855,27,35-39,1882,22
STAT,1845,53,40-44,1898,0.0159619622119109
STAT,1902,38,35-39,1940,4.331354176918912
SIM,1841,60,na,1901,2671
SIM,1952,16,30-34,1968,41
STAT,1845,27,50-100,1872,1.1998029907042547
SIM,1811,94,na,1905,12
SIM,1853,27,50-100,1880,4
SIM,1914,19,15-19,1933,18
STAT,1853,51,25-29,1904,0.00563099181163961
STAT,1858,25,45-49,1883,1.8154799652664404
SIM,1853,18,na,1871,4563
SIM,1840,16,35-39,1856,1
STAT,1909,47,35-39,1956,0.23939884572843717
STAT,1848,49,25-29,1897,0.09247515223394365
SIM,1849,88,na,1937,147
SIM,1885,27,20-24,1912,26
STAT,1905,40,30-34,1945,0.23553434590937447
STAT,1908,10,na,1918,7765.511789552772
STAT,1921,35,40-44,1956,3.38083529796181
SIM,1818,36,20-24,1854,5
SIM,1919,46,na,1965,8144
STAT,1917,37,40-44,1954,3.1399860242963666
SIM,1878,21,50-100,1899,1
SIM,1915,32,na,1947,7833
STAT,1911,49,40-44,1960,0.2997678256005135
STAT,1918,25,40-44,1943,10.084308531820053
STAT,1869,16,30-34,1885,3.1810343055415946
SIM,1845,74,na,1919,1685
SIM,1881,25,na,1906,4125
SIM,1935,32,30-34,1967,58
STAT,1870,44,50-100,1914,2.0664862426807717
STAT,1899,26,50-100,1925,1.7761921184654008
STAT,1919,33,35-39,1952,19.823739040362735
SIM,1864,30,30-34,1894,49
STAT,1852,54,50-100,1906,0.02340898236565758
SIM,1896,20,25-29,1916,166
STAT,1841,40,na,1881,3575.093454319815
STAT,1911,41,30-34,1952,0.247929227935791
STAT,1843,95,na,1938,18.624625697670584
STAT,1935,28,45-49,1963,4.754727634468255
STAT,1837,88,na,1925,191.33976183344953
SIM,1851,59,na,1910,3013
SIM,1818,41,na,1859,3139
STAT,1863,40,na,1903,4127.271963325678
STAT,1812,54,40-44,1866,0.06704735369746745
STAT,1918,31,na,1949,8148.522188236781
SIM,1901,24,25-29,1925,170
STAT,1895,3,na,1898,6957.087963833323
STAT,1891,68,na,1959,4030.8567417513523
STAT,1794,77,na,1871,704.5284870798059
STAT,1833,74,na,1907,1458.9589150827517
STAT,1856,30,30-34,1886,28.117364232923652
SIM,1842,55,na,1897,2942
STAT,1888,20,25-29,1908,137.4643290021853
STAT,1845,54,na,1899,3226.6530543750137
STAT,1844,15,15-19,1859,12.32742918249162
SIM,1815,43,50-100,1858,4
SIM,1931,31,35-39,1962,34
STAT,1867,54,na,1921,3960.561779938103
SIM,1914,15,50-100,1929,1
SIM,1849,22,40-44,1871,4
SIM,1848,34,40-44,1882,8
SIM,1925,37,40-44,1962,2
STAT,1916,41,45-49,1957,0.34494704467071646
STAT,1930,21,25-29,1951,239.70331284519128
STAT,1950,17,30-34,1967,29.105017126561386
SIM,1862,38,45-49,1900,6
SIM,1898,41,40-44,1939,2
SIM,1926,25,40-44,1951,18
STAT,1881,50,50-100,1931,0.029905460299697213
SIM,1925,8,na,1933,9746
STAT,1906,15,50-100,1921,0.14485024855529338
SIM,1870,37,40-44,1907,12
STAT,1865,15,35-39,1880,1.1536222650460706
STAT,1890,38,50-100,1928,3.0115655352041095
STAT,1827,37,50-100,1864,2.551447954753699
SIM,1911,18,35-39,1929,2
STAT,1945,23,35-39,1968,20.833378472845215
SIM,1852,15,15-19,1867,9
SIM,1890,3,na,1893,7012
STAT,1855,39,15-19,1894,0.08382515391353637
STAT,1849,9,na,1858,4743.683851064729
STAT,1903,18,35-39,1921,1.5737134165432582
SIM,1840,96,na,1936,12
STAT,1901,23,20-24,1924,194.2389899112002
SIM,1876,20,35-39,1896,12
SIM,1930,16,50-100,1946,1
STAT,1923,31,35-39,1954,21.23768302367758
STAT,1888,16,na,1904,6043.593122892113
STAT,1849,20,25-29,1869,111.06810121852529
STAT,1926,23,25-29,1949,225.89860719229011
SIM,1874,27,45-49,1901,1
STAT,1896,67,na,1963,4630.459275356676
STAT,1952,6,na,1958,9513.6304593048
STAT,1862,87,na,1949,304.12348736272304
STAT,1897,31,30-34,1928,47.32760845430154
STAT,1892,53,na,1945,5356.58507024524
SIM,1921,17,40-44,1938,4
STAT,1922,16,50-100,1938,0.8776080464258086
SIM,1896,28,35-39,1924,37
STAT,1884,15,45-49,1899,0.13087599957623816
STAT,1831,30,na,1861,3699.637764437102
STAT,1865,38,20-24,1903,1.4073469646583003
STAT,1868,20,35-39,1888,11.375798978898802
SIM,1944,17,35-39,1961,10
STAT,1866,24,40-44,1890,3.8588264094529388
STAT,1942,28,15-19,1970,1.4957205378574205
STAT,1882,24,50-100,1906,0.7972630484904375
STAT,1887,41,15-19,1928,0.03133468532025366
STAT,1852,20,45-49,1872,1.3394546449131337
SIM,1966,2,na,1968,9445
SIM,1777,85,na,1862,133
STAT,1913,17,40-44,1930,0.5777131311019162
SIM,1829,37,35-39,1866,21
STAT,1835,44,na,1879,3180.010721608322
STAT,1788,81,na,1869,421.79389433972466
STAT,1943,27,40-44,1970,10.025193532908268
SIM,1868,91,na,1959,131
SIM,1873,38,20-24,1911,3
STAT,1852,38,35-39,1890,11.21698105578746
SIM,1817,56,na,1873,2503
SIM,1882,37,50-100,1919,5
SIM,1839,23,35-39,1862,15
SIM,1813,42,na,1855,3069
SIM,1860,38,35-39,1898,15
STAT,1908,32,20-24,1940,4.653013962877731
SIM,1890,24,50-100,1914,1
STAT,1874,37,50-100,1911,2.5388674453140085
STAT,1923,48,20-24,1971,0.026028486030897975
SIM,1902,36,na,1938,6976
SIM,1791,78,na,1869,492
SIM,1857,20,25-29,1877,136
SIM,1934,23,25-29,1957,291
SIM,1940,31,na,1971,8130
STAT,1906,19,15-19,1925,17.37139032185938
SIM,1915,28,20-24,1943,38
STAT,1930,41,40-44,1971,0.6656088414537343
STAT,1931,17,20-24,1948,358.404345282253
SIM,1823,63,na,1886,1978
STAT,1927,32,30-34,1959,39.13566541510038
STAT,1762,100,na,1862,0.4734175330322727
STAT,1867,28,15-19,1895,0.8551234770792493
STAT,1823,39,50-100,1862,4.382785952154154
STAT,1897,49,20-24,1946,0.01789233055929815
STAT,1760,97,na,1857,0.22942324125223196
STAT,1917,46,30-34,1963,0.188505101566036
SIM,1949,12,na,1961,9611
STAT,1904,31,25-29,1935,29.811978697301736
STAT,1877,27,20-24,1904,24.602709320192115
SIM,1849,41,45-49,1890,4
STAT,1914,29,50-100,1943,2.0123719773650026
STAT,1936,17,35-39,1953,8.115187764865953
STAT,1841,18,na,1859,4270.20313068134
STAT,1891,30,25-29,1921,25.77498495765335
STAT,1897,20,na,1917,6422.879631528497
STAT,1870,21,na,1891,4703.6407838523555
SIM,1792,63,na,1855,1720
SIM,1796,77,na,1873,637
SIM,1906,20,45-49,1926,3
STAT,1859,26,15-19,1885,0.7472761857290282
STAT,1781,109,na,1890,0.006334331628258721
STAT,1914,17,na,1931,8070.282862917448
STAT,1840,55,na,1895,2984.6211910496836
SIM,1859,87,na,1946,206
SIM,1880,30,15-19,1910,2
STAT,1870,39,40-44,1909,8.592473218525756
SIM,1855,73,na,1928,1885
STAT,1907,28,20-24,1935,34.70062101191336
SIM,1910,35,30-34,1945,5
SIM,1899,20,na,1919,6649
STAT,1871,17,25-29,1888,11.443809808213393
STAT,1903,65,na,1968,5460.4985063025815
STAT,1928,44,40-44,1972,0.6417430161620318
SIM,1837,36,30-34,1873,6
SIM,1903,48,45-49,1951,1
STAT,1921,42,50-100,1963,0.2671713468955697
STAT,1829,49,15-19,1878,6.148372471059794E-4
SIM,1912,31,25-29,1943,22
STAT,1925,19,25-29,1944,105.13605302493448
SIM,1933,19,25-29,1952,140
SIM,1865,40,na,1905,4376
STAT,1820,52,25-29,1872,0.01267635313509713
STAT,1858,48,30-34,1906,0.15048873619580375
SIM,1869,54,na,1923,4068
STAT,1848,33,50-100,1881,1.577882909572702
STAT,1820,56,na,1876,2468.5714037867656
STAT,1911,45,25-29,1956,0.10192859690502397
SIM,1916,32,20-24,1948,6
STAT,1839,25,35-39,1864,19.255431207457804
STAT,1902,35,30-34,1937,3.3111755901057163
STAT,1951,5,na,1956,9455.148425462243
STAT,1770,86,na,1856,111.34430330000002
SIM,1939,16,15-19,1955,92
STAT,1872,76,na,1948,1922.9835766119877
SIM,1889,38,45-49,1927,6
SIM,1867,26,15-19,1893,1
STAT,1899,26,45-49,1925,3.0829062371402003
STAT,1871,91,na,1962,247.90948510700542
STAT,1880,53,35-39,1933,0.018022312529286166
SIM,1903,40,35-39,1943,2
SIM,1929,30,40-44,1959,17
STAT,1848,8,na,1856,4991.4965420199
STAT,1872,30,15-19,1902,0.29137405449388754
SIM,1926,29,35-39,1955,46
STAT,1812,50,25-29,1862,0.024443058593822325
STAT,1840,44,na,1884,3392.038182086998
SIM,1905,41,35-39,1946,1
SIM,1838,18,na,1856,4216
STAT,1940,27,15-19,1967,1.4539866020887775
STAT,1783,108,na,1891,0.005642027402673434
STAT,1880,28,45-49,1908,2.3539358372252015
STAT,1840,37,50-100,1877,2.0960476033217454
SIM,1847,25,35-39,1872,27
STAT,1917,17,25-29,1934,18.832124060274317
STAT,1918,27,50-100,1945,2.1389580783810325
SIM,1865,44,50-100,1909,4
SIM,1869,17,35-39,1886,2
STAT,1938,33,45-49,1971,3.194054368718962
SIM,1877,49,45-49,1926,1
STAT,1906,2,na,1908,7844.888470720396
STAT,1952,12,na,1964,9506.307308561558
STAT,1821,107,na,1928,0.0052273806714362514
SIM,1860,20,45-49,1880,2
STAT,1886,49,50-100,1935,0.5126726189410598
STAT,1896,27,30-34,1923,67.14573031896474
STAT,1918,21,25-29,1939,201.7728940610669
STAT,1851,16,45-49,1867,0.12384527600366392
STAT,1857,44,50-100,1901,1.640615088942191
SIM,1926,21,25-29,1947,10
STAT,1909,38,45-49,1947,1.29743658958661
SIM,1926,27,50-100,1953,2
STAT,1883,17,na,1900,5011.492997158295
SIM,1869,65,na,1934,3136
STAT,1905,15,40-44,1920,0.536701778481615
SIM,1838,40,30-34,1878,6
STAT,1829,36,30-34,1865,9.485767487222345
SIM,1889,53,na,1942,5352
STAT,1883,21,50-100,1904,0.8116105984829651
STAT,1849,30,50-100,1879,1.7134780627559583
STAT,1924,27,30-34,1951,92.11326449188239
STAT,1920,45,50-100,1965,0.5072073979805846
SIM,1890,39,na,1929,6110
STAT,1840,28,15-19,1868,0.8106925417522227
SIM,1803,75,na,1878,891
STAT,1847,24,30-34,1871,32.809447998842494
STAT,1918,29,35-39,1947,32.03281059022152
STAT,1909,19,40-44,1928,0.5512943600581223
SIM,1927,33,35-39,1960,34
STAT,1804,52,40-44,1856,0.061562815368863925
STAT,1931,30,30-34,1961,41.74253492297686
SIM,1941,18,20-24,1959,288
STAT,1805,78,na,1883,713.9218383962118
STAT,1905,27,20-24,1932,34.26499607645367
SIM,1772,86,na,1858,94
SIM,1857,30,50-100,1887,3
STAT,1933,18,20-24,1951,365.61342477361194
SIM,1889,30,35-39,1919,27
STAT,1937,23,na,1960,7181.107419256596
SIM,1905,16,45-49,1921,1
STAT,1895,15,20-24,1910,46.87171051919755
STAT,1913,36,45-49,1949,1.365602365757276
SIM,1885,48,40-44,1933,1
SIM,1921,28,na,1949,8380
SIM,1906,17,15-19,1923,19
STAT,1935,34,30-34,1969,43.97331185145992
SIM,1921,36,45-49,1957,1
SIM,1932,27,30-34,1959,133
STAT,1914,37,15-19,1951,0.03872955907215319
SIM,1834,30,45-49,1864,6
STAT,1860,41,15-19,1901,0.022751747029056878
STAT,1801,64,na,1865,1804.3230634066554
SIM,1879,41,30-34,1920,4
STAT,1849,40,40-44,1889,3.6200829026773493
SIM,1816,40,50-100,1856,6
SIM,1833,26,45-49,1859,3
SIM,1855,24,30-34,1879,52
SIM,1877,16,30-34,1893,4
SIM,1898,21,25-29,1919,173
SIM,1807,89,na,1896,85
SIM,1878,37,30-34,1915,19
STAT,1925,44,15-19,1969,0.0037416985683005268
SIM,1858,16,20-24,1874,32
SIM,1866,36,na,1902,4579
STAT,1871,43,40-44,1914,4.480603361850964
SIM,1807,78,na,1885,581
SIM,1866,25,45-49,1891,3
SIM,1870,73,na,1943,2201
SIM,1874,87,na,1961,432
SIM,1816,93,na,1909,15
SIM,1942,22,20-24,1964,227
SIM,1917,19,40-44,1936,3
SIM,1803,64,na,1867,1821
STAT,1915,49,25-29,1964,0.10732826200000921
SIM,1872,21,na,1893,5067
SIM,1821,37,45-49,1858,4
SIM,1836,24,20-24,1860,118
SIM,1920,24,35-39,1944,35
STAT,1839,50,25-29,1889,0.0056682148343995915
SIM,1943,28,45-49,1971,5
STAT,1887,53,na,1940,4785.600893659329
SIM,1857,40,40-44,1897,6
SIM,1920,30,20-24,1950,6
SIM,1866,48,30-34,1914,1
STAT,1892,17,45-49,1909,0.16515462133678882
STAT,1852,17,15-19,1869,11.439755031883283
SIM,1913,27,20-24,1940,36
STAT,1840,15,30-34,1855,3.0141241956243796
SIM,1811,45,50-100,1856,2
SIM,1911,47,40-44,1958,1
STAT,1861,53,25-29,1914,0.005858553077734464
SIM,1908,33,25-29,1941,19
STAT,1826,30,45-49,1856,6.07272433166497
SIM,1870,30,50-100,1900,3
STAT,1912,24,35-39,1936,18.878126844225083
SIM,1935,31,na,1966,10866
STAT,1903,47,40-44,1950,0.27640146716087594
STAT,1934,22,20-24,1956,301.84087309107014
STAT,1912,30,20-24,1942,4.887602384762898
SIM,1888,26,35-39,1914,4
STAT,1870,10,na,1880,5316.969983277198
STAT,1925,39,40-44,1964,3.6202165331540903
SIM,1907,29,25-29,1936,14
STAT,1816,41,na,1857,3114.09919960598
STAT,1860,49,25-29,1909,0.09249633456342128
STAT,1893,21,45-49,1914,1.7904474345694756
STAT,1833,33,40-44,1866,7.279597142822209
SIM,1887,6,na,1893,6453
STAT,1821,95,na,1916,14.73738795215365
STAT,1859,34,15-19,1893,0.22695888423926636
SIM,1838,42,50-100,1880,4
SIM,1882,42,na,1924,4778
STAT,1831,25,30-34,1856,45.122534822983056
SIM,1914,15,na,1929,8316
STAT,1909,32,15-19,1941,0.2477961122073112
SIM,1799,74,na,1873,797
SIM,1924,47,na,1971,9189
SIM,1851,37,30-34,1888,7
SIM,1922,34,na,1956,8974
STAT,1808,49,30-34,1857,0.5862722869268175
STAT,1895,39,45-49,1934,5.19332064530793
SIM,1827,36,50-100,1863,4
STAT,1879,38,35-39,1917,14.867275460417959
STAT,1901,22,45-49,1923,1.9715853954796654
STAT,1920,31,50-100,1951,1.8360637972026905
SIM,1835,36,20-24,1871,4
SIM,1837,44,30-34,1881,4
STAT,1817,52,50-100,1869,0.06990941697294252
STAT,1856,33,35-39,1889,15.808557911951132
STAT,1898,43,40-44,1941,0.42380902545305743
SIM,1916,3,na,1919,8768
STAT,1904,23,25-29,1927,165.42737290361143
STAT,1836,34,20-24,1870,4.450438092220682
SIM,1823,31,na,1854,3406
STAT,1819,37,25-29,1856,16.74471866982218
SIM,1836,48,45-49,1884,1
STAT,1894,27,20-24,1921,30.436039856694794
SIM,1862,25,25-29,1887,85
SIM,1881,19,15-19,1900,10
STAT,1854,25,25-29,1879,75.78922096300977
STAT,1871,22,20-24,1893,138.2739539474391
SIM,1856,36,na,1892,3996
STAT,1946,26,50-100,1972,2.2400997832087657
SIM,1820,98,na,1918,3
STAT,1906,31,35-39,1937,17.18304266289109
STAT,1895,72,na,1967,3991.3429569024156
SIM,1829,25,40-44,1854,7
SIM,1853,27,25-29,1880,83
STAT,1915,12,na,1927,8348.590511136188
SIM,1889,46,45-49,1935,1
SIM,1912,23,25-29,1935,5
STAT,1813,41,15-19,1854,0.10670700387750985
STAT,1850,27,20-24,1877,21.167668225614214
STAT,1841,29,20-24,1870,20.83903741948315
STAT,1857,33,na,1890,3740.671009761051
SIM,1857,53,na,1910,3805
STAT,1835,38,35-39,1873,11.213188522430881
SIM,1869,47,30-34,1916,1
SIM,1903,25,25-29,1928,140
STAT,1944,20,15-19,1964,11.615034444423275
SIM,1844,21,15-19,1865,6
SIM,1838,23,40-44,1861,4
SIM,1894,22,50-100,1916,1
STAT,1910,20,45-49,1930,2.1475385610332
SIM,1919,40,25-29,1959,1
STAT,1843,37,30-34,1880,8.715621836165754
SIM,1844,47,40-44,1891,1
STAT,1908,64,na,1972,5946.350440338828
STAT,1929,24,40-44,1953,8.532773125834236
SIM,1920,22,20-24,1942,281
SIM,1841,33,40-44,1874,2
STAT,1858,50,na,1908,3438.7022022135056
SIM,1865,72,na,1937,2357
STAT,1840,23,30-34,1863,32.46193932497034
STAT,1921,20,20-24,1941,255.10079096913034
STAT,1828,48,45-49,1876,0.419529134200198
SIM,1943,22,15-19,1965,6
STAT,1849,43,45-49,1892,2.350281371230822
STAT,1842,31,40-44,1873,7.881103437682695
SIM,1864,33,35-39,1897,22
STAT,1868,37,20-24,1905,1.4812064803315421
SIM,1881,22,30-34,1903,40
SIM,1916,28,na,1944,7906
SIM,1888,49,20-24,1937,1
STAT,1883,27,45-49,1910,2.2031449222534873
STAT,1938,22,40-44,1960,6.721848425676128
SIM,1937,24,40-44,1961,11
SIM,1844,25,na,1869,3757
SIM,1842,39,30-34,1881,14
SIM,1855,35,35-39,1890,22
STAT,1923,31,na,1954,8789.535627834251
SIM,1899,17,20-24,1916,43
SIM,1804,60,na,1864,2007
SIM,1908,0,na,1908,8263
SIM,1919,20,30-34,1939,81
SIM,1946,22,40-44,1968,8
STAT,1857,23,na,1880,3857.7630012903446
STAT,1885,40,na,1925,4693.159070905918
SIM,1900,19,35-39,1919,2
STAT,1849,14,na,1863,4606.00433488152
STAT,1914,30,30-34,1944,32.29241483641665
SIM,1833,41,na,1874,3330
SIM,1840,23,50-100,1863,1
SIM,1847,21,40-44,1868,4
SIM,1890,71,na,1961,3794
STAT,1912,22,20-24,1934,215.27726737964403
STAT,1895,50,na,1945,5747.927112428673
SIM,1885,22,15-19,1907,8
STAT,1864,32,30-34,1896,31.52019354521049
SIM,1848,45,45-49,1893,2
SIM,1882,52,na,1934,4380
STAT,1884,38,30-34,1922,10.575901643779678
SIM,1891,27,45-49,1918,5
SIM,1874,29,25-29,1903,85
SIM,1921,21,25-29,1942,250
STAT,1828,35,25-29,1863,6.040602514629709
STAT,1874,48,15-19,1922,8.167718685639031E-4
STAT,1878,31,20-24,1909,5.724863844902131
STAT,1834,39,30-34,1873,8.643120752013951
STAT,1862,24,20-24,1886,120.03237570748595
STAT,1890,17,35-39,1907,1.3526536002371097
STAT,1932,21,35-39,1953,25.028622587956743
SIM,1871,23,25-29,1894,123
STAT,1847,35,35-39,1882,11.42107866063135
STAT,1845,32,20-24,1877,4.9524881346293474
STAT,1950,11,na,1961,9381.229052779338
SIM,1891,26,20-24,1917,34
STAT,1841,49,15-19,1890,5.682537482883461E-4
STAT,1880,50,30-34,1930,0.012846477624561835
STAT,1861,28,35-39,1889,16.220465778914917
STAT,1880,32,15-19,1912,0.3029827239731796
SIM,1824,36,45-49,1860,3
SIM,1827,55,na,1882,2693
SIM,1935,36,25-29,1971,4
STAT,1820,78,na,1898,874.707736572508
SIM,1940,21,35-39,1961,24
STAT,1833,104,na,1937,0.0876857283939871
SIM,1961,7,na,1968,10514
STAT,1839,21,40-44,1860,4.210876078590623
STAT,1845,27,25-29,1872,79.34027693730911
STAT,1857,39,25-29,1896,4.486806541950018
STAT,1889,15,45-49,1904,0.16342402825668748
STAT,1913,21,25-29,1934,181.3604852627777
STAT,1827,36,20-24,1863,1.6449154480538588
STAT,1839,48,20-24,1887,0.018847698458263413
STAT,1893,18,15-19,1911,15.15192394195407
SIM,1870,24,20-24,1894,132
SIM,1874,33,na,1907,4606
STAT,1947,15,45-49,1962,1.1369967750657968
SIM,1829,36,na,1865,3440
SIM,1882,20,na,1902,5002
STAT,1869,49,45-49,1918,0.45219491084381674
STAT,1890,24,50-100,1914,0.9989738005803203
STAT,1896,22,25-29,1918,152.64131934805948
STAT,1863,23,25-29,1886,102.48032265554212
SIM,1835,23,15-19,1858,6
STAT,1863,36,30-34,1899,9.467513521403397
STAT,1878,92,na,1970,334.1610272445225
STAT,1931,27,50-100,1958,2.5953869036843886
STAT,1838,39,15-19,1877,0.08982067273876451
STAT,1945,15,50-100,1960,0.8269329813389583
SIM,1870,100,na,1970,10
SIM,1922,30,30-34,1952,53
STAT,1857,2,na,1859,5541.112679575535
SIM,1920,40,35-39,1960,1
STAT,1844,58,na,1902,3193.6499098111326
SIM,1905,33,35-39,1938,6
STAT,1897,34,35-39,1931,27.105382504521426
SIM,1878,48,50-100,1926,1
SIM,1892,38,30-34,1930,26
SIM,1904,5,na,1909,7714
SIM,1836,35,25-29,1871,8
STAT,1861,15,15-19,1876,11.602568144755944
SIM,1841,20,35-39,1861,13
STAT,1933,33,45-49,1966,4.280590844580288
SIM,1847,48,20-24,1895,1
SIM,1865,94,na,1959,38
STAT,1895,26,25-29,1921,111.70373821922642
SIM,1867,85,na,1952,463
SIM,1869,34,25-29,1903,27
SIM,1870,49,35-39,1919,2
SIM,1890,15,35-39,1905,2
STAT,1810,46,na,1856,2682.582615686094
SIM,1854,35,na,1889,4010
SIM,1819,36,na,1855,3224
SIM,1933,1,na,1934,11606
SIM,1940,29,30-34,1969,100
STAT,1855,17,40-44,1872,0.3280434994567366
STAT,1874,34,40-44,1908,8.891180185746595
SIM,1904,29,20-24,1933,37
STAT,1888,16,40-44,1904,0.437673813076269
SIM,1834,27,15-19,1861,1
SIM,1869,22,30-34,1891,43
STAT,1817,47,30-34,1864,0.467508704940045
STAT,1932,29,30-34,1961,103.55419717094756
SIM,1829,68,na,1897,1940
SIM,1853,32,20-24,1885,4
STAT,1846,39,35-39,1885,11.080855349794827
STAT,1927,36,25-29,1963,2.4742181165707207
STAT,1896,35,30-34,1931,14.345900061804858
SIM,1892,52,na,1944,6098
STAT,1848,47,45-49,1895,0.38516683113743716
STAT,1831,50,35-39,1881,0.012059144245019675
STAT,1851,24,45-49,1875,1.2724252083638805
STAT,1925,44,na,1969,9048.992097796288
STAT,1878,17,35-39,1895,1.157392569284415
STAT,1932,38,50-100,1970,1.138238481015767
SIM,1823,39,20-24,1862,2
STAT,1815,39,20-24,1854,5.387057463857631
SIM,1892,23,45-49,1915,4
STAT,1940,11,na,1951,8104.394832226661
STAT,1922,39,15-19,1961,0.04402470314771764
STAT,1863,36,50-100,1899,2.1809741198613604
SIM,1907,41,45-49,1948,1
STAT,1829,44,30-34,1873,1.8347081599768769
SIM,1932,38,50-100,1970,1
SIM,1887,38,35-39,1925,18
SIM,1890,61,na,1951,4844
SIM,1813,48,50-100,1861,1
SIM,1863,36,50-100,1899,6
SIM,1886,31,20-24,1917,8
SIM,1879,24,40-44,1903,5
SIM,1888,43,50-100,1931,4
STAT,1819,42,20-24,1861,0.735281924560589
STAT,1873,25,35-39,1898,19.93447334877387
STAT,1885,16,15-19,1901,11.959505544349202
STAT,1847,15,40-44,1862,0.35211401410701226
STAT,1858,72,na,1930,1988.3248797094614
STAT,1864,15,40-44,1879,0.37982499672392067
STAT,1923,23,35-39,1946,22.051139999029374
SIM,1817,48,35-39,1865,1
SIM,1929,42,35-39,1971,2
STAT,1912,40,35-39,1952,0.3967863882954049
SIM,1875,72,na,1947,2675
STAT,1856,47,50-100,1903,0.3809186251180399
SIM,1887,43,30-34,1930,5
STAT,1935,32,na,1967,10569.509264702672
SIM,1880,26,30-34,1906,6
STAT,1872,22,na,1894,4800.434962569218
STAT,1884,23,45-49,1907,1.3863507196336138
SIM,1865,37,45-49,1902,8
SIM,1840,21,30-34,1861,44
STAT,1876,39,35-39,1915,14.62564367910107
STAT,1857,42,40-44,1899,3.5364438210970994
SIM,1845,30,20-24,1875,7
STAT,1939,21,45-49,1960,2.2831655749581405
SIM,1810,98,na,1908,11
SIM,1868,38,25-29,1906,7
SIM,1882,28,20-24,1910,25
STAT,1869,24,30-34,1893,34.639346679696715
STAT,1870,26,20-24,1896,23.341268450204957
STAT,1907,40,40-44,1947,0.4683196782094613
SIM,1845,27,50-100,1872,4
STAT,1918,43,20-24,1961,0.037855591216539024
STAT,1835,25,15-19,1860,0.7773037253801351
SIM,1822,33,30-34,1855,36
STAT,1844,49,40-44,1893,0.2707007297793371
STAT,1834,32,45-49,1866,2.9733707073560676
STAT,1932,14,na,1946,10562.710083685866
STAT,1879,43,30-34,1922,2.411103820366618
STAT,1940,23,35-39,1963,19.36705673727393
SIM,1842,32,45-49,1874,6
STAT,1872,51,35-39,1923,0.017557763379553844
STAT,1862,37,40-44,1899,7.556450783220027
STAT,1927,41,20-24,1968,0.04478962125955158
SIM,1907,45,na,1952,6757
SIM,1909,43,20-24,1952,1
SIM,1857,75,na,1932,1710
STAT,1838,37,35-39,1875,11.550726109255024
SIM,1844,35,na,1879,3549
STAT,1807,80,na,1887,597.8103453703143
STAT,1874,28,20-24,1902,24.17424794802549
STAT,1927,13,na,1940,9932.938238092544
SIM,1884,39,35-39,1923,24
SIM,1838,43,35-39,1881,4
SIM,1931,17,na,1948,9716
SIM,1941,30,40-44,1971,12
SIM,1834,44,50-100,1878,4
STAT,1839,54,50-100,1893,0.022933375549752565
SIM,1855,15,40-44,1870,2
SIM,1936,32,25-29,1968,19
STAT,1829,31,25-29,1860,20.207730835142424
SIM,1835,49,40-44,1884,1
SIM,1902,14,na,1916,7585
STAT,1905,35,35-39,1940,4.501292571874807
STAT,1841,22,35-39,1863,10.725841451457576
STAT,1866,35,45-49,1901,3.7501021660034515
STAT,1908,36,15-19,1944,0.0365107156331358
STAT,1761,101,na,1862,0.02019262889899854
SIM,1921,29,20-24,1950,43
SIM,1947,21,45-49,1968,3
STAT,1864,27,35-39,1891,17.41930210401174
SIM,1872,42,na,1914,4874
SIM,1894,33,20-24,1927,7
SIM,1898,67,na,1965,4837
STAT,1848,44,40-44,1892,3.6383707337964104
SIM,1872,27,35-39,1899,29
STAT,1880,15,25-29,1895,12.112394217625265
SIM,1867,53,na,1920,4256
STAT,1885,8,na,1893,5225.857871892664
STAT,1892,25,45-49,1917,2.8262196259538452
STAT,1816,41,50-100,1857,6.059652767289971
SIM,1849,56,na,1905,3316
STAT,1955,17,45-49,1972,1.3391226792122823
STAT,1771,110,na,1881,0.0029833265986965386
SIM,1914,47,na,1961,7481
STAT,1930,21,50-100,1951,1.707531969541844
STAT,1937,30,25-29,1967,18.492429321779674
SIM,1837,31,25-29,1868,26
SIM,1867,39,35-39,1906,24
STAT,1928,32,25-29,1960,23.33707016555845
SIM,1809,91,na,1900,53
SIM,1907,35,na,1942,7168
SIM,1913,35,35-39,1948,6
SIM,1823,38,50-100,1861,3
STAT,1889,32,35-39,1921,25.218752484922998
STAT,1920,42,35-39,1962,0.449052704870687
STAT,1827,49,40-44,1876,0.3010387123671931
STAT,1913,29,20-24,1942,36.4801787130915
SIM,1901,28,40-44,1929,12
SIM,1959,11,na,1970,10850
STAT,1833,47,15-19,1880,6.170136613417507E-4
SIM,1897,32,35-39,1929,44
SIM,1936,15,35-39,1951,5
SIM,1875,28,15-19,1903,3
SIM,1888,34,35-39,1922,5
STAT,1886,33,20-24,1919,5.7384471272546635
STAT,1947,20,40-44,1967,7.679522685710469
STAT,1853,39,40-44,1892,6.856383297236637
SIM,1856,31,35-39,1887,27
STAT,1889,45,40-44,1934,0.4305781699564813
SIM,1901,20,45-49,1921,1
STAT,1909,15,25-29,1924,17.252157167107534
SIM,1894,28,25-29,1922,120
SIM,1839,56,na,1895,2748
STAT,1839,16,45-49,1855,0.1342166574470801
STAT,1922,19,20-24,1941,315.10016958555667
SIM,1826,38,35-39,1864,14
STAT,1825,34,45-49,1859,5.207760503006685
SIM,1831,23,30-34,1854,50
SIM,1846,37,35-39,1883,14
STAT,1902,22,50-100,1924,1.1627516189490525
SIM,1871,20,20-24,1891,138
SIM,1802,79,na,1881,685
SIM,1837,27,40-44,1864,6
STAT,1936,31,20-24,1967,4.788600450479957
SIM,1831,60,na,1891,2565
SIM,1895,49,na,1944,6072
SIM,1902,21,15-19,1923,9
STAT,1870,48,30-34,1918,0.18952597445493052
SIM,1879,44,35-39,1923,9
SIM,1893,29,35-39,1922,38
SIM,1843,38,35-39,1881,23
STAT,1871,38,na,1909,4703.856145928741
STAT,1928,15,35-39,1943,10.726258605845146
SIM,1896,33,30-34,1929,10
STAT,1885,29,35-39,1914,19.258568546740154
SIM,1874,35,45-49,1909,3
SIM,1887,83,na,1970,1788
STAT,1801,109,na,1910,5.639505453402338E-4
STAT,1839,54,40-44,1893,0.015986131502381856
STAT,1866,18,50-100,1884,0.09315534877470093
SIM,1828,49,35-39,1877,1
SIM,1936,20,30-34,1956,68
SIM,1898,44,45-49,1942,1
SIM,1833,34,45-49,1867,2
SIM,1899,26,50-100,1925,7
SIM,1878,45,30-34,1923,1
STAT,1896,18,40-44,1914,0.4864201238079681
STAT,1861,50,20-24,1911,0.001258274451327178
SIM,1894,21,na,1915,6344
STAT,1803,76,na,1879,798.8853458128924
STAT,1837,30,20-24,1867,4.82381670436018
STAT,1852,40,50-100,1892,1.7007738153179943
SIM,1846,42,30-34,1888,3
STAT,1934,26,15-19,1960,1.9191352696359318
STAT,1899,49,30-34,1948,0.14794005193663065
SIM,1931,23,35-39,1954,30
STAT,1855,37,35-39,1892,10.665501441767887
SIM,1906,33,50-100,1939,2
STAT,1829,27,40-44,1856,8.680519363827019
SIM,1917,15,25-29,1932,27
SIM,1888,22,40-44,1910,4
STAT,1809,48,35-39,1857,1.0657034412542674
STAT,1864,29,15-19,1893,0.8132194300037897
STAT,1885,72,na,1957,2664.9031122673496
SIM,1902,22,50-100,1924,1
STAT,1886,28,25-29,1914,89.86675144707006
STAT,1818,38,35-39,1856,43.88255849010346
STAT,1884,32,50-100,1916,1.8272414507495944
STAT,1918,30,15-19,1948,0.27795570215658766
SIM,1878,32,25-29,1910,26
SIM,1893,16,15-19,1909,17
SIM,1920,31,50-100,1951,3
SIM,1861,26,20-24,1887,28
STAT,1891,28,20-24,1919,29.18309758761088
SIM,1834,31,50-100,1865,3
SIM,1827,37,25-29,1864,5
SIM,1830,76,na,1906,1086
STAT,1869,33,20-24,1902,5.267399892822015
SIM,1832,22,35-39,1854,11
SIM,1832,37,20-24,1869,2
SIM,1930,19,20-24,1949,331
SIM,1929,22,40-44,1951,11
STAT,1939,23,50-100,1962,1.3343035212006649
SIM,1836,38,na,1874,3324
STAT,1838,42,30-34,1880,1.8196658413047275
STAT,1944,16,30-34,1960,26.497154108136446
STAT,1854,38,45-49,1892,3.04083205287853
STAT,1881,24,30-34,1905,34.55335172369958
STAT,1875,25,45-49,1900,2.3243735962231513
STAT,1928,20,30-34,1948,72.89531513541058
SIM,1915,40,40-44,1955,2
STAT,1849,36,na,1885,3853.1831498611364
STAT,1798,80,na,1878,499.1530125639227
STAT,1853,26,20-24,1879,21.658197080288044
STAT,1919,42,25-29,1961,0.15625540573390118
SIM,1883,25,45-49,1908,3
SIM,1789,96,na,1885,3
STAT,1800,58,na,1858,2177.4515136733608
STAT,1830,29,45-49,1859,2.311948886092441
SIM,1816,61,na,1877,2146
SIM,1942,26,15-19,1968,2
STAT,1895,43,15-19,1938,0.00250545812925079
STAT,1860,22,45-49,1882,1.178955372067314
STAT,1824,37,20-24,1861,2.3415480325079945
SIM,1877,33,20-24,1910,7
SIM,1834,37,30-34,1871,10
SIM,1907,13,na,1920,7771
STAT,1878,39,45-49,1917,4.1625427915778905
STAT,1898,46,45-49,1944,0.36487163070387285
STAT,1847,23,40-44,1870,3.866043108457439
STAT,1926,32,15-19,1958,0.31376404715629563
SIM,1832,29,20-24,1861,22
SIM,1916,39,40-44,1955,5
STAT,1888,70,na,1958,3529.8785914219197
STAT,1850,50,45-49,1900,0.0225712083015138
STAT,1907,47,na,1954,6648.4438313382125
STAT,1893,28,30-34,1921,64.23568408083253
SIM,1887,35,30-34,1922,14
SIM,1859,28,50-100,1887,2
STAT,1937,13,na,1950,7774.389378628407
SIM,1820,43,50-100,1863,4
SIM,1917,45,na,1962,7962
STAT,1830,56,na,1886,2850.7100173001713
STAT,1929,27,45-49,1956,4.3662963482268875
SIM,1879,54,na,1933,4298
STAT,1826,31,50-100,1857,2.954827205537807
STAT,1899,39,15-19,1938,0.03320146259937041
STAT,1931,40,45-49,1971,0.45029990410762677
SIM,1853,15,30-34,1868,5
SIM,1886,34,25-29,1920,27
SIM,1937,27,45-49,1964,4
STAT,1881,49,45-49,1930,0.451072300714367
STAT,1944,3,na,1947,8727.354599512377
SIM,1865,39,25-29,1904,6
STAT,1834,24,45-49,1858,1.2236626264158383
STAT,1945,24,25-29,1969,204.30231309752028
SIM,1847,21,50-100,1868,1
SIM,1845,25,25-29,1870,87
SIM,1854,44,30-34,1898,4
SIM,1842,24,45-49,1866,1
SIM,1900,16,30-34,1916,6
STAT,1915,29,30-34,1944,80.14450107249978
STAT,1865,42,na,1907,4235.467704659488
SIM,1861,37,na,1898,4479
STAT,1851,21,40-44,1872,3.8854872419684656
STAT,1879,35,30-34,1914,11.36553548500896
SIM,1838,35,35-39,1873,16
STAT,1830,26,40-44,1856,7.4661510258801105
SIM,1928,21,35-39,1949,27
STAT,1816,94,na,1910,19.631375035662924
STAT,1825,49,30-34,1874,0.20421602271511935
STAT,1845,15,30-34,1860,3.141126670205453
SIM,1849,26,20-24,1875,23
SIM,1874,42,50-100,1916,4
STAT,1838,45,35-39,1883,0.1999922751335778
SIM,1867,17,25-29,1884,13
STAT,1848,31,35-39,1879,19.56700403918452
SIM,1787,95,na,1882,3
STAT,1826,37,30-34,1863,12.629471831822803
STAT,1846,44,30-34,1890,1.7371877108075673
SIM,1827,34,20-24,1861,8
STAT,1843,22,45-49,1865,1.226109536514804
STAT,1866,7,na,1873,5202.419064685153
STAT,1908,39,40-44,1947,2.8040344343977757
SIM,1872,74,na,1946,2232
SIM,1932,12,na,1944,10728
STAT,1927,33,20-24,1960,6.055104608170206
SIM,1849,25,50-100,1874,2
STAT,1888,33,30-34,1921,41.50160356467862
STAT,1857,37,45-49,1894,3.1381406589572833
STAT,1877,22,15-19,1899,6.918575305548278
SIM,1905,21,40-44,1926,9
SIM,1813,96,na,1909,2
SIM,1892,20,na,1912,6831
STAT,1892,49,20-24,1941,0.01675670597399081
STAT,1909,20,20-24,1929,210.07743076277262
SIM,1861,34,20-24,1895,7
SIM,1868,48,40-44,1916,1
SIM,1920,25,25-29,1945,184
STAT,1929,41,30-34,1970,0.334826414218827
STAT,1897,26,35-39,1923,26.138043865168044
STAT,1789,104,na,1893,0.03413635019268674
SIM,1869,31,20-24,1900,6
STAT,1866,42,50-100,1908,1.966252905292588
SIM,1781,90,na,1871,31
STAT,1918,26,30-34,1944,84.49040908483711
SIM,1906,20,50-100,1926,1
SIM,1893,24,15-19,1917,8
STAT,1872,26,30-34,1898,51.288127404851195
SIM,1834,25,na,1859,3785
STAT,1929,28,50-100,1957,2.5143997194148984
STAT,1914,33,35-39,1947,18.5026267435301
SIM,1861,7,na,1868,5478
SIM,1876,26,50-100,1902,1
STAT,1837,25,25-29,1862,76.78932360465183
SIM,1935,33,20-24,1968,8
STAT,1836,37,25-29,1873,4.699893130182405
SIM,1918,27,50-100,1945,1
STAT,1863,20,20-24,1883,126.0621470054096
STAT,1853,34,20-24,1887,4.313680370555508
STAT,1878,5,na,1883,5737.795316790526
STAT,1941,19,30-34,1960,25.33975115407538
SIM,1878,28,40-44,1906,8
SIM,1889,43,40-44,1932,8
SIM,1922,33,35-39,1955,30
STAT,1885,24,15-19,1909,6.590497835083285
SIM,1829,42,30-34,1871,7
STAT,1878,49,50-100,1927,0.50722787774727
STAT,1837,35,na,1872,3710.7074295626585
SIM,1853,24,20-24,1877,117
STAT,1842,34,45-49,1876,3.0718458085541096
SIM,1872,29,15-19,1901,1
STAT,1859,17,25-29,1876,10.573878004505332
STAT,1880,2,na,1882,6828.233639135125
STAT,1807,90,na,1897,62.93112664054636
STAT,1820,46,na,1866,2922.6085983426774
STAT,1851,39,30-34,1890,8.178667331747574
STAT,1864,68,na,1932,2758.869536328626
STAT,1887,45,30-34,1932,0.22083098897687492
STAT,1867,33,na,1900,4494.480337781839
STAT,1845,35,25-29,1880,5.2300839780112485
SIM,1891,29,25-29,1920,116
STAT,1786,106,na,1892,0.011284115570514223
STAT,1845,24,20-24,1869,129.94143641730608
SIM,1882,84,na,1966,1109
STAT,1933,30,40-44,1963,10.66406510718191
STAT,1832,39,20-24,1871,1.243023800514507
STAT,1928,17,50-100,1945,0.9532724410105009
STAT,1867,38,30-34,1905,10.030495268573443
SIM,1926,26,30-34,1952,118
STAT,1850,4,na,1854,4994.0
STAT,1855,21,25-29,1876,101.57555940991874
STAT,1878,34,25-29,1912,21.41976118975217
STAT,1854,42,15-19,1896,0.021144229017058317
STAT,1860,49,50-100,1909,0.3943940959902159
STAT,1868,28,30-34,1896,48.21736027266561
SIM,1824,38,25-29,1862,8
STAT,1854,68,na,1922,2342.7073996332497
STAT,1872,17,40-44,1889,0.3724669130036896
SIM,1846,34,30-34,1880,42
SIM,1923,29,30-34,1952,112
SIM,1898,36,45-49,1934,9
STAT,1878,26,25-29,1904,89.53261738938419
STAT,1868,24,15-19,1892,6.299477480426135
STAT,1862,27,25-29,1889,73.28995393563301
SIM,1926,22,15-19,1948,15
STAT,1882,22,na,1904,4652.988766737381
STAT,1942,20,50-100,1962,1.3943302885213231
STAT,1907,25,na,1932,7132.126430019206
STAT,1858,38,15-19,1896,0.08797225359757734
STAT,1918,22,15-19,1940,11.593028522812457
STAT,1872,15,50-100,1887,0.10095363033685367
STAT,1856,16,45-49,1872,0.12107064030152999
SIM,1900,32,45-49,1932,7
STAT,1782,109,na,1891,0.003995187730955733
SIM,1886,39,45-49,1925,5
SIM,1917,5,na,1922,8933
STAT,1874,21,35-39,1895,12.10370782641088
STAT,1846,36,30-34,1882,8.613824865361329
STAT,1852,24,na,1876,3990.346753181824
SIM,1819,43,25-29,1862,2
SIM,1938,20,40-44,1958,7
SIM,1847,24,45-49,1871,2
STAT,1844,23,15-19,1867,6.60414528636235
SIM,1870,27,25-29,1897,84
STAT,1938,34,35-39,1972,18.536710615985132
STAT,1816,38,25-29,1854,21.43572112948301
SIM,1945,26,40-44,1971,17
SIM,1912,46,na,1958,7329
SIM,1848,42,40-44,1890,9
STAT,1896,39,50-100,1935,3.2407398454718317
SIM,1883,1,na,1884,6685
STAT,1837,27,50-100,1864,1.144611499558276
STAT,1883,29,25-29,1912,83.33766548391435
SIM,1845,16,35-39,1861,2
SIM,1903,22,20-24,1925,205
STAT,1903,32,20-24,1935,7.772814069593329
SIM,1923,6,na,1929,9951
SIM,1819,48,45-49,1867,2
SIM,1852,23,15-19,1875,5
SIM,1911,32,20-24,1943,7
STAT,1839,24,45-49,1863,1.3789840341827166
SIM,1857,85,na,1942,401
STAT,1864,35,35-39,1899,12.890079220900006
SIM,1952,2,na,1954,9820
SIM,1902,46,na,1948,6563
SIM,1928,30,25-29,1958,30
STAT,1937,26,40-44,1963,9.182204321331223
SIM,1824,90,na,1914,121
STAT,1859,15,50-100,1874,0.09250327369993534
SIM,1864,25,35-39,1889,29
STAT,1794,98,na,1892,1.2724519834482806
SIM,1877,73,na,1950,2230
SIM,1839,22,45-49,1861,2
STAT,1898,38,45-49,1936,1.1701507957380062
STAT,1925,31,45-49,1956,3.7753058850426364
SIM,1825,32,45-49,1857,6
SIM,1868,35,20-24,1903,1
SIM,1854,36,30-34,1890,16
STAT,1862,49,35-39,1911,0.2366223268589697
SIM,1896,24,40-44,1920,7
SIM,1868,26,30-34,1894,65
STAT,1925,12,na,1937,9664.748521824053
SIM,1927,34,25-29,1961,29
STAT,1867,53,50-100,1920,0.028107058776581685
STAT,1875,19,na,1894,5223.459706745049
SIM,1907,33,45-49,1940,4
SIM,1918,24,30-34,1942,83
STAT,1820,36,25-29,1856,15.2643999474026
STAT,1879,46,35-39,1925,0.2965864763857261
STAT,1797,63,na,1860,1712.9864314670347
SIM,1867,36,30-34,1903,15
STAT,1887,21,na,1908,5358.28289594293
STAT,1911,19,45-49,1930,0.20086281151684116
STAT,1926,24,15-19,1950,12.976978202092706
SIM,1857,35,45-49,1892,6
STAT,1850,19,20-24,1869,32.82658898562973
SIM,1886,26,25-29,1912,103
STAT,1819,45,25-29,1864,0.24910536672004988
SIM,1874,55,na,1929,3947
SIM,1880,17,40-44,1897,1
STAT,1821,73,na,1894,1316.5598308649703
STAT,1936,22,30-34,1958,55.50628140803024
STAT,1890,51,na,1941,5333.436530847582
SIM,1882,34,40-44,1916,14
SIM,1843,20,45-49,1863,5
SIM,1946,1,na,1947,8918
SIM,1829,33,40-44,1862,9
STAT,1865,20,na,1885,4455.924416287734
SIM,1853,37,40-44,1890,9
SIM,1930,15,40-44,1945,6
STAT,1857,55,na,1912,3254.988354620143
STAT,1932,25,50-100,1957,2.635471811233691
SIM,1863,21,25-29,1884,108
SIM,1863,49,50-100,1912,2
STAT,1905,39,15-19,1944,0.03504493330562272
SIM,1849,24,na,1873,4232
SIM,1885,27,35-39,1912,23
STAT,1828,48,50-100,1876,0.43659472538283267
SIM,1819,58,na,1877,2268
SIM,1922,22,30-34,1944,88
STAT,1915,34,na,1949,7713.343663988575
SIM,1933,31,45-49,1964,7
STAT,1810,47,20-24,1857,0.0782755358670465
STAT,1870,29,25-29,1899,83.27692962704197
SIM,1830,27,45-49,1857,2
SIM,1934,24,15-19,1958,18
STAT,1888,24,40-44,1912,4.943048132393765
SIM,1850,28,25-29,1878,91
SIM,1862,25,50-100,1887,4
SIM,1815,43,40-44,1858,11
SIM,1861,39,40-44,1900,15
STAT,1813,54,50-100,1867,0.08530950384723876
SIM,1818,36,35-39,1854,20
STAT,1873,26,50-100,1899,1.3171894701000197
SIM,1878,24,25-29,1902,125
STAT,1914,16,45-49,1930,0.20924317024048666
SIM,1836,48,50-100,1884,1
SIM,1915,27,30-34,1942,103
STAT,1907,43,45-49,1950,0.30627265880935095
STAT,1931,25,35-39,1956,39.18211994080548
STAT,1948,16,15-19,1964,104.91538258978159
SIM,1874,32,40-44,1906,10
STAT,1922,32,30-34,1954,35.94228848515917
STAT,1785,106,na,1891,0.018974455046872875
STAT,1934,29,40-44,1963,12.6528229244575
STAT,1891,36,na,1927,5909.726812678014
SIM,1819,35,25-29,1854,7
STAT,1842,28,25-29,1870,77.32370772454564
STAT,1857,48,15-19,1905,6.217663143878218E-4
SIM,1876,37,20-24,1913,1
STAT,1838,34,30-34,1872,28.759303574671424
SIM,1812,79,na,1891,576
SIM,1871,68,na,1939,2869
STAT,1835,54,na,1889,2731.473145153913
STAT,1923,0,na,1923,10680.581990555482
SIM,1903,30,20-24,1933,9
SIM,1930,32,30-34,1962,52
SIM,1878,15,35-39,1893,2
STAT,1927,44,25-29,1971,0.18024335109647532
SIM,1836,23,30-34,1859,44
STAT,1867,16,20-24,1883,34.483053397558784
SIM,1875,16,20-24,1891,46
SIM,1885,49,na,1934,4690
STAT,1843,27,15-19,1870,0.7821633729496511
STAT,1914,17,20-24,1931,56.64947573218775
SIM,1902,68,na,1970,5204
SIM,1831,26,35-39,1857,28
SIM,1851,27,15-19,1878,1
SIM,1875,38,30-34,1913,18
SIM,1922,17,20-24,1939,343
STAT,1919,34,25-29,1953,19.962487793237663
SIM,1839,47,45-49,1886,1
STAT,1874,19,50-100,1893,0.10076772131616307
SIM,1919,14,na,1933,8954
STAT,1840,48,45-49,1888,0.3391472638361642
SIM,1887,46,35-39,1933,1
SIM,1837,23,25-29,1860,3
STAT,1910,13,na,1923,7893.916120124368
SIM,1879,36,35-39,1915,15
STAT,1842,26,45-49,1868,2.0590089854607796
SIM,1800,78,na,1878,607
SIM,1820,38,40-44,1858,8
SIM,1929,25,45-49,1954,7
STAT,1951,21,45-49,1972,2.7156377424446716
STAT,1887,37,30-34,1924,12.038411250401682
STAT,1892,22,40-44,1914,5.268485339113539
STAT,1926,46,50-100,1972,0.564938135392727
SIM,1808,47,30-34,1855,1
SIM,1884,21,45-49,1905,2
STAT,1864,24,30-34,1888,32.206278683327234
SIM,1799,96,na,1895,2
STAT,1835,20,45-49,1855,1.4793767494702903
SIM,1878,37,45-49,1915,5
STAT,1835,42,50-100,1877,1.6402055111687126
SIM,1893,26,30-34,1919,79
STAT,1876,48,25-29,1924,0.11880651569082307
SIM,1915,43,45-49,1958,1
STAT,1885,43,50-100,1928,2.1084394729781284
STAT,1805,57,na,1862,2348.0027802271593
SIM,1894,25,20-24,1919,4
SIM,1888,25,45-49,1913,3
SIM,1924,25,na,1949,9096
STAT,1819,47,40-44,1866,0.7184394125115898
STAT,1890,19,15-19,1909,14.551137548695834
STAT,1928,23,35-39,1951,23.666226800566744
SIM,1932,39,25-29,1971,5
STAT,1877,21,na,1898,4974.855401221343
SIM,1862,54,na,1916,3811
STAT,1900,18,30-34,1918,4.453724305128694
SIM,1942,29,40-44,1971,15
STAT,1886,38,40-44,1924,9.286294967207827
STAT,1947,23,45-49,1970,2.5672395642633092
STAT,1813,44,na,1857,2794.006546835606
STAT,1876,69,na,1945,3065.492284653917
SIM,1803,96,na,1899,12
STAT,1917,21,50-100,1938,1.416519375189485
SIM,1888,31,30-34,1919,56
STAT,1836,21,15-19,1857,5.832062000537988
SIM,1907,31,50-100,1938,1
STAT,1903,15,30-34,1918,4.604565579583587
SIM,1865,30,50-100,1895,2
SIM,1826,35,30-34,1861,12
STAT,1898,15,na,1913,6934.774095275913
STAT,1912,25,25-29,1937,131.92304900755133
SIM,1874,26,20-24,1900,23
STAT,1827,44,20-24,1871,0.29096877650368896
STAT,1824,60,na,1884,2191.6678234758565
SIM,1919,36,40-44,1955,5
STAT,1821,48,35-39,1869,0.40389143236195313
SIM,1806,61,na,1867,2043
STAT,1883,71,na,1954,2648.609318198057
SIM,1877,20,15-19,1897,6
SIM,1926,28,45-49,1954,4
STAT,1840,15,45-49,1855,0.12352965503369052
SIM,1872,24,30-34,1896,38
SIM,1895,37,30-34,1932,11
SIM,1826,38,na,1864,3248
SIM,1901,25,15-19,1926,5
STAT,1885,26,30-34,1911,50.796801932802246
STAT,1922,14,na,1936,9228.665593833372
SIM,1863,39,na,1902,4370
STAT,1841,93,na,1934,42.40399681407867
STAT,1803,98,na,1901,2.2925857482304584
SIM,1894,38,40-44,1932,19
SIM,1911,15,30-34,1926,7
SIM,1914,31,35-39,1945,23
SIM,1932,34,na,1966,10200
STAT,1825,31,40-44,1856,17.054376547060155
STAT,1922,15,40-44,1937,3.2835623359549535
STAT,1886,25,20-24,1911,25.1804617418422
STAT,1864,18,45-49,1882,0.121274676044749
STAT,1894,35,20-24,1929,2.0188810749897876
SIM,1936,23,35-39,1959,21
STAT,1849,35,45-49,1884,3.2943634661443784
STAT,1848,72,na,1920,2070.777923276377
STAT,1800,109,na,1909,6.076730060165016E-4
SIM,1845,33,25-29,1878,8
SIM,1831,28,15-19,1859,1
SIM,1833,31,40-44,1864,13
SIM,1856,44,40-44,1900,6
STAT,1940,20,30-34,1960,59.17655520598879
SIM,1855,23,40-44,1878,7
STAT,1836,39,na,1875,3423.4809724514253
STAT,1837,33,25-29,1870,17.7180909306429
SIM,1859,15,25-29,1874,19
SIM,1872,18,45-49,1890,3
SIM,1901,19,na,1920,7168
STAT,1945,21,20-24,1966,246.1885000223456
SIM,1847,30,30-34,1877,43
STAT,1872,8,na,1880,5495.2997514606295
SIM,1846,28,45-49,1874,2
STAT,1869,20,15-19,1889,6.522311948785828
SIM,1868,22,15-19,1890,6
SIM,1902,49,40-44,1951,1
SIM,1929,20,25-29,1949,261
SIM,1941,17,30-34,1958,31
STAT,1928,36,40-44,1964,3.8237847048891576
SIM,1916,24,20-24,1940,240
STAT,1863,19,na,1882,4582.001246384995
SIM,1817,37,30-34,1854,9
SIM,1870,29,40-44,1899,7
STAT,1834,91,na,1925,77.0090481156165
STAT,1933,17,30-34,1950,32.956528804527046
SIM,1845,22,20-24,1867,132
STAT,1795,94,na,1889,9.281593616070971
STAT,1847,26,45-49,1873,2.0489881104040664
SIM,1863,37,35-39,1900,4
STAT,1851,61,na,1912,2896.726391009282
STAT,1862,15,30-34,1877,3.188561503070354
STAT,1887,28,40-44,1915,6.742540212657652
SIM,1842,21,40-44,1863,4
STAT,1862,29,40-44,1891,5.133988400107081
STAT,1864,47,50-100,1911,0.4413169314544017
STAT,1895,29,na,1924,6235.559930453242
STAT,1955,10,na,1965,10533.05323226661
STAT,1846,20,20-24,1866,132.12949413069126
SIM,1837,36,45-49,1873,6
SIM,1844,57,na,1901,2857
STAT,1855,74,na,1929,1673.4883435746267
SIM,1897,51,na,1948,5910
STAT,1844,39,25-29,1883,4.812421301034018
SIM,1833,94,na,1927,24
SIM,1852,39,25-29,1891,9
STAT,1902,16,na,1918,7219.064062572772
SIM,1801,84,na,1885,187
SIM,1918,20,15-19,1938,14
STAT,1924,39,25-29,1963,2.3392066291112763
SIM,1830,103,na,1933,1
STAT,1842,24,na,1866,3957.5990523409864
SIM,1954,13,na,1967,9916
SIM,1828,37,40-44,1865,13
STAT,1819,36,50-100,1855,7.684410314766631
SIM,1869,39,45-49,1908,5
SIM,1939,24,15-19,1963,9
STAT,1830,24,25-29,1854,305.698723905033
SIM,1880,22,15-19,1902,5
STAT,1851,15,20-24,1866,33.810760042090905
SIM,1895,28,40-44,1923,13
STAT,1829,35,40-44,1864,7.929230260682006
STAT,1853,37,25-29,1890,4.555469967836242
STAT,1852,103,na,1955,0.22873570847975014
STAT,1859,89,na,1948,168.87240013163552
STAT,1942,20,40-44,1962,7.125027255971195
STAT,1834,21,40-44,1855,3.7365854528502034
SIM,1842,18,25-29,1860,10
STAT,1884,66,na,1950,3268.62953410238
SIM,1852,25,30-34,1877,60
SIM,1892,19,na,1911,7216
STAT,1896,27,45-49,1923,2.9605436753482235
STAT,1812,47,30-34,1859,0.6723284415909478
SIM,1827,87,na,1914,146
SIM,1934,15,25-29,1949,147
STAT,1838,28,45-49,1866,1.8977684373302552
SIM,1872,49,45-49,1921,1
STAT,1965,5,na,1970,9911.576323912683
SIM,1906,29,30-34,1935,80
STAT,1837,42,15-19,1879,0.022717639923558523
STAT,1875,53,50-100,1928,0.030899702249078963
SIM,1861,17,30-34,1878,6
SIM,1863,25,40-44,1888,7
STAT,1857,21,35-39,1878,10.681627854823976
STAT,1894,19,35-39,1913,1.4159349426819288
STAT,1934,34,15-19,1968,0.3539416439592696
STAT,1846,49,na,1895,3374.1496811791017
SIM,1937,28,20-24,1965,38
SIM,1844,26,35-39,1870,25
STAT,1846,47,35-39,1893,0.2134395515312593
STAT,1849,48,15-19,1897,6.247686346232868E-4
SIM,1929,14,na,1943,10478
STAT,1871,27,40-44,1898,6.010643953979892
STAT,1889,41,50-100,1930,2.6427149953892033
STAT,1903,35,25-29,1938,1.8039880825184036
STAT,1853,17,30-34,1870,3.0335884010888883
SIM,1938,32,35-39,1970,21
SIM,1889,37,20-24,1926,3
STAT,1829,36,45-49,1865,3.548076817664756
SIM,1794,97,na,1891,6
SIM,1865,21,35-39,1886,13
SIM,1895,29,45-49,1924,2
SIM,1908,25,25-29,1933,138
STAT,1899,27,20-24,1926,32.46255245454906
SIM,1835,28,35-39,1863,25
STAT,1827,28,35-39,1855,39.88856903411901
STAT,1872,48,40-44,1920,0.3431253312081745
SIM,1820,44,na,1864,2927
STAT,1819,38,na,1857,3025.216120176809
STAT,1810,48,50-100,1858,1.5714620965894341
STAT,1855,25,40-44,1880,5.2491041409565735
STAT,1859,99,na,1958,4.898746737903259
STAT,1898,49,15-19,1947,6.03799411025907E-4
SIM,1952,18,45-49,1970,1
STAT,1864,49,45-49,1913,0.41715737765659083
SIM,1871,36,30-34,1907,13
STAT,1847,49,50-100,1896,0.3665616197581853
SIM,1909,34,30-34,1943,40
STAT,1836,26,35-39,1862,16.7242185569721
STAT,1885,19,na,1904,5049.988286772355
SIM,1769,98,na,1867,1
SIM,1930,35,35-39,1965,8
STAT,1907,15,15-19,1922,17.69774328460744
SIM,1892,28,15-19,1920,2
SIM,1812,48,35-39,1860,1
STAT,1941,28,na,1969,7823.156580682052
STAT,1924,19,30-34,1943,29.149286519319
STAT,1844,25,30-34,1869,50.50544173969063
SIM,1900,28,25-29,1928,120
STAT,1854,16,35-39,1870,1.012194819342792
SIM,1859,36,30-34,1895,16
STAT,1887,15,35-39,1902,1.2451787195145037
STAT,1916,30,40-44,1946,8.225255191748277
STAT,1827,57,na,1884,2560.724486741644
STAT,1837,49,35-39,1886,0.19747529123834906
SIM,1858,31,45-49,1889,4
STAT,1909,23,25-29,1932,172.94023078422117
STAT,1931,29,15-19,1960,1.8389591324779795
STAT,1880,41,na,1921,4939.581105112294
STAT,1892,16,20-24,1908,44.93305923817484
STAT,1902,18,40-44,1920,0.5201535517830731
STAT,1944,18,45-49,1962,1.085297246143667
STAT,1863,23,50-100,1886,0.730020895857685
STAT,1842,17,20-24,1859,33.893997455009206
STAT,1937,22,25-29,1959,181.70056128107083
SIM,1828,38,45-49,1866,2
SIM,1894,36,25-29,1930,10
SIM,1910,18,40-44,1928,3
SIM,1927,25,35-39,1952,47
STAT,1873,16,45-49,1889,0.13483965170114148
SIM,1898,33,40-44,1931,15
SIM,1837,35,40-44,1872,9
SIM,1890,37,50-100,1927,7
STAT,1938,31,30-34,1969,32.01832613605062
SIM,1822,57,na,1879,2382
STAT,1818,49,25-29,1867,0.2462120864438012
STAT,1896,26,40-44,1922,8.01486722861764
SIM,1840,36,50-100,1876,4
STAT,1890,73,na,1963,3423.436717020359
SIM,1861,37,25-29,1898,9
STAT,1919,31,20-24,1950,5.335378093593428
SIM,1879,33,30-34,1912,37
SIM,1834,22,45-49,1856,3
SIM,1945,22,25-29,1967,226
STAT,1848,111,na,1959,2.653373218909488E-4
STAT,1859,67,na,1926,2548.220520595656
STAT,1804,107,na,1911,0.003172511189120578
STAT,1817,57,na,1874,2452.9263403931263
SIM,1835,27,30-34,1862,57
SIM,1887,29,45-49,1916,8
STAT,1803,107,na,1910,0.00332817956280267
STAT,1816,47,15-19,1863,0.0019653637435361943
STAT,1953,17,35-39,1970,10.250776730752236
SIM,1899,32,45-49,1931,5
STAT,1908,24,20-24,1932,205.29875727561185
STAT,1879,29,45-49,1908,2.328726278916593
SIM,1850,17,20-24,1867,40
STAT,1886,36,25-29,1922,6.16782691492581
STAT,1910,45,na,1955,6957.690938522318
STAT,1939,30,35-39,1969,18.85446044880323
SIM,1911,35,25-29,1946,4
STAT,1890,39,45-49,1929,4.8647957854525
SIM,1852,86,na,1938,303
SIM,1820,76,na,1896,927
STAT,1835,47,25-29,1882,0.07866996869083034
STAT,1852,34,na,1886,3856.9543199869026
SIM,1812,47,na,1859,2823
STAT,1866,29,25-29,1895,78.26444263548156
STAT,1922,35,35-39,1957,5.566566824602566
STAT,1957,2,na,1959,10476.891721187236
STAT,1833,39,15-19,1872,0.09056231110000568
SIM,1932,19,30-34,1951,44
STAT,1837,22,20-24,1859,125.7635515765345
STAT,1839,30,30-34,1869,34.253172296794524
STAT,1884,28,15-19,1912,0.9016206622629951
STAT,1928,6,na,1934,10198.10893245882
SIM,1863,26,45-49,1889,3
SIM,1869,38,40-44,1907,12
SIM,1927,31,20-24,1958,5
SIM,1895,48,35-39,1943,1
STAT,1827,27,30-34,1854,149.95213283106182
SIM,1897,24,35-39,1921,21
SIM,1792,84,na,1876,189
STAT,1825,104,na,1929,0.07717432958612029
SIM,1905,24,45-49,1929,6
STAT,1845,37,40-44,1882,7.087382858576836
STAT,1802,81,na,1883,463.36204545319634
STAT,1877,27,35-39,1904,20.235329440173956
SIM,1950,20,40-44,1970,12
STAT,1867,36,15-19,1903,0.10672332420496602
STAT,1942,16,20-24,1958,286.22850267870143
STAT,1823,48,45-49,1871,0.7189046189672471
STAT,1835,46,20-24,1881,0.016600907122791022
STAT,1843,15,20-24,1858,32.113894326796974
SIM,1833,25,20-24,1858,25
STAT,1873,22,30-34,1895,36.55180464132467
STAT,1876,28,30-34,1904,52.41629923213716
STAT,1894,18,30-34,1912,4.124295768660754
STAT,1919,38,50-100,1957,0.9098464382677055
STAT,1855,36,50-100,1891,1.8602661965738332
SIM,1865,34,40-44,1899,12
SIM,1884,28,30-34,1912,60
STAT,1863,93,na,1956,59.00723347637027
STAT,1838,21,25-29,1859,101.24480037962998
SIM,1883,19,25-29,1902,16
STAT,1889,24,35-39,1913,14.440733187909565
SIM,1850,64,na,1914,2752
SIM,1846,21,25-29,1867,115
SIM,1870,19,na,1889,4899
SIM,1904,25,40-44,1929,13
STAT,1827,67,na,1894,1916.8999164876332
STAT,1843,29,30-34,1872,42.79133045320609
SIM,1882,37,45-49,1919,4
STAT,1863,32,15-19,1895,0.25176262198778243
SIM,1858,27,25-29,1885,75
SIM,1920,2,na,1922,9454
STAT,1870,51,25-29,1921,0.0070568030166504375
SIM,1794,75,na,1869,808
SIM,1852,76,na,1928,1443
STAT,1841,48,50-100,1889,0.3534069652132145
STAT,1887,48,35-39,1935,0.3122575215959063
STAT,1857,34,40-44,1891,6.768397085430673
STAT,1909,36,30-34,1945,3.5027595997464704
SIM,1838,61,na,1899,2569
SIM,1879,27,45-49,1906,4
SIM,1937,20,25-29,1957,200
STAT,1836,72,na,1908,1679.1238107343577
STAT,1885,29,na,1914,4763.329075574385
STAT,1828,26,35-39,1854,47.69385885892791
SIM,1937,11,na,1948,7981
STAT,1858,33,45-49,1891,2.733919579420032
STAT,1893,48,na,1941,5688.009340743507
STAT,1905,66,na,1971,5514.3908870898
SIM,1839,44,40-44,1883,9
STAT,1851,93,na,1944,45.30469742034262
STAT,1870,31,50-100,1901,1.8241810676430839
STAT,1870,15,30-34,1885,3.228391906751315
SIM,1851,29,30-34,1880,55
SIM,1871,37,35-39,1908,20
SIM,1896,27,45-49,1923,8
STAT,1894,38,25-29,1932,7.432729874852512
STAT,1855,26,45-49,1881,1.7577619850730433
STAT,1888,30,50-100,1918,2.204718332500954
SIM,1859,37,35-39,1896,22
STAT,1873,93,na,1966,194.05911708226722
STAT,1817,37,15-19,1854,0.42045477419802946
SIM,1895,21,20-24,1916,200
STAT,1898,35,40-44,1933,12.077723732111355
STAT,1842,56,na,1898,3036.636497457252
SIM,1911,8,na,1919,8181
SIM,1874,7,na,1881,5299
SIM,1948,20,35-39,1968,33
STAT,1879,7,na,1886,5639.065387097411
SIM,1828,30,20-24,1858,4
SIM,1879,22,na,1901,4896
SIM,1953,15,50-100,1968,1
STAT,1877,38,25-29,1915,6.008182845978256
STAT,1856,22,30-34,1878,32.235700530395704
SIM,1876,28,30-34,1904,68
STAT,1846,38,50-100,1884,1.943530797324176
STAT,1851,48,20-24,1899,0.01836845498428329
SIM,1837,87,na,1924,173
SIM,1866,33,45-49,1899,5
SIM,1885,38,25-29,1923,10
STAT,1873,19,15-19,1892,12.11272296217903
STAT,1861,38,na,1899,3940.77372760045
SIM,1864,22,30-34,1886,54
STAT,1881,15,40-44,1896,0.35870050293055117
STAT,1830,24,na,1854,3392.770501143731
STAT,1888,27,45-49,1915,2.65036586406891
STAT,1831,47,40-44,1878,0.2619871062592617
STAT,1865,20,30-34,1885,33.55964317423175
STAT,1883,38,15-19,1921,0.1108733287776709
SIM,1950,16,20-24,1966,315
STAT,1919,25,35-39,1944,32.97766665694788
STAT,1891,49,50-100,1940,0.3386249136852542
STAT,1902,48,na,1950,6335.646975179898
SIM,1839,27,15-19,1866,3
SIM,1915,15,15-19,1930,25
SIM,1928,37,45-49,1965,2
SIM,1887,51,na,1938,5245
STAT,1929,20,25-29,1949,237.29324515046895
STAT,1936,25,35-39,1961,29.049480231527482
SIM,1836,26,35-39,1862,21
STAT,1863,28,45-49,1891,1.9559962053258286
SIM,1849,33,45-49,1882,4
SIM,1853,35,25-29,1888,8
SIM,1805,77,na,1882,637
SIM,1924,30,40-44,1954,12
STAT,1898,18,15-19,1916,16.17715243827665
SIM,1857,32,40-44,1889,10
SIM,1929,2,na,1931,10819
STAT,1886,16,30-34,1902,3.406383756853786
STAT,1916,29,na,1945,7766.811431112698
SIM,1960,5,na,1965,10826
STAT,1835,27,30-34,1862,42.52546427712952
SIM,1887,41,na,1928,5683
STAT,1924,48,na,1972,8806.263547633169
STAT,1925,36,15-19,1961,0.04658156607462936
STAT,1878,43,15-19,1921,0.028918660991462904
SIM,1886,17,35-39,1903,2
STAT,1927,27,35-39,1954,36.85680696595793
SIM,1829,36,45-49,1865,7
SIM,1859,34,na,1893,4225
STAT,1852,25,15-19,1877,0.8544688152057978
STAT,1861,37,25-29,1898,4.839954624227642
SIM,1889,22,35-39,1911,17
SIM,1900,56,na,1956,5904
STAT,1833,42,na,1875,3348.6359595779318
SIM,1843,27,30-34,1870,61
SIM,1855,41,na,1896,4107
STAT,1826,44,50-100,1870,2.142821313971426
SIM,1918,51,na,1969,8036
STAT,1866,28,20-24,1894,21.784369733041203
SIM,1860,25,15-19,1885,1
SIM,1871,28,45-49,1899,1
SIM,1894,16,30-34,1910,9
STAT,1853,19,na,1872,4317.567895496025
SIM,1869,22,na,1891,4612
STAT,1852,39,25-29,1891,4.542708747302951
SIM,1902,16,40-44,1918,1
SIM,1886,23,20-24,1909,142
SIM,1830,38,35-39,1868,20
STAT,1887,29,45-49,1916,2.4900198086645893
STAT,1887,21,20-24,1908,156.12898459618046
SIM,1824,41,50-100,1865,3
SIM,1860,39,25-29,1899,7
STAT,1846,27,40-44,1873,5.5507481548891
SIM,1913,19,20-24,1932,73
SIM,1944,25,35-39,1969,42
SIM,1935,27,35-39,1962,62
STAT,1878,23,20-24,1901,144.9080166564191
STAT,1822,38,35-39,1860,27.038629892263728
SIM,1818,95,na,1913,11
SIM,1854,27,40-44,1881,7
STAT,1826,35,15-19,1861,0.14242442103150102
SIM,1845,38,45-49,1883,7
SIM,1852,54,na,1906,3394
STAT,1857,17,15-19,1874,10.980247992102282
STAT,1861,17,30-34,1878,3.07955459612507
STAT,1898,22,35-39,1920,15.94887898529461
SIM,1874,23,na,1897,4546
STAT,1836,39,40-44,1875,6.998803814862956
STAT,1907,48,15-19,1955,6.613453016076763E-4
SIM,1887,22,25-29,1909,155
SIM,1876,29,35-39,1905,20
STAT,1847,32,30-34,1879,31.24890525964067
STAT,1836,25,30-34,1861,43.96273693971136
STAT,1893,26,15-19,1919,1.1654088712871515
SIM,1891,18,20-24,1909,49
STAT,1843,49,25-29,1892,0.07900241482105982
STAT,1926,15,25-29,1941,107.78476750723719
STAT,1842,23,40-44,1865,3.8849505558735604
STAT,1849,32,40-44,1881,7.2285285340466086
STAT,1874,88,na,1962,529.9228645561624
STAT,1881,16,45-49,1897,0.12782801742761654
SIM,1873,20,30-34,1893,44
SIM,1937,33,na,1970,7649
STAT,1905,19,20-24,1924,51.503459996669555
STAT,1831,106,na,1937,0.015676719825786993
STAT,1862,16,35-39,1878,1.0912360195363704
SIM,1889,8,na,1897,6633
SIM,1825,39,30-34,1864,13
SIM,1870,16,35-39,1886,2
STAT,1826,49,25-29,1875,0.11177933930554095
STAT,1879,22,25-29,1901,120.93004440675662
STAT,1817,39,30-34,1856,33.24375994359749
SIM,1909,37,35-39,1946,7
STAT,1874,56,na,1930,4217.789390983195
SIM,1855,32,30-34,1887,46
SIM,1943,26,30-34,1969,97
STAT,1873,71,na,1944,2739.085771738938
SIM,1844,37,25-29,1881,7
STAT,1884,16,20-24,1900,35.442320364225345
SIM,1837,20,20-24,1857,124
STAT,1876,17,25-29,1893,11.83700086854376
STAT,1935,26,30-34,1961,107.93854551936954
STAT,1860,38,20-24,1898,1.257985317837265
SIM,1855,26,45-49,1881,3
SIM,1801,62,na,1863,1899
SIM,1898,14,na,1912,7299
STAT,1837,38,45-49,1875,3.3486517130823277
STAT,1929,28,20-24,1957,46.112097571621696
STAT,1807,49,15-19,1856,0.0026471218893977465
SIM,1839,31,35-39,1870,29
STAT,1927,20,15-19,1947,13.32256922666208
SIM,1850,23,40-44,1873,7
SIM,1856,47,45-49,1903,2
SIM,1805,55,na,1860,2237
STAT,1834,31,50-100,1865,1.5785863111543534
SIM,1903,33,25-29,1936,25
STAT,1876,21,45-49,1897,1.4610045776380194
STAT,1899,34,45-49,1933,4.784084681244495
STAT,1859,36,30-34,1895,8.608473233121188
SIM,1865,17,15-19,1882,13
STAT,1863,37,35-39,1900,12.5042226014112
STAT,1827,47,25-29,1874,0.10402484236805104
SIM,1844,25,30-34,1869,47
SIM,1838,26,45-49,1864,3
SIM,1844,39,40-44,1883,11
SIM,1861,48,30-34,1909,1
SIM,1855,49,45-49,1904,1
SIM,1838,32,30-34,1870,11
STAT,1846,28,45-49,1874,2.0426079284173433
STAT,1901,39,30-34,1940,3.219708449171688
STAT,1799,97,na,1896,3.653456594440413
STAT,1901,53,na,1954,5990.217586318053
STAT,1920,39,40-44,1959,3.3024038844028825
STAT,1946,20,25-29,1966,207.72262418723395
SIM,1953,15,35-39,1968,12
STAT,1861,36,20-24,1897,1.3020402230703507
STAT,1897,17,45-49,1914,0.17634737298250586
SIM,1907,30,40-44,1937,9
STAT,1916,26,20-24,1942,38.24871221707826
SIM,1899,39,30-34,1938,5
SIM,1939,30,35-39,1969,28
STAT,1827,102,na,1929,0.35451727879279193
STAT,1883,18,20-24,1901,35.08608580304007
STAT,1837,37,40-44,1874,7.430065872404154
STAT,1897,23,30-34,1920,47.93819814995275
SIM,1860,27,30-34,1887,56
SIM,1887,73,na,1960,3160
STAT,1852,27,30-34,1879,46.74708468582873
STAT,1866,37,na,1903,4390.315677970207
STAT,1870,53,na,1923,4200.810427242629
SIM,1854,20,20-24,1874,155
SIM,1913,23,40-44,1936,9
STAT,1905,23,40-44,1928,6.067541740972367
STAT,1945,15,35-39,1960,9.2616511069598
SIM,1854,28,45-49,1882,2
STAT,1842,37,15-19,1879,0.09807347172857622
SIM,1899,25,20-24,1924,4
STAT,1853,48,30-34,1901,0.15123267685531838
STAT,1900,27,20-24,1927,32.86712158028482
SIM,1924,26,20-24,1950,48
STAT,1812,43,50-100,1855,8.201335157936777
STAT,1887,33,15-19,1920,0.3203119654937139
SIM,1877,27,35-39,1904,32
SIM,1919,32,25-29,1951,26
STAT,1866,32,40-44,1898,8.081383253250355
STAT,1822,36,35-39,1858,29.559090125194384
STAT,1849,44,50-100,1893,1.648537119721536
SIM,1870,1,na,1871,6705
SIM,1909,26,na,1935,7333
STAT,1867,47,20-24,1914,0.02259128102212679
SIM,1887,27,45-49,1914,3
SIM,1862,22,20-24,1884,135
STAT,1838,38,50-100,1876,1.9843041402585093
SIM,1846,38,50-100,1884,3
STAT,1889,21,30-34,1910,44.49064949714832
SIM,1880,19,na,1899,5599
STAT,1851,18,25-29,1869,10.617393208252063
SIM,1910,6,na,1916,8368
STAT,1846,25,50-100,1871,1.2025498367129874
STAT,1921,23,25-29,1944,210.00442314651852
STAT,1824,104,na,1928,0.07131141313703254
STAT,1825,37,15-19,1862,0.14770311407262968
SIM,1869,36,40-44,1905,14
SIM,1847,75,na,1922,1595
SIM,1842,15,20-24,1857,36
SIM,1935,20,15-19,1955,15
STAT,1796,79,na,1875,578.2866627806541
STAT,1941,17,50-100,1958,0.7794077512145333
SIM,1860,42,na,1902,3973
STAT,1871,25,25-29,1896,85.45427943571836
STAT,1896,38,35-39,1934,18.765895212574904
SIM,1863,28,45-49,1891,4
SIM,1888,30,50-100,1918,3
STAT,1883,24,40-44,1907,4.108961536585336
SIM,1876,15,25-29,1891,17
STAT,1862,18,35-39,1880,1.0784191164953454
STAT,1833,36,45-49,1869,3.317096114520259
SIM,1924,17,30-34,1941,39
SIM,1897,48,45-49,1945,1
SIM,1908,49,35-39,1957,1
STAT,1916,17,30-34,1933,5.2227701674575195
SIM,1770,84,na,1854,137
STAT,1839,33,35-39,1872,19.25832213276456
SIM,1913,26,45-49,1939,3
SIM,1837,47,35-39,1884,1
SIM,1892,16,20-24,1908,52
STAT,1919,1,na,1920,9318.416880305114
SIM,1852,28,35-39,1880,1
SIM,1919,23,35-39,1942,23
STAT,1878,47,30-34,1925,0.2032284070323789
STAT,1956,0,na,1956,10583.754799781587
SIM,1848,38,20-24,1886,2
SIM,1881,25,35-39,1906,26
STAT,1855,28,45-49,1883,1.7326111398163533
STAT,1909,59,na,1968,6414.615159311704
STAT,1886,17,35-39,1903,1.169816379717226
SIM,1941,29,25-29,1970,139
STAT,1892,28,15-19,1920,1.1430564988831269
STAT,1901,31,na,1932,6774.5543194992115
SIM,1849,34,na,1883,4034
SIM,1858,24,20-24,1882,126
STAT,1844,36,20-24,1880,1.4606591077892332
STAT,1900,67,na,1967,5025.201956004
STAT,1818,75,na,1893,1056.1693399049623
STAT,1905,26,45-49,1931,3.2540808449238403
STAT,1846,23,25-29,1869,107.41268106631364
SIM,1886,48,35-39,1934,1
STAT,1930,33,na,1963,9851.303837642248
SIM,1934,21,45-49,1955,2
STAT,1894,16,30-34,1910,4.145285758868934
STAT,1829,47,35-39,1876,0.22089944540683448
STAT,1898,47,na,1945,6121.483144463379
STAT,1850,39,15-19,1889,0.08566587101895826
SIM,1841,27,20-24,1868,22
SIM,1886,47,30-34,1933,1
SIM,1843,72,na,1915,1816
SIM,1917,27,40-44,1944,17
STAT,1847,29,15-19,1876,0.8193710956513627
SIM,1908,31,45-49,1939,5
SIM,1951,15,25-29,1966,122
SIM,1860,21,50-100,1881,3
SIM,1913,30,na,1943,7809
SIM,1920,16,35-39,1936,13
STAT,1833,27,20-24,1860,20.396213289972483
STAT,1885,38,25-29,1923,5.759330414972694
STAT,1875,38,15-19,1913,0.11618592168517917
SIM,1809,58,na,1867,2173
STAT,1876,26,15-19,1902,0.9509732946613443
SIM,1893,38,25-29,1931,2
STAT,1780,100,na,1880,0.40162118064339725
STAT,1868,15,25-29,1883,11.21767357089162
STAT,1915,6,na,1921,8445.082014051877
STAT,1942,23,45-49,1965,2.3818735377941596
SIM,1884,26,15-19,1910,2
STAT,1905,34,na,1939,6968.997855327341
STAT,1824,49,15-19,1873,9.419014189574613E-4
STAT,1920,15,30-34,1935,5.565540610624951
STAT,1808,47,15-19,1855,0.002541698396923356
STAT,1926,29,na,1955,9003.276397375823
SIM,1779,76,na,1855,744
STAT,1854,22,20-24,1876,124.12560955217786
SIM,1876,26,30-34,1902,64
SIM,1923,21,35-39,1944,33
STAT,1865,52,na,1917,3929.624906846109
STAT,1818,47,25-29,1865,0.25392763764669934
SIM,1909,28,45-49,1937,5
STAT,1911,28,35-39,1939,29.47465647721965
STAT,1912,16,35-39,1928,1.7183345759979998
SIM,1852,36,20-24,1888,2
STAT,1879,26,40-44,1905,6.349776417097717
SIM,1855,29,15-19,1884,1
STAT,1878,48,35-39,1926,0.2915916146701159
SIM,1904,21,25-29,1925,192
STAT,1895,23,20-24,1918,180.7918458147879
STAT,1896,29,45-49,1925,2.939384115486734
SIM,1918,48,40-44,1966,1
SIM,1921,25,40-44,1946,16
STAT,1909,27,40-44,1936,9.001306366233303
STAT,1933,29,25-29,1962,176.350205086636
STAT,1923,27,50-100,1950,2.3072218252672014
SIM,1911,39,40-44,1950,5
SIM,1946,25,45-49,1971,5
SIM,1883,37,na,1920,4850
SIM,1837,38,45-49,1875,5
STAT,1926,21,45-49,1947,2.76858396770873
STAT,1845,49,35-39,1894,0.21122669690032012
STAT,1835,49,25-29,1884,0.07667977998453107
SIM,1954,4,na,1958,9929
STAT,1840,26,35-39,1866,17.49133744031132
STAT,1863,39,35-39,1902,12.378373162806197
STAT,1924,15,15-19,1939,109.62546694161655
SIM,1895,26,40-44,1921,11
STAT,1838,25,40-44,1863,5.232011558787859
STAT,1914,29,15-19,1943,1.4272770685895122
STAT,1885,37,20-24,1922,1.5496345740212099
SIM,1931,27,50-100,1958,3
SIM,1946,25,na,1971,8263
STAT,1916,33,45-49,1949,3.26720949909443
SIM,1862,27,40-44,1889,7
SIM,1852,27,30-34,1879,59
STAT,1943,19,40-44,1962,2.9934696437305046
STAT,1894,66,na,1960,4508.061596564334
STAT,1863,27,40-44,1890,5.295859425659547
STAT,1847,111,na,1958,2.0442235008642096E-4
SIM,1856,20,30-34,1876,40
STAT,1943,15,25-29,1958,92.85547701551913
STAT,1901,39,50-100,1940,0.7417048610775577
STAT,1886,15,na,1901,5409.464145972538
SIM,1893,37,20-24,1930,2
STAT,1822,35,30-34,1857,23.175897276997535
SIM,1794,65,na,1859,1565
STAT,1887,26,40-44,1913,6.789578149356593
SIM,1836,32,20-24,1868,6
STAT,1860,75,na,1935,1688.4030804144127
SIM,1824,80,na,1904,686
SIM,1859,39,35-39,1898,21
STAT,1855,48,40-44,1903,0.2549145966031275
SIM,1871,39,35-39,1910,19
STAT,1828,32,20-24,1860,6.059269816865416
STAT,1854,27,40-44,1881,4.814082174389506
STAT,1844,27,30-34,1871,49.78278727304341
SIM,1819,68,na,1887,1630
SIM,1908,22,20-24,1930,196
SIM,1927,22,30-34,1949,93
SIM,1881,26,50-100,1907,2
STAT,1915,44,na,1959,7527.01109135468
STAT,1931,3,na,1934,10722.52844275927
SIM,1853,49,35-39,1902,1
SIM,1913,52,na,1965,7216
STAT,1818,46,20-24,1864,0.05372468810853529
SIM,1869,25,35-39,1894,26
STAT,1889,11,na,1900,6440.645627512059
SIM,1870,18,35-39,1888,2
STAT,1938,25,45-49,1963,3.4602632284059034
STAT,1866,38,15-19,1904,0.10412385839629508
SIM,1830,36,35-39,1866,16
SIM,1833,28,25-29,1861,86
SIM,1895,70,na,1965,4307
SIM,1830,35,30-34,1865,13
SIM,1852,37,25-29,1889,7
SIM,1855,49,50-100,1904,1
SIM,1847,33,35-39,1880,3
STAT,1895,17,35-39,1912,1.4439997438470222
SIM,1831,25,50-100,1856,1
SIM,1863,48,40-44,1911,1
SIM,1905,30,30-34,1935,34
SIM,1917,36,30-34,1953,6
SIM,1933,29,na,1962,10454
STAT,1938,20,25-29,1958,184.78756994001944
SIM,1884,17,25-29,1901,15
STAT,1776,80,na,1856,467.4344354685
STAT,1844,28,35-39,1872,18.938270742137593
SIM,1842,76,na,1918,1217
STAT,1898,69,na,1967,4617.148308385437
STAT,1948,20,35-39,1968,21.848239381821834
SIM,1818,49,40-44,1867,1
SIM,1891,24,40-44,1915,2
SIM,1828,35,40-44,1863,11
SIM,1928,34,40-44,1962,11
STAT,1902,23,15-19,1925,9.377592936474349
STAT,1866,26,20-24,1892,21.936343881093826
STAT,1915,38,20-24,1953,0.535199206601615
SIM,1891,20,25-29,1911,158
STAT,1883,20,25-29,1903,114.2686911788089
STAT,1931,16,45-49,1947,1.3238191609991168
SIM,1851,15,20-24,1866,32
STAT,1834,48,20-24,1882,0.0167247942148955
STAT,1919,22,30-34,1941,63.54835562134917
STAT,1874,37,45-49,1911,4.122360685230302
SIM,1824,33,40-44,1857,10
SIM,1861,15,30-34,1876,4
STAT,1889,39,20-24,1928,1.9002733721307696
STAT,1901,15,20-24,1916,50.35798857867744
STAT,1943,24,15-19,1967,11.429979898987504
STAT,1851,6,na,1857,4701.97091030841
STAT,1931,22,30-34,1953,75.28763081009673
STAT,1829,38,45-49,1867,3.4210842206957133
SIM,1932,15,15-19,1947,119
SIM,1846,25,40-44,1871,7
SIM,1922,29,15-19,1951,2
SIM,1923,38,20-24,1961,1
STAT,1869,37,50-100,1906,2.4026183530607677
SIM,1946,20,25-29,1966,210
STAT,1890,41,na,1931,5723.346549981455
STAT,1859,47,20-24,1906,0.019199940581496072
STAT,1895,40,na,1935,6143.702059101436
STAT,1896,26,50-100,1922,1.7115473854293948
SIM,1858,40,35-39,1898,5
SIM,1927,20,15-19,1947,15
STAT,1838,26,45-49,1864,1.925316730887562
STAT,1865,74,na,1939,2036.2525467905377
SIM,1836,37,40-44,1873,13
STAT,1861,52,50-100,1913,0.025252696140701546
SIM,1849,30,40-44,1879,11
SIM,1831,39,na,1870,3566
STAT,1859,38,30-34,1897,8.524745142648717
SIM,1814,69,na,1883,1552
STAT,1843,20,na,1863,3814.0711525318484
STAT,1921,27,40-44,1948,10.488866116853616
STAT,1935,17,40-44,1952,3.8624900553909955
SIM,1840,24,35-39,1864,13
SIM,1882,74,na,1956,2154
STAT,1870,18,35-39,1888,1.0918903538247535
SIM,1899,28,25-29,1927,132
STAT,1895,28,40-44,1923,7.855468547742358
SIM,1877,37,50-100,1914,2
SIM,1885,35,20-24,1920,4
STAT,1827,35,na,1862,3469.8441478567916
SIM,1905,17,20-24,1922,58
STAT,1849,89,na,1938,166.17347705681354
STAT,1941,28,20-24,1969,38.12001975103595
SIM,1840,18,15-19,1858,11
SIM,1938,23,45-49,1961,1
STAT,1841,61,na,1902,2711.2591772980477
SIM,1896,55,na,1951,5699
STAT,1905,32,30-34,1937,29.281907763509956
STAT,1878,70,na,1948,2959.5053760073524
STAT,1834,37,15-19,1871,0.09297838677445976
SIM,1951,19,40-44,1970,4
STAT,1923,20,30-34,1943,67.92062008320694
STAT,1855,34,30-34,1889,26.256464497850565
SIM,1902,19,45-49,1921,4
SIM,1895,24,25-29,1919,183
STAT,1881,27,35-39,1908,18.835492544886687
SIM,1943,17,40-44,1960,5
SIM,1935,24,30-34,1959,95
STAT,1887,24,25-29,1911,128.49649030911434
STAT,1786,79,na,1865,495.9478023751945
STAT,1785,94,na,1879,9.007302242542409
SIM,1924,33,45-49,1957,7
STAT,1906,27,15-19,1933,1.3352212606027705
SIM,1938,7,na,1945,8021
STAT,1892,19,25-29,1911,14.250332636835127
STAT,1919,20,15-19,1939,11.840055949692998
STAT,1826,46,20-24,1872,0.024256429583884805
SIM,1846,26,45-49,1872,5
STAT,1869,36,25-29,1905,5.66153353166256
STAT,1939,26,15-19,1965,1.4341232326447346
STAT,1913,25,40-44,1938,9.445726790667425
SIM,1863,49,na,1912,4094
STAT,1828,37,40-44,1865,8.815684038849728
STAT,1939,32,35-39,1971,18.833160923068956
STAT,1927,24,30-34,1951,71.05771595331744
STAT,1869,27,35-39,1896,18.882369541524646
STAT,1875,52,na,1927,4453.358236897955
STAT,1860,29,30-34,1889,41.14564579882684
SIM,1893,37,na,1930,6206
STAT,1826,94,na,1920,23.925434556971062
SIM,1883,15,na,1898,5258
STAT,1869,99,na,1968,21.078261779422096
STAT,1847,23,na,1870,3966.8198022222646
STAT,1945,10,na,1955,8667.877348235952
SIM,1897,15,45-49,1912,1
SIM,1916,31,45-49,1947,4
STAT,1879,31,15-19,1910,0.30206234556820827
SIM,1885,24,50-100,1909,1
SIM,1866,89,na,1955,138
STAT,1811,95,na,1906,12.359058919200582
STAT,1926,39,35-39,1965,5.956330047383043
SIM,1833,27,20-24,1860,19
STAT,1837,46,30-34,1883,0.1418901550494556
SIM,1828,33,25-29,1861,5
STAT,1772,110,na,1882,0.003189557685776853
STAT,1915,21,35-39,1936,19.718164816849132
SIM,1895,9,na,1904,7268
STAT,1848,38,20-24,1886,1.289087079360716
SIM,1931,20,30-34,1951,92
STAT,1832,24,35-39,1856,10.66180694619065
SIM,1879,20,25-29,1899,128
STAT,1842,39,15-19,1881,0.08741254302340623
STAT,1910,25,15-19,1935,1.3984018134957272
STAT,1825,76,na,1901,1096.1798643417594
SIM,1856,38,20-24,1894,2
STAT,1877,24,50-100,1901,0.8498472945845533
STAT,1908,31,45-49,1939,3.0140625257886153
STAT,1918,46,25-29,1964,0.11426834643668507
STAT,1877,29,35-39,1906,20.09070375261136
STAT,1881,18,45-49,1899,0.12718074990730238
STAT,1877,35,20-24,1912,1.6319450386409309
SIM,1923,30,na,1953,9179
STAT,1907,15,na,1922,7531.745978449938
STAT,1813,76,na,1889,844.4645150476754
STAT,1946,22,25-29,1968,207.57932025399248
SIM,1799,64,na,1863,1579
STAT,1843,42,na,1885,3333.50158627421
STAT,1869,38,40-44,1907,8.524018437438395
STAT,1860,27,15-19,1887,0.7520826475679441
SIM,1854,23,25-29,1877,125
SIM,1877,36,25-29,1913,6
STAT,1851,17,20-24,1868,33.413642255063536
SIM,1896,33,na,1929,6740
STAT,1893,37,20-24,1930,1.9732791465773616
SIM,1887,26,40-44,1913,6
STAT,1934,21,45-49,1955,3.0553187352249083
SIM,1873,23,35-39,1896,19
SIM,1896,36,35-39,1932,29
STAT,1871,39,35-39,1910,14.049087755357483
SIM,1851,42,50-100,1893,5
STAT,1903,33,50-100,1936,1.5064727769123403
SIM,1848,39,25-29,1887,7
STAT,1846,25,40-44,1871,5.631323654315513
STAT,1788,104,na,1892,0.041491058566810554
STAT,1935,22,15-19,1957,14.642635606166307
SIM,1915,31,50-100,1946,1
STAT,1927,18,45-49,1945,1.2509469957055561
STAT,1830,106,na,1936,0.016766254700937507
STAT,1875,49,20-24,1924,0.024431236533365243
STAT,1889,48,45-49,1937,0.32734347568319
SIM,1811,62,na,1873,1937
SIM,1935,18,45-49,1953,2
STAT,1816,49,15-19,1865,0.0019060538144163286
STAT,1830,38,35-39,1868,13.070445859765215
SIM,1864,23,na,1887,4541
STAT,1828,102,na,1930,0.36003520406956047
STAT,1859,48,25-29,1907,0.09142796239087858
STAT,1892,18,20-24,1910,44.705537053144546
STAT,1948,21,50-100,1969,1.5262317660317455
SIM,1841,36,45-49,1877,4
SIM,1878,48,na,1926,4861
STAT,1858,26,20-24,1884,19.044613296698675
STAT,1852,36,20-24,1888,1.2481465736772568
STAT,1911,20,50-100,1931,1.2682140557105266
SIM,1863,34,30-34,1897,43
STAT,1843,42,50-100,1885,1.5237207761569729
SIM,1883,22,40-44,1905,4
STAT,1907,31,50-100,1938,1.5680618817770327
STAT,1926,33,50-100,1959,2.0174943137182235
STAT,1917,34,15-19,1951,0.2694196370772118
STAT,1821,54,50-100,1875,0.04086050202431472
SIM,1913,32,30-34,1945,40
SIM,1902,25,30-34,1927,83
STAT,1884,26,15-19,1910,0.9079106322595208
SIM,1834,57,na,1891,2592
STAT,1876,37,na,1913,4921.305838910606
SIM,1822,36,35-39,1858,20
STAT,1860,53,na,1913,3474.673383039961
STAT,1879,27,45-49,1906,2.34548993455457
SIM,1854,25,40-44,1879,10
SIM,1877,38,40-44,1915,17
SIM,1844,34,20-24,1878,7
SIM,1835,25,30-34,1860,52
SIM,1892,26,15-19,1918,1
STAT,1837,47,35-39,1884,0.2026006723293617
SIM,1843,94,na,1937,16
SIM,1903,37,40-44,1940,1
STAT,1936,34,25-29,1970,18.111362764715313
SIM,1780,84,na,1864,199
STAT,1843,19,50-100,1862,0.08667265028948805
SIM,1814,80,na,1894,533
STAT,1904,20,20-24,1924,200.9512611370736
SIM,1889,39,20-24,1928,2
STAT,1929,25,na,1954,9503.780246177663
SIM,1915,39,25-29,1954,2
STAT,1836,28,35-39,1864,16.484920952098708
STAT,1951,17,25-29,1968,104.21190969334725
STAT,1844,54,50-100,1898,0.02371894292908364
STAT,1894,49,30-34,1943,0.13870472210862195
STAT,1870,17,30-34,1887,3.1904734497846534
SIM,1924,15,na,1939,9225
SIM,1925,29,40-44,1954,16
SIM,1808,95,na,1903,4
STAT,1917,29,40-44,1946,9.800752840048279
STAT,1946,24,40-44,1970,7.550998618020429
STAT,1859,39,35-39,1898,11.255214349649782
SIM,1866,26,20-24,1892,19
STAT,1845,86,na,1931,341.8969281254068
SIM,1933,21,50-100,1954,2
SIM,1942,21,45-49,1963,4
SIM,1893,15,na,1908,6730
STAT,1856,60,na,1916,2971.8363689158723
SIM,1844,28,35-39,1872,22
STAT,1907,39,25-29,1946,1.8261211121163456
STAT,1865,23,35-39,1888,10.759346318940887
SIM,1876,24,15-19,1900,6
SIM,1912,20,20-24,1932,210
STAT,1884,88,na,1972,784.1568093509446
STAT,1906,30,na,1936,7139.448160709272
STAT,1888,36,35-39,1924,16.964785512322482
STAT,1828,34,35-39,1862,21.379796814075803
SIM,1892,19,25-29,1911,19
STAT,1826,30,na,1856,3547.5676439258687
SIM,1819,49,50-100,1868,1
SIM,1873,17,na,1890,5340
SIM,1853,33,25-29,1886,23
SIM,1894,27,35-39,1921,36
STAT,1917,31,45-49,1948,3.3412079368722236
SIM,1859,29,35-39,1888,23
SIM,1850,32,45-49,1882,2
SIM,1871,29,35-39,1900,25
SIM,1897,28,15-19,1925,2
STAT,1919,27,na,1946,8173.066622019609
SIM,1939,8,na,1947,8293
SIM,1809,45,30-34,1854,1
STAT,1908,63,na,1971,6032.494461245412
SIM,1854,34,na,1888,3982
SIM,1851,25,15-19,1876,1
STAT,1864,50,25-29,1914,0.006486320126534938
SIM,1869,40,25-29,1909,3
STAT,1915,26,50-100,1941,2.0575925777599173
SIM,1876,36,30-34,1912,12
SIM,1887,24,40-44,1911,4
STAT,1908,20,40-44,1928,6.284302501058214
SIM,1853,31,30-34,1884,39
STAT,1827,42,20-24,1869,0.3016730045247898
STAT,1854,39,35-39,1893,10.733571702799107
STAT,1868,36,30-34,1904,10.290214489503546
STAT,1892,38,15-19,1930,0.14127115049824587
SIM,1832,41,40-44,1873,8
STAT,1834,45,15-19,1879,6.366337849302746E-4
STAT,1854,31,25-29,1885,16.247408620233788
STAT,1807,105,na,1912,0.023403977553202414
STAT,1836,48,30-34,1884,0.13300699711898764
STAT,1894,33,20-24,1927,6.983212947387288
SIM,1916,4,na,1920,8734
STAT,1845,33,25-29,1878,18.57243134142822
SIM,1936,31,20-24,1967,6
SIM,1827,36,35-39,1863,19
SIM,1852,3,na,1855,5325
STAT,1893,60,na,1953,4882.147382588382
SIM,1846,15,na,1861,4530
SIM,1823,43,40-44,1866,9
STAT,1871,41,50-100,1912,2.1293781101196827
SIM,1890,72,na,1962,3666
SIM,1821,35,30-34,1856,13
STAT,1897,36,50-100,1933,3.330418542476066
STAT,1823,97,na,1920,6.446698493499995
SIM,1882,53,na,1935,4323
STAT,1900,44,25-29,1944,0.12324565923343
STAT,1886,27,35-39,1913,20.57096128186149
SIM,1815,44,45-49,1859,7
STAT,1882,34,40-44,1916,8.458993691995936
STAT,1875,28,15-19,1903,0.940086297822138
STAT,1895,25,35-39,1920,25.564685338255703
SIM,1862,49,35-39,1911,2
STAT,1816,42,45-49,1858,8.243627165291722
STAT,1861,27,30-34,1888,42.63852852967809
SIM,1844,33,30-34,1877,43
SIM,1882,35,45-49,1917,2
STAT,1884,19,25-29,1903,11.240384322249465
STAT,1845,31,30-34,1876,32.323230854845676
STAT,1874,35,45-49,1909,4.161511244178595
SIM,1928,32,25-29,1960,23
STAT,1832,36,50-100,1868,2.044128700947584
SIM,1885,29,35-39,1914,27
SIM,1916,20,40-44,1936,11
SIM,1945,0,na,1945,9532
STAT,1885,40,15-19,1925,0.0280419747711022
SIM,1818,43,30-34,1861,3
STAT,1813,53,30-34,1866,0.0343061512329665
STAT,1824,41,40-44,1865,5.990464017107807
STAT,1848,47,50-100,1895,0.4008346337796385
STAT,1887,52,na,1939,4837.800763901828
SIM,1880,27,35-39,1907,26
STAT,1859,45,20-24,1904,0.019482182687077076
STAT,1871,46,30-34,1917,0.19478211083644706
SIM,1890,34,40-44,1924,18
STAT,1940,12,na,1952,8092.319283926643
STAT,1880,44,30-34,1924,2.4129866584237565
STAT,1854,49,35-39,1903,0.21013715475990027
STAT,1815,43,40-44,1858,13.095173666597743
STAT,1926,32,50-100,1958,2.018745936198667
STAT,1891,32,40-44,1923,10.826101421001031
SIM,1848,93,na,1941,22
STAT,1913,10,na,1923,8181.740426395952
SIM,1821,48,35-39,1869,1
STAT,1819,41,30-34,1860,5.492589010175902
STAT,1876,42,15-19,1918,0.02881128183940472
STAT,1883,33,45-49,1916,3.4456178168101
SIM,1841,16,15-19,1857,12
STAT,1843,43,15-19,1886,0.019664364975199276
SIM,1819,37,na,1856,3188
STAT,1927,22,15-19,1949,13.243550661190488
SIM,1818,38,35-39,1856,17
SIM,1835,35,30-34,1870,13
SIM,1855,51,na,1906,3834
SIM,1867,28,30-34,1895,7
STAT,1863,47,35-39,1910,0.24635220797096294
SIM,1823,42,na,1865,3119
STAT,1854,89,na,1943,161.04571260280738
STAT,1928,31,20-24,1959,6.16230775244473
STAT,1828,49,35-39,1877,0.24562080736173575
STAT,1811,46,50-100,1857,1.6962218121668522
STAT,1833,34,45-49,1867,2.896754193616039
STAT,1890,40,25-29,1930,1.598990437260858
SIM,1871,47,35-39,1918,1
SIM,1778,81,na,1859,367
SIM,1852,23,na,1875,4078
SIM,1827,56,na,1883,2644
SIM,1935,22,15-19,1957,11
STAT,1842,88,na,1930,204.389786390746
STAT,1856,101,na,1957,1.2598346524589024
STAT,1906,48,50-100,1954,0.4025891982367698
STAT,1831,26,35-39,1857,17.031396960642443
STAT,1856,44,40-44,1900,3.4575933833835397
STAT,1929,30,25-29,1959,23.73519081619531
STAT,1895,71,na,1966,4111.607475562622
STAT,1857,3,na,1860,5227.48570191156
SIM,1909,57,na,1966,6590
STAT,1896,25,50-100,1921,1.7172658808125
SIM,1864,44,40-44,1908,6
STAT,1859,28,30-34,1887,40.882689357790554
STAT,1836,40,na,1876,3411.7059844958485
SIM,1824,42,45-49,1866,7
STAT,1880,39,35-39,1919,14.896703845916926
STAT,1886,32,30-34,1918,37.22311474613993
STAT,1879,33,50-100,1912,1.927379749477561
SIM,1888,78,na,1966,2468
SIM,1900,38,40-44,1938,5
STAT,1825,47,15-19,1872,8.674170425639001E-4
STAT,1862,30,20-24,1892,4.703529514707431
STAT,1815,44,50-100,1859,5.914564527863762
SIM,1925,31,45-49,1956,2
STAT,1889,28,15-19,1917,1.1258479863655095
SIM,1852,34,20-24,1886,6
SIM,1853,26,35-39,1879,24
SIM,1919,21,20-24,1940,239
STAT,1856,29,15-19,1885,0.722106495536606
SIM,1836,34,35-39,1870,26
STAT,1830,45,30-34,1875,0.1714740219984991
STAT,1870,102,na,1972,6.201760933057895
STAT,1854,38,50-100,1892,1.8727787535382436
STAT,1859,13,na,1872,4434.261611365806
STAT,1835,37,30-34,1872,8.537538733287064
SIM,1872,43,35-39,1915,8
STAT,1877,36,25-29,1913,6.06719383909129
SIM,1831,61,na,1892,2504
STAT,1813,48,35-39,1861,0.8488708823839772
STAT,1850,31,40-44,1881,7.0284975026054495
STAT,1788,105,na,1893,0.018239054435384254
STAT,1835,19,30-34,1854,5.329827362564807
STAT,1877,19,35-39,1896,1.144558752555444
STAT,1906,1,na,1907,8010.301190300093
STAT,1952,13,na,1965,9504.691236319102
SIM,1836,49,35-39,1885,1
STAT,1853,15,30-34,1868,3.0696422949863664
SIM,1869,87,na,1956,298
SIM,1894,54,na,1948,5642
STAT,1895,32,25-29,1927,26.954750454075576
STAT,1875,46,15-19,1921,8.341013941040195E-4
STAT,1825,29,15-19,1854,3.05865697187874
STAT,1857,22,na,1879,3885.662054844127
STAT,1919,16,30-34,1935,5.470076376129911
SIM,1914,48,na,1962,7453
SIM,1919,16,25-29,1935,130
SIM,1844,24,na,1868,3673
SIM,1870,23,30-34,1893,43
STAT,1881,40,30-34,1921,2.266891081650181
STAT,1831,44,35-39,1875,2.7942900012905003
STAT,1843,25,15-19,1868,0.7935173747256016
STAT,1851,30,45-49,1881,2.8726333836652342
SIM,1885,36,25-29,1921,11
STAT,1833,29,20-24,1862,20.087508675984857
SIM,1868,27,35-39,1895,26
SIM,1841,34,45-49,1875,4
STAT,1852,51,45-49,1903,0.023240702422629312
STAT,1864,43,35-39,1907,3.245464206196419
SIM,1843,19,30-34,1862,2
STAT,1828,41,25-29,1869,1.2288168940930073
SIM,1799,63,na,1862,1643
STAT,1897,48,45-49,1945,0.35487049723218556
SIM,1869,48,35-39,1917,1
SIM,1858,16,na,1874,4613
STAT,1839,19,15-19,1858,11.979391707185608
SIM,1859,46,25-29,1905,1
STAT,1881,42,25-29,1923,1.2519994051692094
SIM,1880,45,35-39,1925,1
STAT,1836,18,35-39,1854,1.8035927574482857
SIM,1833,40,45-49,1873,4
SIM,1826,37,30-34,1863,11
SIM,1927,16,30-34,1943,36
STAT,1844,34,20-24,1878,5.112769527770609
STAT,1844,59,na,1903,3138.527512367791
STAT,1848,50,40-44,1898,0.01751032911415176
STAT,1852,78,na,1930,1245.2960605641154
STAT,1869,47,30-34,1916,0.18854860665113507
SIM,1859,44,30-34,1903,3
SIM,1872,43,na,1915,4829
STAT,1862,23,30-34,1885,31.24996298178757
STAT,1885,28,30-34,1913,50.44488363960898
STAT,1855,23,40-44,1878,3.644566955526215
STAT,1887,47,50-100,1934,0.5521731625613779
SIM,1816,40,45-49,1856,8
STAT,1889,46,45-49,1935,0.589363528493558
SIM,1857,43,50-100,1900,3
STAT,1850,5,na,1855,4711.3396
STAT,1853,27,50-100,1880,1.1724984034712675
SIM,1880,62,na,1942,3993
STAT,1831,51,25-29,1882,0.004864179265240598
STAT,1844,35,30-34,1879,10.204271860501036
STAT,1913,20,20-24,1933,218.96403475871483
STAT,1881,43,35-39,1924,3.50932066597724
STAT,1892,31,45-49,1923,4.426916045293032
SIM,1873,42,40-44,1915,10
STAT,1848,27,15-19,1875,0.8881229793211594
SIM,1949,22,45-49,1971,3
STAT,1867,32,na,1899,4513.527423509046
SIM,1903,32,na,1935,7043
STAT,1843,18,25-29,1861,10.084536493453312
SIM,1843,37,30-34,1880,10
SIM,1907,46,na,1953,6701
STAT,1919,24,50-100,1943,1.445754091559198
SIM,1861,91,na,1952,64
STAT,1853,40,na,1893,3693.745821959433
SIM,1851,18,25-29,1869,14
STAT,1814,52,35-39,1866,0.04275092581618454
STAT,1860,17,15-19,1877,11.225447233670133
STAT,1933,39,40-44,1972,4.109674546795239
STAT,1826,50,50-100,1876,0.030223263708085958
SIM,1863,23,40-44,1886,7
SIM,1847,19,15-19,1866,13
STAT,1868,18,na,1886,4911.784984130418
STAT,1825,40,45-49,1865,3.6105643471638893
STAT,1872,45,35-39,1917,0.28699666159240533
STAT,1846,54,25-29,1900,0.0052761403849814386
STAT,1818,37,30-34,1855,36.87877141506076
SIM,1839,57,na,1896,2708
SIM,1877,32,30-34,1909,48
STAT,1844,53,50-100,1897,0.023998040135863746
STAT,1872,23,na,1895,4785.601618534877
SIM,1835,43,na,1878,3366
STAT,1801,108,na,1909,0.0014519465135816119
STAT,1814,51,25-29,1865,0.017943951652223847
SIM,1865,43,45-49,1908,7
SIM,1937,30,25-29,1967,21
STAT,1885,18,30-34,1903,3.1957547846796186
STAT,1943,2,na,1945,8683.349358231631
SIM,1877,34,25-29,1911,26
SIM,1894,32,30-34,1926,60
STAT,1857,43,45-49,1900,2.338987114559091
STAT,1858,42,50-100,1900,1.6612494185821265
SIM,1933,22,50-100,1955,2
STAT,1928,16,25-29,1944,110.53267297964041
SIM,1831,42,35-39,1873,5
STAT,1845,21,na,1866,4119.758896574267
SIM,1921,20,20-24,1941,12
STAT,1870,25,30-34,1895,50.27010774911839
STAT,1809,51,15-19,1860,1.850032204173881E-4
STAT,1905,21,25-29,1926,167.7066725217992
SIM,1827,41,30-34,1868,2
SIM,1846,23,40-44,1869,6
SIM,1857,86,na,1943,401
STAT,1868,19,40-44,1887,0.3536137418822912
SIM,1882,17,15-19,1899,13
SIM,1893,28,30-34,1921,78
STAT,1878,22,50-100,1900,0.8601525872430006
STAT,1899,37,15-19,1936,0.03353901789634194
STAT,1827,35,30-34,1862,11.670196866651994
STAT,1838,23,40-44,1861,3.632699204671233
SIM,1895,16,na,1911,7071
SIM,1897,46,45-49,1943,1
STAT,1873,40,na,1913,4790.6502012248575
STAT,1874,17,15-19,1891,12.272145445689556
STAT,1894,26,30-34,1920,65.55604212103448
SIM,1816,60,na,1876,2225
SIM,1911,51,na,1962,7147
STAT,1830,48,35-39,1878,0.2385584868091099
STAT,1841,36,45-49,1877,3.4433972242426303
STAT,1885,19,50-100,1904,0.09796001468479974
STAT,1860,35,15-19,1895,0.09297279994028712
STAT,1829,33,40-44,1862,8.093791407178065
STAT,1834,27,15-19,1861,0.7919337758544605
STAT,1855,52,25-29,1907,0.005312689463899737
STAT,1869,38,50-100,1907,2.3907013660295857
STAT,1889,17,50-100,1906,0.12200118589019548
SIM,1915,49,40-44,1964,2
STAT,1947,23,50-100,1970,1.5013097439078866
STAT,1871,24,35-39,1895,11.635678156011217
SIM,1868,37,35-39,1905,18
SIM,1868,42,30-34,1910,8
STAT,1866,41,45-49,1907,2.801577999081516
STAT,1835,86,na,1921,287.3611322351895
STAT,1851,27,15-19,1878,0.8234920949604673
STAT,1858,36,15-19,1894,0.08883629688391968
SIM,1862,31,25-29,1893,24
STAT,1805,49,50-100,1854,1.9577438811155174
SIM,1941,26,na,1967,7901
STAT,1780,95,na,1875,4.6711189133322675
STAT,1831,72,na,1903,1630.584359136354
STAT,1845,16,35-39,1861,1.0750021792441178
SIM,1863,70,na,1933,2451
SIM,1871,26,na,1897,4656
STAT,1819,36,35-39,1855,44.26923318608136
STAT,1866,48,15-19,1914,7.360253940721366E-4
STAT,1809,47,30-34,1856,0.7503238827983857
STAT,1853,32,20-24,1885,4.404201199879602
STAT,1869,32,30-34,1901,34.16761125027922
STAT,1907,21,35-39,1928,17.374115588878897
SIM,1852,35,30-34,1887,17
STAT,1865,42,40-44,1907,4.121915579676828
STAT,1822,52,50-100,1874,0.04517595051332001
STAT,1823,42,35-39,1865,6.030505485613596
STAT,1879,24,40-44,1903,4.374441203656741
STAT,1913,54,na,1967,7054.705582528069
SIM,1926,24,15-19,1950,10
STAT,1892,32,50-100,1924,2.3165398739483614
STAT,1805,54,35-39,1859,0.06492029890249615
STAT,1818,44,20-24,1862,0.7266866751364398
STAT,1855,50,30-34,1905,0.009105043692805438
SIM,1814,45,50-100,1859,1
STAT,1868,26,30-34,1894,48.553738709984835
SIM,1856,27,15-19,1883,1
STAT,1910,22,50-100,1932,1.2484217562044024
STAT,1890,33,35-39,1923,24.85944542515244
STAT,1853,25,30-34,1878,46.82615870144498
STAT,1876,38,30-34,1914,11.077522030080862
STAT,1815,46,45-49,1861,1.2883632402281955
STAT,1833,47,50-100,1880,0.37884670631049366
STAT,1757,99,na,1856,1.1242930572
SIM,1848,61,na,1909,2810
STAT,1869,34,25-29,1903,19.872547278709813
STAT,1880,26,30-34,1906,53.7601901938908
STAT,1943,21,45-49,1964,2.4184204146614734
SIM,1861,32,20-24,1893,6
SIM,1915,21,35-39,1936,28
STAT,1917,48,50-100,1965,0.47576085297711324
SIM,1877,47,30-34,1924,1
STAT,1901,21,na,1922,6707.053335407014
SIM,1867,38,30-34,1905,13
SIM,1837,33,40-44,1870,13
SIM,1894,34,25-29,1928,32
STAT,1885,35,20-24,1920,1.5643516413452558
SIM,1867,52,na,1919,4306
SIM,1875,71,na,1946,2848
SIM,1882,32,40-44,1914,14
SIM,1803,97,na,1900,8
STAT,1896,13,na,1909,6875.40201822929
STAT,1896,24,40-44,1920,5.52154330226452
SIM,1884,38,30-34,1922,16
SIM,1827,43,25-29,1870,1
STAT,1905,35,na,1940,7001.45915904629
SIM,1861,25,30-34,1886,60
STAT,1882,37,45-49,1919,3.9219791190821587
STAT,1865,27,15-19,1892,0.8324585187230034
STAT,1854,24,35-39,1878,10.3605080331694
STAT,1904,31,50-100,1935,2.666811294639232
STAT,1918,24,15-19,1942,11.520454149391298
STAT,1830,55,na,1885,2907.7306146535293
SIM,1862,24,35-39,1886,12
STAT,1875,31,45-49,1906,3.640837631259088
SIM,1883,31,45-49,1914,4
SIM,1826,44,20-24,1870,1
STAT,1886,34,25-29,1920,21.64968754283226
SIM,1842,27,15-19,1869,1
STAT,1840,42,35-39,1882,2.726576215835192
STAT,1844,17,30-34,1861,3.2719472726826138
STAT,1907,49,40-44,1956,0.28218138394973524
STAT,1872,52,25-29,1924,0.00715109435159121
SIM,1815,41,40-44,1856,5
SIM,1852,17,30-34,1869,4
STAT,1885,41,na,1926,4667.299764425222
SIM,1856,80,na,1936,921
STAT,1855,45,35-39,1900,0.21321549755207728
STAT,1819,43,25-29,1862,2.8778525400097195
SIM,1826,45,30-34,1871,1
SIM,1866,29,25-29,1895,96
STAT,1895,22,30-34,1917,46.8753484404611
STAT,1909,29,50-100,1938,1.9084597677951516
STAT,1854,46,30-34,1900,0.14881448457664423
SIM,1834,25,15-19,1859,1
STAT,1881,50,25-29,1931,0.007013658392144208
STAT,1864,46,40-44,1910,0.30994648898914995
STAT,1874,32,40-44,1906,8.9679602816685
STAT,1928,21,20-24,1949,281.192442712797
SIM,1840,37,50-100,1877,5
STAT,1899,40,45-49,1939,0.2904899367461782
STAT,1964,5,na,1969,9999.287156365213
STAT,1860,22,na,1882,3998.5666133193067
STAT,1862,38,30-34,1900,9.154292156752394
STAT,1879,54,35-39,1933,0.017686325384736787
STAT,1827,45,25-29,1872,0.10684041952780468
SIM,1833,32,45-49,1865,4
STAT,1831,43,25-29,1874,1.0037867954627018
STAT,1868,39,35-39,1907,13.454019853093262
STAT,1885,36,30-34,1921,10.765597071557144
SIM,1891,49,50-100,1940,1
SIM,1870,38,30-34,1908,12
SIM,1872,46,40-44,1918,1
STAT,1877,33,20-24,1910,5.644819729324295
STAT,1883,49,50-100,1932,0.47716230379745844
STAT,1800,89,na,1889,83.20698765402115
SIM,1813,46,35-39,1859,1
SIM,1840,42,na,1882,3815
SIM,1823,46,45-49,1869,2
STAT,1892,23,45-49,1915,1.757587493426658
STAT,1862,31,30-34,1893,30.262152787535406
STAT,1832,37,50-100,1869,2.022455002678894
STAT,1868,40,15-19,1908,0.026803709370310992
STAT,1830,53,30-34,1883,0.008859487368539627
STAT,1935,24,15-19,1959,14.632680305178525
SIM,1890,37,45-49,1927,7
STAT,1893,16,15-19,1909,15.229037406413475
STAT,1841,41,40-44,1882,3.43495504424941
SIM,1859,26,30-34,1885,58
SIM,1876,89,na,1965,481
SIM,1858,38,30-34,1896,14
SIM,1880,37,35-39,1917,19
SIM,1828,93,na,1921,37
STAT,1825,32,45-49,1857,6.188867847806076
STAT,1854,36,30-34,1890,8.209498444799339
STAT,1828,101,na,1929,0.7007575305958978
STAT,1923,47,30-34,1970,0.2105484375349893
SIM,1866,90,na,1956,114
STAT,1858,29,25-29,1887,67.202731234482
STAT,1775,84,na,1859,153.34401835748707
STAT,1762,98,na,1860,1.263240567040316
STAT,1842,19,20-24,1861,33.49590201893832
STAT,1894,36,25-29,1930,7.505732441968052
SIM,1830,43,30-34,1873,5
SIM,1947,20,40-44,1967,8
STAT,1856,92,na,1948,64.89962351772164
STAT,1865,44,50-100,1909,1.9122251723670247
SIM,1852,42,20-24,1894,2
SIM,1818,42,20-24,1860,1
STAT,1822,36,na,1858,3259.4008702619763
SIM,1849,87,na,1936,203
STAT,1891,21,50-100,1912,1.0210741085391404
SIM,1879,53,na,1932,4352
STAT,1919,41,20-24,1960,0.038699537848456755
STAT,1899,33,na,1932,6575.387843956845
STAT,1855,53,35-39,1908,0.012773458049761885
STAT,1822,50,20-24,1872,0.00229693448008886
SIM,1850,19,20-24,1869,30
STAT,1805,53,25-29,1858,0.027255093661471278
SIM,1936,21,20-24,1957,191
SIM,1927,23,20-24,1950,271
STAT,1846,37,35-39,1883,11.313382595608031
SIM,1919,24,25-29,1943,198
STAT,1835,44,20-24,1879,0.2403292112154504
STAT,1790,110,na,1900,1.0809289583164634E-4
STAT,1844,42,20-24,1886,0.2626674489563902
SIM,1947,11,na,1958,9313
SIM,1862,36,30-34,1898,16
SIM,1939,21,45-49,1960,4
STAT,1868,29,35-39,1897,18.408157001374626
STAT,1816,40,na,1856,3153.016751397111
SIM,1900,12,na,1912,7582
SIM,1883,18,20-24,1901,37
SIM,1860,10,na,1870,4884
SIM,1836,46,30-34,1882,1
STAT,1939,20,40-44,1959,6.825249887482618
SIM,1893,18,30-34,1911,6
STAT,1803,77,na,1880,726.6421439910328
STAT,1828,39,40-44,1867,8.465566965673647
SIM,1871,44,30-34,1915,5
STAT,1897,45,40-44,1942,0.26330641473191685
STAT,1947,22,na,1969,8334.841242054186
SIM,1844,32,20-24,1876,5
STAT,1839,37,na,1876,3996.4515212086417
SIM,1881,40,25-29,1921,1
SIM,1823,62,na,1885,2054
STAT,1856,47,45-49,1903,0.36602929835300496
STAT,1898,48,na,1946,6072.878568296341
STAT,1895,37,30-34,1932,14.025479709381411
SIM,1885,26,30-34,1911,59
STAT,1883,30,40-44,1913,8.674401150080183
STAT,1919,23,20-24,1942,245.0973676680205
SIM,1919,47,na,1966,8125
SIM,1811,61,na,1872,2018
SIM,1862,39,35-39,1901,20
SIM,1815,75,na,1890,834
STAT,1831,105,na,1936,0.037857328726846134
SIM,1770,85,na,1855,108
SIM,1864,24,na,1888,4501
STAT,1818,52,20-24,1870,0.003119606928764201
SIM,1923,29,na,1952,8963
STAT,1877,26,30-34,1903,52.991659101514614
SIM,1841,31,40-44,1872,12
STAT,1872,27,35-39,1899,19.58482093226469
SIM,1821,45,30-34,1866,1
SIM,1889,63,na,1952,4390
SIM,1893,69,na,1962,4126
STAT,1850,12,na,1862,4472.802435525003
SIM,1860,15,15-19,1875,11
STAT,1827,36,na,1863,3434.7873386712554
SIM,1836,39,40-44,1875,12
STAT,1869,67,na,1936,3102.175447321944
STAT,1828,46,30-34,1874,0.1766656626559293
STAT,1863,44,30-34,1907,2.005064315152433
SIM,1885,33,20-24,1918,6
STAT,1818,45,30-34,1863,0.4401255620089404
SIM,1901,25,50-100,1926,3
STAT,1833,31,40-44,1864,7.4332596655199765
STAT,1823,45,40-44,1868,0.5442620442842665
STAT,1828,31,30-34,1859,40.35498997700873
STAT,1900,35,na,1935,6663.249751991078
STAT,1904,49,na,1953,6386.721866967823
SIM,1882,73,na,1955,2246
SIM,1933,20,40-44,1953,7
STAT,1885,43,20-24,1928,0.3169549594962328
SIM,1850,32,50-100,1882,4
STAT,1813,45,30-34,1858,0.618480329319145
SIM,1844,41,30-34,1885,6
STAT,1871,37,na,1908,4727.303571644095
SIM,1905,11,na,1916,7806
STAT,1820,108,na,1928,0.002050628105812923
STAT,1862,88,na,1950,236.97910382278113
STAT,1792,64,na,1856,1652.0884168000002
SIM,1854,47,35-39,1901,1
SIM,1893,36,30-34,1929,19
SIM,1868,39,50-100,1907,5
STAT,1880,36,30-34,1916,11.393641412373414
STAT,1881,26,50-100,1907,1.2530168517456322
STAT,1821,37,30-34,1858,20.867033782039197
STAT,1852,33,15-19,1885,0.23257360769308938
STAT,1890,36,40-44,1926,10.843165797464808
STAT,1940,32,na,1972,7905.901941591174
STAT,1894,34,na,1928,6138.0325946017865
STAT,1807,52,45-49,1859,0.09452703881801744
STAT,1925,20,40-44,1945,8.175221472936844
SIM,1809,48,35-39,1857,1
STAT,1893,42,15-19,1935,0.03530795621422146
SIM,1836,31,30-34,1867,40
STAT,1873,40,25-29,1913,1.3310387673058715
SIM,1891,30,40-44,1921,15
STAT,1836,41,30-34,1877,1.8423062573933437
SIM,1864,47,45-49,1911,1
SIM,1876,39,35-39,1915,28
SIM,1874,33,45-49,1907,2
STAT,1786,80,na,1866,451.09924260640565
STAT,1966,6,na,1972,9914.650762331737
STAT,1877,41,20-24,1918,0.33456305235579353
SIM,1840,40,35-39,1880,5
STAT,1770,85,na,1855,137.58100000000002
SIM,1906,29,na,1935,6966
STAT,1841,33,40-44,1874,7.5555401687385615
SIM,1877,35,35-39,1912,24
STAT,1855,49,50-100,1904,0.3626160848745085
SIM,1844,15,30-34,1859,3
STAT,1805,88,na,1893,102.68941227438319
STAT,1839,17,50-100,1856,0.10006959100103763
STAT,1854,29,40-44,1883,4.745200131855159
STAT,1767,97,na,1864,1.5201014982945724
STAT,1845,26,35-39,1871,18.228348589976953
STAT,1861,46,50-100,1907,0.41402783488957695
SIM,1828,47,35-39,1875,1
SIM,1836,41,25-29,1877,2
SIM,1898,68,na,1966,4711
STAT,1945,11,na,1956,8666.837202954164
SIM,1835,75,na,1910,1238
SIM,1850,95,na,1945,17
STAT,1922,47,na,1969,8521.477748517318
SIM,1869,32,25-29,1901,24
SIM,1922,15,50-100,1937,1
STAT,1887,38,35-39,1925,15.897020930487644
SIM,1863,42,30-34,1905,4
STAT,1863,51,20-24,1914,0.0013108100395810356
SIM,1895,38,35-39,1933,24
STAT,1889,43,40-44,1932,5.560758625479294
SIM,1865,41,na,1906,4342
STAT,1853,18,35-39,1871,1.0381988644497846
SIM,1865,40,40-44,1905,2
STAT,1837,50,50-100,1887,0.021984870326824987
SIM,1794,64,na,1858,1624
STAT,1927,43,50-100,1970,0.29704921833006864
SIM,1862,29,40-44,1891,7
SIM,1848,43,45-49,1891,5
STAT,1774,99,na,1873,0.5065086671305772
STAT,1861,34,20-24,1895,4.504961685529137
SIM,1861,18,35-39,1879,2
SIM,1853,60,na,1913,3050
SIM,1798,78,na,1876,576
STAT,1842,32,50-100,1874,1.6478902368462496
STAT,1841,62,na,1903,2651.909713906993
SIM,1885,41,20-24,1926,2
STAT,1863,52,30-34,1915,0.010467494156639669
STAT,1871,23,25-29,1894,114.50924913249315
STAT,1903,64,na,1967,5547.483040375673
SIM,1947,1,na,1948,9561
STAT,1853,28,35-39,1881,15.978355087157919
STAT,1880,54,25-29,1934,0.007328659003126731
SIM,1935,18,30-34,1953,48
STAT,1832,40,35-39,1872,2.9636171175662063
STAT,1869,35,35-39,1904,13.972731962235558
SIM,1867,46,30-34,1913,1
STAT,1952,19,50-100,1971,0.9060776972016898
STAT,1851,22,45-49,1873,1.2908959250647218
STAT,1887,30,25-29,1917,23.321889424754808
SIM,1818,39,50-100,1857,4
SIM,1918,22,15-19,1940,12
STAT,1811,50,45-49,1861,0.09782392458487749
STAT,1867,44,15-19,1911,0.02576767706541375
SIM,1940,25,50-100,1965,3
STAT,1868,18,30-34,1886,3.099748575526937
STAT,1834,69,na,1903,1950.2739793683259
STAT,1880,42,na,1922,4911.277305380002
STAT,1914,16,50-100,1930,0.15693237768036503
STAT,1852,41,15-19,1893,0.022109838891403225
STAT,1914,15,50-100,1929,0.15727523769854782
SIM,1880,44,25-29,1924,3
SIM,1909,28,30-34,1937,86
SIM,1928,28,na,1956,9352
STAT,1851,37,15-19,1888,0.08798202828459536
SIM,1868,19,35-39,1887,2
SIM,1841,42,45-49,1883,3
SIM,1924,14,na,1938,9872
STAT,1915,45,na,1960,7512.305174881308
SIM,1829,67,na,1896,2032
SIM,1940,3,na,1943,8476
SIM,1877,31,20-24,1908,2
STAT,1908,18,50-100,1926,0.14648744595684948
STAT,1877,49,30-34,1926,0.19876632657483462
SIM,1861,28,35-39,1889,22
STAT,1893,34,15-19,1927,0.3614251787753755
STAT,1840,50,35-39,1890,0.012605239776240092
SIM,1845,41,na,1886,3879
SIM,1876,18,30-34,1894,3
STAT,1817,49,30-34,1866,0.453143994628773
STAT,1837,35,40-44,1872,7.585982784860991
STAT,1872,44,25-29,1916,1.2858185277813718
STAT,1864,99,na,1963,10.954948341660243
STAT,1831,36,35-39,1867,11.690707083732557
STAT,1810,79,na,1889,615.0480593516104
SIM,1830,44,na,1874,2927
SIM,1866,35,na,1901,4617
STAT,1843,39,30-34,1882,7.7682033204458465
SIM,1834,58,na,1892,2592
SIM,1919,17,35-39,1936,9
STAT,1840,45,na,1885,3359.8530019464692
SIM,1835,38,35-39,1873,15
SIM,1899,30,na,1929,6680
STAT,1836,33,30-34,1869,29.0465184266038
SIM,1862,21,30-34,1883,39
SIM,1911,20,50-100,1931,1
STAT,1853,35,25-29,1888,4.651064653586322
STAT,1869,42,25-29,1911,1.2551153296276207
SIM,1870,72,na,1942,2380
SIM,1895,30,25-29,1925,39
STAT,1859,46,30-34,1905,0.15604674460841314
STAT,1894,29,35-39,1923,24.854232605254886
STAT,1873,41,35-39,1914,3.73270503188257
STAT,1927,18,30-34,1945,30.52311290087714
STAT,1879,65,na,1944,3570.007135039756
SIM,1854,37,35-39,1891,28
STAT,1822,51,30-34,1873,0.01816345640432326
STAT,1871,16,35-39,1887,1.1146691569294358
STAT,1875,51,na,1926,4498.614296722985
STAT,1851,17,na,1868,4326.308034532531
STAT,1833,49,15-19,1882,5.472767276499072E-4
STAT,1826,43,15-19,1869,0.0285821554218554
SIM,1888,14,na,1902,6045
SIM,1889,44,45-49,1933,9
SIM,1901,41,na,1942,6611
STAT,1917,21,45-49,1938,2.422248039279433
SIM,1877,42,na,1919,4751
STAT,1833,42,45-49,1875,2.3882343166082607
SIM,1961,6,na,1967,10514
STAT,1865,50,40-44,1915,0.01959383223493079
STAT,1862,33,na,1895,4101.869848215947
STAT,1948,22,35-39,1970,21.833166692219216
SIM,1831,29,na,1860,3888
SIM,1877,42,25-29,1919,2
SIM,1885,34,30-34,1919,51
STAT,1863,25,40-44,1888,5.372734921756185
STAT,1906,20,na,1926,7001.734644474394
SIM,1910,20,45-49,1930,5
STAT,1805,105,na,1910,0.02193213674229151
STAT,1880,47,35-39,1927,0.2964715827890917
STAT,1854,21,30-34,1875,32.31562052100133
STAT,1877,34,30-34,1911,36.30229980290745
STAT,1903,20,50-100,1923,1.1796233231912627
STAT,1868,93,na,1961,116.67916186671799
STAT,1827,38,35-39,1865,14.310784810444165
SIM,1925,21,45-49,1946,6
STAT,1851,19,15-19,1870,11.053703024286426
STAT,1797,96,na,1893,4.154878047473845
SIM,1851,39,30-34,1890,12
STAT,1933,30,na,1963,10306.333526446548
SIM,1856,42,40-44,1898,5
SIM,1875,26,15-19,1901,1
STAT,1863,18,na,1881,4609.149134788901
SIM,1881,41,35-39,1922,4
STAT,1843,46,20-24,1889,0.016947182688077905
STAT,1859,53,20-24,1912,0.0011671517602063342
STAT,1911,33,50-100,1944,1.6196101862897192
SIM,1861,35,25-29,1896,5
STAT,1880,29,35-39,1909,20.382076598138276
SIM,1853,17,na,1870,4587
STAT,1947,22,40-44,1969,7.674224727384623
STAT,1880,21,25-29,1901,122.16192589154537
STAT,1836,40,20-24,1876,0.25777422647240156
SIM,1847,76,na,1923,1469
SIM,1831,92,na,1923,25
STAT,1902,20,45-49,1922,2.000168553765601
STAT,1821,41,50-100,1862,3.4557371555253646
STAT,1900,36,25-29,1936,1.749447775650328
STAT,1872,37,35-39,1909,14.356195225671783
SIM,1821,38,35-39,1859,20
SIM,1843,62,na,1905,2676
SIM,1871,25,40-44,1896,9
STAT,1806,50,35-39,1856,0.052291883212936485
SIM,1876,27,50-100,1903,3
SIM,1858,48,na,1906,3813
STAT,1808,53,na,1861,2408.464030584767
SIM,1885,16,30-34,1901,6
STAT,1811,96,na,1907,7.98185102178731
STAT,1937,32,25-29,1969,18.471538775731005
STAT,1848,42,40-44,1890,3.6836131653826936
STAT,1760,102,na,1862,0.02067057850980989
STAT,1895,47,30-34,1942,0.14302569468373316
SIM,1912,13,na,1925,8239
STAT,1835,19,50-100,1854,0.16382662742693538
STAT,1920,48,45-49,1968,0.4837499795214714
SIM,1842,17,20-24,1859,37
SIM,1939,24,na,1963,7517
STAT,1870,30,50-100,1900,1.8313599988385312
STAT,1852,6,na,1858,4809.032977787708
SIM,1934,32,50-100,1966,4
STAT,1869,39,30-34,1908,10.324691566140803
STAT,1915,47,25-29,1962,0.1079610660505765
STAT,1884,47,20-24,1931,0.023819677862325483
STAT,1933,36,50-100,1969,1.1561370242194284
SIM,1840,32,35-39,1872,33
SIM,1903,32,50-100,1935,3
SIM,1849,29,25-29,1878,75
STAT,1885,39,35-39,1924,14.075562455853182
STAT,1836,92,na,1928,55.37635964985142
STAT,1881,46,40-44,1927,0.33514515953681184
SIM,1845,36,30-34,1881,18
SIM,1948,16,15-19,1964,104
SIM,1859,34,50-100,1893,3
SIM,1819,45,40-44,1864,1
SIM,1923,26,50-100,1949,3
SIM,1929,13,na,1942,10514
STAT,1837,101,na,1938,0.7953097813673432
STAT,1829,37,35-39,1866,12.362519881449877
STAT,1904,18,na,1922,7301.893576737281
SIM,1877,24,30-34,1901,43
SIM,1886,36,40-44,1922,11
STAT,1878,36,40-44,1914,9.277910855598801
SIM,1846,59,na,1905,3059
STAT,1891,14,na,1905,6426.05837518999
STAT,1867,48,30-34,1915,0.1807893703989762
SIM,1822,41,30-34,1863,5
STAT,1769,105,na,1874,0.026789052347875618
STAT,1844,45,25-29,1889,0.09448595159173002
SIM,1890,17,na,1907,6692
STAT,1828,73,na,1901,1458.6263720294824
STAT,1835,33,15-19,1868,0.23249497688610507
SIM,1884,16,15-19,1900,13
SIM,1863,27,35-39,1890,21
SIM,1886,22,30-34,1908,53
SIM,1929,32,40-44,1961,14
STAT,1823,41,25-29,1864,2.1932208100896786
STAT,1895,15,50-100,1910,0.1295275453989563
SIM,1826,48,35-39,1874,1
STAT,1878,22,30-34,1900,37.571460936045064
STAT,1925,23,45-49,1948,2.711110107926245
SIM,1813,43,30-34,1856,3
SIM,1877,39,30-34,1916,14
STAT,1884,21,45-49,1905,1.3948463087912064
SIM,1769,97,na,1866,2
SIM,1911,48,45-49,1959,2
SIM,1893,39,35-39,1932,21
STAT,1789,77,na,1866,695.0349526182588
SIM,1806,94,na,1900,1
STAT,1880,19,40-44,1899,0.38705273516221705
SIM,1834,47,30-34,1881,1
SIM,1901,30,45-49,1931,8
STAT,1870,21,15-19,1891,6.561143786721923
SIM,1854,33,40-44,1887,9
SIM,1872,35,35-39,1907,26
SIM,1822,56,na,1878,2435
STAT,1818,48,35-39,1866,0.6077341714724678
SIM,1899,53,na,1952,5837
STAT,1863,94,na,1957,46.30651654291632
STAT,1876,52,45-49,1928,0.030153018213478346
STAT,1895,40,25-29,1935,1.7069719708089175
SIM,1820,42,50-100,1862,4
SIM,1914,48,50-100,1962,1
STAT,1900,15,na,1915,7108.675257623838
STAT,1858,28,15-19,1886,0.7259933821578455
STAT,1904,29,na,1933,6868.466098471742
SIM,1828,43,40-44,1871,9
SIM,1866,28,15-19,1894,1
SIM,1918,26,30-34,1944,103
STAT,1814,41,30-34,1855,6.894882476488515
STAT,1878,37,30-34,1915,11.241682047006725
SIM,1880,34,30-34,1914,45
STAT,1957,12,na,1969,10458.048226245333
STAT,1872,34,30-34,1906,35.13528372104517
STAT,1930,3,na,1933,10590.483907287386
SIM,1857,22,na,1879,4387
STAT,1869,31,20-24,1900,5.311339674338843
STAT,1881,32,30-34,1913,34.08278741531593
STAT,1945,3,na,1948,8846.284599230541
STAT,1900,29,35-39,1929,26.83946691710968
SIM,1909,20,20-24,1929,203
STAT,1893,38,30-34,1931,13.575399559808334
STAT,1867,26,15-19,1893,0.8610890690840431
STAT,1821,42,na,1863,3045.7772317728254
SIM,1898,29,20-24,1927,31
STAT,1892,20,40-44,1912,5.299920123058968
STAT,1904,30,20-24,1934,7.8984463023125
STAT,1880,73,na,1953,2527.0305035791635
STAT,1876,36,na,1912,4944.992352278017
STAT,1873,33,35-39,1906,20.693610683054015
STAT,1853,41,30-34,1894,1.8272373274457727
SIM,1857,44,50-100,1901,7
SIM,1877,23,50-100,1900,3
STAT,1843,20,45-49,1863,1.2439079279206813
STAT,1872,41,20-24,1913,0.32380779815383065
STAT,1897,38,15-19,1935,0.1508452870826961
SIM,1845,35,40-44,1880,13
SIM,1939,18,15-19,1957,86
STAT,1809,93,na,1902,25.97593780615847
STAT,1850,46,50-100,1896,0.37764020894296646
SIM,1867,21,na,1888,4841
STAT,1869,50,25-29,1919,0.007031113695746427
STAT,1823,34,35-39,1857,45.15560802542382
STAT,1869,98,na,1967,30.675352591061635
STAT,1873,47,45-49,1920,0.48202748206333457
STAT,1860,39,30-34,1899,8.65297527058275
SIM,1845,21,30-34,1866,44
SIM,1857,28,20-24,1885,22
STAT,1922,21,25-29,1943,214.51917044637105
SIM,1831,41,25-29,1872,3
STAT,1806,74,na,1880,932.4876986053569
STAT,1852,44,20-24,1896,0.2497012197194263
SIM,1930,21,25-29,1951,262
STAT,1803,108,na,1911,0.0012926982239881847
STAT,1826,104,na,1930,0.07984695585854773
STAT,1855,27,35-39,1882,15.165897263673033
STAT,1847,39,15-19,1886,0.08698711983282648
STAT,1890,25,35-39,1915,23.947486008268893
STAT,1890,32,25-29,1922,25.249616837231816
STAT,1890,72,na,1962,3539.2040825609274
SIM,1855,39,15-19,1894,1
SIM,1874,30,40-44,1904,13
STAT,1825,45,na,1870,3059.980900137138
SIM,1814,42,35-39,1856,6
SIM,1819,39,40-44,1858,11
STAT,1837,36,30-34,1873,9.140472147796135
STAT,1944,18,30-34,1962,26.481258189816582
STAT,1859,49,35-39,1908,0.22034964549884414
STAT,1879,53,25-29,1932,0.007362282863132362
SIM,1875,19,25-29,1894,15
STAT,1849,28,20-24,1877,21.83939163810757
SIM,1923,47,25-29,1970,3
STAT,1872,53,35-39,1925,0.017193589862654804
SIM,1956,15,na,1971,9986
STAT,1880,15,50-100,1895,0.10471808449281296
SIM,1856,69,na,1925,2392
SIM,1912,30,20-24,1942,1
SIM,1851,20,45-49,1871,1
SIM,1886,12,na,1898,5463
SIM,1880,41,20-24,1921,1
STAT,1840,45,40-44,1885,0.2556655741803929
STAT,1914,28,na,1942,7601.537484058529
STAT,1899,29,15-19,1928,1.2464848475974624
STAT,1779,78,na,1857,502.6721748059254
STAT,1840,22,na,1862,3924.8043349395257
STAT,1886,67,na,1953,3379.593375506426
STAT,1948,8,na,1956,9082.937733081333
SIM,1933,23,45-49,1956,3
STAT,1840,31,30-34,1871,31.016333446358733
STAT,1867,19,25-29,1886,10.828509518486193
STAT,1942,29,40-44,1971,9.870434892639281
STAT,1805,50,20-24,1855,0.0060328841891809665
STAT,1847,50,25-29,1897,0.005476827752451689
STAT,1931,28,na,1959,9763.444497507884
SIM,1843,15,15-19,1858,10
STAT,1882,53,na,1935,4168.119269903876
SIM,1790,82,na,1872,309
SIM,1828,34,50-100,1862,2
STAT,1857,40,40-44,1897,3.5765311114768874
SIM,1944,23,20-24,1967,219
STAT,1885,46,25-29,1931,0.11612181699812345
STAT,1932,39,25-29,1971,2.666309784350861
STAT,1936,23,20-24,1959,214.6728735382493
SIM,1820,45,na,1865,2896
STAT,1819,37,na,1856,3049.1268835803603
STAT,1837,54,30-34,1891,0.00807025165364903
STAT,1841,44,45-49,1885,2.19939665471847
SIM,1888,44,50-100,1932,3
SIM,1870,31,30-34,1901,46
STAT,1925,41,45-49,1966,0.4074469972883732
STAT,1823,74,na,1897,1331.7478901609534
SIM,1831,34,35-39,1865,6
SIM,1873,69,na,1942,2892
SIM,1864,47,50-100,1911,1
SIM,1878,35,30-34,1913,17
SIM,1890,30,25-29,1920,27
STAT,1831,33,30-34,1864,29.13869603504525
SIM,1925,31,na,1956,9151
STAT,1848,18,na,1866,4638.3717527741965
STAT,1936,19,35-39,1955,8.071667676496462
SIM,1851,17,15-19,1868,9
STAT,1860,43,15-19,1903,0.022485651241468903
SIM,1924,39,40-44,1963,6
STAT,1831,52,35-39,1883,0.011590809486098017
STAT,1827,51,30-34,1878,0.010584136945360752
STAT,1863,73,na,1936,2099.8287198728704
SIM,1895,71,na,1966,4173
STAT,1868,32,15-19,1900,0.2736401035855144
SIM,1851,37,na,1888,3813
STAT,1864,42,25-29,1906,1.157864909596218
SIM,1897,2,na,1899,7338
STAT,1847,54,40-44,1901,0.015606434386886166
STAT,1899,47,15-19,1946,6.214473453812005E-4
STAT,1815,55,na,1870,2463.872259139843
STAT,1881,17,35-39,1898,1.0711248442472527
SIM,1834,29,30-34,1863,48
SIM,1842,77,na,1919,1086
SIM,1850,96,na,1946,11
STAT,1898,41,40-44,1939,0.42882439259558613
STAT,1859,68,na,1927,2456.561028469831
SIM,1896,26,35-39,1922,36
STAT,1843,17,15-19,1860,10.623728120747954
STAT,1911,47,40-44,1958,0.3015352472538126
SIM,1942,12,na,1954,8467
STAT,1866,47,na,1913,4172.986856580742
STAT,1871,20,20-24,1891,139.09897510396542
STAT,1920,35,na,1955,8331.651653178811
STAT,1855,54,na,1909,3157.5497487051607
STAT,1843,74,na,1917,1554.6114984035491
STAT,1835,51,45-49,1886,0.019546998251076968
SIM,1864,88,na,1952,184
SIM,1859,47,35-39,1906,2
STAT,1906,21,40-44,1927,6.151047799182953
STAT,1826,29,30-34,1855,107.75805471826881
STAT,1868,46,25-29,1914,0.11099415999680691
SIM,1881,33,35-39,1914,25
STAT,1925,22,50-100,1947,1.590358776588841
SIM,1891,4,na,1895,6769
STAT,1894,42,30-34,1936,0.20686949741037697
STAT,1861,23,15-19,1884,5.656393581707325
STAT,1893,49,na,1942,5640.116302094449
STAT,1896,43,30-34,1939,0.2113373963882517
SIM,1944,19,35-39,1963,14
SIM,1841,47,50-100,1888,3
SIM,1895,45,30-34,1940,1
STAT,1882,30,25-29,1912,20.313244447553124
SIM,1843,18,na,1861,4347
STAT,1851,92,na,1943,64.5641975492983
SIM,1905,49,50-100,1954,2
SIM,1907,45,50-100,1952,2
SIM,1840,28,15-19,1868,1
STAT,1916,39,40-44,1955,3.0648967902338877
SIM,1918,5,na,1923,9077
STAT,1852,15,15-19,1867,11.575715373103142
STAT,1877,44,25-29,1921,1.32852690356086
STAT,1877,42,30-34,1919,2.408067785899863
SIM,1928,22,25-29,1950,273
SIM,1829,35,35-39,1864,14
SIM,1885,44,25-29,1929,3
STAT,1871,28,30-34,1899,50.35000194730803
SIM,1867,49,35-39,1916,1
STAT,1831,26,50-100,1857,1.1291258991004374
SIM,1907,30,50-100,1937,3
SIM,1886,37,30-34,1923,10
STAT,1832,28,15-19,1860,0.7879461056385463
STAT,1859,57,na,1916,3230.460097122736
SIM,1848,40,40-44,1888,11
SIM,1903,15,30-34,1918,6
SIM,1886,22,50-100,1908,1
STAT,1877,16,30-34,1893,3.350805855649166
SIM,1899,27,15-19,1926,2
STAT,1914,48,20-24,1962,0.022077362187874677
STAT,1829,52,30-34,1881,0.008256431122752917
STAT,1819,92,na,1911,43.58097552539499
STAT,1867,87,na,1954,333.2326682193264
STAT,1826,47,30-34,1873,0.19302698159766815
STAT,1807,59,na,1866,2284.2143543716807
STAT,1872,26,45-49,1898,2.261361079663467
STAT,1888,44,35-39,1932,4.26418438207782
STAT,1868,27,50-100,1895,1.2291858066995898
SIM,1828,41,na,1869,3291
STAT,1857,36,20-24,1893,1.219308441949191
STAT,1828,96,na,1924,10.544893361151296
STAT,1846,33,40-44,1879,7.768793463179521
SIM,1884,45,20-24,1929,1
SIM,1918,33,20-24,1951,8
SIM,1896,44,35-39,1940,2
STAT,1883,48,15-19,1931,7.837357044058446E-4
STAT,1913,5,na,1918,8277.48478896821
STAT,1921,30,20-24,1951,5.52479977639083
STAT,1784,108,na,1892,0.0033132299914936996
SIM,1877,38,50-100,1915,6
SIM,1845,24,35-39,1869,12
STAT,1843,35,15-19,1878,0.09375831731543512
STAT,1795,84,na,1879,235.20619643750294
SIM,1820,34,25-29,1854,6
STAT,1836,43,25-29,1879,1.003003435197586
STAT,1776,81,na,1857,378.29468862465706
STAT,1799,98,na,1897,2.209208668092173
SIM,1818,46,35-39,1864,1
STAT,1814,60,na,1874,2090.586454335863
STAT,1899,9,na,1908,7179.709554881577
SIM,1830,24,40-44,1854,3
STAT,1876,45,20-24,1921,0.02531621817413075
SIM,1875,48,30-34,1923,1
STAT,1906,49,25-29,1955,0.09362331073205989
SIM,1938,30,40-44,1968,14
STAT,1846,39,na,1885,3691.0125936375243
STAT,1884,18,15-19,1902,11.804091409475918
SIM,1844,43,25-29,1887,2
SIM,1869,37,30-34,1906,16
STAT,1837,24,35-39,1861,10.497223667939986
STAT,1843,73,na,1916,1663.8249693946111
STAT,1847,87,na,1934,268.5597392405667
SIM,1842,44,50-100,1886,4
SIM,1889,41,40-44,1930,11
STAT,1833,50,45-49,1883,0.02049130171664287
STAT,1822,43,30-34,1865,3.766130048090237
SIM,1841,82,na,1923,619
SIM,1813,49,50-100,1862,2
SIM,1895,34,40-44,1929,20
STAT,1893,45,20-24,1938,0.017500564381235328
STAT,1856,37,15-19,1893,0.08750206984097846
SIM,1782,86,na,1868,109
SIM,1898,13,na,1911,7310
SIM,1885,42,30-34,1927,4
STAT,1887,34,40-44,1921,9.711876211541949
SIM,1825,30,45-49,1855,4
SIM,1876,8,na,1884,5774
STAT,1826,54,20-24,1880,0.0013639657931344504
SIM,1868,16,30-34,1884,6
SIM,1937,12,na,1949,7970
SIM,1864,55,na,1919,3908
SIM,1914,21,40-44,1935,13
STAT,1863,29,35-39,1892,16.936427855065926
STAT,1831,40,20-24,1871,0.25804553426575044
STAT,1815,78,na,1893,726.2485209928232
SIM,1878,16,na,1894,5543
STAT,1875,18,20-24,1893,36.7672664137822
SIM,1864,19,15-19,1883,9
SIM,1860,41,na,1901,4006
STAT,1896,25,30-34,1921,67.60126900090873
STAT,1907,20,45-49,1927,2.0822533434761974
SIM,1894,9,na,1903,7040
STAT,1832,46,45-49,1878,0.36845395796468017
STAT,1868,52,30-34,1920,0.01137709070031311
STAT,1877,37,35-39,1914,14.833035282969458
SIM,1830,25,30-34,1855,46
STAT,1863,21,25-29,1884,103.96794251307024
SIM,1938,30,50-100,1968,1
SIM,1830,52,50-100,1882,1
SIM,1904,31,25-29,1935,22
SIM,1858,26,15-19,1884,1
SIM,1885,37,35-39,1922,20
STAT,1856,19,15-19,1875,10.806055313839526
STAT,1832,32,35-39,1864,17.21064566587119
STAT,1930,20,20-24,1950,289.40374993794654
SIM,1840,46,45-49,1886,2
SIM,1912,31,50-100,1943,2
SIM,1871,21,25-29,1892,121
SIM,1872,42,25-29,1914,3
STAT,1814,44,35-39,1858,9.737332235704725
STAT,1782,108,na,1890,0.010286006361720175
STAT,1856,91,na,1947,90.29638467000812
STAT,1824,44,45-49,1868,3.7053081133270442
SIM,1887,72,na,1959,3283
STAT,1777,96,na,1873,2.706834282612245
SIM,1932,13,na,1945,10707
STAT,1859,108,na,1967,0.028653982522960024
SIM,1944,26,25-29,1970,152
SIM,1851,43,50-100,1894,6
STAT,1868,50,45-49,1918,0.028286719924474055
SIM,1904,39,50-100,1943,3
STAT,1884,24,na,1908,4687.020196749812
STAT,1843,43,50-100,1886,1.5043238106764945
SIM,1853,30,20-24,1883,7
STAT,1908,23,45-49,1931,2.08403357490505
STAT,1855,42,30-34,1897,1.7314898773198486
SIM,1833,33,50-100,1866,2
STAT,1838,49,15-19,1887,5.428609121025302E-4
SIM,1845,39,35-39,1884,9
SIM,1851,92,na,1943,37
SIM,1835,39,25-29,1874,6
SIM,1891,57,na,1948,5287
STAT,1934,31,45-49,1965,4.342230327091279
STAT,1806,53,40-44,1859,0.06021171721326736
STAT,1895,36,40-44,1931,11.575416375105446
STAT,1898,37,20-24,1935,2.106797637035763
STAT,1817,45,15-19,1862,0.0019931582691938682
STAT,1900,41,20-24,1941,0.03103696570405915
SIM,1802,57,na,1859,2257
SIM,1823,32,35-39,1855,27
STAT,1871,49,35-39,1920,0.27504687252548843
STAT,1938,32,40-44,1970,7.948231034600274
STAT,1834,30,45-49,1864,3.0357656831533077
SIM,1903,46,45-49,1949,1
STAT,1814,93,na,1907,25.15223793824718
SIM,1928,15,35-39,1943,16
SIM,1890,23,35-39,1913,23
STAT,1882,23,35-39,1905,11.445228715886993
STAT,1877,86,na,1963,835.6016402170627
STAT,1901,28,40-44,1929,8.439751633244684
STAT,1937,12,na,1949,7786.4583891315615
STAT,1888,19,45-49,1907,0.15509285793794028
STAT,1825,33,50-100,1858,2.9716109206345194
STAT,1809,54,20-24,1863,0.005224663685568288
SIM,1840,43,40-44,1883,11
STAT,1891,35,45-49,1926,5.023766985922863
STAT,1881,35,35-39,1916,13.93804353461124
STAT,1850,105,na,1955,0.04495649838231511
SIM,1918,21,25-29,1939,232
SIM,1861,36,na,1897,4519
STAT,1894,18,50-100,1912,0.12677136055786384
SIM,1862,38,50-100,1900,3
STAT,1936,26,25-29,1962,127.3009936947301
STAT,1852,19,30-34,1871,3.0363407262472166
STAT,1859,53,50-100,1912,0.02388770507977956
STAT,1884,36,15-19,1920,0.11252638575337837
STAT,1907,46,na,1953,6698.548977691341
STAT,1835,102,na,1937,0.37970319919714757
SIM,1855,25,35-39,1880,31
STAT,1923,49,25-29,1972,0.12455067263355708
SIM,1899,39,50-100,1938,1
STAT,1816,39,15-19,1855,0.3734832391143869
SIM,1851,81,na,1932,694
SIM,1921,31,25-29,1952,33
STAT,1882,50,40-44,1932,0.021009703678277078
SIM,1892,18,15-19,1910,15
STAT,1860,21,na,1881,4027.483948066423
STAT,1875,20,na,1895,4947.109745980968
SIM,1822,44,35-39,1866,5
SIM,1877,17,35-39,1894,2
SIM,1832,44,45-49,1876,6
STAT,1872,50,30-34,1922,0.012255756141037065
SIM,1842,30,45-49,1872,5
STAT,1827,31,15-19,1858,0.3701442275867213
STAT,1837,31,25-29,1868,18.08989786748253
STAT,1848,73,na,1921,1947.566636841433
SIM,1832,23,na,1855,3720
SIM,1834,89,na,1923,88
SIM,1860,19,30-34,1879,4
STAT,1880,21,na,1901,5047.0050776183325
STAT,1949,21,40-44,1970,7.925962534458007
SIM,1844,36,35-39,1880,14
STAT,1874,51,45-49,1925,0.03015402447411934
SIM,1854,36,45-49,1890,6
STAT,1839,37,15-19,1876,0.10478027858184646
STAT,1864,51,35-39,1915,0.015616378910840337
SIM,1830,75,na,1905,1204
STAT,1759,107,na,1866,0.006526765559033552
STAT,1864,35,na,1899,4293.661746808041
STAT,1847,25,35-39,1872,17.935209154992137
STAT,1894,22,15-19,1916,8.558977428489467
SIM,1909,24,15-19,1933,9
STAT,1845,30,20-24,1875,5.056414085245541
STAT,1837,39,35-39,1876,11.758336311880521
SIM,1853,38,30-34,1891,14
STAT,1827,39,25-29,1866,5.673773962483759
SIM,1880,50,30-34,1930,1
STAT,1913,31,25-29,1944,18.652457834109537
STAT,1869,17,35-39,1886,1.0886599522214893
SIM,1863,24,30-34,1887,53
SIM,1902,47,na,1949,6511
SIM,1934,24,na,1958,9681
STAT,1850,34,45-49,1884,2.7395225509386143
SIM,1878,34,40-44,1912,14
STAT,1840,34,35-39,1874,17.438459004952215
SIM,1831,31,30-34,1862,45
SIM,1853,4,na,1857,5115
SIM,1868,34,30-34,1902,44
SIM,1911,17,30-34,1928,7
SIM,1881,44,40-44,1925,8
STAT,1858,28,na,1886,3818.801805661509
STAT,1855,24,30-34,1879,30.929874978385403
STAT,1860,20,45-49,1880,1.3143618369851955
STAT,1842,25,20-24,1867,21.912801536931084
STAT,1890,22,30-34,1912,43.91005545571341
SIM,1874,54,na,1928,4000
SIM,1845,31,25-29,1876,27
SIM,1868,44,25-29,1912,3
SIM,1878,68,na,1946,3167
STAT,1908,41,45-49,1949,0.3129797562008951
STAT,1903,17,30-34,1920,4.583271033934876
STAT,1932,13,na,1945,10580.591282954058
STAT,1936,27,na,1963,7242.058182736966
STAT,1854,69,na,1923,2249.7253429418056
STAT,1847,43,35-39,1890,2.740359416022325
STAT,1846,36,45-49,1882,3.221933529087817
STAT,1948,18,15-19,1966,104.85244276064601
STAT,1888,26,35-39,1914,23.11166249050752
STAT,1836,36,35-39,1872,11.66608147871199
SIM,1878,30,25-29,1908,25
SIM,1850,25,20-24,1875,26
STAT,1798,58,na,1856,1945.3970534503999
STAT,1865,21,na,1886,4423.930878978788
STAT,1837,25,na,1862,3925.9473636610637
SIM,1844,18,35-39,1862,1
SIM,1918,29,35-39,1947,52
SIM,1830,27,50-100,1857,4
SIM,1855,43,35-39,1898,5
SIM,1938,27,na,1965,7544
STAT,1852,47,25-29,1899,0.09137547612425131
SIM,1916,23,45-49,1939,2
STAT,1873,44,40-44,1917,4.553337779490708
STAT,1840,41,25-29,1881,0.9793753175891369
STAT,1828,45,40-44,1873,0.31658781913818285
SIM,1858,17,na,1875,4576
STAT,1902,7,na,1909,7428.772358470944
STAT,1823,31,30-34,1854,114.13078538922584
STAT,1831,41,na,1872,3351.6614446593876
STAT,1835,55,na,1890,2677.982383442044
STAT,1849,38,15-19,1887,0.08995274660313109
STAT,1863,54,25-29,1917,0.006089728094347985
SIM,1927,24,50-100,1951,2
STAT,1870,28,35-39,1898,19.064813057458128
SIM,1773,82,na,1855,251
STAT,1842,47,15-19,1889,5.956247673045465E-4
STAT,1924,25,50-100,1949,2.3558157090666083
STAT,1847,36,50-100,1883,1.9620319500390766
STAT,1878,25,35-39,1903,20.490569318082922
SIM,1937,20,50-100,1957,1
STAT,1871,8,na,1879,5449.578143890037
STAT,1886,46,na,1932,4810.149561505654
STAT,1862,33,25-29,1895,17.60618333250543
STAT,1858,4,na,1862,4902.039489289498
SIM,1855,40,na,1895,4110
STAT,1829,111,na,1940,1.2702896237935422E-4
STAT,1873,29,15-19,1902,0.9243688781330379
STAT,1883,39,na,1922,4627.851948847051
STAT,1854,58,na,1912,3031.6317829786317
STAT,1929,20,50-100,1949,1.6903637978188437
SIM,1886,25,35-39,1911,24
SIM,1881,36,na,1917,4053
STAT,1936,17,50-100,1953,0.7245702019031115
STAT,1775,85,na,1860,124.10131405671427
SIM,1937,7,na,1944,8020
SIM,1844,88,na,1932,142
SIM,1829,28,45-49,1857,1
SIM,1855,36,50-100,1891,4
STAT,1850,16,15-19,1866,11.185039415904066
STAT,1902,47,na,1949,6386.3546309496405
STAT,1921,36,45-49,1957,1.538348231107833
STAT,1879,50,20-24,1929,0.0015812389692824475
STAT,1899,19,20-24,1918,48.794220434234305
SIM,1819,41,25-29,1860,1
STAT,1921,15,25-29,1936,100.2010512843547
STAT,1896,46,35-39,1942,0.2111701213964057
SIM,1914,39,30-34,1953,5
SIM,1929,3,na,1932,10764
STAT,1878,32,25-29,1910,21.604732282949662
SIM,1837,31,50-100,1868,3
STAT,1872,23,40-44,1895,4.216521775625874
STAT,1900,36,na,1936,6684.666248698768
STAT,1891,17,15-19,1908,14.814906297019455
STAT,1901,24,25-29,1925,160.84123041886892
SIM,1886,32,25-29,1918,4
SIM,1847,55,na,1902,3123
SIM,1903,18,35-39,1921,2
SIM,1878,38,35-39,1916,24
SIM,1860,37,30-34,1897,3
STAT,1861,41,45-49,1902,2.5272483946414748
SIM,1853,23,30-34,1876,48
STAT,1847,18,45-49,1865,0.1235459464751989
STAT,1936,16,30-34,1952,23.630583624363386
STAT,1845,23,30-34,1868,33.8297484650041
STAT,1842,29,15-19,1871,0.8233783494430823
SIM,1868,49,30-34,1917,1
STAT,1834,49,30-34,1883,0.13319588825245957
STAT,1914,6,na,1920,8347.486209322777
STAT,1932,36,20-24,1968,0.7160269649500203
STAT,1829,31,50-100,1860,1.807669506857149
SIM,1832,26,15-19,1858,1
STAT,1852,37,30-34,1889,8.540426306287761
SIM,1795,81,na,1876,401
SIM,1939,22,35-39,1961,23
STAT,1840,16,35-39,1856,1.0315375401899023
STAT,1849,41,45-49,1890,2.3780946627301423
SIM,1886,35,na,1921,4984
STAT,1883,26,20-24,1909,23.358291795640007
SIM,1867,28,50-100,1895,1
SIM,1856,33,50-100,1889,2
SIM,1857,41,45-49,1898,7
SIM,1944,16,30-34,1960,33
STAT,1858,46,15-19,1904,6.315548244049585E-4
SIM,1869,47,45-49,1916,2
SIM,1891,33,45-49,1924,1
STAT,1837,21,30-34,1858,32.742052367624105
STAT,1963,4,na,1967,10088.305551087988
SIM,1787,85,na,1872,154
SIM,1830,28,35-39,1858,19
STAT,1820,45,na,1865,2960.286900414579
STAT,1868,43,20-24,1911,0.30295899939866455
STAT,1906,39,30-34,1945,3.3513214350815694
STAT,1839,52,40-44,1891,0.016350661526906618
SIM,1807,56,na,1863,2110
STAT,1805,89,na,1894,78.58101895472623
SIM,1870,26,35-39,1896,30
SIM,1870,95,na,1965,87
SIM,1952,18,30-34,1970,48
STAT,1928,42,25-29,1970,0.1838260628115829
SIM,1845,29,40-44,1874,8
STAT,1845,38,30-34,1883,8.539701111485769
STAT,1850,49,15-19,1899,6.00501999566727E-4
STAT,1837,29,40-44,1866,5.283315481214709
STAT,1872,87,na,1959,516.6088478762023
SIM,1817,89,na,1906,73
STAT,1831,25,45-49,1856,1.9895119831339727
SIM,1918,36,25-29,1954,4
STAT,1898,44,45-49,1942,0.2802150335519113
SIM,1951,16,na,1967,9151
STAT,1836,47,40-44,1883,0.23826867536736235
SIM,1908,21,45-49,1929,3
STAT,1862,26,35-39,1888,16.838292983747447
STAT,1873,0,na,1873,7588.0255259078
STAT,1830,27,30-34,1857,58.105880335209214
STAT,1930,42,45-49,1972,0.44225008891918133
SIM,1939,23,na,1962,8109
SIM,1938,33,45-49,1971,6
SIM,1903,5,na,1908,7737
SIM,1882,21,35-39,1903,14
SIM,1861,29,25-29,1890,97
SIM,1877,83,na,1960,954
STAT,1832,26,na,1858,3753.8373697125435
SIM,1827,40,20-24,1867,3
STAT,1906,46,20-24,1952,0.019977346989309742
STAT,1893,48,25-29,1941,0.0821284230707924
SIM,1796,99,na,1895,1
STAT,1894,40,45-49,1934,3.922058155650026
STAT,1886,8,na,1894,5542.083280444353
STAT,1928,23,50-100,1951,1.6538245681719441
SIM,1936,17,35-39,1953,13
STAT,1886,31,20-24,1917,5.786316307143784
SIM,1846,37,50-100,1883,6
SIM,1884,21,na,1905,5144
SIM,1916,50,na,1966,7657
SIM,1881,15,35-39,1896,1
STAT,1903,48,45-49,1951,0.37799540995187825
STAT,1823,50,35-39,1873,0.02664436467261644
SIM,1893,68,na,1961,4245
SIM,1936,24,25-29,1960,161
SIM,1931,9,na,1940,10541
STAT,1936,9,na,1945,7698.860587809479
SIM,1837,22,na,1859,3783
SIM,1855,95,na,1950,7
STAT,1863,19,40-44,1882,0.3318261034862419
STAT,1832,43,40-44,1875,3.54140063706861
SIM,1926,20,20-24,1946,295
STAT,1873,15,35-39,1888,1.1393641389215257
STAT,1896,28,35-39,1924,25.637612761469885
SIM,1915,10,na,1925,8453
SIM,1919,24,na,1943,8105
STAT,1872,54,na,1926,4250.1893487783655
STAT,1884,35,na,1919,4743.077501941617
STAT,1837,66,na,1903,2284.37943746826
STAT,1928,17,35-39,1945,10.676653317447302
STAT,1822,53,25-29,1875,0.010386212920514224
SIM,1862,35,40-44,1897,12
STAT,1890,41,35-39,1931,4.484136598948617
SIM,1827,33,30-34,1860,44
STAT,1794,99,na,1893,0.7418267818305131
STAT,1853,29,25-29,1882,69.5470086804706
STAT,1921,19,50-100,1940,0.8576607749402256
SIM,1920,32,na,1952,8527
STAT,1819,40,20-24,1859,0.7811446254758215
STAT,1790,85,na,1875,161.80676217853505
SIM,1872,32,30-34,1904,49
STAT,1849,58,na,1907,3128.160237186747
SIM,1926,28,30-34,1954,111
STAT,1886,24,30-34,1910,37.73703601182053
SIM,1871,26,30-34,1897,54
SIM,1894,39,30-34,1933,18
STAT,1945,16,50-100,1961,0.8267262480936239
SIM,1894,24,30-34,1918,61
STAT,1854,35,40-44,1889,6.813336649092745
STAT,1822,46,35-39,1868,0.44154650519580285
STAT,1921,33,25-29,1954,20.68035024216753
SIM,1837,37,35-39,1874,23
SIM,1895,37,45-49,1932,7
STAT,1819,48,30-34,1867,0.40015388459294543
STAT,1928,24,25-29,1952,231.42558752620664
STAT,1853,21,15-19,1874,6.2119212725169195
STAT,1876,34,15-19,1910,0.29492283910107353
STAT,1918,20,20-24,1938,243.60878239016057
SIM,1839,40,50-100,1879,2
STAT,1896,20,25-29,1916,153.55206438880748
STAT,1887,37,45-49,1924,4.502873166204099
STAT,1844,38,35-39,1882,11.945399066036444
SIM,1835,74,na,1909,1375
SIM,1839,88,na,1927,178
STAT,1880,52,30-34,1932,0.012597064122194966
SIM,1852,38,35-39,1890,22
SIM,1875,7,na,1882,6048
STAT,1842,32,45-49,1874,3.1363072443257756
STAT,1865,45,45-49,1910,0.4373324303960244
STAT,1918,28,30-34,1946,83.9050627751291
STAT,1886,39,30-34,1925,11.247996708632108
SIM,1861,21,15-19,1882,7
STAT,1820,40,45-49,1860,6.3992496231003155
SIM,1873,45,45-49,1918,1
STAT,1835,53,30-34,1888,0.007706215939747177
STAT,1948,21,45-49,1969,2.609856220471291
STAT,1838,37,50-100,1875,2.005015955074429
STAT,1863,26,30-34,1889,44.84105619890716
SIM,1878,27,30-34,1905,69
STAT,1905,47,15-19,1952,6.559524510903151E-4
STAT,1851,24,50-100,1875,0.7441083373373824
SIM,1853,45,40-44,1898,1
SIM,1865,36,20-24,1901,5
STAT,1859,34,na,1893,3803.127169826593
SIM,1818,39,25-29,1857,6
STAT,1909,30,20-24,1939,4.741257524441443
SIM,1910,36,50-100,1946,4
SIM,1921,42,50-100,1963,1
STAT,1930,31,25-29,1961,24.103659467059153
STAT,1802,53,20-24,1855,0.004635477917731833
SIM,1886,56,na,1942,4159
STAT,1840,18,50-100,1858,0.09101978797280089
SIM,1880,41,na,1921,5149
STAT,1820,44,25-29,1864,2.4546439120310906
STAT,1927,21,25-29,1948,230.49969551049548
STAT,1944,15,na,1959,8003.577059458132
STAT,1862,30,50-100,1892,1.5943375300443094
STAT,1902,46,35-39,1948,0.22581485283731145
SIM,1890,20,30-34,1910,55
SIM,1852,22,na,1874,4112
STAT,1877,48,40-44,1925,0.3545222159691878
STAT,1907,42,20-24,1949,0.03269569558857808
SIM,1896,18,35-39,1914,4
STAT,1912,40,20-24,1952,0.034799188085866385
SIM,1932,20,45-49,1952,4
STAT,1860,46,20-24,1906,0.019736872754917315
SIM,1825,44,na,1869,2858
STAT,1836,61,na,1897,2484.5064064068047
STAT,1897,16,35-39,1913,1.484956350564932
STAT,1880,29,50-100,1909,1.3512649970868125
SIM,1905,31,40-44,1936,12
SIM,1795,60,na,1855,1986
SIM,1923,22,45-49,1945,4
SIM,1855,22,50-100,1877,1
SIM,1917,30,20-24,1947,5
STAT,1899,27,50-100,1926,1.7701175414202488
SIM,1896,1,na,1897,7442
SIM,1901,48,35-39,1949,1
SIM,1846,91,na,1937,49
STAT,1876,91,na,1967,365.84581700926196
SIM,1930,32,45-49,1962,8
STAT,1837,46,45-49,1883,0.34593054297690007
STAT,1865,31,35-39,1896,18.65718928230245
SIM,1859,54,na,1913,3671
SIM,1811,45,35-39,1856,1
SIM,1871,18,30-34,1889,5
STAT,1834,32,50-100,1866,1.5622795145601296
SIM,1818,72,na,1890,1183
STAT,1854,43,40-44,1897,3.423202865103487
STAT,1913,34,45-49,1947,3.1356127454844502
STAT,1845,45,40-44,1890,0.26643824261696153
STAT,1863,18,30-34,1881,2.9087599540928433
STAT,1904,50,na,1954,6331.338796920722
SIM,1903,63,na,1966,5760
SIM,1887,25,30-34,1912,83
SIM,1943,28,na,1971,8174
SIM,1928,26,40-44,1954,14
STAT,1879,25,30-34,1904,53.55708727590296
STAT,1924,20,45-49,1944,2.69668779058824
STAT,1876,16,na,1892,5288.594000965715
SIM,1838,72,na,1910,1665
STAT,1864,39,15-19,1903,0.1003560553746645
STAT,1811,51,20-24,1862,0.004875241388938626
STAT,1911,44,35-39,1955,0.38350078416911487
STAT,1922,32,45-49,1954,3.5898038251188313
SIM,1878,37,na,1915,5132
STAT,1828,42,na,1870,3250.0344904611593
STAT,1882,20,30-34,1902,35.252918053732756
STAT,1873,37,15-19,1910,0.11523231225086061
SIM,1867,16,15-19,1883,16
SIM,1910,46,35-39,1956,1
SIM,1921,34,45-49,1955,7
STAT,1840,76,na,1916,1367.5206617845568
STAT,1870,11,na,1881,5275.125429508806
STAT,1915,22,45-49,1937,2.3491665355968254
STAT,1875,50,35-39,1925,0.018158509427070146
SIM,1895,33,50-100,1928,5
SIM,1837,55,na,1892,2756
STAT,1833,21,50-100,1854,0.8921168642468952
SIM,1807,101,na,1908,2
SIM,1810,46,30-34,1856,1
SIM,1886,66,na,1952,3280
SIM,1932,34,20-24,1966,9
SIM,1881,37,15-19,1918,1
STAT,1899,64,na,1963,5191.674094971262
SIM,1812,42,50-100,1854,6
STAT,1929,42,40-44,1971,0.6541299951777465
STAT,1874,43,50-100,1917,2.1688710634505988
SIM,1907,18,20-24,1925,48
SIM,1949,18,25-29,1967,135
STAT,1901,40,45-49,1941,0.29681282394597464
STAT,1944,25,na,1969,8183.756389312182
STAT,1822,32,40-44,1854,27.821093967426247
SIM,1850,11,na,1861,4660
SIM,1855,40,30-34,1895,4
STAT,1855,102,na,1957,0.6355738611901035
STAT,1821,36,40-44,1857,18.26081557202618
STAT,1845,50,50-100,1895,0.02360679925179735
STAT,1889,64,na,1953,4328.91723065719
SIM,1835,54,35-39,1889,1
SIM,1912,41,40-44,1953,1
STAT,1929,34,50-100,1963,2.1180826299057736
SIM,1878,47,na,1925,4913
SIM,1838,62,na,1900,2504
SIM,1888,47,na,1935,5285
STAT,1807,104,na,1911,0.053240468512028044
STAT,1894,3,na,1897,6858.6553122398145
STAT,1886,46,40-44,1932,0.3660248376412458
SIM,1830,32,40-44,1862,8
STAT,1811,46,25-29,1857,0.39781097594282944
STAT,1954,18,40-44,1972,3.490676006630876
STAT,1925,36,50-100,1961,1.0184422931822217
STAT,1827,54,35-39,1881,0.0131250787010228
STAT,1870,36,35-39,1906,14.091881542482435
STAT,1891,35,50-100,1926,3.0940229221330924
STAT,1765,95,na,1860,4.453333293718525
SIM,1906,37,30-34,1943,2
STAT,1823,38,15-19,1861,0.2093363450021425
STAT,1923,43,15-19,1966,0.003618126995559463
SIM,1837,26,30-34,1863,52
STAT,1882,53,45-49,1935,0.028093247377924305
SIM,1867,5,na,1872,5734
STAT,1810,56,na,1866,2268.4122914396926
SIM,1952,17,50-100,1969,1
SIM,1859,0,na,1859,6686
STAT,1865,7,na,1872,5142.659614962936
SIM,1941,27,na,1968,7910
SIM,1860,7,na,1867,5014
STAT,1765,108,na,1873,0.009107351983930319
SIM,1912,36,na,1948,7669
STAT,1862,41,25-29,1903,1.1135079327884148
SIM,1935,21,25-29,1956,327
SIM,1838,25,35-39,1863,27
SIM,1899,19,15-19,1918,16
SIM,1848,17,na,1865,4400
STAT,1842,46,50-100,1888,0.37042948164085826
STAT,1847,40,30-34,1887,1.8080000847488802
STAT,1863,36,45-49,1899,3.5412490651355175
SIM,1896,66,na,1962,4753
SIM,1891,35,50-100,1926,2
STAT,1904,41,40-44,1945,0.4548153661064697
STAT,1780,109,na,1889,0.005986414029896244
STAT,1894,45,35-39,1939,0.20692642479739315
STAT,1870,45,50-100,1915,0.4918373772304125
SIM,1829,26,na,1855,3652
SIM,1846,36,na,1882,3829
STAT,1864,17,35-39,1881,1.0247432049955567
STAT,1822,57,na,1879,2467.491934599002
STAT,1868,17,na,1885,4940.886807426157
STAT,1873,49,na,1922,4520.4042822358415
SIM,1895,39,na,1934,6448
STAT,1885,47,35-39,1932,0.28012937110764247
SIM,1828,72,na,1900,1522
STAT,1844,53,25-29,1897,0.005628204813005949
SIM,1916,16,20-24,1932,49
STAT,1899,39,50-100,1938,0.7259046132655299
STAT,1792,97,na,1889,1.9883085442259174
STAT,1870,40,20-24,1910,0.31807624995519634
SIM,1835,20,na,1855,3840
SIM,1840,21,na,1861,4324
SIM,1906,19,15-19,1925,17
SIM,1896,56,na,1952,5609
STAT,1881,68,na,1949,2983.1658164918736
STAT,1946,16,40-44,1962,3.1338198799471537
STAT,1878,44,40-44,1922,4.680358581183126
SIM,1849,18,20-24,1867,41
STAT,1852,52,20-24,1904,0.001169842465900477
SIM,1872,17,35-39,1889,1
STAT,1866,91,na,1957,137.6982761183009
SIM,1863,19,35-39,1882,1
STAT,1810,48,30-34,1858,0.619371055956087
STAT,1839,41,35-39,1880,3.3169659873008874
STAT,1929,6,na,1935,10329.583112718596
SIM,1911,47,50-100,1958,2
STAT,1898,16,50-100,1914,0.1342279611493558
STAT,1934,8,na,1942,10896.884849610304
SIM,1847,41,35-39,1888,4
STAT,1840,86,na,1926,320.26503611678385
SIM,1954,16,40-44,1970,4
STAT,1830,34,40-44,1864,8.307426189977306
SIM,1886,44,40-44,1930,7
STAT,1808,104,na,1912,0.05241295384005239
STAT,1895,44,40-44,1939,0.405497421146011
SIM,1848,72,na,1920,1787
STAT,1828,53,40-44,1881,0.016338516250254252
STAT,1839,48,50-100,1887,0.38574954650629045
SIM,1945,18,40-44,1963,2
SIM,1877,46,40-44,1923,1
SIM,1868,37,na,1905,4545
STAT,1840,38,15-19,1878,0.09487880512022069
STAT,1913,33,na,1946,7569.380233013906
STAT,1845,44,na,1889,3534.9643573335
SIM,1906,30,45-49,1936,4
STAT,1858,18,20-24,1876,32.41302636288909
STAT,1826,61,na,1887,2327.296199871736
SIM,1879,26,35-39,1905,24
STAT,1838,42,na,1880,3327.6195696894856
STAT,1890,29,15-19,1919,1.1104537545724382
STAT,1829,29,35-39,1858,20.968303961964548
SIM,1919,28,40-44,1947,14
STAT,1853,44,35-39,1897,2.8263991049897994
STAT,1838,17,40-44,1855,0.32697529613693055
STAT,1820,37,35-39,1857,35.170497518552494
STAT,1943,22,20-24,1965,238.92045076892816
STAT,1880,40,50-100,1920,2.2703584145687286
STAT,1861,45,25-29,1906,0.09779139717202051
STAT,1859,16,15-19,1875,11.139233337570506
SIM,1858,19,25-29,1877,18
SIM,1926,26,na,1952,9258
STAT,1923,21,40-44,1944,7.92256073898839
SIM,1888,37,na,1925,5553
STAT,1855,22,50-100,1877,0.7183805202138613
STAT,1869,35,15-19,1904,0.11093473093438426
SIM,1931,21,40-44,1952,10
SIM,1866,18,20-24,1884,1
STAT,1889,47,20-24,1936,0.01677779987196478
SIM,1836,91,na,1927,44
SIM,1850,41,na,1891,3735
SIM,1862,22,na,1884,4425
SIM,1837,29,35-39,1866,25
SIM,1855,5,na,1860,5295
SIM,1877,28,25-29,1905,93
STAT,1895,25,15-19,1920,1.2020777993040035
STAT,1937,18,40-44,1955,2.7414832622292225
STAT,1869,46,40-44,1915,0.33597925498079295
SIM,1924,6,na,1930,10026
STAT,1792,87,na,1879,116.41292415976196
STAT,1904,41,25-29,1945,0.12984751854707885
STAT,1818,42,na,1860,3028.6936637743706
SIM,1879,64,na,1943,3554
STAT,1922,8,na,1930,9319.719651467698
SIM,1910,11,na,1921,8298
STAT,1854,80,na,1934,948.300244506626
STAT,1933,32,20-24,1965,6.639361994589935
SIM,1856,91,na,1947,65
STAT,1903,42,35-39,1945,0.36114708322441996
STAT,1863,37,50-100,1900,2.1705272538272236
STAT,1914,31,40-44,1945,7.989480945899561
STAT,1855,19,35-39,1874,0.9725715263423368
STAT,1900,6,na,1906,7318.844260170902
SIM,1903,53,na,1956,6256
STAT,1914,45,15-19,1959,7.414362349105242E-4
STAT,1838,24,30-34,1862,30.829158472227487
STAT,1890,47,45-49,1937,0.32664061730657423
STAT,1938,17,45-49,1955,0.9953669780631783
STAT,1911,47,50-100,1958,0.43257626560427354
STAT,1869,34,na,1903,4629.884907496631
STAT,1908,32,na,1940,7214.750364699598
SIM,1875,19,na,1894,5645
STAT,1811,47,35-39,1858,0.9503788742468193
STAT,1772,97,na,1869,1.4883463401725652
SIM,1821,34,40-44,1855,9
STAT,1908,16,20-24,1924,53.278715526693865
STAT,1930,34,45-49,1964,4.096023148267149
SIM,1903,28,50-100,1931,2
STAT,1892,20,na,1912,6015.22004834228
SIM,1846,24,30-34,1870,43
STAT,1828,34,15-19,1862,0.30064454294849685
STAT,1835,75,na,1910,1333.2994237745577
SIM,1846,19,35-39,1865,1
STAT,1884,48,30-34,1932,0.1906197598807456
STAT,1848,46,20-24,1894,0.0197323528683345
STAT,1918,28,50-100,1946,2.1314289459451308
SIM,1894,20,15-19,1914,10
STAT,1905,14,na,1919,7518.523335276433
STAT,1916,51,na,1967,7513.197917809151
SIM,1870,26,50-100,1896,2
SIM,1885,38,50-100,1923,1
STAT,1784,78,na,1862,491.9016972496823
SIM,1922,31,40-44,1953,15
STAT,1886,20,15-19,1906,7.075294609902909
STAT,1928,28,40-44,1956,11.590074311737176
SIM,1936,28,40-44,1964,10
SIM,1912,41,25-29,1953,1
SIM,1845,43,40-44,1888,11
SIM,1894,31,na,1925,6597
STAT,1877,53,na,1930,4443.031558706484
STAT,1880,25,40-44,1905,6.416519348369618
STAT,1889,34,na,1923,5891.593120699978
SIM,1848,92,na,1940,41
STAT,1910,48,35-39,1958,0.2423570247273398
SIM,1915,20,45-49,1935,1
STAT,1837,43,40-44,1880,3.653032622090824
STAT,1838,19,35-39,1857,0.9694045556969553
STAT,1927,23,na,1950,9057.2343694099
STAT,1860,47,30-34,1907,0.1580198711219164
STAT,1862,77,na,1939,1492.1147951422934
STAT,1869,23,50-100,1892,0.795555287894947
SIM,1828,62,na,1890,2189
STAT,1832,22,50-100,1854,1.2840047618925579
STAT,1858,50,35-39,1908,0.013749040960407388
STAT,1904,19,40-44,1923,0.5273450675267266
STAT,1794,78,na,1872,640.8179759931788
SIM,1840,22,50-100,1862,1
SIM,1862,24,15-19,1886,7
STAT,1824,38,na,1862,3031.741653578507
STAT,1870,35,25-29,1905,5.763169218861274
STAT,1907,45,50-100,1952,0.41533334147290835
SIM,1895,27,30-34,1922,85
STAT,1854,90,na,1944,120.86158639415487
SIM,1875,40,na,1915,5207
SIM,1811,44,25-29,1855,2
SIM,1828,36,30-34,1864,13
SIM,1856,47,50-100,1903,1
STAT,1824,30,35-39,1854,64.98823277851689
STAT,1883,49,na,1932,4371.087983984961
STAT,1826,71,na,1897,1597.8965548284102
SIM,1925,32,20-24,1957,6
STAT,1877,52,25-29,1929,0.007388617468736914
STAT,1887,0,na,1887,7111.993154727465
STAT,1835,48,35-39,1883,0.18877760604585414
SIM,1873,44,50-100,1917,5
STAT,1801,65,na,1866,1738.2848392859714
STAT,1823,46,15-19,1869,0.0012536622833187155
STAT,1845,48,45-49,1893,0.35909140966207437
SIM,1832,77,na,1909,1108
STAT,1860,76,na,1936,1553.8204708745798
STAT,1909,33,25-29,1942,17.747406270316393
STAT,1903,33,na,1936,6891.152253139754
STAT,1956,1,na,1957,10521.204808914878
SIM,1915,45,50-100,1960,2
STAT,1775,95,na,1870,3.7044161356461305
SIM,1921,31,40-44,1952,20
STAT,1921,41,40-44,1962,0.5696507975003006
STAT,1874,36,20-24,1910,1.6017220802113112
STAT,1880,18,30-34,1898,3.382189006006489
STAT,1852,45,30-34,1897,0.1558189443616988
STAT,1910,30,45-49,1940,3.0900584942953704
STAT,1856,33,50-100,1889,1.4302781152818247
STAT,1905,32,45-49,1937,2.9245857436047262
STAT,1912,43,25-29,1955,0.13829782782456618
SIM,1836,27,25-29,1863,8
STAT,1885,82,na,1967,1579.137929717568
SIM,1846,27,35-39,1873,26
SIM,1936,26,na,1962,6437
STAT,1843,54,20-24,1897,0.001005264742641963
STAT,1923,35,15-19,1958,0.0450012606958255
STAT,1895,18,25-29,1913,14.873664329159768
STAT,1933,35,25-29,1968,2.713498599105656
SIM,1940,22,45-49,1962,3
STAT,1856,16,na,1872,4254.439865696881
STAT,1824,105,na,1929,0.03134778410090812
STAT,1913,49,15-19,1962,7.220708389607729E-4
SIM,1889,16,35-39,1905,2
STAT,1911,43,25-29,1954,0.13686334828732308
SIM,1821,42,40-44,1863,8
SIM,1853,93,na,1946,43
SIM,1949,13,na,1962,9609
STAT,1860,11,na,1871,4536.151944629495
SIM,1832,30,35-39,1862,30
STAT,1916,18,20-24,1934,57.94041293169488
STAT,1817,51,50-100,1868,0.07132044915109771
STAT,1932,33,15-19,1965,0.3448205277488921
STAT,1880,33,40-44,1913,9.187744401657417
STAT,1845,85,na,1930,422.42352462459297
STAT,1870,33,30-34,1903,34.473508717909716
STAT,1939,24,na,1963,7402.6342172669265
SIM,1843,48,35-39,1891,1
STAT,1880,52,50-100,1932,0.03196114607870788
STAT,1838,27,35-39,1865,16.611552638315946
STAT,1813,42,40-44,1855,16.7137992215898
STAT,1828,27,25-29,1855,144.06755800014759
SIM,1880,23,40-44,1903,6
SIM,1931,27,na,1958,9803
SIM,1933,28,na,1961,10425
STAT,1869,54,40-44,1923,0.020035432830671492
STAT,1859,54,30-34,1913,0.009305527123171758
STAT,1931,22,45-49,1953,2.947386853073324
STAT,1822,35,45-49,1857,8.66876232923284
STAT,1811,43,20-24,1854,1.221239109266062
STAT,1852,48,35-39,1900,0.22032975357987297
STAT,1903,45,40-44,1948,0.2804646116141641
STAT,1760,96,na,1856,0.37476435239999994
STAT,1913,31,40-44,1944,7.897446689721303
SIM,1949,15,20-24,1964,317
SIM,1882,0,na,1882,7107
STAT,1788,82,na,1870,341.3577986891392
STAT,1850,20,35-39,1870,10.894987552194987
STAT,1900,46,na,1946,6322.280320650947
STAT,1873,30,30-34,1903,36.11631309993068
SIM,1896,44,50-100,1940,1
STAT,1876,16,15-19,1892,12.426890024359075
STAT,1846,61,na,1907,2862.206165597117
STAT,1893,46,30-34,1939,0.14017454534563964
SIM,1921,27,na,1948,8433
SIM,1891,67,na,1958,4498
SIM,1851,47,30-34,1898,1
STAT,1886,36,na,1922,5046.983064426793
SIM,1876,66,na,1942,3580
SIM,1813,63,na,1876,1969
STAT,1863,33,40-44,1896,7.634529752658773
STAT,1778,82,na,1860,333.53124709082914
SIM,1941,22,50-100,1963,2
STAT,1891,21,35-39,1912,14.61156878300857
SIM,1923,37,30-34,1960,7
STAT,1843,47,30-34,1890,0.13496698509479063
STAT,1909,58,na,1967,6471.107931554171
SIM,1928,29,45-49,1957,9
STAT,1813,53,50-100,1866,0.08704122645714008
STAT,1830,41,15-19,1871,0.025104110154954788
SIM,1883,38,na,1921,4852
STAT,1854,24,15-19,1878,5.857198473045719
SIM,1823,73,na,1896,1195
SIM,1830,35,45-49,1865,5
STAT,1875,10,na,1885,5483.675558008972
STAT,1917,32,20-24,1949,5.158050654266582
SIM,1959,0,na,1959,10872
STAT,1906,43,15-19,1949,0.0028018459830227082
STAT,1894,65,na,1959,4587.517397895891
STAT,1940,21,40-44,1961,6.920406288984709
SIM,1841,35,20-24,1876,6
SIM,1884,49,35-39,1933,1
SIM,1888,42,35-39,1930,2
STAT,1836,51,25-29,1887,0.004861465897250213
STAT,1846,18,30-34,1864,3.048758020588811
SIM,1854,18,30-34,1872,9
STAT,1833,43,na,1876,3306.0080236247295
STAT,1876,49,35-39,1925,0.28633443129251557
STAT,1906,32,45-49,1938,2.94677816066355
SIM,1887,17,30-34,1904,6
STAT,1886,49,45-49,1935,0.4926332991400545
STAT,1915,44,20-24,1959,0.035792246825237954
SIM,1894,49,45-49,1943,1
SIM,1937,16,40-44,1953,4
STAT,1888,44,50-100,1932,2.4877796315245444
SIM,1869,44,40-44,1913,8
STAT,1863,40,15-19,1903,0.02466075718305354
STAT,1887,27,30-34,1914,56.88069064555959
SIM,1910,55,na,1965,6908
SIM,1914,32,45-49,1946,5
SIM,1881,30,30-34,1911,39
STAT,1833,35,20-24,1868,1.296103374007614
STAT,1911,36,35-39,1947,4.742315983250472
STAT,1854,28,30-34,1882,40.17851847740073
SIM,1872,33,50-100,1905,4
SIM,1908,17,25-29,1925,23
SIM,1807,79,na,1886,532
SIM,1931,39,30-34,1970,7
STAT,1853,94,na,1947,31.62200128792824
SIM,1837,45,na,1882,3201
STAT,1878,47,45-49,1925,0.4954742150259639
STAT,1854,17,25-29,1871,10.391751605764675
STAT,1871,42,15-19,1913,0.02767551540206897
STAT,1902,21,20-24,1923,197.08660594497465
STAT,1946,19,45-49,1965,1.1181581887544578
SIM,1838,17,na,1855,4268
SIM,1843,93,na,1936,29
STAT,1841,52,45-49,1893,0.020944400562150526
STAT,1904,15,25-29,1919,16.50269011515164
SIM,1828,29,40-44,1857,6
SIM,1895,19,30-34,1914,6
SIM,1873,31,35-39,1904,4
STAT,1785,95,na,1880,5.514090286839611
STAT,1841,26,15-19,1867,0.8235416558716033
STAT,1864,47,15-19,1911,7.187566135671178E-4
STAT,1915,37,30-34,1952,3.718762788367362
STAT,1846,26,30-34,1872,46.99924789419125
SIM,1908,62,na,1970,6020
SIM,1916,19,25-29,1935,112
SIM,1862,28,30-34,1890,49
STAT,1872,77,na,1949,1754.4917556292448
STAT,1901,21,20-24,1922,195.42929091750506
SIM,1845,19,na,1864,4666
STAT,1900,48,40-44,1948,0.267156298411439
SIM,1862,17,25-29,1879,17
STAT,1888,41,30-34,1929,2.7567504038223936
STAT,1860,54,20-24,1914,0.0011769678708028026
SIM,1862,43,40-44,1905,8
STAT,1828,52,na,1880,2833.4161255297736
STAT,1901,47,30-34,1948,0.15366382450222033
STAT,1885,44,30-34,1929,2.279977152468758
SIM,1828,28,30-34,1856,55
SIM,1870,41,na,1911,4569
SIM,1909,31,25-29,1940,23
SIM,1939,13,na,1952,8218
SIM,1912,15,25-29,1927,28
STAT,1818,53,30-34,1871,0.024667231027181307
STAT,1836,71,na,1907,1774.7284313301109
STAT,1919,48,na,1967,8023.5864133289815
STAT,1923,39,30-34,1962,4.2545658141136675
STAT,1921,33,40-44,1954,8.756055905062453
SIM,1845,10,na,1855,4962
STAT,1888,17,na,1905,6028.786319741028
STAT,1882,45,45-49,1927,0.4689345433478275
SIM,1855,74,na,1929,1759
SIM,1886,47,45-49,1933,2
SIM,1815,44,na,1859,2750
SIM,1870,34,35-39,1904,30
SIM,1870,19,25-29,1889,18
SIM,1846,16,30-34,1862,2
SIM,1939,29,20-24,1968,4
STAT,1850,76,na,1926,1452.6253793419914
STAT,1804,51,15-19,1855,1.467686365812742E-4
SIM,1776,79,na,1855,393
SIM,1910,21,20-24,1931,199
SIM,1822,46,na,1868,2900
STAT,1862,19,25-29,1881,10.07519857919313
STAT,1854,35,na,1889,3666.9458085864544
STAT,1803,52,25-29,1855,0.026021542949009553
STAT,1877,45,35-39,1922,0.29652923637330836
STAT,1910,36,50-100,1946,0.8151759335458869
SIM,1924,18,20-24,1942,328
SIM,1808,96,na,1904,2
SIM,1856,46,20-24,1902,1
SIM,1822,77,na,1899,859
STAT,1898,30,35-39,1928,27.900640853645438
SIM,1870,33,25-29,1903,20
STAT,1823,105,na,1928,0.03518484754352417
STAT,1830,37,45-49,1867,3.736000398124617
SIM,1893,14,na,1907,6829
STAT,1887,19,30-34,1906,3.5809133790548056
STAT,1922,33,40-44,1955,8.889819586435548
SIM,1858,18,15-19,1876,10
STAT,1861,38,35-39,1899,11.83066774605014
STAT,1939,31,45-49,1970,3.244843389678046
STAT,1866,16,na,1882,4859.375284000159
STAT,1870,43,25-29,1913,1.264088528239357
SIM,1854,26,30-34,1880,51
STAT,1770,96,na,1866,2.5140909571550383
STAT,1879,18,40-44,1897,0.38536621292107204
SIM,1838,17,35-39,1855,1
STAT,1906,31,na,1937,7111.4615239192935
STAT,1844,80,na,1924,998.9798257646141
STAT,1908,19,25-29,1927,16.8971227775574
STAT,1895,29,30-34,1924,65.79581643863116
SIM,1887,28,35-39,1915,34
STAT,1917,17,50-100,1934,0.16281371982207335
SIM,1836,38,30-34,1874,10
STAT,1838,16,30-34,1854,2.866238181349667
SIM,1845,46,45-49,1891,3
STAT,1923,46,20-24,1969,0.02616593846879768
SIM,1864,15,35-39,1879,2
SIM,1913,53,na,1966,7189
STAT,1859,16,50-100,1875,0.09195842941784271
STAT,1953,16,50-100,1969,0.9155040939612508
SIM,1872,22,na,1894,5041
SIM,1819,35,50-100,1854,4
SIM,1854,19,40-44,1873,1
STAT,1867,53,na,1920,4007.1651101693747
STAT,1872,16,30-34,1888,3.265013901519762
SIM,1842,56,na,1898,2895
STAT,1941,27,30-34,1968,81.86502090620577
SIM,1921,19,50-100,1940,1
STAT,1811,44,30-34,1855,8.304503469579954
SIM,1852,43,30-34,1895,2
STAT,1815,54,45-49,1869,0.07178048304835173
STAT,1913,42,45-49,1955,0.3278658602769049
STAT,1882,3,na,1885,5884.261840950085
SIM,1932,37,50-100,1969,1
SIM,1844,29,25-29,1873,91
STAT,1853,63,na,1916,2823.1287791482773
STAT,1932,22,45-49,1954,2.981839494792608
SIM,1884,1,na,1885,6940
STAT,1828,38,30-34,1866,10.516549738951246
STAT,1821,40,25-29,1861,2.161500966322975
STAT,1951,4,na,1955,9457.13442369122
STAT,1801,54,15-19,1855,1.4800488788661035E-4
STAT,1935,20,20-24,1955,306.07753707687397
SIM,1880,16,30-34,1896,6
STAT,1873,32,50-100,1905,1.8801872961248869
SIM,1839,98,na,1937,3
STAT,1879,34,na,1913,4997.86821672003
STAT,1906,51,na,1957,6439.2571303636605
STAT,1879,28,35-39,1907,20.3113918496617
SIM,1913,32,45-49,1945,4
STAT,1924,37,50-100,1961,0.9996088734826458
STAT,1917,40,50-100,1957,0.2482724133469391
STAT,1833,33,50-100,1866,1.5380065795915123
STAT,1836,29,25-29,1865,71.75187522737713
STAT,1856,15,35-39,1871,1.0230191497495735
SIM,1881,32,50-100,1913,2
SIM,1858,92,na,1950,55
STAT,1907,45,25-29,1952,0.09740716734556507
SIM,1943,20,20-24,1963,246
STAT,1894,48,40-44,1942,0.2473955538380657
STAT,1890,37,15-19,1927,0.13842975116760187
STAT,1949,17,20-24,1966,318.4293706238579
STAT,1931,37,15-19,1968,0.05136548987063816
STAT,1913,19,50-100,1932,0.15391468775330838
STAT,1821,33,35-39,1854,66.55014966744716
STAT,1882,27,15-19,1909,0.892612868841865
STAT,1782,97,na,1879,1.8849426472708508
STAT,1918,32,na,1950,8115.357702930656
STAT,1871,38,45-49,1909,3.9801212069094882
STAT,1878,17,na,1895,5327.262730236327
SIM,1869,64,na,1933,3252
SIM,1841,33,50-100,1874,1
SIM,1885,40,na,1925,4947
STAT,1846,19,40-44,1865,0.34779683109324117
STAT,1864,90,na,1954,142.33162402926823
STAT,1844,50,20-24,1894,0.0012088012567397657
STAT,1855,75,na,1930,1552.361257266696
STAT,1902,36,50-100,1938,0.7592363171726044
SIM,1828,39,35-39,1867,20
STAT,1911,40,20-24,1951,0.03443823720177028
STAT,1913,42,50-100,1955,0.23143472423813857
STAT,1804,83,na,1887,281.58900315491184
SIM,1911,20,25-29,1931,192
STAT,1810,44,15-19,1854,0.09704995640788824
STAT,1830,30,25-29,1860,20.973220913396535
SIM,1927,26,25-29,1953,182
STAT,1847,56,na,1903,3109.099459247959
STAT,1912,46,45-49,1958,0.4230051791777174
STAT,1829,68,na,1897,1808.6357018869357
STAT,1870,32,20-24,1902,5.359698537210325
SIM,1856,53,45-49,1909,1
SIM,1886,18,25-29,1904,12
STAT,1818,50,50-100,1868,0.0664498723971336
SIM,1873,50,40-44,1923,1
SIM,1801,85,na,1886,153
SIM,1844,58,na,1902,2805
SIM,1850,75,na,1925,1510
STAT,1922,40,30-34,1962,0.2971033367225878
STAT,1844,31,15-19,1875,0.277883594377943
SIM,1824,68,na,1892,1853
STAT,1813,45,45-49,1858,1.507865264276662
STAT,1853,47,40-44,1900,0.2696100657990561
STAT,1915,33,15-19,1948,0.26322752536040267
STAT,1859,88,na,1947,220.68188666366382
STAT,1852,102,na,1954,0.4672652975971362
SIM,1904,43,40-44,1947,1
SIM,1812,47,45-49,1859,1
STAT,1857,51,45-49,1908,0.022954704223834898
STAT,1837,24,15-19,1861,5.934489143026002
STAT,1827,46,35-39,1873,0.2562368407311312
SIM,1887,33,50-100,1920,3
STAT,1847,22,50-100,1869,0.762035680319083
STAT,1903,20,25-29,1923,165.59550481170072
STAT,1869,28,25-29,1897,82.4899326321792
SIM,1920,32,35-39,1952,31
STAT,1827,56,na,1883,2611.9447227548685
STAT,1836,19,na,1855,4027.693182497146
STAT,1878,48,na,1926,4685.96216608284
STAT,1884,46,50-100,1930,0.49118343974310086
STAT,1923,32,45-49,1955,3.642122163406094
SIM,1900,34,25-29,1934,38
STAT,1880,52,na,1932,4556.634348177821
STAT,1891,36,20-24,1927,1.9335952818691806
STAT,1834,90,na,1924,104.77421512328779
STAT,1844,43,30-34,1887,1.8772780019484008
STAT,1903,34,35-39,1937,16.578124055969976
STAT,1835,45,30-34,1880,0.14905561190921568
STAT,1950,5,na,1955,9388.549749506077
SIM,1801,95,na,1896,9
STAT,1897,42,35-39,1939,0.3390529134047401
STAT,1824,45,20-24,1869,0.029891055410727608
STAT,1908,42,20-24,1950,0.03302093151777472
SIM,1824,58,na,1882,2622
STAT,1823,53,40-44,1876,0.030694437896558145
SIM,1937,34,50-100,1971,1
STAT,1912,32,35-39,1944,18.165487592062203
STAT,1921,44,45-49,1965,0.3772334082198516
SIM,1930,33,40-44,1963,15
STAT,1834,28,na,1862,3742.3358620062763
SIM,1845,24,15-19,1869,7
STAT,1885,50,45-49,1935,0.02959349676272558
STAT,1900,40,45-49,1940,0.29411020843950814
STAT,1931,31,40-44,1962,10.362480202229337
SIM,1911,34,35-39,1945,31
SIM,1920,46,45-49,1966,1
STAT,1890,44,40-44,1934,5.469971082631225
SIM,1863,38,na,1901,4410
STAT,1886,42,25-29,1928,1.3673564005439898
STAT,1855,85,na,1940,413.37673172422456
STAT,1823,43,na,1866,3265.094001030648
SIM,1841,21,50-100,1862,1
STAT,1853,43,25-29,1896,1.0086822793421302
STAT,1935,31,25-29,1966,25.84489349411692
STAT,1835,52,20-24,1887,9.744245258969734E-4
SIM,1950,21,na,1971,8570
STAT,1890,30,30-34,1920,43.38689502845811
SIM,1855,20,na,1875,4468
STAT,1891,37,na,1928,5881.419221245284
SIM,1871,57,na,1928,3903
STAT,1883,35,50-100,1918,2.4593139465118385
STAT,1880,40,15-19,1920,0.029677889940808253
STAT,1836,44,35-39,1880,2.7923567826303035
SIM,1931,32,45-49,1963,3
STAT,1887,33,50-100,1920,2.060874993539768
SIM,1873,38,na,1911,4942
SIM,1902,41,30-34,1943,1
STAT,1783,83,na,1866,227.67445361605482
SIM,1868,16,15-19,1884,13
SIM,1816,39,na,1855,3056
STAT,1800,80,na,1880,558.6939081840461
STAT,1813,43,na,1856,2827.2665450390537
STAT,1846,16,na,1862,4442.911950400747
STAT,1862,45,40-44,1907,0.2984719159907699
STAT,1876,46,30-34,1922,0.20277571026422536
SIM,1894,17,20-24,1911,46
STAT,1884,55,na,1939,4123.580107612554
STAT,1903,41,25-29,1944,0.1288093026363055
SIM,1881,67,na,1948,2625
STAT,1934,32,20-24,1966,6.726887677722129
STAT,1880,36,45-49,1916,4.2617020729721435
STAT,1831,48,15-19,1879,6.043210201238327E-4
STAT,1812,46,40-44,1858,1.209449556519291
SIM,1844,44,35-39,1888,2
SIM,1823,44,50-100,1867,7
SIM,1859,23,na,1882,4339
SIM,1911,41,25-29,1952,1
SIM,1859,33,na,1892,4249
STAT,1821,62,na,1883,2111.8304368046574
SIM,1861,36,35-39,1897,16
SIM,1873,48,na,1921,4678
SIM,1930,40,30-34,1970,1
SIM,1871,67,na,1938,2992
STAT,1874,43,45-49,1917,3.072567348693185
SIM,1882,43,45-49,1925,6
SIM,1933,36,50-100,1969,3
STAT,1893,1,na,1894,6967.646261491052
STAT,1853,36,35-39,1889,11.307594097685476
STAT,1841,21,50-100,1862,0.7549553598362225
STAT,1868,51,20-24,1919,0.0014247158381965588
STAT,1885,32,15-19,1917,0.28628160285927445
STAT,1929,16,40-44,1945,3.613619208914064
STAT,1841,30,35-39,1871,18.20190781108091
STAT,1891,40,40-44,1931,5.671709835416874
STAT,1906,47,30-34,1953,0.15994518664675628
STAT,1808,76,na,1884,817.8569042329657
SIM,1902,67,na,1969,5301
STAT,1883,18,na,1901,4998.362885505739
SIM,1853,48,45-49,1901,1
STAT,1919,26,25-29,1945,144.09442536013466
SIM,1771,91,na,1862,21
SIM,1869,23,na,1892,4548
SIM,1906,34,50-100,1940,2
STAT,1818,41,15-19,1859,0.07065673925891688
STAT,1864,40,30-34,1904,2.0964495881406764
SIM,1887,52,na,1939,5182
SIM,1917,12,na,1929,8826
SIM,1862,46,45-49,1908,3
STAT,1868,47,35-39,1915,0.2677595394242671
SIM,1850,40,45-49,1890,6
SIM,1853,41,25-29,1894,3
STAT,1852,23,na,1875,4019.2046425150806
STAT,1871,92,na,1963,202.54948661697662
SIM,1905,42,45-49,1947,1
STAT,1837,17,25-29,1854,15.46528644429603
STAT,1827,53,25-29,1880,0.006052997253613338
STAT,1901,52,na,1953,6055.557046853604
STAT,1871,54,30-34,1925,0.011615431132803545
STAT,1919,19,35-39,1938,9.312967534614586
SIM,1909,1,na,1910,8173
STAT,1864,54,40-44,1918,0.0184830222973129
SIM,1869,23,50-100,1892,1
SIM,1833,73,na,1906,1532
STAT,1900,33,20-24,1933,7.540997779062628
SIM,1966,3,na,1969,9442
STAT,1757,118,na,1875,1.5291811957836806E-4
STAT,1795,61,na,1856,1978.74368597
STAT,1850,35,20-24,1885,1.225830491707614
STAT,1856,41,35-39,1897,2.834442961489049
SIM,1805,54,na,1859,2283
STAT,1873,18,na,1891,5169.106884737228
SIM,1889,7,na,1896,6648
STAT,1821,72,na,1893,1399.8509631738123
STAT,1834,38,na,1872,3503.7627491767635
STAT,1868,18,15-19,1886,11.541481877780985
SIM,1845,17,25-29,1862,19
SIM,1836,60,na,1896,2406
STAT,1838,53,35-39,1891,0.011464471685682582
SIM,1927,19,35-39,1946,15
SIM,1832,22,50-100,1854,1
STAT,1926,40,15-19,1966,0.0038334680011076288
SIM,1861,27,50-100,1888,2
SIM,1796,76,na,1872,701
SIM,1923,7,na,1930,9940
STAT,1873,52,40-44,1925,0.021488321998075915
SIM,1872,40,30-34,1912,6
SIM,1932,1,na,1933,11145
STAT,1842,40,45-49,1882,2.365168676003515
STAT,1911,33,30-34,1944,30.86283590176972
SIM,1876,47,35-39,1923,2
STAT,1877,30,15-19,1907,0.3010520240851251
STAT,1845,41,25-29,1886,1.0206420606974709
STAT,1945,16,25-29,1961,95.62468866259195
SIM,1880,19,35-39,1899,2
STAT,1856,52,40-44,1908,0.016317234424210125
STAT,1886,17,20-24,1903,37.796210769922325
SIM,1953,16,25-29,1969,144
SIM,1829,45,50-100,1874,1
STAT,1822,54,35-39,1876,0.024746773781738902
STAT,1872,19,35-39,1891,1.1077644315862405
SIM,1889,40,50-100,1929,3
STAT,1874,89,na,1963,455.4104105709204
SIM,1911,7,na,1918,8203
SIM,1878,34,50-100,1912,2
STAT,1921,41,25-29,1962,0.16263246144692284
STAT,1870,52,na,1922,4246.631582012549
STAT,1837,56,na,1893,2842.7511690209285
STAT,1892,46,15-19,1938,5.720869590210493E-4
SIM,1882,43,50-100,1925,5
STAT,1928,7,na,1935,10170.77800051983
SIM,1835,46,35-39,1881,1
STAT,1815,51,40-44,1866,0.05528991309087685
STAT,1915,30,45-49,1945,3.2629744604806583
STAT,1845,16,20-24,1861,34.732809053894435
STAT,1883,41,45-49,1924,2.9831806405620735
STAT,1920,45,40-44,1965,0.3535582516192666
SIM,1944,23,40-44,1967,6
STAT,1941,23,15-19,1964,11.106908800489885
STAT,1847,51,35-39,1898,0.013185938366162895
STAT,1859,42,15-19,1901,0.02217182094036925
STAT,1910,41,15-19,1951,0.002949142999076737
SIM,1925,41,na,1966,9085
STAT,1894,37,35-39,1931,18.349964924297762
SIM,1871,36,45-49,1907,8
STAT,1832,51,40-44,1883,0.014561866685486449
STAT,1878,25,15-19,1903,0.9634876450252396
SIM,1870,30,20-24,1900,8
STAT,1920,31,30-34,1951,34.98751499461752
STAT,1821,44,40-44,1865,6.760150654040325
SIM,1821,92,na,1913,47
SIM,1837,86,na,1923,231
SIM,1854,29,35-39,1883,20
STAT,1825,47,50-100,1872,0.53259451153531
STAT,1811,54,25-29,1865,0.022033488707991773
STAT,1861,37,na,1898,3960.417397894004
STAT,1900,26,30-34,1926,70.7923375333724
SIM,1786,79,na,1865,591
SIM,1926,28,50-100,1954,2
STAT,1920,12,na,1932,8976.010525760426
STAT,1870,42,na,1912,4577.147016720487
STAT,1848,53,45-49,1901,0.023414038341785695
SIM,1868,92,na,1960,105
STAT,1816,95,na,1911,13.059575928724394
SIM,1891,41,45-49,1932,4
SIM,1918,52,na,1970,8036
STAT,1905,41,40-44,1946,0.45827361442777387
SIM,1923,30,45-49,1953,4
STAT,1936,23,40-44,1959,6.491380674791883
SIM,1912,19,40-44,1931,1
SIM,1811,95,na,1906,4
SIM,1847,48,50-100,1895,1
SIM,1861,47,40-44,1908,3
SIM,1945,9,na,1954,9055
SIM,1810,47,50-100,1857,2
STAT,1861,35,30-34,1896,9.044150317727667
STAT,1846,29,35-39,1875,17.623536209911904
STAT,1882,42,40-44,1924,4.419769643709506
SIM,1869,15,20-24,1884,38
STAT,1842,57,na,1899,2991.967574579655
STAT,1926,33,25-29,1959,22.553338372084404
STAT,1816,50,45-49,1866,0.07118886541367603
SIM,1896,15,30-34,1911,5
SIM,1903,32,35-39,1935,24
SIM,1794,98,na,1892,3
SIM,1879,33,na,1912,4900
SIM,1934,33,25-29,1967,29
SIM,1837,76,na,1913,1234
SIM,1853,16,20-24,1869,39
STAT,1839,68,na,1907,2386.170967941566
STAT,1851,45,15-19,1896,6.262543840611382E-4
STAT,1846,52,30-34,1898,0.00906903687549894
STAT,1854,46,45-49,1900,0.3628121728000297
STAT,1894,44,25-29,1938,0.1141295500255606
STAT,1888,15,30-34,1903,3.822347221706057
SIM,1928,18,40-44,1946,5
STAT,1832,47,20-24,1879,0.018496268046790904
STAT,1862,34,35-39,1896,17.331685532102213
STAT,1924,42,20-24,1966,0.042413399985991
SIM,1890,42,40-44,1932,12
STAT,1862,26,50-100,1888,1.1163237371852817
STAT,1894,30,15-19,1924,0.3724318035360979
STAT,1870,47,40-44,1917,0.3378774449142938
STAT,1916,44,20-24,1960,0.03642905635265105
SIM,1855,19,na,1874,4799
SIM,1928,35,50-100,1963,1
STAT,1922,47,15-19,1969,8.544472249812141E-4
STAT,1858,17,50-100,1875,0.09010242355615362
STAT,1944,21,25-29,1965,201.47485364866992
STAT,1845,34,35-39,1879,18.1732420804886
STAT,1926,30,20-24,1956,5.962332083357257
STAT,1913,43,40-44,1956,0.4919656581780858
SIM,1826,91,na,1917,40
STAT,1936,30,30-34,1966,30.947762522568976
STAT,1889,40,35-39,1929,4.554848915311683
STAT,1927,5,na,1932,10095.240482380224
SIM,1781,91,na,1872,22
STAT,1846,71,na,1917,2044.5262871187065
STAT,1881,39,15-19,1920,0.10851500947379475
SIM,1918,33,40-44,1951,14
SIM,1798,57,na,1855,2033
STAT,1878,40,25-29,1918,1.3681696852158955
SIM,1886,40,25-29,1926,1
STAT,1912,43,40-44,1955,0.48441416437969037
STAT,1902,43,30-34,1945,0.22599372841600268
SIM,1862,12,na,1874,5087
STAT,1831,41,30-34,1872,1.8440776842919646
STAT,1931,34,45-49,1965,4.159034252068034
SIM,1911,31,30-34,1942,52
STAT,1868,54,25-29,1922,0.006618908769649953
STAT,1941,20,45-49,1961,2.35008669593131
STAT,1840,53,40-44,1893,0.014952045437557425
STAT,1873,48,20-24,1921,0.024315264508656793
STAT,1832,57,na,1889,2629.79954354765
STAT,1882,23,na,1905,4638.611031448162
STAT,1877,63,na,1940,3741.968290228887
STAT,1893,69,na,1962,4131.10437335005
STAT,1809,104,na,1913,0.05928392737481257
SIM,1845,20,na,1865,4358
STAT,1871,35,40-44,1906,8.866943336895064
STAT,1905,45,na,1950,6638.038342788129
SIM,1861,33,30-34,1894,46
SIM,1847,86,na,1933,286
SIM,1853,34,35-39,1887,20
SIM,1875,28,50-100,1903,2
SIM,1900,31,20-24,1931,9
STAT,1844,46,35-39,1890,0.22672986964758104
STAT,1847,47,15-19,1894,6.068935993983247E-4
STAT,1899,10,na,1909,7167.791237020473
SIM,1962,8,na,1970,10315
STAT,1851,49,30-34,1900,0.1469245881484935
STAT,1860,1,na,1861,6004.717962169304
STAT,1853,40,20-24,1893,0.25380965782220394
STAT,1865,53,45-49,1918,0.026200006648670573
STAT,1852,57,na,1909,3202.970450954396
STAT,1862,23,na,1885,4149.253683530045
STAT,1911,52,na,1963,6908.023383885607
SIM,1907,12,na,1919,7789
SIM,1900,35,na,1935,6995
SIM,1874,41,45-49,1915,4
SIM,1812,44,40-44,1856,8
SIM,1864,41,35-39,1905,8
SIM,1826,39,50-100,1865,1
SIM,1832,46,na,1878,3216
STAT,1918,31,25-29,1949,19.913463923365683
SIM,1819,57,na,1876,2320
STAT,1952,20,20-24,1972,270.1720985342157
STAT,1862,48,45-49,1910,0.4022647049648523
SIM,1847,15,35-39,1862,2
STAT,1867,22,na,1889,4491.739268101297
STAT,1911,22,25-29,1933,176.97593134911517
SIM,1820,42,25-29,1862,2
SIM,1842,87,na,1929,209
STAT,1903,31,30-34,1934,50.41168228763979
SIM,1826,39,na,1865,3212
SIM,1868,27,20-24,1895,24
STAT,1818,39,50-100,1857,6.9275705627598345
STAT,1809,51,50-100,1860,0.11359207275824255
SIM,1902,44,35-39,1946,1
STAT,1764,108,na,1872,0.00738502377295722
SIM,1936,16,25-29,1952,100
STAT,1854,102,na,1956,0.5409420374039349
STAT,1934,25,na,1959,10188.200099434473
STAT,1832,105,na,1937,0.0382258827512522
SIM,1876,18,15-19,1894,12
STAT,1877,22,na,1899,4959.881086463665
STAT,1840,41,50-100,1881,1.6112303510670067
STAT,1864,89,na,1953,189.65412006884685
STAT,1861,42,20-24,1903,0.266637360770056
STAT,1853,33,30-34,1886,28.15394659434498
STAT,1904,44,45-49,1948,0.2971988190831311
SIM,1815,54,na,1869,2315
STAT,1811,62,na,1873,2055.151083970352
SIM,1888,16,35-39,1904,2
STAT,1906,34,50-100,1940,1.5350511717882325
STAT,1886,35,35-39,1921,15.222270042161647
STAT,1812,42,25-29,1854,5.257733428170692
SIM,1901,31,20-24,1932,8
SIM,1820,35,35-39,1855,16
SIM,1948,19,20-24,1967,324
STAT,1814,48,15-19,1862,0.0020402433968510873
STAT,1786,105,na,1891,0.027249735741401167
STAT,1899,15,40-44,1914,0.5084696229801053
STAT,1896,36,na,1932,6312.280037501808
SIM,1849,28,15-19,1877,1
STAT,1894,55,na,1949,5364.4694876679
STAT,1904,59,na,1963,5973.479279081466
STAT,1879,88,na,1967,708.303314184715
STAT,1880,51,20-24,1931,0.0015774891175979523
SIM,1957,9,na,1966,10324
SIM,1866,3,na,1869,5892
SIM,1918,40,30-34,1958,2
STAT,1819,44,35-39,1863,7.852348402869805
SIM,1813,73,na,1886,1031
SIM,1864,78,na,1942,1362
SIM,1775,84,na,1859,138
SIM,1894,35,35-39,1929,23
STAT,1814,83,na,1897,341.6587460222606
SIM,1921,43,40-44,1964,2
STAT,1881,37,na,1918,4599.05891780931
SIM,1800,55,na,1855,2209
SIM,1884,85,na,1969,1182
STAT,1878,6,na,1884,5692.638867647384
SIM,1859,20,50-100,1879,1
SIM,1873,6,na,1879,5764
SIM,1914,34,50-100,1948,3
STAT,1922,37,na,1959,8643.449312301931
STAT,1838,50,30-34,1888,0.008337102172419732
STAT,1867,18,15-19,1885,11.407479278002496
STAT,1824,52,45-49,1876,0.03385036234122989
STAT,1899,54,na,1953,5794.428171872868
STAT,1874,40,40-44,1914,4.69824422986645
STAT,1888,48,15-19,1936,5.318334169352602E-4
SIM,1845,28,30-34,1873,58
STAT,1829,26,30-34,1855,91.7794533247219
SIM,1809,53,30-34,1862,1
STAT,1817,53,15-19,1870,1.1160626380687756E-4
STAT,1892,46,50-100,1938,0.3512616879130444
SIM,1932,33,na,1965,10185
STAT,1847,17,35-39,1864,1.0439349193436707
SIM,1823,40,35-39,1863,9
STAT,1881,54,40-44,1935,0.019985693261949565
STAT,1875,41,na,1916,4827.62550610938
STAT,1869,88,na,1957,332.9888502698412
STAT,1872,52,50-100,1924,0.030491471964251154
STAT,1929,19,45-49,1948,1.280511910618371
STAT,1868,44,30-34,1912,2.179298906890778
STAT,1845,75,na,1920,1586.3348453360309
STAT,1853,102,na,1955,0.46386189476153994
SIM,1890,31,35-39,1921,37
STAT,1854,54,30-34,1908,0.008874246149920176
SIM,1853,19,25-29,1872,12
STAT,1927,43,35-39,1970,0.5091578938345389
SIM,1827,44,35-39,1871,10
SIM,1944,14,na,1958,8687
STAT,1882,31,35-39,1913,20.005377896004333
STAT,1891,43,45-49,1934,3.7091963718666117
STAT,1827,50,20-24,1877,0.0013383737405879047
STAT,1878,18,25-29,1896,11.921517746767625
SIM,1855,17,35-39,1872,2
STAT,1894,41,20-24,1935,0.4138883349615941
STAT,1932,37,30-34,1969,4.946039096228019
STAT,1844,90,na,1934,127.32073751650718
STAT,1820,34,30-34,1854,112.30693362119553
STAT,1857,56,na,1913,3210.7856127644
SIM,1905,35,50-100,1940,4
SIM,1876,44,30-34,1920,6
SIM,1937,19,45-49,1956,1
SIM,1904,42,45-49,1946,1
SIM,1882,40,40-44,1922,9
SIM,1926,31,25-29,1957,27
STAT,1895,51,na,1946,5693.609201216224
STAT,1835,41,15-19,1876,0.02171705458889465
STAT,1901,33,20-24,1934,7.610292951236556
STAT,1839,15,35-39,1854,1.1340999803236902
SIM,1814,58,na,1872,2269
SIM,1840,65,na,1905,2600
SIM,1842,19,15-19,1861,12
SIM,1863,93,na,1956,64
STAT,1876,53,20-24,1929,0.001516661098928304
STAT,1837,28,30-34,1865,44.734844218452835
STAT,1864,33,50-100,1897,1.6471264630848164
STAT,1893,49,35-39,1942,0.1979369159695246
STAT,1832,54,45-49,1886,0.018915645194429113
SIM,1810,99,na,1909,7
STAT,1896,17,30-34,1913,4.249938606210267
STAT,1806,95,na,1901,9.053139564081299
SIM,1884,46,30-34,1930,1
SIM,1827,29,25-29,1856,84
STAT,1931,41,35-39,1972,0.5441019084792184
SIM,1883,2,na,1885,6263
STAT,1819,51,25-29,1870,0.014558650446826301
STAT,1844,16,50-100,1860,0.10116800890015379
SIM,1864,34,na,1898,4472
STAT,1871,31,25-29,1902,20.635927633155198
SIM,1832,87,na,1919,266
STAT,1830,76,na,1906,1308.2537231304657
STAT,1805,51,30-34,1856,0.047692071087576664
STAT,1883,70,na,1953,2784.082786593707
STAT,1920,41,25-29,1961,0.1594742632695726
STAT,1832,36,15-19,1868,0.0934944638352715
STAT,1853,15,50-100,1868,0.09435373988411794
STAT,1855,49,15-19,1904,5.905794466811606E-4
STAT,1910,45,30-34,1955,0.16883061197673524
SIM,1837,19,40-44,1856,1
SIM,1905,34,na,1939,7153
STAT,1876,27,50-100,1903,1.3362276717663153
SIM,1908,52,na,1960,6532
STAT,1860,42,na,1902,3785.9577776040483
SIM,1819,38,30-34,1857,13
STAT,1865,46,20-24,1911,0.022080248131380188
STAT,1930,31,40-44,1961,10.205484304604166
SIM,1901,37,50-100,1938,1
STAT,1914,49,30-34,1963,0.17754041474830254
STAT,1845,19,25-29,1864,10.906938811586956
STAT,1872,29,50-100,1901,1.2891295785664818
SIM,1862,53,na,1915,3865
SIM,1903,22,40-44,1925,7
SIM,1880,29,50-100,1909,2
SIM,1934,30,20-24,1964,7
STAT,1888,18,35-39,1906,1.3063727731791062
STAT,1924,45,25-29,1969,0.12810707720503897
STAT,1867,16,50-100,1883,0.09529213282322087
STAT,1881,51,50-100,1932,0.029622853699865077
SIM,1922,49,30-34,1971,1
STAT,1815,40,35-39,1855,11.72309456207532
STAT,1894,34,30-34,1928,44.909616632512694
SIM,1861,43,25-29,1904,6
STAT,1821,47,45-49,1868,0.6907592169367833
SIM,1875,18,15-19,1893,13
STAT,1876,50,50-100,1926,0.03200087648764312
STAT,1920,34,35-39,1954,20.037986447751567
STAT,1844,38,na,1882,3978.990519859354
SIM,1862,8,na,1870,5225
STAT,1925,11,na,1936,9679.170485847966
STAT,1879,51,30-34,1930,0.012634789371311128
STAT,1872,42,30-34,1914,2.3306552294608207
STAT,1820,41,20-24,1861,0.6610716479742237
SIM,1829,27,35-39,1856,25
SIM,1871,33,40-44,1904,11
SIM,1849,39,50-100,1888,3
SIM,1877,52,na,1929,4334
SIM,1853,38,na,1891,3858
SIM,1865,19,na,1884,4829
STAT,1905,44,45-49,1949,0.29945860930523027
STAT,1900,22,15-19,1922,9.242626605484594
STAT,1884,44,15-19,1928,0.027168789868862682
STAT,1871,21,30-34,1892,35.848517645499065
STAT,1895,29,50-100,1924,1.6714022138954912
STAT,1860,35,50-100,1895,2.032723232685157
SIM,1886,29,30-34,1915,64
STAT,1916,37,50-100,1953,0.8683402436637884
SIM,1897,40,35-39,1937,2
SIM,1835,43,30-34,1878,5
STAT,1878,29,30-34,1907,52.73656685921172
STAT,1850,42,45-49,1892,2.2919279179638563
STAT,1873,9,na,1882,5493.9217667263565
STAT,1895,47,45-49,1942,0.3486990073719142
SIM,1863,16,30-34,1879,4
SIM,1880,42,30-34,1922,4
STAT,1827,43,30-34,1870,2.144631757985623
SIM,1918,18,30-34,1936,34
STAT,1909,40,50-100,1949,0.22455895302384324
SIM,1913,44,45-49,1957,2
STAT,1861,31,15-19,1892,0.24036678801870992
STAT,1855,16,30-34,1871,2.8756019625797657
SIM,1812,80,na,1892,576
STAT,1927,22,30-34,1949,71.50535188373976
SIM,1907,19,25-29,1926,18
SIM,1947,22,50-100,1969,4
STAT,1929,30,40-44,1959,10.049474756001441
STAT,1839,15,40-44,1854,0.3780333486622435
SIM,1936,16,50-100,1952,1
STAT,1948,22,50-100,1970,1.5257281095489545
STAT,1908,28,35-39,1936,28.581986087128875
STAT,1907,41,15-19,1948,0.0028594889896936394
STAT,1800,108,na,1908,0.0015645143173875589
STAT,1776,108,na,1884,0.00990646511462975
STAT,1903,19,45-49,1922,0.18683159689023282
SIM,1914,45,45-49,1959,1
STAT,1893,20,40-44,1913,5.3661239558351665
SIM,1933,25,30-34,1958,121
SIM,1852,21,na,1873,4108
SIM,1912,37,35-39,1949,8
STAT,1850,85,na,1935,420.32203350410623
STAT,1865,25,35-39,1890,17.8240718333812
STAT,1923,28,50-100,1951,2.2991004044422607
STAT,1916,47,25-29,1963,0.10988189085339961
STAT,1887,54,na,1941,4729.9443552660705
SIM,1823,32,na,1855,3384
SIM,1816,70,na,1886,1434
SIM,1869,43,50-100,1912,6
STAT,1900,15,50-100,1915,0.1378945639241033
SIM,1841,69,na,1910,1991
SIM,1903,42,35-39,1945,1
STAT,1914,39,15-19,1953,0.03833976328699986
STAT,1882,25,50-100,1907,1.2670669509359227
SIM,1924,16,20-24,1940,299
STAT,1906,45,45-49,1951,0.39568131932733924
SIM,1897,20,20-24,1917,194
STAT,1836,62,na,1898,2430.12056117056
STAT,1937,16,50-100,1953,0.7380629367048143
STAT,1869,30,45-49,1899,3.439985189215397
STAT,1936,28,40-44,1964,9.00640430498828
SIM,1836,82,na,1918,494
STAT,1900,24,15-19,1924,9.184766156565756
SIM,1884,23,45-49,1907,3
STAT,1921,34,30-34,1955,35.09837740828791
SIM,1944,15,35-39,1959,10
SIM,1959,9,na,1968,10851
SIM,1873,25,35-39,1898,26
STAT,1923,42,40-44,1965,0.5902349646324782
STAT,1851,54,20-24,1905,0.0011124530435417627
SIM,1895,18,na,1913,7007
STAT,1902,21,15-19,1923,9.435059042090453
SIM,1894,76,na,1970,3266
SIM,1937,30,40-44,1967,7
SIM,1835,41,na,1876,3471
SIM,1944,26,45-49,1970,4
STAT,1859,28,15-19,1887,0.7365838235827965
SIM,1881,25,50-100,1906,4
STAT,1867,22,35-39,1889,11.082839864566179
SIM,1799,97,na,1896,1
SIM,1918,36,45-49,1954,1
SIM,1916,2,na,1918,8817
SIM,1892,31,50-100,1923,1
STAT,1847,21,25-29,1868,107.74818963031693
SIM,1935,22,30-34,1957,109
SIM,1918,25,35-39,1943,46
STAT,1904,37,35-39,1941,4.425297099624467
SIM,1827,46,na,1873,3119
STAT,1878,18,na,1896,5313.305301883114
SIM,1855,21,25-29,1876,124
STAT,1920,36,35-39,1956,5.352091359997921
STAT,1921,45,40-44,1966,0.36056005242999445
SIM,1848,16,na,1864,4417
STAT,1870,37,40-44,1907,8.67983186546242
STAT,1911,27,25-29,1938,129.67493385647836
STAT,1849,37,na,1886,3813.3797679230693
SIM,1919,34,40-44,1953,16
STAT,1911,30,25-29,1941,18.328316755873388
SIM,1900,30,45-49,1930,6
SIM,1833,47,30-34,1880,1
STAT,1850,33,50-100,1883,1.4544344528959792
STAT,1920,16,40-44,1936,3.1763888041997084
STAT,1782,96,na,1878,3.079066038209106
STAT,1904,48,45-49,1952,0.38104209090410274
SIM,1942,18,35-39,1960,10
STAT,1925,45,25-29,1970,0.13040194174331385
SIM,1848,31,35-39,1879,35
STAT,1914,19,20-24,1933,56.34567620697853
STAT,1917,15,25-29,1932,18.919620855138614
SIM,1870,101,na,1971,4
STAT,1897,19,50-100,1916,0.13155124362930914
STAT,1900,37,20-24,1937,0.46613697737363824
STAT,1940,29,15-19,1969,1.45254751128863
SIM,1857,44,na,1901,4013
SIM,1846,92,na,1938,34
STAT,1904,51,na,1955,6271.507645289823
STAT,1950,19,30-34,1969,29.085520024848513
SIM,1900,18,30-34,1918,6
STAT,1886,13,na,1899,5497.227204904262
SIM,1888,33,30-34,1921,52
STAT,1934,18,35-39,1952,11.434404219852993
SIM,1843,22,45-49,1865,3
SIM,1869,33,20-24,1902,10
SIM,1902,26,40-44,1928,10
STAT,1782,88,na,1870,89.31514353952753
STAT,1921,15,45-49,1936,1.1550551130945552
STAT,1942,26,15-19,1968,1.4971125291332086
SIM,1820,99,na,1919,2
SIM,1889,32,35-39,1921,36
SIM,1912,17,40-44,1929,1
STAT,1841,49,na,1890,3196.2038229924683
STAT,1951,15,30-34,1966,29.327017926968168
STAT,1786,78,na,1864,545.2552331048678
SIM,1920,10,na,1930,9237
STAT,1904,17,40-44,1921,0.5301883590074699
SIM,1873,15,na,1888,5449
SIM,1811,46,40-44,1857,1
SIM,1903,30,na,1933,7052
SIM,1887,7,na,1894,6433
SIM,1922,19,20-24,1941,316
STAT,1879,20,50-100,1899,0.8665877947651986
SIM,1799,73,na,1872,879
STAT,1835,22,45-49,1857,1.2010568902623406
STAT,1952,16,30-34,1968,29.505755370690068
SIM,1833,42,na,1875,3304
SIM,1837,56,na,1893,2720
STAT,1930,27,35-39,1957,38.55492978246592
STAT,1932,35,45-49,1967,1.8532317807877572
STAT,1790,83,na,1873,247.04586364187128
STAT,1857,32,na,1889,3779.7154705720604
STAT,1916,16,20-24,1932,58.23529205004897
STAT,1831,39,na,1870,3406.4413984812113
STAT,1871,47,na,1918,4493.2932204680255
SIM,1806,84,na,1890,178
SIM,1907,35,30-34,1942,6
STAT,1811,52,25-29,1863,0.022936081324953412
STAT,1902,34,20-24,1936,4.387674268210424
STAT,1932,15,20-24,1947,364.27847483598356
SIM,1831,51,na,1882,3044
STAT,1863,22,20-24,1885,124.25839338063916
SIM,1802,70,na,1872,1379
STAT,1905,16,45-49,1921,0.19126129942021167
STAT,1893,31,50-100,1924,2.3550619818434786
STAT,1915,18,25-29,1933,18.2710855903736
SIM,1923,18,25-29,1941,116
SIM,1912,15,na,1927,8118
SIM,1808,75,na,1883,829
STAT,1911,21,50-100,1932,1.264498188527295
SIM,1940,15,20-24,1955,282
STAT,1866,48,30-34,1914,0.17811829545220134
SIM,1875,9,na,1884,5954
STAT,1840,75,na,1915,1485.9670992671406
SIM,1805,49,20-24,1854,1
SIM,1829,32,50-100,1861,4
STAT,1934,34,50-100,1968,2.2772470646973995
SIM,1920,23,25-29,1943,234
STAT,1908,22,20-24,1930,206.59205947361676
STAT,1810,77,na,1887,743.4243760525803
STAT,1844,17,15-19,1861,12.18263973112781
SIM,1922,42,45-49,1964,1
STAT,1934,32,15-19,1966,0.35439867102768724
SIM,1897,26,35-39,1923,37
SIM,1926,19,35-39,1945,14
STAT,1913,40,30-34,1953,0.25471033816273847
STAT,1917,32,15-19,1949,0.27174621972944446
SIM,1877,18,30-34,1895,7
SIM,1852,13,na,1865,4727
STAT,1912,23,25-29,1935,178.27824792157523
SIM,1923,39,50-100,1962,1
STAT,1896,16,25-29,1912,15.147035381863935
SIM,1847,35,35-39,1882,20
STAT,1803,75,na,1878,878.3110104916533
SIM,1827,54,na,1881,2744
STAT,1894,24,na,1918,6097.462927209851
SIM,1941,19,30-34,1960,28
STAT,1898,38,na,1936,6457.711555590341
SIM,1943,19,35-39,1962,10
STAT,1932,15,na,1947,9889.852296475754
SIM,1852,17,15-19,1869,12
STAT,1854,67,na,1921,2430.1187718569445
SIM,1878,46,na,1924,4951
STAT,1935,19,35-39,1954,11.525328271800385
STAT,1830,52,35-39,1882,0.013069698545422092
SIM,1945,24,40-44,1969,11
STAT,1870,54,30-34,1924,0.011478306003036565
STAT,1890,18,na,1908,6209.70078475161
SIM,1902,46,35-39,1948,1
STAT,1829,25,25-29,1854,240.8660933077555
STAT,1889,26,35-39,1915,24.11053664116142
SIM,1902,15,30-34,1917,7
SIM,1807,100,na,1907,2
SIM,1882,51,na,1933,4427
STAT,1860,47,25-29,1907,0.09402835215804911
STAT,1937,24,40-44,1961,6.609621254410635
STAT,1868,16,na,1884,4970.161056046267
SIM,1837,25,25-29,1862,86
STAT,1872,21,na,1893,4814.927895534777
STAT,1924,29,30-34,1953,91.4549137469558
STAT,1792,98,na,1890,1.2172027246042219
SIM,1849,40,40-44,1889,9
STAT,1819,49,50-100,1868,1.000108142541549
STAT,1899,31,na,1930,6630.238645325766
SIM,1805,49,50-100,1854,2
STAT,1836,52,50-100,1888,0.02032225977056799
SIM,1860,53,25-29,1913,1
STAT,1885,48,40-44,1933,0.3398382894724322
STAT,1903,30,20-24,1933,7.835293053692836
SIM,1816,62,na,1878,2058
STAT,1908,41,na,1949,6984.230744495976
SIM,1837,46,50-100,1883,2
STAT,1825,78,na,1903,904.0298445712167
STAT,1852,53,25-29,1905,0.005554655096219139
STAT,1918,19,35-39,1937,9.173071679007318
SIM,1903,25,45-49,1928,6
SIM,1861,89,na,1950,128
STAT,1869,18,30-34,1887,3.143672078182548
STAT,1877,52,na,1929,4491.494787463214
STAT,1931,2,na,1933,10811.834193195062
STAT,1933,31,15-19,1964,0.34999047125057664
SIM,1850,44,50-100,1894,3
STAT,1858,40,40-44,1898,3.5770341045116014
SIM,1906,27,na,1933,6969
STAT,1907,41,45-49,1948,0.3098970975008235
SIM,1831,39,20-24,1870,2
STAT,1761,102,na,1863,0.012654114752135416
SIM,1898,66,na,1964,4950
SIM,1933,0,na,1933,11864
STAT,1924,41,45-49,1965,0.40027658515490805
STAT,1909,29,35-39,1938,28.78663567510949
STAT,1913,43,50-100,1956,0.23106905737384228
STAT,1866,60,na,1926,3553.990645547176
SIM,1886,33,na,1919,4959
STAT,1943,22,15-19,1965,11.437756252178138
SIM,1911,30,20-24,1941,5
STAT,1854,103,na,1957,0.32142775862541817
STAT,1938,23,45-49,1961,2.248643457338243
STAT,1853,42,na,1895,3652.344738971824
STAT,1903,36,35-39,1939,4.411042847692457
SIM,1911,36,35-39,1947,7
SIM,1840,44,na,1884,3706
SIM,1936,34,40-44,1970,8
STAT,1866,92,na,1958,112.50362253693538
SIM,1853,62,na,1915,2904
SIM,1857,76,na,1933,1556
STAT,1823,39,20-24,1862,2.7517699757011003
STAT,1915,11,na,1926,8361.048473361496
STAT,1919,25,na,1944,8228.515389629238
SIM,1932,29,30-34,1961,120
STAT,1890,39,50-100,1929,2.996116204008511
SIM,1911,41,na,1952,7422
SIM,1915,55,na,1970,7293
STAT,1952,5,na,1957,9515.152883766204
STAT,1849,8,na,1857,4781.312782664298
SIM,1828,35,25-29,1863,7
STAT,1840,39,20-24,1879,1.2889729984234688
STAT,1910,34,25-29,1944,17.8510459040289
SIM,1916,28,35-39,1944,37
SIM,1856,25,35-39,1881,25
STAT,1786,107,na,1893,0.00438286332874343
SIM,1932,23,50-100,1955,3
STAT,1918,44,25-29,1962,0.152800388728907
SIM,1930,30,30-34,1960,48
SIM,1844,26,na,1870,3719
STAT,1857,43,50-100,1900,1.6510497231927692
SIM,1946,23,45-49,1969,4
STAT,1889,20,20-24,1909,172.63206830366923
SIM,1915,29,30-34,1944,92
STAT,1878,20,15-19,1898,7.000152800885863
STAT,1839,35,35-39,1874,13.474496044695256
STAT,1928,34,40-44,1962,9.86816828689743
SIM,1853,94,na,1947,34
SIM,1939,27,20-24,1966,38
STAT,1905,24,50-100,1929,1.1836100583696656
SIM,1878,26,25-29,1904,101
STAT,1907,29,30-34,1936,73.5900932190639
SIM,1910,32,na,1942,7643
SIM,1916,22,20-24,1938,250
STAT,1871,53,35-39,1924,0.016996850638728325
SIM,1901,47,30-34,1948,1
STAT,1871,39,na,1910,4679.725363900124
SIM,1836,90,na,1926,61
STAT,1857,24,na,1881,3855.261720448443
STAT,1923,30,na,1953,8824.126202548241
STAT,1917,45,20-24,1962,0.023420160440005094
SIM,1917,29,35-39,1946,41
STAT,1922,30,30-34,1952,36.23119770782397
STAT,1800,100,na,1900,0.9067737416859026
STAT,1933,31,45-49,1964,4.285732182049456
STAT,1919,28,40-44,1947,10.133315539539566
STAT,1863,5,na,1868,5072.704960603489
SIM,1908,47,40-44,1955,1
SIM,1819,67,na,1886,1700
STAT,1893,23,45-49,1916,1.7795423579911462
STAT,1891,67,na,1958,4117.404586152274
SIM,1870,74,na,1944,2039
SIM,1829,80,na,1909,811
SIM,1905,37,50-100,1942,1
STAT,1856,15,40-44,1871,0.3410064029937219
SIM,1924,19,25-29,1943,134
STAT,1835,21,na,1856,3707.317106602971
SIM,1871,99,na,1970,17
SIM,1878,78,na,1956,1545
STAT,1918,41,20-24,1959,0.03797017475455616
STAT,1898,40,50-100,1938,0.2025284624157754
SIM,1815,77,na,1892,757
STAT,1857,101,na,1958,1.5001111979857442
SIM,1935,34,25-29,1969,37
STAT,1805,107,na,1912,0.003527577616201615
SIM,1881,26,na,1907,4128
SIM,1908,36,30-34,1944,8
STAT,1847,110,na,1957,5.185226006656374E-4
STAT,1867,30,40-44,1897,8.26850570735523
SIM,1941,16,20-24,1957,288
SIM,1919,45,na,1964,8166
STAT,1905,29,20-24,1934,34.020097735087994
STAT,1924,28,na,1952,8775.72322297268
SIM,1858,18,20-24,1876,32
STAT,1911,24,20-24,1935,211.71063226511444
SIM,1895,26,25-29,1921,119
STAT,1841,21,30-34,1862,32.97644654125906
STAT,1839,59,na,1898,3034.580011831162
STAT,1847,23,50-100,1870,0.7565642641343919
STAT,1916,19,25-29,1935,18.469080382832782
STAT,1883,48,30-34,1931,0.18966420028181477
STAT,1921,37,35-39,1958,5.453116310340018
SIM,1918,20,na,1938,8144
SIM,1927,28,40-44,1955,16
SIM,1834,21,35-39,1855,17
SIM,1910,37,30-34,1947,7
STAT,1856,90,na,1946,122.85222404082741
STAT,1878,34,50-100,1912,1.9160908992087886
STAT,1907,26,20-24,1933,34.94270271451975
STAT,1940,32,45-49,1972,3.2893583314998724
SIM,1857,48,30-34,1905,1
SIM,1886,34,50-100,1920,2
STAT,1878,33,20-24,1911,5.6775030504543755
SIM,1866,13,na,1879,5215
STAT,1910,47,30-34,1957,0.16803972173338247
SIM,1878,23,20-24,1901,147
STAT,1889,40,50-100,1929,2.657357032639045
STAT,1887,26,25-29,1913,95.87804244519268
SIM,1911,33,25-29,1944,22
STAT,1941,25,15-19,1966,1.4762469573541765
SIM,1924,31,15-19,1955,2
SIM,1930,16,45-49,1946,1
STAT,1920,8,na,1928,9035.226309895905
STAT,1895,20,45-49,1915,1.8460419619408368
SIM,1830,77,na,1907,977
SIM,1887,74,na,1961,3017
SIM,1888,16,na,1904,5933
STAT,1923,45,45-49,1968,0.5157365481286259
STAT,1924,41,15-19,1965,0.0036934404914185635
STAT,1907,25,50-100,1932,1.9117211666427159
STAT,1826,32,45-49,1858,5.242656811038505
STAT,1875,29,na,1904,4926.953506288712
STAT,1854,59,na,1913,2979.305818404421
STAT,1894,56,na,1950,5291.619992025369
STAT,1807,57,na,1864,2376.5070709079064
STAT,1931,19,20-24,1950,356.48229625139504
SIM,1789,95,na,1884,3
SIM,1879,43,30-34,1922,6
STAT,1869,30,15-19,1899,0.28092330232654933
STAT,1922,16,45-49,1938,1.1701440619010781
SIM,1940,30,na,1970,8158
SIM,1819,42,20-24,1861,3
SIM,1834,32,45-49,1866,3
SIM,1907,16,20-24,1923,54
STAT,1844,41,50-100,1885,1.7698395762506833
STAT,1865,11,na,1876,4982.669805355891
SIM,1866,4,na,1870,5529
STAT,1900,24,45-49,1924,1.941403131941143
SIM,1864,54,na,1918,3963
STAT,1915,43,na,1958,7540.206452646807
STAT,1859,90,na,1949,126.7353588507898
STAT,1901,25,15-19,1926,1.2914873260970363
STAT,1903,33,25-29,1936,16.840687012108692
STAT,1949,23,na,1972,8602.568763942683
STAT,1945,18,40-44,1963,3.084593819395313
SIM,1816,47,30-34,1863,1
SIM,1860,22,45-49,1882,3
SIM,1923,35,45-49,1958,4
SIM,1858,18,na,1876,4560
STAT,1800,54,15-19,1854,1.477502606057328E-4
STAT,1875,38,30-34,1913,11.027098910397227
SIM,1846,60,na,1906,2997
STAT,1875,21,na,1896,4932.614714425241
STAT,1878,20,45-49,1898,1.4796368617388749
SIM,1928,30,na,1958,9668
SIM,1888,30,20-24,1918,8
STAT,1841,60,na,1901,2767.1839652354556
SIM,1902,27,25-29,1929,125
SIM,1913,29,20-24,1942,41
STAT,1933,16,20-24,1949,367.47415994791504
STAT,1913,23,40-44,1936,6.837770323395709
STAT,1850,106,na,1956,0.02334635917492005
STAT,1852,22,45-49,1874,1.320289128313818
SIM,1883,38,30-34,1921,13
SIM,1921,27,35-39,1948,41
STAT,1838,19,40-44,1857,0.32313487060810875
SIM,1849,15,45-49,1864,1
SIM,1887,82,na,1969,1989
STAT,1897,33,30-34,1930,46.93607545082164
SIM,1856,22,25-29,1878,129
SIM,1905,19,20-24,1924,61
STAT,1913,27,35-39,1940,30.22034587121823
SIM,1864,15,40-44,1879,1
STAT,1914,42,45-49,1956,0.3331178379507605
STAT,1914,18,na,1932,8049.138721816603
STAT,1903,16,40-44,1919,0.5272408962042406
SIM,1877,21,na,1898,4903
SIM,1879,87,na,1966,644
SIM,1921,38,45-49,1959,4
SIM,1856,59,na,1915,3267
STAT,1907,56,na,1963,6367.580834333973
SIM,1953,18,40-44,1971,6
STAT,1902,37,25-29,1939,1.7719674094258466
STAT,1899,41,40-44,1940,0.434167020293939
SIM,1851,28,na,1879,3989
STAT,1817,67,na,1884,1780.4411328636863
STAT,1921,48,45-49,1969,0.4933300727120284
STAT,1925,42,20-24,1967,0.04317317852203345
SIM,1891,36,na,1927,6117
STAT,1904,43,50-100,1947,0.21112169018654592
STAT,1930,24,30-34,1954,73.89497794996964
STAT,1870,97,na,1967,48.25369391007415
STAT,1863,40,50-100,1903,1.8865477866468905
SIM,1902,30,25-29,1932,36
STAT,1899,30,30-34,1929,48.70180952118784
SIM,1838,42,30-34,1880,5
SIM,1874,64,na,1938,3260
STAT,1860,44,20-24,1904,0.2569507182665309
STAT,1873,62,na,1935,3750.6068732576746
STAT,1911,26,40-44,1937,9.214409331787031
SIM,1879,31,na,1910,4934
SIM,1912,43,50-100,1955,2
SIM,1901,19,30-34,1920,5
STAT,1879,67,na,1946,3348.7363899165894
STAT,1932,23,na,1955,9647.789276403757
STAT,1813,53,na,1866,2486.833572184414
STAT,1911,15,30-34,1926,4.950372439797864
SIM,1854,25,25-29,1879,93
SIM,1871,40,50-100,1911,2
STAT,1901,20,45-49,1921,1.9833489967706766
SIM,1871,22,20-24,1893,126
STAT,1860,23,50-100,1883,0.6844973784180752
STAT,1901,36,25-29,1937,1.7655236701638588
STAT,1930,35,40-44,1965,3.9503391827008945
SIM,1837,22,20-24,1859,107
SIM,1910,37,25-29,1947,2
STAT,1846,25,25-29,1871,79.52191969426632
SIM,1938,6,na,1944,8021
STAT,1902,40,25-29,1942,0.12843221098191585
SIM,1823,64,na,1887,1908
SIM,1914,25,20-24,1939,39
SIM,1834,56,na,1890,2624
SIM,1877,30,45-49,1907,8
SIM,1830,66,na,1896,2009
SIM,1926,16,30-34,1942,33
STAT,1879,45,50-100,1924,0.5239968346465769
SIM,1874,21,35-39,1895,14
STAT,1909,38,25-29,1947,1.8738904832743764
STAT,1911,43,30-34,1954,0.2450295418989606
STAT,1937,27,45-49,1964,3.4018444276604014
SIM,1833,100,na,1933,1
SIM,1909,32,30-34,1941,43
SIM,1917,38,25-29,1955,4
SIM,1901,44,50-100,1945,1
SIM,1903,23,25-29,1926,199
SIM,1921,23,40-44,1944,10
SIM,1930,33,35-39,1963,34
STAT,1834,30,50-100,1864,1.5950633152003737
SIM,1887,45,50-100,1932,1
STAT,1909,41,25-29,1950,0.13574452299000397
STAT,1926,37,40-44,1963,3.6942977349916672
SIM,1844,34,na,1878,3525
SIM,1848,48,na,1896,3410
STAT,1849,19,50-100,1868,0.09427012641124574
STAT,1848,22,25-29,1870,114.2915180970993
SIM,1897,23,30-34,1920,69
SIM,1925,15,25-29,1940,134
STAT,1901,20,15-19,1921,9.383211782492486
SIM,1836,28,50-100,1864,5
STAT,1808,47,30-34,1855,0.6150915303463161
SIM,1853,5,na,1858,5071
STAT,1924,38,20-24,1962,0.6269791668746648
STAT,1926,20,50-100,1946,1.6238127850272086
STAT,1906,25,20-24,1931,34.759235585650934
STAT,1915,35,45-49,1950,1.4041842587403186
SIM,1929,4,na,1933,10725
STAT,1855,37,50-100,1892,1.8513555214922448
STAT,1903,66,na,1969,5365.922672173421
STAT,1889,23,30-34,1912,44.21967033829763
STAT,1943,0,na,1943,9565.074407283284
STAT,1927,38,40-44,1965,3.754557513873946
STAT,1869,89,na,1958,286.1672880333988
SIM,1842,30,50-100,1872,4
STAT,1836,30,na,1866,3718.6430505483113
SIM,1849,43,45-49,1892,6
STAT,1813,77,na,1890,768.0995889519141
STAT,1871,45,35-39,1916,0.2837126760534795
STAT,1816,42,na,1858,3075.784076870934
STAT,1936,26,45-49,1962,3.3413225338003842
STAT,1775,86,na,1861,100.43519346609887
STAT,1872,49,15-19,1921,7.949437613519832E-4
SIM,1833,46,50-100,1879,3
STAT,1781,108,na,1889,0.010107922236996698
SIM,1839,87,na,1926,228
SIM,1849,32,35-39,1881,27
STAT,1882,31,na,1913,4714.006437087668
STAT,1825,46,50-100,1871,0.5399771948042199
STAT,1940,10,na,1950,8116.813556968823
STAT,1856,32,30-34,1888,27.539459860879646
STAT,1837,87,na,1924,245.55293990586682
SIM,1915,26,20-24,1941,43
STAT,1884,30,40-44,1914,8.718104217246358
SIM,1936,17,na,1953,6384
SIM,1904,4,na,1908,7714
STAT,1833,73,na,1906,1561.4526682250437
STAT,1917,48,25-29,1965,0.11157909176774657
STAT,1823,50,50-100,1873,0.04674182816946188
SIM,1854,87,na,1941,237
SIM,1897,0,na,1897,7579
SIM,1910,21,15-19,1931,8
SIM,1909,48,40-44,1957,1
STAT,1888,22,25-29,1910,136.64900322706902
SIM,1934,37,40-44,1971,4
STAT,1767,99,na,1866,0.5696798535906351
STAT,1837,32,20-24,1869,4.7246713954224235
SIM,1872,48,50-100,1920,2
STAT,1822,81,na,1903,610.5681916782645
STAT,1936,15,35-39,1951,8.152892110741922
SIM,1896,22,25-29,1918,186
STAT,1964,3,na,1967,10004.18862054299
STAT,1910,31,20-24,1941,4.771052598782301
SIM,1911,33,30-34,1944,44
STAT,1826,95,na,1921,15.916156084679429
SIM,1915,25,50-100,1940,4
STAT,1872,15,25-29,1887,11.67697226570553
STAT,1923,45,15-19,1968,8.741290068507038E-4
SIM,1886,33,20-24,1919,5
SIM,1839,21,40-44,1860,3
SIM,1857,52,na,1909,3805
SIM,1845,32,20-24,1877,7
SIM,1875,22,35-39,1897,15
SIM,1946,20,40-44,1966,10
STAT,1828,103,na,1931,0.1762444330961312
SIM,1906,15,20-24,1921,51
STAT,1922,33,35-39,1955,20.759436265600097
SIM,1919,37,45-49,1956,5
SIM,1880,15,25-29,1895,13
STAT,1918,27,40-44,1945,10.016354295386416
STAT,1820,55,na,1875,2517.9483713489176
SIM,1791,77,na,1868,544
SIM,1862,7,na,1869,5270
SIM,1905,22,45-49,1927,2
SIM,1828,95,na,1923,13
SIM,1902,37,na,1939,6928
SIM,1917,41,25-29,1958,1
SIM,1829,31,25-29,1860,20
STAT,1904,45,40-44,1949,0.28272518454039813
STAT,1922,45,na,1967,8561.58465622182
SIM,1936,30,25-29,1966,19
STAT,1824,69,na,1893,1569.0034237258662
STAT,1903,33,30-34,1936,28.70692126902439
SIM,1799,65,na,1864,1509
STAT,1895,41,na,1936,6130.950932869759
SIM,1854,37,50-100,1891,3
STAT,1866,21,35-39,1887,11.042372786399397
STAT,1916,36,15-19,1952,0.039907346992753036
SIM,1892,30,40-44,1922,19
STAT,1828,28,50-100,1856,1.8258368922365371
STAT,1918,16,30-34,1934,5.387906969651094
SIM,1926,27,40-44,1953,18
STAT,1915,35,15-19,1950,0.039554490865694854
STAT,1904,34,30-34,1938,28.81213093997775
STAT,1920,20,25-29,1940,208.58191293339758
STAT,1827,34,na,1861,3451.745152656106
SIM,1938,29,25-29,1967,135
STAT,1928,30,25-29,1958,23.363463426285325
STAT,1846,37,50-100,1883,1.9638170272153093
SIM,1864,32,30-34,1896,42
STAT,1926,26,30-34,1952,95.17248042150833
STAT,1921,32,35-39,1953,20.533724694858577
SIM,1925,7,na,1932,9769
SIM,1897,23,25-29,1920,165
STAT,1889,23,25-29,1912,142.11440812462826
SIM,1842,37,30-34,1879,12
STAT,1912,44,30-34,1956,0.24716442698021054
SIM,1820,39,45-49,1859,4
STAT,1898,46,na,1944,6167.616919017634
STAT,1911,53,na,1964,6876.7991181904445
STAT,1938,28,15-19,1966,1.4120574195447428
SIM,1884,20,40-44,1904,8
STAT,1938,20,40-44,1958,6.726488903912948
SIM,1878,38,na,1916,5118
STAT,1925,25,30-34,1950,94.08116875853142
SIM,1863,21,50-100,1884,5
SIM,1938,18,15-19,1956,92
STAT,1842,47,30-34,1889,0.1441413151446267
SIM,1912,34,30-34,1946,43
STAT,1920,17,25-29,1937,98.17021987985542
SIM,1806,92,na,1898,10
SIM,1856,22,30-34,1878,41
SIM,1908,1,na,1909,8099
STAT,1834,37,30-34,1871,8.824493128085445
SIM,1934,26,30-34,1960,137
SIM,1875,18,20-24,1893,49
STAT,1872,32,na,1904,4843.592209062068
STAT,1875,20,50-100,1895,0.8529989198288374
STAT,1928,38,35-39,1966,6.166398496126306
STAT,1849,69,na,1918,2321.3575612627355
SIM,1952,12,na,1964,9765
STAT,1880,75,na,1955,2190.25573402478
STAT,1919,44,40-44,1963,0.5454929177810652
SIM,1861,37,40-44,1898,11
STAT,1831,49,20-24,1880,0.01789869063884338
STAT,1830,44,35-39,1874,3.1561408677573963
SIM,1920,26,35-39,1946,41
STAT,1914,23,35-39,1937,19.37158184451799
SIM,1931,28,50-100,1959,8
SIM,1941,19,25-29,1960,118
STAT,1849,50,50-100,1899,0.024232804947350164
SIM,1911,34,50-100,1945,3
STAT,1802,82,na,1884,374.99890338527183
STAT,1843,32,45-49,1875,2.936687046825386
SIM,1855,10,na,1865,5072
STAT,1829,29,40-44,1858,6.5097274560309035
SIM,1923,39,30-34,1962,3
STAT,1888,43,30-34,1931,2.7245084986644406
STAT,1903,21,30-34,1924,51.374970161238245
SIM,1868,20,20-24,1888,135
SIM,1922,34,45-49,1956,9
SIM,1918,34,25-29,1952,27
STAT,1830,105,na,1935,0.0404884199491367
STAT,1902,17,na,1919,7201.377355619467
SIM,1851,32,45-49,1883,5
SIM,1833,93,na,1926,37
STAT,1849,20,45-49,1869,1.352945331859265
STAT,1924,25,15-19,1949,1.6708649182128041
STAT,1870,46,30-34,1916,0.1924826247545828
SIM,1847,32,25-29,1879,25
STAT,1813,45,na,1858,2807.905772367409
STAT,1843,21,35-39,1864,10.334803940519333
STAT,1926,45,40-44,1971,0.39467275141363994
SIM,1843,27,15-19,1870,1
SIM,1922,23,35-39,1945,29
SIM,1837,29,40-44,1866,8
STAT,1893,19,50-100,1912,0.12474066945623115
SIM,1907,32,20-24,1939,7
SIM,1765,93,na,1858,5
SIM,1908,39,35-39,1947,8
STAT,1912,26,35-39,1938,29.991362543614496
STAT,1839,32,25-29,1871,19.681346012877242
STAT,1882,87,na,1969,841.8368140635487
SIM,1897,22,40-44,1919,9
SIM,1927,44,40-44,1971,1
STAT,1823,52,na,1875,2893.3894867411896
SIM,1934,29,35-39,1963,55
STAT,1855,31,25-29,1886,15.890523910741132
SIM,1810,46,na,1856,2835
SIM,1851,21,35-39,1872,15
SIM,1893,39,50-100,1932,4
STAT,1917,48,30-34,1965,0.18751486436137088
SIM,1865,15,35-39,1880,4
SIM,1867,23,45-49,1890,2
STAT,1853,37,40-44,1890,6.926091325704433
STAT,1866,43,50-100,1909,1.9544553878608328
SIM,1809,89,na,1898,89
SIM,1862,32,20-24,1894,5
STAT,1856,18,45-49,1874,0.1196486283535384
SIM,1908,53,na,1961,6487
SIM,1856,20,50-100,1876,1
STAT,1921,9,na,1930,9162.138102100049
STAT,1869,97,na,1966,43.295581701121556
STAT,1890,82,na,1972,2097.2212393223167
STAT,1832,31,30-34,1863,29.99440290411509
STAT,1889,22,40-44,1911,5.189169228321459
SIM,1902,22,25-29,1924,174
STAT,1757,109,na,1866,0.01025908923441047
SIM,1922,22,45-49,1944,3
STAT,1910,19,30-34,1929,4.853351731952195
SIM,1863,19,40-44,1882,1
STAT,1855,20,15-19,1875,5.896061222518105
STAT,1831,38,50-100,1869,1.9865489168268566
STAT,1901,44,25-29,1945,0.1243781790174805
STAT,1933,19,25-29,1952,116.54289967085839
STAT,1884,31,50-100,1915,1.8347087152205424
STAT,1914,34,45-49,1948,3.17215414905851
SIM,1820,67,na,1887,1599
STAT,1919,45,30-34,1964,0.19615656897645367
STAT,1938,31,na,1969,7686.061428408522
STAT,1854,50,30-34,1904,0.009256315365995079
SIM,1896,31,50-100,1927,3
STAT,1854,32,20-24,1886,4.243454955914632
SIM,1780,85,na,1865,152
STAT,1844,14,na,1858,4856.202442700185
STAT,1812,44,50-100,1856,7.763878812381213
STAT,1894,38,40-44,1932,11.300648731303577
SIM,1913,29,na,1942,7640
STAT,1797,73,na,1870,992.9075202259365
STAT,1901,62,na,1963,5533.700363805603
STAT,1785,85,na,1870,184.72704614348146
STAT,1884,48,25-29,1932,0.11342663288543593
STAT,1838,29,na,1867,3670.8790148090766
STAT,1844,15,50-100,1859,0.10176741899805235
STAT,1881,4,na,1885,5541.197748067876
STAT,1956,16,20-24,1972,362.36167125219305
STAT,1899,44,45-49,1943,0.28370617030998546
STAT,1914,22,45-49,1936,2.3220183328792254
SIM,1861,23,15-19,1884,3
STAT,1847,54,na,1901,3191.9062574209065
STAT,1907,29,25-29,1936,123.61916840393188
STAT,1865,48,15-19,1913,7.247020984482463E-4
STAT,1825,105,na,1930,0.033925063542762625
SIM,1915,29,25-29,1944,150
STAT,1911,29,45-49,1940,3.3793059386860187
STAT,1819,47,na,1866,2820.237467663286
SIM,1850,46,50-100,1896,2
STAT,1835,27,15-19,1862,0.7661817157562487
STAT,1857,15,35-39,1872,1.027300763535115
STAT,1899,33,35-39,1932,27.904738864212835
STAT,1911,18,35-39,1929,1.6919006561527596
STAT,1848,28,na,1876,4204.198707070691
STAT,1881,39,50-100,1920,2.372532407264311
STAT,1884,8,na,1892,5184.198299408179
STAT,1853,23,15-19,1876,6.123038322493789
SIM,1835,47,40-44,1882,1
SIM,1860,96,na,1956,15
SIM,1814,90,na,1904,52
SIM,1902,24,20-24,1926,6
STAT,1880,72,na,1952,2686.90112023303
STAT,1852,34,50-100,1886,1.480912239743233
SIM,1874,44,15-19,1918,1
STAT,1884,86,na,1970,1022.4953010342567
STAT,1867,18,20-24,1885,34.078039318072314
STAT,1940,24,45-49,1964,2.3134925542061384
STAT,1944,17,50-100,1961,0.8142334893243337
SIM,1843,92,na,1935,40
SIM,1930,29,20-24,1959,51
STAT,1847,65,na,1912,2576.0805616046596
STAT,1838,18,na,1856,4079.2680133130616
STAT,1845,17,30-34,1862,3.104233170310989
STAT,1901,51,na,1952,6117.0950227828
STAT,1922,29,20-24,1951,41.4067350671594
STAT,1768,92,na,1860,18.648951730881787
STAT,1910,17,35-39,1927,1.6798345844605063
STAT,1834,54,20-24,1888,9.680616912031146E-4
STAT,1827,47,40-44,1874,0.309184950556464
STAT,1865,22,25-29,1887,106.31167951233792
STAT,1851,70,na,1921,2175.0212504355645
STAT,1910,23,20-24,1933,210.31887054150775
STAT,1884,65,na,1949,3370.242340673692
SIM,1784,75,na,1859,678
SIM,1873,22,25-29,1895,129
SIM,1859,19,20-24,1878,37
STAT,1841,50,45-49,1891,0.02135908578154039
STAT,1930,23,40-44,1953,8.672343409285075
STAT,1950,15,15-19,1965,108.42593370523393
STAT,1888,79,na,1967,2441.9278442253976
STAT,1920,33,25-29,1953,20.35534641797659
SIM,1846,15,25-29,1861,13
SIM,1926,44,30-34,1970,2
SIM,1901,26,25-29,1927,123
STAT,1859,98,na,1957,7.12918289999601
SIM,1867,51,50-100,1918,1
SIM,1881,58,na,1939,3369
STAT,1894,24,15-19,1918,8.505396742236847
STAT,1925,22,20-24,1947,268.75470117209613
SIM,1892,22,35-39,1914,22
SIM,1876,39,50-100,1915,4
SIM,1901,15,15-19,1916,18
SIM,1937,34,35-39,1971,25
STAT,1861,17,15-19,1878,11.466292409465053
STAT,1860,48,50-100,1908,0.3977430928318604
STAT,1906,28,25-29,1934,124.05251408377521
SIM,1928,24,40-44,1952,8
STAT,1802,90,na,1892,60.50877360970002
STAT,1936,24,25-29,1960,178.26635014467814
STAT,1918,44,30-34,1962,0.2735619851534432
STAT,1853,101,na,1954,0.9028414783789558
STAT,1768,105,na,1873,0.03555347410832373
STAT,1783,81,na,1864,347.6123696283375
STAT,1871,54,50-100,1925,0.029470556599660983
STAT,1913,38,45-49,1951,1.352320187218389
SIM,1892,33,45-49,1925,5
STAT,1851,37,50-100,1888,1.9236068298225266
STAT,1826,92,na,1918,49.85872358911776
STAT,1829,46,50-100,1875,0.3926253875849721
SIM,1904,39,20-24,1943,1
SIM,1958,8,na,1966,10841
STAT,1951,16,15-19,1967,109.16776582902473
STAT,1813,42,na,1855,2860.5620974683784
STAT,1942,22,20-24,1964,235.46529526023116
SIM,1856,99,na,1955,2
STAT,1873,32,30-34,1905,35.828319972367936
SIM,1928,43,45-49,1971,1
SIM,1868,79,na,1947,1197
SIM,1926,32,30-34,1958,49
STAT,1868,48,40-44,1916,0.3248318571811003
STAT,1924,23,50-100,1947,1.5628128700005215
SIM,1820,75,na,1895,1023
SIM,1949,16,25-29,1965,128
STAT,1900,29,15-19,1929,1.262019340325397
SIM,1809,60,na,1869,2067
SIM,1944,24,25-29,1968,226
SIM,1872,84,na,1956,627
STAT,1858,43,45-49,1901,2.3393160629703424
STAT,1860,21,50-100,1881,0.6944336458514169
STAT,1941,29,30-34,1970,81.7839945760657
STAT,1823,44,na,1867,3223.8784075905783
SIM,1841,29,na,1870,3837
SIM,1907,38,35-39,1945,7
STAT,1879,20,30-34,1899,37.8525507701297
STAT,1941,25,45-49,1966,3.6126789293466066
SIM,1887,16,25-29,1903,17
SIM,1933,22,20-24,1955,297
STAT,1935,32,30-34,1967,44.03009238053043
STAT,1843,18,50-100,1861,0.08718617687125971
SIM,1859,17,25-29,1876,14
SIM,1881,32,30-34,1913,37
SIM,1858,40,50-100,1898,2
STAT,1913,17,50-100,1930,0.15474455105799945
SIM,1946,16,na,1962,8049
STAT,1879,17,30-34,1896,3.367012723488561
SIM,1933,20,na,1953,10256
STAT,1891,48,50-100,1939,0.34150034660365697
STAT,1926,35,20-24,1961,0.6516679544616041
SIM,1814,41,30-34,1855,5
SIM,1844,66,na,1910,2292
SIM,1866,43,45-49,1909,8
SIM,1914,17,15-19,1931,14
STAT,1847,102,na,1949,0.4468989009683775
STAT,1855,19,40-44,1874,0.32419052755102384
STAT,1906,17,15-19,1923,17.46505181440441
SIM,1914,28,25-29,1942,156
SIM,1870,18,na,1888,4924
SIM,1876,90,na,1966,397
STAT,1929,34,35-39,1963,23.410714013872386
SIM,1902,48,50-100,1950,1
SIM,1850,20,35-39,1870,13
SIM,1868,68,na,1936,3011
SIM,1917,22,15-19,1939,11
STAT,1882,22,30-34,1904,35.04382662655377
SIM,1858,37,50-100,1895,3
SIM,1869,21,20-24,1890,125
SIM,1927,23,40-44,1950,13
SIM,1885,25,50-100,1910,2
STAT,1892,45,50-100,1937,0.35375922806317034
STAT,1926,29,35-39,1955,36.08269946571793
STAT,1842,44,50-100,1886,1.5861278969011463
STAT,1902,37,30-34,1939,3.2800247971552143
STAT,1925,42,15-19,1967,0.0037541896394655935
SIM,1917,33,25-29,1950,22
SIM,1880,19,40-44,1899,1
SIM,1849,28,20-24,1877,28
SIM,1895,61,na,1956,5089
SIM,1937,33,45-49,1970,5
STAT,1892,34,15-19,1926,0.35696614422945644
STAT,1916,28,na,1944,7795.185907817148
SIM,1855,29,na,1884,4282
STAT,1911,34,40-44,1945,7.632415206892858
SIM,1929,23,na,1952,9477
STAT,1912,46,na,1958,7150.2788388773515
STAT,1872,19,40-44,1891,0.3692548319081611
SIM,1857,106,na,1963,1
SIM,1891,21,35-39,1912,16
STAT,1879,5,na,1884,5728.883179071421
STAT,1884,33,45-49,1917,3.4629774090484218
SIM,1840,31,30-34,1871,48
STAT,1871,19,50-100,1890,0.09777576186666412
SIM,1899,19,20-24,1918,44
STAT,1909,22,15-19,1931,9.997314640863094
STAT,1925,34,20-24,1959,5.8410785151959725
STAT,1795,63,na,1858,1836.550294048974
SIM,1824,30,35-39,1854,28
SIM,1902,4,na,1906,7711
SIM,1933,34,20-24,1967,7
SIM,1944,12,na,1956,8687
STAT,1817,42,45-49,1859,8.123302086186289
STAT,1956,2,na,1958,10514.997298077618
STAT,1874,36,na,1910,4895.409092399511
STAT,1824,93,na,1917,31.245919670697017
STAT,1828,49,50-100,1877,0.43088907217765393
STAT,1885,28,na,1913,4780.730936182089
SIM,1890,22,30-34,1912,63
SIM,1874,5,na,1879,5371
STAT,1919,23,40-44,1942,7.4113710302530125
STAT,1847,45,35-39,1892,0.2155354420289566
STAT,1884,22,35-39,1906,11.637525586743038
SIM,1907,19,30-34,1926,4
SIM,1938,26,20-24,1964,35
STAT,1922,0,na,1922,10527.157619648564
SIM,1851,36,na,1887,3839
SIM,1876,48,40-44,1924,2
STAT,1905,49,15-19,1954,6.452649225604047E-4
STAT,1862,54,na,1916,3614.5911709878205
SIM,1875,33,45-49,1908,7
SIM,1825,42,45-49,1867,4
STAT,1909,35,20-24,1944,0.5089868859738662
SIM,1839,25,35-39,1864,21
STAT,1824,106,na,1930,0.012981117396186057
SIM,1933,28,35-39,1961,55
STAT,1867,33,45-49,1900,3.2843893302531697
STAT,1851,62,na,1913,2833.317050310089
SIM,1868,28,30-34,1896,59
SIM,1883,36,na,1919,4883
SIM,1898,1,na,1899,7526
STAT,1837,55,na,1892,2881.8871971583394
STAT,1912,40,15-19,1952,0.0030260165187305016
SIM,1918,31,na,1949,8313
STAT,1863,95,na,1958,35.52358110073282
STAT,1897,49,50-100,1946,0.36619635094829706
STAT,1940,26,50-100,1966,2.050953689059524
SIM,1835,24,50-100,1859,1
STAT,1792,66,na,1858,1533.3686162498489
STAT,1827,33,15-19,1860,0.33448378365695325
STAT,1898,16,35-39,1914,1.5033534434083886
STAT,1965,4,na,1969,9913.65819213303
STAT,1846,91,na,1937,88.75920000425154
STAT,1916,32,20-24,1948,5.085888883814746
STAT,1944,22,30-34,1966,62.66930782950131
SIM,1823,31,30-34,1854,44
STAT,1870,49,35-39,1919,0.27179982662113594
SIM,1924,32,20-24,1956,9
STAT,1915,39,30-34,1954,3.681335095008132
STAT,1887,34,50-100,1921,2.051889578567935
STAT,1883,21,35-39,1904,11.614146304932982
SIM,1825,31,35-39,1856,21
STAT,1915,39,50-100,1954,0.8480470136746052
SIM,1893,46,na,1939,5949
STAT,1813,74,na,1887,1020.7259345874386
SIM,1906,39,30-34,1945,3
STAT,1848,25,35-39,1873,19.16196081713667
SIM,1905,34,45-49,1939,4
STAT,1888,46,35-39,1934,0.3351379433254697
SIM,1872,21,25-29,1893,127
SIM,1892,21,na,1913,6814
SIM,1929,28,15-19,1957,4
SIM,1866,69,na,1935,2764
STAT,1803,67,na,1870,1577.7847802701942
STAT,1814,49,20-24,1863,0.06026188577678596
SIM,1788,70,na,1858,1164
STAT,1813,44,35-39,1857,11.888586100055635
SIM,1920,42,35-39,1962,1
SIM,1903,27,40-44,1930,11
STAT,1876,28,50-100,1904,1.3315241503616972
SIM,1821,44,35-39,1865,5
STAT,1858,17,na,1875,4221.6163149986705
SIM,1878,17,35-39,1895,4
STAT,1833,35,50-100,1868,2.064323584565921
SIM,1821,41,50-100,1862,4
STAT,1867,40,50-100,1907,2.0183616377260782
STAT,1816,93,na,1909,28.70671633910876
STAT,1928,35,30-34,1963,4.659250606855919
SIM,1875,40,50-100,1915,5
SIM,1881,45,45-49,1926,1
STAT,1901,41,20-24,1942,0.03132216826547488
STAT,1920,19,45-49,1939,1.1255761776169197
STAT,1929,33,45-49,1962,4.033892254128252
SIM,1886,20,15-19,1906,6
STAT,1907,4,na,1911,7808.834530496739
SIM,1920,23,30-34,1943,85
STAT,1915,15,20-24,1930,57.5780800017457
STAT,1925,28,35-39,1953,35.680048739104336
SIM,1929,39,25-29,1968,6
STAT,1838,31,25-29,1869,17.405252757734793
STAT,1950,15,45-49,1965,1.1934607789170146
SIM,1855,18,na,1873,4824
SIM,1821,38,na,1859,3196
SIM,1938,9,na,1947,7995
SIM,1800,79,na,1879,539
SIM,1933,37,25-29,1970,5
STAT,1880,3,na,1883,6441.755615160077
STAT,1900,69,na,1969,4806.766420093116
SIM,1868,47,na,1915,4339
STAT,1869,57,na,1926,3932.726353881201
STAT,1885,18,15-19,1903,11.898947619305444
SIM,1898,23,40-44,1921,10
SIM,1820,36,40-44,1856,7
SIM,1943,23,25-29,1966,208
SIM,1887,47,50-100,1934,1
STAT,1874,87,na,1961,608.5331808596063
STAT,1912,23,30-34,1935,55.47224560558237
STAT,1908,25,30-34,1933,76.00472556079472
STAT,1931,39,15-19,1970,0.051256139481855825
STAT,1792,63,na,1855,1714.8520000000003
STAT,1841,19,20-24,1860,32.78606967618499
SIM,1839,22,30-34,1861,31
SIM,1841,35,50-100,1876,3
STAT,1796,77,na,1873,698.9899324460184
STAT,1890,23,50-100,1913,1.0021606715157403
STAT,1855,15,25-29,1870,10.284282204318526
STAT,1944,19,50-100,1963,0.8136880440806373
SIM,1952,19,50-100,1971,1
STAT,1882,48,15-19,1930,7.770698534551897E-4
STAT,1925,26,15-19,1951,1.6894168053792251
SIM,1936,35,30-34,1971,3
SIM,1857,84,na,1941,480
SIM,1893,18,15-19,1911,16
STAT,1879,47,50-100,1926,0.5164055923148569
SIM,1900,33,na,1933,6908
STAT,1935,12,na,1947,10941.639403239287
STAT,1935,23,25-29,1958,253.99936741112455
SIM,1893,35,na,1928,6312
SIM,1916,25,30-34,1941,106
SIM,1919,25,50-100,1944,8
SIM,1821,60,na,1881,2216
STAT,1925,37,25-29,1962,2.386190229168012
STAT,1917,19,40-44,1936,3.013411534213227
STAT,1832,34,35-39,1866,16.84250681486602
STAT,1838,30,50-100,1868,1.5732270766571905
STAT,1922,13,na,1935,9244.288441299166
SIM,1940,18,25-29,1958,126
STAT,1901,54,na,1955,5920.5513557891745
STAT,1902,37,50-100,1939,0.7555995752133474
SIM,1846,30,50-100,1876,3
SIM,1863,15,25-29,1878,17
SIM,1839,36,na,1875,3567
SIM,1852,47,40-44,1899,2
SIM,1954,17,45-49,1971,2
STAT,1880,22,20-24,1902,146.61636238790385
SIM,1917,35,na,1952,8148
STAT,1883,16,na,1899,5023.801310368698
STAT,1842,20,35-39,1862,11.117129340049063
SIM,1865,28,na,1893,4436
SIM,1868,17,na,1885,5006
STAT,1868,34,15-19,1902,0.2712973062557445
STAT,1903,10,na,1913,7448.644041959239
SIM,1923,15,20-24,1938,314
STAT,1932,18,25-29,1950,115.59543479492913
SIM,1867,43,na,1910,4650
SIM,1901,17,35-39,1918,1
STAT,1911,61,na,1972,6472.54350338064
STAT,1822,59,na,1881,2371.665780129213
STAT,1806,54,45-49,1860,0.08135413155000651
STAT,1827,104,na,1931,0.08065598332471553
STAT,1844,47,40-44,1891,0.27518434832333655
STAT,1908,42,15-19,1950,0.002871385504457732
STAT,1910,44,20-24,1954,0.033306647217714376
STAT,1918,32,30-34,1950,33.806673556204814
SIM,1910,37,50-100,1947,2
SIM,1854,6,na,1860,5031
SIM,1876,19,20-24,1895,44
STAT,1920,30,20-24,1950,5.437974309984796
SIM,1931,24,45-49,1955,6
SIM,1932,25,50-100,1957,3
STAT,1846,40,na,1886,3675.9996026614613
SIM,1780,82,na,1862,290
SIM,1834,59,na,1893,2554
SIM,1925,19,40-44,1944,5
STAT,1864,21,25-29,1885,105.76734552133892
SIM,1892,10,na,1902,7428
STAT,1873,45,45-49,1918,0.48911336084030277
STAT,1835,77,na,1912,1119.5104479635527
STAT,1925,13,na,1938,9649.768161615224
SIM,1788,81,na,1869,318
SIM,1902,29,45-49,1931,3
STAT,1796,88,na,1884,96.79560241279394
SIM,1848,16,40-44,1864,1
SIM,1862,45,35-39,1907,1
STAT,1828,111,na,1939,1.318102548155487E-4
STAT,1923,24,45-49,1947,2.6266626608267645
STAT,1898,32,35-39,1930,27.678159871209242
STAT,1924,25,45-49,1949,4.088948975468494
STAT,1820,45,35-39,1865,0.5362986157565129
SIM,1867,54,na,1921,4208
STAT,1875,54,50-100,1929,0.030540338711922178
STAT,1839,18,45-49,1857,0.13264024148005532
SIM,1882,15,35-39,1897,1
STAT,1870,23,15-19,1893,6.521181834165164
STAT,1874,15,35-39,1889,1.1442099638375782
SIM,1932,25,45-49,1957,11
SIM,1839,41,35-39,1880,6
SIM,1923,39,na,1962,9155
STAT,1821,54,40-44,1875,0.028482564949802284
SIM,1834,67,na,1901,2036
STAT,1848,95,na,1943,21.80079052764833
STAT,1904,15,45-49,1919,0.19023270068521853
STAT,1951,18,35-39,1969,10.087606977823198
STAT,1946,17,45-49,1963,1.118907731616975
STAT,1872,28,50-100,1900,1.2938391530837061
STAT,1861,69,na,1930,2466.9527508862784
SIM,1953,16,45-49,1969,1
SIM,1845,11,na,1856,4938
STAT,1832,44,45-49,1876,2.3261881792298063
SIM,1857,22,40-44,1879,3
SIM,1819,59,na,1878,2231
SIM,1866,32,35-39,1898,25
STAT,1860,44,na,1904,3739.458341302896
STAT,1868,39,50-100,1907,2.3353964253144177
SIM,1901,31,15-19,1932,1
SIM,1911,9,na,1920,8166
STAT,1884,57,na,1941,4007.7477601529354
STAT,1883,72,na,1955,2505.9287342267276
STAT,1926,38,25-29,1964,2.427381337955753
SIM,1888,8,na,1896,6094
STAT,1913,35,40-44,1948,3.0127088724304407
STAT,1871,36,na,1907,4750.056341519976
STAT,1847,42,30-34,1889,1.7622613942481073
STAT,1850,77,na,1927,1325.3463436040458
STAT,1952,19,35-39,1971,10.148072088855095
STAT,1895,49,na,1944,5798.206817891305
SIM,1908,21,na,1929,7111
STAT,1894,64,na,1958,4660.595535898785
STAT,1910,15,15-19,1925,18.25262342165872
SIM,1831,24,50-100,1855,1
STAT,1945,16,45-49,1961,1.1023016641248318
STAT,1926,41,25-29,1967,0.1780191693334972
SIM,1903,45,50-100,1948,1
SIM,1902,18,35-39,1920,2
SIM,1845,51,na,1896,3529
STAT,1919,39,50-100,1958,0.9088274102568461
STAT,1869,43,20-24,1912,0.30854244121041785
STAT,1926,38,na,1964,9275.060581058055
STAT,1882,51,45-49,1933,0.028688284061971023
SIM,1946,2,na,1948,8835
STAT,1930,38,45-49,1968,1.7940344648567277
SIM,1970,0,na,1970,10455
SIM,1846,81,na,1927,691
STAT,1884,45,20-24,1929,0.02416983082272596
STAT,1921,17,40-44,1938,3.2191982386253013
STAT,1934,15,30-34,1949,33.45619573443673
STAT,1947,18,15-19,1965,103.20840091353537
SIM,1840,34,35-39,1874,28
STAT,1915,48,20-24,1963,0.022429362356049896
STAT,1879,21,15-19,1900,6.990153117811386
SIM,1854,25,na,1879,4275
STAT,1839,34,50-100,1873,1.7243963363913974
SIM,1901,23,20-24,1924,195
STAT,1825,47,30-34,1872,0.20991510117995854
STAT,1868,19,20-24,1887,34.27527339475821
STAT,1965,7,na,1972,9908.603073034817
SIM,1908,15,25-29,1923,20
STAT,1904,33,40-44,1937,7.187814590963186
SIM,1818,74,na,1892,1031
SIM,1840,44,45-49,1884,7
SIM,1888,33,25-29,1921,29
STAT,1873,94,na,1967,152.28983272148005
STAT,1910,26,25-29,1936,128.8534890170244
SIM,1960,7,na,1967,10823
STAT,1849,80,na,1929,978.4945303830806
STAT,1859,28,50-100,1887,1.0385374207849
STAT,1851,37,30-34,1888,8.3502933415672
STAT,1902,25,na,1927,6850.969912714661
STAT,1918,47,35-39,1965,0.2770467828521653
STAT,1935,27,40-44,1962,12.834270336519534
SIM,1806,49,na,1855,2728
SIM,1887,21,15-19,1908,7
STAT,1913,24,30-34,1937,58.26301651446437
SIM,1877,36,50-100,1913,4
SIM,1908,61,na,1969,6096
STAT,1849,22,40-44,1871,3.9851627090773407
STAT,1861,46,35-39,1907,0.23600935285237729
SIM,1848,19,15-19,1867,12
SIM,1921,24,30-34,1945,79
SIM,1875,30,40-44,1905,12
STAT,1924,45,30-34,1969,0.2152910623778569
SIM,1943,16,30-34,1959,29
STAT,1926,27,na,1953,9068.087717841261
SIM,1811,49,45-49,1860,1
STAT,1879,32,25-29,1911,21.6372672244947
STAT,1919,40,25-29,1959,0.1566891345455619
SIM,1921,35,40-44,1956,5
SIM,1943,27,40-44,1970,22
SIM,1800,90,na,1890,24
SIM,1855,42,30-34,1897,3
STAT,1935,16,30-34,1951,33.7415072622555
SIM,1847,34,50-100,1881,3
SIM,1887,32,25-29,1919,27
STAT,1817,54,20-24,1871,0.003281949140270675
SIM,1824,89,na,1913,162
STAT,1856,39,na,1895,3634.2201828582724
SIM,1906,35,45-49,1941,3
STAT,1892,38,30-34,1930,13.407914893087144
SIM,1880,17,na,1897,5639
STAT,1949,15,na,1964,8649.671640517456
SIM,1847,77,na,1924,1336
SIM,1942,15,30-34,1957,40
STAT,1919,15,35-39,1934,1.8872552299607768
SIM,1917,26,30-34,1943,102
STAT,1895,48,50-100,1943,0.36000207919447846
STAT,1852,50,20-24,1902,0.0011930045696896964
STAT,1857,54,20-24,1911,0.0011296863636621546
SIM,1932,35,na,1967,10312
STAT,1919,48,35-39,1967,0.28158354626119275
SIM,1806,60,na,1866,2126
SIM,1846,31,25-29,1877,28
SIM,1858,69,na,1927,2448
STAT,1841,47,15-19,1888,5.830025150738514E-4
STAT,1919,26,45-49,1945,3.7821067729086164
SIM,1917,37,40-44,1954,4
STAT,1802,109,na,1911,5.460330816742131E-4
STAT,1838,20,15-19,1858,5.876861963328074
STAT,1848,21,40-44,1869,4.190435496065142
SIM,1904,22,35-39,1926,21
SIM,1912,33,40-44,1945,7
STAT,1902,33,15-19,1935,0.40434002876532055
SIM,1865,31,35-39,1896,26
SIM,1907,47,25-29,1954,1
STAT,1871,50,30-34,1921,0.012115518530911395
SIM,1856,21,40-44,1877,6
SIM,1869,24,25-29,1893,122
STAT,1911,21,na,1932,7333.668503934223
STAT,1915,35,na,1950,7749.27209969242
STAT,1912,42,35-39,1954,0.39233903674985193
STAT,1853,104,na,1957,0.15698320855232473
STAT,1914,50,na,1964,7293.435553482106
STAT,1864,80,na,1944,1116.757754840357
SIM,1814,44,35-39,1858,4
SIM,1823,37,50-100,1860,3
SIM,1882,43,na,1925,4750
STAT,1841,49,50-100,1890,0.34890809454605015
SIM,1927,15,35-39,1942,19
STAT,1824,37,na,1861,3060.9496119942078
STAT,1873,35,35-39,1908,14.651873318390582
STAT,1909,26,30-34,1935,76.57274308402067
SIM,1868,25,50-100,1893,1
SIM,1927,39,50-100,1966,3
STAT,1895,33,20-24,1928,7.083433199865456
STAT,1857,31,35-39,1888,16.20784560140262
STAT,1913,43,35-39,1956,0.3960644476501176
SIM,1866,80,na,1946,1124
SIM,1888,13,na,1901,6056
SIM,1867,3,na,1870,6162
STAT,1935,35,35-39,1970,6.843819589890504
SIM,1892,50,na,1942,6222
SIM,1927,26,45-49,1953,6
SIM,1943,27,na,1970,8189
SIM,1911,21,30-34,1932,72
SIM,1886,20,45-49,1906,3
SIM,1846,20,15-19,1866,6
SIM,1905,23,35-39,1928,21
SIM,1955,4,na,1959,10125
SIM,1868,23,25-29,1891,129
STAT,1868,44,25-29,1912,1.217266061081593
STAT,1909,37,40-44,1946,2.8632461933807183
SIM,1947,12,na,1959,9313
STAT,1875,72,na,1947,2626.0025100116163
STAT,1813,41,50-100,1854,8.163085200124055
STAT,1828,42,20-24,1870,0.29902978770187405
STAT,1858,32,35-39,1890,15.944238293295918
STAT,1880,35,35-39,1915,15.191071020257082
SIM,1881,35,35-39,1916,19
STAT,1860,84,na,1944,545.5951911229316
SIM,1813,97,na,1910,2
SIM,1918,38,40-44,1956,2
SIM,1876,44,25-29,1920,3
STAT,1836,70,na,1906,1865.5038486031397
STAT,1804,60,na,1864,1990.0288472660447
STAT,1897,22,50-100,1919,1.1008880845885074
STAT,1879,36,40-44,1915,9.291882622681754
SIM,1837,53,na,1890,2826
SIM,1905,20,30-34,1925,69
SIM,1890,22,25-29,1912,170
STAT,1820,42,30-34,1862,4.651044033686484
STAT,1863,29,40-44,1892,5.258008926959474
SIM,1884,55,na,1939,4440
STAT,1892,39,20-24,1931,1.9293189257998518
STAT,1902,44,40-44,1946,0.43935252130270436
SIM,1901,35,30-34,1936,7
STAT,1822,50,40-44,1872,0.032769597309099
STAT,1903,34,50-100,1937,1.4999045556050024
SIM,1818,37,30-34,1855,13
SIM,1919,20,15-19,1939,15
STAT,1936,27,35-39,1963,29.024212674077827
STAT,1879,20,25-29,1899,121.65158192157433
STAT,1942,14,na,1956,8287.76199943473
SIM,1833,63,na,1896,2297
SIM,1930,15,50-100,1945,1
SIM,1797,61,na,1858,1891
SIM,1827,37,40-44,1864,11
SIM,1919,46,40-44,1965,1
SIM,1924,8,na,1932,9993
STAT,1805,53,45-49,1858,0.11167017638971696
SIM,1928,20,25-29,1948,287
STAT,1837,26,35-39,1863,17.38983614451372
STAT,1855,20,na,1875,3821.291440853748
STAT,1877,28,30-34,1905,52.62453492213904
SIM,1793,71,na,1864,1114
SIM,1829,58,na,1887,2538
STAT,1856,20,30-34,1876,32.70363883296653
STAT,1931,18,45-49,1949,1.3171158954480466
STAT,1869,2,na,1871,6529.521301844572
SIM,1936,6,na,1942,6956
STAT,1851,30,na,1881,3931.0182083510495
STAT,1868,72,na,1940,2426.685888960738
SIM,1789,66,na,1855,1561
SIM,1883,15,15-19,1898,12
SIM,1888,45,na,1933,5360
STAT,1888,43,50-100,1931,2.5036023986842277
STAT,1900,25,20-24,1925,33.09010292508295
SIM,1842,33,15-19,1875,1
STAT,1930,20,15-19,1950,13.854525803895864
STAT,1875,15,15-19,1890,12.397351021252566
STAT,1854,45,35-39,1899,0.21675787100495267
STAT,1894,47,30-34,1941,0.1410020896284415
SIM,1823,31,25-29,1854,24
SIM,1808,64,na,1872,1854
STAT,1871,24,15-19,1895,6.578101779376905
SIM,1885,28,30-34,1913,62
SIM,1924,35,25-29,1959,3
SIM,1918,17,40-44,1935,3
STAT,1843,37,15-19,1880,0.09183127532660479
STAT,1916,28,20-24,1944,37.983726607588885
SIM,1905,64,na,1969,5744
STAT,1872,44,45-49,1916,2.996786719821292
STAT,1916,35,25-29,1951,2.0556967000350177
SIM,1871,35,35-39,1906,5
SIM,1896,29,45-49,1925,4
STAT,1848,48,15-19,1896,6.476411608201169E-4
STAT,1914,27,15-19,1941,1.43755151840117
STAT,1848,20,50-100,1868,0.8259766573972204
SIM,1861,60,na,1921,3643
STAT,1814,48,45-49,1862,1.203744617313581
SIM,1887,36,40-44,1923,17
SIM,1924,15,15-19,1939,111
STAT,1856,45,45-49,1901,0.371409985831333
SIM,1863,37,50-100,1900,1
STAT,1887,31,15-19,1918,0.3229839551028944
SIM,1821,49,40-44,1870,1
STAT,1787,106,na,1893,0.008930354831485389
SIM,1851,17,20-24,1868,34
SIM,1916,29,40-44,1945,1
STAT,1847,42,25-29,1889,0.9843261882019839
STAT,1867,21,45-49,1888,1.3339423225397433
SIM,1859,56,na,1915,3614
STAT,1909,38,30-34,1947,3.468690913612618
SIM,1924,28,20-24,1952,44
STAT,1831,45,40-44,1876,0.26879185664664
STAT,1825,48,20-24,1873,0.025666820482468017
STAT,1917,13,na,1930,8569.09763135864
STAT,1843,17,20-24,1860,31.7367067500607
STAT,1917,15,na,1932,8432.292257962088
SIM,1885,40,45-49,1925,3
SIM,1949,16,30-34,1965,37
STAT,1848,32,50-100,1880,1.7520358132301042
SIM,1831,62,na,1893,2444
SIM,1917,38,30-34,1955,6
SIM,1950,18,20-24,1968,325
SIM,1875,21,45-49,1896,1
SIM,1922,27,15-19,1949,2
STAT,1908,29,40-44,1937,8.8411384199449
SIM,1836,93,na,1929,14
SIM,1892,72,na,1964,4128
SIM,1869,22,50-100,1891,1
STAT,1845,34,15-19,1879,0.2555536942981498
STAT,1885,42,na,1927,4640.556136775063
STAT,1840,78,na,1918,1127.8071523995643
STAT,1786,89,na,1875,67.18277854915284
STAT,1927,34,30-34,1961,39.085196663670324
SIM,1871,100,na,1971,13
SIM,1910,28,35-39,1938,39
STAT,1942,18,20-24,1960,286.056791223168
STAT,1920,37,40-44,1957,3.3094492676940614
STAT,1946,26,na,1972,8430.956107487256
SIM,1889,42,50-100,1931,6
SIM,1912,36,45-49,1948,1
SIM,1951,17,25-29,1968,2
SIM,1880,44,45-49,1924,6
STAT,1934,19,40-44,1953,3.800986756155398
STAT,1844,16,25-29,1860,11.701768724531863
SIM,1822,48,45-49,1870,2
SIM,1919,33,35-39,1952,29
STAT,1848,9,na,1857,4952.213464234203
STAT,1905,28,45-49,1933,3.2315366977869124
STAT,1941,29,25-29,1970,137.38356558605156
STAT,1872,24,na,1896,4770.383405387935
SIM,1905,42,na,1947,6982
STAT,1792,95,na,1887,5.3054900539305345
STAT,1880,25,25-29,1905,90.60994673014865
STAT,1910,47,25-29,1957,0.09999057725782205
STAT,1852,17,30-34,1869,3.072427331253159
STAT,1874,25,na,1899,4968.608275245493
SIM,1892,18,20-24,1910,43
STAT,1919,41,15-19,1960,0.0033651773859697752
STAT,1863,16,35-39,1879,1.1134918932496345
STAT,1889,49,15-19,1938,5.501474074887398E-4
STAT,1894,34,25-29,1928,26.345869362104544
SIM,1930,31,na,1961,10428
STAT,1929,31,30-34,1960,40.43715694237487
STAT,1899,49,15-19,1948,6.113220135487502E-4
SIM,1889,33,40-44,1922,15
STAT,1875,34,15-19,1909,0.2935803972108161
STAT,1902,28,35-39,1930,27.415591346673537
STAT,1826,47,25-29,1873,0.11485902926517141
STAT,1943,17,25-29,1960,92.80627011258431
STAT,1866,49,20-24,1915,0.021894861067070347
SIM,1879,43,25-29,1922,2
SIM,1835,43,25-29,1878,5
STAT,1821,38,35-39,1859,26.039402503115152
STAT,1843,44,20-24,1887,0.22326142044570413
STAT,1831,43,45-49,1874,2.3394708298106504
STAT,1851,31,35-39,1882,16.510189171040427
STAT,1920,17,30-34,1937,27.61214257773366
SIM,1896,9,na,1905,7233
STAT,1837,39,40-44,1876,7.277353565636459
SIM,1865,19,15-19,1884,12
STAT,1885,50,na,1935,4390.707220891885
STAT,1876,54,30-34,1930,0.012092113017283884
SIM,1888,67,na,1955,3728
STAT,1827,43,25-29,1870,1.1979024282805681
SIM,1860,17,30-34,1877,3
STAT,1924,22,40-44,1946,8.010726329049579
STAT,1869,17,40-44,1886,0.3628866717512018
STAT,1890,15,40-44,1905,0.4529794349386519
STAT,1820,39,30-34,1859,23.510101014145523
SIM,1806,63,na,1869,1872
STAT,1868,70,na,1938,2696.0441131659763
STAT,1882,22,25-29,1904,112.62482604130842
SIM,1942,19,40-44,1961,4
SIM,1907,32,50-100,1939,2
SIM,1913,28,45-49,1941,3
SIM,1831,24,40-44,1855,4
STAT,1844,68,na,1912,2467.907652096724
SIM,1937,31,30-34,1968,7
STAT,1842,87,na,1929,262.30048816861216
SIM,1890,35,45-49,1925,8
STAT,1877,37,50-100,1914,2.5747708086252814
STAT,1817,80,na,1897,623.9319545796761
SIM,1910,44,40-44,1954,1
STAT,1857,19,15-19,1876,10.851281598616684
SIM,1894,28,40-44,1922,13
STAT,1872,46,40-44,1918,0.34847816802250897
STAT,1884,18,20-24,1902,35.26285530423315
STAT,1886,28,40-44,1914,6.363890171490248
SIM,1781,78,na,1859,513
STAT,1922,25,40-44,1947,10.721348429073824
SIM,1804,82,na,1886,238
SIM,1823,44,45-49,1867,4
SIM,1930,25,40-44,1955,18
SIM,1889,20,35-39,1909,19
STAT,1895,46,35-39,1941,0.2084142824775277
STAT,1942,25,25-29,1967,139.6434698694477
STAT,1878,15,na,1893,5352.0139698099365
SIM,1844,80,na,1924,737
STAT,1909,15,50-100,1924,0.1491540664420892
SIM,1916,22,50-100,1938,2
SIM,1895,15,na,1910,7085
STAT,1819,37,40-44,1856,25.458504072962324
SIM,1875,94,na,1969,113
SIM,1871,16,35-39,1887,4
STAT,1877,55,na,1932,4336.322467822713
SIM,1821,34,25-29,1855,24
SIM,1861,33,25-29,1894,26
SIM,1842,22,na,1864,4244
SIM,1884,38,25-29,1922,7
SIM,1849,38,30-34,1887,14
SIM,1942,24,20-24,1966,224
SIM,1891,25,na,1916,6202
STAT,1849,38,20-24,1887,1.2348057298303963
SIM,1884,23,na,1907,5125
SIM,1826,83,na,1909,382
STAT,1888,40,20-24,1928,0.38292227626142816
STAT,1869,46,25-29,1915,0.11303974845932714
SIM,1839,34,na,1873,3568
SIM,1809,50,50-100,1859,1
STAT,1846,54,45-49,1900,0.02161751982091632
SIM,1870,17,30-34,1887,4
STAT,1908,30,na,1938,7272.743553431764
STAT,1835,43,50-100,1878,1.6193256950115353
SIM,1797,93,na,1890,9
SIM,1851,41,50-100,1892,2
SIM,1923,19,15-19,1942,99
STAT,1846,111,na,1957,1.7987877417468615E-4
STAT,1864,28,45-49,1892,1.997385133825471
SIM,1945,23,35-39,1968,1
STAT,1915,19,15-19,1934,19.08199797593842
STAT,1810,52,15-19,1862,1.5204516178463635E-4
SIM,1842,31,35-39,1873,29
STAT,1886,35,15-19,1921,0.12085527983373422
STAT,1899,29,20-24,1928,32.23053651516657
STAT,1819,61,na,1880,2147.8727395940487
STAT,1897,53,na,1950,5719.6080718126495
STAT,1951,6,na,1957,9453.635601714168
STAT,1819,44,15-19,1863,0.05988445339566674
STAT,1917,47,na,1964,7749.231921422425
SIM,1886,24,30-34,1910,45
SIM,1795,80,na,1875,489
SIM,1925,24,20-24,1949,277
STAT,1938,17,na,1955,7334.144379690381
STAT,1894,1,na,1895,7061.601727846748
STAT,1850,6,na,1856,4674.261357348
STAT,1915,39,25-29,1954,1.9887672243172156
SIM,1904,17,na,1921,7447
SIM,1938,24,50-100,1962,1
SIM,1932,22,40-44,1954,11
STAT,1859,20,40-44,1879,3.87459047489184
STAT,1878,21,20-24,1899,145.79601632181397
SIM,1888,24,35-39,1912,16
STAT,1838,35,40-44,1873,7.2988774593178585
SIM,1906,39,25-29,1945,5
SIM,1855,72,na,1927,2055
STAT,1917,24,20-24,1941,237.16302265835733
STAT,1928,40,50-100,1968,0.3032629784300159
STAT,1934,24,20-24,1958,301.6356561599889
SIM,1857,38,20-24,1895,2
STAT,1904,16,35-39,1920,1.594471439958487
SIM,1901,23,50-100,1924,1
STAT,1859,27,25-29,1886,69.17280777162527
SIM,1874,49,20-24,1923,1
STAT,1878,24,30-34,1902,37.336257060665496
STAT,1860,23,15-19,1883,5.537583153898331
STAT,1871,29,35-39,1900,19.222345139267098
SIM,1902,47,40-44,1949,1
SIM,1912,16,35-39,1928,3
STAT,1904,40,na,1944,6790.65585448713
STAT,1908,49,35-39,1957,0.23426338565692525
SIM,1923,39,25-29,1962,3
STAT,1904,36,45-49,1940,1.253262974958832
STAT,1770,112,na,1882,0.0012952821763143475
SIM,1852,16,25-29,1868,12
SIM,1916,49,35-39,1965,1
STAT,1827,88,na,1915,166.00803843186483
SIM,1902,27,30-34,1929,84
STAT,1855,46,40-44,1901,0.25889132496766953
STAT,1925,21,45-49,1946,2.7277238531436345
SIM,1935,34,30-34,1969,60
STAT,1858,38,30-34,1896,8.349365635017191
STAT,1826,63,na,1889,2160.055670938624
STAT,1834,31,35-39,1865,17.447776661240248
STAT,1841,38,na,1879,3623.553144777927
SIM,1883,33,50-100,1916,5
STAT,1917,44,15-19,1961,0.0032256394539576993
SIM,1867,27,25-29,1894,91
STAT,1767,96,na,1863,2.483095655353936
STAT,1867,48,25-29,1915,0.10757714498571827
SIM,1862,20,na,1882,4509
STAT,1853,33,25-29,1886,16.516288817867398
SIM,1847,23,35-39,1870,1
SIM,1867,20,40-44,1887,4
SIM,1867,51,na,1918,4355
SIM,1833,41,35-39,1874,8
STAT,1868,27,na,1895,4585.767387177257
SIM,1897,25,45-49,1922,6
SIM,1916,21,45-49,1937,3
SIM,1846,35,40-44,1881,14
STAT,1877,25,50-100,1902,1.3506375622816893
SIM,1845,39,50-100,1884,3
STAT,1813,49,40-44,1862,1.020134994338772
STAT,1943,3,na,1946,8611.624892532638
STAT,1826,49,na,1875,2980.91179622383
STAT,1830,49,40-44,1879,0.2879732101147849
SIM,1816,41,35-39,1857,6
STAT,1858,94,na,1952,31.466446992504245
STAT,1892,32,35-39,1924,25.604219460101827
STAT,1881,39,45-49,1920,3.852282378189128
STAT,1918,23,25-29,1941,200.5439560768048
SIM,1905,10,na,1915,7823
SIM,1876,26,na,1902,5148
SIM,1884,77,na,1961,2153
STAT,1895,36,25-29,1931,7.613451683244959
STAT,1897,75,na,1972,3731.694238027611
STAT,1935,31,50-100,1966,2.311938250683683
SIM,1797,95,na,1892,7
SIM,1883,32,35-39,1915,23
STAT,1875,32,35-39,1907,21.057730658450822
STAT,1909,18,na,1927,7633.507914428109
SIM,1916,34,20-24,1950,7
STAT,1837,26,50-100,1863,1.1528892443325838
STAT,1840,38,45-49,1878,3.3681971812068183
STAT,1831,93,na,1924,37.73431157170489
STAT,1937,23,35-39,1960,18.51600623066416
STAT,1908,21,45-49,1929,2.096804580677458
SIM,1813,43,na,1856,3034
SIM,1868,38,40-44,1906,14
STAT,1829,102,na,1931,0.34697526726577804
STAT,1889,24,na,1913,5852.652308700117
STAT,1809,102,na,1911,0.26057802214690406
STAT,1839,99,na,1938,2.9571376589403853
STAT,1850,103,na,1953,0.22004724205829063
STAT,1899,16,15-19,1915,16.462056939998206
SIM,1821,52,na,1873,2646
STAT,1825,41,35-39,1866,4.27367858491151
SIM,1926,23,25-29,1949,253
STAT,1867,28,30-34,1895,47.46200820150781
STAT,1889,25,45-49,1914,2.7836713915854796
SIM,1906,32,40-44,1938,11
STAT,1839,23,35-39,1862,11.623373936797295
STAT,1853,46,30-34,1899,0.1535919426004357
SIM,1854,33,na,1887,4065
STAT,1776,79,na,1855,513.90705
STAT,1834,33,15-19,1867,0.24030934323572972
STAT,1896,34,na,1930,6308.450495245624
SIM,1925,39,35-39,1964,8
STAT,1914,20,30-34,1934,57.25669450482704
SIM,1857,25,15-19,1882,1
SIM,1880,20,15-19,1900,7
STAT,1834,50,na,1884,3052.472532532707
STAT,1861,43,30-34,1904,1.9186412652360803
SIM,1793,89,na,1882,45
STAT,1826,41,na,1867,3286.212587357304
STAT,1839,81,na,1920,844.3650270885114
STAT,1862,39,35-39,1901,12.086404780372417
STAT,1858,2,na,1860,5507.8875069774995
STAT,1893,71,na,1964,3921.0877110034376
STAT,1908,34,20-24,1942,4.613176714810747
SIM,1848,19,na,1867,4330
SIM,1895,34,50-100,1929,5
STAT,1848,50,na,1898,3581.300358775416
SIM,1804,80,na,1884,407
STAT,1917,39,35-39,1956,5.042593672252244
SIM,1870,39,35-39,1909,22
SIM,1914,25,na,1939,7801
SIM,1845,23,30-34,1868,45
STAT,1891,23,50-100,1914,1.014855053385228
STAT,1904,30,15-19,1934,0.41612094728345006
STAT,1849,25,15-19,1874,0.8630748335842104
STAT,1860,17,20-24,1877,33.53424738887114
STAT,1864,66,na,1930,2958.9205719951433
SIM,1944,24,30-34,1968,76
STAT,1837,23,30-34,1860,32.27356442700549
SIM,1858,37,25-29,1895,7
SIM,1861,46,30-34,1907,2
STAT,1805,50,40-44,1855,0.08606914442080317
SIM,1895,47,na,1942,6193
STAT,1934,36,30-34,1970,5.084901671058966
STAT,1911,23,15-19,1934,10.167482599824798
STAT,1829,34,30-34,1863,31.72903066548613
STAT,1894,28,30-34,1922,65.10187237857198
STAT,1846,29,40-44,1875,5.471325565774072
SIM,1892,24,15-19,1916,10
STAT,1903,24,35-39,1927,16.675239517076726
SIM,1907,35,25-29,1942,4
SIM,1842,54,na,1896,2994
STAT,1786,104,na,1890,0.061988980052779086
STAT,1877,87,na,1964,735.8892964899605
SIM,1852,41,50-100,1893,3
STAT,1852,34,20-24,1886,4.368908275106714
STAT,1835,37,25-29,1872,4.61223354323916
STAT,1839,20,30-34,1859,36.254645053379065
STAT,1919,47,45-49,1966,0.4759926655029474
SIM,1901,38,35-39,1939,6
STAT,1809,69,na,1878,1590.5289687095512
STAT,1837,45,35-39,1882,0.2078590803482669
STAT,1853,29,50-100,1882,1.0517068030314016
SIM,1925,19,na,1944,8945
STAT,1866,42,35-39,1908,3.370260301080477
STAT,1919,27,35-39,1946,32.755442976467975
SIM,1864,32,25-29,1896,24
SIM,1939,19,50-100,1958,1
STAT,1898,39,15-19,1937,0.032792903115536
SIM,1927,27,35-39,1954,51
STAT,1897,46,45-49,1943,0.36040656143128463
STAT,1872,41,40-44,1913,4.586103852375267
SIM,1853,49,na,1902,3630
SIM,1868,90,na,1958,173
STAT,1853,52,50-100,1905,0.02376838375715513
STAT,1840,24,50-100,1864,0.7378403410239616
STAT,1828,45,25-29,1873,0.10651552710512734
STAT,1864,35,50-100,1899,2.237505612687822
SIM,1874,42,35-39,1916,2
SIM,1817,55,na,1872,2559
SIM,1909,23,25-29,1932,194
SIM,1858,21,45-49,1879,1
STAT,1856,23,35-39,1879,10.484908145973034
STAT,1856,32,25-29,1888,16.155805063639495
STAT,1858,31,45-49,1889,2.7741627139423715
SIM,1837,34,30-34,1871,36
STAT,1871,9,na,1880,5406.689963897622
SIM,1911,24,35-39,1935,23
SIM,1936,28,na,1964,6487
SIM,1859,44,25-29,1903,2
SIM,1918,31,20-24,1949,5
STAT,1884,24,15-19,1908,6.537959605188781
SIM,1813,94,na,1907,9
STAT,1898,20,35-39,1918,16.044039080237354
STAT,1843,19,na,1862,4060.9193414008623
SIM,1900,18,25-29,1918,15
STAT,1891,36,50-100,1927,3.0796666557743944
STAT,1932,39,50-100,1971,1.1369636539170287
STAT,1900,28,25-29,1928,118.09553317225388
SIM,1843,41,na,1884,3537
SIM,1846,38,45-49,1884,7
SIM,1825,33,15-19,1858,1
SIM,1845,40,15-19,1885,1
STAT,1770,110,na,1880,0.0032982728529425158
SIM,1953,17,35-39,1970,15
SIM,1929,35,45-49,1964,4
STAT,1924,17,na,1941,8849.923992480415
SIM,1853,91,na,1944,76
STAT,1839,67,na,1906,2475.2040579043864
SIM,1860,34,20-24,1894,7
SIM,1885,34,25-29,1919,27
STAT,1873,20,30-34,1893,36.76989352413608
SIM,1843,37,25-29,1880,8
SIM,1877,53,na,1930,4276
STAT,1897,21,na,1918,6404.060594208119
STAT,1877,34,25-29,1911,21.296455411265924
SIM,1857,42,35-39,1899,4
SIM,1933,21,45-49,1954,7
STAT,1841,71,na,1912,1936.7020886915245
SIM,1819,99,na,1918,2
SIM,1863,48,50-100,1911,2
STAT,1858,48,15-19,1906,6.218537578115212E-4
STAT,1901,29,30-34,1930,70.68965343998441
STAT,1943,29,35-39,1972,32.25991394593486
SIM,1861,27,30-34,1888,62
SIM,1877,75,na,1952,1882
SIM,1847,85,na,1932,360
STAT,1848,24,45-49,1872,1.372290121461005
STAT,1849,44,15-19,1893,0.02154950640765963
STAT,1794,76,na,1870,774.5731357452487
STAT,1826,44,20-24,1870,0.32212347163950217
STAT,1924,29,25-29,1953,153.62910806754095
STAT,1908,46,30-34,1954,0.16415931744223008
STAT,1762,101,na,1863,0.2966765654253344
SIM,1934,17,25-29,1951,147
STAT,1817,53,50-100,1870,0.06852630354230796
STAT,1838,38,45-49,1876,3.221915894206792
STAT,1842,27,15-19,1869,0.8353306340490475
STAT,1862,34,15-19,1896,0.24371965368236773
STAT,1920,32,50-100,1952,1.8285910175480757
STAT,1867,23,na,1890,4459.488580156324
SIM,1850,27,15-19,1877,1
SIM,1866,28,20-24,1894,26
STAT,1864,39,45-49,1903,3.5626395421156207
STAT,1939,16,na,1955,7443.911497690998
SIM,1898,43,35-39,1941,1
STAT,1858,28,20-24,1886,18.772114445280607
SIM,1851,39,na,1890,3693
SIM,1842,27,20-24,1869,28
SIM,1872,39,45-49,1911,9
STAT,1853,27,30-34,1880,46.15614906335607
STAT,1833,53,20-24,1886,9.818277542351485E-4
STAT,1834,36,na,1870,3577.2877863990934
SIM,1893,17,25-29,1910,15
STAT,1905,44,na,1949,6682.502572054901
STAT,1933,15,15-19,1948,123.27916669110124
STAT,1941,26,20-24,1967,38.15549612084118
SIM,1811,93,na,1904,20
STAT,1834,27,20-24,1861,20.477144611479247
STAT,1826,43,50-100,1869,2.186534729994127
SIM,1854,29,40-44,1883,7
STAT,1876,38,25-29,1914,5.984408420181609
SIM,1822,79,na,1901,674
STAT,1885,17,25-29,1902,11.391802553842648
SIM,1872,52,na,1924,4489
SIM,1931,17,15-19,1948,125
STAT,1864,25,40-44,1889,5.465722386422259
STAT,1928,20,15-19,1948,13.500986618860134
SIM,1834,43,50-100,1877,2
SIM,1862,35,25-29,1897,6
STAT,1805,79,na,1884,649.3618865500423
STAT,1931,27,15-19,1958,1.8407810550993264
SIM,1772,87,na,1859,71
SIM,1921,40,na,1961,8497
STAT,1923,17,15-19,1940,107.59270301596737
STAT,1886,16,50-100,1902,0.10470439746827051
SIM,1918,34,30-34,1952,56
STAT,1822,53,45-49,1875,0.04255462275275743
STAT,1860,21,35-39,1881,9.937344309034001
STAT,1809,47,25-29,1856,0.44647371108111417
STAT,1844,60,na,1904,3079.9312037118852
STAT,1854,39,40-44,1893,6.643116358600492
SIM,1864,57,na,1921,3795
STAT,1878,41,15-19,1919,0.02926088518545563
STAT,1941,22,40-44,1963,7.0179285709685875
SIM,1871,88,na,1959,279
STAT,1819,93,na,1912,30.58077052616967
STAT,1831,40,40-44,1871,3.654710064215891
STAT,1854,35,25-29,1889,4.481308291519421
STAT,1922,16,na,1938,8621.951183993515
SIM,1936,20,15-19,1956,8
SIM,1932,29,25-29,1961,179
STAT,1893,35,20-24,1928,1.9920196177414469
SIM,1872,25,40-44,1897,4
SIM,1800,76,na,1876,728
SIM,1951,17,na,1968,9778
STAT,1926,17,25-29,1943,107.28629971212193
STAT,1829,30,15-19,1859,0.28923031064193133
SIM,1947,20,35-39,1967,28
SIM,1838,28,45-49,1866,2
STAT,1880,0,na,1880,7672.141939673954
SIM,1819,81,na,1900,432
SIM,1926,35,35-39,1961,11
SIM,1875,28,30-34,1903,68
SIM,1908,27,25-29,1935,126
STAT,1850,37,15-19,1887,0.08746353450425923
STAT,1806,94,na,1900,13.608832247130804
SIM,1940,19,15-19,1959,90
STAT,1875,28,20-24,1903,24.307945505928075
SIM,1886,27,35-39,1913,33
SIM,1886,46,35-39,1932,1
SIM,1923,36,20-24,1959,1
STAT,1934,27,25-29,1961,178.85202230636082
SIM,1888,21,30-34,1909,57
STAT,1801,107,na,1908,0.003738180050929718
STAT,1815,44,45-49,1859,8.378966438484671
STAT,1884,38,15-19,1922,0.11143192693916625
STAT,1936,21,20-24,1957,214.81462779928387
STAT,1775,109,na,1884,0.004747506783377099
SIM,1855,30,30-34,1885,38
STAT,1932,19,15-19,1951,120.7258234259881
SIM,1859,22,15-19,1881,6
STAT,1854,20,20-24,1874,125.92743566681894
SIM,1942,27,25-29,1969,149
STAT,1859,24,20-24,1883,113.28942106414108
SIM,1849,19,30-34,1868,5
STAT,1863,30,15-19,1893,0.25378632572174414
STAT,1838,52,25-29,1890,0.0047682606931048
SIM,1904,35,40-44,1939,5
STAT,1935,28,30-34,1963,107.83818598676237
SIM,1862,76,na,1938,1579
STAT,1882,35,45-49,1917,3.959226630015818
SIM,1890,25,35-39,1915,31
SIM,1904,15,na,1919,7471
STAT,1925,25,25-29,1950,158.04078151903667
SIM,1944,21,20-24,1965,241
STAT,1831,95,na,1926,17.166509093813104
STAT,1896,21,15-19,1917,8.823168796323262
STAT,1947,20,25-29,1967,210.9689550764261
STAT,1866,22,40-44,1888,3.91484171702326
STAT,1878,27,35-39,1905,20.3524913340836
STAT,1878,46,35-39,1924,0.29614051324388657
STAT,1914,58,na,1972,6981.674023017711
SIM,1874,22,40-44,1896,5
STAT,1862,51,25-29,1913,0.0061434812918875325
SIM,1853,17,30-34,1870,5
SIM,1916,46,30-34,1962,1
SIM,1837,21,na,1858,3800
SIM,1859,88,na,1947,156
STAT,1897,19,45-49,1916,0.17540165817241216
SIM,1886,36,na,1922,4959
STAT,1810,49,50-100,1859,1.5415308211212544
SIM,1833,31,na,1864,3638
STAT,1880,51,40-44,1931,0.022505510536448097
SIM,1791,90,na,1881,32
STAT,1774,90,na,1864,41.944463890598314
STAT,1901,17,20-24,1918,50.12510005357517
SIM,1828,39,40-44,1867,10
SIM,1914,28,50-100,1942,3
STAT,1930,26,45-49,1956,4.438516803809843
STAT,1939,20,35-39,1959,19.113370169109306
STAT,1918,35,35-39,1953,5.196851577682197
SIM,1810,54,na,1864,2478
STAT,1890,18,45-49,1908,0.1606082616484034
SIM,1863,20,15-19,1883,5
SIM,1876,38,30-34,1914,11
SIM,1933,25,25-29,1958,195
STAT,1913,31,na,1944,7632.522755021709
STAT,1845,27,40-44,1872,5.618460670652381
SIM,1871,37,na,1908,4598
SIM,1887,20,25-29,1907,158
STAT,1828,49,40-44,1877,0.3003591580239746
SIM,1831,27,45-49,1858,1
STAT,1823,107,na,1930,0.005659151321296852
SIM,1819,36,35-39,1855,16
STAT,1818,97,na,1915,5.5116139917660565
SIM,1899,22,45-49,1921,3
SIM,1914,24,45-49,1938,3
STAT,1945,17,35-39,1962,9.256743080188688
STAT,1803,51,50-100,1854,0.1132105759761114
STAT,1877,40,45-49,1917,3.1703617551651146
SIM,1853,27,40-44,1880,8
STAT,1882,25,35-39,1907,19.112058481957646
STAT,1774,110,na,1884,0.0028963768284175876
STAT,1915,36,20-24,1951,0.5404558103875682
SIM,1930,28,50-100,1958,4
SIM,1883,28,20-24,1911,23
STAT,1862,43,50-100,1905,1.8104749281071686
STAT,1899,32,45-49,1931,4.8253978110035
STAT,1849,42,35-39,1891,2.8608155962955086
SIM,1937,8,na,1945,8011
STAT,1868,38,30-34,1906,10.190129377262814
SIM,1897,28,na,1925,6494
STAT,1928,16,45-49,1944,1.2741515927495715
STAT,1841,21,25-29,1862,105.98062234321243
STAT,1903,46,50-100,1949,0.3995081826850738
SIM,1875,6,na,1881,6094
SIM,1783,79,na,1862,557
STAT,1859,23,45-49,1882,1.1546596090190577
STAT,1906,24,45-49,1930,2.0393314878059883
STAT,1854,24,50-100,1878,0.724004838979571
STAT,1843,47,25-29,1890,0.08031093250551964
STAT,1881,38,na,1919,4576.247585576972
STAT,1790,86,na,1876,130.95021263108842
STAT,1859,36,na,1895,3805.4358565973735
STAT,1871,90,na,1961,298.07919429956524
STAT,1824,49,50-100,1873,0.5783279570589127
SIM,1925,15,30-34,1940,37
SIM,1866,31,45-49,1897,5
SIM,1884,28,15-19,1912,1
STAT,1927,37,35-39,1964,6.072534947703285
STAT,1855,48,50-100,1903,0.36569523878507865
STAT,1871,17,40-44,1888,0.3693679399176705
SIM,1870,43,50-100,1913,3
SIM,1827,27,30-34,1854,8
SIM,1828,35,50-100,1863,2
SIM,1830,34,35-39,1864,22
SIM,1851,82,na,1933,596
STAT,1861,27,25-29,1888,71.62566601343374
STAT,1925,10,na,1935,9694.00230938132
SIM,1888,42,50-100,1930,2
SIM,1878,36,50-100,1914,7
SIM,1894,18,30-34,1912,5
SIM,1912,44,na,1956,7355
SIM,1943,28,30-34,1971,101
STAT,1836,49,35-39,1885,0.18991667907772686
SIM,1880,41,40-44,1921,10
STAT,1841,34,45-49,1875,3.006748427219818
SIM,1862,74,na,1936,1889
SIM,1944,15,na,1959,8119
SIM,1915,25,15-19,1940,1
STAT,1801,63,na,1864,1872.8701094111018
STAT,1828,30,20-24,1858,6.442270404288813
STAT,1933,37,50-100,1970,1.1550849395273892
SIM,1775,92,na,1867,5
STAT,1837,40,15-19,1877,0.02330726590342911
SIM,1818,43,25-29,1861,3
STAT,1822,34,35-39,1856,48.22792778396135
STAT,1864,88,na,1952,247.83936864582788
SIM,1847,20,30-34,1867,40
SIM,1916,5,na,1921,8705
SIM,1823,34,35-39,1857,27
STAT,1908,37,25-29,1945,1.8630368374863164
SIM,1845,26,35-39,1871,30
STAT,1847,30,30-34,1877,31.904650835710882
STAT,1886,18,30-34,1904,3.3891352567838733
SIM,1867,24,20-24,1891,133
STAT,1867,45,20-24,1912,0.022923376358380203
SIM,1907,15,15-19,1922,17
STAT,1817,47,15-19,1864,0.0019318525248182093
STAT,1917,15,30-34,1932,5.3214841446632
SIM,1912,8,na,1920,8286
STAT,1906,28,50-100,1934,1.8759523302357548
STAT,1851,48,na,1899,3443.8414515459617
STAT,1919,28,na,1947,8144.297427510099
SIM,1939,20,40-44,1959,8
SIM,1921,29,na,1950,8344
STAT,1876,28,15-19,1904,0.9443849881933051
STAT,1891,38,15-19,1929,0.1394879336889333
SIM,1949,19,35-39,1968,12
STAT,1810,48,na,1858,2614.7988017714965
STAT,1950,19,25-29,1969,103.4085597711583
SIM,1848,32,40-44,1880,12
SIM,1916,37,25-29,1953,3
SIM,1901,52,na,1953,6143
STAT,1893,18,30-34,1911,4.069421513885766
STAT,1827,37,30-34,1864,11.075724278802173
STAT,1851,38,20-24,1889,1.195277055414813
SIM,1887,39,45-49,1926,9
SIM,1888,19,50-100,1907,1
SIM,1929,30,25-29,1959,30
STAT,1824,47,15-19,1871,9.687410623709996E-4
STAT,1874,54,20-24,1928,0.0014839916875329074
STAT,1862,22,na,1884,4179.260775901017
SIM,1903,23,30-34,1926,76
STAT,1924,46,15-19,1970,8.876656533946613E-4
STAT,1883,28,15-19,1911,0.8971009195093647
STAT,1907,25,15-19,1932,1.355890368866648
SIM,1836,30,20-24,1866,5
SIM,1879,29,45-49,1908,4
SIM,1928,39,45-49,1967,5
STAT,1864,48,50-100,1912,0.4378128750186537
SIM,1834,27,30-34,1861,54
SIM,1891,28,15-19,1919,1
STAT,1812,45,30-34,1857,0.6955873920577568
SIM,1927,43,na,1970,9646
STAT,1879,39,45-49,1918,4.168811237056827
STAT,1897,33,25-29,1930,27.534675308316977
SIM,1835,37,30-34,1872,12
SIM,1865,50,na,1915,4089
STAT,1848,22,30-34,1870,35.56242691652506
SIM,1843,39,na,1882,3561
SIM,1882,19,15-19,1901,12
SIM,1881,66,na,1947,2731
STAT,1922,15,50-100,1937,0.8795254118235842
STAT,1908,19,na,1927,7530.884401435235
SIM,1847,19,20-24,1866,36
STAT,1902,21,50-100,1923,1.166262067773049
SIM,1871,59,na,1930,3751
STAT,1853,74,na,1927,1755.9090979035816
STAT,1928,16,50-100,1944,0.9556136945621785
SIM,1945,16,50-100,1961,1
STAT,1939,22,50-100,1961,1.3347439867162816
STAT,1921,7,na,1928,9200.003340609279
STAT,1878,24,25-29,1902,119.99230281845931
STAT,1933,21,50-100,1954,1.768228793324206
STAT,1853,49,35-39,1902,0.21688328191923176
SIM,1920,27,40-44,1947,14
STAT,1835,34,20-24,1869,4.367431190983884
STAT,1881,2,na,1883,6226.039981309599
STAT,1846,34,30-34,1880,30.95424096104422
SIM,1826,69,na,1895,1635
SIM,1900,27,20-24,1927,36
STAT,1860,27,30-34,1887,41.74292221399668
STAT,1881,51,35-39,1932,0.01688599157399746
SIM,1858,30,40-44,1888,12
SIM,1927,11,na,1938,10232
SIM,1938,24,40-44,1962,5
STAT,1865,29,15-19,1894,0.8265087818534557
STAT,1916,31,45-49,1947,3.2944640221002772
STAT,1808,84,na,1892,261.40704381014405
STAT,1895,21,20-24,1916,181.89974241218806
SIM,1885,37,50-100,1922,5
STAT,1917,36,30-34,1953,3.8413099841363856
SIM,1902,23,15-19,1925,8
STAT,1850,24,45-49,1874,1.264926579730934
STAT,1912,27,40-44,1939,9.279142977319351
SIM,1906,41,na,1947,6840
SIM,1850,51,na,1901,3473
SIM,1843,34,20-24,1877,3
SIM,1873,30,50-100,1903,1
STAT,1804,94,na,1898,13.445012059052793
STAT,1831,61,na,1892,2412.685271069576
STAT,1835,30,50-100,1865,1.5431951317665082
SIM,1831,35,40-44,1866,11
SIM,1898,40,30-34,1938,1
STAT,1789,75,na,1864,840.1065870034292
SIM,1900,15,20-24,1915,47
STAT,1877,45,15-19,1922,8.472256753608223E-4
STAT,1957,10,na,1967,10460.872473517478
SIM,1925,36,30-34,1961,9
SIM,1875,49,na,1924,4965
STAT,1847,57,na,1904,3063.3646062024204
STAT,1919,24,30-34,1943,63.15053187045532
STAT,1944,25,35-39,1969,32.798284675817435
STAT,1950,16,20-24,1966,323.8243441932887
SIM,1899,51,na,1950,5971
SIM,1881,15,40-44,1896,2
STAT,1931,20,30-34,1951,75.73683969195663
SIM,1929,20,40-44,1949,11
STAT,1893,47,15-19,1940,5.749005062624752E-4
STAT,1886,66,na,1952,3494.275497328755
SIM,1900,28,50-100,1928,2
STAT,1912,38,na,1950,7381.17113872757
STAT,1824,34,45-49,1858,6.1722102005135255
SIM,1845,26,50-100,1871,1
STAT,1858,34,15-19,1892,0.222289661088964
STAT,1883,19,na,1902,4984.617387570599
STAT,1873,15,40-44,1888,0.3797880682964514
SIM,1891,22,40-44,1913,4
SIM,1897,41,na,1938,6402
STAT,1930,1,na,1931,10903.85448077156
STAT,1908,3,na,1911,7925.346032156831
SIM,1927,24,30-34,1951,92
SIM,1845,35,25-29,1880,8
STAT,1857,64,na,1921,2736.5184827694993
STAT,1950,16,50-100,1966,0.8948718102917138
SIM,1861,49,35-39,1910,2
STAT,1783,109,na,1892,0.0021914198634723886
STAT,1875,41,50-100,1916,2.2066746011018976
STAT,1895,27,50-100,1922,1.6834340320614851
STAT,1903,63,na,1966,5627.848720098681
STAT,1872,24,30-34,1896,35.92798035440419
SIM,1872,36,40-44,1908,14
STAT,1951,15,25-29,1966,104.26716399156125
STAT,1857,86,na,1943,349.2768080848145
SIM,1835,97,na,1932,13
SIM,1925,33,na,1958,9025
SIM,1932,26,20-24,1958,46
STAT,1946,26,40-44,1972,10.489982628654522
SIM,1806,95,na,1901,1
STAT,1883,22,40-44,1905,4.134846393645862
STAT,1939,19,25-29,1958,87.55720709898219
SIM,1838,45,35-39,1883,1
SIM,1909,28,50-100,1937,4
STAT,1900,21,40-44,1921,5.8556755159510026
STAT,1942,21,45-49,1963,2.3834463528297194
STAT,1837,35,25-29,1872,4.989497701929629
STAT,1840,21,na,1861,3953.188226405115
STAT,1853,96,na,1949,13.585822050937521
SIM,1825,32,50-100,1857,3
STAT,1795,60,na,1855,2053.91705
STAT,1853,24,20-24,1877,126.98428652409453
SIM,1928,41,30-34,1969,1
SIM,1950,21,45-49,1971,2
STAT,1857,35,45-49,1892,3.1679439610547284
SIM,1861,24,20-24,1885,121
STAT,1834,39,na,1873,3467.5688799777686
STAT,1855,52,na,1907,3229.551013499093
STAT,1875,33,50-100,1908,1.897156703954952
STAT,1787,97,na,1884,1.8695316088156755
SIM,1873,37,na,1910,4951
STAT,1899,35,15-19,1934,0.15686319255157727
SIM,1864,54,35-39,1918,1
SIM,1934,20,50-100,1954,8
STAT,1783,84,na,1867,184.25693531147314
STAT,1847,25,40-44,1872,5.568086177961451
STAT,1849,48,30-34,1897,0.15119413697863857
SIM,1862,20,20-24,1882,131
STAT,1906,29,na,1935,6973.207150846377
STAT,1873,23,35-39,1896,11.93773067526219
SIM,1845,23,25-29,1868,121
STAT,1837,23,25-29,1860,103.72168022798778
STAT,1839,19,20-24,1858,35.786537205574874
SIM,1880,49,45-49,1929,1
STAT,1836,33,25-29,1869,17.039908983263356
STAT,1821,33,15-19,1854,0.9358339325634323
STAT,1912,20,20-24,1932,216.56173415763828
STAT,1930,34,50-100,1964,2.1521477425840345
STAT,1913,26,45-49,1939,3.48939182050714
SIM,1879,34,35-39,1913,23
SIM,1860,19,na,1879,4586
STAT,1924,26,20-24,1950,43.059923909653875
STAT,1854,46,25-29,1900,0.0885507668285306
STAT,1887,36,35-39,1923,16.053157821906435
STAT,1864,37,na,1901,4253.267945744165
STAT,1841,24,35-39,1865,10.572371311083495
STAT,1842,34,na,1876,3817.7434573755836
SIM,1876,17,25-29,1893,16
SIM,1866,38,30-34,1904,14
SIM,1899,31,40-44,1930,15
STAT,1868,17,25-29,1885,11.085918540879806
STAT,1789,78,na,1867,632.1829418529898
STAT,1804,62,na,1866,1847.024498688814
STAT,1864,36,40-44,1900,7.940783731823299
STAT,1832,27,na,1859,3727.636405159712
SIM,1895,36,35-39,1931,31
SIM,1952,17,40-44,1969,3
SIM,1828,45,35-39,1873,1
SIM,1921,26,45-49,1947,5
STAT,1871,43,20-24,1914,0.3163587994742368
STAT,1944,17,40-44,1961,3.039805766015584
STAT,1827,34,20-24,1861,6.054071886201865
STAT,1856,37,na,1893,3671.168864543995
STAT,1877,24,15-19,1901,6.875263821687156
STAT,1853,44,15-19,1897,0.02155499944684793
SIM,1920,20,20-24,1940,290
STAT,1778,80,na,1858,509.234063395868
STAT,1922,48,na,1970,8497.788040376437
STAT,1926,45,50-100,1971,0.5661894139976618
SIM,1828,42,na,1870,3250
STAT,1900,44,30-34,1944,0.2206494857893223
STAT,1836,44,15-19,1880,0.02129538209898898
STAT,1911,27,30-34,1938,77.19507090917034
SIM,1904,26,45-49,1930,4
SIM,1855,25,40-44,1880,7
SIM,1844,33,25-29,1877,27
SIM,1850,24,45-49,1874,1
SIM,1830,24,25-29,1854,109
SIM,1895,35,30-34,1930,20
SIM,1903,20,20-24,1923,193
SIM,1908,24,20-24,1932,199
SIM,1838,25,40-44,1863,6
SIM,1840,29,20-24,1869,27
SIM,1828,44,30-34,1872,6
STAT,1865,35,45-49,1900,3.692409162762738
STAT,1915,32,40-44,1947,8.049993715221508
STAT,1894,25,20-24,1919,30.642527944828636
STAT,1905,2,na,1907,7785.8080013976005
SIM,1885,24,15-19,1909,8
SIM,1928,23,35-39,1951,27
STAT,1843,23,15-19,1866,5.759067455057838
SIM,1864,35,35-39,1899,23
SIM,1919,24,30-34,1943,75
STAT,1888,47,na,1935,5345.478831956446
STAT,1872,49,45-49,1921,0.4690172139615091
STAT,1920,44,50-100,1964,0.2611114041284585
STAT,1863,54,45-49,1917,0.02495096949245063
STAT,1897,24,35-39,1921,15.6550857049935
SIM,1824,35,na,1859,3532
STAT,1812,48,35-39,1860,0.9560281441761466
SIM,1815,42,50-100,1857,4
STAT,1928,39,na,1967,9580.6775273384
STAT,1836,46,30-34,1882,0.13645913304815158
STAT,1921,30,15-19,1951,0.29106799343942497
STAT,1871,93,na,1964,162.31910758511273
STAT,1876,20,40-44,1896,4.3787555625911905
STAT,1932,32,40-44,1964,10.507274977958472
STAT,1902,25,30-34,1927,72.28944374379442
SIM,1925,30,na,1955,9033
SIM,1890,44,35-39,1934,8
SIM,1924,19,30-34,1943,41
STAT,1882,85,na,1967,1073.7127105896711
STAT,1847,46,40-44,1893,0.26170825669339476
STAT,1947,25,45-49,1972,3.950526097740932
SIM,1843,43,50-100,1886,3
STAT,1893,2,na,1895,6823.764366191262
STAT,1900,13,na,1913,7224.006290185689
STAT,1879,11,na,1890,5463.632232817007
SIM,1913,30,30-34,1943,43
STAT,1897,36,35-39,1933,19.1862575038199
STAT,1843,64,na,1907,2435.123266778628
SIM,1911,19,na,1930,7904
SIM,1838,33,35-39,1871,25
STAT,1872,25,35-39,1897,19.717690788191682
SIM,1817,87,na,1904,141
STAT,1880,54,45-49,1934,0.030027144787844073
SIM,1841,91,na,1932,57
SIM,1904,38,45-49,1942,2
STAT,1897,16,40-44,1913,0.4949854788473794
STAT,1853,71,na,1924,2111.9234760163517
SIM,1827,49,50-100,1876,3
STAT,1842,24,45-49,1866,1.2907176190120169
SIM,1818,47,40-44,1865,2
STAT,1819,90,na,1909,82.49693109085074
SIM,1869,20,15-19,1889,7
SIM,1835,34,20-24,1869,8
SIM,1885,38,40-44,1923,12
SIM,1903,3,na,1906,7824
SIM,1910,25,30-34,1935,98
STAT,1916,19,30-34,1935,5.194761521717329
STAT,1909,34,15-19,1943,0.24567458081480023
STAT,1887,35,30-34,1922,12.152741500782556
STAT,1882,44,35-39,1926,3.5145007493508347
SIM,1802,59,na,1861,2146
STAT,1846,35,35-39,1881,11.550789331166266
SIM,1869,36,25-29,1905,9
STAT,1815,57,na,1872,2368.186676387761
SIM,1824,31,40-44,1855,2
SIM,1864,23,35-39,1887,12
STAT,1798,57,na,1855,1984.3093599999997
SIM,1856,32,50-100,1888,4
SIM,1883,20,50-100,1903,5
STAT,1863,35,35-39,1898,12.622976718636583
SIM,1844,23,15-19,1867,6
STAT,1837,39,50-100,1876,2.04105366947983
SIM,1915,3,na,1918,8615
STAT,1867,77,na,1944,1634.9325689593063
SIM,1934,22,15-19,1956,1
SIM,1880,22,30-34,1902,48
SIM,1854,79,na,1933,1101
SIM,1899,22,na,1921,6618
SIM,1869,27,35-39,1896,23
STAT,1811,49,30-34,1860,0.6349598917038575
SIM,1908,18,35-39,1926,2
SIM,1879,26,40-44,1905,8
STAT,1906,29,15-19,1935,1.3256781842998218
SIM,1829,35,40-44,1864,10
SIM,1881,32,25-29,1913,15
STAT,1811,52,30-34,1863,0.0385453592648191
SIM,1886,36,25-29,1922,7
STAT,1912,47,35-39,1959,0.2503129566484081
STAT,1917,18,35-39,1935,1.8187363931813185
SIM,1839,45,45-49,1884,1
SIM,1919,48,na,1967,8088
SIM,1925,18,35-39,1943,12
STAT,1757,117,na,1874,2.4401697796027898E-4
STAT,1939,16,20-24,1955,274.1857659653032
STAT,1877,84,na,1961,1042.9858461020622
STAT,1862,36,30-34,1898,9.244203513524496
SIM,1814,41,25-29,1855,2
SIM,1851,23,15-19,1874,6
SIM,1864,86,na,1950,295
STAT,1897,30,20-24,1927,7.355947370572166
STAT,1924,26,na,1950,8836.94524025849
STAT,1898,15,45-49,1913,0.17936162320439333
STAT,1905,30,30-34,1935,51.40591808041412
STAT,1910,18,40-44,1928,0.5584778382849407
STAT,1920,33,na,1953,8329.33901276249
STAT,1894,45,15-19,1939,5.912178581212992E-4
SIM,1914,29,15-19,1943,1
STAT,1828,75,na,1903,1264.236727895618
STAT,1927,34,25-29,1961,22.929019717966998
SIM,1870,23,25-29,1893,136
STAT,1856,35,35-39,1891,11.125952585381764
SIM,1947,16,20-24,1963,353
STAT,1896,76,na,1972,3499.243887489869
SIM,1820,48,35-39,1868,1
SIM,1854,35,35-39,1889,22
SIM,1928,36,40-44,1964,5
STAT,1852,46,15-19,1898,6.393336043168754E-4
SIM,1923,32,40-44,1955,13
STAT,1852,53,30-34,1905,0.009334906571114538
STAT,1858,49,na,1907,3468.2323049535
STAT,1831,48,45-49,1879,0.35654970197490177
SIM,1854,34,30-34,1888,50
SIM,1865,43,50-100,1908,6
SIM,1879,31,50-100,1910,5
STAT,1888,25,na,1913,5735.435271212589
SIM,1825,84,na,1909,301
STAT,1841,28,50-100,1869,1.144528413364903
STAT,1868,35,20-24,1903,1.4952736777581486
STAT,1832,29,20-24,1861,20.174880078066415
STAT,1854,27,na,1881,3835.3109358073416
SIM,1875,27,na,1902,5300
STAT,1926,34,15-19,1960,0.3133594218730493
STAT,1862,23,25-29,1885,100.43200139434276
STAT,1916,30,na,1946,7949.334751266883
STAT,1886,69,na,1955,3128.7182148324355
SIM,1943,24,15-19,1967,9
SIM,1835,21,15-19,1856,6
SIM,1924,31,45-49,1955,2
SIM,1834,23,15-19,1857,6
STAT,1838,82,na,1920,631.4573132959213
STAT,1936,24,30-34,1960,55.46854354764829
SIM,1839,24,45-49,1863,1
SIM,1883,78,na,1961,2095
SIM,1899,54,na,1953,5749
SIM,1913,24,50-100,1937,2
SIM,1869,43,30-34,1912,3
SIM,1896,26,40-44,1922,12
STAT,1888,26,40-44,1914,7.175145121030597
STAT,1873,46,50-100,1919,0.5054158896696685
SIM,1824,57,na,1881,2683
SIM,1905,27,15-19,1932,2
STAT,1861,24,20-24,1885,117.30664834056343
STAT,1806,72,na,1878,1127.1218158841245
SIM,1938,25,45-49,1963,5
STAT,1878,36,25-29,1914,6.102322692466594
SIM,1886,24,25-29,1910,129
SIM,1922,20,30-34,1942,92
SIM,1937,5,na,1942,8069
STAT,1864,34,na,1898,4271.14635867763
STAT,1926,22,15-19,1948,13.058728109666161
SIM,1855,33,35-39,1888,22
SIM,1849,15,15-19,1864,11
STAT,1906,42,40-44,1948,0.45910526431027493
STAT,1919,18,50-100,1937,0.8338077757711752
SIM,1882,11,na,1893,5391
STAT,1906,49,50-100,1955,0.3991993971876162
SIM,1907,39,40-44,1946,4
SIM,1952,10,na,1962,9773
STAT,1847,33,35-39,1880,17.937901867997084
STAT,1898,36,45-49,1934,5.4745973806053065
STAT,1820,87,na,1907,197.2356891769236
STAT,1900,40,15-19,1940,0.0027138198762479216
SIM,1830,28,40-44,1858,6
STAT,1928,37,50-100,1965,1.0714674768192316
STAT,1877,47,30-34,1924,0.20205849497231193
STAT,1908,43,50-100,1951,0.21834300918937607
SIM,1844,37,40-44,1881,14
SIM,1919,49,45-49,1968,1
SIM,1853,2,na,1855,5773
STAT,1891,15,35-39,1906,1.3761519137900549
STAT,1931,23,35-39,1954,24.588757480208884
SIM,1823,72,na,1895,1271
SIM,1876,35,20-24,1911,2
SIM,1886,21,20-24,1907,140
STAT,1811,73,na,1884,1147.6389343131268
STAT,1927,17,40-44,1944,3.5118534958922663
STAT,1866,19,50-100,1885,0.09260666377041792
SIM,1896,11,na,1907,7207
SIM,1832,24,35-39,1856,17
SIM,1826,61,na,1887,2124
STAT,1865,22,30-34,1887,33.079456778398566
SIM,1945,20,25-29,1965,247
STAT,1841,43,35-39,1884,2.695404881980605
STAT,1916,30,50-100,1946,1.7378017430815749
SIM,1836,33,25-29,1869,20
SIM,1907,31,45-49,1938,6
STAT,1925,29,40-44,1954,11.036750517307729
SIM,1854,25,50-100,1879,2
SIM,1873,22,30-34,1895,40
SIM,1934,1,na,1935,11096
SIM,1866,15,15-19,1881,9
STAT,1887,33,30-34,1920,39.27145388322526
STAT,1842,48,20-24,1890,0.0176412894383684
SIM,1813,65,na,1878,1828
STAT,1814,45,40-44,1859,0.9150074369834603
SIM,1903,26,35-39,1929,38
SIM,1838,21,25-29,1859,124
SIM,1837,24,na,1861,3681
STAT,1848,41,na,1889,3833.89626535378
STAT,1888,47,40-44,1935,0.40676032970773857
SIM,1924,30,50-100,1954,4
SIM,1891,25,45-49,1916,5
SIM,1929,23,45-49,1952,5
SIM,1916,43,50-100,1959,3
STAT,1848,45,45-49,1893,0.3908288433170461
STAT,1947,24,40-44,1971,7.669007140942956
SIM,1880,24,30-34,1904,42
STAT,1873,18,45-49,1891,0.1336942470837019
STAT,1931,15,40-44,1946,3.7147928004779804
STAT,1933,36,15-19,1969,0.05287945477669489
STAT,1775,94,na,1869,6.051187780793445
STAT,1833,76,na,1909,1245.4831855502914
STAT,1874,38,15-19,1912,0.11554688067744853
STAT,1836,37,40-44,1873,7.145670868324415
SIM,1931,29,15-19,1960,1
STAT,1848,29,15-19,1877,0.8754153182091864
STAT,1898,33,40-44,1931,11.802608576039122
SIM,1935,17,40-44,1952,4
STAT,1836,23,15-19,1859,5.748614247003339
STAT,1892,44,na,1936,5784.530165149231
SIM,1910,16,25-29,1926,28
SIM,1828,42,30-34,1870,4
SIM,1904,49,na,1953,6493
SIM,1851,27,30-34,1878,60
SIM,1868,46,50-100,1914,1
STAT,1828,33,25-29,1861,22.274908860472067
STAT,1859,107,na,1966,0.06113762593445426
SIM,1859,38,30-34,1897,14
STAT,1866,78,na,1944,1455.9976514571433
STAT,1779,114,na,1893,1.2709926363496798E-4
SIM,1875,41,na,1916,5185
STAT,1843,27,30-34,1870,43.412495875627734
SIM,1879,31,30-34,1910,43
STAT,1881,36,40-44,1917,8.58636998705412
SIM,1875,48,25-29,1923,1
STAT,1820,109,na,1929,7.964844625787978E-4
SIM,1853,23,25-29,1876,138
STAT,1858,15,15-19,1873,11.044125773054246
SIM,1869,24,30-34,1893,44
STAT,1845,23,25-29,1868,108.72298783162289
STAT,1826,37,15-19,1863,0.1330691632586872
STAT,1863,34,30-34,1897,30.60277475372166
SIM,1854,32,30-34,1886,49
STAT,1902,16,25-29,1918,16.197488276555834
STAT,1895,24,25-29,1919,149.70620957122355
STAT,1951,19,40-44,1970,3.3613589664123276
SIM,1839,42,40-44,1881,7
SIM,1913,21,25-29,1934,207
STAT,1850,53,20-24,1903,0.0011132631699411477
SIM,1840,98,na,1938,4
STAT,1893,28,15-19,1921,1.1573349633785746
SIM,1959,1,na,1960,10864
STAT,1842,106,na,1948,0.018076722743997877
STAT,1873,32,25-29,1905,21.01839891397162
SIM,1908,48,30-34,1956,1
STAT,1846,16,35-39,1862,1.0620464772690468
STAT,1923,29,15-19,1952,1.6247039973030515
SIM,1839,41,50-100,1880,4
STAT,1840,53,na,1893,3058.067346471159
STAT,1872,20,15-19,1892,6.736115832377224
STAT,1918,40,na,1958,7995.657570929756
STAT,1934,15,25-29,1949,118.94774490414467
STAT,1908,33,na,1941,7184.304118160566
SIM,1939,26,15-19,1965,3
SIM,1862,23,na,1885,4400
STAT,1903,37,40-44,1940,2.716962256168414
SIM,1936,25,na,1961,6473
SIM,1815,43,na,1858,2783
SIM,1919,30,25-29,1949,25
SIM,1844,46,30-34,1890,1
SIM,1862,23,25-29,1885,120
STAT,1829,38,na,1867,3206.9007007442224
SIM,1868,40,45-49,1908,1
STAT,1876,23,45-49,1899,1.4521060383719038
STAT,1763,109,na,1872,0.0028799328226208586
SIM,1888,36,35-39,1924,25
SIM,1913,25,40-44,1938,12
STAT,1883,25,45-49,1908,2.218091780813927
STAT,1877,38,40-44,1915,9.13478156734323
SIM,1906,18,25-29,1924,22
STAT,1832,31,25-29,1863,17.595977872009993
STAT,1905,25,40-44,1930,8.808743814682169
SIM,1933,29,40-44,1962,14
STAT,1830,46,na,1876,3377.53869649644
STAT,1862,17,30-34,1879,3.151110866458707
SIM,1824,34,45-49,1858,5
STAT,1933,19,30-34,1952,32.779789696636776
SIM,1822,45,40-44,1867,1
SIM,1926,18,na,1944,9316
SIM,1869,45,30-34,1914,1
SIM,1911,37,40-44,1948,4
SIM,1930,28,45-49,1958,5
STAT,1852,27,15-19,1879,0.8422426929375912
STAT,1953,15,35-39,1968,10.256211805074102
SIM,1885,70,na,1955,2851
STAT,1832,35,40-44,1867,7.366326336820784
STAT,1922,28,45-49,1950,3.9331863461126457
SIM,1918,22,30-34,1940,72
SIM,1941,28,20-24,1969,41
SIM,1870,71,na,1941,2545
SIM,1863,49,45-49,1912,2
STAT,1824,91,na,1915,61.95409538838591
STAT,1842,21,40-44,1863,3.941345085502999
SIM,1885,47,30-34,1932,1
SIM,1942,15,25-29,1957,127
STAT,1874,19,15-19,1893,12.206332445454132
SIM,1873,35,45-49,1908,7
STAT,1854,23,25-29,1877,102.3708111029304
SIM,1847,31,na,1878,3858
SIM,1871,29,40-44,1900,6
SIM,1895,33,30-34,1928,63
SIM,1840,35,40-44,1875,14
SIM,1849,97,na,1946,3
SIM,1860,27,15-19,1887,1
SIM,1898,22,35-39,1920,18
STAT,1862,56,na,1918,3520.818767466308
SIM,1808,49,30-34,1857,1
STAT,1930,11,na,1941,10361.02389708204
STAT,1883,49,20-24,1932,0.023314120001118706
SIM,1840,31,25-29,1871,30
SIM,1938,30,35-39,1968,27
STAT,1875,74,na,1949,2307.6406187918133
STAT,1933,28,20-24,1961,48.932150452821936
SIM,1860,64,na,1924,3005
STAT,1921,16,35-39,1937,9.681313374480169
STAT,1899,39,30-34,1938,3.1511202626179617
SIM,1804,69,na,1873,1439
STAT,1845,45,na,1890,3501.4230295171
STAT,1847,28,45-49,1875,2.0196702713933274
STAT,1831,23,30-34,1854,66.05121112842257
STAT,1855,49,45-49,1904,0.3484421668197503
SIM,1899,34,45-49,1933,5
SIM,1827,33,25-29,1860,24
STAT,1863,25,25-29,1888,75.87029643715407
SIM,1840,76,na,1916,1569
STAT,1846,30,15-19,1876,0.2631811129005301
STAT,1833,37,15-19,1870,0.0924704269042745
STAT,1832,24,na,1856,3692.2503176300424
STAT,1837,20,20-24,1857,131.7958961128588
SIM,1854,22,20-24,1876,148
SIM,1850,21,40-44,1871,4
SIM,1851,68,na,1919,2285
SIM,1894,24,25-29,1918,156
SIM,1838,30,30-34,1868,10
SIM,1894,30,45-49,1924,9
SIM,1909,35,35-39,1944,2
SIM,1854,4,na,1858,5089
SIM,1892,28,30-34,1920,80
SIM,1919,16,45-49,1935,1
STAT,1886,24,25-29,1910,121.28033737404202
STAT,1908,25,25-29,1933,127.67535081964691
STAT,1839,45,45-49,1884,0.38519553489533326
STAT,1887,62,na,1949,4128.46570675221
STAT,1928,24,30-34,1952,72.0093291264409
STAT,1867,38,15-19,1905,0.10568530736939344
STAT,1907,46,15-19,1953,6.716624456814398E-4
STAT,1815,54,na,1869,2512.8633665208613
STAT,1850,39,50-100,1889,1.872967216006046
SIM,1857,21,35-39,1878,9
SIM,1864,89,na,1953,139
STAT,1846,22,20-24,1868,130.2389261875078
SIM,1811,84,na,1895,242
STAT,1871,46,25-29,1917,0.11590340367818087
SIM,1841,18,15-19,1859,12
STAT,1824,37,50-100,1861,3.729419215192775
STAT,1872,22,30-34,1894,36.15431263511958
STAT,1900,27,50-100,1927,1.7921778802424837
SIM,1910,34,20-24,1944,8
SIM,1938,20,25-29,1958,213
STAT,1884,28,30-34,1912,50.042746356511664
SIM,1832,37,50-100,1869,2
STAT,1893,38,25-29,1931,7.33383650354642
STAT,1940,17,15-19,1957,93.06958649287786
STAT,1937,28,50-100,1965,1.9590050679624604
STAT,1865,30,50-100,1895,1.6946508605361503
STAT,1899,65,na,1964,5110.268645162112
STAT,1917,34,50-100,1951,1.7334356896882208
SIM,1845,20,20-24,1865,128
SIM,1871,25,25-29,1896,96
SIM,1900,39,30-34,1939,2
STAT,1876,35,20-24,1911,1.6254874195537627
SIM,1847,32,30-34,1879,47
SIM,1845,39,40-44,1884,8
STAT,1873,36,40-44,1909,9.02611654230688
STAT,1831,24,35-39,1855,11.455031138766827
SIM,1884,35,20-24,1919,1
STAT,1820,42,50-100,1862,4.273932345900752
SIM,1918,37,35-39,1955,10
SIM,1904,23,40-44,1927,5
STAT,1888,43,25-29,1931,1.5217975460209785
STAT,1907,38,20-24,1945,0.49142934296831403
SIM,1879,22,25-29,1901,130
STAT,1917,27,25-29,1944,139.3961995525483
STAT,1781,100,na,1881,0.4249625459287141
SIM,1866,19,30-34,1885,4
STAT,1858,19,30-34,1877,2.8969033696559876
SIM,1825,37,30-34,1862,10
STAT,1846,32,30-34,1878,31.603803126571734
SIM,1832,34,45-49,1866,5
SIM,1925,34,50-100,1959,2
SIM,1906,32,50-100,1938,4
SIM,1947,19,25-29,1966,124
SIM,1912,12,na,1924,8249
STAT,1897,21,30-34,1918,48.23196453292468
SIM,1873,60,na,1933,3917
SIM,1925,27,25-29,1952,165
STAT,1836,27,30-34,1863,43.33369842185693
STAT,1783,106,na,1889,0.02317959714666918
STAT,1896,47,40-44,1943,0.25629932364956803
STAT,1943,26,30-34,1969,84.31369919123578
SIM,1861,27,na,1888,4571
SIM,1878,49,50-100,1927,4
SIM,1844,27,30-34,1871,6
STAT,1879,33,na,1912,5019.75434566714
STAT,1927,31,20-24,1958,6.062377280876389
STAT,1891,25,45-49,1916,2.790545234359839
STAT,1942,1,na,1943,8750.296518044643
STAT,1830,45,25-29,1875,0.10203412780910513
SIM,1938,22,40-44,1960,11
STAT,1821,35,30-34,1856,23.763867766638416
STAT,1823,98,na,1921,3.898254112034513
SIM,1846,38,na,1884,3749
SIM,1934,33,50-100,1967,3
STAT,1929,38,15-19,1967,0.04973627977194384
STAT,1870,24,20-24,1894,135.7861708315759
SIM,1870,36,30-34,1906,20
STAT,1857,32,40-44,1889,6.86899322468931
SIM,1866,67,na,1933,3032
STAT,1826,39,30-34,1865,11.808533799952226
SIM,1908,15,30-34,1923,7
STAT,1866,54,50-100,1920,0.027369735139095724
STAT,1916,15,15-19,1931,19.536607082687155
SIM,1935,25,35-39,1960,6
STAT,1807,47,15-19,1854,0.0027540169141961634
STAT,1839,32,30-34,1871,33.54915687548006
SIM,1888,6,na,1894,6116
STAT,1809,83,na,1892,352.8475819683985
STAT,1888,29,45-49,1917,2.63142320308992
SIM,1855,75,na,1930,1622
SIM,1949,21,na,1970,8950
STAT,1811,45,15-19,1856,0.0028107592387069027
SIM,1851,50,na,1901,3437
SIM,1968,3,na,1971,10505
SIM,1901,20,na,1921,6767
SIM,1795,83,na,1878,237
SIM,1865,32,40-44,1897,12
STAT,1817,37,30-34,1854,39.90497570775675
SIM,1834,39,30-34,1873,18
SIM,1829,38,45-49,1867,4
SIM,1855,42,25-29,1897,2
STAT,1778,83,na,1861,269.926838270608
STAT,1828,72,na,1900,1550.9052334178443
STAT,1872,100,na,1972,18.935829180207996
SIM,1916,25,25-29,1941,157
SIM,1940,22,na,1962,7682
SIM,1849,31,45-49,1880,6
SIM,1897,73,na,1970,3911
STAT,1928,37,45-49,1965,1.739742423376585
SIM,1939,14,na,1953,8198
STAT,1937,20,25-29,1957,181.8259996198797
SIM,1796,68,na,1864,1490
SIM,1913,33,35-39,1946,25
STAT,1863,51,40-44,1914,0.018700889171263113
SIM,1935,31,20-24,1966,9
STAT,1849,21,35-39,1870,11.240723234539876
SIM,1828,26,35-39,1854,19
STAT,1926,38,30-34,1964,4.493237820455444
SIM,1895,23,20-24,1918,178
SIM,1868,34,25-29,1902,24
SIM,1776,91,na,1867,44
SIM,1944,27,35-39,1971,38
SIM,1828,32,20-24,1860,6
SIM,1880,25,35-39,1905,26
STAT,1840,24,na,1864,3868.646477772791
SIM,1858,71,na,1929,2205
STAT,1887,17,35-39,1904,1.2394201925426924
STAT,1851,16,na,1867,4351.940966827141
SIM,1860,37,25-29,1897,2
STAT,1957,13,na,1970,10456.270358046871
STAT,1778,107,na,1885,0.01722172115650345
SIM,1909,27,40-44,1936,12
SIM,1864,20,30-34,1884,49
STAT,1887,23,20-24,1910,155.17804993021656
SIM,1890,25,50-100,1915,4
STAT,1788,90,na,1878,62.81829610947811
STAT,1862,27,40-44,1889,5.190008651805501
SIM,1870,27,40-44,1897,8
STAT,1840,35,40-44,1875,7.6302607801315006
STAT,1927,25,35-39,1952,37.10685564643517
STAT,1856,3,na,1859,5205.698436059633
STAT,1949,23,20-24,1972,261.9421723152021
STAT,1852,37,25-29,1889,4.613793496460859
STAT,1866,15,na,1881,4888.166585186907
STAT,1868,22,15-19,1890,6.339161734631235
STAT,1893,43,50-100,1936,0.18644163803428526
STAT,1886,30,45-49,1916,3.7476123948272804
SIM,1865,35,45-49,1900,8
SIM,1895,17,35-39,1912,2
SIM,1858,33,45-49,1891,6
STAT,1858,54,45-49,1912,0.02222028886687523
STAT,1905,33,35-39,1938,16.91255408521808
SIM,1876,22,15-19,1898,8
STAT,1918,48,40-44,1966,0.33784680412550905
STAT,1834,61,na,1895,2483.300574055702
STAT,1923,39,25-29,1962,2.298443588111085
STAT,1891,34,35-39,1925,25.064580210126888
SIM,1944,18,50-100,1962,5
STAT,1845,20,20-24,1865,133.7413165741646
SIM,1939,20,35-39,1959,23
STAT,1812,58,na,1870,2388.0765787271694
STAT,1854,42,35-39,1896,2.7725368361469487
STAT,1902,47,40-44,1949,0.2740737831162454
SIM,1914,23,40-44,1937,12
STAT,1875,18,15-19,1893,12.307686654425249
STAT,1896,43,25-29,1939,0.11804431197911829
SIM,1838,71,na,1909,1776
STAT,1894,46,25-29,1940,0.08453438626215684
SIM,1860,29,30-34,1889,66
STAT,1898,9,na,1907,7091.359879892287
SIM,1876,38,25-29,1914,4
STAT,1854,26,30-34,1880,44.79313876529771
STAT,1857,38,20-24,1895,1.207449153457873
STAT,1833,52,45-49,1885,0.019695509167153007
SIM,1814,81,na,1895,454
SIM,1933,2,na,1935,11496
STAT,1852,29,30-34,1881,41.9311675311598
STAT,1801,94,na,1895,15.842300583845287
SIM,1896,35,45-49,1931,5
STAT,1938,16,40-44,1954,2.7938732056663405
STAT,1822,33,30-34,1855,96.36846523757272
STAT,1873,54,40-44,1927,0.02100925033898345
SIM,1821,40,25-29,1861,1
STAT,1837,29,35-39,1866,17.017942100545135
STAT,1901,29,na,1930,6699.355587435028
STAT,1858,19,25-29,1877,10.299441268246719
STAT,1824,43,35-39,1867,4.5931782906424425
STAT,1838,51,na,1889,2956.4902403460974
SIM,1903,52,na,1955,6280
STAT,1827,53,30-34,1880,0.010172398260362524
STAT,1894,44,30-34,1938,0.20432870969362285
STAT,1819,49,40-44,1868,0.6971437871667587
SIM,1878,33,50-100,1911,5
SIM,1825,45,na,1870,2843
STAT,1877,47,35-39,1924,0.2922333606295785
STAT,1829,52,25-29,1881,0.0049129176455277755
SIM,1829,35,na,1864,3504
SIM,1897,19,na,1916,6922
STAT,1875,16,20-24,1891,36.954387950474846
STAT,1868,38,25-29,1906,5.505012391980448
SIM,1832,43,35-39,1875,7
STAT,1852,86,na,1938,353.6285321157083
SIM,1883,16,20-24,1899,29
STAT,1888,35,45-49,1923,4.803775433520249
SIM,1931,39,25-29,1970,4
SIM,1871,32,35-39,1903,22
STAT,1848,45,15-19,1893,6.624212107848024E-4
STAT,1859,33,na,1892,3819.7814168038594
STAT,1877,6,na,1883,5676.8686025320785
SIM,1886,67,na,1953,3165
STAT,1863,35,40-44,1898,7.812488280293488
STAT,1879,42,40-44,1921,4.745693805426061
SIM,1862,26,30-34,1888,58
SIM,1878,33,30-34,1911,50
SIM,1901,31,50-100,1932,4
SIM,1871,17,40-44,1888,1
STAT,1865,45,50-100,1910,0.45512222342738295
SIM,1884,32,na,1916,5155
SIM,1848,39,30-34,1887,14
STAT,1863,17,40-44,1880,0.3689778300295077
SIM,1834,81,na,1915,608
SIM,1853,39,40-44,1892,5
SIM,1914,16,na,1930,8391
STAT,1885,37,15-19,1922,0.11288730105222862
SIM,1834,26,25-29,1860,71
SIM,1830,33,30-34,1863,36
SIM,1876,37,na,1913,5124
SIM,1946,16,40-44,1962,2
STAT,1811,45,20-24,1856,0.084322851334395
SIM,1851,23,20-24,1874,133
STAT,1893,17,25-29,1910,14.506133767454743
SIM,1864,39,45-49,1903,3
STAT,1843,23,20-24,1866,120.29973029973014
SIM,1846,43,35-39,1889,8
SIM,1896,65,na,1961,4855
SIM,1929,19,45-49,1948,6
STAT,1813,99,na,1912,1.6828918337906709
SIM,1869,63,na,1932,3349
STAT,1944,26,na,1970,8180.319211628676
SIM,1870,32,na,1902,4642
SIM,1887,42,40-44,1929,8
SIM,1881,36,40-44,1917,14
STAT,1882,29,15-19,1911,0.8862331975711231
SIM,1926,22,20-24,1948,291
SIM,1938,32,50-100,1970,1
STAT,1834,20,45-49,1854,2.3480783263246914
STAT,1845,39,40-44,1884,6.941713815547354
STAT,1876,51,50-100,1927,0.0316984682048349
SIM,1850,20,na,1870,4112
STAT,1845,51,25-29,1896,0.005484128560394654
STAT,1918,22,20-24,1940,242.1638946816975
SIM,1837,32,30-34,1869,35
STAT,1917,24,na,1941,7788.784801814865
STAT,1879,25,na,1904,5075.6787511086895
STAT,1906,52,na,1958,6412.598605843953
STAT,1906,60,na,1966,6073.703212675811
SIM,1858,24,15-19,1882,5
SIM,1851,38,20-24,1889,2
STAT,1864,16,45-49,1880,0.1348527627404645
STAT,1828,41,na,1869,3291.8860535237186
STAT,1847,49,45-49,1896,0.3522334788477511
STAT,1914,46,20-24,1960,0.022193949347478037
SIM,1859,65,na,1924,2933
SIM,1871,23,50-100,1894,1
STAT,1865,44,35-39,1909,3.2776539415698176
STAT,1882,47,45-49,1929,0.4621409989580628
SIM,1845,27,40-44,1872,7
STAT,1883,30,na,1913,4773.154835421912
STAT,1896,23,30-34,1919,47.34841587500676
STAT,1889,46,15-19,1935,9.98920393959773E-4
SIM,1880,25,40-44,1905,8
SIM,1872,30,30-34,1902,44
STAT,1831,25,50-100,1856,1.1462416409112237
SIM,1887,44,35-39,1931,7
STAT,1849,26,20-24,1875,22.156415548994183
STAT,1875,43,na,1918,4771.163432687617
STAT,1865,32,40-44,1897,7.957056168392267
STAT,1878,45,30-34,1923,0.20621589614835953
STAT,1880,16,30-34,1896,3.399402154165681
STAT,1780,87,na,1867,102.49356916542038
STAT,1779,90,na,1869,50.12478295946161
SIM,1825,33,20-24,1858,3
STAT,1846,38,45-49,1884,3.155712191359626
STAT,1868,26,50-100,1894,1.2334040485456161
STAT,1844,52,20-24,1896,0.0011853324613298475
STAT,1829,32,30-34,1861,33.49082331823758
SIM,1866,19,25-29,1885,16
STAT,1843,38,20-24,1881,1.1352895055021244
SIM,1856,37,na,1893,3969
STAT,1861,21,15-19,1882,5.738502646121821
SIM,1827,49,40-44,1876,2
STAT,1879,26,35-39,1905,20.45309007228383
STAT,1834,50,40-44,1884,0.014949616107773475
SIM,1835,37,25-29,1872,4
STAT,1902,70,na,1972,4837.921361047972
SIM,1804,51,na,1855,2447
SIM,1851,44,50-100,1895,3
SIM,1854,38,45-49,1892,7
STAT,1907,22,45-49,1929,2.0699031226328612
STAT,1821,35,35-39,1856,31.537201886224853
STAT,1808,103,na,1911,0.11277423582075138
STAT,1882,37,50-100,1919,2.4154570322569233
STAT,1841,28,15-19,1869,0.8117580532421472
SIM,1880,49,50-100,1929,4
STAT,1858,37,25-29,1895,4.5330607940866186
STAT,1895,43,35-39,1938,0.3285281742440219
STAT,1859,47,15-19,1906,6.399974564196333E-4
SIM,1855,34,45-49,1889,7
SIM,1910,47,40-44,1957,1
STAT,1894,28,25-29,1922,109.36036323559289
SIM,1873,44,35-39,1917,6
STAT,1879,44,35-39,1923,3.7736682632538887
STAT,1881,15,35-39,1896,1.0761014464866596
STAT,1906,23,40-44,1929,6.113583617888411
SIM,1890,47,45-49,1937,1
SIM,1818,71,na,1889,1301
SIM,1853,20,20-24,1873,2
STAT,1821,94,na,1915,22.1534903976815
STAT,1837,27,40-44,1864,5.360008887517282
SIM,1892,24,20-24,1916,199
STAT,1855,42,25-29,1897,0.9671384939915524
SIM,1802,88,na,1890,91
SIM,1870,35,25-29,1905,7
SIM,1871,19,35-39,1890,1
SIM,1938,21,30-34,1959,71
STAT,1817,89,na,1906,105.95965446916468
STAT,1820,36,30-34,1856,28.255378781147105
SIM,1922,11,na,1933,9777
SIM,1887,26,35-39,1913,31
STAT,1887,20,na,1907,5374.028800327895
STAT,1880,31,25-29,1911,21.880944007888317
STAT,1771,111,na,1882,0.0018695612796051603
SIM,1874,28,20-24,1902,19
STAT,1896,41,30-34,1937,0.2138383686898683
SIM,1919,27,35-39,1946,44
STAT,1903,46,45-49,1949,0.3838922282920325
SIM,1910,34,na,1944,7565
SIM,1865,73,na,1938,2181
STAT,1884,24,20-24,1908,136.5698150529549
STAT,1912,49,20-24,1961,0.02132963819383676
SIM,1838,22,50-100,1860,1
STAT,1920,43,40-44,1963,0.5569029474167407
STAT,1877,30,na,1907,5044.6984534978765
SIM,1890,40,na,1930,6133
STAT,1829,50,30-34,1879,0.009439910717822799
STAT,1923,32,na,1955,8753.762217828962
STAT,1863,19,35-39,1882,0.9954782528217186
STAT,1828,52,35-39,1880,0.014976337961752642
STAT,1832,53,40-44,1885,0.013996333893723891
STAT,1870,12,na,1882,5251.176360058836
STAT,1943,24,50-100,1967,1.4128530549867184
STAT,1912,60,na,1972,6641.929748495302
SIM,1894,21,20-24,1915,195
SIM,1821,63,na,1884,1965
SIM,1886,27,30-34,1913,57
STAT,1919,21,25-29,1940,204.85007394592756
STAT,1928,27,35-39,1955,37.3503975993962
STAT,1885,73,na,1958,2577.7341314650844
SIM,1842,18,30-34,1860,5
STAT,1876,50,45-49,1926,0.030750027945794067
SIM,1863,25,35-39,1888,23
STAT,1845,53,20-24,1898,0.0011188291704833798
STAT,1838,43,na,1881,3286.4652979548027
SIM,1947,15,45-49,1962,5
STAT,1840,17,45-49,1857,0.12207876120053904
STAT,1861,36,15-19,1897,0.09485062421035129
STAT,1960,0,na,1960,10416.915019463955
STAT,1835,31,15-19,1866,0.23737378948081436
STAT,1864,33,35-39,1897,18.205336292132838
STAT,1787,103,na,1890,0.10555697532655264
STAT,1897,40,35-39,1937,0.34289624113207057
STAT,1839,42,40-44,1881,3.7015815123408218
STAT,1859,50,45-49,1909,0.02366378966842883
STAT,1890,21,40-44,1911,5.1524225140393725
STAT,1874,9,na,1883,5517.2879427139915
STAT,1878,71,na,1949,2815.4958444108333
STAT,1814,41,25-29,1855,3.851195633255239
STAT,1853,45,25-29,1898,0.09204337798951497
SIM,1852,36,15-19,1888,2
STAT,1844,37,25-29,1881,4.9134080060759695
STAT,1855,25,35-39,1880,16.907744893930268
SIM,1886,47,50-100,1933,1
SIM,1838,63,na,1901,2440
SIM,1927,21,25-29,1948,256
STAT,1858,41,50-100,1899,1.6708232357228174
STAT,1864,34,45-49,1898,3.121185648642481
SIM,1875,27,25-29,1902,105
SIM,1882,50,40-44,1932,1
STAT,1887,39,45-49,1926,4.457553750664242
SIM,1941,3,na,1944,8491
STAT,1849,46,15-19,1895,6.345151739885894E-4
SIM,1819,36,30-34,1855,14
SIM,1845,44,30-34,1889,5
STAT,1890,20,30-34,1910,44.172047853421084
SIM,1846,25,35-39,1871,26
STAT,1927,14,na,1941,9916.151572470168
STAT,1947,21,30-34,1968,65.6205048890207
STAT,1844,36,15-19,1880,0.10640564375625887
STAT,1869,35,na,1904,4654.291389255244
STAT,1873,48,na,1921,4558.789288041155
STAT,1903,43,40-44,1946,0.4459020035007669
SIM,1852,21,15-19,1873,5
SIM,1931,28,na,1959,9759
STAT,1878,27,30-34,1905,53.11619827161125
SIM,1845,65,na,1910,2770
SIM,1878,39,45-49,1917,7
STAT,1849,31,45-49,1880,3.227448156300158
STAT,1886,21,20-24,1907,147.36103593288777
STAT,1821,40,50-100,1861,3.5560176964366588
STAT,1895,27,30-34,1922,66.26945665095784
STAT,1849,44,20-24,1893,0.24781931030314955
SIM,1895,39,45-49,1934,11
SIM,1797,64,na,1861,1697
SIM,1906,31,35-39,1937,24
STAT,1899,17,20-24,1916,49.05730470260691
SIM,1847,42,40-44,1889,14
STAT,1948,23,45-49,1971,2.6081339995791217
SIM,1936,27,35-39,1963,34
STAT,1766,107,na,1873,0.009372446273316081
STAT,1828,54,30-34,1882,0.009056792213458906
SIM,1842,20,45-49,1862,2
STAT,1830,28,40-44,1858,6.523770634304425
STAT,1849,35,na,1884,3893.4019924430722
STAT,1909,29,na,1938,7182.778488616434
SIM,1828,48,45-49,1876,2
SIM,1836,36,30-34,1872,15
SIM,1888,40,35-39,1928,7
STAT,1845,104,na,1949,0.10278047303460187
STAT,1916,50,na,1966,7541.5541614562235
SIM,1857,31,45-49,1888,5
STAT,1858,71,na,1929,2101.5345456855407
STAT,1862,25,na,1887,4194.827696639694
SIM,1846,36,50-100,1882,5
STAT,1784,77,na,1861,540.8068617585038
STAT,1851,5,na,1856,4739.268957
STAT,1853,27,25-29,1880,77.53468591152537
SIM,1827,30,20-24,1857,8
STAT,1829,35,35-39,1864,12.811601808065372
SIM,1857,26,20-24,1883,21
STAT,1850,33,35-39,1883,16.075552741861372
STAT,1869,52,25-29,1921,0.0068946050944281275
SIM,1766,92,na,1858,10
SIM,1916,15,15-19,1931,20
SIM,1861,27,25-29,1888,85
STAT,1939,15,45-49,1954,1.0124714133137391
STAT,1844,21,15-19,1865,6.700012057810905
SIM,1890,29,15-19,1919,1
STAT,1825,34,50-100,1859,2.7362809253667666
STAT,1889,35,na,1924,5922.650709150327
SIM,1870,36,35-39,1906,29
STAT,1838,41,40-44,1879,3.606001386024249
STAT,1855,43,35-39,1898,2.710863191958111
SIM,1840,38,50-100,1878,3
STAT,1838,43,35-39,1881,2.574958734764253
STAT,1836,40,50-100,1876,1.7147589521068052
STAT,1873,24,45-49,1897,1.4219850502557998
STAT,1870,27,25-29,1897,83.87641003119886
SIM,1822,88,na,1910,89
STAT,1818,46,15-19,1864,0.0017908213616836882
SIM,1921,29,15-19,1950,2
STAT,1954,17,35-39,1971,10.475379535025905
STAT,1861,39,25-29,1900,4.791242633746607
STAT,1913,34,na,1947,7536.377735197962
STAT,1938,34,40-44,1972,7.9379811182608115
STAT,1924,21,35-39,1945,22.50089573758637
SIM,1867,6,na,1873,5703
STAT,1853,6,na,1859,4748.24140296931
STAT,1871,29,40-44,1900,5.967684756448252
SIM,1898,27,20-24,1925,34
STAT,1789,103,na,1892,0.07344941516629387
STAT,1840,31,25-29,1871,18.19548529562946
STAT,1880,10,na,1890,5511.107704553428
STAT,1908,15,15-19,1923,17.873789148695543
STAT,1835,46,15-19,1881,5.533630840026776E-4
SIM,1945,17,35-39,1962,12
STAT,1868,53,20-24,1921,0.0013951651621701353
STAT,1828,36,30-34,1864,10.955044208695504
STAT,1881,30,30-34,1911,34.3567497041244
STAT,1937,17,35-39,1954,8.246053971908234
STAT,1939,33,45-49,1972,3.2409507444561165
STAT,1828,51,25-29,1879,0.006285079044101144
SIM,1893,40,45-49,1933,8
STAT,1820,38,25-29,1858,13.470341386824582
SIM,1804,91,na,1895,22
STAT,1834,103,na,1937,0.19072254565972704
STAT,1885,40,45-49,1925,3.039048802452964
SIM,1896,57,na,1953,5512
SIM,1883,19,30-34,1902,5
STAT,1831,27,45-49,1858,1.935334359404532
SIM,1850,101,na,1951,1
STAT,1913,29,15-19,1942,1.4108356521498953
SIM,1893,22,15-19,1915,9
STAT,1934,9,na,1943,10876.28973724454
STAT,1899,19,15-19,1918,16.333658556307444
STAT,1895,42,25-29,1937,0.11720703745387209
STAT,1837,44,30-34,1881,1.6774930710940166
STAT,1871,40,15-19,1911,0.027989230670416965
STAT,1942,11,na,1953,8314.67729965514
STAT,1891,20,50-100,1911,1.0240746472555993
SIM,1922,17,50-100,1939,1
SIM,1845,26,30-34,1871,66
SIM,1846,41,40-44,1887,9
SIM,1891,34,na,1925,6112
STAT,1853,43,30-34,1896,1.805866654014152
SIM,1879,85,na,1964,841
STAT,1847,35,50-100,1882,1.9825112916821526
SIM,1929,34,40-44,1963,14
STAT,1850,21,40-44,1871,3.862589372848884
STAT,1869,50,30-34,1919,0.011816177297012022
SIM,1887,29,na,1916,5799
STAT,1818,43,na,1861,2991.1479363784742
STAT,1874,50,40-44,1924,0.02208313043541566
STAT,1854,44,30-34,1898,1.7386373243358797
SIM,1797,84,na,1881,166
STAT,1848,53,50-100,1901,0.02436647375973874
SIM,1898,32,45-49,1930,7
SIM,1880,42,na,1922,5119
STAT,1822,56,na,1878,2516.8473103550646
STAT,1838,25,35-39,1863,16.85268844789173
STAT,1885,22,15-19,1907,6.632015404157588
STAT,1896,24,50-100,1920,1.0805369283713788
STAT,1875,51,40-44,1926,0.021995423170868292
SIM,1909,22,20-24,1931,193
STAT,1880,17,40-44,1897,0.38913961112304973
STAT,1885,7,na,1892,5237.537580697619
SIM,1883,51,40-44,1934,1
SIM,1869,49,45-49,1918,2
STAT,1889,55,na,1944,5149.088253057668
SIM,1932,21,35-39,1953,28
SIM,1867,18,30-34,1885,4
STAT,1842,31,50-100,1873,1.6650906229816496
SIM,1900,36,na,1936,6963
STAT,1859,18,30-34,1877,2.9565762332996344
STAT,1899,35,20-24,1934,2.153303554106643
SIM,1876,57,na,1933,4451
SIM,1850,40,na,1890,3742
SIM,1892,75,na,1967,3649
STAT,1881,35,na,1916,4642.736737635575
STAT,1909,49,na,1958,6781.56993397436
STAT,1849,28,15-19,1877,0.8446173629420616
SIM,1808,73,na,1881,1009
STAT,1913,47,15-19,1960,7.263281458730089E-4
STAT,1938,19,45-49,1957,0.9947001936689772
SIM,1824,37,20-24,1861,2
SIM,1872,75,na,1947,2062
STAT,1856,54,40-44,1910,0.01595344964063759
SIM,1815,43,35-39,1858,6
STAT,1837,89,na,1926,146.41892594781058
SIM,1866,27,na,1893,4641
STAT,1880,32,35-39,1912,21.546072359049894
STAT,1877,44,30-34,1921,2.3784917047080176
STAT,1930,34,na,1964,9844.703464071024
SIM,1848,41,45-49,1889,7
SIM,1931,36,20-24,1967,1
STAT,1852,58,na,1910,3151.915101966184
STAT,1874,34,35-39,1908,20.762613526331453
STAT,1862,20,20-24,1882,123.54248499369307
STAT,1869,39,50-100,1908,2.3784370680218543
STAT,1889,18,50-100,1907,0.12168154278316318
STAT,1802,106,na,1908,0.009318537285872395
SIM,1825,73,na,1898,1245
SIM,1843,30,na,1873,3892
STAT,1830,25,35-39,1855,26.79502556460241
SIM,1858,40,na,1898,4029
STAT,1858,18,15-19,1876,10.850123245673908
STAT,1896,40,20-24,1936,0.029702897577241212
SIM,1929,31,30-34,1960,50
SIM,1888,43,40-44,1931,7
STAT,1832,22,35-39,1854,18.374105992116124
STAT,1934,24,na,1958,9906.1615425974
SIM,1896,34,35-39,1930,42
SIM,1821,41,35-39,1862,7
STAT,1814,92,na,1906,35.84471702757185
SIM,1843,29,30-34,1872,62
STAT,1846,52,25-29,1898,0.0053964516425015424
SIM,1798,58,na,1856,1984
STAT,1829,53,35-39,1882,0.01170676770361003
SIM,1906,35,50-100,1941,1
STAT,1861,37,30-34,1898,8.959064991898797
SIM,1845,73,na,1918,1815
STAT,1857,31,50-100,1888,1.4664036396405118
STAT,1883,28,20-24,1911,23.196466447038222
STAT,1835,29,30-34,1864,41.91699089985454
SIM,1791,79,na,1870,445
STAT,1839,21,50-100,1860,0.8240462592852902
STAT,1820,39,35-39,1859,31.200426181866856
SIM,1898,12,na,1910,7322
SIM,1891,28,20-24,1919,29
STAT,1858,51,40-44,1909,0.016654228990124583
STAT,1860,25,15-19,1885,0.7629999929863901
STAT,1824,31,40-44,1855,23.042425288834472
SIM,1832,28,15-19,1860,3
STAT,1923,36,20-24,1959,0.6172379504299375
SIM,1842,17,15-19,1859,13
STAT,1894,43,20-24,1937,0.02840510828572754
STAT,1864,15,35-39,1879,1.1394749241975195
SIM,1897,59,na,1956,5373
SIM,1933,23,50-100,1956,2
SIM,1840,73,na,1913,1858
SIM,1872,31,40-44,1903,8
STAT,1844,53,30-34,1897,0.009458510957461433
STAT,1856,48,na,1904,3461.733005965102
SIM,1873,47,45-49,1920,2
SIM,1874,22,na,1896,4583
SIM,1837,35,35-39,1872,18
STAT,1794,67,na,1861,1529.7685846790375
STAT,1854,29,35-39,1883,15.284633557571297
SIM,1830,34,40-44,1864,8
STAT,1927,4,na,1931,10133.952179706705
STAT,1867,27,25-29,1894,80.00994800041421
SIM,1854,19,35-39,1873,2
STAT,1875,54,45-49,1929,0.02934657959222635
SIM,1847,21,35-39,1868,12
STAT,1764,107,na,1871,0.011784549719880032
STAT,1830,42,20-24,1872,0.2846722663639537
STAT,1871,42,50-100,1913,2.117176773548696
STAT,1896,26,35-39,1922,25.816468262238292
STAT,1834,35,15-19,1869,0.09492950043079136
STAT,1881,91,na,1972,426.34701786517843
STAT,1894,47,35-39,1941,0.203928642117021
SIM,1880,70,na,1950,3099
SIM,1952,15,25-29,1967,148
STAT,1875,19,25-29,1894,11.719930261002842
STAT,1921,29,na,1950,8369.807542240165
SIM,1863,42,25-29,1905,2
STAT,1932,24,50-100,1956,1.737769184219789
STAT,1944,15,25-29,1959,94.22962771325048
SIM,1865,31,50-100,1896,4
SIM,1920,45,50-100,1965,1
STAT,1822,34,40-44,1856,20.65265990567904
SIM,1870,20,20-24,1890,134
SIM,1894,37,35-39,1931,28
STAT,1876,32,15-19,1908,0.29746965554193705
SIM,1862,29,35-39,1891,20
SIM,1962,6,na,1968,10320
SIM,1882,34,35-39,1916,32
SIM,1909,49,na,1958,6833
SIM,1877,39,50-100,1916,5
STAT,1856,109,na,1965,0.007656240428774148
STAT,1890,20,na,1910,5864.99998005402
STAT,1865,47,45-49,1912,0.4309967118589166
SIM,1904,26,na,1930,7020
STAT,1834,53,45-49,1887,0.01941935951115684
STAT,1819,37,50-100,1856,7.140256782761176
SIM,1872,15,35-39,1887,1
SIM,1888,22,35-39,1910,23
SIM,1926,25,25-29,1951,174
SIM,1848,29,50-100,1877,1
STAT,1880,19,35-39,1899,1.1611581382569762
SIM,1867,29,na,1896,4827
STAT,1855,41,40-44,1896,3.4071072788240673
SIM,1864,46,50-100,1910,1
STAT,1847,16,45-49,1863,0.12501427765819043
SIM,1937,13,na,1950,7953
STAT,1839,21,35-39,1860,11.79210059018589
STAT,1835,23,na,1858,3654.2711540465575
SIM,1832,31,40-44,1863,12
SIM,1890,44,40-44,1934,11
SIM,1967,4,na,1971,10512
STAT,1873,39,45-49,1912,4.049575053466771
STAT,1890,26,50-100,1916,1.582353135373879
SIM,1894,33,15-19,1927,1
STAT,1810,46,15-19,1856,0.002660030891418575
SIM,1939,21,50-100,1960,1
STAT,1888,34,35-39,1922,23.966998270877625
SIM,1902,20,50-100,1922,1
STAT,1891,22,40-44,1913,5.20198307320015
STAT,1874,52,35-39,1926,0.017708027559887284
SIM,1885,73,na,1958,2651
SIM,1923,27,50-100,1950,3
STAT,1868,37,15-19,1905,0.10790247240793054
STAT,1870,42,20-24,1912,0.31451111530448633
STAT,1832,58,na,1890,2578.2291744986796
STAT,1881,32,25-29,1913,19.994396124286265
SIM,1883,21,45-49,1904,1
STAT,1876,47,15-19,1923,8.316478444869266E-4
STAT,1832,38,15-19,1870,0.09152197950301659
STAT,1896,44,35-39,1940,0.33076851309861344
SIM,1881,39,45-49,1920,6
STAT,1846,19,35-39,1865,1.0433904328686587
STAT,1886,33,15-19,1919,0.3023237688949129
SIM,1878,36,35-39,1914,20
STAT,1836,48,na,1884,3090.598265945846
STAT,1897,30,na,1927,6493.968561935899
SIM,1840,22,35-39,1862,16
STAT,1882,44,40-44,1926,4.365485679363893
STAT,1803,51,20-24,1854,0.005531461585916015
SIM,1881,24,45-49,1905,1
SIM,1839,65,na,1904,2224
SIM,1842,53,45-49,1895,1
STAT,1819,42,15-19,1861,0.06393756211076566
SIM,1946,19,45-49,1965,1
STAT,1806,103,na,1909,0.09772161741403262
SIM,1841,48,50-100,1889,1
SIM,1870,32,20-24,1902,5
STAT,1918,25,25-29,1943,142.40409936748216
STAT,1956,15,45-49,1971,1.3354908306837423
STAT,1865,53,na,1918,3887.2242541012374
SIM,1868,47,35-39,1915,1
STAT,1806,48,45-49,1854,1.4179604590071977
STAT,1849,29,25-29,1878,78.18334854384591
SIM,1829,43,35-39,1872,7
SIM,1862,42,35-39,1904,6
STAT,1891,19,15-19,1910,14.735456991604337
SIM,1928,20,30-34,1948,82
SIM,1849,19,25-29,1868,15
SIM,1954,5,na,1959,9928
STAT,1895,40,30-34,1935,3.0560304513638448
STAT,1854,81,na,1935,828.9851077428021
STAT,1873,51,35-39,1924,0.01775079901158613
STAT,1836,30,20-24,1866,4.639179125787473
STAT,1861,16,50-100,1877,0.09521926266674044
SIM,1822,41,25-29,1863,1
STAT,1836,49,40-44,1885,0.23224096702233168
STAT,1839,54,35-39,1893,0.01307277111854369
STAT,1854,50,50-100,1904,0.02348503148776607
STAT,1907,14,na,1921,7641.005743426119
STAT,1818,51,na,1869,2717.1975181108833
STAT,1850,50,50-100,1900,0.02348935910909969
SIM,1885,44,30-34,1929,7
STAT,1870,26,15-19,1896,0.9027009970248029
STAT,1804,52,20-24,1856,0.0043151507776637964
STAT,1924,22,45-49,1946,2.680693248010778
SIM,1938,24,35-39,1962,24
SIM,1837,78,na,1915,1000
STAT,1915,27,50-100,1942,2.0505556111439773
SIM,1911,46,45-49,1957,1
STAT,1861,19,30-34,1880,3.0433842791987216
SIM,1862,45,na,1907,4133
STAT,1807,99,na,1906,1.5116987376181628
SIM,1932,22,45-49,1954,3
SIM,1832,47,na,1879,3169
STAT,1866,31,45-49,1897,3.262857121264133
SIM,1848,30,na,1878,3966
STAT,1833,48,50-100,1881,0.3403614822405255
SIM,1832,86,na,1918,340
SIM,1844,49,40-44,1893,1
STAT,1847,49,15-19,1896,5.970053938623769E-4
STAT,1812,44,25-29,1856,4.719220484249185
STAT,1896,37,na,1933,6282.044216122174
SIM,1836,39,35-39,1875,21
STAT,1853,42,20-24,1895,0.25096485062294205
SIM,1831,30,40-44,1861,10
SIM,1894,19,35-39,1913,1
STAT,1884,39,20-24,1923,1.521809122555062
SIM,1843,19,na,1862,4327
STAT,1902,49,50-100,1951,0.3867744649789017
SIM,1849,37,25-29,1886,7
STAT,1801,74,na,1875,987.4125966179024
STAT,1833,34,15-19,1867,0.23656083074139753
SIM,1890,26,40-44,1916,14
SIM,1881,23,35-39,1904,14
STAT,1761,100,na,1861,0.032222108763780836
SIM,1863,22,30-34,1885,36
STAT,1875,19,30-34,1894,3.296441484637147
STAT,1850,18,15-19,1868,11.053667684090634
SIM,1869,43,35-39,1912,8
STAT,1827,37,25-29,1864,5.983437221220296
STAT,1847,34,45-49,1881,2.7817749774643623
SIM,1819,37,40-44,1856,11
STAT,1838,100,na,1938,1.4367954734376966
SIM,1839,49,30-34,1888,1
SIM,1818,38,50-100,1856,5
SIM,1821,94,na,1915,21
SIM,1827,28,35-39,1855,28
STAT,1845,76,na,1921,1459.8880948142958
STAT,1837,45,40-44,1882,0.25418196052542213
STAT,1889,63,na,1952,4443.333056871635
SIM,1820,41,50-100,1861,4
STAT,1864,27,50-100,1891,1.1548427410473838
STAT,1878,28,40-44,1906,6.296303696829212
SIM,1886,28,40-44,1914,9
STAT,1815,53,40-44,1868,0.05312276946251876
STAT,1900,47,35-39,1947,0.22021746277507953
SIM,1856,44,35-39,1900,4
SIM,1869,55,na,1924,4012
STAT,1851,47,15-19,1898,6.171817170594063E-4
SIM,1828,73,na,1901,1414
SIM,1944,20,15-19,1964,14
STAT,1844,91,na,1935,93.5807420746328
SIM,1857,29,25-29,1886,65
SIM,1832,46,45-49,1878,1
STAT,1888,61,na,1949,4460.554810021606
STAT,1820,35,15-19,1855,0.3215823256325859
STAT,1840,32,35-39,1872,17.804397979484815
SIM,1850,12,na,1862,4635
SIM,1853,36,35-39,1889,16
SIM,1931,1,na,1932,10874
STAT,1870,20,na,1890,4717.462950296724
SIM,1914,20,30-34,1934,64
STAT,1901,49,45-49,1950,0.3685309621474369
STAT,1845,36,35-39,1881,11.570919990941595
SIM,1892,39,20-24,1931,1
STAT,1819,46,35-39,1865,0.5964180005067129
SIM,1857,42,50-100,1899,3
STAT,1824,46,45-49,1870,0.57964831821231
STAT,1848,81,na,1929,886.6954760377862
STAT,1859,32,15-19,1891,0.22891879558266195
SIM,1820,44,25-29,1864,2
STAT,1954,16,na,1970,9191.32761693246
STAT,1849,47,25-29,1896,0.09068681161100532
SIM,1829,26,45-49,1855,4
STAT,1876,48,30-34,1924,0.19966095190471445
STAT,1906,20,30-34,1926,52.73332631278724
SIM,1878,60,na,1938,4117
STAT,1817,48,20-24,1865,0.05705806984107382
STAT,1824,51,na,1875,2619.1573871995824
STAT,1869,53,35-39,1922,0.016576905076380415
STAT,1891,37,45-49,1928,4.97650451948113
STAT,1898,39,20-24,1937,0.450157067949134
STAT,1888,17,45-49,1905,0.1559290735941656
STAT,1871,22,15-19,1893,6.619541258129062
SIM,1825,53,na,1878,2503
SIM,1873,32,40-44,1905,14
STAT,1876,47,20-24,1923,0.024949457280981198
STAT,1812,43,15-19,1855,0.10720700336257893
SIM,1840,38,45-49,1878,10
STAT,1822,53,50-100,1875,0.04428565818183265
STAT,1903,24,na,1927,6758.270358423138
STAT,1949,16,15-19,1965,106.62273704353532
STAT,1832,38,45-49,1870,3.2490298859679796
SIM,1817,39,30-34,1856,12
STAT,1927,42,50-100,1969,0.2975192988222076
STAT,1890,40,na,1930,5755.056913575253
STAT,1894,10,na,1904,6720.333531377988
SIM,1883,41,50-100,1924,4
STAT,1936,1,na,1937,8076.3906938703385
STAT,1901,48,35-39,1949,0.22047647451101157
SIM,1849,35,na,1884,4031
STAT,1835,47,30-34,1882,0.13220925421297028
SIM,1875,24,15-19,1899,8
SIM,1904,46,na,1950,6648
SIM,1864,36,40-44,1900,14
STAT,1837,47,50-100,1884,0.3554194640928753
SIM,1904,16,35-39,1920,1
STAT,1849,29,30-34,1878,46.54229584137202
SIM,1840,23,45-49,1863,3
SIM,1965,3,na,1968,10581
STAT,1929,22,25-29,1951,235.88581603459212
STAT,1881,33,35-39,1914,19.68543136574055
STAT,1891,45,na,1936,5673.51060644645
STAT,1886,37,35-39,1923,15.079062359749107
SIM,1833,24,15-19,1857,5
SIM,1874,43,45-49,1917,6
SIM,1886,23,50-100,1909,1
STAT,1852,16,25-29,1868,10.98820703909999
STAT,1855,40,30-34,1895,1.7511171472591331
SIM,1906,32,45-49,1938,4
STAT,1803,52,30-34,1855,0.04373064898855518
STAT,1949,0,na,1949,10378.330811605067
SIM,1860,16,25-29,1876,15
STAT,1874,23,50-100,1897,0.840670104268037
SIM,1883,36,15-19,1919,2
STAT,1912,45,50-100,1957,0.4411871924895762
SIM,1870,33,30-34,1903,34
STAT,1853,46,35-39,1899,0.22213710716741303
SIM,1927,26,50-100,1953,3
SIM,1845,47,50-100,1892,1
STAT,1894,4,na,1898,6825.047901209839
STAT,1895,48,35-39,1943,0.20521291221605764
STAT,1846,15,na,1861,4469.235748962132
SIM,1862,41,25-29,1903,2
STAT,1878,23,50-100,1901,0.8574947157484196
STAT,1874,35,15-19,1909,0.11722568279110021
SIM,1893,60,na,1953,4944
STAT,1832,23,45-49,1855,1.3708640822738416
STAT,1809,105,na,1914,0.026060621634693852
SIM,1843,47,30-34,1890,2
STAT,1793,82,na,1875,328.85036588525423
STAT,1825,39,15-19,1864,0.1369539161950467
STAT,1831,54,35-39,1885,0.011140663205130416
SIM,1883,18,15-19,1901,12
STAT,1828,39,35-39,1867,13.678184322824091
STAT,1874,53,45-49,1927,0.02952858620479015
STAT,1855,22,30-34,1877,31.37885771981727
STAT,1886,36,50-100,1922,2.6300751199580237
STAT,1777,95,na,1872,4.42163135452358
SIM,1894,36,50-100,1930,5
SIM,1828,29,35-39,1857,21
STAT,1814,42,35-39,1856,10.457185387415619
STAT,1936,20,15-19,1956,10.287449993705362
SIM,1937,22,25-29,1959,198
STAT,1919,26,50-100,1945,2.179030993646594
STAT,1875,36,15-19,1911,0.11732707314480646
STAT,1867,24,15-19,1891,6.200792622210258
STAT,1948,16,na,1964,8509.036287148294
STAT,1886,19,35-39,1905,1.1635428942851607
SIM,1842,45,na,1887,3315
SIM,1886,46,40-44,1932,1
SIM,1871,34,30-34,1905,42
SIM,1944,0,na,1944,9207
SIM,1862,85,na,1947,448
STAT,1845,32,15-19,1877,0.260916384705767
SIM,1921,18,na,1939,8463
STAT,1872,86,na,1958,586.6088862754522
SIM,1829,44,45-49,1873,4
SIM,1880,22,35-39,1902,15
STAT,1813,41,35-39,1854,13.991954905832324
SIM,1850,27,20-24,1877,21
STAT,1929,40,25-29,1969,0.18726922813200642
STAT,1842,27,20-24,1869,21.599263364370707
SIM,1847,39,15-19,1886,2
STAT,1850,36,45-49,1886,3.1373640765569375
STAT,1857,39,30-34,1896,8.305365346647571
STAT,1839,39,15-19,1878,0.10262669901461471
STAT,1861,83,na,1944,667.3384711589243
SIM,1864,54,40-44,1918,1
SIM,1857,29,30-34,1886,48
STAT,1878,46,40-44,1924,0.3621375410745362
SIM,1866,34,20-24,1900,5
SIM,1881,38,50-100,1919,4
STAT,1939,30,40-44,1969,8.074051223982023
SIM,1822,42,35-39,1864,7
SIM,1858,9,na,1867,4887
STAT,1873,1,na,1874,7158.543281141419
STAT,1856,68,na,1924,2381.292707703257
STAT,1892,48,15-19,1940,5.632993550439454E-4
SIM,1878,36,40-44,1914,10
STAT,1858,49,20-24,1907,0.01849854874706191
STAT,1820,35,20-24,1855,4.414447732821975
SIM,1833,40,na,1873,3379
SIM,1784,89,na,1873,38
STAT,1841,25,40-44,1866,5.4767438824323
STAT,1851,50,40-44,1901,0.016554301395480784
SIM,1874,31,45-49,1905,5
STAT,1823,41,na,1864,3349.1114914260024
STAT,1941,23,50-100,1964,1.3729184275836803
STAT,1910,0,na,1910,8989.388394847096
SIM,1831,93,na,1924,20
STAT,1842,48,na,1890,3307.5075654733214
SIM,1929,34,35-39,1963,36
STAT,1860,26,25-29,1886,70.62830698011471
STAT,1921,44,50-100,1965,0.2662824050391816
SIM,1827,88,na,1915,102
STAT,1883,42,35-39,1925,3.588725813500238
STAT,1797,95,na,1892,6.433392761986662
STAT,1819,36,na,1855,3071.8847818992735
SIM,1852,37,30-34,1889,14
SIM,1887,20,na,1907,5840
STAT,1916,6,na,1922,8560.137603882391
STAT,1867,24,20-24,1891,129.52681765193165
STAT,1848,44,35-39,1892,2.9291257856575696
STAT,1882,76,na,1958,2071.400625202171
SIM,1826,29,30-34,1855,49
STAT,1924,19,15-19,1943,108.53330646527533
STAT,1862,39,40-44,1901,7.480398467196226
SIM,1866,98,na,1964,15
SIM,1930,19,15-19,1949,104
STAT,1866,43,45-49,1909,2.768811807403899
SIM,1880,42,25-29,1922,2
STAT,1872,42,25-29,1914,1.3018074307909406
STAT,1822,37,45-49,1859,7.9847956433529985
STAT,1830,25,30-34,1855,69.9300084309014
STAT,1846,51,40-44,1897,0.01620245026754804
STAT,1910,38,35-39,1948,4.650483129991076
STAT,1890,71,na,1961,3645.8450502816663
STAT,1812,89,na,1901,99.58090053652047
STAT,1870,43,na,1913,4549.684134620162
STAT,1881,27,50-100,1908,1.2487315341126615
SIM,1932,19,15-19,1951,102
STAT,1895,23,15-19,1918,8.654985616157404
SIM,1891,42,35-39,1933,7
SIM,1837,19,35-39,1856,1
SIM,1889,32,na,1921,6001
STAT,1909,17,25-29,1926,17.17237182319526
STAT,1841,31,40-44,1872,7.714090108306206
STAT,1861,52,20-24,1913,0.0012338451371590488
STAT,1922,19,15-19,1941,105.47844673493492
STAT,1851,84,na,1935,515.6886997199492
STAT,1900,20,35-39,1920,16.446370433281636
STAT,1833,37,20-24,1870,1.2693666096159708
STAT,1898,60,na,1958,5349.572725050415
STAT,1880,50,na,1930,4646.852681652984
STAT,1857,41,45-49,1898,2.3666667495282088
STAT,1891,19,45-49,1910,0.16219542113151625
SIM,1836,21,50-100,1857,1
STAT,1816,51,35-39,1867,0.04139591178014347
STAT,1893,17,na,1910,6465.243695782025
SIM,1867,20,na,1887,4858
STAT,1916,39,na,1955,7702.639540074398
SIM,1879,47,40-44,1926,1
STAT,1876,18,30-34,1894,3.3206467530588863
STAT,1821,63,na,1884,2034.5374428176065
SIM,1832,28,45-49,1860,3
STAT,1923,26,45-49,1949,4.018348154369003
SIM,1879,32,40-44,1911,14
STAT,1834,92,na,1926,55.34948324261821
SIM,1931,26,45-49,1957,2
STAT,1844,37,30-34,1881,9.095031890960163
STAT,1845,18,35-39,1863,1.062375947655725
SIM,1853,18,35-39,1871,2
STAT,1872,16,50-100,1888,0.1003590134541696
SIM,1849,16,20-24,1865,34
SIM,1822,40,40-44,1862,9
SIM,1918,15,20-24,1933,66
STAT,1922,37,15-19,1959,0.04411862591392465
STAT,1940,23,40-44,1963,6.915839574466226
SIM,1841,37,20-24,1878,2
STAT,1825,56,na,1881,2550.3226918943483
STAT,1828,32,15-19,1860,0.3192259590727159
SIM,1948,20,50-100,1968,8
SIM,1852,19,30-34,1871,3
SIM,1829,40,30-34,1869,4
SIM,1943,25,25-29,1968,153
SIM,1897,30,35-39,1927,33
STAT,1861,45,50-100,1906,0.41697165477226933
STAT,1856,24,45-49,1880,1.24391773092633
SIM,1917,17,25-29,1934,23
STAT,1874,38,20-24,1912,1.586143344283122
STAT,1872,51,50-100,1923,0.030801333378034198
STAT,1892,15,15-19,1907,15.074012552472288
STAT,1820,51,20-24,1871,0.0026940210769026253
STAT,1860,43,45-49,1903,2.4368822822058025
SIM,1878,91,na,1969,330
STAT,1851,35,15-19,1886,0.08982829538873684
STAT,1898,46,50-100,1944,0.37971386590549816
STAT,1895,41,15-19,1936,0.00253510778658169
STAT,1763,100,na,1863,0.193211163581131
STAT,1865,84,na,1949,610.3741635706047
SIM,1827,46,30-34,1873,1
STAT,1834,81,na,1915,718.6424289466946
STAT,1888,31,30-34,1919,41.84780309961711
STAT,1869,33,15-19,1902,0.2775071639697172
SIM,1889,18,15-19,1907,13
SIM,1894,37,30-34,1931,16
STAT,1814,40,40-44,1854,13.990208603626348
STAT,1914,33,40-44,1947,7.923385371389093
SIM,1877,37,35-39,1914,18
SIM,1801,86,na,1887,128
STAT,1869,37,35-39,1906,13.841279652183184
SIM,1833,42,45-49,1875,7
STAT,1861,91,na,1952,97.41076643676794
SIM,1909,22,15-19,1931,10
STAT,1886,37,30-34,1923,11.362353745101608
STAT,1895,35,50-100,1930,3.261650232923543
SIM,1935,30,15-19,1965,1
STAT,1873,17,na,1890,5182.685520801725
STAT,1853,30,20-24,1883,4.496621572015778
STAT,1881,31,40-44,1912,8.500218968282073
STAT,1865,45,15-19,1910,7.412407835605605E-4
SIM,1897,50,na,1947,5976
STAT,1872,52,30-34,1924,0.012017811456694494
SIM,1922,33,40-44,1955,9
SIM,1833,71,na,1904,1652
SIM,1870,39,40-44,1909,15
SIM,1927,34,na,1961,9613
SIM,1923,21,na,1944,8939
STAT,1841,63,na,1904,2588.9003391045635
STAT,1836,27,25-29,1863,72.79343629624589
SIM,1844,27,25-29,1871,11
STAT,1805,51,25-29,1856,0.02837875277033695
STAT,1892,21,45-49,1913,1.7683580300889987
STAT,1910,14,na,1924,7880.575401881358
STAT,1889,30,35-39,1919,25.421464401277564
STAT,1851,17,15-19,1868,11.185075176114532
STAT,1851,29,15-19,1880,0.8117092014707108
STAT,1870,27,30-34,1897,49.93135702796097
SIM,1852,55,na,1907,3350
STAT,1849,66,na,1915,2592.583380761133
SIM,1875,24,20-24,1899,142
SIM,1882,38,20-24,1920,3
STAT,1815,41,40-44,1856,14.028678220001154
STAT,1904,39,20-24,1943,0.47744101128543803
SIM,1845,48,45-49,1893,2
SIM,1860,49,25-29,1909,1
STAT,1821,50,25-29,1871,0.010377294003193488
STAT,1912,33,40-44,1945,7.746184740591231
SIM,1902,21,20-24,1923,190
STAT,1807,47,20-24,1854,0.08262058010169832
STAT,1935,25,25-29,1960,181.39506530585214
STAT,1914,15,40-44,1929,0.5871610301907896
SIM,1816,42,50-100,1858,5
SIM,1823,35,40-44,1858,10
SIM,1838,40,na,1878,3442
STAT,1799,99,na,1898,1.2879465614110557
STAT,1871,26,35-39,1897,19.427160717861117
STAT,1856,39,45-49,1895,3.0750593495279532
SIM,1920,33,40-44,1953,10
STAT,1848,10,na,1858,4913.239544270679
SIM,1794,96,na,1890,6
STAT,1898,71,na,1969,4382.42219409458
STAT,1825,42,45-49,1867,3.4553300304006287
STAT,1850,43,na,1893,3518.1547580401957
SIM,1896,31,30-34,1927,58
STAT,1902,43,25-29,1945,0.12623073170378915
SIM,1922,15,40-44,1937,3
SIM,1833,30,45-49,1863,4
STAT,1882,26,40-44,1908,5.913687271720514
SIM,1821,83,na,1904,431
STAT,1892,33,45-49,1925,4.390292945331399
SIM,1880,21,25-29,1901,142
STAT,1857,52,35-39,1909,0.013480208433657208
STAT,1856,42,40-44,1898,3.5005878838196436
SIM,1833,24,45-49,1857,2
STAT,1915,31,35-39,1946,18.87510321503472
SIM,1897,45,35-39,1942,2
SIM,1891,5,na,1896,6746
SIM,1881,20,30-34,1901,37
STAT,1897,22,40-44,1919,5.62553770296806
STAT,1852,49,25-29,1901,0.08988668222403973
SIM,1883,47,na,1930,4654
STAT,1825,30,45-49,1855,7.7752877420527176
STAT,1930,29,20-24,1959,46.82982281724237
STAT,1932,31,35-39,1963,24.550744712972953
SIM,1917,32,20-24,1949,2
STAT,1906,23,35-39,1929,17.120426163854688
SIM,1873,29,45-49,1902,2
SIM,1891,65,na,1956,4609
SIM,1868,29,35-39,1897,21
STAT,1863,38,45-49,1901,3.506806021162233
STAT,1851,32,45-49,1883,2.8135913135071853
STAT,1811,47,50-100,1858,1.6672360771876944
STAT,1877,25,20-24,1902,24.769622178578377
SIM,1917,13,na,1930,8811
STAT,1812,45,35-39,1857,1.0060148236799298
STAT,1847,88,na,1935,209.26712001103436
SIM,1844,30,20-24,1874,5
STAT,1832,35,50-100,1867,2.0660075485887233
STAT,1846,18,na,1864,4390.728581570699
STAT,1892,15,45-49,1907,0.1659219537936984
SIM,1849,34,20-24,1883,6
STAT,1821,52,20-24,1873,0.0020775416407882263
SIM,1832,55,na,1887,2741
STAT,1836,42,20-24,1878,0.2512530677273593
SIM,1838,31,40-44,1869,16
STAT,1819,46,30-34,1865,0.41238044587776074
STAT,1845,54,30-34,1899,0.008920258313527534
STAT,1889,45,35-39,1934,0.3521083173651995
SIM,1923,31,35-39,1954,29
STAT,1865,73,na,1938,2179.3019251579026
SIM,1851,14,na,1865,4649
STAT,1880,37,35-39,1917,15.048156851204132
SIM,1869,42,25-29,1911,4
SIM,1919,30,30-34,1949,43
SIM,1919,37,50-100,1956,3
SIM,1841,32,50-100,1873,3
SIM,1863,47,na,1910,4166
SIM,1890,41,35-39,1931,10
STAT,1842,41,35-39,1883,2.8252341677587864
STAT,1840,30,40-44,1870,7.7843772306713825
SIM,1905,36,45-49,1941,3
STAT,1841,43,40-44,1884,3.3480577332491115
STAT,1842,23,35-39,1865,10.87938160319664
STAT,1850,52,45-49,1902,0.02213298980461087
STAT,1916,36,50-100,1952,0.8725196126081814
STAT,1860,36,50-100,1896,2.0232913968854978
SIM,1794,99,na,1893,1
STAT,1842,30,45-49,1872,3.202121377127407
STAT,1878,40,30-34,1918,2.4494650715742265
STAT,1894,31,20-24,1925,7.041465758534548
SIM,1886,40,30-34,1926,1
SIM,1928,17,35-39,1945,15
SIM,1914,23,35-39,1937,18
STAT,1882,41,35-39,1923,3.5787088837049796
SIM,1822,48,na,1870,2829
STAT,1813,46,35-39,1859,0.8790041559582519
STAT,1831,41,25-29,1872,1.0300253774224677
SIM,1889,42,45-49,1931,6
STAT,1827,40,20-24,1867,0.3128794865288952
SIM,1865,38,20-24,1903,2
SIM,1850,23,35-39,1873,11
SIM,1827,37,50-100,1864,3
STAT,1897,37,40-44,1934,11.817690118851706
STAT,1852,17,50-100,1869,0.09443934548966816
STAT,1851,20,45-49,1871,1.3096347654817564
STAT,1941,21,35-39,1962,19.659433484422912
SIM,1889,36,45-49,1925,8
STAT,1818,74,na,1892,1138.5797416021244
SIM,1858,28,30-34,1886,61
STAT,1863,32,35-39,1895,17.903646780643065
STAT,1866,25,15-19,1891,0.8512013978862233
STAT,1902,39,na,1941,6702.569881991139
SIM,1869,28,40-44,1897,8
SIM,1885,31,20-24,1916,3
SIM,1859,38,25-29,1897,7
STAT,1847,52,40-44,1899,0.015962306219227087
SIM,1866,37,25-29,1903,9
SIM,1891,24,35-39,1915,22
SIM,1841,33,35-39,1874,8
SIM,1911,6,na,1917,8222
SIM,1934,16,na,1950,10016
STAT,1821,71,na,1892,1479.5545677378493
SIM,1909,3,na,1912,8058
STAT,1833,51,na,1884,2975.184987386151
SIM,1830,37,45-49,1867,9
SIM,1850,31,50-100,1881,7
SIM,1860,73,na,1933,2055
STAT,1842,25,na,1867,4040.7035005281223
STAT,1872,25,40-44,1897,6.121467588711603
STAT,1878,49,45-49,1927,0.4874013816976897
SIM,1824,33,35-39,1857,18
SIM,1885,25,20-24,1910,28
STAT,1854,47,35-39,1901,0.213617658283599
SIM,1820,53,na,1873,2531
SIM,1845,96,na,1941,9
STAT,1866,28,15-19,1894,0.8424894439445325
SIM,1848,17,15-19,1865,10
SIM,1862,47,35-39,1909,1
SIM,1850,41,35-39,1891,7
SIM,1911,28,na,1939,7476
STAT,1787,74,na,1861,850.0934749063133
STAT,1791,70,na,1861,1324.8751085840618
STAT,1824,82,na,1906,498.8400600107223
STAT,1877,31,20-24,1908,5.691907884895393
STAT,1832,50,35-39,1882,0.012146263692171968
STAT,1862,35,25-29,1897,5.017275130752061
STAT,1929,26,40-44,1955,11.785437591123127
STAT,1811,48,25-29,1859,0.38435285260021435
STAT,1833,33,35-39,1866,16.999257572813725
STAT,1811,64,na,1875,1907.4670228097636
SIM,1874,29,30-34,1903,57
SIM,1895,72,na,1967,4042
STAT,1773,85,na,1858,153.14625377918244
STAT,1896,42,40-44,1938,0.41596822352597684
SIM,1827,100,na,1927,1
STAT,1880,30,15-19,1910,0.30541814216587776
SIM,1853,36,30-34,1889,15
STAT,1905,37,15-19,1942,0.03540123094865339
STAT,1857,38,15-19,1895,0.08795988317294211
SIM,1869,40,30-34,1909,5
STAT,1909,32,20-24,1941,4.703450520740205
SIM,1859,25,na,1884,4410
SIM,1937,26,40-44,1963,11
STAT,1831,51,30-34,1882,0.008174523566203113
STAT,1898,42,45-49,1940,0.28369945292873827
SIM,1870,17,25-29,1887,15
SIM,1849,18,15-19,1867,12
STAT,1862,17,25-29,1879,11.203232264761223
STAT,1883,24,35-39,1907,11.506699996936591
STAT,1878,47,50-100,1925,0.5156290975022185
SIM,1801,94,na,1895,14
SIM,1908,42,50-100,1950,2
STAT,1914,17,50-100,1931,0.15654789335504807
STAT,1845,36,30-34,1881,8.718903268434644
STAT,1833,51,35-39,1884,0.011917479502231017
SIM,1838,46,40-44,1884,1
SIM,1816,48,na,1864,2817
STAT,1897,43,40-44,1940,0.4186227174538698
SIM,1920,0,na,1920,9727
SIM,1940,31,35-39,1971,26
STAT,1877,43,20-24,1920,0.3306501300294001
STAT,1870,46,35-39,1916,0.27838396154807415
STAT,1821,38,40-44,1859,16.116050232516386
STAT,1832,38,50-100,1870,2.0010030262249
SIM,1931,23,40-44,1954,7
SIM,1861,43,30-34,1904,5
SIM,1828,41,25-29,1869,2
STAT,1858,16,20-24,1874,32.79825193039332
SIM,1879,35,45-49,1914,10
STAT,1851,30,50-100,1881,1.5093497346425275
STAT,1896,45,na,1941,6059.973477420017
STAT,1909,41,50-100,1950,0.22332163319268186
STAT,1773,82,na,1855,288.92009999999993
STAT,1955,16,40-44,1971,3.7505945800722347
SIM,1850,29,na,1879,3960
SIM,1883,39,na,1922,4817
SIM,1945,8,na,1953,9055
STAT,1856,17,na,1873,4229.381214887929
STAT,1940,26,45-49,1966,3.5598051890637747
SIM,1834,23,20-24,1857,105
STAT,1887,32,25-29,1919,23.13591961500366
SIM,1905,15,40-44,1920,1
SIM,1842,85,na,1927,336
STAT,1830,28,35-39,1858,21.013538057035362
STAT,1843,26,25-29,1869,73.45319692181727
STAT,1874,98,na,1972,48.81716220573992
STAT,1925,36,20-24,1961,0.6394377811185528
SIM,1922,18,45-49,1940,1
STAT,1879,41,30-34,1920,2.439636886327083
STAT,1877,46,25-29,1923,0.12113927464869362
STAT,1886,38,na,1924,4997.894887791068
STAT,1854,100,na,1954,1.6274883401393239
STAT,1863,10,na,1873,4876.211267182688
STAT,1851,53,45-49,1904,0.022135680321508325
SIM,1817,78,na,1895,723
STAT,1805,56,na,1861,2394.968104761531
STAT,1854,26,35-39,1880,17.163351260294764
STAT,1914,18,45-49,1932,0.20818365049927715
STAT,1832,103,na,1935,0.18710309693438068
STAT,1900,7,na,1907,7299.229757553644
SIM,1832,78,na,1910,981
STAT,1885,50,50-100,1935,0.03079729997029089
SIM,1860,28,20-24,1888,23
STAT,1829,51,40-44,1880,0.016367696479409517
SIM,1876,65,na,1941,3698
STAT,1835,35,30-34,1870,8.716695513608316
SIM,1851,26,25-29,1877,88
SIM,1848,35,45-49,1883,8
SIM,1895,32,25-29,1927,36
STAT,1850,33,40-44,1883,6.884038747438781
STAT,1871,26,30-34,1897,50.70125831800687
STAT,1903,32,na,1935,6861.986317037222
SIM,1918,18,25-29,1936,132
STAT,1841,22,50-100,1863,0.7495347803525981
SIM,1832,25,40-44,1857,9
STAT,1830,40,25-29,1870,1.183851260519237
SIM,1843,17,30-34,1860,6
STAT,1852,28,20-24,1880,21.62162349275408
SIM,1907,14,na,1921,7756
SIM,1907,28,20-24,1935,37
STAT,1866,46,15-19,1912,7.475075653586513E-4
SIM,1883,33,45-49,1916,7
SIM,1917,21,na,1938,8039
STAT,1912,36,45-49,1948,1.350620054220566
SIM,1866,58,na,1924,3842
STAT,1900,49,30-34,1949,0.14978377564126247
STAT,1862,53,20-24,1915,0.0012533451763552478
STAT,1804,50,25-29,1854,0.021565275159240276
SIM,1887,41,30-34,1928,4
SIM,1845,42,35-39,1887,8
STAT,1806,97,na,1903,3.658043615850177
SIM,1839,25,na,1864,3741
SIM,1927,25,40-44,1952,20
SIM,1862,26,35-39,1888,23
STAT,1834,29,15-19,1863,0.7806024329199769
SIM,1828,27,40-44,1855,7
SIM,1811,53,na,1864,2393
STAT,1911,50,na,1961,6962.9220806928015
STAT,1867,17,50-100,1884,0.09473086216089209
SIM,1861,5,na,1866,5568
SIM,1944,23,na,1967,8134
SIM,1948,16,45-49,1964,1
STAT,1815,50,35-39,1865,0.04612674490971481
STAT,1837,58,na,1895,2756.2874065933975
STAT,1951,19,na,1970,8845.51215783995
STAT,1891,16,40-44,1907,0.4577173273739515
SIM,1833,28,30-34,1861,53
SIM,1836,37,na,1873,3366
SIM,1887,32,50-100,1919,1
STAT,1852,46,20-24,1898,0.019180025000894926
STAT,1910,35,30-34,1945,3.5551390150178346
STAT,1879,32,50-100,1911,1.935547761029104
STAT,1919,25,40-44,1944,10.238101396373278
SIM,1816,42,45-49,1858,5
STAT,1837,42,35-39,1879,2.9788503268468385
SIM,1849,32,na,1881,4139
STAT,1869,43,na,1912,4490.283635764952
STAT,1872,28,45-49,1900,2.2456944569398236
SIM,1917,4,na,1921,8955
STAT,1892,19,30-34,1911,4.00816273030642
SIM,1778,89,na,1867,55
SIM,1920,36,45-49,1956,2
SIM,1834,38,20-24,1872,2
STAT,1848,48,20-24,1896,0.019429251915220453
SIM,1880,28,45-49,1908,5
STAT,1861,25,30-34,1886,43.25747585627592
STAT,1879,23,30-34,1902,37.51176980656084
STAT,1880,16,35-39,1896,1.1702859663946583
SIM,1895,46,50-100,1941,1
SIM,1838,43,50-100,1881,1
STAT,1887,46,50-100,1933,0.5563345449576611
STAT,1893,29,20-24,1922,29.81644687582407
SIM,1864,21,40-44,1885,3
SIM,1827,49,35-39,1876,1
STAT,1862,32,20-24,1894,4.666023355876208
STAT,1875,33,45-49,1908,3.6107176201386015
STAT,1914,36,45-49,1950,1.3815166482976462
SIM,1844,24,20-24,1868,119
SIM,1877,37,30-34,1914,17
SIM,1895,18,40-44,1913,1
STAT,1860,19,15-19,1879,11.09360089959548
STAT,1895,45,30-34,1940,0.1451281945872293
SIM,1953,15,40-44,1968,8
STAT,1871,41,25-29,1912,1.2943278789930717
STAT,1925,18,20-24,1943,329.8283509521951
STAT,1870,32,50-100,1902,1.8167566506977764
SIM,1854,31,25-29,1885,24
STAT,1779,99,na,1878,0.6052917274905768
STAT,1901,42,25-29,1943,0.12592479745379173
STAT,1860,40,40-44,1900,3.726222022800146
SIM,1872,98,na,1970,37
SIM,1849,66,na,1915,2615
SIM,1933,20,50-100,1953,1
STAT,1863,17,50-100,1880,0.09883332329553418
STAT,1830,46,35-39,1876,0.244811715098932
STAT,1944,2,na,1946,8800.042954315019
SIM,1943,22,20-24,1965,220
SIM,1770,86,na,1856,85
STAT,1846,17,40-44,1863,0.3519303615489923
STAT,1858,34,20-24,1892,4.219309225196161
STAT,1887,18,40-44,1905,0.4120576610703906
STAT,1945,15,40-44,1960,3.0872172143994603
STAT,1816,96,na,1912,8.43426592204808
SIM,1846,40,30-34,1886,5
SIM,1898,26,15-19,1924,2
SIM,1870,40,na,1910,4566
STAT,1886,35,na,1921,5070.510231902823
STAT,1909,57,na,1966,6522.045103814967
SIM,1881,80,na,1961,1202
STAT,1832,55,na,1887,2736.0554837378613
SIM,1890,32,40-44,1922,18
STAT,1846,35,40-44,1881,7.148900634875168
STAT,1923,23,40-44,1946,7.874306805425738
STAT,1891,34,40-44,1925,10.733412662414109
STAT,1884,27,25-29,1911,84.36047452486876
SIM,1909,0,na,1909,8361
SIM,1934,13,na,1947,10716
STAT,1856,36,40-44,1892,6.854013988353763
SIM,1887,23,30-34,1910,48
STAT,1803,78,na,1881,660.9318949099243
SIM,1902,24,25-29,1926,4
STAT,1845,84,na,1929,512.6125823660813
STAT,1859,48,30-34,1907,0.1536497716099698
STAT,1935,22,20-24,1957,305.8663799383023
STAT,1811,110,na,1921,2.568740436461417E-4
SIM,1866,16,20-24,1882,30
STAT,1860,37,15-19,1897,0.09209813281311255
STAT,1833,96,na,1929,11.288258727976313
STAT,1925,20,50-100,1945,1.599847762762275
STAT,1843,41,50-100,1884,1.5433678488731277
SIM,1913,41,50-100,1954,1
SIM,1812,78,na,1890,641
SIM,1877,50,na,1927,4451
STAT,1905,41,50-100,1946,0.21524439835350742
STAT,1773,111,na,1884,0.002300771032231657
STAT,1824,43,40-44,1867,5.705349203373595
SIM,1899,29,30-34,1928,83
STAT,1836,24,20-24,1860,119.2191915533621
STAT,1914,49,25-29,1963,0.10564388213783418
SIM,1865,17,na,1882,4900
STAT,1897,42,50-100,1939,0.19780780013231003
SIM,1861,8,na,1869,5424
SIM,1933,18,20-24,1951,403
STAT,1856,21,40-44,1877,3.7984365932103095
SIM,1825,36,25-29,1861,6
STAT,1863,50,30-34,1913,0.010674743588196686
STAT,1901,46,40-44,1947,0.27381723042525863
SIM,1832,43,40-44,1875,6
STAT,1837,48,45-49,1885,0.3371792104003961
SIM,1922,36,45-49,1958,5
STAT,1836,45,25-29,1881,0.0822458113669193
STAT,1846,31,25-29,1877,18.7336381930089
SIM,1849,55,na,1904,3373
STAT,1870,51,na,1921,4289.786837598789
SIM,1854,35,40-44,1889,10
STAT,1826,38,20-24,1864,1.7655367593311098
SIM,1874,25,45-49,1899,3
STAT,1869,37,30-34,1906,10.429661469720124
STAT,1882,32,40-44,1914,8.532041626410248
STAT,1850,34,15-19,1884,0.223720649792466
STAT,1933,31,na,1964,10300.665043007008
STAT,1866,25,45-49,1891,2.0830643134976254
STAT,1923,8,na,1931,9455.54664069093
STAT,1925,47,50-100,1972,0.5534147108826569
STAT,1887,36,40-44,1923,9.935462145009168
STAT,1812,42,30-34,1854,9.41303884095348
STAT,1894,40,15-19,1934,0.036189697171944604
STAT,1858,109,na,1967,0.010683160122696066
SIM,1816,39,15-19,1855,3
STAT,1825,45,15-19,1870,8.91634170239064E-4
STAT,1949,22,15-19,1971,12.544006701706113
SIM,1823,38,45-49,1861,5
SIM,1831,32,35-39,1863,30
SIM,1836,36,35-39,1872,22
SIM,1861,30,20-24,1891,8
STAT,1934,16,na,1950,10081.03384484775
STAT,1781,89,na,1870,71.031296946603
SIM,1853,39,35-39,1892,12
SIM,1817,45,30-34,1862,1
SIM,1892,27,25-29,1919,132
STAT,1867,39,20-24,1906,1.443328400509325
SIM,1917,35,25-29,1952,2
SIM,1893,38,30-34,1931,6
STAT,1831,104,na,1935,0.08611963130836948
STAT,1893,47,20-24,1940,0.017247030358936464
SIM,1805,53,na,1858,2282
STAT,1856,51,35-39,1907,0.013479132931599932
SIM,1828,70,na,1898,1735
SIM,1853,100,na,1953,1
SIM,1886,43,35-39,1929,8
SIM,1823,41,40-44,1864,7
STAT,1927,44,40-44,1971,0.6313362522016762
SIM,1890,29,45-49,1919,5
STAT,1878,43,35-39,1921,3.7919591575645675
STAT,1854,22,15-19,1876,5.9422224516223
SIM,1875,39,20-24,1914,2
STAT,1882,29,45-49,1911,2.1687943087049018
STAT,1845,39,35-39,1884,11.216028586195893
STAT,1892,36,15-19,1928,0.1426586833185399
STAT,1841,46,45-49,1887,0.3484069944481079
STAT,1838,22,30-34,1860,31.27667919762876
STAT,1883,61,na,1944,3707.883810820528
SIM,1810,48,50-100,1858,2
STAT,1844,19,30-34,1863,3.2335172445323916
STAT,1883,21,30-34,1904,35.45114709696063
STAT,1911,39,na,1950,7267.138071667674
SIM,1945,20,30-34,1965,83
SIM,1838,34,45-49,1872,8
SIM,1915,22,45-49,1937,5
STAT,1823,32,35-39,1855,58.00071517399269
STAT,1851,18,30-34,1869,2.986333079715098
SIM,1895,36,40-44,1931,20
SIM,1818,37,25-29,1855,6
STAT,1872,21,25-29,1893,116.54453595775341
STAT,1900,4,na,1904,7370.199284023792
STAT,1834,47,15-19,1881,5.646810397429136E-4
STAT,1877,28,25-29,1905,88.40050284150526
STAT,1897,25,45-49,1922,3.0177563453838467
SIM,1874,28,15-19,1902,1
STAT,1838,40,30-34,1878,1.8668944380395374
STAT,1909,35,25-29,1944,1.90111658652899
STAT,1876,36,30-34,1912,11.186322909312452
STAT,1832,66,na,1898,2136.806813838332
STAT,1890,23,35-39,1913,14.34091753088163
STAT,1927,30,15-19,1957,0.3195654333811897
SIM,1846,22,30-34,1868,41
STAT,1852,55,na,1907,3295.5430399447973
STAT,1929,29,45-49,1958,4.361974783711485
STAT,1810,52,45-49,1862,0.089706720957562
SIM,1864,32,na,1896,4531
STAT,1892,18,15-19,1910,14.964989117647592
SIM,1858,91,na,1949,78
SIM,1937,29,45-49,1966,8
SIM,1884,36,30-34,1920,10
SIM,1862,44,30-34,1906,5
STAT,1809,45,30-34,1854,0.7780159301284743
STAT,1819,49,35-39,1868,0.5700942197921929
STAT,1865,44,40-44,1909,4.07128988277399
STAT,1868,54,30-34,1922,0.011123444011756764
STAT,1947,24,35-39,1971,21.476220611821326
SIM,1869,24,na,1893,4572
SIM,1824,30,30-34,1854,49
SIM,1885,28,25-29,1913,86
STAT,1892,75,na,1967,3329.4763914543532
SIM,1891,21,30-34,1912,61
STAT,1849,91,na,1940,91.66175523027412
STAT,1937,20,30-34,1957,56.576147825008164
SIM,1869,32,na,1901,4608
STAT,1866,29,30-34,1895,46.59057089321094
SIM,1830,31,35-39,1861,21
STAT,1813,43,30-34,1856,8.016045805515294
STAT,1938,30,25-29,1968,18.793632834704987
STAT,1902,29,45-49,1931,3.1432315664817616
STAT,1831,24,40-44,1855,4.090510951194619
STAT,1875,48,15-19,1923,8.212890888896531E-4
SIM,1905,33,40-44,1938,4
SIM,1901,29,na,1930,6713
STAT,1842,20,30-34,1862,33.934047082101955
SIM,1871,1,na,1872,6522
SIM,1873,44,40-44,1917,10
STAT,1838,40,na,1878,3413.986417478992
STAT,1899,38,25-29,1937,1.7111073084238833
STAT,1856,39,15-19,1895,0.08662140042894968
STAT,1925,46,30-34,1971,0.21866339332549337
STAT,1948,20,40-44,1968,7.801852423884792
STAT,1949,22,45-49,1971,2.651452795058277
STAT,1821,34,25-29,1855,51.49053900522665
STAT,1875,83,na,1958,1017.8520704038951
SIM,1841,19,20-24,1860,36
STAT,1803,53,15-19,1856,1.7710148034244633E-4
SIM,1885,17,na,1902,5295
STAT,1885,38,30-34,1923,10.66088827347093
STAT,1880,34,30-34,1914,36.82878730294682
SIM,1838,49,45-49,1887,2
SIM,1857,43,45-49,1900,4
SIM,1910,29,45-49,1939,4
STAT,1869,36,50-100,1905,2.4141822862117213
SIM,1830,104,na,1934,1
STAT,1876,68,na,1944,3192.1903183908494
STAT,1910,25,20-24,1935,36.158675173325825
STAT,1870,44,15-19,1914,0.02701289403511392
SIM,1872,33,35-39,1905,37
STAT,1818,47,30-34,1865,0.42673950626911256
SIM,1884,18,30-34,1902,7
SIM,1819,48,50-100,1867,2
SIM,1853,40,na,1893,3861
SIM,1862,22,15-19,1884,8
SIM,1866,41,50-100,1907,4
SIM,1850,20,30-34,1870,46
STAT,1839,36,na,1875,4038.1657736504494
STAT,1934,27,na,1961,10179.338290917793
STAT,1855,43,na,1898,3460.021601661953
SIM,1913,54,na,1967,7147
STAT,1891,35,15-19,1926,0.14151457981328494
SIM,1924,46,na,1970,9192
STAT,1864,30,30-34,1894,31.77355734031638
SIM,1820,42,30-34,1862,4
STAT,1939,33,40-44,1972,8.059929865045797
SIM,1843,35,30-34,1878,16
SIM,1864,42,40-44,1906,7
SIM,1821,43,30-34,1864,3
STAT,1889,49,20-24,1938,0.016504436742514325
STAT,1945,19,na,1964,8114.355747111667
SIM,1836,18,35-39,1854,2
SIM,1856,14,na,1870,4787
SIM,1908,39,na,1947,7033
STAT,1907,19,15-19,1926,17.52142681111706
SIM,1818,63,na,1881,1974
SIM,1915,19,15-19,1934,20
STAT,1895,27,35-39,1922,25.392414858197917
SIM,1829,66,na,1895,2114
SIM,1859,35,20-24,1894,2
STAT,1865,76,na,1941,1738.3068723478937
SIM,1841,15,na,1856,4338
SIM,1863,41,40-44,1904,10
STAT,1809,52,50-100,1861,0.11132698991380709
SIM,1829,44,50-100,1873,5
STAT,1828,36,35-39,1864,14.538518909248298
STAT,1919,21,20-24,1940,246.5993299852221
STAT,1854,40,15-19,1894,0.021383909015198543
STAT,1929,35,50-100,1964,1.0904007776121531
STAT,1802,52,15-19,1854,1.5768028500200176E-4
STAT,1824,44,15-19,1868,0.03418969664100532
STAT,1841,28,45-49,1869,1.986538363426237
SIM,1927,21,20-24,1948,293
STAT,1914,40,50-100,1954,0.2367857850384149
SIM,1842,14,na,1856,4425
SIM,1881,0,na,1881,5914
STAT,1891,31,35-39,1922,25.384340530780882
SIM,1935,16,30-34,1951,38
STAT,1854,23,30-34,1877,31.85323415811512
STAT,1933,15,45-49,1948,1.3569525783691727
SIM,1920,33,na,1953,8505
STAT,1897,61,na,1958,5184.418950861171
STAT,1936,25,40-44,1961,9.018573909917894
SIM,1935,30,50-100,1965,2
STAT,1885,41,20-24,1926,0.3207058128147048
SIM,1935,18,25-29,1953,159
SIM,1835,52,na,1887,2964
STAT,1760,101,na,1861,0.03298479025613144
SIM,1841,40,45-49,1881,7
SIM,1855,45,35-39,1900,1
SIM,1918,19,35-39,1937,10
STAT,1850,38,30-34,1888,8.215333380684973
SIM,1867,29,20-24,1896,24
SIM,1839,41,30-34,1880,5
STAT,1866,47,25-29,1913,0.1068360230557707
SIM,1807,103,na,1910,2
SIM,1924,23,na,1947,8982
SIM,1871,90,na,1961,193
SIM,1827,57,na,1884,2595
STAT,1896,45,50-100,1941,0.37308671835643864
SIM,1853,16,15-19,1869,14
SIM,1873,91,na,1964,263
STAT,1889,66,na,1955,4081.5169096807795
STAT,1865,26,40-44,1891,5.515156142432539
STAT,1898,32,30-34,1930,47.718939421975804
SIM,1944,25,40-44,1969,14
STAT,1757,98,na,1855,1.83654
STAT,1927,16,30-34,1943,30.67845574650448
SIM,1918,29,na,1947,8153
SIM,1832,40,35-39,1872,7
STAT,1920,24,35-39,1944,21.00391167652448
SIM,1849,26,50-100,1875,1
SIM,1872,42,30-34,1914,5
STAT,1807,50,45-49,1857,0.09843257042951986
STAT,1846,69,na,1915,2247.849602529202
STAT,1845,16,15-19,1861,11.626660672904315
SIM,1944,9,na,1953,8721
STAT,1906,42,45-49,1948,0.3054829346996523
SIM,1862,23,30-34,1885,46
STAT,1885,39,50-100,1924,2.443285992039891
STAT,1850,74,na,1924,1701.6052661763417
STAT,1864,42,30-34,1906,2.072951684505307
STAT,1894,17,50-100,1911,0.12710437401779037
SIM,1881,42,40-44,1923,9
SIM,1814,51,40-44,1865,1
SIM,1862,48,45-49,1910,1
STAT,1841,47,20-24,1888,0.017490090837081838
STAT,1852,35,30-34,1887,8.719643681154812
SIM,1869,86,na,1955,340
STAT,1780,84,na,1864,193.3606047936868
SIM,1915,46,50-100,1961,1
STAT,1816,53,20-24,1869,0.003409332986847822
STAT,1911,24,25-29,1935,175.8680312604528
SIM,1860,35,30-34,1895,11
SIM,1910,15,15-19,1925,17
STAT,1876,14,na,1890,5377.035272161224
STAT,1902,15,15-19,1917,17.00007816118691
STAT,1927,45,na,1972,9355.961083189697
STAT,1948,24,20-24,1972,257.6574694054422
SIM,1878,30,30-34,1908,42
STAT,1883,44,20-24,1927,0.3108748278359399
SIM,1924,24,50-100,1948,3
STAT,1839,42,50-100,1881,1.7385785707412513
SIM,1919,31,40-44,1950,15
STAT,1862,54,30-34,1916,0.009992734390606068
STAT,1873,42,40-44,1915,4.609957648121547
SIM,1848,39,na,1887,3602
STAT,1907,17,na,1924,7496.914221624985
STAT,1918,25,20-24,1943,39.4929229661565
STAT,1790,94,na,1884,7.889707772933361
STAT,1858,74,na,1932,1747.2714661463149
SIM,1820,44,50-100,1864,3
STAT,1865,41,35-39,1906,3.33753500566849
STAT,1894,29,50-100,1923,1.6477543093917313
SIM,1865,31,30-34,1896,44
STAT,1868,19,na,1887,4882.854570573889
STAT,1949,9,na,1958,9229.642440151276
STAT,1886,15,20-24,1901,37.971817477365384
SIM,1856,29,45-49,1885,1
STAT,1888,31,50-100,1919,2.196075836637549
STAT,1931,36,45-49,1967,1.825135546899599
SIM,1812,89,na,1901,97
STAT,1887,31,na,1918,5412.209613151389
SIM,1867,44,15-19,1911,2
SIM,1910,26,40-44,1936,17
STAT,1882,40,25-29,1922,1.2761255498163102
SIM,1838,94,na,1932,23
SIM,1876,34,na,1910,5119
SIM,1848,34,35-39,1882,26
STAT,1909,45,35-39,1954,0.24170043600331484
SIM,1879,3,na,1882,6065
SIM,1852,44,na,1896,3706
SIM,1873,26,40-44,1899,6
STAT,1896,20,30-34,1916,47.7785592371715
STAT,1907,25,45-49,1932,3.318141684700069
STAT,1772,89,na,1861,57.074288242235326
STAT,1951,18,30-34,1969,29.302096987826832
STAT,1871,45,40-44,1916,0.3469400716310285
SIM,1889,35,35-39,1924,26
STAT,1825,87,na,1912,203.8474589572017
STAT,1870,49,40-44,1919,0.3323723586445003
STAT,1854,48,45-49,1902,0.3572391569457702
STAT,1873,31,na,1904,4916.85580466303
STAT,1906,21,50-100,1927,1.2037276412319016
STAT,1944,15,20-24,1959,294.80024140407244
SIM,1778,80,na,1858,473
SIM,1870,43,na,1913,4496
STAT,1879,23,35-39,1902,12.289226678583734
STAT,1880,52,25-29,1932,0.007495773620302579
STAT,1801,97,na,1898,4.258398182792866
STAT,1911,48,50-100,1959,0.4313737035858937
STAT,1932,32,45-49,1964,4.225044290981075
SIM,1873,41,35-39,1914,5
STAT,1927,18,25-29,1945,108.51967377979199
STAT,1865,24,50-100,1889,0.7464776703451204
STAT,1848,29,45-49,1877,2.1423207402843936
STAT,1844,40,20-24,1884,0.269484862758711
STAT,1859,44,15-19,1903,0.02189950486183396
SIM,1851,19,15-19,1870,12
SIM,1952,15,20-24,1967,327
STAT,1921,20,na,1941,8377.887671357421
STAT,1934,31,50-100,1965,2.2815108357439207
STAT,1892,37,25-29,1929,7.279462415371661
SIM,1887,23,35-39,1910,18
STAT,1883,41,na,1924,4606.882677272014
SIM,1863,61,na,1924,3400
STAT,1902,31,20-24,1933,7.738853318175634
SIM,1840,41,40-44,1881,7
SIM,1808,50,na,1858,2708
STAT,1842,43,20-24,1885,0.24151197902336044
SIM,1917,45,35-39,1962,1
STAT,1887,51,na,1938,4886.963617897881
STAT,1934,37,40-44,1971,4.172734956498894
STAT,1843,19,15-19,1862,10.498949162923882
STAT,1782,99,na,1881,0.706409310515602
SIM,1898,27,50-100,1925,2
SIM,1909,26,30-34,1935,88
STAT,1900,43,20-24,1943,0.030673969147231448
STAT,1889,32,na,1921,5942.4701781310405
STAT,1856,34,50-100,1890,1.4155033423509624
SIM,1920,20,25-29,1940,250
STAT,1825,46,25-29,1871,0.12663960179684794
SIM,1911,50,na,1961,7176
SIM,1936,30,30-34,1966,34
STAT,1859,29,20-24,1888,18.90920305739062
SIM,1861,80,na,1941,996
STAT,1833,40,45-49,1873,2.450291010340293
STAT,1914,5,na,1919,8373.947884638234
STAT,1840,41,30-34,1881,1.7533977388323403
SIM,1863,22,35-39,1885,15
SIM,1913,51,na,1964,7253
STAT,1919,24,25-29,1943,202.95493817267422
SIM,1909,46,na,1955,6898
STAT,1942,22,na,1964,7733.028920447136
SIM,1925,26,15-19,1951,2
STAT,1856,50,25-29,1906,0.005598607188109771
SIM,1922,14,na,1936,9731
STAT,1861,33,15-19,1894,0.2383782757417657
SIM,1847,36,40-44,1883,10
STAT,1877,40,15-19,1917,0.029253628399073212
SIM,1846,22,35-39,1868,15
SIM,1897,27,40-44,1924,9
STAT,1924,47,25-29,1971,0.12750695714221605
SIM,1916,47,40-44,1963,1
SIM,1883,16,na,1899,5268
STAT,1838,109,na,1947,9.628662413089838E-4
STAT,1844,33,15-19,1877,0.27217217197077903
SIM,1868,28,25-29,1896,91
STAT,1905,46,45-49,1951,0.38992894035883924
STAT,1840,48,15-19,1888,5.748253870875612E-4
STAT,1832,41,40-44,1873,3.634006369755074
STAT,1848,64,na,1912,2850.3988810193027
SIM,1848,31,50-100,1879,3
SIM,1849,38,50-100,1887,4
SIM,1945,21,40-44,1966,7
SIM,1920,48,45-49,1968,3
STAT,1844,18,20-24,1862,36.17934957365563
STAT,1805,52,50-100,1857,0.11858406793828122
SIM,1833,23,35-39,1856,8
STAT,1830,47,45-49,1877,0.4073778849655006
SIM,1876,68,na,1944,3434
SIM,1919,15,35-39,1934,2
STAT,1881,60,na,1941,3722.9697295415112
STAT,1855,22,35-39,1877,10.280024041052204
SIM,1882,39,30-34,1921,25
STAT,1806,106,na,1912,0.008267466129208515
SIM,1831,39,50-100,1870,8
STAT,1849,25,45-49,1874,2.1121210446572607
SIM,1855,47,50-100,1902,2
STAT,1889,27,40-44,1916,7.459651638963889
STAT,1804,54,40-44,1858,0.05912900057424258
STAT,1926,42,30-34,1968,0.3182527924396754
STAT,1857,31,30-34,1888,27.943375065861208
STAT,1850,30,35-39,1880,18.224402997065873
STAT,1852,89,na,1941,167.4353780395342
SIM,1815,48,30-34,1863,1
STAT,1928,33,35-39,1961,23.059518276861105
STAT,1900,45,15-19,1945,6.384414435912264E-4
SIM,1868,39,na,1907,4490
STAT,1841,34,50-100,1875,1.5798169604819776
STAT,1865,49,30-34,1914,0.17390137237405737
SIM,1894,15,20-24,1909,54
STAT,1898,49,na,1947,6021.744930751284
SIM,1872,44,na,1916,4790
STAT,1937,21,40-44,1958,6.616301470266916
SIM,1915,22,40-44,1937,11
STAT,1937,9,na,1946,7823.013067439824
STAT,1896,14,na,1910,6863.7825888184825
SIM,1913,46,45-49,1959,1
STAT,1813,47,45-49,1860,1.4561146073403075
SIM,1857,25,45-49,1882,3
SIM,1823,41,na,1864,3174
SIM,1836,33,30-34,1869,39
SIM,1863,16,na,1879,4875
SIM,1901,17,30-34,1918,7
STAT,1859,51,20-24,1910,0.0011918729362181257
STAT,1865,48,20-24,1913,0.02174108207762713
SIM,1894,53,na,1947,5716
STAT,1908,21,15-19,1929,9.91996944513131
SIM,1932,9,na,1941,10798
SIM,1924,36,50-100,1960,5
SIM,1916,21,15-19,1937,13
STAT,1890,29,na,1919,5841.1039374224465
STAT,1907,48,35-39,1955,0.23147105071063814
STAT,1924,40,40-44,1964,0.602370230579362
SIM,1848,70,na,1918,2025
SIM,1890,40,25-29,1930,2
SIM,1903,21,na,1924,6989
SIM,1914,49,30-34,1963,1
STAT,1856,46,50-100,1902,0.3837893696026681
STAT,1902,26,40-44,1928,8.570701440964788
STAT,1829,32,35-39,1861,19.425502185275118
STAT,1839,36,40-44,1875,8.253355167082365
STAT,1880,38,45-49,1918,4.220251728983198
SIM,1936,31,40-44,1967,10
STAT,1818,43,15-19,1861,0.06557137424168791
STAT,1896,23,35-39,1919,15.511809188433453
STAT,1905,36,na,1941,6968.9723885483145
STAT,1807,48,30-34,1855,0.6533934618160763
STAT,1807,82,na,1889,391.5457435928825
STAT,1821,97,na,1918,5.95484113893186
STAT,1835,43,15-19,1878,0.021167657690736984
STAT,1907,22,40-44,1929,6.185499760318098
STAT,1903,39,35-39,1942,4.3457314211543085
STAT,1875,30,40-44,1905,9.090042698276209
STAT,1814,51,30-34,1865,0.030155807928402396
STAT,1824,48,30-34,1872,0.23116459455626628
STAT,1923,49,30-34,1972,0.2093143268598469
SIM,1900,34,30-34,1934,60
STAT,1886,17,15-19,1903,12.652121418154783
STAT,1828,33,30-34,1861,37.970188180119735
STAT,1926,5,na,1931,9954.354691859351
SIM,1926,25,20-24,1951,50
STAT,1959,2,na,1961,10394.115751187186
STAT,1867,52,50-100,1919,0.02841364197347548
SIM,1852,24,na,1876,4043
STAT,1865,22,na,1887,4392.1670552677215
STAT,1860,98,na,1958,8.430630976382556
STAT,1865,40,25-29,1905,1.1901257779119747
STAT,1871,47,35-39,1918,0.279602476269629
SIM,1852,18,20-24,1870,33
SIM,1873,40,25-29,1913,3
STAT,1923,41,35-39,1964,0.47586289239671264
STAT,1763,92,na,1855,9.79488
SIM,1859,2,na,1861,5951
SIM,1863,44,45-49,1907,6
SIM,1883,30,40-44,1913,13
STAT,1871,101,na,1972,11.082698447935025
STAT,1808,106,na,1914,0.009540951117756992
STAT,1895,24,30-34,1919,46.58190061228825
STAT,1917,26,15-19,1943,1.500220243936866
STAT,1848,51,45-49,1899,0.023909965763333492
STAT,1885,34,15-19,1919,0.2838305740592091
STAT,1925,35,50-100,1960,1.019278101225226
STAT,1908,47,40-44,1955,0.28815967574722395
SIM,1888,37,40-44,1925,18
STAT,1881,46,na,1927,4404.341389987353
SIM,1774,90,na,1864,29
SIM,1858,15,na,1873,4643
STAT,1891,39,30-34,1930,13.170757042250296
STAT,1924,48,35-39,1972,0.30905118874695253
STAT,1878,94,na,1972,210.150852159011
STAT,1928,31,40-44,1959,9.886644810976062
SIM,1927,24,25-29,1951,259
SIM,1865,96,na,1961,18
SIM,1785,82,na,1867,194
SIM,1911,39,35-39,1950,6
SIM,1893,41,20-24,1934,1
STAT,1867,31,na,1898,4531.972551794855
STAT,1818,50,20-24,1868,0.003246736564888821
STAT,1837,20,50-100,1857,0.7799036042434017
STAT,1874,39,30-34,1913,10.910190237575367
STAT,1838,22,35-39,1860,10.246549346914005
STAT,1874,19,45-49,1893,0.1343569617548841
STAT,1869,19,35-39,1888,1.0758733058842487
STAT,1824,40,35-39,1864,4.941482791568142
STAT,1933,38,35-39,1971,6.647625045180452
STAT,1936,28,na,1964,7238.58199480925
STAT,1917,42,20-24,1959,0.03721868703514576
SIM,1831,41,30-34,1872,2
STAT,1854,98,na,1952,4.979972316128901
STAT,1845,22,na,1867,4090.1790276968673
SIM,1939,24,20-24,1963,242
STAT,1960,9,na,1969,10334.554126189427
STAT,1881,49,15-19,1930,7.645286797533178E-4
SIM,1832,24,na,1856,3649
SIM,1880,73,na,1953,2580
STAT,1918,41,25-29,1959,0.15353157421982944
SIM,1840,35,50-100,1875,5
SIM,1909,25,20-24,1934,39
STAT,1850,15,40-44,1865,0.34676574847436065
SIM,1902,34,35-39,1936,24
STAT,1890,32,30-34,1922,43.04092594905879
STAT,1890,43,na,1933,5656.40846360456
SIM,1894,17,15-19,1911,16
STAT,1832,89,na,1921,136.9601536016799
SIM,1817,47,na,1864,2907
SIM,1877,19,35-39,1896,1
STAT,1782,107,na,1889,0.01641375263172032
SIM,1898,26,45-49,1924,1
STAT,1823,41,30-34,1864,3.9265727245788713
SIM,1874,44,20-24,1918,4
STAT,1883,47,25-29,1930,0.11376130016694387
STAT,1918,40,15-19,1958,0.0033061516865568862
STAT,1887,30,30-34,1917,39.75488904223143
SIM,1903,24,40-44,1927,8
STAT,1812,48,40-44,1860,1.169085842182213
STAT,1863,41,na,1904,4104.53069480775
STAT,1818,53,25-29,1871,0.01467802162677546
STAT,1920,21,30-34,1941,64.71123455502234
SIM,1891,31,45-49,1922,6
SIM,1872,20,50-100,1892,1
SIM,1954,2,na,1956,9934
STAT,1900,44,na,1944,6409.88325246661
SIM,1882,82,na,1964,1381
STAT,1901,35,20-24,1936,0.474888007626038
SIM,1918,16,30-34,1934,5
STAT,1845,17,25-29,1862,11.036566685466648
SIM,1913,31,na,1944,7796
STAT,1874,44,50-100,1918,2.1551637983295917
STAT,1908,28,30-34,1936,74.59364139160456
STAT,1868,41,20-24,1909,0.3065442241576068
STAT,1841,40,35-39,1881,2.801019868913766
STAT,1767,106,na,1873,0.021122407935894226
STAT,1918,29,50-100,1947,2.123670544581891
STAT,1932,39,30-34,1971,4.935509627912478
SIM,1886,23,15-19,1909,8
SIM,1891,34,50-100,1925,5
SIM,1855,23,50-100,1878,1
STAT,1807,68,na,1875,1661.8386871211499
STAT,1878,23,15-19,1901,6.937131451780438
STAT,1869,18,25-29,1887,11.176784933531698
SIM,1882,44,50-100,1926,4
STAT,1871,23,30-34,1894,35.6301751113393
SIM,1935,15,20-24,1950,351
STAT,1883,31,45-49,1914,3.474360592589747
SIM,1913,19,15-19,1932,20
SIM,1831,27,50-100,1858,1
SIM,1876,88,na,1964,585
SIM,1783,81,na,1864,360
STAT,1881,42,30-34,1923,2.241482796857731
SIM,1870,63,na,1933,3555
STAT,1925,43,25-29,1968,0.17429398628165554
SIM,1898,35,na,1933,6735
SIM,1858,0,na,1858,6500
STAT,1881,15,50-100,1896,0.09608046849202496
STAT,1864,45,35-39,1909,0.25526307176416135
STAT,1850,40,45-49,1890,2.317908022448722
SIM,1951,16,15-19,1967,111
STAT,1824,50,45-49,1874,0.03522362168209649
STAT,1817,51,15-19,1868,1.1615698573129716E-4
STAT,1836,26,15-19,1862,0.7863899583367959
STAT,1947,8,na,1955,8940.521120413818
SIM,1889,32,30-34,1921,61
STAT,1905,19,15-19,1924,17.240565021176597
STAT,1895,49,45-49,1944,0.3430176038137078
SIM,1896,34,na,1930,6561
SIM,1869,27,30-34,1896,62
SIM,1824,40,45-49,1864,7
STAT,1857,19,45-49,1876,0.11944171054261146
STAT,1800,78,na,1878,675.307667069082
SIM,1905,22,50-100,1927,2
SIM,1930,23,na,1953,9962
SIM,1919,18,40-44,1937,3
SIM,1920,30,50-100,1950,3
STAT,1853,17,na,1870,4368.88175690962
STAT,1875,15,45-49,1890,0.1364595323343525
STAT,1943,16,15-19,1959,97.21972462579873
STAT,1935,8,na,1943,11013.822669416506
SIM,1853,17,25-29,1870,18
STAT,1896,68,na,1964,4533.127021388677
STAT,1770,94,na,1864,6.708458104552205
SIM,1820,48,40-44,1868,1
STAT,1885,44,25-29,1929,1.2735007570399177
STAT,1918,54,na,1972,7688.307074558578
STAT,1879,53,30-34,1932,0.012372725486455093
SIM,1916,28,30-34,1944,101
STAT,1865,29,45-49,1894,2.0226364201782676
STAT,1814,43,45-49,1857,8.338797681746554
SIM,1843,95,na,1938,11
STAT,1903,35,na,1938,6893.065581099049
STAT,1891,41,45-49,1932,3.7530910991880972
SIM,1900,36,25-29,1936,5
STAT,1891,38,20-24,1929,1.9147886670011005
STAT,1892,30,40-44,1922,11.052636769050727
SIM,1848,31,30-34,1879,50
STAT,1878,40,na,1918,4924.291116671184
SIM,1816,46,25-29,1862,1
STAT,1867,46,30-34,1913,0.18360972759646
SIM,1803,98,na,1901,3
SIM,1877,34,30-34,1911,48
SIM,1883,37,25-29,1920,7
STAT,1884,42,15-19,1926,0.02750662848038908
STAT,1871,48,45-49,1919,0.46758752860170694
STAT,1906,41,35-39,1947,0.3717397557769398
SIM,1818,40,na,1858,3167
STAT,1927,15,20-24,1942,341.98047115209454
STAT,1927,19,50-100,1946,0.9356301686005244
SIM,1874,53,na,1927,4061
STAT,1820,54,25-29,1874,0.01218143901343608
SIM,1850,30,45-49,1880,3
STAT,1816,40,45-49,1856,8.91087262256906
STAT,1932,12,na,1944,10597.01665877516
STAT,1824,47,20-24,1871,0.029062257435259337
STAT,1850,54,na,1904,3210.6009589130344
STAT,1912,30,50-100,1942,1.6567320114810136
SIM,1936,33,35-39,1969,20
STAT,1907,45,na,1952,6746.176987221121
STAT,1912,48,45-49,1960,0.42078308830214983
SIM,1909,29,35-39,1938,39
STAT,1925,23,50-100,1948,1.5854445679691824
SIM,1891,11,na,1902,6675
STAT,1875,37,25-29,1912,5.986863185580689
SIM,1845,76,na,1921,1400
SIM,1943,25,20-24,1968,41
SIM,1861,35,na,1896,4525
SIM,1895,30,30-34,1925,67
STAT,1810,88,na,1898,124.15279395047297
SIM,1866,44,na,1910,4427
SIM,1898,25,35-39,1923,36
STAT,1935,25,20-24,1960,50.306285931265805
SIM,1870,2,na,1872,6264
SIM,1839,44,35-39,1883,9
STAT,1822,51,25-29,1873,0.010808007012456104
STAT,1947,11,na,1958,8937.392302780774
SIM,1910,7,na,1917,8350
SIM,1827,27,25-29,1854,16
STAT,1862,16,15-19,1878,11.802237389063952
STAT,1898,35,35-39,1933,19.514502936168096
SIM,1822,43,45-49,1865,6
STAT,1892,34,20-24,1926,6.775621223459703
STAT,1915,7,na,1922,8422.449194254217
STAT,1838,74,na,1912,1501.9513498278886
SIM,1835,66,na,1901,2170
SIM,1858,94,na,1952,25
STAT,1838,52,30-34,1890,0.008013327075365744
SIM,1877,18,25-29,1895,13
STAT,1853,49,40-44,1902,0.26521726984961047
STAT,1912,20,25-29,1932,179.89784180966362
STAT,1909,42,30-34,1951,0.24163394196189
STAT,1780,101,na,1881,0.2516839452737978
STAT,1844,43,25-29,1887,1.048569699072207
SIM,1871,38,45-49,1909,6
SIM,1894,18,25-29,1912,24
SIM,1887,20,30-34,1907,57
SIM,1915,45,30-34,1960,1
SIM,1926,29,50-100,1955,3
STAT,1881,34,45-49,1915,3.3749382532767105
SIM,1830,74,na,1904,1315
SIM,1935,19,50-100,1954,1
SIM,1853,71,na,1924,2063
STAT,1869,34,30-34,1903,33.87508180246474
STAT,1841,91,na,1932,84.07821856919082
STAT,1920,38,50-100,1958,0.9272520841148165
STAT,1855,52,30-34,1907,0.008928269879547545
SIM,1791,68,na,1859,1265
STAT,1879,16,25-29,1895,12.000234727942333
SIM,1852,43,25-29,1895,3
SIM,1870,16,15-19,1886,13
STAT,1886,18,25-29,1904,12.049487011896753
SIM,1889,52,na,1941,5410
SIM,1890,49,na,1939,5859
STAT,1837,22,15-19,1859,6.020635084653487
STAT,1865,51,45-49,1916,0.02675494303137146
SIM,1857,24,35-39,1881,11
SIM,1874,25,na,1899,4647
STAT,1929,26,na,1955,9472.132657957884
STAT,1840,33,45-49,1873,3.034144489705234
STAT,1870,29,na,1899,4698.2423712418995
STAT,1804,53,30-34,1857,0.034113880071002634
STAT,1863,27,na,1890,4219.136033403132
STAT,1833,65,na,1898,2221.6717087991597
STAT,1928,30,30-34,1958,39.825756791742876
SIM,1879,62,na,1941,3766
STAT,1900,28,30-34,1928,70.30189093736698
STAT,1919,50,na,1969,7973.435174427914
STAT,1902,41,30-34,1943,0.22866814413592168
SIM,1910,31,20-24,1941,6
STAT,1907,45,30-34,1952,0.1636981578112183
STAT,1823,44,35-39,1867,5.7301662198013785
STAT,1839,39,45-49,1878,3.6432473817476096
SIM,1847,39,45-49,1886,7
SIM,1934,35,25-29,1969,1
STAT,1825,43,20-24,1868,0.3587118549092954
SIM,1928,24,45-49,1952,4
STAT,1834,45,50-100,1879,0.3908934723136212
STAT,1926,35,25-29,1961,2.4340445525741607
STAT,1830,51,50-100,1881,0.023386767344546783
STAT,1910,32,25-29,1942,18.005199232179287
SIM,1861,49,40-44,1910,2
STAT,1856,79,na,1935,1089.3710962485536
STAT,1902,40,20-24,1942,0.0317628052723212
STAT,1922,43,40-44,1965,0.5787448742070606
STAT,1890,35,35-39,1925,17.601444750917814
STAT,1829,110,na,1939,3.2704864030111034E-4
SIM,1904,20,40-44,1924,7
STAT,1863,31,25-29,1894,18.181907412917262
STAT,1923,25,50-100,1948,2.322874775711583
STAT,1859,54,25-29,1913,0.0055371731108349006
SIM,1792,64,na,1856,1639
SIM,1868,25,20-24,1893,22
STAT,1830,44,40-44,1874,3.920354196195577
STAT,1879,56,na,1935,4308.680178134451
SIM,1904,57,na,1961,6154
STAT,1842,46,25-29,1888,0.08687596902276531
STAT,1863,53,35-39,1916,0.014975588697453246
STAT,1867,29,50-100,1896,1.201282323980613
SIM,1887,20,50-100,1907,1
SIM,1902,31,30-34,1933,65
SIM,1921,49,na,1970,8309
STAT,1910,31,15-19,1941,0.251357653259375
SIM,1842,45,50-100,1887,1
STAT,1860,13,na,1873,4495.0571823216815
STAT,1942,27,50-100,1969,2.1098857612001134
SIM,1842,36,25-29,1878,4
SIM,1910,41,30-34,1951,1
STAT,1802,59,na,1861,2187.682772710517
SIM,1814,50,na,1864,2600
STAT,1834,36,25-29,1870,4.817014643372899
STAT,1849,42,50-100,1891,1.6690363577908314
SIM,1915,25,45-49,1940,5
SIM,1798,80,na,1878,423
SIM,1881,35,na,1916,4064
STAT,1916,46,20-24,1962,0.022948975120608398
STAT,1926,45,35-39,1971,0.3227464096105845
SIM,1885,62,na,1947,3830
STAT,1806,51,40-44,1857,0.06267586424955424
STAT,1830,28,50-100,1858,1.3931288259419625
STAT,1829,25,50-100,1854,3.6424357245216394
STAT,1830,43,30-34,1873,2.0320747547882054
STAT,1842,45,15-19,1887,6.11083936401286E-4
SIM,1909,28,25-29,1937,141
SIM,1932,28,15-19,1960,2
STAT,1816,73,na,1889,1198.4702810612657
STAT,1850,18,45-49,1868,0.12166940503375004
STAT,1863,52,25-29,1915,0.006228591504251191
STAT,1914,27,na,1941,7628.389414798617
STAT,1913,22,35-39,1935,18.431804767277246
STAT,1903,55,na,1958,6067.585863172551
SIM,1850,43,na,1893,3704
STAT,1933,35,30-34,1968,5.0228591365551
SIM,1807,57,na,1864,2060
STAT,1817,58,na,1875,2404.8244548580146
STAT,1896,45,45-49,1941,0.3585035247423637
STAT,1838,24,50-100,1862,0.7057958291148186
STAT,1855,21,50-100,1876,0.7235757944177809
SIM,1928,39,na,1967,9717
SIM,1946,24,na,1970,8025
SIM,1926,17,35-39,1943,15
SIM,1900,37,35-39,1937,7
SIM,1942,18,30-34,1960,38
STAT,1856,100,na,1956,1.9623287058751457
SIM,1865,34,35-39,1899,22
SIM,1825,29,15-19,1854,1
STAT,1883,47,na,1930,4443.486352317484
SIM,1825,42,na,1867,2916
STAT,1862,79,na,1941,1206.796351610704
STAT,1861,94,na,1955,33.59676442637951
STAT,1934,18,30-34,1952,33.21422238046487
SIM,1890,18,na,1908,6678
SIM,1831,44,35-39,1875,5
STAT,1857,34,35-39,1891,15.80550724895077
STAT,1872,55,na,1927,4196.92198676326
SIM,1835,19,30-34,1854,4
STAT,1785,93,na,1878,14.71348662573493
STAT,1948,23,40-44,1971,7.793897237448432
STAT,1869,12,na,1881,5204.802620431867
STAT,1928,34,45-49,1962,3.9680552922102543
STAT,1871,44,30-34,1915,2.275688747480468
STAT,1826,45,30-34,1871,0.19834656828037922
STAT,1883,46,15-19,1929,7.959621678863465E-4
STAT,1924,28,15-19,1952,1.6537637970840038
STAT,1843,41,na,1884,3376.4842305288407
STAT,1829,91,na,1920,68.58176843912972
STAT,1850,37,20-24,1887,1.2006356407722916
SIM,1767,94,na,1861,11
STAT,1849,24,35-39,1873,11.000332354137969
SIM,1931,25,50-100,1956,3
STAT,1887,85,na,1972,1381.1987736201659
SIM,1936,34,45-49,1970,3
STAT,1858,40,na,1898,3675.57562382496
STAT,1886,0,na,1886,7080.457412906572
SIM,1908,45,25-29,1953,1
SIM,1845,22,15-19,1867,6
SIM,1921,22,35-39,1943,30
STAT,1829,54,45-49,1883,0.01934696866993149
SIM,1898,48,25-29,1946,1
SIM,1878,69,na,1947,3007
STAT,1883,34,50-100,1917,1.8025159654323255
SIM,1852,78,na,1930,1178
STAT,1927,19,35-39,1946,10.479059829846188
SIM,1935,19,35-39,1954,12
STAT,1846,103,na,1949,0.2198232673921188
STAT,1866,44,20-24,1910,0.291950164294887
SIM,1865,41,45-49,1906,5
STAT,1854,13,na,1867,4357.885082526729
STAT,1893,36,30-34,1929,13.708734018906355
STAT,1888,39,na,1927,5567.269182021507
SIM,1918,35,40-44,1953,7
STAT,1957,4,na,1961,10469.978087392532
SIM,1794,73,na,1867,886
STAT,1820,49,45-49,1869,0.8530975536263417
STAT,1822,52,35-39,1874,0.025751763400118394
STAT,1841,107,na,1948,0.006842518204810176
SIM,1952,4,na,1956,9774
SIM,1910,57,na,1967,6804
SIM,1931,25,na,1956,9774
STAT,1887,8,na,1895,5871.835995488775
STAT,1910,23,50-100,1933,1.2445641329777308
STAT,1936,18,50-100,1954,0.7226718279741258
STAT,1910,36,40-44,1946,2.906500488114584
SIM,1883,67,na,1950,3190
STAT,1927,30,50-100,1957,2.0560718343440008
SIM,1920,29,35-39,1949,47
STAT,1930,17,50-100,1947,0.9782349990387476
STAT,1872,40,30-34,1912,2.357074326634429
STAT,1874,33,na,1907,4913.863584477904
STAT,1916,24,50-100,1940,1.3837807399596316
STAT,1809,91,na,1900,51.50482832978562
SIM,1920,24,40-44,1944,8
STAT,1846,53,35-39,1899,0.012974849959038184
STAT,1816,38,30-34,1854,39.67888826600374
SIM,1948,17,20-24,1965,310
STAT,1941,26,na,1967,7830.437195899806
STAT,1947,24,50-100,1971,1.5007842854975193
SIM,1792,95,na,1887,2
STAT,1764,91,na,1855,25.711560000000002
STAT,1896,2,na,1898,7107.791120250828
STAT,1893,32,15-19,1925,0.3645462784848889
STAT,1912,49,na,1961,7090.739371469867
STAT,1936,7,na,1943,7730.6784003285775
STAT,1883,29,30-34,1912,49.61064413231693
STAT,1887,17,30-34,1904,3.600220624217256
STAT,1846,38,na,1884,3729.538728705047
SIM,1856,41,35-39,1897,9
STAT,1883,40,40-44,1923,4.5082132388316785
SIM,1877,15,20-24,1892,39
SIM,1835,83,na,1918,377
SIM,1843,28,20-24,1871,28
STAT,1912,24,40-44,1936,6.74124615279369
STAT,1835,53,25-29,1888,0.004585516878630215
STAT,1872,49,50-100,1921,0.4880958794905302
SIM,1862,39,50-100,1901,7
STAT,1876,45,na,1921,4746.454811743901
STAT,1909,40,na,1949,7099.052412175431
SIM,1891,2,na,1893,6806
SIM,1807,88,na,1895,85
STAT,1898,17,40-44,1915,0.49989010476705364
SIM,1911,17,25-29,1928,21
STAT,1847,15,35-39,1862,1.0563419811600927
SIM,1852,75,na,1927,1576
STAT,1929,17,45-49,1946,1.287416059022617
SIM,1880,40,30-34,1920,1
STAT,1901,24,30-34,1925,50.046622856785405
SIM,1863,43,35-39,1906,5
STAT,1910,34,na,1944,7304.587699658626
STAT,1881,52,40-44,1933,0.02044142485991854
STAT,1837,41,25-29,1878,1.0699911735320686
SIM,1858,20,35-39,1878,10
STAT,1864,4,na,1868,5470.107823464895
STAT,1835,28,20-24,1863,19.669025001967523
SIM,1872,34,45-49,1906,4
STAT,1895,20,15-19,1915,8.733613053709895
SIM,1828,26,30-34,1854,58
STAT,1826,103,na,1929,0.17180255585366155
SIM,1873,45,50-100,1918,1
SIM,1908,30,na,1938,7305
SIM,1914,21,50-100,1935,2
STAT,1893,44,15-19,1937,0.002421743012022926
STAT,1933,16,25-29,1949,117.45903979321892
SIM,1788,79,na,1867,472
SIM,1882,23,50-100,1905,4
SIM,1868,44,30-34,1912,4
STAT,1861,40,20-24,1901,0.2696598234042776
STAT,1912,29,35-39,1941,29.675171291511152
STAT,1832,80,na,1912,806.4750377333174
STAT,1866,38,na,1904,4368.53971220747
SIM,1935,32,na,1967,10870
STAT,1903,17,25-29,1920,16.2950312133036
SIM,1790,83,na,1873,250
STAT,1848,41,35-39,1889,3.003787104260011
STAT,1821,40,na,1861,3123.9364574610186
STAT,1942,28,35-39,1970,31.80960910053486
SIM,1845,41,25-29,1886,4
SIM,1839,26,40-44,1865,8
SIM,1941,16,25-29,1957,113
SIM,1864,34,50-100,1898,2
STAT,1851,33,20-24,1884,4.316231241393501
STAT,1811,49,35-39,1860,0.9183304223019094
SIM,1893,41,50-100,1934,3
SIM,1894,34,30-34,1928,55
STAT,1884,46,30-34,1930,0.19359347349330958
STAT,1912,45,40-44,1957,0.3075376523183094
STAT,1840,51,40-44,1891,0.015268741311736469
STAT,1957,1,na,1958,10483.076736461748
SIM,1850,28,30-34,1878,62
SIM,1879,28,35-39,1907,30
SIM,1932,23,20-24,1955,293
SIM,1827,43,30-34,1870,3
STAT,1867,42,15-19,1909,0.02608809311206357
SIM,1899,21,35-39,1920,26
STAT,1928,18,40-44,1946,3.5495603674338407
SIM,1833,34,50-100,1867,2
SIM,1929,15,na,1944,9793
STAT,1843,44,50-100,1887,1.4851737685665827
SIM,1861,26,15-19,1887,1
STAT,1870,33,25-29,1903,20.223609668444556
SIM,1916,18,20-24,1934,54
STAT,1873,21,40-44,1894,4.2890025805746355
SIM,1899,62,na,1961,5411
STAT,1842,28,30-34,1870,46.03055442744737
STAT,1907,46,50-100,1953,0.4124010880821097
SIM,1898,22,30-34,1920,68
STAT,1908,18,20-24,1926,53.00893443504848
SIM,1884,29,20-24,1913,30
STAT,1886,34,30-34,1920,36.90442529715085
SIM,1900,17,15-19,1917,16
STAT,1853,26,15-19,1879,0.8376098385503131
STAT,1857,16,40-44,1873,0.3404166737223505
STAT,1889,42,35-39,1931,4.503796220559989
SIM,1915,26,25-29,1941,146
STAT,1876,29,20-24,1905,24.330211841686676
SIM,1936,18,40-44,1954,4
SIM,1881,89,na,1970,562
SIM,1828,42,35-39,1870,6
STAT,1861,15,na,1876,4487.791364430147
STAT,1890,45,45-49,1935,0.5875768654756548
STAT,1852,7,na,1859,4771.185888252518
SIM,1865,16,40-44,1881,1
STAT,1924,23,20-24,1947,264.0997189110889
SIM,1882,8,na,1890,5408
STAT,1836,93,na,1929,38.857591566300734
STAT,1887,33,35-39,1920,22.77841025222275
SIM,1895,33,35-39,1928,41
STAT,1813,44,40-44,1857,14.767233262722694
STAT,1855,44,45-49,1899,2.226372139588204
SIM,1937,10,na,1947,7985
STAT,1907,26,25-29,1933,125.99685553259847
STAT,1934,33,25-29,1967,25.474152372604237
STAT,1870,45,25-29,1915,0.11534948179403894
STAT,1858,15,45-49,1873,0.1215643757645642
SIM,1900,33,20-24,1933,9
STAT,1919,43,35-39,1962,0.4399272561182526
SIM,1943,28,25-29,1971,164
SIM,1821,44,40-44,1865,7
STAT,1921,41,50-100,1962,0.2675566284405241
SIM,1906,52,na,1958,6391
STAT,1935,28,25-29,1963,181.15029198547975
STAT,1823,54,45-49,1877,0.0414789224720465
STAT,1922,46,45-49,1968,0.5053776235582081
STAT,1869,15,20-24,1884,35.59212567694945
SIM,1823,95,na,1918,7
STAT,1803,54,25-29,1857,0.024994077950453806
STAT,1892,33,50-100,1925,2.3067640756802996
SIM,1841,38,na,1879,3606
SIM,1798,89,na,1887,50
STAT,1861,60,na,1921,3205.985040029072
STAT,1950,18,15-19,1968,108.33379763800947
SIM,1825,76,na,1901,968
SIM,1939,22,na,1961,7576
STAT,1911,46,35-39,1957,0.24719560768232227
STAT,1873,39,15-19,1912,0.11407255028338821
STAT,1896,65,na,1961,4803.82543458458
SIM,1867,23,na,1890,4771
SIM,1871,35,40-44,1906,4
STAT,1936,21,25-29,1957,178.44652048319546
SIM,1939,26,45-49,1965,5
STAT,1873,50,25-29,1923,0.007372859325986471
STAT,1890,39,15-19,1929,0.1370365172956533
SIM,1878,15,na,1893,5531
SIM,1829,25,35-39,1854,19
STAT,1872,52,na,1924,4347.10595598344
STAT,1861,18,20-24,1879,34.05197974752767
STAT,1891,59,na,1950,4851.629103634398
STAT,1942,21,15-19,1963,11.276069888468768
STAT,1920,46,45-49,1966,0.48630458888062583
SIM,1860,50,na,1910,3807
SIM,1900,67,na,1967,5296
SIM,1934,32,20-24,1966,7
STAT,1888,16,35-39,1904,1.3130213632064323
SIM,1851,48,35-39,1899,1
STAT,1925,21,15-19,1946,12.904844603686534
STAT,1890,74,na,1964,3298.823620520819
SIM,1868,70,na,1938,2718
STAT,1900,46,25-29,1946,0.09128657880837682
SIM,1908,26,15-19,1934,2
STAT,1847,31,40-44,1878,7.842747338503079
SIM,1874,21,30-34,1895,44
SIM,1904,23,45-49,1927,2
STAT,1838,36,50-100,1874,2.025943956141368
STAT,1843,75,na,1918,1442.0887181491
STAT,1877,27,15-19,1904,0.9514860034375646
STAT,1819,43,30-34,1862,5.15228436506589
STAT,1905,67,na,1972,5409.066021146386
STAT,1808,46,25-29,1854,0.37500972336754274
SIM,1909,9,na,1918,7924
SIM,1924,38,35-39,1962,11
STAT,1833,30,35-39,1863,17.540277892128984
SIM,1824,35,50-100,1859,5
SIM,1933,21,15-19,1954,12
SIM,1898,15,na,1913,7184
STAT,1926,32,20-24,1958,5.955596550086996
STAT,1854,39,50-100,1893,1.8631713985325922
SIM,1855,35,50-100,1890,5
SIM,1911,31,50-100,1942,3
STAT,1927,38,45-49,1965,1.7098014121712064
STAT,1925,47,40-44,1972,0.38576790949635154
STAT,1912,15,na,1927,7926.454126204289
SIM,1838,27,35-39,1865,22
STAT,1778,91,na,1869,37.57439421480213
STAT,1892,52,na,1944,5415.013061175323
STAT,1809,94,na,1903,17.763904828119518
SIM,1885,27,15-19,1912,4
STAT,1941,29,na,1970,7819.166770825904
STAT,1836,43,30-34,1879,1.7956996911518082
SIM,1944,21,25-29,1965,209
STAT,1779,106,na,1885,0.02244281363943999
SIM,1818,94,na,1912,24
STAT,1814,103,na,1917,0.1235132702140054
STAT,1941,22,45-49,1963,2.348465415301417
SIM,1847,100,na,1947,4
SIM,1865,39,30-34,1904,10
STAT,1857,50,40-44,1907,0.01681074869181744
STAT,1969,1,na,1970,9932.471877484391
STAT,1823,48,15-19,1871,0.0012184813794532455
SIM,1811,70,na,1881,1340
SIM,1844,43,30-34,1887,3
STAT,1843,48,35-39,1891,0.1936502956728746
STAT,1852,31,15-19,1883,0.23745407032332452
STAT,1872,22,35-39,1894,11.844510287639343
SIM,1855,31,40-44,1886,12
STAT,1880,19,na,1899,5344.594943849955
STAT,1849,21,30-34,1870,34.31130643624141
STAT,1947,14,na,1961,8932.745658634358
STAT,1850,23,na,1873,3906.5677100896883
STAT,1916,31,15-19,1947,0.2690394468516606
SIM,1857,21,30-34,1878,39
STAT,1823,75,na,1898,1235.3559778711042
STAT,1899,16,45-49,1915,0.18120036993730862
SIM,1896,16,35-39,1912,4
SIM,1902,45,na,1947,6620
STAT,1943,21,na,1964,7849.091543179919
SIM,1858,39,20-24,1897,1
SIM,1911,59,na,1970,6766
SIM,1855,15,35-39,1870,2
SIM,1909,48,45-49,1957,1
SIM,1904,44,45-49,1948,1
STAT,1812,54,35-39,1866,0.05482844357063133
SIM,1856,68,na,1924,2490
SIM,1805,76,na,1881,701
STAT,1773,117,na,1890,1.393499536059455E-4
SIM,1844,40,50-100,1884,3
STAT,1840,54,50-100,1894,0.021200434642364836
STAT,1829,46,na,1875,2943.952754385312
STAT,1838,71,na,1909,1806.4752436917681
STAT,1846,16,30-34,1862,3.084992203892629
STAT,1827,52,20-24,1879,0.0012863089936519724
STAT,1927,31,25-29,1958,22.971950540851427
STAT,1948,7,na,1955,9084.11866850824
STAT,1901,45,30-34,1946,0.15592270656464385
SIM,1910,44,35-39,1954,1
SIM,1862,45,40-44,1907,2
STAT,1846,32,35-39,1878,18.330984009100515
STAT,1878,42,25-29,1920,1.3528346542178216
SIM,1841,30,35-39,1871,24
SIM,1843,16,na,1859,4466
SIM,1854,32,35-39,1886,25
STAT,1884,49,35-39,1933,0.2733684279168278
SIM,1895,17,30-34,1912,3
STAT,1911,34,35-39,1945,17.823155520709395
STAT,1916,38,35-39,1954,4.977622096092331
STAT,1862,33,30-34,1895,30.011799305505722
STAT,1882,45,na,1927,4470.457865092325
STAT,1769,103,na,1872,0.0682149463111356
STAT,1804,106,na,1910,0.008167944154683394
SIM,1854,16,30-34,1870,3
SIM,1891,40,40-44,1931,10
SIM,1857,30,na,1887,4300
SIM,1844,26,15-19,1870,4
STAT,1826,41,15-19,1867,0.02977403815332121
STAT,1876,51,20-24,1927,0.0015487851527618986
SIM,1801,63,na,1864,1820
STAT,1852,43,15-19,1895,0.021851250617468152
STAT,1864,49,15-19,1913,7.070458076988087E-4
SIM,1853,51,50-100,1904,1
SIM,1938,29,na,1967,7514
STAT,1897,18,35-39,1915,1.4774371538023825
SIM,1812,55,na,1867,2480
SIM,1918,31,25-29,1949,28
STAT,1922,49,15-19,1971,8.494389596431267E-4
SIM,1829,41,40-44,1870,4
SIM,1886,42,25-29,1928,3
STAT,1825,53,na,1878,2706.3197791392104
STAT,1902,44,35-39,1946,0.35370744030765644
STAT,1843,41,15-19,1884,0.020174744596764233
SIM,1810,44,30-34,1854,3
SIM,1869,20,45-49,1889,1
STAT,1888,32,40-44,1920,10.352024724221947
SIM,1853,33,30-34,1886,40
STAT,1913,6,na,1919,8251.32793703507
STAT,1910,35,50-100,1945,0.8189759821028442
STAT,1795,83,na,1878,290.6291813141023
SIM,1863,30,na,1893,4477
SIM,1847,23,na,1870,4237
STAT,1920,44,na,1964,8254.596480630325
SIM,1820,54,35-39,1874,1
STAT,1806,48,15-19,1854,0.002403320789040533
STAT,1866,21,30-34,1887,33.705859360825336
SIM,1809,69,na,1878,1485
SIM,1891,29,30-34,1920,77
STAT,1815,46,na,1861,2858.14847273791
SIM,1850,97,na,1947,6
SIM,1874,40,40-44,1914,8
STAT,1930,40,30-34,1970,0.34066450961483064
STAT,1857,35,15-19,1892,0.08923786867044334
SIM,1896,32,40-44,1928,18
STAT,1926,16,15-19,1942,112.63284192079196
STAT,1870,74,na,1944,2200.519026406106
SIM,1824,38,30-34,1862,12
STAT,1759,106,na,1865,0.010414996025074683
STAT,1819,39,na,1858,3000.5076786890004
STAT,1779,76,na,1855,607.59276
STAT,1874,67,na,1941,3278.0954340187295
SIM,1950,21,15-19,1971,15
STAT,1845,33,30-34,1878,31.658882081793536
STAT,1827,36,15-19,1863,0.11982829274908526
STAT,1867,88,na,1955,259.66155972986354
STAT,1910,37,na,1947,7269.572159313768
SIM,1934,16,15-19,1950,100
STAT,1866,40,40-44,1906,4.233773460898823
STAT,1894,27,15-19,1921,1.177084423785194
SIM,1928,21,40-44,1949,12
SIM,1787,94,na,1881,7
STAT,1762,99,na,1861,0.7733306103307406
STAT,1816,52,45-49,1868,0.06840231223011808
STAT,1846,50,30-34,1896,0.009248597781776068
STAT,1901,20,na,1921,6726.762750265292
STAT,1833,38,30-34,1871,8.685264862405692
STAT,1837,26,30-34,1863,45.38422198052798
STAT,1892,55,na,1947,5227.791728775655
SIM,1815,40,35-39,1855,5
STAT,1841,94,na,1935,28.998397261275827
SIM,1878,18,40-44,1896,1
STAT,1916,15,45-49,1931,0.21504241199053611
SIM,1847,20,na,1867,4062
STAT,1912,27,45-49,1939,3.4393061743246873
STAT,1835,46,na,1881,3110.8874717110884
STAT,1845,53,na,1898,3264.620591858328
STAT,1854,27,50-100,1881,1.0280307238775952
STAT,1874,31,35-39,1905,21.02749168918663
STAT,1861,43,25-29,1904,1.0716735038859808
SIM,1846,44,45-49,1890,7
SIM,1952,18,25-29,1970,122
SIM,1838,49,na,1887,3117
SIM,1843,61,na,1904,2759
SIM,1871,31,25-29,1902,20
STAT,1860,23,20-24,1883,115.67319971938198
STAT,1834,33,50-100,1867,1.5461411671747232
STAT,1894,40,50-100,1934,2.768511631348845
STAT,1898,36,15-19,1934,0.15421402906109352
STAT,1899,8,na,1907,7193.30490114474
SIM,1888,45,50-100,1933,2
SIM,1892,49,35-39,1941,1
STAT,1805,52,35-39,1857,0.06759678160329571
SIM,1777,87,na,1864,81
STAT,1942,25,30-34,1967,83.12930832496485
STAT,1885,18,50-100,1903,0.09823014759067407
STAT,1809,53,15-19,1862,1.776986801967961E-4
SIM,1935,31,25-29,1966,33
STAT,1876,30,50-100,1906,1.9292927088221887
STAT,1902,56,na,1958,5942.303637666533
STAT,1853,52,30-34,1905,0.009367994925228442
STAT,1909,16,15-19,1925,18.02814568269127
SIM,1929,16,40-44,1945,4
STAT,1901,27,35-39,1928,27.281081130812186
STAT,1910,39,45-49,1949,1.3040039771688603
STAT,1911,21,20-24,1932,213.6875262318055
SIM,1894,22,na,1916,6363
STAT,1872,43,35-39,1915,3.64893122243932
SIM,1836,68,na,1904,1919
STAT,1907,23,20-24,1930,203.92517244044114
STAT,1820,46,40-44,1866,0.646370808693756
SIM,1917,16,15-19,1933,19
STAT,1907,48,na,1955,6595.655187317384
STAT,1921,39,20-24,1960,0.5930477098749667
SIM,1909,17,35-39,1926,2
STAT,1883,43,45-49,1926,2.948290493398702
SIM,1849,89,na,1938,112
SIM,1917,44,na,1961,7982
SIM,1941,18,15-19,1959,92
STAT,1814,61,na,1875,2014.0709901071705
STAT,1829,60,na,1889,2295.5648770974203
SIM,1953,17,50-100,1970,1
STAT,1884,26,na,1910,4775.705739281954
SIM,1900,15,25-29,1915,23
SIM,1772,95,na,1867,3
SIM,1864,17,35-39,1881,1
SIM,1835,100,na,1935,4
SIM,1880,43,35-39,1923,10
STAT,1840,54,45-49,1894,0.02037175319142995
STAT,1933,18,15-19,1951,122.38754489178243
SIM,1858,49,na,1907,3769
STAT,1759,109,na,1868,0.002563160622098432
STAT,1906,49,30-34,1955,0.15733917649667958
STAT,1835,50,20-24,1885,0.0010137957374395487
STAT,1830,54,na,1884,2965.8056487315425
STAT,1945,17,50-100,1962,0.8264947647441581
SIM,1818,43,na,1861,3045
STAT,1874,16,40-44,1890,0.37915687766958905
STAT,1859,59,na,1918,3124.097600294206
SIM,1841,38,30-34,1879,8
STAT,1894,33,na,1927,6164.911609217977
STAT,1811,46,30-34,1857,0.6685434521250254
STAT,1917,55,na,1972,7506.031165806969
SIM,1891,43,45-49,1934,5
SIM,1929,41,45-49,1970,2
STAT,1777,98,na,1875,1.0144249969772963
SIM,1907,37,na,1944,7113
STAT,1820,47,na,1867,2885.409837473155
SIM,1837,32,35-39,1869,24
SIM,1920,27,45-49,1947,1
SIM,1859,96,na,1955,7
SIM,1882,31,35-39,1913,25
SIM,1928,15,50-100,1943,1
SIM,1915,23,20-24,1938,219
STAT,1944,18,25-29,1962,94.14955510500228
STAT,1838,44,45-49,1882,2.1011149995087655
STAT,1856,17,35-39,1873,1.011003474848169
STAT,1883,22,50-100,1905,0.8091676505815313
STAT,1900,21,45-49,1921,1.9595314049399388
STAT,1834,33,20-24,1867,4.561343176503156
STAT,1856,93,na,1949,45.540065822385266
SIM,1891,22,50-100,1913,1
STAT,1869,66,na,1935,3207.4437512375594
SIM,1926,28,25-29,1954,171
SIM,1840,20,40-44,1860,5
SIM,1851,90,na,1941,75
STAT,1836,100,na,1936,1.4115453757922467
STAT,1838,20,na,1858,3808.7316564548637
STAT,1931,33,40-44,1964,10.350048952334543
SIM,1869,23,15-19,1892,7
SIM,1810,77,na,1887,711
SIM,1932,26,25-29,1958,185
SIM,1856,26,40-44,1882,8
SIM,1942,11,na,1953,8477
STAT,1921,18,50-100,1939,0.860025846016772
STAT,1918,31,50-100,1949,1.7813460503723295
STAT,1864,26,na,1890,4323.198395635014
STAT,1924,26,25-29,1950,155.26603813147273
STAT,1842,24,15-19,1866,6.106377037174836
STAT,1863,16,30-34,1879,3.234428891102618
STAT,1913,44,45-49,1957,0.32677497351128637
SIM,1849,86,na,1935,259
SIM,1926,31,50-100,1957,5
STAT,1843,72,na,1915,1769.0855602281886
STAT,1890,42,40-44,1932,5.5379891078935
SIM,1850,24,15-19,1874,5
SIM,1871,16,30-34,1887,1
SIM,1841,83,na,1924,515
STAT,1791,79,na,1870,564.546982543834
STAT,1919,40,30-34,1959,0.2805240945709044
SIM,1861,38,na,1899,4494
STAT,1886,30,15-19,1916,0.306045401909103
STAT,1918,28,25-29,1946,140.94660886302776
STAT,1949,19,20-24,1968,318.2160586096295
STAT,1811,87,na,1898,163.7713817900222
STAT,1823,51,40-44,1874,0.03194041977526217
STAT,1842,42,45-49,1884,2.305334763955401
SIM,1830,30,25-29,1860,23
STAT,1876,44,15-19,1920,0.028457419370950608
SIM,1865,42,na,1907,4323
SIM,1878,33,35-39,1911,24
STAT,1901,23,na,1924,6666.2026916934
STAT,1870,30,20-24,1900,5.402780555728499
STAT,1808,98,na,1906,2.552706665538712
SIM,1884,30,50-100,1914,4
STAT,1902,34,25-29,1936,16.626057998179466
SIM,1842,33,20-24,1875,5
SIM,1888,15,30-34,1903,4
STAT,1882,48,20-24,1930,0.02331211610976928
SIM,1901,32,25-29,1933,37
STAT,1885,19,20-24,1904,35.44847110797846
SIM,1809,80,na,1889,449
STAT,1827,41,50-100,1868,2.043663933081497
SIM,1909,15,na,1924,7728
SIM,1850,42,45-49,1892,6
SIM,1826,28,20-24,1854,25
STAT,1854,41,25-29,1895,0.9888728249139269
STAT,1848,26,40-44,1874,5.906224729697277
SIM,1835,41,50-100,1876,2
STAT,1909,26,na,1935,7256.90407664381
STAT,1937,21,na,1958,7185.849297253798
SIM,1871,38,50-100,1909,4
STAT,1836,29,50-100,1865,1.085049331936014
STAT,1854,45,40-44,1899,0.2650639102176458
STAT,1864,31,40-44,1895,7.861110178345337
SIM,1924,15,45-49,1939,1
STAT,1861,47,40-44,1908,0.2864469514486255
STAT,1863,38,50-100,1901,2.15976143864824
STAT,1881,15,na,1896,4953.094811526349
STAT,1839,51,35-39,1890,0.01350674596632447
SIM,1863,40,30-34,1903,5
STAT,1911,30,na,1941,7499.885320455286
SIM,1901,36,40-44,1937,8
SIM,1874,24,35-39,1898,2
SIM,1945,24,45-49,1969,2
SIM,1884,63,na,1947,3783
STAT,1810,53,20-24,1863,0.004470101476197638
SIM,1865,53,45-49,1918,1
SIM,1910,34,25-29,1944,24
STAT,1874,0,na,1874,7620.298125949335
STAT,1905,43,40-44,1948,0.45291382037740013
SIM,1957,10,na,1967,10323
STAT,1847,34,na,1881,3806.6841909340137
STAT,1890,24,45-49,1914,1.7082451339033171
STAT,1883,25,15-19,1908,0.9063775958499268
SIM,1939,23,40-44,1962,1
STAT,1924,44,20-24,1968,0.042272280637088634
STAT,1823,33,45-49,1856,8.688637965170713
STAT,1855,12,na,1867,4281.599815954776
SIM,1831,33,45-49,1864,5
SIM,1892,41,na,1933,6653
STAT,1821,53,30-34,1874,0.016428475322880245
SIM,1930,31,40-44,1961,12
SIM,1935,35,40-44,1970,8
STAT,1878,26,na,1904,5051.170096098267
SIM,1881,21,40-44,1902,7
STAT,1858,100,na,1958,2.7381417777110864
STAT,1904,32,35-39,1936,16.85606025918504
STAT,1880,35,40-44,1915,9.401907882444645
SIM,1903,20,25-29,1923,174
SIM,1874,56,na,1930,3888
STAT,1932,35,15-19,1967,0.05220371834316445
SIM,1869,4,na,1873,5484
STAT,1820,42,25-29,1862,2.59788046187752
STAT,1893,48,30-34,1941,0.1380213789908674
SIM,1937,26,50-100,1963,1
SIM,1879,40,25-29,1919,1
STAT,1915,32,45-49,1947,3.23695535334115
SIM,1913,43,40-44,1956,2
STAT,1848,49,30-34,1897,0.1554096323354153
SIM,1892,4,na,1896,7532
SIM,1905,56,na,1961,6379
STAT,1805,87,na,1892,131.78487753700264
STAT,1862,36,35-39,1898,12.268049769770764
STAT,1937,24,45-49,1961,2.211830281151209
SIM,1906,47,50-100,1953,2
STAT,1831,42,35-39,1873,2.8673260057889527
SIM,1816,43,20-24,1859,2
SIM,1898,69,na,1967,4584
STAT,1861,30,45-49,1891,2.954942590497816
STAT,1840,44,35-39,1884,2.657599434962875
SIM,1810,47,35-39,1857,1
STAT,1927,35,40-44,1962,3.7648638559887644
SIM,1883,34,20-24,1917,7
SIM,1834,87,na,1921,159
SIM,1812,58,na,1870,2334
STAT,1875,34,20-24,1909,5.5724880420443785
STAT,1906,30,45-49,1936,2.97046478229073
SIM,1923,32,45-49,1955,8
STAT,1912,19,50-100,1931,0.15222605725601368
STAT,1849,12,na,1861,4648.113399494787
SIM,1902,43,30-34,1945,1
STAT,1848,19,na,1867,4611.051743150356
STAT,1906,45,15-19,1951,6.706457394730162E-4
SIM,1819,39,35-39,1858,20
STAT,1845,51,50-100,1896,0.023383714998867867
SIM,1889,55,na,1944,5214
STAT,1846,40,20-24,1886,0.252590255604304
STAT,1930,22,35-39,1952,24.361230937547155
SIM,1924,35,30-34,1959,7
SIM,1893,77,na,1970,3029
STAT,1850,51,35-39,1901,0.013263167194884264
STAT,1916,35,30-34,1951,3.80522582733606
SIM,1890,63,na,1953,4605
STAT,1852,47,30-34,1899,0.15356156552214875
STAT,1911,31,30-34,1942,31.120288590782646
STAT,1917,45,25-29,1962,0.1124167648680946
SIM,1853,28,50-100,1881,1
STAT,1857,78,na,1935,1229.9715482576219
STAT,1940,27,20-24,1967,37.59593898113641
SIM,1815,50,45-49,1865,1
SIM,1915,28,15-19,1943,3
STAT,1867,85,na,1952,518.5046047347545
STAT,1845,28,50-100,1873,1.1911884052309982
STAT,1779,79,na,1858,457.21553003822555
SIM,1904,41,40-44,1945,1
SIM,1941,18,na,1959,7740
SIM,1925,18,30-34,1943,35
STAT,1879,45,45-49,1924,0.5035148745101324
STAT,1874,41,45-49,1915,3.108928191427407
STAT,1897,30,25-29,1927,27.873629658605115
SIM,1858,60,na,1918,3290
STAT,1812,80,na,1892,586.3713525853043
STAT,1895,46,40-44,1941,0.2548608934133525
SIM,1919,34,45-49,1953,4
SIM,1900,64,na,1964,5501
STAT,1851,36,25-29,1887,4.558163819604591
SIM,1845,29,35-39,1874,31
SIM,1856,34,na,1890,3985
SIM,1914,30,45-49,1944,5
SIM,1839,22,25-29,1861,111
SIM,1820,36,na,1856,3161
STAT,1914,8,na,1922,8306.549939951585
STAT,1902,5,na,1907,7472.347586559209
SIM,1912,32,35-39,1944,26
STAT,1832,35,na,1867,3576.860979471849
STAT,1920,33,30-34,1953,34.69806941987718
SIM,1859,16,15-19,1875,10
SIM,1844,46,35-39,1890,1
SIM,1803,95,na,1898,12
SIM,1882,41,45-49,1923,6
STAT,1960,10,na,1970,10333.417325235545
SIM,1887,45,45-49,1932,1
SIM,1830,43,na,1873,2967
STAT,1908,43,25-29,1951,0.13271830053759953
SIM,1870,49,na,1919,4304
STAT,1843,45,30-34,1888,0.13846999161767193
STAT,1950,16,25-29,1966,103.50686028101589
STAT,1910,43,15-19,1953,0.002914650943233875
STAT,1907,28,15-19,1935,1.3420129780718475
STAT,1849,110,na,1959,8.257363328920862E-4
STAT,1857,53,45-49,1910,0.022478590314229198
STAT,1864,52,40-44,1916,0.018904488652092186
STAT,1814,54,35-39,1868,0.04107610556654936
SIM,1946,25,50-100,1971,5
SIM,1826,42,50-100,1868,4
STAT,1864,7,na,1871,5079.593080408793
STAT,1866,24,35-39,1890,10.80622377174418
STAT,1797,64,na,1861,1650.2911280753412
STAT,1781,80,na,1861,476.9401466555949
STAT,1836,46,35-39,1882,0.19735825036569035
STAT,1901,24,50-100,1925,1.1457561420439684
STAT,1818,42,50-100,1860,5.206831687788179
STAT,1892,21,50-100,1913,1.0341275423792415
STAT,1812,51,30-34,1863,0.04026192578598871
STAT,1842,79,na,1921,1040.8379664871193
STAT,1895,18,na,1913,6629.04851691236
SIM,1935,18,na,1953,10410
SIM,1845,42,na,1887,3822
SIM,1891,25,15-19,1916,1
SIM,1885,48,na,1933,4693
STAT,1901,41,15-19,1942,0.0027236669528010785
STAT,1938,25,50-100,1963,1.993603373358353
STAT,1881,45,35-39,1926,0.2760159767876941
STAT,1876,54,25-29,1930,0.0071953068500282035
STAT,1917,18,30-34,1935,5.282996284991011
STAT,1850,20,na,1870,3991.938153540414
SIM,1867,26,20-24,1893,27
STAT,1902,16,20-24,1918,50.67433216014749
STAT,1904,24,30-34,1928,51.30993988131325
SIM,1859,79,na,1938,1015
STAT,1840,44,45-49,1884,2.196509732442621
STAT,1917,38,na,1955,7852.211248157497
STAT,1822,53,40-44,1875,0.030870133087405358
STAT,1843,12,na,1855,4273.50978
SIM,1847,28,45-49,1875,5
STAT,1841,37,15-19,1878,0.09599513623070889
STAT,1883,47,20-24,1930,0.02370027197366513
STAT,1884,10,na,1894,5165.810660349025
STAT,1934,36,35-39,1970,6.748210019789782
STAT,1886,1,na,1887,6679.70352333606
STAT,1913,24,na,1937,7402.766847667134
STAT,1929,32,35-39,1961,23.44094309309472
SIM,1855,65,na,1920,2882
SIM,1901,32,30-34,1933,66
STAT,1839,108,na,1947,0.00286010515310961
STAT,1907,24,50-100,1931,1.2028919577260333
STAT,1836,33,15-19,1869,0.2369137500139511
STAT,1898,18,na,1916,6884.618047643042
SIM,1807,104,na,1911,2
STAT,1827,97,na,1924,6.49630011529382
STAT,1869,3,na,1872,6159.9503961601695
STAT,1839,20,35-39,1859,11.877380179877418
SIM,1851,51,na,1902,3399
SIM,1924,18,15-19,1942,94
STAT,1835,40,45-49,1875,2.3839330941192913
SIM,1933,38,35-39,1971,11
STAT,1909,19,na,1928,7612.515767663433
STAT,1825,54,20-24,1879,0.0014824676765456775
STAT,1839,28,45-49,1867,2.168339473294472
SIM,1910,38,40-44,1948,8
STAT,1916,45,30-34,1961,0.18553175095795382
STAT,1865,23,40-44,1888,3.8420868011766203
STAT,1848,26,45-49,1874,2.189136995673852
STAT,1906,32,40-44,1938,7.3283512078745385
STAT,1859,36,50-100,1895,1.9830821778613634
STAT,1902,38,40-44,1940,2.680719017331294
SIM,1864,25,40-44,1889,11
SIM,1905,34,40-44,1939,15
STAT,1822,66,na,1888,1859.054886513804
SIM,1842,15,na,1857,4324
STAT,1854,17,30-34,1871,2.9228673147715627
STAT,1871,67,na,1938,3180.76338679104
STAT,1856,25,40-44,1881,4.907118664733036
STAT,1788,89,na,1877,77.62053145864094
STAT,1805,70,na,1875,1523.91816191585
STAT,1872,25,na,1897,4876.8863379763825
SIM,1881,1,na,1882,5563
STAT,1846,36,50-100,1882,1.9843150011774715
SIM,1870,42,30-34,1912,3
STAT,1845,31,15-19,1876,0.2636397836710893
SIM,1914,32,40-44,1946,15
STAT,1898,42,35-39,1940,0.34325343278322457
SIM,1921,17,35-39,1938,12
SIM,1846,29,na,1875,4006
STAT,1792,94,na,1886,8.666552409308593
STAT,1846,18,35-39,1864,1.049572414389412
STAT,1925,38,35-39,1963,5.855899736279175
STAT,1943,4,na,1947,8569.427930559228
SIM,1899,29,20-24,1928,34
STAT,1806,49,15-19,1855,0.002363470923315224
SIM,1923,25,45-49,1948,8
STAT,1872,47,45-49,1919,0.4767855501595201
STAT,1926,6,na,1932,9922.898931033074
SIM,1889,30,40-44,1919,17
SIM,1871,15,30-34,1886,6
SIM,1940,22,40-44,1962,7
STAT,1777,114,na,1891,3.3944887926633987E-4
STAT,1784,75,na,1859,653.6871349396889
STAT,1892,45,20-24,1937,0.017284653521307352
STAT,1809,84,na,1893,295.67568826205877
STAT,1955,2,na,1957,10549.183013876469
SIM,1930,40,na,1970,10461
STAT,1915,25,45-49,1940,3.5832604517735893
STAT,1863,48,na,1911,3927.517648946904
STAT,1972,0,na,1972,10241.155340731462
STAT,1913,17,35-39,1930,1.7331392929590448
SIM,1843,40,45-49,1883,5
SIM,1806,64,na,1870,1811
SIM,1862,17,30-34,1879,7
STAT,1838,41,25-29,1879,1.0294954101066274
STAT,1839,82,na,1921,728.5350326725093
STAT,1863,15,30-34,1878,3.2535925512293598
STAT,1932,28,25-29,1960,174.04266205917995
STAT,1857,42,50-100,1899,1.6610158181013774
STAT,1798,83,na,1881,264.58323230802563
SIM,1940,28,25-29,1968,154
STAT,1927,37,30-34,1964,4.575767946253444
STAT,1831,51,40-44,1882,0.014457421817570494
SIM,1896,63,na,1959,5047
SIM,1833,49,25-29,1882,1
STAT,1814,54,45-49,1868,0.0692425778585098
STAT,1844,42,50-100,1886,1.747309518445012
STAT,1932,22,40-44,1954,8.910642859887195
SIM,1810,49,30-34,1859,1
STAT,1810,46,50-100,1856,1.6332603393361904
SIM,1858,14,na,1872,4747
SIM,1917,28,25-29,1945,156
SIM,1910,25,35-39,1935,43
SIM,1814,83,na,1897,322
STAT,1877,24,na,1901,4928.831368835066
STAT,1905,25,50-100,1930,1.8810770053812778
STAT,1920,34,40-44,1954,8.580872915664527
STAT,1888,20,30-34,1908,42.772772950799066
STAT,1897,48,50-100,1945,0.36930590668256424
SIM,1856,26,45-49,1882,1
STAT,1928,38,50-100,1966,1.0703852946676444
SIM,1907,48,35-39,1955,2
STAT,1892,29,na,1921,5990.711957088687
STAT,1903,37,45-49,1940,1.2372871863719137
STAT,1894,48,35-39,1942,0.2023094486986118
SIM,1884,78,na,1962,2037
SIM,1955,16,na,1971,9461
STAT,1875,48,25-29,1923,0.11826572731381901
SIM,1934,25,20-24,1959,43
SIM,1924,45,30-34,1969,1
STAT,1830,54,50-100,1884,0.022037244945240907
SIM,1905,21,35-39,1926,27
STAT,1881,61,na,1942,3647.7285113074777
STAT,1831,46,45-49,1877,0.36581057139651496
STAT,1885,75,na,1960,2386.088445574194
STAT,1837,25,30-34,1862,45.712437280199815
SIM,1809,48,50-100,1857,1
STAT,1874,35,50-100,1909,2.56297937708548
SIM,1854,18,35-39,1872,1
STAT,1879,42,25-29,1921,1.3548719114177088
SIM,1829,33,na,1862,3490
STAT,1888,23,50-100,1911,0.9704143897789237
STAT,1912,30,15-19,1942,0.2574979504129722
STAT,1826,28,50-100,1854,4.916419405384373
STAT,1871,21,15-19,1892,6.639526232087645
SIM,1910,16,20-24,1926,65
SIM,1911,37,45-49,1948,2
SIM,1912,24,30-34,1936,77
STAT,1902,25,35-39,1927,27.699088511905845
STAT,1859,26,20-24,1885,19.32242693320877
STAT,1909,28,25-29,1937,126.66321200740073
SIM,1867,50,na,1917,4404
STAT,1929,26,50-100,1955,2.5167397437608128
SIM,1873,23,40-44,1896,1
SIM,1937,32,35-39,1969,31
STAT,1822,50,na,1872,2834.232591849896
SIM,1922,37,20-24,1959,1
STAT,1873,47,50-100,1920,0.5016353788149392
STAT,1877,34,15-19,1911,0.29609448726771614
STAT,1929,23,na,1952,9296.85965393709
STAT,1900,17,25-29,1917,15.876045357579741
SIM,1930,18,50-100,1948,2
SIM,1764,91,na,1855,16
STAT,1844,54,30-34,1898,0.00934850847502615
STAT,1818,45,na,1863,2950.8126529870297
STAT,1816,40,35-39,1856,10.78143642934408
SIM,1846,9,na,1855,4745
STAT,1842,46,20-24,1888,0.018099161057351668
STAT,1875,46,50-100,1921,0.5121386861972168
SIM,1887,11,na,1898,6404
SIM,1899,16,15-19,1915,14
SIM,1837,52,na,1889,2873
SIM,1838,22,35-39,1860,16
STAT,1914,37,20-24,1951,0.5316511531003648
STAT,1882,15,40-44,1897,0.36151475143078965
SIM,1916,25,na,1941,7975
STAT,1824,34,50-100,1858,3.2430256785558
SIM,1912,11,na,1923,8259
STAT,1899,21,45-49,1920,1.9354110722417486
STAT,1945,20,25-29,1965,204.5824471592053
STAT,1803,53,30-34,1856,0.04285859435655071
STAT,1865,18,45-49,1883,0.12278038199919193
SIM,1875,5,na,1880,6149
STAT,1825,49,25-29,1874,0.12151697102295762
STAT,1840,79,na,1919,1009.1167276810343
STAT,1857,41,35-39,1898,2.8634756875387053
STAT,1886,32,15-19,1918,0.3036049819186095
STAT,1843,44,na,1887,3249.170839486879
STAT,1827,81,na,1908,653.9110360385357
STAT,1871,35,35-39,1906,14.326705563120719
STAT,1869,23,25-29,1892,111.68003964874259
SIM,1828,28,35-39,1856,22
STAT,1860,37,25-29,1897,4.722121866356587
SIM,1925,27,20-24,1952,47
SIM,1920,32,40-44,1952,14
SIM,1812,44,35-39,1856,6
SIM,1942,27,20-24,1969,42
SIM,1847,33,40-44,1880,2
SIM,1808,71,na,1879,1257
STAT,1842,86,na,1928,330.3324578661447
SIM,1936,16,40-44,1952,4
SIM,1897,24,40-44,1921,8
STAT,1919,38,35-39,1957,5.241547820761037
STAT,1844,15,20-24,1859,36.826244092486505
SIM,1901,27,35-39,1928,32
SIM,1941,24,na,1965,7740
STAT,1864,50,50-100,1914,0.027656948512417557
SIM,1785,69,na,1854,1154
SIM,1793,88,na,1881,55
SIM,1937,19,na,1956,7358
SIM,1826,84,na,1910,314
SIM,1919,16,40-44,1935,4
SIM,1927,38,35-39,1965,11
STAT,1944,0,na,1944,9693.617309721378
STAT,1910,27,35-39,1937,29.290884094005847
SIM,1874,31,35-39,1905,27
STAT,1912,32,40-44,1944,7.7790121719568885
SIM,1900,26,na,1926,6989
STAT,1926,25,20-24,1951,44.48598933886802
STAT,1889,24,40-44,1913,5.156684127074555
STAT,1882,49,50-100,1931,0.4731039295540695
STAT,1883,42,50-100,1925,2.0937084755237283
STAT,1917,27,20-24,1944,38.65874223534372
STAT,1919,41,50-100,1960,0.25743605121492685
SIM,1859,3,na,1862,5577
SIM,1852,15,20-24,1867,33
SIM,1843,17,20-24,1860,34
STAT,1887,19,35-39,1906,1.232773436131225
STAT,1819,41,15-19,1860,0.06597704984367361
STAT,1858,20,45-49,1878,1.2779430980218311
SIM,1902,44,40-44,1946,1
STAT,1855,38,50-100,1893,1.8421727981056433
STAT,1882,38,15-19,1920,0.10993032582414941
STAT,1914,21,35-39,1935,18.702898706087144
SIM,1928,4,na,1932,10415
SIM,1888,29,45-49,1917,1
STAT,1919,30,25-29,1949,20.296721534349402
STAT,1868,19,25-29,1887,10.955711014262855
STAT,1856,48,15-19,1904,6.154622374399772E-4
SIM,1880,32,na,1912,5293
SIM,1884,46,na,1930,4881
STAT,1918,48,45-49,1966,0.46572339863514817
SIM,1916,24,15-19,1940,7
SIM,1879,23,35-39,1902,15
STAT,1943,25,20-24,1968,39.29559212631694
SIM,1876,27,na,1903,5144
STAT,1821,44,35-39,1865,5.442362267194793
SIM,1888,21,35-39,1909,18
STAT,1934,27,20-24,1961,49.601023921782755
STAT,1903,42,40-44,1945,0.44859356489010754
SIM,1931,24,40-44,1955,9
STAT,1902,40,na,1942,6679.630612312395
SIM,1886,18,30-34,1904,7
SIM,1945,2,na,1947,9249
STAT,1908,35,50-100,1943,0.8019780874119321
STAT,1923,24,40-44,1947,7.849266509784484
STAT,1855,52,40-44,1907,0.015790493807296344
STAT,1881,45,45-49,1926,0.4652840745077499
STAT,1834,67,na,1901,2106.6560068749263
SIM,1893,39,na,1932,6150
SIM,1936,20,25-29,1956,180
STAT,1839,33,40-44,1872,8.246997033413257
SIM,1817,48,na,1865,2868
STAT,1903,31,50-100,1934,2.645488392606872
STAT,1908,24,15-19,1932,9.828196527490029
STAT,1869,32,15-19,1901,0.2786832071036948
SIM,1914,35,20-24,1949,1
STAT,1828,27,50-100,1855,2.178624698885483
SIM,1880,47,45-49,1927,1
STAT,1906,54,na,1960,6352.142444801022
STAT,1843,31,50-100,1874,1.5591106621162083
SIM,1800,75,na,1875,817
SIM,1825,67,na,1892,1708
STAT,1906,35,20-24,1941,0.4943001468439656
SIM,1821,53,na,1874,2586
SIM,1927,30,25-29,1957,30
STAT,1885,41,50-100,1926,2.133390801099281
SIM,1876,19,25-29,1895,18
STAT,1838,45,50-100,1883,0.350843590169023
STAT,1917,49,40-44,1966,0.3306130976859539
SIM,1836,27,30-34,1863,5
STAT,1895,18,30-34,1913,4.183485996188397
STAT,1923,35,20-24,1958,0.6177445009206927
STAT,1811,105,na,1916,0.02725545151327607
STAT,1815,47,15-19,1862,0.002149491451743025
STAT,1888,46,50-100,1934,0.5879277045057677
SIM,1866,20,45-49,1886,2
STAT,1901,39,na,1940,6646.207503965353
STAT,1834,51,na,1885,2992.6135461697445
STAT,1914,27,50-100,1941,2.0268583131570117
STAT,1801,88,na,1889,102.89440328742181
SIM,1922,21,35-39,1943,33
STAT,1851,47,25-29,1898,0.08887424128756363
STAT,1864,31,25-29,1895,18.566637027346644
STAT,1860,99,na,1959,5.79302376911151
STAT,1832,25,50-100,1857,1.15134791273245
SIM,1884,18,20-24,1902,43
STAT,1908,46,35-39,1954,0.23742050054057062
STAT,1895,22,15-19,1917,8.681812416524464
SIM,1873,94,na,1967,123
STAT,1819,62,na,1881,2069.2605973249065
STAT,1899,19,50-100,1918,0.1348403020178529
STAT,1903,32,15-19,1935,0.4095021514231643
STAT,1855,47,45-49,1902,0.35421341746225116
STAT,1881,45,na,1926,4435.657129320353
STAT,1938,16,na,1954,7352.157164743999
STAT,1879,21,50-100,1900,0.8640486925265367
STAT,1885,59,na,1944,3906.93855532751
SIM,1869,57,na,1926,3866
SIM,1917,42,na,1959,8010
STAT,1828,27,30-34,1855,85.7629537551279
STAT,1835,40,50-100,1875,1.6827762969090518
SIM,1888,34,40-44,1922,3
SIM,1865,43,na,1908,4286
STAT,1868,38,50-100,1906,2.347438786288078
SIM,1842,31,na,1873,3798
STAT,1928,16,40-44,1944,3.5676253272560534
SIM,1925,36,35-39,1961,11
STAT,1875,20,45-49,1895,1.4586280973294052
STAT,1942,21,na,1963,7735.581662395731
SIM,1905,41,na,1946,7028
STAT,1938,33,50-100,1971,1.6782319460858797
SIM,1846,45,na,1891,3473
STAT,1865,38,15-19,1903,0.10252197721173666
SIM,1817,50,45-49,1867,1
STAT,1928,39,15-19,1967,0.048902505534334804
SIM,1870,45,35-39,1915,1
STAT,1914,34,40-44,1948,7.888839411169832
STAT,1874,16,45-49,1890,0.1354131376671854
STAT,1938,30,35-39,1968,18.5816374622025
STAT,1915,20,50-100,1935,1.326147560762797
STAT,1920,32,15-19,1952,0.28420917559339187
STAT,1876,41,45-49,1917,3.140417039764612
SIM,1884,41,45-49,1925,5
STAT,1908,37,20-24,1945,0.49879177588896395
STAT,1834,47,25-29,1881,0.08131413745652719
STAT,1927,41,15-19,1968,0.0038947498851024283
SIM,1847,20,35-39,1867,11
STAT,1890,35,45-49,1925,4.960926862764483
SIM,1922,34,40-44,1956,13
STAT,1952,15,20-24,1967,328.2731334312604
STAT,1798,67,na,1865,1440.298449526291
STAT,1930,17,35-39,1947,10.956234019163306
SIM,1902,17,25-29,1919,20
STAT,1862,45,35-39,1907,0.24407750195719183
STAT,1809,50,45-49,1859,0.11137282922373765
SIM,1796,69,na,1865,1425
SIM,1860,12,na,1872,4840
SIM,1900,10,na,1910,7591
STAT,1915,28,25-29,1943,135.121329677744
STAT,1890,5,na,1895,6460.282590206291
STAT,1853,33,15-19,1886,0.22963361623572923
SIM,1830,46,na,1876,2890
SIM,1855,22,35-39,1877,12
STAT,1917,54,na,1971,7547.011437914846
STAT,1891,28,15-19,1919,1.1286280925481211
SIM,1878,15,40-44,1893,1
SIM,1893,16,20-24,1909,55
STAT,1879,63,na,1942,3769.3018859730355
STAT,1913,40,na,1953,7399.353435966413
SIM,1945,22,na,1967,8382
STAT,1838,65,na,1903,2287.1396770731317
SIM,1905,4,na,1909,7940
SIM,1889,42,35-39,1931,10
SIM,1864,26,na,1890,4540
STAT,1837,50,20-24,1887,0.0010741793744591308
SIM,1934,0,na,1934,11324
SIM,1832,22,40-44,1854,8
STAT,1886,24,15-19,1910,6.989299892381376
SIM,1918,46,45-49,1964,1
STAT,1931,37,20-24,1968,0.7051079995105056
STAT,1898,30,40-44,1928,11.947899758041485
SIM,1926,19,na,1945,9208
SIM,1907,1,na,1908,8061
STAT,1920,46,35-39,1966,0.28848577346695364
STAT,1892,44,50-100,1936,0.18297766549700614
STAT,1855,41,25-29,1896,0.9727121345223658
STAT,1824,37,15-19,1861,0.17057636820018846
SIM,1920,26,30-34,1946,110
SIM,1857,30,45-49,1887,7
STAT,1947,20,35-39,1967,21.505668251539237
SIM,1894,24,15-19,1918,9
SIM,1786,70,na,1856,1293
STAT,1813,73,na,1886,1122.2071248913649
STAT,1912,26,30-34,1938,78.27185051466479
STAT,1902,19,25-29,1921,16.071153437468602
STAT,1843,71,na,1914,1869.8123516093867
STAT,1903,40,15-19,1943,0.00278544049193149
SIM,1910,19,25-29,1929,20
STAT,1849,30,45-49,1879,3.2611356879567515
STAT,1842,54,20-24,1896,0.001068413546185895
STAT,1868,15,50-100,1883,0.09698274905056152
STAT,1892,21,35-39,1913,14.798363399397353
STAT,1931,21,na,1952,9594.755975833838
STAT,1847,22,35-39,1869,10.904729309040347
STAT,1897,44,na,1941,6176.555583521527
STAT,1893,30,na,1923,6157.767600633499
STAT,1782,106,na,1888,0.02619201913562213
STAT,1910,32,30-34,1942,30.69196858890789
STAT,1954,18,35-39,1972,10.472027413574695
STAT,1886,46,35-39,1932,0.29931937726605
STAT,1825,30,35-39,1855,45.154174869058714
STAT,1914,49,15-19,1963,7.336374592912988E-4
STAT,1921,25,45-49,1946,3.9140643494863117
SIM,1872,77,na,1949,1698
SIM,1821,37,na,1858,3245
SIM,1933,33,50-100,1966,3
SIM,1780,81,na,1861,290
STAT,1879,44,50-100,1923,2.201606262832163
STAT,1869,20,45-49,1889,1.3786346466554478
SIM,1850,38,50-100,1888,4
STAT,1930,36,na,1966,9919.775403351507
SIM,1930,18,15-19,1948,117
SIM,1861,47,35-39,1908,1
SIM,1869,15,15-19,1884,12
SIM,1936,28,35-39,1964,27
STAT,1937,8,na,1945,7837.826559637539
SIM,1849,20,45-49,1869,2
STAT,1871,99,na,1970,25.960600468922923
STAT,1827,43,15-19,1870,0.02576134426420727
STAT,1848,51,35-39,1899,0.014183878014971467
SIM,1833,30,35-39,1863,29
STAT,1903,34,40-44,1937,7.099255011241988
STAT,1778,108,na,1886,0.010792335997146019
STAT,1925,35,30-34,1960,4.424641777057693
SIM,1880,48,na,1928,4930
STAT,1888,23,35-39,1911,13.886628292399312
STAT,1814,90,na,1904,67.85252314674615
SIM,1847,46,na,1893,3439
SIM,1912,27,35-39,1939,36
STAT,1922,18,15-19,1940,105.7693123438806
SIM,1876,16,20-24,1892,35
STAT,1928,20,25-29,1948,234.27299403801823
SIM,1932,22,50-100,1954,2
STAT,1894,34,15-19,1928,0.366298829065605
STAT,1814,51,40-44,1865,0.05333341227041708
STAT,1901,55,na,1956,5888.402761927238
STAT,1928,28,35-39,1956,37.332469408548484
STAT,1832,47,15-19,1879,6.165417258952547E-4
STAT,1923,27,45-49,1950,4.00460540368106
SIM,1911,34,40-44,1945,11
STAT,1841,27,50-100,1868,1.1528055572660736
STAT,1877,50,50-100,1927,0.03212800725982061
STAT,1856,94,na,1950,31.14302941329639
STAT,1925,33,50-100,1958,1.9812556342612588
SIM,1931,27,45-49,1958,7
STAT,1881,42,40-44,1923,4.385363495573143
SIM,1849,25,15-19,1874,1
SIM,1877,20,45-49,1897,3
STAT,1943,17,20-24,1960,290.34722408389797
STAT,1875,45,20-24,1920,0.02520098277261543
SIM,1879,36,40-44,1915,16
SIM,1933,35,30-34,1968,5
STAT,1853,47,35-39,1900,0.22047552160580075
STAT,1877,53,30-34,1930,0.012283003016106237
STAT,1916,48,35-39,1964,0.266331577124293
SIM,1896,23,35-39,1919,17
SIM,1896,32,25-29,1928,30
STAT,1885,16,20-24,1901,35.72713044072268
STAT,1945,25,30-34,1970,86.88637573319916
STAT,1904,27,35-39,1931,27.969732078123965
SIM,1918,32,25-29,1950,23
SIM,1887,27,na,1914,5836
STAT,1896,42,25-29,1938,0.11875685309770453
SIM,1904,17,35-39,1921,1
STAT,1856,33,40-44,1889,6.769703471757609
SIM,1856,23,40-44,1879,5
STAT,1908,38,35-39,1946,4.553962079028774
SIM,1916,38,35-39,1954,8
STAT,1888,32,25-29,1920,24.449763607460742
STAT,1943,22,na,1965,7846.50134297067
SIM,1822,51,40-44,1873,1
STAT,1848,23,40-44,1871,4.130476869348515
STAT,1868,47,na,1915,4302.973776421392
SIM,1951,17,20-24,1968,1
STAT,1808,54,20-24,1862,0.004203585219665182
STAT,1870,44,30-34,1914,2.2488232690285987
SIM,1863,7,na,1870,5178
SIM,1829,41,25-29,1870,1
STAT,1924,22,50-100,1946,1.5676569299139558
STAT,1872,36,50-100,1908,2.5039933504809584
SIM,1932,8,na,1940,10819
STAT,1829,51,25-29,1880,0.005506888492257773
STAT,1830,34,35-39,1864,19.39943582040222
STAT,1852,40,45-49,1892,2.409429578605023
SIM,1857,29,na,1886,4323
STAT,1941,18,25-29,1959,90.12266626754872
SIM,1853,15,na,1868,4652
STAT,1872,84,na,1956,732.1967025149185
STAT,1842,38,50-100,1880,2.1220924272526362
STAT,1941,15,45-49,1956,1.0397613356773268
SIM,1919,19,45-49,1938,2
SIM,1922,30,25-29,1952,29
STAT,1879,30,30-34,1909,37.179726243908
SIM,1877,20,20-24,1897,146
STAT,1901,46,25-29,1947,0.092125422603459
SIM,1892,3,na,1895,7566
STAT,1860,34,20-24,1894,4.395284611935901
SIM,1845,25,30-34,1870,56
SIM,1905,57,na,1962,6316
STAT,1843,28,na,1871,3702.6068662095154
SIM,1836,22,25-29,1858,106
SIM,1888,12,na,1900,6071
STAT,1932,2,na,1934,10938.216059015642
STAT,1845,45,35-39,1890,0.21788174096025595
SIM,1880,36,50-100,1916,4
STAT,1804,54,50-100,1858,0.08482524842539918
STAT,1804,109,na,1913,4.786124239140298E-4
STAT,1858,53,50-100,1911,0.023396263531060474
STAT,1789,101,na,1890,0.2920389024007977
SIM,1903,35,45-49,1938,2
STAT,1934,28,35-39,1962,40.77645571072284
SIM,1908,22,na,1930,7132
STAT,1876,18,20-24,1894,36.93539044077121
SIM,1841,40,35-39,1881,6
SIM,1943,18,25-29,1961,122
STAT,1816,97,na,1913,5.276898474129381
SIM,1923,17,45-49,1940,1
SIM,1855,45,45-49,1900,2
STAT,1855,13,na,1868,4262.161352790342
STAT,1859,27,na,1886,3902.528801985143
SIM,1839,59,na,1898,2593
STAT,1840,30,25-29,1870,18.385406545241807
STAT,1917,22,15-19,1939,11.425146908330975
STAT,1851,39,25-29,1890,4.418360488299309
STAT,1821,41,30-34,1862,3.7606551480888095
STAT,1869,20,20-24,1889,136.24295504310297
STAT,1937,17,45-49,1954,0.9816729100131836
SIM,1805,79,na,1884,516
SIM,1878,46,50-100,1924,2
SIM,1835,45,na,1880,3301
SIM,1848,41,35-39,1889,6
STAT,1870,77,na,1947,1713.9403031068364
SIM,1831,31,na,1862,3862
STAT,1868,16,20-24,1884,34.88812262371849
SIM,1901,26,20-24,1927,36
STAT,1880,44,na,1924,4850.9566046131395
SIM,1898,31,45-49,1929,6
STAT,1848,40,50-100,1888,1.7750440726429144
STAT,1833,40,35-39,1873,2.9646542914851786
STAT,1877,56,na,1933,4277.435208709683
STAT,1783,100,na,1883,0.382712331606981
SIM,1897,27,45-49,1924,6
STAT,1867,62,na,1929,3457.015637118487
STAT,1889,27,45-49,1916,2.7649133118122875
SIM,1860,28,na,1888,4160
SIM,1838,35,40-44,1873,13
SIM,1904,28,15-19,1932,1
STAT,1860,83,na,1943,651.0915559303219
SIM,1840,20,25-29,1860,140
STAT,1878,51,20-24,1929,0.0015639410949675214
SIM,1869,29,35-39,1898,29
STAT,1843,106,na,1949,0.01700829430881568
STAT,1850,27,15-19,1877,0.8186391092119247
STAT,1925,43,30-34,1968,0.3120424580339859
STAT,1897,26,40-44,1923,8.11470217642166
STAT,1862,42,30-34,1904,1.9821154126808729
STAT,1830,31,50-100,1861,1.8453321785242127
STAT,1896,59,na,1955,5182.107821724578
STAT,1903,45,45-49,1948,0.3866217780450305
STAT,1823,51,na,1874,2951.2637530389025
STAT,1834,44,20-24,1878,0.24840689326306653
STAT,1827,65,na,1892,2043.5607889662579
STAT,1812,46,35-39,1858,0.9890358545746438
STAT,1892,45,na,1937,5746.040890705951
STAT,1869,28,30-34,1897,49.10599149317116
SIM,1881,21,25-29,1902,118
STAT,1821,49,40-44,1870,0.48681569100404204
SIM,1776,92,na,1868,25
SIM,1926,45,40-44,1971,2
STAT,1886,76,na,1962,2471.8214455312245
SIM,1847,30,na,1877,3888
SIM,1853,23,15-19,1876,8
SIM,1819,35,30-34,1854,13
SIM,1925,22,15-19,1947,13
SIM,1818,49,na,1867,2847
SIM,1914,18,na,1932,8269
STAT,1762,96,na,1858,3.370759675914993
STAT,1881,29,na,1910,4625.390820019924
STAT,1943,28,25-29,1971,141.50136221844357
SIM,1942,28,35-39,1970,36
STAT,1878,17,40-44,1895,0.3857975454320226
STAT,1882,62,na,1944,3595.8721682979344
SIM,1857,13,na,1870,4963
SIM,1888,30,25-29,1918,33
STAT,1916,18,15-19,1934,19.395307743738034
SIM,1907,45,30-34,1952,1
SIM,1869,21,25-29,1890,116
STAT,1851,20,35-39,1871,10.959574277561968
SIM,1850,34,na,1884,3891
SIM,1896,8,na,1904,7252
STAT,1889,41,na,1930,5781.567572648882
SIM,1923,28,25-29,1951,177
SIM,1900,19,40-44,1919,1
STAT,1914,30,25-29,1944,18.944088292465988
SIM,1884,62,na,1946,3877
SIM,1887,30,30-34,1917,58
SIM,1853,45,35-39,1898,1
STAT,1936,29,50-100,1965,1.9223058483817805
SIM,1840,39,15-19,1879,1
STAT,1869,49,50-100,1918,0.47058927932561556
STAT,1863,54,40-44,1917,0.01810002531021926
SIM,1931,38,25-29,1969,4
STAT,1919,35,30-34,1954,3.9756448766141474
STAT,1814,40,25-29,1854,3.994134777565146
STAT,1935,18,25-29,1953,119.35468301254559
SIM,1859,31,na,1890,4286
STAT,1923,38,25-29,1961,2.3010207313301745
SIM,1875,15,15-19,1890,11
STAT,1899,20,30-34,1919,49.58314392645667
STAT,1840,41,40-44,1881,3.4304463312746476
SIM,1878,93,na,1971,183
STAT,1771,113,na,1884,7.342052980363943E-4
SIM,1858,28,20-24,1886,23
SIM,1886,26,30-34,1912,78
STAT,1832,39,15-19,1871,0.0905514140792821
SIM,1846,101,na,1947,1
SIM,1863,44,40-44,1907,10
SIM,1841,15,45-49,1856,1
SIM,1806,48,na,1854,2774
STAT,1831,86,na,1917,286.4750134562193
STAT,1769,86,na,1855,87.40440000000001
STAT,1902,24,na,1926,6701.356340403677
STAT,1922,40,25-29,1962,0.16594961218168872
STAT,1936,22,25-29,1958,178.38763313143593
STAT,1878,26,30-34,1904,53.298479070030744
STAT,1839,48,15-19,1887,6.282560626400081E-4
SIM,1944,22,25-29,1966,231
SIM,1927,35,30-34,1962,6
STAT,1828,82,na,1910,572.9891934571395
STAT,1845,23,15-19,1868,6.265628737553188
SIM,1817,64,na,1881,1954
SIM,1905,37,45-49,1942,3
STAT,1848,59,na,1907,3186.712241556779
STAT,1867,15,15-19,1882,11.611447450608615
STAT,1861,40,50-100,1901,1.7938240084507897
STAT,1918,45,40-44,1963,0.3403831680210278
STAT,1927,45,30-34,1972,0.22702540961684417
STAT,1910,24,30-34,1934,54.18968250642129
SIM,1800,91,na,1891,16
SIM,1820,68,na,1888,1531
STAT,1869,36,30-34,1905,10.479859999115881
SIM,1915,24,50-100,1939,1
STAT,1840,47,na,1887,3274.855618439452
STAT,1920,43,30-34,1963,0.28464878166065133
SIM,1945,18,35-39,1963,15
SIM,1948,19,15-19,1967,104
SIM,1856,66,na,1922,2677
SIM,1822,48,50-100,1870,2
STAT,1838,81,na,1919,731.8528931827277
SIM,1888,15,25-29,1903,17
SIM,1883,20,45-49,1903,1
STAT,1860,29,25-29,1889,69.11787028115961
SIM,1938,20,35-39,1958,23
STAT,1810,47,15-19,1857,0.0026091822337759576
SIM,1926,30,50-100,1956,3
STAT,1881,31,25-29,1912,20.076105875198323
SIM,1922,37,45-49,1959,3
STAT,1890,32,40-44,1922,10.690682412012935
STAT,1926,39,40-44,1965,3.6864330598057324
SIM,1919,27,45-49,1946,6
SIM,1936,24,40-44,1960,5
STAT,1859,2,na,1861,5588.2339143297095
STAT,1917,38,25-29,1955,2.055006636225057
SIM,1842,20,35-39,1862,15
STAT,1910,35,35-39,1945,4.718050864077509
STAT,1866,30,45-49,1896,3.275697856863036
SIM,1837,84,na,1921,376
SIM,1882,41,35-39,1923,7
SIM,1934,16,30-34,1950,34
STAT,1830,31,30-34,1861,35.164130660672605
STAT,1839,50,na,1889,3445.6726837801248
STAT,1874,32,na,1906,4934.687967701607
SIM,1879,20,30-34,1899,53
STAT,1940,20,25-29,1960,190.1832612865483
SIM,1925,33,30-34,1958,49
STAT,1863,40,20-24,1903,0.283598692287704
SIM,1822,40,25-29,1862,3
STAT,1771,89,na,1860,53.38396699141758
SIM,1801,60,na,1861,2029
SIM,1875,38,25-29,1913,12
STAT,1917,33,30-34,1950,33.17651225395799
STAT,1891,16,45-49,1907,0.16347043431019465
STAT,1902,17,35-39,1919,1.5645597114443937
STAT,1903,62,na,1965,5702.089931000305
STAT,1878,15,15-19,1893,12.57591129126509
SIM,1832,25,45-49,1857,3
SIM,1807,86,na,1893,140
SIM,1859,40,20-24,1899,1
SIM,1879,32,25-29,1911,26
STAT,1926,17,20-24,1943,335.64843480789534
SIM,1877,36,30-34,1913,17
SIM,1887,43,na,1930,5604
STAT,1823,41,40-44,1864,7.682168568601471
STAT,1921,27,35-39,1948,33.785397997082164
SIM,1843,25,20-24,1868,25
STAT,1916,5,na,1921,8587.273387787802
STAT,1936,31,15-19,1967,0.25228214250596015
SIM,1840,24,40-44,1864,5
STAT,1823,67,na,1890,1902.2636861739504
STAT,1867,38,25-29,1905,5.418773276265331
SIM,1911,5,na,1916,8248
STAT,1953,5,na,1958,9605.013403237914
STAT,1822,82,na,1904,526.81044714384
STAT,1826,96,na,1922,10.27913108416852
STAT,1837,21,15-19,1858,6.0641758673812864
SIM,1845,21,15-19,1866,7
STAT,1908,45,20-24,1953,0.020495024232777097
STAT,1783,74,na,1857,758.523281743073
STAT,1914,37,45-49,1951,1.374899183552301
STAT,1866,31,35-39,1897,18.948703368168566
STAT,1965,3,na,1968,9916.434793875314
STAT,1835,25,20-24,1860,20.098853309390563
STAT,1787,88,na,1875,88.58491489638553
STAT,1901,30,15-19,1931,0.4058755118340646
SIM,1854,36,50-100,1890,4
SIM,1866,25,15-19,1891,1
STAT,1840,108,na,1948,0.002643983753601654
STAT,1862,27,30-34,1889,43.629273775090276
SIM,1831,41,40-44,1872,8
SIM,1932,18,25-29,1950,138
STAT,1874,28,15-19,1902,0.9349156739943918
STAT,1914,25,na,1939,7680.1429133884085
STAT,1918,39,na,1957,7990.2617280455215
SIM,1918,43,40-44,1961,2
SIM,1828,48,na,1876,3023
SIM,1838,31,25-29,1869,27
STAT,1851,63,na,1914,2765.997437194721
SIM,1824,47,50-100,1871,1
STAT,1920,30,25-29,1950,20.605922578499214
STAT,1927,33,15-19,1960,0.3190065196384848
STAT,1855,77,na,1932,1303.446634368121
SIM,1841,27,15-19,1868,4
SIM,1847,14,na,1861,4566
STAT,1789,74,na,1863,923.6304924342592
SIM,1945,17,45-49,1962,2
STAT,1864,42,40-44,1906,4.055639712274543
SIM,1934,17,20-24,1951,384
STAT,1904,15,40-44,1919,0.5326516914461816
SIM,1838,35,50-100,1873,1
STAT,1843,50,45-49,1893,0.020621386555322623
STAT,1846,51,25-29,1897,0.005451291636363359
SIM,1882,35,50-100,1917,1
SIM,1913,18,15-19,1931,17
SIM,1854,2,na,1856,5715
STAT,1847,58,na,1905,3014.534574379554
SIM,1832,34,50-100,1866,2
SIM,1883,21,35-39,1904,15
STAT,1929,41,25-29,1970,0.18702016005859085
SIM,1878,19,35-39,1897,1
STAT,1881,0,na,1881,6995.522558707067
STAT,1819,52,30-34,1871,0.023983406609770358
STAT,1924,18,25-29,1942,103.92105346273476
SIM,1929,22,35-39,1951,31
SIM,1896,23,50-100,1919,1
SIM,1902,28,40-44,1930,10
STAT,1920,40,15-19,1960,0.0034341216596671725
STAT,1876,26,20-24,1902,24.58945213622757
STAT,1907,16,20-24,1923,52.75395284574404
STAT,1874,41,35-39,1915,3.7615521037048087
SIM,1884,26,20-24,1910,28
STAT,1870,53,20-24,1923,0.0014396739570261732
SIM,1820,52,na,1872,2569
STAT,1832,24,40-44,1856,3.807256178057907
STAT,1807,50,35-39,1857,0.058392202878576875
SIM,1912,20,15-19,1932,7
STAT,1853,44,30-34,1897,1.7944535767607825
STAT,1886,43,30-34,1929,2.4333209754895733
STAT,1928,24,40-44,1952,8.424168612000527
SIM,1863,41,25-29,1904,2
STAT,1922,18,50-100,1940,0.8731642069964799
SIM,1872,42,40-44,1914,9
STAT,1830,39,40-44,1869,7.977060862957013
STAT,1934,35,20-24,1969,0.7360634817968176
SIM,1907,34,15-19,1941,1
STAT,1873,20,35-39,1893,12.046180673311328
STAT,1922,47,20-24,1969,0.025633439297463194
STAT,1940,27,45-49,1967,3.558203276728695
STAT,1899,26,15-19,1925,1.259766240342193
STAT,1857,79,na,1936,1100.5293425189896
STAT,1937,18,35-39,1955,8.224449310501832
SIM,1872,13,na,1885,5587
SIM,1896,36,40-44,1932,22
STAT,1926,16,30-34,1942,30.25031750677163
SIM,1831,90,na,1921,61
SIM,1888,41,50-100,1929,5
SIM,1848,40,45-49,1888,3
STAT,1869,80,na,1949,1210.5555371476416
STAT,1915,17,45-49,1932,0.2111709266491754
STAT,1856,36,45-49,1892,3.121274012456617
SIM,1925,38,25-29,1963,5
SIM,1927,20,na,1947,9275
STAT,1833,27,15-19,1860,0.7888038352186053
SIM,1829,45,40-44,1874,1
STAT,1910,26,20-24,1936,35.73493276017204
STAT,1880,18,50-100,1898,0.103960706507361
STAT,1774,111,na,1885,0.0018150724670644499
SIM,1908,30,50-100,1938,2
STAT,1905,18,15-19,1923,17.288107316296415
STAT,1880,76,na,1956,2097.45459857415
SIM,1859,16,20-24,1875,30
STAT,1873,10,na,1883,5450.6846024222195
STAT,1826,37,25-29,1863,6.82281807858929
SIM,1903,32,40-44,1935,13
SIM,1870,70,na,1940,2710
STAT,1861,15,20-24,1876,34.660836438253135
STAT,1849,65,na,1914,2673.179750230586
SIM,1866,65,na,1931,3238
SIM,1911,10,na,1921,8148
STAT,1892,49,15-19,1941,5.585563744744752E-4
SIM,1874,84,na,1958,638
STAT,1863,29,50-100,1892,1.122829758098695
SIM,1920,22,15-19,1942,12
STAT,1772,90,na,1862,46.19022147444105
STAT,1918,47,30-34,1965,0.19155806119954474
STAT,1925,24,15-19,1949,12.78545761892431
SIM,1882,2,na,1884,6341
SIM,1864,21,25-29,1885,121
SIM,1908,27,20-24,1935,31
STAT,1901,43,20-24,1944,0.030955836087865833
STAT,1921,20,15-19,1941,12.212352092306615
SIM,1897,43,50-100,1940,1
SIM,1898,0,na,1898,7685
SIM,1853,42,30-34,1895,4
STAT,1832,71,na,1903,1740.203412595511
STAT,1916,41,15-19,1957,0.0031829025964357502
SIM,1794,89,na,1883,79
SIM,1886,37,50-100,1923,8
SIM,1919,49,na,1968,8062
STAT,1884,9,na,1893,5174.400164622298
STAT,1877,83,na,1960,1147.803237775743
SIM,1790,75,na,1865,893
SIM,1861,44,50-100,1905,2
STAT,1836,37,30-34,1873,8.699802224902516
SIM,1935,23,na,1958,10367
SIM,1862,51,na,1913,3962
STAT,1810,49,40-44,1859,1.074552429839965
SIM,1919,20,25-29,1939,227
SIM,1915,35,na,1950,7794
STAT,1911,28,40-44,1939,9.150572257769737
SIM,1933,24,15-19,1957,19
SIM,1829,48,45-49,1877,3
STAT,1894,45,30-34,1939,0.14307484222364525
STAT,1905,47,20-24,1952,0.019678590842653228
STAT,1949,20,45-49,1969,2.6532832452874757
STAT,1848,18,45-49,1866,0.13199637456220487
STAT,1867,51,45-49,1918,0.0275804705958929
STAT,1857,95,na,1952,20.92979569110765
STAT,1808,49,25-29,1857,0.3488562334867894
STAT,1841,85,na,1926,397.7498346370579
STAT,1936,30,25-29,1966,18.15525870863839
SIM,1844,37,30-34,1881,13
STAT,1890,48,15-19,1938,5.492318950173161E-4
STAT,1856,14,na,1870,4358.666926161119
STAT,1900,26,15-19,1926,1.2754662542952002
STAT,1871,25,30-34,1896,50.87065760784099
STAT,1886,60,na,1946,4065.9975297928395
STAT,1893,41,45-49,1934,3.8485516872336025
STAT,1828,38,35-39,1866,13.956589706724627
STAT,1902,22,30-34,1924,50.78898520748823
STAT,1785,104,na,1889,0.07311814696621233
SIM,1777,93,na,1870,7
SIM,1840,25,50-100,1865,3
SIM,1903,34,30-34,1937,39
STAT,1937,29,15-19,1966,1.3887179210660865
SIM,1896,39,45-49,1935,2
SIM,1899,24,15-19,1923,6
STAT,1888,39,45-49,1927,4.7106895807423665
STAT,1853,41,15-19,1894,0.021948798281786957
STAT,1929,40,35-39,1969,0.5280790852288247
SIM,1833,31,50-100,1864,2
STAT,1869,64,na,1933,3401.862304714046
SIM,1953,16,40-44,1969,4
STAT,1914,45,20-24,1959,0.022243106613092974
STAT,1873,21,25-29,1894,117.82586363441604
SIM,1896,46,50-100,1942,1
STAT,1955,17,50-100,1972,1.0043420094092117
STAT,1945,16,40-44,1961,3.086445410095861
STAT,1836,52,30-34,1888,0.008009750614302678
STAT,1920,37,45-49,1957,1.5071019715380092
STAT,1820,86,na,1906,248.39202717325543
STAT,1827,54,30-34,1881,0.009075054412023166
STAT,1900,16,50-100,1916,0.1375939537747488
SIM,1910,22,30-34,1932,70
STAT,1888,24,na,1912,5610.1830849357175
SIM,1836,30,na,1866,3591
SIM,1887,44,50-100,1931,5
SIM,1949,7,na,1956,9617
SIM,1910,17,35-39,1927,2
STAT,1896,75,na,1971,3654.066693284326
STAT,1901,37,35-39,1938,4.316340566494995
SIM,1854,59,na,1913,3211
STAT,1847,38,45-49,1885,3.1202748257718014
STAT,1892,61,na,1953,4724.463652740349
SIM,1869,25,40-44,1894,8
SIM,1938,33,40-44,1971,10
STAT,1826,50,45-49,1876,0.029041898399114616
STAT,1852,48,na,1900,3540.7633052331757
STAT,1878,22,15-19,1900,6.9586336296962
STAT,1897,22,25-29,1919,154.5426531712123
STAT,1775,110,na,1885,0.0029751200759389265
STAT,1931,30,50-100,1961,2.190551606404095
SIM,1870,27,30-34,1897,59
STAT,1892,48,25-29,1940,0.08111517469414252
SIM,1922,27,50-100,1949,3
SIM,1886,22,15-19,1908,9
SIM,1908,26,30-34,1934,101
SIM,1849,41,50-100,1890,3
STAT,1912,44,35-39,1956,0.3893025287749262
SIM,1875,58,na,1933,4440
SIM,1919,28,35-39,1947,40
STAT,1920,18,40-44,1938,3.1603049022021503
STAT,1852,25,20-24,1877,22.094122044598883
STAT,1853,100,na,1953,1.67973632696228
SIM,1823,32,50-100,1855,3
STAT,1894,42,15-19,1936,0.0024849190639412225
SIM,1816,90,na,1906,46
SIM,1927,26,40-44,1953,12
STAT,1925,37,20-24,1962,0.6388558927377347
SIM,1954,15,na,1969,9244
SIM,1855,31,25-29,1886,21
SIM,1929,21,50-100,1950,2
SIM,1917,17,20-24,1934,56
STAT,1804,53,na,1857,2285.614639999741
SIM,1918,48,35-39,1966,2
SIM,1966,5,na,1971,9436
SIM,1834,37,25-29,1871,6
SIM,1834,50,45-49,1884,1
STAT,1871,83,na,1954,796.5603675720247
STAT,1856,21,25-29,1877,104.34921957906842
SIM,1862,99,na,1961,1
STAT,1921,22,40-44,1943,7.668107018731349
STAT,1777,89,na,1866,63.544403265001904
STAT,1912,22,15-19,1934,10.30589429661151
STAT,1875,97,na,1972,73.88767262290717
STAT,1852,32,na,1884,3937.890938771526
SIM,1874,30,50-100,1904,3
STAT,1919,26,40-44,1945,10.204008518723352
SIM,1835,29,na,1864,3654
STAT,1847,30,35-39,1877,18.505483088319487
STAT,1847,31,25-29,1878,18.523267048500436
STAT,1837,17,30-34,1854,4.349890372335004
SIM,1855,38,45-49,1893,4
SIM,1928,29,15-19,1957,1
SIM,1849,80,na,1929,837
STAT,1817,37,20-24,1854,5.7716966287297415
SIM,1865,4,na,1869,5390
SIM,1910,27,25-29,1937,156
STAT,1936,26,40-44,1962,9.014786108875736
SIM,1858,23,15-19,1881,4
STAT,1845,42,30-34,1887,1.8040172649800323
SIM,1849,10,na,1859,4950
SIM,1938,28,45-49,1966,5
SIM,1908,49,40-44,1957,1
STAT,1851,48,15-19,1899,6.122812942259546E-4
STAT,1791,88,na,1879,94.49580767243587
SIM,1850,66,na,1916,2571
STAT,1893,28,25-29,1921,107.90531035600183
SIM,1845,17,30-34,1862,6
STAT,1889,19,45-49,1908,0.16179589138734599
STAT,1925,46,35-39,1971,0.31624870949836864
STAT,1888,56,na,1944,4868.739232294588
SIM,1855,30,35-39,1885,25
STAT,1853,70,na,1923,2219.946050850749
STAT,1902,27,25-29,1929,120.61599419364926
SIM,1881,25,40-44,1906,6
SIM,1890,6,na,1896,6931
STAT,1884,51,45-49,1935,0.02908015372134314
SIM,1944,26,40-44,1970,16
STAT,1871,16,50-100,1887,0.09952401342926584
SIM,1906,58,na,1964,6148
STAT,1873,48,15-19,1921,8.105081040046822E-4
STAT,1805,53,40-44,1858,0.08100819568001502
SIM,1927,31,15-19,1958,3
SIM,1897,20,25-29,1917,193
SIM,1859,95,na,1954,7
SIM,1925,35,20-24,1960,1
STAT,1842,70,na,1912,2088.917083465467
STAT,1854,28,na,1882,3807.7734032882468
SIM,1936,27,45-49,1963,4
SIM,1825,31,50-100,1856,4
SIM,1855,81,na,1936,899
STAT,1851,8,na,1859,4628.253113682229
SIM,1924,30,35-39,1954,29
STAT,1869,27,40-44,1896,5.862137427154516
STAT,1877,30,20-24,1907,5.714307972146205
STAT,1779,85,na,1864,144.37925721343748
SIM,1901,35,35-39,1936,8
STAT,1934,38,25-29,1972,2.7417440845936216
SIM,1862,21,15-19,1883,7
STAT,1829,38,50-100,1867,2.106967346821703
STAT,1823,44,45-49,1867,4.7359905728168945
SIM,1924,16,25-29,1940,125
STAT,1934,33,30-34,1967,43.42367303837883
SIM,1907,33,50-100,1940,4
STAT,1939,29,25-29,1968,133.5194951379572
SIM,1878,40,30-34,1918,4
STAT,1922,31,35-39,1953,20.932608060505203
SIM,1831,44,45-49,1875,7
STAT,1880,15,30-34,1895,3.406829041476097
STAT,1927,40,25-29,1967,0.18134704913698335
STAT,1858,80,na,1938,973.9293347906795
SIM,1940,25,45-49,1965,5
SIM,1951,16,30-34,1967,40
STAT,1848,38,15-19,1886,0.09390701759622692
SIM,1919,24,40-44,1943,12
STAT,1892,20,45-49,1912,1.7735545449055732
STAT,1909,35,na,1944,7264.195054972499
STAT,1875,21,35-39,1896,12.170648323647308
STAT,1853,48,25-29,1901,0.08998969114577435
STAT,1921,24,30-34,1945,65.13622345158154
SIM,1837,38,50-100,1875,4
STAT,1868,79,na,1947,1343.3491901229086
STAT,1848,43,na,1891,3762.3802213004515
SIM,1946,23,na,1969,7999
STAT,1828,31,15-19,1859,0.32914967180617133
STAT,1766,89,na,1855,41.2743
STAT,1887,82,na,1969,1841.4841164129623
SIM,1896,31,35-39,1927,41
STAT,1873,25,40-44,1898,6.188768949335257
STAT,1865,26,45-49,1891,2.0441877681372573
STAT,1917,26,30-34,1943,83.2668818367628
STAT,1916,30,35-39,1946,19.20755075636569
STAT,1818,77,na,1895,886.8170118119697
SIM,1820,90,na,1910,56
STAT,1932,27,50-100,1959,2.6331794488620917
STAT,1865,51,35-39,1916,0.015871576396668828
STAT,1872,44,40-44,1916,4.503821336002906
SIM,1897,20,50-100,1917,5
SIM,1810,103,na,1913,1
SIM,1911,30,25-29,1941,21
SIM,1864,58,na,1922,3736
SIM,1930,31,35-39,1961,34
STAT,1880,40,20-24,1920,0.34129571588561686
STAT,1780,102,na,1882,0.1577227779847309
STAT,1923,20,25-29,1943,218.28518052571027
SIM,1948,20,40-44,1968,13
STAT,1898,45,na,1943,6211.46989648683
SIM,1901,11,na,1912,7383
STAT,1894,31,na,1925,6216.338285508251
STAT,1805,50,25-29,1855,0.028957842757265713
STAT,1922,17,na,1939,8600.827403592732
SIM,1873,62,na,1935,3732
SIM,1869,44,50-100,1913,4
SIM,1873,26,45-49,1899,4
STAT,1930,33,50-100,1963,2.153590648318408
STAT,1858,58,na,1916,3113.5657117359638
STAT,1915,37,15-19,1952,0.03918237113912352
STAT,1908,43,30-34,1951,0.23760856934514105
STAT,1824,50,35-39,1874,0.020895368823594097
SIM,1835,39,50-100,1874,3
STAT,1831,43,40-44,1874,3.515952125844297
SIM,1859,19,25-29,1878,8
STAT,1827,39,50-100,1866,2.4194018316050108
STAT,1921,38,15-19,1959,0.043250597154819756
STAT,1888,31,35-39,1919,24.272756236419507
STAT,1845,51,na,1896,3333.7677782094643
SIM,1807,49,na,1856,2439
SIM,1816,49,25-29,1865,1
SIM,1878,16,30-34,1894,3
STAT,1915,22,40-44,1937,7.020023731544843
STAT,1941,20,na,1961,7627.311404975932
SIM,1787,92,na,1879,19
SIM,1868,13,na,1881,5189
SIM,1898,30,30-34,1928,56
STAT,1802,89,na,1891,80.62676368417547
SIM,1883,61,na,1944,3843
STAT,1812,43,30-34,1855,8.924982397339711
SIM,1869,28,45-49,1897,3
SIM,1820,43,30-34,1863,3
SIM,1860,27,25-29,1887,81
STAT,1939,27,20-24,1966,37.06564195586396
SIM,1839,16,40-44,1855,1
STAT,1852,27,25-29,1879,78.52735988481238
STAT,1893,46,na,1939,5776.743639934422
STAT,1838,52,40-44,1890,0.014172330503725237
STAT,1882,46,na,1928,4438.896432564775
STAT,1943,16,30-34,1959,26.110746099432504
STAT,1932,38,na,1970,10199.433131446161
STAT,1938,22,35-39,1960,18.823805618636356
SIM,1829,40,35-39,1869,6
SIM,1843,96,na,1939,6
STAT,1850,102,na,1952,0.4495163467443427
STAT,1902,20,50-100,1922,1.1696892572969289
SIM,1946,22,35-39,1968,27
STAT,1903,30,25-29,1933,29.689997201310547
STAT,1908,48,25-29,1956,0.09668139463567307
STAT,1851,101,na,1952,0.8845707761665391
STAT,1864,45,45-49,1909,0.43030060608827925
SIM,1857,27,50-100,1884,1
STAT,1879,42,na,1921,4876.430014284914
STAT,1916,16,25-29,1932,18.61426525131985
STAT,1949,6,na,1955,9233.242937715058
SIM,1910,47,50-100,1957,2
STAT,1830,85,na,1915,378.547609773005
STAT,1870,42,50-100,1912,2.092182596708149
SIM,1895,46,na,1941,6232
STAT,1917,35,20-24,1952,0.5581817282086432
SIM,1885,30,20-24,1915,7
SIM,1891,32,na,1923,6185
STAT,1876,39,na,1915,4871.775084638807
STAT,1839,36,45-49,1875,3.758525010652356
STAT,1854,21,15-19,1875,5.9851961600514665
STAT,1797,66,na,1863,1531.7004814837508
STAT,1866,13,na,1879,4994.905636735777
SIM,1818,47,30-34,1865,1
STAT,1940,24,40-44,1964,6.913419030615162
SIM,1872,45,45-49,1917,1
SIM,1837,18,35-39,1855,1
STAT,1873,27,45-49,1900,2.2784043188857206
STAT,1916,53,na,1969,7448.27421681092
SIM,1914,35,45-49,1949,2
SIM,1930,24,na,1954,9922
SIM,1816,63,na,1879,1985
SIM,1862,25,30-34,1887,52
STAT,1891,41,35-39,1932,4.54093721381999
STAT,1854,25,30-34,1879,45.11707939535637
STAT,1877,38,30-34,1915,11.121530009988577
SIM,1840,27,45-49,1867,3
SIM,1841,30,na,1871,3871
STAT,1832,27,45-49,1859,1.9488679676596226
SIM,1885,38,30-34,1923,15
STAT,1918,43,15-19,1961,0.0032917907183610765
STAT,1839,66,na,1905,2559.1969001678976
SIM,1845,44,na,1889,3724
SIM,1923,22,40-44,1945,10
STAT,1927,43,40-44,1970,0.6324430274998013
STAT,1873,7,na,1880,5581.427743070303
STAT,1876,17,30-34,1893,3.3293697016772814
STAT,1928,27,45-49,1955,4.297913837310123
STAT,1849,31,35-39,1880,18.743069486959488
STAT,1906,35,45-49,1941,1.2783060177003958
SIM,1924,17,na,1941,9167
SIM,1874,30,45-49,1904,4
SIM,1857,31,35-39,1888,25
STAT,1812,47,25-29,1859,0.4000632010578704
SIM,1820,40,15-19,1860,3
STAT,1924,24,na,1948,8645.844294554197
STAT,1928,38,na,1966,9591.41991764616
SIM,1877,38,35-39,1915,21
SIM,1896,31,na,1927,6621
SIM,1847,36,45-49,1883,8
STAT,1851,47,na,1898,3471.4044025018275
SIM,1903,37,35-39,1940,6
STAT,1902,24,20-24,1926,195.26329258139728
STAT,1904,20,15-19,1924,9.620070345826413
STAT,1844,29,na,1873,4215.436706852155
STAT,1884,15,15-19,1899,11.890086967530024
SIM,1905,30,25-29,1935,22
STAT,1812,110,na,1922,2.619426276388303E-4
STAT,1944,23,na,1967,7959.992572317323
STAT,1912,35,45-49,1947,1.3569161451339875
SIM,1881,20,35-39,1901,15
SIM,1867,18,20-24,1885,40
SIM,1785,85,na,1870,107
SIM,1922,7,na,1929,9851
STAT,1941,27,15-19,1968,1.4749629015119532
SIM,1892,27,20-24,1919,33
SIM,1907,21,na,1928,7127
STAT,1850,40,35-39,1890,2.8044815644433108
STAT,1871,28,35-39,1899,19.29257009441076
SIM,1897,40,40-44,1937,2
SIM,1877,28,na,1905,4914
SIM,1842,39,25-29,1881,9
SIM,1858,27,30-34,1885,47
STAT,1888,36,40-44,1924,10.499677765945185
STAT,1920,10,na,1930,9003.1796036148
STAT,1865,28,na,1893,4363.406214268414
SIM,1825,36,20-24,1861,2
SIM,1860,40,45-49,1900,5
STAT,1869,38,35-39,1907,13.772626905108353
SIM,1846,52,40-44,1898,1
SIM,1847,51,na,1898,3283
STAT,1870,47,35-39,1917,0.2763016495156946
SIM,1910,24,20-24,1934,218
SIM,1849,49,25-29,1898,1
SIM,1938,5,na,1943,8041
STAT,1889,39,15-19,1928,0.13843052796931452
STAT,1828,35,30-34,1863,11.181540886332385
SIM,1932,16,20-24,1948,364
SIM,1880,41,25-29,1921,3
STAT,1863,32,na,1895,4218.760905693873
SIM,1826,52,na,1878,2696
STAT,1897,20,20-24,1917,187.14907266529556
SIM,1939,27,25-29,1966,135
STAT,1889,40,40-44,1929,5.657738930666646
SIM,1925,28,35-39,1953,47
STAT,1924,16,20-24,1940,326.7748108178635
STAT,1834,39,25-29,1873,4.6692721047670185
SIM,1861,44,30-34,1905,4
STAT,1859,43,na,1902,3688.4544727568546
STAT,1882,83,na,1965,1313.0548650046028
SIM,1926,18,25-29,1944,143
STAT,1901,34,30-34,1935,48.94241969651231
STAT,1918,18,25-29,1936,94.9950436707388
SIM,1868,30,45-49,1898,1
STAT,1936,35,30-34,1971,3.6206061837852666
STAT,1861,84,na,1945,559.2096186770439
STAT,1865,98,na,1963,18.334917910821854
STAT,1872,41,25-29,1913,1.3093097758063112
SIM,1844,81,na,1925,631
STAT,1846,54,40-44,1900,0.015681861821887935
SIM,1848,95,na,1943,13
STAT,1896,30,30-34,1926,46.92930110718378
STAT,1840,53,35-39,1893,0.012227139988816577
STAT,1859,18,20-24,1877,32.88585196369731
STAT,1917,28,35-39,1945,31.6842659861211
STAT,1841,29,15-19,1870,0.8059296304198686
STAT,1943,18,35-39,1961,8.983552654665678
SIM,1927,22,25-29,1949,272
SIM,1911,36,30-34,1947,5
SIM,1908,22,15-19,1930,8
STAT,1870,98,na,1968,34.18822467222664
STAT,1936,29,45-49,1965,3.3365133354985765
SIM,1879,30,20-24,1909,6
SIM,1916,6,na,1922,8692
SIM,1924,31,50-100,1955,2
STAT,1927,7,na,1934,10036.369772535721
SIM,1836,35,30-34,1871,11
STAT,1916,31,50-100,1947,1.7309895602486958
SIM,1810,53,na,1863,2527
SIM,1840,26,45-49,1866,4
STAT,1858,25,15-19,1883,0.7418585562893554
SIM,1814,67,na,1881,1671
STAT,1810,46,25-29,1856,0.38304476743524835
STAT,1862,47,na,1909,3865.5720289575324
STAT,1850,15,45-49,1865,0.12384488005342974
STAT,1853,44,50-100,1897,1.6489573371887332
STAT,1873,28,45-49,1901,2.2703843356832416
SIM,1831,52,na,1883,2982
SIM,1950,20,35-39,1970,27
SIM,1889,41,45-49,1930,7
STAT,1895,26,30-34,1921,66.49687596676416
STAT,1849,48,20-24,1897,0.018743075525731952
SIM,1881,28,45-49,1909,2
STAT,1799,73,na,1872,1036.9504498014712
SIM,1890,10,na,1900,6873
SIM,1931,20,25-29,1951,265
SIM,1874,9,na,1883,5213
SIM,1810,47,40-44,1857,1
SIM,1855,35,40-44,1890,14
STAT,1812,67,na,1879,1768.0416383844833
STAT,1932,25,45-49,1957,4.574343282008993
SIM,1898,32,35-39,1930,39
SIM,1857,51,na,1908,3857
SIM,1870,23,15-19,1893,3
SIM,1951,18,35-39,1969,15
STAT,1850,52,40-44,1902,0.016055795979210058
STAT,1931,41,40-44,1972,0.6758482239673241
STAT,1919,22,25-29,1941,204.23347522335033
STAT,1862,23,15-19,1885,5.7878250649339495
STAT,1815,39,15-19,1854,0.39243469905946277
SIM,1944,16,na,1960,8144
STAT,1867,94,na,1961,80.65003028331068
SIM,1880,44,40-44,1924,10
STAT,1907,0,na,1907,8716.110798015667
SIM,1894,24,na,1918,6331
SIM,1931,39,15-19,1970,1
STAT,1832,26,45-49,1858,1.971897807333953
STAT,1927,16,na,1943,9264.240200451894
STAT,1954,17,45-49,1971,1.2470687612127929
SIM,1888,37,45-49,1925,7
STAT,1914,48,25-29,1962,0.10597133355853007
SIM,1876,43,na,1919,4985
STAT,1903,36,30-34,1939,3.3238027686700264
STAT,1897,60,na,1957,5240.810067184072
SIM,1797,70,na,1867,1297
STAT,1896,38,na,1934,6250.885276810207
STAT,1889,20,25-29,1909,143.40546650943568
SIM,1906,28,25-29,1934,137
STAT,1879,53,40-44,1932,0.021882340902440053
STAT,1912,41,30-34,1953,0.25052780095485633
SIM,1941,24,50-100,1965,2
SIM,1907,18,15-19,1925,16
STAT,1833,66,na,1899,2154.6883067788644
STAT,1881,54,35-39,1935,0.016343440789284118
STAT,1923,39,15-19,1962,0.0448278059804983
SIM,1878,17,30-34,1895,1
STAT,1892,2,na,1894,6739.577090846593
STAT,1892,24,na,1916,5942.109714793331
STAT,1831,40,25-29,1871,1.0434014947867392
STAT,1846,95,na,1941,20.36489746891398
STAT,1765,93,na,1858,11.883022665307603
STAT,1878,18,30-34,1896,3.3531415959910413
STAT,1834,20,35-39,1854,19.64970654808669
STAT,1847,35,40-44,1882,7.0686213856956215
STAT,1786,103,na,1889,0.09891805903071645
STAT,1871,32,30-34,1903,35.03318517101237
STAT,1829,29,na,1858,3349.994285162876
STAT,1912,39,na,1951,7343.305730785899
STAT,1918,30,50-100,1948,1.788356407489689
STAT,1911,36,50-100,1947,0.8231880074450948
SIM,1866,37,20-24,1903,3
STAT,1852,28,25-29,1880,77.96353344083943
STAT,1942,20,35-39,1962,19.95286409339066
SIM,1812,49,40-44,1861,1
STAT,1851,44,20-24,1895,0.24286611016906562
STAT,1933,24,50-100,1957,1.7617078519032265
SIM,1860,28,25-29,1888,80
SIM,1920,35,45-49,1955,4
STAT,1862,43,20-24,1905,0.27216290287746175
SIM,1866,21,35-39,1887,9
SIM,1839,27,20-24,1866,18
STAT,1864,51,30-34,1915,0.01079761055631639
STAT,1899,62,na,1961,5336.364684039849
STAT,1782,73,na,1855,942.3145200000001
SIM,1949,16,15-19,1965,105
STAT,1898,18,20-24,1916,48.32668317084808
SIM,1910,26,25-29,1936,137
STAT,1854,50,na,1904,3348.2122600254015
SIM,1818,70,na,1888,1445
STAT,1890,47,15-19,1937,5.536276989469549E-4
SIM,1907,16,25-29,1923,21
SIM,1859,40,45-49,1899,8
STAT,1925,28,30-34,1953,93.11825820523566
STAT,1845,34,30-34,1879,31.331845829888604
SIM,1838,96,na,1934,10
STAT,1837,80,na,1917,862.1719947252165
SIM,1922,10,na,1932,9800
SIM,1871,25,35-39,1896,26
STAT,1945,27,45-49,1972,3.82760253935422
SIM,1811,48,na,1859,2606
STAT,1841,48,na,1889,3237.41613033159
STAT,1847,42,40-44,1889,3.4477876871628723
SIM,1933,28,30-34,1961,140
STAT,1897,21,50-100,1918,1.1042117619921035
SIM,1836,83,na,1919,418
STAT,1839,18,40-44,1857,0.37139276645758723
STAT,1922,42,50-100,1964,0.2722581508278
SIM,1783,89,na,1872,70
STAT,1852,85,na,1937,436.91826002410323
STAT,1927,36,40-44,1963,3.761776667626853
SIM,1853,34,30-34,1887,37
STAT,1894,30,20-24,1924,7.069176932108415
SIM,1948,23,45-49,1971,3
SIM,1918,39,45-49,1957,4
STAT,1902,26,25-29,1928,121.02991650810698
STAT,1842,65,na,1907,2516.0405308008553
STAT,1882,51,35-39,1933,0.017018473619809814
SIM,1910,15,30-34,1925,5
STAT,1906,4,na,1910,7741.96725246168
STAT,1887,77,na,1964,2541.2033639784063
STAT,1853,40,50-100,1893,1.6883859524582292
STAT,1851,51,20-24,1902,0.0011493829825620736
SIM,1945,17,na,1962,8481
SIM,1852,20,na,1872,4184
STAT,1867,41,50-100,1908,2.0072404651022073
SIM,1935,36,40-44,1971,5
SIM,1861,45,20-24,1906,1
SIM,1901,4,na,1905,7509
SIM,1886,42,na,1928,4800
SIM,1846,40,35-39,1886,6
STAT,1910,34,20-24,1944,4.710952817699009
STAT,1871,30,na,1901,4826.65694495938
SIM,1928,15,30-34,1943,40
STAT,1879,45,40-44,1924,0.3652616374471047
STAT,1828,44,na,1872,3167.9186468874364
STAT,1852,24,20-24,1876,128.61006206915494
STAT,1912,48,15-19,1960,7.131910748070456E-4
SIM,1901,37,25-29,1938,1
STAT,1858,21,35-39,1879,10.617579540049096
STAT,1902,61,na,1963,5685.8931230657345
STAT,1894,41,15-19,1935,0.03599029194052719
SIM,1827,31,na,1858,3556
SIM,1926,29,40-44,1955,14
SIM,1865,17,20-24,1882,36
STAT,1902,15,30-34,1917,4.56578874550183
STAT,1904,23,40-44,1927,6.021754540095957
STAT,1819,44,30-34,1863,4.985380391829836
STAT,1882,45,50-100,1927,0.4880098460045689
STAT,1841,50,35-39,1891,0.012670644125357488
STAT,1843,46,15-19,1889,5.649055926923896E-4
STAT,1883,30,45-49,1913,3.488033684633511
SIM,1942,26,30-34,1968,101
SIM,1906,26,20-24,1932,36
STAT,1769,91,na,1860,22.953588654152387
STAT,1920,39,35-39,1959,5.335837424998553
SIM,1948,0,na,1948,9678
STAT,1867,18,50-100,1885,0.09417289738276445
STAT,1929,19,15-19,1948,116.33453062065313
STAT,1812,104,na,1916,0.06322539249155393
STAT,1853,40,15-19,1893,0.022070406220059485
STAT,1919,37,45-49,1956,1.4788118402765456
STAT,1936,34,40-44,1970,7.668347152136636
SIM,1894,20,45-49,1914,2
STAT,1849,28,na,1877,4027.1667724812946
STAT,1921,18,45-49,1939,1.1467011280223622
SIM,1845,50,na,1895,3580
STAT,1803,52,50-100,1855,0.11095296863475619
STAT,1899,22,35-39,1921,16.147582520111648
STAT,1895,74,na,1969,3720.2535136944675
STAT,1896,33,50-100,1929,2.432793184590526
STAT,1837,19,45-49,1856,0.12907233625318487
STAT,1837,96,na,1933,11.967701333823213
SIM,1817,40,50-100,1857,1
SIM,1824,98,na,1922,6
SIM,1868,47,50-100,1915,2
SIM,1912,23,40-44,1935,1
STAT,1918,29,40-44,1947,9.944765536175758
STAT,1900,18,15-19,1918,16.58282183339253
STAT,1897,36,45-49,1933,5.407602704979861
SIM,1824,88,na,1912,216
SIM,1874,57,na,1931,3820
STAT,1829,83,na,1912,469.8377209592431
STAT,1864,46,35-39,1910,0.25346091447750646
STAT,1910,21,15-19,1931,10.130222815656127
STAT,1932,16,na,1948,9868.292418469442
STAT,1776,109,na,1885,0.006208084493385025
SIM,1869,36,35-39,1905,21
STAT,1934,26,30-34,1960,106.5179665261629
STAT,1887,55,na,1942,4670.536254163929
SIM,1907,38,30-34,1945,4
STAT,1847,54,35-39,1901,0.012762271140202657
STAT,1887,45,na,1932,5132.58845857426
SIM,1909,15,20-24,1924,58
SIM,1766,93,na,1859,4
SIM,1819,42,30-34,1861,4
STAT,1902,34,50-100,1936,1.487273277130209
STAT,1828,66,na,1894,2012.7956816928888
STAT,1895,22,50-100,1917,1.0731536978988718
STAT,1908,40,na,1948,7022.927072666368
SIM,1855,42,40-44,1897,8
STAT,1849,38,na,1887,3773.9875549204253
SIM,1837,31,na,1868,3638
SIM,1840,35,na,1875,4031
STAT,1779,91,na,1870,30.685389632123204
SIM,1887,41,35-39,1928,8
SIM,1795,74,na,1869,973
STAT,1823,33,40-44,1856,21.607799113220494
STAT,1863,25,35-39,1888,17.305968599664617
STAT,1903,25,na,1928,6909.154585377442
STAT,1879,41,35-39,1920,3.842611255768468
STAT,1853,33,na,1886,3847.9473845621824
SIM,1869,19,30-34,1888,2
SIM,1870,33,na,1903,4656
STAT,1782,95,na,1877,5.02967434122171
STAT,1907,44,15-19,1951,0.0028081848855597584
STAT,1881,43,30-34,1924,2.2280339000765843
SIM,1947,18,45-49,1965,2
SIM,1879,46,45-49,1925,1
STAT,1864,34,40-44,1898,7.762085698734535
SIM,1920,37,35-39,1957,8
STAT,1862,85,na,1947,473.21119339288845
STAT,1890,24,40-44,1914,5.104755749575087
STAT,1913,16,45-49,1929,0.20683280845805482
SIM,1828,36,50-100,1864,3
SIM,1926,16,35-39,1942,12
STAT,1895,33,30-34,1928,45.75362713071509
SIM,1911,31,25-29,1942,28
SIM,1920,25,na,1945,8478
SIM,1839,42,50-100,1881,3
SIM,1886,64,na,1950,3500
SIM,1927,15,25-29,1942,141
STAT,1924,27,15-19,1951,1.6596056088270752
STAT,1810,53,25-29,1863,0.02145648608486319
STAT,1812,44,20-24,1856,1.1671190594037393
SIM,1932,27,15-19,1959,5
SIM,1853,85,na,1938,332
STAT,1803,90,na,1893,55.63997807344272
STAT,1908,36,30-34,1944,3.4651984228079833
SIM,1827,53,na,1880,2743
SIM,1877,35,30-34,1912,20
SIM,1903,55,na,1958,6256
STAT,1886,20,45-49,1906,1.4955197422476105
SIM,1873,19,20-24,1892,36
STAT,1910,25,50-100,1935,1.9716596619577174
STAT,1865,19,20-24,1884,33.12633224653371
STAT,1910,17,30-34,1927,4.879519595239951
SIM,1847,21,25-29,1868,111
SIM,1840,45,na,1885,3675
STAT,1782,89,na,1871,72.28274566653963
STAT,1913,40,50-100,1953,0.23405814806835867
STAT,1881,46,35-39,1927,0.27406730399157303
SIM,1886,33,30-34,1919,51
STAT,1847,80,na,1927,942.9522048185881
STAT,1930,16,45-49,1946,1.3075167480844703
STAT,1878,33,30-34,1911,36.67238050736766
STAT,1830,35,25-29,1865,5.548642142856498
SIM,1832,24,45-49,1856,1
SIM,1864,35,50-100,1899,3
STAT,1870,51,30-34,1921,0.011859349628391797
STAT,1879,26,na,1905,5058.776740867496
STAT,1866,5,na,1871,5285.282050169
SIM,1932,10,na,1942,10777
SIM,1827,44,30-34,1871,7
STAT,1866,54,45-49,1920,0.0262999084016077
STAT,1857,17,20-24,1874,32.801753452982645
STAT,1939,18,45-49,1957,1.009658157617011
SIM,1925,37,25-29,1962,2
STAT,1841,24,45-49,1865,1.2633652249544312
SIM,1874,79,na,1953,1150
SIM,1881,33,50-100,1914,2
STAT,1849,47,20-24,1896,0.018893086633602754
SIM,1861,50,na,1911,4187
STAT,1919,34,na,1953,8168.582590231248
SIM,1849,29,30-34,1878,45
STAT,1838,44,na,1882,3244.6285947118413
SIM,1866,38,20-24,1904,3
STAT,1825,31,50-100,1856,3.603186113955856
STAT,1886,35,30-34,1921,11.470263395434433
SIM,1860,33,na,1893,4155
STAT,1878,19,30-34,1897,3.3439204566020653
STAT,1933,38,50-100,1971,1.1539183037384666
STAT,1860,44,25-29,1904,1.038974630150804
SIM,1865,40,45-49,1905,3
SIM,1866,29,30-34,1895,48
SIM,1894,35,30-34,1929,20
STAT,1864,30,35-39,1894,18.4294456330123
SIM,1809,99,na,1908,1
STAT,1881,30,25-29,1911,20.155113921771672
SIM,1936,24,50-100,1960,5
SIM,1927,37,45-49,1964,1
STAT,1811,43,50-100,1854,8.12389478938511
STAT,1878,37,50-100,1915,2.5896786471763487
STAT,1848,19,20-24,1867,35.612820940028406
SIM,1856,19,20-24,1875,39
SIM,1893,12,na,1905,6855
SIM,1831,68,na,1899,1989
SIM,1840,19,na,1859,4665
STAT,1891,15,45-49,1906,0.16382757843117463
STAT,1921,31,50-100,1952,1.8653793265627028
SIM,1937,19,15-19,1956,77
STAT,1850,31,45-49,1881,2.8262050160343
SIM,1836,42,30-34,1878,3
STAT,1853,11,na,1864,4564.315963234686
STAT,1919,15,25-29,1934,19.490404036784433
STAT,1918,16,35-39,1934,1.8548531856096868
STAT,1828,42,30-34,1870,2.1647156005442345
STAT,1903,44,30-34,1947,0.22647266225022405
SIM,1915,15,20-24,1930,68
STAT,1801,101,na,1902,0.45231438547511876
SIM,1911,44,30-34,1955,1
SIM,1934,15,30-34,1949,36
STAT,1869,24,15-19,1893,6.4155749260416215
SIM,1823,34,45-49,1857,6
STAT,1871,36,25-29,1907,5.8049581258042755
STAT,1867,57,na,1924,3801.0655072131576
SIM,1862,32,30-34,1894,38
SIM,1925,26,30-34,1951,114
SIM,1892,29,50-100,1921,2
STAT,1890,41,30-34,1931,2.8469351495553625
STAT,1917,37,25-29,1954,2.065250277601962
STAT,1840,45,35-39,1885,0.20907231581657817
STAT,1839,29,20-24,1868,22.746153939958255
SIM,1833,65,na,1898,2155
SIM,1903,28,45-49,1931,4
STAT,1871,27,35-39,1898,19.360719828206044
SIM,1806,85,na,1891,151
STAT,1823,45,35-39,1868,0.44507410266072167
SIM,1845,32,30-34,1877,53
STAT,1871,62,na,1933,3667.3699798328453
STAT,1808,46,na,1854,2684.4299514292447
STAT,1855,53,30-34,1908,0.008831933847547232
STAT,1821,45,25-29,1866,0.17354086110182326
STAT,1869,35,30-34,1904,10.528713228496105
STAT,1890,36,35-39,1926,17.51977404727356
STAT,1838,44,40-44,1882,3.157731079623718
STAT,1838,40,35-39,1878,2.9404989001221735
STAT,1894,25,na,1919,6233.594057123574
STAT,1899,40,na,1939,6482.364136954193
STAT,1915,10,na,1925,8373.860479895737
SIM,1911,18,40-44,1929,4
SIM,1786,91,na,1877,25
SIM,1881,27,na,1908,4103
STAT,1933,34,15-19,1967,0.3493363962339266
STAT,1854,32,30-34,1886,27.409513200829064
SIM,1863,40,25-29,1903,1
STAT,1903,18,40-44,1921,0.5245711692197977
STAT,1948,19,25-29,1967,100.0854796080925
STAT,1858,29,30-34,1887,40.005569686100024
SIM,1825,46,na,1871,2813
STAT,1770,88,na,1858,72.92678751389644
STAT,1839,21,25-29,1860,115.67960179472996
STAT,1837,32,30-34,1869,30.51780785416581
STAT,1907,15,20-24,1922,52.869207718570514
STAT,1910,37,25-29,1947,1.902523831540079
SIM,1936,34,na,1970,6628
SIM,1929,20,30-34,1949,89
STAT,1871,50,20-24,1921,0.0015019238404089742
STAT,1886,15,50-100,1901,0.10493315173906166
SIM,1892,28,20-24,1920,33
STAT,1903,31,25-29,1934,29.573612412281424
STAT,1823,50,30-34,1873,0.01842267499386037
SIM,1890,25,45-49,1915,3
STAT,1850,84,na,1934,510.06241475633584
SIM,1781,76,na,1857,643
STAT,1842,34,50-100,1876,1.6140206691075007
STAT,1921,22,na,1943,8328.196905694298
STAT,1854,50,20-24,1904,0.001147477153954394
STAT,1874,53,40-44,1927,0.02142073709173529
SIM,1877,39,35-39,1916,19
STAT,1814,68,na,1882,1551.3910009966548
STAT,1839,52,45-49,1891,0.022539463340357686
SIM,1932,26,50-100,1958,8
SIM,1916,36,30-34,1952,5
STAT,1922,44,40-44,1966,0.5777320706771982
STAT,1899,30,na,1929,6656.331464667261
SIM,1856,28,na,1884,4141
SIM,1846,44,40-44,1890,10
SIM,1812,45,25-29,1857,1
STAT,1845,39,50-100,1884,1.9469179733969166
SIM,1847,29,20-24,1876,20
STAT,1884,16,50-100,1900,0.09794301742287147
STAT,1882,25,45-49,1907,2.1992264042301364
SIM,1825,37,20-24,1862,1
STAT,1869,39,35-39,1908,13.701973329085147
SIM,1875,19,30-34,1894,3
SIM,1945,16,45-49,1961,1
STAT,1855,40,35-39,1895,2.7581409749700656
STAT,1794,74,na,1868,936.2464304912284
STAT,1942,28,30-34,1970,83.01713417742309
STAT,1943,27,25-29,1970,141.56931548987868
SIM,1843,28,25-29,1871,103
SIM,1836,67,na,1903,1972
SIM,1913,55,na,1968,7106
SIM,1909,27,50-100,1936,3
SIM,1814,41,40-44,1855,3
SIM,1879,78,na,1957,1594
STAT,1878,24,50-100,1902,0.85476788255234
STAT,1884,28,20-24,1912,23.313334080159336
SIM,1896,35,40-44,1931,21
STAT,1808,99,na,1907,1.4882024589424125
SIM,1855,33,50-100,1888,2
STAT,1916,47,20-24,1963,0.0228920616623093
SIM,1871,22,30-34,1893,40
STAT,1860,26,20-24,1886,19.58734544289855
SIM,1895,39,50-100,1934,4
STAT,1873,32,40-44,1905,8.899185640985065
STAT,1845,37,35-39,1882,11.451392387435176
STAT,1849,20,40-44,1869,4.043011933473623
STAT,1915,47,50-100,1962,0.46033399321312735
STAT,1830,52,25-29,1882,0.0053772473472831145
STAT,1925,32,15-19,1957,0.30812814788624443
SIM,1933,32,15-19,1965,1
SIM,1908,15,15-19,1923,18
SIM,1877,43,30-34,1920,6
SIM,1948,17,25-29,1965,125
STAT,1931,37,45-49,1968,1.823474673551921
SIM,1865,27,na,1892,4446
STAT,1812,52,20-24,1864,0.004892001969319348
STAT,1863,11,na,1874,4837.83548450996
STAT,1847,33,50-100,1880,1.6229303532154145
SIM,1876,64,na,1940,3812
STAT,1809,51,20-24,1860,0.005550101494575731
STAT,1900,8,na,1908,7282.9524751943
SIM,1910,41,na,1951,7409
SIM,1918,36,40-44,1954,9
SIM,1901,34,20-24,1935,5
STAT,1891,32,45-49,1923,4.353246498101054
SIM,1885,30,45-49,1915,4
STAT,1829,54,40-44,1883,0.014034750140980797
SIM,1881,32,40-44,1913,9
SIM,1883,32,50-100,1915,4
SIM,1923,47,50-100,1970,1
SIM,1928,18,35-39,1946,13
SIM,1829,44,40-44,1873,7
SIM,1911,42,na,1953,7387
STAT,1823,37,50-100,1860,4.76401991220381
STAT,1824,41,45-49,1865,3.9859802760223024
STAT,1835,28,25-29,1863,70.92282820499133
SIM,1897,10,na,1907,7179
STAT,1883,46,45-49,1929,0.4696180743225174
SIM,1925,40,na,1965,9102
STAT,1863,22,30-34,1885,32.1179159090233
STAT,1950,17,15-19,1967,108.36847555018554
STAT,1880,22,30-34,1902,37.8969329149181
STAT,1832,23,40-44,1855,4.09655860683367
STAT,1946,15,50-100,1961,0.8396257415819679
SIM,1900,16,15-19,1916,17
STAT,1872,53,30-34,1925,0.011888139271076762
SIM,1900,47,35-39,1947,1
SIM,1902,12,na,1914,7607
STAT,1877,30,45-49,1907,3.6864670728964097
STAT,1887,39,na,1926,5268.103787761484
SIM,1954,15,50-100,1969,1
SIM,1781,92,na,1873,15
SIM,1832,41,45-49,1873,3
STAT,1875,32,50-100,1907,1.9051966337493742
STAT,1909,17,20-24,1926,53.72428483283269
SIM,1889,18,20-24,1907,42
STAT,1864,54,35-39,1918,0.01511462107237828
SIM,1917,39,40-44,1956,6
STAT,1909,39,40-44,1948,2.8344288940162476
STAT,1887,39,50-100,1926,2.7453051703714633
STAT,1921,23,40-44,1944,7.64441256804347
SIM,1800,54,na,1854,2257
SIM,1888,39,na,1927,5493
SIM,1853,37,35-39,1890,9
SIM,1834,66,na,1900,2100
SIM,1864,79,na,1943,1180
SIM,1891,46,45-49,1937,1
STAT,1856,44,35-39,1900,2.783588225771616
STAT,1838,47,45-49,1885,0.3286011420297157
SIM,1848,44,50-100,1892,4
SIM,1836,38,35-39,1874,19
SIM,1864,44,35-39,1908,5
SIM,1881,41,30-34,1922,3
STAT,1946,19,15-19,1965,101.58469200460034
STAT,1857,40,45-49,1897,2.379779333656656
STAT,1842,45,45-49,1887,0.36053982593701883
SIM,1817,38,25-29,1855,2
STAT,1876,29,25-29,1905,87.73019681790937
SIM,1895,25,na,1920,6660
STAT,1907,49,na,1956,6575.274612788569
STAT,1836,40,15-19,1876,0.022415151338696652
SIM,1840,23,40-44,1863,4
STAT,1809,47,na,1856,2810.8491264303157
STAT,1824,36,na,1860,3090.496255991783
STAT,1922,38,na,1960,8634.719428496499
STAT,1834,36,20-24,1870,1.2896617179577154
STAT,1934,29,35-39,1963,40.7556597183104
STAT,1895,29,35-39,1924,25.21093051574632
STAT,1862,63,na,1925,3080.0682045809267
SIM,1879,56,na,1935,4163
STAT,1918,46,40-44,1964,0.3396309212197013
STAT,1792,67,na,1859,1477.2473248951048
STAT,1840,51,45-49,1891,0.021048031266683483
STAT,1937,15,na,1952,7266.8493275791825
STAT,1844,111,na,1955,1.733327214357471E-4
STAT,1849,102,na,1951,0.46374368498973445
STAT,1918,42,25-29,1960,0.15331048875295283
STAT,1919,17,50-100,1936,0.8359980907689898
STAT,1768,104,na,1872,0.0567339654177218
STAT,1843,27,20-24,1870,20.224509909823393
STAT,1881,52,45-49,1933,0.02817859971577415
STAT,1900,37,30-34,1937,3.2228278710962006
STAT,1920,44,30-34,1964,0.28415064629274506
SIM,1903,33,40-44,1936,13
SIM,1851,27,20-24,1878,25
SIM,1923,26,20-24,1949,5
STAT,1935,29,40-44,1964,12.821567550715761
STAT,1904,20,na,1924,6896.565094904774
STAT,1833,32,50-100,1865,1.5541558106822928
SIM,1850,45,45-49,1895,1
STAT,1901,44,20-24,1945,0.030760195203790513
SIM,1908,28,35-39,1936,41
SIM,1842,36,20-24,1878,4
SIM,1865,42,50-100,1907,5
STAT,1834,54,25-29,1888,0.00464669590101949
STAT,1912,37,35-39,1949,4.769066930133512
STAT,1901,49,40-44,1950,0.26734110450042103
SIM,1854,80,na,1934,952
STAT,1853,5,na,1858,4785.906487022175
STAT,1911,47,45-49,1958,0.4156677477616905
SIM,1888,22,25-29,1910,138
STAT,1928,17,na,1945,9365.306625107045
STAT,1835,30,na,1865,3648.343766881552
SIM,1869,33,30-34,1902,45
STAT,1863,51,25-29,1914,0.0062918878964898775
STAT,1848,41,30-34,1889,1.907075509453483
STAT,1869,43,30-34,1912,2.23357893891187
STAT,1870,21,45-49,1891,1.3868426130318456
STAT,1819,47,35-39,1866,0.5875088667264905
SIM,1870,11,na,1881,5212
SIM,1885,25,na,1910,5018
SIM,1830,24,35-39,1854,8
STAT,1911,16,25-29,1927,17.561828640715618
SIM,1815,68,na,1883,1572
STAT,1898,32,50-100,1930,2.5041794802253525
SIM,1875,35,20-24,1910,1
STAT,1799,68,na,1867,1484.6918930242769
STAT,1867,35,20-24,1902,1.4718493744977603
STAT,1829,61,na,1890,2211.5472025956533
STAT,1886,38,35-39,1924,15.00427021044476
SIM,1848,17,20-24,1865,31
SIM,1884,29,25-29,1913,107
SIM,1942,29,35-39,1971,39
SIM,1816,85,na,1901,201
STAT,1851,54,25-29,1905,0.005339774359914816
STAT,1853,53,20-24,1906,0.001148791066481139
STAT,1832,65,na,1897,2203.2343288532575
SIM,1856,41,30-34,1897,5
SIM,1889,40,30-34,1929,4
STAT,1869,42,na,1911,4517.387963546231
STAT,1921,15,40-44,1936,3.2341551031303895
STAT,1810,50,20-24,1860,0.004749503824963314
SIM,1823,43,35-39,1866,4
SIM,1912,26,35-39,1938,34
STAT,1893,25,20-24,1918,30.234825398815502
SIM,1929,23,35-39,1952,28
STAT,1908,39,35-39,1947,4.530600253563356
STAT,1849,81,na,1930,855.3803485702812
SIM,1834,34,20-24,1868,6
SIM,1931,28,20-24,1959,53
STAT,1823,36,45-49,1859,8.01839080272825
SIM,1894,38,35-39,1932,26
SIM,1866,81,na,1947,963
STAT,1808,46,20-24,1854,0.07812702934598022
STAT,1846,63,na,1909,2733.0351058824567
STAT,1923,28,20-24,1951,42.163678812876434
SIM,1899,20,35-39,1919,18
STAT,1847,9,na,1856,4635.1720008621
STAT,1876,53,50-100,1929,0.031040995929071693
STAT,1848,15,40-44,1863,0.3761982859065377
STAT,1917,18,50-100,1935,0.16238714787613948
STAT,1911,49,50-100,1960,0.4300407588418133
SIM,1935,19,40-44,1954,4
STAT,1792,73,na,1865,993.9888697286833
STAT,1864,27,na,1891,4308.4130571219475
STAT,1926,40,50-100,1966,0.2932602806551698
STAT,1911,44,na,1955,7073.139062212759
STAT,1826,34,20-24,1860,7.128445516703199
SIM,1862,28,35-39,1890,23
SIM,1890,34,35-39,1924,40
SIM,1909,18,25-29,1927,20
SIM,1881,24,40-44,1905,7
SIM,1852,31,45-49,1883,3
STAT,1854,28,35-39,1882,15.395170884522166
STAT,1882,34,35-39,1916,19.75337505027061
SIM,1931,15,50-100,1946,1
STAT,1818,41,45-49,1859,7.657423579573481
STAT,1829,50,25-29,1879,0.005617136901922689
STAT,1831,52,30-34,1883,0.008014216841041638
SIM,1831,36,45-49,1867,3
STAT,1909,56,na,1965,6567.359887035511
SIM,1925,18,50-100,1943,1
STAT,1815,43,35-39,1858,10.542469050280607
STAT,1901,36,20-24,1937,0.47268452727065335
STAT,1915,26,20-24,1941,37.734616726090174
STAT,1878,78,na,1956,1730.0577414059915
SIM,1880,16,na,1896,5670
SIM,1916,39,35-39,1955,7
SIM,1924,38,30-34,1962,10
STAT,1875,37,20-24,1912,1.6028658479824527
STAT,1888,43,40-44,1931,5.33038224971939
SIM,1785,90,na,1875,32
SIM,1891,30,45-49,1921,10
SIM,1906,29,15-19,1935,1
STAT,1830,32,20-24,1862,5.353873875126692
STAT,1898,41,45-49,1939,0.2853344191504704
SIM,1854,96,na,1950,12
SIM,1815,46,na,1861,2691
STAT,1780,88,na,1868,82.94804552557471
STAT,1850,78,na,1928,1197.9938134471329
SIM,1897,42,30-34,1939,1
STAT,1899,39,20-24,1938,0.4557654747034168
STAT,1855,40,25-29,1895,0.9781014736421336
SIM,1886,36,35-39,1922,21
SIM,1905,29,50-100,1934,4
SIM,1915,40,na,1955,7632
SIM,1955,3,na,1958,10130
SIM,1865,70,na,1935,2626
STAT,1890,20,35-39,1910,14.471199618872609
STAT,1889,42,30-34,1931,2.859416854016707
SIM,1852,30,na,1882,4056
STAT,1906,39,15-19,1945,0.035310862173469265
STAT,1814,84,na,1898,286.2997794042734
STAT,1890,27,45-49,1917,2.7370703300296215
STAT,1835,52,na,1887,2841.8371642879033
STAT,1844,31,45-49,1875,3.4027631067603386
SIM,1840,51,na,1891,3366
STAT,1868,40,20-24,1908,0.30824264111012356
SIM,1845,82,na,1927,623
STAT,1878,36,35-39,1914,14.990723637080407
STAT,1870,54,35-39,1924,0.016600855797038804
SIM,1923,38,na,1961,9162
SIM,1901,47,40-44,1948,1
STAT,1830,26,35-39,1856,24.049013602182423
STAT,1876,12,na,1888,5426.193264477591
SIM,1935,17,na,1952,10531
SIM,1885,47,na,1932,4733
STAT,1916,38,30-34,1954,3.750730762690221
STAT,1866,51,40-44,1917,0.01971192631940213
STAT,1805,51,50-100,1856,0.12100384947159891
STAT,1861,18,25-29,1879,10.884337676340694
STAT,1871,53,25-29,1924,0.006992989906510315
STAT,1856,35,45-49,1891,3.1358242369159055
SIM,1896,30,20-24,1926,10
SIM,1877,12,na,1889,5395
STAT,1869,58,na,1927,3870.0386958003332
SIM,1826,41,45-49,1867,5
SIM,1840,31,40-44,1871,14
STAT,1948,16,20-24,1964,313.418104546514
STAT,1899,24,na,1923,6503.448249055921
SIM,1868,48,35-39,1916,1
SIM,1918,22,20-24,1940,250
STAT,1879,48,45-49,1927,0.4922803686065466
STAT,1926,18,35-39,1944,10.361311191009241
SIM,1796,91,na,1887,45
SIM,1860,24,20-24,1884,117
SIM,1841,30,30-34,1871,44
STAT,1819,67,na,1886,1717.308810061271
STAT,1885,32,45-49,1917,3.5055990927943648
SIM,1893,32,45-49,1925,8
SIM,1872,30,35-39,1902,27
STAT,1878,25,na,1903,5068.0466915812385
STAT,1908,31,50-100,1939,1.583659961401182
SIM,1856,40,50-100,1896,4
STAT,1823,53,35-39,1876,0.025100591795724443
STAT,1871,33,20-24,1904,5.400839832298677
SIM,1915,18,25-29,1933,26
STAT,1810,106,na,1916,0.010980370760038188
STAT,1907,18,25-29,1925,16.776832768511124
STAT,1870,9,na,1879,5359.146465964337
SIM,1786,75,na,1861,886
SIM,1903,25,40-44,1928,12
SIM,1934,18,35-39,1952,15
STAT,1837,35,35-39,1872,12.257001949407202
STAT,1890,44,35-39,1934,4.403683548822465
STAT,1932,29,15-19,1961,1.8657370074820732
STAT,1871,39,50-100,1910,2.438690419744471
STAT,1896,41,25-29,1937,0.11944125146861968
STAT,1857,57,na,1914,3163.5549564006365
STAT,1870,41,15-19,1911,0.02750640581763985
STAT,1844,50,na,1894,3527.149254172478
STAT,1920,36,30-34,1956,4.0329003128686685
SIM,1864,35,45-49,1899,7
SIM,1887,48,45-49,1935,1
SIM,1940,29,15-19,1969,4
STAT,1822,50,25-29,1872,0.011025284990127605
STAT,1842,53,45-49,1895,0.021259378853640754
STAT,1877,41,15-19,1918,0.029092440906594318
STAT,1815,102,na,1917,0.27250606665973615
SIM,1811,91,na,1902,38
STAT,1903,35,40-44,1938,2.742765575938934
SIM,1833,97,na,1930,3
STAT,1888,30,20-24,1918,6.504242391036601
STAT,1880,18,35-39,1898,1.1643601286106555
STAT,1884,47,15-19,1931,7.939885636581224E-4
SIM,1877,49,50-100,1926,1
STAT,1865,42,45-49,1907,2.7426713778932275
SIM,1863,63,na,1926,3218
SIM,1905,38,20-24,1943,2
STAT,1840,49,15-19,1889,5.675078599099362E-4
SIM,1845,35,35-39,1880,17
SIM,1823,33,na,1856,3359
STAT,1887,40,30-34,1927,2.6230654586923388
STAT,1904,26,35-39,1930,28.06571682968148
STAT,1833,30,30-34,1863,30.2405745928859
STAT,1941,16,20-24,1957,282.12073542021295
SIM,1907,11,na,1918,7805
SIM,1846,67,na,1913,2436
STAT,1871,24,30-34,1895,35.51687115448523
STAT,1927,39,45-49,1966,1.707886434589575
STAT,1832,31,40-44,1863,7.450133297907473
STAT,1858,38,20-24,1896,1.2076189656292284
SIM,1841,36,na,1877,3681
SIM,1873,42,45-49,1915,8
STAT,1905,47,45-49,1952,0.3870122718849552
STAT,1859,42,45-49,1901,2.4028709257119933
SIM,1911,35,40-44,1946,4
STAT,1928,3,na,1931,10320.236400969736
STAT,1910,39,40-44,1949,2.8634658362947993
STAT,1910,38,50-100,1948,0.8072473354697142
STAT,1841,41,45-49,1882,2.285576378774709
STAT,1844,42,25-29,1886,1.062090106123155
STAT,1890,20,25-29,1910,141.9613576563666
STAT,1812,50,30-34,1862,0.041077918310521114
STAT,1924,26,50-100,1950,2.3479708427554153
SIM,1928,16,45-49,1944,1
STAT,1926,27,25-29,1953,159.32723527170978
SIM,1871,34,na,1905,4604
SIM,1810,47,na,1857,2797
STAT,1846,50,35-39,1896,0.013376071178051898
STAT,1785,87,na,1872,120.9900250206641
STAT,1898,61,na,1959,5292.011322528875
SIM,1880,11,na,1891,5804
SIM,1815,40,30-34,1855,1
STAT,1873,35,45-49,1908,4.129596914550769
STAT,1915,48,30-34,1963,0.18093018297602437
SIM,1897,16,40-44,1913,1
STAT,1882,18,45-49,1900,0.12817856906774866
SIM,1858,19,30-34,1877,3
STAT,1826,51,20-24,1877,0.0014476766212669432
STAT,1879,40,20-24,1919,0.3388740991815581
SIM,1887,40,20-24,1927,1
STAT,1866,20,40-44,1886,3.9716701512671504
STAT,1874,31,30-34,1905,36.252756931147744
STAT,1883,43,40-44,1926,4.430937157147923
SIM,1860,71,na,1931,2322
SIM,1882,31,30-34,1913,42
STAT,1834,43,45-49,1877,2.3711496587509435
STAT,1859,64,na,1923,2794.3923483105086
STAT,1879,54,30-34,1933,0.012228830689047622
STAT,1910,25,30-34,1935,77.61564279328823
SIM,1826,28,25-29,1854,80
SIM,1839,97,na,1936,6
SIM,1913,31,35-39,1944,26
STAT,1875,52,20-24,1927,0.0015262254714927337
SIM,1842,43,45-49,1885,4
STAT,1880,41,50-100,1921,2.2578487397044538
STAT,1816,52,40-44,1868,0.04962066035218637
STAT,1848,27,na,1875,4234.603157743283
STAT,1870,43,30-34,1913,2.26312622678186
STAT,1911,42,15-19,1953,0.00296106439557998
STAT,1821,33,30-34,1854,114.7367662908722
STAT,1889,16,40-44,1905,0.4565898498814783
SIM,1911,26,na,1937,7501
SIM,1914,36,20-24,1950,1
STAT,1885,11,na,1896,5199.355268671689
SIM,1875,28,20-24,1903,26
STAT,1901,27,30-34,1928,71.19852260943752
STAT,1930,16,35-39,1946,10.983142718824427
SIM,1830,51,na,1881,2691
SIM,1911,45,45-49,1956,2
STAT,1864,52,45-49,1916,0.02605992596940834
STAT,1872,31,na,1903,4863.386190858866
SIM,1863,40,35-39,1903,3
SIM,1881,35,45-49,1916,6
SIM,1809,50,na,1859,2517
STAT,1894,30,45-49,1924,4.560532634874542
STAT,1949,16,na,1965,8647.509222607328
STAT,1931,34,40-44,1965,10.343114419536482
STAT,1858,45,20-24,1903,0.019081375912203172
STAT,1912,21,25-29,1933,179.37074113316132
STAT,1909,15,30-34,1924,4.852479948141525
STAT,1912,23,na,1935,7365.3981461286185
STAT,1842,49,na,1891,3279.658351772034
SIM,1871,0,na,1871,6915
STAT,1823,42,30-34,1865,3.8287098659316534
STAT,1923,35,45-49,1958,1.597544564714687
SIM,1854,64,na,1918,2817
SIM,1892,35,20-24,1927,4
STAT,1933,30,35-39,1963,24.902640348578444
STAT,1905,31,35-39,1936,17.053635823175494
STAT,1928,33,na,1961,9543.529641590276
STAT,1857,42,35-39,1899,2.847067971849108
STAT,1864,37,45-49,1901,3.5988604719930897
SIM,1822,54,na,1876,2532
SIM,1887,48,50-100,1935,1
STAT,1825,107,na,1932,0.005456526930679861
STAT,1940,32,40-44,1972,8.180314834541605
SIM,1868,38,30-34,1906,18
SIM,1872,37,45-49,1909,6
STAT,1885,19,25-29,1904,11.330710652065916
STAT,1855,54,45-49,1909,0.021281978862500855
STAT,1886,31,15-19,1917,0.30484570393361937
SIM,1822,43,40-44,1865,8
SIM,1841,14,na,1855,4421
STAT,1884,35,20-24,1919,1.551880919371671
STAT,1829,45,na,1874,2981.912072439835
SIM,1941,30,35-39,1971,32
SIM,1900,48,50-100,1948,1
STAT,1873,26,na,1899,4914.085797115141
STAT,1898,17,50-100,1915,0.13389910264453994
SIM,1814,44,45-49,1858,6
STAT,1872,51,40-44,1923,0.02147063631176923
SIM,1839,23,40-44,1862,4
STAT,1901,47,25-29,1948,0.0914363244423851
STAT,1909,42,50-100,1951,0.22204200023448778
SIM,1875,41,50-100,1916,4
STAT,1860,48,40-44,1908,0.27725414308853447
SIM,1939,16,20-24,1955,283
SIM,1920,28,45-49,1948,5
STAT,1890,33,30-34,1923,42.85929324155376
STAT,1892,41,40-44,1933,5.712566462366789
STAT,1819,40,15-19,1859,0.0679256232753149
STAT,1817,45,50-100,1862,1.223800205327037
STAT,1839,51,30-34,1890,0.009338950063912162
SIM,1917,15,30-34,1932,6
SIM,1942,22,15-19,1964,11
SIM,1821,34,35-39,1855,29
SIM,1842,79,na,1921,955
SIM,1852,42,50-100,1894,5
STAT,1808,53,45-49,1861,0.0843810992255129
STAT,1817,44,20-24,1861,0.7977632657390727
SIM,1826,47,na,1873,2950
STAT,1919,37,35-39,1956,5.246847136368766
STAT,1823,51,45-49,1874,0.044030017954653326
STAT,1920,47,35-39,1967,0.2877703287487557
STAT,1814,43,40-44,1857,12.532241506296215
STAT,1852,41,20-24,1893,0.2542631335181643
STAT,1900,38,na,1938,6619.649569748556
STAT,1920,24,50-100,1944,1.4677787655410242
SIM,1887,41,25-29,1928,3
STAT,1899,49,25-29,1948,0.08803044327915714
SIM,1805,84,na,1889,179
SIM,1810,69,na,1879,1518
SIM,1855,12,na,1867,5031
SIM,1867,17,30-34,1884,4
SIM,1905,19,na,1924,7548
SIM,1879,39,45-49,1918,7
SIM,1825,44,20-24,1869,2
STAT,1927,19,40-44,1946,3.4930201455237637
STAT,1837,52,35-39,1889,0.012045402828481759
STAT,1797,72,na,1869,1091.6229869344156
SIM,1915,40,35-39,1955,1
STAT,1912,28,45-49,1940,3.427199816591065
SIM,1864,41,30-34,1905,5
SIM,1850,42,40-44,1892,11
SIM,1930,18,na,1948,10108
STAT,1917,15,15-19,1932,19.813804675460986
STAT,1914,42,40-44,1956,0.5006373046311621
SIM,1926,7,na,1933,10163
STAT,1836,47,35-39,1883,0.19484587983853513
STAT,1875,44,45-49,1919,3.070034399454467
STAT,1933,17,15-19,1950,122.70904258335081
STAT,1934,22,15-19,1956,14.449923906678316
SIM,1901,28,35-39,1929,40
SIM,1831,42,30-34,1873,1
STAT,1881,34,40-44,1915,8.393143791771925
STAT,1861,31,45-49,1892,2.943359215543063
SIM,1941,17,15-19,1958,86
STAT,1841,64,na,1905,2522.2361553726214
STAT,1897,39,na,1936,6345.963487778335
STAT,1859,17,30-34,1876,2.9740936448679074
STAT,1880,25,35-39,1905,20.668073891448955
SIM,1919,17,40-44,1936,7
SIM,1870,34,30-34,1904,42
SIM,1963,6,na,1969,10474
STAT,1870,48,25-29,1918,0.11277578536560384
STAT,1880,66,na,1946,3487.1137548632905
STAT,1885,43,25-29,1928,1.2816004720231036
STAT,1866,30,50-100,1896,1.72112937179508
STAT,1844,18,50-100,1862,0.09997975948599154
SIM,1822,32,na,1854,3334
SIM,1858,39,25-29,1897,8
STAT,1811,66,na,1877,1770.3956032651643
STAT,1869,46,35-39,1915,0.2747493913889249
STAT,1872,78,na,1950,1585.902642830831
SIM,1882,40,45-49,1922,6
SIM,1853,30,15-19,1883,1
SIM,1883,44,45-49,1927,9
SIM,1877,24,15-19,1901,8
STAT,1890,42,45-49,1932,3.684909097166616
STAT,1906,36,20-24,1942,0.4920065941626097
STAT,1825,50,40-44,1875,0.022899055569461743
STAT,1764,92,na,1856,15.740102800799999
STAT,1912,34,30-34,1946,31.05034029561198
STAT,1834,51,20-24,1885,0.001027321591505862
STAT,1940,28,20-24,1968,37.57789293042546
STAT,1907,40,35-39,1947,0.37702789125692965
STAT,1842,42,40-44,1884,3.4646495954676135
SIM,1935,33,na,1968,10865
STAT,1847,79,na,1926,1065.6753817849424
STAT,1858,21,45-49,1879,1.268767466578034
SIM,1925,15,15-19,1940,115
SIM,1927,37,35-39,1964,4
STAT,1935,32,50-100,1967,2.3105973264982858
SIM,1903,36,45-49,1939,1
STAT,1820,54,20-24,1874,0.002537799912847161
STAT,1952,17,25-29,1969,104.87326146791388
STAT,1874,40,45-49,1914,3.126153296088857
STAT,1893,14,na,1907,6589.506395794413
SIM,1866,21,45-49,1887,3
SIM,1867,42,45-49,1909,2
SIM,1831,51,45-49,1882,1
STAT,1818,52,25-29,1870,0.014974112559567411
STAT,1831,64,na,1895,2244.478164677398
STAT,1862,30,15-19,1892,0.24780027391750253
STAT,1892,51,na,1943,5470.041680480961
STAT,1924,40,na,1964,8944.179642954741
STAT,1864,43,30-34,1907,2.0605139743982743
SIM,1869,26,30-34,1895,57
STAT,1789,68,na,1857,1453.9198543211041
STAT,1843,37,25-29,1880,4.708439356909882
STAT,1894,15,50-100,1909,0.12769491947640121
STAT,1847,20,30-34,1867,33.768895376412665
SIM,1890,31,30-34,1921,67
STAT,1922,1,na,1923,9758.254027109433
SIM,1840,40,30-34,1880,3
SIM,1844,47,35-39,1891,1
SIM,1848,30,40-44,1878,13
SIM,1847,24,na,1871,3858
STAT,1942,24,15-19,1966,11.264684890187787
SIM,1896,46,45-49,1942,1
SIM,1839,19,20-24,1858,27
SIM,1909,16,35-39,1925,2
SIM,1845,28,35-39,1873,23
SIM,1857,104,na,1961,1
SIM,1829,97,na,1926,2
SIM,1827,37,30-34,1864,12
STAT,1840,33,40-44,1873,7.545622786545401
STAT,1928,24,50-100,1952,1.6485654060451571
STAT,1850,34,50-100,1884,1.4394101449975636
STAT,1831,50,40-44,1881,0.014746610642759535
SIM,1823,40,30-34,1863,4
SIM,1916,35,50-100,1951,5
STAT,1842,27,na,1869,3982.8873062236785
STAT,1911,60,na,1971,6542.945598015284
SIM,1855,20,50-100,1875,1
STAT,1888,46,45-49,1934,0.5649468179610608
STAT,1911,44,40-44,1955,0.47635988742478735
SIM,1902,6,na,1908,7690
STAT,1845,30,15-19,1875,0.2663916089919764
SIM,1851,37,25-29,1888,2
SIM,1864,64,na,1928,3301
SIM,1920,34,30-34,1954,45
STAT,1945,27,35-39,1972,33.26322539467489
SIM,1902,47,50-100,1949,1
SIM,1944,15,25-29,1959,122
STAT,1806,50,30-34,1856,0.03615610209084531
STAT,1880,82,na,1962,1449.5338225183052
STAT,1842,53,20-24,1895,0.0010809854064630603
STAT,1876,6,na,1882,5670.593740559999
SIM,1872,43,30-34,1915,4
STAT,1849,54,45-49,1903,0.02232444423130806
SIM,1830,41,35-39,1871,6
SIM,1894,28,30-34,1922,74
SIM,1888,9,na,1897,6086
STAT,1863,26,na,1889,4249.648509702797
STAT,1851,79,na,1930,1083.740811585473
STAT,1912,55,na,1967,6908.699367432333
SIM,1834,28,50-100,1862,2
STAT,1898,43,35-39,1941,0.3411939121865251
SIM,1908,37,25-29,1945,3
STAT,1859,53,25-29,1912,0.005602328187657354
STAT,1877,17,50-100,1894,0.10274372033971517
STAT,1819,37,30-34,1856,30.995543239816612
STAT,1907,27,15-19,1934,1.3467535505698527
SIM,1808,98,na,1906,2
STAT,1867,52,20-24,1919,0.0013882887507384002
SIM,1933,36,30-34,1969,10
STAT,1779,75,na,1854,668.0
STAT,1856,32,40-44,1888,6.840364436385469
STAT,1832,49,na,1881,3058.49906716043
STAT,1860,46,15-19,1906,6.57895179790228E-4
STAT,1860,33,50-100,1893,1.496377130719706
STAT,1886,28,30-34,1914,53.497387999529586
STAT,1893,18,20-24,1911,45.26397526174311
SIM,1815,84,na,1899,316
SIM,1967,1,na,1968,10519
SIM,1816,47,na,1863,2860
STAT,1925,36,30-34,1961,4.421013570800506
STAT,1841,17,45-49,1858,0.12223921206943907
STAT,1903,41,na,1944,6699.242771435491
STAT,1910,38,na,1948,7233.5150814035715
SIM,1855,20,30-34,1875,47
SIM,1909,29,40-44,1938,10
STAT,1822,41,35-39,1863,6.259888064512431
STAT,1851,36,20-24,1887,1.2203594586143527
STAT,1939,30,50-100,1969,1.7058559234541615
STAT,1896,46,50-100,1942,0.3704527261248422
STAT,1857,53,40-44,1910,0.0163065027893486
SIM,1765,92,na,1857,10
SIM,1834,27,20-24,1861,24
STAT,1878,29,35-39,1907,20.20702826853253
STAT,1914,19,na,1933,8027.003590331612
STAT,1860,46,na,1906,3700.4016165448097
STAT,1823,35,na,1858,3505.8079445704648
STAT,1778,90,na,1868,61.37801662060528
SIM,1796,75,na,1871,787
SIM,1940,29,25-29,1969,153
SIM,1828,32,na,1860,3515
SIM,1876,40,45-49,1916,7
SIM,1840,34,45-49,1874,4
STAT,1941,29,50-100,1970,2.077547737752442
STAT,1884,29,50-100,1913,1.2666018341721332
SIM,1920,21,25-29,1941,238
SIM,1831,36,na,1867,3699
STAT,1817,47,25-29,1864,0.2781869952997272
STAT,1932,29,25-29,1961,173.95390030152976
SIM,1876,38,50-100,1914,5
STAT,1779,107,na,1886,0.014064238023427858
STAT,1947,9,na,1956,8939.448257879369
SIM,1895,41,na,1936,6451
STAT,1873,41,30-34,1914,2.3698584830534113
STAT,1900,15,20-24,1915,49.89945623159805
STAT,1901,42,30-34,1943,0.22544600742228055
STAT,1899,22,45-49,1921,1.929585484914301
STAT,1931,37,na,1968,10063.210240604807
SIM,1891,43,40-44,1934,4
SIM,1838,38,45-49,1876,4
SIM,1870,41,30-34,1911,3
STAT,1896,45,40-44,1941,0.2600669634742226
STAT,1921,26,45-49,1947,3.901030515202522
SIM,1819,38,35-39,1857,24
STAT,1832,34,45-49,1866,2.9001822569634115
STAT,1893,42,20-24,1935,0.40604147453289396
STAT,1905,44,40-44,1949,0.4500514050326149
STAT,1920,42,40-44,1962,0.5577842465262524
STAT,1844,34,na,1878,4099.305275636291
STAT,1877,45,30-34,1922,0.20502878619948775
SIM,1886,29,35-39,1915,27
STAT,1832,40,30-34,1872,1.8815719716927066
SIM,1816,69,na,1885,1582
SIM,1918,47,45-49,1965,2
SIM,1939,19,25-29,1958,120
STAT,1781,94,na,1875,8.07375995388188
STAT,1853,51,30-34,1904,0.009463194663543695
STAT,1888,21,30-34,1909,42.64744872605323
SIM,1872,30,25-29,1902,24
SIM,1934,27,25-29,1961,200
SIM,1830,26,50-100,1856,2
STAT,1878,41,na,1919,4897.158272618327
SIM,1910,9,na,1919,8321
STAT,1760,95,na,1855,0.61218
STAT,1863,64,na,1927,3073.245002371204
STAT,1851,40,40-44,1891,3.5219712729701937
STAT,1846,41,20-24,1887,0.2493747816504612
STAT,1863,6,na,1869,5032.782772563539
STAT,1829,67,na,1896,1876.1197285218677
STAT,1912,45,na,1957,7166.115955138208
SIM,1896,26,na,1922,6600
STAT,1901,4,na,1905,7437.924967455314
STAT,1853,110,na,1963,0.0019086260253337371
SIM,1874,20,40-44,1894,3
STAT,1904,26,na,1930,6941.650137558533
SIM,1903,21,25-29,1924,184
STAT,1911,49,35-39,1960,0.24513724112648227
STAT,1815,40,30-34,1855,7.442879857442093
STAT,1871,20,15-19,1891,6.659037211116215
STAT,1845,27,30-34,1872,47.23101159170409
STAT,1869,26,na,1895,4686.308855560093
STAT,1897,29,45-49,1926,2.975997730082593
STAT,1909,41,na,1950,7059.936633384344
STAT,1862,37,35-39,1899,12.209285811373563
STAT,1868,40,45-49,1908,2.9048517990639064
SIM,1918,25,25-29,1943,161
STAT,1878,53,35-39,1931,0.017867530670396845
STAT,1931,21,35-39,1952,24.739437952681794
SIM,1853,27,30-34,1880,61
SIM,1906,49,50-100,1955,1
STAT,1882,31,30-34,1913,34.49056658301095
STAT,1884,63,na,1947,3558.385272175669
SIM,1780,91,na,1871,29
STAT,1833,52,40-44,1885,0.014287589687887165
STAT,1836,53,20-24,1889,9.734726895097802E-4
STAT,1829,50,35-39,1879,0.013652763441054786
STAT,1852,27,na,1879,4015.844258219569
STAT,1864,30,25-29,1894,18.639704669651675
SIM,1832,40,30-34,1872,8
SIM,1877,22,na,1899,4882
STAT,1870,32,25-29,1902,20.309314977650235
STAT,1885,81,na,1966,1706.4935428180816
STAT,1862,34,30-34,1896,29.88094786053371
STAT,1898,45,50-100,1943,0.38241370667462105
SIM,1842,40,40-44,1882,6
SIM,1896,21,30-34,1917,50
STAT,1941,19,15-19,1960,94.34903238322313
SIM,1892,38,25-29,1930,11
STAT,1903,38,45-49,1941,1.23115024192751
SIM,1794,68,na,1862,1386
STAT,1862,53,na,1915,3657.123517496303
STAT,1929,18,na,1947,9461.190868883417
STAT,1834,43,50-100,1877,1.6737526954984299
STAT,1906,39,25-29,1945,1.8104839837263544
STAT,1872,54,45-49,1926,0.028646402141223572
STAT,1846,15,30-34,1861,3.1032704669429227
STAT,1876,42,45-49,1918,3.122422450126761
STAT,1851,43,45-49,1894,2.3033059600375836
SIM,1855,49,na,1904,3875
SIM,1847,25,40-44,1872,10
STAT,1831,30,20-24,1861,4.659087562727398
STAT,1909,27,25-29,1936,127.1106414653587
STAT,1867,19,30-34,1886,3.04571334458365
STAT,1897,33,40-44,1930,11.658175683880327
STAT,1809,51,45-49,1860,0.10915199191764045
SIM,1898,11,na,1909,7322
SIM,1917,27,25-29,1944,146
STAT,1859,29,25-29,1888,68.18305227628011
SIM,1867,29,25-29,1896,94
STAT,1911,40,25-29,1951,0.13925026168885982
SIM,1871,42,35-39,1913,11
SIM,1917,2,na,1919,9034
STAT,1862,46,25-29,1908,0.0997114885087964
STAT,1819,83,na,1902,415.39793540509737
SIM,1914,56,na,1970,7162
SIM,1884,42,45-49,1926,7
SIM,1886,7,na,1893,5515
SIM,1829,30,30-34,1859,40
STAT,1864,12,na,1876,4899.221384737315
STAT,1863,18,35-39,1881,1.0013763595796425
STAT,1824,40,30-34,1864,3.137299843527696
SIM,1841,52,40-44,1893,1
STAT,1834,40,40-44,1874,3.7031939934633487
STAT,1823,49,15-19,1872,0.0012012684548679093
SIM,1872,34,40-44,1906,13
STAT,1884,38,25-29,1922,5.713418098035197
SIM,1906,48,30-34,1954,1
STAT,1852,33,50-100,1885,1.4963697391486381
SIM,1868,45,na,1913,4380
SIM,1971,0,na,1971,10512
SIM,1838,42,40-44,1880,13
SIM,1938,23,50-100,1961,1
STAT,1913,16,35-39,1929,1.737395912945762
SIM,1936,17,40-44,1953,3
STAT,1910,9,na,1919,7943.287370036741
STAT,1948,21,na,1969,8470.405006849966
STAT,1775,116,na,1891,1.1168360510092895E-4
STAT,1850,68,na,1918,2343.1390937753813
STAT,1919,34,40-44,1953,8.452113096484744
STAT,1936,36,na,1972,7467.622755648175
SIM,1849,8,na,1857,4999
SIM,1889,31,40-44,1920,21
STAT,1896,41,35-39,1937,0.3368114849582947
STAT,1873,96,na,1969,87.45131665316993
STAT,1910,28,35-39,1938,29.187780181994945
SIM,1878,77,na,1955,1632
STAT,1846,104,na,1950,0.10216506175316113
STAT,1899,46,20-24,1945,0.01878394063678696
SIM,1885,48,35-39,1933,1
SIM,1864,28,45-49,1892,3
STAT,1857,16,45-49,1873,0.12157735390768903
STAT,1909,18,35-39,1927,1.6584437046041702
STAT,1854,35,35-39,1889,11.008604021163436
SIM,1910,31,na,1941,7669
SIM,1911,38,45-49,1949,2
STAT,1847,45,45-49,1892,0.3633311731994385
STAT,1856,28,45-49,1884,1.7799224668230786
SIM,1912,26,45-49,1938,4
STAT,1891,31,30-34,1922,43.764246383848075
STAT,1816,41,35-39,1857,10.386561721006517
STAT,1836,27,50-100,1863,1.1008000720855255
STAT,1855,44,40-44,1899,3.345977969615982
SIM,1876,11,na,1887,5633
SIM,1795,90,na,1885,50
STAT,1807,98,na,1905,2.5930097216387296
STAT,1825,53,45-49,1878,0.02974016865306554
STAT,1843,51,20-24,1894,0.0010386363675033974
SIM,1860,33,50-100,1893,1
SIM,1864,32,40-44,1896,10
STAT,1904,26,45-49,1930,3.2295247298322094
STAT,1928,17,40-44,1945,3.5588846452042757
SIM,1801,55,na,1856,2293
SIM,1904,41,50-100,1945,1
STAT,1890,44,na,1934,5620.659962114579
STAT,1883,32,35-39,1915,20.09486743955382
STAT,1810,87,na,1897,159.32957823268526
SIM,1879,88,na,1967,546
STAT,1803,54,20-24,1857,0.005207099815907941
STAT,1887,42,20-24,1929,0.3582840627425053
STAT,1891,24,50-100,1915,1.011627814315463
SIM,1929,30,35-39,1959,30
STAT,1839,45,na,1884,3672.155171759255
STAT,1865,41,30-34,1906,2.118968838446386
STAT,1836,44,30-34,1880,1.7728404340834456
STAT,1875,41,40-44,1916,4.698197737309219
SIM,1858,30,na,1888,4127
STAT,1814,46,45-49,1860,1.2418159678317293
STAT,1916,34,15-19,1950,0.26565042283153517
STAT,1842,31,35-39,1873,18.40389030693204
SIM,1839,26,45-49,1865,2
STAT,1852,17,20-24,1869,34.17445802574343
STAT,1885,40,20-24,1925,0.32248269245010497
STAT,1863,42,35-39,1905,3.1973975220665034
STAT,1870,82,na,1952,925.1523575848087
SIM,1905,25,50-100,1930,4
STAT,1861,53,30-34,1914,0.009845624017194457
STAT,1870,45,20-24,1915,0.024031143161410813
SIM,1911,47,35-39,1958,1
SIM,1873,41,30-34,1914,3
STAT,1842,49,25-29,1891,0.08396519503348411
STAT,1925,45,20-24,1970,0.02716707246379213
STAT,1924,40,35-39,1964,0.4849473305490906
SIM,1883,41,40-44,1924,6
STAT,1903,47,35-39,1950,0.22602923768551714
SIM,1861,34,na,1895,4505
SIM,1901,21,15-19,1922,11
SIM,1822,46,45-49,1868,2
STAT,1892,37,20-24,1929,1.948934080433536
STAT,1933,22,na,1955,9783.92124863302
STAT,1855,51,40-44,1906,0.015950960469620735
STAT,1936,15,25-29,1951,84.1980240849431
STAT,1805,54,na,1859,2491.290797543305
SIM,1877,28,30-34,1905,56
SIM,1878,32,50-100,1910,5
STAT,1808,50,40-44,1858,0.0650913085717174
SIM,1875,63,na,1938,3946
SIM,1954,1,na,1955,9939
SIM,1803,99,na,1902,2
SIM,1901,25,30-34,1926,89
SIM,1846,61,na,1907,2929
STAT,1871,17,30-34,1888,3.2187776338239202
STAT,1959,1,na,1960,10400.251899808072
STAT,1835,20,na,1855,3675.654790391498
SIM,1844,44,30-34,1888,4
STAT,1945,24,40-44,1969,7.436848931669405
STAT,1812,53,35-39,1865,0.055939635042519455
SIM,1850,31,35-39,1881,25
STAT,1923,32,40-44,1955,9.057604237644243
SIM,1885,63,na,1948,3742
STAT,1847,20,50-100,1867,0.77309750546573
STAT,1860,41,20-24,1901,0.26164507670247633
STAT,1814,52,30-34,1866,0.029559211550937797
SIM,1914,39,25-29,1953,3
STAT,1858,48,25-29,1906,0.08954701571628
STAT,1881,37,45-49,1918,3.891448072118904
STAT,1898,17,45-49,1915,0.17853213685938657
SIM,1931,32,40-44,1963,15
STAT,1832,87,na,1919,229.69003596460595
STAT,1837,28,35-39,1865,17.141014585267353
SIM,1849,21,35-39,1870,15
STAT,1914,45,45-49,1959,0.4374477467895629
SIM,1842,43,50-100,1885,7
STAT,1842,42,15-19,1884,0.021271833225449746
STAT,1840,36,45-49,1876,3.4388774300845664
STAT,1909,17,30-34,1926,4.830038883077033
SIM,1890,42,45-49,1932,9
SIM,1840,43,35-39,1883,7
STAT,1828,45,35-39,1873,0.2588919087707821
STAT,1804,91,na,1895,38.982591085336146
SIM,1831,33,40-44,1864,13
SIM,1871,12,na,1883,5132
STAT,1824,46,na,1870,2809.817438049153
SIM,1880,31,20-24,1911,11
SIM,1904,56,na,1960,6191
STAT,1817,98,na,1915,3.27656127788046
STAT,1927,32,25-29,1959,22.958626809537733
SIM,1873,47,50-100,1920,2
STAT,1898,40,30-34,1938,0.22039862134786897
STAT,1908,55,na,1963,6503.848971988283
SIM,1895,16,30-34,1911,7
STAT,1822,87,na,1909,198.9227870815994
SIM,1874,34,50-100,1908,2
STAT,1847,64,na,1911,2649.852453921843
SIM,1868,31,20-24,1899,9
STAT,1848,50,45-49,1898,0.024138070529840495
STAT,1849,51,40-44,1900,0.016732294009900266
STAT,1875,11,na,1886,5440.519031367441
STAT,1911,46,30-34,1957,0.1709181058057498
SIM,1865,42,35-39,1907,10
SIM,1860,17,20-24,1877,37
STAT,1907,48,30-34,1955,0.16004569784739808
STAT,1889,62,na,1951,4551.476129713631
SIM,1905,42,40-44,1947,1
STAT,1890,59,na,1949,4790.942178614694
SIM,1870,37,35-39,1907,18
STAT,1825,46,20-24,1871,0.026383251605048688
STAT,1838,97,na,1935,7.270615989544016
STAT,1865,15,40-44,1880,0.3845407772798091
STAT,1865,47,50-100,1912,0.44852878075722136
STAT,1850,30,30-34,1880,31.420050562077567
SIM,1850,13,na,1863,4623
STAT,1925,39,35-39,1964,5.849341128574546
SIM,1915,19,na,1934,8201
STAT,1901,23,15-19,1924,9.298736102847354
STAT,1791,72,na,1863,1096.0924751278908
STAT,1853,54,35-39,1907,0.013246690156827709
STAT,1882,42,45-49,1924,2.940859768805311
SIM,1936,18,na,1954,6362
STAT,1773,91,na,1864,32.54866771455354
STAT,1880,51,25-29,1931,0.007571947411259855
STAT,1837,86,na,1923,309.24115597993426
STAT,1931,30,25-29,1961,24.487926069884704
STAT,1839,33,50-100,1872,1.7423952796299746
STAT,1912,25,40-44,1937,9.342095730106141
SIM,1833,53,45-49,1886,2
STAT,1944,19,40-44,1963,3.0377694366105987
SIM,1916,41,na,1957,7802
STAT,1860,50,45-49,1910,0.02414359958873433
STAT,1918,49,45-49,1967,0.4642843133333658
STAT,1932,26,20-24,1958,48.31216412128187
SIM,1902,16,25-29,1918,22
STAT,1822,72,na,1894,1425.9135928288529
STAT,1875,21,45-49,1896,1.4543543170042306
STAT,1905,40,25-29,1945,0.13155972528044912
STAT,1835,52,25-29,1887,0.004677237506125333
SIM,1852,79,na,1931,1055
SIM,1917,18,35-39,1935,1
STAT,1879,41,25-29,1920,1.362680068208544
SIM,1862,35,35-39,1897,19
STAT,1918,33,na,1951,8081.1108934242875
SIM,1830,73,na,1903,1423
SIM,1858,15,15-19,1873,11
STAT,1868,63,na,1931,3428.5877005052857
SIM,1935,32,25-29,1967,33
STAT,1854,12,na,1866,4377.760113441755
SIM,1823,31,40-44,1854,9
STAT,1877,48,35-39,1925,0.2899130277461796
STAT,1877,77,na,1954,1812.7670810989434
STAT,1832,43,35-39,1875,2.8510585320583934
STAT,1837,34,50-100,1871,1.5685877369061936
STAT,1887,16,30-34,1903,3.609062828146215
STAT,1847,51,30-34,1898,0.009117134523329538
STAT,1877,54,20-24,1931,0.0015049775380572199
SIM,1952,19,40-44,1971,6
STAT,1831,53,45-49,1884,0.01915562705384581
SIM,1940,26,20-24,1966,40
SIM,1885,41,na,1926,4890
SIM,1845,34,50-100,1879,3
SIM,1920,25,40-44,1945,17
STAT,1892,44,45-49,1936,0.2592183601969157
STAT,1794,90,na,1884,63.90021881672876
SIM,1843,41,45-49,1884,9
STAT,1802,99,na,1901,1.4535102351349316
STAT,1896,48,45-49,1944,0.3505045356974169
SIM,1836,23,15-19,1859,6
SIM,1859,35,50-100,1894,4
STAT,1921,37,na,1958,8481.957243777373
STAT,1873,44,35-39,1917,3.6657339442697143
SIM,1894,77,na,1971,3075
STAT,1816,52,15-19,1868,1.1593602484245982E-4
STAT,1901,45,35-39,1946,0.225508046786597
STAT,1876,92,na,1968,298.9070078710773
SIM,1890,22,40-44,1912,8
STAT,1815,51,45-49,1866,0.07621740362936562
STAT,1838,40,25-29,1878,1.0427698705588413
STAT,1854,34,na,1888,3669.2049969034115
STAT,1897,49,15-19,1946,5.964104940202801E-4
STAT,1881,30,35-39,1911,19.927760811212558
SIM,1869,17,40-44,1886,2
SIM,1841,36,50-100,1877,4
SIM,1910,37,40-44,1947,6
STAT,1867,28,20-24,1895,22.11104973004813
SIM,1909,25,25-29,1934,142
SIM,1864,52,45-49,1916,1
SIM,1891,32,35-39,1923,32
SIM,1806,69,na,1875,1482
STAT,1922,47,45-49,1969,0.5041242870517837
SIM,1879,4,na,1883,5705
STAT,1840,42,30-34,1882,1.731076985617004
STAT,1841,21,40-44,1862,3.8578216080919367
STAT,1913,16,50-100,1929,0.15512460634354114
SIM,1824,41,35-39,1865,7
STAT,1933,38,30-34,1971,5.009109023234658
SIM,1871,18,35-39,1889,2
SIM,1884,0,na,1884,7428
SIM,1919,26,50-100,1945,5
SIM,1921,16,35-39,1937,11
STAT,1882,22,40-44,1904,4.099678581832577
STAT,1856,52,45-49,1908,0.022493383923047127
SIM,1927,34,40-44,1961,12
STAT,1951,3,na,1954,9503.702566265922
STAT,1856,78,na,1934,1217.5008899018214
STAT,1879,48,50-100,1927,0.5123053319118771
STAT,1878,50,30-34,1928,0.012736147627582897
SIM,1873,78,na,1951,1390
STAT,1914,38,20-24,1952,0.5290141633809871
SIM,1922,38,20-24,1960,2
STAT,1855,24,50-100,1879,0.7081016101835206
STAT,1835,41,45-49,1876,2.3535856258311525
SIM,1917,17,30-34,1934,6
STAT,1821,42,20-24,1863,0.5049343617262055
SIM,1881,44,35-39,1925,9
STAT,1919,18,na,1937,8191.640868394237
SIM,1863,24,50-100,1887,2
SIM,1891,59,na,1950,5208
STAT,1835,79,na,1914,905.440471866403
SIM,1854,86,na,1940,304
STAT,1859,50,20-24,1909,0.0012032435881259153
STAT,1844,18,25-29,1862,11.564327847887654
STAT,1806,53,35-39,1859,0.049238553909445947
SIM,1923,29,15-19,1952,1
STAT,1895,36,35-39,1931,18.702903117314055
STAT,1883,43,15-19,1926,0.02720452780061812
STAT,1843,34,20-24,1877,4.458530713035496
STAT,1866,47,20-24,1913,0.022257505841536334
SIM,1921,16,50-100,1937,1
STAT,1836,31,na,1867,3680.229467836145
SIM,1851,34,20-24,1885,6
STAT,1849,51,50-100,1900,0.0240038049405977
SIM,1879,43,40-44,1922,8
STAT,1821,36,35-39,1857,29.50479303891427
SIM,1907,49,35-39,1956,1
STAT,1820,52,30-34,1872,0.02130331589068984
STAT,1920,45,45-49,1965,0.487381702443025
SIM,1800,70,na,1870,1407
SIM,1869,22,15-19,1891,5
SIM,1861,40,50-100,1901,1
STAT,1859,96,na,1955,13.802959113507427
STAT,1833,36,50-100,1869,2.0429234560445986
STAT,1902,37,40-44,1939,2.694081662376681
STAT,1839,25,40-44,1864,5.97795651170818
STAT,1915,29,15-19,1944,1.443964278437767
STAT,1868,41,na,1909,4461.2031588693135
SIM,1852,18,25-29,1870,18
SIM,1846,40,25-29,1886,3
SIM,1886,26,na,1912,4984
STAT,1872,31,20-24,1903,5.508929173513046
STAT,1881,38,50-100,1919,2.384766258168717
STAT,1908,32,15-19,1940,0.24513891768675045
STAT,1863,16,50-100,1879,0.0994189006201871
SIM,1838,39,45-49,1877,7
SIM,1858,24,na,1882,4088
SIM,1853,49,40-44,1902,1
STAT,1859,37,15-19,1896,0.09026785072932735
STAT,1879,39,40-44,1918,9.154303793759283
STAT,1856,36,35-39,1892,11.074328165385593
STAT,1906,5,na,1911,7712.392937557276
STAT,1824,30,30-34,1854,112.0439204603749
SIM,1855,36,40-44,1891,15
SIM,1935,15,25-29,1950,140
STAT,1788,101,na,1889,0.2910157053493948
SIM,1937,21,40-44,1958,9
STAT,1886,16,25-29,1902,12.110811084800332
STAT,1829,98,na,1927,3.8446780535927534
SIM,1890,23,30-34,1913,54
STAT,1874,22,50-100,1896,0.8432758265721451
STAT,1892,39,na,1931,5896.656809683879
STAT,1834,43,20-24,1877,0.251609887126183
SIM,1844,22,20-24,1866,132
STAT,1845,13,na,1858,4628.294742363352
STAT,1915,37,na,1952,7676.368696014298
STAT,1945,17,40-44,1962,3.0855812053810343
SIM,1894,62,na,1956,4894
SIM,1823,32,30-34,1855,42
SIM,1924,9,na,1933,9980
STAT,1763,91,na,1854,16.0
STAT,1820,41,25-29,1861,2.6730288033083327
STAT,1890,27,50-100,1917,1.576941487650901
SIM,1894,16,25-29,1910,15
SIM,1919,32,30-34,1951,48
SIM,1888,42,30-34,1930,2
STAT,1945,18,50-100,1963,0.8262302864194396
STAT,1873,32,na,1905,4896.8442015380515
STAT,1833,41,35-39,1874,2.926872106483926
STAT,1877,46,na,1923,4731.668087839957
STAT,1770,89,na,1859,59.01964913499639
STAT,1899,61,na,1960,5400.413589207856
SIM,1800,85,na,1885,127
SIM,1827,32,na,1859,3515
STAT,1817,46,25-29,1863,0.28256537307390794
STAT,1788,99,na,1887,0.7585747553435187
STAT,1891,21,30-34,1912,44.60051222394033
STAT,1790,93,na,1883,12.88788881200523
STAT,1887,45,25-29,1932,0.13140356242227036
SIM,1846,39,na,1885,3694
STAT,1927,22,na,1949,9085.307971040396
SIM,1835,51,na,1886,3016
SIM,1887,39,40-44,1926,17
SIM,1901,43,25-29,1944,3
STAT,1854,20,15-19,1874,6.028480651126555
STAT,1929,21,40-44,1950,8.612449746375816
STAT,1836,22,20-24,1858,120.9497953625377
SIM,1900,21,45-49,1921,3
SIM,1903,22,25-29,1925,182
STAT,1820,54,30-34,1874,0.020471585205993383
SIM,1864,42,45-49,1906,6
SIM,1949,22,15-19,1971,11
STAT,1865,34,35-39,1899,18.422169238343578
SIM,1924,44,50-100,1968,1
STAT,1780,108,na,1888,0.009552737533145426
STAT,1910,40,20-24,1950,0.034103050465661956
SIM,1833,22,45-49,1855,1
STAT,1852,18,20-24,1870,33.973170467971805
SIM,1825,39,35-39,1864,17
STAT,1879,31,30-34,1910,37.03398171703188
STAT,1881,51,na,1932,4223.268850480114
STAT,1889,31,na,1920,5966.754870453787
SIM,1860,18,20-24,1878,32
STAT,1882,23,30-34,1905,34.93554120227772
STAT,1902,49,35-39,1951,0.22047404422420172
STAT,1807,49,50-100,1856,1.6253342054371265
SIM,1835,26,15-19,1861,1
SIM,1872,32,25-29,1904,24
SIM,1935,33,25-29,1968,30
STAT,1882,41,30-34,1923,2.272087811382591
STAT,1843,41,20-24,1884,0.23200955033175133
SIM,1812,70,na,1882,1421
STAT,1847,43,30-34,1890,1.7398278066993287
STAT,1850,20,30-34,1870,33.255979061359696
SIM,1825,45,50-100,1870,2
SIM,1945,16,na,1961,8433
SIM,1823,66,na,1889,1767
SIM,1870,48,na,1918,4347
SIM,1949,15,25-29,1964,136
STAT,1832,50,na,1882,3020.776311432626
STAT,1840,40,40-44,1880,3.8183282243171996
STAT,1887,76,na,1963,2664.6010380505268
STAT,1901,42,20-24,1943,0.031142692241313715
STAT,1958,14,na,1972,10413.999175608835
SIM,1824,34,50-100,1858,1
STAT,1879,57,na,1936,4245.2994927140935
STAT,1894,17,15-19,1911,15.396579621609805
STAT,1817,39,35-39,1856,44.11803579677698
SIM,1849,39,20-24,1888,2
STAT,1895,75,na,1970,3573.749930325179
STAT,1888,37,40-44,1925,10.449384309446305
STAT,1891,81,na,1972,2323.774899401885
STAT,1850,39,20-24,1889,1.1759586269424633
SIM,1841,41,35-39,1882,2
SIM,1861,0,na,1861,6725
SIM,1842,36,30-34,1878,14
SIM,1865,32,50-100,1897,2
SIM,1815,47,na,1862,2654
STAT,1826,44,25-29,1870,1.3024992382484346
STAT,1834,36,30-34,1870,8.916601622849479
STAT,1917,19,30-34,1936,26.259728037020523
STAT,1933,30,45-49,1963,4.288090631896998
STAT,1870,48,35-39,1918,0.27410781441854
SIM,1855,43,30-34,1898,4
SIM,1916,19,na,1935,7936
STAT,1847,52,45-49,1899,0.022004113733488772
SIM,1841,67,na,1908,2181
STAT,1927,15,25-29,1942,109.31026490475155
STAT,1890,18,40-44,1908,0.44970324197211076
STAT,1909,42,20-24,1951,0.03337886341663774
STAT,1841,18,45-49,1859,0.12151922311035011
SIM,1885,10,na,1895,5417
STAT,1847,36,40-44,1883,6.995602526781388
STAT,1809,53,50-100,1862,0.10910708129522358
STAT,1944,25,25-29,1969,143.78944273784595
SIM,1872,20,30-34,1892,50
SIM,1917,42,20-24,1959,1
STAT,1876,53,25-29,1929,0.00727997293526534
SIM,1808,65,na,1873,1787
SIM,1851,41,20-24,1892,2
SIM,1894,37,50-100,1931,7
STAT,1862,84,na,1946,574.2436150194022
SIM,1890,41,30-34,1931,6
STAT,1862,53,25-29,1915,0.00601605656587286
SIM,1920,24,na,1944,8313
STAT,1897,37,35-39,1934,19.094355330376594
SIM,1891,26,na,1917,6177
STAT,1952,3,na,1955,9519.817034347794
SIM,1882,45,na,1927,4703
STAT,1820,53,na,1873,2619.477991240657
STAT,1950,22,45-49,1972,2.6956199154871276
STAT,1882,50,45-49,1932,0.028961974723104345
SIM,1834,44,25-29,1878,2
STAT,1831,33,25-29,1864,17.093984244025012
SIM,1831,27,40-44,1858,4
STAT,1807,54,15-19,1861,1.5385842697999703E-4
SIM,1890,32,45-49,1922,9
SIM,1836,23,25-29,1859,108
SIM,1876,29,40-44,1905,5
SIM,1920,46,50-100,1966,1
SIM,1869,25,30-34,1894,66
STAT,1861,18,15-19,1879,11.398755947173303
SIM,1841,23,35-39,1864,16
STAT,1870,18,40-44,1888,0.3639634723479687
STAT,1871,39,40-44,1910,8.695122860798575
STAT,1866,39,30-34,1905,9.831603386552136
STAT,1919,27,40-44,1946,10.169110809589318
SIM,1837,62,na,1899,2385
STAT,1837,81,na,1918,753.693514348889
SIM,1882,77,na,1959,1869
STAT,1815,50,30-34,1865,0.03189334932312095
SIM,1840,14,na,1854,4840
STAT,1830,79,na,1909,965.3826468253621
SIM,1936,24,30-34,1960,57
SIM,1851,36,25-29,1887,8
SIM,1853,15,25-29,1868,21
SIM,1900,38,50-100,1938,2
SIM,1901,5,na,1906,7478
SIM,1845,48,50-100,1893,1
STAT,1828,30,15-19,1858,0.33940392333919195
SIM,1927,27,40-44,1954,16
SIM,1845,24,50-100,1869,1
STAT,1927,33,25-29,1960,22.944392460915818
SIM,1908,3,na,1911,7989
STAT,1854,47,40-44,1901,0.2612238786701032
SIM,1930,1,na,1931,11291
SIM,1941,30,45-49,1971,5
STAT,1843,36,25-29,1879,4.7575852121514055
STAT,1860,33,20-24,1893,4.414531971330906
SIM,1823,41,45-49,1864,4
SIM,1889,34,45-49,1923,9
STAT,1935,1,na,1936,11532.07214776865
STAT,1874,45,15-19,1919,8.354117107441587E-4
SIM,1862,47,40-44,1909,1
STAT,1850,112,na,1962,1.4654009083856995E-4
STAT,1833,23,35-39,1856,10.380573782545994
STAT,1782,74,na,1856,857.1010179564003
STAT,1890,28,na,1918,5862.44323078249
STAT,1828,45,na,1873,3141.256357979773
STAT,1845,15,25-29,1860,11.167735173626548
SIM,1874,39,30-34,1913,10
STAT,1861,47,na,1908,3764.3693438523483
SIM,1787,86,na,1873,134
SIM,1873,31,30-34,1904,4
SIM,1906,42,45-49,1948,1
STAT,1818,38,40-44,1856,27.159360391362302
STAT,1949,16,50-100,1965,0.8802095388095725
STAT,1814,50,40-44,1864,0.054409844869816155
STAT,1949,17,25-29,1966,101.78241681194328
STAT,1885,19,15-19,1904,11.866225513352353
STAT,1835,28,15-19,1863,0.7606805310371189
STAT,1933,28,30-34,1961,105.03427718102257
SIM,1837,17,35-39,1854,1
STAT,1843,29,35-39,1872,16.396319965697842
SIM,1883,44,20-24,1927,1
SIM,1813,43,25-29,1856,2
SIM,1889,29,50-100,1918,2
SIM,1941,28,30-34,1969,85
STAT,1864,20,30-34,1884,33.148087567923625
STAT,1860,29,35-39,1889,15.765744289034826
STAT,1920,21,20-24,1941,250.35603375578114
STAT,1881,67,na,1948,3094.4740479983748
SIM,1826,28,15-19,1854,1
STAT,1848,65,na,1913,2771.043776171725
SIM,1925,19,30-34,1944,35
STAT,1828,50,50-100,1878,0.02733551721777356
STAT,1858,44,20-24,1902,0.24666310187481535
SIM,1857,47,30-34,1904,1
STAT,1806,107,na,1913,0.0032111665192458803
SIM,1918,19,50-100,1937,1
STAT,1824,49,20-24,1873,0.028257067424581252
SIM,1806,54,na,1860,2445
STAT,1852,20,50-100,1872,0.7833068397369534
STAT,1872,34,25-29,1906,20.611834709917964
SIM,1880,34,25-29,1914,29
STAT,1828,105,na,1933,0.036007415940615926
STAT,1893,40,na,1933,5976.191472133659
SIM,1838,46,35-39,1884,1
STAT,1929,5,na,1934,10362.328069417958
SIM,1817,44,25-29,1861,2
STAT,1839,44,35-39,1883,2.904626334518095
STAT,1894,25,50-100,1919,1.670875274042119
STAT,1867,29,20-24,1896,22.03056550903075
STAT,1875,44,20-24,1919,0.3257706681944078
SIM,1851,29,35-39,1880,25
STAT,1861,31,na,1892,4027.802063364871
SIM,1846,35,na,1881,3878
STAT,1918,40,20-24,1958,0.03802074234187087
STAT,1841,25,35-39,1866,17.640989000588522
STAT,1883,19,50-100,1902,0.0966919455562958
SIM,1914,24,na,1938,7590
STAT,1775,92,na,1867,16.146647198543548
STAT,1808,53,20-24,1861,0.00429056453022709
SIM,1831,31,25-29,1862,28
SIM,1911,21,20-24,1932,209
SIM,1897,35,35-39,1932,29
STAT,1777,108,na,1885,0.009042519486612239
SIM,1826,38,40-44,1864,11
SIM,1847,44,35-39,1891,7
STAT,1858,79,na,1937,1100.684117796076
STAT,1878,18,40-44,1896,0.3847867558629908
STAT,1931,40,50-100,1971,0.3178587549298125
STAT,1890,22,25-29,1912,141.11935919168937
STAT,1809,78,na,1887,717.8558557343684
SIM,1859,33,20-24,1892,5
STAT,1854,65,na,1919,2590.69103816184
STAT,1864,41,40-44,1905,4.079012453633864
SIM,1883,8,na,1891,5399
SIM,1886,63,na,1949,3597
SIM,1861,16,15-19,1877,17
STAT,1861,42,25-29,1903,1.0781423580341853
SIM,1893,29,40-44,1922,10
STAT,1855,38,40-44,1893,6.568246088418242
STAT,1833,44,15-19,1877,0.021478644443307514
STAT,1853,16,15-19,1869,11.362066257795119
STAT,1960,8,na,1968,10335.79442152001
STAT,1798,89,na,1887,74.33948705270633
SIM,1869,30,50-100,1899,5
STAT,1879,16,35-39,1895,1.161982363645374
STAT,1935,17,25-29,1952,119.6682137325248
SIM,1887,31,30-34,1918,67
STAT,1867,45,25-29,1912,0.1100322013875284
STAT,1899,48,25-29,1947,0.08877795364888072
SIM,1856,29,na,1885,4118
STAT,1903,21,20-24,1924,198.76044480271733
SIM,1829,27,na,1856,3602
STAT,1889,35,35-39,1924,17.7804963084067
STAT,1856,84,na,1940,518.3678220210737
STAT,1807,49,20-24,1856,0.07941372653689059
SIM,1894,30,na,1924,6434
SIM,1888,37,35-39,1925,20
SIM,1872,41,40-44,1913,10
STAT,1885,29,40-44,1914,5.9789305162677415
SIM,1862,20,15-19,1882,5
STAT,1856,51,30-34,1907,0.009319857622768416
SIM,1932,32,45-49,1964,3
SIM,1855,71,na,1926,2197
STAT,1820,49,35-39,1869,0.5060748206533447
STAT,1879,41,na,1920,4904.532988307913
SIM,1879,47,35-39,1926,1
STAT,1880,37,40-44,1917,9.313456854157028
STAT,1809,101,na,1910,0.5071782127504069
STAT,1833,39,20-24,1872,1.2431733868710728
STAT,1842,64,na,1906,2588.0930410640794
STAT,1907,38,30-34,1945,3.3976969433241653
STAT,1823,31,25-29,1854,66.95391739064817
SIM,1846,38,40-44,1884,12
SIM,1860,34,na,1894,4130
SIM,1852,18,15-19,1870,11
SIM,1900,37,30-34,1937,3
SIM,1926,17,25-29,1943,121
SIM,1915,32,45-49,1947,5
SIM,1906,36,50-100,1942,2
STAT,1894,19,40-44,1913,0.4719783415542927
STAT,1844,28,40-44,1872,5.879492268114249
STAT,1870,45,30-34,1915,0.19385121432773658
SIM,1814,89,na,1903,74
STAT,1827,28,40-44,1855,12.38362976300829
STAT,1848,34,35-39,1882,17.259846892255837
SIM,1835,28,40-44,1863,10
STAT,1813,46,40-44,1859,1.0748965082358268
STAT,1838,30,30-34,1868,29.97897241824724
STAT,1891,16,35-39,1907,1.3731519026179928
STAT,1831,92,na,1923,53.775561595703145
STAT,1769,92,na,1861,14.051727902299007
STAT,1803,54,30-34,1857,0.04200393696045163
STAT,1809,90,na,1899,70.07459636705528
STAT,1838,54,45-49,1892,0.01910106434247729
STAT,1890,31,40-44,1921,10.734371303217028
STAT,1838,38,40-44,1876,7.075013766834297
STAT,1951,7,na,1958,9452.312092729928
SIM,1878,44,na,1922,4991
SIM,1832,30,30-34,1862,45
STAT,1918,17,25-29,1935,19.108844124945787
SIM,1835,40,50-100,1875,3
SIM,1924,5,na,1929,10049
STAT,1924,32,45-49,1956,3.7067154281016372
SIM,1799,71,na,1870,1080
SIM,1842,43,20-24,1885,1
STAT,1924,38,30-34,1962,4.334875866285694
STAT,1823,40,40-44,1863,7.87478126345103
STAT,1894,0,na,1894,7618.022059038953
SIM,1932,38,30-34,1970,11
STAT,1833,28,na,1861,3720.312019242434
STAT,1882,19,45-49,1901,0.12782607800281237
STAT,1907,32,45-49,1939,2.9722294481918023
SIM,1953,5,na,1958,9964
STAT,1881,41,40-44,1922,4.410636442388027
STAT,1920,34,50-100,1954,1.8129353512293633
SIM,1887,43,25-29,1930,4
STAT,1937,22,30-34,1959,56.53711700425528
SIM,1831,40,40-44,1871,5
SIM,1915,38,30-34,1953,7
STAT,1870,16,15-19,1886,11.949666842468659
SIM,1914,49,50-100,1963,1
STAT,1850,44,15-19,1894,0.02088838232854727
STAT,1866,31,50-100,1897,1.7143825446576426
SIM,1926,35,25-29,1961,4
STAT,1884,34,20-24,1918,5.344477810771424
STAT,1929,24,45-49,1953,2.8553899316574793
STAT,1827,87,na,1914,213.04386236475557
STAT,1875,37,30-34,1912,11.082065957546662
STAT,1772,113,na,1885,7.849593645942855E-4
STAT,1830,46,40-44,1876,0.2993697537734559
SIM,1883,37,30-34,1920,17
STAT,1829,48,40-44,1877,0.26661660264988707
SIM,1856,34,35-39,1890,24
SIM,1846,30,30-34,1876,45
SIM,1902,31,20-24,1933,11
SIM,1945,22,30-34,1967,79
STAT,1879,43,25-29,1922,1.3467426799492024
SIM,1882,21,30-34,1903,51
STAT,1900,26,50-100,1926,1.7983281625584329
SIM,1837,22,30-34,1859,34
STAT,1817,44,50-100,1861,5.306859883970966
STAT,1808,46,30-34,1854,0.6302246800666913
STAT,1902,62,na,1964,5618.458430626176
SIM,1820,40,50-100,1860,6
STAT,1817,43,20-24,1860,0.8292444694831215
SIM,1892,34,20-24,1926,11
STAT,1918,35,25-29,1953,2.1154992967402397
STAT,1873,26,40-44,1899,6.168160348733968
SIM,1832,25,35-39,1857,21
STAT,1870,52,20-24,1922,0.0014553774800357582
STAT,1834,45,na,1879,3252.970531333876
STAT,1838,59,na,1897,2630.220449692202
SIM,1823,35,35-39,1858,18
SIM,1891,39,30-34,1930,18
STAT,1935,35,25-29,1970,2.785935929285803
SIM,1866,6,na,1872,5453
SIM,1831,37,50-100,1868,4
SIM,1936,32,30-34,1968,36
SIM,1926,32,20-24,1958,10
STAT,1832,33,45-49,1865,2.931714425759368
SIM,1870,49,40-44,1919,1
STAT,1942,20,45-49,1962,2.3843047025226265
SIM,1820,47,35-39,1867,1
SIM,1855,39,45-49,1894,7
SIM,1776,86,na,1862,98
STAT,1916,54,na,1970,7411.554224922041
SIM,1863,30,30-34,1893,38
STAT,1849,47,30-34,1896,0.152404226537345
SIM,1918,15,25-29,1933,22
STAT,1841,30,30-34,1871,31.381267405166213
STAT,1856,33,30-34,1889,27.254977240516766
SIM,1867,39,40-44,1906,12
STAT,1902,46,30-34,1948,0.15613484103389885
SIM,1838,36,40-44,1874,15
STAT,1851,50,45-49,1901,0.022820181851031362
STAT,1928,32,30-34,1960,39.780766390984624
SIM,1910,46,30-34,1956,1
STAT,1918,32,20-24,1950,5.233843278935954
SIM,1864,33,30-34,1897,34
STAT,1910,43,25-29,1953,0.135531259808563
STAT,1882,26,35-39,1908,19.048415327212705
SIM,1881,42,45-49,1923,5
STAT,1900,43,15-19,1943,0.0026673018090399275
SIM,1944,23,25-29,1967,191
STAT,1808,49,35-39,1857,0.8479144649478338
STAT,1839,36,35-39,1875,13.335304500553553
STAT,1953,19,40-44,1972,3.41463681717994
SIM,1824,48,30-34,1872,1
STAT,1893,27,25-29,1920,108.28647876124138
SIM,1893,45,na,1938,5996
SIM,1859,9,na,1868,5036
STAT,1866,23,45-49,1889,1.3006485171775843
SIM,1924,18,na,1942,9173
STAT,1846,30,na,1876,4005.2613138216293
SIM,1855,43,50-100,1898,1
STAT,1827,28,na,1855,3374.4222535540275
STAT,1883,39,30-34,1922,10.468903203145642
SIM,1843,86,na,1929,265
SIM,1871,37,40-44,1908,8
SIM,1807,48,na,1855,2472
SIM,1890,26,35-39,1916,30
STAT,1860,36,25-29,1896,4.744849696402354
SIM,1914,27,50-100,1941,1
STAT,1929,17,na,1946,9486.044304962417
STAT,1933,22,45-49,1955,3.014569871298532
STAT,1865,50,45-49,1915,0.027010189320449712
SIM,1927,34,30-34,1961,48
STAT,1834,46,25-29,1880,0.09050831429829745
STAT,1870,83,na,1953,787.1566319274586
SIM,1873,23,50-100,1896,1
SIM,1866,37,30-34,1903,14
SIM,1788,71,na,1859,1053
STAT,1936,23,25-29,1959,178.3287652125026
SIM,1841,20,30-34,1861,40
STAT,1862,50,20-24,1912,0.0012921023628421648
STAT,1871,61,na,1932,3749.445338287969
SIM,1888,5,na,1893,6134
SIM,1884,29,15-19,1913,1
STAT,1957,9,na,1966,10462.023296080048
STAT,1861,28,40-44,1889,5.035734488690581
STAT,1871,47,40-44,1918,0.34191388447836796
SIM,1943,17,25-29,1960,105
SIM,1941,22,45-49,1963,4
STAT,1866,43,15-19,1909,0.025548438309539692
SIM,1919,35,35-39,1954,6
STAT,1861,47,30-34,1908,0.16196299621264815
STAT,1909,25,na,1934,7281.150307166677
SIM,1834,36,25-29,1870,3
STAT,1815,53,35-39,1868,0.04344151718401655
STAT,1820,49,na,1869,2812.426607558528
STAT,1841,15,40-44,1856,0.3463377201868823
STAT,1862,49,40-44,1911,0.28935530189168207
STAT,1863,37,40-44,1900,7.738990153049844
SIM,1950,20,45-49,1970,4
STAT,1844,18,15-19,1862,12.110883983111467
STAT,1847,39,45-49,1886,3.088042386821579
STAT,1853,18,40-44,1871,0.34606630818675477
STAT,1927,29,40-44,1956,11.396309901539096
SIM,1944,19,50-100,1963,1
STAT,1855,30,30-34,1885,27.369989086766097
STAT,1844,19,50-100,1863,0.09939087870261908
STAT,1876,29,15-19,1905,0.9409474268362813
SIM,1810,45,50-100,1855,1
STAT,1895,36,50-100,1931,3.2465161758427783
STAT,1888,8,na,1896,6205.2861706166
STAT,1846,94,na,1940,30.61285771888938
SIM,1812,54,na,1866,2525
STAT,1806,51,45-49,1857,0.0863989718246787
STAT,1843,50,na,1893,3059.5394514953186
STAT,1834,39,35-39,1873,11.470348461791756
STAT,1832,34,na,1866,3575.2225968582816
STAT,1888,45,45-49,1933,0.5689637016950281
SIM,1928,31,40-44,1959,17
STAT,1848,52,35-39,1900,0.014041188202140854
STAT,1892,3,na,1895,6683.9081840762
SIM,1823,70,na,1893,1449
SIM,1896,25,na,1921,6622
SIM,1866,59,na,1925,3777
STAT,1835,101,na,1936,0.7390384974057917
STAT,1816,48,30-34,1864,0.46838579432448707
STAT,1916,30,45-49,1946,3.3074291443461132
STAT,1932,37,na,1969,10209.74497386977
STAT,1832,51,45-49,1883,0.020073601290356662
STAT,1886,39,na,1925,4972.255687016704
STAT,1802,68,na,1870,1591.6088872661148
STAT,1840,43,45-49,1883,2.224831841788591
SIM,1868,14,na,1882,5169
STAT,1847,46,35-39,1893,0.2140137618082322
STAT,1858,39,20-24,1897,1.2014238803355504
STAT,1826,36,25-29,1862,7.061514176500504
STAT,1850,15,35-39,1865,1.0402971851911125
SIM,1946,22,45-49,1968,5
STAT,1838,42,25-29,1880,1.0163899335359696
STAT,1857,49,30-34,1906,0.14920063788903665
SIM,1811,85,na,1896,203
STAT,1861,99,na,1960,6.8470844258983385
STAT,1897,42,30-34,1939,0.21526143002811893
STAT,1919,34,30-34,1953,34.02839593196492
STAT,1851,102,na,1953,0.45447477337884445
STAT,1911,32,50-100,1943,1.6264739061737725
SIM,1911,24,25-29,1935,217
SIM,1800,69,na,1869,1407
SIM,1824,51,na,1875,2983
SIM,1842,39,35-39,1881,25
SIM,1799,67,na,1866,1408
STAT,1938,22,45-49,1960,2.2493857546372733
STAT,1811,72,na,1883,1261.737891875422
SIM,1873,32,45-49,1905,5
SIM,1948,17,50-100,1965,1
SIM,1864,36,35-39,1900,15
SIM,1869,28,35-39,1897,25
SIM,1908,19,30-34,1927,7
SIM,1840,33,45-49,1873,8
STAT,1838,46,40-44,1884,0.24144870757359868
STAT,1873,42,45-49,1915,3.067408502285301
STAT,1901,45,25-29,1946,0.09278045259880656
STAT,1903,24,25-29,1927,163.58281990679424
STAT,1824,108,na,1932,0.001958361591728039
SIM,1847,36,35-39,1883,18
SIM,1836,20,20-24,1856,124
SIM,1870,42,50-100,1912,5
SIM,1829,82,na,1911,587
SIM,1925,5,na,1930,9819
SIM,1834,29,35-39,1863,21
STAT,1895,48,40-44,1943,0.25094607493121146
STAT,1895,21,15-19,1916,8.70802356746253
STAT,1897,27,40-44,1924,8.086949894978298
STAT,1812,47,35-39,1859,0.9723758457168213
STAT,1936,30,15-19,1966,0.2524209740416831
SIM,1841,51,na,1892,3078
SIM,1815,51,35-39,1866,2
STAT,1846,44,25-29,1890,0.9703210676643808
STAT,1821,48,40-44,1869,0.4939015218636235
SIM,1872,83,na,1955,690
STAT,1889,32,30-34,1921,43.47876187309797
SIM,1806,70,na,1876,1351
SIM,1847,52,na,1899,3247
SIM,1887,80,na,1967,2152
SIM,1922,8,na,1930,9828
STAT,1875,47,25-29,1922,0.11921227275952967
SIM,1900,21,50-100,1921,1
STAT,1879,47,40-44,1926,0.3599700222673833
STAT,1910,32,20-24,1942,4.751634414705255
STAT,1848,17,50-100,1865,0.09958382967845973
STAT,1933,9,na,1942,10763.630912563513
STAT,1829,82,na,1911,552.2045519242669
STAT,1874,42,35-39,1916,3.7399984101505805
STAT,1822,88,na,1910,155.004614149724
STAT,1817,51,20-24,1868,0.0034847126372081873
STAT,1923,15,50-100,1938,0.89234374682731
SIM,1929,21,na,1950,9545
STAT,1864,8,na,1872,5039.616682865975
STAT,1892,23,na,1915,5961.0659043692285
SIM,1898,48,30-34,1946,1
STAT,1881,25,50-100,1906,1.2572033388640484
SIM,1902,39,na,1941,6839
SIM,1854,49,50-100,1903,1
SIM,1899,61,na,1960,5492
SIM,1910,34,50-100,1944,5
STAT,1892,33,15-19,1925,0.35852933211748866
SIM,1864,48,na,1912,4241
SIM,1909,39,40-44,1948,3
SIM,1869,95,na,1964,70
STAT,1891,40,45-49,1931,3.773885206676887
STAT,1814,53,45-49,1867,0.07064010927077684
SIM,1900,27,30-34,1927,79
STAT,1849,18,15-19,1867,11.486914885377345
SIM,1881,34,45-49,1915,5
STAT,1877,40,50-100,1917,2.237902408997673
SIM,1857,18,15-19,1875,10
SIM,1885,40,50-100,1925,4
SIM,1897,32,30-34,1929,65
STAT,1871,43,25-29,1914,1.279189911964962
STAT,1922,23,na,1945,8429.297050310843
STAT,1926,37,na,1963,9284.43786329998
STAT,1825,42,15-19,1867,0.03188309363775869
SIM,1861,48,35-39,1909,1
STAT,1901,38,35-39,1939,4.294931517285182
SIM,1924,30,45-49,1954,6
STAT,1840,69,na,1909,2118.3113369865655
SIM,1824,83,na,1907,434
STAT,1804,52,25-29,1856,0.020712722766595224
STAT,1859,29,15-19,1888,0.7312951517294719
SIM,1860,98,na,1958,5
STAT,1944,22,20-24,1966,242.4561894746972
SIM,1916,51,na,1967,7628
STAT,1876,50,20-24,1926,0.00156356080234405
STAT,1893,35,25-29,1928,7.440391177728396
STAT,1856,54,35-39,1910,0.013046045296962211
STAT,1884,42,20-24,1926,0.31632621043942105
STAT,1804,90,na,1894,53.03753889161375
STAT,1864,32,25-29,1896,18.49107081464534
STAT,1925,43,50-100,1968,0.2867417175641663
SIM,1838,43,30-34,1881,1
SIM,1876,33,na,1909,5130
STAT,1830,41,50-100,1871,1.9204642865189374
STAT,1927,8,na,1935,10013.988667942967
STAT,1860,26,30-34,1886,42.044803906042056
STAT,1817,38,20-24,1855,5.294841952098036
SIM,1816,38,30-34,1854,11
SIM,1928,38,50-100,1966,2
SIM,1840,41,45-49,1881,6
STAT,1886,7,na,1893,5554.469747982353
STAT,1840,14,na,1854,4421.0
STAT,1844,28,na,1872,4245.9224298988265
STAT,1944,22,na,1966,7962.620236995531
STAT,1814,53,na,1867,2401.176449506359
SIM,1895,56,na,1951,5570
STAT,1839,29,45-49,1868,2.152770795876218
SIM,1883,62,na,1945,3741
STAT,1812,54,25-29,1866,0.022557987984283524
SIM,1883,29,30-34,1912,65
SIM,1884,32,20-24,1916,8
STAT,1837,24,30-34,1861,32.04184023441959
SIM,1929,25,50-100,1954,3
STAT,1875,29,30-34,1904,51.98778170958563
STAT,1884,29,20-24,1913,23.228473544107544
SIM,1875,95,na,1970,85
STAT,1937,25,35-39,1962,29.588973015314668
STAT,1897,34,30-34,1931,46.731434161856036
STAT,1898,24,na,1922,6423.420284871335
SIM,1877,24,25-29,1901,134
SIM,1887,76,na,1963,2767
STAT,1838,53,30-34,1891,0.007926863276222551
STAT,1775,88,na,1863,65.78168613696171
SIM,1860,47,50-100,1907,1
STAT,1945,24,30-34,1969,63.56977489996246
SIM,1848,33,45-49,1881,7
STAT,1875,27,na,1902,4962.4208571197305
STAT,1913,21,30-34,1934,56.431300503188815
STAT,1918,43,25-29,1961,0.15306825818072323
STAT,1924,48,30-34,1972,0.2136868218367695
SIM,1921,21,30-34,1942,105
STAT,1832,41,45-49,1873,2.418022655910471
STAT,1823,73,na,1896,1425.304904063694
SIM,1884,19,20-24,1903,37
SIM,1918,33,25-29,1951,27
SIM,1873,68,na,1941,3036
SIM,1910,33,50-100,1943,2
SIM,1847,29,45-49,1876,2
STAT,1901,37,50-100,1938,0.7492456856390333
SIM,1903,6,na,1909,7717
STAT,1823,35,40-44,1858,18.19104760230923
SIM,1882,24,35-39,1906,10
STAT,1910,48,30-34,1958,0.16757257130696368
SIM,1935,29,40-44,1964,16
STAT,1828,51,50-100,1879,0.02679887889098679
STAT,1848,30,50-100,1878,1.788801572673398
STAT,1877,23,20-24,1900,144.07383388265112
STAT,1900,18,25-29,1918,15.834450118742879
SIM,1881,52,45-49,1933,1
STAT,1941,24,50-100,1965,1.3724379061340268
SIM,1872,28,40-44,1900,9
SIM,1873,26,35-39,1899,25
SIM,1885,23,20-24,1908,162
STAT,1834,28,30-34,1862,43.6391882286245
STAT,1905,11,na,1916,7554.198466636675
STAT,1800,102,na,1902,0.2504070306671882
STAT,1897,9,na,1906,7004.580282806346
STAT,1921,45,50-100,1966,0.5172520374540592
STAT,1891,22,45-49,1913,1.7407810887291248
STAT,1853,48,35-39,1901,0.2187249459642507
STAT,1863,32,30-34,1895,30.867046080134983
STAT,1916,49,35-39,1965,0.26550861255097896
SIM,1945,25,35-39,1970,48
SIM,1953,17,40-44,1970,5
STAT,1865,4,na,1869,5538.022858902275
STAT,1868,73,na,1941,2282.298078567573
SIM,1901,21,na,1922,6738
SIM,1856,31,30-34,1887,40
SIM,1879,37,40-44,1916,15
SIM,1879,44,30-34,1923,6
SIM,1830,83,na,1913,395
STAT,1926,42,20-24,1968,0.04396284894645685
SIM,1856,30,50-100,1886,6
STAT,1951,20,50-100,1971,1.5886642266761324
SIM,1816,43,50-100,1859,7
STAT,1865,19,45-49,1884,0.12205720554921672
STAT,1873,34,45-49,1907,3.547783992897394
STAT,1869,31,15-19,1900,0.27982208298142924
STAT,1890,26,40-44,1916,7.409873893515789
SIM,1867,2,na,1869,6162
STAT,1881,44,45-49,1925,2.882127649521597
STAT,1907,1,na,1908,8079.486065328602
STAT,1868,29,40-44,1897,5.714915486924712
SIM,1922,43,45-49,1965,2
STAT,1811,88,na,1899,127.6139361184212
STAT,1837,17,40-44,1854,0.4991677675442003
SIM,1843,18,20-24,1861,33
STAT,1946,21,40-44,1967,7.558630265698452
SIM,1814,43,45-49,1857,3
SIM,1821,49,45-49,1870,1
SIM,1887,9,na,1896,6415
SIM,1883,47,25-29,1930,1
STAT,1809,62,na,1871,2064.881292172643
STAT,1841,40,30-34,1881,1.7783405441491837
STAT,1807,51,35-39,1858,0.05722205165098364
STAT,1867,84,na,1951,629.2073450170551
SIM,1898,19,15-19,1917,13
STAT,1938,22,na,1960,7300.48199934014
SIM,1851,28,20-24,1879,26
SIM,1868,26,25-29,1894,99
SIM,1917,36,na,1953,8102
STAT,1850,20,50-100,1870,0.7613549145618803
STAT,1856,41,30-34,1897,1.7995605437989994
STAT,1817,97,na,1914,5.418580227687674
SIM,1907,42,na,1949,6907
STAT,1863,70,na,1933,2480.495826567593
STAT,1843,28,20-24,1871,20.079297928670865
STAT,1858,52,20-24,1910,0.0011556089780743884
SIM,1860,34,25-29,1894,24
STAT,1867,37,25-29,1904,5.445784366724287
STAT,1900,25,15-19,1925,1.2797277476950253
STAT,1841,22,30-34,1863,32.7396756550928
STAT,1820,46,30-34,1866,0.36547134577974016
SIM,1854,44,25-29,1898,2
STAT,1852,54,na,1906,3337.370094319111
SIM,1875,37,25-29,1912,11
STAT,1848,31,30-34,1879,33.73478167479811
STAT,1865,26,35-39,1891,17.764717674176037
STAT,1830,42,25-29,1872,1.1510661058082161
STAT,1842,38,30-34,1880,9.2119106621766
SIM,1900,32,na,1932,6939
STAT,1873,52,45-49,1925,0.02962175231408298
SIM,1842,28,30-34,1870,53
STAT,1852,34,25-29,1886,16.554948688175244
SIM,1850,38,30-34,1888,12
STAT,1813,49,45-49,1862,1.4062608579644955
SIM,1882,42,35-39,1924,8
SIM,1780,75,na,1855,668
STAT,1842,34,15-19,1876,0.25085953029170294
STAT,1912,24,na,1936,7321.549531465521
STAT,1849,49,20-24,1898,0.018585258829805287
SIM,1881,29,45-49,1910,2
SIM,1884,27,25-29,1911,8
SIM,1888,43,45-49,1931,9
SIM,1950,21,50-100,1971,1
STAT,1851,85,na,1936,424.9584298912214
SIM,1927,23,25-29,1950,260
SIM,1840,35,35-39,1875,19
SIM,1817,70,na,1887,1512
STAT,1931,40,40-44,1971,0.676748299205267
SIM,1820,44,30-34,1864,3
SIM,1913,39,na,1952,7554
STAT,1832,30,40-44,1862,7.530894336118605
SIM,1854,22,30-34,1876,45
SIM,1900,63,na,1963,5589
STAT,1900,31,45-49,1931,4.905500396516214
SIM,1953,18,50-100,1971,1
STAT,1856,45,50-100,1901,0.38651818801001886
STAT,1859,65,na,1924,2716.596465333544
STAT,1837,42,30-34,1879,1.891243389586562
STAT,1921,16,40-44,1937,3.2271046450055647
SIM,1866,39,20-24,1905,2
STAT,1915,36,15-19,1951,0.03937095802807801
SIM,1835,82,na,1917,463
STAT,1855,99,na,1954,2.8558271978158416
STAT,1878,25,30-34,1903,53.47655600151579
SIM,1868,23,20-24,1891,125
STAT,1846,48,40-44,1894,0.2589336912846384
STAT,1823,66,na,1889,1974.5315405583879
SIM,1909,32,20-24,1941,6
SIM,1924,22,45-49,1946,3
SIM,1876,80,na,1956,1351
SIM,1891,1,na,1892,6874
STAT,1878,48,40-44,1926,0.3565748879742963
SIM,1940,17,na,1957,7708
SIM,1794,95,na,1889,8
STAT,1886,37,50-100,1923,2.6174770601334245
SIM,1920,18,40-44,1938,3
STAT,1876,27,25-29,1903,88.36173467696234
STAT,1812,44,30-34,1856,8.448926961425766
SIM,1871,33,na,1904,4629
STAT,1824,31,45-49,1855,9.265510574451893
STAT,1897,45,35-39,1942,0.21532066674928996
STAT,1873,29,45-49,1902,2.2621201367013533
STAT,1854,51,50-100,1905,0.023263097940206687
SIM,1880,10,na,1890,5814
STAT,1937,31,40-44,1968,7.825384321693579
STAT,1903,32,25-29,1935,29.45324780976344
STAT,1881,20,30-34,1901,34.97848811313118
STAT,1881,21,20-24,1902,134.9289250847065
STAT,1907,61,na,1968,6092.819600635908
STAT,1846,22,30-34,1868,33.6637450844719
SIM,1886,25,30-34,1911,60
STAT,1896,60,na,1956,5131.789554775634
SIM,1856,26,35-39,1882,22
SIM,1862,84,na,1946,556
STAT,1945,20,15-19,1965,11.789941443706724
SIM,1896,33,25-29,1929,5
SIM,1840,30,40-44,1870,12
SIM,1790,81,na,1871,385
SIM,1923,29,25-29,1952,175
SIM,1866,50,na,1916,4270
STAT,1920,43,na,1963,8269.067348490178
STAT,1825,49,35-39,1874,0.2953537519945572
STAT,1792,110,na,1902,1.0354169855148669E-4
STAT,1916,44,50-100,1960,0.24233241372639572
SIM,1833,49,35-39,1882,1
STAT,1855,34,25-29,1889,15.403146039556903
STAT,1911,31,20-24,1942,4.817945575409046
SIM,1830,52,na,1882,2648
SIM,1828,32,30-34,1860,44
SIM,1918,37,40-44,1955,5
STAT,1923,41,45-49,1964,0.3933013608848378
STAT,1840,20,20-24,1860,128.33386888357575
SIM,1845,24,30-34,1869,42
STAT,1878,21,15-19,1899,6.97964235317927
STAT,1880,29,40-44,1909,6.327729886141665
SIM,1832,31,45-49,1863,5
SIM,1910,30,20-24,1940,6
STAT,1936,34,30-34,1970,30.872936750596427
SIM,1949,19,40-44,1968,2
STAT,1860,40,45-49,1900,2.4793818049060175
SIM,1893,76,na,1969,3180
SIM,1886,48,40-44,1934,2
STAT,1837,47,40-44,1884,0.24775167873427562
SIM,1825,38,20-24,1863,2
SIM,1833,96,na,1929,7
SIM,1892,45,25-29,1937,1
SIM,1822,53,na,1875,2583
STAT,1851,32,15-19,1883,0.22976940879446345
STAT,1953,4,na,1957,9607.030879722655
SIM,1821,38,40-44,1859,11
STAT,1838,49,45-49,1887,0.3202882077216482
STAT,1873,36,35-39,1909,14.583888626193252
STAT,1921,49,20-24,1970,0.02500706956533116
SIM,1892,29,20-24,1921,36
STAT,1888,42,40-44,1930,5.36255759529114
STAT,1936,6,na,1942,7751.452292472403
STAT,1816,44,15-19,1860,0.07042057916185128
SIM,1857,39,30-34,1896,12
STAT,1943,16,na,1959,7884.889176852288
SIM,1814,45,35-39,1859,1
SIM,1877,21,20-24,1898,141
SIM,1911,32,25-29,1943,21
STAT,1848,102,na,1950,0.48072115312069785
SIM,1857,14,na,1871,4937
SIM,1929,6,na,1935,10667
SIM,1822,37,40-44,1859,7
STAT,1891,13,na,1904,6436.936798379251
STAT,1912,18,40-44,1930,0.5698779162243626
STAT,1919,30,15-19,1949,0.2821947239515554
SIM,1885,57,na,1942,4245
STAT,1851,39,35-39,1890,10.853968947079439
STAT,1918,49,na,1967,7848.041736282225
SIM,1869,3,na,1872,5809
SIM,1927,35,na,1962,9710
STAT,1811,44,50-100,1855,7.631165333678989
SIM,1900,48,35-39,1948,1
STAT,1869,28,40-44,1897,5.841502703410932
SIM,1926,6,na,1932,10182
STAT,1787,73,na,1860,934.6102827779205
STAT,1866,54,20-24,1920,0.0013372835287981345
STAT,1924,40,45-49,1964,0.4008096620053753
STAT,1910,49,45-49,1959,0.40728229513892544
STAT,1953,15,25-29,1968,105.91980819249706
SIM,1845,47,40-44,1892,1
STAT,1841,33,35-39,1874,17.64363754068034
SIM,1843,26,25-29,1869,70
STAT,1852,52,25-29,1904,0.005615243574386772
SIM,1805,85,na,1890,146
STAT,1817,54,25-29,1871,0.015753355138448978
SIM,1929,21,30-34,1950,92
STAT,1869,21,20-24,1890,135.26473062589343
STAT,1838,28,na,1866,3697.4265373472304
SIM,1880,32,35-39,1912,25
SIM,1831,23,25-29,1854,124
STAT,1860,18,30-34,1878,2.9971121231346642
STAT,1881,28,40-44,1909,5.827000704496748
SIM,1843,15,na,1858,4437
SIM,1850,99,na,1949,2
STAT,1900,39,na,1939,6585.690767455745
SIM,1818,48,na,1866,2880
STAT,1896,1,na,1897,7257.661837188776
SIM,1897,27,35-39,1924,38
SIM,1813,41,35-39,1854,9
STAT,1874,49,30-34,1923,0.1959946703120102
SIM,1846,49,45-49,1895,2
STAT,1915,24,50-100,1939,1.3651815402037826
SIM,1882,49,30-34,1931,2
STAT,1864,26,50-100,1890,1.158805857078592
SIM,1844,16,15-19,1860,11
SIM,1864,95,na,1959,27
STAT,1826,29,35-39,1855,41.289567894459644
STAT,1846,49,50-100,1895,0.3683332481816312
SIM,1881,20,50-100,1901,1
STAT,1835,51,na,1886,2898.6802846702844
STAT,1877,93,na,1970,253.63016009215005
SIM,1845,42,30-34,1887,5
SIM,1855,44,na,1899,4015
SIM,1829,51,40-44,1880,1
STAT,1840,109,na,1949,0.0010269497297364185
STAT,1872,46,na,1918,4579.5583652459745
SIM,1777,92,na,1869,13
SIM,1878,41,30-34,1919,4
SIM,1929,16,35-39,1945,12
STAT,1912,46,50-100,1958,0.44021216879417435
STAT,1884,45,25-29,1929,0.11601518253729856
STAT,1942,18,30-34,1960,25.717707153763147
SIM,1889,56,na,1945,5128
STAT,1851,46,25-29,1897,0.08954403063672634
STAT,1857,32,50-100,1889,1.4512556900430251
STAT,1889,27,35-39,1916,24.028078605848663
SIM,1950,18,30-34,1968,33
STAT,1871,40,20-24,1911,0.32187613532498527
STAT,1889,19,na,1908,6255.618879164773
STAT,1919,23,25-29,1942,203.6023937849102
STAT,1947,15,na,1962,8377.71263398856
SIM,1837,41,20-24,1878,1
STAT,1900,47,30-34,1947,0.1522646456211951
STAT,1887,41,30-34,1928,2.608612368014944
SIM,1902,43,na,1945,6704
STAT,1811,52,15-19,1863,1.5927820985775073E-4
STAT,1852,26,25-29,1878,79.095263879467
STAT,1930,42,na,1972,9868.934353066603
SIM,1772,89,na,1861,46
SIM,1830,36,40-44,1866,11
STAT,1848,80,na,1928,1014.3168180898513
STAT,1884,32,na,1916,4758.9496649374205
SIM,1858,29,20-24,1887,22
STAT,1789,84,na,1873,224.36400832032555
STAT,1835,26,25-29,1861,71.95235470194065
STAT,1896,32,20-24,1928,7.207512352787554
STAT,1856,42,45-49,1898,2.3292476541949707
SIM,1898,21,40-44,1919,9
SIM,1921,40,50-100,1961,1
SIM,1889,20,25-29,1909,144
STAT,1904,25,na,1929,6964.843064964868
SIM,1820,39,35-39,1859,25
STAT,1837,48,50-100,1885,0.35089497431497285
SIM,1924,28,30-34,1952,115
STAT,1812,82,na,1894,442.2764491299871
SIM,1878,49,40-44,1927,1
STAT,1849,39,30-34,1888,8.449141759952692
STAT,1856,35,50-100,1891,1.9312822620924204
STAT,1890,75,na,1965,3168.9159463447086
STAT,1898,20,25-29,1918,157.39079206342535
STAT,1916,28,30-34,1944,81.5331685190548
SIM,1881,22,25-29,1903,116
STAT,1832,28,45-49,1860,1.9282656462865424
STAT,1873,51,30-34,1924,0.012273409596734683
SIM,1790,74,na,1864,1009
STAT,1866,46,na,1912,4204.436038146076
SIM,1880,27,40-44,1907,12
SIM,1810,90,na,1900,68
STAT,1872,32,35-39,1904,20.55531612220134
STAT,1941,19,25-29,1960,90.09112333435506
SIM,1919,41,40-44,1960,1
STAT,1827,59,na,1886,2461.2776043505373
STAT,1856,13,na,1869,4378.545522834788
SIM,1838,28,40-44,1866,8
SIM,1881,36,35-39,1917,16
STAT,1904,18,50-100,1922,0.14164262595967353
SIM,1815,74,na,1889,910
SIM,1878,15,30-34,1893,7
SIM,1840,28,45-49,1868,2
STAT,1853,52,20-24,1905,0.0011613217279254546
STAT,1953,15,na,1968,8996.505319658254
SIM,1854,58,na,1912,3278
STAT,1816,101,na,1917,0.5604964561991784
SIM,1860,26,25-29,1886,86
SIM,1899,38,25-29,1937,2
STAT,1883,35,15-19,1918,0.11248422798679053
STAT,1878,43,30-34,1921,2.4074783568993174
STAT,1884,31,na,1915,4778.397743754499
SIM,1911,11,na,1922,8143
STAT,1911,36,30-34,1947,3.57342323330227
STAT,1887,49,40-44,1936,0.21357952531328253
STAT,1904,23,30-34,1927,51.473626012031495
SIM,1841,15,35-39,1856,2
STAT,1937,16,na,1953,7251.00759604506
SIM,1831,37,na,1868,3657
SIM,1882,3,na,1885,5965
STAT,1866,47,30-34,1913,0.1795438738102548
STAT,1927,25,25-29,1952,162.67844943392998
STAT,1872,15,35-39,1887,1.130680869261009
STAT,1893,4,na,1897,6734.239812171141
SIM,1886,43,30-34,1929,4
STAT,1860,54,25-29,1914,0.005649445516322511
SIM,1784,74,na,1858,743
STAT,1931,27,na,1958,9768.133201444576
STAT,1897,19,40-44,1916,0.49112476231201313
STAT,1829,41,20-24,1870,0.2654826334214268
SIM,1849,21,45-49,1870,1
STAT,1842,52,45-49,1894,0.021491269653198777
SIM,1904,24,35-39,1928,22
SIM,1855,43,na,1898,4046
SIM,1862,39,40-44,1901,10
STAT,1915,29,25-29,1944,134.62948803771704
STAT,1804,63,na,1867,1779.4234020368033
STAT,1872,47,na,1919,4545.3032686739325
SIM,1903,26,40-44,1929,12
STAT,1840,27,40-44,1867,5.391294279918249
SIM,1895,49,40-44,1944,1
SIM,1912,23,30-34,1935,1
STAT,1888,47,35-39,1935,0.332631111509395
SIM,1906,57,na,1963,6221
STAT,1845,29,50-100,1874,1.1826356724814395
SIM,1889,25,35-39,1914,32
STAT,1811,51,25-29,1862,0.023401157575306395
STAT,1840,25,50-100,1865,1.1680047220800074
SIM,1909,17,25-29,1926,24
STAT,1898,46,15-19,1944,6.184259721993325E-4
STAT,1812,51,20-24,1863,0.004991148009428562
STAT,1825,52,na,1877,2760.4522402384187
STAT,1877,26,25-29,1903,89.01721065868779
STAT,1857,94,na,1951,31.462022264307095
SIM,1837,40,30-34,1877,4
STAT,1888,33,25-29,1921,24.34658560503726
STAT,1916,46,30-34,1962,0.18512172578833663
SIM,1830,31,30-34,1861,36
SIM,1866,43,na,1909,4437
STAT,1905,20,40-44,1925,6.122663179700679
STAT,1896,31,30-34,1927,46.74533824684361
STAT,1861,16,25-29,1877,11.013696937994732
STAT,1887,23,30-34,1910,40.109930790087596
SIM,1823,97,na,1920,1
SIM,1904,62,na,1966,5821
SIM,1838,47,na,1885,3204
STAT,1814,102,na,1916,0.2523150641730786
SIM,1895,23,30-34,1918,55
SIM,1863,31,20-24,1894,8
STAT,1846,26,50-100,1872,1.1939155288853884
SIM,1867,19,20-24,1886,44
SIM,1879,29,40-44,1908,9
STAT,1827,40,50-100,1867,2.0813287185382925
SIM,1814,40,40-44,1854,6
STAT,1916,22,45-49,1938,2.3811715227495225
STAT,1900,29,30-34,1929,70.04599205435494
SIM,1869,48,40-44,1917,1
SIM,1918,44,30-34,1962,2
STAT,1853,80,na,1933,978.7439518175777
SIM,1860,19,35-39,1879,2
SIM,1829,42,25-29,1871,3
SIM,1935,25,25-29,1960,20
STAT,1832,53,35-39,1885,0.011445600173131691
SIM,1857,20,40-44,1877,7
SIM,1859,27,15-19,1886,1
SIM,1850,34,50-100,1884,5
STAT,1852,19,35-39,1871,1.0452976082177587
STAT,1822,36,40-44,1858,18.294420589263606
STAT,1829,40,30-34,1869,1.9518742878019049
SIM,1885,26,25-29,1911,88
STAT,1957,0,na,1957,10545.40005076175
STAT,1890,29,45-49,1919,2.717507976001334
SIM,1924,46,30-34,1970,1
STAT,1921,23,30-34,1944,65.34401742699934
SIM,1853,39,50-100,1892,1
SIM,1840,21,25-29,1861,127
STAT,1823,38,45-49,1861,7.43143936379618
STAT,1888,40,15-19,1928,0.03329759103855592
SIM,1881,31,40-44,1912,12
SIM,1887,21,na,1908,5805
STAT,1897,40,40-44,1937,0.42592354844319125
STAT,1903,44,50-100,1947,0.2081100135029887
STAT,1878,31,na,1909,5054.017376318749
STAT,1846,40,30-34,1886,1.828533776030453
SIM,1794,67,na,1861,1437
SIM,1831,38,45-49,1869,6
STAT,1831,31,35-39,1862,17.269060254351327
STAT,1915,42,45-49,1957,0.33842904922604733
SIM,1810,68,na,1878,1583
STAT,1876,19,20-24,1895,36.8338181170591
SIM,1847,101,na,1948,4
STAT,1969,2,na,1971,9926.611719076676
STAT,1832,81,na,1913,705.0043484857116
STAT,1892,44,20-24,1936,0.027506446971608395
SIM,1828,49,50-100,1877,3
SIM,1825,44,50-100,1869,3
SIM,1939,20,na,1959,7534
SIM,1803,89,na,1892,87
SIM,1913,20,40-44,1933,10
STAT,1930,4,na,1934,10538.590536141677
STAT,1908,2,na,1910,7991.354621329009
STAT,1832,35,35-39,1867,11.902093483598177
STAT,1941,26,15-19,1967,1.4756269336320875
STAT,1777,99,na,1876,0.6210106946495612
STAT,1843,21,50-100,1864,0.7222086058797416
STAT,1896,39,40-44,1935,11.554820935088413
STAT,1903,40,na,1943,6736.360115672849
SIM,1870,17,na,1887,4971
STAT,1825,53,20-24,1878,0.0015122120227989827
SIM,1903,2,na,1905,7862
SIM,1854,40,30-34,1894,2
SIM,1862,29,na,1891,4343
STAT,1873,31,40-44,1904,8.93555334309145
SIM,1949,17,15-19,1966,107
STAT,1836,95,na,1931,17.67752401468918
SIM,1939,15,45-49,1954,1
STAT,1825,46,30-34,1871,0.21282488840421174
SIM,1858,1,na,1859,6089
SIM,1895,43,35-39,1938,1
SIM,1854,25,35-39,1879,25
STAT,1831,51,50-100,1882,0.02074032006893789
STAT,1938,21,30-34,1959,57.476957366957414
SIM,1844,25,25-29,1869,82
STAT,1904,16,40-44,1920,0.5314905107588292
SIM,1883,83,na,1966,1347
STAT,1819,52,na,1871,2611.9892937524764
SIM,1858,95,na,1953,15
SIM,1877,28,40-44,1905,9
STAT,1892,37,30-34,1929,13.474749651357872
SIM,1840,41,na,1881,3832
STAT,1875,39,20-24,1914,1.5867337161772386
STAT,1899,34,na,1933,6546.719152957193
SIM,1810,75,na,1885,854
SIM,1933,38,na,1971,10779
SIM,1840,32,30-34,1872,44
SIM,1848,24,35-39,1872,11
SIM,1835,67,na,1902,2067
STAT,1873,22,25-29,1895,117.47120778487641
STAT,1855,25,50-100,1880,1.1209281716136872
STAT,1859,19,20-24,1878,32.692154295631134
STAT,1897,43,45-49,1940,0.27854635135119166
STAT,1887,43,35-39,1930,4.060705826104
SIM,1881,26,40-44,1907,8
SIM,1888,40,40-44,1928,8
STAT,1851,14,na,1865,4458.556650349554
SIM,1930,20,40-44,1950,7
SIM,1871,32,30-34,1903,42
SIM,1804,90,na,1894,30
SIM,1853,48,na,1901,3632
STAT,1852,31,20-24,1883,4.507146866693937
STAT,1805,108,na,1913,0.0013701464219088694
SIM,1815,78,na,1893,757
STAT,1914,21,45-49,1935,2.2349377576575273
STAT,1860,22,15-19,1882,5.577630541184031
STAT,1906,21,na,1927,6981.219561966083
SIM,1871,98,na,1969,28
SIM,1886,8,na,1894,5507
STAT,1901,17,30-34,1918,4.506457052527123
SIM,1908,21,15-19,1929,8
SIM,1888,61,na,1949,4390
STAT,1879,52,40-44,1931,0.022121026781411483
SIM,1863,25,50-100,1888,3
SIM,1939,16,na,1955,7610
STAT,1855,31,20-24,1886,4.193564275980265
STAT,1865,31,30-34,1896,32.16620213515771
SIM,1833,46,30-34,1879,1
STAT,1876,61,na,1937,3903.3176008993464
SIM,1927,20,20-24,1947,307
STAT,1835,19,35-39,1854,1.8348585671372877
STAT,1829,48,50-100,1877,0.3824826960455064
STAT,1883,50,40-44,1933,0.02118992885702274
STAT,1832,32,30-34,1864,29.672267295380593
STAT,1949,19,50-100,1968,0.8793736034308779
SIM,1906,36,na,1942,7005
SIM,1932,26,15-19,1958,2
STAT,1837,20,15-19,1857,6.309419431969016
STAT,1920,32,25-29,1952,20.44161001222819
SIM,1848,62,na,1910,2737
STAT,1862,19,40-44,1881,0.3251937428029486
SIM,1867,28,na,1895,5025
STAT,1851,43,20-24,1894,0.2444107863387264
SIM,1863,14,na,1877,4968
SIM,1899,24,50-100,1923,1
SIM,1946,21,30-34,1967,77
SIM,1910,47,45-49,1957,2
STAT,1846,25,35-39,1871,18.138901649790974
STAT,1906,29,20-24,1935,34.278249919194714
STAT,1802,67,na,1869,1652.0748258938286
STAT,1836,25,25-29,1861,73.85011682306255
STAT,1875,51,45-49,1926,0.030320793651046472
STAT,1910,46,40-44,1956,0.2979330921206181
STAT,1926,15,30-34,1941,30.316407274630322
STAT,1824,33,35-39,1857,39.976889470551
STAT,1838,66,na,1904,2218.182415809377
STAT,1924,44,15-19,1968,0.0036758506887174984
STAT,1922,20,40-44,1942,7.831701663875095
SIM,1822,33,25-29,1855,23
SIM,1827,63,na,1890,2144
STAT,1813,51,50-100,1864,0.09061087390317075
STAT,1834,32,15-19,1866,0.24281764955563945
SIM,1832,33,35-39,1865,19
SIM,1885,17,15-19,1902,9
SIM,1851,29,na,1880,3986
SIM,1918,47,35-39,1965,1
SIM,1860,31,20-24,1891,8
STAT,1843,81,na,1924,757.5125006626547
STAT,1869,27,na,1896,4670.281679274081
STAT,1921,19,45-49,1940,1.1435476999203014
STAT,1947,25,50-100,1972,2.276064459588757
SIM,1909,35,25-29,1944,1
STAT,1842,50,40-44,1892,0.015898954082830687
STAT,1830,38,40-44,1868,8.089431468796656
STAT,1832,50,30-34,1882,0.008398273749067297
STAT,1843,18,30-34,1861,2.8364575308925266
SIM,1914,29,20-24,1943,37
STAT,1854,42,30-34,1896,1.7602569409046256
STAT,1902,47,45-49,1949,0.37781199108892993
SIM,1851,18,30-34,1869,4
SIM,1931,24,na,1955,9515
SIM,1814,42,30-34,1856,6
SIM,1843,19,35-39,1862,1
SIM,1942,3,na,1945,8648
STAT,1834,50,45-49,1884,0.02060811568138
STAT,1919,20,20-24,1939,247.32398927379435
STAT,1883,46,na,1929,4476.974118725558
STAT,1910,39,50-100,1949,0.8031061566387545
SIM,1845,20,15-19,1865,6
STAT,1849,54,20-24,1903,0.00113514127517934
STAT,1912,43,50-100,1955,0.22752223144249248
SIM,1876,32,45-49,1908,3
STAT,1873,33,30-34,1906,35.677124462084535
STAT,1911,39,35-39,1950,4.672099612053175
STAT,1817,66,na,1883,1848.080893568286
STAT,1868,27,15-19,1895,0.8718014038513995
STAT,1901,39,25-29,1940,1.739382715866489
STAT,1868,32,45-49,1900,3.3508003633509
STAT,1930,18,50-100,1948,0.9756720233412658
SIM,1906,29,25-29,1935,110
STAT,1814,52,na,1866,2449.2053147985453
STAT,1870,19,50-100,1889,0.09691597486883853
SIM,1880,47,na,1927,4956
STAT,1850,23,35-39,1873,10.661990475850974
SIM,1878,23,30-34,1901,51
STAT,1840,23,25-29,1863,104.32708472162163
SIM,1925,33,50-100,1958,5
STAT,1767,105,na,1872,0.0337057908243481
STAT,1849,101,na,1950,0.9026113998009547
SIM,1916,10,na,1926,8631
STAT,1828,52,30-34,1880,0.010355067957433444
STAT,1891,24,35-39,1915,14.476392328489244
STAT,1803,53,na,1856,2352.5059567325698
STAT,1881,24,25-29,1905,111.04852413797336
SIM,1922,37,50-100,1959,1
SIM,1922,21,45-49,1943,2
STAT,1807,67,na,1874,1724.972687483028
SIM,1921,24,35-39,1945,29
STAT,1917,33,50-100,1950,1.7410265655138613
SIM,1836,27,40-44,1863,2
STAT,1913,47,20-24,1960,0.02178986354327981
STAT,1821,34,na,1855,3115.8343509314723
STAT,1849,27,50-100,1876,1.1994701941966153
STAT,1901,31,15-19,1932,0.4042844798276751
STAT,1914,37,50-100,1951,0.8467688890533687
STAT,1850,41,35-39,1891,2.7890288710232283
SIM,1842,50,45-49,1892,1
SIM,1901,58,na,1959,5832
STAT,1808,48,20-24,1856,0.07443536803175804
STAT,1901,35,30-34,1936,3.283331683424382
STAT,1903,28,40-44,1931,8.58360986100225
SIM,1945,23,na,1968,8987
STAT,1873,54,35-39,1927,0.017180461765424346
STAT,1847,32,25-29,1879,18.33192169988943
STAT,1895,43,30-34,1938,0.2085793744762039
SIM,1836,34,30-34,1870,36
STAT,1913,24,35-39,1937,19.087540273802016
STAT,1869,24,25-29,1893,111.32489712265958
STAT,1925,21,20-24,1946,269.56609511840253
STAT,1856,18,40-44,1874,0.33501624085747844
STAT,1851,36,30-34,1887,8.437452223031112
SIM,1933,21,20-24,1954,305
STAT,1893,32,20-24,1925,6.919500746400588
STAT,1895,25,30-34,1920,66.71905040461151
SIM,1911,28,40-44,1939,11
SIM,1918,19,40-44,1937,4
SIM,1855,32,25-29,1887,26
STAT,1810,45,25-29,1855,0.3905144039355158
STAT,1852,36,15-19,1888,0.09092459627716314
SIM,1876,25,25-29,1901,105
STAT,1828,34,30-34,1862,36.86015377367144
SIM,1854,42,35-39,1896,4
SIM,1881,33,30-34,1914,39
STAT,1826,41,20-24,1867,0.3424014202697956
SIM,1878,45,25-29,1923,1
SIM,1883,39,20-24,1922,5
SIM,1885,0,na,1885,6987
STAT,1910,47,40-44,1957,0.297194218052159
SIM,1882,16,35-39,1898,2
SIM,1947,0,na,1947,9778
STAT,1891,42,35-39,1933,4.514917643584801
SIM,1916,16,25-29,1932,19
SIM,1937,32,45-49,1969,1
STAT,1892,47,25-29,1939,0.08176438390232701
STAT,1821,52,25-29,1873,0.009972199410608082
SIM,1831,30,na,1861,3899
SIM,1847,41,30-34,1888,5
STAT,1846,42,35-39,1888,2.8072179171494205
STAT,1887,26,50-100,1913,1.4498911083900874
SIM,1944,27,40-44,1971,12
STAT,1870,76,na,1946,1878.5377837160354
STAT,1832,25,40-44,1857,5.391554293532769
STAT,1822,39,45-49,1861,7.2530257267048075
STAT,1830,48,na,1878,3292.0943124435175
STAT,1859,23,50-100,1882,0.6752395631666053
STAT,1918,39,40-44,1957,3.179342275593342
STAT,1934,21,50-100,1955,1.7867361705504676
SIM,1844,29,40-44,1873,6
SIM,1830,39,45-49,1869,7
SIM,1908,25,30-34,1933,94
STAT,1896,35,25-29,1931,7.750083898891795
SIM,1869,94,na,1963,91
STAT,1859,39,40-44,1898,6.965966281868225
SIM,1903,29,45-49,1932,6
STAT,1828,27,40-44,1855,10.202105913750962
STAT,1906,28,20-24,1934,34.403478581230395
SIM,1914,28,20-24,1942,43
STAT,1815,41,45-49,1856,9.334508065467928
STAT,1829,51,na,1880,2743.3751023418044
STAT,1874,16,35-39,1890,1.1374705671505743
STAT,1883,51,40-44,1934,0.02098968402932387
STAT,1829,44,25-29,1873,1.0247919494052415
STAT,1882,32,45-49,1914,3.430789985005377
STAT,1813,67,na,1880,1667.8028534429166
STAT,1836,29,40-44,1865,5.0810900159715
STAT,1860,51,20-24,1911,0.0012160394989941662
SIM,1824,82,na,1906,517
SIM,1867,23,50-100,1890,1
STAT,1844,99,na,1943,3.0584324236825124
STAT,1897,38,na,1935,6328.747677713241
STAT,1921,26,35-39,1947,33.90134058187217
SIM,1886,21,15-19,1907,4
STAT,1805,104,na,1909,0.04989225583450832
SIM,1839,81,na,1920,626
STAT,1834,38,20-24,1872,1.263154925248004
STAT,1912,17,na,1929,7889.7969787914535
SIM,1898,24,45-49,1922,2
STAT,1936,27,40-44,1963,9.010729455126734
SIM,1878,18,35-39,1896,1
STAT,1887,44,35-39,1931,4.035042165283025
SIM,1831,43,45-49,1874,7
STAT,1845,49,40-44,1894,0.2583000744710075
SIM,1859,36,25-29,1895,8
SIM,1837,44,25-29,1881,2
SIM,1879,57,na,1936,4163
STAT,1824,51,35-39,1875,0.020483996611829553
STAT,1895,18,40-44,1913,0.4800721826349878
STAT,1867,42,20-24,1909,0.3000130545847653
STAT,1893,37,15-19,1930,0.14374883008819242
SIM,1927,30,15-19,1957,1
STAT,1867,47,15-19,1914,7.530420383361248E-4
SIM,1965,4,na,1969,10578
STAT,1862,15,25-29,1877,11.336381556615555
STAT,1838,108,na,1946,0.002478994467982244
STAT,1890,34,45-49,1924,4.26198907007977
STAT,1830,52,na,1882,3085.637772423228
STAT,1860,28,20-24,1888,19.307080937005733
STAT,1808,52,na,1860,2456.6384789367203
STAT,1843,44,25-29,1887,0.9027526885288057
STAT,1839,41,30-34,1880,2.1059097667409636
SIM,1846,66,na,1912,2528
STAT,1769,85,na,1854,108.0
STAT,1842,33,na,1875,3857.592386730508
STAT,1929,32,45-49,1961,4.03639481891598
STAT,1857,45,15-19,1902,6.359558652517192E-4
STAT,1823,43,45-49,1866,4.858745832141683
STAT,1907,40,45-49,1947,0.3116140911430215
SIM,1878,13,na,1891,5613
STAT,1838,51,40-44,1889,0.014455808916579356
STAT,1841,108,na,1949,0.0026577024959303216
STAT,1870,52,50-100,1922,0.029786724578730814
SIM,1896,37,40-44,1933,12
SIM,1942,21,50-100,1963,3
SIM,1851,44,25-29,1895,2
STAT,1908,16,25-29,1924,17.02995053602825
STAT,1949,19,15-19,1968,106.5214773841723
STAT,1822,50,50-100,1872,0.047010590497879715
STAT,1826,46,15-19,1872,8.085469415707211E-4
STAT,1894,15,25-29,1909,14.770048667116695
STAT,1850,99,na,1949,2.903809051166156
SIM,1767,93,na,1860,16
SIM,1872,44,45-49,1916,9
STAT,1821,93,na,1914,32.39477436563258
SIM,1818,39,40-44,1857,10
SIM,1863,34,25-29,1897,23
STAT,1843,18,na,1861,4084.9798728519595
SIM,1862,24,30-34,1886,44
SIM,1835,24,25-29,1859,118
STAT,1846,43,35-39,1889,2.771482033064109
STAT,1884,19,30-34,1903,3.1615605518080594
SIM,1896,44,30-34,1940,1
STAT,1861,53,50-100,1914,0.02498021954934338
STAT,1827,31,45-49,1858,4.532520621204297
SIM,1915,40,45-49,1955,4
STAT,1848,26,35-39,1874,19.024377938469634
SIM,1828,35,35-39,1863,21
SIM,1895,44,35-39,1939,1
SIM,1854,43,35-39,1897,4
STAT,1831,96,na,1927,11.086646568057319
STAT,1762,97,na,1859,2.06351165840164
STAT,1833,48,30-34,1881,0.13414898846088438
SIM,1907,31,20-24,1938,7
STAT,1882,61,na,1943,3676.3474131722755
STAT,1939,15,40-44,1954,2.83492064666027
STAT,1905,38,50-100,1943,0.7701605047291117
STAT,1854,24,30-34,1878,31.62452793685985
SIM,1907,43,na,1950,6854
STAT,1865,52,35-39,1917,0.01571190833811834
SIM,1875,42,20-24,1917,1
SIM,1891,10,na,1901,6688
SIM,1900,11,na,1911,7582
SIM,1904,21,30-34,1925,68
STAT,1812,54,50-100,1866,0.09618475500042108
STAT,1888,44,30-34,1932,2.707289604952881
SIM,1862,17,40-44,1879,1
SIM,1892,19,30-34,1911,8
SIM,1861,44,na,1905,4379
SIM,1866,28,na,1894,4635
STAT,1844,66,na,1910,2646.8604714418075
SIM,1850,44,na,1894,3678
STAT,1894,22,45-49,1916,1.8091288664986545
SIM,1925,24,na,1949,8724
STAT,1849,23,45-49,1872,1.3240116313601786
STAT,1864,44,45-49,1908,2.6654281596140756
SIM,1921,10,na,1931,9199
SIM,1904,25,na,1929,7034
STAT,1927,22,20-24,1949,276.64124186509093
SIM,1895,26,35-39,1921,31
SIM,1936,35,35-39,1971,4
STAT,1841,31,45-49,1872,3.1018863064479665
SIM,1873,34,35-39,1907,28
SIM,1947,15,40-44,1962,3
SIM,1863,38,40-44,1901,9
SIM,1935,22,20-24,1957,323
STAT,1854,17,40-44,1871,0.3354110167055188
SIM,1845,81,na,1926,749
STAT,1848,19,45-49,1867,0.13121891591603344
STAT,1875,33,15-19,1908,0.2948660130276166
SIM,1869,49,50-100,1918,4
STAT,1887,26,35-39,1913,21.869723328789675
SIM,1897,42,na,1939,6364
SIM,1926,39,40-44,1965,8
STAT,1846,50,25-29,1896,0.005503297800578826
SIM,1835,31,45-49,1866,4
SIM,1845,29,na,1874,4170
STAT,1930,0,na,1930,11763.025891917192
SIM,1840,25,40-44,1865,7
STAT,1916,42,15-19,1958,0.003178319216696883
STAT,1861,62,na,1923,3072.4313876870033
STAT,1928,35,35-39,1963,6.1833253942448
SIM,1912,34,35-39,1946,24
STAT,1909,47,30-34,1956,0.16552720182864933
STAT,1833,29,na,1862,3693.659902799606
STAT,1942,21,50-100,1963,1.3938283296174552
SIM,1821,41,30-34,1862,6
SIM,1930,23,45-49,1953,3
SIM,1933,24,25-29,1957,266
STAT,1828,37,35-39,1865,14.243883688370264
SIM,1830,32,25-29,1862,15
SIM,1895,19,na,1914,7002
SIM,1901,20,15-19,1921,10
STAT,1814,48,50-100,1862,1.252710497994392
STAT,1871,68,na,1939,3066.3513277681654
SIM,1878,43,35-39,1921,5
SIM,1924,24,15-19,1948,14
STAT,1859,32,20-24,1891,4.345137696872725
SIM,1846,44,50-100,1890,5
SIM,1884,31,na,1915,5165
STAT,1900,60,na,1960,5569.270211640723
STAT,1901,23,50-100,1924,1.1494112698821934
SIM,1834,82,na,1916,507
STAT,1906,20,25-29,1926,169.47583281492996
STAT,1788,102,na,1890,0.18237081207130526
STAT,1880,32,30-34,1912,37.1468235774046
SIM,1858,34,20-24,1892,3
SIM,1835,38,50-100,1873,4
SIM,1937,26,35-39,1963,44
SIM,1851,22,15-19,1873,7
STAT,1777,115,na,1892,1.3184533919583907E-4
STAT,1852,47,50-100,1899,0.38961488011170636
STAT,1874,22,45-49,1896,1.4420016084939786
STAT,1853,43,na,1896,3630.4306705379927
STAT,1839,34,45-49,1873,3.2819156282298936
STAT,1886,39,35-39,1925,14.927298304265173
STAT,1898,17,na,1915,6902.703129843232
SIM,1892,41,45-49,1933,8
STAT,1916,24,15-19,1940,11.194784897494758
SIM,1910,25,na,1935,7611
STAT,1829,104,na,1933,0.07894010544697413
STAT,1834,48,15-19,1882,5.574926501069864E-4
STAT,1918,47,40-44,1965,0.33878863653507646
SIM,1795,84,na,1879,198
SIM,1886,32,na,1918,5082
SIM,1917,45,50-100,1962,3
STAT,1853,21,45-49,1874,1.3130267236270512
STAT,1920,28,40-44,1948,10.287686862032341
SIM,1901,46,40-44,1947,1
SIM,1915,33,20-24,1948,7
STAT,1836,45,30-34,1881,0.13821865654598198
STAT,1949,21,45-49,1970,2.652328063319172
STAT,1819,48,35-39,1867,0.5787349573181815
STAT,1907,33,20-24,1940,4.587742309132837
STAT,1856,31,40-44,1887,6.911762947634534
STAT,1840,21,35-39,1861,10.78922940726653
STAT,1931,15,50-100,1946,0.9950335438749854
STAT,1951,21,15-19,1972,12.847665289052715
SIM,1917,49,40-44,1966,1
STAT,1868,48,30-34,1916,0.18366661117636573
STAT,1845,45,25-29,1890,0.0896427725190601
STAT,1847,24,25-29,1871,105.44391777640682
SIM,1865,28,15-19,1893,1
STAT,1904,34,35-39,1938,16.71174540018516
SIM,1867,99,na,1966,12
STAT,1908,18,30-34,1926,4.765725877383734
SIM,1929,22,50-100,1951,1
STAT,1813,41,30-34,1854,8.883357443158054
STAT,1922,23,45-49,1945,2.59719025514877
STAT,1925,24,25-29,1949,221.85692950375477
SIM,1864,22,25-29,1886,125
SIM,1872,46,na,1918,4771
SIM,1929,39,20-24,1968,1
SIM,1899,28,30-34,1927,88
STAT,1875,25,15-19,1900,0.9498074742555133
STAT,1895,28,35-39,1923,25.30303355789707
SIM,1822,87,na,1909,127
STAT,1894,38,30-34,1932,13.758457503443628
STAT,1864,21,20-24,1885,127.32314925481715
STAT,1869,35,50-100,1904,2.4254363106933376
STAT,1917,18,40-44,1935,0.6062454994946643
SIM,1874,31,50-100,1905,3
STAT,1812,57,na,1869,2435.843469157346
SIM,1802,71,na,1873,1251
SIM,1872,21,20-24,1893,144
SIM,1906,39,50-100,1945,2
SIM,1925,18,40-44,1943,4
SIM,1797,85,na,1882,129
STAT,1872,33,35-39,1905,20.46857268816565
STAT,1825,54,50-100,1879,0.03034117057868186
STAT,1948,15,na,1963,8511.164078167834
SIM,1865,74,na,1939,1998
SIM,1903,36,35-39,1939,11
SIM,1920,33,30-34,1953,45
STAT,1871,32,20-24,1903,5.423727964308056
STAT,1855,44,na,1899,3438.154265139449
STAT,1856,22,25-29,1878,103.5999921824907
STAT,1923,33,na,1956,8748.33488525391
STAT,1921,31,30-34,1952,35.54614347180947
SIM,1853,45,25-29,1898,1
SIM,1855,24,25-29,1879,117
STAT,1848,32,45-49,1880,3.334519794150865
STAT,1849,21,40-44,1870,4.013983107791281
STAT,1907,26,15-19,1933,1.3513752539383224
STAT,1857,28,15-19,1885,0.730372784496159
SIM,1879,84,na,1963,949
STAT,1827,47,30-34,1874,0.17481952844230447
STAT,1925,31,15-19,1956,0.3083069659264817
STAT,1851,42,45-49,1893,2.3172092153295627
STAT,1865,24,45-49,1889,1.2764767676527362
STAT,1822,51,na,1873,2778.6533085852534
STAT,1845,52,30-34,1897,0.009123665997326008
SIM,1924,45,na,1969,9215
STAT,1845,38,35-39,1883,11.333099504072967
STAT,1889,30,25-29,1919,25.711494428301275
STAT,1913,39,na,1952,7424.764386626331
SIM,1835,21,20-24,1856,126
STAT,1880,30,20-24,1910,5.797181832343609
SIM,1764,92,na,1856,11
SIM,1882,76,na,1958,1974
SIM,1939,30,40-44,1969,14
SIM,1899,35,20-24,1934,3
STAT,1901,15,25-29,1916,16.096372559114688
STAT,1952,20,na,1972,8872.851726000601
STAT,1845,14,na,1859,4607.282284233022
SIM,1873,93,na,1966,172
SIM,1894,61,na,1955,4960
STAT,1884,41,45-49,1925,2.998210397849943
SIM,1853,38,35-39,1891,17
SIM,1897,30,25-29,1927,32
SIM,1889,22,30-34,1911,52
STAT,1817,50,45-49,1867,0.06991592612450664
SIM,1861,21,45-49,1882,1
STAT,1903,19,na,1922,7223.590504736699
STAT,1850,8,na,1858,4600.977992841606
STAT,1913,41,35-39,1954,0.398977360050455
SIM,1968,1,na,1969,10511
SIM,1862,42,30-34,1904,3
STAT,1843,22,15-19,1865,5.800716600247613
STAT,1903,5,na,1908,7535.8095640435395
SIM,1836,37,35-39,1873,20
STAT,1930,24,35-39,1954,24.208725397896178
SIM,1873,24,45-49,1897,6
STAT,1955,16,50-100,1971,1.0046233039343129
STAT,1831,28,50-100,1859,1.1028410330396936
SIM,1854,31,na,1885,4142
STAT,1866,50,40-44,1916,0.01989998114118634
STAT,1831,32,35-39,1863,17.084285185060768
STAT,1902,39,45-49,1941,1.2145196349180287
STAT,1851,36,50-100,1887,1.943685096873227
STAT,1896,33,35-39,1929,26.889142423060385
STAT,1849,53,45-49,1902,0.022587132583251266
STAT,1932,1,na,1933,11168.852870797613
SIM,1910,39,45-49,1949,5
SIM,1921,41,35-39,1962,1
STAT,1830,31,20-24,1861,5.444000534746725
STAT,1930,39,20-24,1969,0.6929469787961785
STAT,1811,53,15-19,1864,1.561127382598396E-4
SIM,1929,31,25-29,1960,26
STAT,1844,105,na,1949,0.04735036288026066
STAT,1884,49,40-44,1933,0.3342905339388085
SIM,1892,49,40-44,1941,2
STAT,1875,49,15-19,1924,8.143738347612022E-4
SIM,1856,32,45-49,1888,5
STAT,1920,26,30-34,1946,87.0857076305248
STAT,1911,38,na,1949,7304.610724685317
STAT,1946,23,30-34,1969,64.5681189709204
SIM,1857,21,40-44,1878,7
SIM,1945,3,na,1948,9194
STAT,1878,51,30-34,1929,0.012615791032502236
STAT,1917,39,na,1956,7843.416771559561
SIM,1919,44,45-49,1963,1
STAT,1798,82,na,1880,326.9284966119184
STAT,1932,18,20-24,1950,361.6438153237219
SIM,1853,79,na,1932,982
SIM,1874,47,na,1921,4313
SIM,1947,18,na,1965,8741
STAT,1803,84,na,1887,234.56711554742088
STAT,1929,26,35-39,1955,37.96174869141247
STAT,1824,52,na,1876,2567.7957216799964
STAT,1862,35,30-34,1897,9.287296569607483
SIM,1872,26,50-100,1898,2
SIM,1940,18,20-24,1958,286
STAT,1903,29,35-39,1932,27.54778922031275
SIM,1932,19,25-29,1951,135
STAT,1855,108,na,1963,0.014082274036143365
STAT,1819,99,na,1918,1.981698298518321
STAT,1828,50,20-24,1878,0.0013356116433253218
SIM,1943,16,35-39,1959,8
STAT,1879,32,20-24,1911,5.71014973276911
SIM,1902,38,40-44,1940,6
STAT,1907,39,na,1946,6977.636219899522
SIM,1847,79,na,1926,1029
SIM,1888,35,45-49,1923,8
STAT,1914,15,35-39,1929,1.761482988584599
SIM,1884,47,na,1931,4843
STAT,1845,50,20-24,1895,0.001153426719207768
STAT,1950,16,15-19,1966,108.39882722180762
SIM,1888,23,25-29,1911,132
SIM,1838,32,25-29,1870,3
STAT,1886,46,25-29,1932,0.12314854254676472
SIM,1950,16,25-29,1966,127
STAT,1825,52,45-49,1877,0.03033687800030436
SIM,1884,17,30-34,1901,3
SIM,1768,88,na,1856,69
SIM,1853,29,50-100,1882,1
SIM,1865,64,na,1929,3179
SIM,1887,32,20-24,1919,8
STAT,1803,74,na,1877,965.6332228323856
STAT,1880,17,35-39,1897,1.1674187657769912
SIM,1851,40,45-49,1891,6
SIM,1885,19,na,1904,5263
STAT,1897,23,25-29,1920,154.06511637291322
SIM,1843,23,20-24,1866,121
STAT,1808,52,45-49,1860,0.08612716412598773
STAT,1849,43,15-19,1892,0.021686565501629933
STAT,1835,23,20-24,1858,117.84169005315262
SIM,1911,26,30-34,1937,98
STAT,1837,50,30-34,1887,0.008665046633282434
STAT,1874,11,na,1885,5430.787554207252
STAT,1935,16,35-39,1951,11.615928520146642
STAT,1861,43,15-19,1904,0.023046743558290717
STAT,1829,42,35-39,1871,2.980502201702787
STAT,1910,60,na,1970,6448.750580469263
STAT,1922,37,20-24,1959,0.6056283340753678
STAT,1917,25,30-34,1942,83.54508697639424
STAT,1926,39,30-34,1965,4.488205394096533
STAT,1889,43,50-100,1932,2.611806805034829
STAT,1942,16,25-29,1958,91.48976649366665
SIM,1892,66,na,1958,4906
STAT,1889,30,40-44,1919,10.886241286081399
SIM,1922,15,35-39,1937,17
STAT,1913,39,20-24,1952,0.5202376416987484
STAT,1899,34,15-19,1933,0.3906879807152877
SIM,1842,42,45-49,1884,6
SIM,1837,42,35-39,1879,10
SIM,1816,52,45-49,1868,1
SIM,1826,41,50-100,1867,2
STAT,1848,23,30-34,1871,35.30708869126443
STAT,1907,19,25-29,1926,16.730696478397714
STAT,1835,85,na,1920,355.0429744556748
STAT,1878,72,na,1950,2663.8250832724225
STAT,1962,10,na,1972,10165.532594364504
STAT,1880,11,na,1891,5502.675709765462
STAT,1895,41,20-24,1936,0.02915373797107072
STAT,1948,16,45-49,1964,1.1548196076999337
STAT,1938,31,25-29,1969,18.783296336645893
SIM,1930,37,20-24,1967,1
SIM,1916,18,15-19,1934,16
STAT,1772,112,na,1884,0.0012525880680330722
STAT,1903,36,40-44,1939,2.730039143666578
STAT,1777,90,na,1867,51.42648556236604
SIM,1845,50,30-34,1895,1
STAT,1908,18,15-19,1926,17.74451621094656
SIM,1907,34,25-29,1941,21
SIM,1911,36,40-44,1947,4
STAT,1843,40,45-49,1883,2.214630032482621
STAT,1912,33,30-34,1945,31.18631261862921
SIM,1880,33,35-39,1913,31
STAT,1787,102,na,1889,0.16844108594085028
STAT,1858,42,na,1900,3634.378200189436
STAT,1854,43,25-29,1897,0.9773073441254069
SIM,1868,49,35-39,1917,1
SIM,1915,19,25-29,1934,20
SIM,1892,76,na,1968,3468
STAT,1933,23,20-24,1956,297.8152136653599
SIM,1931,29,20-24,1960,47
STAT,1854,27,35-39,1881,15.506507609155902
SIM,1836,77,na,1913,1001
SIM,1852,21,20-24,1873,152
SIM,1896,22,20-24,1918,198
STAT,1848,16,40-44,1864,0.3739824780025478
STAT,1937,34,45-49,1971,3.1407578875294693
STAT,1860,38,15-19,1898,0.09164132607435951
STAT,1912,26,40-44,1938,9.310986551324888
STAT,1870,33,15-19,1903,0.2811782158035924
SIM,1840,82,na,1922,713
SIM,1880,40,25-29,1920,1
SIM,1916,18,30-34,1934,6
STAT,1834,102,na,1936,0.38961134511302314
STAT,1924,26,15-19,1950,1.6653009380351558
SIM,1834,72,na,1906,1528
SIM,1813,42,35-39,1855,7
SIM,1898,22,40-44,1920,8
SIM,1941,23,20-24,1964,219
STAT,1881,22,35-39,1903,11.391331378124915
STAT,1844,47,30-34,1891,0.15559488882626915
STAT,1851,24,15-19,1875,6.019835756037096
STAT,1858,33,15-19,1891,0.22326308815331247
SIM,1951,15,30-34,1966,39
STAT,1909,26,35-39,1935,29.34031690437219
SIM,1946,24,35-39,1970,24
SIM,1894,39,35-39,1933,29
STAT,1830,27,35-39,1857,22.264383831357566
SIM,1846,31,20-24,1877,7
STAT,1843,48,40-44,1891,0.2368066467338691
STAT,1904,49,20-24,1953,0.019211884618860326
STAT,1801,89,na,1890,83.27244058051045
STAT,1862,16,na,1878,4565.02201708982
SIM,1902,36,30-34,1938,4
STAT,1919,24,na,1943,8023.763473130419
STAT,1844,21,20-24,1865,139.95488850399255
SIM,1883,43,45-49,1926,4
STAT,1873,25,50-100,1898,1.3215903660188628
SIM,1854,23,50-100,1877,1
SIM,1857,45,na,1902,4012
SIM,1920,26,40-44,1946,18
STAT,1924,19,25-29,1943,103.63527056571225
STAT,1923,29,20-24,1952,42.010203021997576
STAT,1872,40,25-29,1912,1.316564043687027
STAT,1869,51,20-24,1920,0.0014509729158758583
STAT,1892,43,45-49,1935,3.756614819788454
SIM,1836,49,50-100,1885,1
STAT,1869,53,30-34,1922,0.011461745790474561
STAT,1878,62,na,1940,3855.2345365116757
SIM,1866,33,15-19,1899,1
SIM,1884,24,20-24,1908,4
STAT,1910,20,15-19,1930,10.159991591017809
SIM,1859,64,na,1923,3026
SIM,1827,48,35-39,1875,1
SIM,1897,30,40-44,1927,14
STAT,1830,41,30-34,1871,2.0899170222684864
STAT,1876,24,20-24,1900,143.04739074261144
STAT,1875,43,45-49,1918,3.0895604213171906
STAT,1938,24,35-39,1962,18.81100760496523
SIM,1917,26,35-39,1943,44
STAT,1862,26,na,1888,4164.7088337778205
SIM,1879,33,25-29,1912,19
SIM,1861,37,30-34,1898,15
SIM,1847,34,45-49,1881,3
STAT,1933,16,15-19,1949,123.01041810771464
SIM,1842,24,15-19,1866,7
SIM,1862,27,35-39,1889,21
STAT,1834,66,na,1900,2178.1426486020464
STAT,1838,31,20-24,1869,4.593306462973588
STAT,1820,42,15-19,1862,0.05586840076094216
STAT,1834,24,15-19,1858,5.789140283770435
SIM,1941,16,15-19,1957,94
STAT,1943,15,30-34,1958,26.117275418287075
STAT,1851,4,na,1855,5023.6050000000005
STAT,1798,88,na,1886,91.85652669307592
STAT,1893,79,na,1972,2787.059747096838
STAT,1947,21,25-29,1968,210.89300625259855
SIM,1926,40,na,1966,9507
STAT,1853,37,30-34,1890,8.432465731432538
STAT,1830,86,na,1916,306.38507892197697
STAT,1864,11,na,1875,4921.565291159178
STAT,1839,31,40-44,1870,8.420056914250413
STAT,1933,23,na,1956,9780.69255462098
STAT,1907,36,25-29,1943,1.8535656463743035
SIM,1901,49,45-49,1950,1
STAT,1858,48,na,1906,3497.6827940796516
SIM,1835,54,50-100,1889,1
STAT,1836,48,35-39,1884,0.1923654917881906
STAT,1860,52,na,1912,3512.5740571162473
SIM,1872,24,25-29,1896,129
STAT,1825,34,15-19,1859,0.42528708635634876
STAT,1860,32,45-49,1892,2.8600128431481204
STAT,1873,6,na,1879,5625.702017951582
STAT,1818,76,na,1894,971.9820818211376
SIM,1875,64,na,1939,3841
STAT,1863,33,25-29,1896,18.031491681996762
STAT,1889,24,30-34,1913,44.07905178662182
STAT,1845,42,20-24,1887,0.2492035903570287
STAT,1910,8,na,1918,7958.328611111741
SIM,1840,72,na,1912,1974
STAT,1903,43,30-34,1946,0.2279130728707673
SIM,1916,20,na,1936,7836
STAT,1806,98,na,1904,2.211982394068443
SIM,1839,26,na,1865,3689
STAT,1853,45,30-34,1898,0.15468401172320154
STAT,1817,48,15-19,1865,0.0019019339883631877
SIM,1838,24,25-29,1862,106
STAT,1867,25,na,1892,4544.552736419456
STAT,1946,20,na,1966,8212.25253005808
STAT,1757,115,na,1872,6.213584875795727E-4
STAT,1809,99,na,1908,1.6832954457060083
STAT,1873,20,50-100,1893,0.8418016829655011
STAT,1897,15,25-29,1912,15.369215072637227
STAT,1862,42,50-100,1904,1.821403348196347
STAT,1892,25,15-19,1917,1.1548765348997152
STAT,1793,89,na,1882,74.77649629920141
STAT,1849,35,15-19,1884,0.09279898191337355
SIM,1847,31,40-44,1878,13
STAT,1859,35,25-29,1894,4.6722336438281635
SIM,1827,45,30-34,1872,1
SIM,1861,13,na,1874,5252
STAT,1927,44,30-34,1971,0.32269374015887387
STAT,1911,34,25-29,1945,18.026497475984783
SIM,1837,25,na,1862,3765
STAT,1878,54,35-39,1932,0.017659731288700128
SIM,1913,23,45-49,1936,4
SIM,1914,55,na,1969,7211
STAT,1871,35,25-29,1906,5.832018692537653
SIM,1907,24,15-19,1931,10
SIM,1816,53,na,1869,2588
SIM,1909,47,40-44,1956,1
SIM,1918,21,na,1939,8161
SIM,1844,21,45-49,1865,2
STAT,1892,34,50-100,1926,2.2967065843103334
SIM,1844,48,35-39,1892,1
STAT,1940,29,20-24,1969,37.55872820503095
STAT,1915,18,20-24,1933,57.16164409720136
STAT,1893,39,40-44,1932,11.093091231948685
SIM,1892,15,15-19,1907,16
STAT,1884,39,15-19,1923,0.11086028115396829
SIM,1897,24,30-34,1921,68
STAT,1946,26,35-39,1972,33.788994362517826
SIM,1906,26,na,1932,6993
SIM,1848,31,40-44,1879,14
STAT,1905,23,45-49,1928,2.0304298897423374
STAT,1862,19,50-100,1881,0.08710544564034738
STAT,1912,19,35-39,1931,1.7049321571506935
STAT,1868,42,na,1910,4435.6404647689915
SIM,1812,44,25-29,1856,2
SIM,1814,52,na,1866,2549
SIM,1920,19,35-39,1939,10
STAT,1883,25,na,1908,4767.64180598314
SIM,1874,21,40-44,1895,4
SIM,1937,23,30-34,1960,77
STAT,1852,16,30-34,1868,3.090631148719115
STAT,1888,22,20-24,1910,164.49861105658437
SIM,1873,21,40-44,1894,7
STAT,1890,65,na,1955,4166.021121368423
SIM,1860,16,30-34,1876,5
STAT,1897,30,15-19,1927,0.3875399883535967
STAT,1773,112,na,1885,0.0014418241827686127
STAT,1922,41,50-100,1963,0.2726507679336247
SIM,1860,65,na,1925,2920
STAT,1857,22,45-49,1879,1.267256336325208
SIM,1845,27,35-39,1872,20
SIM,1864,34,45-49,1898,6
STAT,1827,54,50-100,1881,0.02302513799416587
SIM,1929,24,35-39,1953,27
STAT,1820,45,50-100,1865,0.9408209973561203
STAT,1847,70,na,1917,2138.7647089319535
STAT,1906,27,50-100,1933,1.8825790083451297
STAT,1920,18,30-34,1938,27.539798764180006
STAT,1866,53,45-49,1919,0.026609375437951076
STAT,1923,39,na,1962,8782.387500691646
STAT,1848,96,na,1944,14.07960454647112
SIM,1804,68,na,1872,1502
STAT,1856,34,45-49,1890,2.6940225069109873
STAT,1836,21,45-49,1857,1.2327350789900664
STAT,1834,42,45-49,1876,2.401723600181251
STAT,1883,18,15-19,1901,11.744918567898333
SIM,1923,18,20-24,1941,308
STAT,1866,21,40-44,1887,3.9431535595810514
STAT,1900,66,na,1966,5123.052254056481
SIM,1903,33,30-34,1936,42
SIM,1861,9,na,1870,5370
SIM,1890,47,na,1937,5915
SIM,1853,35,30-34,1888,14
STAT,1849,7,na,1856,4819.240203062399
STAT,1865,32,45-49,1897,3.199584555253885
STAT,1855,32,35-39,1887,15.54897861819118
STAT,1918,15,20-24,1933,60.06035568510898
SIM,1830,42,35-39,1872,6
SIM,1829,31,20-24,1860,4
STAT,1879,10,na,1889,5506.972103269741
SIM,1832,23,45-49,1855,1
STAT,1830,34,25-29,1864,19.620761343055946
STAT,1837,43,25-29,1880,1.042922593426587
SIM,1928,28,50-100,1956,3
STAT,1866,77,na,1943,1610.7772360712274
STAT,1826,48,40-44,1874,0.33677840650527313
STAT,1865,21,40-44,1886,3.897859114062364
STAT,1872,1,na,1873,7103.986919778781
STAT,1898,23,45-49,1921,1.8999519866835077
SIM,1946,16,35-39,1962,12
SIM,1941,26,25-29,1967,163
STAT,1881,82,na,1963,1377.2833476427709
SIM,1891,18,15-19,1909,13
STAT,1849,44,na,1893,3606.5670230498495
STAT,1933,26,25-29,1959,176.60439352275068
SIM,1841,20,na,1861,3946
STAT,1929,23,30-34,1952,73.17035625952349
SIM,1856,23,30-34,1879,43
STAT,1914,56,na,1970,7085.520193465889
STAT,1867,49,40-44,1916,0.31705094581456034
STAT,1912,6,na,1918,8160.800878175102
SIM,1917,39,30-34,1956,6
STAT,1843,43,na,1886,3291.066111080936
STAT,1866,35,15-19,1901,0.10563669329527635
STAT,1887,83,na,1970,1689.0828909386262
SIM,1785,84,na,1869,131
SIM,1926,15,20-24,1941,322
STAT,1921,38,na,1959,8473.390466961164
SIM,1842,46,50-100,1888,1
STAT,1839,44,na,1883,3707.3320011141595
STAT,1822,42,35-39,1864,6.094038334164907
STAT,1864,24,25-29,1888,103.50543543093468
STAT,1927,37,40-44,1964,3.758353450859313
SIM,1916,20,45-49,1936,3
STAT,1763,108,na,1871,0.0045956130381554225
SIM,1890,48,50-100,1938,1
SIM,1902,15,35-39,1917,2
STAT,1845,105,na,1950,0.045181268141280644
STAT,1904,18,45-49,1922,0.18885683461289798
SIM,1925,25,30-34,1950,112
SIM,1819,37,35-39,1856,16
SIM,1888,40,25-29,1928,2
STAT,1917,49,30-34,1966,0.18693544343049417
SIM,1934,17,na,1951,9900
STAT,1930,20,50-100,1950,1.7125497402808674
SIM,1845,43,25-29,1888,4
SIM,1863,79,na,1942,1201
STAT,1783,90,na,1873,51.77034817161814
SIM,1811,54,na,1865,2337
SIM,1899,39,na,1938,6527
STAT,1850,19,15-19,1869,10.988561581431346
STAT,1878,28,35-39,1906,20.280850564587624
STAT,1861,68,na,1929,2568.9129040479406
SIM,1897,17,40-44,1914,1
SIM,1836,36,na,1872,3387
SIM,1876,12,na,1888,5607
SIM,1886,28,35-39,1914,26
STAT,1889,17,40-44,1906,0.45547120474926883
STAT,1851,78,na,1929,1211.208381672709
STAT,1908,20,45-49,1928,2.1029662718539894
SIM,1801,54,na,1855,2356
STAT,1783,105,na,1888,0.03698852210360984
STAT,1909,39,30-34,1948,3.450896529225784
STAT,1949,7,na,1956,9231.950283703778
SIM,1933,16,25-29,1949,156
STAT,1793,73,na,1866,974.8243175837432
STAT,1905,38,na,1943,6901.190479393562
SIM,1827,29,40-44,1856,11
STAT,1773,90,na,1863,53.16845979050858
SIM,1820,36,30-34,1856,11
STAT,1902,38,30-34,1940,3.2637558741613253
STAT,1852,23,20-24,1875,129.54016042097757
STAT,1826,47,na,1873,3058.277028032517
STAT,1880,40,30-34,1920,2.470684162452345
STAT,1867,27,30-34,1894,47.62966462097365
STAT,1926,30,50-100,1956,2.021029054321783
STAT,1862,57,na,1919,3469.0275233968787
STAT,1796,87,na,1883,119.60410529197323
SIM,1888,32,40-44,1920,14
STAT,1840,53,50-100,1893,0.021449896943821475
SIM,1870,31,15-19,1901,1
STAT,1841,51,35-39,1892,0.012550906538372864
STAT,1874,8,na,1882,5561.05343323354
STAT,1945,19,45-49,1964,1.101254807758924
SIM,1934,30,50-100,1964,5
SIM,1910,38,30-34,1948,8
STAT,1875,82,na,1957,1109.690016139609
STAT,1839,42,45-49,1881,2.4629863156081107
STAT,1843,45,50-100,1888,0.3513246885686823
STAT,1905,42,na,1947,6765.598190275719
STAT,1925,16,25-29,1941,105.96252427933774
STAT,1934,16,15-19,1950,124.29792129693692
SIM,1888,20,20-24,1908,171
STAT,1952,16,35-39,1968,10.157718878855974
SIM,1855,41,40-44,1896,8
STAT,1858,49,15-19,1907,6.166177491707482E-4
STAT,1876,67,na,1943,3311.297696535222
SIM,1885,22,45-49,1907,1
SIM,1915,16,20-24,1931,58
STAT,1923,23,na,1946,8552.14688726187
SIM,1812,54,50-100,1866,1
SIM,1847,42,45-49,1889,7
SIM,1865,33,na,1898,4420
SIM,1871,33,25-29,1904,24
SIM,1878,26,35-39,1904,27
SIM,1896,32,na,1928,6641
STAT,1886,43,20-24,1929,0.3361344347166104
SIM,1839,32,45-49,1871,7
STAT,1876,43,50-100,1919,2.1908385222578697
STAT,1842,17,15-19,1859,11.345872044100863
STAT,1898,55,na,1953,5651.242580072091
SIM,1863,32,35-39,1895,29
SIM,1814,68,na,1882,1619
SIM,1887,35,25-29,1922,8
STAT,1908,56,na,1964,6464.370608728313
STAT,1845,35,30-34,1880,9.681219331590071
STAT,1938,16,35-39,1954,8.38161913171324
STAT,1910,29,25-29,1939,127.4950196920336
SIM,1846,8,na,1854,4781
SIM,1899,27,50-100,1926,2
SIM,1884,43,50-100,1927,4
SIM,1881,33,na,1914,4058
SIM,1910,35,na,1945,7628
SIM,1850,17,15-19,1867,10
STAT,1879,35,25-29,1914,6.14000189497831
STAT,1943,23,30-34,1966,61.73502200653105
STAT,1819,52,20-24,1871,0.002973149689757981
STAT,1830,70,na,1900,1937.4814985282962
STAT,1878,44,25-29,1922,1.3362190307679462
STAT,1956,15,40-44,1971,3.739375235237014
SIM,1879,25,25-29,1904,91
STAT,1830,24,30-34,1854,95.11981911126279
STAT,1907,15,45-49,1922,0.1948017578796407
STAT,1911,37,45-49,1948,1.3302085249233173
SIM,1917,23,30-34,1940,73
SIM,1861,43,50-100,1904,4
SIM,1938,25,40-44,1963,13
SIM,1886,44,25-29,1930,2
SIM,1890,22,50-100,1912,5
STAT,1912,36,35-39,1948,4.79202070933121
STAT,1895,10,na,1905,6816.781044625341
STAT,1919,45,35-39,1964,0.2836975172432705
STAT,1847,41,40-44,1888,3.492243952680495
STAT,1929,24,na,1953,9267.295640237573
SIM,1902,28,30-34,1930,78
SIM,1922,20,na,1942,8896
STAT,1891,47,50-100,1938,0.3442335610786213
STAT,1767,90,na,1857,47.17572985177301
STAT,1884,23,15-19,1907,6.558816642110695
SIM,1880,30,30-34,1910,46
STAT,1936,19,50-100,1955,0.7206844804471965
STAT,1908,26,15-19,1934,1.3648178731729326
STAT,1919,29,45-49,1948,3.7422329901028015
STAT,1949,19,30-34,1968,28.608960381445993
STAT,1838,34,25-29,1872,16.87141667503936
STAT,1838,96,na,1934,11.620899847429095
STAT,1847,43,50-100,1890,1.5987606837289006
STAT,1845,15,50-100,1860,0.09655100506912558
STAT,1882,22,50-100,1904,0.8022854951271524
STAT,1877,25,na,1902,5038.871789154735
SIM,1853,42,20-24,1895,4
STAT,1935,37,30-34,1972,5.148027591928256
SIM,1890,31,na,1921,6273
SIM,1892,23,15-19,1915,10
STAT,1880,17,50-100,1897,0.10423379906090056
SIM,1920,36,35-39,1956,9
STAT,1872,30,30-34,1902,35.72355695856649
STAT,1909,49,40-44,1958,0.2910346566512797
STAT,1781,88,na,1869,87.76880878117262
SIM,1915,36,25-29,1951,3
STAT,1852,26,na,1878,4044.886543602637
STAT,1928,4,na,1932,10269.667242604984
SIM,1848,21,30-34,1869,39
STAT,1842,71,na,1913,1987.2703781840373
STAT,1848,33,40-44,1881,7.468337309248808
SIM,1832,29,15-19,1861,1
STAT,1898,29,15-19,1927,1.2311462701351703
STAT,1909,23,30-34,1932,53.81129256648604
STAT,1874,42,na,1916,4773.562652549498
STAT,1894,46,30-34,1940,0.14206473383754636
SIM,1914,22,50-100,1936,1
SIM,1849,37,30-34,1886,9
SIM,1908,16,15-19,1924,22
STAT,1912,29,45-49,1941,3.4147248092586757
SIM,1872,50,na,1922,4602
SIM,1894,36,30-34,1930,18
STAT,1858,29,50-100,1887,1.0162560685581639
SIM,1920,29,45-49,1949,3
STAT,1892,40,40-44,1932,5.744217098579965
STAT,1917,23,na,1940,7813.632152058408
STAT,1844,24,25-29,1868,113.77421749364707
STAT,1876,37,15-19,1913,0.11729900288273985
STAT,1819,45,30-34,1864,0.4186354119948317
SIM,1852,24,25-29,1876,124
STAT,1858,51,45-49,1909,0.022957932507324835
STAT,1896,32,50-100,1928,2.443103079586381
SIM,1846,34,25-29,1880,23
STAT,1837,59,na,1896,2708.713885955594
STAT,1787,89,na,1876,71.6917716256448
STAT,1837,53,35-39,1890,0.01180919247901523
SIM,1856,33,40-44,1889,12
STAT,1873,25,na,1898,4930.504376689511
STAT,1809,46,15-19,1855,0.0031571967382449085
STAT,1886,36,30-34,1922,11.41704137327962
STAT,1822,32,25-29,1854,65.70880469527174
STAT,1906,22,50-100,1928,1.2001044210317937
SIM,1900,15,15-19,1915,14
STAT,1882,52,35-39,1934,0.016847267775194533
SIM,1866,29,50-100,1895,2
SIM,1927,29,45-49,1956,5
SIM,1807,70,na,1877,1182
SIM,1902,61,na,1963,5787
SIM,1907,26,25-29,1933,144
SIM,1914,20,25-29,1934,200
STAT,1925,20,45-49,1945,2.7357395700839797
SIM,1902,34,25-29,1936,19
STAT,1912,16,30-34,1928,4.991352906008526
STAT,1903,46,35-39,1949,0.22773267811783854
STAT,1862,38,35-39,1900,12.148727753749153
SIM,1837,25,35-39,1862,19
STAT,1813,46,na,1859,2772.18927044178
SIM,1888,27,40-44,1915,9
SIM,1854,65,na,1919,2736
STAT,1896,16,35-39,1912,1.4666869752352178
STAT,1857,31,40-44,1888,6.940690558155051
STAT,1917,21,15-19,1938,11.459640426013273
STAT,1906,47,15-19,1953,6.609299664178055E-4
SIM,1939,27,15-19,1966,5
STAT,1864,22,35-39,1886,10.70425662466464
SIM,1877,35,50-100,1912,5
STAT,1835,36,15-19,1871,0.09089385408703193
STAT,1882,24,45-49,1906,1.3633197609722625
SIM,1847,33,30-34,1880,7
SIM,1916,21,20-24,1937,236
STAT,1863,50,25-29,1913,0.006351913478865153
STAT,1801,53,20-24,1854,0.00453046588225555
STAT,1812,88,na,1900,130.13198716270986
SIM,1870,27,na,1897,4654
SIM,1864,85,na,1949,384
SIM,1862,5,na,1867,5320
STAT,1872,7,na,1879,5538.890822231592
SIM,1837,83,na,1920,466
STAT,1946,24,45-49,1970,2.5268508971105543
STAT,1951,18,40-44,1969,3.3625358539612145
SIM,1929,35,40-44,1964,7
SIM,1843,31,20-24,1874,6
STAT,1850,21,45-49,1871,1.2925690912802246
STAT,1885,10,na,1895,5207.322472053932
STAT,1922,44,na,1966,8578.344618164667
SIM,1872,22,35-39,1894,15
STAT,1827,38,50-100,1865,2.484116721596124
STAT,1909,48,45-49,1957,0.40243616227615026
STAT,1908,18,na,1926,7551.651442903218
STAT,1869,95,na,1964,79.3416437082347
STAT,1824,83,na,1907,424.4330766595229
SIM,1916,35,30-34,1951,6
STAT,1829,25,35-39,1854,54.94140979086261
SIM,1895,18,35-39,1913,2
STAT,1857,24,35-39,1881,9.512406160160593
SIM,1925,34,na,1959,9023
SIM,1870,38,35-39,1908,23
STAT,1877,22,45-49,1899,1.462393656822755
STAT,1909,45,50-100,1954,0.4240116207297637
STAT,1873,18,40-44,1891,0.37434398286545967
SIM,1890,24,45-49,1914,1
STAT,1885,25,25-29,1910,85.61531312655521
SIM,1834,33,20-24,1867,6
STAT,1904,15,50-100,1919,0.1426745255139139
STAT,1882,77,na,1959,1975.4740622490588
SIM,1815,49,50-100,1864,1
STAT,1863,30,20-24,1893,4.817151549472375
STAT,1874,21,30-34,1895,36.94549003489601
SIM,1908,36,35-39,1944,10
SIM,1908,55,na,1963,6405
STAT,1835,31,20-24,1866,4.505623045488081
STAT,1899,38,30-34,1937,3.1673688648948723
SIM,1902,39,35-39,1941,7
STAT,1910,59,na,1969,6511.981924960631
SIM,1875,23,15-19,1898,8
SIM,1823,33,45-49,1856,5
STAT,1821,65,na,1886,1888.3346869802585
STAT,1904,38,15-19,1942,0.03495981926957833
SIM,1850,65,na,1915,2670
STAT,1800,70,na,1870,1441.4934007894283
STAT,1888,55,na,1943,4935.766947440836
STAT,1821,51,30-34,1872,0.01709583872479652
SIM,1865,24,35-39,1889,14
SIM,1877,16,25-29,1893,12
STAT,1825,31,na,1856,3397.030794066465
SIM,1831,23,50-100,1854,1
STAT,1838,44,50-100,1882,1.4831399954031177
STAT,1893,15,na,1908,6495.2821608849
STAT,1877,42,15-19,1919,0.028925741220199537
SIM,1909,37,30-34,1946,6
SIM,1882,12,na,1894,5387
STAT,1893,24,20-24,1917,175.30323839986093
STAT,1867,23,15-19,1890,6.220574047681886
STAT,1858,11,na,1869,4410.462861972813
STAT,1793,83,na,1876,266.1386011109362
STAT,1804,54,35-39,1858,0.04835315478670629
STAT,1889,34,40-44,1923,10.706973459721636
STAT,1838,32,35-39,1870,17.031150419861078
STAT,1932,37,15-19,1969,0.052113444864845426
SIM,1907,28,15-19,1935,1
STAT,1908,35,30-34,1943,3.4813518956035834
STAT,1809,48,40-44,1857,1.3032030622998831
STAT,1919,42,30-34,1961,0.2797475800886889
SIM,1879,22,20-24,1901,133
STAT,1837,24,50-100,1861,0.7335586929818245
STAT,1887,18,35-39,1905,1.2361729116382303
STAT,1898,20,40-44,1918,5.729213370446628
STAT,1936,20,20-24,1956,214.89198891529335
STAT,1899,30,35-39,1929,28.248248730436774
STAT,1893,18,na,1911,6448.304757299078
STAT,1894,62,na,1956,4790.485105460329
SIM,1917,48,45-49,1965,1
SIM,1828,27,35-39,1855,24
STAT,1841,23,45-49,1864,1.272501787790769
SIM,1906,22,40-44,1928,7
STAT,1799,74,na,1873,943.1790206259241
STAT,1870,45,na,1915,4505.520307402765
STAT,1833,50,na,1883,3034.6953634559113
STAT,1845,78,na,1923,1203.9834432087919
STAT,1867,28,50-100,1895,1.205670966297937
SIM,1893,25,25-29,1918,126
SIM,1946,8,na,1954,8659
STAT,1908,21,20-24,1929,207.2157789683113
STAT,1911,15,35-39,1926,1.704226546901214
SIM,1786,76,na,1862,796
SIM,1869,30,na,1899,4647
SIM,1902,34,40-44,1936,11
SIM,1775,91,na,1866,12
STAT,1808,83,na,1891,311.9527474851655
SIM,1832,53,na,1885,2877
STAT,1844,35,na,1879,4100.8063211449735
SIM,1932,19,na,1951,9916
STAT,1876,32,20-24,1908,5.64631056476217
SIM,1881,64,na,1945,2900
SIM,1845,13,na,1858,4888
STAT,1867,5,na,1872,5343.013908447795
SIM,1920,16,30-34,1936,36
STAT,1855,78,na,1933,1178.1984472716886
SIM,1942,16,15-19,1958,93
SIM,1933,20,45-49,1953,5
STAT,1793,80,na,1873,502.08731424603747
STAT,1863,97,na,1960,19.384701853656814
STAT,1920,24,25-29,1944,206.04676158327518
SIM,1879,31,35-39,1910,26
SIM,1826,34,25-29,1860,22
SIM,1826,46,na,1872,2986
SIM,1847,26,40-44,1873,9
SIM,1817,48,40-44,1865,1
STAT,1942,26,50-100,1968,2.1108356372368693
SIM,1851,20,na,1871,4160
STAT,1845,19,40-44,1864,0.3520395381573469
SIM,1866,40,40-44,1906,8
STAT,1843,26,30-34,1869,43.726451799548485
STAT,1945,17,na,1962,8119.795100411892
SIM,1862,43,25-29,1905,3
STAT,1876,39,40-44,1915,9.051959167921781
STAT,1867,39,15-19,1906,0.10514314174258849
STAT,1826,40,45-49,1866,3.2941070877957643
SIM,1887,58,na,1945,4758
STAT,1784,105,na,1889,0.03504546880185462
SIM,1925,21,15-19,1946,12
STAT,1889,10,na,1899,6450.514915332518
SIM,1846,32,35-39,1878,29
STAT,1867,51,50-100,1918,0.02870238799672251
STAT,1837,40,20-24,1877,0.26803354341271013
STAT,1839,33,30-34,1872,33.202594084956345
SIM,1853,19,40-44,1872,1
SIM,1865,31,40-44,1896,14
STAT,1821,44,25-29,1865,1.929989294218488
SIM,1851,26,30-34,1877,59
SIM,1860,23,20-24,1883,2
SIM,1944,20,20-24,1964,253
STAT,1855,15,35-39,1870,0.9958267329841778
SIM,1884,39,40-44,1923,15
STAT,1939,26,45-49,1965,3.509593539788113
STAT,1863,43,35-39,1906,3.1782131369341036
STAT,1833,22,40-44,1855,3.810116858382069
SIM,1838,30,35-39,1868,7
SIM,1885,49,35-39,1934,1
SIM,1855,28,40-44,1883,10
SIM,1916,28,40-44,1944,15
STAT,1852,28,15-19,1880,0.8361953904022994
STAT,1902,36,40-44,1938,2.7070484243292188
STAT,1839,26,40-44,1865,5.935034783954116
STAT,1893,31,45-49,1924,4.482214767306169
SIM,1907,28,30-34,1935,93
STAT,1930,28,15-19,1958,1.812022265880861
SIM,1826,53,na,1879,2633
SIM,1850,37,50-100,1887,4
STAT,1897,21,35-39,1918,15.801268464674068
STAT,1916,16,15-19,1932,19.494017279246897
SIM,1838,44,45-49,1882,6
STAT,1934,25,30-34,1959,106.56272286976824
SIM,1847,83,na,1930,561
STAT,1905,37,20-24,1942,0.48596229097161064
STAT,1931,39,20-24,1970,0.7036069170897172
SIM,1891,42,50-100,1933,8
STAT,1866,18,15-19,1884,11.284220198336868
SIM,1834,26,30-34,1860,57
SIM,1933,28,40-44,1961,23
STAT,1856,26,40-44,1882,4.871885552720255
SIM,1901,29,25-29,1930,128
STAT,1898,32,40-44,1930,11.852626660546626
STAT,1863,17,35-39,1880,1.1069334259983945
STAT,1889,20,15-19,1909,8.264355404537536
STAT,1897,35,45-49,1932,5.432810947777546
STAT,1906,24,40-44,1930,6.094142421983527
STAT,1827,50,na,1877,2941.405790434525
STAT,1836,41,15-19,1877,0.02212980646215505
STAT,1845,53,25-29,1898,0.005370379767806923
SIM,1950,18,15-19,1968,99
STAT,1893,17,30-34,1910,4.080111405768882
STAT,1910,15,50-100,1925,0.15068205609356128
SIM,1951,4,na,1955,9809
STAT,1878,41,20-24,1919,0.33650016145807365
STAT,1905,3,na,1908,7721.497227306056
SIM,1906,20,na,1926,6967
SIM,1839,41,40-44,1880,8
SIM,1856,50,na,1906,3670
SIM,1816,91,na,1907,28
SIM,1933,18,15-19,1951,122
SIM,1868,78,na,1946,1373
STAT,1818,53,15-19,1871,1.0193062083463347E-4
STAT,1835,38,40-44,1873,6.939956071286707
STAT,1948,17,20-24,1965,313.33034747724093
SIM,1843,38,40-44,1881,13
STAT,1865,23,30-34,1888,32.84194627872965
SIM,1943,15,20-24,1958,256
SIM,1910,36,40-44,1946,4
SIM,1869,21,15-19,1890,8
STAT,1821,37,35-39,1858,27.69279241970537
STAT,1846,23,50-100,1869,0.7651566625338443
STAT,1956,4,na,1960,10508.0585186566
STAT,1847,28,40-44,1875,5.449008685299686
STAT,1861,26,15-19,1887,0.7737744964109393
SIM,1849,33,15-19,1882,1
STAT,1831,65,na,1896,2181.99189257278
STAT,1879,33,35-39,1912,21.30291588914804
SIM,1835,98,na,1933,5
SIM,1873,37,50-100,1910,4
STAT,1941,21,na,1962,7624.565572870143
SIM,1829,32,35-39,1861,26
SIM,1928,34,45-49,1962,7
STAT,1920,29,35-39,1949,33.0167649542679
SIM,1860,28,15-19,1888,1
SIM,1867,38,na,1905,4758
STAT,1849,50,40-44,1899,0.01689192267921889
STAT,1813,52,35-39,1865,0.05062351662630735
SIM,1924,16,15-19,1940,98
SIM,1786,69,na,1855,1425
STAT,1914,39,20-24,1953,0.5263003207228427
STAT,1926,26,35-39,1952,36.467163427568686
SIM,1897,20,15-19,1917,9
SIM,1867,35,25-29,1902,10
SIM,1859,32,45-49,1891,5
STAT,1859,37,50-100,1896,1.973583214229408
SIM,1856,60,na,1916,3191
STAT,1812,98,na,1910,3.0793128228761826
STAT,1880,43,35-39,1923,3.8248079321416077
SIM,1890,5,na,1895,6955
STAT,1916,28,15-19,1944,1.468983913729288
STAT,1868,44,15-19,1912,0.026177766502793846
SIM,1942,25,30-34,1967,111
STAT,1863,53,50-100,1916,0.026271461235189482
SIM,1864,26,40-44,1890,6
STAT,1925,28,40-44,1953,11.077071055951397
SIM,1829,38,40-44,1867,13
STAT,1849,75,na,1924,1628.4013126127686
STAT,1911,17,25-29,1928,17.518802160545867
SIM,1907,23,20-24,1930,200
STAT,1882,16,40-44,1898,0.36072664927267045
SIM,1875,26,na,1901,5367
SIM,1907,15,na,1922,7647
STAT,1884,27,30-34,1911,50.21951906361558
STAT,1898,25,35-39,1923,26.55027997050297
SIM,1873,23,30-34,1896,44
SIM,1924,23,20-24,1947,267
SIM,1860,30,45-49,1890,4
STAT,1826,33,20-24,1859,7.602002394633689
STAT,1900,45,20-24,1945,0.01915326015558221
STAT,1930,41,35-39,1971,0.5358585376013769
STAT,1934,35,50-100,1969,1.1723395183461287
STAT,1781,95,na,1876,4.942594368567407
STAT,1837,27,35-39,1864,17.264977120996118
SIM,1864,20,35-39,1884,13
SIM,1887,33,35-39,1920,31
STAT,1918,44,50-100,1962,0.2513812831028841
SIM,1868,22,45-49,1890,1
STAT,1858,52,50-100,1910,0.023651462814832512
STAT,1863,63,na,1926,3154.472673719481
STAT,1909,45,25-29,1954,0.09944246409502962
STAT,1928,32,na,1960,9549.45030077676
SIM,1938,21,25-29,1959,212
STAT,1851,31,50-100,1882,1.4937581518836704
STAT,1931,27,20-24,1958,47.59733832878921
STAT,1935,15,20-24,1950,376.1250776855908
SIM,1843,40,50-100,1883,5
SIM,1917,45,40-44,1962,1
SIM,1947,19,20-24,1966,333
SIM,1895,40,na,1935,6488
STAT,1939,19,20-24,1958,273.9253716250932
SIM,1850,20,40-44,1870,7
SIM,1829,33,50-100,1862,2
STAT,1854,54,50-100,1908,0.022515649264361188
SIM,1887,21,50-100,1908,2
SIM,1879,23,na,1902,4880
SIM,1934,26,35-39,1960,50
STAT,1847,21,20-24,1868,129.70769723505413
SIM,1915,34,na,1949,7745
SIM,1875,34,20-24,1909,6
STAT,1831,54,45-49,1885,0.018779975091038834
SIM,1862,50,na,1912,3997
SIM,1942,18,40-44,1960,3
SIM,1918,30,20-24,1948,5
STAT,1854,53,35-39,1907,0.01298567695137265
STAT,1919,49,15-19,1968,8.020377612575724E-4
STAT,1867,34,20-24,1901,5.068859488256345
SIM,1825,36,30-34,1861,12
SIM,1839,34,35-39,1873,26
STAT,1826,38,15-19,1864,0.1286152767953531
STAT,1828,76,na,1904,1163.4644183150572
SIM,1871,43,35-39,1914,3
STAT,1877,49,35-39,1926,0.2874719600525569
STAT,1916,23,20-24,1939,234.59108210306883
STAT,1847,44,45-49,1891,2.250596737743664
STAT,1942,18,15-19,1960,95.75629888071744
SIM,1838,21,20-24,1859,133
SIM,1938,29,20-24,1967,36
STAT,1852,30,45-49,1882,2.9380421399148724
STAT,1894,49,35-39,1943,0.2006060031405696
STAT,1893,29,15-19,1922,1.1531222641118766
STAT,1925,18,15-19,1943,110.40864304624354
STAT,1897,43,50-100,1940,0.19662095333151616
STAT,1934,18,40-44,1952,3.8114682939637983
SIM,1828,46,50-100,1874,2
STAT,1883,15,na,1898,5034.7771245001095
SIM,1864,27,na,1891,4551
SIM,1914,24,40-44,1938,6
STAT,1841,49,20-24,1890,0.017047627444311143
STAT,1892,30,na,1922,6081.7969708339815
STAT,1900,29,50-100,1929,1.779368849436691
STAT,1842,20,40-44,1862,3.9698485984397953
SIM,1947,20,50-100,1967,2
STAT,1880,50,25-29,1930,0.007644184959123573
STAT,1926,45,25-29,1971,0.1327870928998246
STAT,1874,36,50-100,1910,2.5510871527758034
STAT,1846,17,35-39,1863,1.0557910235179324
STAT,1862,42,20-24,1904,0.27380573730126934
SIM,1854,17,35-39,1871,1
SIM,1808,99,na,1907,2
SIM,1855,44,45-49,1899,7
STAT,1861,21,20-24,1882,119.87015711136686
SIM,1896,29,40-44,1925,9
STAT,1843,38,15-19,1881,0.08270321941545686
STAT,1888,29,40-44,1917,7.099499404149854
STAT,1911,24,15-19,1935,10.135150005157353
SIM,1889,32,40-44,1921,18
STAT,1852,38,40-44,1890,6.942303308635023
SIM,1844,65,na,1909,2367
STAT,1921,21,50-100,1942,1.5051386035205165
SIM,1878,21,25-29,1899,144
SIM,1967,2,na,1969,10517
SIM,1860,38,40-44,1898,11
SIM,1903,44,35-39,1947,1
STAT,1857,63,na,1920,2808.8462743335895
STAT,1865,16,40-44,1881,0.3478710052639967
STAT,1920,24,40-44,1944,7.500348946235789
SIM,1875,27,30-34,1902,70
SIM,1916,24,25-29,1940,225
STAT,1882,21,40-44,1903,4.112055870001281
SIM,1897,11,na,1908,7165
STAT,1835,34,25-29,1869,16.549351625860872
STAT,1885,27,15-19,1912,0.9120764829397483
SIM,1816,84,na,1900,258
STAT,1917,36,35-39,1953,5.097830440184158
STAT,1934,21,15-19,1955,14.454693955683695
SIM,1834,22,15-19,1856,5
STAT,1816,48,50-100,1864,1.1883837891418216
SIM,1870,35,30-34,1905,14
SIM,1841,21,45-49,1862,1
SIM,1944,1,na,1945,8984
STAT,1926,35,15-19,1961,0.04747250596668105
STAT,1869,54,25-29,1923,0.0067408932363467585
STAT,1885,22,20-24,1907,138.5345232869479
SIM,1937,24,45-49,1961,4
SIM,1817,79,na,1896,636
STAT,1839,22,25-29,1861,114.84902225384381
SIM,1908,33,30-34,1941,37
SIM,1900,19,30-34,1919,3
STAT,1836,64,na,1900,2311.29208854874
STAT,1927,30,20-24,1957,6.065713423259179
SIM,1855,21,20-24,1876,142
SIM,1908,38,25-29,1946,4
STAT,1821,41,20-24,1862,0.5194899090994826
STAT,1921,34,35-39,1955,20.3579231410841
SIM,1865,21,30-34,1886,37
SIM,1901,32,50-100,1933,6
STAT,1865,33,40-44,1898,7.923477391361653
STAT,1867,56,na,1923,3857.8139504238925
SIM,1852,47,30-34,1899,1
SIM,1851,33,20-24,1884,6
SIM,1890,21,40-44,1911,6
STAT,1834,53,50-100,1887,0.020209299525877883
SIM,1806,91,na,1897,19
SIM,1920,22,25-29,1942,259
STAT,1848,54,50-100,1902,0.024083091669912977
SIM,1843,34,25-29,1877,25
SIM,1893,27,15-19,1920,1
STAT,1857,34,45-49,1891,2.7216169296873294
SIM,1929,38,45-49,1967,2
SIM,1942,21,15-19,1963,11
STAT,1810,105,na,1915,0.026516229799657537
STAT,1901,45,na,1946,6425.742286145297
STAT,1949,22,20-24,1971,262.0286417669851
SIM,1865,41,35-39,1906,7
SIM,1847,45,na,1892,3458
SIM,1928,24,35-39,1952,30
SIM,1892,27,30-34,1919,96
STAT,1818,83,na,1901,407.2860010868012
STAT,1901,19,40-44,1920,0.5143611505089261
SIM,1875,41,45-49,1916,6
STAT,1818,36,15-19,1854,0.4307714475074547
SIM,1947,23,40-44,1970,13
STAT,1851,28,30-34,1879,45.378196551839565
STAT,1898,22,30-34,1920,48.68253249910871
SIM,1885,26,na,1911,5041
STAT,1923,47,15-19,1970,8.70034132734835E-4
STAT,1860,30,50-100,1890,1.5147976689119942
SIM,1935,30,20-24,1965,9
STAT,1799,67,na,1866,1541.096006875936
STAT,1894,58,na,1952,5130.67260456731
STAT,1923,29,50-100,1952,2.290731678970092
STAT,1771,95,na,1866,3.714634336775792
STAT,1909,45,40-44,1954,0.2955651039167322
STAT,1812,51,na,1863,2742.7924586510717
STAT,1881,28,50-100,1909,1.244335999112585
SIM,1824,48,50-100,1872,2
STAT,1856,20,35-39,1876,10.714035432222301
SIM,1869,26,na,1895,4643
STAT,1867,41,45-49,1908,2.8435906670434683
SIM,1848,31,na,1879,3901
SIM,1902,37,45-49,1939,3
STAT,1804,69,na,1873,1422.7190600335844
SIM,1859,30,na,1889,4337
SIM,1915,38,50-100,1953,2
STAT,1907,38,50-100,1945,0.7827069994428281
SIM,1852,26,15-19,1878,1
STAT,1880,45,na,1925,4834.421868872039
SIM,1874,78,na,1952,1343
SIM,1785,91,na,1876,16
SIM,1839,31,30-34,1870,38
SIM,1866,12,na,1878,5239
SIM,1931,29,50-100,1960,7
SIM,1875,29,20-24,1904,29
STAT,1949,1,na,1950,9620.297529125433
SIM,1934,28,25-29,1962,180
STAT,1935,35,40-44,1970,4.235709336255323
SIM,1933,18,30-34,1951,44
STAT,1834,35,na,1869,3614.626882091099
STAT,1887,15,30-34,1902,3.6169477742941742
SIM,1917,25,20-24,1942,42
SIM,1937,18,na,1955,7343
STAT,1911,35,50-100,1946,0.8270254053258065
STAT,1903,26,30-34,1929,72.6606232085548
STAT,1783,80,na,1863,429.5222656966978
SIM,1836,46,na,1882,3024
STAT,1943,26,35-39,1969,32.30641288292834
SIM,1882,22,45-49,1904,3
STAT,1804,51,30-34,1855,0.03551803998102003
STAT,1856,21,50-100,1877,0.7433340253544001
STAT,1861,78,na,1939,1313.4268360378285
STAT,1939,23,40-44,1962,6.818290497278895
STAT,1871,42,30-34,1913,2.3039864939176855
SIM,1913,37,20-24,1950,1
STAT,1877,53,20-24,1930,0.0015226863806643467
SIM,1865,34,45-49,1899,3
STAT,1853,49,na,1902,3485.3775019530963
SIM,1879,42,40-44,1921,8
SIM,1844,37,50-100,1881,6
STAT,1786,94,na,1880,7.636318782809518
STAT,1843,33,20-24,1876,4.50506806615892
STAT,1925,18,30-34,1943,29.652954242151097
STAT,1854,40,20-24,1894,0.24591494039270367
SIM,1856,97,na,1953,3
STAT,1908,31,15-19,1939,0.24614071037798882
STAT,1932,17,45-49,1949,1.3360122999434971
SIM,1833,32,na,1865,3586
SIM,1847,22,25-29,1869,124
STAT,1908,24,25-29,1932,170.54168643295327
STAT,1876,35,25-29,1911,6.071357002833535
STAT,1895,44,25-29,1939,0.11576749124330064
STAT,1841,20,40-44,1861,3.8857210854857245
STAT,1885,44,15-19,1929,0.02738711488374238
STAT,1927,27,50-100,1954,2.4434857222562627
SIM,1935,27,50-100,1962,5
STAT,1908,28,40-44,1936,8.873437733294091
STAT,1865,37,50-100,1902,2.252676219782227
STAT,1911,38,40-44,1949,2.906520271073179
SIM,1891,31,35-39,1922,42
STAT,1874,24,35-39,1898,11.991732422892634
SIM,1874,85,na,1959,577
STAT,1776,115,na,1891,2.33046478560567E-4
STAT,1844,26,15-19,1870,0.9034235579991978
STAT,1835,24,na,1859,3628.033487160499
SIM,1905,3,na,1908,7968
SIM,1796,90,na,1886,45
STAT,1862,31,15-19,1893,0.24682889684374595
SIM,1898,40,35-39,1938,1
SIM,1940,17,45-49,1957,3
STAT,1836,37,50-100,1873,2.004121088132556
STAT,1872,52,40-44,1924,0.021254641710472824
STAT,1891,44,na,1935,5691.856932765713
STAT,1809,68,na,1877,1650.9538807448116
STAT,1849,34,na,1883,3895.800699365316
SIM,1921,28,15-19,1949,2
SIM,1871,30,20-24,1901,6
STAT,1886,29,na,1915,5051.566092331237
STAT,1821,34,30-34,1855,87.77164781103474
STAT,1909,25,20-24,1934,35.79200854487552
SIM,1829,64,na,1893,2249
SIM,1801,92,na,1893,34
SIM,1889,77,na,1966,2800
STAT,1924,18,na,1942,8826.737191620115
SIM,1884,35,25-29,1919,8
SIM,1770,92,na,1862,5
SIM,1906,25,45-49,1931,6
STAT,1885,26,50-100,1911,1.290384279804261
SIM,1824,40,35-39,1864,7
STAT,1876,77,na,1953,1805.5939477970744
SIM,1834,40,45-49,1874,4
SIM,1895,15,30-34,1910,4
STAT,1853,12,na,1865,4543.593968761601
SIM,1826,31,20-24,1857,6
STAT,1885,48,30-34,1933,0.19215155655307456
SIM,1893,22,20-24,1915,173
SIM,1928,17,45-49,1945,4
STAT,1864,28,40-44,1892,5.388884065018687
STAT,1867,63,na,1930,3374.8769455805527
SIM,1851,13,na,1864,4677
STAT,1825,38,30-34,1863,13.494000903286077
STAT,1883,31,35-39,1914,20.17698777981767
STAT,1865,20,50-100,1885,0.7683069325519271
SIM,1821,47,na,1868,2893
SIM,1873,20,50-100,1893,1
SIM,1939,17,20-24,1956,251
SIM,1901,24,30-34,1925,56
STAT,1913,28,15-19,1941,1.4159898552229062
STAT,1898,35,45-49,1933,5.5001179277902486
STAT,1846,64,na,1910,2662.6594519059827
SIM,1842,46,na,1888,3268
STAT,1788,68,na,1856,1448.82585316
SIM,1872,12,na,1884,5615
SIM,1911,29,35-39,1940,34
STAT,1858,47,25-29,1905,0.0902637095702679
SIM,1901,27,na,1928,6750
STAT,1863,40,30-34,1903,2.0530078899737947
STAT,1924,15,45-49,1939,1.2066642240865246
STAT,1927,40,15-19,1967,0.003899936801047822
SIM,1921,41,na,1962,8476
SIM,1933,22,na,1955,10225
STAT,1930,21,30-34,1951,74.58498834063877
SIM,1903,56,na,1959,6215
SIM,1834,28,20-24,1862,21
STAT,1920,27,45-49,1947,3.826591679891131
STAT,1939,17,na,1956,7441.8272024716425
STAT,1832,39,50-100,1871,1.9797829394152833
STAT,1773,102,na,1875,0.15435590885300354
SIM,1888,34,30-34,1922,11
SIM,1900,42,na,1942,6765
SIM,1932,15,45-49,1947,1
SIM,1850,72,na,1922,1908
STAT,1888,62,na,1950,4362.913265230233
STAT,1892,29,30-34,1921,63.21225177233914
SIM,1858,38,50-100,1896,3
SIM,1840,39,50-100,1879,5
STAT,1828,53,25-29,1881,0.005497070845141768
STAT,1898,14,na,1912,7035.373848637307
SIM,1854,27,na,1881,4238
STAT,1850,22,40-44,1872,3.8348559811518297
SIM,1791,91,na,1882,14
SIM,1871,40,30-34,1911,2
STAT,1880,54,40-44,1934,0.02178240331775642
STAT,1899,45,20-24,1944,0.018917498173894657
STAT,1819,68,na,1887,1654.455307613029
SIM,1921,0,na,1921,9710
STAT,1862,45,25-29,1907,0.10042045693475575
SIM,1925,16,15-19,1941,106
STAT,1906,27,45-49,1933,3.267560139694128
STAT,1889,33,45-49,1922,4.324197865009856
SIM,1907,30,45-49,1937,5
SIM,1838,41,40-44,1879,7
STAT,1859,37,na,1896,3787.207818844273
STAT,1955,16,35-39,1971,11.251783088751846
SIM,1769,91,na,1860,21
STAT,1897,32,40-44,1929,11.707581678563864
SIM,1845,9,na,1854,5004
SIM,1833,38,30-34,1871,15
SIM,1864,21,50-100,1885,1
SIM,1885,46,30-34,1931,1
SIM,1847,43,40-44,1890,10
STAT,1877,46,30-34,1923,0.20358128296891936
STAT,1918,18,na,1936,8068.58915540887
STAT,1944,27,30-34,1971,85.52293908060187
SIM,1841,19,15-19,1860,12
STAT,1868,48,na,1916,4268.808164636604
SIM,1821,42,25-29,1863,2
STAT,1869,16,25-29,1885,11.309619901506865
STAT,1873,63,na,1936,3661.4924539490717
SIM,1883,40,40-44,1923,3
SIM,1846,15,35-39,1861,1
STAT,1875,40,40-44,1915,4.724228234883425
STAT,1916,26,25-29,1942,137.91770793736032
SIM,1916,26,na,1942,7969
SIM,1890,41,na,1931,6088
STAT,1928,19,45-49,1947,1.2642136484402828
STAT,1844,43,15-19,1887,0.02254988750760638
STAT,1885,44,na,1929,4583.560455058703
STAT,1917,16,15-19,1933,19.77061058126848
STAT,1926,28,25-29,1954,158.7664034035533
SIM,1839,44,45-49,1883,6
SIM,1896,20,30-34,1916,59
STAT,1830,49,45-49,1879,0.3969724161744847
SIM,1858,49,40-44,1907,2
STAT,1858,37,30-34,1895,8.39098492022149
SIM,1934,23,30-34,1957,97
STAT,1888,25,25-29,1913,101.66130261495464
STAT,1870,37,30-34,1907,10.567632062325405
SIM,1850,30,35-39,1880,26
SIM,1906,18,20-24,1924,55
STAT,1842,23,45-49,1865,1.300051992316852
STAT,1794,68,na,1862,1473.779054479785
SIM,1848,30,50-100,1878,4
SIM,1929,22,45-49,1951,1
SIM,1897,33,45-49,1930,5
STAT,1884,37,25-29,1921,5.741897911677116
SIM,1911,39,45-49,1950,5
SIM,1914,27,45-49,1941,6
STAT,1913,30,na,1943,7662.559990183228
STAT,1861,24,25-29,1885,97.44663778426887
SIM,1838,31,na,1869,3705
STAT,1813,42,25-29,1855,4.771706314578413
STAT,1839,43,40-44,1882,3.654460379688724
SIM,1926,37,30-34,1963,7
STAT,1852,64,na,1916,2770.613426856258
STAT,1831,102,na,1933,0.37853233056704966
STAT,1857,21,30-34,1878,32.60471758957594
STAT,1904,31,30-34,1935,50.81800550784739
STAT,1826,28,20-24,1854,90.16323441877134
STAT,1837,49,na,1886,3172.6992568061037
SIM,1892,37,25-29,1929,10
SIM,1924,26,25-29,1950,170
SIM,1832,22,30-34,1854,41
STAT,1938,32,na,1970,7681.603512780041
SIM,1848,28,15-19,1876,1
STAT,1880,33,25-29,1913,21.69992679602864
STAT,1821,54,35-39,1875,0.02329181718556126
STAT,1912,22,25-29,1934,178.83083520235044
SIM,1919,36,50-100,1955,1
SIM,1829,34,25-29,1863,17
STAT,1903,39,45-49,1942,1.224834441186421
SIM,1807,80,na,1887,532
STAT,1926,23,30-34,1949,70.28957916190731
STAT,1952,18,25-29,1970,104.83970202424415
STAT,1911,28,30-34,1939,76.92334425957007
STAT,1833,21,45-49,1854,1.5255197797355198
SIM,1850,23,45-49,1873,3
SIM,1896,25,25-29,1921,133
STAT,1856,29,45-49,1885,1.7671426235112881
STAT,1917,47,40-44,1964,0.3325623820914563
STAT,1842,30,35-39,1872,18.59598685110395
STAT,1850,90,na,1940,120.88385773664656
SIM,1860,27,na,1887,4206
STAT,1947,25,40-44,1972,10.658398711410841
STAT,1893,19,20-24,1912,45.13949932977332
SIM,1864,31,40-44,1895,12
SIM,1909,43,25-29,1952,1
SIM,1915,41,na,1956,7630
SIM,1865,71,na,1936,2477
SIM,1837,20,25-29,1857,103
STAT,1843,49,na,1892,3085.8134668146963
STAT,1918,37,30-34,1955,3.8790841197052686
STAT,1836,52,20-24,1888,9.929443277774967E-4
STAT,1935,32,20-24,1967,6.816600949917256
SIM,1887,16,35-39,1903,1
SIM,1912,31,30-34,1943,32
STAT,1882,30,na,1912,4732.558064701301
SIM,1906,22,50-100,1928,4
STAT,1900,48,25-29,1948,0.08988436138261098
SIM,1819,98,na,1917,3
SIM,1912,39,na,1951,7532
STAT,1911,38,35-39,1949,4.696191072253839
SIM,1837,30,20-24,1867,7
STAT,1861,39,40-44,1900,7.284557746892503
SIM,1928,21,30-34,1949,91
SIM,1928,32,40-44,1960,13
STAT,1859,31,15-19,1890,0.22985430259422038
SIM,1926,24,30-34,1950,73
STAT,1904,40,35-39,1944,0.36818473697641435
SIM,1818,36,25-29,1854,7
STAT,1870,29,35-39,1899,18.99541713792898
SIM,1865,39,20-24,1904,2
STAT,1883,40,na,1923,4632.407241170866
STAT,1896,21,20-24,1917,184.30498251144786
SIM,1931,17,20-24,1948,360
STAT,1868,26,15-19,1894,0.8747931965837162
STAT,1854,99,na,1953,2.903274060579988
SIM,1883,19,15-19,1902,14
SIM,1909,27,35-39,1936,39
STAT,1902,43,35-39,1945,0.35595708911083684
SIM,1868,18,35-39,1886,3
STAT,1866,20,50-100,1886,0.7772349198084585
STAT,1879,35,na,1914,5024.214525948108
STAT,1866,29,15-19,1895,0.8394227823685745
STAT,1923,17,20-24,1940,321.416175682753
STAT,1900,35,25-29,1935,8.143037263365756
STAT,1940,26,na,1966,7719.076025346166
SIM,1880,29,45-49,1909,4
SIM,1852,20,45-49,1872,3
SIM,1885,27,25-29,1912,94
STAT,1877,27,25-29,1904,88.71277179823507
STAT,1908,17,25-29,1925,16.988227157214975
STAT,1932,40,40-44,1972,0.6866027223108707
SIM,1856,35,na,1891,4013
SIM,1961,8,na,1969,10508
STAT,1928,40,20-24,1968,0.04558855318204797
SIM,1835,33,20-24,1868,7
STAT,1757,97,na,1854,3.0
STAT,1941,22,35-39,1963,19.652945871373046
STAT,1873,50,35-39,1923,0.01792014437593875
SIM,1909,38,45-49,1947,1
SIM,1852,45,na,1897,3705
STAT,1944,16,na,1960,8001.576165193266
STAT,1877,8,na,1885,5587.866298371171
SIM,1838,17,40-44,1855,1
STAT,1859,47,30-34,1906,0.15487951495874222
STAT,1891,23,40-44,1914,5.185908945503963
STAT,1894,24,20-24,1918,177.66712096498966
STAT,1912,17,45-49,1929,0.20406242127384683
SIM,1890,62,na,1952,4737
SIM,1926,35,40-44,1961,6
SIM,1910,32,25-29,1942,24
STAT,1910,28,50-100,1938,1.9350543362297281
STAT,1920,0,na,1920,10205.806081140092
STAT,1936,17,30-34,1953,23.5726886944837
STAT,1913,35,35-39,1948,4.867764608702963
STAT,1921,34,50-100,1955,1.8418816000458476
SIM,1877,80,na,1957,1268
STAT,1866,84,na,1950,619.9111127668249
SIM,1882,67,na,1949,3139
SIM,1839,45,50-100,1884,1
SIM,1907,52,na,1959,6516
SIM,1928,38,na,1966,9719
STAT,1930,32,30-34,1962,41.06367678725558
SIM,1869,44,30-34,1913,2
SIM,1921,46,45-49,1967,1
STAT,1868,34,20-24,1902,5.149529768717438
STAT,1860,52,20-24,1912,0.0012038061416342841
SIM,1890,32,50-100,1922,4
STAT,1845,23,na,1868,4060.8115422780024
STAT,1765,92,na,1857,19.410994585428476
STAT,1929,27,40-44,1956,11.780134144207127
SIM,1828,39,50-100,1867,3
STAT,1824,32,40-44,1856,19.510989569934516
SIM,1864,30,na,1894,4548
SIM,1832,32,40-44,1864,10
SIM,1937,27,40-44,1964,13
STAT,1902,32,25-29,1934,29.20521057720621
STAT,1913,46,45-49,1959,0.429599373200388
STAT,1864,21,50-100,1885,0.7534360775727079
STAT,1902,45,30-34,1947,0.15724499066801503
SIM,1871,20,25-29,1891,123
SIM,1891,29,20-24,1920,28
SIM,1898,42,na,1940,6528
STAT,1937,33,25-29,1970,18.460086421690058
SIM,1795,99,na,1894,2
STAT,1829,76,na,1905,1121.260845984091
STAT,1930,30,35-39,1960,23.844880776089408
STAT,1918,35,40-44,1953,3.2163841342687802
SIM,1944,17,30-34,1961,33
STAT,1833,81,na,1914,710.9040536901548
SIM,1935,17,35-39,1952,13
SIM,1923,43,45-49,1966,1
STAT,1876,20,35-39,1896,12.262228830821696
SIM,1826,30,45-49,1856,2
STAT,1822,35,40-44,1857,19.035758484886255
SIM,1872,8,na,1880,5752
SIM,1889,21,25-29,1910,169
SIM,1937,25,45-49,1962,4
SIM,1853,86,na,1939,259
STAT,1895,25,50-100,1920,1.6948550012945551
STAT,1885,21,45-49,1906,1.4060551201733702
SIM,1939,22,45-49,1961,3
SIM,1924,24,na,1948,8882
SIM,1848,20,25-29,1868,103
SIM,1905,27,20-24,1932,36
STAT,1904,42,30-34,1946,0.23113689649792166
STAT,1918,24,30-34,1942,62.201908603463885
SIM,1921,35,35-39,1956,9
STAT,1924,46,20-24,1970,0.026629993026468443
STAT,1851,44,50-100,1895,1.6155875716316057
STAT,1827,33,20-24,1860,6.34888058737684
SIM,1835,20,15-19,1855,3
SIM,1830,35,40-44,1865,13
STAT,1877,15,30-34,1892,3.3581265715751996
STAT,1900,48,30-34,1948,0.15105566433496284
STAT,1807,103,na,1910,0.11455475624414334
STAT,1829,30,20-24,1859,5.489918478077337
SIM,1878,22,na,1900,5136
STAT,1863,20,25-29,1883,104.7198308989245
SIM,1910,45,30-34,1955,1
SIM,1925,20,50-100,1945,2
SIM,1924,27,30-34,1951,115
STAT,1862,94,na,1956,39.59028725657055
STAT,1863,33,30-34,1896,30.73678714567682
SIM,1920,34,na,1954,8450
STAT,1907,49,25-29,1956,0.09493953030941271
STAT,1872,29,45-49,1901,2.2375201291165623
SIM,1885,16,15-19,1901,11
STAT,1915,43,45-49,1958,0.3378943313282702
SIM,1869,31,25-29,1900,28
STAT,1887,30,na,1917,5433.508968307157
STAT,1811,49,25-29,1860,0.37782736993440313
STAT,1837,71,na,1908,1860.3857246245395
STAT,1932,40,50-100,1972,0.322487232995553
STAT,1846,36,35-39,1882,11.431469677375322
SIM,1887,24,25-29,1911,143
STAT,1880,48,35-39,1928,0.2941175984217463
STAT,1820,38,40-44,1858,20.480173350342007
STAT,1917,40,45-49,1957,0.3517192532493939
SIM,1903,62,na,1965,5837
STAT,1907,38,15-19,1945,0.03579949306474604
STAT,1865,30,30-34,1895,32.2927898714538
STAT,1915,32,35-39,1947,18.798281544949532
SIM,1907,24,20-24,1931,220
STAT,1821,108,na,1929,0.0020303669265925557
SIM,1880,23,30-34,1903,51
SIM,1916,29,na,1945,8202
STAT,1806,49,50-100,1855,1.4511723659594218
SIM,1900,29,40-44,1929,12
STAT,1909,46,25-29,1955,0.09874040029851872
STAT,1830,54,30-34,1884,0.008685689398248873
SIM,1888,44,40-44,1932,5
SIM,1923,32,35-39,1955,33
STAT,1916,27,30-34,1943,81.82117906937903
STAT,1926,43,20-24,1969,0.04389338764512143
STAT,1849,13,na,1862,4627.010964661081
STAT,1879,24,25-29,1903,120.17300131112863
SIM,1882,36,50-100,1918,4
STAT,1828,51,na,1879,2890.090803939751
SIM,1911,24,40-44,1935,7
SIM,1837,36,35-39,1873,12
STAT,1891,75,na,1966,3249.196260316154
STAT,1890,10,na,1900,6385.557519196762
SIM,1916,19,20-24,1935,286
STAT,1878,47,40-44,1925,0.35942875226729887
STAT,1830,41,25-29,1871,1.1673410442414511
STAT,1895,47,40-44,1942,0.2529545339306205
STAT,1896,27,35-39,1923,25.728175940781423
STAT,1891,51,na,1942,5400.995238671206
STAT,1925,37,na,1962,9117.668735189716
SIM,1823,48,na,1871,2902
STAT,1922,36,15-19,1958,0.044158810431417235
STAT,1806,48,na,1854,2468.0742259810136
STAT,1895,65,na,1960,4698.236855855093
STAT,1914,16,40-44,1930,0.5858810191449736
STAT,1924,33,15-19,1957,0.302517910371106
STAT,1807,89,na,1896,83.85450197279926
STAT,1850,53,na,1903,3248.379613821782
STAT,1942,17,30-34,1959,25.725939454388563
STAT,1946,22,40-44,1968,7.5561359177107725
STAT,1810,53,na,1863,2406.9156998414837
STAT,1835,46,30-34,1881,0.1339139791677761
STAT,1917,43,25-29,1960,0.15025517114090375
STAT,1944,28,45-49,1972,3.7690090178454834
STAT,1844,20,15-19,1864,6.748466044006873
SIM,1950,17,30-34,1967,32
SIM,1919,3,na,1922,9191
STAT,1929,27,na,1956,9467.870198261811
STAT,1842,37,50-100,1879,2.1442424517795176
STAT,1808,105,na,1913,0.02304021037854865
STAT,1873,78,na,1951,1603.338560628712
SIM,1852,39,35-39,1891,29
SIM,1874,32,na,1906,4615
STAT,1828,35,na,1863,3479.7917451683434
SIM,1849,15,20-24,1864,38
SIM,1886,47,40-44,1933,1
STAT,1858,73,na,1931,1870.0195493667486
STAT,1903,24,40-44,1927,5.954610601411136
STAT,1914,4,na,1918,8406.059030133343
STAT,1875,17,50-100,1892,0.10187134014750496
STAT,1944,17,35-39,1961,9.119416770043365
STAT,1899,71,na,1970,4472.192315591053
STAT,1952,20,15-19,1972,12.933855595988572
STAT,1853,109,na,1962,0.004558566063994214
SIM,1922,16,40-44,1938,4
STAT,1891,46,15-19,1937,5.648657034560106E-4
STAT,1885,37,30-34,1922,10.714029861584383
STAT,1927,17,35-39,1944,10.535559877680416
SIM,1858,41,45-49,1899,2
STAT,1892,20,50-100,1912,1.0371664400485838
SIM,1879,63,na,1942,3659
STAT,1844,39,35-39,1883,11.822003093684291
SIM,1935,28,45-49,1963,6
SIM,1799,89,na,1888,40
SIM,1957,11,na,1968,10318
STAT,1848,30,30-34,1878,34.086899345032315
STAT,1838,23,25-29,1861,99.7961444586256
STAT,1851,18,15-19,1869,11.119195083327218
SIM,1866,15,20-24,1881,30
STAT,1774,85,na,1859,120.8166935234043
STAT,1818,46,30-34,1864,0.43337913470309736
SIM,1832,25,na,1857,3733
SIM,1836,39,na,1875,3264
STAT,1778,99,na,1877,0.7411823755980715
SIM,1912,42,30-34,1954,1
STAT,1924,39,50-100,1963,0.9974808373396853
STAT,1882,15,na,1897,4991.955196529979
STAT,1920,25,25-29,1945,146.77833729568636
SIM,1844,24,50-100,1868,3
STAT,1927,28,45-49,1955,4.2261875863054845
SIM,1858,30,35-39,1888,19
SIM,1819,37,50-100,1856,3
SIM,1861,81,na,1942,862
STAT,1841,17,na,1858,4295.50364716313
STAT,1901,26,50-100,1927,1.814853225063517
SIM,1856,30,30-34,1886,41
SIM,1910,0,na,1910,8694
SIM,1820,83,na,1903,345
STAT,1796,72,na,1868,1122.7686607845428
STAT,1878,93,na,1971,267.78996401321547
STAT,1900,32,45-49,1932,4.88553500990239
SIM,1846,23,25-29,1869,117
STAT,1866,6,na,1872,5243.68688043417
SIM,1783,74,na,1857,851
SIM,1865,95,na,1960,29
SIM,1893,37,30-34,1930,22
STAT,1953,18,45-49,1971,1.219939831378721
SIM,1873,33,40-44,1906,16
STAT,1903,25,25-29,1928,122.46562325322138
SIM,1845,46,40-44,1891,1
SIM,1936,33,na,1969,6633
SIM,1863,23,25-29,1886,135
STAT,1874,23,35-39,1897,12.029987784045893
STAT,1840,15,35-39,1855,1.0376492945347124
SIM,1828,46,35-39,1874,1
STAT,1869,33,na,1902,4650.159603367317
SIM,1916,17,25-29,1933,26
SIM,1864,32,50-100,1896,2
STAT,1858,15,20-24,1873,32.99257821608606
SIM,1838,65,na,1903,2307
SIM,1952,17,35-39,1969,13
SIM,1902,35,25-29,1937,2
STAT,1933,28,15-19,1961,1.8924036238459943
STAT,1949,15,15-19,1964,106.64939939338365
STAT,1821,51,25-29,1872,0.01017273038282734
SIM,1928,14,na,1942,10214
SIM,1878,31,20-24,1909,7
STAT,1861,20,45-49,1881,1.2217312741398934
STAT,1820,71,na,1891,1494.3191503709804
STAT,1839,40,30-34,1879,2.133063667224736
STAT,1915,19,na,1934,8120.852427612328
SIM,1931,18,na,1949,9654
STAT,1821,96,na,1917,9.517847261139393
SIM,1911,25,25-29,1936,160
SIM,1841,61,na,1902,2611
SIM,1917,19,50-100,1936,4
STAT,1908,19,20-24,1927,52.86315986535212
SIM,1878,37,35-39,1915,20
STAT,1845,82,na,1927,718.973514632061
STAT,1933,39,25-29,1972,2.7030395781855545
SIM,1897,31,30-34,1928,62
STAT,1900,21,35-39,1921,16.398182567912126
SIM,1847,40,30-34,1887,4
SIM,1861,23,20-24,1884,133
STAT,1849,96,na,1945,13.582359863285188
STAT,1939,20,50-100,1959,1.3356654371908894
STAT,1804,51,25-29,1855,0.021134701272616237
STAT,1840,38,50-100,1878,2.0743954315794326
STAT,1889,31,30-34,1920,43.65644359854403
STAT,1848,49,20-24,1897,0.019265657614094298
STAT,1844,20,45-49,1864,1.4264373082887645
STAT,1875,45,na,1920,4724.849703814926
SIM,1861,6,na,1867,5517
STAT,1927,44,na,1971,9374.27609822363
SIM,1894,52,na,1946,5783
STAT,1847,30,na,1877,3960.283856802167
STAT,1884,19,50-100,1903,0.09717909556445926
SIM,1862,47,na,1909,4105
SIM,1914,46,na,1960,7500
STAT,1876,47,30-34,1923,0.20125894795144889
STAT,1923,40,45-49,1963,0.3938251483321197
SIM,1907,36,na,1943,7120
STAT,1855,23,25-29,1878,100.12217084066121
STAT,1895,40,15-19,1935,0.036709077092764233
SIM,1836,98,na,1934,5
STAT,1837,46,40-44,1883,0.2509462241679335
STAT,1871,42,25-29,1913,1.2869113802464405
STAT,1935,7,na,1942,11038.43838701956
SIM,1842,18,15-19,1860,9
STAT,1853,23,20-24,1876,127.90262738874573
SIM,1903,22,na,1925,6954
STAT,1816,66,na,1882,1848.8101551771847
SIM,1835,36,25-29,1871,5
SIM,1815,53,na,1868,2354
SIM,1935,23,15-19,1958,12
STAT,1871,52,50-100,1923,0.03014257050861901
STAT,1850,45,15-19,1895,6.194218014849573E-4
STAT,1836,46,na,1882,3170.8133339316223
SIM,1897,34,35-39,1931,37
SIM,1926,27,35-39,1953,45
STAT,1839,35,na,1874,4080.3154320636695
SIM,1874,47,50-100,1921,2
STAT,1838,23,50-100,1861,0.710900091773754
STAT,1856,107,na,1963,0.03683039272010338
SIM,1854,39,45-49,1893,4
STAT,1840,51,na,1891,3122.839575503878
STAT,1810,47,50-100,1857,1.6020392373166257
STAT,1894,27,25-29,1921,109.74667151934094
SIM,1785,81,na,1866,244
STAT,1940,19,50-100,1959,0.7678086527778849
STAT,1924,38,15-19,1962,0.0456739847903568
SIM,1899,24,na,1923,6649
STAT,1817,51,na,1868,2762.1512648051316
SIM,1874,88,na,1962,372
SIM,1873,34,50-100,1907,3
STAT,1911,35,30-34,1946,3.590081210117215
STAT,1907,37,30-34,1944,3.414633525611196
STAT,1899,7,na,1906,7209.381822609158
SIM,1777,86,na,1863,98
SIM,1915,31,na,1946,7855
STAT,1921,40,35-39,1961,0.4592168108641191
SIM,1811,63,na,1874,1854
SIM,1885,16,na,1901,5320
STAT,1906,17,20-24,1923,52.17407877050834
SIM,1892,45,na,1937,6547
SIM,1914,17,20-24,1931,47
STAT,1772,103,na,1875,0.0840345983807595
SIM,1896,59,na,1955,5317
STAT,1815,42,40-44,1857,13.57736014163928
STAT,1896,24,25-29,1920,151.6857581598793
SIM,1899,31,35-39,1930,43
STAT,1917,40,15-19,1957,0.0032453912612951715
STAT,1790,105,na,1895,0.011469125644035426
STAT,1888,16,45-49,1904,0.15631203808748
STAT,1853,29,35-39,1882,15.863630497632125
STAT,1878,44,30-34,1922,2.392263093683713
STAT,1832,56,na,1888,2682.4014357017636
STAT,1909,19,50-100,1928,0.14766809624922897
SIM,1939,31,50-100,1970,4
STAT,1835,49,40-44,1884,0.22790934783938938
SIM,1919,21,na,1940,8164
STAT,1829,33,25-29,1862,19.11619145678521
STAT,1835,30,45-49,1865,2.9370488172988325
SIM,1941,27,30-34,1968,103
SIM,1882,27,na,1909,4974
STAT,1915,43,15-19,1958,0.0031178256521441467
STAT,1827,36,25-29,1863,6.1439226194395955
SIM,1920,18,na,1938,8526
STAT,1833,22,35-39,1855,10.669817970383544
STAT,1902,40,30-34,1942,0.22993508646232913
SIM,1831,47,50-100,1878,3
SIM,1886,44,30-34,1930,4
STAT,1851,7,na,1858,4664.966399244282
STAT,1874,20,30-34,1894,37.054058426084445
STAT,1846,39,45-49,1885,3.1231136844228806
STAT,1930,35,35-39,1965,6.382734635229173
SIM,1861,29,35-39,1890,27
SIM,1886,73,na,1959,2633
STAT,1915,37,50-100,1952,0.8566690061753867
STAT,1954,18,na,1972,9185.813643905256
STAT,1776,100,na,1876,0.4164927803716368
SIM,1930,25,35-39,1955,55
SIM,1907,27,30-34,1934,91
STAT,1919,17,30-34,1936,27.19781008261126
SIM,1895,37,35-39,1932,28
SIM,1921,30,35-39,1951,10
SIM,1903,46,na,1949,6644
SIM,1888,41,30-34,1929,3
STAT,1862,52,25-29,1914,0.006081677870091144
SIM,1862,40,50-100,1902,4
SIM,1790,68,na,1858,1499
STAT,1887,37,35-39,1924,15.9762631959395
SIM,1906,11,na,1917,7607
STAT,1846,20,25-29,1866,109.75997641490804
STAT,1901,28,25-29,1929,119.18072780350866
SIM,1824,73,na,1897,1396
STAT,1894,16,15-19,1910,15.434393886632053
SIM,1915,37,30-34,1952,3
SIM,1835,20,45-49,1855,3
STAT,1813,54,30-34,1867,0.03362361560971129
STAT,1852,17,na,1869,4424.8164029518
STAT,1859,20,35-39,1879,10.850369322906552
SIM,1885,15,30-34,1900,3
SIM,1843,30,45-49,1873,7
SIM,1904,32,25-29,1936,26
STAT,1904,35,na,1939,6948.624381696762
STAT,1908,49,na,1957,6675.221415649882
STAT,1785,69,na,1854,1424.9999999999998
STAT,1781,79,na,1860,524.3578247475124
SIM,1902,21,na,1923,6927
STAT,1878,10,na,1888,5515.539025000472
SIM,1850,39,30-34,1889,17
SIM,1860,40,na,1900,4049
SIM,1924,28,15-19,1952,2
STAT,1868,37,25-29,1905,5.532453360649267
STAT,1842,39,30-34,1881,8.296244019480122
STAT,1833,97,na,1930,7.06249907315838
SIM,1846,76,na,1922,1298
SIM,1849,65,na,1914,2717
STAT,1938,28,20-24,1966,36.51177012690497
SIM,1845,37,50-100,1882,5
STAT,1808,53,50-100,1861,0.08781355057521281
STAT,1832,101,na,1933,0.7439321734665311
STAT,1880,45,30-34,1925,0.20800229183599933
STAT,1933,27,30-34,1960,105.08471784558854
SIM,1941,1,na,1942,8596
STAT,1902,48,35-39,1950,0.22234619922164792
STAT,1823,47,50-100,1870,0.7588705927486599
STAT,1822,32,30-34,1854,112.0083451294232
SIM,1809,46,25-29,1855,1
SIM,1876,37,25-29,1913,7
STAT,1842,28,20-24,1870,21.444180653414534
STAT,1913,30,35-39,1943,18.51463229821659
SIM,1860,41,50-100,1901,7
SIM,1850,28,20-24,1878,25
STAT,1917,41,50-100,1958,0.24794221103718767
SIM,1867,20,35-39,1887,14
SIM,1918,28,45-49,1946,4
STAT,1933,32,na,1965,10294.69065728206
SIM,1902,38,35-39,1940,6
SIM,1830,32,30-34,1862,28
SIM,1875,73,na,1948,2503
STAT,1946,1,na,1947,9233.510085408201
STAT,1890,16,50-100,1906,0.12106924014036169
STAT,1831,31,na,1862,3661.448724996488
STAT,1836,101,na,1937,0.7586915240345746
STAT,1937,30,20-24,1967,4.880216122231573
STAT,1862,52,30-34,1914,0.010220597630185593
SIM,1837,33,25-29,1870,28
SIM,1847,41,50-100,1888,3
STAT,1835,45,na,1880,3150.866712702275
STAT,1918,38,45-49,1956,1.4494754943229822
SIM,1842,86,na,1928,265
STAT,1841,32,40-44,1873,7.6344035574874045
SIM,1837,22,15-19,1859,5
STAT,1811,94,na,1905,18.57834603932502
SIM,1926,38,45-49,1964,1
STAT,1899,16,20-24,1915,49.17779028881451
SIM,1835,39,35-39,1874,15
SIM,1829,25,45-49,1854,2
SIM,1904,35,35-39,1939,7
STAT,1827,39,35-39,1866,13.937967842286838
SIM,1928,37,40-44,1965,5
STAT,1891,20,30-34,1911,44.731575740861054
STAT,1852,42,15-19,1894,0.021983149514555482
SIM,1885,24,20-24,1909,161
STAT,1834,46,50-100,1880,0.38591739841106876
STAT,1859,31,45-49,1890,2.814630862065108
SIM,1904,46,45-49,1950,1
STAT,1918,27,35-39,1945,32.263403172403784
STAT,1877,24,20-24,1901,143.61567909090425
STAT,1904,45,35-39,1949,0.23120050190966865
SIM,1867,31,45-49,1898,6
STAT,1857,48,na,1905,3497.1909592154416
SIM,1918,17,35-39,1935,19
STAT,1953,17,30-34,1970,29.776066278692113
SIM,1854,36,35-39,1890,20
SIM,1817,40,45-49,1857,2
SIM,1830,42,na,1872,3009
SIM,1866,37,na,1903,4571
STAT,1848,33,35-39,1881,17.440002114094426
STAT,1903,16,35-39,1919,1.5817225970328648
STAT,1921,43,45-49,1964,0.37789472398682855
SIM,1828,30,25-29,1858,29
STAT,1806,88,na,1894,93.47853922817542
SIM,1809,49,50-100,1858,2
SIM,1935,27,30-34,1962,140
SIM,1863,48,na,1911,4139
STAT,1816,49,30-34,1865,0.46126541176204167
SIM,1837,33,30-34,1870,44
STAT,1812,51,50-100,1863,0.10215215854849993
SIM,1943,20,15-19,1963,12
STAT,1903,27,45-49,1930,3.192745902751352
STAT,1905,21,40-44,1926,6.104723776584156
STAT,1944,25,40-44,1969,10.18241125520591
STAT,1912,19,40-44,1931,0.5683107519547457
SIM,1878,23,15-19,1901,5
STAT,1847,15,45-49,1862,0.12575497445774655
STAT,1802,74,na,1876,1011.1000932680547
SIM,1930,22,25-29,1952,267
SIM,1949,16,na,1965,8974
SIM,1911,27,45-49,1938,5
STAT,1806,64,na,1870,1703.9574608421945
SIM,1912,45,35-39,1957,1
SIM,1920,19,40-44,1939,3
STAT,1876,31,45-49,1907,3.6574859258940946
SIM,1893,67,na,1960,4361
SIM,1844,10,na,1854,4327
SIM,1895,21,25-29,1916,187
SIM,1910,48,35-39,1958,1
SIM,1913,21,40-44,1934,10
SIM,1848,24,na,1872,3921
STAT,1887,21,25-29,1908,129.6963541691163
STAT,1853,26,25-29,1879,78.09541096223424
SIM,1856,33,35-39,1889,27
STAT,1858,19,50-100,1877,0.08904414284895035
STAT,1893,43,15-19,1936,0.0024371457733102474
SIM,1878,62,na,1940,3905
SIM,1793,100,na,1893,1
SIM,1884,31,45-49,1915,4
STAT,1911,32,20-24,1943,4.798336536917131
STAT,1927,27,30-34,1954,96.18937722792901
STAT,1795,87,na,1882,124.67442677077186
STAT,1855,20,20-24,1875,123.16135909759058
STAT,1929,25,45-49,1954,4.382856979899722
SIM,1841,45,na,1886,3301
SIM,1862,30,25-29,1892,24
SIM,1889,35,45-49,1924,9
STAT,1865,27,na,1892,4378.819659469755
SIM,1909,21,20-24,1930,209
SIM,1820,51,50-100,1871,1
STAT,1909,30,15-19,1939,0.24978793257196988
STAT,1909,49,35-39,1958,0.23799563098797583
SIM,1918,36,na,1954,8251
SIM,1853,16,25-29,1869,17
STAT,1911,29,na,1940,7327.681732067345
STAT,1886,17,25-29,1903,12.081139597642572
SIM,1835,73,na,1908,1508
STAT,1803,106,na,1909,0.00856872779486282
STAT,1883,29,20-24,1912,23.112031309171005
SIM,1840,20,na,1860,4334
STAT,1897,44,40-44,1941,0.4159770218795615
STAT,1854,30,25-29,1884,16.416996190885637
STAT,1935,36,25-29,1971,2.7836514618237875
STAT,1937,22,na,1959,7183.477966985706
SIM,1871,83,na,1954,613
STAT,1886,45,na,1931,4844.3506772873025
STAT,1811,44,25-29,1855,4.638551506491739
STAT,1849,111,na,1960,3.25538291879376E-4
STAT,1917,40,20-24,1957,0.037321997489100964
STAT,1816,38,20-24,1854,5.7389962423187715
STAT,1831,28,45-49,1859,1.9141822914233597
STAT,1837,43,30-34,1880,1.8671678612371245
SIM,1911,57,na,1968,6876
STAT,1896,24,30-34,1920,47.19784791252423
SIM,1849,18,25-29,1867,16
SIM,1905,19,15-19,1924,20
SIM,1962,4,na,1966,10321
STAT,1829,33,30-34,1862,32.5857848150113
STAT,1861,36,30-34,1897,9.002185460253411
SIM,1824,38,20-24,1862,2
STAT,1881,14,na,1895,5024.947204923647
STAT,1967,4,na,1971,9919.370565443267
SIM,1878,34,25-29,1912,25
SIM,1845,43,30-34,1888,6
SIM,1946,17,40-44,1963,1
SIM,1872,21,50-100,1893,1
SIM,1917,30,15-19,1947,4
STAT,1908,25,na,1933,7203.072275484735
STAT,1895,2,na,1897,7015.0321292206845
STAT,1874,20,25-29,1894,119.08536498694104
SIM,1859,25,30-34,1884,57
SIM,1894,17,25-29,1911,19
STAT,1907,40,na,1947,6953.755546995457
SIM,1854,20,25-29,1874,138
SIM,1863,20,20-24,1883,140
SIM,1934,17,50-100,1951,1
SIM,1841,22,35-39,1863,16
STAT,1903,22,20-24,1925,198.16217586386114
SIM,1861,15,15-19,1876,12
STAT,1765,107,na,1872,0.01453293118216975
SIM,1828,49,45-49,1877,2
STAT,1901,17,15-19,1918,16.77916487013741
SIM,1861,26,25-29,1887,101
STAT,1814,50,50-100,1864,0.07805524468614285
SIM,1911,22,20-24,1933,228
STAT,1828,40,25-29,1868,1.248859450962586
STAT,1845,16,25-29,1861,11.101957213453888
STAT,1825,86,na,1911,256.71866879566977
STAT,1895,31,25-29,1926,27.064904615862137
SIM,1873,90,na,1963,263
STAT,1902,6,na,1908,7448.734968185681
SIM,1855,15,45-49,1870,1
STAT,1853,15,15-19,1868,11.429385337432603
SIM,1816,94,na,1910,11
SIM,1833,23,45-49,1856,1
STAT,1837,28,na,1865,3841.9881802997947
SIM,1927,17,30-34,1944,36
SIM,1873,30,30-34,1903,51
SIM,1878,34,30-34,1912,44
STAT,1949,18,25-29,1967,101.7498464385634
STAT,1903,30,50-100,1933,2.6558995187202545
SIM,1911,16,35-39,1927,2
STAT,1955,16,na,1971,9869.79679607596
STAT,1861,13,na,1874,4591.499917719987
STAT,1899,55,na,1954,5721.650154034144
STAT,1922,22,25-29,1944,213.87346774332738
STAT,1923,9,na,1932,9437.675657540025
STAT,1938,17,40-44,1955,2.7870282163124576
STAT,1858,108,na,1966,0.024086125541543192
STAT,1889,34,35-39,1923,25.00283959347307
STAT,1820,35,50-100,1855,7.030958139951903
STAT,1800,54,20-24,1854,0.004432511717156887
STAT,1854,83,na,1937,608.5760136050046
STAT,1845,52,25-29,1897,0.005428958227077081
SIM,1889,24,35-39,1913,13
SIM,1879,15,30-34,1894,4
SIM,1879,47,na,1926,4588
SIM,1906,25,50-100,1931,2
STAT,1872,26,35-39,1898,19.652030877866995
SIM,1858,61,na,1919,3215
SIM,1875,33,na,1908,5269
SIM,1789,71,na,1860,1148
SIM,1924,34,50-100,1958,3
SIM,1871,36,40-44,1907,10
STAT,1952,11,na,1963,9507.733468581844
STAT,1856,43,40-44,1899,3.4795843565167255
STAT,1915,46,25-29,1961,0.10822947514894594
SIM,1904,26,50-100,1930,3
STAT,1920,28,35-39,1948,33.137385035798225
STAT,1955,15,45-49,1970,1.3398326967532725
STAT,1815,84,na,1899,309.2103399640499
STAT,1928,41,35-39,1969,0.5191172581397018
SIM,1853,30,na,1883,4070
SIM,1890,2,na,1892,7012
SIM,1782,92,na,1874,6
STAT,1842,58,na,1900,2944.2756114408558
SIM,1876,95,na,1971,149
SIM,1861,65,na,1926,3190
STAT,1876,46,na,1922,4712.944840772993
SIM,1859,34,20-24,1893,4
SIM,1878,43,50-100,1921,3
STAT,1839,51,na,1890,3378.103042451196
STAT,1849,17,45-49,1866,0.1271873565452723
STAT,1895,44,30-34,1939,0.20726115282951418
STAT,1937,24,35-39,1961,18.50952562848342
STAT,1833,45,15-19,1878,6.330299907344997E-4
STAT,1880,51,na,1931,4602.939923811362
STAT,1924,36,25-29,1960,2.346332279589592
STAT,1846,33,25-29,1879,18.34860027386592
SIM,1838,41,na,1879,3416
SIM,1880,20,20-24,1900,176
SIM,1934,9,na,1943,10787
SIM,1867,37,50-100,1904,7
SIM,1859,24,na,1883,4328
STAT,1939,32,45-49,1971,3.2429613805120336
SIM,1834,51,na,1885,2887
STAT,1937,35,45-49,1972,1.3794099466046548
SIM,1904,20,30-34,1924,65
STAT,1897,40,25-29,1937,0.1215990487075327
SIM,1847,43,35-39,1890,5
STAT,1769,104,na,1873,0.04274826040479936
SIM,1816,38,na,1854,3112
STAT,1838,26,35-39,1864,16.73168614483587
STAT,1855,23,30-34,1878,31.15355752138897
SIM,1854,36,40-44,1890,10
SIM,1918,23,15-19,1941,12
SIM,1885,32,na,1917,5016
SIM,1801,61,na,1862,1961
SIM,1796,84,na,1880,227
SIM,1831,26,50-100,1857,1
STAT,1864,17,40-44,1881,0.34158108810899
STAT,1887,9,na,1896,5860.738225457302
STAT,1840,48,na,1888,3233.166706416717
SIM,1824,33,na,1857,3599
STAT,1865,83,na,1948,728.3961998288776
STAT,1941,27,na,1968,7826.913499161652
SIM,1805,75,na,1880,791
SIM,1927,13,na,1940,10217
STAT,1827,66,na,1893,1981.9474311789256
SIM,1854,22,15-19,1876,6
SIM,1932,36,25-29,1968,3
STAT,1857,109,na,1966,0.009116443954973637
SIM,1782,89,na,1871,51
SIM,1851,44,na,1895,3617
STAT,1900,29,na,1929,6638.354913497735
STAT,1926,34,30-34,1960,38.4190458386204
SIM,1883,68,na,1951,3064
SIM,1913,25,35-39,1938,37
STAT,1854,43,na,1897,3517.50658192287
SIM,1854,39,50-100,1893,5
SIM,1906,51,na,1957,6422
STAT,1853,98,na,1951,5.139846596966768
SIM,1861,26,30-34,1887,59
STAT,1905,25,35-39,1930,28.373602286254275
SIM,1854,33,25-29,1887,19
STAT,1928,42,40-44,1970,0.6438853741147745
STAT,1902,42,20-24,1944,0.031406794165877196
STAT,1931,26,15-19,1957,1.8416097795001005
SIM,1920,15,25-29,1935,134
STAT,1856,32,50-100,1888,1.4452071046730972
STAT,1912,15,25-29,1927,17.78466663697895
STAT,1891,39,20-24,1930,1.904965801139385
STAT,1911,46,50-100,1957,0.4336517218745225
STAT,1839,43,35-39,1882,2.94207900019052
SIM,1828,46,40-44,1874,1
STAT,1853,26,30-34,1879,46.48994688196861
SIM,1873,47,na,1920,4711
STAT,1846,22,15-19,1868,6.2348831482778335
STAT,1928,31,30-34,1959,39.80385262550741
STAT,1949,15,20-24,1964,318.59820537083004
SIM,1844,17,35-39,1861,2
STAT,1832,42,40-44,1874,3.5874040108257015
STAT,1824,48,20-24,1872,0.028656768980767133
STAT,1863,45,30-34,1908,0.17283890541803534
SIM,1871,33,30-34,1904,43
SIM,1827,78,na,1905,814
SIM,1934,34,30-34,1968,50
SIM,1864,70,na,1934,2564
SIM,1909,36,25-29,1945,3
STAT,1827,36,30-34,1863,11.372792996285655
STAT,1830,92,na,1922,57.51297289350198
SIM,1922,19,45-49,1941,1
STAT,1899,19,25-29,1918,15.596531414552166
STAT,1863,17,na,1880,4630.689759748086
SIM,1900,25,25-29,1925,146
SIM,1846,26,35-39,1872,25
SIM,1898,9,na,1907,7322
SIM,1848,34,45-49,1882,5
SIM,1902,33,35-39,1935,1
STAT,1854,28,50-100,1882,1.020649463280155
STAT,1883,29,15-19,1912,0.8938354721623509
SIM,1837,21,30-34,1858,36
SIM,1937,34,na,1971,7678
SIM,1788,89,na,1877,51
SIM,1917,14,na,1931,8792
STAT,1882,32,50-100,1914,1.8026184555702292
STAT,1852,47,20-24,1899,0.019036558413888228
STAT,1918,24,na,1942,7903.233550515335
SIM,1884,20,35-39,1904,12
STAT,1816,38,15-19,1854,0.4180726265438763
SIM,1848,23,35-39,1871,12
STAT,1854,43,30-34,1897,1.749695399259198
STAT,1851,105,na,1956,0.05630393550211249
SIM,1813,89,na,1902,73
SIM,1842,32,50-100,1874,3
STAT,1909,50,na,1959,6760.070507848962
STAT,1917,45,15-19,1962,7.80671327961737E-4
SIM,1904,31,40-44,1935,9
STAT,1835,30,15-19,1865,0.2398514550110788
STAT,1917,20,50-100,1937,1.4206819733714628
STAT,1852,3,na,1855,5446.2482
STAT,1893,39,na,1932,5970.314765332772
STAT,1915,21,50-100,1936,1.3779292190586048
SIM,1863,23,30-34,1886,45
SIM,1913,24,na,1937,7491
STAT,1816,42,50-100,1858,5.819030923530741
STAT,1887,34,25-29,1921,22.93783910711911
STAT,1894,27,30-34,1921,65.33184045698054
SIM,1859,22,20-24,1881,123
SIM,1895,34,25-29,1929,40
SIM,1913,28,50-100,1941,5
SIM,1863,32,na,1895,4439
STAT,1900,44,15-19,1944,0.002650444461606796
SIM,1885,18,35-39,1903,2
SIM,1830,44,30-34,1874,5
SIM,1847,39,na,1886,3602
SIM,1903,19,35-39,1922,2
STAT,1800,94,na,1894,17.070536587909974
SIM,1848,22,45-49,1870,1
SIM,1902,35,30-34,1937,4
STAT,1822,97,na,1919,6.065709240852301
STAT,1875,50,45-49,1925,0.030610058705816432
SIM,1882,23,35-39,1905,16
STAT,1918,33,20-24,1951,5.211756460298844
STAT,1900,39,40-44,1939,2.62046047846776
SIM,1945,24,35-39,1969,34
STAT,1841,47,45-49,1888,0.34397177340878343
SIM,1926,33,20-24,1959,1
STAT,1855,84,na,1939,501.6342641606493
STAT,1835,49,35-39,1884,0.18637446712089037
STAT,1789,99,na,1888,0.7612418672507758
STAT,1931,15,35-39,1946,11.144377756187726
SIM,1950,19,20-24,1969,326
SIM,1926,21,20-24,1947,8
STAT,1862,50,50-100,1912,0.026445027312475146
STAT,1865,33,35-39,1898,18.502841627840965
STAT,1878,40,15-19,1918,0.029423005948230375
STAT,1857,106,na,1963,0.08877831281367843
STAT,1836,23,20-24,1859,120.08137583183468
SIM,1943,21,20-24,1964,241
STAT,1885,42,50-100,1927,2.1211664718089818
SIM,1805,78,na,1883,576
STAT,1822,47,35-39,1869,0.4352458469194594
STAT,1873,43,40-44,1916,4.582297902232818
SIM,1849,28,50-100,1877,3
STAT,1843,59,na,1902,2722.4390156819736
SIM,1907,27,25-29,1934,143
SIM,1933,19,20-24,1952,364
STAT,1850,49,30-34,1899,0.14532160634661606
STAT,1906,40,45-49,1946,0.3089457305841282
STAT,1852,30,50-100,1882,1.5437170470361206
SIM,1822,63,na,1885,1968
STAT,1901,19,35-39,1920,1.5430833621840867
STAT,1850,38,20-24,1888,1.1882330746031136
SIM,1918,25,40-44,1943,17
STAT,1942,19,20-24,1961,285.9566713462399
STAT,1921,45,35-39,1966,0.29485051084467423
STAT,1821,56,na,1877,2462.9197977627864
STAT,1829,36,na,1865,3273.5397153927615
SIM,1937,23,25-29,1960,192
STAT,1787,95,na,1882,4.988552397908579
STAT,1831,25,40-44,1856,5.3676425450011385
SIM,1881,43,40-44,1924,6
STAT,1906,42,35-39,1948,0.369609686976338
SIM,1801,64,na,1865,1742
STAT,1858,50,45-49,1908,0.0231769547295188
SIM,1940,30,45-49,1970,1
SIM,1852,85,na,1937,369
STAT,1931,26,45-49,1957,4.506796653049738
STAT,1900,32,15-19,1932,0.39897283073093276
SIM,1919,34,35-39,1953,26
STAT,1918,21,20-24,1939,242.89500865775736
SIM,1891,29,15-19,1920,1
SIM,1835,36,30-34,1871,15
SIM,1895,31,20-24,1926,10
SIM,1830,47,35-39,1877,1
STAT,1818,73,na,1891,1218.5664429150693
STAT,1898,30,na,1928,6574.422201203463
SIM,1844,23,20-24,1867,112
SIM,1831,86,na,1917,191
STAT,1818,41,50-100,1859,5.405240158327158
STAT,1898,42,50-100,1940,0.200258436787596
SIM,1871,43,na,1914,4448
SIM,1875,57,na,1932,4503
STAT,1920,23,35-39,1943,21.070917193198856
SIM,1879,18,35-39,1897,2
STAT,1923,26,50-100,1949,2.315139602708464
SIM,1864,43,40-44,1907,10
STAT,1929,23,25-29,1952,235.15692886304527
SIM,1870,52,25-29,1922,1
SIM,1887,27,35-39,1914,33
STAT,1879,27,35-39,1906,20.383140504236614
STAT,1865,34,50-100,1899,1.6667444079577536
STAT,1935,21,20-24,1956,305.96734916352614
SIM,1928,36,35-39,1964,15
STAT,1902,48,40-44,1950,0.27189763727830235
SIM,1920,1,na,1921,9530
SIM,1840,28,50-100,1868,2
STAT,1842,21,50-100,1863,0.7713004642369485
STAT,1861,20,15-19,1881,5.780003068151148
STAT,1905,36,45-49,1941,1.262792324453786
STAT,1925,19,20-24,1944,328.9213229870766
STAT,1926,46,30-34,1972,0.22266291387330467
STAT,1852,45,25-29,1897,0.09271870980095503
STAT,1852,33,na,1885,3897.2125253740155
SIM,1871,37,50-100,1908,5
SIM,1882,9,na,1891,5400
STAT,1877,16,15-19,1893,12.47625867603247
STAT,1914,27,20-24,1941,37.17097467776422
SIM,1887,42,na,1929,5650
SIM,1918,18,40-44,1936,3
SIM,1876,37,30-34,1913,13
SIM,1871,39,45-49,1910,8
STAT,1912,14,na,1926,8041.43975070643
SIM,1803,71,na,1874,1272
STAT,1922,36,45-49,1958,1.5676375838848653
STAT,1941,30,40-44,1971,8.307715249589318
SIM,1907,29,20-24,1936,4
STAT,1932,30,45-49,1962,4.22982264125227
SIM,1844,19,30-34,1863,3
STAT,1893,48,20-24,1941,0.017110088937886507
SIM,1890,33,40-44,1923,13
SIM,1840,42,40-44,1882,13
SIM,1895,37,40-44,1932,18
STAT,1846,36,40-44,1882,7.075052491316907
SIM,1889,20,40-44,1909,4
SIM,1869,41,20-24,1910,1
STAT,1872,23,25-29,1895,115.83469825748561
SIM,1849,81,na,1930,721
SIM,1919,45,45-49,1964,1
STAT,1799,77,na,1876,709.7452837265809
SIM,1922,27,20-24,1949,46
SIM,1900,29,35-39,1929,35
STAT,1909,46,30-34,1955,0.16593872987874864
STAT,1887,37,40-44,1924,9.887871281334574
STAT,1944,23,20-24,1967,242.37617893217046
STAT,1866,24,45-49,1890,1.2913098608242493
STAT,1922,25,35-39,1947,34.53424037509869
STAT,1882,33,40-44,1915,8.496036410746795
SIM,1917,44,35-39,1961,1
SIM,1888,83,na,1971,1609
SIM,1897,57,na,1954,5514
STAT,1876,43,na,1919,4792.980317323495
SIM,1930,36,45-49,1966,4
STAT,1920,25,30-34,1945,87.37667194811198
STAT,1874,46,15-19,1920,8.29513704066305E-4
STAT,1893,46,25-29,1939,0.08340964601334998
STAT,1944,9,na,1953,8565.564704092316
SIM,1828,63,na,1891,2135
STAT,1806,52,40-44,1858,0.06143143593832598
STAT,1868,37,30-34,1905,10.240924362098827
STAT,1889,33,50-100,1922,2.2720361523358967
STAT,1901,25,20-24,1926,33.3941720213255
SIM,1839,63,na,1902,2366
STAT,1845,52,50-100,1897,0.023148474825979252
STAT,1909,10,na,1919,7849.686410095554
SIM,1930,24,45-49,1954,6
STAT,1857,46,15-19,1903,6.314660168430416E-4
STAT,1866,68,na,1934,2847.7651380834327
STAT,1870,29,50-100,1899,1.2593340114270266
STAT,1916,20,na,1936,7774.309433769994
SIM,1829,88,na,1917,146
STAT,1882,45,40-44,1927,0.3401762446946162
STAT,1925,17,25-29,1942,105.70291609485338
SIM,1919,46,35-39,1965,2
SIM,1868,17,20-24,1885,31
SIM,1877,6,na,1883,5559
SIM,1803,68,na,1871,1581
STAT,1837,34,40-44,1871,7.42434197575477
STAT,1804,105,na,1909,0.01972456931824051
STAT,1929,27,50-100,1956,2.51560721087612
SIM,1924,29,20-24,1953,47
STAT,1833,41,na,1874,3391.813545537012
STAT,1852,49,40-44,1901,0.2671631964679614
STAT,1921,40,40-44,1961,0.5704094420582377
SIM,1932,33,20-24,1965,8
SIM,1810,78,na,1888,640
STAT,1916,29,20-24,1945,37.845465842737276
SIM,1823,42,40-44,1865,11
SIM,1868,4,na,1872,5530
STAT,1859,58,na,1917,3178.9665631745997
STAT,1853,18,na,1871,4343.1490433614235
STAT,1922,24,45-49,1946,2.5889311901373966
STAT,1842,28,15-19,1870,0.8293329600965758
SIM,1933,17,25-29,1950,161
SIM,1860,49,40-44,1909,2
STAT,1815,54,40-44,1869,0.052071265621483606
STAT,1836,19,30-34,1855,4.060366406323697
SIM,1850,28,15-19,1878,1
STAT,1952,20,45-49,1972,2.7338559669455336
SIM,1816,78,na,1894,700
SIM,1833,28,15-19,1861,1
STAT,1841,44,40-44,1885,3.305436958304849
SIM,1842,30,na,1872,3861
STAT,1860,46,50-100,1906,0.40394797972395025
STAT,1856,47,na,1903,3489.4391528386404
SIM,1934,30,45-49,1964,2
SIM,1855,17,40-44,1872,1
SIM,1852,48,na,1900,3607
STAT,1877,53,50-100,1930,0.031164313357053577
SIM,1862,43,30-34,1905,4
STAT,1902,34,15-19,1936,0.23115978801101475
STAT,1818,52,na,1870,2663.9133164031878
STAT,1838,23,30-34,1861,31.05211264098979
STAT,1843,40,na,1883,3420.021099120646
STAT,1915,40,40-44,1955,0.5100312462005107
SIM,1870,98,na,1968,28
STAT,1870,26,30-34,1896,50.10270829031383
STAT,1924,33,20-24,1957,5.742132152088846
SIM,1896,35,na,1931,6601
STAT,1849,17,50-100,1866,0.0953905174089542
SIM,1904,23,35-39,1927,24
SIM,1857,24,45-49,1881,2
SIM,1904,34,45-49,1938,4
SIM,1885,72,na,1957,2768
STAT,1925,30,50-100,1955,1.9847268830716434
STAT,1937,21,30-34,1958,56.55578041179117
SIM,1880,23,25-29,1903,137
SIM,1907,43,50-100,1950,1
SIM,1868,15,30-34,1883,3
SIM,1909,24,30-34,1933,69
SIM,1841,85,na,1926,346
STAT,1892,19,15-19,1911,14.923835397574061
SIM,1945,21,30-34,1966,90
STAT,1863,48,35-39,1911,0.24439617143967343
SIM,1854,30,20-24,1884,7
STAT,1855,35,50-100,1890,1.8689380692149904
STAT,1811,48,40-44,1859,1.142382098566209
STAT,1874,39,20-24,1913,1.5780064289269498
SIM,1903,16,30-34,1919,8
STAT,1909,31,50-100,1940,1.6008261160516815
SIM,1886,31,25-29,1917,30
STAT,1902,45,25-29,1947,0.09356726627256821
SIM,1868,1,na,1869,6680
STAT,1855,26,35-39,1881,15.275575898625158
STAT,1831,55,na,1886,2716.170971114768
SIM,1909,35,40-44,1944,2
STAT,1802,54,30-34,1856,0.03664242578786384
STAT,1926,30,45-49,1956,3.8464746755178916
SIM,1873,33,35-39,1906,33
STAT,1863,39,45-49,1902,3.4888161062736724
SIM,1904,47,na,1951,6603
SIM,1900,24,50-100,1924,1
STAT,1846,30,20-24,1876,4.995475237663803
SIM,1901,36,na,1937,6760
STAT,1868,32,na,1900,4585.3596618985475
SIM,1825,74,na,1899,1155
SIM,1865,20,25-29,1885,116
STAT,1806,67,na,1873,1523.6270499612808
STAT,1940,17,20-24,1957,278.03066308759423
STAT,1885,21,15-19,1906,6.652038038653934
STAT,1849,24,45-49,1873,1.3145052278470124
STAT,1870,73,na,1943,2355.108337692224
STAT,1877,18,35-39,1895,1.1477149687194224
STAT,1939,26,na,1965,7610.1971632928235
SIM,1853,70,na,1923,2166
STAT,1841,92,na,1933,60.430378814420195
STAT,1911,23,30-34,1934,54.89686562704019
STAT,1853,58,na,1911,3128.9576153932385
STAT,1861,8,na,1869,4744.6175113623685
STAT,1888,18,40-44,1906,0.4354576162721786
SIM,1895,0,na,1895,7639
STAT,1844,84,na,1928,537.2224550254397
STAT,1876,46,25-29,1922,0.12065992560589223
SIM,1863,26,35-39,1889,23
STAT,1856,50,35-39,1906,0.01360772594174946
STAT,1842,18,na,1860,4362.6548433209255
SIM,1839,66,na,1905,2147
STAT,1857,39,15-19,1896,0.08750864897226493
SIM,1913,33,40-44,1946,12
STAT,1868,22,20-24,1890,132.41717568922766
SIM,1926,36,25-29,1962,4
STAT,1811,46,20-24,1857,0.08287729052075146
STAT,1862,16,25-29,1878,11.269610269247092
STAT,1916,23,15-19,1939,11.230497880755559
STAT,1887,31,20-24,1918,6.130600832625238
STAT,1878,31,25-29,1909,21.693022886096067
STAT,1905,22,30-34,1927,52.02577211810818
SIM,1826,49,35-39,1875,2
STAT,1932,32,35-39,1964,24.536505281039425
SIM,1898,25,45-49,1923,7
STAT,1844,36,30-34,1880,10.098861732182062
SIM,1913,21,na,1934,7613
SIM,1829,27,40-44,1856,5
STAT,1935,34,35-39,1969,25.505603649915596
SIM,1821,42,30-34,1863,4
SIM,1876,22,20-24,1898,150
SIM,1819,44,40-44,1863,4
SIM,1859,28,35-39,1887,25
STAT,1928,34,35-39,1962,23.04406839961561
SIM,1777,89,na,1866,66
SIM,1819,40,25-29,1859,1
STAT,1806,104,na,1910,0.0454170989093458
STAT,1948,22,45-49,1970,2.6089949679185356
SIM,1849,19,15-19,1868,11
STAT,1832,45,45-49,1877,0.3732085695038022
SIM,1917,31,50-100,1948,3
STAT,1865,43,na,1908,4210.054898431531
STAT,1905,33,40-44,1938,7.242468082457632
STAT,1863,36,40-44,1899,7.776238334672928
STAT,1907,24,na,1931,6976.372875856251
SIM,1837,48,50-100,1885,1
SIM,1846,23,30-34,1869,42
STAT,1765,89,na,1854,64.0
SIM,1830,38,45-49,1868,5
STAT,1831,41,50-100,1872,1.694557868333538
STAT,1921,28,na,1949,8400.384943434268
SIM,1924,23,15-19,1947,13
STAT,1876,83,na,1959,1084.0296135053634
STAT,1888,71,na,1959,3435.524936673212
STAT,1962,6,na,1968,10170.616951966622
STAT,1929,38,20-24,1967,0.6827433909695222
SIM,1830,45,na,1875,2924
SIM,1839,30,25-29,1869,24
SIM,1852,36,30-34,1888,18
STAT,1829,36,35-39,1865,12.588631077567916
SIM,1935,25,40-44,1960,1
STAT,1937,32,40-44,1969,7.8208455987869945
SIM,1863,69,na,1932,2577
SIM,1841,38,20-24,1879,2
STAT,1898,21,25-29,1919,156.9296370426795
STAT,1868,102,na,1970,4.926422204691757
SIM,1882,83,na,1965,1251
STAT,1833,38,20-24,1871,1.2562020910146234
STAT,1842,55,na,1897,3078.441736235328
SIM,1886,27,50-100,1913,2
SIM,1859,37,25-29,1896,6
STAT,1760,108,na,1868,0.0012519473324367036
STAT,1928,43,25-29,1971,0.18353561763234064
STAT,1813,42,30-34,1855,8.54289352824363
STAT,1907,32,50-100,1939,1.5616798699182
STAT,1907,46,20-24,1953,0.020149891094958364
SIM,1935,8,na,1943,11310
SIM,1852,20,15-19,1872,7
SIM,1869,47,40-44,1916,1
SIM,1915,32,50-100,1947,5
STAT,1821,53,50-100,1874,0.0416821645545083
STAT,1822,38,45-49,1860,7.620775866019939
SIM,1913,22,30-34,1935,92
SIM,1850,81,na,1931,818
STAT,1897,45,na,1942,6135.45783898894
SIM,1851,5,na,1856,4962
STAT,1844,81,na,1925,873.2881840869103
STAT,1880,33,30-34,1913,36.99006398190795
STAT,1878,27,50-100,1905,1.3493035908702204
SIM,1874,29,15-19,1903,1
STAT,1820,34,25-29,1854,65.88396925883568
SIM,1895,3,na,1898,7394
STAT,1856,5,na,1861,4633.090140379507
STAT,1921,42,30-34,1963,0.2907452899067198
STAT,1913,8,na,1921,8210.863230100511
SIM,1849,25,na,1874,4276
STAT,1841,24,50-100,1865,0.7388101012235455
STAT,1864,58,na,1922,3570.175504091867
STAT,1933,36,20-24,1969,0.7258906060606866
SIM,1922,19,15-19,1941,96
STAT,1833,49,30-34,1882,0.13244107968930516
SIM,1895,23,15-19,1918,9
SIM,1870,50,50-100,1920,1
STAT,1922,21,40-44,1943,7.8087547779999396
STAT,1847,46,50-100,1893,0.3754412838607278
SIM,1845,30,25-29,1875,33
STAT,1916,23,45-49,1939,2.3738137027442265
STAT,1843,99,na,1942,2.652962487742665
SIM,1826,37,na,1863,3288
SIM,1882,20,30-34,1902,42
SIM,1887,24,30-34,1911,53
STAT,1873,46,45-49,1919,0.48566022051277014
STAT,1822,44,30-34,1866,3.6660419649809377
STAT,1891,35,na,1926,5937.275772261308
STAT,1935,24,25-29,1959,253.91046763253064
SIM,1918,27,30-34,1945,104
STAT,1891,23,35-39,1914,14.522574114172311
STAT,1786,70,na,1856,1163.8870082400001
STAT,1882,48,45-49,1930,0.45847159942633586
STAT,1887,23,15-19,1910,7.428785208959483
STAT,1824,32,35-39,1856,45.561908261205495
STAT,1804,108,na,1912,0.0012322350709663237
STAT,1879,24,30-34,1903,37.392482378575984
SIM,1763,97,na,1860,3
SIM,1848,40,na,1888,3596
SIM,1832,32,35-39,1864,29
STAT,1890,50,na,1940,5384.3183391525745
SIM,1890,48,45-49,1938,1
STAT,1954,15,na,1969,9193.62602343832
STAT,1927,25,40-44,1952,11.52003125511458
SIM,1828,43,25-29,1871,4
SIM,1804,53,na,1857,2349
STAT,1905,36,15-19,1941,0.035571619003681
SIM,1943,24,25-29,1967,213
STAT,1921,50,na,1971,8286.894637682033
SIM,1895,36,50-100,1931,8
STAT,1887,36,50-100,1923,2.786564001068343
STAT,1933,16,na,1949,9976.61244269982
SIM,1870,16,25-29,1886,13
STAT,1818,49,35-39,1867,0.5984321605897037
STAT,1906,35,50-100,1941,0.7872793725004231
STAT,1914,19,45-49,1933,0.20761114546040418
STAT,1924,34,20-24,1958,5.738284923546945
STAT,1918,36,25-29,1954,2.1056833800033643
STAT,1907,21,45-49,1928,2.0761523411798124
SIM,1924,23,45-49,1947,3
SIM,1858,39,na,1897,4009
STAT,1926,30,15-19,1956,0.31411890131084746
STAT,1869,54,30-34,1923,0.011328445686931338
STAT,1930,41,50-100,1971,0.31262671492963284
SIM,1930,21,40-44,1951,12
SIM,1946,15,45-49,1961,1
SIM,1909,33,20-24,1942,6
STAT,1811,97,na,1908,4.993845091781229
STAT,1957,3,na,1960,10472.910502333185
SIM,1817,63,na,1880,2032
STAT,1791,110,na,1901,1.0905237275261091E-4
SIM,1794,74,na,1868,808
SIM,1862,28,50-100,1890,1
SIM,1897,20,na,1917,6497
SIM,1798,88,na,1886,67
SIM,1952,3,na,1955,9776
SIM,1821,38,50-100,1859,5
SIM,1900,22,20-24,1922,190
STAT,1906,39,na,1945,6917.886517261906
SIM,1908,40,45-49,1948,1
SIM,1904,33,45-49,1937,2
STAT,1943,20,50-100,1963,1.4147903226507828
SIM,1920,17,45-49,1937,2
SIM,1890,40,35-39,1930,8
SIM,1928,33,30-34,1961,58
STAT,1829,92,na,1921,49.29246024794009
SIM,1844,15,15-19,1859,11
SIM,1951,20,50-100,1971,5
STAT,1887,6,na,1893,5900.773528128974
SIM,1854,55,na,1909,3439
STAT,1902,44,25-29,1946,0.12543295347942124
SIM,1869,44,25-29,1913,2
STAT,1919,49,na,1968,7998.793531311796
STAT,1938,15,45-49,1953,0.9999915982077537
STAT,1848,43,50-100,1891,1.7197582669834672
STAT,1881,16,35-39,1897,1.0737555453333192
SIM,1844,26,25-29,1870,86
STAT,1913,32,25-29,1945,18.576542330724706
STAT,1833,103,na,1936,0.18866883637573614
SIM,1888,44,35-39,1932,5
SIM,1921,32,25-29,1953,28
STAT,1807,48,20-24,1855,0.08099919247906037
SIM,1914,35,50-100,1949,2
STAT,1832,96,na,1928,11.194578858771955
STAT,1837,49,45-49,1886,0.3328869190519992
STAT,1955,17,40-44,1972,3.749544413589815
STAT,1868,94,na,1962,91.5651390665256
STAT,1840,17,50-100,1857,0.09155907090040426
STAT,1857,20,25-29,1877,105.5437536361308
STAT,1903,29,40-44,1932,8.552365521108204
SIM,1852,29,na,1881,4022
SIM,1929,38,50-100,1967,2
STAT,1858,18,25-29,1876,10.36046440358383
STAT,1914,19,15-19,1933,18.861476381808014
STAT,1910,49,50-100,1959,0.4238497098383042
STAT,1931,23,40-44,1954,8.780472137580842
STAT,1944,26,25-29,1970,143.7290511718961
STAT,1872,20,20-24,1892,140.70905128764187
SIM,1878,22,30-34,1900,48
SIM,1919,31,30-34,1950,39
STAT,1837,30,25-29,1867,18.27871701423962
STAT,1906,61,na,1967,6008.350166107419
SIM,1856,43,50-100,1899,3
STAT,1847,17,40-44,1864,0.3479783265954202
SIM,1886,57,na,1943,4108
STAT,1882,40,35-39,1922,3.5985368215919515
SIM,1802,86,na,1888,145
SIM,1911,29,40-44,1940,14
STAT,1901,16,30-34,1917,4.517524988749557
SIM,1900,27,15-19,1927,1
STAT,1861,43,50-100,1904,1.7630757533750718
SIM,1908,9,na,1917,7850
SIM,1775,82,na,1857,220
SIM,1950,16,na,1966,8573
STAT,1836,26,25-29,1862,73.31987298427296
STAT,1878,4,na,1882,6082.038707643127
STAT,1830,30,na,1860,3950.9059125582276
SIM,1900,38,25-29,1938,4
STAT,1808,74,na,1882,988.5646324462233
STAT,1828,53,30-34,1881,0.009238133037121263
STAT,1880,46,45-49,1926,0.5035328071164078
STAT,1850,22,35-39,1872,10.739097193701753
STAT,1888,31,na,1919,5719.5584976775135
SIM,1795,59,na,1854,2049
STAT,1841,33,na,1874,3775.8437644748037
STAT,1953,15,40-44,1968,3.418737466298855
STAT,1864,98,na,1962,15.942818554676254
STAT,1868,33,15-19,1901,0.27248534234838334
SIM,1892,30,35-39,1922,38
SIM,1830,47,40-44,1877,1
SIM,1883,12,na,1895,5365
SIM,1921,23,35-39,1944,25
STAT,1934,19,25-29,1953,117.7627098082083
SIM,1898,15,35-39,1913,2
STAT,1918,36,30-34,1954,3.8977543631045406
SIM,1862,34,40-44,1896,12
STAT,1836,50,25-29,1886,0.004958706124348694
STAT,1913,49,na,1962,7201.276342365957
STAT,1883,77,na,1960,2049.1738324980097
STAT,1818,36,na,1854,3102.429830554885
SIM,1902,34,50-100,1936,2
STAT,1852,49,35-39,1901,0.21847457705473045
STAT,1866,36,15-19,1902,0.10514653903838628
SIM,1869,43,25-29,1912,3
STAT,1879,17,25-29,1896,11.970834152858878
STAT,1838,50,na,1888,3015.6266795317138
STAT,1845,111,na,1956,1.6787496843042338E-4
SIM,1800,60,na,1860,1974
STAT,1814,46,na,1860,2677.4254001434397
STAT,1891,20,25-29,1911,143.75958396480394
STAT,1880,43,40-44,1923,4.750929205852568
SIM,1942,19,25-29,1961,107
STAT,1905,28,50-100,1933,1.8618243863508697
SIM,1860,49,35-39,1909,1
STAT,1921,42,25-29,1963,0.1623982707024393
SIM,1923,31,45-49,1954,6
STAT,1940,16,45-49,1956,1.0247180455403853
SIM,1885,15,25-29,1900,18
STAT,1884,30,35-39,1914,20.358447895943407
STAT,1900,47,25-29,1947,0.09060375519889018
STAT,1921,44,na,1965,8418.068949638197
STAT,1930,20,30-34,1950,74.80416454274906
SIM,1863,85,na,1948,536
STAT,1822,47,40-44,1869,0.532243491576953
STAT,1919,15,40-44,1934,0.6290851130768699
SIM,1888,21,na,1909,5554
STAT,1861,24,30-34,1885,30.32105087203409
STAT,1870,19,30-34,1889,3.1530003567701583
STAT,1898,8,na,1906,7104.787929078244
SIM,1939,7,na,1946,8306
SIM,1821,68,na,1889,1619
SIM,1874,17,15-19,1891,11
SIM,1937,15,40-44,1952,2
STAT,1915,31,45-49,1946,3.2501836005955744
SIM,1878,38,40-44,1916,16
STAT,1851,32,na,1883,3850.2228467954073
STAT,1908,62,na,1970,6112.073660302552
STAT,1834,60,na,1894,2534.523289741372
SIM,1871,27,na,1898,4826
SIM,1793,73,na,1866,910
SIM,1869,88,na,1957,298
SIM,1909,39,35-39,1948,4
STAT,1871,43,30-34,1914,2.2901625749541794
STAT,1822,107,na,1929,0.00532470480814054
STAT,1805,85,na,1890,205.05512320408982
STAT,1873,51,25-29,1924,0.007303185805355899
SIM,1913,29,15-19,1942,2
STAT,1795,110,na,1905,1.1809635843773192E-4
STAT,1854,34,40-44,1888,6.668159140537399
STAT,1951,16,20-24,1967,326.1214266118787
STAT,1909,41,30-34,1950,0.24302648371356875
SIM,1926,36,30-34,1962,7
STAT,1872,27,40-44,1899,6.080217397433578
STAT,1913,23,35-39,1936,19.148432288479388
STAT,1856,63,na,1919,2780.367434875231
STAT,1804,52,30-34,1856,0.03480888165156665
SIM,1842,19,20-24,1861,39
STAT,1877,5,na,1882,5721.89995517934
STAT,1944,26,30-34,1970,85.56144172938014
SIM,1920,31,na,1951,8551
SIM,1875,70,na,1945,3019
STAT,1817,88,na,1905,138.46772142906667
STAT,1864,53,40-44,1917,0.018700509219536105
STAT,1909,34,25-29,1943,17.67002757897782
SIM,1832,71,na,1903,1681
SIM,1927,15,40-44,1942,3
STAT,1870,27,na,1897,4732.063313586351
STAT,1892,26,15-19,1918,1.1510307960384987
STAT,1826,65,na,1891,2023.0626592689093
STAT,1861,35,25-29,1896,4.885920259767926
SIM,1828,42,25-29,1870,2
STAT,1929,37,45-49,1966,1.7674228189736636
STAT,1813,50,15-19,1863,1.5057029952975244E-4
STAT,1920,20,30-34,1940,64.90139564426002
STAT,1854,40,50-100,1894,1.6358689201239724
SIM,1832,44,50-100,1876,6
STAT,1872,39,50-100,1911,2.466918358600638
STAT,1925,34,na,1959,9056.908851759774
STAT,1850,50,na,1900,3348.829240028749
STAT,1926,31,20-24,1957,5.95905280071141
SIM,1888,43,na,1931,5397
STAT,1843,40,15-19,1883,0.020434880627147833
SIM,1888,31,50-100,1919,6
STAT,1927,29,35-39,1956,36.708340199225006
SIM,1912,30,30-34,1942,8
STAT,1878,48,50-100,1926,0.5115350024680511
STAT,1849,43,50-100,1892,1.6590221396440865
STAT,1856,40,25-29,1896,1.0107290646420088
SIM,1876,25,50-100,1901,2
STAT,1786,73,na,1859,875.8287629646152
SIM,1915,37,25-29,1952,2
SIM,1910,59,na,1969,6664
STAT,1877,51,25-29,1928,0.007463702314015916
SIM,1822,38,50-100,1860,3
STAT,1878,40,20-24,1918,0.33836455012928585
SIM,1917,34,25-29,1951,28
STAT,1899,15,45-49,1914,0.18159624976178929
SIM,1838,16,35-39,1854,1
STAT,1859,46,25-29,1905,0.09285426035967696
STAT,1835,34,30-34,1869,28.210306018715208
STAT,1927,40,50-100,1967,0.29834514347902563
STAT,1825,83,na,1908,459.32813142308913
STAT,1867,40,45-49,1907,2.8593456616390998
SIM,1935,29,35-39,1964,49
STAT,1904,30,30-34,1934,51.01799605237268
SIM,1847,20,50-100,1867,2
SIM,1867,75,na,1942,2011
SIM,1845,21,50-100,1866,1
SIM,1870,79,na,1949,1217
SIM,1941,17,na,1958,7756
STAT,1872,26,50-100,1898,1.302865354227767
STAT,1930,42,35-39,1972,0.5350869013072311
STAT,1825,35,15-19,1860,0.15892012593742683
STAT,1854,53,40-44,1907,0.01587962777820117
STAT,1922,48,15-19,1970,8.520718616957665E-4
STAT,1853,29,40-44,1882,4.924952976172412
STAT,1848,21,35-39,1869,11.73485896142176
SIM,1934,31,20-24,1965,8
STAT,1840,16,40-44,1856,0.34384586663823297
SIM,1856,21,35-39,1877,12
SIM,1875,40,45-49,1915,7
SIM,1848,27,15-19,1875,1
SIM,1861,84,na,1945,518
SIM,1873,30,25-29,1903,34
SIM,1890,65,na,1955,4325
SIM,1905,32,na,1937,7200
SIM,1843,65,na,1908,2529
STAT,1870,22,15-19,1892,6.541394743923891
SIM,1902,23,25-29,1925,191
SIM,1922,26,45-49,1948,3
SIM,1941,27,25-29,1968,152
STAT,1890,43,40-44,1933,5.504761173246136
STAT,1953,19,35-39,1972,10.243909858429625
SIM,1843,34,30-34,1877,38
STAT,1818,45,25-29,1863,0.26189289387792813
STAT,1765,104,na,1869,0.05905225727565397
STAT,1835,45,25-29,1880,0.08869424755396715
STAT,1844,29,30-34,1873,49.070472869965144
STAT,1871,52,na,1923,4297.363798648173
STAT,1871,49,45-49,1920,0.46365044161088065
SIM,1889,28,15-19,1917,4
STAT,1805,63,na,1868,1978.404773032954
SIM,1847,40,25-29,1887,3
SIM,1868,17,15-19,1885,12
STAT,1820,48,45-49,1868,0.8655537828713641
STAT,1835,27,50-100,1862,1.0802686095706826
SIM,1892,42,na,1934,6620
STAT,1860,19,30-34,1879,2.979459132729402
STAT,1900,20,45-49,1920,1.9652897037719899
STAT,1809,45,15-19,1854,0.0032149391510479628
STAT,1933,20,40-44,1953,9.062200724632158
STAT,1870,38,30-34,1908,10.51521660729627
SIM,1877,17,25-29,1894,17
SIM,1852,29,30-34,1881,61
STAT,1839,50,35-39,1889,0.013776911194855588
SIM,1812,85,na,1897,220
STAT,1919,44,35-39,1963,0.43915738342004557
SIM,1920,15,30-34,1935,35
SIM,1924,20,40-44,1944,11
SIM,1896,72,na,1968,4077
STAT,1846,33,50-100,1879,1.6413621835706917
SIM,1907,23,15-19,1930,9
SIM,1821,62,na,1883,2048
STAT,1841,30,na,1871,3895.316935158764
SIM,1863,91,na,1954,108
SIM,1916,29,25-29,1945,9
STAT,1876,36,15-19,1912,0.11786356938007038
SIM,1897,33,50-100,1930,3
SIM,1911,20,30-34,1931,66
STAT,1854,32,15-19,1886,0.22356175232752565
STAT,1885,16,50-100,1901,0.09873007532421428
STAT,1903,25,30-34,1928,72.9033915022573
STAT,1873,39,50-100,1912,2.4940404432437817
SIM,1880,22,25-29,1902,138
STAT,1843,34,50-100,1877,1.5112912170361634
SIM,1772,93,na,1865,11
STAT,1831,71,na,1902,1723.4252789113061
SIM,1830,98,na,1928,7
SIM,1836,44,40-44,1880,10
STAT,1841,35,50-100,1876,2.1428450030863364
STAT,1916,20,40-44,1936,7.158120468323775
STAT,1907,37,25-29,1944,1.8446870669281699
STAT,1776,89,na,1865,69.61559940309813
STAT,1840,52,40-44,1892,0.015115137774140393
STAT,1889,41,35-39,1930,4.529751697788317
SIM,1852,35,25-29,1887,6
STAT,1827,29,30-34,1856,81.01685817199126
STAT,1832,28,50-100,1860,1.1109550468907077
STAT,1848,34,40-44,1882,7.39118938484427
SIM,1868,23,na,1891,4539
SIM,1835,29,30-34,1864,62
SIM,1789,74,na,1863,856
SIM,1936,34,35-39,1970,18
SIM,1876,58,na,1934,4381
STAT,1952,14,na,1966,9502.790298071839
SIM,1941,20,40-44,1961,10
STAT,1928,44,45-49,1972,0.4270078240002363
SIM,1926,28,na,1954,9247
SIM,1905,26,45-49,1931,4
STAT,1868,88,na,1956,294.80394171427815
STAT,1923,6,na,1929,9502.145385914084
STAT,1830,45,35-39,1875,0.24799961870525805
SIM,1931,26,50-100,1957,3
STAT,1874,24,40-44,1898,4.282163200205716
SIM,1911,41,50-100,1952,1
SIM,1922,44,na,1966,8960
STAT,1876,35,30-34,1911,11.238469407362608
STAT,1941,16,50-100,1957,0.7796260465075553
STAT,1908,29,25-29,1937,124.84885305748041
SIM,1826,93,na,1919,21
STAT,1899,41,35-39,1940,0.3495327737253757
SIM,1932,37,25-29,1969,3
STAT,1871,30,25-29,1901,20.7171388173191
SIM,1861,19,30-34,1880,5
STAT,1788,74,na,1862,920.3944304278784
STAT,1868,25,25-29,1893,81.83474913675487
SIM,1847,50,35-39,1897,1
SIM,1921,30,40-44,1951,4
STAT,1883,45,50-100,1928,0.4921960859950334
SIM,1887,31,50-100,1918,4
SIM,1899,30,45-49,1929,6
STAT,1848,40,35-39,1888,3.042518363021273
SIM,1856,38,na,1894,3945
SIM,1888,41,25-29,1929,3
STAT,1916,23,50-100,1939,1.3881952006978506
SIM,1902,30,30-34,1932,63
STAT,1798,98,na,1896,1.7585991476281944
STAT,1813,52,40-44,1865,0.06190532876026648
SIM,1928,35,na,1963,9770
STAT,1849,50,35-39,1899,0.013813488204113924
SIM,1878,25,35-39,1903,30
SIM,1893,36,25-29,1929,10
STAT,1791,78,na,1869,620.6745852917685
STAT,1885,49,30-34,1934,0.19053364044689766
STAT,1924,37,25-29,1961,2.3441971172151663
STAT,1895,35,40-44,1930,11.629376682914165
SIM,1884,35,30-34,1919,14
SIM,1877,25,50-100,1902,2
STAT,1884,45,50-100,1929,0.4946758512529467
SIM,1931,16,45-49,1947,2
SIM,1844,96,na,1940,2
SIM,1941,4,na,1945,8452
STAT,1853,19,30-34,1872,2.9979579712762305
STAT,1920,37,50-100,1957,0.9281895555659383
STAT,1906,45,na,1951,6688.409276749538
SIM,1871,22,15-19,1893,6
STAT,1881,53,40-44,1934,0.020220861885680022
STAT,1828,44,40-44,1872,4.100927783612214
SIM,1919,40,na,1959,8222
SIM,1909,36,30-34,1945,6
SIM,1898,45,na,1943,6395
STAT,1830,29,50-100,1859,1.3320111199948597
STAT,1861,49,45-49,1910,0.3884348122915972
SIM,1900,23,20-24,1923,180
STAT,1885,36,25-29,1921,5.8158972366168005
SIM,1833,44,50-100,1877,8
STAT,1869,17,25-29,1886,11.243006240286986
SIM,1937,18,45-49,1955,1
STAT,1902,41,20-24,1943,0.03158779221527069
SIM,1901,15,20-24,1916,45
STAT,1912,15,30-34,1927,5.002257828073727
STAT,1823,52,40-44,1875,0.03131123157218687
STAT,1826,31,na,1857,3521.481441512441
SIM,1855,50,na,1905,3877
STAT,1914,26,45-49,1940,3.5300560495082483
SIM,1876,36,na,1912,5154
SIM,1831,46,na,1877,3292
SIM,1884,87,na,1971,919
STAT,1885,20,na,1905,4782.815925299641
SIM,1817,44,30-34,1861,4
STAT,1909,28,na,1937,7209.01931893736
STAT,1933,27,25-29,1960,176.5249215456655
SIM,1856,40,35-39,1896,6
STAT,1813,98,na,1911,2.8866564328559146
SIM,1831,52,40-44,1883,1
STAT,1929,18,45-49,1947,1.2840430289479774
STAT,1830,52,40-44,1882,0.015982374184401824
STAT,1913,30,40-44,1943,7.9285265136548295
STAT,1866,47,50-100,1913,0.4555369348542111
STAT,1917,41,20-24,1958,0.03727235923244046
STAT,1918,30,na,1948,8180.590101434401
SIM,1942,16,20-24,1958,282
STAT,1883,20,35-39,1903,11.64827575288895
SIM,1842,29,30-34,1871,50
STAT,1816,45,15-19,1861,0.00202654392998355
SIM,1813,47,40-44,1860,3
SIM,1879,17,35-39,1896,1
SIM,1838,25,na,1863,3866
SIM,1890,41,25-29,1931,3
STAT,1878,43,25-29,1921,1.3447176462925143
SIM,1906,31,45-49,1937,4
STAT,1951,19,25-29,1970,104.14209938558659
SIM,1846,16,25-29,1862,10
SIM,1897,35,40-44,1932,23
STAT,1883,36,15-19,1919,0.11196230116893181
SIM,1835,36,na,1871,3629
STAT,1872,38,40-44,1910,8.841124221905995
STAT,1894,28,50-100,1922,1.6537740469225297
STAT,1909,44,35-39,1953,0.37591714318633507
STAT,1814,62,na,1876,1940.3559918692479
STAT,1935,36,30-34,1971,5.152716564001497
STAT,1861,25,15-19,1886,0.7793703757085266
SIM,1921,20,30-34,1941,5
STAT,1784,90,na,1874,49.05078706922784
STAT,1871,46,35-39,1917,0.281709664560542
SIM,1880,38,40-44,1918,13
SIM,1822,32,35-39,1854,19
STAT,1900,44,20-24,1944,0.030480109662220953
SIM,1886,43,25-29,1929,3
STAT,1863,22,15-19,1885,5.948579165998501
STAT,1932,31,45-49,1963,4.22749623879958
STAT,1825,29,20-24,1854,79.08812963873469
STAT,1903,18,50-100,1921,0.1405101004438953
SIM,1833,29,20-24,1862,22
STAT,1785,91,na,1876,39.26063546735277
STAT,1889,35,40-44,1924,11.004529448441597
STAT,1895,40,20-24,1935,0.4221543637658648
STAT,1899,16,50-100,1915,0.13590027745298144
STAT,1820,43,15-19,1863,0.05430240825076285
SIM,1867,43,20-24,1910,1
STAT,1818,42,15-19,1860,0.06806316429110783
STAT,1834,29,30-34,1863,43.32585885714297
SIM,1857,17,15-19,1874,14
STAT,1888,15,na,1903,6056.796940221795
SIM,1934,34,25-29,1968,31
STAT,1885,33,15-19,1918,0.28507349449520825
STAT,1770,92,na,1862,17.900470153020365
STAT,1884,40,45-49,1924,3.0148220674415467
SIM,1937,34,40-44,1971,10
SIM,1891,20,35-39,1911,20
STAT,1892,54,na,1946,5294.287985878287
SIM,1938,18,20-24,1956,267
SIM,1922,24,50-100,1946,5
STAT,1838,16,25-29,1854,10.19041646981922
STAT,1810,72,na,1882,1194.1425081392028
STAT,1823,109,na,1932,8.537527434010345E-4
STAT,1880,24,40-44,1904,4.405701249541871
STAT,1776,95,na,1871,4.844085415374818
SIM,1820,37,30-34,1857,14
SIM,1940,19,20-24,1959,262
STAT,1863,79,na,1942,1235.9486417341468
STAT,1923,16,45-49,1939,1.1871979166123021
SIM,1867,59,na,1926,3885
STAT,1937,33,30-34,1970,31.467377022434643
SIM,1883,26,15-19,1909,1
STAT,1857,27,15-19,1884,0.7356547858586239
STAT,1932,19,20-24,1951,360.6492948315816
STAT,1936,15,40-44,1951,2.7176308609282254
SIM,1821,33,40-44,1854,13
STAT,1908,26,20-24,1934,35.29029043765629
SIM,1856,81,na,1937,785
SIM,1940,31,45-49,1971,5
STAT,1869,50,20-24,1919,0.0014648154216100734
SIM,1809,49,40-44,1858,1
STAT,1831,26,40-44,1857,5.287492617923111
STAT,1845,53,30-34,1898,0.009025221641214862
SIM,1904,30,40-44,1934,20
STAT,1904,42,25-29,1946,0.12910349226580412
SIM,1901,18,25-29,1919,24
STAT,1876,30,45-49,1906,3.6718796942957335
SIM,1884,30,45-49,1914,7
STAT,1914,24,50-100,1938,1.349404785070345
STAT,1881,36,na,1917,4621.194439172944
STAT,1878,7,na,1885,5647.837799759
STAT,1905,17,50-100,1922,0.1430945319274741
STAT,1914,40,na,1954,7485.58307656222
SIM,1892,40,45-49,1932,12
SIM,1911,25,30-34,1936,107
STAT,1849,17,15-19,1866,11.554973680354632
STAT,1875,26,15-19,1901,0.9466446153662422
STAT,1929,34,40-44,1963,10.02517704769416
SIM,1850,19,na,1869,4436
STAT,1847,53,40-44,1900,0.015790072935121628
STAT,1835,35,15-19,1870,0.09184258802129185
STAT,1897,41,25-29,1938,0.1209290379491542
STAT,1938,23,50-100,1961,1.314996223987132
SIM,1868,24,20-24,1892,3
SIM,1878,5,na,1883,5942
SIM,1848,20,30-34,1868,46
STAT,1835,48,na,1883,3032.18840501769
STAT,1896,10,na,1906,6906.918583573876
SIM,1816,39,30-34,1855,15
STAT,1920,29,40-44,1949,10.250239681854547
STAT,1926,34,25-29,1960,22.538227635375108
STAT,1861,44,15-19,1905,0.022901088139002317
STAT,1859,43,20-24,1902,0.25344607148051845
STAT,1921,30,30-34,1951,35.68603272007217
SIM,1809,81,na,1890,449
SIM,1916,26,20-24,1942,44
SIM,1878,44,35-39,1922,7
SIM,1865,27,15-19,1892,1
STAT,1839,41,50-100,1880,1.9351603219478826
STAT,1832,104,na,1936,0.08695803533122273
SIM,1856,34,40-44,1890,14
STAT,1842,35,15-19,1877,0.10013150367182393
STAT,1891,49,30-34,1940,0.1334645428721852
SIM,1906,43,20-24,1949,1
STAT,1903,31,na,1934,6890.028733984538
SIM,1881,39,50-100,1920,5
SIM,1898,18,15-19,1916,13
STAT,1909,31,20-24,1940,4.722671794945632
STAT,1843,96,na,1939,12.028342014326594
STAT,1856,51,25-29,1907,0.005545700350182133
STAT,1901,47,50-100,1948,0.389874330581135
STAT,1913,20,30-34,1933,56.59713009436531
SIM,1895,30,20-24,1925,11
SIM,1917,31,20-24,1948,7
SIM,1872,28,na,1900,5061
SIM,1887,28,40-44,1915,8
SIM,1859,25,25-29,1884,87
SIM,1852,32,15-19,1884,3
SIM,1925,41,50-100,1966,1
STAT,1861,39,35-39,1900,11.76997642051291
SIM,1815,50,na,1865,2522
STAT,1841,95,na,1936,19.290893794091136
STAT,1907,34,20-24,1941,4.567739752665017
SIM,1934,37,35-39,1971,9
STAT,1859,24,15-19,1883,5.42346534133753
SIM,1837,24,35-39,1861,12
SIM,1935,26,30-34,1961,144
SIM,1938,13,na,1951,7941
STAT,1831,37,40-44,1868,7.158872152066894
SIM,1847,21,na,1868,3995
STAT,1837,32,15-19,1869,0.24891411062585625
STAT,1911,45,35-39,1956,0.2477431199774725
SIM,1828,47,40-44,1875,1
STAT,1869,45,40-44,1914,0.33836813400688165
STAT,1874,82,na,1956,1034.7995643633815
STAT,1829,35,50-100,1864,2.223883225371377
SIM,1905,26,na,1931,7164
STAT,1896,15,35-39,1911,1.4698913383528267
STAT,1858,70,na,1928,2209.025738101564
SIM,1797,69,na,1866,1442
SIM,1832,22,na,1854,3705
SIM,1834,88,na,1922,130
SIM,1895,38,40-44,1933,15
SIM,1861,29,40-44,1890,7
STAT,1887,38,40-44,1925,9.838827439779152
STAT,1844,48,30-34,1892,0.15435946540898854
STAT,1877,17,15-19,1894,12.44569184227619
SIM,1867,24,15-19,1891,6
STAT,1906,41,45-49,1947,0.30724343960860967
STAT,1881,23,35-39,1904,11.356132164166512
STAT,1822,40,15-19,1862,0.049020198889686915
STAT,1926,37,35-39,1963,5.969037344752319
SIM,1915,34,20-24,1949,5
STAT,1927,26,30-34,1953,96.51947382842225
SIM,1859,21,45-49,1880,2
STAT,1844,32,15-19,1876,0.2750130568480189
STAT,1922,31,50-100,1953,1.8938761758957499
STAT,1949,18,30-34,1967,28.61897702340418
SIM,1877,45,40-44,1922,1
STAT,1851,19,20-24,1870,33.021188738717356
STAT,1885,33,20-24,1918,5.411017405353611
SIM,1859,102,na,1961,2
STAT,1923,42,35-39,1965,0.4751776498316613
SIM,1803,65,na,1868,1768
STAT,1879,28,40-44,1907,6.305785409911483
STAT,1933,23,45-49,1956,3.013575063241002
STAT,1938,27,45-49,1965,3.4572534533869415
SIM,1920,18,35-39,1938,12
STAT,1841,40,25-29,1881,0.9933073350303225
STAT,1916,36,20-24,1952,0.5478189670671609
SIM,1909,62,na,1971,6191
SIM,1929,17,na,1946,9735
STAT,1915,3,na,1918,8546.216106124628
SIM,1806,79,na,1885,548
STAT,1799,107,na,1906,0.0032071398615236275
SIM,1860,34,30-34,1894,37
STAT,1901,24,na,1925,6645.004167133816
SIM,1941,24,20-24,1965,224
STAT,1898,47,15-19,1945,6.138001459272815E-4
STAT,1863,57,na,1920,3552.8279895428836
STAT,1958,2,na,1960,10436.62449841696
STAT,1928,41,40-44,1969,0.6448139061396155
STAT,1830,42,30-34,1872,2.060779632612072
STAT,1846,37,40-44,1883,7.001967199081608
STAT,1902,49,40-44,1951,0.269608259172419
STAT,1852,34,30-34,1886,28.21984686625194
STAT,1869,36,na,1905,4632.695477209099
STAT,1953,16,30-34,1969,29.784405912347573
SIM,1909,20,15-19,1929,10
SIM,1910,49,40-44,1959,1
STAT,1931,19,15-19,1950,119.33093830624081
STAT,1924,21,45-49,1945,2.6887864953618177
STAT,1839,31,35-39,1870,19.66245019536924
SIM,1796,78,na,1874,579
STAT,1858,19,15-19,1877,10.786216019756887
SIM,1893,33,20-24,1926,8
SIM,1882,24,40-44,1906,5
SIM,1898,39,na,1937,6669
STAT,1902,30,20-24,1932,7.769309009492849
SIM,1854,37,40-44,1891,14
STAT,1914,23,40-44,1937,6.917455458396435
STAT,1935,31,30-34,1966,44.055644654430004
SIM,1850,48,50-100,1898,1
SIM,1936,31,30-34,1967,31
STAT,1875,42,na,1917,4799.963211959371
STAT,1898,70,na,1968,4502.78154478673
STAT,1934,17,na,1951,10056.33531192788
STAT,1860,15,na,1875,4393.526988335492
STAT,1863,41,15-19,1904,0.024524876410974922
STAT,1905,48,15-19,1953,6.507441886286579E-4
STAT,1834,25,15-19,1859,0.8034296062761508
STAT,1834,82,na,1916,620.059060543787
SIM,1818,64,na,1882,1918
STAT,1847,33,na,1880,3838.818087249483
STAT,1851,54,na,1905,3246.0157539983074
SIM,1902,20,20-24,1922,190
STAT,1859,43,15-19,1902,0.02203879001472704
STAT,1863,32,25-29,1895,18.10790704974668
STAT,1891,30,35-39,1921,25.48423874666782
SIM,1851,60,na,1911,2949
STAT,1855,81,na,1936,815.4373882303231
SIM,1839,21,35-39,1860,17
SIM,1847,31,35-39,1878,24
STAT,1890,46,45-49,1936,0.3291023025294949
STAT,1905,29,15-19,1934,1.315694398094098
SIM,1860,80,na,1940,1097
STAT,1840,22,35-39,1862,10.711762740122355
SIM,1880,57,na,1937,4439
STAT,1895,19,na,1914,6610.818633490854
SIM,1899,41,45-49,1940,1
SIM,1914,49,na,1963,7425
SIM,1823,94,na,1917,13
STAT,1910,42,25-29,1952,0.13634935594422837
STAT,1896,22,50-100,1918,1.0873438901037964
SIM,1922,23,40-44,1945,9
SIM,1815,46,50-100,1861,1
STAT,1818,42,20-24,1860,0.7827263470720097
STAT,1883,1,na,1884,6630.52562434676
STAT,1920,48,50-100,1968,0.5034279439633446
SIM,1929,39,na,1968,9951
SIM,1944,15,40-44,1959,4
SIM,1893,33,15-19,1926,1
SIM,1953,2,na,1955,9969
SIM,1866,19,15-19,1885,17
STAT,1876,31,15-19,1907,0.29868530473219723
SIM,1846,27,40-44,1873,9
STAT,1831,48,20-24,1879,0.018129646551155777
SIM,1852,32,20-24,1884,6
STAT,1878,33,15-19,1911,0.29911299730784435
SIM,1840,66,na,1906,2508
SIM,1838,19,na,1857,4203
SIM,1841,23,40-44,1864,2
STAT,1849,99,na,1948,2.995715549940199
STAT,1880,48,40-44,1928,0.35966380524059516
SIM,1866,40,35-39,1906,5
SIM,1909,16,na,1925,7708
STAT,1865,49,20-24,1914,0.021558022166533505
SIM,1908,31,na,1939,7253
SIM,1932,21,45-49,1953,2
STAT,1860,45,20-24,1905,0.019877205828063446
STAT,1815,50,25-29,1865,0.0189778605713479
STAT,1820,38,35-39,1858,33.0907058186712
STAT,1916,23,na,1939,7704.318466027514
STAT,1930,32,25-29,1962,24.089679344568264
STAT,1827,39,40-44,1866,8.626349619912386
SIM,1835,39,40-44,1874,7
STAT,1933,24,20-24,1957,297.7109783405771
STAT,1911,26,35-39,1937,29.680280319550725
STAT,1914,7,na,1921,8325.114946281792
SIM,1926,34,na,1960,9425
STAT,1913,33,45-49,1946,3.149343884822277
SIM,1845,42,25-29,1887,5
SIM,1820,37,na,1857,3119
SIM,1887,17,25-29,1904,19
STAT,1924,48,25-29,1972,0.1271524878013607
SIM,1921,33,45-49,1954,6
SIM,1901,18,30-34,1919,6
STAT,1833,23,40-44,1856,3.706829795816626
STAT,1838,27,40-44,1865,5.157149595556347
STAT,1844,32,20-24,1876,5.2200589182771076
STAT,1931,12,na,1943,10474.577064398716
SIM,1873,40,35-39,1913,7
STAT,1872,49,20-24,1921,0.023848333818348038
STAT,1902,55,na,1957,5978.593701434239
STAT,1808,102,na,1910,0.23037717727723364
STAT,1929,15,40-44,1944,3.62151410967315
STAT,1865,23,50-100,1888,0.7518761410377716
SIM,1902,39,40-44,1941,7
SIM,1941,23,45-49,1964,4
STAT,1846,85,na,1931,419.8942095229549
STAT,1802,101,na,1903,0.4379437520315788
SIM,1884,31,15-19,1915,3
SIM,1871,9,na,1880,5220
STAT,1882,41,25-29,1923,1.2690940980368217
STAT,1884,25,na,1909,4791.661973654226
STAT,1948,15,45-49,1963,1.1551083847961332
SIM,1872,16,35-39,1888,1
SIM,1919,39,50-100,1958,3
STAT,1860,15,15-19,1875,11.358860548201925
STAT,1788,80,na,1868,521.1836084761209
STAT,1878,56,na,1934,4302.2014183041365
STAT,1864,16,35-39,1880,1.132763416893996
STAT,1894,39,50-100,1933,3.1531937703438153
STAT,1865,40,35-39,1905,3.356026712856329
STAT,1871,46,40-44,1917,0.3444906747253133
SIM,1900,26,25-29,1926,132
STAT,1850,48,30-34,1898,0.14655560453681601
STAT,1884,41,15-19,1925,0.027665149788678206
SIM,1918,15,30-34,1933,7
STAT,1858,27,na,1885,3846.4190947618963
STAT,1837,42,25-29,1879,1.056370185893006
STAT,1942,26,20-24,1968,38.711052228629974
STAT,1863,24,50-100,1887,0.7247793458254274
STAT,1934,16,20-24,1950,371.32037200188455
SIM,1793,95,na,1888,1
STAT,1896,34,35-39,1930,26.771905762095848
SIM,1818,42,na,1860,3097
STAT,1866,41,50-100,1907,1.9775844642728715
STAT,1912,18,35-39,1930,1.7096336496873337
SIM,1879,60,na,1939,3935
STAT,1829,43,35-39,1872,2.934733957121878
SIM,1864,33,na,1897,4519
STAT,1926,17,50-100,1943,0.9275470725537462
STAT,1916,34,50-100,1950,1.7091847087039935
STAT,1817,50,15-19,1867,1.1850146996179102E-4
STAT,1892,76,na,1968,3188.406476748432
SIM,1844,18,40-44,1862,1
STAT,1947,18,20-24,1965,308.31876688735906
STAT,1850,26,50-100,1876,1.1625775817383117
STAT,1818,49,40-44,1867,0.7317970404049439
SIM,1956,15,45-49,1971,6
SIM,1863,33,35-39,1896,23
STAT,1886,43,15-19,1929,0.02922908285839333
STAT,1893,47,30-34,1940,0.1391260397464542
SIM,1849,40,35-39,1889,11
SIM,1850,29,20-24,1879,26
SIM,1858,79,na,1937,1076
SIM,1847,44,40-44,1891,6
STAT,1848,30,25-29,1878,19.996808355145884
STAT,1878,47,na,1925,4723.46649001355
SIM,1854,89,na,1943,134
STAT,1895,43,25-29,1938,0.1165037952291489
STAT,1926,44,35-39,1970,0.4996041915702056
SIM,1861,25,25-29,1886,84
STAT,1815,47,na,1862,2821.779536720597
STAT,1842,29,20-24,1871,21.29021143632301
SIM,1896,19,na,1915,6971
STAT,1835,42,15-19,1877,0.021440596483978024
SIM,1852,25,15-19,1877,1
STAT,1867,45,30-34,1912,0.18491522911400488
STAT,1935,27,35-39,1962,41.3401149838997
STAT,1835,61,na,1896,2420.1481408697964
SIM,1855,34,na,1889,4119
STAT,1844,25,15-19,1869,0.9099570496154367
STAT,1912,48,na,1960,7112.717669067283
STAT,1813,48,45-49,1861,1.4309537711666813
STAT,1861,93,na,1954,49.128132112390716
STAT,1855,33,35-39,1888,15.388357669065266
STAT,1809,49,30-34,1858,0.7236409270943834
STAT,1830,45,40-44,1875,0.30326810446020164
STAT,1861,32,50-100,1893,1.5402164659094058
STAT,1851,29,30-34,1880,45.052381100597344
SIM,1890,16,na,1906,6691
STAT,1905,40,50-100,1945,0.21643696603636783
STAT,1872,56,na,1928,4139.927786183014
SIM,1943,27,35-39,1970,43
SIM,1923,23,na,1946,8924
STAT,1904,19,45-49,1923,0.1883374783177125
SIM,1857,2,na,1859,6037
SIM,1803,74,na,1877,979
STAT,1828,97,na,1925,6.5974125314043075
SIM,1904,32,30-34,1936,39
STAT,1823,42,na,1865,3306.8345149545103
SIM,1854,21,25-29,1875,129
STAT,1804,84,na,1888,227.88998025327027
SIM,1889,22,na,1911,6012
SIM,1817,49,30-34,1866,1
STAT,1884,41,na,1925,4630.092913873722
SIM,1904,41,na,1945,6818
STAT,1762,109,na,1871,0.007056583413262915
STAT,1896,38,50-100,1934,3.2574505668799247
SIM,1821,48,45-49,1869,1
SIM,1930,22,30-34,1952,91
SIM,1843,39,30-34,1882,15
STAT,1939,22,40-44,1961,6.820541275899942
SIM,1866,96,na,1962,28
SIM,1836,40,25-29,1876,1
STAT,1810,54,20-24,1864,0.004380670785549614
STAT,1930,33,45-49,1963,4.098769323714039
SIM,1950,17,25-29,1967,120
SIM,1821,84,na,1905,338
STAT,1850,23,40-44,1873,3.8073217152071592
STAT,1942,17,25-29,1959,91.46414935904845
SIM,1883,31,na,1914,4986
STAT,1828,52,25-29,1880,0.0061616932706575304
SIM,1841,39,na,1880,3535
STAT,1897,29,na,1926,6396.710593844873
SIM,1825,77,na,1902,859
SIM,1852,39,40-44,1891,16
SIM,1891,45,50-100,1936,1
SIM,1935,30,na,1965,10885
SIM,1906,40,40-44,1946,1
STAT,1841,79,na,1920,1014.3526949398147
STAT,1868,21,45-49,1889,1.3496120191325358
STAT,1901,7,na,1908,7366.3032931262305
STAT,1835,39,30-34,1874,8.362064214424294
SIM,1895,22,25-29,1917,167
STAT,1797,97,na,1894,2.5994994504020115
STAT,1893,35,30-34,1928,13.772639064164073
SIM,1868,27,25-29,1895,84
STAT,1922,22,30-34,1944,66.54789167770183
STAT,1924,30,40-44,1954,9.259889867246905
SIM,1885,78,na,1963,2141
STAT,1915,48,15-19,1963,7.4764475421453E-4
SIM,1916,29,30-34,1945,9
STAT,1921,33,35-39,1954,20.447072376646283
SIM,1881,88,na,1969,562
STAT,1869,53,25-29,1922,0.00682021230545925
STAT,1937,23,50-100,1960,1.2939209222808534
SIM,1947,22,40-44,1969,10
STAT,1844,39,40-44,1883,7.316757582436363
STAT,1814,99,na,1913,1.629917960487554
SIM,1865,20,30-34,1885,39
SIM,1891,63,na,1954,4825
STAT,1826,87,na,1913,210.90690576157758
SIM,1859,27,na,1886,4354
STAT,1827,32,na,1859,3515.5201257998087
SIM,1878,84,na,1962,1036
STAT,1907,33,45-49,1940,2.959686639920433
STAT,1909,37,35-39,1946,4.626271264935817
STAT,1861,32,15-19,1893,0.2393884951914738
STAT,1831,29,45-49,1860,1.8952325314821454
SIM,1923,45,na,1968,9088
SIM,1909,8,na,1917,7932
SIM,1856,30,25-29,1886,26
STAT,1924,8,na,1932,9589.636749629719
STAT,1905,60,na,1965,5994.694447727901
STAT,1861,48,30-34,1909,0.16067701002271964
STAT,1848,49,na,1897,3612.055033451623
SIM,1880,39,50-100,1919,3
SIM,1918,26,50-100,1944,3
STAT,1836,50,50-100,1886,0.021143372096033824
SIM,1811,44,50-100,1855,3
SIM,1931,3,na,1934,10724
SIM,1826,35,15-19,1861,2
STAT,1870,22,20-24,1892,136.64157081317146
STAT,1910,18,25-29,1928,17.30283945287604
SIM,1932,30,40-44,1962,13
SIM,1909,19,na,1928,7684
STAT,1837,21,50-100,1858,0.7495891922754243
SIM,1902,23,30-34,1925,60
SIM,1892,29,na,1921,6804
STAT,1887,22,25-29,1909,129.30596814306725
SIM,1915,33,45-49,1948,4
STAT,1880,39,45-49,1919,4.198601837613515
STAT,1797,94,na,1891,9.670784622071224
STAT,1872,53,na,1925,4300.20068271838
STAT,1908,29,30-34,1937,74.32212053693911
STAT,1845,42,15-19,1887,0.021669878592759224
SIM,1920,32,50-100,1952,3
SIM,1907,39,25-29,1946,2
STAT,1885,26,15-19,1911,0.9152064891325817
SIM,1792,94,na,1886,2
STAT,1830,33,40-44,1863,8.447120696341637
SIM,1929,28,20-24,1957,49
STAT,1821,42,50-100,1863,3.3589111248445467
SIM,1886,48,50-100,1934,3
STAT,1890,37,50-100,1927,3.0265773589042744
SIM,1821,87,na,1908,166
SIM,1946,24,40-44,1970,8
SIM,1916,17,30-34,1933,4
STAT,1839,18,50-100,1857,0.09948018111004149
STAT,1852,46,30-34,1898,0.15471886261450532
STAT,1867,54,50-100,1921,0.02778017368301004
STAT,1870,34,15-19,1904,0.27995227878268886
SIM,1877,41,25-29,1918,1
STAT,1825,39,30-34,1864,12.998170158180852
STAT,1917,47,50-100,1964,0.47708715526876044
SIM,1833,39,30-34,1872,15
STAT,1867,30,35-39,1897,19.308549017744014
STAT,1869,41,25-29,1910,1.2623485870313098
STAT,1881,11,na,1892,5048.790404395122
SIM,1789,90,na,1879,28
STAT,1839,20,50-100,1859,0.8300057002128185
SIM,1828,31,25-29,1859,18
STAT,1853,25,25-29,1878,78.66019113458051
STAT,1935,20,15-19,1955,14.652744258958968
STAT,1839,44,40-44,1883,3.607939099055287
SIM,1877,37,na,1914,4833
SIM,1931,40,na,1971,10083
STAT,1804,87,na,1891,118.5201415903106
STAT,1857,20,30-34,1877,32.84051246910411
STAT,1917,44,25-29,1961,0.14999222459140715
SIM,1771,92,na,1863,11
SIM,1843,27,50-100,1870,2
SIM,1924,27,25-29,1951,186
SIM,1827,84,na,1911,300
STAT,1905,24,45-49,1929,2.023973122692957
SIM,1889,25,na,1914,6046
STAT,1811,45,30-34,1856,0.6802043089235219
SIM,1839,30,30-34,1869,50
STAT,1861,29,30-34,1890,42.02843737847011
STAT,1813,41,25-29,1854,4.961875348912296
SIM,1830,43,25-29,1873,3
STAT,1921,46,40-44,1967,0.35976321471412404
SIM,1918,4,na,1922,9118
SIM,1792,91,na,1883,20
STAT,1836,54,40-44,1890,0.013615862035833383
SIM,1807,55,na,1862,2154
STAT,1925,17,30-34,1942,29.730849066705872
SIM,1809,68,na,1877,1485
SIM,1809,84,na,1893,260
SIM,1897,31,25-29,1928,34
SIM,1891,23,45-49,1914,2
SIM,1822,47,na,1869,2866
SIM,1854,33,50-100,1887,3
STAT,1819,54,40-44,1873,0.04075801650280969
STAT,1898,21,30-34,1919,48.829509322168455
STAT,1889,31,25-29,1920,25.610705370142345
SIM,1873,21,35-39,1894,16
STAT,1938,24,40-44,1962,6.717278345120159
SIM,1909,2,na,1911,8100
STAT,1847,89,na,1936,160.13747824604388
STAT,1826,107,na,1933,0.0056454920607866155
SIM,1932,39,50-100,1971,2
STAT,1865,34,40-44,1899,7.888931029935316
STAT,1873,19,na,1892,5154.891840804197
SIM,1834,32,na,1866,3636
SIM,1890,19,15-19,1909,14
SIM,1876,26,15-19,1902,1
STAT,1884,0,na,1884,7026.979612222199
STAT,1920,35,35-39,1955,5.356483676612743
SIM,1836,61,na,1897,2358
SIM,1933,17,30-34,1950,40
STAT,1911,30,30-34,1941,31.242760210809024
STAT,1968,3,na,1971,9921.228164037588
STAT,1961,7,na,1968,10254.003396197666
STAT,1883,23,45-49,1906,1.379401068986381
STAT,1911,23,25-29,1934,176.42907572124642
STAT,1916,27,25-29,1943,137.44602937621463
SIM,1895,47,50-100,1942,1
SIM,1927,25,50-100,1952,3
SIM,1913,24,45-49,1937,5
SIM,1918,18,35-39,1936,17
STAT,1820,47,30-34,1867,0.360208943839273
STAT,1896,66,na,1962,4720.623178057574
SIM,1866,42,50-100,1908,5
STAT,1882,19,15-19,1901,11.613001536514428
STAT,1854,37,na,1891,3611.6830310060977
STAT,1870,29,40-44,1899,5.897233686894289
SIM,1809,45,25-29,1854,1
STAT,1904,40,40-44,1944,0.4573352835186576
STAT,1934,19,30-34,1953,33.12288326891859
STAT,1886,45,40-44,1931,0.3686273467090114
STAT,1935,33,20-24,1968,6.812374657328305
SIM,1867,22,na,1889,4830
SIM,1830,31,25-29,1861,20
SIM,1889,39,50-100,1928,5
STAT,1936,21,na,1957,7054.830426161371
SIM,1887,15,35-39,1902,3
STAT,1865,21,35-39,1886,10.915530616797529
STAT,1880,32,25-29,1912,21.79188856577621
STAT,1934,32,50-100,1966,2.2801875594591894
STAT,1916,39,25-29,1955,2.01586214010947
SIM,1924,39,25-29,1963,4
SIM,1858,64,na,1922,2947
SIM,1876,36,25-29,1912,7
STAT,1826,44,30-34,1870,2.331893787968363
STAT,1880,20,25-29,1900,122.52091216418641
SIM,1829,30,50-100,1859,2
SIM,1858,45,na,1903,3904
SIM,1940,5,na,1945,8419
STAT,1874,66,na,1940,3389.3333547206607
SIM,1868,15,25-29,1883,16
STAT,1868,36,25-29,1904,5.559081360365416
SIM,1942,19,30-34,1961,32
STAT,1860,68,na,1928,2506.3705631137404
STAT,1822,43,25-29,1865,2.103604179612243
STAT,1910,44,15-19,1954,0.002896230349272637
STAT,1840,91,na,1931,83.64421686366867
SIM,1912,40,40-44,1952,1
STAT,1862,53,30-34,1915,0.010110317381755895
STAT,1861,16,na,1877,4461.358273293655
STAT,1886,51,na,1937,4612.5197263172495
STAT,1915,43,20-24,1958,0.03585499306309836
STAT,1863,44,25-29,1907,1.1199458382709988
STAT,1891,29,na,1920,5915.093274689953
STAT,1930,30,50-100,1960,2.157363835809591
STAT,1836,24,na,1860,3697.9891403054858
SIM,1911,20,na,1931,7474
SIM,1932,2,na,1934,11044
SIM,1834,44,30-34,1878,7
STAT,1816,39,20-24,1855,5.126905637342797
STAT,1845,26,50-100,1871,1.2084798762154814
SIM,1928,22,30-34,1950,99
STAT,1866,22,na,1888,4443.20552679074
STAT,1936,18,45-49,1954,0.9635624372988342
SIM,1854,71,na,1925,2093
STAT,1845,44,40-44,1889,3.4401926007051573
STAT,1919,18,45-49,1937,1.1117437010282334
SIM,1843,49,na,1892,3304
STAT,1902,33,25-29,1935,29.081964588570404
SIM,1910,33,25-29,1943,21
SIM,1833,72,na,1905,1652
STAT,1879,31,50-100,1910,1.9434576335978473
STAT,1861,90,na,1951,132.5316550160108
SIM,1875,45,30-34,1920,1
STAT,1832,54,40-44,1886,0.013721857857342406
STAT,1827,35,25-29,1862,6.304589077261298
STAT,1942,29,25-29,1971,139.3839138118855
SIM,1824,39,20-24,1863,2
SIM,1944,18,45-49,1962,1
STAT,1835,50,50-100,1885,0.020749018604754817
SIM,1851,34,50-100,1885,2
STAT,1846,21,25-29,1867,108.97189978424902
SIM,1917,34,30-34,1951,50
STAT,1894,26,25-29,1920,110.12329318202345
SIM,1873,53,na,1926,4432
SIM,1853,24,na,1877,4141
STAT,1924,45,20-24,1969,0.026688975662682978
SIM,1871,44,25-29,1915,4
STAT,1836,18,40-44,1854,0.6011976206247203
STAT,1838,72,na,1910,1709.1604223140923
SIM,1917,11,na,1928,8837
SIM,1907,17,20-24,1924,1
SIM,1821,41,25-29,1862,3
STAT,1908,48,50-100,1956,0.4122387272575099
SIM,1866,74,na,1940,2004
STAT,1796,109,na,1905,3.169669842332539E-4
STAT,1896,44,na,1940,6100.565597582033
STAT,1911,35,25-29,1946,1.9394691488421627
SIM,1889,21,30-34,1910,50
SIM,1891,66,na,1957,4498
SIM,1933,29,25-29,1962,198
SIM,1884,47,30-34,1931,1
SIM,1853,44,40-44,1897,9
SIM,1835,35,25-29,1870,7
SIM,1824,32,45-49,1856,7
SIM,1897,46,50-100,1943,1
SIM,1871,32,25-29,1903,22
STAT,1762,106,na,1868,0.02867330574842096
STAT,1854,49,45-49,1903,0.3542312032442868
SIM,1944,22,na,1966,8071
STAT,1915,19,20-24,1934,57.00444957593405
SIM,1790,84,na,1874,197
SIM,1923,19,20-24,1942,301
SIM,1862,49,45-49,1911,4
STAT,1876,17,50-100,1893,0.10233716264699724
STAT,1825,44,50-100,1869,2.3347941788883304
SIM,1900,22,45-49,1922,2
STAT,1950,20,40-44,1970,8.060892807429918
STAT,1925,29,25-29,1954,155.85387063490975
STAT,1877,15,25-29,1892,11.939240969361268
STAT,1823,76,na,1899,1136.885752874998
STAT,1903,41,50-100,1944,0.21191207719863905
SIM,1783,80,na,1863,449
STAT,1813,45,40-44,1858,1.0938412415624106
STAT,1915,41,na,1956,7563.02959461762
SIM,1881,82,na,1963,1004
SIM,1884,40,50-100,1924,5
STAT,1850,47,50-100,1897,0.37481546018007317
STAT,1817,54,30-34,1871,0.026474388751716434
STAT,1879,15,35-39,1894,1.164521019467813
STAT,1819,50,25-29,1869,0.01485197645521993
SIM,1898,36,na,1934,6693
SIM,1818,79,na,1897,583
STAT,1879,21,20-24,1900,146.01557307477003
STAT,1841,18,15-19,1859,11.040023653588804
STAT,1899,58,na,1957,5561.231785139618
SIM,1819,43,na,1862,2978
STAT,1877,19,40-44,1896,0.3815196062746782
STAT,1825,111,na,1936,1.2418750841715443E-4
SIM,1857,82,na,1939,686
SIM,1932,37,na,1969,10292
STAT,1844,44,15-19,1888,0.022262827439634553
STAT,1901,16,25-29,1917,16.06128246693581
SIM,1846,33,35-39,1879,35
SIM,1873,34,40-44,1907,10
STAT,1842,22,45-49,1864,1.309453871111432
SIM,1887,21,20-24,1908,188
SIM,1834,35,na,1869,3552
STAT,1865,30,25-29,1895,18.944308303787306
STAT,1870,25,25-29,1895,84.44545513786908
STAT,1930,23,35-39,1953,24.285954733950128
STAT,1911,25,50-100,1936,1.97427983595523
STAT,1849,29,15-19,1878,0.8385530102761376
STAT,1862,78,na,1940,1348.7374844770707
SIM,1928,35,45-49,1963,2
STAT,1808,68,na,1876,1556.1350108799174
STAT,1893,15,50-100,1908,0.12599592310517466
STAT,1926,46,25-29,1972,0.132493633424516
SIM,1875,30,35-39,1905,34
STAT,1884,45,30-34,1929,0.19496996142094136
STAT,1876,40,50-100,1916,2.2290470119289116
SIM,1778,87,na,1865,96
SIM,1845,75,na,1920,1553
SIM,1793,79,na,1872,480
SIM,1845,54,25-29,1899,1
STAT,1863,42,na,1905,4081.0117339265034
STAT,1858,40,35-39,1898,2.8797457978584737
SIM,1818,98,na,1916,1
SIM,1921,19,na,1940,8442
STAT,1930,30,40-44,1960,10.211100409829568
STAT,1903,34,na,1937,6861.106829316065
SIM,1807,58,na,1865,2016
SIM,1882,20,25-29,1902,112
STAT,1853,22,20-24,1875,128.8276096258594
SIM,1808,80,na,1888,455
STAT,1851,38,na,1889,3653.174441000552
SIM,1902,26,35-39,1928,36
STAT,1838,33,35-39,1871,16.855218636023917
STAT,1909,34,30-34,1943,30.12062929300238
SIM,1843,31,na,1874,3823
STAT,1886,41,25-29,1927,1.3752365057217748
SIM,1906,19,20-24,1925,51
SIM,1837,21,25-29,1858,113
STAT,1828,35,50-100,1863,2.5758242898868016
STAT,1909,43,20-24,1952,0.03317859023613792
STAT,1925,18,na,1943,8954.560588780527
STAT,1820,35,30-34,1855,30.521082598929418
STAT,1835,23,15-19,1858,5.641394542973854
STAT,1900,19,50-100,1919,0.13652076824667717
STAT,1893,55,na,1948,5293.094571340182
STAT,1826,40,15-19,1866,0.030395453924503883
STAT,1844,35,25-29,1879,5.512652584032717
STAT,1924,33,45-49,1957,3.7044172645362137
SIM,1843,23,15-19,1866,6
STAT,1847,16,35-39,1863,1.0501201268910594
SIM,1908,15,na,1923,7677
STAT,1910,15,20-24,1925,54.52682432837794
STAT,1932,36,15-19,1968,0.05216091129412306
SIM,1861,22,20-24,1883,143
SIM,1856,3,na,1859,5468
STAT,1880,36,40-44,1916,9.358283029870101
SIM,1861,68,na,1929,2858
SIM,1855,16,35-39,1871,1
SIM,1865,12,na,1877,5103
SIM,1932,33,45-49,1965,6
STAT,1900,32,20-24,1932,7.5729556519137
SIM,1878,22,25-29,1900,149
STAT,1818,39,30-34,1857,30.072281636049002
SIM,1870,64,na,1934,3446
SIM,1791,69,na,1860,1230
SIM,1872,23,35-39,1895,19
STAT,1927,17,50-100,1944,0.9406748147939272
STAT,1884,59,na,1943,3875.7931637137217
STAT,1773,84,na,1857,189.23298378744897
STAT,1900,42,na,1942,6489.588902534654
STAT,1904,33,35-39,1937,16.784927684891283
SIM,1896,17,35-39,1913,1
SIM,1842,83,na,1925,523
STAT,1860,12,na,1872,4515.557814800877
STAT,1843,44,30-34,1887,1.616218516398499
STAT,1891,45,15-19,1936,5.688820104497862E-4
STAT,1961,10,na,1971,10250.312396904985
STAT,1898,34,45-49,1932,4.725214287744826
SIM,1829,26,35-39,1855,19
SIM,1845,72,na,1917,1967
STAT,1847,86,na,1933,338.21514922305494
STAT,1918,20,15-19,1938,11.662199133231036
STAT,1871,53,40-44,1924,0.020784720161712983
SIM,1846,20,20-24,1866,131
SIM,1865,23,35-39,1888,11
STAT,1828,42,15-19,1870,0.026002591639368085
STAT,1895,33,15-19,1928,0.37318287930679095
SIM,1845,97,na,1942,3
SIM,1850,100,na,1950,1
STAT,1857,23,35-39,1880,10.52879034238053
STAT,1795,68,na,1863,1524.1792184939127
SIM,1926,39,35-39,1965,13
STAT,1840,19,45-49,1859,0.12064490856218814
STAT,1883,32,50-100,1915,1.8180816547823757
SIM,1851,44,30-34,1895,4
SIM,1829,43,50-100,1872,6
STAT,1913,46,15-19,1959,7.281339179896232E-4
SIM,1850,22,45-49,1872,2
STAT,1907,48,50-100,1955,0.4060663562993861
STAT,1906,46,15-19,1952,6.659109805523372E-4
SIM,1771,95,na,1866,5
STAT,1903,56,na,1959,6030.755616983095
SIM,1937,22,40-44,1959,6
STAT,1946,15,35-39,1961,9.403810048020166
STAT,1864,23,35-39,1887,10.627400062099547
SIM,1826,39,30-34,1865,13
SIM,1839,43,45-49,1882,5
STAT,1824,39,na,1863,3002.709845034572
STAT,1839,38,na,1877,3955.1681769945576
STAT,1821,52,30-34,1873,0.01675883528212447
STAT,1885,26,na,1911,4814.0827163804015
STAT,1775,101,na,1876,0.19959715974993716
SIM,1915,30,40-44,1945,15
SIM,1891,32,50-100,1923,5
STAT,1802,107,na,1909,0.003619413067205696
STAT,1852,30,15-19,1882,0.23993257381078997
STAT,1900,45,na,1945,6367.232985528774
STAT,1893,20,35-39,1913,15.027246654998596
STAT,1841,48,20-24,1889,0.017267441980725787
STAT,1918,39,35-39,1957,5.137001437381245
SIM,1908,37,na,1945,7117
STAT,1881,17,40-44,1898,0.35704163542136896
STAT,1935,24,30-34,1959,79.00562175446113
SIM,1907,36,20-24,1943,2
SIM,1805,91,na,1896,24
STAT,1854,17,50-100,1871,0.0898422147701647
STAT,1845,20,na,1865,4149.552684851503
STAT,1908,17,30-34,1925,4.7782448789666265
STAT,1852,18,50-100,1870,0.09388309774473401
STAT,1830,48,45-49,1878,0.4021414486318774
SIM,1843,46,na,1889,3403
SIM,1912,33,35-39,1945,21
SIM,1857,60,na,1917,3373
STAT,1913,32,30-34,1945,31.665889744009878
STAT,1802,58,na,1860,2231.4413373356692
STAT,1929,22,40-44,1951,8.586526272639222
SIM,1928,25,50-100,1953,3
STAT,1863,106,na,1969,0.23843200890147237
STAT,1888,17,35-39,1905,1.3098044608665762
STAT,1859,36,15-19,1895,0.09070231481730219
STAT,1839,40,25-29,1879,1.1914409721534551
STAT,1907,30,40-44,1937,7.451061190811608
STAT,1911,33,35-39,1944,17.90120477352196
SIM,1921,32,30-34,1953,48
SIM,1943,24,30-34,1967,73
STAT,1857,26,na,1883,3897.60662427687
STAT,1888,18,na,1906,6012.99089958331
STAT,1848,34,na,1882,4067.057856952167
SIM,1864,29,15-19,1893,1
SIM,1860,18,50-100,1878,1
SIM,1891,41,na,1932,5992
SIM,1867,78,na,1945,1492
STAT,1824,33,40-44,1857,17.11931530669626
STAT,1904,43,45-49,1947,0.2990890619546848
STAT,1880,54,50-100,1934,0.03124858791433405
STAT,1892,31,50-100,1923,2.3260067213040694
STAT,1818,52,50-100,1870,0.06384795261413313
SIM,1892,26,na,1918,6923
STAT,1820,45,40-44,1865,0.655816591469862
STAT,1928,43,30-34,1971,0.3285879592554198
SIM,1905,23,40-44,1928,11
SIM,1837,37,40-44,1874,13
STAT,1936,16,50-100,1952,0.7263497588122017
SIM,1832,33,40-44,1865,7
SIM,1876,33,20-24,1909,7
STAT,1920,16,35-39,1936,9.529165860871759
STAT,1867,41,15-19,1908,0.026238439369651673
STAT,1854,42,25-29,1896,0.9832065836271702
SIM,1870,42,na,1912,4520
STAT,1868,33,20-24,1901,5.17208003768173
SIM,1865,49,na,1914,4124
STAT,1854,46,40-44,1900,0.26319255901150923
SIM,1954,15,35-39,1969,13
STAT,1881,30,na,1911,4695.716983159913
SIM,1894,23,50-100,1917,1
SIM,1840,49,50-100,1889,1
SIM,1859,29,40-44,1888,5
SIM,1810,44,na,1854,2871
STAT,1912,32,50-100,1944,1.6435211548744844
STAT,1782,80,na,1862,485.34300795302005
STAT,1946,25,45-49,1971,3.889736514292456
STAT,1851,25,15-19,1876,0.8354460307135602
SIM,1924,24,20-24,1948,287
SIM,1839,33,35-39,1872,26
STAT,1852,41,50-100,1893,1.6914025515955924
SIM,1887,34,35-39,1921,30
STAT,1880,41,15-19,1921,0.0295143647672344
SIM,1858,34,15-19,1892,4
SIM,1901,42,na,1943,6574
STAT,1880,22,15-19,1902,7.018914497176038
SIM,1902,32,20-24,1934,2
SIM,1944,16,50-100,1960,4
STAT,1898,24,35-39,1922,15.849036230931496
STAT,1829,37,40-44,1866,7.651288902888382
SIM,1894,55,na,1949,5554
SIM,1917,37,35-39,1954,12
STAT,1869,25,50-100,1894,1.260332214657911
STAT,1838,20,20-24,1858,122.7603105388544
STAT,1916,24,20-24,1940,233.8450824619811
SIM,1926,20,15-19,1946,14
STAT,1801,73,na,1874,1085.5817546949688
STAT,1859,74,na,1933,1783.973129820755
SIM,1929,17,40-44,1946,8
STAT,1811,48,35-39,1859,0.9341909706080271
STAT,1896,28,40-44,1924,7.959340536228678
STAT,1870,15,15-19,1885,12.02046739542773
SIM,1910,56,na,1966,6853
SIM,1886,19,25-29,1905,12
SIM,1888,77,na,1965,2619
STAT,1874,63,na,1937,3689.7891810929195
SIM,1935,17,50-100,1952,3
STAT,1882,49,20-24,1931,0.023115828092125024
STAT,1848,12,na,1860,4852.441790592549
SIM,1897,22,35-39,1919,23
STAT,1893,31,15-19,1924,0.3660360451888072
STAT,1925,46,50-100,1971,0.5547905915497003
STAT,1912,30,na,1942,7578.492428629177
STAT,1920,22,20-24,1942,249.6024620941763
SIM,1886,11,na,1897,5477
STAT,1856,48,50-100,1904,0.37789413123460286
SIM,1930,29,15-19,1959,2
STAT,1903,28,35-39,1931,27.64842950370624
SIM,1933,26,20-24,1959,51
SIM,1812,43,40-44,1855,5
SIM,1835,32,20-24,1867,8
SIM,1911,28,35-39,1939,37
STAT,1922,29,15-19,1951,1.601365457426049
STAT,1838,75,na,1913,1393.2401111273455
SIM,1845,18,25-29,1863,14
STAT,1832,50,25-29,1882,0.004997319868636925
STAT,1889,22,35-39,1911,14.531704181697181
SIM,1809,65,na,1874,1674
SIM,1948,18,20-24,1966,303
STAT,1833,35,na,1868,3593.558303022588
STAT,1791,94,na,1885,8.692569471890735
STAT,1837,54,25-29,1891,0.0048021331691121966
STAT,1871,34,40-44,1905,8.627186416447426
STAT,1939,32,na,1971,7794.387868653001
STAT,1861,46,40-44,1907,0.28860572225106346
STAT,1939,25,45-49,1964,3.511068188427252
STAT,1904,19,na,1923,7281.813369401253
STAT,1925,26,20-24,1951,43.683491331693595
SIM,1836,35,50-100,1871,3
SIM,1848,86,na,1934,320
STAT,1879,34,35-39,1913,21.210035175871347
STAT,1853,64,na,1917,2750.4332130852085
STAT,1874,30,35-39,1904,21.11024384505925
SIM,1852,48,30-34,1900,1
SIM,1888,45,40-44,1933,1
STAT,1866,17,15-19,1883,11.351078048039822
SIM,1931,0,na,1931,11108
STAT,1837,18,25-29,1855,12.261578462500903
STAT,1869,11,na,1880,5228.540192907667
STAT,1832,49,50-100,1881,0.3357655392540154
STAT,1836,49,na,1885,3051.254950020356
SIM,1828,57,na,1885,2605
SIM,1890,19,na,1909,6655
SIM,1833,87,na,1920,187
STAT,1886,23,50-100,1909,0.866699329704238
STAT,1809,52,15-19,1861,1.8131416350912501E-4
STAT,1827,32,20-24,1859,6.672064802412477
STAT,1900,37,15-19,1937,0.03395700262404803
STAT,1936,0,na,1936,8712.771526139573
SIM,1871,48,40-44,1919,1
SIM,1922,41,na,1963,9023
STAT,1816,72,na,1888,1317.6229218875578
SIM,1812,88,na,1900,134
STAT,1885,45,15-19,1930,8.121345048141407E-4
STAT,1913,45,45-49,1958,0.430550890668766
STAT,1911,39,40-44,1950,2.891609822082574
SIM,1882,30,35-39,1912,35
STAT,1893,30,45-49,1923,4.499854195753524
STAT,1801,95,na,1896,10.538932040397242
STAT,1924,33,na,1957,8903.487152403563
SIM,1942,18,na,1960,7896
SIM,1853,40,25-29,1893,1
SIM,1869,85,na,1954,446
SIM,1940,2,na,1942,8476
STAT,1919,41,30-34,1960,0.28015099752512507
STAT,1855,27,40-44,1882,4.708337784103096
STAT,1926,41,30-34,1967,0.3187117373414471
SIM,1846,20,na,1866,4138
STAT,1891,24,40-44,1915,5.16941775505726
STAT,1894,23,20-24,1917,178.23390478219707
STAT,1863,48,40-44,1911,0.29886160324273436
STAT,1845,40,25-29,1885,1.033802364801392
STAT,1911,20,20-24,1931,214.31547056054794
STAT,1941,21,45-49,1962,2.349240664720774
STAT,1875,19,15-19,1894,12.273840516125578
SIM,1929,32,50-100,1961,6
STAT,1869,43,15-19,1912,0.026829778945657665
SIM,1865,33,45-49,1898,2
SIM,1921,45,45-49,1966,1
SIM,1928,25,35-39,1953,52
SIM,1863,27,40-44,1890,10
SIM,1826,29,50-100,1855,1
STAT,1896,69,na,1965,4429.182418788233
STAT,1945,2,na,1947,8919.963497721723
STAT,1770,95,na,1865,4.106783882444769
STAT,1852,110,na,1962,0.0015839208108241545
STAT,1857,33,45-49,1890,2.733535142910418
SIM,1864,48,50-100,1912,1
STAT,1876,43,15-19,1919,0.028638414148368284
STAT,1850,26,15-19,1876,0.8245594460344522
STAT,1867,34,45-49,1901,3.2700693927732636
SIM,1857,54,na,1911,3754
SIM,1917,24,20-24,1941,242
STAT,1862,7,na,1869,4893.373895432304
SIM,1876,47,40-44,1923,1
STAT,1893,42,45-49,1935,3.826499486065753
STAT,1766,103,na,1869,0.06077113409152058
STAT,1890,16,45-49,1906,0.16142565352048227
STAT,1888,24,35-39,1912,13.842468814429488
STAT,1872,15,40-44,1887,0.3768936449086954
STAT,1905,48,20-24,1953,0.01952234283136256
SIM,1825,40,40-44,1865,6
STAT,1913,24,40-44,1937,6.816026213767309
SIM,1873,37,45-49,1910,10
STAT,1894,35,15-19,1929,0.14707082529116294
SIM,1853,44,35-39,1897,7
STAT,1840,22,40-44,1862,3.825095040272931
SIM,1831,25,45-49,1856,1
STAT,1884,31,40-44,1915,8.683929248714753
STAT,1915,21,40-44,1936,7.041217797114158
STAT,1873,29,20-24,1902,23.90153794293993
SIM,1875,34,45-49,1909,6
SIM,1892,31,40-44,1923,18
STAT,1886,11,na,1897,5513.976960333887
STAT,1829,41,15-19,1870,0.023085447631336922
STAT,1862,42,15-19,1904,0.023809195833891746
STAT,1836,51,30-34,1887,0.008169963600508654
STAT,1920,38,45-49,1958,1.5055797985467552
SIM,1880,66,na,1946,3527
STAT,1897,19,35-39,1916,1.4733742016294258
SIM,1853,28,30-34,1881,50
SIM,1853,64,na,1917,2760
STAT,1915,13,na,1928,8335.650195843926
STAT,1820,77,na,1897,967.6933948872206
STAT,1878,52,20-24,1930,0.0015482078475521474
STAT,1824,67,na,1891,1694.813406919367
SIM,1915,27,20-24,1942,37
SIM,1949,17,20-24,1966,318
STAT,1911,23,na,1934,7289.001335777611
SIM,1874,18,20-24,1892,1
STAT,1854,52,35-39,1906,0.013127320742180777
STAT,1857,15,45-49,1872,0.12229768728580238
STAT,1911,27,40-44,1938,9.182896051872321
SIM,1922,35,na,1957,9075
STAT,1819,38,30-34,1857,28.96981817542579
STAT,1909,24,20-24,1933,207.52410255354033
SIM,1928,43,35-39,1971,1
STAT,1884,48,35-39,1932,0.27568973548965064
STAT,1864,95,na,1959,41.23601923450228
SIM,1931,28,15-19,1959,2
STAT,1845,28,30-34,1873,46.89189292847565
STAT,1843,49,30-34,1892,0.132767948409435
SIM,1797,60,na,1857,1950
SIM,1867,26,50-100,1893,1
STAT,1847,41,35-39,1888,2.811484194445903
STAT,1896,32,15-19,1928,0.3797198528679018
STAT,1866,18,20-24,1884,33.70982232106628
STAT,1923,28,15-19,1951,1.6306395251746872
SIM,1909,16,40-44,1925,1
STAT,1826,51,45-49,1877,0.028470972471101797
STAT,1950,10,na,1960,9382.354935371583
STAT,1925,43,na,1968,9064.8555950877
SIM,1878,44,40-44,1922,11
SIM,1892,51,na,1943,6165
STAT,1855,18,45-49,1873,0.1164683014081496
STAT,1878,16,na,1894,5340.34657935575
STAT,1782,100,na,1882,0.43244965171144123
SIM,1908,40,50-100,1948,1
SIM,1848,18,na,1866,4359
SIM,1863,18,45-49,1881,2
SIM,1848,28,20-24,1876,25
STAT,1782,98,na,1880,1.1539241898062693
STAT,1865,37,45-49,1902,3.657671810366976
SIM,1855,41,35-39,1896,6
SIM,1857,20,35-39,1877,15
SIM,1842,25,20-24,1867,26
SIM,1880,15,40-44,1895,1
STAT,1883,48,50-100,1931,0.4812141267446485
STAT,1827,44,15-19,1871,0.025301634106014353
SIM,1774,91,na,1865,17
SIM,1839,40,40-44,1879,3
STAT,1883,62,na,1945,3626.7182342016677
SIM,1840,28,20-24,1868,26
STAT,1813,51,35-39,1864,0.051651149775906194
SIM,1896,41,na,1937,6562
SIM,1878,26,40-44,1904,10
SIM,1933,25,15-19,1958,2
SIM,1807,95,na,1902,10
SIM,1934,20,na,1954,9816
STAT,1922,17,45-49,1939,1.1672772089494206
STAT,1843,47,35-39,1890,0.1952001851429093
SIM,1837,43,40-44,1880,4
STAT,1850,75,na,1925,1578.4430770104977
SIM,1827,38,30-34,1865,14
STAT,1834,25,20-24,1859,20.77439393857105
STAT,1872,23,50-100,1895,0.8251510924449771
SIM,1861,34,15-19,1895,3
SIM,1926,15,50-100,1941,1
STAT,1931,38,20-24,1969,0.704395840431
STAT,1898,31,40-44,1929,11.901063990989963
SIM,1871,26,25-29,1897,93
STAT,1832,28,20-24,1860,20.37403485386593
STAT,1876,37,20-24,1913,1.6101952006205635
STAT,1896,34,40-44,1930,11.46454119298342
SIM,1781,85,na,1866,156
STAT,1821,46,45-49,1867,0.7008214881435081
SIM,1894,29,30-34,1923,83
SIM,1930,30,na,1960,10442
SIM,1887,37,45-49,1924,3
STAT,1882,52,40-44,1934,0.020601801689013478
STAT,1879,37,45-49,1916,4.211195042015155
SIM,1884,37,20-24,1921,2
SIM,1888,46,na,1934,5322
STAT,1817,40,40-44,1857,13.152828764049813
STAT,1863,26,25-29,1889,75.32554770873531
STAT,1924,33,50-100,1957,1.9463887201989418
SIM,1905,63,na,1968,5847
SIM,1908,48,40-44,1956,1
SIM,1917,22,25-29,1939,232
STAT,1807,83,na,1890,316.87797028971977
STAT,1871,31,30-34,1902,35.17635292742698
STAT,1827,28,50-100,1855,2.644481628756576
STAT,1886,29,30-34,1915,53.30265750721128
STAT,1794,83,na,1877,281.0189214261631
SIM,1855,23,35-39,1878,14
STAT,1853,34,15-19,1887,0.22726150098001424
STAT,1847,23,35-39,1870,10.826433352601438
STAT,1868,47,40-44,1915,0.3274316645980087
STAT,1826,33,15-19,1859,0.40050312639080227
SIM,1851,47,35-39,1898,1
STAT,1923,46,15-19,1969,8.721971817455639E-4
SIM,1909,53,na,1962,6778
STAT,1849,40,50-100,1889,1.7002998685611888
STAT,1861,29,25-29,1890,70.60081392446548
SIM,1844,28,na,1872,3693
STAT,1929,33,na,1962,9695.373197465036
STAT,1925,25,15-19,1950,1.69506135970705
SIM,1869,37,25-29,1906,8
SIM,1886,34,20-24,1920,7
STAT,1845,46,30-34,1891,0.1495860742188299
STAT,1849,90,na,1939,124.70987106159743
SIM,1838,87,na,1925,229
STAT,1831,49,na,1880,3036.142227646533
STAT,1860,45,15-19,1905,6.625729447803771E-4
STAT,1880,42,35-39,1922,3.8478953039654002
STAT,1882,21,35-39,1903,11.515365341206849
SIM,1863,31,15-19,1894,1
STAT,1847,25,30-34,1872,46.80754360150541
SIM,1811,69,na,1880,1473
SIM,1847,47,50-100,1894,1
STAT,1845,44,35-39,1889,2.769579460595373
SIM,1849,59,na,1908,3148
SIM,1827,39,50-100,1866,4
STAT,1858,26,15-19,1884,0.7365320118551978
SIM,1926,25,na,1951,9298
STAT,1912,43,35-39,1955,0.38998500252935253
STAT,1867,52,45-49,1919,0.027303011061698215
STAT,1878,34,20-24,1912,5.6527491371543945
SIM,1920,43,35-39,1963,1
SIM,1836,92,na,1928,24
SIM,1874,26,na,1900,4654
SIM,1896,36,50-100,1932,11
STAT,1841,39,na,1880,3586.1218407923725
SIM,1890,21,35-39,1911,25
STAT,1855,31,15-19,1886,0.22093331678459788
STAT,1829,32,50-100,1861,1.7575208825944766
STAT,1907,18,na,1925,7477.272306364328
SIM,1838,28,35-39,1866,24
SIM,1855,25,30-34,1880,56
SIM,1959,12,na,1971,10850
STAT,1918,3,na,1921,8914.656047580778
STAT,1786,88,na,1874,83.01344192407369
SIM,1919,38,45-49,1957,1
STAT,1801,98,na,1899,2.5750107971530185
SIM,1846,82,na,1928,592
SIM,1822,35,50-100,1857,4
SIM,1865,30,40-44,1895,13
SIM,1826,39,25-29,1865,6
SIM,1852,47,25-29,1899,1
SIM,1862,33,20-24,1895,1
STAT,1827,46,40-44,1873,0.3133410502286116
STAT,1950,17,20-24,1967,323.7336733769146
SIM,1833,41,50-100,1874,6
SIM,1868,38,na,1906,4512
SIM,1846,36,45-49,1882,5
STAT,1830,33,35-39,1863,19.72564932488659
STAT,1866,62,na,1928,3405.9399138138597
STAT,1844,46,40-44,1890,0.277258239958224
STAT,1880,24,35-39,1904,12.337687297198709
SIM,1884,24,15-19,1908,1
SIM,1839,22,40-44,1861,4
STAT,1860,18,25-29,1878,10.655716241664418
STAT,1903,32,30-34,1935,50.20650674072908
STAT,1778,114,na,1892,2.511029885837749E-4
STAT,1876,24,15-19,1900,6.848058349791355
SIM,1843,39,25-29,1882,8
SIM,1845,33,20-24,1878,4
STAT,1824,36,45-49,1860,6.320727670850417
SIM,1837,28,45-49,1865,2
STAT,1917,48,40-44,1965,0.33163785866924206
STAT,1908,31,na,1939,7244.2343987023105
SIM,1869,79,na,1948,1167
STAT,1862,47,45-49,1909,0.40548424990913084
STAT,1866,90,na,1956,165.56442438685195
STAT,1846,110,na,1956,4.5626718287004387E-4
STAT,1923,48,na,1971,8652.805500112565
STAT,1812,42,na,1854,3029.8271463533397
SIM,1861,99,na,1960,6
SIM,1921,42,40-44,1963,2
STAT,1891,27,45-49,1918,2.771740834431366
SIM,1847,29,15-19,1876,1
STAT,1860,30,40-44,1890,7.16974616941772
SIM,1863,36,45-49,1899,3
SIM,1873,13,na,1886,5504
STAT,1835,39,25-29,1874,4.517436964603781
STAT,1897,54,na,1951,5653.089029937468
SIM,1821,33,35-39,1854,25
SIM,1837,46,na,1883,3158
STAT,1855,36,45-49,1891,3.0205154061796278
STAT,1813,83,na,1896,352.7629779918689
STAT,1848,22,40-44,1870,4.160348169203394
STAT,1919,25,50-100,1944,2.1863114106440387
SIM,1842,21,na,1863,3981
SIM,1888,48,45-49,1936,1
SIM,1920,40,na,1960,8488
SIM,1941,17,20-24,1958,282
STAT,1935,33,na,1968,10562.956168958557
STAT,1891,27,15-19,1918,1.13261489698551
SIM,1838,16,na,1854,4264
SIM,1851,97,na,1948,3
STAT,1829,46,45-49,1875,0.37727846751722915
STAT,1788,83,na,1871,276.26086647912035
STAT,1870,50,25-29,1920,0.007124126007420562
STAT,1894,37,40-44,1931,11.356979348873992
STAT,1905,32,35-39,1937,16.98422752537517
STAT,1838,49,20-24,1887,0.01628584168864455
STAT,1844,47,25-29,1891,0.09258538750016611
STAT,1849,20,35-39,1869,11.322015304425655
STAT,1837,33,20-24,1870,4.67586553990771
SIM,1842,92,na,1934,45
SIM,1910,10,na,1920,8310
STAT,1839,47,15-19,1886,6.363568857961939E-4
STAT,1850,44,45-49,1894,2.263778275921191
SIM,1879,29,35-39,1908,25
STAT,1848,40,40-44,1888,3.7792196645353906
STAT,1824,36,15-19,1860,0.17804868795885984
SIM,1911,32,30-34,1943,35
STAT,1899,42,40-44,1941,0.43167924326765494
STAT,1837,51,20-24,1888,0.001053114716925987
SIM,1856,22,40-44,1878,5
STAT,1852,70,na,1922,2236.234025288098
STAT,1933,17,20-24,1950,366.57384825604277
SIM,1913,32,35-39,1945,20
STAT,1928,38,45-49,1966,1.737985283528975
STAT,1886,47,30-34,1933,0.2054099237195765
SIM,1868,23,15-19,1891,6
STAT,1809,49,25-29,1858,0.430596249988782
STAT,1926,38,40-44,1964,3.6905664942793255
STAT,1820,43,20-24,1863,0.6244776611551914
STAT,1845,29,na,1874,3999.3610416674705
STAT,1800,57,na,1857,2221.005430158776
STAT,1881,53,35-39,1934,0.016535751580161396
SIM,1830,36,na,1866,3238
STAT,1867,34,15-19,1901,0.267047281347268
STAT,1772,96,na,1868,2.431223398628778
STAT,1913,27,50-100,1940,2.0035100633153426
STAT,1843,34,na,1877,3574.751096105513
SIM,1881,15,30-34,1896,3
SIM,1871,23,20-24,1894,130
STAT,1839,29,na,1868,4194.3730332170535
SIM,1938,22,na,1960,7302
SIM,1883,26,20-24,1909,23
SIM,1867,84,na,1951,604
STAT,1878,19,25-29,1897,11.888733572964012
STAT,1886,45,35-39,1931,0.3014475973030092
STAT,1899,1,na,1900,7531.781978953336
STAT,1913,42,40-44,1955,0.49274419400461317
STAT,1896,37,45-49,1933,5.315489383953995
SIM,1877,29,30-34,1906,68
STAT,1939,22,35-39,1961,19.100184214361008
SIM,1894,45,35-39,1939,1
STAT,1922,7,na,1929,9340.54907590697
STAT,1829,28,45-49,1857,2.7208793450206907
STAT,1907,27,20-24,1934,34.82319867123609
SIM,1936,7,na,1943,6936
STAT,1869,45,35-39,1914,0.2767029139614932
STAT,1889,46,50-100,1935,0.613337637119889
SIM,1789,65,na,1854,1617
SIM,1855,4,na,1859,5339
SIM,1861,36,40-44,1897,10
STAT,1870,34,20-24,1904,5.3138109379263865
SIM,1815,90,na,1905,58
STAT,1853,36,40-44,1889,6.9983846390255655
SIM,1838,45,50-100,1883,2
STAT,1861,17,50-100,1878,0.09465842120963329
SIM,1851,30,40-44,1881,13
STAT,1815,45,50-100,1860,1.362100216730214
STAT,1868,97,na,1965,38.3307373023451
SIM,1937,21,50-100,1958,1
STAT,1881,23,40-44,1904,4.055194823829814
STAT,1917,48,na,1965,7727.689056680869
STAT,1885,48,25-29,1933,0.11433811519407008
STAT,1918,16,40-44,1934,0.6182844310011599
SIM,1828,33,50-100,1861,1
STAT,1908,19,50-100,1927,0.1460846054804682
STAT,1933,35,50-100,1968,1.157085834603804
SIM,1890,56,na,1946,5357
STAT,1840,20,15-19,1860,6.1436829976893
STAT,1857,30,40-44,1887,7.013136255676186
STAT,1861,44,20-24,1905,0.26336249937408923
STAT,1841,54,45-49,1895,0.02047745536620154
STAT,1819,54,35-39,1873,0.03333015375906733
STAT,1873,15,30-34,1888,3.309581606076276
SIM,1832,36,45-49,1868,7
STAT,1879,32,15-19,1911,0.30083295182174563
SIM,1852,46,40-44,1898,1
STAT,1937,28,45-49,1965,3.4002115423351245
STAT,1875,26,20-24,1901,24.477524858208792
STAT,1818,39,25-29,1857,16.245945162478776
STAT,1896,19,45-49,1915,0.17324369660984712
STAT,1765,113,na,1878,8.802107022485526E-4
STAT,1824,54,45-49,1878,0.03253064382153694
SIM,1841,25,50-100,1866,1
SIM,1947,22,35-39,1969,33
STAT,1880,26,na,1906,5094.92709371941
SIM,1882,30,50-100,1912,2
SIM,1884,56,na,1940,4377
STAT,1868,15,20-24,1883,35.09483117936493
STAT,1918,46,35-39,1964,0.2777355670584701
STAT,1924,27,20-24,1951,42.912658969882855
SIM,1898,21,35-39,1919,13
STAT,1923,39,50-100,1962,0.9800987250613735
SIM,1793,70,na,1863,1246
SIM,1932,27,20-24,1959,49
STAT,1849,39,25-29,1888,4.5644788567574475
SIM,1857,39,25-29,1896,9
SIM,1822,32,40-44,1854,14
SIM,1870,47,45-49,1917,1
STAT,1801,70,na,1871,1442.6273195173706
STAT,1826,62,na,1888,2242.117158956431
STAT,1843,30,40-44,1873,7.45651143758687
SIM,1855,39,20-24,1894,3
SIM,1873,84,na,1957,665
STAT,1847,39,20-24,1886,1.1940957674690793
STAT,1854,33,20-24,1887,4.199620066220034
SIM,1818,37,50-100,1855,3
SIM,1876,15,20-24,1891,38
SIM,1868,39,30-34,1907,17
SIM,1887,34,50-100,1921,2
STAT,1838,36,45-49,1874,3.2895264897314025
SIM,1921,24,40-44,1945,10
STAT,1891,45,45-49,1936,0.3356406686684354
SIM,1849,31,na,1880,4191
STAT,1830,35,30-34,1865,10.27089083145544
SIM,1934,24,20-24,1958,321
STAT,1833,75,na,1908,1353.3594688090611
STAT,1855,59,na,1914,2930.616403850834
SIM,1859,15,20-24,1874,35
SIM,1886,24,50-100,1910,1
SIM,1917,20,na,1937,8632
STAT,1877,62,na,1939,3833.0413527707187
STAT,1878,87,na,1965,776.9729284291695
SIM,1928,40,30-34,1968,2
STAT,1823,38,20-24,1861,2.873616738028552
STAT,1930,24,40-44,1954,8.644765357243552
SIM,1882,45,45-49,1927,1
STAT,1847,28,35-39,1875,17.55165192037284
SIM,1881,31,35-39,1912,22
STAT,1846,41,15-19,1887,0.021684764792992167
STAT,1890,29,20-24,1919,28.713161138007607
STAT,1848,46,50-100,1894,0.403855472715551
STAT,1868,18,25-29,1886,11.020622480674023
STAT,1868,25,50-100,1893,1.2375250068183208
SIM,1872,25,30-34,1897,62
SIM,1908,16,20-24,1924,59
SIM,1818,67,na,1885,1675
STAT,1840,25,45-49,1865,2.0272857903573693
SIM,1893,47,40-44,1940,1
STAT,1833,26,15-19,1859,0.7949851798272614
STAT,1897,16,30-34,1913,4.313444715144179
STAT,1862,41,30-34,1903,1.993538387642062
SIM,1938,17,15-19,1955,74
SIM,1863,15,40-44,1878,1
SIM,1872,99,na,1971,27
STAT,1855,90,na,1945,118.88640148792703
STAT,1864,26,45-49,1890,2.011319477933929
STAT,1943,23,50-100,1966,1.4133477266910603
SIM,1870,28,30-34,1898,56
STAT,1837,65,na,1902,2355.394584181327
SIM,1838,25,30-34,1863,56
SIM,1876,18,25-29,1894,16
STAT,1861,26,20-24,1887,20.0075975324902
SIM,1862,13,na,1875,5062
SIM,1882,49,50-100,1931,2
SIM,1847,47,45-49,1894,1
STAT,1885,47,40-44,1932,0.3425582015930815
SIM,1842,28,25-29,1870,87
STAT,1966,2,na,1968,9924.869565460054
STAT,1838,18,45-49,1856,0.11608904735671308
STAT,1855,15,40-44,1870,0.3319422635471204
STAT,1873,31,35-39,1904,20.8662333718016
STAT,1845,60,na,1905,2938.841206423246
SIM,1929,42,40-44,1971,3
STAT,1874,15,45-49,1889,0.13621544664794183
STAT,1862,28,30-34,1890,43.31601558938512
SIM,1850,28,na,1878,4004
SIM,1853,3,na,1856,5456
SIM,1906,21,40-44,1927,9
STAT,1928,27,50-100,1955,2.4762091664374104
SIM,1855,28,35-39,1883,23
STAT,1874,45,45-49,1919,0.4928933241990099
SIM,1872,26,45-49,1898,4
STAT,1839,47,45-49,1886,0.37545087863039495
SIM,1809,90,na,1899,74
SIM,1826,62,na,1888,2056
STAT,1846,26,25-29,1872,78.95095231086148
SIM,1880,26,na,1906,5544
STAT,1874,97,na,1971,68.901161883022
STAT,1844,29,25-29,1873,82.43026722789017
STAT,1871,36,30-34,1907,10.74534807909089
STAT,1939,33,50-100,1972,1.7028724145414318
SIM,1899,20,40-44,1919,7
SIM,1831,38,20-24,1869,2
SIM,1814,40,35-39,1854,1
SIM,1817,85,na,1902,233
STAT,1858,3,na,1861,5196.141074082573
STAT,1851,69,na,1920,2274.960254411879
SIM,1942,15,15-19,1957,96
STAT,1865,19,15-19,1884,11.08889936805012
SIM,1873,19,15-19,1892,14
STAT,1865,77,na,1942,1585.9964241927707
SIM,1890,19,20-24,1909,48
STAT,1934,15,15-19,1949,124.56948276937419
SIM,1875,34,15-19,1909,2
STAT,1942,25,15-19,1967,1.4977415805970593
STAT,1872,62,na,1934,3709.8199335930744
SIM,1844,87,na,1931,186
STAT,1807,54,45-49,1861,0.0907765483232803
STAT,1821,43,40-44,1864,6.95224276718514
STAT,1902,46,na,1948,6434.48457557494
SIM,1810,48,30-34,1858,1
SIM,1852,29,25-29,1881,81
SIM,1884,84,na,1968,1337
STAT,1864,25,30-34,1889,45.94703291928024
SIM,1775,85,na,1860,110
STAT,1882,19,20-24,1901,34.69200454523818
STAT,1826,47,35-39,1873,0.27917125450330654
STAT,1850,26,45-49,1876,2.017865995823147
STAT,1922,29,50-100,1951,2.2578257879733914
SIM,1844,38,30-34,1882,14
SIM,1852,82,na,1934,676
SIM,1938,8,na,1946,8009
STAT,1868,48,25-29,1916,0.10928922212601129
STAT,1842,80,na,1922,920.9750662664627
SIM,1837,46,45-49,1883,3
STAT,1761,96,na,1857,0.22942324125223196
STAT,1944,22,15-19,1966,11.607021450522714
SIM,1916,25,15-19,1941,2
SIM,1875,16,15-19,1891,14
SIM,1898,19,20-24,1917,49
SIM,1892,11,na,1903,7416
SIM,1820,38,45-49,1858,1
SIM,1938,30,45-49,1968,4
STAT,1891,69,na,1960,3938.4291966629953
STAT,1870,19,25-29,1889,11.209950022313498
STAT,1813,103,na,1916,0.12752756816407718
STAT,1881,21,15-19,1902,6.459405846257439
SIM,1878,29,45-49,1907,3
SIM,1863,54,na,1917,3893
SIM,1930,29,50-100,1959,4
SIM,1924,17,15-19,1941,101
SIM,1949,22,na,1971,8942
SIM,1855,59,na,1914,3388
STAT,1814,77,na,1891,743.9214394759238
SIM,1837,35,50-100,1872,5
SIM,1874,20,35-39,1894,14
SIM,1885,37,40-44,1922,13
STAT,1820,46,25-29,1866,0.21747055076472205
SIM,1867,44,na,1911,4623
STAT,1834,40,50-100,1874,1.7393359294853457
STAT,1825,49,na,1874,2907.1245114661565
STAT,1838,31,15-19,1869,0.24199329379198972
SIM,1804,59,na,1863,2074
STAT,1867,16,15-19,1883,11.543056025124528
STAT,1888,29,35-39,1917,22.86800215362096
STAT,1871,32,15-19,1903,0.2857431362994551
SIM,1840,30,35-39,1870,29
STAT,1838,35,30-34,1873,8.886330133304071
STAT,1874,27,15-19,1901,0.938218202065663
SIM,1876,28,50-100,1904,5
SIM,1878,47,45-49,1925,1
STAT,1844,31,50-100,1875,1.787892468786621
SIM,1911,35,35-39,1946,8
SIM,1914,40,na,1954,7636
STAT,1812,51,15-19,1863,1.6637145396828582E-4
SIM,1820,36,25-29,1856,5
SIM,1852,31,50-100,1883,2
STAT,1908,25,15-19,1933,1.3693779015852117
SIM,1849,44,45-49,1893,6
STAT,1895,19,30-34,1914,4.171981409698878
STAT,1919,45,40-44,1964,0.34692153457173
STAT,1893,38,35-39,1931,18.016011568827455
STAT,1839,29,15-19,1868,0.8796855185434306
STAT,1858,95,na,1953,20.932739197293536
SIM,1909,25,na,1934,7351
STAT,1872,18,45-49,1890,0.1322403545874802
SIM,1802,80,na,1882,567
STAT,1867,16,na,1883,4912.454904454922
STAT,1872,16,25-29,1888,11.60819489906052
STAT,1834,28,25-29,1862,73.30660857551
SIM,1836,28,30-34,1864,58
SIM,1908,34,20-24,1942,3
STAT,1828,28,30-34,1856,71.87523625955156
STAT,1796,78,na,1874,635.780272854925
STAT,1866,20,35-39,1886,11.122230400676266
STAT,1793,98,na,1891,1.1791292107830313
STAT,1911,51,na,1962,6936.741493669398
SIM,1832,23,50-100,1855,1
STAT,1914,22,35-39,1936,19.43162556752163
STAT,1826,51,50-100,1877,0.02962911367550265
SIM,1922,22,35-39,1944,30
STAT,1821,40,30-34,1861,3.86978397226116
STAT,1906,36,na,1942,7021.854524781201
STAT,1836,38,30-34,1874,8.60993326791927
SIM,1880,16,25-29,1896,14
SIM,1861,28,na,1889,4543
STAT,1916,17,15-19,1933,19.44625693691274
STAT,1862,44,40-44,1906,3.8302935471573507
STAT,1903,35,35-39,1938,4.431605497199464
STAT,1854,36,25-29,1890,4.4350163768680275
STAT,1828,38,50-100,1866,2.4226342807997905
STAT,1870,36,40-44,1906,8.721608369552579
SIM,1890,38,50-100,1928,7
STAT,1898,29,20-24,1927,31.83392472967877
SIM,1902,15,na,1917,7471
SIM,1891,20,40-44,1911,5
STAT,1889,59,na,1948,4839.6782722172
SIM,1830,40,20-24,1870,2
SIM,1900,16,20-24,1916,51
SIM,1811,45,40-44,1856,2
STAT,1866,50,35-39,1916,0.016273349101582468
SIM,1883,40,50-100,1923,2
STAT,1831,47,45-49,1878,0.361150450546584
STAT,1860,15,20-24,1875,33.93279855581791
SIM,1871,24,50-100,1895,1
SIM,1914,31,40-44,1945,13
SIM,1939,4,na,1943,8380
SIM,1937,15,35-39,1952,10
STAT,1832,30,35-39,1862,17.58608478761129
STAT,1880,21,30-34,1901,38.011347069597576
STAT,1887,40,25-29,1927,1.465135667606532
STAT,1800,85,na,1885,193.9642260875429
STAT,1864,21,15-19,1885,6.095297165853528
SIM,1843,34,na,1877,3723
STAT,1827,49,45-49,1876,0.4149832720996047
SIM,1832,31,na,1863,3624
SIM,1828,97,na,1925,5
STAT,1854,18,30-34,1872,2.90565162628756
SIM,1935,21,30-34,1956,104
STAT,1887,27,25-29,1914,95.55013954003012
SIM,1803,53,40-44,1856,1
STAT,1826,93,na,1919,34.985866342483924
STAT,1829,43,40-44,1872,3.6453368419184176
SIM,1872,39,20-24,1911,3
STAT,1813,49,15-19,1862,0.002383490973455199
STAT,1875,40,50-100,1915,2.2189007442024526
SIM,1856,25,45-49,1881,1
SIM,1862,36,25-29,1898,11
SIM,1791,75,na,1866,663
SIM,1872,21,15-19,1893,8
STAT,1809,46,20-24,1855,0.09471598546268195
STAT,1893,24,15-19,1917,8.39223140832884
STAT,1909,22,25-29,1931,173.47627246614155
SIM,1929,24,40-44,1953,9
SIM,1903,43,35-39,1946,1
STAT,1835,54,20-24,1889,9.365823129890191E-4
SIM,1852,7,na,1859,4906
SIM,1822,35,45-49,1857,5
STAT,1818,67,na,1885,1751.451973178556
STAT,1842,48,50-100,1890,0.3610583762100273
STAT,1890,47,20-24,1937,0.016608845578102268
STAT,1913,58,na,1971,6871.600073449003
STAT,1862,27,50-100,1889,1.1083085327522912
SIM,1837,25,40-44,1862,11
STAT,1852,41,45-49,1893,2.3961536216269086
STAT,1835,39,na,1874,3358.7708647803693
STAT,1884,56,na,1940,4067.5818897511767
SIM,1895,27,25-29,1922,127
STAT,1927,21,30-34,1948,71.72123279445108
STAT,1852,23,45-49,1875,1.3108094523725258
STAT,1896,16,40-44,1912,0.4888956867182164
STAT,1921,49,15-19,1970,8.335682522760025E-4
SIM,1846,35,30-34,1881,11
SIM,1828,36,25-29,1864,8
SIM,1865,18,na,1883,4866
SIM,1866,41,40-44,1907,9
STAT,1896,41,na,1937,6212.019816391968
STAT,1913,18,na,1931,7956.417242141732
STAT,1947,22,50-100,1969,1.5018053396699784
SIM,1820,46,na,1866,2860
STAT,1918,32,15-19,1950,0.27573927071281107
STAT,1877,52,30-34,1929,0.012416982254633733
SIM,1938,17,45-49,1955,2
STAT,1853,39,45-49,1892,3.122352980526446
STAT,1882,38,50-100,1920,2.403476365376929
STAT,1906,31,40-44,1937,7.3582994867857545
STAT,1860,33,45-49,1893,2.847943588950035
SIM,1849,26,15-19,1875,1
STAT,1929,15,35-39,1944,10.864541699975408
STAT,1881,26,45-49,1907,2.174839887717717
STAT,1963,5,na,1968,10086.187006922259
SIM,1863,94,na,1957,64
SIM,1865,28,20-24,1893,20
STAT,1848,43,45-49,1891,2.4363242185415124
STAT,1802,52,na,1854,2512.6202709765275
SIM,1896,2,na,1898,7370
SIM,1874,32,35-39,1906,27
STAT,1819,39,45-49,1858,10.173897177595103
STAT,1828,46,25-29,1874,0.10512336850110811
STAT,1829,25,40-44,1854,17.056868521049157
SIM,1856,13,na,1869,4816
SIM,1906,21,35-39,1927,28
STAT,1895,59,na,1954,5114.479625450907
STAT,1776,86,na,1862,131.33423407211745
SIM,1881,18,35-39,1899,1
STAT,1853,28,50-100,1881,1.0593126679875524
STAT,1830,31,15-19,1861,0.28681117435300735
SIM,1785,75,na,1860,633
STAT,1863,41,20-24,1904,0.2820360634931989
STAT,1847,24,na,1871,3938.338036042309
STAT,1873,18,35-39,1891,1.1230318835741684
STAT,1888,42,35-39,1930,4.317208684517762
STAT,1911,45,40-44,1956,0.3029544431595187
SIM,1883,29,25-29,1912,103
STAT,1929,33,35-39,1962,23.426409708376987
SIM,1905,35,na,1940,7225
STAT,1875,29,25-29,1904,87.33086290532437
SIM,1834,97,na,1931,2
SIM,1850,6,na,1856,4853
SIM,1866,99,na,1965,13
STAT,1868,45,15-19,1913,7.762726203959157E-4
STAT,1887,23,50-100,1910,0.9182677458818884
SIM,1841,49,50-100,1890,3
STAT,1861,47,25-29,1908,0.09637467450347431
STAT,1891,37,50-100,1928,3.0649150524932334
SIM,1834,33,45-49,1867,6
STAT,1833,49,50-100,1882,0.33602819305440706
STAT,1870,54,40-44,1924,0.020300475042135082
SIM,1848,46,na,1894,3466
STAT,1897,35,50-100,1932,3.3459437213430965
STAT,1876,21,na,1897,4955.169860082292
STAT,1918,43,30-34,1961,0.2740415578797326
SIM,1854,26,25-29,1880,86
SIM,1927,19,na,1946,9381
SIM,1835,49,45-49,1884,3
STAT,1822,40,20-24,1862,0.5637322567837302
STAT,1853,103,na,1956,0.275626737867307
STAT,1942,2,na,1944,8569.60289494702
STAT,1838,34,50-100,1872,1.5092216790572144
STAT,1857,28,20-24,1885,18.885353276263338
SIM,1846,34,50-100,1880,3
SIM,1879,26,30-34,1905,56
STAT,1883,20,40-44,1903,4.159517242033129
SIM,1851,69,na,1920,2192
STAT,1773,81,na,1854,357.0
SIM,1870,44,40-44,1914,12
STAT,1878,21,50-100,1899,0.8627494631270128
STAT,1849,36,20-24,1885,1.260717626196515
SIM,1939,28,15-19,1967,1
STAT,1942,15,na,1957,7772.804808680684
SIM,1827,39,45-49,1866,7
STAT,1881,50,30-34,1931,0.011786842689286684
SIM,1904,27,45-49,1931,6
STAT,1943,22,25-29,1965,198.47122865314464
STAT,1866,104,na,1970,1.288272802083584
SIM,1863,33,40-44,1896,12
STAT,1871,77,na,1948,1734.4158233111427
STAT,1864,39,20-24,1903,1.3776147686356341
STAT,1826,33,45-49,1859,4.9042739125191375
STAT,1852,23,15-19,1875,6.20143137598619
STAT,1829,39,na,1868,3174.088444259459
SIM,1826,90,na,1916,57
STAT,1879,36,30-34,1915,11.312799400358513
SIM,1888,32,35-39,1920,32
SIM,1843,36,20-24,1879,3
STAT,1879,19,45-49,1898,0.13725227227922163
STAT,1867,48,35-39,1915,0.26147223003436754
STAT,1932,21,40-44,1953,8.93754486994573
STAT,1926,24,20-24,1950,271.0728759473354
STAT,1848,25,45-49,1873,2.204968670729692
STAT,1872,48,45-49,1920,0.47299987289125345
SIM,1859,18,na,1877,4819
SIM,1937,33,35-39,1970,28
STAT,1841,51,40-44,1892,0.015347965674387504
STAT,1921,30,25-29,1951,20.934927229242
STAT,1893,24,45-49,1917,1.7738834132927335
STAT,1921,49,45-49,1970,0.49180568278734826
SIM,1940,21,40-44,1961,12
STAT,1918,19,45-49,1937,1.092032140411371
SIM,1926,19,45-49,1945,2
SIM,1857,18,20-24,1875,35
SIM,1874,41,50-100,1915,2
STAT,1831,29,15-19,1860,0.7744478025300714
SIM,1816,38,25-29,1854,4
SIM,1861,28,50-100,1889,1
STAT,1835,36,20-24,1871,1.2477245673021873
STAT,1849,18,20-24,1867,34.31534062587264
STAT,1855,33,40-44,1888,6.589760996362852
SIM,1896,24,35-39,1920,22
SIM,1779,75,na,1854,826
SIM,1832,62,na,1894,2376
SIM,1887,36,30-34,1923,22
SIM,1829,33,35-39,1862,22
SIM,1911,35,na,1946,7535
SIM,1840,97,na,1937,5
SIM,1899,23,45-49,1922,2
SIM,1925,16,20-24,1941,342
SIM,1939,28,20-24,1967,42
STAT,1854,51,20-24,1905,0.0011366334948495248
STAT,1913,39,15-19,1952,0.03789811111709506
SIM,1814,46,50-100,1860,1
STAT,1935,28,40-44,1963,12.828109886758003
STAT,1811,57,na,1868,2349.8159757392905
STAT,1864,23,40-44,1887,3.7949697220486502
SIM,1879,21,30-34,1900,44
STAT,1823,52,35-39,1875,0.025604979148453184
STAT,1842,24,50-100,1866,0.7548056539134812
STAT,1889,38,45-49,1927,4.939623426660987
STAT,1844,26,20-24,1870,23.359951812393078
STAT,1845,29,45-49,1874,2.0526804803680627
STAT,1840,38,20-24,1878,1.3024270700571594
SIM,1879,38,na,1917,4798
STAT,1916,38,na,1954,7742.357835771903
STAT,1947,17,15-19,1964,103.24143817375098
STAT,1837,62,na,1899,2547.410365049454
STAT,1819,53,20-24,1872,0.0029144301821318374
SIM,1849,41,40-44,1890,8
SIM,1871,58,na,1929,3825
SIM,1883,43,na,1926,4766
STAT,1895,28,na,1923,6258.340289105588
STAT,1803,109,na,1912,5.020969171792507E-4
SIM,1761,93,na,1854,4
SIM,1798,73,na,1871,873
SIM,1863,16,25-29,1879,12
STAT,1796,100,na,1896,0.47298026313230523
STAT,1874,57,na,1931,4155.745709041832
SIM,1954,12,na,1966,9923
STAT,1837,53,40-44,1890,0.014440955341036125
SIM,1833,31,35-39,1864,23
STAT,1846,14,na,1860,4551.756279409928
STAT,1872,31,15-19,1903,0.2902318682002714
STAT,1943,24,20-24,1967,238.7580124577174
STAT,1857,45,45-49,1902,0.37521427631001053
STAT,1848,19,15-19,1867,11.92124092330461
STAT,1917,16,20-24,1933,59.06157077400711
STAT,1856,32,na,1888,3763.962263294635
STAT,1864,28,35-39,1892,17.357986160605627
SIM,1893,61,na,1954,4821
SIM,1886,19,30-34,1905,5
SIM,1923,18,15-19,1941,100
STAT,1855,16,25-29,1871,10.22370778213509
STAT,1932,24,45-49,1956,2.9715851917899365
STAT,1825,38,25-29,1863,7.28986251693096
STAT,1862,44,35-39,1906,3.0836361702782398
SIM,1864,29,20-24,1893,22
SIM,1880,45,40-44,1925,1
STAT,1951,20,na,1971,8816.897747337967
STAT,1829,30,na,1859,3432.0627978220223
STAT,1869,42,30-34,1911,2.247061306752385
STAT,1934,24,50-100,1958,1.7849321742617343
SIM,1852,26,20-24,1878,24
SIM,1872,23,40-44,1895,4
SIM,1891,48,50-100,1939,3
SIM,1896,22,15-19,1918,9
SIM,1888,33,40-44,1921,12
SIM,1817,47,35-39,1864,1
STAT,1923,18,50-100,1941,0.8858898328488781
STAT,1928,23,na,1951,9178.52990251792
STAT,1847,55,na,1902,3151.9022923784587
SIM,1865,30,35-39,1895,32
STAT,1821,45,30-34,1866,0.2916450610513971
STAT,1895,37,25-29,1932,7.576983249682214
STAT,1891,38,na,1929,5852.2473819079105
SIM,1847,92,na,1939,54
STAT,1876,38,35-39,1914,14.701060117503868
SIM,1877,22,50-100,1899,2
SIM,1884,38,35-39,1922,19
STAT,1850,44,na,1894,3495.9200199693823
STAT,1883,17,15-19,1900,11.775771088149284
STAT,1905,51,na,1956,6355.493117662099
SIM,1856,43,45-49,1899,4
SIM,1891,17,15-19,1908,18
STAT,1917,34,20-24,1951,5.113889483658573
SIM,1877,42,30-34,1919,3
SIM,1836,52,na,1888,2725
SIM,1853,29,45-49,1882,3
STAT,1892,29,25-29,1921,106.18611358155212
SIM,1928,28,45-49,1956,7
SIM,1942,27,na,1969,8064
SIM,1853,33,na,1886,4001
SIM,1909,31,30-34,1940,40
STAT,1857,30,35-39,1887,16.377020220278084
STAT,1849,36,15-19,1885,0.09184036843020842
SIM,1861,38,30-34,1899,14
SIM,1923,20,na,1943,8999
STAT,1865,80,na,1945,1135.0074254548992
STAT,1909,38,40-44,1947,2.8490444922615485
SIM,1870,44,35-39,1914,14
STAT,1884,87,na,1971,900.4809367618388
SIM,1847,32,40-44,1879,13
STAT,1915,18,15-19,1933,19.134618175922206
SIM,1889,31,na,1920,6025
SIM,1877,47,25-29,1924,1
SIM,1920,22,30-34,1942,89
SIM,1911,21,15-19,1932,11
SIM,1860,18,na,1878,4622
STAT,1930,39,45-49,1969,1.7920251462560879
STAT,1869,17,30-34,1886,3.162298013481956
SIM,1882,30,40-44,1912,12
STAT,1825,31,35-39,1856,39.82524499354837
STAT,1870,16,20-24,1886,35.697738875649165
STAT,1833,26,45-49,1859,1.945491703808284
SIM,1932,33,50-100,1965,6
SIM,1930,32,35-39,1962,33
STAT,1892,40,35-39,1932,4.624469481786234
STAT,1939,20,45-49,1959,2.283987810569946
SIM,1856,44,na,1900,3849
STAT,1884,34,15-19,1918,0.28156792921444046
STAT,1851,28,25-29,1879,76.22785453892277
STAT,1852,101,na,1953,0.9094657199523847
STAT,1853,50,25-29,1903,0.005684712343283639
SIM,1844,56,na,1900,2915
SIM,1927,10,na,1937,10232
STAT,1817,43,15-19,1860,0.07210821863229014
STAT,1871,19,45-49,1890,0.13036768248888553
STAT,1919,41,25-29,1960,0.15648073799661627
STAT,1922,44,35-39,1966,0.46511200458568075
SIM,1894,1,na,1895,7169
STAT,1853,38,30-34,1891,8.390640701404635
STAT,1839,32,40-44,1871,8.333077726326206
STAT,1859,26,50-100,1885,1.0536129870000706
STAT,1873,16,na,1889,5213.392402049801
STAT,1903,21,15-19,1924,9.515190151832924
STAT,1888,33,50-100,1921,2.1779080864327485
SIM,1834,30,50-100,1864,2
SIM,1889,43,35-39,1932,6
STAT,1821,43,35-39,1864,5.5970089491855575
STAT,1889,26,45-49,1915,2.7744017658514992
SIM,1892,34,15-19,1926,1
STAT,1857,54,na,1911,3296.3006886562152
STAT,1869,47,25-29,1916,0.11219421114085135
STAT,1886,42,na,1928,4921.3639574682975
STAT,1892,22,35-39,1914,14.753820325565169
STAT,1889,44,45-49,1933,3.676675274074249
STAT,1922,32,35-39,1954,20.84741234569894
STAT,1890,43,35-39,1933,4.43169184125922
STAT,1882,49,15-19,1931,7.705269252890966E-4
SIM,1846,38,35-39,1884,21
STAT,1886,44,20-24,1930,0.33401006508920156
SIM,1897,26,45-49,1923,4
STAT,1901,61,na,1962,5600.117760444474
SIM,1857,40,50-100,1897,3
SIM,1856,19,15-19,1875,12
SIM,1852,51,na,1903,3508
STAT,1888,36,50-100,1924,2.9448075648999956
SIM,1948,21,40-44,1969,8
SIM,1917,38,40-44,1955,6
STAT,1910,10,na,1920,7930.10151300248
STAT,1864,34,50-100,1898,1.6399449917057671
STAT,1806,70,na,1876,1362.3810692001225
STAT,1868,45,20-24,1913,0.02328819909695286
STAT,1862,46,30-34,1908,0.16757069758119392
SIM,1843,37,35-39,1880,18
SIM,1900,19,25-29,1919,19
SIM,1929,27,45-49,1956,7
STAT,1834,29,na,1863,3715.4658905170713
SIM,1805,60,na,1865,1968
SIM,1877,17,30-34,1894,5
STAT,1912,22,30-34,1934,55.64418614075731
STAT,1839,47,50-100,1886,0.3907234561024751
STAT,1839,50,40-44,1889,0.016847194222286133
SIM,1855,21,15-19,1876,8
STAT,1838,38,35-39,1876,11.431407108546422
STAT,1869,29,30-34,1898,48.92724568413601
SIM,1897,38,45-49,1935,1
SIM,1892,16,15-19,1908,19
STAT,1841,50,50-100,1891,0.02222792991241939
SIM,1873,44,na,1917,4791
SIM,1919,23,40-44,1942,13
SIM,1878,24,20-24,1902,124
SIM,1947,20,45-49,1967,2
STAT,1848,37,15-19,1885,0.09488720239698777
STAT,1877,39,30-34,1916,11.064476561037335
STAT,1893,44,50-100,1937,0.18526332688190858
STAT,1833,22,50-100,1855,0.7456197916991247
STAT,1825,41,50-100,1866,2.4933186707195873
SIM,1821,35,25-29,1856,8
STAT,1839,44,50-100,1883,1.6945961020294456
STAT,1822,42,40-44,1864,7.569620544882636
STAT,1823,45,na,1868,3206.5854178482373
STAT,1894,39,30-34,1933,13.687876616450968
SIM,1869,25,25-29,1894,97
STAT,1826,30,40-44,1856,15.10227586355702
SIM,1873,22,40-44,1895,7
SIM,1914,34,45-49,1948,4
STAT,1870,39,45-49,1909,3.9129571963648053
SIM,1841,32,45-49,1873,5
STAT,1849,50,na,1899,3454.820772192196
STAT,1841,48,15-19,1889,5.755808930569613E-4
SIM,1889,31,35-39,1920,35
SIM,1921,25,na,1946,8499
SIM,1811,60,na,1871,2106
STAT,1827,48,30-34,1875,0.1725010037941264
STAT,1906,34,45-49,1940,2.921549022405789
SIM,1874,6,na,1880,5336
STAT,1795,101,na,1896,0.24386275888361864
SIM,1872,34,50-100,1906,1
STAT,1835,37,35-39,1872,11.330229796225892
STAT,1860,6,na,1866,4718.942476187652
SIM,1861,59,na,1920,3712
SIM,1878,35,50-100,1913,7
SIM,1860,74,na,1934,1912
STAT,1833,44,45-49,1877,2.327747928117156
SIM,1896,29,35-39,1925,41
SIM,1818,48,30-34,1866,1
STAT,1831,44,40-44,1875,3.4708864372490402
STAT,1888,46,na,1934,5385.76434928913
SIM,1820,74,na,1894,1110
SIM,1866,44,45-49,1910,6
STAT,1912,40,30-34,1952,0.2519158573287376
SIM,1811,48,45-49,1859,1
SIM,1868,94,na,1962,51
STAT,1868,43,25-29,1911,1.2250081123516554
STAT,1939,6,na,1945,8085.995953853154
STAT,1898,28,15-19,1926,1.2356440143473943
STAT,1916,17,20-24,1933,58.09261558452635
STAT,1797,88,na,1885,94.11048626360524
SIM,1839,40,35-39,1879,5
SIM,1855,28,na,1883,4287
SIM,1885,39,30-34,1924,17
SIM,1905,22,35-39,1927,22
STAT,1833,32,45-49,1865,2.957909464396356
STAT,1879,39,35-39,1918,14.79100633730601
SIM,1850,34,45-49,1884,6
STAT,1859,37,20-24,1896,1.239131249563963
STAT,1873,33,50-100,1906,1.8722529057352397
STAT,1841,18,20-24,1859,32.98032378326844
STAT,1893,21,40-44,1914,5.35040121264457
SIM,1830,67,na,1897,1944
SIM,1848,49,25-29,1897,1
SIM,1929,27,15-19,1956,2
STAT,1832,46,15-19,1878,6.24497708208863E-4
STAT,1862,24,15-19,1886,5.746268480967722
SIM,1920,40,30-34,1960,3
SIM,1873,7,na,1880,5715
SIM,1858,76,na,1934,1510
STAT,1866,31,na,1897,4465.014863320934
SIM,1829,38,35-39,1867,18
STAT,1831,30,15-19,1861,0.24545889860782397
STAT,1931,38,15-19,1969,0.0513136107258688
SIM,1912,34,40-44,1946,13
SIM,1895,31,na,1926,6624
STAT,1900,11,na,1911,7246.017448551989
STAT,1915,49,20-24,1964,0.0223600556263697
STAT,1852,37,35-39,1889,11.334061915373267
STAT,1824,44,50-100,1868,2.615511601912241
STAT,1866,36,20-24,1902,1.4433750361094082
STAT,1805,54,40-44,1859,0.0793882510462597
SIM,1912,46,40-44,1958,2
STAT,1839,69,na,1908,2291.4638422239655
SIM,1874,36,20-24,1910,2
SIM,1837,77,na,1914,1114
SIM,1912,28,50-100,1940,2
SIM,1860,37,35-39,1897,3
SIM,1870,24,15-19,1894,7
STAT,1808,77,na,1885,743.8981043831787
STAT,1813,52,na,1865,2536.5757230343143
STAT,1878,54,40-44,1932,0.021595328497523422
STAT,1927,36,35-39,1963,6.078065987752141
SIM,1915,25,na,1940,7815
STAT,1851,21,35-39,1872,10.880884534249082
SIM,1841,26,45-49,1867,1
SIM,1834,30,40-44,1864,13
STAT,1918,15,50-100,1933,0.1659736835184228
STAT,1880,26,25-29,1906,90.30821560753725
STAT,1904,46,40-44,1950,0.2807291447375429
SIM,1867,13,na,1880,5448
SIM,1815,42,45-49,1857,7
SIM,1887,39,35-39,1926,29
STAT,1856,29,20-24,1885,18.671610663451546
SIM,1940,24,45-49,1964,3
STAT,1872,45,40-44,1917,0.35095591679508215
STAT,1911,48,45-49,1959,0.41451219142291296
STAT,1852,20,40-44,1872,4.00269765984439
STAT,1897,23,na,1920,6365.055388110631
STAT,1874,33,45-49,1907,3.5908581002145237
SIM,1935,36,35-39,1971,8
SIM,1842,52,na,1894,3079
SIM,1874,94,na,1968,100
STAT,1822,54,40-44,1876,0.030261769011882166
STAT,1845,43,20-24,1888,0.24603122865178362
STAT,1889,38,15-19,1927,0.139144338425437
SIM,1837,23,20-24,1860,4
STAT,1883,17,45-49,1900,0.12961770726750668
STAT,1879,6,na,1885,5683.796868452129
SIM,1848,42,35-39,1890,8
SIM,1869,19,25-29,1888,22
STAT,1930,42,40-44,1972,0.6646503647220409
SIM,1904,10,na,1914,7633
SIM,1882,27,45-49,1909,4
STAT,1813,53,25-29,1866,0.020413577396427036
STAT,1888,22,15-19,1910,7.874985213830671
SIM,1830,100,na,1930,7
STAT,1946,18,45-49,1964,1.1185496811428577
SIM,1824,67,na,1891,1853
SIM,1840,17,35-39,1857,2
SIM,1848,41,50-100,1889,4
SIM,1921,27,50-100,1948,4
STAT,1852,39,30-34,1891,8.40884389754976
SIM,1841,44,45-49,1885,8
STAT,1874,30,50-100,1904,1.909947760448475
SIM,1882,33,45-49,1915,5
SIM,1937,19,20-24,1956,258
STAT,1880,44,25-29,1924,1.3477943552646998
STAT,1852,104,na,1956,0.13027642276464166
STAT,1930,36,40-44,1966,3.947099904571079
STAT,1904,34,40-44,1938,7.156475719346589
SIM,1877,46,na,1923,4644
STAT,1842,16,15-19,1858,11.413095174679736
SIM,1808,49,na,1857,2751
STAT,1833,25,50-100,1858,1.1298663819670618
STAT,1923,17,na,1940,8726.17714958801
STAT,1951,19,30-34,1970,29.29184125388109
STAT,1865,22,40-44,1887,3.869872485623397
SIM,1824,44,45-49,1868,6
SIM,1860,39,30-34,1899,16
SIM,1849,28,na,1877,4191
SIM,1823,45,50-100,1868,1
SIM,1838,20,30-34,1858,38
STAT,1899,49,na,1948,6096.768511067511
SIM,1830,42,40-44,1872,8
STAT,1853,54,50-100,1907,0.023238479233130115
STAT,1906,16,45-49,1922,0.19271263335125718
SIM,1860,20,40-44,1880,4
STAT,1864,53,35-39,1917,0.015292472527877497
STAT,1887,42,15-19,1929,0.0311551375733686
STAT,1883,35,45-49,1918,3.9931896186431617
SIM,1943,28,40-44,1971,20
STAT,1861,27,35-39,1888,16.337770974511905
SIM,1915,4,na,1919,8583
SIM,1807,64,na,1871,1623
STAT,1801,67,na,1868,1613.3709258895524
STAT,1879,34,50-100,1913,1.9189763737698387
STAT,1886,82,na,1968,1708.255707160152
STAT,1902,18,na,1920,7182.509746947745
STAT,1915,24,45-49,1939,2.3344603447988455
SIM,1833,35,20-24,1868,1
STAT,1929,19,20-24,1948,347.5310024174156
SIM,1848,30,35-39,1878,28
STAT,1846,70,na,1916,2149.1015694900952
SIM,1883,46,na,1929,4690
SIM,1924,17,20-24,1941,340
SIM,1876,49,30-34,1925,1
STAT,1874,27,45-49,1901,2.2960122714203055
STAT,1921,2,na,1923,9412.9472646825
STAT,1898,31,35-39,1929,27.79127034149915
SIM,1875,79,na,1954,1411
STAT,1917,19,25-29,1936,93.36194278014257
STAT,1937,16,45-49,1953,0.9840839156064193
STAT,1858,44,15-19,1902,0.02144896653889598
SIM,1861,39,45-49,1900,7
SIM,1901,48,50-100,1949,2
SIM,1809,59,na,1868,2135
STAT,1845,69,na,1914,2261.3899653561803
STAT,1816,44,45-49,1860,7.6318297308508845
SIM,1923,24,45-49,1947,4
STAT,1890,18,35-39,1908,1.3491096478044886
SIM,1890,25,na,1915,6291
SIM,1891,35,45-49,1926,7
STAT,1921,34,40-44,1955,8.717879501316371
SIM,1962,7,na,1969,10315
STAT,1868,49,30-34,1917,0.18212013831026078
STAT,1766,96,na,1862,1.7581830104675107
STAT,1844,44,na,1888,3725.9498089986787
SIM,1868,69,na,1937,2877
SIM,1871,43,40-44,1914,6
SIM,1880,23,50-100,1903,1
SIM,1838,41,35-39,1879,7
STAT,1859,80,na,1939,994.3868467347139
SIM,1887,20,15-19,1907,9
SIM,1908,32,25-29,1940,22
STAT,1873,47,15-19,1920,8.169950446592771E-4
SIM,1863,35,50-100,1898,2
SIM,1899,36,20-24,1935,3
SIM,1897,30,50-100,1927,4
SIM,1825,43,45-49,1868,6
STAT,1816,63,na,1879,2067.6279393143072
STAT,1889,30,50-100,1919,2.300005123432265
SIM,1936,27,na,1963,6459
STAT,1897,32,35-39,1929,27.339451978451695
STAT,1884,34,45-49,1918,3.44787882754497
STAT,1930,39,15-19,1969,0.0504795875879353
SIM,1875,31,40-44,1906,14
SIM,1939,31,40-44,1970,12
STAT,1857,19,50-100,1876,0.08958128290695858
STAT,1867,46,15-19,1913,7.587172433161296E-4
STAT,1828,29,45-49,1857,2.826068532850664
STAT,1840,52,35-39,1892,0.01236050989053545
STAT,1940,28,15-19,1968,1.453288688519775
STAT,1934,23,na,1957,9909.629913066976
STAT,1839,53,45-49,1892,0.022296262530915222
STAT,1879,16,40-44,1895,0.3873274769742569
STAT,1882,24,na,1906,4623.860248368158
SIM,1836,29,45-49,1865,1
STAT,1843,15,15-19,1858,10.749990063971232
STAT,1889,41,40-44,1930,5.626564789158672
SIM,1860,41,45-49,1901,5
SIM,1813,64,na,1877,1892
STAT,1922,48,20-24,1970,0.025562178336216247
SIM,1787,70,na,1857,1091
STAT,1819,51,30-34,1870,0.02446662112561108
STAT,1873,72,na,1945,2591.5312212153617
SIM,1850,59,na,1909,3099
STAT,1825,35,20-24,1860,2.181539636123488
STAT,1926,26,40-44,1952,11.321435221400163
STAT,1860,77,na,1937,1417.674721216549
SIM,1933,30,50-100,1963,3
SIM,1821,90,na,1911,74
STAT,1877,35,15-19,1912,0.11888342836833748
SIM,1879,24,35-39,1903,20
SIM,1894,46,na,1940,6076
SIM,1910,23,20-24,1933,8
STAT,1862,40,25-29,1902,1.1196773550145451
STAT,1866,32,35-39,1898,18.871582145460117
STAT,1902,36,35-39,1938,4.373895743654912
STAT,1949,22,na,1971,8605.408548763784
STAT,1863,43,40-44,1906,3.9477709423777427
SIM,1948,12,na,1960,9331
STAT,1902,47,50-100,1949,0.3931806138095255
SIM,1853,41,30-34,1894,3
STAT,1904,10,na,1914,7508.680860727556
STAT,1892,26,20-24,1918,29.762367487503194
STAT,1792,88,na,1880,94.21297952249536
STAT,1907,21,na,1928,7041.5162713490045
STAT,1913,42,35-39,1955,0.39669121977736604
SIM,1910,18,35-39,1928,1
STAT,1836,54,35-39,1890,0.011134466643765405
SIM,1870,40,25-29,1910,1
STAT,1902,23,20-24,1925,195.88621073152345
STAT,1902,18,35-39,1920,1.5604605650004089
SIM,1847,35,45-49,1882,5
SIM,1897,41,40-44,1938,1
STAT,1869,44,20-24,1913,0.3065924529819679
SIM,1835,42,25-29,1877,1
SIM,1877,44,20-24,1921,1
STAT,1817,43,45-49,1860,7.814727645618819
STAT,1920,21,15-19,1941,11.98520796836329
STAT,1854,54,25-29,1908,0.005280543112695753
STAT,1890,40,30-34,1930,2.8627086743510364
STAT,1861,32,20-24,1893,4.543864438944697
STAT,1833,44,na,1877,3263.922739460561
STAT,1847,95,na,1942,20.26694532537385
STAT,1894,33,25-29,1927,26.46124037011827
SIM,1907,39,30-34,1946,5
SIM,1862,44,na,1906,4141
SIM,1883,22,35-39,1905,14
STAT,1892,79,na,1971,2722.7210476678324
SIM,1921,42,35-39,1963,3
STAT,1920,35,40-44,1955,3.3151820588670478
SIM,1892,34,45-49,1926,6
SIM,1912,30,25-29,1942,4
STAT,1853,54,40-44,1907,0.016198809640135856
STAT,1827,42,25-29,1869,1.2198082201019906
STAT,1900,38,20-24,1938,0.4638249379658648
STAT,1828,29,na,1857,3505.084986711462
SIM,1897,7,na,1904,7223
STAT,1840,29,na,1869,3837.6583144731912
STAT,1950,19,na,1969,8783.207541205911
STAT,1895,34,20-24,1929,7.052549431114041
STAT,1851,25,20-24,1876,21.602247192386326
STAT,1845,41,30-34,1886,1.8272785205465905
STAT,1903,20,30-34,1923,51.52594116886303
SIM,1910,36,35-39,1946,9
SIM,1938,29,15-19,1967,2
STAT,1889,23,40-44,1912,5.17313469540595
SIM,1867,37,20-24,1904,1
STAT,1921,13,na,1934,9105.191124243403
SIM,1887,34,40-44,1921,17
STAT,1885,45,20-24,1930,0.02436405657585967
STAT,1912,25,35-39,1937,30.091567463267186
SIM,1933,29,30-34,1962,128
STAT,1830,51,35-39,1881,0.013331219210823522
SIM,1864,31,35-39,1895,26
SIM,1894,47,25-29,1941,1
STAT,1892,47,50-100,1939,0.34863425048745494
STAT,1810,54,15-19,1864,1.4602223107219056E-4
STAT,1868,57,na,1925,3861.5590011102113
STAT,1834,85,na,1919,364.3076253850094
SIM,1919,26,45-49,1945,4
SIM,1916,35,na,1951,7969
STAT,1858,44,45-49,1902,2.3245315854523687
SIM,1928,25,40-44,1953,17
SIM,1930,39,na,1969,10448
STAT,1886,47,25-29,1933,0.12222739144851488
SIM,1856,40,40-44,1896,6
STAT,1828,43,20-24,1871,0.2942462915748879
STAT,1832,59,na,1891,2533.7289389468333
SIM,1877,43,na,1920,4710
SIM,1888,36,45-49,1924,6
SIM,1836,43,20-24,1879,1
SIM,1849,62,na,1911,2946
SIM,1920,25,35-39,1945,47
SIM,1813,67,na,1880,1681
STAT,1855,3,na,1858,5067.3280825203565
STAT,1871,52,35-39,1923,0.017182247084773037
STAT,1882,21,na,1903,4667.036546743075
STAT,1925,29,30-34,1954,92.7793077453686
STAT,1893,36,15-19,1929,0.1444407010462038
STAT,1914,38,15-19,1952,0.03853746045915531
STAT,1867,15,50-100,1882,0.0958567289567763
STAT,1817,100,na,1917,1.0708021926611095
SIM,1897,23,40-44,1920,5
STAT,1778,81,na,1859,412.123127506276
SIM,1842,21,35-39,1863,11
SIM,1812,43,35-39,1855,5
STAT,1858,41,40-44,1899,3.557324646595742
STAT,1836,34,15-19,1870,0.234466430976307
STAT,1855,28,na,1883,3724.133228007984
SIM,1921,50,na,1971,8271
SIM,1865,42,40-44,1907,7
STAT,1826,49,30-34,1875,0.1878513914767409
STAT,1850,47,na,1897,3433.530564267592
STAT,1932,17,50-100,1949,1.002009224957623
STAT,1871,34,35-39,1905,20.1461373678452
STAT,1939,23,na,1962,7405.226046383159
STAT,1887,24,na,1911,5308.711649012394
STAT,1826,45,15-19,1871,8.196132278876335E-4
SIM,1889,29,20-24,1918,34
STAT,1904,49,15-19,1953,6.403955906482297E-4
SIM,1853,92,na,1945,60
STAT,1847,21,15-19,1868,6.209451808044254
STAT,1884,16,15-19,1900,11.864166577940813
STAT,1807,52,na,1859,2623.5003417110615
STAT,1879,34,40-44,1913,9.082779692235418
SIM,1801,79,na,1880,586
SIM,1906,18,15-19,1924,18
STAT,1854,19,45-49,1873,0.11838265372702826
SIM,1854,18,na,1872,4636
STAT,1856,31,35-39,1887,16.140294074504016
SIM,1834,49,30-34,1883,1
SIM,1848,77,na,1925,1148
STAT,1841,70,na,1911,2035.762281299561
SIM,1847,44,50-100,1891,1
STAT,1929,21,35-39,1950,24.118229043485957
STAT,1930,20,25-29,1950,240.40770742795516
STAT,1909,24,15-19,1933,9.934729713678008
STAT,1876,25,20-24,1901,24.67160859284174
SIM,1893,27,20-24,1920,36
SIM,1907,20,40-44,1927,7
SIM,1828,26,na,1854,3624
STAT,1917,47,35-39,1964,0.27195521962718266
STAT,1943,1,na,1944,8866.441372575313
STAT,1866,39,25-29,1905,5.311325938291915
SIM,1873,25,45-49,1898,3
SIM,1908,36,40-44,1944,9
SIM,1928,20,na,1948,9332
SIM,1889,41,50-100,1930,6
SIM,1865,80,na,1945,1021
SIM,1938,32,40-44,1970,12
STAT,1812,53,40-44,1865,0.06840618212281416
STAT,1893,64,na,1957,4551.908338636883
SIM,1961,5,na,1966,10515
SIM,1866,26,15-19,1892,1
SIM,1869,22,20-24,1891,132
STAT,1920,17,40-44,1937,3.1686066516294185
SIM,1912,7,na,1919,8306
STAT,1927,33,30-34,1960,39.11140130254302
SIM,1937,21,35-39,1958,25
STAT,1944,19,na,1963,7993.977064857624
STAT,1764,114,na,1878,4.4728602095715883E-4
STAT,1935,32,15-19,1967,0.35912511599937796
SIM,1846,11,na,1857,4677
SIM,1956,2,na,1958,10713
STAT,1865,25,45-49,1890,2.051017656934851
STAT,1927,38,na,1965,9435.881578133658
SIM,1895,15,25-29,1910,18
STAT,1880,23,20-24,1903,146.1633178281253
STAT,1893,24,na,1917,6016.33544438206
STAT,1904,49,45-49,1953,0.37783371649869024
STAT,1816,41,40-44,1857,12.901515658876546
STAT,1894,49,na,1943,5716.17064492072
SIM,1874,39,25-29,1913,7
SIM,1882,21,na,1903,4955
STAT,1848,37,45-49,1885,3.3684952844965967
STAT,1879,20,15-19,1899,7.010694452557379
SIM,1819,89,na,1908,65
STAT,1840,85,na,1925,395.6966975756253
STAT,1883,32,40-44,1915,8.605231079756752
SIM,1798,70,na,1868,1218
SIM,1846,33,40-44,1879,12
STAT,1870,37,25-29,1907,5.708950623021204
STAT,1868,49,50-100,1917,0.46207340757701026
SIM,1878,27,25-29,1905,101
STAT,1818,54,20-24,1872,0.002997455524587854
STAT,1810,78,na,1888,676.1965097261456
STAT,1899,45,45-49,1944,0.3720441166340823
SIM,1876,49,50-100,1925,3
STAT,1855,49,20-24,1904,0.017717398985248944
STAT,1944,21,30-34,1965,62.68999552802556
STAT,1938,23,35-39,1961,18.817593762782202
SIM,1859,58,na,1917,3499
SIM,1937,0,na,1937,8456
SIM,1912,49,45-49,1961,2
STAT,1885,27,20-24,1912,23.58369172691907
STAT,1966,5,na,1971,9916.237360309387
SIM,1896,26,30-34,1922,88
STAT,1916,35,na,1951,7854.847992348483
SIM,1884,25,20-24,1909,28
STAT,1900,51,na,1951,6061.396095616122
SIM,1799,95,na,1894,4
STAT,1937,29,50-100,1966,1.9580059753777996
SIM,1819,52,na,1871,2565
STAT,1921,37,45-49,1958,1.5369483342175254
SIM,1824,41,40-44,1865,7
SIM,1845,18,30-34,1863,6
SIM,1891,32,40-44,1923,14
STAT,1830,30,30-34,1860,35.75130878483925
STAT,1926,22,25-29,1948,226.59879747649242
SIM,1948,18,15-19,1966,93
SIM,1934,22,25-29,1956,12
STAT,1823,34,50-100,1857,4.085450317525943
SIM,1925,34,20-24,1959,6
STAT,1858,98,na,1956,5.992688597486739
STAT,1911,54,na,1965,6842.896498537766
STAT,1915,34,50-100,1949,1.6862118005698945
STAT,1835,70,na,1905,1817.1801285519025
STAT,1911,15,40-44,1926,0.5680755485246345
STAT,1821,41,15-19,1862,0.04517303801370292
SIM,1923,34,50-100,1957,2
SIM,1946,23,35-39,1969,30
SIM,1879,42,35-39,1921,9
STAT,1809,47,35-39,1856,1.0851791698282853
STAT,1874,30,40-44,1904,9.040046020864972
SIM,1826,36,20-24,1862,2
STAT,1856,69,na,1925,2286.779200134514
SIM,1828,66,na,1894,1985
STAT,1888,26,30-34,1914,60.317119269646
STAT,1839,35,45-49,1874,3.7977558283593065
SIM,1783,71,na,1854,1036
STAT,1843,33,15-19,1876,0.23734455100588717
STAT,1886,29,50-100,1915,1.354040189578952
STAT,1837,18,30-34,1855,3.448789797445669
STAT,1910,18,30-34,1928,4.866735253900422
STAT,1878,50,25-29,1928,0.0075785340524630535
STAT,1841,20,35-39,1861,10.881539387592278
SIM,1771,86,na,1857,108
SIM,1926,31,30-34,1957,46
SIM,1837,26,25-29,1863,79
STAT,1798,73,na,1871,969.1272434819059
STAT,1785,107,na,1892,0.007369868084755893
STAT,1880,41,20-24,1921,0.33941517649108705
STAT,1946,15,40-44,1961,3.1346035308298617
STAT,1822,39,15-19,1861,0.2043106081483647
SIM,1820,35,40-44,1855,15
SIM,1843,24,20-24,1867,134
STAT,1905,17,45-49,1922,0.19079270923663216
SIM,1792,85,na,1877,157
STAT,1853,32,25-29,1885,16.688682912351997
STAT,1904,30,25-29,1934,29.92930155941465
STAT,1814,48,20-24,1862,0.06120735574556085
STAT,1896,17,25-29,1913,15.109925145178368
STAT,1933,38,na,1971,10339.935588567792
SIM,1856,37,45-49,1893,6
SIM,1833,38,25-29,1871,9
SIM,1851,33,45-49,1884,5
STAT,1818,36,20-24,1854,5.9133163990683935
STAT,1947,17,45-49,1964,1.1363942463647867
SIM,1838,23,35-39,1861,20
STAT,1864,36,na,1900,4273.73915630285
STAT,1845,46,25-29,1891,0.08900989454507556
STAT,1899,27,15-19,1926,1.255457839800222
SIM,1850,31,40-44,1881,12
SIM,1859,80,na,1939,880
STAT,1869,46,50-100,1915,0.48198893085876165
STAT,1830,44,50-100,1874,1.8413328931154453
SIM,1883,40,35-39,1923,3
STAT,1882,2,na,1884,6237.292602236681
SIM,1902,45,40-44,1947,1
STAT,1838,33,40-44,1871,7.217915305940865
SIM,1831,34,50-100,1865,2
SIM,1844,59,na,1903,2740
SIM,1851,15,15-19,1866,8
SIM,1829,35,30-34,1864,11
STAT,1862,32,na,1894,4119.253096282255
STAT,1875,40,35-39,1915,3.803311908704161
STAT,1888,49,na,1937,5259.361843699593
STAT,1852,35,15-19,1887,0.09187365109295331
SIM,1923,21,40-44,1944,10
STAT,1858,16,50-100,1874,0.09063627119348319
STAT,1804,78,na,1882,642.1179547195703
STAT,1843,33,45-49,1876,2.9063510696316794
STAT,1918,31,30-34,1949,33.94482901027664
SIM,1935,33,30-34,1968,51
STAT,1853,95,na,1948,21.036220136781388
SIM,1917,24,15-19,1941,11
STAT,1835,24,20-24,1859,116.99558671857095
STAT,1829,26,25-29,1855,154.1742808070045
STAT,1886,42,30-34,1928,2.448009029667578
STAT,1874,94,na,1968,164.59230668850498
STAT,1813,50,20-24,1863,0.00451711295929555
STAT,1844,49,45-49,1893,0.3731622212978298
STAT,1864,50,30-34,1914,0.010900621428818723
SIM,1846,51,na,1897,3380
STAT,1887,15,25-29,1902,12.85943520307422
STAT,1844,44,20-24,1888,0.25602250172779956
STAT,1881,39,20-24,1920,1.4896149426323064
STAT,1951,15,15-19,1966,109.19506459517353
STAT,1835,42,20-24,1877,0.24656684624845765
SIM,1860,17,15-19,1877,11
STAT,1870,36,na,1906,4693.979895903422
STAT,1843,51,45-49,1894,0.02042651445237483
STAT,1881,39,na,1920,4552.771435462964
SIM,1786,85,na,1871,168
SIM,1861,32,25-29,1893,21
STAT,1823,106,na,1929,0.014570045367773359
SIM,1825,52,na,1877,2546
SIM,1834,26,na,1860,3751
SIM,1902,27,40-44,1929,12
SIM,1954,15,40-44,1969,6
STAT,1909,42,15-19,1951,0.0029025100190834038
STAT,1899,45,15-19,1944,6.305827177811114E-4
SIM,1865,58,na,1923,3655
STAT,1791,63,na,1854,1719.9999999999998
STAT,1819,77,na,1896,904.4797876819244
STAT,1840,40,50-100,1880,1.793412789836504
SIM,1836,26,40-44,1862,7
STAT,1858,64,na,1922,2736.9033388474413
STAT,1900,36,30-34,1936,3.238339517384471
STAT,1939,26,20-24,1965,37.082329003915724
SIM,1930,29,45-49,1959,7
STAT,1865,43,45-49,1908,2.7262153496258668
STAT,1907,39,20-24,1946,0.4889083104388866
STAT,1886,17,30-34,1903,3.3980381166494933
STAT,1882,40,40-44,1922,4.469869856828174
SIM,1919,31,25-29,1950,25
SIM,1887,49,45-49,1936,1
SIM,1842,37,20-24,1879,1
SIM,1881,11,na,1892,4476
SIM,1857,32,35-39,1889,20
SIM,1899,39,25-29,1938,2
STAT,1854,74,na,1928,1701.2917666373776
STAT,1895,17,40-44,1912,0.4813332758176301
SIM,1901,26,15-19,1927,2
STAT,1954,16,45-49,1970,1.247418038263507
STAT,1809,50,50-100,1859,0.11590324920519884
SIM,1924,39,30-34,1963,9
STAT,1916,39,30-34,1955,3.73148951387762
STAT,1863,46,45-49,1909,0.41840913605264507
STAT,1892,44,15-19,1936,0.0023918650832396083
SIM,1909,28,40-44,1937,14
STAT,1871,54,25-29,1925,0.006911661433897602
STAT,1963,8,na,1971,10081.850565771792
SIM,1861,96,na,1957,13
STAT,1937,29,20-24,1966,35.908277385367086
SIM,1850,24,50-100,1874,4
SIM,1953,16,35-39,1969,15
STAT,1807,106,na,1913,0.009691587104781123
STAT,1873,40,30-34,1913,2.382988751071816
STAT,1840,27,35-39,1867,17.365749637489873
SIM,1852,4,na,1856,5026
STAT,1945,16,35-39,1961,9.25933569418306
SIM,1873,16,na,1889,5369
STAT,1952,19,45-49,1971,1.2081035962689193
SIM,1904,19,na,1923,7399
SIM,1804,50,na,1854,2448
STAT,1890,13,na,1903,6356.419946720666
SIM,1915,39,20-24,1954,1
STAT,1840,34,40-44,1874,7.467676503160386
SIM,1873,43,45-49,1916,4
SIM,1890,40,40-44,1930,11
STAT,1870,17,35-39,1887,1.0983596924130663
STAT,1847,27,na,1874,3963.503215944097
SIM,1826,99,na,1925,1
STAT,1923,16,15-19,1939,107.85695254971418
SIM,1841,46,50-100,1887,3
STAT,1823,37,45-49,1860,7.735342160525568
STAT,1849,32,35-39,1881,16.88000256220951
STAT,1887,20,50-100,1907,0.9266098787343116
STAT,1891,60,na,1951,4761.049188269544
SIM,1823,57,na,1880,2422
STAT,1892,14,na,1906,6508.209246661191
STAT,1846,79,na,1925,1070.8258958998194
SIM,1869,32,30-34,1901,49
STAT,1881,76,na,1957,1992.9092003070168
STAT,1922,29,45-49,1951,3.9188695478127977
STAT,1817,109,na,1926,7.175964161176972E-4
SIM,1867,29,50-100,1896,3
STAT,1834,37,20-24,1871,1.2763395124112127
STAT,1943,19,35-39,1962,8.980408411236546
SIM,1951,19,35-39,1970,13
STAT,1889,56,na,1945,5079.163634581147
STAT,1926,42,15-19,1968,0.0038228566366024777
STAT,1824,30,na,1854,3063.244720729079
SIM,1875,8,na,1883,6000
STAT,1831,34,30-34,1865,28.826015691785184
STAT,1844,27,35-39,1871,19.075230899999593
STAT,1924,36,50-100,1960,1.0005193460875854
SIM,1890,35,50-100,1925,6
STAT,1857,49,25-29,1906,0.08878054400393795
SIM,1912,14,na,1926,8239
STAT,1858,32,45-49,1890,2.7455056131073463
STAT,1940,4,na,1944,8243.287490545505
SIM,1852,27,35-39,1879,24
STAT,1854,46,35-39,1900,0.2152275604356578
SIM,1866,32,45-49,1898,3
SIM,1808,74,na,1882,914
SIM,1931,16,15-19,1947,121
STAT,1846,39,50-100,1885,1.923454124187816
STAT,1896,20,15-19,1916,8.849096649506311
SIM,1831,37,45-49,1868,8
STAT,1809,52,20-24,1861,0.005439429689977227
STAT,1874,46,20-24,1920,0.024885433012044676
STAT,1924,45,15-19,1969,8.896317395390427E-4
STAT,1942,12,na,1954,8302.288430478655
STAT,1846,24,35-39,1870,10.87077393509046
SIM,1887,30,25-29,1917,32
STAT,1786,85,na,1871,156.61011190407447
STAT,1827,32,15-19,1859,0.3515103882017375
SIM,1821,45,35-39,1866,1
SIM,1909,56,na,1965,6646
SIM,1884,53,na,1937,4573
SIM,1959,8,na,1967,10851
STAT,1869,22,50-100,1891,0.7980211733205077
SIM,1889,28,45-49,1917,4
STAT,1897,51,na,1948,5840.75378968977
STAT,1919,26,35-39,1945,32.86785102698025
STAT,1936,23,30-34,1959,55.48796433516561
STAT,1851,43,15-19,1894,0.021253113003440474
SIM,1851,66,na,1917,2481
STAT,1918,18,30-34,1936,26.719067077822846
SIM,1839,32,na,1871,3576
SIM,1871,80,na,1951,1030
STAT,1899,33,45-49,1932,4.805034632241066
SIM,1898,49,20-24,1947,1
STAT,1875,43,50-100,1918,2.1808661735037576
SIM,1925,29,35-39,1954,40
SIM,1905,44,45-49,1949,2
STAT,1866,93,na,1959,90.15815302864928
STAT,1880,51,50-100,1931,0.03228594266188647
STAT,1863,21,30-34,1884,32.35019027519924
STAT,1780,94,na,1874,7.630303037231316
STAT,1894,23,15-19,1917,8.532530188235436
STAT,1917,29,35-39,1946,31.568935257931628
SIM,1824,42,50-100,1866,4
STAT,1826,30,50-100,1856,3.1907534427038082
SIM,1823,42,35-39,1865,10
STAT,1823,82,na,1905,559.899589826869
STAT,1890,28,45-49,1918,2.7274358424679175
STAT,1929,20,20-24,1949,285.6545479186438
STAT,1811,54,50-100,1865,0.0939483483482335
STAT,1896,39,35-39,1935,18.6696261701344
SIM,1871,21,30-34,1892,46
STAT,1876,43,20-24,1919,0.32934174491820145
STAT,1880,36,35-39,1916,15.120584450723088
SIM,1926,18,30-34,1944,32
SIM,1854,24,35-39,1878,17
SIM,1922,41,40-44,1963,3
STAT,1856,50,40-44,1906,0.016640304827536315
SIM,1818,42,25-29,1860,2
STAT,1813,45,35-39,1858,0.8944963444619788
STAT,1898,25,40-44,1923,8.242683185192508
STAT,1879,32,na,1911,5041.027481639662
STAT,1879,30,25-29,1909,21.811190653354842
SIM,1894,17,30-34,1911,7
SIM,1875,17,na,1892,5648
STAT,1861,17,25-29,1878,10.94882626302994
STAT,1879,49,45-49,1928,0.4881353679028797
STAT,1896,46,40-44,1942,0.25823089071209454
STAT,1860,27,20-24,1887,19.446708302618536
STAT,1878,22,20-24,1900,145.35717031268527
STAT,1905,20,35-39,1925,17.145852489447467
STAT,1877,33,25-29,1910,21.38971456677707
STAT,1883,31,na,1914,4754.444068467059
STAT,1875,22,35-39,1897,12.13401467219313
SIM,1830,29,40-44,1859,8
SIM,1886,22,20-24,1908,160
STAT,1903,23,35-39,1926,16.728435943376656
STAT,1818,37,35-39,1855,48.94208597918115
SIM,1890,33,35-39,1923,38
SIM,1885,33,25-29,1918,31
STAT,1902,33,30-34,1935,49.573611052350444
SIM,1910,33,30-34,1943,35
STAT,1781,101,na,1882,0.26631127865714727
STAT,1878,19,na,1897,5298.693712302932
STAT,1772,99,na,1871,0.5577791523216815
STAT,1815,42,35-39,1857,10.930660617571993
STAT,1815,87,na,1902,163.75998697922455
SIM,1928,23,na,1951,9281
STAT,1900,29,25-29,1929,117.66566543150685
SIM,1825,29,30-34,1854,43
SIM,1909,20,45-49,1929,7
STAT,1925,37,15-19,1962,0.04653917684950146
SIM,1917,51,na,1968,7819
STAT,1919,33,40-44,1952,8.48912568446903
STAT,1895,15,15-19,1910,15.690106507645257
STAT,1873,41,na,1914,4764.253718616104
STAT,1882,33,35-39,1915,19.839876913613967
STAT,1874,39,15-19,1913,0.11495412517957325
SIM,1839,34,40-44,1873,9
SIM,1911,23,35-39,1934,19
STAT,1867,47,na,1914,4235.565271771255
STAT,1910,28,40-44,1938,9.061509904472286
SIM,1845,66,na,1911,2684
STAT,1821,87,na,1908,195.28690693028489
STAT,1834,21,35-39,1855,10.463901264599194
STAT,1866,99,na,1965,14.419496414280697
SIM,1841,22,50-100,1863,1
STAT,1815,48,50-100,1863,1.2991472282420296
STAT,1855,51,35-39,1906,0.013044009759911022
SIM,1924,39,na,1963,9289
SIM,1900,34,15-19,1934,1
SIM,1826,34,30-34,1860,39
STAT,1838,48,45-49,1886,0.3244180494916773
STAT,1853,22,15-19,1875,6.16731967778025
SIM,1802,89,na,1891,71
STAT,1885,25,30-34,1910,50.96652044588705
STAT,1826,54,50-100,1880,0.027915832127557563
SIM,1859,43,25-29,1902,3
STAT,1845,91,na,1936,89.29385844889917
STAT,1914,34,35-39,1948,18.421955290928306
STAT,1895,28,50-100,1923,1.6775083442686294
STAT,1872,35,30-34,1907,10.92039655159788
STAT,1929,37,15-19,1966,0.04978656420178765
SIM,1872,35,40-44,1907,16
SIM,1909,22,na,1931,7244
SIM,1822,44,40-44,1866,5
STAT,1876,28,25-29,1904,88.05070137089943
SIM,1916,45,50-100,1961,2
SIM,1930,33,na,1963,10396
STAT,1872,93,na,1965,178.0533912054935
STAT,1887,61,na,1948,4220.8603395857435
SIM,1883,38,20-24,1921,2
STAT,1829,48,35-39,1877,0.21802759612770434
STAT,1891,39,15-19,1930,0.138772360589109
SIM,1861,22,15-19,1883,8
SIM,1840,29,na,1869,4126
STAT,1904,28,50-100,1932,1.8477745897752993
SIM,1903,31,na,1934,6983
STAT,1890,19,na,1909,6192.624107593542
STAT,1917,44,30-34,1961,0.2685344655084893
SIM,1922,34,35-39,1956,27
SIM,1859,21,50-100,1880,4
SIM,1867,24,45-49,1891,3
SIM,1813,44,30-34,1857,2
SIM,1913,20,35-39,1933,25
STAT,1850,32,45-49,1882,2.797010318218665
STAT,1859,38,35-39,1897,11.313251328967379
STAT,1824,48,15-19,1872,9.552247924439637E-4
SIM,1848,49,na,1897,3375
SIM,1853,61,na,1914,2986
SIM,1946,20,30-34,1966,77
STAT,1917,17,na,1934,8393.295781680672
SIM,1828,34,35-39,1862,26
SIM,1936,24,na,1960,6309
STAT,1850,45,20-24,1895,0.018582670390484373
STAT,1924,15,20-24,1939,327.4887362629165
STAT,1945,21,15-19,1966,11.78569706478699
SIM,1859,86,na,1945,274
STAT,1854,16,40-44,1870,0.33739829264922266
SIM,1877,27,40-44,1904,5
STAT,1867,103,na,1970,2.5783308912636764
SIM,1846,48,45-49,1894,2
SIM,1927,26,35-39,1953,44
SIM,1817,37,25-29,1854,7
STAT,1833,100,na,1933,1.3956680856291919
STAT,1928,21,15-19,1949,13.461428728066876
SIM,1936,26,45-49,1962,6
STAT,1953,17,50-100,1970,0.9152477528149414
SIM,1836,31,20-24,1867,6
SIM,1898,33,35-39,1931,37
STAT,1887,25,35-39,1912,21.942792828909937
STAT,1920,31,25-29,1951,20.525147361991497
STAT,1906,47,20-24,1953,0.01982791643382971
SIM,1935,23,20-24,1958,282
STAT,1841,42,45-49,1883,2.2564809914729076
STAT,1918,20,45-49,1938,2.4650632946589517
SIM,1837,48,35-39,1885,1
SIM,1853,95,na,1948,25
STAT,1908,47,25-29,1955,0.09695091818823638
STAT,1927,23,20-24,1950,275.78642042772776
SIM,1822,37,35-39,1859,14
STAT,1942,29,30-34,1971,82.97479543899259
SIM,1893,25,30-34,1918,78
STAT,1937,21,25-29,1958,181.76054226001654
SIM,1897,26,na,1923,6548
STAT,1919,28,50-100,1947,2.1639347505974014
STAT,1895,22,20-24,1917,181.35222418752736
SIM,1895,25,35-39,1920,35
STAT,1830,53,25-29,1883,0.0052717610279919645
STAT,1877,31,na,1908,5024.923235560166
SIM,1834,29,na,1863,3658
SIM,1904,36,40-44,1940,4
STAT,1871,26,50-100,1897,1.28795719829762
SIM,1945,21,25-29,1966,229
STAT,1836,55,na,1891,2749.1971567968035
SIM,1829,42,na,1871,3230
SIM,1856,46,50-100,1902,1
STAT,1770,114,na,1884,5.086771140783099E-4
STAT,1828,31,20-24,1859,6.247633110413773
STAT,1860,51,45-49,1911,0.023915442572620793
STAT,1873,47,na,1920,4595.275777716214
STAT,1891,33,45-49,1924,4.334875797879066
STAT,1891,46,20-24,1937,0.016945986009933887
SIM,1932,15,20-24,1947,354
STAT,1881,28,35-39,1909,18.769191611128687
SIM,1891,35,na,1926,6147
STAT,1854,21,20-24,1875,125.02327667873111
SIM,1819,83,na,1902,298
STAT,1857,24,40-44,1881,3.3968132516606073
SIM,1884,25,na,1909,5180
STAT,1797,57,na,1854,2032.9999999999998
STAT,1822,35,na,1857,3290.441180266598
STAT,1933,29,20-24,1962,48.907195056091005
SIM,1934,26,40-44,1960,16
STAT,1914,44,45-49,1958,0.33200947662120645
SIM,1835,42,na,1877,3427
SIM,1875,11,na,1886,5877
STAT,1859,12,na,1871,4454.484973143879
SIM,1935,18,40-44,1953,2
SIM,1797,63,na,1860,1770
STAT,1875,76,na,1951,1969.985281480702
STAT,1884,19,na,1903,5009.730714095125
STAT,1885,18,25-29,1903,11.361956031151575
STAT,1835,27,25-29,1862,71.43573679518072
STAT,1934,37,25-29,1971,2.74451604579988
STAT,1837,21,20-24,1858,126.67306417732773
STAT,1938,20,30-34,1958,57.49765652330581
SIM,1901,33,20-24,1934,10
SIM,1921,36,40-44,1957,3
STAT,1833,38,15-19,1871,0.09151142211729336
STAT,1845,19,35-39,1864,1.0561185533240327
SIM,1880,63,na,1943,3885
STAT,1875,38,20-24,1913,1.594915633376459
SIM,1864,43,35-39,1907,7
SIM,1884,28,25-29,1912,106
SIM,1912,4,na,1916,8356
STAT,1893,61,na,1954,4783.479183986269
SIM,1843,27,25-29,1870,88
STAT,1913,55,na,1968,7016.398531214941
SIM,1845,21,20-24,1866,139
STAT,1766,106,na,1872,0.014955951734271753
SIM,1952,18,40-44,1970,5
STAT,1839,91,na,1930,90.48136372007359
STAT,1944,18,40-44,1962,3.0388330281704587
STAT,1857,100,na,1957,2.3365854083047672
SIM,1936,21,15-19,1957,8
SIM,1838,48,50-100,1886,4
STAT,1848,40,na,1888,3883.3310698732666
STAT,1918,34,35-39,1952,19.440821212475573
SIM,1817,57,na,1874,2457
SIM,1941,29,20-24,1970,44
SIM,1865,24,40-44,1889,8
STAT,1808,47,20-24,1855,0.07625101898063605
STAT,1857,4,na,1861,4931.610011183366
STAT,1928,26,45-49,1954,4.312663145266938
SIM,1851,19,30-34,1870,4
SIM,1831,34,40-44,1865,2
SIM,1846,14,na,1860,4612
STAT,1864,37,50-100,1901,2.2164556646649203
STAT,1852,79,na,1931,1114.2411031503477
STAT,1814,44,40-44,1858,12.095084753653587
SIM,1893,18,25-29,1911,20
STAT,1932,37,20-24,1969,0.715375380411916
STAT,1828,26,40-44,1854,14.806825724255546
STAT,1833,45,20-24,1878,0.018990916427077453
STAT,1860,37,30-34,1897,8.740949034642295
STAT,1930,27,na,1957,9620.1419088047
STAT,1940,16,15-19,1956,93.0956532757951
SIM,1867,35,30-34,1902,19
SIM,1862,21,20-24,1883,128
STAT,1868,27,20-24,1895,22.542293261698862
STAT,1824,42,45-49,1866,3.889850132543692
STAT,1898,39,na,1937,6424.583495310157
SIM,1814,74,na,1888,1078
STAT,1859,24,45-49,1883,1.1463691530263016
STAT,1895,56,na,1951,5367.563185454367
STAT,1843,19,30-34,1862,2.8197507960355717
SIM,1926,34,35-39,1960,37
SIM,1925,19,25-29,1944,134
STAT,1850,38,15-19,1888,0.08656003619283019
SIM,1852,14,na,1866,4707
SIM,1878,49,35-39,1927,2
SIM,1861,30,50-100,1891,3
SIM,1931,34,45-49,1965,6
STAT,1919,31,15-19,1950,0.28108852063366546
SIM,1860,49,na,1909,3846
STAT,1923,34,45-49,1957,3.637425338752848
SIM,1910,19,na,1929,8062
STAT,1828,26,na,1854,3361.388022166918
STAT,1881,35,40-44,1916,8.626396466659422
STAT,1927,18,40-44,1945,3.5026524397330285
STAT,1913,36,40-44,1949,2.9987299032623653
SIM,1832,42,45-49,1874,5
STAT,1842,107,na,1949,0.007021179880996217
SIM,1918,39,na,1957,8236
STAT,1886,26,50-100,1912,1.368467592835886
SIM,1831,27,35-39,1858,23
STAT,1808,53,15-19,1861,1.4301869187012206E-4
SIM,1915,56,na,1971,7238
STAT,1861,22,na,1883,4084.35700178811
SIM,1799,58,na,1857,1956
STAT,1909,28,30-34,1937,75.40220258231574
STAT,1874,49,50-100,1923,0.4972757324822481
SIM,1852,29,50-100,1881,1
SIM,1869,35,35-39,1904,15
SIM,1853,26,40-44,1879,8
STAT,1844,29,50-100,1873,1.2465305764274008
STAT,1917,4,na,1921,8742.511383630874
SIM,1913,29,45-49,1942,6
STAT,1865,40,40-44,1905,4.168639473826581
SIM,1934,19,35-39,1953,14
SIM,1821,39,40-44,1860,15
SIM,1858,70,na,1928,2325
SIM,1914,16,15-19,1930,1
SIM,1887,37,50-100,1924,1
STAT,1918,28,40-44,1946,9.981096728266651
SIM,1945,15,30-34,1960,35
STAT,1844,24,30-34,1868,35.40146602274715
STAT,1851,37,20-24,1888,1.2077531454068662
SIM,1912,42,na,1954,7425
STAT,1774,94,na,1868,5.891029479595886
STAT,1779,113,na,1892,3.2722963784394835E-4
SIM,1923,37,50-100,1960,2
STAT,1919,16,25-29,1935,19.447914955984253
SIM,1904,28,20-24,1932,39
STAT,1886,14,na,1900,5487.936890927974
STAT,1900,39,35-39,1939,4.233991837817282
STAT,1869,32,20-24,1901,5.2897225218642845
STAT,1905,29,45-49,1934,3.2197739042069693
STAT,1778,84,na,1862,218.45179021240307
STAT,1926,19,35-39,1945,10.332817585233968
STAT,1831,39,50-100,1870,1.965504454797115
SIM,1877,32,20-24,1909,7
STAT,1840,40,35-39,1880,3.0740033048477753
SIM,1844,19,25-29,1863,11
SIM,1917,28,30-34,1945,99
SIM,1913,44,35-39,1957,2
SIM,1829,46,50-100,1875,2
SIM,1868,27,30-34,1895,61
STAT,1803,68,na,1871,1520.0378573123057
STAT,1806,79,na,1885,580.5287733979426
SIM,1927,16,25-29,1943,114
STAT,1877,23,15-19,1900,6.897196907854133
STAT,1904,44,na,1948,6632.074721586621
STAT,1920,47,40-44,1967,0.35190200120123777
STAT,1814,50,35-39,1864,0.044494032122317805
STAT,1865,49,15-19,1914,7.186001067793119E-4
STAT,1913,15,45-49,1928,0.2072846890802498
SIM,1866,68,na,1934,2908
STAT,1845,26,40-44,1871,5.659092958091477
STAT,1899,30,40-44,1929,12.096755982842705
SIM,1892,22,45-49,1914,3
STAT,1905,20,na,1925,6949.004032635472
SIM,1885,23,15-19,1908,6
STAT,1895,47,35-39,1942,0.20685534364459568
STAT,1823,34,40-44,1857,19.336999498729618
SIM,1833,47,na,1880,3157
STAT,1928,23,40-44,1951,8.451042928513194
SIM,1846,85,na,1931,335
SIM,1825,31,45-49,1856,6
SIM,1909,18,30-34,1927,8
STAT,1890,25,40-44,1915,7.4346312154632805
STAT,1893,43,20-24,1936,0.028027174879295777
STAT,1871,51,20-24,1922,0.001487730660117109
STAT,1851,23,50-100,1874,0.7494896731908928
STAT,1875,44,15-19,1919,0.028327885720831714
STAT,1952,16,40-44,1968,3.3859064889919384
SIM,1906,25,20-24,1931,32
STAT,1851,111,na,1962,4.956068396317439E-4
SIM,1843,17,15-19,1860,11
STAT,1905,44,35-39,1949,0.36232073963967193
STAT,1953,16,25-29,1969,105.89332824044897
SIM,1926,28,40-44,1954,18
SIM,1915,7,na,1922,8499
STAT,1911,18,45-49,1929,0.20141670746236268
STAT,1901,30,na,1931,6801.215082623096
STAT,1836,19,25-29,1855,14.435933820760845
STAT,1881,41,35-39,1922,3.550850058943622
STAT,1851,91,na,1942,89.82969856874296
SIM,1854,21,30-34,1875,42
SIM,1842,47,30-34,1889,1
SIM,1871,52,na,1923,4146
SIM,1886,82,na,1968,1466
STAT,1935,18,30-34,1953,33.570654407171
STAT,1793,67,na,1860,1448.7653325397448
SIM,1773,87,na,1860,96
SIM,1886,25,25-29,1911,103
SIM,1788,80,na,1868,390
SIM,1843,71,na,1914,1932
STAT,1900,26,20-24,1926,32.97991288234244
SIM,1922,26,15-19,1948,2
SIM,1936,23,40-44,1959,8
SIM,1875,42,na,1917,5134
SIM,1903,22,30-34,1925,64
STAT,1855,38,35-39,1893,10.612600554616714
STAT,1914,26,15-19,1940,1.4424848164735091
SIM,1871,36,35-39,1907,15
STAT,1845,24,15-19,1869,6.220641523217556
SIM,1852,24,30-34,1876,48
SIM,1839,37,45-49,1876,8
STAT,1834,47,30-34,1881,0.1366529267648161
STAT,1853,16,20-24,1869,33.94237510598266
STAT,1856,43,35-39,1899,2.8012923936997995
STAT,1928,31,25-29,1959,23.350613521400877
SIM,1861,16,20-24,1877,42
STAT,1855,45,40-44,1900,0.2607320935481192
STAT,1842,38,25-29,1880,4.9765494108692785
SIM,1850,38,25-29,1888,11
SIM,1889,25,40-44,1914,12
STAT,1864,64,na,1928,3138.2749432875944
STAT,1938,27,15-19,1965,1.4127355326003916
STAT,1908,34,na,1942,7152.980552205383
STAT,1906,16,15-19,1922,17.50794628279726
SIM,1880,35,30-34,1915,12
SIM,1928,21,25-29,1949,251
STAT,1867,53,20-24,1920,0.001373309115117933
STAT,1856,38,na,1894,3652.9598669758566
SIM,1893,28,35-39,1921,35
SIM,1827,29,35-39,1856,20
SIM,1899,21,na,1920,6601
STAT,1837,109,na,1946,9.916009733924498E-4
SIM,1872,28,35-39,1900,21
SIM,1927,41,na,1968,9686
STAT,1893,18,50-100,1911,0.12508465224991844
STAT,1858,0,na,1858,6188.61289383775
STAT,1869,25,15-19,1894,0.8938920284217409
SIM,1839,19,15-19,1858,9
STAT,1871,16,40-44,1887,0.3715564071558182
SIM,1854,5,na,1859,5031
SIM,1896,10,na,1906,7222
STAT,1879,46,40-44,1925,0.3626828902867281
SIM,1884,18,15-19,1902,11
SIM,1860,43,na,1903,3987
STAT,1937,15,30-34,1952,24.06411218717963
STAT,1834,43,15-19,1877,0.021879121801378396
SIM,1842,40,50-100,1882,3
STAT,1901,18,20-24,1919,49.9937722914348
SIM,1817,88,na,1905,107
SIM,1943,21,50-100,1964,3
SIM,1792,88,na,1880,63
SIM,1936,31,25-29,1967,21
STAT,1873,50,40-44,1923,0.021913776500612266
SIM,1878,53,na,1931,4639
SIM,1943,18,30-34,1961,31
STAT,1846,21,30-34,1867,33.90719877165236
STAT,1944,24,35-39,1968,20.517126108537965
SIM,1873,40,40-44,1913,9
SIM,1905,39,50-100,1944,1
STAT,1854,31,30-34,1885,27.695608840147784
SIM,1867,81,na,1948,995
STAT,1825,77,na,1902,1000.1325846281347
STAT,1931,19,45-49,1950,1.3134938267355643
SIM,1918,23,20-24,1941,243
STAT,1842,16,45-49,1858,0.12562567820773837
STAT,1848,74,na,1922,1819.7283627991608
SIM,1957,1,na,1958,10338
STAT,1880,28,50-100,1908,1.3562015708045416
SIM,1844,22,15-19,1866,6
STAT,1931,34,35-39,1965,24.153158845630724
STAT,1946,21,35-39,1967,21.167122174483975
STAT,1883,39,25-29,1922,5.6556143430674535
STAT,1790,84,na,1874,199.93421744536641
STAT,1887,22,30-34,1909,40.23425463691566
STAT,1885,28,35-39,1913,19.32892583678605
SIM,1836,38,50-100,1874,5
STAT,1809,53,na,1862,2555.1549681466645
STAT,1831,40,na,1871,3394.8769781079877
SIM,1849,96,na,1945,5
SIM,1922,38,na,1960,9031
SIM,1935,26,25-29,1961,209
STAT,1936,33,40-44,1969,7.673488389357507
SIM,1887,36,na,1923,5795
SIM,1937,20,20-24,1957,207
SIM,1886,15,15-19,1901,10
STAT,1908,44,20-24,1952,0.032615365795198886
STAT,1843,21,45-49,1864,1.2349766689982111
SIM,1851,21,45-49,1872,1
STAT,1902,23,50-100,1925,1.1591587164464996
SIM,1858,28,15-19,1886,1
SIM,1829,73,na,1902,1423
STAT,1771,104,na,1875,0.04925693364331581
STAT,1843,45,15-19,1888,5.72189565865862E-4
STAT,1850,48,25-29,1898,0.08720663987563691
STAT,1846,45,30-34,1891,0.14974762663352068
SIM,1790,90,na,1880,42
STAT,1860,33,15-19,1893,0.2325747565297069
SIM,1908,39,45-49,1947,3
SIM,1929,15,45-49,1944,1
STAT,1852,42,20-24,1894,0.25280620576310514
STAT,1910,44,na,1954,7004.296328410415
STAT,1911,31,15-19,1942,0.25382815810399845
STAT,1940,27,50-100,1967,2.050030759899447
STAT,1865,46,na,1911,4139.753389184376
STAT,1911,20,na,1931,7355.219296472886
SIM,1826,37,35-39,1863,16
STAT,1901,28,30-34,1929,70.94790380985229
SIM,1876,27,20-24,1903,24
SIM,1828,31,30-34,1859,36
SIM,1835,25,50-100,1860,2
STAT,1840,54,na,1894,3022.5020232317006
SIM,1895,22,30-34,1917,64
SIM,1903,29,50-100,1932,2
STAT,1867,31,40-44,1898,8.236093164982396
SIM,1934,23,na,1957,9729
STAT,1915,47,30-34,1962,0.1814345710836369
SIM,1940,23,na,1963,7691
SIM,1930,18,20-24,1948,364
STAT,1917,45,na,1962,7785.704202243355
STAT,1860,43,50-100,1903,1.7201521942747788
STAT,1903,17,40-44,1920,0.5259491560085401
SIM,1846,45,40-44,1891,1
SIM,1926,24,25-29,1950,231
STAT,1914,31,30-34,1945,32.16582857025787
STAT,1914,41,40-44,1955,0.5013592619683965
STAT,1822,45,45-49,1867,0.7551005132330532
SIM,1854,45,30-34,1899,1
STAT,1841,32,35-39,1873,17.8277987012644
STAT,1875,48,30-34,1923,0.19875212698460135
STAT,1922,18,20-24,1940,315.969084568119
STAT,1761,107,na,1868,0.0012229995339989156
STAT,1862,22,25-29,1884,101.15831811843309
STAT,1845,16,30-34,1861,3.122625434117943
STAT,1837,37,50-100,1874,2.0838843511681233
STAT,1856,2,na,1858,5518.018270150131
STAT,1918,24,25-29,1942,199.90622629648053
SIM,1871,24,35-39,1895,17
STAT,1878,25,25-29,1903,89.8317571406626
SIM,1870,22,25-29,1892,133
STAT,1859,35,30-34,1894,8.648602749880629
SIM,1813,98,na,1911,1
SIM,1913,6,na,1919,8484
SIM,1944,23,30-34,1967,70
STAT,1859,21,40-44,1880,3.846770915282117
STAT,1787,67,na,1854,1389.0000000000002
STAT,1898,28,45-49,1926,3.0238742051714222
SIM,1858,38,25-29,1896,8
SIM,1922,31,30-34,1953,51
STAT,1838,45,40-44,1883,0.24456198159935863
STAT,1826,52,20-24,1878,0.0014192171931107346
SIM,1867,21,40-44,1888,4
STAT,1855,22,na,1877,3766.6146925079647
STAT,1828,41,30-34,1869,2.1999786239717642
STAT,1784,84,na,1868,174.57768817839238
SIM,1853,16,30-34,1869,5
SIM,1797,91,na,1888,18
STAT,1880,29,na,1909,5041.212582589891
STAT,1913,39,45-49,1952,1.3453827846579591
STAT,1944,20,50-100,1964,1.4357275378964618
SIM,1838,53,35-39,1891,1
STAT,1868,23,na,1891,4530.460796945469
SIM,1908,29,35-39,1937,36
STAT,1789,110,na,1899,1.4142680519802465E-4
SIM,1869,36,50-100,1905,4
SIM,1901,36,25-29,1937,3
STAT,1863,24,35-39,1887,10.371591224836385
STAT,1885,15,20-24,1900,35.80518574564818
SIM,1899,29,15-19,1928,1
SIM,1934,29,45-49,1963,3
STAT,1837,24,25-29,1861,102.97695856395084
STAT,1957,14,na,1971,10454.179103975262
STAT,1836,32,25-29,1868,17.21776853220099
STAT,1934,34,20-24,1968,6.718212786967011
STAT,1871,46,na,1917,4527.1563499657705
STAT,1916,49,40-44,1965,0.3246791025993071
STAT,1946,25,50-100,1971,2.24104102043735
STAT,1815,53,na,1868,2563.126216892459
STAT,1860,9,na,1869,4608.402774112242
SIM,1844,32,25-29,1876,19
SIM,1885,27,50-100,1912,2
SIM,1916,21,50-100,1937,1
STAT,1891,30,40-44,1921,10.913123162739131
STAT,1817,82,na,1899,470.60690832451036
STAT,1830,50,20-24,1880,0.0012808131648510991
SIM,1887,67,na,1954,3722
STAT,1842,89,na,1931,156.40519623979057
STAT,1908,21,50-100,1929,1.226201555889892
SIM,1855,96,na,1951,3
STAT,1895,32,30-34,1927,45.94752568912316
SIM,1893,15,20-24,1908,47
SIM,1903,37,na,1940,7005
STAT,1860,74,na,1934,1820.1451892093878
STAT,1927,26,25-29,1953,162.13673019731496
STAT,1864,35,40-44,1899,7.977800727197492
STAT,1919,2,na,1921,9125.991571726812
STAT,1871,29,50-100,1900,1.2743785955051317
STAT,1906,38,50-100,1944,0.7760046565583261
SIM,1918,33,30-34,1951,54
SIM,1830,45,45-49,1875,1
STAT,1884,22,45-49,1906,1.3906478214017448
SIM,1891,39,25-29,1930,8
SIM,1845,24,25-29,1869,134
SIM,1835,26,20-24,1861,21
SIM,1836,41,30-34,1877,4
STAT,1832,25,na,1857,3779.9498862930513
SIM,1876,4,na,1880,5980
SIM,1921,39,45-49,1960,4
SIM,1928,31,35-39,1959,32
STAT,1940,31,40-44,1971,8.185062170600553
SIM,1881,40,30-34,1921,6
SIM,1905,66,na,1971,5537
STAT,1894,17,20-24,1911,45.994845392427905
SIM,1867,38,35-39,1905,19
SIM,1872,38,45-49,1910,10
STAT,1802,83,na,1885,303.4866125097005
SIM,1872,68,na,1940,3077
STAT,1816,48,25-29,1864,0.2787088997218029
SIM,1841,41,40-44,1882,5
SIM,1921,20,25-29,1941,7
STAT,1931,28,50-100,1959,2.59414111797062
STAT,1857,27,45-49,1884,1.8002980672744022
STAT,1851,49,20-24,1900,0.018213792593315625
STAT,1897,44,35-39,1941,0.3348886383980699
SIM,1784,90,na,1874,38
SIM,1848,15,na,1863,4486
SIM,1827,47,na,1874,3076
SIM,1919,25,30-34,1944,107
SIM,1929,35,50-100,1964,3
STAT,1799,83,na,1882,283.09977208566295
SIM,1912,37,45-49,1949,3
STAT,1891,49,25-29,1940,0.07941691730729641
STAT,1800,54,na,1854,2356.609833285068
STAT,1864,38,45-49,1902,3.581010124052007
STAT,1874,29,na,1903,4899.854480106928
SIM,1959,2,na,1961,10861
STAT,1887,46,30-34,1933,0.21927192219469824
SIM,1824,48,25-29,1872,1
STAT,1904,37,45-49,1941,1.2472598453087789
STAT,1926,28,na,1954,9036.168049074453
STAT,1913,20,25-29,1933,181.89343302153083
SIM,1893,36,na,1929,6221
STAT,1833,41,40-44,1874,3.635571359188157
SIM,1865,27,45-49,1892,3
STAT,1926,29,45-49,1955,4.152039691371816
STAT,1857,88,na,1945,216.11140684402403
SIM,1917,19,35-39,1936,10
STAT,1862,107,na,1969,0.10069791182171435
SIM,1907,22,50-100,1929,1
STAT,1856,47,15-19,1903,6.203881191056762E-4
SIM,1831,40,35-39,1871,4
SIM,1875,48,na,1923,5005
SIM,1923,25,20-24,1948,49
STAT,1781,73,na,1854,926.0
STAT,1855,50,na,1905,3293.4939784261414
SIM,1812,48,na,1860,2797
SIM,1908,19,25-29,1927,19
STAT,1838,19,na,1857,4055.241124714646
STAT,1899,18,na,1917,6970.391972142258
SIM,1886,35,35-39,1921,21
SIM,1870,26,40-44,1896,8
SIM,1917,30,45-49,1947,7
STAT,1884,46,15-19,1930,7.99972356887642E-4
STAT,1937,25,40-44,1962,9.1860624675676
STAT,1827,29,25-29,1856,136.0949034825567
STAT,1858,33,na,1891,3741.197086958317
SIM,1958,3,na,1961,10847
STAT,1759,113,na,1872,3.953042111131002E-4
STAT,1890,15,30-34,1905,3.9473920613892957
SIM,1881,42,na,1923,3957
STAT,1879,3,na,1882,6436.921644528502
STAT,1853,30,50-100,1883,1.5242027307906743
SIM,1882,42,40-44,1924,10
STAT,1887,47,45-49,1934,0.530589847632339
STAT,1810,48,20-24,1858,0.07678153870396084
STAT,1921,15,35-39,1936,9.702464747630005
SIM,1900,38,30-34,1938,6
STAT,1775,79,na,1854,393.0
STAT,1862,26,40-44,1888,5.227542406282606
STAT,1937,26,50-100,1963,1.960828214663203
STAT,1930,27,45-49,1957,4.436519471248124
STAT,1878,35,35-39,1913,15.0606048435545
SIM,1902,52,na,1954,6276
SIM,1952,11,na,1963,9771
STAT,1861,54,30-34,1915,0.009731119409874487
SIM,1895,62,na,1957,5089
STAT,1882,35,50-100,1917,2.438396920381528
SIM,1845,46,35-39,1891,3
STAT,1795,93,na,1888,15.161543363179083
STAT,1848,52,40-44,1900,0.01717036724759255
STAT,1837,100,na,1937,1.4796736336812655
SIM,1823,88,na,1911,122
SIM,1844,29,35-39,1873,23
STAT,1843,68,na,1911,2140.726201281385
SIM,1826,68,na,1894,1708
STAT,1874,42,40-44,1916,4.645584299099051
STAT,1901,24,15-19,1925,9.269166122040302
STAT,1832,28,na,1860,3701.4319169020773
STAT,1909,26,40-44,1935,9.10886578463853
SIM,1863,48,45-49,1911,1
SIM,1945,25,40-44,1970,12
SIM,1826,31,na,1857,3469
STAT,1855,48,45-49,1903,0.35140096292760065
STAT,1871,12,na,1883,5297.762004621332
STAT,1910,36,25-29,1946,1.9116807824881978
STAT,1941,27,20-24,1968,38.13832614758682
SIM,1850,35,20-24,1885,4
STAT,1893,41,50-100,1934,2.716624712615352
STAT,1806,73,na,1879,1025.1961900737233
STAT,1842,35,20-24,1877,1.3745322865571938
STAT,1851,47,30-34,1898,0.14935810138109185
STAT,1877,27,50-100,1904,1.3415361406072297
STAT,1905,42,45-49,1947,0.30318231879930885
STAT,1920,21,50-100,1941,1.4814844682494348
STAT,1882,52,na,1934,4213.58383953243
STAT,1833,46,50-100,1879,0.3837322221845445
STAT,1876,18,15-19,1894,12.363965460142643
SIM,1919,18,na,1937,8239
STAT,1901,38,40-44,1939,2.658176663980874
SIM,1932,36,50-100,1968,2
STAT,1928,25,30-34,1953,98.13887627398547
STAT,1836,29,35-39,1865,16.366559219662644
SIM,1868,60,na,1928,3704
STAT,1824,98,na,1922,3.4731322374885973
SIM,1831,24,30-34,1855,45
STAT,1852,54,20-24,1906,0.0011437613986553968
SIM,1858,16,15-19,1874,11
STAT,1849,59,na,1908,3074.168191492904
STAT,1901,36,15-19,1937,0.03443397651761627
SIM,1914,5,na,1919,8588
STAT,1855,35,30-34,1890,8.112978636391734
STAT,1856,40,30-34,1896,1.8095310599392647
STAT,1917,44,50-100,1961,0.24676140019603743
SIM,1928,30,20-24,1958,8
STAT,1902,41,15-19,1943,0.0027467646888134608
SIM,1856,52,40-44,1908,1
STAT,1807,51,40-44,1858,0.06997439442897677
SIM,1900,26,30-34,1926,88
STAT,1965,6,na,1971,9909.990471700856
SIM,1831,83,na,1914,388
STAT,1868,28,35-39,1896,18.475407484618643
STAT,1846,48,na,1894,3402.801267854435
STAT,1886,25,15-19,1911,0.9738300199236288
SIM,1848,100,na,1948,2
SIM,1851,35,na,1886,3861
SIM,1917,26,40-44,1943,13
SIM,1858,34,45-49,1892,5
SIM,1906,42,na,1948,6799
STAT,1819,39,50-100,1858,6.265870045945584
SIM,1814,49,50-100,1863,2
SIM,1894,20,20-24,1914,190
SIM,1819,80,na,1899,491
STAT,1787,98,na,1885,1.1444898602847802
STAT,1902,15,na,1917,7234.836005063809
SIM,1899,35,45-49,1934,10
STAT,1923,24,35-39,1947,21.981017373832458
STAT,1855,53,na,1908,3194.7041580634377
STAT,1886,20,20-24,1906,147.79407256550468
STAT,1919,48,45-49,1967,0.47466940589284917
STAT,1871,24,25-29,1895,114.1451097202519
SIM,1931,24,35-39,1955,29
STAT,1768,91,na,1859,30.46318359123426
STAT,1859,29,50-100,1888,1.0310807221036642
STAT,1837,46,35-39,1883,0.20521303425543336
STAT,1860,49,30-34,1909,0.15544523041724165
STAT,1940,21,30-34,1961,59.15525164611464
SIM,1868,49,40-44,1917,2
SIM,1927,36,45-49,1963,3
SIM,1820,77,na,1897,842
STAT,1844,52,50-100,1896,0.024259803414708445
STAT,1954,15,30-34,1969,30.44461747615383
SIM,1874,0,na,1874,6948
STAT,1888,40,na,1928,5572.749162550221
SIM,1884,21,40-44,1905,5
STAT,1831,35,45-49,1866,3.330205564648795
STAT,1914,34,na,1948,7624.204212081955
STAT,1933,23,15-19,1956,14.257204902853534
SIM,1850,50,na,1900,3512
STAT,1894,15,30-34,1909,4.154342224919256
SIM,1845,34,35-39,1879,29
SIM,1868,63,na,1931,3460
STAT,1869,73,na,1942,2324.360134964814
STAT,1909,19,35-39,1928,1.6538829844165088
SIM,1835,24,30-34,1859,35
SIM,1862,31,30-34,1893,42
STAT,1870,40,15-19,1910,0.02765880583780617
STAT,1882,37,15-19,1919,0.11047829818313777
SIM,1868,37,40-44,1905,9
STAT,1881,3,na,1884,5873.646118367475
SIM,1932,37,30-34,1969,9
SIM,1861,19,25-29,1880,14
STAT,1872,38,35-39,1910,14.284988497352453
STAT,1930,15,45-49,1945,1.31037336201366
SIM,1941,23,15-19,1964,10
STAT,1851,60,na,1911,2956.4767868719637
SIM,1877,23,25-29,1900,124
SIM,1895,47,45-49,1942,1
SIM,1909,24,25-29,1933,194
STAT,1898,47,20-24,1945,0.0184140205754041
SIM,1837,32,50-100,1869,5
SIM,1877,35,25-29,1912,9
STAT,1890,31,35-39,1921,25.0668188205347
SIM,1880,38,35-39,1918,27
STAT,1836,22,15-19,1858,5.790187795374124
STAT,1869,35,25-29,1904,5.687925506010444
STAT,1871,15,na,1886,5161.01317700739
SIM,1930,20,35-39,1950,34
STAT,1933,35,15-19,1968,0.05292285151493715
SIM,1903,25,35-39,1928,39
STAT,1843,65,na,1908,2367.329435031511
STAT,1830,27,40-44,1857,6.912102713767595
STAT,1924,37,30-34,1961,4.3392585173882585
SIM,1919,15,na,1934,8800
STAT,1910,43,30-34,1953,0.24264467382577692
STAT,1853,19,25-29,1872,10.658723509130496
STAT,1815,46,15-19,1861,0.0021836646709062608
SIM,1863,35,30-34,1898,12
SIM,1883,43,50-100,1926,5
STAT,1823,40,35-39,1863,6.339712619422751
STAT,1926,22,na,1948,8958.51645994566
STAT,1909,30,45-49,1939,3.05872379178245
SIM,1935,24,35-39,1959,31
SIM,1823,48,50-100,1871,3
SIM,1880,26,35-39,1906,1
STAT,1867,22,45-49,1889,1.324364616663908
STAT,1902,49,na,1951,6282.300827648885
SIM,1918,24,35-39,1942,26
STAT,1820,53,30-34,1873,0.020883310074007372
SIM,1825,83,na,1908,362
SIM,1767,87,na,1854,70
STAT,1907,55,na,1962,6406.468095674719
STAT,1919,36,45-49,1955,1.4801587847706867
STAT,1887,24,20-24,1911,154.68458373143847
SIM,1824,36,na,1860,3501
SIM,1827,48,40-44,1875,2
STAT,1826,110,na,1936,3.3080571906839E-4
SIM,1788,86,na,1874,102
SIM,1960,6,na,1966,10825
SIM,1773,81,na,1854,308
STAT,1902,44,50-100,1946,0.2063574382980357
STAT,1837,34,35-39,1871,17.337264559887263
STAT,1868,51,50-100,1919,0.0291591830006012
STAT,1936,36,45-49,1972,1.3531488104680662
SIM,1895,24,20-24,1919,192
STAT,1811,53,20-24,1864,0.0046833862674577
SIM,1853,24,15-19,1877,4
SIM,1845,35,na,1880,4126
SIM,1858,23,20-24,1881,124
STAT,1848,49,15-19,1897,6.421880222460113E-4
SIM,1919,35,40-44,1954,5
STAT,1895,25,na,1920,6323.056081976346
STAT,1920,34,na,1954,8293.023094666849
STAT,1894,40,na,1934,6056.777632182934
STAT,1877,37,40-44,1914,9.180315934377747
SIM,1876,25,30-34,1901,73
STAT,1919,5,na,1924,8971.8589637935
SIM,1891,36,20-24,1927,1
STAT,1946,23,25-29,1969,207.51081907830866
STAT,1872,33,40-44,1905,8.765262989879874
STAT,1935,20,45-49,1955,3.0971810398831123
STAT,1925,47,25-29,1972,0.1297910713435
SIM,1794,80,na,1874,425
STAT,1916,35,15-19,1951,0.04009338027723943
SIM,1844,50,na,1894,3109
SIM,1828,33,20-24,1861,1
SIM,1881,53,45-49,1934,1
SIM,1944,26,35-39,1970,39
STAT,1931,16,40-44,1947,3.7066945521729386
STAT,1858,22,35-39,1880,10.54134531895154
SIM,1907,46,50-100,1953,2
SIM,1836,21,na,1857,3681
SIM,1894,27,40-44,1921,8
STAT,1916,47,15-19,1963,7.630680508563196E-4
STAT,1941,15,20-24,1956,282.1912832410231
SIM,1952,17,na,1969,9110
STAT,1857,85,na,1942,431.54157935778994
STAT,1883,48,20-24,1931,0.023512091814194214
STAT,1858,9,na,1867,4480.711743419049
STAT,1873,53,45-49,1926,0.029302133606614027
STAT,1866,48,20-24,1914,0.02208078124515454
STAT,1927,24,35-39,1951,23.27921031494501
SIM,1848,24,40-44,1872,5
SIM,1813,42,40-44,1855,9
SIM,1818,36,30-34,1854,14
SIM,1838,56,na,1894,2837
STAT,1859,52,50-100,1911,0.02414826485759299
SIM,1885,27,30-34,1912,70
SIM,1905,34,35-39,1939,29
SIM,1918,30,na,1948,8384
SIM,1830,35,35-39,1865,14
SIM,1827,36,40-44,1863,13
STAT,1877,27,30-34,1904,52.81042762738745
SIM,1899,55,na,1954,5681
STAT,1822,35,35-39,1857,30.756901969686048
STAT,1886,39,40-44,1925,9.238656274026045
SIM,1867,25,20-24,1892,24
SIM,1894,39,40-44,1933,15
SIM,1937,6,na,1943,8047
STAT,1851,94,na,1945,30.982070377875505
STAT,1864,33,na,1897,4289.850105136022
SIM,1857,20,na,1877,4402
STAT,1916,45,25-29,1961,0.1103990573572516
SIM,1782,95,na,1877,1
STAT,1907,33,15-19,1940,0.24170015247299806
STAT,1874,26,na,1900,4952.062809688918
STAT,1819,48,40-44,1867,0.7077101747456008
STAT,1836,24,50-100,1860,0.7054808224668229
STAT,1835,20,40-44,1855,4.420827443184501
STAT,1911,22,50-100,1933,1.260692048979828
STAT,1825,47,20-24,1872,0.02602253416720457
STAT,1945,26,45-49,1971,3.8293257359353903
STAT,1842,47,20-24,1889,0.01786875873709158
STAT,1901,31,20-24,1932,7.673776760394858
SIM,1862,78,na,1940,1302
STAT,1929,21,50-100,1950,1.6854110318912345
STAT,1831,32,40-44,1863,7.316008542586188
STAT,1886,27,40-44,1913,6.386370194575153
STAT,1862,19,35-39,1881,0.9755811719238564
STAT,1907,45,15-19,1952,6.764380986579652E-4
SIM,1805,50,35-39,1855,1
SIM,1919,21,15-19,1940,11
SIM,1937,30,30-34,1967,26
SIM,1943,20,45-49,1963,5
SIM,1883,77,na,1960,2227
STAT,1864,41,35-39,1905,3.283871114885091
STAT,1887,30,15-19,1917,0.3242550348394651
STAT,1802,80,na,1882,572.5467014125743
STAT,1942,5,na,1947,8424.86736316731
STAT,1881,9,na,1890,5064.934682109948
SIM,1909,34,35-39,1943,27
SIM,1849,22,35-39,1871,13
STAT,1819,36,40-44,1855,27.39867728134384
STAT,1929,42,30-34,1971,0.33434426418235197
SIM,1835,29,25-29,1864,88
SIM,1814,43,na,1857,2844
SIM,1870,19,35-39,1889,1
STAT,1841,36,15-19,1877,0.09699711644357097
SIM,1912,22,40-44,1934,6
SIM,1880,33,40-44,1913,17
STAT,1877,17,20-24,1894,37.179535075689934
SIM,1844,36,40-44,1880,7
STAT,1831,37,35-39,1868,11.566900744693516
SIM,1869,47,35-39,1916,1
SIM,1904,30,35-39,1934,46
STAT,1827,103,na,1930,0.17354329831464746
STAT,1859,25,20-24,1884,19.46216527991859
SIM,1927,28,50-100,1955,3
STAT,1867,78,na,1945,1477.831898408007
STAT,1932,18,15-19,1950,121.05873494709265
STAT,1827,72,na,1899,1527.1359489350534
STAT,1910,33,20-24,1943,4.731582517475201
SIM,1859,21,15-19,1880,7
SIM,1872,37,50-100,1909,5
SIM,1872,41,35-39,1913,5
STAT,1850,13,na,1863,4452.495912467719
SIM,1940,18,15-19,1958,93
SIM,1943,16,40-44,1959,6
STAT,1946,19,20-24,1965,303.46819344415377
SIM,1843,20,40-44,1863,5
STAT,1816,45,20-24,1861,0.06079637137801926
STAT,1915,37,20-24,1952,0.5378670270558119
SIM,1958,0,na,1958,10862
STAT,1853,17,35-39,1870,1.044350086459028
STAT,1844,13,na,1857,4878.350152392045
STAT,1847,53,35-39,1900,0.012912442850554606
STAT,1845,38,40-44,1883,7.014170193647739
STAT,1892,38,20-24,1930,1.939267367394586
STAT,1897,41,30-34,1938,0.2165019864102496
SIM,1925,18,na,1943,8934
STAT,1882,55,na,1937,4068.0127970801564
SIM,1952,18,50-100,1970,1
STAT,1835,53,50-100,1888,0.019552134606536428
STAT,1846,46,45-49,1892,0.3625096730051812
SIM,1932,39,20-24,1971,2
STAT,1904,22,40-44,1926,6.040419436153675
SIM,1901,45,50-100,1946,1
STAT,1847,103,na,1950,0.21876595000204013
STAT,1931,32,45-49,1963,4.164404604113669
SIM,1822,72,na,1894,1383
STAT,1840,20,na,1860,3981.777388051324
STAT,1846,23,20-24,1869,129.3038106974815
SIM,1875,22,45-49,1897,1
STAT,1899,42,50-100,1941,0.20275341209610015
SIM,1861,17,35-39,1878,2
SIM,1900,57,na,1957,5863
SIM,1913,26,40-44,1939,15
STAT,1908,45,50-100,1953,0.41946481268979496
SIM,1946,17,na,1963,8618
STAT,1812,73,na,1885,1189.6543524936358
STAT,1888,77,na,1965,2727.1598208681917
SIM,1820,43,na,1863,2955
STAT,1964,7,na,1971,9996.287594202335
STAT,1878,47,35-39,1925,0.2939253822048223
STAT,1915,25,20-24,1940,37.86069283322483
STAT,1935,16,40-44,1951,3.871976397565029
SIM,1819,44,35-39,1863,6
SIM,1918,36,35-39,1954,10
STAT,1836,36,40-44,1872,7.220256113981851
STAT,1883,36,20-24,1919,1.5369368499480727
SIM,1853,38,40-44,1891,9
STAT,1831,25,35-39,1856,17.289565685040326
STAT,1807,58,na,1865,2329.903767247403
STAT,1911,41,25-29,1952,0.1384829927469542
STAT,1929,30,30-34,1959,40.45940961766458
STAT,1832,52,45-49,1884,0.019679946595652205
STAT,1865,12,na,1877,4960.048484439575
STAT,1905,26,40-44,1931,8.779410697779277
STAT,1924,39,20-24,1963,0.6262769502077653
SIM,1854,23,20-24,1877,131
STAT,1837,34,na,1871,3709.339134710343
STAT,1880,4,na,1884,6077.152247342016
SIM,1878,46,30-34,1924,1
SIM,1912,15,35-39,1927,2
STAT,1884,42,50-100,1926,2.1042569249842837
SIM,1892,42,50-100,1934,7
STAT,1806,52,35-39,1858,0.05023598744859315
SIM,1854,49,na,1903,3664
SIM,1877,77,na,1954,1521
SIM,1876,7,na,1883,5824
STAT,1862,29,45-49,1891,1.9029082800597863
STAT,1887,44,40-44,1931,5.0120685822662505
SIM,1881,36,50-100,1917,3
STAT,1933,39,30-34,1972,5.003498821128634
SIM,1813,95,na,1908,6
STAT,1920,9,na,1929,9018.149732170203
SIM,1928,29,20-24,1957,51
STAT,1899,23,35-39,1922,16.0976864901245
STAT,1847,50,30-34,1897,0.009204113394911454
SIM,1836,44,35-39,1880,8
STAT,1842,45,50-100,1887,0.3752058521385824
SIM,1854,46,45-49,1900,2
SIM,1940,25,20-24,1965,44
STAT,1827,106,na,1933,0.014682148932191622
STAT,1897,48,15-19,1945,6.014749127859377E-4
SIM,1886,37,25-29,1923,5
SIM,1904,24,40-44,1928,6
STAT,1913,27,45-49,1940,3.4774581004810075
SIM,1903,15,25-29,1918,23
STAT,1887,49,35-39,1936,0.17465615428046147
STAT,1836,26,30-34,1862,43.64708448848427
STAT,1815,52,45-49,1867,0.07470876245087012
STAT,1910,26,15-19,1936,1.3820139852313105
STAT,1932,25,20-24,1957,48.332463756059404
SIM,1943,19,45-49,1962,1
STAT,1844,17,25-29,1861,11.632845306744375
STAT,1853,27,na,1880,3965.079479144405
SIM,1817,54,na,1871,2600
STAT,1926,43,50-100,1969,0.2919864426819436
SIM,1795,68,na,1863,1469
SIM,1852,17,25-29,1869,12
STAT,1861,53,na,1914,3561.378122776093
SIM,1889,62,na,1951,4513
STAT,1859,18,15-19,1877,11.008399612250797
SIM,1930,26,40-44,1956,17
STAT,1882,43,45-49,1925,2.923214610192478
STAT,1868,26,na,1894,4601.504532679019
STAT,1891,42,40-44,1933,5.6081388857912255
SIM,1894,23,25-29,1917,168
SIM,1899,32,40-44,1931,14
SIM,1869,34,20-24,1903,8
SIM,1926,16,40-44,1942,6
STAT,1863,23,20-24,1886,123.36621811616618
STAT,1876,16,25-29,1892,11.866072746773353
STAT,1891,66,na,1957,4197.578332299189
STAT,1803,100,na,1903,0.7492323927043456
STAT,1848,71,na,1919,2188.6822352915315
SIM,1805,69,na,1874,1456
STAT,1904,15,35-39,1919,1.5979549818188523
SIM,1921,27,45-49,1948,7
STAT,1909,29,45-49,1938,3.3124809305820735
SIM,1890,30,30-34,1920,51
SIM,1847,61,na,1908,2772
STAT,1922,26,40-44,1948,10.68564633880501
STAT,1935,19,45-49,1954,1.3720626352894565
STAT,1964,4,na,1968,10001.387447729237
SIM,1946,20,50-100,1966,2
STAT,1810,46,30-34,1856,0.6437280181439499
STAT,1873,43,35-39,1916,3.689048732257583
SIM,1882,49,25-29,1931,1
SIM,1890,43,45-49,1933,9
SIM,1960,9,na,1969,10820
STAT,1909,16,30-34,1925,4.841901541854577
SIM,1859,27,20-24,1886,24
SIM,1917,16,30-34,1933,7
STAT,1872,23,30-34,1895,36.042595809077056
STAT,1884,81,na,1965,1654.7450137023989
SIM,1874,63,na,1937,3350
STAT,1895,35,35-39,1930,18.79008913088134
STAT,1834,20,na,1854,3610.805472920255
STAT,1932,22,na,1954,9677.693348851713
STAT,1938,20,50-100,1958,1.3163384331292631
SIM,1827,32,25-29,1859,23
STAT,1789,90,na,1879,63.03916218018104
SIM,1919,41,35-39,1960,1
STAT,1873,36,50-100,1909,2.531523049370606
SIM,1881,43,35-39,1924,6
STAT,1896,49,45-49,1945,0.34755328750684455
SIM,1903,31,50-100,1934,5
SIM,1869,48,na,1917,4274
SIM,1872,31,25-29,1903,23
STAT,1866,17,45-49,1883,0.12494304624196641
SIM,1850,45,50-100,1895,4
STAT,1828,44,35-39,1872,3.3015143851391358
SIM,1835,27,35-39,1862,25
SIM,1822,34,30-34,1856,38
STAT,1831,46,na,1877,3155.108403160138
STAT,1935,19,50-100,1954,1.029046976467092
SIM,1876,21,15-19,1897,9
SIM,1839,15,35-39,1854,1
STAT,1941,3,na,1944,8389.351042736902
STAT,1882,30,30-34,1912,34.62630168561859
STAT,1910,41,na,1951,7132.261246270764
SIM,1858,31,40-44,1889,14
STAT,1857,46,20-24,1903,0.01894399716906197
STAT,1769,110,na,1879,0.0025891181785115073
STAT,1919,40,na,1959,8149.2448952283685
SIM,1931,21,30-34,1952,95
STAT,1936,26,35-39,1962,29.03727944983024
SIM,1871,89,na,1960,229
SIM,1855,30,50-100,1885,2
SIM,1830,25,25-29,1855,74
SIM,1926,20,45-49,1946,2
STAT,1878,37,25-29,1915,6.073092566769678
STAT,1800,88,na,1888,102.81352731251849
STAT,1803,99,na,1902,1.3365545653608744
SIM,1863,38,35-39,1901,16
STAT,1894,18,35-39,1912,1.4198395013105332
STAT,1929,40,40-44,1969,0.6559457085231345
STAT,1896,30,25-29,1926,27.530701193508627
STAT,1850,16,na,1866,4326.294202735833
STAT,1868,21,15-19,1889,6.385006078273236
SIM,1832,47,50-100,1879,1
SIM,1866,22,35-39,1888,15
STAT,1881,25,30-34,1906,49.49061298485595
STAT,1832,42,35-39,1874,2.8880942489102965
STAT,1865,37,15-19,1902,0.10303302099587622
SIM,1828,94,na,1922,20
STAT,1928,35,40-44,1963,3.8269227815700453
SIM,1861,90,na,1951,89
STAT,1889,25,na,1914,5983.317829964727
SIM,1900,22,15-19,1922,9
STAT,1836,86,na,1922,295.00283967495005
SIM,1868,33,25-29,1901,6
SIM,1798,79,na,1877,526
STAT,1824,47,50-100,1871,0.5948075119583223
STAT,1827,27,35-39,1854,57.45703915716184
STAT,1923,21,30-34,1944,67.72161266636317
STAT,1790,87,na,1877,105.97800708233987
SIM,1928,33,25-29,1961,31
STAT,1947,21,na,1968,8337.59264762791
SIM,1851,38,na,1889,3731
SIM,1898,15,40-44,1913,1
STAT,1868,25,30-34,1893,48.71596286632969
SIM,1927,33,40-44,1960,10
STAT,1892,48,30-34,1940,0.1363185587859192
SIM,1862,34,35-39,1896,20
SIM,1819,46,25-29,1865,1
SIM,1835,76,na,1911,1124
STAT,1846,33,30-34,1879,31.27733584027425
SIM,1867,18,15-19,1885,12
SIM,1840,42,35-39,1882,13
SIM,1886,21,50-100,1907,1
SIM,1888,15,na,1903,5953
STAT,1856,53,45-49,1909,0.02225068031051745
SIM,1924,30,na,1954,9267
SIM,1870,29,45-49,1899,4
SIM,1849,32,45-49,1881,4
SIM,1895,44,40-44,1939,1
STAT,1770,111,na,1881,0.0020669286487534867
SIM,1914,28,15-19,1942,3
STAT,1906,28,15-19,1934,1.3305212817654488
STAT,1818,98,na,1916,3.332817864681015
SIM,1868,100,na,1968,5
SIM,1844,26,30-34,1870,57
SIM,1893,30,na,1923,6331
STAT,1925,40,na,1965,9104.40249039138
SIM,1868,30,20-24,1898,8
STAT,1807,48,15-19,1855,0.0026999707076491176
STAT,1840,37,45-49,1877,3.4033538262317915
STAT,1871,28,40-44,1899,5.989486487261883
STAT,1846,48,35-39,1894,0.21174484149210102
STAT,1876,52,na,1928,4473.721907995654
STAT,1865,52,40-44,1917,0.019213419294876365
SIM,1866,34,na,1900,4600
SIM,1858,26,25-29,1884,84
SIM,1904,16,na,1920,7445
STAT,1883,50,35-39,1933,0.01732821289032991
STAT,1838,31,50-100,1869,1.5569756409553215
STAT,1925,44,20-24,1969,0.04302953121139368
STAT,1857,1,na,1858,5873.555946126283
SIM,1931,31,40-44,1962,10
SIM,1853,22,25-29,1875,124
SIM,1865,89,na,1954,136
STAT,1850,41,40-44,1891,3.4643514012717964
SIM,1853,6,na,1859,5031
SIM,1905,31,30-34,1936,34
SIM,1831,49,45-49,1880,1
STAT,1795,90,na,1885,66.08547277261337
SIM,1918,29,50-100,1947,3
STAT,1829,45,30-34,1874,0.15678664402664327
SIM,1836,24,15-19,1860,4
STAT,1881,38,45-49,1919,3.8721464896811932
SIM,1936,35,40-44,1971,3
SIM,1906,47,30-34,1953,1
STAT,1898,16,45-49,1914,0.17897061486580776
STAT,1904,41,na,1945,6753.2393407289055
STAT,1895,49,50-100,1944,0.356970861687661
SIM,1846,31,50-100,1877,3
SIM,1859,37,30-34,1896,13
SIM,1862,75,na,1937,1736
STAT,1922,20,35-39,1942,21.931828932769633
STAT,1774,91,na,1865,25.677561904546472
SIM,1918,26,25-29,1944,174
STAT,1837,31,30-34,1868,30.836347322002084
STAT,1910,46,35-39,1956,0.2436368749595563
SIM,1854,33,30-34,1887,35
SIM,1843,23,45-49,1866,2
SIM,1913,22,25-29,1935,230
STAT,1905,18,20-24,1923,51.645485080641315
STAT,1900,19,15-19,1919,16.537219073350702
SIM,1887,42,25-29,1929,2
STAT,1822,32,na,1854,3195.085112533685
STAT,1871,18,30-34,1889,3.199819033560698
SIM,1848,27,45-49,1875,1
STAT,1814,47,45-49,1861,1.222628750361902
STAT,1854,34,35-39,1888,15.57143239420549
STAT,1825,46,na,1871,3021.029364966978
STAT,1791,104,na,1895,0.026322096298605546
STAT,1828,34,25-29,1862,21.623716005742672
STAT,1904,30,50-100,1934,2.6773063354742916
SIM,1914,38,25-29,1952,5
STAT,1857,45,50-100,1902,0.3904772292813269
STAT,1845,22,25-29,1867,109.5092643496534
STAT,1824,61,na,1885,2111.4527811366406
STAT,1839,97,na,1936,8.388371384669385
STAT,1916,42,20-24,1958,0.03655066901788076
SIM,1899,17,15-19,1916,13
STAT,1946,20,20-24,1966,250.05731733767982
SIM,1877,74,na,1951,2043
STAT,1896,36,30-34,1932,14.279335085518085
STAT,1880,1,na,1881,7237.898705888409
SIM,1856,75,na,1931,1612
STAT,1833,72,na,1905,1660.2367551568773
STAT,1823,49,45-49,1872,0.7087489849140731
SIM,1818,49,45-49,1867,1
STAT,1837,31,na,1868,3826.7080024944125
SIM,1818,39,35-39,1857,17
SIM,1897,1,na,1898,7414
STAT,1846,43,40-44,1889,3.4425558532575318
SIM,1898,73,na,1971,4035
SIM,1862,24,25-29,1886,130
STAT,1931,22,35-39,1953,24.66497224444422
SIM,1810,84,na,1894,290
STAT,1847,30,50-100,1877,1.6742822224114255
STAT,1846,45,na,1891,3480.457809472477
SIM,1845,31,30-34,1876,35
STAT,1833,48,25-29,1881,0.07982419071152277
STAT,1876,24,45-49,1900,1.4474883411698811
SIM,1878,40,25-29,1918,2
SIM,1854,43,40-44,1897,5
STAT,1879,66,na,1945,3462.3714199183078
SIM,1904,20,25-29,1924,169
STAT,1840,19,15-19,1859,10.960592160814857
SIM,1839,25,45-49,1864,5
SIM,1900,28,20-24,1928,36
SIM,1841,76,na,1917,1173
SIM,1894,15,na,1909,6856
SIM,1927,44,na,1971,9631
SIM,1801,70,na,1871,1298
STAT,1879,52,35-39,1931,0.018089624746142025
STAT,1839,60,na,1899,2977.9244030102736
STAT,1854,24,25-29,1878,101.6357886792114
STAT,1863,36,35-39,1899,12.564406106662107
SIM,1876,28,35-39,1904,24
SIM,1912,25,45-49,1937,6
STAT,1886,23,25-29,1909,121.66723919468109
SIM,1842,24,na,1866,3849
STAT,1907,49,30-34,1956,0.1595511566410496
STAT,1843,52,20-24,1895,0.0010281876856463134
SIM,1917,29,45-49,1946,6
STAT,1802,54,25-29,1856,0.02180375728346345
STAT,1887,34,30-34,1921,39.100230344294395
SIM,1831,30,25-29,1861,29
SIM,1863,23,na,1886,4425
STAT,1810,47,na,1857,2648.4740895507266
STAT,1920,37,na,1957,8317.244112897271
STAT,1937,31,35-39,1968,18.273775468728065
SIM,1870,16,30-34,1886,5
STAT,1940,24,35-39,1964,19.36027826741587
SIM,1836,34,25-29,1870,23
STAT,1824,51,40-44,1875,0.025049001513271413
SIM,1936,25,30-34,1961,74
SIM,1885,17,20-24,1902,39
STAT,1890,21,25-29,1911,141.54541087843342
SIM,1895,34,30-34,1929,67
STAT,1830,61,na,1891,2580.3673356088857
SIM,1912,45,na,1957,7354
STAT,1780,91,na,1871,33.25863149515192
SIM,1895,20,50-100,1915,4
STAT,1895,25,25-29,1920,112.07695447763697
STAT,1901,34,25-29,1935,28.711681200505097
STAT,1906,38,25-29,1944,1.8198196585748436
SIM,1844,16,20-24,1860,29
STAT,1838,51,35-39,1889,0.011821339094557565
STAT,1945,23,40-44,1968,7.439452740128448
SIM,1789,68,na,1857,1447
SIM,1913,18,20-24,1931,50
STAT,1819,46,na,1865,2856.592869632051
STAT,1835,23,45-49,1858,1.1924333017902573
STAT,1891,34,50-100,1925,2.267716052466028
SIM,1904,39,45-49,1943,4
SIM,1859,89,na,1948,116
STAT,1874,49,25-29,1923,0.1166249266649505
STAT,1919,23,30-34,1942,63.35199120247917
STAT,1836,39,45-49,1875,3.1872103708473576
STAT,1923,31,40-44,1954,9.094619338351333
SIM,1819,41,30-34,1860,4
SIM,1874,44,50-100,1918,4
STAT,1840,24,30-34,1864,32.228862600617056
STAT,1868,28,50-100,1896,1.2248590726600068
SIM,1937,9,na,1946,7992
STAT,1904,25,45-49,1929,3.2403149787113183
STAT,1864,67,na,1931,2861.8087988222633
STAT,1878,32,30-34,1910,36.82779379719183
SIM,1927,23,30-34,1950,92
STAT,1876,21,40-44,1897,4.365925808792797
SIM,1881,29,20-24,1910,23
SIM,1845,36,25-29,1881,10
STAT,1905,22,25-29,1927,167.20187543750853
STAT,1870,67,na,1937,3143.2131153301716
STAT,1866,44,50-100,1910,1.942103229809552
SIM,1844,39,45-49,1883,8
SIM,1864,40,30-34,1904,1
SIM,1867,28,25-29,1895,11
STAT,1872,36,45-49,1908,4.065735595276081
SIM,1899,8,na,1907,7304
SIM,1928,29,na,1957,9370
SIM,1802,55,na,1857,2355
STAT,1890,81,na,1971,2266.359660808451
STAT,1936,16,25-29,1952,84.01447239243792
SIM,1886,32,30-34,1918,7
STAT,1920,40,20-24,1960,0.03949239695315381
SIM,1857,23,na,1880,4680
SIM,1804,84,na,1888,157
SIM,1813,45,45-49,1858,1
STAT,1885,66,na,1951,3294.895834335612
SIM,1897,29,na,1926,6430
STAT,1837,36,25-29,1873,4.937956190668695
STAT,1862,16,30-34,1878,3.16978087581727
STAT,1935,36,na,1971,10636.374079859183
STAT,1781,107,na,1888,0.01612957734851947
SIM,1834,21,45-49,1855,2
SIM,1918,21,30-34,1939,79
SIM,1944,16,25-29,1960,105
SIM,1828,43,30-34,1871,3
SIM,1880,36,45-49,1916,6
STAT,1859,28,25-29,1887,68.67614701182501
STAT,1880,35,30-34,1915,11.446754352569334
STAT,1958,12,na,1970,10417.85342716987
STAT,1843,36,na,1879,3539.1193647657847
STAT,1914,48,30-34,1962,0.17809071505783122
STAT,1866,27,20-24,1893,21.86132158502048
STAT,1885,44,20-24,1929,0.3149518041522168
STAT,1879,33,40-44,1912,9.12255402779661
SIM,1926,15,15-19,1941,109
SIM,1926,11,na,1937,10095
SIM,1934,30,na,1964,10302
SIM,1888,20,na,1908,5544
STAT,1882,43,40-44,1925,4.393251025847247
SIM,1864,48,45-49,1912,2
STAT,1827,73,na,1900,1436.2713599734177
SIM,1888,29,50-100,1917,2
SIM,1925,22,45-49,1947,4
SIM,1844,44,25-29,1888,2
STAT,1877,25,30-34,1902,53.16871090884104
STAT,1926,20,45-49,1946,2.776719756595554
SIM,1785,77,na,1862,503
SIM,1841,43,45-49,1884,5
SIM,1899,35,50-100,1934,8
STAT,1843,34,15-19,1877,0.23489278179399636
STAT,1845,42,25-29,1887,1.007649287264792
STAT,1866,39,15-19,1905,0.10358970300272209
STAT,1865,46,45-49,1911,0.43424486343742863
SIM,1830,81,na,1911,564
SIM,1945,20,20-24,1965,252
SIM,1836,25,35-39,1861,17
STAT,1769,94,na,1863,5.266086707406096
SIM,1865,29,20-24,1894,20
SIM,1885,25,30-34,1910,68
STAT,1929,21,25-29,1950,236.59797594217812
SIM,1842,54,50-100,1896,1
SIM,1928,23,25-29,1951,244
STAT,1861,18,30-34,1879,3.061416019553894
SIM,1800,83,na,1883,206
STAT,1856,48,45-49,1904,0.3631230257240823
SIM,1834,95,na,1929,5
STAT,1824,50,40-44,1874,0.025552050959640516
STAT,1870,16,30-34,1886,3.2093766784205497
SIM,1853,22,30-34,1875,42
SIM,1873,46,45-49,1919,1
SIM,1890,43,40-44,1933,13
SIM,1915,49,50-100,1964,1
SIM,1929,37,50-100,1966,5
SIM,1878,35,40-44,1913,14
STAT,1836,44,25-29,1880,0.9902352014675209
STAT,1820,34,20-24,1854,17.38700758990578
SIM,1887,33,40-44,1920,14
STAT,1815,52,40-44,1867,0.054195508982729054
STAT,1818,37,na,1855,3086.3199796797926
SIM,1909,31,na,1940,7419
SIM,1854,29,45-49,1883,6
STAT,1896,45,35-39,1941,0.2126715827707673
STAT,1873,45,40-44,1918,0.3548144377097054
SIM,1870,31,20-24,1901,6
SIM,1881,45,40-44,1926,1
SIM,1826,76,na,1902,1015
SIM,1871,26,40-44,1897,12
SIM,1917,30,50-100,1947,1
STAT,1863,38,35-39,1901,12.442201657308193
SIM,1853,42,25-29,1895,1
STAT,1852,72,na,1924,2012.8148226803194
SIM,1906,24,50-100,1930,1
STAT,1863,26,40-44,1889,5.334158685017976
STAT,1854,28,40-44,1882,4.77951706437739
SIM,1862,28,40-44,1890,6
STAT,1847,50,35-39,1897,0.013311734254871432
STAT,1838,52,35-39,1890,0.011589522634913293
STAT,1813,44,30-34,1857,7.547948841411178
SIM,1951,10,na,1961,9798
SIM,1821,44,30-34,1865,7
SIM,1900,18,na,1918,7398
STAT,1872,36,35-39,1908,14.425292376153553
STAT,1881,53,na,1934,4135.672119800825
SIM,1793,96,na,1889,1
STAT,1885,67,na,1952,3186.7573530527175
STAT,1845,22,30-34,1867,34.07440267621936
SIM,1894,18,35-39,1912,2
SIM,1917,50,na,1967,7846
STAT,1822,42,30-34,1864,3.869046259728067
STAT,1846,29,45-49,1875,2.0279420034913054
SIM,1837,22,50-100,1859,3
STAT,1856,86,na,1942,345.7354971078244
STAT,1872,24,40-44,1896,4.2031132363793855
SIM,1871,38,35-39,1909,22
STAT,1895,16,35-39,1911,1.4475462321157062
SIM,1894,23,30-34,1917,63
STAT,1835,28,30-34,1863,42.220131443619756
SIM,1892,15,20-24,1907,46
SIM,1936,22,20-24,1958,190
SIM,1834,40,50-100,1874,3
SIM,1938,30,30-34,1968,37
STAT,1886,18,35-39,1904,1.166751460802367
STAT,1837,36,40-44,1873,7.507619582693376
STAT,1892,37,na,1929,5956.60741380485
STAT,1875,37,15-19,1912,0.11676507646444284
STAT,1879,53,35-39,1932,0.017894437695131164
STAT,1889,19,15-19,1908,14.699159707001504
STAT,1880,22,25-29,1902,121.79421849461181
STAT,1858,28,25-29,1886,67.68873636155801
STAT,1825,38,15-19,1863,0.14217818711054409
STAT,1853,19,35-39,1872,1.0320838731381758
STAT,1859,37,30-34,1896,8.567238646334538
STAT,1861,38,25-29,1899,4.81594844929147
SIM,1919,30,20-24,1949,7
STAT,1899,46,15-19,1945,6.261308037935765E-4
SIM,1842,16,20-24,1858,41
SIM,1877,26,35-39,1903,23
STAT,1877,48,na,1925,4658.986785371201
STAT,1894,37,25-29,1931,7.469779983571027
STAT,1843,47,20-24,1890,0.016731445052458663
STAT,1857,29,20-24,1886,18.749756439739773
STAT,1871,37,30-34,1908,10.693877861792043
SIM,1919,25,25-29,1944,169
STAT,1792,70,na,1862,1320.9097265730209
STAT,1881,85,na,1966,1033.0265972628513
SIM,1910,28,na,1938,7506
STAT,1844,43,20-24,1887,0.2593236923311754
SIM,1897,19,15-19,1916,12
STAT,1856,53,40-44,1909,0.0161411714647729
STAT,1816,51,45-49,1867,0.06978167976067409
SIM,1827,32,30-34,1859,41
STAT,1827,46,25-29,1873,0.10542315626555122
STAT,1848,67,na,1915,2599.2931611367203
SIM,1937,21,25-29,1958,210
STAT,1873,34,na,1907,4854.919376304686
SIM,1843,28,30-34,1871,62
SIM,1929,15,40-44,1944,9
STAT,1833,43,45-49,1876,2.3577972301637673
SIM,1856,42,50-100,1898,3
STAT,1886,23,30-34,1909,37.85742261573856
STAT,1827,51,20-24,1878,0.0013120831409594573
STAT,1859,49,25-29,1908,0.09065813894754743
STAT,1878,54,30-34,1932,0.012210442771224898
SIM,1823,47,45-49,1870,1
STAT,1917,22,45-49,1939,2.4149570726812035
STAT,1831,35,35-39,1866,11.815620523520625
STAT,1881,17,45-49,1898,0.12751483878491884
STAT,1871,43,na,1914,4604.036756617999
SIM,1876,27,30-34,1903,60
SIM,1806,88,na,1894,63
STAT,1876,46,20-24,1922,0.02513748567382139
STAT,1823,100,na,1923,1.273975578877922
STAT,1882,38,45-49,1920,3.9025261026515112
STAT,1808,46,15-19,1854,0.002604232020761455
SIM,1821,39,35-39,1860,23
SIM,1890,30,35-39,1920,30
STAT,1867,38,na,1905,4434.0506522804435
SIM,1890,38,45-49,1928,6
SIM,1902,31,50-100,1933,2
STAT,1833,26,na,1859,3774.140622833951
SIM,1840,44,40-44,1884,8
SIM,1939,32,50-100,1971,3
STAT,1892,29,15-19,1921,1.138895773227192
STAT,1894,42,20-24,1936,0.028576567691878815
STAT,1895,49,35-39,1944,0.20348501949519843
STAT,1928,22,20-24,1950,280.3460534602314
STAT,1818,108,na,1926,0.0018792438790455899
SIM,1884,41,50-100,1925,5
STAT,1850,40,40-44,1890,3.483545738289775
STAT,1859,41,15-19,1900,0.022299597634816756
STAT,1902,64,na,1966,5466.119130724871
SIM,1866,28,25-29,1894,83
STAT,1877,45,25-29,1922,0.12200059887676352
SIM,1925,44,50-100,1969,3
STAT,1882,30,35-39,1912,20.084107597787657
STAT,1830,39,35-39,1869,12.888883790104149
STAT,1837,53,30-34,1890,0.008165213081790256
SIM,1856,18,15-19,1874,11
SIM,1872,34,35-39,1906,26
SIM,1901,67,na,1968,5075
STAT,1873,22,50-100,1895,0.8368088050702687
STAT,1894,17,30-34,1911,4.135129808759704
SIM,1872,25,45-49,1897,3
STAT,1899,26,20-24,1925,32.57395538195535
STAT,1818,48,25-29,1866,0.2500391994540905
SIM,1830,38,na,1868,3135
SIM,1863,76,na,1939,1722
STAT,1847,18,na,1865,4341.422483768734
SIM,1938,12,na,1950,7955
STAT,1865,51,40-44,1916,0.019408670520310686
SIM,1874,42,45-49,1916,2
STAT,1835,48,25-29,1883,0.07766849998939611
SIM,1873,18,15-19,1891,11
STAT,1832,44,40-44,1876,3.495989849353613
SIM,1855,57,na,1912,3536
SIM,1861,36,25-29,1897,7
STAT,1855,37,na,1892,3552.6589686736884
SIM,1852,26,30-34,1878,61
SIM,1877,39,40-44,1916,13
STAT,1771,105,na,1876,0.030867842606256725
SIM,1815,92,na,1907,34
STAT,1896,28,45-49,1924,2.950122561610998
SIM,1822,43,35-39,1865,7
SIM,1881,49,50-100,1930,2
SIM,1831,55,na,1886,2818
SIM,1837,60,na,1897,2510
SIM,1857,35,20-24,1892,1
STAT,1805,50,30-34,1855,0.04866526399165592
STAT,1861,30,15-19,1891,0.24131273393573813
STAT,1876,33,15-19,1909,0.2962143335955502
STAT,1850,35,45-49,1885,3.1701113265603063
SIM,1895,37,50-100,1932,4
STAT,1854,15,35-39,1869,1.0181919700463649
STAT,1829,37,45-49,1866,3.484347895257106
STAT,1869,39,40-44,1908,8.480290222854332
STAT,1895,46,30-34,1941,0.14410358953344346
STAT,1865,18,15-19,1883,11.15459996182527
STAT,1872,92,na,1964,222.18347251677542
SIM,1896,71,na,1967,4214
STAT,1838,32,40-44,1870,7.293254626229819
STAT,1864,25,45-49,1889,2.0258651899981155
STAT,1805,62,na,1867,2053.5652616078005
STAT,1813,81,na,1894,480.523794531386
STAT,1855,32,40-44,1887,6.658543753334801
STAT,1876,29,30-34,1905,52.22550390293217
SIM,1868,45,25-29,1913,1
STAT,1844,108,na,1952,0.0029580761345233725
SIM,1826,28,30-34,1854,53
STAT,1849,53,50-100,1902,0.023505931158202657
STAT,1948,21,35-39,1969,21.84037401564438
SIM,1828,39,45-49,1867,9
STAT,1860,26,15-19,1886,0.7575216530367478
SIM,1880,36,35-39,1916,19
SIM,1887,28,45-49,1915,1
SIM,1837,37,45-49,1874,5
SIM,1854,46,35-39,1900,1
STAT,1814,43,35-39,1857,10.089271939002565
STAT,1844,30,15-19,1874,0.28078409406968285
STAT,1884,18,na,1902,5023.545464121459
SIM,1883,30,50-100,1913,4
STAT,1859,54,20-24,1913,0.0011535777852351348
SIM,1852,38,25-29,1890,5
SIM,1879,16,na,1895,5283
STAT,1809,76,na,1885,867.6907983542222
STAT,1937,15,25-29,1952,85.55580857147777
STAT,1869,43,25-29,1912,1.2475846376498552
SIM,1843,88,na,1931,156
STAT,1857,52,45-49,1909,0.022723779899343113
STAT,1871,15,35-39,1886,1.1212734575946692
SIM,1888,52,na,1940,5033
STAT,1849,35,20-24,1884,1.2738767732643348
STAT,1830,31,25-29,1861,20.62875753758626
SIM,1910,45,50-100,1955,2
STAT,1839,28,15-19,1867,0.886047338433382
STAT,1853,36,25-29,1889,4.603019155714776
STAT,1862,16,50-100,1878,0.09743176940681378
SIM,1867,101,na,1968,6
SIM,1841,38,50-100,1879,2
STAT,1840,46,40-44,1886,0.2524109514210765
SIM,1850,26,na,1876,4080
STAT,1881,34,35-39,1915,19.599602884985917
STAT,1879,28,45-49,1907,2.3372338099849386
STAT,1829,54,35-39,1883,0.01147701532867124
STAT,1821,33,25-29,1854,67.30941126629943
SIM,1835,26,30-34,1861,56
SIM,1945,15,25-29,1960,129
SIM,1877,43,25-29,1920,3
STAT,1864,47,40-44,1911,0.30762808925151114
SIM,1906,22,35-39,1928,24
STAT,1844,38,25-29,1882,4.862652501373205
STAT,1932,29,50-100,1961,2.6305732458100453
SIM,1886,29,40-44,1915,9
SIM,1827,27,35-39,1854,4
SIM,1863,41,30-34,1904,4
STAT,1823,46,40-44,1869,0.536567908391162
STAT,1930,28,na,1958,9615.52424068847
SIM,1776,84,na,1860,112
STAT,1867,104,na,1971,1.468488359119227
SIM,1927,15,50-100,1942,1
STAT,1854,40,25-29,1894,0.9943517027963344
SIM,1874,46,50-100,1920,3
STAT,1855,27,45-49,1882,1.7451412540202187
STAT,1841,45,45-49,1886,0.3528994038592361
STAT,1891,41,40-44,1932,5.640458714223729
SIM,1877,23,30-34,1900,46
STAT,1891,36,45-49,1927,5.00045670710818
SIM,1836,38,40-44,1874,12
STAT,1818,40,15-19,1858,0.07332479768777972
STAT,1777,81,na,1858,345.30350170200126
SIM,1846,32,40-44,1878,11
SIM,1863,27,45-49,1890,3
STAT,1801,80,na,1881,559.133392322739
STAT,1892,69,na,1961,4035.7386809339896
SIM,1913,27,50-100,1940,2
SIM,1836,42,25-29,1878,1
STAT,1881,51,25-29,1932,0.006947379320338445
STAT,1885,31,15-19,1916,0.2874515305887709
SIM,1883,40,45-49,1923,3
STAT,1853,41,20-24,1894,0.2524111666076036
STAT,1860,91,na,1951,95.03921956355543
STAT,1890,37,40-44,1927,10.791227033294952
SIM,1861,16,30-34,1877,6
SIM,1884,29,30-34,1913,70
SIM,1893,39,25-29,1932,6
STAT,1845,25,35-39,1870,18.3601746439203
STAT,1819,52,25-29,1871,0.014271117845130304
SIM,1831,46,40-44,1877,1
STAT,1848,18,15-19,1866,11.99187305560211
STAT,1890,24,35-39,1914,14.295313413133425
STAT,1851,36,15-19,1887,0.0889003690973712
STAT,1918,15,15-19,1933,20.104949598552672
SIM,1817,38,30-34,1855,5
STAT,1856,54,na,1910,3262.879558074411
STAT,1892,40,45-49,1932,3.8221306380843822
STAT,1895,29,40-44,1924,7.826874642228574
STAT,1797,58,na,1855,1993.1328699999997
STAT,1834,36,15-19,1870,0.0939488786913413
STAT,1875,40,45-49,1915,3.143442729961414
SIM,1851,75,na,1926,1460
STAT,1880,36,na,1916,5036.638947896026
STAT,1929,31,na,1960,9707.018128575604
STAT,1885,39,25-29,1924,5.729785049943882
SIM,1916,33,na,1949,7938
SIM,1859,24,50-100,1883,5
STAT,1881,47,40-44,1928,0.3326382737434764
STAT,1947,1,na,1948,9361.212513940336
STAT,1828,38,40-44,1866,8.63787488062705
STAT,1838,27,45-49,1865,1.91149295675979
STAT,1851,23,na,1874,3929.7262877943776
STAT,1840,33,35-39,1873,17.620478548356736
SIM,1901,7,na,1908,7426
STAT,1844,26,30-34,1870,50.14281266799965
STAT,1939,31,35-39,1970,18.844090495556383
SIM,1882,41,40-44,1923,11
STAT,1805,94,na,1899,14.94977346391096
STAT,1854,4,na,1858,4887.882780801154
STAT,1829,42,40-44,1871,3.7021871972141147
SIM,1908,14,na,1922,7797
SIM,1832,45,45-49,1877,2
STAT,1874,41,40-44,1915,4.672356904159887
STAT,1942,29,na,1971,7933.0163154260845
STAT,1871,2,na,1873,6646.1405713032655
STAT,1937,20,20-24,1957,218.88285816284895
SIM,1855,89,na,1944,129
SIM,1873,0,na,1873,7470
STAT,1891,26,50-100,1917,1.6023968225028469
STAT,1824,45,45-49,1869,0.5878574007682884
STAT,1835,40,15-19,1875,0.021997077383992883
SIM,1856,2,na,1858,5812
STAT,1807,50,40-44,1857,0.07140532221256234
SIM,1878,44,50-100,1922,6
SIM,1883,17,20-24,1900,17
STAT,1818,53,20-24,1871,0.0030579213148884173
STAT,1946,17,50-100,1963,0.8391807987127312
STAT,1868,87,na,1955,338.5360254866426
SIM,1829,41,na,1870,3306
SIM,1842,39,na,1881,3545
STAT,1954,15,25-29,1969,108.24059680910935
SIM,1831,48,50-100,1879,1
STAT,1864,73,na,1937,2144.2611479684233
STAT,1886,43,25-29,1929,1.3591522621407257
SIM,1843,48,25-29,1891,1
SIM,1845,36,50-100,1881,4
SIM,1846,27,45-49,1873,4
STAT,1940,3,na,1943,8283.878495171846
SIM,1868,33,30-34,1901,9
SIM,1942,1,na,1943,8743
STAT,1854,45,30-34,1899,0.14987258502693435
SIM,1928,19,40-44,1947,4
STAT,1840,30,30-34,1870,31.34007643594202
SIM,1894,26,50-100,1920,2
SIM,1827,44,25-29,1871,2
SIM,1891,44,50-100,1935,1
STAT,1809,50,15-19,1859,1.887673482764664E-4
STAT,1813,47,35-39,1860,0.8637968021688018
SIM,1881,48,45-49,1929,1
SIM,1830,25,40-44,1855,4
STAT,1888,43,35-39,1931,4.291305432410656
STAT,1909,20,45-49,1929,2.1257614710301374
SIM,1871,20,na,1891,4603
SIM,1943,15,15-19,1958,85
STAT,1896,33,40-44,1929,11.514745483290566
SIM,1875,18,25-29,1893,14
STAT,1886,35,25-29,1921,6.196579041679201
STAT,1849,27,20-24,1876,21.99733248535241
SIM,1905,49,na,1954,6651
STAT,1825,41,45-49,1866,3.5322014603080585
SIM,1884,49,25-29,1933,3
STAT,1834,109,na,1943,9.454858221518234E-4
STAT,1834,75,na,1909,1368.0911381141868
SIM,1894,35,25-29,1929,11
SIM,1901,35,na,1936,6790
SIM,1945,23,25-29,1968,7
SIM,1844,41,20-24,1885,4
STAT,1830,44,30-34,1874,2.0038034469051316
STAT,1870,28,25-29,1898,83.58116506788907
STAT,1882,46,45-49,1928,0.4656238654717919
STAT,1869,51,25-29,1920,0.006964669671321625
SIM,1893,27,30-34,1920,91
STAT,1876,41,15-19,1917,0.028977321893856517
STAT,1937,23,25-29,1960,181.64060009584804
SIM,1810,93,na,1903,25
STAT,1867,43,15-19,1910,0.02593156455339119
STAT,1868,55,na,1923,3973.166185673978
SIM,1792,79,na,1871,554
SIM,1857,27,20-24,1884,20
STAT,1873,15,45-49,1888,0.13563856283624703
STAT,1864,17,45-49,1881,0.12199321608750435
SIM,1880,20,25-29,1900,160
STAT,1864,41,na,1905,4191.382666702901
SIM,1871,35,30-34,1906,3
STAT,1873,48,45-49,1921,0.47820018385575164
SIM,1844,73,na,1917,1641
SIM,1848,87,na,1935,241
SIM,1867,90,na,1957,175
STAT,1761,98,na,1859,0.08597965243340164
SIM,1870,22,30-34,1892,50
STAT,1833,58,na,1891,2599.8046330213274
STAT,1910,27,50-100,1937,1.9418897882844894
SIM,1870,34,25-29,1904,25
SIM,1821,47,35-39,1868,1
SIM,1771,85,na,1856,137
STAT,1892,32,45-49,1924,4.408898496988691
SIM,1873,30,35-39,1903,35
STAT,1928,30,20-24,1958,6.1656988868324865
SIM,1886,29,na,1915,4937
STAT,1819,44,25-29,1863,2.784626896919859
STAT,1893,25,15-19,1918,1.169302649108683
SIM,1882,36,45-49,1918,6
STAT,1844,51,20-24,1895,0.0011973780848635754
SIM,1917,20,45-49,1937,1
STAT,1862,47,30-34,1909,0.16631726876328665
SIM,1868,28,35-39,1896,26
SIM,1876,31,15-19,1907,3
STAT,1793,76,na,1869,733.5584727148538
SIM,1859,35,30-34,1894,8
SIM,1880,24,na,1904,5251
SIM,1884,38,na,1922,5038
STAT,1863,24,na,1887,4203.478904918378
SIM,1922,29,na,1951,8887
SIM,1834,34,15-19,1868,1
STAT,1841,50,40-44,1891,0.015494387637562466
SIM,1891,19,20-24,1910,46
STAT,1935,15,15-19,1950,125.90627616771476
STAT,1909,0,na,1909,8898.231605535295
STAT,1873,40,35-39,1913,3.753386189788301
SIM,1890,46,45-49,1936,1
STAT,1853,16,30-34,1869,3.051562101868896
STAT,1878,29,40-44,1907,6.2733851513727545
SIM,1923,22,50-100,1945,1
STAT,1861,35,20-24,1896,1.3081098527872832
SIM,1841,40,40-44,1881,9
STAT,1836,41,20-24,1877,0.254492760569408
SIM,1867,37,30-34,1904,17
STAT,1835,53,20-24,1888,9.553160609441337E-4
STAT,1917,30,na,1947,8062.124881501788
STAT,1838,89,na,1927,142.1759807289639
STAT,1883,19,20-24,1902,34.989599067081706
STAT,1943,20,45-49,1963,2.4192913595509116
SIM,1846,21,na,1867,4113
SIM,1817,40,na,1857,3167
STAT,1826,34,15-19,1860,0.37555430366102865
SIM,1815,45,45-49,1860,1
SIM,1935,9,na,1944,11288
STAT,1876,49,25-29,1925,0.11780616482870634
SIM,1833,41,45-49,1874,8
SIM,1819,38,40-44,1857,14
STAT,1910,51,na,1961,6836.877223529876
SIM,1935,29,50-100,1964,4
STAT,1867,18,25-29,1885,10.892667329054321
STAT,1919,32,20-24,1951,5.3136631047525045
SIM,1864,103,na,1967,1
SIM,1928,20,20-24,1948,279
SIM,1881,40,35-39,1921,4
SIM,1919,22,20-24,1941,242
SIM,1927,32,20-24,1959,8
SIM,1868,49,50-100,1917,2
SIM,1936,30,20-24,1966,5
STAT,1894,45,25-29,1939,0.08513544248610873
STAT,1852,24,15-19,1876,6.156905098706607
SIM,1814,75,na,1889,989
STAT,1821,46,30-34,1867,0.28745559371238505
SIM,1810,61,na,1871,2045
SIM,1867,38,50-100,1905,4
SIM,1842,19,25-29,1861,14
STAT,1804,54,30-34,1858,0.033432752723086004
STAT,1815,40,na,1855,3036.646494574
SIM,1920,35,50-100,1955,2
STAT,1814,40,30-34,1854,7.150789653157598
STAT,1923,38,30-34,1961,4.259336270736894
STAT,1878,65,na,1943,3564.6390831388953
SIM,1835,69,na,1904,1901
SIM,1863,32,40-44,1895,8
STAT,1875,17,20-24,1892,36.86384969999618
SIM,1931,38,30-34,1969,8
STAT,1812,64,na,1876,1977.2999835369544
STAT,1885,27,30-34,1912,50.62307687019205
SIM,1849,28,25-29,1877,89
SIM,1863,44,35-39,1907,10
SIM,1919,33,25-29,1952,28
STAT,1840,16,45-49,1856,0.12280206536554211
STAT,1877,42,20-24,1919,0.33264600606579475
STAT,1872,27,45-49,1899,2.253627224771017
SIM,1861,10,na,1871,5330
SIM,1873,38,45-49,1911,6
STAT,1833,40,40-44,1873,3.682501947434157
SIM,1843,56,na,1899,3046
SIM,1850,58,na,1908,3163
STAT,1945,22,20-24,1967,246.1072578173382
SIM,1924,33,50-100,1957,5
STAT,1877,50,20-24,1927,0.0015697724038364414
STAT,1890,45,40-44,1935,0.4262422003291901
STAT,1818,36,30-34,1854,40.88412167793325
SIM,1824,45,50-100,1869,2
STAT,1832,31,35-39,1863,17.39749225103767
STAT,1800,63,na,1863,1871.3980157779558
STAT,1871,45,30-34,1916,0.19616705021093622
STAT,1816,45,50-100,1861,1.2442990182717395
STAT,1920,22,50-100,1942,1.4770252000000044
STAT,1823,54,40-44,1877,0.030089794579397942
STAT,1804,77,na,1881,705.9577104781052
STAT,1827,54,25-29,1881,0.005400032325357483
SIM,1860,24,15-19,1884,7
STAT,1871,75,na,1946,2065.6311176128543
SIM,1890,35,40-44,1925,19
SIM,1918,21,15-19,1939,12
STAT,1845,17,35-39,1862,1.0686704164083705
STAT,1847,25,45-49,1872,2.063806239201534
STAT,1881,31,30-34,1912,34.222071245284226
SIM,1876,51,na,1927,4693
SIM,1938,33,35-39,1971,26
STAT,1817,95,na,1912,13.410218190913195
STAT,1875,89,na,1964,488.36934538863625
STAT,1895,41,25-29,1936,0.11788250420295501
SIM,1838,34,na,1872,3568
STAT,1870,20,15-19,1890,6.580424430302711
STAT,1934,10,na,1944,10858.235096280714
SIM,1865,21,50-100,1886,1
STAT,1840,49,45-49,1889,0.3348299191675299
SIM,1826,36,30-34,1862,16
STAT,1893,33,15-19,1926,0.36300789318968246
STAT,1854,48,35-39,1902,0.21192153407682718
SIM,1836,22,30-34,1858,31
STAT,1836,32,30-34,1868,29.34970083624218
STAT,1860,34,15-19,1894,0.2315607305912373
SIM,1844,32,30-34,1876,32
STAT,1871,41,15-19,1912,0.027835010009422966
SIM,1839,44,50-100,1883,4
SIM,1865,35,na,1900,4414
SIM,1873,86,na,1959,506
STAT,1769,111,na,1880,0.0016225226889278065
SIM,1856,46,45-49,1902,1
STAT,1819,54,na,1873,2510.55158484546
STAT,1849,52,na,1901,3387.7456583730755
STAT,1938,24,na,1962,7295.518514786253
STAT,1870,33,20-24,1903,5.337080609383299
SIM,1869,49,na,1918,4230
STAT,1820,37,25-29,1857,14.31696896752362
SIM,1878,38,45-49,1916,8
STAT,1866,42,45-49,1908,2.7855249571467797
STAT,1804,50,15-19,1854,1.4975873052545455E-4
SIM,1822,40,30-34,1862,4
SIM,1855,25,45-49,1880,5
STAT,1835,45,20-24,1880,0.01847796910235572
STAT,1846,76,na,1922,1451.146827366663
STAT,1880,27,30-34,1907,53.57633034342768
STAT,1880,18,40-44,1898,0.3881200653419074
STAT,1865,90,na,1955,144.65755840967316
SIM,1869,49,35-39,1918,1
STAT,1842,62,na,1904,2721.1524430308405
STAT,1826,42,15-19,1868,0.029169754446626898
STAT,1832,47,45-49,1879,0.36375992444876265
SIM,1856,74,na,1930,1752
SIM,1850,18,20-24,1868,32
STAT,1773,99,na,1872,0.6420462488712962
STAT,1828,50,25-29,1878,0.0064109355889092005
SIM,1925,30,45-49,1955,7
SIM,1861,33,20-24,1894,6
SIM,1852,60,na,1912,3046
STAT,1924,20,35-39,1944,22.567017097682573
SIM,1900,47,40-44,1947,1
STAT,1872,53,25-29,1925,0.00707393404353754
STAT,1913,16,na,1929,7996.910244916598
STAT,1827,29,35-39,1856,31.04316493865882
STAT,1863,43,30-34,1906,2.017816918074665
STAT,1882,35,40-44,1917,8.694076392169471
STAT,1891,20,35-39,1911,14.654506487015524
STAT,1813,101,na,1914,0.507056604169817
SIM,1822,94,na,1916,11
STAT,1840,41,35-39,1881,2.761733077917078
SIM,1844,25,50-100,1869,1
SIM,1899,9,na,1908,7293
SIM,1930,16,na,1946,10149
SIM,1898,28,20-24,1926,27
STAT,1815,44,40-44,1859,12.59261046830517
SIM,1797,78,na,1875,566
SIM,1837,34,40-44,1871,7
STAT,1867,35,15-19,1902,0.10722082885083395
STAT,1799,92,na,1891,28.32417407475155
STAT,1839,74,na,1913,1732.8553374542855
SIM,1835,29,35-39,1864,20
SIM,1899,68,na,1967,4804
SIM,1909,19,30-34,1928,5
SIM,1763,98,na,1861,2
SIM,1871,43,30-34,1914,6
STAT,1830,40,15-19,1870,0.02545916859324436
SIM,1877,40,20-24,1917,1
STAT,1819,86,na,1905,232.1660653948479
SIM,1823,44,40-44,1867,7
STAT,1849,38,25-29,1887,4.6121220778213425
SIM,1840,47,45-49,1887,2
SIM,1877,33,50-100,1910,4
STAT,1890,15,50-100,1905,0.1213337477103703
SIM,1857,38,25-29,1895,6
STAT,1831,27,35-39,1858,16.818742894290406
STAT,1887,47,35-39,1934,0.31475668971222126
STAT,1836,24,30-34,1860,30.815398983335292
SIM,1845,36,40-44,1881,16
SIM,1891,40,na,1931,6014
STAT,1851,28,15-19,1879,0.8175794217186508
STAT,1818,69,na,1887,1625.5918637470766
STAT,1918,23,15-19,1941,11.557206064676965
STAT,1834,44,15-19,1878,0.021600600580846837
SIM,1879,91,na,1970,301
SIM,1895,54,na,1949,5738
SIM,1840,31,35-39,1871,35
STAT,1869,40,20-24,1909,0.31392345882458517
STAT,1814,55,na,1869,2308.2017617698425
STAT,1808,54,15-19,1862,1.4011938406838836E-4
SIM,1839,19,na,1858,4033
STAT,1884,18,50-100,1902,0.09744707502076637
STAT,1876,38,20-24,1914,1.6022086324254852
STAT,1812,52,15-19,1864,1.6306658887171716E-4
STAT,1884,48,20-24,1932,0.02363054962009861
SIM,1820,35,25-29,1855,6
STAT,1856,24,50-100,1880,0.727437297265004
STAT,1829,34,40-44,1863,7.880987283758686
STAT,1946,11,na,1957,8799.866226060929
SIM,1832,37,45-49,1869,6
STAT,1848,54,45-49,1902,0.02314173307587072
SIM,1926,23,15-19,1949,10
STAT,1896,25,40-44,1921,8.041645909496262
SIM,1926,43,na,1969,9453
STAT,1833,51,45-49,1884,0.020089465418611435
SIM,1844,24,30-34,1868,44
STAT,1868,27,30-34,1895,48.38768492359668
STAT,1888,32,na,1920,5696.279894591966
SIM,1823,34,50-100,1857,3
STAT,1838,57,na,1895,2719.7684888483336
SIM,1858,22,na,1880,4180
SIM,1873,35,50-100,1908,4
STAT,1875,45,15-19,1920,8.400320201663943E-4
STAT,1880,30,25-29,1910,21.96705486295109
SIM,1895,47,35-39,1942,1
SIM,1858,39,30-34,1897,13
STAT,1851,31,45-49,1882,2.842959080811973
STAT,1872,28,35-39,1900,19.51588236258312
SIM,1863,24,40-44,1887,4
SIM,1886,37,40-44,1923,10
STAT,1846,46,35-39,1892,0.21504811140456542
STAT,1962,7,na,1969,10169.193065593347
SIM,1964,5,na,1969,10484
STAT,1872,19,45-49,1891,0.13187669361236473
SIM,1821,77,na,1898,1005
STAT,1896,42,30-34,1938,0.21261307483727537
SIM,1872,37,na,1909,4990
STAT,1775,102,na,1877,0.12508155210049313
STAT,1857,37,20-24,1894,1.2134679545122538
STAT,1874,44,45-49,1918,3.053148723049444
STAT,1863,88,na,1951,242.70375121553673
STAT,1891,28,45-49,1919,2.7619843066941665
STAT,1888,26,45-49,1914,2.6594612214462576
STAT,1834,43,na,1877,3325.377154545962
SIM,1830,42,30-34,1872,6
SIM,1914,38,50-100,1952,1
SIM,1851,43,na,1894,3632
SIM,1869,41,25-29,1910,3
STAT,1882,47,50-100,1929,0.4809399540580182
STAT,1914,25,50-100,1939,2.040609185477213
STAT,1807,53,45-49,1860,0.09263280414324385
SIM,1880,19,45-49,1899,1
STAT,1931,18,50-100,1949,0.9878369215860348
STAT,1862,22,30-34,1884,31.475960377296566
SIM,1951,20,45-49,1971,3
SIM,1951,6,na,1957,9804
SIM,1882,44,45-49,1926,8
STAT,1851,87,na,1938,273.11238932466
SIM,1888,41,35-39,1929,7
STAT,1917,30,45-49,1947,3.35435701637642
SIM,1829,35,45-49,1864,5
SIM,1896,26,45-49,1922,3
SIM,1818,48,50-100,1866,1
STAT,1829,51,30-34,1880,0.009254632138683565
STAT,1791,103,na,1894,0.05663589013384447
SIM,1880,88,na,1968,617
STAT,1852,32,15-19,1884,0.23500116977688462
STAT,1901,15,na,1916,7173.997764053063
STAT,1905,29,na,1934,6920.6913817956465
STAT,1869,33,50-100,1902,1.7854705298686508
STAT,1877,15,50-100,1892,0.10322108264857564
STAT,1878,37,40-44,1915,9.233469662600479
SIM,1814,41,35-39,1855,5
SIM,1949,16,20-24,1965,339
STAT,1841,42,40-44,1883,3.391228066536116
STAT,1855,24,40-44,1879,3.6183989647855364
SIM,1880,28,35-39,1908,25
STAT,1822,42,na,1864,3111.4691340963163
STAT,1826,56,na,1882,2614.8665363744076
STAT,1859,16,25-29,1875,10.636527149415388
STAT,1856,45,40-44,1901,0.26942961659463077
STAT,1845,34,25-29,1879,18.380578125671267
STAT,1848,51,40-44,1899,0.01734485650402302
SIM,1793,64,na,1857,1667
SIM,1878,27,40-44,1905,10
STAT,1897,68,na,1965,4629.4294565157015
STAT,1863,34,40-44,1897,7.601243202937181
SIM,1906,30,35-39,1936,32
STAT,1842,18,20-24,1860,33.69436180999921
STAT,1893,54,na,1947,5360.421464939827
STAT,1895,30,20-24,1925,7.1706309049840105
SIM,1867,16,25-29,1883,15
SIM,1881,32,35-39,1913,22
STAT,1868,47,25-29,1915,0.11016392368003079
STAT,1873,32,35-39,1905,20.781307801978357
STAT,1880,38,35-39,1918,14.973517993222156
STAT,1814,51,35-39,1865,0.04361377181704095
SIM,1930,3,na,1933,11147
STAT,1881,42,35-39,1923,3.530503688105876
SIM,1819,46,40-44,1865,1
STAT,1853,44,25-29,1897,1.0023074073366878
STAT,1850,110,na,1960,0.001003761028997754
SIM,1898,39,25-29,1937,2
STAT,1831,52,25-29,1883,0.004768790140444029
STAT,1889,17,na,1906,6289.3473597388465
STAT,1900,45,25-29,1945,0.09193564445825209
STAT,1842,19,na,1861,4336.958806293766
SIM,1853,34,25-29,1887,18
SIM,1891,31,40-44,1922,14
SIM,1894,32,20-24,1926,9
STAT,1877,16,na,1893,5309.604145463966
STAT,1924,32,na,1956,8909.010739061778
STAT,1835,37,20-24,1872,1.2348355725219562
STAT,1830,47,35-39,1877,0.2416648473503356
SIM,1850,26,20-24,1876,26
SIM,1837,71,na,1908,1695
STAT,1809,46,30-34,1855,0.7640422544555815
SIM,1848,9,na,1857,4630
STAT,1896,17,40-44,1913,0.48769789228575683
SIM,1861,28,25-29,1889,81
STAT,1833,48,15-19,1881,5.54334195965834E-4
STAT,1847,106,na,1953,0.018508085823048123
STAT,1899,18,20-24,1917,48.92877456428609
STAT,1916,13,na,1929,8449.214889272345
STAT,1901,49,35-39,1950,0.2186200625956288
SIM,1852,34,30-34,1886,42
SIM,1877,47,40-44,1924,1
STAT,1919,35,25-29,1954,2.1477621629327426
STAT,1853,28,25-29,1881,70.04996744673822
SIM,1866,73,na,1939,2191
STAT,1839,53,40-44,1892,0.016174237889031294
SIM,1855,17,45-49,1872,1
SIM,1858,18,25-29,1876,13
STAT,1863,51,30-34,1914,0.010573867261288228
STAT,1846,30,25-29,1876,18.929176587154206
STAT,1896,36,45-49,1932,5.341073124219004
SIM,1837,26,40-44,1863,7
STAT,1893,49,25-29,1942,0.08143690174853634
STAT,1844,22,15-19,1866,6.6519059712358235
SIM,1875,27,15-19,1902,2
SIM,1879,43,35-39,1922,8
STAT,1814,52,25-29,1866,0.017588952158310973
SIM,1923,46,na,1969,9065
SIM,1857,3,na,1860,5673
STAT,1763,115,na,1878,1.7442783293007352E-4
SIM,1835,37,35-39,1872,16
STAT,1883,50,45-49,1933,0.029210415974405556
SIM,1858,54,na,1912,3605
STAT,1895,38,30-34,1933,13.955913330022877
STAT,1952,15,15-19,1967,109.88804057034227
STAT,1869,72,na,1941,2471.408968596292
SIM,1824,40,40-44,1864,7
SIM,1828,47,45-49,1875,1
STAT,1850,27,45-49,1877,2.003377717973137
SIM,1852,22,15-19,1874,7
SIM,1895,38,45-49,1933,6
STAT,1869,47,40-44,1916,0.33346613015353654
SIM,1874,17,na,1891,4935
SIM,1963,4,na,1967,10477
STAT,1829,45,45-49,1874,0.3822484292920699
SIM,1854,38,35-39,1892,17
SIM,1865,7,na,1872,5255
STAT,1907,49,50-100,1956,0.4048116112584209
STAT,1946,17,40-44,1963,3.1329424103807697
STAT,1842,26,20-24,1868,21.755467621895914
STAT,1922,20,na,1942,8505.87418825518
STAT,1864,34,35-39,1898,18.125961025899148
SIM,1847,40,35-39,1887,10
STAT,1841,77,na,1918,1254.1723892287669
STAT,1883,31,40-44,1914,8.64039749757187
STAT,1836,35,35-39,1871,11.787849968890622
STAT,1875,32,45-49,1907,3.6260194220998625
STAT,1893,41,15-19,1934,0.035511436746780506
SIM,1845,32,25-29,1877,27
STAT,1894,71,na,1965,4014.712626494305
SIM,1927,15,30-34,1942,34
SIM,1872,24,50-100,1896,2
STAT,1887,38,45-49,1925,4.480538915299727
STAT,1851,24,20-24,1875,125.74685459951118
STAT,1859,51,na,1910,3477.7542748329124
SIM,1831,30,30-34,1861,49
STAT,1827,41,na,1868,3284.420273494885
SIM,1900,43,25-29,1943,1
STAT,1890,21,30-34,1911,44.04262375321056
SIM,1882,33,40-44,1915,16
SIM,1854,30,25-29,1884,25
SIM,1919,16,35-39,1935,10
STAT,1870,40,50-100,1910,2.1158984919760004
STAT,1910,27,40-44,1937,9.093519091674988
SIM,1798,63,na,1861,1683
STAT,1827,37,35-39,1864,14.698674308696384
STAT,1816,89,na,1905,103.18908560780284
STAT,1844,34,30-34,1878,33.02462859159056
STAT,1834,27,25-29,1861,73.83675648708729
SIM,1877,36,na,1913,4867
STAT,1849,39,15-19,1888,0.08902353473072076
SIM,1842,27,25-29,1869,99
SIM,1843,36,30-34,1879,17
STAT,1870,41,20-24,1911,0.31632364981794314
STAT,1894,28,35-39,1922,24.945032523640947
SIM,1941,26,50-100,1967,2
STAT,1847,17,45-49,1864,0.12427794356278365
STAT,1839,40,35-39,1879,3.3597354191871402
STAT,1880,26,40-44,1906,6.395152338939547
SIM,1869,48,45-49,1917,3
STAT,1837,32,25-29,1869,17.903029222511435
STAT,1844,10,na,1854,4962.0
SIM,1861,20,15-19,1881,6
SIM,1895,39,35-39,1934,22
STAT,1821,42,15-19,1863,0.043907338173752114
STAT,1841,88,na,1929,199.1888625501941
SIM,1954,17,40-44,1971,7
SIM,1844,35,35-39,1879,17
STAT,1809,47,20-24,1856,0.09301536081414014
SIM,1821,35,40-44,1856,11
SIM,1863,35,45-49,1898,4
STAT,1874,52,45-49,1926,0.02985067498790969
SIM,1838,42,35-39,1880,4
STAT,1899,16,na,1915,7005.866745885257
SIM,1861,27,35-39,1888,20
STAT,1857,40,50-100,1897,1.679844230708536
SIM,1815,42,40-44,1857,6
STAT,1853,27,35-39,1880,17.685614829265702
STAT,1812,52,50-100,1864,0.10012296967460557
STAT,1855,52,35-39,1907,0.012912787021726312
STAT,1847,22,40-44,1869,3.8940020431270908
STAT,1835,28,50-100,1863,1.072512280953965
SIM,1883,32,45-49,1915,4
STAT,1884,50,na,1934,4355.705314944402
SIM,1884,37,30-34,1921,16
STAT,1885,23,15-19,1908,6.611522476558742
SIM,1927,35,25-29,1962,4
STAT,1826,40,50-100,1866,2.325252055310171
STAT,1939,20,30-34,1959,58.341859969161426
SIM,1794,81,na,1875,425
STAT,1888,64,na,1952,4149.574747062617
STAT,1860,59,na,1919,3187.442188867175
STAT,1871,51,50-100,1922,0.030448886304845747
STAT,1870,36,25-29,1906,5.73642811368576
STAT,1853,42,50-100,1895,1.669461800580406
STAT,1862,39,na,1901,4025.95926468631
SIM,1798,95,na,1893,2
SIM,1819,74,na,1893,1039
STAT,1853,20,15-19,1873,6.25684542265156
STAT,1887,39,35-39,1926,15.815469213114241
SIM,1862,37,30-34,1899,16
STAT,1783,77,na,1860,570.7912390340091
STAT,1937,31,25-29,1968,18.482258485652693
STAT,1886,32,20-24,1918,5.762765999773711
STAT,1870,24,30-34,1894,35.097579308122185
STAT,1825,34,20-24,1859,8.072429990803675
SIM,1850,30,40-44,1880,11
STAT,1926,42,50-100,1968,0.29244851132984473
STAT,1898,38,20-24,1936,0.4524782815334005
STAT,1781,86,na,1867,134.0050370839165
STAT,1844,21,na,1865,4342.339362479559
STAT,1853,33,20-24,1886,4.358705801484843
SIM,1815,60,na,1875,2003
SIM,1816,41,45-49,1857,6
SIM,1893,23,15-19,1916,7
SIM,1898,8,na,1906,7330
STAT,1870,69,na,1939,2909.885017028143
SIM,1859,27,30-34,1886,56
SIM,1895,31,25-29,1926,36
STAT,1890,40,35-39,1930,4.508981084725454
SIM,1862,40,25-29,1902,2
STAT,1890,48,45-49,1938,0.32404709080516
STAT,1831,26,45-49,1857,1.959804483233936
SIM,1896,28,na,1924,6589
STAT,1920,41,35-39,1961,0.4497002732641873
STAT,1834,54,50-100,1888,0.019812995162175405
STAT,1876,37,30-34,1913,11.132740422576845
STAT,1799,81,na,1880,432.2355057976521
STAT,1829,26,40-44,1855,10.917810809063825
SIM,1894,16,na,1910,6850
STAT,1855,53,25-29,1908,0.0052553655445842585
STAT,1841,21,35-39,1862,10.803409934789368
STAT,1906,38,30-34,1944,3.368602365215124
SIM,1882,20,35-39,1902,12
STAT,1855,35,45-49,1890,3.0345959313008644
STAT,1831,111,na,1942,1.3858212303685305E-4
STAT,1885,29,50-100,1914,1.2767800889132188
STAT,1838,44,35-39,1882,2.5421795100707048
SIM,1847,70,na,1917,2148
SIM,1892,19,15-19,1911,12
STAT,1862,53,50-100,1915,0.025651796927115646
STAT,1876,41,50-100,1917,2.2167649628931834
STAT,1909,43,na,1952,6977.366297296201
SIM,1828,48,35-39,1876,1
STAT,1819,41,20-24,1860,0.7587360322222545
STAT,1848,35,na,1883,4064.553704253536
SIM,1927,28,na,1955,9374
SIM,1914,38,30-34,1952,7
SIM,1815,81,na,1896,550
STAT,1887,31,25-29,1918,23.230467618209783
STAT,1903,19,50-100,1922,0.1401236976676746
STAT,1822,50,30-34,1872,0.018528604120318256
STAT,1892,25,20-24,1917,29.86180730583161
STAT,1855,41,30-34,1896,1.7414684917777359
SIM,1923,14,na,1937,9832
STAT,1821,45,50-100,1866,0.7399589546403926
STAT,1863,18,40-44,1881,0.3337921391860476
STAT,1866,19,20-24,1885,33.5112714675952
STAT,1882,51,40-44,1933,0.020811161978517366
STAT,1846,37,45-49,1883,3.188650955732341
STAT,1875,28,25-29,1903,87.64990857252839
STAT,1911,43,35-39,1954,0.3859399244919037
STAT,1906,14,na,1920,7575.575588193894
SIM,1844,48,40-44,1892,2
STAT,1911,38,50-100,1949,0.8151814820024611
STAT,1845,31,20-24,1876,5.004181327744953
STAT,1920,49,45-49,1969,0.48225519208475
SIM,1947,20,30-34,1967,87
SIM,1880,24,40-44,1904,3
STAT,1879,71,na,1950,2819.735748498443
SIM,1904,32,na,1936,7048
STAT,1846,18,40-44,1864,0.34985749171946895
STAT,1863,46,35-39,1909,0.24820880986878144
STAT,1832,51,50-100,1883,0.020890154528876114
STAT,1862,31,20-24,1893,4.685091679009778
SIM,1864,18,na,1882,4960
SIM,1908,46,na,1954,6736
STAT,1875,7,na,1882,5615.2100379953245
STAT,1894,21,15-19,1915,8.584817729856331
SIM,1862,91,na,1953,109
STAT,1861,26,30-34,1887,42.946887179627836
STAT,1845,50,25-29,1895,0.005536447993937361
STAT,1887,44,30-34,1931,2.5618094178878628
STAT,1941,20,35-39,1961,19.666513429257456
STAT,1795,100,na,1895,0.4537065971155158
STAT,1919,40,20-24,1959,0.038751076780574926
SIM,1939,20,45-49,1959,5
SIM,1905,17,na,1922,7613
SIM,1846,44,35-39,1890,7
STAT,1898,53,na,1951,5790.468175333732
STAT,1831,78,na,1909,1008.8162388162535
STAT,1892,42,50-100,1934,2.667734507532293
SIM,1885,21,15-19,1906,7
SIM,1841,22,na,1863,3918
STAT,1892,5,na,1897,6625.749614104445
SIM,1876,38,35-39,1914,16
SIM,1855,22,40-44,1877,6
STAT,1884,1,na,1885,6629.252566170422
SIM,1864,32,35-39,1896,23
STAT,1811,44,20-24,1855,1.1471686668002221
SIM,1845,36,na,1881,4073
SIM,1881,41,25-29,1922,2
SIM,1804,97,na,1901,1
STAT,1880,68,na,1948,3251.3518608976883
SIM,1872,31,30-34,1903,46
STAT,1865,30,35-39,1895,18.730613286385083
STAT,1867,3,na,1870,6003.362400536685
SIM,1885,17,30-34,1902,7
SIM,1874,19,20-24,1893,33
STAT,1830,93,na,1923,40.356853079370325
STAT,1838,20,50-100,1858,0.7264354313832893
SIM,1853,31,20-24,1884,4
STAT,1828,49,45-49,1877,0.4140465032611359
SIM,1780,78,na,1858,485
SIM,1955,16,45-49,1971,1
SIM,1860,16,15-19,1876,9
SIM,1933,38,40-44,1971,8
STAT,1855,50,50-100,1905,0.02310122649975573
STAT,1827,43,20-24,1870,0.29625544303736956
STAT,1872,20,25-29,1892,116.88701491144394
STAT,1867,30,50-100,1897,1.7469395533572174
STAT,1873,41,25-29,1914,1.3237047436980172
SIM,1809,47,35-39,1856,1
STAT,1842,33,45-49,1875,3.10390919049189
STAT,1899,27,na,1926,6603.840728287246
SIM,1917,25,15-19,1942,2
STAT,1897,33,35-39,1930,27.224079491102643
STAT,1901,29,40-44,1930,8.409030937299677
STAT,1868,39,25-29,1907,5.476771678409585
STAT,1771,97,na,1868,1.392112531624583
STAT,1855,16,40-44,1871,0.329987123614828
SIM,1861,21,na,1882,4626
STAT,1894,34,20-24,1928,6.952766138936678
SIM,1876,39,25-29,1915,9
STAT,1900,37,25-29,1937,1.7410679208049633
STAT,1886,20,na,1906,5072.232123956733
STAT,1807,96,na,1903,6.853933865521271
STAT,1947,16,45-49,1963,1.1367125258720308
SIM,1839,18,15-19,1857,15
STAT,1936,27,50-100,1963,1.9242103455772095
SIM,1881,73,na,1954,1838
STAT,1766,97,na,1863,1.0763244753480006
STAT,1871,21,20-24,1892,138.6914151069109
STAT,1806,50,25-29,1856,0.021514374590505925
STAT,1888,18,45-49,1906,0.155520539421349
STAT,1835,36,30-34,1871,8.62665204895275
STAT,1892,37,15-19,1929,0.14197534822544403
STAT,1895,34,na,1929,6226.123159931081
STAT,1945,25,25-29,1970,145.9547208589101
STAT,1852,40,15-19,1892,0.022232339079732554
STAT,1936,15,30-34,1951,23.682210844003308
SIM,1896,23,40-44,1919,9
STAT,1899,48,na,1947,6148.539211226031
SIM,1829,27,45-49,1856,5
SIM,1870,47,30-34,1917,1
SIM,1939,21,35-39,1960,24
STAT,1827,38,25-29,1865,5.825537779895186
SIM,1829,32,40-44,1861,11
STAT,1924,20,50-100,1944,1.5770104639413833
STAT,1941,12,na,1953,8195.352848588782
SIM,1844,20,15-19,1864,4
STAT,1852,36,30-34,1888,8.629569761928488
SIM,1830,29,35-39,1859,22
SIM,1835,43,20-24,1878,1
STAT,1837,47,45-49,1884,0.34152684716480425
STAT,1955,15,40-44,1970,3.7515324631880316
SIM,1844,16,30-34,1860,4
SIM,1865,41,40-44,1906,10
STAT,1816,40,40-44,1856,13.392003499776564
STAT,1945,26,na,1971,8303.503959236006
STAT,1842,46,15-19,1888,6.033048378908973E-4
STAT,1894,29,25-29,1923,108.96229151341531
SIM,1899,16,20-24,1915,62
STAT,1909,25,15-19,1934,1.3842213360386455
SIM,1818,38,25-29,1856,7
SIM,1819,42,25-29,1861,1
STAT,1802,97,na,1899,4.123103172714264
STAT,1968,4,na,1972,9918.450220151657
STAT,1868,38,35-39,1906,13.52339486877006
SIM,1824,36,20-24,1860,3
SIM,1914,6,na,1920,8553
STAT,1774,103,na,1877,0.0763102246498884
STAT,1856,32,35-39,1888,15.97356483671439
SIM,1855,42,35-39,1897,7
STAT,1900,42,20-24,1942,0.0308591238905749
STAT,1817,48,30-34,1865,0.46026841301708643
SIM,1860,36,30-34,1896,13
STAT,1879,45,35-39,1924,0.2986952649563178
SIM,1779,81,na,1860,346
SIM,1869,45,40-44,1914,1
STAT,1846,38,35-39,1884,11.196515353395403
STAT,1919,15,30-34,1934,5.482027195415915
STAT,1837,28,40-44,1865,5.321524023704909
STAT,1888,21,50-100,1909,0.9763611115221472
STAT,1970,0,na,1970,10012.450201835974
SIM,1849,18,na,1867,4649
SIM,1891,27,20-24,1918,31
SIM,1827,93,na,1920,14
STAT,1901,48,50-100,1949,0.38677872839632094
STAT,1915,36,50-100,1951,0.860792200817301
SIM,1828,28,40-44,1856,6
SIM,1854,37,45-49,1891,5
SIM,1871,46,35-39,1917,1
STAT,1864,50,35-39,1914,0.01576536157775007
SIM,1826,44,na,1870,3036
STAT,1874,49,15-19,1923,8.09894649430595E-4
STAT,1836,48,40-44,1884,0.2352355151299358
STAT,1827,30,15-19,1857,0.39069585706654075
SIM,1835,38,25-29,1873,5
SIM,1885,29,25-29,1914,102
STAT,1866,21,na,1887,4475.338456911362
SIM,1845,28,40-44,1873,8
STAT,1898,45,45-49,1943,0.3674659402419813
SIM,1875,30,45-49,1905,7
STAT,1826,88,na,1914,164.34287910753648
STAT,1862,25,35-39,1887,16.960066259490585
SIM,1908,15,20-24,1923,52
STAT,1888,23,40-44,1911,4.958817170997536
STAT,1861,27,20-24,1888,19.863942982206915
SIM,1895,19,40-44,1914,1
SIM,1912,51,na,1963,7222
STAT,1846,43,30-34,1889,1.7595872565838804
STAT,1847,42,35-39,1889,2.775694000650607
SIM,1934,25,15-19,1959,2
STAT,1877,29,25-29,1906,88.07872501116219
SIM,1886,33,25-29,1919,30
SIM,1870,25,35-39,1895,25
SIM,1932,28,na,1960,9929
STAT,1926,25,15-19,1951,1.7204526401596787
STAT,1893,17,15-19,1910,15.191726264767759
SIM,1854,43,30-34,1897,3
STAT,1878,33,25-29,1911,21.51356031271561
SIM,1899,48,30-34,1947,1
STAT,1883,27,20-24,1910,23.278406437698923
STAT,1887,19,40-44,1906,0.41092450250244694
SIM,1944,15,30-34,1959,33
SIM,1886,38,30-34,1924,16
STAT,1893,20,45-49,1913,1.7957088615337693
STAT,1936,12,na,1948,7662.886038144097
SIM,1835,34,30-34,1869,51
STAT,1847,38,15-19,1885,0.08789507596757146
STAT,1821,37,40-44,1858,17.139350016238993
STAT,1860,109,na,1969,0.015029277625710236
STAT,1896,21,25-29,1917,153.10215684014838
STAT,1880,51,30-34,1931,0.01272507841100973
STAT,1850,48,15-19,1898,6.056011613452541E-4
STAT,1928,16,35-39,1944,10.702875362084406
SIM,1880,38,50-100,1918,6
SIM,1908,22,45-49,1930,3
STAT,1849,73,na,1922,1878.7850775211161
STAT,1922,20,25-29,1942,215.14955865322497
SIM,1879,40,30-34,1919,5
SIM,1841,27,45-49,1868,3
STAT,1829,29,45-49,1858,2.4128247498095936
SIM,1886,72,na,1958,2746
STAT,1776,96,na,1872,2.965452209584156
STAT,1772,82,na,1854,251.0
SIM,1900,39,40-44,1939,3
SIM,1949,20,40-44,1969,8
STAT,1861,22,15-19,1883,5.697300197122666
SIM,1874,50,45-49,1924,1
SIM,1891,34,45-49,1925,7
STAT,1844,18,30-34,1862,3.252675503246514
STAT,1865,43,40-44,1908,4.097184086198765
STAT,1794,101,na,1895,0.22351298005287687
STAT,1834,24,20-24,1858,120.92791415270759
SIM,1933,13,na,1946,11219
SIM,1898,36,20-24,1934,1
STAT,1772,104,na,1876,0.052661961767270546
SIM,1852,37,35-39,1889,18
STAT,1825,43,50-100,1868,2.3862135980394736
SIM,1853,25,35-39,1878,1
STAT,1833,27,45-49,1860,1.9303646864000676
SIM,1923,30,35-39,1953,37
STAT,1863,27,50-100,1890,1.1309126021732667
STAT,1878,30,20-24,1908,5.747393627923596
STAT,1902,32,na,1934,6804.1988666712505
STAT,1879,50,na,1929,4613.881579024307
SIM,1897,31,35-39,1928,40
STAT,1889,48,20-24,1937,0.01664458414098139
SIM,1860,36,na,1896,4122
SIM,1858,15,20-24,1873,33
STAT,1823,33,35-39,1856,50.45836129399423
SIM,1837,30,25-29,1867,31
STAT,1820,50,20-24,1870,0.0027482034025906772
STAT,1868,44,20-24,1912,0.301044298522465
STAT,1894,25,30-34,1919,65.77507311450582
STAT,1905,16,40-44,1921,0.5355317686045252
SIM,1852,18,30-34,1870,3
STAT,1828,42,25-29,1870,1.209120430476321
STAT,1906,46,na,1952,6641.189107255688
SIM,1913,16,40-44,1929,1
STAT,1844,37,35-39,1881,12.070083023670964
STAT,1883,34,45-49,1917,3.4305949231288078
SIM,1848,48,25-29,1896,1
STAT,1934,2,na,1936,11174.022983633518
SIM,1833,78,na,1911,965
STAT,1857,17,na,1874,4247.082327245804
SIM,1949,17,50-100,1966,4
STAT,1895,33,25-29,1928,26.841001407159386
STAT,1895,42,15-19,1937,0.002520581618964578
STAT,1878,86,na,1964,882.2520676634493
SIM,1887,17,40-44,1904,2
STAT,1857,41,40-44,1898,3.556824425052651
STAT,1922,38,15-19,1960,0.04407406610175159
SIM,1930,20,25-29,1950,278
SIM,1883,29,15-19,1912,1
SIM,1939,17,15-19,1956,77
SIM,1831,33,35-39,1864,27
STAT,1876,8,na,1884,5581.689814081034
STAT,1816,43,45-49,1859,7.926762692856401
STAT,1810,103,na,1913,0.12978820520180434
STAT,1829,30,25-29,1859,20.802752766562847
SIM,1837,38,35-39,1875,15
STAT,1851,20,50-100,1871,0.765868313089234
STAT,1885,47,25-29,1932,0.11525322580697754
STAT,1904,16,50-100,1920,0.1423634950482936
STAT,1874,72,na,1946,2611.559079465459
STAT,1831,23,40-44,1854,7.727145167477542
SIM,1937,27,na,1964,7488
STAT,1836,77,na,1913,1149.28124978546
STAT,1864,31,30-34,1895,31.649004995542345
SIM,1871,8,na,1879,5259
STAT,1833,110,na,1943,3.632817321776859E-4
STAT,1915,30,35-39,1945,18.949384803464316
SIM,1824,43,45-49,1867,7
STAT,1858,49,30-34,1907,0.1492216210370351
STAT,1825,46,15-19,1871,8.794409465820683E-4
STAT,1917,15,20-24,1932,59.19060629573179
SIM,1801,57,na,1858,2192
STAT,1893,46,20-24,1939,0.01737701039670381
STAT,1872,38,50-100,1910,2.479638906189389
STAT,1897,32,50-100,1929,2.473534908520421
SIM,1846,35,45-49,1881,8
STAT,1896,29,35-39,1925,25.544291851018137
SIM,1852,92,na,1944,40
STAT,1866,50,45-49,1916,0.027432217018710264
STAT,1877,49,40-44,1926,0.3515371389107274
SIM,1836,22,na,1858,3655
STAT,1844,46,25-29,1890,0.09328314542796728
SIM,1846,16,40-44,1862,3
STAT,1829,38,35-39,1867,12.13805939184051
STAT,1835,32,15-19,1867,0.2349217182354776
SIM,1830,26,30-34,1856,55
SIM,1827,35,35-39,1862,18
STAT,1852,16,15-19,1868,11.507534409555566
STAT,1925,38,40-44,1963,3.624275721962689
STAT,1938,15,40-44,1953,2.799977155866127
SIM,1869,16,35-39,1885,1
STAT,1886,26,35-39,1912,20.641555401334045
SIM,1830,45,35-39,1875,1
STAT,1858,45,15-19,1903,6.360453042529845E-4
STAT,1854,36,40-44,1890,6.742954881507617
STAT,1875,29,15-19,1904,0.9366643836980655
SIM,1857,42,45-49,1899,6
SIM,1868,32,na,1900,4597
STAT,1831,32,30-34,1863,29.45441364625141
STAT,1885,19,30-34,1904,3.1869664590217517
SIM,1850,33,45-49,1883,5
STAT,1812,51,25-29,1863,0.023957509327705823
SIM,1842,24,20-24,1866,136
SIM,1897,13,na,1910,7135
SIM,1806,56,na,1862,2353
STAT,1902,45,50-100,1947,0.39896042983782004
STAT,1838,41,30-34,1879,1.843128871843293
STAT,1859,83,na,1942,638.1523011015471
SIM,1865,37,20-24,1902,3
STAT,1948,20,45-49,1968,2.610796107069836
STAT,1931,13,na,1944,10458.341469948899
STAT,1935,27,na,1962,10315.095239838414
STAT,1874,28,45-49,1902,2.2879303082249067
SIM,1861,24,30-34,1885,46
STAT,1822,45,35-39,1867,0.44794098305085844
SIM,1878,39,35-39,1917,30
SIM,1911,41,35-39,1952,1
SIM,1869,17,na,1886,5033
SIM,1873,54,na,1927,4367
STAT,1838,16,40-44,1854,0.3289125912996856
STAT,1928,25,25-29,1953,164.85705809574412
SIM,1838,33,50-100,1871,4
STAT,1915,50,na,1965,7409.721662282316
SIM,1833,89,na,1922,107
SIM,1885,49,40-44,1934,1
SIM,1837,29,45-49,1866,4
SIM,1877,68,na,1945,2955
SIM,1862,32,25-29,1894,25
STAT,1804,56,na,1860,2154.090179539519
SIM,1946,15,40-44,1961,3
SIM,1862,36,40-44,1898,12
STAT,1819,35,35-39,1854,47.06706547408072
SIM,1840,40,25-29,1880,2
SIM,1835,37,na,1872,3601
STAT,1903,41,35-39,1944,0.36322838185243445
SIM,1911,49,45-49,1960,2
SIM,1936,16,35-39,1952,8
STAT,1888,39,15-19,1927,0.13269549692841015
SIM,1831,23,na,1854,3904
STAT,1850,92,na,1942,63.859786973583454
SIM,1826,37,20-24,1863,2
SIM,1828,44,40-44,1872,9
STAT,1853,24,30-34,1877,32.82249613396064
SIM,1860,25,na,1885,4239
SIM,1882,28,45-49,1910,4
SIM,1848,29,20-24,1877,22
STAT,1843,33,50-100,1876,1.5270658068206209
SIM,1857,91,na,1948,100
SIM,1901,27,40-44,1928,11
SIM,1936,25,25-29,1961,120
STAT,1849,42,45-49,1891,2.3644681803126986
STAT,1864,22,40-44,1886,3.822414659302441
STAT,1885,28,20-24,1913,23.50067713204032
STAT,1887,35,40-44,1922,9.981777593040874
STAT,1840,17,35-39,1857,1.025461784078184
STAT,1931,31,30-34,1962,41.71957652876922
SIM,1893,28,20-24,1921,29
SIM,1895,35,40-44,1930,21
STAT,1861,51,20-24,1912,0.001246383757762136
STAT,1808,59,na,1867,2138.923565048231
STAT,1818,37,20-24,1855,5.333998502012023
STAT,1860,47,20-24,1907,0.019589240946710544
STAT,1854,32,25-29,1886,16.07957288918677
STAT,1854,53,50-100,1907,0.022780587496950742
SIM,1873,43,40-44,1916,8
STAT,1832,40,25-29,1872,1.0509681326328943
SIM,1872,22,40-44,1894,5
SIM,1894,26,35-39,1920,32
SIM,1848,55,na,1903,3153
SIM,1907,35,50-100,1942,2
STAT,1921,35,na,1956,8496.650108264364
SIM,1818,89,na,1907,95
STAT,1859,38,50-100,1897,1.9637942414868292
STAT,1852,45,20-24,1897,0.01931639877625528
STAT,1837,37,30-34,1874,9.046051070509398
STAT,1903,49,45-49,1952,0.37481268860008354
STAT,1842,30,40-44,1872,7.963364998113203
STAT,1860,21,45-49,1881,1.1874814891594787
SIM,1842,28,15-19,1870,1
SIM,1805,82,na,1887,294
SIM,1892,35,15-19,1927,1
SIM,1909,23,15-19,1932,12
STAT,1875,25,20-24,1900,24.559307351689924
SIM,1870,38,40-44,1908,20
STAT,1922,44,50-100,1966,0.27135228397933064
STAT,1848,105,na,1953,0.04807731665186054
SIM,1947,23,35-39,1970,26
STAT,1909,16,25-29,1925,17.214547464483243
STAT,1866,47,15-19,1913,7.419162087697686E-4
STAT,1871,40,25-29,1911,1.30149913925034
STAT,1860,38,30-34,1898,8.697593927430473
STAT,1825,37,25-29,1862,7.573140555483908
STAT,1920,50,na,1970,8125.969473617155
SIM,1867,38,20-24,1905,1
SIM,1861,40,45-49,1901,2
STAT,1855,44,35-39,1899,2.693730536584936
SIM,1856,30,35-39,1886,31
STAT,1791,96,na,1887,3.2576651688251412
STAT,1869,18,35-39,1887,1.0822477451029047
STAT,1884,35,15-19,1919,0.1130509421248376
STAT,1847,31,50-100,1878,1.6569868870539162
SIM,1854,34,40-44,1888,14
SIM,1896,39,15-19,1935,1
STAT,1834,28,15-19,1862,0.786247691343825
STAT,1932,28,30-34,1960,103.60703675969498
STAT,1892,28,25-29,1920,106.57404309843044
STAT,1916,42,45-49,1958,0.34445032092639066
STAT,1846,34,40-44,1880,7.688541826704875
SIM,1940,28,30-34,1968,90
STAT,1919,29,50-100,1948,2.156058028105226
SIM,1917,16,25-29,1933,25
SIM,1904,30,25-29,1934,42
STAT,1924,6,na,1930,9636.896316597064
SIM,1774,82,na,1856,283
STAT,1822,74,na,1896,1253.0437854321303
SIM,1778,96,na,1874,2
SIM,1849,40,45-49,1889,2
SIM,1878,31,25-29,1909,25
SIM,1845,37,30-34,1882,21
STAT,1872,17,na,1889,5143.187475878727
STAT,1889,39,45-49,1928,4.914283158482215
SIM,1840,15,35-39,1855,2
SIM,1868,36,35-39,1904,19
STAT,1850,32,40-44,1882,6.955893123403534
STAT,1890,15,45-49,1905,0.1617783302804937
STAT,1852,40,na,1892,3720.8472181861894
SIM,1890,22,35-39,1912,16
STAT,1944,17,30-34,1961,26.489734904986168
STAT,1862,34,25-29,1896,17.5294203731757
STAT,1908,40,45-49,1948,0.31471382940089404
SIM,1831,24,45-49,1855,1
STAT,1832,27,15-19,1859,0.7963648206243658
SIM,1876,35,30-34,1911,17
SIM,1952,17,30-34,1969,38
STAT,1838,35,45-49,1873,3.323861984026394
SIM,1837,92,na,1929,36
SIM,1898,43,45-49,1941,1
STAT,1897,30,30-34,1927,47.51386279646368
STAT,1838,47,50-100,1885,0.3419679675845529
STAT,1859,29,30-34,1888,40.589151648201614
STAT,1870,27,35-39,1897,19.132158254514007
SIM,1867,29,30-34,1896,66
STAT,1842,36,50-100,1878,2.166623674335403
STAT,1828,46,40-44,1874,0.3124500143662462
SIM,1846,41,30-34,1887,5
STAT,1870,58,na,1928,3921.2341764796606
STAT,1811,47,25-29,1858,0.39101301860153803
STAT,1907,22,50-100,1929,1.2104697084807579
SIM,1855,31,50-100,1886,1
STAT,1791,85,na,1876,178.2723215787347
SIM,1883,25,20-24,1908,28
SIM,1817,42,50-100,1859,4
SIM,1877,27,25-29,1904,96
STAT,1848,47,20-24,1895,0.019584754868879346
STAT,1875,44,50-100,1919,2.1670830992872148
STAT,1901,47,na,1948,6332.651329043987
STAT,1939,23,35-39,1962,19.09388115357026
SIM,1853,55,na,1908,3361
SIM,1857,69,na,1926,2583
STAT,1895,37,40-44,1932,11.519970130668687
SIM,1885,26,20-24,1911,25
STAT,1871,48,35-39,1919,0.2773824326080481
STAT,1880,31,15-19,1911,0.3042209030485875
STAT,1882,22,35-39,1904,11.48070409152982
SIM,1947,7,na,1954,9333
STAT,1821,89,na,1910,116.44616910456786
SIM,1899,19,25-29,1918,24
STAT,1868,35,30-34,1903,10.338183661693803
SIM,1840,59,na,1899,3050
SIM,1825,59,na,1884,2166
STAT,1885,35,na,1920,4781.192282584593
STAT,1851,55,na,1906,3205.3336379592515
SIM,1855,25,na,1880,4403
SIM,1821,45,na,1866,2985
STAT,1881,21,na,1902,4630.705524149263
STAT,1857,44,45-49,1901,2.3242047159950783
SIM,1832,42,40-44,1874,9
STAT,1855,69,na,1924,2212.959124053653
STAT,1837,40,na,1877,3547.496779991434
SIM,1851,11,na,1862,4732
SIM,1897,39,45-49,1936,2
STAT,1898,42,40-44,1940,0.42636722882601347
STAT,1766,113,na,1879,5.676575091846473E-4
STAT,1855,19,45-49,1874,0.11578230311285555
STAT,1900,18,50-100,1918,0.13689723564470013
STAT,1911,48,40-44,1959,0.30069697926644684
SIM,1854,40,na,1894,3902
SIM,1872,69,na,1941,2915
STAT,1877,17,30-34,1894,3.342596381302826
STAT,1877,26,20-24,1903,24.687139336723707
STAT,1806,54,40-44,1860,0.05901621740957042
STAT,1872,52,35-39,1924,0.017381132279955528
SIM,1880,33,30-34,1913,53
STAT,1840,42,25-29,1882,0.966907869796227
SIM,1930,41,45-49,1971,1
STAT,1881,22,50-100,1903,0.7960400217612976
STAT,1936,18,35-39,1954,8.093925972922003
SIM,1846,47,50-100,1893,1
STAT,1940,27,na,1967,7715.602441134753
SIM,1823,31,35-39,1854,29
SIM,1850,36,50-100,1886,4
STAT,1890,57,na,1947,4954.053783140299
SIM,1836,46,40-44,1882,1
SIM,1844,19,35-39,1863,1
STAT,1888,48,50-100,1936,0.32654599231017917
SIM,1886,30,20-24,1916,5
STAT,1847,51,25-29,1898,0.00542507173019102
SIM,1900,29,na,1929,6919
STAT,1836,19,35-39,1855,1.397831032706153
SIM,1866,17,20-24,1883,33
STAT,1889,49,na,1938,5486.668754085843
STAT,1867,27,15-19,1894,0.858144144467776
STAT,1891,33,40-44,1924,10.780415273004404
STAT,1858,17,20-24,1875,32.6050702265233
SIM,1883,21,na,1904,4926
STAT,1905,41,30-34,1946,0.23423655166341387
STAT,1831,51,35-39,1882,0.01182265805565149
SIM,1840,27,15-19,1867,4
STAT,1889,31,35-39,1920,25.321812260824554
STAT,1872,33,30-34,1905,35.289144390588135
STAT,1896,35,50-100,1931,3.304778671842442
STAT,1881,43,25-29,1924,1.244487408738194
SIM,1928,26,50-100,1954,3
STAT,1824,42,40-44,1866,5.845991609923021
SIM,1871,27,50-100,1898,1
STAT,1878,38,30-34,1916,11.185923304053574
STAT,1934,30,45-49,1964,4.344619868018691
SIM,1896,27,35-39,1923,40
STAT,1862,43,15-19,1905,0.023666340658888393
STAT,1851,27,25-29,1878,76.77912868286577
STAT,1860,18,15-19,1878,11.159329349463816
STAT,1817,44,15-19,1861,0.06937072250669214
STAT,1862,38,40-44,1900,7.518970787335255
SIM,1887,35,na,1922,5847
SIM,1880,27,45-49,1907,3
STAT,1852,48,25-29,1900,0.09064995484382471
SIM,1887,36,45-49,1923,6
SIM,1905,1,na,1906,8069
SIM,1860,39,35-39,1899,25
STAT,1823,59,na,1882,2518.9836623435103
SIM,1842,31,45-49,1873,5
STAT,1827,34,30-34,1861,39.10473069882078
SIM,1891,72,na,1963,3873
SIM,1907,4,na,1911,7918
STAT,1852,39,35-39,1891,11.159437942971271
SIM,1887,42,30-34,1929,4
STAT,1803,82,na,1885,358.1360560101645
STAT,1883,0,na,1883,7028.329048491371
SIM,1896,48,50-100,1944,1
STAT,1846,34,50-100,1880,1.6244069122144067
STAT,1911,40,30-34,1951,0.24930288684229207
STAT,1879,42,50-100,1921,2.228982807998627
SIM,1790,67,na,1857,1564
SIM,1865,44,45-49,1909,5
SIM,1820,60,na,1880,2144
SIM,1813,42,30-34,1855,5
SIM,1824,74,na,1898,1305
STAT,1835,92,na,1927,53.94189908672802
STAT,1853,52,25-29,1905,0.0055743440340145145
SIM,1913,5,na,1918,8484
SIM,1829,36,35-39,1865,18
STAT,1868,31,15-19,1899,0.27475837015203314
SIM,1903,47,na,1950,6575
STAT,1879,42,30-34,1921,2.425657766968429
STAT,1834,31,45-49,1865,3.0044062236463334
STAT,1879,36,45-49,1915,4.2314637533939115
STAT,1923,41,50-100,1964,0.2776244892407875
STAT,1918,5,na,1923,8837.087111377772
STAT,1913,43,45-49,1956,0.3273478322176673
SIM,1845,58,na,1903,3286
SIM,1842,48,30-34,1890,1
STAT,1888,27,35-39,1915,23.03262060478998
STAT,1820,40,na,1860,3123.367697628151
STAT,1883,18,45-49,1901,0.12927810887446586
STAT,1903,17,na,1920,7262.538007249291
STAT,1886,19,25-29,1905,12.016350922614034
STAT,1841,38,20-24,1879,1.3041388793269655
STAT,1911,35,35-39,1946,4.764422905532144
STAT,1882,9,na,1891,5104.672526680778
STAT,1892,23,50-100,1915,1.027828982687587
STAT,1858,88,na,1946,216.14180012985778
SIM,1830,41,40-44,1871,12
STAT,1858,51,50-100,1909,0.023891814468384454
STAT,1914,36,15-19,1950,0.038915966551936944
STAT,1788,76,na,1864,761.4584973370035
STAT,1916,44,25-29,1960,0.14730009554391815
SIM,1827,28,25-29,1855,86
STAT,1796,95,na,1891,5.923380220988332
SIM,1940,30,35-39,1970,21
SIM,1813,44,45-49,1857,4
STAT,1861,37,35-39,1898,11.889640362246888
STAT,1873,28,15-19,1901,0.9277458731111625
STAT,1859,53,30-34,1912,0.009415023850553698
STAT,1859,38,20-24,1897,1.2329851585661253
STAT,1931,9,na,1940,10523.751512635497
SIM,1921,18,40-44,1939,5
SIM,1944,18,35-39,1962,10
SIM,1876,46,35-39,1922,1
SIM,1880,35,45-49,1915,8
STAT,1887,40,15-19,1927,0.0315082960313866
STAT,1845,54,40-44,1899,0.01577632459138638
STAT,1857,45,20-24,1902,0.019078692739804996
SIM,1832,93,na,1925,32
SIM,1928,13,na,1941,10238
STAT,1828,26,25-29,1854,209.09244050799768
SIM,1924,19,20-24,1943,341
STAT,1872,35,45-49,1907,4.084688550148769
SIM,1879,70,na,1949,2740
SIM,1894,19,25-29,1913,18
STAT,1798,96,na,1894,4.648390691797435
SIM,1844,25,20-24,1869,23
STAT,1845,38,na,1883,3775.0346587869685
STAT,1770,106,na,1876,0.021386068905751524
STAT,1804,52,50-100,1856,0.08831674908616118
SIM,1910,49,na,1959,7119
SIM,1871,37,45-49,1908,5
STAT,1862,18,na,1880,4511.404427928815
STAT,1901,31,45-49,1932,4.950577653470148
STAT,1834,48,30-34,1882,0.13491333500709993
STAT,1836,25,20-24,1861,20.480849832900667
SIM,1893,43,30-34,1936,2
STAT,1843,25,na,1868,3783.520141890266
SIM,1859,19,30-34,1878,5
SIM,1870,57,na,1927,3866
SIM,1795,98,na,1893,2
STAT,1818,40,50-100,1858,5.609346613220393
SIM,1876,28,20-24,1904,29
STAT,1826,49,35-39,1875,0.27168589688700295
STAT,1933,26,50-100,1959,2.670654649813399
SIM,1851,47,50-100,1898,2
SIM,1807,47,25-29,1854,1
STAT,1853,18,50-100,1871,0.09269631000859382
STAT,1920,33,35-39,1953,20.125734650829187
STAT,1866,38,25-29,1904,5.338713538745681
STAT,1922,41,45-49,1963,0.3862552556794992
SIM,1828,88,na,1916,178
STAT,1881,74,na,1955,2166.3974950120614
STAT,1848,56,na,1904,3344.4026691002646
SIM,1874,38,25-29,1912,7
STAT,1850,60,na,1910,2924.220929994971
STAT,1904,45,45-49,1949,0.38973798839011076
STAT,1843,46,30-34,1889,0.13670726862437899
SIM,1869,38,30-34,1907,14
STAT,1894,49,40-44,1943,0.24531248327474917
STAT,1938,31,40-44,1969,7.952843683936955
SIM,1839,40,na,1879,3482
SIM,1891,35,20-24,1926,3
STAT,1935,31,15-19,1966,0.35933352944645686
STAT,1864,24,50-100,1888,0.7373233098944033
SIM,1853,18,25-29,1871,13
STAT,1863,27,30-34,1890,44.519097415399024
SIM,1868,21,na,1889,4587
SIM,1829,35,50-100,1864,5
SIM,1855,26,35-39,1881,25
STAT,1883,35,20-24,1918,1.5441014808190743
SIM,1903,47,45-49,1950,2
STAT,1865,36,na,1901,4343.579129705277
STAT,1900,34,20-24,1934,7.508119028745912
SIM,1857,16,50-100,1873,1
SIM,1802,95,na,1897,7
STAT,1879,17,40-44,1896,0.38637852465567
SIM,1843,28,50-100,1871,2
STAT,1850,36,20-24,1886,1.2131676627282744
STAT,1921,42,40-44,1963,0.5688305003519001
SIM,1836,26,25-29,1862,72
STAT,1803,60,na,1863,2048.3363333507355
STAT,1940,26,15-19,1966,1.4546411906245587
STAT,1883,87,na,1970,873.2435437033992
STAT,1838,48,15-19,1886,5.498606380245834E-4
STAT,1894,18,20-24,1912,45.87433889749976
SIM,1893,29,50-100,1922,1
STAT,1929,20,35-39,1949,24.189103115614703
STAT,1871,54,na,1925,4201.556168581635
STAT,1923,34,15-19,1957,0.2970470748921397
STAT,1895,48,45-49,1943,0.34593033725338135
SIM,1802,63,na,1865,1913
STAT,1913,30,25-29,1943,18.725863217923795
STAT,1827,27,20-24,1854,69.85795990927025
STAT,1879,29,35-39,1908,20.23745838332893
SIM,1871,27,30-34,1898,4
STAT,1873,55,na,1928,4243.064281245286
STAT,1909,41,15-19,1950,0.002919237248517409
STAT,1875,36,na,1911,4922.483533018935
SIM,1834,49,35-39,1883,1
STAT,1924,43,20-24,1967,0.042346386814013155
STAT,1907,46,25-29,1953,0.09671947274410536
STAT,1923,47,na,1970,8676.927358168277
STAT,1812,43,na,1855,2994.004784941929
STAT,1822,41,40-44,1863,7.775628360613563
SIM,1804,76,na,1880,718
SIM,1815,47,50-100,1862,2
SIM,1862,38,na,1900,4271
SIM,1835,27,20-24,1862,21
STAT,1895,17,25-29,1912,14.912735696685086
STAT,1932,30,35-39,1962,24.564255053252243
STAT,1917,18,25-29,1935,18.782783895236392
SIM,1787,79,na,1866,439
STAT,1845,18,25-29,1863,10.971561307689246
STAT,1847,26,35-39,1873,17.80643435325928
STAT,1934,37,50-100,1971,1.1703122457791386
SIM,1807,94,na,1901,15
STAT,1920,49,50-100,1969,0.5018723516164977
STAT,1870,32,30-34,1902,34.61960344444529
SIM,1862,44,40-44,1906,13
SIM,1856,38,45-49,1894,6
STAT,1843,109,na,1952,9.966254435172504E-4
STAT,1777,101,na,1878,0.23824133885277965
STAT,1916,19,20-24,1935,57.781076796132716
SIM,1887,29,35-39,1916,35
SIM,1936,32,na,1968,6622
STAT,1860,42,15-19,1902,0.022621379518580387
SIM,1921,30,25-29,1951,8
STAT,1939,19,15-19,1958,91.69535756933163
SIM,1947,19,15-19,1966,98
STAT,1862,15,20-24,1877,35.46621270444641
SIM,1833,37,25-29,1870,8
STAT,1911,24,50-100,1935,1.252799897644936
STAT,1839,105,na,1944,0.045782126867828093
STAT,1905,19,45-49,1924,0.1897695270495015
STAT,1871,36,40-44,1907,8.825800719811872
SIM,1777,79,na,1856,504
SIM,1910,17,na,1927,8068
STAT,1815,48,20-24,1863,0.06347625145009776
STAT,1881,18,35-39,1899,1.0683184971553248
STAT,1848,38,45-49,1886,3.3336987282077475
STAT,1880,54,35-39,1934,0.017812713034570573
STAT,1920,46,40-44,1966,0.352776887883188
STAT,1882,39,20-24,1921,1.5013019812173831
STAT,1894,36,35-39,1930,18.43828430612409
STAT,1895,9,na,1904,6828.115716715088
STAT,1902,42,30-34,1944,0.22735787567002277
STAT,1837,19,na,1856,4209.3807728445445
STAT,1845,49,45-49,1894,0.3560678599927197
SIM,1937,20,35-39,1957,20
SIM,1890,39,20-24,1929,4
STAT,1926,18,50-100,1944,0.9251168992236554
STAT,1920,20,15-19,1940,12.0204278218814
STAT,1861,54,25-29,1915,0.0057904181054404145
SIM,1869,70,na,1939,2610
SIM,1900,32,20-24,1932,11
STAT,1854,29,50-100,1883,1.0133212001338037
STAT,1851,40,35-39,1891,2.8354166265068335
STAT,1868,17,50-100,1885,0.09584365680197426
SIM,1852,42,30-34,1894,4
STAT,1855,28,35-39,1883,15.05700612131986
STAT,1929,42,na,1971,9712.72464956925
SIM,1920,31,35-39,1951,30
STAT,1835,38,na,1873,3393.829119585691
SIM,1898,40,40-44,1938,1
STAT,1900,52,na,1952,6000.418450894225
SIM,1916,12,na,1928,8603
STAT,1824,46,20-24,1870,0.029473644417464088
SIM,1907,61,na,1968,6070
STAT,1937,24,50-100,1961,1.2934680499580549
SIM,1850,34,20-24,1884,5
SIM,1846,28,35-39,1874,25
SIM,1852,45,35-39,1897,1
STAT,1896,21,50-100,1917,1.09062667639976
STAT,1838,28,35-39,1866,16.49228169037285
STAT,1844,45,35-39,1889,0.22965335688067198
SIM,1902,43,35-39,1945,2
STAT,1851,47,50-100,1898,0.3789498926078148
STAT,1923,47,20-24,1970,0.026101046941395076
SIM,1843,47,35-39,1890,1
STAT,1842,22,50-100,1864,0.765762526903727
STAT,1848,88,na,1936,225.10489738051592
STAT,1885,15,50-100,1900,0.09894577711833226
STAT,1828,36,na,1864,3444.3392166286085
STAT,1878,53,40-44,1931,0.02184943745512654
SIM,1864,6,na,1870,5458
STAT,1903,46,40-44,1949,0.27848453145616814
SIM,1812,45,40-44,1857,2
STAT,1786,95,na,1881,4.674801632460331
STAT,1842,34,20-24,1876,4.7615976613709785
SIM,1936,0,na,1936,7281
SIM,1820,92,na,1912,27
STAT,1818,91,na,1909,59.451152959805015
STAT,1883,55,na,1938,4102.908973852579
STAT,1859,48,35-39,1907,0.22222074416471094
STAT,1840,60,na,1900,2752.9000926600957
SIM,1948,8,na,1956,9331
STAT,1832,41,na,1873,3376.199254075311
STAT,1891,74,na,1965,3382.394974408355
STAT,1939,30,45-49,1969,3.246629035647654
STAT,1870,17,20-24,1887,35.48747919367162
STAT,1912,44,40-44,1956,0.4835664395920259
STAT,1874,37,20-24,1911,1.5940498314470992
STAT,1825,93,na,1918,33.81482425897353
SIM,1810,82,na,1892,406
SIM,1846,20,50-100,1866,1
STAT,1915,48,25-29,1963,0.1076609342869559
SIM,1859,36,20-24,1895,1
SIM,1863,87,na,1950,326
STAT,1838,68,na,1906,2068.2122902913707
STAT,1928,41,25-29,1969,0.18409115407344864
STAT,1852,18,na,1870,4398.754234338412
SIM,1924,31,na,1955,9233
SIM,1908,32,50-100,1940,2
SIM,1902,18,30-34,1920,6
STAT,1903,49,na,1952,6335.655844804557
STAT,1873,16,35-39,1889,1.132653284143277
SIM,1872,18,35-39,1890,2
SIM,1882,37,20-24,1919,7
SIM,1858,27,50-100,1885,3
STAT,1801,53,15-19,1854,1.5101539657023008E-4
STAT,1844,50,45-49,1894,0.023773090480353226
STAT,1778,76,na,1854,744.0
STAT,1891,49,15-19,1940,5.51505910792409E-4
STAT,1915,28,na,1943,7690.411924738232
SIM,1856,42,na,1898,3897
STAT,1885,43,30-34,1928,2.2944782550406138
SIM,1882,36,na,1918,4924
STAT,1820,62,na,1882,2116.6764060599717
STAT,1818,47,35-39,1865,0.6171852366193191
SIM,1821,43,40-44,1864,7
SIM,1884,17,15-19,1901,14
SIM,1911,33,35-39,1944,31
STAT,1835,47,35-39,1882,0.19121173138640296
STAT,1844,27,20-24,1871,23.192227358380094
STAT,1875,49,30-34,1924,0.19707863407539084
SIM,1861,35,35-39,1896,18
SIM,1884,48,35-39,1932,1
STAT,1825,50,35-39,1875,0.018725863242510188
STAT,1830,38,45-49,1868,3.6838752097686163
STAT,1940,32,35-39,1972,19.102606390272076
STAT,1880,34,40-44,1914,9.147685836066191
SIM,1852,27,20-24,1879,21
SIM,1944,3,na,1947,8867
SIM,1795,66,na,1861,1578
SIM,1811,46,na,1857,2681
STAT,1870,44,25-29,1914,1.256099488740884
STAT,1856,49,20-24,1905,0.01830841746671562
STAT,1828,58,na,1886,2516.0503733009177
STAT,1911,46,na,1957,7043.718802357562
SIM,1869,92,na,1961,128
SIM,1850,90,na,1940,95
STAT,1833,36,20-24,1869,1.282667118670487
STAT,1922,30,50-100,1952,1.901329387093155
STAT,1813,43,40-44,1856,15.683044591566484
STAT,1876,85,na,1961,886.4339226771282
STAT,1903,33,35-39,1936,16.650721200403737
SIM,1832,32,50-100,1864,3
STAT,1876,48,35-39,1924,0.28876583966247343
STAT,1898,46,20-24,1944,0.018552795485636663
STAT,1818,52,30-34,1870,0.025164828294030214
STAT,1853,35,35-39,1888,11.425620760137692
SIM,1883,49,30-34,1932,1
STAT,1892,41,35-39,1933,4.598988654941591
SIM,1896,50,na,1946,6111
STAT,1820,53,25-29,1873,0.012426432320967505
SIM,1919,30,na,1949,8345
STAT,1833,80,na,1913,813.223882598727
STAT,1913,18,40-44,1931,0.5761995226984294
SIM,1826,47,35-39,1873,1
SIM,1856,20,na,1876,4295
SIM,1820,82,na,1902,429
STAT,1833,90,na,1923,103.6460014788168
STAT,1938,7,na,1945,7964.923872285756
STAT,1885,38,35-39,1923,14.148142426501133
SIM,1937,24,50-100,1961,2
STAT,1940,29,50-100,1969,2.0480017312946766
SIM,1835,27,50-100,1862,4
STAT,1798,109,na,1907,3.851490445928629E-4
STAT,1854,16,25-29,1870,10.45332167040335
STAT,1883,33,na,1916,4715.111386618119
STAT,1891,52,na,1943,5346.661226570173
SIM,1896,21,50-100,1917,1
SIM,1855,68,na,1923,2555
STAT,1830,43,40-44,1873,3.9756657791068273
STAT,1868,66,na,1934,3149.401248302629
STAT,1778,98,na,1876,1.210726217122532
SIM,1900,23,50-100,1923,6
STAT,1891,42,na,1933,5762.634065367282
STAT,1828,68,na,1896,1876.7116433044407
STAT,1837,52,40-44,1889,0.014729806853431924
STAT,1929,10,na,1939,10242.468653053545
SIM,1893,38,35-39,1931,9
SIM,1863,28,35-39,1891,25
STAT,1853,17,20-24,1870,33.742454516608426
STAT,1882,33,50-100,1915,1.7950114056877227
STAT,1903,27,na,1930,6862.596477524057
SIM,1795,76,na,1871,801
SIM,1861,17,20-24,1878,52
SIM,1882,58,na,1940,4069
STAT,1891,37,20-24,1928,1.9243333604690267
SIM,1870,35,na,1905,4660
SIM,1882,33,50-100,1915,2
STAT,1832,63,na,1895,2326.229331442117
STAT,1933,36,25-29,1969,2.711273530254389
STAT,1861,46,25-29,1907,0.09710098990798609
SIM,1914,31,na,1945,7826
SIM,1920,7,na,1927,9288
STAT,1793,65,na,1858,1560.934793620633
STAT,1863,35,na,1898,4204.690393196368
STAT,1857,28,45-49,1885,1.7873719271513724
STAT,1883,44,50-100,1927,2.0679933805306683
SIM,1830,44,45-49,1874,8
STAT,1813,92,na,1905,37.00970418915676
STAT,1807,54,20-24,1861,0.004615756869573355
STAT,1863,54,35-39,1917,0.014801422600901865
STAT,1924,47,50-100,1971,0.5436755016501429
SIM,1876,40,na,1916,5079
SIM,1880,32,40-44,1912,13
STAT,1897,0,na,1897,7927.057120274235
SIM,1880,17,30-34,1897,2
SIM,1853,49,45-49,1902,1
SIM,1931,20,40-44,1951,9
SIM,1940,24,15-19,1964,11
STAT,1846,20,50-100,1866,0.781877674029711
STAT,1826,46,30-34,1872,0.19566852473510266
STAT,1912,40,50-100,1952,0.231490246767074
SIM,1875,88,na,1963,525
STAT,1931,34,na,1965,9996.149295651816
STAT,1861,76,na,1937,1592.5934963282655
SIM,1909,27,30-34,1936,108
SIM,1873,75,na,1948,1922
STAT,1913,40,40-44,1953,0.49832968626386526
SIM,1813,41,40-44,1854,4
SIM,1891,38,25-29,1929,11
STAT,1872,17,30-34,1889,3.245782969639812
SIM,1879,27,35-39,1906,24
STAT,1840,82,na,1922,673.4839060799884
STAT,1874,45,20-24,1919,0.02506237336802292
STAT,1931,36,15-19,1967,0.05141227504092539
SIM,1915,35,50-100,1950,3
STAT,1803,53,25-29,1856,0.025502634412652676
STAT,1932,24,15-19,1956,14.058551081873711
SIM,1846,33,50-100,1879,4
STAT,1821,79,na,1900,774.9205062867286
SIM,1869,29,40-44,1898,9
SIM,1904,18,40-44,1922,1
STAT,1820,49,40-44,1869,0.6188572078289343
STAT,1901,46,30-34,1947,0.1548218922562975
SIM,1819,45,50-100,1864,1
STAT,1898,2,na,1900,7285.482475865698
STAT,1915,22,50-100,1937,1.3737816521092379
SIM,1812,63,na,1875,1972
STAT,1843,49,35-39,1892,0.19201976018330907
SIM,1930,41,30-34,1971,1
SIM,1865,28,45-49,1893,2
STAT,1920,30,30-34,1950,35.12520580135886
STAT,1843,18,15-19,1861,10.561154362116747
STAT,1881,40,20-24,1921,0.31314411866330233
STAT,1885,46,35-39,1931,0.28224053027409274
STAT,1908,58,na,1966,6369.628075541654
SIM,1916,17,20-24,1933,55
STAT,1883,23,na,1906,4678.40190689676
STAT,1802,65,na,1867,1779.9853568291269
STAT,1925,28,na,1953,8902.807867111056
STAT,1927,29,50-100,1956,2.4336428613411396
STAT,1866,53,na,1919,3947.961196190678
STAT,1830,35,40-44,1865,8.436100443294144
STAT,1901,68,na,1969,5000.627913346394
STAT,1840,100,na,1940,1.532421285356767
STAT,1946,20,35-39,1966,21.174745082713752
SIM,1844,28,25-29,1872,74
SIM,1848,33,na,1881,3845
STAT,1891,20,na,1911,5939.292008795012
STAT,1836,28,25-29,1864,72.27077942363887
SIM,1939,29,na,1968,8074
STAT,1914,42,35-39,1956,0.40304568872977764
STAT,1925,7,na,1932,9750.251050369043
STAT,1919,32,na,1951,8239.122669469481
SIM,1850,80,na,1930,954
SIM,1851,6,na,1857,4924
STAT,1872,32,40-44,1904,8.80240915652039
STAT,1795,78,na,1873,662.7326117013503
STAT,1870,16,50-100,1886,0.09864885325578039
STAT,1908,17,20-24,1925,53.14818267365346
SIM,1845,16,25-29,1861,11
STAT,1811,43,30-34,1854,8.840709054907382
SIM,1845,47,45-49,1892,1
SIM,1854,19,na,1873,4601
SIM,1861,48,40-44,1909,1
SIM,1880,2,na,1882,6832
SIM,1933,34,25-29,1967,27
STAT,1879,26,30-34,1905,53.378742175274205
STAT,1922,41,30-34,1963,0.2967081892847469
STAT,1816,47,25-29,1863,0.28301261481479106
SIM,1890,55,na,1945,5432
SIM,1837,39,na,1876,3432
SIM,1838,23,na,1861,3812
STAT,1871,86,na,1957,534.7712294445225
SIM,1869,16,20-24,1885,40
STAT,1850,39,25-29,1889,4.392322302125016
SIM,1830,53,35-39,1883,1
STAT,1849,20,na,1869,4148.401698687537
SIM,1920,27,na,1947,8451
STAT,1846,27,30-34,1873,46.66179329431096
SIM,1886,48,45-49,1934,1
SIM,1886,17,25-29,1903,16
SIM,1928,30,35-39,1958,31
SIM,1799,80,na,1879,402
STAT,1821,101,na,1922,0.632505509053035
STAT,1920,29,na,1949,8238.271111419775
STAT,1925,34,25-29,1959,22.1333910015106
SIM,1875,66,na,1941,3600
STAT,1928,29,40-44,1957,11.584163373838194
SIM,1878,21,na,1899,5152
STAT,1859,40,na,1899,3752.7815663297756
STAT,1833,44,20-24,1877,0.24700439775711436
SIM,1897,34,na,1931,6479
STAT,1765,114,na,1879,5.516016407781005E-4
STAT,1842,41,na,1883,3605.999476180824
STAT,1883,38,25-29,1921,5.684777250361811
SIM,1817,94,na,1911,4
SIM,1853,46,40-44,1899,1
STAT,1881,25,45-49,1906,2.1821063017023863
SIM,1926,44,35-39,1970,1
SIM,1876,15,15-19,1891,13
STAT,1898,29,45-49,1927,3.0128673030645983
STAT,1862,18,25-29,1880,11.137245226721781
SIM,1789,80,na,1869,415
STAT,1910,29,na,1939,7256.361539090506
STAT,1912,31,35-39,1943,18.239723265753813
SIM,1889,26,50-100,1915,2
SIM,1870,18,25-29,1888,20
STAT,1832,48,20-24,1880,0.01826062936061846
SIM,1936,29,40-44,1965,13
STAT,1864,38,15-19,1902,0.10087353661751232
STAT,1923,20,40-44,1943,7.945842056213094
STAT,1836,87,na,1923,234.24700484389416
STAT,1861,54,na,1915,3519.959295208206
STAT,1866,51,35-39,1917,0.01611956595257251
SIM,1842,15,45-49,1857,2
STAT,1811,52,20-24,1863,0.004778350498928733
STAT,1817,42,na,1859,3075.241814127104
STAT,1871,39,45-49,1910,3.9597031851180438
STAT,1844,42,30-34,1886,1.9014838918921884
STAT,1860,37,na,1897,3863.99771206093
STAT,1893,37,30-34,1930,13.643069182955793
STAT,1931,31,45-49,1962,4.166821360502759
SIM,1887,26,30-34,1913,75
STAT,1926,46,35-39,1972,0.3220331400453452
SIM,1854,27,30-34,1881,55
STAT,1878,54,na,1932,4416.784926877726
STAT,1907,31,na,1938,7172.883131560986
SIM,1863,22,na,1885,4503
STAT,1883,47,15-19,1930,7.90008370870557E-4
STAT,1926,41,15-19,1967,0.003828369488666157
SIM,1876,19,30-34,1895,3
STAT,1851,48,30-34,1899,0.14817219805612608
STAT,1846,87,na,1933,269.8577149199236
SIM,1935,17,30-34,1952,34
STAT,1927,17,30-34,1944,30.60329352992555
STAT,1859,45,30-34,1904,0.1571562678595012
SIM,1867,37,na,1904,4775
STAT,1869,27,25-29,1896,82.7813228887476
SIM,1835,58,na,1893,2658
STAT,1812,75,na,1887,984.221965770808
SIM,1849,72,na,1921,1917
STAT,1903,41,20-24,1944,0.03185606449986717
STAT,1906,34,15-19,1940,0.2385856781756468
STAT,1907,43,20-24,1950,0.0324995214150466
STAT,1821,50,50-100,1871,0.044247628909099605
STAT,1884,19,15-19,1903,11.771630158099859
STAT,1822,44,45-49,1866,4.772460038696619
SIM,1812,48,45-49,1860,1
STAT,1868,19,30-34,1887,3.0814910564170828
SIM,1873,22,na,1895,5023
STAT,1878,48,45-49,1926,0.49154014975865773
SIM,1822,34,45-49,1856,6
SIM,1860,89,na,1949,155
STAT,1812,96,na,1908,8.139347208427282
SIM,1870,42,25-29,1912,2
STAT,1914,44,15-19,1958,0.003063524797516907
STAT,1933,33,20-24,1966,6.635245590153287
SIM,1925,30,50-100,1955,3
STAT,1861,108,na,1969,0.04005029203793824
SIM,1833,34,20-24,1867,2
SIM,1846,25,30-34,1871,53
STAT,1919,10,na,1929,8868.082884528283
SIM,1883,75,na,1958,2440
STAT,1858,29,15-19,1887,0.7207807496739519
SIM,1844,19,na,1863,4056
SIM,1830,36,45-49,1866,4
SIM,1811,44,35-39,1855,10
SIM,1842,35,50-100,1877,3
STAT,1866,75,na,1941,1918.3817038863956
SIM,1901,34,50-100,1935,2
STAT,1826,54,30-34,1880,0.011002656990749874
SIM,1920,49,na,1969,8316
SIM,1842,93,na,1935,25
SIM,1943,19,30-34,1962,32
SIM,1875,47,30-34,1922,1
SIM,1840,48,20-24,1888,1
STAT,1845,15,20-24,1860,34.9385973925365
STAT,1887,28,30-34,1915,56.68047061448723
STAT,1893,45,30-34,1938,0.14117121411730782
STAT,1842,17,45-49,1859,0.12488574296309475
STAT,1932,30,na,1962,10166.287665234242
STAT,1901,30,20-24,1931,7.703976347677754
STAT,1930,35,45-49,1965,1.7989591285200925
SIM,1824,64,na,1888,2080
SIM,1935,20,25-29,1955,288
STAT,1845,46,40-44,1891,0.26455718862408584
SIM,1866,29,15-19,1895,1
SIM,1907,29,na,1936,7359
STAT,1877,36,35-39,1913,14.904427490649667
STAT,1910,40,15-19,1950,0.0029654828093562896
STAT,1855,50,20-24,1905,0.0011287244665013226
SIM,1926,32,na,1958,9453
SIM,1839,38,45-49,1877,3
STAT,1915,45,20-24,1960,0.022597749400665123
STAT,1908,16,na,1924,7590.084450314223
STAT,1862,42,25-29,1904,1.1071275323335374
STAT,1838,25,30-34,1863,43.98236689131184
SIM,1908,18,25-29,1926,20
SIM,1865,88,na,1953,187
STAT,1879,49,15-19,1928,8.273473848264654E-4
SIM,1898,27,45-49,1925,8
SIM,1853,15,20-24,1868,31
SIM,1859,39,25-29,1898,9
SIM,1899,15,na,1914,7138
STAT,1823,69,na,1892,1761.054181098013
STAT,1811,79,na,1890,649.8633425399404
STAT,1910,23,25-29,1933,174.71189473723908
STAT,1938,18,45-49,1956,0.9950484606301979
STAT,1925,40,45-49,1965,0.4079896234876117
SIM,1885,36,35-39,1921,23
SIM,1826,44,30-34,1870,3
STAT,1870,40,45-49,1910,2.9975228722224543
STAT,1842,37,25-29,1879,5.0284937513204175
SIM,1936,10,na,1946,6884
STAT,1830,52,30-34,1882,0.009036762990168028
STAT,1853,48,40-44,1901,0.26746936187661163
STAT,1838,19,45-49,1857,0.11540528286778204
SIM,1868,17,30-34,1885,4
SIM,1892,36,na,1928,6786
STAT,1870,37,na,1907,4671.49573220205
STAT,1897,17,35-39,1914,1.481318207506048
STAT,1899,41,45-49,1940,0.28888933719470683
SIM,1818,45,35-39,1863,1
STAT,1841,100,na,1941,1.5403725039390066
STAT,1916,3,na,1919,8662.649544340278
SIM,1857,29,50-100,1886,4
SIM,1850,37,25-29,1887,8
STAT,1918,44,35-39,1962,0.43088066473842174
SIM,1886,40,na,1926,4882
STAT,1832,110,na,1942,3.602669018150192E-4
STAT,1867,47,30-34,1914,0.18223632683403843
SIM,1864,24,50-100,1888,1
STAT,1870,35,35-39,1905,14.157572679716315
STAT,1935,19,30-34,1954,33.478335107551274
SIM,1946,18,45-49,1964,2
STAT,1820,45,25-29,1865,0.22064857111325065
STAT,1822,36,45-49,1858,8.331161806095873
SIM,1878,46,45-49,1924,2
SIM,1914,40,35-39,1954,1
STAT,1858,66,na,1924,2580.487605204627
STAT,1852,53,20-24,1905,0.0011572198656934107
STAT,1866,35,20-24,1901,1.450103516425624
SIM,1824,42,na,1866,3331
STAT,1818,58,na,1876,2365.669079906384
STAT,1830,46,45-49,1876,0.4126826048771679
SIM,1857,26,45-49,1883,1
STAT,1852,44,30-34,1896,1.8076196687818404
SIM,1825,81,na,1906,511
SIM,1881,22,50-100,1903,1
SIM,1905,30,40-44,1935,11
STAT,1927,20,25-29,1947,231.1770442501484
SIM,1866,20,na,1886,4695
STAT,1819,51,50-100,1870,0.06207646831536495
STAT,1913,27,na,1940,7540.514726770302
SIM,1838,26,35-39,1864,24
SIM,1849,17,20-24,1866,40
SIM,1880,35,na,1915,5297
SIM,1883,53,na,1936,4378
STAT,1858,40,45-49,1898,2.3801140189681136
SIM,1790,77,na,1867,733
STAT,1871,27,50-100,1898,1.2835523846794423
SIM,1855,1,na,1856,6025
STAT,1863,37,45-49,1900,3.5242864821135176
SIM,1851,18,15-19,1869,10
SIM,1872,15,30-34,1887,6
STAT,1885,35,30-34,1920,10.815782301435803
SIM,1850,17,45-49,1867,1
STAT,1909,29,30-34,1938,75.12773856491611
SIM,1917,29,30-34,1946,103
STAT,1840,24,45-49,1864,1.2617069350763281
STAT,1865,35,50-100,1900,2.2740701588060457
SIM,1895,28,30-34,1923,84
SIM,1914,53,na,1967,7293
SIM,1853,87,na,1940,201
STAT,1812,47,40-44,1859,1.189076745734423
STAT,1803,92,na,1895,29.39314821277205
STAT,1818,44,30-34,1862,5.260579537794361
STAT,1871,53,30-34,1924,0.01175210815059496
SIM,1893,35,30-34,1928,2
STAT,1876,17,15-19,1893,12.396444143799394
SIM,1906,44,na,1950,6702
STAT,1912,47,45-49,1959,0.4219561263333566
STAT,1906,40,35-39,1946,0.3737993904181437
STAT,1851,76,na,1927,1468.648681771478
STAT,1941,4,na,1945,8348.24322262749
STAT,1849,26,45-49,1875,2.096956015556622
STAT,1869,40,na,1909,4568.594727237067
STAT,1877,91,na,1968,387.3685811331994
STAT,1916,45,na,1961,7645.962822347736
SIM,1820,47,40-44,1867,1
STAT,1845,107,na,1952,0.00726698141816037
STAT,1824,49,25-29,1873,0.13563391731104446
SIM,1942,28,na,1970,8047
STAT,1905,41,45-49,1946,0.3049295652079504
SIM,1828,37,30-34,1865,18
STAT,1823,37,15-19,1860,0.2178969881816036
STAT,1886,16,20-24,1902,37.88903891526472
SIM,1900,35,25-29,1935,3
STAT,1853,35,na,1888,3805.853319489044
SIM,1894,16,20-24,1910,49
STAT,1898,49,25-29,1947,0.08694718761353082
STAT,1886,47,40-44,1933,0.36328697185568937
STAT,1940,17,na,1957,7548.2972005567035
SIM,1804,51,50-100,1855,1
STAT,1928,32,35-39,1960,23.07382404777072
SIM,1929,30,na,1959,9904
STAT,1919,18,35-39,1937,9.338648818866467
SIM,1868,86,na,1954,330
SIM,1868,22,50-100,1890,1
STAT,1890,28,15-19,1918,1.1145105730583709
SIM,1851,21,na,1872,4141
STAT,1821,41,25-29,1862,2.100546127346681
SIM,1839,72,na,1911,1633
STAT,1907,63,na,1970,5942.171085114921
SIM,1917,29,na,1946,8038
SIM,1945,19,40-44,1964,3
STAT,1879,17,na,1896,5335.285147698086
SIM,1877,5,na,1882,5604
SIM,1922,31,45-49,1953,8
SIM,1921,33,na,1954,8467
STAT,1836,107,na,1943,0.006270252751250432
STAT,1862,49,45-49,1911,0.39887763614904814
STAT,1858,34,na,1892,3724.8854676591773
STAT,1918,26,na,1944,8077.920412106948
SIM,1863,17,30-34,1880,4
STAT,1864,15,30-34,1879,3.3099034109313954
SIM,1889,69,na,1958,3738
STAT,1855,17,30-34,1872,2.858664667020169
SIM,1881,41,na,1922,3989
STAT,1884,43,15-19,1927,0.02734158870950676
STAT,1929,24,50-100,1953,1.6698187371087774
SIM,1915,16,na,1931,8271
SIM,1929,42,45-49,1971,1
STAT,1846,54,35-39,1900,0.012823952454014569
STAT,1896,73,na,1969,3947.5537679250197
STAT,1937,19,40-44,1956,2.7405237430874414
SIM,1854,42,40-44,1896,5
SIM,1870,49,45-49,1919,1
SIM,1926,4,na,1930,10212
STAT,1840,37,15-19,1877,0.09586913326686741
SIM,1807,62,na,1869,1765
SIM,1868,26,20-24,1894,27
STAT,1820,34,50-100,1854,5.893607906375886
SIM,1869,33,50-100,1902,3
STAT,1820,94,na,1914,22.374561689488566
STAT,1875,16,45-49,1891,0.13616205055386355
SIM,1838,47,50-100,1885,1
SIM,1864,61,na,1925,3484
STAT,1910,47,35-39,1957,0.24303265550965664
SIM,1840,69,na,1909,2216
SIM,1864,71,na,1935,2438
STAT,1932,21,45-49,1953,2.9908419289988952
SIM,1940,15,na,1955,7765
STAT,1882,47,20-24,1929,0.02349869575405649
SIM,1911,13,na,1924,8131
STAT,1839,52,na,1891,3344.1193258441367
STAT,1949,18,20-24,1967,318.3274732252582
STAT,1831,40,50-100,1871,1.7165637386977215
STAT,1940,20,40-44,1960,6.922898532456393
STAT,1843,47,50-100,1890,0.34243689518234793
SIM,1828,35,na,1863,3493
STAT,1874,48,25-29,1922,0.11761524704507001
STAT,1851,34,50-100,1885,1.447943132050558
STAT,1853,32,30-34,1885,28.44781249744357
STAT,1878,45,40-44,1923,0.3647124106940361
STAT,1922,30,na,1952,8697.369438485533
SIM,1876,19,na,1895,5404
STAT,1846,42,40-44,1888,3.4869446587635924
STAT,1913,48,15-19,1961,7.243089536274816E-4
STAT,1917,31,20-24,1948,5.179129712195217
STAT,1882,20,50-100,1902,0.8070723872941747
SIM,1859,43,30-34,1902,8
STAT,1909,30,50-100,1939,1.6071260501683413
STAT,1921,21,35-39,1942,21.538530895437415
STAT,1830,39,na,1869,3644.1112090902907
SIM,1836,54,na,1890,2614
STAT,1883,51,35-39,1934,0.01716446127851629
STAT,1920,36,50-100,1956,0.9290349773953678
STAT,1918,18,50-100,1936,0.8212826325480357
STAT,1865,22,50-100,1887,0.7573136530667911
STAT,1861,43,20-24,1904,0.2650375366054357
SIM,1900,50,na,1950,6316
SIM,1832,61,na,1893,2429
SIM,1930,30,40-44,1960,14
STAT,1840,28,50-100,1868,1.1430261083737607
STAT,1856,22,na,1878,3869.4672803335666
STAT,1814,47,15-19,1861,0.002072250375077977
STAT,1878,17,25-29,1895,11.952834172299047
STAT,1866,46,50-100,1912,0.45897003068372555
STAT,1914,31,45-49,1945,3.2126227712880984
STAT,1837,44,40-44,1881,3.281942153812347
STAT,1821,54,30-34,1875,0.016104627875289847
STAT,1899,17,50-100,1916,0.1355673217732217
SIM,1886,45,40-44,1931,1
STAT,1854,53,30-34,1907,0.0089786680594516
STAT,1833,47,25-29,1880,0.08885004124406297
STAT,1849,16,50-100,1865,0.09595569646111012
STAT,1873,49,20-24,1922,0.024110529981493916
SIM,1861,32,30-34,1893,33
STAT,1823,50,25-29,1873,0.010962252783256037
STAT,1910,20,20-24,1930,212.2295419848827
STAT,1807,47,50-100,1854,1.6909678057982513
SIM,1861,44,25-29,1905,2
STAT,1829,27,30-34,1856,72.97189296642703
SIM,1817,72,na,1889,1250
STAT,1877,52,50-100,1929,0.031504244151447695
STAT,1811,46,35-39,1857,0.9669016873958575
STAT,1817,52,15-19,1869,1.138588896517684E-4
STAT,1894,27,50-100,1921,1.659615894872481
STAT,1936,31,30-34,1967,30.93074125318155
SIM,1845,44,40-44,1889,10
SIM,1918,17,30-34,1935,34
STAT,1896,18,30-34,1914,4.238803767061994
SIM,1922,30,40-44,1952,13
SIM,1826,40,50-100,1866,4
STAT,1880,39,50-100,1919,2.5858226233197743
STAT,1920,41,20-24,1961,0.0394398720652061
STAT,1827,42,30-34,1869,2.183850191569966
STAT,1896,49,15-19,1945,5.890728728425996E-4
STAT,1805,53,35-39,1858,0.06624501998455658
STAT,1897,14,na,1911,6949.279373349869
STAT,1937,30,35-39,1967,18.283831576094904
STAT,1799,60,na,1859,2000.7056624827726
STAT,1904,40,25-29,1944,0.13056694239970126
SIM,1872,90,na,1962,395
SIM,1859,28,20-24,1887,23
STAT,1940,21,45-49,1961,2.3158307562073013
STAT,1856,16,35-39,1872,1.0169935669575485
SIM,1925,26,na,1951,8908
STAT,1914,30,40-44,1944,8.020922963918121
SIM,1926,41,30-34,1967,1
STAT,1875,14,na,1889,5366.755066460796
STAT,1881,22,40-44,1903,4.06776421525495
STAT,1920,42,25-29,1962,0.15924462033046446
SIM,1919,29,40-44,1948,13
STAT,1841,53,45-49,1894,0.020718410480084926
STAT,1912,17,50-100,1929,0.1530468159553851
SIM,1880,44,35-39,1924,9
SIM,1864,16,35-39,1880,1
STAT,1872,44,35-39,1916,3.625869977113504
STAT,1840,54,40-44,1894,0.014778153149118633
STAT,1810,47,30-34,1857,0.6314226326256239
STAT,1888,54,na,1942,4998.548719355947
STAT,1872,50,20-24,1922,0.0015193086687539058
SIM,1841,47,25-29,1888,1
STAT,1949,18,50-100,1967,0.8796814919530616
SIM,1848,28,45-49,1876,4
SIM,1885,8,na,1893,5430
SIM,1909,30,25-29,1939,17
STAT,1888,40,30-34,1928,2.7720242574811134
STAT,1873,23,na,1896,4838.216044023969
SIM,1900,41,45-49,1941,1
STAT,1801,59,na,1860,2136.430944434364
SIM,1818,42,30-34,1860,2
SIM,1934,18,50-100,1952,1
SIM,1914,31,45-49,1945,6
STAT,1888,19,35-39,1907,1.3027802480528634
STAT,1933,15,na,1948,9998.408974263715
SIM,1919,40,35-39,1959,1
STAT,1840,39,na,1879,3581.4147066772566
SIM,1862,29,50-100,1891,5
STAT,1916,48,40-44,1964,0.32568547070378173
STAT,1877,33,30-34,1910,36.46127094422425
SIM,1850,22,50-100,1872,4
STAT,1886,73,na,1959,2788.501852022712
STAT,1849,19,20-24,1868,34.11322326958627
SIM,1830,33,40-44,1863,13
SIM,1885,33,30-34,1918,50
SIM,1835,42,30-34,1877,2
STAT,1872,49,na,1921,4471.245982539397
STAT,1831,31,40-44,1862,7.395134825643598
STAT,1953,2,na,1955,9613.37468415113
SIM,1844,17,20-24,1861,33
SIM,1874,71,na,1945,2396
STAT,1762,116,na,1878,2.6783468112880835E-4
STAT,1912,42,25-29,1954,0.13913262356596193
STAT,1894,33,30-34,1927,45.10628001337102
STAT,1936,32,35-39,1968,17.930186006308393
STAT,1821,57,na,1878,2414.621940528658
SIM,1857,19,20-24,1876,40
STAT,1820,42,20-24,1862,0.6424865740495764
SIM,1928,15,25-29,1943,122
STAT,1853,67,na,1920,2508.133962773355
STAT,1918,41,30-34,1959,0.27487104304312565
STAT,1890,29,50-100,1919,1.5656707916352128
STAT,1841,46,20-24,1887,0.01771561055950433
STAT,1914,33,na,1947,7657.5913101944025
SIM,1949,19,25-29,1968,141
STAT,1904,40,50-100,1944,0.21480367808153322
SIM,1931,33,na,1964,10022
STAT,1912,8,na,1920,8120.780118073631
STAT,1937,28,na,1965,7373.013410446534
SIM,1859,15,15-19,1874,12
STAT,1890,41,25-29,1931,1.5901799999515507
SIM,1895,43,40-44,1938,2
STAT,1831,43,35-39,1874,2.83057082041831
STAT,1901,42,15-19,1943,0.0027080603411615283
SIM,1896,34,50-100,1930,3
SIM,1826,54,na,1880,2566
STAT,1822,53,35-39,1875,0.025244267769879446
STAT,1876,54,20-24,1930,0.0014990223303477674
STAT,1925,31,20-24,1956,5.8520149752049155
STAT,1854,41,na,1895,3559.132847233632
STAT,1868,34,na,1902,4546.101642948946
STAT,1904,5,na,1909,7596.5489456706455
SIM,1866,52,na,1918,4177
STAT,1824,32,50-100,1856,4.122210301498487
STAT,1953,13,na,1966,9594.452956634812
STAT,1887,43,40-44,1930,5.043946323027785
SIM,1930,30,50-100,1960,2
STAT,1793,97,na,1890,1.949973061871424
SIM,1901,13,na,1914,7355
SIM,1866,40,45-49,1906,7
SIM,1834,42,na,1876,3301
STAT,1926,43,30-34,1969,0.31774995302762077
STAT,1880,46,35-39,1926,0.29870590294310606
STAT,1927,42,35-39,1969,0.5099636363800196
STAT,1861,86,na,1947,372.9757274419026
SIM,1829,28,35-39,1857,17
STAT,1839,20,na,1859,4351.888139110818
SIM,1836,18,25-29,1854,19
SIM,1837,17,na,1854,4115
STAT,1930,30,25-29,1960,24.11692377513548
SIM,1914,24,50-100,1938,2
SIM,1958,10,na,1968,10839
STAT,1821,48,45-49,1869,0.6808455564609882
STAT,1840,21,40-44,1861,3.8527578415754435
SIM,1896,19,35-39,1915,2
STAT,1836,39,50-100,1875,1.9629298040085192
SIM,1897,66,na,1963,4838
STAT,1877,53,25-29,1930,0.007308894286249244
STAT,1900,49,40-44,1949,0.26490684237881473
STAT,1897,46,50-100,1943,0.37506716670402923
STAT,1789,82,na,1871,342.55799608973206
STAT,1892,49,30-34,1941,0.13517075652094182
SIM,1933,31,20-24,1964,10
STAT,1910,6,na,1916,7997.548779066434
SIM,1855,18,35-39,1873,1
STAT,1922,33,45-49,1955,3.5746548529768303
STAT,1929,42,45-49,1971,0.43524996582683556
SIM,1940,21,45-49,1961,2
STAT,1802,54,20-24,1856,0.004542449645947538
STAT,1911,30,15-19,1941,0.2548270802586123
SIM,1818,57,na,1875,2424
STAT,1902,20,20-24,1922,197.66576664123343
STAT,1866,18,45-49,1884,0.12420713169960126
STAT,1922,46,15-19,1968,8.565715223566588E-4
STAT,1853,89,na,1942,166.2158352159407
STAT,1898,32,na,1930,6521.997458777411
SIM,1930,33,45-49,1963,5
STAT,1810,44,50-100,1854,7.424321122682102
SIM,1931,11,na,1942,10511
STAT,1842,50,35-39,1892,0.013001481172484635
STAT,1914,11,na,1925,8264.423804379128
STAT,1771,87,na,1858,81.50640957435482
STAT,1847,45,50-100,1892,0.37811074572555003
SIM,1839,94,na,1933,34
STAT,1884,30,45-49,1914,3.5056069750267054
SIM,1937,17,40-44,1954,3
SIM,1889,47,na,1936,5685
SIM,1857,37,na,1894,4134
SIM,1885,34,na,1919,4946
STAT,1836,52,25-29,1888,0.00476613255100514
SIM,1841,43,na,1884,3384
STAT,1847,18,35-39,1865,1.0377861426687367
STAT,1790,79,na,1869,512.404385235628
STAT,1859,19,na,1878,4232.891724754511
STAT,1869,20,50-100,1889,0.8062191223306285
STAT,1906,31,45-49,1937,2.9588205603441504
SIM,1889,26,40-44,1915,13
STAT,1839,42,na,1881,3803.5541118271503
STAT,1864,51,25-29,1915,0.006425024401339185
STAT,1822,33,40-44,1855,23.93639620131193
SIM,1810,48,35-39,1858,1
SIM,1892,30,45-49,1922,10
SIM,1890,33,50-100,1923,3
STAT,1808,91,na,1899,45.535447959134366
STAT,1874,33,50-100,1907,1.8867220410084085
SIM,1858,86,na,1944,327
STAT,1837,107,na,1944,0.0065728865905818525
STAT,1857,48,25-29,1905,0.08953442385277838
SIM,1923,0,na,1923,10374
STAT,1812,43,25-29,1855,4.985125323415192
STAT,1821,47,na,1868,2879.557870898499
SIM,1920,42,25-29,1962,1
STAT,1929,41,40-44,1970,0.6550733007307988
STAT,1905,46,15-19,1951,6.608959528173892E-4
STAT,1916,41,20-24,1957,0.036603377882030885
SIM,1916,44,na,1960,7781
SIM,1876,43,30-34,1919,5
SIM,1835,91,na,1926,67
STAT,1863,30,25-29,1893,18.253460979958696
STAT,1921,20,30-34,1941,65.9376443696114
STAT,1853,57,na,1910,3179.641094438589
STAT,1867,16,45-49,1883,0.12705617709762784
SIM,1878,15,25-29,1893,15
STAT,1868,43,30-34,1911,2.193159676043371
STAT,1893,48,35-39,1941,0.19961769697808004
SIM,1820,43,25-29,1863,3
STAT,1860,45,50-100,1905,0.40682012984062504
SIM,1872,42,35-39,1914,7
STAT,1912,52,na,1964,7012.530568899864
SIM,1837,42,40-44,1879,10
STAT,1846,45,45-49,1891,0.36508718855638944
SIM,1867,15,na,1882,5310
STAT,1927,41,30-34,1968,0.3242379049530768
SIM,1825,91,na,1916,40
SIM,1837,49,na,1886,3036
SIM,1946,10,na,1956,8638
SIM,1859,17,15-19,1876,15
STAT,1872,60,na,1932,3871.079841185594
SIM,1856,16,35-39,1872,1
STAT,1842,94,na,1936,29.7555603562554
SIM,1854,93,na,1947,51
SIM,1909,15,15-19,1924,17
STAT,1911,32,30-34,1943,30.993629016218165
STAT,1822,49,15-19,1871,0.0012083385920835484
STAT,1900,20,na,1920,6665.512521668364
STAT,1871,32,25-29,1903,20.551939407688266
SIM,1895,22,na,1917,6601
SIM,1786,94,na,1880,5
SIM,1842,61,na,1903,2637
STAT,1832,52,40-44,1884,0.014276300229249424
STAT,1861,34,30-34,1895,29.098649112943264
STAT,1954,4,na,1958,9817.528692035372
STAT,1918,41,50-100,1959,0.25258420116103386
STAT,1763,99,na,1862,0.31561168868818157
STAT,1850,43,45-49,1893,2.2781763504560724
SIM,1848,25,40-44,1873,1
STAT,1820,36,35-39,1856,37.49791884651791
STAT,1824,45,50-100,1869,0.6117702431846402
SIM,1821,39,50-100,1860,5
STAT,1840,51,50-100,1891,0.021904222333082993
STAT,1844,53,na,1897,3421.3508396332004
STAT,1924,46,25-29,1970,0.1278239605644158
STAT,1858,16,45-49,1874,0.12084836159131093
STAT,1848,16,35-39,1864,1.1219473690482253
STAT,1831,57,na,1888,2610.6872548785486
STAT,1864,42,35-39,1906,3.2650545333967993
STAT,1923,40,35-39,1963,0.4764966329184942
SIM,1832,45,50-100,1877,2
SIM,1866,27,50-100,1893,4
STAT,1810,62,na,1872,1945.04998686341
STAT,1824,53,45-49,1877,0.03318394289564066
STAT,1854,47,45-49,1901,0.3600983377474853
STAT,1901,34,50-100,1935,2.568384892899378
STAT,1929,17,40-44,1946,3.6047658418522244
STAT,1910,44,30-34,1954,0.241111159487198
SIM,1926,41,50-100,1967,1
SIM,1810,45,30-34,1855,1
STAT,1879,50,30-34,1929,0.012755327213478497
STAT,1864,18,35-39,1882,1.0187074675181333
SIM,1871,34,40-44,1905,10
SIM,1870,46,40-44,1916,1
STAT,1862,46,40-44,1908,0.29636470426387496
STAT,1858,27,50-100,1885,1.0310081952957237
SIM,1854,45,45-49,1899,1
SIM,1907,19,20-24,1926,46
STAT,1888,6,na,1894,6235.867009598131
SIM,1812,95,na,1907,8
STAT,1912,40,25-29,1952,0.14070975872329644
SIM,1833,24,na,1857,3675
STAT,1842,109,na,1951,0.0010592315428559701
SIM,1903,30,30-34,1933,61
STAT,1891,44,45-49,1935,3.685754250796414
STAT,1933,25,na,1958,10055.638175360176
SIM,1859,49,na,1908,3889
SIM,1889,15,na,1904,6553
SIM,1861,41,20-24,1902,3
SIM,1880,41,30-34,1921,4
STAT,1776,101,na,1877,0.26100353067549364
STAT,1856,40,35-39,1896,2.850147272963076
SIM,1844,39,50-100,1883,3
SIM,1846,42,na,1888,3582
STAT,1806,58,na,1864,2057.9481804808356
STAT,1839,16,35-39,1855,1.1274201314395835
SIM,1862,47,45-49,1909,1
SIM,1848,23,na,1871,3917
SIM,1827,39,na,1866,3279
SIM,1836,54,40-44,1890,1
STAT,1867,19,15-19,1886,11.340289225055061
SIM,1875,19,15-19,1894,12
SIM,1860,57,na,1917,3452
SIM,1926,30,25-29,1956,30
STAT,1881,49,20-24,1930,0.02293588056776381
SIM,1894,48,na,1942,5964
STAT,1852,47,35-39,1899,0.2220931733764823
STAT,1872,41,30-34,1913,2.3440868470946734
STAT,1902,45,35-39,1947,0.22742044115184348
STAT,1837,40,25-29,1877,1.083787792125831
STAT,1868,28,20-24,1896,22.46294438941769
STAT,1901,37,40-44,1938,2.671426941611265
STAT,1877,29,50-100,1906,1.3319479306747446
STAT,1861,50,45-49,1911,0.02474606327031441
STAT,1825,61,na,1886,2269.850574294289
STAT,1864,106,na,1970,0.27677352903419145
STAT,1809,54,na,1863,2505.0485200573266
STAT,1865,47,20-24,1912,0.021915087875357467
SIM,1862,16,na,1878,4976
SIM,1878,43,40-44,1921,6
STAT,1938,14,na,1952,7869.517980186641
STAT,1931,40,35-39,1971,0.5448265277611407
SIM,1845,40,25-29,1885,2
STAT,1948,24,na,1972,8461.85277656086
STAT,1855,48,15-19,1903,5.955943511175705E-4
STAT,1908,48,na,1956,6695.9117830595405
SIM,1870,89,na,1959,283
STAT,1921,45,45-49,1966,0.49703371758811155
STAT,1815,61,na,1876,2149.9046238741175
STAT,1873,53,40-44,1926,0.02125646300371667
STAT,1840,50,25-29,1890,0.005186155741319403
STAT,1882,70,na,1952,2760.40352739269
STAT,1828,54,40-44,1882,0.016017797769329958
SIM,1865,56,na,1921,3779
SIM,1890,23,na,1913,6214
STAT,1827,45,35-39,1872,0.2596815778616468
STAT,1847,71,na,1918,2034.692418195324
STAT,1895,45,40-44,1940,0.25667300482743416
STAT,1923,15,na,1938,8766.720241252197
SIM,1885,18,20-24,1903,39
STAT,1890,49,20-24,1939,0.016338235245493875
STAT,1901,33,25-29,1934,28.837412318212504
STAT,1834,53,na,1887,2876.394058712636
STAT,1924,34,50-100,1958,1.945084639756408
SIM,1852,38,na,1890,3792
STAT,1845,41,50-100,1886,1.6791207989797718
SIM,1894,40,20-24,1934,4
STAT,1809,54,30-34,1863,0.04214561883713486
STAT,1880,43,30-34,1923,2.4283337275820744
SIM,1915,48,na,1963,7515
STAT,1858,56,na,1914,3211.2371684055634
STAT,1868,52,20-24,1920,0.001410383196864301
STAT,1930,32,40-44,1962,10.199565123707494
SIM,1866,19,na,1885,4978
STAT,1794,61,na,1855,1913.3123999999998
SIM,1926,19,30-34,1945,51
STAT,1823,41,35-39,1864,6.184646835200107
SIM,1895,46,45-49,1941,1
STAT,1821,45,40-44,1866,0.5158020078458949
SIM,1853,41,50-100,1894,3
SIM,1875,56,na,1931,4585
STAT,1928,14,na,1942,10048.949824376425
SIM,1840,80,na,1920,988
STAT,1797,109,na,1906,3.442583501443224E-4
SIM,1891,42,45-49,1933,9
SIM,1945,14,na,1959,9030
STAT,1857,71,na,1928,2101.2390334796723
SIM,1829,25,30-34,1854,61
SIM,1878,17,25-29,1895,18
STAT,1810,48,35-39,1858,0.8957845854664039
STAT,1916,47,50-100,1963,0.4685241768051654
STAT,1843,42,15-19,1885,0.01991792009804743
STAT,1820,47,50-100,1867,0.9139185576280191
STAT,1888,22,na,1910,5645.525052959505
STAT,1823,80,na,1903,742.3164413220812
STAT,1884,47,30-34,1931,0.1921453943115796
SIM,1929,18,45-49,1947,1
STAT,1888,16,30-34,1904,3.8140145047627363
STAT,1908,41,20-24,1949,0.03321123187642663
SIM,1896,16,30-34,1912,4
SIM,1903,31,35-39,1934,46
STAT,1926,32,25-29,1958,22.567330116756793
STAT,1849,50,45-49,1899,0.023285594368758353
SIM,1934,32,25-29,1966,27
SIM,1867,17,15-19,1884,12
STAT,1844,75,na,1919,1662.492746803504
SIM,1924,47,50-100,1971,2
STAT,1883,42,45-49,1925,2.9660870154916528
STAT,1851,44,15-19,1895,0.02111879332925872
SIM,1847,16,35-39,1863,1
STAT,1908,26,na,1934,7179.086044807375
STAT,1886,40,20-24,1926,0.34199666004562046
STAT,1870,49,45-49,1919,0.45817684995117447
STAT,1866,15,40-44,1881,0.35399843516715024
SIM,1871,30,25-29,1901,21
STAT,1798,64,na,1862,1610.7664201499547
STAT,1831,34,45-49,1865,2.8790526634394316
STAT,1841,49,25-29,1890,0.0818286079156162
SIM,1906,34,na,1940,6961
STAT,1924,11,na,1935,9541.003521547556
STAT,1846,51,30-34,1897,0.009161198532738292
STAT,1922,30,40-44,1952,8.99925407180203
SIM,1884,48,na,1932,4809
STAT,1876,45,30-34,1921,0.2042174857133616
SIM,1927,42,35-39,1969,1
STAT,1899,40,50-100,1939,0.2050517194685237
STAT,1890,32,35-39,1922,24.964796867935124
STAT,1784,83,na,1867,215.71442997453647
STAT,1878,41,25-29,1919,1.3606310702503563
SIM,1849,29,15-19,1878,1
STAT,1827,51,50-100,1878,0.026853967221751398
SIM,1837,27,30-34,1864,58
STAT,1942,24,50-100,1966,1.3924210367136653
SIM,1889,29,45-49,1918,3
STAT,1831,40,30-34,1871,1.8680252491525984
STAT,1816,44,20-24,1860,0.8098366166213107
STAT,1918,30,25-29,1948,19.991831904431056
STAT,1847,93,na,1940,44.54949025075737
STAT,1862,60,na,1922,3292.175916858908
STAT,1869,29,na,1898,4636.902301835582
SIM,1886,41,25-29,1927,2
SIM,1874,15,40-44,1889,1
SIM,1849,29,50-100,1878,1
STAT,1904,42,40-44,1946,0.4522092740586796
STAT,1854,44,40-44,1898,3.401568222996033
SIM,1887,23,50-100,1910,1
SIM,1883,85,na,1968,1057
SIM,1777,80,na,1857,415
STAT,1879,23,50-100,1902,0.8587860319326092
SIM,1855,15,30-34,1870,6
STAT,1843,57,na,1900,2815.1267124889087
STAT,1813,46,45-49,1859,1.4817498608353572
STAT,1866,85,na,1951,510.84395158662977
STAT,1892,45,15-19,1937,5.761546105716855E-4
STAT,1844,54,25-29,1898,0.005562748791030688
STAT,1870,1,na,1871,6982.931966546992
SIM,1888,17,35-39,1905,2
SIM,1911,30,30-34,1941,40
SIM,1875,34,na,1909,5263
STAT,1835,44,30-34,1879,1.7397744779300979
STAT,1944,20,25-29,1964,201.54741071652788
SIM,1843,24,na,1867,3894
STAT,1881,38,15-19,1919,0.10907456197673546
STAT,1919,42,35-39,1961,0.44062344115527796
STAT,1868,46,35-39,1914,0.2697774749367941
SIM,1850,41,45-49,1891,5
STAT,1896,51,na,1947,5768.895163574807
SIM,1820,34,35-39,1854,8
SIM,1899,47,na,1946,6233
STAT,1878,16,20-24,1894,37.486645646435264
STAT,1880,37,45-49,1917,4.241288520042609
STAT,1899,17,45-49,1916,0.18075642903096223
STAT,1897,36,na,1933,6390.907185038104
STAT,1845,18,50-100,1863,0.09485497775203154
SIM,1816,76,na,1892,893
STAT,1873,47,20-24,1920,0.02450987289947866
STAT,1851,49,35-39,1900,0.21249423915403573
STAT,1845,16,na,1861,4497.110184058921
STAT,1897,41,35-39,1938,0.34100688284343295
SIM,1912,42,40-44,1954,2
STAT,1768,98,na,1866,0.9815880149677745
STAT,1887,46,45-49,1933,0.5345885701369639
SIM,1831,41,35-39,1872,5
SIM,1941,11,na,1952,8349
STAT,1903,3,na,1906,7601.956329820998
SIM,1868,29,25-29,1897,82
STAT,1918,19,30-34,1937,26.645589643358825
STAT,1813,52,30-34,1865,0.035002545765755906
STAT,1859,17,15-19,1876,11.073623253212217
SIM,1878,28,30-34,1906,78
SIM,1893,2,na,1895,7070
STAT,1934,31,20-24,1965,6.730791536813482
SIM,1843,44,30-34,1887,3
STAT,1849,19,na,1868,4416.887892329309
STAT,1842,41,45-49,1883,2.3350600787579903
STAT,1870,48,40-44,1918,0.33519469800167434
SIM,1906,12,na,1918,7599
STAT,1847,15,30-34,1862,3.068422000610646
STAT,1893,33,na,1926,6082.886713506057
SIM,1864,93,na,1957,39
STAT,1865,54,45-49,1919,0.02589530057134654
STAT,1903,30,30-34,1933,50.610073776845006
SIM,1845,68,na,1913,2473
SIM,1813,58,na,1871,2395
SIM,1821,46,45-49,1867,1
SIM,1787,78,na,1865,488
STAT,1891,3,na,1894,6599.539525764077
SIM,1924,38,25-29,1962,4
STAT,1918,33,30-34,1951,33.664009393797635
STAT,1896,29,na,1925,6318.012047136721
STAT,1930,18,na,1948,9585.36853792136
SIM,1910,23,25-29,1933,6
SIM,1872,59,na,1931,4020
STAT,1832,46,20-24,1878,0.018734947726149764
STAT,1812,48,45-49,1860,1.6115902979359413
SIM,1912,31,35-39,1943,26
SIM,1843,20,35-39,1863,16
SIM,1903,46,40-44,1949,1
STAT,1892,15,na,1907,6415.147490580485
SIM,1846,21,15-19,1867,7
SIM,1857,33,40-44,1890,16
STAT,1770,105,na,1875,0.03412652417660255
SIM,1918,27,45-49,1945,5
STAT,1854,15,20-24,1869,32.89729821821895
STAT,1900,28,20-24,1928,32.75142931232222
SIM,1873,22,50-100,1895,1
STAT,1873,56,na,1929,4185.443468305975
STAT,1921,43,30-34,1964,0.29028591234866724
SIM,1944,24,35-39,1968,30
STAT,1925,36,25-29,1961,2.3883636400804855
STAT,1911,16,30-34,1927,4.939580627879107
STAT,1845,9,na,1854,4745.0
STAT,1844,30,50-100,1874,1.8065541733978199
STAT,1936,24,35-39,1960,18.17204330009296
STAT,1903,16,na,1919,7280.374925817541
STAT,1792,103,na,1895,0.05377394471495574
STAT,1845,37,na,1882,3814.4378012741286
STAT,1916,38,25-29,1954,2.026256837686802
STAT,1904,46,35-39,1950,0.22956822636618643
SIM,1832,94,na,1926,21
STAT,1892,47,30-34,1939,0.13740959093796679
STAT,1838,21,15-19,1859,5.83466609443138
SIM,1845,57,na,1902,3334
STAT,1928,26,50-100,1954,2.4847068639119887
SIM,1910,18,30-34,1928,5
STAT,1902,23,25-29,1925,162.72268361696206
STAT,1913,37,45-49,1950,1.3590611304252984
STAT,1907,45,20-24,1952,0.020293160810278935
STAT,1881,49,50-100,1930,0.4694210037012935
STAT,1867,24,45-49,1891,1.310674437657943
STAT,1927,31,30-34,1958,39.158377273919264
STAT,1930,34,40-44,1964,10.186411921597262
STAT,1933,35,20-24,1968,0.7264863248470611
STAT,1805,72,na,1877,1260.7642933014683
STAT,1809,86,na,1895,197.20664887224655
STAT,1861,48,40-44,1909,0.28417256265412333
STAT,1822,64,na,1886,2002.9906779469707
STAT,1812,101,na,1913,0.5408977269939296
SIM,1866,26,45-49,1892,1
SIM,1917,35,30-34,1952,7
SIM,1840,38,na,1878,3880
STAT,1792,80,na,1872,511.95809643890607
STAT,1796,94,na,1890,8.90412515932345
STAT,1803,81,na,1884,442.5257086496538
STAT,1922,35,45-49,1957,1.568924101648217
STAT,1828,69,na,1897,1802.2249581816873
SIM,1905,18,20-24,1923,59
SIM,1867,19,15-19,1886,11
SIM,1930,35,45-49,1965,3
STAT,1815,49,25-29,1864,0.29992351849445864
STAT,1876,22,45-49,1898,1.4566069538593287
SIM,1926,33,30-34,1959,14
SIM,1909,36,35-39,1945,7
SIM,1921,37,45-49,1958,2
STAT,1865,37,na,1902,4322.773385673989
SIM,1875,24,45-49,1899,2
STAT,1904,31,35-39,1935,29.475694510813863
STAT,1837,18,na,1855,4228.7246195433945
SIM,1912,39,45-49,1951,4
SIM,1909,29,45-49,1938,4
SIM,1830,28,na,1858,3406
SIM,1932,37,20-24,1969,3
SIM,1863,86,na,1949,423
STAT,1894,18,na,1912,6535.2571452272805
SIM,1838,20,25-29,1858,109
STAT,1843,26,na,1869,3756.354467271494
STAT,1852,44,50-100,1896,1.6610559082085619
SIM,1920,30,30-34,1950,49
STAT,1927,26,35-39,1953,36.98328981713254
STAT,1921,45,na,1966,8401.622126677808
STAT,1938,6,na,1944,7986.327229260173
SIM,1939,19,30-34,1958,28
STAT,1898,19,50-100,1917,0.13318102920637323
STAT,1913,26,na,1939,7566.391786680753
SIM,1926,26,40-44,1952,19
STAT,1851,45,na,1896,3522.4345858363317
STAT,1903,17,35-39,1920,1.5778473766701342
STAT,1944,23,30-34,1967,62.64862695791756
STAT,1869,5,na,1874,5482.377782005961
SIM,1908,37,30-34,1945,5
SIM,1899,32,35-39,1931,32
STAT,1904,39,45-49,1943,1.2347067297469254
SIM,1855,67,na,1922,2688
SIM,1911,17,35-39,1928,2
STAT,1863,51,50-100,1914,0.026827911081238
STAT,1823,81,na,1904,648.9181866749369
STAT,1938,21,50-100,1959,1.315864551293337
STAT,1934,29,30-34,1963,106.36465417198356
SIM,1942,29,30-34,1971,97
STAT,1883,30,50-100,1913,1.832695653494261
SIM,1804,75,na,1879,788
SIM,1808,89,na,1897,76
SIM,1900,28,na,1928,6958
SIM,1793,86,na,1879,84
STAT,1902,18,30-34,1920,4.532766484840584
SIM,1887,22,15-19,1909,4
SIM,1912,29,na,1941,7554
STAT,1930,41,30-34,1971,0.34021142581704295
STAT,1879,22,15-19,1901,6.9691127569267755
STAT,1841,39,25-29,1880,4.820769937454783
STAT,1842,49,50-100,1891,0.358018264682339
STAT,1913,44,35-39,1957,0.39537133486673
STAT,1835,20,35-39,1855,12.380046557754344
STAT,1924,39,15-19,1963,0.04562282992739162
SIM,1800,93,na,1893,12
SIM,1921,44,35-39,1965,1
STAT,1945,22,35-39,1967,20.840255757245117
STAT,1914,40,35-39,1954,0.4058632178124588
STAT,1942,28,25-29,1970,139.45503588018434
STAT,1818,59,na,1877,2319.278309249419
SIM,1935,26,35-39,1961,56
STAT,1853,49,45-49,1902,0.36560324615416334
SIM,1902,17,40-44,1919,1
STAT,1835,52,50-100,1887,0.01994322117375374
STAT,1930,21,35-39,1951,24.43477962421604
STAT,1939,32,50-100,1971,1.7039288504286974
STAT,1788,75,na,1863,837.1631620842854
STAT,1904,44,40-44,1948,0.4466552035779489
SIM,1933,36,25-29,1969,6
SIM,1953,11,na,1964,9958
STAT,1846,16,25-29,1862,10.968158741437176
STAT,1910,24,15-19,1934,10.0365047745582
STAT,1814,45,na,1859,2711.9342166958963
STAT,1910,42,15-19,1952,0.0029322444096920273
STAT,1817,108,na,1925,0.0018475230197927375
STAT,1849,33,40-44,1882,7.153857834289905
STAT,1929,29,20-24,1958,46.08858040186016
SIM,1909,34,40-44,1943,16
STAT,1881,75,na,1956,2081.084761658487
SIM,1837,21,20-24,1858,115
SIM,1854,16,25-29,1870,15
STAT,1952,18,40-44,1970,3.3838752484757655
STAT,1833,24,50-100,1857,0.7156923019129982
SIM,1907,30,na,1937,7271
STAT,1939,25,15-19,1964,1.4347258174880797
STAT,1820,47,40-44,1867,0.6370637507336463
STAT,1907,47,15-19,1954,6.666384105877428E-4
SIM,1887,15,25-29,1902,15
STAT,1884,41,50-100,1925,2.116383804182249
STAT,1918,26,40-44,1944,10.050727784409093
STAT,1918,42,50-100,1960,0.2522204799113619
STAT,1852,94,na,1946,31.85401519134637
STAT,1930,36,35-39,1966,6.377500792828283
STAT,1864,49,20-24,1913,0.021211392889211752
STAT,1902,31,50-100,1933,2.6232097079639196
STAT,1877,38,na,1915,4916.350197547107
STAT,1899,27,45-49,1926,3.0723626978091807
SIM,1906,16,15-19,1922,13
STAT,1859,30,45-49,1889,2.844009479993439
STAT,1899,32,40-44,1931,12.000295899023445
SIM,1923,16,15-19,1939,105
SIM,1927,32,35-39,1959,35
STAT,1860,38,na,1898,3844.832283409107
STAT,1892,47,na,1939,5662.796897679276
SIM,1935,19,45-49,1954,2
STAT,1920,32,30-34,1952,34.84511580858942
SIM,1836,25,20-24,1861,18
STAT,1935,34,50-100,1969,2.307617615769233
STAT,1912,38,40-44,1950,2.9369838239937454
SIM,1864,5,na,1869,5490
STAT,1929,37,50-100,1966,1.0885151979239445
SIM,1858,32,45-49,1890,5
SIM,1934,27,30-34,1961,127
STAT,1895,16,20-24,1911,46.7695301902657
SIM,1776,94,na,1870,8
STAT,1925,43,15-19,1968,0.0037482580198352376
STAT,1852,19,na,1871,4372.845571898161
STAT,1908,39,30-34,1947,3.4138914960684854
STAT,1825,92,na,1917,48.189859283131696
STAT,1810,45,30-34,1855,0.656281157383441
SIM,1920,38,40-44,1958,5
SIM,1898,34,40-44,1932,21
SIM,1860,58,na,1918,3402
STAT,1834,22,40-44,1856,3.709756769298739
SIM,1886,16,20-24,1902,45
STAT,1915,16,15-19,1931,19.232000970629063
STAT,1877,28,50-100,1905,1.3368139333922924
SIM,1869,71,na,1940,2469
STAT,1823,35,50-100,1858,5.101978916580003
STAT,1869,29,25-29,1898,82.18966927739805
STAT,1943,27,30-34,1970,84.27575802659972
SIM,1836,76,na,1912,1106
SIM,1867,30,45-49,1897,4
STAT,1917,41,15-19,1958,0.003241074890917649
SIM,1887,20,20-24,1907,174
STAT,1903,22,30-34,1925,51.22033150105293
STAT,1888,34,50-100,1922,2.1684124071759014
STAT,1874,18,na,1892,5209.054749968261
STAT,1927,19,45-49,1946,1.2475068914673657
STAT,1912,30,30-34,1942,31.570218955390608
SIM,1904,42,40-44,1946,1
STAT,1926,27,30-34,1953,94.84699053846674
STAT,1776,102,na,1878,0.16356308256841162
STAT,1929,41,na,1970,9726.731142414319
STAT,1935,28,35-39,1963,41.320271728707425
STAT,1947,17,20-24,1964,308.4174604747109
STAT,1874,46,50-100,1920,0.5093218421477966
SIM,1907,50,na,1957,6573
STAT,1938,29,15-19,1967,1.4113372702607752
STAT,1880,43,50-100,1923,2.231441798827392
STAT,1875,67,na,1942,3296.2251956991013
SIM,1920,48,na,1968,8345
STAT,1918,28,35-39,1946,32.14983599323691
STAT,1884,28,na,1912,4742.619833307308
STAT,1928,40,35-39,1968,0.5198086035824665
STAT,1868,65,na,1933,3247.307571585945
STAT,1887,17,25-29,1904,12.799964700327406
SIM,1824,95,na,1919,21
STAT,1908,44,25-29,1952,0.1318795208782019
SIM,1902,24,30-34,1926,1
SIM,1910,18,na,1928,8045
STAT,1859,19,15-19,1878,10.943560138534636
STAT,1919,32,35-39,1951,19.907749744283606
SIM,1919,31,na,1950,8348
SIM,1943,28,35-39,1971,39
SIM,1935,31,30-34,1966,56
STAT,1908,43,15-19,1951,0.0028541571914309865
STAT,1883,86,na,1969,991.5672654949065
STAT,1841,38,50-100,1879,2.0771218562758005
STAT,1849,18,45-49,1867,0.12643822301522062
SIM,1957,2,na,1959,10335
STAT,1834,41,50-100,1875,1.7171941831029967
SIM,1795,77,na,1872,733
SIM,1877,16,20-24,1893,33
SIM,1888,30,na,1918,5619
SIM,1882,89,na,1971,514
STAT,1934,34,25-29,1968,25.457084690514588
SIM,1948,9,na,1957,9331
STAT,1917,34,25-29,1951,19.377879476514938
SIM,1901,25,25-29,1926,140
STAT,1883,22,na,1905,4692.902977095992
STAT,1895,67,na,1962,4528.68130269561
SIM,1828,26,25-29,1854,84
SIM,1929,27,20-24,1956,48
STAT,1903,15,40-44,1918,0.5283927924918728
SIM,1866,31,40-44,1897,11
SIM,1878,22,20-24,1900,153
SIM,1925,29,30-34,1954,108
SIM,1901,45,na,1946,6492
STAT,1828,39,50-100,1867,2.3743076880454264
STAT,1944,26,35-39,1970,32.78450939625359
SIM,1870,88,na,1958,339
SIM,1852,48,40-44,1900,1
STAT,1927,24,40-44,1951,8.312842066939721
STAT,1839,45,50-100,1884,0.4008645051479764
SIM,1823,58,na,1881,2366
SIM,1853,47,45-49,1900,1
SIM,1878,24,15-19,1902,8
STAT,1858,26,45-49,1884,1.8024448191158273
SIM,1862,15,20-24,1877,50
STAT,1823,48,20-24,1871,0.03655447353812951
STAT,1907,36,50-100,1943,0.7903945679702338
SIM,1919,1,na,1920,9324
STAT,1933,37,15-19,1970,0.052831334472848095
STAT,1947,19,15-19,1966,103.17227797321567
SIM,1845,15,20-24,1860,29
STAT,1868,20,45-49,1888,1.359372312335103
SIM,1882,69,na,1951,2852
STAT,1944,24,40-44,1968,7.326521247942279
SIM,1925,34,25-29,1959,31
SIM,1911,15,40-44,1926,2
STAT,1869,16,20-24,1885,35.382488056712226
STAT,1861,55,na,1916,3475.843861595776
SIM,1926,28,35-39,1954,41
STAT,1950,22,15-19,1972,12.752961074074037
SIM,1877,20,50-100,1897,1
STAT,1930,37,45-49,1967,1.795848271611055
SIM,1935,24,40-44,1959,12
SIM,1902,42,30-34,1944,1
STAT,1890,39,20-24,1929,1.8811374098362985
STAT,1909,38,35-39,1947,4.603324959461736
SIM,1920,8,na,1928,9269
STAT,1944,19,45-49,1963,1.0849173921075166
SIM,1879,21,25-29,1900,135
SIM,1909,33,30-34,1942,36
SIM,1870,29,50-100,1899,1
SIM,1900,26,20-24,1926,34
SIM,1877,90,na,1967,338
STAT,1845,92,na,1937,64.17906782156177
SIM,1930,32,40-44,1962,17
STAT,1840,48,20-24,1888,0.017244776781706713
SIM,1828,89,na,1917,178
SIM,1876,20,45-49,1896,2
SIM,1899,33,45-49,1932,10
STAT,1927,15,50-100,1942,0.9450453271716392
STAT,1910,25,25-29,1935,130.38142496546445
STAT,1953,16,35-39,1969,10.253647752122834
STAT,1837,73,na,1910,1655.4368242734954
STAT,1858,31,40-44,1889,6.8990733496484875
SIM,1795,97,na,1892,2
SIM,1811,77,na,1888,693
SIM,1851,7,na,1858,4892
SIM,1916,39,30-34,1955,6
STAT,1911,15,na,1926,7844.237822262339
STAT,1938,27,20-24,1965,36.529304192917586
SIM,1884,21,35-39,1905,17
STAT,1851,110,na,1961,0.0012571196216308437
STAT,1757,102,na,1859,0.2702940434062342
SIM,1906,24,15-19,1930,10
STAT,1922,32,40-44,1954,8.927493609467497
SIM,1951,19,30-34,1970,35
STAT,1925,33,20-24,1958,5.844994661619258
SIM,1831,77,na,1908,1014
SIM,1860,20,35-39,1880,13
SIM,1863,21,15-19,1884,5
SIM,1861,43,na,1904,4412
SIM,1869,17,25-29,1886,15
STAT,1878,39,50-100,1917,2.5636146834815814
STAT,1863,50,50-100,1913,0.027083853496782585
STAT,1870,54,50-100,1924,0.029122644081233596
STAT,1896,49,50-100,1945,0.361691047760563
STAT,1835,21,45-49,1856,1.2097428438814093
STAT,1838,35,na,1873,3571.0600896244523
STAT,1882,37,20-24,1919,1.5165655387970227
SIM,1904,37,45-49,1941,1
STAT,1798,108,na,1906,9.916043474495065E-4
STAT,1898,30,50-100,1928,2.524308430760704
STAT,1904,33,na,1937,6946.695632122033
STAT,1922,34,35-39,1956,20.745527443302137
STAT,1874,73,na,1947,2456.171314237265
SIM,1867,25,50-100,1892,2
STAT,1878,24,20-24,1902,144.4472091634517
STAT,1915,49,15-19,1964,7.453345319240071E-4
STAT,1940,23,45-49,1963,2.314302560102175
SIM,1920,20,30-34,1940,100
STAT,1862,29,50-100,1891,1.0963456002930767
STAT,1879,19,40-44,1898,0.3843064558355391
SIM,1784,81,na,1865,274
SIM,1886,24,20-24,1910,147
SIM,1842,60,na,1902,2701
SIM,1846,74,na,1920,1582
SIM,1920,46,40-44,1966,1
STAT,1912,46,40-44,1958,0.30685799410668585
STAT,1859,22,45-49,1881,1.1630100209696201
STAT,1863,66,na,1929,2897.6071327808077
SIM,1935,26,na,1961,10556
STAT,1804,55,na,1859,2197.1768169193074
STAT,1904,21,35-39,1925,16.96660731640665
STAT,1808,69,na,1877,1499.1804694817126
STAT,1901,34,15-19,1935,0.39919180725072273
SIM,1829,51,na,1880,2879
STAT,1830,36,45-49,1866,3.7887967048480222
STAT,1855,21,15-19,1876,5.853727502940425
SIM,1830,24,50-100,1854,1
SIM,1875,21,40-44,1896,7
STAT,1911,17,40-44,1928,0.5654483928264705
SIM,1837,24,25-29,1861,112
STAT,1934,23,50-100,1957,1.7855571192534734
SIM,1903,23,35-39,1926,17
SIM,1910,20,20-24,1930,205
STAT,1815,46,20-24,1861,0.0655099977519633
STAT,1841,54,20-24,1895,0.0010412265835589869
STAT,1857,18,na,1875,4222.067012338324
SIM,1869,16,na,1885,5051
STAT,1849,36,45-49,1885,3.2603326915391078
STAT,1814,101,na,1915,0.49109553539078715
SIM,1799,59,na,1858,1913
SIM,1921,36,35-39,1957,6
STAT,1880,58,na,1938,4207.48303466632
STAT,1924,47,15-19,1971,8.854642425742421E-4
SIM,1825,92,na,1917,26
STAT,1896,15,25-29,1911,15.18012806103699
SIM,1900,34,20-24,1934,8
SIM,1910,22,15-19,1932,12
SIM,1942,26,25-29,1968,171
STAT,1917,3,na,1920,8785.56063072141
STAT,1847,20,25-29,1867,108.52741648064799
STAT,1910,32,15-19,1942,0.25033462761060926
STAT,1826,30,35-39,1856,35.26671494361892
STAT,1921,46,35-39,1967,0.2941988912157075
SIM,1834,23,45-49,1857,2
SIM,1851,20,40-44,1871,4
STAT,1912,20,30-34,1932,55.9761910447414
SIM,1895,17,25-29,1912,25
STAT,1774,83,na,1857,184.46240436423597
STAT,1852,39,na,1891,3717.188311296385
STAT,1815,62,na,1877,2071.218114640324
STAT,1859,25,50-100,1884,1.0612326373361438
SIM,1908,38,40-44,1946,8
SIM,1843,21,45-49,1864,1
STAT,1854,18,25-29,1872,10.330544188806721
STAT,1893,32,na,1925,6108.665280991841
STAT,1917,29,30-34,1946,82.3890204328863
STAT,1853,56,na,1909,3227.1119106441647
STAT,1887,24,50-100,1911,0.9153476544499841
STAT,1923,16,na,1939,8747.60879112627
STAT,1924,32,15-19,1956,0.30270558783556406
SIM,1906,13,na,1919,7585
STAT,1901,19,25-29,1920,15.936009986329552
SIM,1930,34,35-39,1964,38
STAT,1938,19,20-24,1957,269.9616868410392
SIM,1865,57,na,1922,3725
STAT,1840,93,na,1933,42.18511245554387
STAT,1948,19,30-34,1967,28.150843873851723
SIM,1895,24,50-100,1919,1
STAT,1902,40,15-19,1942,0.00276198321633547
STAT,1897,46,na,1943,6092.141506645681
STAT,1930,33,30-34,1963,41.03821730764747
STAT,1824,39,25-29,1863,7.998656926454377
STAT,1871,37,45-49,1908,3.99996101353663
STAT,1896,22,15-19,1918,8.796611058246329
SIM,1908,45,30-34,1953,1
STAT,1798,65,na,1863,1551.812369172466
STAT,1913,36,35-39,1949,4.845178180918585
STAT,1768,99,na,1867,0.6009085510029721
STAT,1850,47,25-29,1897,0.08790460241884251
SIM,1855,20,25-29,1875,135
STAT,1830,54,45-49,1884,0.021175854298120075
SIM,1847,60,na,1907,2834
SIM,1878,25,25-29,1903,103
STAT,1921,39,45-49,1960,1.5336763728615979
SIM,1867,68,na,1935,2913
SIM,1926,29,45-49,1955,5
STAT,1810,63,na,1873,1873.8611573442079
STAT,1914,33,45-49,1947,3.1860453065952665
STAT,1768,111,na,1879,0.002153354200882626
STAT,1846,23,15-19,1869,6.1901166872732025
SIM,1912,47,45-49,1959,1
SIM,1946,19,20-24,1965,310
STAT,1887,48,na,1935,5018.069308778281
SIM,1805,92,na,1897,15
STAT,1916,37,15-19,1953,0.03971619080065777
SIM,1925,31,50-100,1956,1
SIM,1844,95,na,1939,9
STAT,1904,47,45-49,1951,0.38409177963439983
SIM,1899,46,na,1945,6292
SIM,1916,36,25-29,1952,3
STAT,1831,54,50-100,1885,0.01954390624908516
SIM,1926,36,35-39,1962,13
STAT,1772,105,na,1877,0.03300167158069544
STAT,1764,115,na,1879,2.803007307532228E-4
SIM,1936,22,35-39,1958,21
STAT,1817,73,na,1890,1197.997545468087
STAT,1860,15,45-49,1875,0.12502870940748398
STAT,1908,46,50-100,1954,0.4165033911122049
STAT,1876,84,na,1960,985.0360292000535
STAT,1934,33,15-19,1967,0.3541789438516501
STAT,1918,29,45-49,1947,3.686018589688935
SIM,1849,26,45-49,1875,5
SIM,1956,15,15-19,1971,123
STAT,1843,20,40-44,1863,3.7171750242225583
STAT,1917,31,50-100,1948,1.755549922095905
SIM,1854,23,15-19,1877,6
SIM,1901,24,15-19,1925,8
STAT,1784,93,na,1877,11.253390555395317
SIM,1884,16,na,1900,5511
STAT,1928,22,35-39,1950,23.739582109284438
SIM,1832,39,25-29,1871,5
STAT,1943,19,30-34,1962,26.085948712598753
SIM,1883,86,na,1969,947
STAT,1921,31,35-39,1952,20.617638483486363
STAT,1852,20,35-39,1872,11.209119564683226
SIM,1912,21,35-39,1933,25
STAT,1891,48,25-29,1939,0.08009128593486803
STAT,1916,46,25-29,1962,0.11015507544049202
SIM,1902,21,25-29,1923,184
SIM,1925,16,na,1941,8959
SIM,1833,56,na,1889,2650
STAT,1867,32,45-49,1899,3.2983081908184224
SIM,1835,27,na,1862,3713
SIM,1840,49,25-29,1889,1
SIM,1857,36,45-49,1893,3
SIM,1918,26,35-39,1944,48
SIM,1846,43,na,1889,3519
SIM,1901,28,30-34,1929,84
SIM,1933,33,20-24,1966,8
SIM,1942,23,50-100,1965,1
SIM,1788,95,na,1883,3
STAT,1832,49,25-29,1881,0.07874631483955435
STAT,1907,35,50-100,1942,0.7940790949708987
STAT,1918,36,35-39,1954,5.1727381863617525
STAT,1908,36,25-29,1944,1.872003735378782
STAT,1841,36,20-24,1877,1.3315057036555078
STAT,1831,88,na,1919,177.25344698137118
SIM,1884,22,45-49,1906,1
SIM,1922,33,45-49,1955,5
STAT,1828,80,na,1908,759.6706744054518
STAT,1834,21,na,1855,3827.1279696246925
SIM,1888,74,na,1962,3036
STAT,1829,31,15-19,1860,0.2809574450267563
STAT,1851,33,50-100,1884,1.4630565057550071
SIM,1917,32,25-29,1949,5
STAT,1901,27,25-29,1928,119.60172587860133
STAT,1932,39,20-24,1971,0.7138524400842687
STAT,1872,24,50-100,1896,0.8225271119710021
STAT,1871,54,35-39,1925,0.016799177265799922
SIM,1861,49,45-49,1910,2
STAT,1818,90,na,1908,80.8859223942925
STAT,1918,25,30-34,1943,84.77270218310689
STAT,1877,18,20-24,1895,37.08212469379164
SIM,1817,62,na,1879,2118
SIM,1921,28,50-100,1949,2
SIM,1896,20,15-19,1916,10
STAT,1895,19,25-29,1914,14.832761752254584
SIM,1810,83,na,1893,354
SIM,1893,1,na,1894,7143
STAT,1913,28,50-100,1941,1.9964577078924712
STAT,1855,27,50-100,1882,1.005449372302325
SIM,1847,48,na,1895,3386
SIM,1876,29,na,1905,5135
STAT,1828,28,25-29,1856,120.73849273152094
STAT,1926,28,40-44,1954,11.243000752929417
SIM,1836,28,25-29,1864,85
SIM,1934,28,40-44,1962,15
STAT,1850,29,25-29,1879,75.23453963546227
SIM,1904,45,45-49,1949,1
STAT,1886,74,na,1960,2687.0003846090844
STAT,1922,42,35-39,1964,0.46666470773451985
STAT,1833,36,na,1869,3556.4383068434613
STAT,1879,15,25-29,1894,12.026452394161607
STAT,1882,60,na,1942,3752.178949746655
STAT,1924,28,50-100,1952,2.331704190918887
STAT,1901,26,15-19,1927,1.287186673301133
SIM,1870,24,na,1894,4587
STAT,1849,15,40-44,1864,0.3603571910907186
STAT,1888,20,15-19,1908,7.921971860435226
SIM,1863,27,50-100,1890,3
SIM,1876,40,50-100,1916,4
SIM,1903,15,35-39,1918,2
STAT,1869,51,na,1920,4233.779547730709
STAT,1828,89,na,1917,129.0115718220996
STAT,1870,0,na,1870,7401.878277026704
SIM,1896,35,50-100,1931,5
STAT,1875,23,40-44,1898,4.319582308477461
STAT,1927,30,na,1957,9405.217452981098
SIM,1871,41,na,1912,4516
STAT,1904,36,40-44,1940,2.752043533240766
SIM,1918,34,35-39,1952,29
STAT,1944,16,40-44,1960,3.0406571500175885
STAT,1948,15,15-19,1963,104.94161799428015
STAT,1924,37,20-24,1961,0.6276130560612869
SIM,1952,16,40-44,1968,3
SIM,1849,41,35-39,1890,6
SIM,1914,16,20-24,1930,1
STAT,1856,47,20-24,1903,0.018611659944606115
STAT,1898,1,na,1899,7439.099888564557
STAT,1826,34,na,1860,3436.7779843440653
STAT,1869,19,25-29,1888,11.110953670273195
STAT,1936,17,45-49,1953,0.9660936025374822
SIM,1944,17,45-49,1961,1
STAT,1909,32,25-29,1941,17.82261771708249
SIM,1932,28,50-100,1960,2
SIM,1845,23,20-24,1868,141
SIM,1868,101,na,1969,3
STAT,1920,44,25-29,1964,0.1587147760561392
STAT,1967,2,na,1969,9925.920616932488
SIM,1824,75,na,1899,1223
STAT,1869,26,20-24,1895,23.03652575844199
STAT,1820,39,40-44,1859,19.310260116864495
STAT,1940,30,35-39,1970,19.12421064768076
STAT,1837,22,50-100,1859,0.7442071418748866
STAT,1837,23,20-24,1860,124.86056927621496
SIM,1876,73,na,1949,2589
SIM,1898,37,45-49,1935,1
STAT,1906,16,20-24,1922,52.30221920756688
STAT,1867,31,35-39,1898,19.23285950559446
STAT,1896,0,na,1896,7829.530764206413
SIM,1922,32,35-39,1954,31
STAT,1846,47,50-100,1893,0.3744339549778967
SIM,1926,18,40-44,1944,4
STAT,1902,30,15-19,1932,0.40931749119082583
SIM,1969,0,na,1969,9615
STAT,1843,108,na,1951,0.0025659108764379142
STAT,1923,18,15-19,1941,107.31081013406553
SIM,1899,30,40-44,1929,22
STAT,1869,82,na,1951,913.0736044380918
SIM,1941,10,na,1951,8359
SIM,1945,24,na,1969,8406
STAT,1934,26,25-29,1960,178.9325419502384
SIM,1911,25,35-39,1936,46
SIM,1907,3,na,1910,7946
STAT,1916,45,15-19,1961,7.666594819192324E-4
SIM,1894,48,45-49,1942,1
STAT,1780,79,na,1859,495.5571042018975
STAT,1845,47,45-49,1892,0.361965415057632
SIM,1869,27,25-29,1896,94
SIM,1889,40,25-29,1929,3
STAT,1940,28,na,1968,7711.898951963011
SIM,1931,18,15-19,1949,126
STAT,1939,31,na,1970,7798.911237170563
STAT,1779,82,na,1861,272.3806061373103
STAT,1869,19,na,1888,4952.044722765858
STAT,1791,95,na,1886,5.32141717930207
SIM,1890,37,20-24,1927,2
STAT,1846,54,na,1900,3207.333054842722
STAT,1886,48,45-49,1934,0.49681649401970046
SIM,1912,36,40-44,1948,3
STAT,1863,21,20-24,1884,125.15702078991075
STAT,1910,22,20-24,1932,210.97077022149205
STAT,1903,25,35-39,1928,27.934334384921836
SIM,1849,34,45-49,1883,5
STAT,1914,32,35-39,1946,18.581038726957864
SIM,1825,30,40-44,1855,10
STAT,1862,92,na,1954,71.89526980457433
SIM,1852,39,na,1891,3759
STAT,1858,55,na,1913,3255.44612680761
SIM,1938,27,15-19,1965,2
SIM,1926,25,30-34,1951,119
STAT,1830,53,35-39,1883,0.012813308183446639
STAT,1888,35,50-100,1923,2.9585351680798873
SIM,1918,14,na,1932,8926
SIM,1820,48,45-49,1868,3
STAT,1834,25,45-49,1859,1.9661569464022441
STAT,1884,21,40-44,1905,4.168224790025067
SIM,1782,79,na,1861,504
SIM,1839,41,na,1880,3406
SIM,1934,35,30-34,1969,3
SIM,1837,93,na,1930,20
STAT,1803,61,na,1864,1973.3672235500987
STAT,1933,0,na,1933,12181.160557882264
STAT,1903,18,45-49,1921,0.18734680059186037
SIM,1841,75,na,1916,1310
STAT,1926,35,30-34,1961,4.505571856093396
SIM,1892,21,40-44,1913,10
SIM,1853,56,na,1909,3300
STAT,1906,49,20-24,1955,0.01950485731235985
SIM,1827,60,na,1887,2395
STAT,1904,43,30-34,1947,0.2297500751189341
SIM,1840,58,na,1898,3100
SIM,1906,39,20-24,1945,3
SIM,1842,25,45-49,1867,5
SIM,1906,33,na,1939,6998
STAT,1903,43,35-39,1946,0.3589802007250735
SIM,1872,91,na,1963,310
STAT,1908,33,20-24,1941,4.633378243954389
SIM,1902,51,na,1953,6276
STAT,1808,60,na,1868,2096.979273937635
STAT,1852,21,45-49,1873,1.3298373605626577
SIM,1897,15,35-39,1912,1
STAT,1838,18,40-44,1856,0.32504941164268414
STAT,1824,54,20-24,1878,0.0016541005960720727
SIM,1920,23,35-39,1943,36
STAT,1841,78,na,1919,1133.6589643477746
SIM,1828,34,na,1862,3495
SIM,1821,36,45-49,1857,5
SIM,1923,24,15-19,1947,14
STAT,1905,32,40-44,1937,7.273160821122772
STAT,1837,31,20-24,1868,4.773986677804138
SIM,1879,24,30-34,1903,38
SIM,1934,24,25-29,1958,291
STAT,1837,33,15-19,1870,0.24634282786309122
STAT,1870,68,na,1938,3030.151739571746
SIM,1807,63,na,1870,1693
STAT,1834,30,40-44,1864,7.549654537262837
STAT,1909,39,45-49,1948,1.290780739882031
STAT,1878,27,25-29,1905,89.22641583791253
STAT,1877,90,na,1967,465.7607776132927
SIM,1887,68,na,1955,3564
STAT,1935,17,30-34,1952,33.658840569463
SIM,1858,40,45-49,1898,3
STAT,1926,24,25-29,1950,225.18024962141854
SIM,1914,7,na,1921,8553
SIM,1858,55,na,1913,3556
SIM,1913,32,40-44,1945,14
STAT,1935,36,35-39,1971,6.838207657826794
SIM,1904,36,35-39,1940,8
STAT,1821,53,40-44,1874,0.02905531993869427
STAT,1943,21,20-24,1964,238.99932054470798
SIM,1930,31,30-34,1961,50
STAT,1871,47,45-49,1918,0.47132988791172603
SIM,1917,39,45-49,1956,3
STAT,1931,18,20-24,1949,357.4653258976136
STAT,1847,49,20-24,1896,0.017910177570259887
SIM,1900,18,20-24,1918,44
SIM,1850,49,50-100,1899,1
STAT,1844,48,40-44,1892,0.2729993845976492
SIM,1871,21,20-24,1892,133
STAT,1950,19,20-24,1969,323.51680807392364
SIM,1891,50,na,1941,5701
STAT,1917,45,30-34,1962,0.18892262055746792
SIM,1928,39,20-24,1967,1
STAT,1915,24,15-19,1939,11.044317388792226
SIM,1895,64,na,1959,4933
STAT,1912,23,35-39,1935,18.173256130875515
STAT,1836,49,45-49,1885,0.32014525857042764
STAT,1918,18,40-44,1936,3.0661225737836593
SIM,1847,17,na,1864,4386
STAT,1836,108,na,1944,0.00243542887111318
STAT,1922,31,30-34,1953,36.08917141280929
SIM,1900,37,25-29,1937,3
SIM,1905,26,50-100,1931,2
SIM,1839,20,40-44,1859,6
SIM,1868,36,20-24,1904,2
STAT,1864,20,25-29,1884,106.53224705519526
STAT,1929,37,20-24,1966,0.683433658965077
STAT,1945,27,na,1972,8299.767382454354
STAT,1910,16,15-19,1926,18.21283270259951
SIM,1852,30,50-100,1882,3
SIM,1911,43,35-39,1954,2
SIM,1877,19,25-29,1896,13
STAT,1891,45,20-24,1936,0.01706647532573357
SIM,1845,26,na,1871,4265
SIM,1847,102,na,1949,3
SIM,1809,75,na,1884,819
STAT,1912,41,35-39,1953,0.3946000952958973
STAT,1854,16,50-100,1870,0.09037452069707043
STAT,1923,23,45-49,1946,2.635042094687871
SIM,1805,61,na,1866,1891
SIM,1916,33,20-24,1949,7
SIM,1923,36,na,1959,9201
SIM,1931,23,45-49,1954,4
STAT,1805,49,15-19,1854,0.0031885052712230374
STAT,1920,40,30-34,1960,0.28589060790361465
SIM,1918,1,na,1919,9289
STAT,1891,45,50-100,1936,0.34929384783722295
STAT,1783,99,na,1882,0.6251630755774136
STAT,1912,49,45-49,1961,0.41948286855929623
SIM,1916,32,50-100,1948,2
SIM,1815,82,na,1897,455
STAT,1944,27,45-49,1971,3.770819010970749
STAT,1826,31,45-49,1857,5.623703425899812
STAT,1903,44,25-29,1947,0.12649824429697135
SIM,1939,15,15-19,1954,83
SIM,1845,26,25-29,1871,98
SIM,1866,83,na,1949,674
STAT,1839,21,30-34,1860,35.99433670189577
SIM,1849,23,40-44,1872,6
SIM,1929,19,20-24,1948,352
STAT,1860,20,40-44,1880,3.927712721792535
STAT,1940,16,20-24,1956,278.1085334769678
STAT,1863,23,15-19,1886,5.905868367586631
STAT,1891,27,20-24,1918,29.286184958665373
SIM,1877,48,45-49,1925,2
STAT,1911,42,30-34,1953,0.24650859345971887
SIM,1942,25,15-19,1967,4
STAT,1829,54,na,1883,2585.1343534517077
STAT,1869,102,na,1971,5.564524193078908
SIM,1892,41,50-100,1933,5
STAT,1850,44,20-24,1894,0.24021638380399804
STAT,1944,15,30-34,1959,26.503780053149736
SIM,1943,22,25-29,1965,196
SIM,1823,89,na,1912,84
SIM,1838,55,na,1893,2878
STAT,1813,54,45-49,1867,0.0819749305415861
STAT,1934,23,20-24,1957,301.7412656029501
STAT,1924,42,na,1966,8919.421395236608
STAT,1931,22,40-44,1953,8.80768789317074
SIM,1832,36,20-24,1868,3
STAT,1915,42,15-19,1957,0.003122759612331631
STAT,1847,16,40-44,1863,0.350040062563922
SIM,1796,62,na,1858,1856
SIM,1946,21,50-100,1967,2
STAT,1819,35,20-24,1854,5.1296476582473804
STAT,1824,36,20-24,1860,2.4441225908351703
STAT,1858,35,na,1893,3744.52123637389
STAT,1876,18,50-100,1894,0.1020690392808621
SIM,1841,23,na,1864,3843
SIM,1861,41,50-100,1902,3
SIM,1932,29,20-24,1961,49
STAT,1923,30,35-39,1953,21.321262372176516
STAT,1860,48,25-29,1908,0.09328176704191424
STAT,1924,29,20-24,1953,42.605954162975316
STAT,1854,21,na,1875,3879.060612682634
STAT,1921,47,50-100,1968,0.5148289603533666
SIM,1899,22,40-44,1921,4
STAT,1880,45,45-49,1925,0.5071130250734261
STAT,1886,26,20-24,1912,25.096610804241855
SIM,1952,15,30-34,1967,37
STAT,1831,39,15-19,1870,0.08989834401420405
SIM,1845,37,na,1882,4033
STAT,1870,17,50-100,1887,0.0980678115101039
STAT,1934,25,15-19,1959,1.919941645126885
SIM,1905,33,45-49,1938,1
STAT,1927,18,35-39,1945,10.507956710800892
SIM,1870,36,40-44,1906,14
SIM,1942,23,20-24,1965,219
SIM,1832,31,50-100,1863,1
SIM,1904,65,na,1969,5529
STAT,1889,15,35-39,1904,1.3727620916963097
STAT,1837,26,25-29,1863,76.23797626117042
SIM,1834,31,45-49,1865,4
STAT,1872,50,35-39,1922,0.017725267154160656
STAT,1844,11,na,1855,4922.94906
STAT,1935,22,25-29,1957,254.0832148720323
STAT,1848,25,na,1873,4296.073297404966
STAT,1959,9,na,1968,10379.364798737288
SIM,1837,70,na,1907,1799
SIM,1848,8,na,1856,4674
SIM,1871,23,15-19,1894,7
STAT,1871,18,25-29,1889,11.376405768443012
SIM,1879,49,na,1928,4489
STAT,1902,27,40-44,1929,8.541389642036687
STAT,1933,29,15-19,1962,1.8914384979978325
SIM,1917,28,na,1945,8075
SIM,1877,29,25-29,1906,94
STAT,1862,54,40-44,1916,0.01767310045972967
SIM,1894,26,20-24,1920,32
SIM,1904,34,40-44,1938,9
STAT,1923,19,25-29,1942,102.1861578325742
STAT,1909,27,30-34,1936,75.66855589908049
STAT,1847,105,na,1952,0.04469472548429877
SIM,1809,74,na,1883,920
SIM,1827,35,20-24,1862,2
SIM,1917,27,30-34,1944,89
SIM,1820,37,40-44,1857,13
SIM,1834,41,na,1875,3350
STAT,1838,30,25-29,1868,17.586925700218035
SIM,1920,16,45-49,1936,4
SIM,1878,30,20-24,1908,7
SIM,1847,21,30-34,1868,49
SIM,1926,42,50-100,1968,1
SIM,1931,30,35-39,1961,39
SIM,1902,32,30-34,1934,10
SIM,1794,71,na,1865,1097
STAT,1860,69,na,1929,2406.8927154637568
SIM,1845,31,20-24,1876,6
SIM,1837,18,na,1855,4093
SIM,1931,19,25-29,1950,139
STAT,1880,27,45-49,1907,2.362250960606536
SIM,1930,26,35-39,1956,57
SIM,1899,22,50-100,1921,1
SIM,1913,28,20-24,1941,40
STAT,1942,27,15-19,1969,1.4964388284950996
SIM,1904,29,45-49,1933,5
SIM,1900,36,50-100,1936,3
SIM,1886,32,20-24,1918,1
SIM,1853,25,20-24,1878,3
SIM,1857,41,40-44,1898,8
STAT,1827,63,na,1890,2157.6420563275087
STAT,1888,21,25-29,1909,137.06155851820887
STAT,1936,16,35-39,1952,8.135118805940506
SIM,1837,36,50-100,1873,5
STAT,1868,15,15-19,1883,11.747846045570187
STAT,1899,26,na,1925,6626.503369812
SIM,1925,27,na,1952,8893
SIM,1885,47,40-44,1932,1
STAT,1919,16,35-39,1935,1.883141013559463
SIM,1927,16,35-39,1943,14
STAT,1878,32,20-24,1910,5.701563649053384
STAT,1762,115,na,1877,4.2739349438908564E-4
STAT,1911,24,30-34,1935,54.72229359434619
SIM,1860,46,25-29,1906,1
STAT,1900,36,20-24,1936,0.4683805200647482
STAT,1799,91,na,1890,39.40809482532148
SIM,1846,30,25-29,1876,27
STAT,1942,25,20-24,1967,38.727317702064866
STAT,1888,17,40-44,1905,0.4366015122342322
SIM,1910,27,40-44,1937,15
STAT,1769,101,na,1870,0.17370076551439195
SIM,1918,19,45-49,1937,2
STAT,1914,32,na,1946,7690.043292890398
STAT,1926,13,na,1939,9794.317483261473
STAT,1918,46,na,1964,7913.940114531762
STAT,1878,34,15-19,1912,0.2978088646395823
SIM,1914,30,35-39,1944,27
STAT,1867,91,na,1958,156.96078906848678
STAT,1925,27,15-19,1952,1.6836389999048282
SIM,1909,19,50-100,1928,2
STAT,1884,72,na,1956,2584.0913114398427
SIM,1902,25,40-44,1927,11
SIM,1933,27,15-19,1960,2
STAT,1905,28,20-24,1933,34.14438329026455
STAT,1907,39,15-19,1946,0.0356158416653239
STAT,1850,26,20-24,1876,21.32075121936929
SIM,1913,46,na,1959,7359
SIM,1896,21,25-29,1917,169
STAT,1785,78,na,1863,643.1474148197524
SIM,1908,34,25-29,1942,20
STAT,1893,22,45-49,1915,1.7850581877914216
STAT,1909,32,na,1941,7292.954981564195
STAT,1810,94,na,1904,18.07446457587912
SIM,1935,18,35-39,1953,13
SIM,1885,28,50-100,1913,1
STAT,1887,30,20-24,1917,6.154727363891694
SIM,1864,17,na,1881,4989
STAT,1858,24,na,1882,3832.145111297961
SIM,1874,61,na,1935,3539
SIM,1878,75,na,1953,1982
STAT,1935,29,45-49,1964,4.7523027233746795
STAT,1878,32,na,1910,5033.447525597135
STAT,1849,41,40-44,1890,3.5739992473262663
SIM,1858,17,20-24,1875,37
STAT,1897,48,20-24,1945,0.018044263255912945
STAT,1797,80,na,1877,511.4011428855303
STAT,1859,72,na,1931,2030.0899015875832
SIM,1855,23,30-34,1878,47
SIM,1944,16,35-39,1960,12
STAT,1877,47,40-44,1924,0.3573596516029151
SIM,1865,34,50-100,1899,4
STAT,1907,53,na,1960,6473.358801692467
STAT,1890,2,na,1892,6571.2674159411845
SIM,1890,24,na,1914,6201
STAT,1847,23,30-34,1870,33.04672347338138
SIM,1836,39,50-100,1875,3
SIM,1829,30,25-29,1859,22
STAT,1876,53,na,1929,4425.450448608385
STAT,1790,78,na,1868,563.3479393951295
STAT,1902,34,30-34,1936,28.341061004506408
SIM,1879,20,15-19,1899,5
STAT,1863,45,45-49,1908,0.42138410785409486
STAT,1898,31,na,1929,6548.650466174744
SIM,1874,33,50-100,1907,3
SIM,1869,24,20-24,1893,139
SIM,1838,16,40-44,1854,1
STAT,1920,48,40-44,1968,0.35092371363789837
SIM,1912,28,40-44,1940,19
STAT,1839,21,na,1860,4320.641582272005
STAT,1920,15,40-44,1935,0.6386686201222461
STAT,1943,22,50-100,1965,1.4138142854052436
SIM,1839,15,45-49,1854,1
SIM,1878,31,50-100,1909,2
SIM,1920,41,35-39,1961,1
STAT,1880,52,35-39,1932,0.018218894399860658
STAT,1909,43,30-34,1952,0.24018413831011873
SIM,1943,17,30-34,1960,30
SIM,1814,42,na,1856,2869
SIM,1854,62,na,1916,2982
SIM,1881,40,na,1921,4010
STAT,1847,40,na,1887,3634.7196208630953
STAT,1818,53,50-100,1871,0.06258545376679439
SIM,1908,24,na,1932,7090
STAT,1898,52,na,1950,5853.628830413899
SIM,1905,29,25-29,1934,156
STAT,1879,31,25-29,1910,21.72569078599369
STAT,1885,13,na,1898,5183.56123656592
SIM,1886,25,50-100,1911,5
SIM,1885,54,na,1939,4455
STAT,1790,103,na,1893,0.0561375898391321
SIM,1849,42,45-49,1891,6
STAT,1904,28,40-44,1932,8.65279461821444
SIM,1869,2,na,1871,6182
STAT,1920,22,30-34,1942,64.51645373901177
STAT,1896,20,20-24,1916,184.8465829996367
STAT,1936,21,30-34,1957,55.524604527524346
STAT,1947,20,50-100,1967,1.5028421221966497
STAT,1898,44,40-44,1942,0.4211305524121941
SIM,1889,16,na,1905,6447
STAT,1811,45,25-29,1856,0.40474966752464764
SIM,1858,21,40-44,1879,6
SIM,1839,22,35-39,1861,10
STAT,1821,78,na,1899,866.0652088679963
STAT,1879,72,na,1951,2667.8365837268325
STAT,1887,24,15-19,1911,7.4051616719949935
STAT,1915,21,45-49,1936,2.356258874810005
STAT,1845,25,20-24,1870,22.32284090890737
STAT,1826,78,na,1904,935.3373263027346
SIM,1903,49,45-49,1952,1
SIM,1895,24,15-19,1919,9
STAT,1827,40,na,1867,3326.678198893374
STAT,1925,8,na,1933,9728.50799052672
SIM,1906,2,na,1908,7780
SIM,1829,26,40-44,1855,6
SIM,1917,43,30-34,1960,1
STAT,1926,31,15-19,1957,0.3139461359151264
SIM,1901,14,na,1915,7339
SIM,1923,21,45-49,1944,4
STAT,1891,21,na,1912,5921.889883209247
SIM,1838,23,30-34,1861,35
SIM,1909,28,35-39,1937,39
STAT,1922,31,na,1953,8663.275750286668
SIM,1881,51,na,1932,3716
STAT,1906,13,na,1919,7588.3999841671375
SIM,1819,36,25-29,1855,8
SIM,1877,35,na,1912,4891
STAT,1832,38,20-24,1870,1.2563470151095015
STAT,1863,52,35-39,1915,0.015138937836711363
STAT,1813,59,na,1872,2208.5098771361504
STAT,1916,35,20-24,1951,0.5503726963783562
SIM,1886,27,25-29,1913,101
SIM,1958,11,na,1969,10839
STAT,1914,43,na,1957,7421.872551875366
SIM,1840,38,20-24,1878,3
STAT,1862,108,na,1970,0.04719509731260109
SIM,1812,94,na,1906,15
STAT,1821,35,40-44,1856,19.518694014987744
SIM,1860,44,50-100,1904,5
STAT,1899,24,40-44,1923,5.730090664587233
STAT,1935,33,30-34,1968,44.0027937232545
SIM,1881,39,20-24,1920,2
SIM,1941,19,20-24,1960,301
SIM,1920,17,na,1937,8515
STAT,1789,92,na,1881,23.624830790294116
SIM,1935,27,45-49,1962,4
STAT,1896,20,na,1916,6343.859127901357
STAT,1890,48,50-100,1938,0.3372286668264429
STAT,1901,69,na,1970,4885.963515293362
STAT,1876,21,35-39,1897,12.22630050034739
STAT,1889,45,50-100,1934,0.6176985891593539
SIM,1850,32,40-44,1882,14
SIM,1902,16,30-34,1918,9
SIM,1934,21,20-24,1955,288
STAT,1836,46,40-44,1882,0.2413409456049128
STAT,1839,47,20-24,1886,0.019090723366721782
STAT,1849,104,na,1953,0.10550600820033897
SIM,1858,24,45-49,1882,3
SIM,1944,21,30-34,1965,79
SIM,1875,30,50-100,1905,5
SIM,1847,24,35-39,1871,16
STAT,1931,35,na,1966,10080.642229486588
SIM,1862,37,45-49,1899,4
STAT,1905,35,45-49,1940,1.2686789949905422
SIM,1820,38,na,1858,3117
SIM,1887,31,25-29,1918,34
SIM,1921,34,40-44,1955,14
SIM,1893,21,na,1914,6658
STAT,1903,40,30-34,1943,0.23188790451728378
SIM,1873,76,na,1949,1740
STAT,1833,30,50-100,1863,1.5869553532209144
STAT,1842,40,na,1882,3652.495747040653
SIM,1843,55,na,1898,3097
STAT,1900,46,15-19,1946,6.339340469994724E-4
STAT,1911,20,15-19,1931,10.25985052955207
STAT,1830,50,30-34,1880,0.010331892480755398
STAT,1876,20,na,1896,4969.731172417475
STAT,1902,3,na,1905,7537.937304746126
STAT,1920,43,35-39,1963,0.4483432015969913
SIM,1897,35,na,1932,6497
STAT,1952,17,30-34,1969,29.49749375918628
STAT,1836,88,na,1924,182.52995111445918
STAT,1925,45,50-100,1970,0.5560193944113493
SIM,1902,35,35-39,1937,5
STAT,1832,74,na,1906,1446.8511946953051
STAT,1855,18,40-44,1873,0.32611132324493647
STAT,1815,93,na,1908,27.16499488726464
STAT,1889,27,na,1916,5942.998576225906
STAT,1854,37,45-49,1891,3.055989762098539
SIM,1863,4,na,1867,5317
SIM,1811,47,40-44,1858,1
STAT,1793,66,na,1859,1503.8045801741173
STAT,1842,32,40-44,1874,7.799691639171435
STAT,1873,39,20-24,1912,1.5659048114200755
SIM,1916,43,na,1959,7776
SIM,1910,34,30-34,1944,46
SIM,1862,69,na,1931,2630
STAT,1919,42,na,1961,8126.68709430241
STAT,1834,22,na,1856,3799.649190802784
SIM,1863,55,na,1918,3823
SIM,1867,69,na,1936,2771
STAT,1909,36,40-44,1945,2.8770271534457224
STAT,1862,39,45-49,1901,3.406525486839257
STAT,1920,28,na,1948,8268.36797083361
STAT,1922,19,45-49,1941,1.1610173405696533
SIM,1827,38,25-29,1865,9
STAT,1881,15,30-34,1896,3.1258185437848156
STAT,1855,50,35-39,1905,0.013168451627793667
SIM,1930,19,45-49,1949,1
STAT,1871,15,20-24,1886,36.22781204705985
STAT,1854,31,20-24,1885,4.287747386416311
STAT,1908,9,na,1917,7778.42397334853
STAT,1914,39,50-100,1953,0.8382465368278484
STAT,1812,74,na,1886,1082.0739093976365
STAT,1943,24,25-29,1967,198.33629114108737
STAT,1839,24,35-39,1863,11.539918111931085
SIM,1894,29,25-29,1923,131
STAT,1804,53,40-44,1857,0.060333639022044805
STAT,1889,71,na,1960,3634.8477325672648
STAT,1911,19,35-39,1930,1.68724792934834
SIM,1907,39,na,1946,7027
SIM,1869,32,50-100,1901,3
STAT,1868,4,na,1872,5730.101544071732
STAT,1933,38,25-29,1971,2.7060703770078027
SIM,1870,39,45-49,1909,6
STAT,1768,112,na,1880,0.0013494424770671156
SIM,1859,21,20-24,1880,148
STAT,1930,18,40-44,1948,3.642509772908004
STAT,1931,32,35-39,1963,24.18434660657563
STAT,1921,32,25-29,1953,20.76799116488334
STAT,1907,29,20-24,1936,34.28329884182833
STAT,1927,15,30-34,1942,30.74548089485527
SIM,1917,36,40-44,1953,9
SIM,1920,48,50-100,1968,1
STAT,1871,44,40-44,1915,4.452285948604065
SIM,1918,24,40-44,1942,11
STAT,1889,16,na,1905,6304.794105296824
SIM,1873,21,na,1894,5000
STAT,1886,29,25-29,1915,89.53963647180268
STAT,1931,25,45-49,1956,4.508690302976991
SIM,1824,42,40-44,1866,9
SIM,1908,31,20-24,1939,6
STAT,1819,38,25-29,1857,15.650361457135618
STAT,1815,47,50-100,1862,1.3197888600465966
SIM,1823,47,50-100,1870,2
SIM,1918,31,30-34,1949,51
STAT,1903,48,40-44,1951,0.2742068395116187
SIM,1888,25,35-39,1913,29
STAT,1926,19,50-100,1945,0.9225728277507906
SIM,1882,80,na,1962,1636
STAT,1817,74,na,1891,1119.3609865835622
SIM,1901,22,20-24,1923,205
STAT,1806,48,20-24,1854,0.07209968709250161
STAT,1847,19,45-49,1866,0.12281826085045995
STAT,1883,33,40-44,1916,8.568917004600179
SIM,1911,22,30-34,1933,84
SIM,1909,37,45-49,1946,3
STAT,1831,89,na,1920,135.6396552335547
STAT,1925,27,na,1952,8934.256449814406
STAT,1872,39,na,1911,4733.893371600612
STAT,1923,16,20-24,1939,322.20557935216584
SIM,1875,87,na,1962,637
STAT,1938,34,45-49,1972,3.1919143522919207
SIM,1784,82,na,1866,219
SIM,1862,31,20-24,1893,8
SIM,1878,20,na,1898,5168
SIM,1926,22,25-29,1948,263
SIM,1900,28,15-19,1928,5
SIM,1921,41,30-34,1962,2
STAT,1828,41,20-24,1869,0.30390095618544255
STAT,1838,99,na,1937,2.5630973356364
STAT,1913,34,40-44,1947,7.797964487976059
SIM,1866,23,40-44,1889,5
STAT,1813,60,na,1873,2165.200998445512
SIM,1816,56,na,1872,2422
SIM,1868,39,25-29,1907,8
SIM,1911,48,40-44,1959,1
STAT,1902,54,na,1956,6011.2347058872065
SIM,1931,16,20-24,1947,353
SIM,1841,44,na,1885,3329
SIM,1943,26,40-44,1969,14
STAT,1870,38,40-44,1908,8.63677989940973
STAT,1918,22,25-29,1940,201.16555764994305
STAT,1895,38,50-100,1933,3.2149397751582223
STAT,1789,81,na,1870,423.2769011364537
STAT,1933,19,20-24,1952,364.6079878554844
STAT,1816,42,40-44,1858,12.389211306738591
SIM,1877,26,20-24,1903,26
SIM,1938,32,45-49,1970,6
SIM,1899,18,20-24,1917,53
STAT,1893,47,25-29,1940,0.0827857418611701
SIM,1933,35,na,1968,10834
STAT,1802,75,na,1877,919.6663118338245
SIM,1856,20,40-44,1876,5
STAT,1953,17,45-49,1970,1.2203303370865886
SIM,1927,39,40-44,1966,9
SIM,1911,40,30-34,1951,4
SIM,1846,22,na,1868,4084
STAT,1871,51,30-34,1922,0.01200102688079428
SIM,1892,35,na,1927,6833
SIM,1952,18,35-39,1970,13
STAT,1912,16,45-49,1928,0.2045636020989894
STAT,1913,41,30-34,1954,0.25330688419946173
SIM,1896,49,na,1945,6171
STAT,1944,18,35-39,1962,9.116498556676955
SIM,1891,33,40-44,1924,4
STAT,1873,87,na,1960,563.0482869042376
STAT,1915,47,20-24,1962,0.02249188980972092
SIM,1825,37,na,1862,3054
SIM,1871,10,na,1881,5176
STAT,1925,47,30-34,1972,0.2181211081100461
SIM,1844,46,40-44,1890,1
SIM,1886,28,na,1914,4971
STAT,1919,39,40-44,1958,3.240413759558989
STAT,1836,33,na,1869,3604.5886402689152
STAT,1848,20,40-44,1868,4.220740412224917
STAT,1872,22,25-29,1894,116.1937369045206
SIM,1863,25,30-34,1888,63
SIM,1883,31,40-44,1914,13
STAT,1941,5,na,1946,8316.352933517053
STAT,1849,10,na,1859,4706.35105915685
STAT,1885,20,45-49,1905,1.41018696798958
SIM,1868,54,na,1922,4119
STAT,1922,26,35-39,1948,34.41924135464961
STAT,1819,44,na,1863,2897.7328278402074
STAT,1939,17,15-19,1956,91.75682436489177
STAT,1845,28,25-29,1873,78.77061374889925
STAT,1943,28,40-44,1971,10.02038144001247
SIM,1927,29,50-100,1956,4
SIM,1838,88,na,1926,175
SIM,1917,46,35-39,1963,1
STAT,1861,18,50-100,1879,0.09410088310870851
SIM,1868,18,20-24,1886,41
SIM,1856,73,na,1929,1872
SIM,1817,93,na,1910,9
STAT,1901,24,20-24,1925,193.62130992328258
SIM,1894,39,50-100,1933,5
SIM,1832,30,na,1862,3652
STAT,1871,21,na,1892,4759.832642885595
STAT,1910,36,30-34,1946,3.5386431699881515
STAT,1870,80,na,1950,1226.5695818342103
SIM,1883,44,50-100,1927,5
STAT,1857,43,40-44,1900,3.515225158170516
STAT,1903,42,50-100,1945,0.2106978209962908
SIM,1869,39,na,1908,4507
STAT,1890,35,na,1925,5863.008963748961
SIM,1947,17,15-19,1964,94
STAT,1839,17,45-49,1856,0.13342612133471682
SIM,1921,9,na,1930,9212
STAT,1866,33,50-100,1899,1.7001997585683883
STAT,1885,57,na,1942,4039.9535224851147
SIM,1913,42,35-39,1955,2
STAT,1869,48,45-49,1917,0.4560347232132724
STAT,1882,34,50-100,1916,1.7871851559589236
STAT,1935,26,40-44,1961,12.840048358280761
SIM,1829,29,45-49,1858,5
SIM,1865,43,40-44,1908,10
STAT,1896,19,40-44,1915,0.48508246846749614
SIM,1918,20,25-29,1938,240
STAT,1858,23,40-44,1881,3.400863755982937
STAT,1875,31,40-44,1906,9.054409730898966
SIM,1870,40,50-100,1910,5
STAT,1921,36,40-44,1957,3.3780630130174796
STAT,1862,40,50-100,1902,1.842049830541771
SIM,1935,15,30-34,1950,42
SIM,1837,28,40-44,1865,5
SIM,1925,18,25-29,1943,136
SIM,1909,25,30-34,1934,96
SIM,1802,64,na,1866,1851
STAT,1899,41,50-100,1940,0.2039218844942522
STAT,1917,25,15-19,1942,1.5052326687237167
STAT,1853,36,na,1889,3766.538854698722
STAT,1940,19,25-29,1959,88.80988542898507
STAT,1887,33,25-29,1920,23.03828603422835
STAT,1893,53,na,1946,5423.496731932199
SIM,1816,40,40-44,1856,11
STAT,1841,55,na,1896,3000.107386459515
STAT,1863,16,25-29,1879,11.49945515931646
STAT,1932,20,na,1952,9735.435978835463
STAT,1936,34,na,1970,7411.108479942686
STAT,1920,18,45-49,1938,1.1286800477482275
STAT,1818,107,na,1925,0.004838299423407198
STAT,1820,48,50-100,1868,0.9007627488308458
SIM,1871,16,25-29,1887,16
SIM,1902,28,45-49,1930,5
STAT,1829,28,40-44,1857,7.340849341928506
STAT,1861,109,na,1970,0.01776390653050713
STAT,1843,15,45-49,1858,0.11832677918159314
SIM,1872,20,25-29,1892,134
STAT,1909,46,35-39,1955,0.2399940309251315
SIM,1875,32,45-49,1907,5
SIM,1899,25,45-49,1924,2
STAT,1849,51,na,1900,3422.172715894979
SIM,1884,17,na,1901,5492
SIM,1914,25,50-100,1939,6
STAT,1862,36,40-44,1898,7.592820392902029
SIM,1856,84,na,1940,448
STAT,1828,47,45-49,1875,0.4250845796679007
STAT,1917,38,40-44,1955,3.1244116936158584
SIM,1895,33,25-29,1928,37
STAT,1927,34,35-39,1961,22.670376478579513
STAT,1906,18,15-19,1924,17.41929337865067
SIM,1915,29,20-24,1944,39
STAT,1863,42,40-44,1905,3.971600545651653
SIM,1819,41,na,1860,3056
STAT,1906,25,50-100,1931,1.895351042487035
STAT,1885,49,40-44,1934,0.3369768510750744
SIM,1886,50,na,1936,4498
SIM,1915,48,25-29,1963,1
STAT,1852,46,25-29,1898,0.09206411570976034
STAT,1820,93,na,1913,32.71804417496062
STAT,1884,16,45-49,1900,0.13059068989716194
SIM,1789,81,na,1870,326
STAT,1840,27,50-100,1867,1.151292387717573
STAT,1923,49,20-24,1972,0.025948058009062504
SIM,1933,17,20-24,1950,373
STAT,1821,38,45-49,1859,7.339145916491016
STAT,1910,29,40-44,1939,9.028526008420013
STAT,1857,39,na,1896,3671.444893465121
SIM,1829,74,na,1903,1330
STAT,1873,35,50-100,1908,2.543324073069649
SIM,1848,21,45-49,1869,2
STAT,1846,32,25-29,1878,18.54011971047512
STAT,1912,21,na,1933,7410.533475699579
SIM,1842,30,40-44,1872,10
SIM,1914,18,15-19,1932,15
SIM,1935,34,35-39,1969,33
SIM,1915,17,na,1932,8235
SIM,1925,25,15-19,1950,1
STAT,1853,25,na,1878,4022.6371723386233
SIM,1893,49,40-44,1942,2
STAT,1900,39,25-29,1939,1.7235448466090717
STAT,1811,49,40-44,1860,1.1229869138251691
SIM,1893,20,45-49,1913,4
SIM,1855,36,na,1891,4115
STAT,1926,21,20-24,1947,273.60407774509315
SIM,1832,46,50-100,1878,1
SIM,1914,32,na,1946,7791
SIM,1854,32,25-29,1886,25
STAT,1927,27,45-49,1954,4.241116315736878
SIM,1887,42,50-100,1929,4
SIM,1858,31,35-39,1889,25
SIM,1925,38,40-44,1963,12
SIM,1873,37,20-24,1910,2
STAT,1898,40,25-29,1938,0.12310553675204489
STAT,1895,38,45-49,1933,5.220099757061657
STAT,1905,42,35-39,1947,0.3668261274835147
STAT,1855,25,30-34,1880,44.12605392480124
STAT,1891,4,na,1895,6567.201782087833
STAT,1854,73,na,1927,1820.8097164234105
SIM,1913,35,45-49,1948,2
SIM,1898,20,na,1918,6680
STAT,1907,48,25-29,1955,0.09523380275994094
STAT,1862,40,na,1902,4029.9221013407914
STAT,1890,68,na,1958,3931.263359611294
STAT,1866,54,na,1920,3902.046407478981
STAT,1900,31,15-19,1931,0.4006032861053819
STAT,1920,25,35-39,1945,33.480049711605055
STAT,1824,46,50-100,1870,0.6032272318607539
SIM,1881,35,50-100,1916,6
SIM,1840,37,na,1877,3906
SIM,1853,28,25-29,1881,73
SIM,1904,29,50-100,1933,3
SIM,1903,20,30-34,1923,70
STAT,1919,31,na,1950,8272.792936721926
SIM,1871,42,40-44,1913,3
SIM,1905,26,20-24,1931,37
SIM,1909,18,40-44,1927,1
SIM,1964,6,na,1970,10483
STAT,1795,77,na,1872,728.6218891359105
STAT,1865,37,20-24,1902,1.414362201176134
STAT,1850,23,50-100,1873,0.745072796908857
SIM,1880,3,na,1883,6466
STAT,1867,39,na,1906,4411.303972434241
STAT,1915,20,35-39,1935,18.977169373364703
STAT,1918,21,15-19,1939,11.628028889770668
STAT,1840,47,45-49,1887,0.34352027696188914
SIM,1928,35,40-44,1963,2
STAT,1947,24,45-49,1971,2.566341030415818
SIM,1867,23,20-24,1890,137
STAT,1865,22,35-39,1887,10.837157106968931
STAT,1922,16,40-44,1938,3.27640417006257
STAT,1819,46,40-44,1865,0.7293340103662811
SIM,1854,47,50-100,1901,2
STAT,1827,45,20-24,1872,0.022258421773252816
SIM,1847,25,45-49,1872,1
STAT,1920,1,na,1921,9460.374004973619
STAT,1880,23,15-19,1903,6.997226051379766
SIM,1885,39,40-44,1924,15
STAT,1929,35,35-39,1964,6.281705988244439
SIM,1850,35,45-49,1885,5
STAT,1843,48,25-29,1891,0.07967326370142586
STAT,1868,23,15-19,1891,6.319573724871223
STAT,1871,44,na,1915,4574.939244316175
STAT,1847,31,30-34,1878,31.57507579257799
SIM,1853,36,25-29,1889,7
SIM,1806,87,na,1893,92
STAT,1812,102,na,1914,0.27790243417494115
SIM,1953,12,na,1965,9954
SIM,1917,23,15-19,1940,12
STAT,1880,49,40-44,1929,0.3566354360004694
SIM,1818,48,40-44,1866,1
SIM,1864,22,40-44,1886,3
SIM,1867,25,15-19,1892,1
SIM,1887,27,40-44,1914,15
SIM,1903,34,25-29,1937,18
SIM,1914,20,40-44,1934,12
STAT,1925,17,20-24,1942,330.69477125287773
STAT,1852,61,na,1913,2978.250495818249
STAT,1845,36,25-29,1881,4.7102120846775986
STAT,1888,25,40-44,1913,7.199118184585266
SIM,1920,31,20-24,1951,7
STAT,1848,23,45-49,1871,1.382214421003812
STAT,1875,19,20-24,1894,36.66615643114431
SIM,1914,22,35-39,1936,27
SIM,1955,13,na,1968,10119
STAT,1841,24,na,1865,3873.731127082153
STAT,1862,33,20-24,1895,4.646332737314409
STAT,1941,18,30-34,1959,25.348623172185647
SIM,1868,31,na,1899,4598
STAT,1794,82,na,1876,347.2370214088263
STAT,1862,8,na,1870,4854.863042875252
STAT,1908,32,50-100,1940,1.5772144653582798
SIM,1844,38,25-29,1882,4
STAT,1909,21,20-24,1930,209.46190389063779
SIM,1827,46,40-44,1873,1
STAT,1829,75,na,1904,1218.37773526181
STAT,1878,42,15-19,1920,0.029093220313342962
SIM,1825,42,50-100,1867,8
STAT,1839,25,45-49,1864,2.2157243175168744
STAT,1887,79,na,1966,2275.4204593563636
SIM,1876,23,15-19,1899,6
STAT,1854,34,25-29,1888,15.749084746831654
STAT,1912,31,20-24,1943,4.868442983414628
SIM,1845,37,45-49,1882,8
SIM,1864,24,35-39,1888,15
STAT,1875,41,35-39,1916,3.7823556600872026
SIM,1872,36,na,1908,5019
SIM,1878,36,30-34,1914,14
SIM,1910,37,35-39,1947,8
STAT,1905,38,15-19,1943,0.035225640843148075
SIM,1836,39,45-49,1875,10
SIM,1873,22,35-39,1895,15
STAT,1856,22,40-44,1878,3.7711638184710616
STAT,1889,38,20-24,1927,1.9100720417047152
SIM,1879,28,45-49,1907,3
STAT,1892,16,na,1908,6401.162469051018
STAT,1811,89,na,1900,97.65401233589944
SIM,1896,25,40-44,1921,11
SIM,1899,26,20-24,1925,33
STAT,1874,20,35-39,1894,12.139275904811978
SIM,1829,34,40-44,1863,13
STAT,1929,33,40-44,1962,10.031898419635313
STAT,1881,16,40-44,1897,0.35791853583416267
SIM,1908,23,20-24,1931,205
STAT,1822,41,na,1863,3151.175460651818
STAT,1854,3,na,1857,5181.13502310913
STAT,1897,18,45-49,1915,0.17588534286529167
SIM,1917,21,20-24,1938,243
SIM,1940,28,50-100,1968,5
STAT,1859,25,15-19,1884,0.7526804312252249
SIM,1883,41,35-39,1924,5
STAT,1837,37,45-49,1874,3.3836043459762615
STAT,1807,74,na,1881,1055.7149215413465
STAT,1828,39,45-49,1867,3.85516490272219
STAT,1872,18,40-44,1890,0.3702730828860979
SIM,1919,37,40-44,1956,7
SIM,1853,36,40-44,1889,12
SIM,1791,84,na,1875,156
STAT,1794,92,na,1886,23.94752412306964
SIM,1813,59,na,1872,2353
STAT,1930,40,40-44,1970,0.6664952801763687
SIM,1855,24,40-44,1879,4
SIM,1937,28,45-49,1965,4
STAT,1867,49,na,1916,4166.554591794206
SIM,1878,29,40-44,1907,8
STAT,1864,19,45-49,1883,0.12056036820284542
STAT,1832,50,50-100,1882,0.02130801681242432
STAT,1879,34,30-34,1913,36.56747371952954
STAT,1826,57,na,1883,2563.589003596105
SIM,1838,34,35-39,1872,28
STAT,1883,36,45-49,1919,3.974661218812658
STAT,1825,42,50-100,1867,2.4390564850580714
STAT,1875,68,na,1943,3177.6599754098047
SIM,1851,74,na,1925,1596
STAT,1893,29,50-100,1922,1.6258307387139905
STAT,1863,27,45-49,1890,1.9629056331545331
SIM,1806,77,na,1883,653
STAT,1869,44,15-19,1913,0.02666021474272111
STAT,1809,75,na,1884,953.9571427754024
STAT,1818,38,na,1856,3069.7025096865204
SIM,1937,33,40-44,1970,16
STAT,1877,49,na,1926,4619.758116638374
STAT,1889,31,50-100,1920,2.2909891033484104
STAT,1829,35,30-34,1864,9.65378007675036
SIM,1838,27,45-49,1865,3
STAT,1887,38,50-100,1925,2.7594612063600903
SIM,1859,49,40-44,1908,1
SIM,1942,15,20-24,1957,306
SIM,1922,21,30-34,1943,97
STAT,1934,15,20-24,1949,372.13161893115455
STAT,1889,7,na,1896,6487.943557407304
SIM,1856,23,45-49,1879,3
STAT,1877,69,na,1946,3077.670651124686
SIM,1800,62,na,1862,1835
SIM,1894,37,40-44,1931,18
STAT,1896,26,30-34,1922,67.37615677513571
STAT,1850,51,45-49,1901,0.0223579103830645
STAT,1902,37,35-39,1939,4.352944783042802
STAT,1907,21,50-100,1928,1.2141242223901523
SIM,1861,74,na,1935,1968
STAT,1892,48,20-24,1940,0.01689899551623753
STAT,1816,45,45-49,1861,1.195661925058671
STAT,1816,57,na,1873,2453.8942769243286
STAT,1927,45,25-29,1972,0.13508949863532257
STAT,1792,102,na,1894,0.10985035282512612
SIM,1872,23,30-34,1895,42
SIM,1891,19,na,1910,6495
STAT,1872,91,na,1963,271.9404091854343
STAT,1894,17,na,1911,6552.424497410495
STAT,1929,28,45-49,1957,4.3642005259797365
STAT,1842,49,20-24,1891,0.01749274978129734
STAT,1824,31,50-100,1855,4.868319085337988
SIM,1923,20,35-39,1943,31
STAT,1859,23,20-24,1882,114.1087216858455
STAT,1930,22,25-29,1952,238.98180587352732
SIM,1865,98,na,1963,4
SIM,1930,16,40-44,1946,3
STAT,1862,50,25-29,1912,0.00620209105233207
STAT,1892,36,na,1928,5985.276890108464
SIM,1849,27,20-24,1876,24
STAT,1849,51,35-39,1900,0.013682950740585047
STAT,1854,96,na,1950,13.16323676769839
STAT,1831,49,45-49,1880,0.35200756920513326
STAT,1850,18,20-24,1868,33.02108316547437
STAT,1886,37,40-44,1923,9.332584586758136
SIM,1823,35,na,1858,3345
STAT,1864,23,30-34,1887,32.43919208247943
STAT,1833,26,20-24,1859,20.55604519928622
STAT,1877,39,25-29,1916,5.977360867978387
STAT,1894,36,20-24,1930,2.009513466801834
SIM,1857,44,45-49,1901,6
SIM,1881,19,na,1900,4351
SIM,1837,35,30-34,1872,13
SIM,1888,30,30-34,1918,57
SIM,1907,27,20-24,1934,35
STAT,1884,17,na,1901,5036.741727447373
STAT,1792,81,na,1873,414.3276874480067
STAT,1848,30,35-39,1878,19.771240958283595
STAT,1828,44,25-29,1872,1.1707944280804352
STAT,1897,25,35-39,1922,26.225374361792817
STAT,1906,20,40-44,1926,6.169123330541439
SIM,1855,31,30-34,1886,37
STAT,1909,23,15-19,1932,9.966422938622825
SIM,1818,48,25-29,1866,1
SIM,1841,26,20-24,1867,21
STAT,1923,15,45-49,1938,1.1897916624364135
SIM,1885,39,25-29,1924,9
SIM,1821,44,na,1865,3013
STAT,1865,15,45-49,1880,0.13733595848896768
STAT,1881,54,na,1935,4087.5742530475422
SIM,1877,15,30-34,1892,3
SIM,1868,47,40-44,1915,1
STAT,1855,26,40-44,1881,4.742388130882835
STAT,1906,39,50-100,1945,0.7720237526701816
STAT,1834,40,35-39,1874,2.9813127383606224
SIM,1860,30,50-100,1890,2
STAT,1854,29,45-49,1883,1.7588042507574884
SIM,1872,48,45-49,1920,1
STAT,1782,81,na,1863,392.78809633637917
STAT,1908,25,20-24,1933,35.408199742799795
SIM,1897,23,35-39,1920,21
STAT,1854,41,15-19,1895,0.0212660836765248
SIM,1850,37,na,1887,3817
STAT,1831,24,na,1855,3642.096038220357
STAT,1917,45,50-100,1962,0.4793325980274057
SIM,1816,43,45-49,1859,5
STAT,1904,66,na,1970,5441.5202671515
STAT,1784,82,na,1866,266.5444581422667
SIM,1831,29,15-19,1860,1
STAT,1876,47,25-29,1923,0.11975738936236016
STAT,1777,80,na,1857,426.6693459804785
STAT,1840,29,15-19,1869,0.8048717693024418
SIM,1867,18,25-29,1885,18
SIM,1849,40,na,1889,3831
STAT,1859,18,25-29,1877,10.511597863058794
STAT,1829,36,50-100,1865,2.1851791761251773
STAT,1937,27,40-44,1964,9.178072329386625
SIM,1938,11,na,1949,7974
STAT,1946,25,40-44,1971,10.494390272568998
SIM,1879,35,35-39,1914,18
SIM,1863,26,40-44,1889,7
SIM,1943,12,na,1955,8601
STAT,1862,54,50-100,1916,0.025353466528853275
SIM,1866,27,20-24,1893,24
STAT,1865,105,na,1970,0.6129312047884645
STAT,1846,77,na,1923,1323.9973423527958
SIM,1830,27,na,1857,3426
STAT,1868,16,25-29,1884,11.151601473559072
STAT,1869,15,30-34,1884,3.1998816082139743
STAT,1759,95,na,1854,2.0
STAT,1914,24,35-39,1938,19.30998021425243
STAT,1889,23,35-39,1912,14.486801215775742
SIM,1887,34,30-34,1921,47
STAT,1887,69,na,1956,3372.7297811425947
SIM,1877,37,25-29,1914,9
SIM,1925,15,20-24,1940,336
SIM,1846,26,40-44,1872,7
STAT,1847,24,40-44,1871,3.838284918938715
STAT,1830,25,40-44,1855,8.31866582625598
STAT,1845,43,15-19,1888,0.021394021038273398
STAT,1851,24,na,1875,3901.510853048016
SIM,1881,29,na,1910,4047
SIM,1886,35,40-44,1921,13
STAT,1857,46,45-49,1903,0.3725652635192618
SIM,1873,29,20-24,1902,28
STAT,1830,25,25-29,1855,117.47083215364809
STAT,1849,29,20-24,1878,21.682584806145965
SIM,1857,29,20-24,1886,18
SIM,1866,49,30-34,1915,1
SIM,1856,1,na,1857,6170
STAT,1869,47,50-100,1916,0.47838365365593816
STAT,1912,41,50-100,1953,0.23021473550738739
STAT,1838,26,40-44,1864,5.194445715795757
STAT,1881,48,45-49,1929,0.45490258044168624
SIM,1811,78,na,1889,633
STAT,1868,86,na,1954,426.3409426190325
STAT,1940,16,50-100,1956,0.7685385341552887
SIM,1865,46,45-49,1911,2
SIM,1940,16,50-100,1956,5
STAT,1857,34,50-100,1891,1.4300021067710662
STAT,1888,49,50-100,1937,0.32379647505492754
STAT,1908,20,50-100,1928,1.2298048842005993
STAT,1911,14,na,1925,7958.030770581347
STAT,1861,44,na,1905,3832.770352676208
SIM,1942,0,na,1942,8743
STAT,1878,35,40-44,1913,9.321161042837565
STAT,1858,27,20-24,1885,18.907872973228375
STAT,1848,37,20-24,1885,1.3025423417510038
STAT,1947,0,na,1947,10098.831140437922
SIM,1922,24,35-39,1946,30
SIM,1905,22,40-44,1927,7
SIM,1927,5,na,1932,10337
STAT,1808,50,35-39,1858,0.05322887395476375
SIM,1847,69,na,1916,2148
SIM,1850,27,na,1877,4054
SIM,1862,34,25-29,1896,21
STAT,1809,55,na,1864,2456.3341244649573
STAT,1955,5,na,1960,10540.007808968525
STAT,1829,36,40-44,1865,7.791231414792663
STAT,1886,44,15-19,1930,0.029044355054728285
SIM,1957,3,na,1960,10331
STAT,1767,112,na,1879,0.0012793131192449549
STAT,1826,53,50-100,1879,0.0284756252582398
SIM,1872,24,40-44,1896,10
SIM,1901,39,35-39,1940,2
STAT,1867,17,20-24,1884,34.27994821304717
SIM,1876,16,25-29,1892,17
SIM,1912,32,25-29,1944,22
STAT,1878,25,50-100,1903,1.3584577094777248
SIM,1861,35,20-24,1896,2
STAT,1938,26,45-49,1964,3.458809917849974
STAT,1853,35,20-24,1888,1.2452318449413102
STAT,1902,31,na,1933,6832.005127540341
STAT,1914,22,40-44,1936,6.938896649041972
STAT,1845,39,45-49,1884,3.161211951302586
STAT,1879,27,40-44,1906,6.328060181751246
STAT,1891,19,20-24,1910,44.019846145851254
SIM,1924,21,na,1945,9039
STAT,1820,35,25-29,1855,16.48840085373842
SIM,1858,28,25-29,1886,87
STAT,1872,71,na,1943,2709.2988786084825
STAT,1863,31,15-19,1894,0.2527914833249148
STAT,1864,24,40-44,1888,3.7677218394443424
SIM,1922,22,40-44,1944,10
STAT,1860,90,na,1950,129.30506063068768
STAT,1938,33,35-39,1971,18.549138538806123
STAT,1873,21,30-34,1894,36.66215773611037
SIM,1912,20,na,1932,7617
SIM,1932,20,50-100,1952,1
STAT,1833,59,na,1892,2554.932005055378
SIM,1875,17,20-24,1892,42
SIM,1896,70,na,1966,4336
STAT,1869,37,25-29,1906,5.634414786045897
SIM,1906,21,45-49,1927,1
SIM,1862,29,45-49,1891,2
STAT,1904,32,25-29,1936,17.048368756261205
SIM,1847,32,35-39,1879,24
STAT,1847,49,na,1896,3357.920520467575
STAT,1910,39,35-39,1949,4.626626151534223
SIM,1882,19,20-24,1901,31
STAT,1838,33,30-34,1871,29.059488086606056
STAT,1895,34,15-19,1929,0.37155580195301324
SIM,1824,96,na,1920,14
STAT,1956,10,na,1966,10498.919786688997
SIM,1842,40,35-39,1882,5
STAT,1954,17,50-100,1971,0.9353015709095945
SIM,1837,36,40-44,1873,7
SIM,1929,31,40-44,1960,12
STAT,1837,94,na,1931,27.855706159906827
STAT,1910,50,na,1960,6862.6809037278945
SIM,1916,25,20-24,1941,39
STAT,1884,46,20-24,1930,0.023999191817117523
STAT,1829,85,na,1914,324.4405925814487
SIM,1909,38,50-100,1947,1
SIM,1926,21,15-19,1947,1
SIM,1827,46,25-29,1873,1
STAT,1896,27,40-44,1923,7.9874563826957665
SIM,1883,34,45-49,1917,6
SIM,1950,5,na,1955,9190
STAT,1937,34,30-34,1971,31.446293879829618
STAT,1810,46,20-24,1856,0.0798009969381714
STAT,1886,37,25-29,1923,6.138283024003311
STAT,1875,34,45-49,1909,3.5949748913147967
STAT,1917,48,35-39,1965,0.2711991841166191
STAT,1909,24,25-29,1933,172.3902808503273
STAT,1839,32,35-39,1871,19.459337084851075
STAT,1852,71,na,1923,2127.418877617579
STAT,1928,37,40-44,1965,3.820305060807709
SIM,1846,33,30-34,1879,43
SIM,1897,16,45-49,1913,1
STAT,1890,38,45-49,1928,4.889880874337852
STAT,1882,16,na,1898,4981.072734201544
SIM,1894,37,25-29,1931,12
SIM,1816,87,na,1903,119
SIM,1867,102,na,1969,3
SIM,1922,17,45-49,1939,2
STAT,1914,17,45-49,1931,0.20873052447339746
SIM,1832,28,20-24,1860,19
SIM,1888,51,na,1939,5089
STAT,1819,46,25-29,1865,0.24538340344659018
STAT,1828,43,15-19,1871,0.025586635431946576
SIM,1886,39,50-100,1925,5
STAT,1848,22,35-39,1870,11.650602674078751
SIM,1845,34,40-44,1879,16
SIM,1864,25,45-49,1889,1
SIM,1868,39,40-44,1907,11
SIM,1859,40,na,1899,4157
STAT,1823,47,45-49,1870,0.729207899767162
SIM,1903,31,20-24,1934,10
STAT,1929,32,30-34,1961,40.41370339134829
STAT,1797,79,na,1876,562.2449540832814
STAT,1895,27,25-29,1922,111.32171143451669
STAT,1932,20,35-39,1952,25.102171951775446
SIM,1825,48,30-34,1873,1
STAT,1830,32,15-19,1862,0.28206295051997315
SIM,1847,31,50-100,1878,2
SIM,1948,11,na,1959,9331
SIM,1829,33,30-34,1862,37
STAT,1880,35,na,1915,5060.117894928492
SIM,1835,48,40-44,1883,1
SIM,1853,33,20-24,1886,6
STAT,1900,17,30-34,1917,4.4654237152626814
SIM,1914,23,45-49,1937,2
STAT,1912,34,25-29,1946,18.21543514323503
SIM,1895,23,na,1918,6579
STAT,1884,39,30-34,1923,10.521647268347085
SIM,1896,24,30-34,1920,60
SIM,1871,74,na,1945,2010
STAT,1794,102,na,1896,0.1148364988915671
STAT,1894,39,40-44,1933,11.24267640331199
STAT,1879,19,50-100,1898,0.10293920420941623
SIM,1846,36,35-39,1882,19
STAT,1888,24,30-34,1912,42.25290307536397
SIM,1892,39,30-34,1931,25
SIM,1866,41,35-39,1907,5
SIM,1917,24,25-29,1941,232
STAT,1947,21,40-44,1968,7.676758057543613
SIM,1853,39,45-49,1892,2
SIM,1856,22,35-39,1878,13
STAT,1864,42,na,1906,4167.366044022697
SIM,1843,39,35-39,1882,17
STAT,1887,36,30-34,1923,12.096352780218933
STAT,1839,31,50-100,1870,1.7789587363939683
SIM,1894,47,na,1941,6013
SIM,1867,26,25-29,1893,94
SIM,1929,26,45-49,1955,5
STAT,1942,17,20-24,1959,286.1483586979513
SIM,1786,93,na,1879,8
SIM,1928,38,45-49,1966,6
STAT,1854,33,15-19,1887,0.2212523594259823
STAT,1861,36,25-29,1897,4.863249589762603
STAT,1906,23,45-49,1929,2.045837250261821
SIM,1836,36,25-29,1872,9
SIM,1918,45,na,1963,8193
SIM,1934,23,15-19,1957,13
SIM,1831,47,45-49,1878,2
STAT,1906,47,na,1953,6591.513012733413
STAT,1929,36,45-49,1965,1.769032638674858
SIM,1842,18,20-24,1860,25
STAT,1844,52,na,1896,3458.669887721718
SIM,1833,79,na,1912,856
STAT,1837,34,25-29,1871,17.535063051329352
SIM,1867,14,na,1881,5428
STAT,1845,33,20-24,1878,4.901328932198624
STAT,1787,80,na,1867,481.3749085679572
STAT,1880,90,na,1970,539.5190783428334
STAT,1802,98,na,1900,2.493199257508588
SIM,1940,20,35-39,1960,23
STAT,1850,37,50-100,1887,1.912270671785241
STAT,1867,105,na,1972,0.7996506510747838
STAT,1832,27,50-100,1859,1.1228249118915021
STAT,1872,47,40-44,1919,0.34587155132570074
STAT,1857,20,35-39,1877,10.758876588731063
SIM,1849,35,20-24,1884,1
STAT,1813,51,40-44,1864,0.06316197729459225
STAT,1834,33,45-49,1867,2.9426557879490796
STAT,1885,15,15-19,1900,11.985634226963985
STAT,1842,95,na,1937,19.794588971395342
STAT,1859,26,25-29,1885,69.67306034490169
STAT,1840,15,40-44,1855,0.34588311820445733
SIM,1901,34,na,1935,6742
STAT,1921,14,na,1935,9089.803351243432
STAT,1856,25,45-49,1881,1.8188192124005687
STAT,1828,36,25-29,1864,5.91824224117572
SIM,1863,45,na,1908,4247
SIM,1882,27,20-24,1909,24
STAT,1776,97,na,1873,1.8153905336632281
STAT,1926,23,15-19,1949,13.018376639807295
SIM,1937,32,30-34,1969,42
STAT,1838,36,35-39,1874,11.671290540538784
STAT,1843,45,20-24,1888,0.017165702075498994
SIM,1869,39,40-44,1908,17
STAT,1826,41,50-100,1867,2.2777137522884887
SIM,1842,33,45-49,1875,6
STAT,1835,46,25-29,1881,0.07968435047234328
STAT,1819,107,na,1926,0.0049346640591427715
SIM,1893,15,15-19,1908,12
STAT,1868,49,40-44,1917,0.3220967729436356
SIM,1854,35,30-34,1889,14
SIM,1869,47,50-100,1916,2
STAT,1836,20,15-19,1856,7.0430471748302335
STAT,1813,50,na,1863,2639.064783617342
STAT,1864,105,na,1969,0.5329639888201488
SIM,1841,54,na,1895,2976
SIM,1920,34,25-29,1954,28
SIM,1909,21,15-19,1930,11
STAT,1791,64,na,1855,1657.0479999999998
STAT,1831,46,40-44,1877,0.26536766849985727
SIM,1833,25,na,1858,3729
SIM,1878,37,40-44,1915,20
STAT,1927,42,20-24,1969,0.04472512420493782
SIM,1862,26,25-29,1888,81
SIM,1878,33,25-29,1911,27
SIM,1871,24,40-44,1895,5
SIM,1872,26,35-39,1898,34
SIM,1888,33,35-39,1921,35
STAT,1867,69,na,1936,2775.7476603136197
STAT,1900,24,50-100,1924,1.1353235122305032
SIM,1878,31,na,1909,5229
SIM,1895,29,40-44,1924,13
STAT,1864,16,40-44,1880,0.3775878274932169
SIM,1803,59,na,1862,2194
STAT,1906,30,35-39,1936,17.250665270752446
SIM,1831,44,na,1875,3362
SIM,1854,28,50-100,1882,1
STAT,1961,11,na,1972,10249.082359417356
SIM,1931,26,15-19,1957,6
STAT,1814,49,45-49,1863,1.1851503752999988
STAT,1836,23,na,1859,3724.73272124402
STAT,1868,36,50-100,1904,2.370494791340195
SIM,1830,26,45-49,1856,5
STAT,1846,28,50-100,1874,1.1768324511015058
SIM,1929,33,35-39,1962,33
STAT,1865,68,na,1933,2803.9540321275304
STAT,1860,23,45-49,1883,1.1704904724958705
SIM,1895,36,30-34,1931,20
SIM,1945,25,50-100,1970,2
STAT,1887,29,40-44,1916,6.717997366283578
SIM,1839,23,45-49,1862,1
SIM,1937,25,40-44,1962,15
STAT,1923,26,15-19,1949,1.642015344427491
STAT,1927,39,na,1966,9425.313390766136
SIM,1859,16,25-29,1875,12
SIM,1865,20,35-39,1885,11
SIM,1845,34,25-29,1879,30
SIM,1868,47,25-29,1915,1
SIM,1911,44,na,1955,7276
SIM,1886,18,na,1904,5316
SIM,1888,23,40-44,1911,6
STAT,1875,30,50-100,1905,1.9205108750422573
SIM,1816,77,na,1893,791
SIM,1819,39,45-49,1858,5
STAT,1864,48,45-49,1912,0.4206996688684633
STAT,1901,38,30-34,1939,3.236310723181609
SIM,1901,68,na,1969,4926
STAT,1863,24,40-44,1887,3.703622187715367
SIM,1871,31,15-19,1902,2
STAT,1823,60,na,1883,2469.5863927249557
SIM,1896,20,50-100,1916,7
SIM,1859,23,15-19,1882,7
SIM,1918,16,40-44,1934,1
STAT,1888,20,50-100,1908,0.9792302561727333
SIM,1851,38,30-34,1889,14
SIM,1854,41,na,1895,3878
SIM,1776,83,na,1859,144
STAT,1854,26,25-29,1880,75.24505435649536
STAT,1864,26,35-39,1890,17.479080559525322
STAT,1937,35,40-44,1972,3.0290500071351985
STAT,1871,23,20-24,1894,137.84668742974142
SIM,1906,20,35-39,1926,25
STAT,1853,38,40-44,1891,6.891737912728939
SIM,1818,58,na,1876,2371
STAT,1806,57,na,1863,2099.1117621363296
STAT,1843,38,30-34,1881,7.84928644946886
SIM,1908,26,25-29,1934,146
STAT,1819,49,45-49,1868,0.9610159691670942
STAT,1866,29,20-24,1895,21.705074627212934
SIM,1881,21,30-34,1902,39
SIM,1861,38,40-44,1899,14
STAT,1796,63,na,1859,1761.8605549902056
STAT,1809,49,35-39,1858,1.0465881181727763
SIM,1817,49,35-39,1866,1
SIM,1843,89,na,1932,110
SIM,1827,49,45-49,1876,2
SIM,1937,28,na,1965,7481
SIM,1824,31,50-100,1855,2
SIM,1828,38,40-44,1866,5
SIM,1876,36,50-100,1912,4
STAT,1859,33,15-19,1892,0.2279527582653032
STAT,1934,18,25-29,1952,118.08745029652377
STAT,1929,25,40-44,1954,11.824814222484006
SIM,1916,46,50-100,1962,2
STAT,1862,36,25-29,1898,4.993994974145368
STAT,1901,48,na,1949,6282.370077491377
SIM,1925,23,20-24,1948,273
SIM,1942,18,25-29,1960,124
SIM,1844,41,na,1885,3334
STAT,1917,23,20-24,1940,237.91960700864487
STAT,1860,30,35-39,1890,16.74273445005157
STAT,1888,5,na,1893,6255.634815615476
STAT,1837,41,15-19,1878,0.023010564408478453
STAT,1880,19,45-49,1899,0.1382330860859543
SIM,1952,6,na,1958,9773
SIM,1867,15,20-24,1882,44
STAT,1840,39,45-49,1879,3.3334037043249523
STAT,1922,24,40-44,1946,7.7365134053741365
STAT,1854,52,40-44,1906,0.016052837899132814
STAT,1872,26,40-44,1898,6.10108310164119
STAT,1862,28,25-29,1890,72.76373206637513
SIM,1896,32,30-34,1928,54
STAT,1878,35,25-29,1913,6.130769462773868
STAT,1836,25,50-100,1861,1.116779452360381
STAT,1931,28,15-19,1959,1.8398974801928787
STAT,1898,21,35-39,1919,15.997030045732261
SIM,1924,27,20-24,1951,46
STAT,1862,61,na,1923,3225.6410415791893
STAT,1926,16,25-29,1942,107.54979671407138
SIM,1796,93,na,1889,15
SIM,1914,15,45-49,1929,1
STAT,1854,37,30-34,1891,8.170174947248753
STAT,1876,18,25-29,1894,11.80598792626817
SIM,1823,79,na,1902,668
STAT,1899,20,25-29,1919,159.3516889239189
SIM,1923,28,30-34,1951,123
STAT,1919,43,25-29,1962,0.15600852219284164
STAT,1888,32,30-34,1920,41.677482541001666
STAT,1906,15,45-49,1921,0.1931336647403912
STAT,1871,26,40-44,1897,6.031270900459462
STAT,1908,28,25-29,1936,125.30496312324907
SIM,1854,28,40-44,1882,6
STAT,1839,39,20-24,1878,1.4087845092260327
SIM,1904,26,40-44,1930,12
STAT,1929,40,30-34,1969,0.33527232641295623
STAT,1922,23,30-34,1945,66.34225869241773
STAT,1959,0,na,1959,10462.082809210506
SIM,1886,38,45-49,1924,8
SIM,1907,42,45-49,1949,1
SIM,1930,23,30-34,1953,91
SIM,1829,41,30-34,1870,1
SIM,1929,34,45-49,1963,11
STAT,1830,28,45-49,1858,2.41802984147176
STAT,1872,25,30-34,1897,51.459487498220255
SIM,1903,15,na,1918,7497
STAT,1856,46,45-49,1902,0.3687878313313637
STAT,1819,38,40-44,1857,23.794654228374124
STAT,1838,29,45-49,1867,1.8841424599502241
STAT,1844,15,25-29,1859,11.771100506515243
SIM,1891,36,45-49,1927,8
STAT,1832,95,na,1927,17.3336309226452
STAT,1849,44,45-49,1893,2.3354275929646433
SIM,1873,55,na,1928,4316
STAT,1793,102,na,1895,0.10641428680094756
STAT,1855,68,na,1923,2304.4216180750523
STAT,1859,15,20-24,1874,33.47385803990079
STAT,1878,16,35-39,1894,1.160235145390622
STAT,1890,16,35-39,1906,1.3559757408020745
STAT,1886,29,40-44,1915,6.340725611266023
STAT,1904,24,25-29,1928,164.90131385777795
STAT,1825,30,50-100,1855,4.0853206528091315
SIM,1930,24,40-44,1954,14
STAT,1811,48,na,1859,2762.8958708831547
STAT,1864,38,50-100,1902,2.2054620445681836
STAT,1868,46,20-24,1914,0.02312378441132837
SIM,1872,38,50-100,1910,5
SIM,1886,35,25-29,1921,7
STAT,1916,27,20-24,1943,38.11790162129586
SIM,1890,36,45-49,1926,8
STAT,1825,49,20-24,1874,0.025316036810705586
SIM,1887,37,35-39,1924,8
SIM,1846,29,45-49,1875,2
STAT,1914,21,30-34,1935,57.08893238992791
STAT,1857,70,na,1927,2208.7151107697277
STAT,1766,112,na,1878,9.058316325732E-4
SIM,1864,46,45-49,1910,1
SIM,1819,47,45-49,1866,1
STAT,1882,15,45-49,1897,0.12911237982837273
SIM,1887,0,na,1887,7295
SIM,1883,19,20-24,1902,41
SIM,1877,14,na,1891,5358
SIM,1781,94,na,1875,9
SIM,1801,78,na,1879,586
SIM,1876,49,40-44,1925,2
STAT,1870,90,na,1960,269.73587400282895
SIM,1901,36,30-34,1937,5
STAT,1867,25,20-24,1892,22.339694074775714
STAT,1871,33,15-19,1904,0.2845373002642712
STAT,1937,25,50-100,1962,1.961652108548793
SIM,1934,16,25-29,1950,132
SIM,1870,28,25-29,1898,93
SIM,1864,92,na,1956,48
STAT,1861,29,35-39,1890,16.104002834622314
STAT,1846,35,30-34,1881,8.703734442148724
SIM,1819,44,25-29,1863,1
STAT,1898,47,45-49,1945,0.362142390906208
SIM,1839,30,35-39,1869,26
STAT,1915,28,30-34,1943,80.43729281835859
SIM,1912,24,25-29,1936,204
STAT,1845,36,40-44,1881,7.161359704322483
STAT,1854,52,na,1906,3283.206943327232
STAT,1864,27,45-49,1891,2.004440765319395
SIM,1887,14,na,1901,6374
STAT,1874,27,20-24,1901,24.259641887469375
SIM,1947,22,45-49,1969,3
SIM,1879,42,50-100,1921,5
SIM,1820,34,20-24,1854,2
SIM,1880,47,40-44,1927,1
STAT,1872,16,na,1888,5173.660335253368
STAT,1897,15,na,1912,6849.910696426775
STAT,1896,30,15-19,1926,0.38277209500790227
SIM,1909,22,25-29,1931,185
SIM,1948,21,35-39,1969,35
STAT,1933,27,50-100,1960,2.669452855220984
SIM,1859,24,25-29,1883,113
SIM,1829,95,na,1924,16
SIM,1888,22,30-34,1910,49
STAT,1880,42,40-44,1922,4.779606846934172
STAT,1810,49,25-29,1859,0.36153165582325136
SIM,1838,78,na,1916,951
SIM,1823,45,45-49,1868,1
SIM,1916,28,25-29,1944,152
SIM,1884,39,25-29,1923,8
STAT,1870,52,25-29,1922,0.006985811578302932
STAT,1877,21,15-19,1898,6.9394630894475124
SIM,1933,12,na,1945,11240
SIM,1901,29,40-44,1930,11
STAT,1906,22,35-39,1928,17.173492254922397
STAT,1896,50,na,1946,5823.931314496802
STAT,1828,47,30-34,1875,0.17435672606173627
STAT,1846,28,40-44,1874,5.510893783136996
STAT,1878,38,45-49,1916,4.1840067461858235
STAT,1835,39,35-39,1874,11.097356284994165
SIM,1840,27,na,1867,4238
STAT,1856,24,35-39,1880,10.409626505484955
STAT,1954,3,na,1957,9820.278369978965
SIM,1941,27,50-100,1968,4
SIM,1956,1,na,1957,10719
STAT,1819,43,20-24,1862,0.7117269813540364
STAT,1939,22,45-49,1961,2.2824121303184053
SIM,1894,34,20-24,1928,9
SIM,1850,19,25-29,1869,17
STAT,1827,48,40-44,1875,0.3050844193681108
STAT,1886,34,20-24,1920,5.713427497779833
SIM,1894,29,40-44,1923,10
SIM,1922,25,50-100,1947,3
STAT,1885,34,na,1919,4756.1203495082345
SIM,1840,20,30-34,1860,44
STAT,1836,38,25-29,1874,4.651343234147622
STAT,1842,19,25-29,1861,10.706593597519591
SIM,1839,43,50-100,1882,4
STAT,1879,37,35-39,1916,14.941384728672174
SIM,1858,26,50-100,1884,2
SIM,1837,32,25-29,1869,20
SIM,1852,91,na,1943,62
SIM,1936,26,50-100,1962,3
SIM,1878,28,45-49,1906,4
SIM,1902,30,na,1932,7027
SIM,1827,38,40-44,1865,13
STAT,1912,31,na,1943,7548.784738308951
STAT,1884,49,25-29,1933,0.11247158063654061
SIM,1943,2,na,1945,8823
SIM,1950,17,20-24,1967,283
STAT,1928,15,na,1943,9408.81920552525
STAT,1880,16,25-29,1896,12.085989198230848
STAT,1910,21,45-49,1931,2.141246273049372
SIM,1852,15,25-29,1867,9
STAT,1811,102,na,1913,0.27252502828234054
STAT,1893,40,50-100,1933,2.7316762487459427
SIM,1929,41,35-39,1970,1
STAT,1851,48,50-100,1899,0.3759410304605088
STAT,1871,29,45-49,1900,2.211917100473989
SIM,1814,96,na,1910,1
SIM,1826,77,na,1903,913
STAT,1847,94,na,1941,30.46561440288294
SIM,1872,27,45-49,1899,2
STAT,1829,32,25-29,1861,19.647125095537557
STAT,1856,17,45-49,1873,0.12035753423015397
STAT,1896,23,25-29,1919,152.16965767127394
STAT,1816,88,na,1904,134.84715132418074
SIM,1890,18,15-19,1908,13
STAT,1851,47,20-24,1898,0.018515467798604197
STAT,1908,35,15-19,1943,0.03668091507910282
SIM,1866,102,na,1968,5
STAT,1842,35,45-49,1877,3.5546679576127977
SIM,1847,22,40-44,1869,4
STAT,1865,29,20-24,1894,21.371155473713657
SIM,1864,72,na,1936,2293
STAT,1882,18,15-19,1900,11.6450253562441
SIM,1904,33,30-34,1937,38
STAT,1839,22,40-44,1861,4.18064198834634
STAT,1919,47,40-44,1966,0.3452963739821352
SIM,1819,48,40-44,1867,1
STAT,1893,36,20-24,1929,1.982776646715127
STAT,1875,26,45-49,1901,2.316633432147729
SIM,1828,34,40-44,1862,10
STAT,1855,22,25-29,1877,100.84624689335553
SIM,1852,36,25-29,1888,5
SIM,1938,21,40-44,1959,8
STAT,1837,45,30-34,1882,0.14371970691852845
SIM,1876,18,na,1894,5437
SIM,1874,92,na,1966,162
STAT,1936,32,20-24,1968,4.78582306221868
SIM,1863,36,35-39,1899,16
STAT,1857,53,50-100,1910,0.023392973610626228
SIM,1875,39,30-34,1914,16
STAT,1822,95,na,1917,15.011770793173229
STAT,1932,28,50-100,1960,2.631915522726636
STAT,1887,25,40-44,1912,6.8122629850969645
STAT,1916,20,35-39,1936,20.045538036207
SIM,1913,15,na,1928,8224
STAT,1905,34,35-39,1939,16.83881534940653
STAT,1897,29,15-19,1926,1.216080277281087
STAT,1908,47,30-34,1955,0.16293140574776221
STAT,1899,42,35-39,1941,0.34752995093192934
SIM,1902,20,15-19,1922,9
SIM,1913,34,35-39,1947,26
STAT,1895,24,20-24,1919,180.21692774509688
STAT,1901,16,20-24,1917,50.24820816357596
SIM,1813,80,na,1893,487
STAT,1867,70,na,1937,2653.8090655960423
SIM,1886,39,40-44,1925,13
STAT,1774,102,na,1876,0.12177098736159125
STAT,1910,28,30-34,1938,76.17465074945112
STAT,1914,12,na,1926,8252.109812910603
SIM,1894,3,na,1897,7128
STAT,1855,36,35-39,1891,10.716835081809755
STAT,1878,39,40-44,1917,9.140538897493716
SIM,1833,32,40-44,1865,12
SIM,1892,38,20-24,1930,4
SIM,1951,7,na,1958,9805
STAT,1919,21,15-19,1940,11.805364585760397
SIM,1856,53,na,1909,3542
STAT,1818,80,na,1898,634.6444910420362
SIM,1895,25,40-44,1920,12
SIM,1904,22,25-29,1926,179
STAT,1826,45,20-24,1871,0.02458841846542064
STAT,1926,38,35-39,1964,5.963008617034119
SIM,1837,39,45-49,1876,6
STAT,1851,18,20-24,1869,33.21683590218121
STAT,1905,20,25-29,1925,168.1994970481502
STAT,1877,15,na,1892,5321.20437099273
STAT,1919,21,30-34,1940,63.740213664479214
STAT,1858,48,20-24,1906,0.01865562914445824
STAT,1943,23,15-19,1966,11.43398179261492
SIM,1929,23,40-44,1952,9
STAT,1860,16,20-24,1876,33.73293437232414
STAT,1811,58,na,1869,2303.736084455042
STAT,1817,42,50-100,1859,5.734095573817358
STAT,1880,16,40-44,1896,0.3900953447176079
SIM,1854,24,25-29,1878,126
STAT,1825,32,40-44,1857,15.391113512811144
STAT,1884,38,20-24,1922,1.5296562591645766
SIM,1863,22,25-29,1885,124
SIM,1887,45,na,1932,5551
STAT,1884,24,45-49,1908,1.3819421243451784
SIM,1826,39,35-39,1865,20
STAT,1830,51,40-44,1881,0.016302176597355212
STAT,1859,41,na,1900,3732.1037398992967
SIM,1883,26,45-49,1909,2
SIM,1934,8,na,1942,10810
STAT,1829,39,45-49,1868,3.3592546838416752
STAT,1881,23,30-34,1904,34.66358191418668
SIM,1921,34,na,1955,8405
SIM,1907,35,20-24,1942,1
SIM,1916,47,30-34,1963,1
STAT,1907,18,30-34,1925,4.718786399519731
SIM,1915,18,30-34,1933,5
STAT,1846,31,15-19,1877,0.26046245200426743
STAT,1873,38,45-49,1911,4.070456495287595
STAT,1815,45,45-49,1860,1.308858516597183
STAT,1843,19,25-29,1862,10.025138573506878
SIM,1880,25,30-34,1905,74
SIM,1891,30,50-100,1921,5
SIM,1832,40,na,1872,3405
SIM,1881,24,35-39,1905,13
SIM,1927,21,30-34,1948,94
STAT,1858,37,15-19,1895,0.0884107710218457
STAT,1867,60,na,1927,3607.286548420559
SIM,1918,23,30-34,1941,73
STAT,1859,0,na,1859,6278.88939492524
SIM,1884,18,25-29,1902,13
SIM,1822,32,30-34,1854,36
SIM,1922,25,45-49,1947,5
STAT,1882,36,45-49,1918,3.940855818452545
SIM,1815,39,25-29,1854,6
STAT,1926,44,na,1970,9214.505077731821
SIM,1885,9,na,1894,5418
SIM,1915,27,na,1942,7769
SIM,1918,49,40-44,1967,1
STAT,1869,48,30-34,1917,0.18705153071432506
SIM,1901,21,45-49,1922,3
STAT,1818,39,35-39,1857,39.90914385018257
STAT,1892,23,40-44,1915,5.252205719415674
SIM,1881,38,45-49,1919,5
STAT,1799,61,na,1860,1927.479835235903
SIM,1868,85,na,1953,409
STAT,1867,28,25-29,1895,79.72831298345271
STAT,1846,23,na,1869,4011.8714888209297
SIM,1849,19,na,1868,4633
STAT,1951,11,na,1962,9447.775798594846
SIM,1848,20,35-39,1868,13
STAT,1917,26,25-29,1943,139.87457058394546
STAT,1835,24,15-19,1859,5.600889330155302
STAT,1885,37,25-29,1922,5.788039088853405
STAT,1889,20,30-34,1909,44.62139017034742
STAT,1940,18,15-19,1958,93.03980422520017
STAT,1817,47,20-24,1864,0.0579556267242454
STAT,1869,34,20-24,1903,5.2444340292893115
STAT,1814,46,40-44,1860,0.900842769063124
SIM,1828,34,25-29,1862,21
STAT,1879,30,15-19,1909,0.30325108984038246
SIM,1807,73,na,1880,878
STAT,1854,42,na,1896,3538.739016018983
SIM,1845,38,40-44,1883,15
SIM,1877,48,30-34,1925,1
SIM,1897,31,50-100,1928,5
SIM,1860,35,20-24,1895,2
SIM,1796,83,na,1879,267
STAT,1925,31,50-100,1956,1.983635283285954
STAT,1849,37,20-24,1886,1.2476944131179046
SIM,1891,71,na,1962,4010
SIM,1901,17,25-29,1918,13
SIM,1929,30,30-34,1959,55
STAT,1914,25,45-49,1939,3.5418504113781375
SIM,1925,33,15-19,1958,1
SIM,1862,23,20-24,1885,127
SIM,1819,36,40-44,1855,11
SIM,1874,33,40-44,1907,10
STAT,1881,37,40-44,1918,8.545241274816137
STAT,1927,16,40-44,1943,3.5204786686304104
STAT,1843,30,35-39,1873,17.412386432283984
STAT,1899,38,15-19,1937,0.03337266436757609
STAT,1877,18,40-44,1895,0.38257167839025125
SIM,1912,21,20-24,1933,217
STAT,1841,17,15-19,1858,11.105434663758336
SIM,1927,21,15-19,1948,14
SIM,1833,42,50-100,1875,4
SIM,1836,43,na,1879,3107
SIM,1833,28,20-24,1861,21
STAT,1869,23,30-34,1892,34.7498512065335
SIM,1877,4,na,1881,5639
SIM,1925,26,25-29,1951,182
SIM,1869,35,40-44,1904,11
SIM,1893,37,25-29,1930,10
STAT,1940,22,35-39,1962,19.373449975765933
STAT,1852,30,na,1882,4020.5259796054665
STAT,1841,35,45-49,1876,3.479338793984489
SIM,1843,24,15-19,1867,6
SIM,1831,25,35-39,1856,19
SIM,1851,23,45-49,1874,1
SIM,1886,27,40-44,1913,8
STAT,1930,26,40-44,1956,11.974982726820729
SIM,1915,21,50-100,1936,3
SIM,1950,14,na,1964,9173
STAT,1821,49,35-39,1870,0.3980969444961289
STAT,1917,33,15-19,1950,0.2705994506821861
SIM,1910,31,50-100,1941,4
SIM,1913,20,25-29,1933,215
STAT,1818,46,25-29,1864,0.25787849089165404
SIM,1939,31,35-39,1970,25
SIM,1896,18,na,1914,6999
STAT,1887,25,25-29,1912,96.19838306078509
STAT,1925,32,45-49,1957,3.7731162076293114
STAT,1939,29,30-34,1968,79.48372587055925
SIM,1863,29,45-49,1892,1
STAT,1848,42,50-100,1890,1.730139101593025
SIM,1895,25,25-29,1920,140
STAT,1855,29,45-49,1884,1.720170991832473
SIM,1798,64,na,1862,1628
SIM,1861,20,na,1881,4650
SIM,1836,53,na,1889,2674
SIM,1878,44,30-34,1922,5
STAT,1843,23,45-49,1866,1.217306070042628
STAT,1878,27,40-44,1905,6.318544975141712
STAT,1892,19,20-24,1911,44.58259682624839
SIM,1857,37,20-24,1894,3
SIM,1940,14,na,1954,8287
STAT,1856,23,na,1879,3841.684505260771
STAT,1929,39,15-19,1968,0.04968057513859925
STAT,1852,35,20-24,1887,1.2611745063276212
SIM,1859,45,25-29,1904,1
STAT,1913,29,45-49,1942,3.4526040564567113
SIM,1933,32,45-49,1965,9
SIM,1914,39,50-100,1953,1
STAT,1911,27,35-39,1938,29.578773760857867
SIM,1815,61,na,1876,1936
STAT,1912,9,na,1921,8105.431843650472
SIM,1885,23,na,1908,4897
SIM,1843,17,25-29,1860,10
SIM,1910,15,25-29,1925,25
STAT,1888,35,35-39,1923,17.04386906478308
SIM,1869,32,20-24,1901,8
STAT,1937,29,na,1966,7369.253173607207
STAT,1925,39,30-34,1964,4.407587255295471
STAT,1801,58,na,1859,2179.1643574846366
SIM,1928,31,25-29,1959,30
SIM,1818,44,25-29,1862,2
SIM,1842,41,50-100,1883,5
STAT,1835,108,na,1943,0.002372341902377897
SIM,1821,36,30-34,1857,15
SIM,1848,42,50-100,1890,7
SIM,1857,90,na,1947,133
SIM,1831,35,50-100,1866,6
STAT,1857,27,20-24,1884,19.02193073896914
SIM,1921,29,45-49,1950,6
STAT,1904,4,na,1908,7625.679039601925
STAT,1925,25,20-24,1950,43.829443378142834
STAT,1929,43,35-39,1972,0.5257852621780923
SIM,1870,25,20-24,1895,23
STAT,1843,26,15-19,1869,0.7878199199750721
SIM,1903,38,40-44,1941,7
SIM,1914,19,25-29,1933,19
STAT,1840,36,40-44,1876,7.551440186272741
STAT,1940,15,45-49,1955,1.0249742891126636
SIM,1885,35,25-29,1920,5
STAT,1877,35,25-29,1912,6.095476851683101
SIM,1868,48,50-100,1916,2
STAT,1804,76,na,1880,776.1444533989745
STAT,1848,15,45-49,1863,0.13435649800875832
STAT,1862,25,20-24,1887,20.62054791186329
STAT,1931,14,na,1945,10440.666872864686
STAT,1882,29,20-24,1911,22.915458210602527
STAT,1900,38,15-19,1938,0.03378857589103274
SIM,1825,29,25-29,1854,74
STAT,1840,22,30-34,1862,32.69670164276538
STAT,1873,49,50-100,1922,0.4934621607504504
STAT,1868,49,25-29,1917,0.1083690068757103
STAT,1888,49,45-49,1937,0.3111399358243625
STAT,1961,6,na,1967,10255.43915767974
STAT,1897,47,45-49,1944,0.3577107203517786
SIM,1933,25,20-24,1958,46
STAT,1846,24,40-44,1870,3.881876818209643
STAT,1921,21,20-24,1942,254.35334565159073
SIM,1822,40,na,1862,3089
SIM,1803,80,na,1883,541
SIM,1848,43,40-44,1891,10
STAT,1878,46,30-34,1924,0.20476001192155213
SIM,1896,35,35-39,1931,32
SIM,1855,45,40-44,1900,1
STAT,1852,17,25-29,1869,10.92348649963969
STAT,1904,21,20-24,1925,200.362473941942
SIM,1877,47,50-100,1924,2
SIM,1896,49,50-100,1945,1
STAT,1893,29,30-34,1922,64.0018661907783
SIM,1875,31,35-39,1906,33
STAT,1872,17,45-49,1889,0.1330238651532328
STAT,1934,37,30-34,1971,5.080274410538305
SIM,1878,85,na,1963,934
STAT,1905,27,45-49,1932,3.2429518884342
SIM,1913,27,45-49,1940,4
SIM,1851,30,35-39,1881,30
SIM,1905,27,na,1932,7135
STAT,1867,46,20-24,1913,0.022761537321290045
STAT,1934,32,na,1966,10430.403973282533
SIM,1851,19,25-29,1870,15
SIM,1865,27,20-24,1892,24
STAT,1826,38,30-34,1864,12.206757566148326
STAT,1941,11,na,1952,8207.582145986302
SIM,1837,43,30-34,1880,3
SIM,1909,26,40-44,1935,12
STAT,1833,38,50-100,1871,2.0007722034116693
STAT,1906,26,15-19,1932,1.339803388190381
STAT,1951,18,25-29,1969,104.17856188224539
SIM,1932,29,na,1961,9945
SIM,1860,17,25-29,1877,9
STAT,1836,35,20-24,1871,1.2847097302463013
STAT,1909,31,15-19,1940,0.24880876387628773
SIM,1908,48,35-39,1956,1
SIM,1834,38,30-34,1872,14
SIM,1849,71,na,1920,2036
SIM,1859,37,50-100,1896,4
SIM,1866,34,45-49,1900,6
STAT,1895,24,50-100,1919,1.066435569235912
SIM,1893,52,na,1945,5639
STAT,1857,39,20-24,1896,1.2012549393006342
SIM,1829,44,35-39,1873,4
STAT,1859,47,25-29,1906,0.09215971049218658
SIM,1854,24,40-44,1878,3
SIM,1880,17,45-49,1897,1
STAT,1797,89,na,1886,76.16361653313574
STAT,1893,21,35-39,1914,14.983216822299452
STAT,1931,17,45-49,1948,1.3205758040546693
SIM,1892,24,45-49,1916,3
STAT,1832,23,35-39,1855,11.471966940794596
SIM,1830,34,30-34,1864,37
SIM,1822,36,50-100,1858,3
SIM,1848,39,20-24,1887,5
STAT,1919,15,50-100,1934,0.16850490002654567
SIM,1820,37,25-29,1857,8
STAT,1932,16,50-100,1948,1.004470176891006
SIM,1840,37,45-49,1877,13
SIM,1919,22,35-39,1941,23
SIM,1954,17,50-100,1971,1
STAT,1808,90,na,1898,61.952990420590986
STAT,1856,28,15-19,1884,0.7273287157154433
SIM,1858,85,na,1943,435
SIM,1881,20,na,1901,4085
STAT,1831,24,30-34,1855,34.96546222499396
SIM,1935,15,50-100,1950,1
STAT,1918,25,na,1943,8104.909761613122
STAT,1821,58,na,1879,2367.2712042748913
STAT,1867,21,40-44,1888,3.9862251649017133
SIM,1830,27,40-44,1857,5
STAT,1846,24,25-29,1870,106.64145801625747
STAT,1896,48,40-44,1944,0.2542643070197906
SIM,1899,29,25-29,1928,128
STAT,1866,52,50-100,1918,0.027993844243915992
SIM,1889,44,40-44,1933,13
STAT,1829,43,30-34,1872,1.8632343312384692
STAT,1859,82,na,1941,750.0262106877285
STAT,1887,15,na,1902,5731.326052191835
SIM,1851,26,15-19,1877,1
SIM,1840,19,15-19,1859,11
STAT,1902,22,15-19,1924,9.406659514373763
STAT,1880,89,na,1969,637.9330026637738
SIM,1845,15,35-39,1860,1
SIM,1857,38,na,1895,4110
SIM,1885,33,na,1918,4978
SIM,1922,18,20-24,1940,309
STAT,1832,37,45-49,1869,3.2838614737760183
SIM,1825,33,45-49,1858,4
SIM,1859,20,45-49,1879,4
SIM,1890,29,20-24,1919,31
SIM,1864,28,15-19,1892,1
STAT,1896,34,30-34,1930,46.15649866959461
SIM,1834,30,35-39,1864,28
STAT,1840,38,na,1878,3618.7968784314544
STAT,1902,15,25-29,1917,16.232875946118373
STAT,1830,83,na,1913,548.192643945033
SIM,1849,38,25-29,1887,9
STAT,1921,28,40-44,1949,10.451945308122287
SIM,1885,28,35-39,1913,21
STAT,1822,34,30-34,1856,83.14806963609497
SIM,1840,23,35-39,1863,14
SIM,1943,21,15-19,1964,11
STAT,1902,29,35-39,1931,27.315798594171646
SIM,1854,72,na,1926,1948
SIM,1872,15,na,1887,5487
SIM,1910,29,35-39,1939,41
SIM,1930,27,45-49,1957,7
STAT,1927,23,15-19,1950,13.202628089647408
SIM,1908,45,na,1953,6789
SIM,1825,40,35-39,1865,4
SIM,1884,36,20-24,1920,3
STAT,1851,22,40-44,1873,3.8575894435711313
STAT,1837,36,50-100,1873,2.105635566570798
STAT,1857,49,15-19,1906,6.165310420206761E-4
STAT,1914,18,20-24,1932,56.501054105769406
SIM,1859,28,40-44,1887,10
STAT,1898,28,20-24,1926,31.950223543376662
SIM,1818,37,35-39,1855,20
STAT,1863,24,25-29,1887,101.74451393887537
SIM,1938,17,20-24,1955,239
STAT,1872,21,15-19,1893,6.716379012988359
SIM,1871,24,25-29,1895,133
STAT,1884,31,35-39,1915,20.27864278019131
SIM,1892,31,35-39,1923,43
STAT,1889,16,45-49,1905,0.16306776387508795
SIM,1830,48,40-44,1878,1
STAT,1771,98,na,1869,0.8522234496099372
STAT,1918,15,na,1933,8556.196733712344
SIM,1862,60,na,1922,3495
STAT,1822,48,40-44,1870,0.5246511873821655
STAT,1867,39,30-34,1906,9.979038827845663
STAT,1916,49,30-34,1965,0.18358024059491124
STAT,1931,24,35-39,1955,24.510565231421815
STAT,1817,40,35-39,1857,10.588885164793842
STAT,1876,36,20-24,1912,1.6179451579270332
SIM,1868,25,30-34,1893,53
STAT,1922,27,45-49,1949,3.947080067951837
SIM,1924,20,35-39,1944,32
SIM,1913,31,30-34,1944,35
STAT,1898,21,na,1919,6483.400365563657
STAT,1925,35,15-19,1960,0.04661979430596025
SIM,1771,84,na,1855,170
SIM,1942,22,45-49,1964,2
STAT,1816,48,15-19,1864,0.0019354768580636022
SIM,1814,44,40-44,1858,6
STAT,1826,48,25-29,1874,0.11330862186733946
SIM,1886,16,35-39,1902,2
SIM,1835,22,15-19,1857,5
STAT,1873,35,40-44,1908,9.068192957630286
SIM,1849,49,30-34,1898,1
SIM,1883,23,40-44,1906,5
STAT,1877,28,35-39,1905,20.164101080544548
STAT,1838,22,25-29,1860,100.51786271290425
STAT,1834,76,na,1910,1259.0405934951052
STAT,1884,27,15-19,1911,0.904805577897193
SIM,1859,71,na,1930,2209
SIM,1814,65,na,1879,1821
SIM,1907,38,25-29,1945,2
STAT,1909,11,na,1920,7837.676389888107
SIM,1917,38,35-39,1955,9
SIM,1863,33,30-34,1896,41
STAT,1865,49,50-100,1914,0.44122083620596503
SIM,1833,35,45-49,1868,4
STAT,1827,48,25-29,1875,0.10264522440887798
SIM,1927,24,35-39,1951,27
STAT,1850,38,na,1888,3631.645632639656
STAT,1825,35,45-49,1860,5.641663799846854
STAT,1936,35,25-29,1971,1.9559596517677145
SIM,1846,22,25-29,1868,118
STAT,1863,49,40-44,1912,0.2963451885434306
STAT,1828,90,na,1918,96.8206044210493
STAT,1848,19,50-100,1867,0.09841418693702507
SIM,1836,25,50-100,1861,1
STAT,1830,29,40-44,1859,6.237567457778979
STAT,1866,33,40-44,1899,8.047279815921636
STAT,1877,36,20-24,1913,1.6243728136616367
STAT,1882,0,na,1882,7008.165902433784
SIM,1871,49,40-44,1920,2
STAT,1887,28,45-49,1915,2.4991165930633397
SIM,1881,35,40-44,1916,14
STAT,1935,21,15-19,1956,14.64746927102574
STAT,1892,26,45-49,1918,2.8168083145994176
SIM,1822,35,35-39,1857,18
SIM,1873,49,50-100,1922,1
SIM,1832,35,45-49,1867,6
SIM,1812,49,35-39,1861,2
SIM,1837,38,na,1875,3429
SIM,1828,31,20-24,1859,4
SIM,1838,31,30-34,1869,46
SIM,1879,25,40-44,1904,8
STAT,1855,33,30-34,1888,26.530524819233243
SIM,1907,20,35-39,1927,19
STAT,1813,91,na,1904,51.492478767227006
STAT,1928,44,30-34,1972,0.3280129303267228
SIM,1838,24,na,1862,3814
STAT,1916,20,50-100,1936,1.4008064557933848
STAT,1938,30,30-34,1968,32.03594590629909
STAT,1894,39,25-29,1933,7.394599970594522
SIM,1924,20,50-100,1944,1
STAT,1847,34,35-39,1881,16.154868854491582
SIM,1855,27,45-49,1882,5
STAT,1883,39,15-19,1922,0.11030454860104139
STAT,1893,39,25-29,1932,7.296213922283228
SIM,1844,34,25-29,1878,23
SIM,1931,17,50-100,1948,3
SIM,1938,24,45-49,1962,3
STAT,1843,16,20-24,1859,31.924743489212148
STAT,1913,22,25-29,1935,180.81459020213677
SIM,1864,21,30-34,1885,43
STAT,1869,26,35-39,1895,18.947168859022508
STAT,1923,22,35-39,1945,22.119489220721402
SIM,1854,21,20-24,1875,138
STAT,1814,76,na,1890,815.363597926219
STAT,1923,17,50-100,1940,0.8882169612874514
STAT,1841,28,20-24,1869,20.989743779822284
STAT,1837,48,35-39,1885,0.2000215657706089
STAT,1842,16,20-24,1858,34.094815920782615
SIM,1878,25,40-44,1903,10
SIM,1921,22,25-29,1943,225
STAT,1910,17,25-29,1927,17.348291977858036
SIM,1850,16,20-24,1866,1
SIM,1877,37,40-44,1914,14
SIM,1931,22,35-39,1953,33
STAT,1920,17,35-39,1937,9.505819404512618
SIM,1892,27,15-19,1919,2
STAT,1869,37,40-44,1906,8.566508318699137
STAT,1836,34,25-29,1870,16.863886723466244
SIM,1847,28,15-19,1875,1
STAT,1764,105,na,1869,0.03000787097667801
SIM,1844,35,20-24,1879,5
STAT,1897,69,na,1966,4523.276639077797
STAT,1845,47,30-34,1892,0.14846717038367302
STAT,1876,74,na,1950,2318.19266335527
STAT,1938,25,na,1963,7503.229392954405
STAT,1857,49,na,1906,3467.744611338848
STAT,1934,22,45-49,1956,3.0543104800422847
STAT,1945,9,na,1954,8682.289949552209
SIM,1823,80,na,1903,668
STAT,1856,21,30-34,1877,32.46882670614584
STAT,1849,47,15-19,1896,6.297690004871547E-4
STAT,1846,21,20-24,1867,131.1808043628329
STAT,1852,38,25-29,1890,4.566133009642419
SIM,1838,24,40-44,1862,4
SIM,1901,20,50-100,1921,2
STAT,1842,38,15-19,1880,0.09706037276562006
SIM,1849,31,40-44,1880,10
SIM,1916,32,45-49,1948,6
SIM,1925,37,30-34,1962,3
STAT,1886,84,na,1970,1423.7929407867932
STAT,1897,15,40-44,1912,0.49606690469962444
STAT,1951,15,20-24,1966,326.2029773562177
STAT,1765,115,na,1880,3.4567220022641227E-4
SIM,1943,18,40-44,1961,4
SIM,1868,36,50-100,1904,1
STAT,1941,29,20-24,1970,38.100578540962914
STAT,1895,27,40-44,1922,7.883217473248189
SIM,1885,36,20-24,1921,3
SIM,1793,65,na,1858,1609
SIM,1845,48,35-39,1893,1
STAT,1908,32,45-49,1940,3.0017952913086563
STAT,1913,26,40-44,1939,9.414272520454507
STAT,1849,41,na,1890,3672.4571612198242
SIM,1852,44,50-100,1896,5
STAT,1846,27,45-49,1873,2.057379916215772
STAT,1836,27,35-39,1863,16.604138667733043
STAT,1861,75,na,1936,1730.5343927764782
STAT,1906,19,25-29,1925,16.5874310360616
SIM,1860,38,25-29,1898,6
STAT,1909,1,na,1910,8248.304769066997
SIM,1890,34,na,1924,6185
STAT,1852,28,30-34,1880,46.41144061778448
STAT,1923,26,na,1949,8713.379876846986
STAT,1862,28,40-44,1890,5.152744389685535
SIM,1844,27,35-39,1871,5
SIM,1895,22,20-24,1917,180
SIM,1855,34,35-39,1889,28
STAT,1828,36,40-44,1864,8.998036764468948
STAT,1862,24,25-29,1886,99.71089962433135
SIM,1860,28,30-34,1888,56
STAT,1935,18,40-44,1953,3.8523703314458726
SIM,1870,28,40-44,1898,11
SIM,1865,67,na,1932,2865
STAT,1921,33,50-100,1954,1.8499473705815839
STAT,1899,47,na,1946,6197.749340993519
STAT,1905,31,30-34,1936,29.401572162210144
STAT,1907,37,20-24,1944,0.4938789827226182
STAT,1932,16,15-19,1948,121.67484538234865
SIM,1810,62,na,1872,1969
STAT,1917,37,30-34,1954,3.8229101093123723
SIM,1888,29,15-19,1917,1
STAT,1871,85,na,1956,600.6775727237749
STAT,1876,15,20-24,1891,37.20447337165658
SIM,1836,36,40-44,1872,15
STAT,1830,43,50-100,1873,1.8673119327347756
SIM,1874,36,45-49,1910,6
STAT,1887,22,20-24,1909,155.65903635254594
SIM,1863,46,50-100,1909,2
SIM,1846,53,na,1899,3293
STAT,1946,21,25-29,1967,207.64784404252651
STAT,1897,22,30-34,1919,48.086786319680584
STAT,1834,42,na,1876,3368.2550412207015
STAT,1899,28,20-24,1927,32.34828426990906
SIM,1870,24,25-29,1894,124
SIM,1829,37,45-49,1866,7
STAT,1824,35,45-49,1859,6.569582297312036
STAT,1860,19,25-29,1879,10.592954073001021
STAT,1819,75,na,1894,1077.205114008283
STAT,1870,19,35-39,1889,1.0854591196407262
STAT,1870,38,na,1908,4648.325113370329
SIM,1937,29,20-24,1966,38
SIM,1888,20,50-100,1908,2
STAT,1881,26,35-39,1907,18.900130992882342
STAT,1927,29,na,1956,9159.38490734395
SIM,1850,68,na,1918,2399
STAT,1855,46,50-100,1901,0.37140017152817606
STAT,1888,28,45-49,1916,2.641036576227389
SIM,1935,23,30-34,1958,97
SIM,1896,28,45-49,1924,4
STAT,1891,26,45-49,1917,2.781252718729421
SIM,1786,83,na,1869,266
STAT,1881,23,50-100,1904,0.7935802580940556
STAT,1927,23,30-34,1950,71.28440034641899
STAT,1875,48,20-24,1923,0.02463869433970557
STAT,1844,42,na,1886,3822.6551364214115
SIM,1808,58,na,1866,2270
STAT,1866,36,45-49,1902,3.7327016919531935
SIM,1894,37,na,1931,6350
STAT,1844,29,35-39,1873,18.80229395820905
SIM,1881,74,na,1955,1698
STAT,1884,17,20-24,1901,35.355486679333005
SIM,1896,46,40-44,1942,1
STAT,1877,70,na,1947,2942.4685794207785
SIM,1940,16,15-19,1956,94
STAT,1848,89,na,1937,172.25702062249218
SIM,1920,15,35-39,1935,11
SIM,1906,28,30-34,1934,98
STAT,1907,30,na,1937,7201.111488596285
STAT,1855,5,na,1860,4509.940033131091
STAT,1915,39,20-24,1954,0.5324536346717488
SIM,1887,23,25-29,1910,149
SIM,1917,28,40-44,1945,13
SIM,1862,26,40-44,1888,7
SIM,1938,31,35-39,1969,27
SIM,1832,39,na,1871,3430
STAT,1878,55,na,1933,4361.429632716427
STAT,1905,24,40-44,1929,6.048246958236076
SIM,1931,15,45-49,1946,1
STAT,1873,17,45-49,1890,0.13404544615262182
STAT,1935,25,30-34,1960,107.98389875684742
STAT,1858,41,35-39,1899,2.8638783985122735
STAT,1860,37,20-24,1897,1.2642560277348294
STAT,1827,94,na,1921,24.16785248622662
SIM,1841,29,25-29,1870,80
SIM,1801,88,na,1889,74
SIM,1855,2,na,1857,5696
STAT,1854,23,20-24,1877,123.23438767559324
SIM,1831,54,na,1885,2868
STAT,1833,29,25-29,1862,72.43180212291338
STAT,1881,19,45-49,1900,0.12683100284505733
SIM,1941,27,20-24,1968,38
SIM,1884,7,na,1891,5688
STAT,1830,36,30-34,1866,10.129331027899504
STAT,1883,17,20-24,1900,35.17825282544272
SIM,1921,26,40-44,1947,16
STAT,1914,28,15-19,1942,1.4324913370563972
SIM,1908,30,45-49,1938,5
SIM,1848,46,45-49,1894,2
SIM,1913,24,40-44,1937,9
SIM,1891,17,20-24,1908,50
SIM,1902,27,35-39,1929,31
STAT,1798,75,na,1873,801.7760105382445
SIM,1884,15,20-24,1899,37
STAT,1919,17,45-49,1936,1.1146641210253203
STAT,1878,49,35-39,1927,0.2891364132745936
SIM,1855,48,45-49,1903,1
STAT,1887,32,15-19,1919,0.3216694104056256
SIM,1935,16,40-44,1951,6
STAT,1863,45,25-29,1908,0.10284628983604295
STAT,1850,49,50-100,1899,0.36870853746415433
SIM,1869,35,25-29,1904,7
STAT,1888,46,40-44,1934,0.4098258268928976
STAT,1904,12,na,1916,7486.021762067916
SIM,1943,25,30-34,1968,98
STAT,1933,27,20-24,1960,48.95564916442088
STAT,1851,25,45-49,1876,2.0445077002390866
SIM,1897,20,30-34,1917,63
STAT,1931,21,30-34,1952,75.5149307516592
SIM,1839,31,50-100,1870,3
STAT,1879,23,25-29,1902,120.55637056953972
SIM,1877,34,20-24,1911,8
STAT,1837,38,40-44,1875,7.353313291942224
SIM,1859,25,50-100,1884,4
STAT,1838,90,na,1928,106.70023001747282
SIM,1923,39,20-24,1962,4
STAT,1925,28,25-29,1953,156.42325126953088
STAT,1870,26,25-29,1896,84.16425177225999
STAT,1863,56,na,1919,3605.870342277791
SIM,1902,20,na,1922,6962
STAT,1928,25,na,1953,9382.816824556448
SIM,1895,32,15-19,1927,1
STAT,1862,17,35-39,1879,1.084808639381301
STAT,1870,89,na,1959,318.9385193889645
SIM,1781,84,na,1865,156
STAT,1930,29,45-49,1959,4.432128403031557
SIM,1869,38,45-49,1907,7
STAT,1856,39,20-24,1895,1.189075438102044
SIM,1880,34,na,1914,5260
SIM,1892,17,20-24,1909,54
STAT,1799,108,na,1907,0.0012456851936143924
SIM,1883,52,na,1935,4424
STAT,1869,41,na,1910,4543.421770289991
SIM,1847,38,na,1885,3647
SIM,1871,19,na,1890,4888
STAT,1844,44,50-100,1888,1.7031061746800633
SIM,1876,34,20-24,1910,7
STAT,1836,38,40-44,1874,7.071856088254626
SIM,1933,31,50-100,1964,3
SIM,1878,6,na,1884,5891
STAT,1823,91,na,1914,69.53746376204508
SIM,1880,21,15-19,1901,8
STAT,1840,25,35-39,1865,17.617833484731687
STAT,1783,76,na,1859,627.5396495421015
STAT,1876,30,na,1906,5024.736542863042
SIM,1933,28,25-29,1961,218
STAT,1871,26,25-29,1897,85.1697166851974
STAT,1899,35,45-49,1934,5.568642673333195
STAT,1928,40,15-19,1968,0.003964222229941335
STAT,1861,6,na,1867,4820.188734495702
STAT,1866,3,na,1869,5938.495403511644
SIM,1923,15,na,1938,9228
SIM,1844,38,40-44,1882,11
SIM,1911,34,na,1945,7462
STAT,1919,11,na,1930,8854.514717714954
STAT,1902,26,30-34,1928,72.04871989612762
STAT,1865,36,45-49,1901,3.675276384247522
SIM,1840,34,40-44,1874,12
SIM,1868,21,15-19,1889,5
SIM,1863,47,40-44,1910,1
STAT,1847,27,45-49,1874,2.0342763757713644
STAT,1866,105,na,1971,0.7015160716465948
SIM,1905,32,35-39,1937,30
STAT,1820,102,na,1922,0.3282115665369739
SIM,1830,37,35-39,1867,15
SIM,1884,25,15-19,1909,3
STAT,1834,47,20-24,1881,0.01694044609366789
STAT,1862,71,na,1933,2304.134475561714
STAT,1913,33,30-34,1946,31.532259689290164
STAT,1916,44,na,1960,7660.930383969157
STAT,1938,23,40-44,1961,6.719630215695652
STAT,1863,35,30-34,1898,9.511647566110145
STAT,1911,30,50-100,1941,1.639547734572632
SIM,1895,33,na,1928,6571
SIM,1928,7,na,1935,10335
SIM,1948,21,na,1969,8667
SIM,1805,51,na,1856,2376
SIM,1830,44,25-29,1874,3
SIM,1850,5,na,1855,4896
STAT,1858,34,45-49,1892,2.7219996900537615
STAT,1909,35,30-34,1944,3.519088168849933
STAT,1886,15,30-34,1901,3.4138258973099216
STAT,1886,48,30-34,1934,0.2037789689252431
SIM,1834,20,40-44,1854,4
SIM,1921,33,30-34,1954,42
STAT,1839,75,na,1914,1607.4312681293443
SIM,1922,28,15-19,1950,2
SIM,1844,72,na,1916,1764
STAT,1821,44,50-100,1865,3.1751436576266365
STAT,1928,33,25-29,1961,23.322601182055813
SIM,1874,29,20-24,1903,23
STAT,1893,22,na,1915,6054.2360140562705
STAT,1840,83,na,1923,573.0270466490975
SIM,1932,18,30-34,1950,31
SIM,1936,33,25-29,1969,15
SIM,1894,15,30-34,1909,4
SIM,1851,16,20-24,1867,49
SIM,1926,33,na,1959,9547
STAT,1822,37,35-39,1859,28.3301776566665
STAT,1939,8,na,1947,8046.342038865954
STAT,1832,34,40-44,1866,7.212471718973334
STAT,1855,47,40-44,1902,0.25695481785691143
STAT,1828,33,20-24,1861,5.878425568136929
SIM,1861,38,25-29,1899,6
SIM,1852,29,35-39,1881,21
STAT,1912,15,35-39,1927,1.7220887294281537
STAT,1812,95,na,1907,12.602925241049936
STAT,1902,19,40-44,1921,0.5187231295156699
SIM,1859,38,35-39,1897,17
STAT,1876,25,15-19,1901,0.9541506162133347
STAT,1941,27,50-100,1968,2.0796060386431408
SIM,1889,21,35-39,1910,19
SIM,1910,26,30-34,1936,93
SIM,1946,23,40-44,1969,7
SIM,1898,51,na,1949,6053
STAT,1844,36,25-29,1880,5.455706882839662
SIM,1927,17,45-49,1944,2
SIM,1895,28,45-49,1923,4
STAT,1863,28,40-44,1891,5.277218000481224
SIM,1900,6,na,1906,7647
SIM,1900,29,25-29,1929,129
STAT,1867,49,25-29,1916,0.1066713454249385
SIM,1871,28,40-44,1899,6
STAT,1924,18,30-34,1942,29.229668106612174
SIM,1873,36,45-49,1909,6
SIM,1898,30,25-29,1928,36
SIM,1905,25,45-49,1930,5
STAT,1822,44,25-29,1866,2.0476991239530893
SIM,1828,37,45-49,1865,6
STAT,1873,24,35-39,1897,11.899768691714856
STAT,1911,7,na,1918,8054.50974514257
STAT,1946,10,na,1956,8800.922336741338
STAT,1919,24,35-39,1943,20.68873862873345
STAT,1943,16,25-29,1959,92.83226314626526
STAT,1854,26,40-44,1880,5.32845856962556
SIM,1836,33,20-24,1869,5
STAT,1824,76,na,1900,1012.903326764115
STAT,1896,37,35-39,1933,18.8594380251798
SIM,1951,16,25-29,1967,138
STAT,1853,38,25-29,1891,4.532874836795776
STAT,1840,18,45-49,1858,0.12135971729706785
STAT,1871,52,40-44,1923,0.02101143352949625
STAT,1921,24,25-29,1945,209.3366090809126
SIM,1879,32,30-34,1911,51
STAT,1909,28,40-44,1937,8.969621767824167
STAT,1877,39,40-44,1916,9.087920137902763
SIM,1864,102,na,1966,1
STAT,1879,20,20-24,1899,146.44465591660568
STAT,1962,8,na,1970,10167.871070494819
SIM,1858,25,20-24,1883,23
STAT,1829,46,35-39,1875,0.22380926070358728
STAT,1843,29,20-24,1872,19.935128569543
STAT,1881,27,45-49,1908,2.167401935301723
STAT,1820,47,25-29,1867,0.2143392041856979
STAT,1894,16,na,1910,6568.517364954637
SIM,1807,93,na,1900,25
STAT,1883,64,na,1947,3449.378313176391
SIM,1823,56,na,1879,2475
SIM,1870,58,na,1928,3804
SIM,1856,11,na,1867,4858
SIM,1839,50,50-100,1889,1
SIM,1948,20,45-49,1968,1
STAT,1911,49,45-49,1960,0.4132313487514162
SIM,1862,33,35-39,1895,7
SIM,1871,28,35-39,1899,27
SIM,1822,36,45-49,1858,6
SIM,1862,38,40-44,1900,14
STAT,1853,51,20-24,1904,0.001173123348814529
STAT,1863,28,35-39,1891,16.998301673156206
STAT,1871,31,15-19,1902,0.28691086351395667
SIM,1844,39,30-34,1883,14
SIM,1920,34,50-100,1954,3
STAT,1854,22,25-29,1876,103.11114915385505
STAT,1856,30,35-39,1886,16.308763602518024
SIM,1811,47,na,1858,2641
STAT,1963,7,na,1970,10083.16137675077
STAT,1879,59,na,1938,4105.523535031738
STAT,1946,9,na,1955,8801.890544701255
STAT,1824,52,35-39,1876,0.02008072345075786
SIM,1865,20,50-100,1885,3
STAT,1827,50,50-100,1877,0.027392048139509573
STAT,1831,33,40-44,1864,7.2375893023198605
SIM,1817,38,50-100,1855,2
STAT,1950,20,35-39,1970,22.573653809288636
STAT,1844,19,40-44,1863,0.3710593707221366
STAT,1903,18,na,1921,7243.510157670294
SIM,1862,22,25-29,1884,130
SIM,1885,38,35-39,1923,24
STAT,1845,40,30-34,1885,1.850839710055598
STAT,1883,49,15-19,1932,7.771366497747476E-4
STAT,1794,81,na,1875,429.0584720237567
STAT,1862,19,na,1881,4490.418683717247
SIM,1845,59,na,1904,3225
STAT,1858,65,na,1923,2660.7079498939293
STAT,1927,20,na,1947,9139.51609249556
SIM,1824,33,45-49,1857,3
STAT,1884,17,15-19,1901,11.83509936982486
STAT,1849,17,20-24,1866,34.51865550680775
STAT,1852,38,30-34,1890,8.452203702543807
SIM,1851,29,20-24,1880,23
STAT,1875,69,na,1944,3051.5386509857894
STAT,1868,45,30-34,1913,0.18785813242957594
SIM,1867,36,20-24,1903,2
STAT,1790,91,na,1881,34.389313523206994
SIM,1851,32,50-100,1883,3
SIM,1857,40,45-49,1897,4
STAT,1843,32,20-24,1875,4.552091167923568
STAT,1826,35,25-29,1861,7.3024876000555965
STAT,1862,70,na,1932,2421.9884326967385
SIM,1872,41,25-29,1913,2
SIM,1830,24,30-34,1854,41
STAT,1923,48,25-29,1971,0.12493672712035901
STAT,1796,96,na,1892,3.825496648120894
STAT,1840,20,30-34,1860,33.17133190718151
SIM,1816,39,25-29,1855,5
STAT,1812,103,na,1915,0.13603879957731727
SIM,1841,30,40-44,1871,13
STAT,1845,48,40-44,1893,0.2604934291444035
STAT,1877,38,35-39,1915,14.759463427965935
STAT,1850,42,35-39,1892,2.773047735592265
STAT,1803,83,na,1886,289.8395101290261
STAT,1874,26,45-49,1900,2.303891580626048
SIM,1864,30,35-39,1894,25
SIM,1909,16,25-29,1925,21
STAT,1879,48,40-44,1927,0.35711186029058034
SIM,1833,36,20-24,1869,1
STAT,1828,67,na,1895,1946.7357274197275
STAT,1864,18,na,1882,4688.9210011760415
STAT,1960,6,na,1966,10338.585651483652
STAT,1894,35,30-34,1929,13.958356690699459
SIM,1840,36,na,1876,3977
SIM,1860,38,30-34,1898,10
STAT,1816,44,50-100,1860,5.3871739122218125
SIM,1891,24,45-49,1915,4
STAT,1883,24,45-49,1907,1.3750145735870045
STAT,1944,23,15-19,1967,11.603191133444039
SIM,1870,34,na,1904,4613
STAT,1833,30,40-44,1863,7.511278435597878
STAT,1885,46,15-19,1931,8.064008352101531E-4
SIM,1874,48,na,1922,4273
STAT,1893,26,25-29,1919,108.65808942708203
SIM,1882,26,45-49,1908,2
STAT,1859,39,25-29,1898,4.581696761092462
SIM,1828,44,50-100,1872,4
SIM,1869,61,na,1930,3563
STAT,1938,25,40-44,1963,9.335684468930285
SIM,1857,17,20-24,1874,40
SIM,1859,48,35-39,1907,1
STAT,1827,44,30-34,1871,2.1063608900286694
STAT,1922,49,20-24,1971,0.025483191205157338
STAT,1837,95,na,1932,18.530729965816406
STAT,1849,40,45-49,1889,2.4087581540309575
STAT,1872,34,40-44,1906,8.727046443243998
SIM,1865,87,na,1952,249
SIM,1891,43,50-100,1934,2
STAT,1811,54,20-24,1865,0.004590310361623505
STAT,1923,46,na,1969,8698.49963726871
SIM,1834,35,25-29,1869,7
STAT,1845,24,25-29,1869,107.94235677899184
SIM,1876,45,30-34,1921,1
STAT,1828,32,25-29,1860,22.960175538033177
STAT,1867,26,50-100,1893,1.2140820803297094
SIM,1881,30,40-44,1911,11
SIM,1853,40,30-34,1893,4
STAT,1891,32,50-100,1923,2.287298993357395
STAT,1843,16,15-19,1859,10.686672622494443
SIM,1899,34,15-19,1933,2
SIM,1836,43,35-39,1879,10
STAT,1864,52,35-39,1916,0.015459278138997284
SIM,1835,44,30-34,1879,2
STAT,1880,53,30-34,1933,0.01246114180031649
STAT,1889,6,na,1895,6505.37797036789
STAT,1911,45,na,1956,7059.3198993350925
STAT,1813,51,20-24,1864,0.0044272415712064694
SIM,1840,28,na,1868,4166
SIM,1851,32,20-24,1883,5
STAT,1895,34,35-39,1929,26.422523665121894
STAT,1841,19,15-19,1860,10.974997914269165
SIM,1874,37,20-24,1911,3
STAT,1846,47,45-49,1893,0.35979810065110257
SIM,1832,92,na,1924,45
STAT,1886,49,40-44,1935,0.3573678844739762
SIM,1858,49,30-34,1907,1
STAT,1845,39,na,1884,3736.0385507616984
STAT,1895,23,25-29,1918,150.18379403625883
STAT,1812,44,na,1856,2958.5952577823296
SIM,1855,43,45-49,1898,8
SIM,1922,20,25-29,1942,244
STAT,1864,41,25-29,1905,1.1645377106784054
STAT,1877,16,50-100,1893,0.10299606068840178
STAT,1817,42,20-24,1859,0.8619882399468164
SIM,1910,48,na,1958,7138
STAT,1817,39,20-24,1856,4.808244931608014
SIM,1872,52,35-39,1924,1
STAT,1792,101,na,1893,0.21380815295481745
STAT,1847,43,45-49,1890,2.2649109751063365
SIM,1880,34,40-44,1914,17
STAT,1866,106,na,1972,0.36430431116679324
SIM,1870,29,30-34,1899,63
SIM,1818,47,35-39,1865,2
STAT,1896,32,30-34,1928,46.55508472017897
STAT,1947,18,45-49,1965,1.1360306002059495
SIM,1853,24,25-29,1877,105
STAT,1854,75,na,1929,1578.1522685681641
STAT,1858,89,na,1947,165.39818971337107
SIM,1881,10,na,1891,4476
SIM,1886,36,30-34,1922,16
STAT,1838,17,45-49,1855,0.11677686308025581
STAT,1874,31,40-44,1905,9.004609040463183
SIM,1840,26,50-100,1866,4
STAT,1828,43,35-39,1871,3.3550473365996547
SIM,1841,25,45-49,1866,2
STAT,1845,90,na,1935,121.48824278761789
STAT,1880,40,25-29,1920,1.3800217900791931
STAT,1840,15,50-100,1855,0.09264724127526791
SIM,1838,40,35-39,1878,3
STAT,1767,111,na,1878,0.0020414462464214893
SIM,1869,39,35-39,1908,18
SIM,1844,18,na,1862,4078
STAT,1866,37,20-24,1903,1.4364612696864443
SIM,1886,41,na,1927,4822
SIM,1863,37,45-49,1900,2
STAT,1865,53,35-39,1918,0.015542376847150043
SIM,1887,35,35-39,1922,21
STAT,1837,18,40-44,1855,0.3957627794182914
SIM,1836,32,25-29,1868,23
STAT,1823,36,40-44,1859,17.607605902799765
STAT,1879,35,35-39,1914,15.083284869939497
STAT,1889,37,15-19,1926,0.1398379345809586
SIM,1870,44,25-29,1914,3
STAT,1949,15,45-49,1964,1.1739061949615035
STAT,1862,29,30-34,1891,43.15834529263977
STAT,1848,44,45-49,1892,2.420926649480329
STAT,1882,50,30-34,1932,0.011879318456925324
STAT,1862,44,25-29,1906,1.0935297034112137
SIM,1853,54,na,1907,3410
SIM,1860,42,45-49,1902,7
STAT,1807,73,na,1880,1160.6747381084976
STAT,1821,80,na,1901,685.6806607827488
SIM,1841,77,na,1918,1061
STAT,1829,41,30-34,1870,1.9218633790887953
SIM,1813,43,40-44,1856,5
SIM,1791,85,na,1876,126
SIM,1892,20,45-49,1912,3
STAT,1911,13,na,1924,7971.502609992233
STAT,1897,31,35-39,1928,27.451178274026994
SIM,1828,87,na,1915,230
SIM,1837,41,30-34,1878,5
STAT,1812,50,20-24,1862,0.005092304111254815
SIM,1851,16,15-19,1867,17
SIM,1849,41,na,1890,3780
STAT,1938,8,na,1946,7947.162092050559
STAT,1834,29,25-29,1863,72.78026712593785
STAT,1914,26,50-100,1940,2.0338139568895737
SIM,1843,22,15-19,1865,3
SIM,1932,30,35-39,1962,34
SIM,1774,81,na,1855,357
STAT,1900,38,50-100,1938,0.7387410431562805
STAT,1890,27,40-44,1917,7.384532124799964
STAT,1867,36,25-29,1903,5.47199522384651
STAT,1911,44,50-100,1955,0.22373925563338903
STAT,1894,19,25-29,1913,14.622899798902962
STAT,1925,32,50-100,1957,1.982484774821648
SIM,1870,66,na,1936,3210
STAT,1853,43,50-100,1896,1.6594450297769234
SIM,1906,20,40-44,1926,3
STAT,1914,20,25-29,1934,184.0131594938392
SIM,1915,30,35-39,1945,29
SIM,1868,35,25-29,1903,7
STAT,1883,32,na,1915,4735.093481108393
SIM,1856,41,40-44,1897,10
STAT,1884,20,45-49,1904,1.3989452182807693
STAT,1939,24,45-49,1963,2.2808603536883894
STAT,1800,54,45-49,1854,0.0871727271291892
STAT,1899,28,15-19,1927,1.2510386282041255
STAT,1850,93,na,1943,44.81041251936352
STAT,1886,41,30-34,1927,2.462116959847504
STAT,1887,46,na,1933,5096.352384056725
SIM,1837,47,45-49,1884,2
STAT,1879,18,45-49,1897,0.1376307568605882
STAT,1828,59,na,1887,2466.7106254804853
STAT,1870,23,20-24,1893,136.21934835935872
STAT,1866,45,50-100,1911,0.4622333984769728
SIM,1831,40,25-29,1871,1
STAT,1844,28,25-29,1872,83.02639675660262
STAT,1861,40,15-19,1901,0.023448681562507737
SIM,1852,28,25-29,1880,5
SIM,1877,41,30-34,1918,2
SIM,1919,18,35-39,1937,10
SIM,1920,45,45-49,1965,1
STAT,1767,103,na,1870,0.08582754931380034
STAT,1894,48,na,1942,5764.709498901472
STAT,1870,41,50-100,1911,2.104239891285213
STAT,1880,42,20-24,1922,0.3374703275297932
STAT,1830,37,40-44,1867,8.203893309926842
STAT,1838,34,35-39,1872,16.681104227513792
STAT,1890,34,na,1924,5832.264128637295
SIM,1804,77,na,1881,642
STAT,1840,40,25-29,1880,1.0901136634196267
STAT,1869,41,30-34,1910,2.2600111707608437
SIM,1936,9,na,1945,6898
STAT,1835,22,15-19,1857,5.682192686462655
SIM,1900,46,30-34,1946,1
STAT,1833,25,45-49,1858,1.9610897266624372
SIM,1945,18,50-100,1963,1
STAT,1824,45,na,1869,2846.044635662554
STAT,1878,36,30-34,1914,11.295788875721435
STAT,1865,50,30-34,1915,0.01107875562999847
STAT,1904,48,15-19,1952,6.458335087922607E-4
STAT,1830,30,15-19,1860,0.2916004082735542
STAT,1843,52,45-49,1895,0.02022102371698393
STAT,1819,50,30-34,1869,0.02495957178335691
SIM,1875,36,25-29,1911,7
STAT,1903,26,na,1929,6886.147100608142
SIM,1933,8,na,1941,11285
SIM,1894,30,20-24,1924,8
STAT,1835,35,20-24,1870,1.260748095124826
SIM,1890,78,na,1968,2772
SIM,1872,24,35-39,1896,11
SIM,1897,37,45-49,1934,12
STAT,1900,53,na,1953,5935.673935809075
STAT,1946,23,50-100,1969,1.4782080122141046
SIM,1888,31,35-39,1919,37
STAT,1812,111,na,1923,1.0174113600119806E-4
SIM,1907,60,na,1967,6141
STAT,1928,18,35-39,1946,10.64868048575559
STAT,1835,37,na,1872,3429.253306239138
STAT,1823,40,25-29,1863,2.2482107737775516
STAT,1879,51,40-44,1930,0.022345825788847286
STAT,1895,36,30-34,1931,14.092985108048971
STAT,1930,38,15-19,1968,0.05053618811862817
STAT,1815,60,na,1875,2231.5804690410177
SIM,1950,6,na,1956,9190
SIM,1826,29,40-44,1855,7
STAT,1869,29,40-44,1898,5.820239633570518
SIM,1815,69,na,1884,1517
STAT,1887,48,45-49,1935,0.5263769642421385
STAT,1850,25,45-49,1875,2.0324590518151795
STAT,1890,42,35-39,1932,4.458442496236641
STAT,1841,57,na,1898,2915.8336553482877
STAT,1830,30,50-100,1860,1.876145927270234
STAT,1864,24,35-39,1888,10.551095329653679
SIM,1938,20,50-100,1958,3
STAT,1861,48,25-29,1909,0.09560945958791672
STAT,1886,30,20-24,1916,5.809087931836583
SIM,1882,59,na,1941,3999
STAT,1890,31,25-29,1921,25.352802744401526
STAT,1840,26,45-49,1866,2.0127298783826046
STAT,1823,51,35-39,1874,0.026119502212902237
SIM,1867,39,50-100,1906,5
SIM,1795,75,na,1870,893
SIM,1936,18,35-39,1954,6
SIM,1873,23,na,1896,4970
STAT,1851,29,25-29,1880,75.68053854333334
STAT,1828,45,30-34,1873,0.17900526255467705
SIM,1824,97,na,1921,6
STAT,1870,30,15-19,1900,0.2846395451414437
STAT,1928,23,30-34,1951,72.23904930322516
STAT,1844,44,30-34,1888,1.8533802529835977
STAT,1869,49,40-44,1918,0.32803291807566304
STAT,1860,28,na,1888,3927.629770168293
SIM,1787,88,na,1875,84
SIM,1861,41,na,1902,4447
SIM,1862,35,30-34,1897,16
SIM,1837,24,40-44,1861,7
SIM,1894,25,25-29,1919,12
STAT,1885,26,20-24,1911,23.664624743541992
SIM,1878,48,45-49,1926,1
SIM,1946,25,40-44,1971,11
SIM,1846,34,35-39,1880,24
SIM,1879,41,35-39,1920,8
SIM,1866,27,15-19,1893,1
SIM,1880,37,50-100,1917,4
STAT,1937,30,na,1967,7567.039628204165
SIM,1802,62,na,1864,1970
SIM,1878,42,30-34,1920,5
SIM,1861,18,25-29,1879,13
STAT,1838,47,40-44,1885,0.2383750655261868
STAT,1880,20,30-34,1900,38.12304759906281
STAT,1896,15,40-44,1911,0.48996380781926213
STAT,1868,17,30-34,1885,3.1181142685688075
STAT,1948,22,na,1970,8467.609773197706
SIM,1876,17,30-34,1893,4
SIM,1893,26,20-24,1919,34
STAT,1848,36,15-19,1884,0.09587761819292064
SIM,1941,20,35-39,1961,22
STAT,1825,39,25-29,1864,7.021999931965193
SIM,1936,23,30-34,1959,63
STAT,1862,9,na,1871,4816.655270727823
STAT,1918,33,15-19,1951,0.2745756509904029
SIM,1947,24,45-49,1971,4
STAT,1854,35,30-34,1889,8.295187734092519
SIM,1877,25,25-29,1902,95
STAT,1848,87,na,1935,288.8849071899026
STAT,1907,30,35-39,1937,17.399659059195855
SIM,1791,93,na,1884,5
SIM,1845,35,30-34,1880,12
STAT,1889,37,45-49,1926,4.964246087253765
SIM,1869,18,na,1887,5066
SIM,1828,79,na,1907,818
STAT,1839,51,40-44,1890,0.0165168207435871
STAT,1837,63,na,1900,2486.883894775879
STAT,1891,43,35-39,1934,4.487828137723292
STAT,1924,30,35-39,1954,21.62362145334208
SIM,1821,37,40-44,1858,6
STAT,1858,27,15-19,1885,0.7312437120100778
STAT,1870,14,na,1884,5203.603913856164
SIM,1842,29,25-29,1871,92
SIM,1877,30,20-24,1907,7
SIM,1935,28,50-100,1963,8
STAT,1870,18,25-29,1888,11.27636782882528
STAT,1886,25,25-29,1911,90.79603905431959
STAT,1844,45,15-19,1889,6.561518950433621E-4
STAT,1840,51,35-39,1891,0.012486120260354625
STAT,1854,33,35-39,1887,15.733964244854826
STAT,1817,75,na,1892,1038.3416383746428
STAT,1899,44,20-24,1943,0.030104922827308943
STAT,1821,40,15-19,1861,0.04648389485343039
STAT,1855,34,35-39,1889,15.229395934343826
STAT,1849,37,15-19,1886,0.09089165742432435
SIM,1847,46,45-49,1893,1
STAT,1837,35,30-34,1872,9.235878775547542
STAT,1913,38,15-19,1951,0.0380935309307699
STAT,1838,50,40-44,1888,0.014744957533817524
SIM,1773,88,na,1861,75
SIM,1897,42,40-44,1939,1
SIM,1861,34,30-34,1895,37
SIM,1846,84,na,1930,427
STAT,1809,45,20-24,1854,0.09644825937053939
STAT,1853,34,30-34,1887,27.863116326025402
STAT,1879,52,25-29,1931,0.0074425883918807535
SIM,1924,32,na,1956,9199
STAT,1870,38,25-29,1908,5.680634227931019
STAT,1877,51,50-100,1928,0.031824397591215324
SIM,1929,25,40-44,1954,17
STAT,1831,36,45-49,1867,3.294998997930308
SIM,1842,70,na,1912,1922
STAT,1851,21,50-100,1872,0.7603693786012534
SIM,1846,50,40-44,1896,1
STAT,1880,28,40-44,1908,6.350846969109224
SIM,1832,84,na,1916,532
STAT,1910,45,35-39,1955,0.24417650503568517
SIM,1827,34,25-29,1861,30
STAT,1881,21,30-34,1902,34.876001142959694
STAT,1786,86,na,1872,126.74456356396749
STAT,1839,46,45-49,1885,0.3802919957361156
STAT,1865,59,na,1924,3565.8898604938377
STAT,1865,104,na,1969,1.125594455482544
STAT,1889,42,40-44,1931,5.5943245729167925
SIM,1898,18,20-24,1916,48
SIM,1863,34,35-39,1897,19
STAT,1852,92,na,1944,66.38126195146366
STAT,1853,54,25-29,1907,0.005450066752383746
SIM,1837,44,35-39,1881,7
STAT,1810,85,na,1895,247.91422889462777
STAT,1850,30,40-44,1880,7.804241533421404
STAT,1868,46,15-19,1914,7.707921356959205E-4
STAT,1832,29,15-19,1861,0.7802439871757044
STAT,1870,51,20-24,1921,0.0014701673637147288
SIM,1836,48,40-44,1884,1
STAT,1822,41,20-24,1863,0.5490083041640498
SIM,1823,35,50-100,1858,3
SIM,1937,31,25-29,1968,4
STAT,1918,16,25-29,1934,19.155775775596
STAT,1832,32,na,1864,3650.177965114117
SIM,1863,56,na,1919,3755
STAT,1859,27,30-34,1886,41.178349910145386
SIM,1872,40,40-44,1912,10
SIM,1830,58,na,1888,2418
STAT,1871,22,25-29,1893,114.86417944698441
STAT,1896,35,35-39,1931,19.038548393368085
STAT,1862,52,50-100,1914,0.025931598879020263
SIM,1822,33,40-44,1855,13
STAT,1850,69,na,1919,2250.139903143436
STAT,1807,52,35-39,1859,0.05607536208886251
STAT,1895,39,40-44,1934,11.404026755386221
STAT,1816,46,20-24,1862,0.05987160471634793
STAT,1895,57,na,1952,5288.606330996334
SIM,1890,20,35-39,1910,22
SIM,1902,49,45-49,1951,1
STAT,1820,44,20-24,1864,0.6070624806241979
SIM,1867,46,na,1913,4572
STAT,1834,26,15-19,1860,0.7976609817030887
STAT,1822,52,30-34,1874,0.017805504971441406
STAT,1872,46,35-39,1918,0.2849704651615628
SIM,1899,48,na,1947,6167
SIM,1914,37,50-100,1951,1
STAT,1887,14,na,1901,5814.467907912413
SIM,1867,27,30-34,1894,65
STAT,1779,84,na,1863,178.40016954582657
STAT,1814,75,na,1889,896.4275404050476
STAT,1861,77,na,1938,1453.0504541799828
STAT,1882,20,35-39,1902,11.54920451042239
SIM,1882,23,40-44,1905,1
SIM,1847,30,35-39,1877,29
STAT,1833,33,45-49,1866,2.927173830840301
SIM,1938,18,45-49,1956,1
STAT,1864,40,40-44,1904,4.10161233761412
SIM,1872,37,40-44,1909,13
SIM,1811,87,na,1898,120
STAT,1832,47,50-100,1879,0.3785569377029276
STAT,1845,41,15-19,1886,0.021949293093843858
STAT,1867,53,45-49,1920,0.027008411572342496
STAT,1883,21,40-44,1904,4.14732985651397
SIM,1883,30,45-49,1913,3
STAT,1911,46,40-44,1957,0.3022849138401361
SIM,1833,34,na,1867,3590
SIM,1897,8,na,1905,7208
STAT,1901,39,35-39,1940,4.27289851860151
SIM,1836,23,na,1859,3606
STAT,1829,44,35-39,1873,2.8898030957350427
STAT,1894,38,35-39,1932,18.258949098273234
STAT,1874,43,35-39,1917,3.717558419689679
STAT,1849,72,na,1921,1997.644952175562
SIM,1825,90,na,1915,58
STAT,1848,41,50-100,1889,1.7524477615981697
STAT,1853,18,25-29,1871,10.721875354971274
SIM,1841,33,45-49,1874,1
STAT,1842,108,na,1950,0.00272709647757774
SIM,1856,41,50-100,1897,4
STAT,1882,53,40-44,1935,0.02037950824878902
STAT,1855,51,25-29,1906,0.005366678247065214
STAT,1839,30,35-39,1869,19.867683364524783
STAT,1871,30,30-34,1901,35.314786892043806
SIM,1852,44,30-34,1896,5
SIM,1930,19,50-100,1949,5
STAT,1871,38,40-44,1909,8.739958849697524
SIM,1880,46,35-39,1926,1
STAT,1936,13,na,1949,7651.008564784974
STAT,1903,22,15-19,1925,9.486549429475907
STAT,1835,29,50-100,1864,1.0648116427767154
STAT,1844,33,20-24,1877,5.166135709651308
STAT,1845,54,50-100,1899,0.022632390869245227
SIM,1911,22,15-19,1933,11
SIM,1969,2,na,1971,9603
SIM,1895,48,45-49,1943,1
STAT,1846,28,35-39,1874,17.750988305948624
STAT,1861,19,40-44,1880,0.3492408328468428
SIM,1854,28,35-39,1882,26
STAT,1933,20,35-39,1953,25.37770775460213
SIM,1812,47,40-44,1859,1
SIM,1808,59,na,1867,2213
SIM,1929,22,30-34,1951,86
STAT,1866,49,15-19,1915,7.298280602540493E-4
STAT,1881,24,40-44,1905,4.042299304290037
SIM,1835,47,35-39,1882,1
SIM,1862,30,30-34,1892,44
SIM,1870,52,50-100,1922,1
SIM,1834,41,50-100,1875,3
SIM,1884,23,15-19,1907,6
SIM,1852,33,20-24,1885,6
STAT,1862,17,50-100,1879,0.09685789628500767
STAT,1878,85,na,1963,990.982688214325
STAT,1875,30,45-49,1905,3.6551658815146255
STAT,1860,16,15-19,1876,11.291956859573014
STAT,1915,51,na,1966,7381.861108832133
STAT,1895,20,20-24,1915,182.4342748374618
SIM,1939,30,45-49,1969,5
SIM,1882,43,35-39,1925,9
SIM,1843,35,20-24,1878,3
SIM,1899,36,50-100,1935,2
STAT,1881,52,35-39,1933,0.016716118498763047
SIM,1906,35,na,1941,7003
STAT,1905,49,20-24,1954,0.019357964704722487
STAT,1824,40,40-44,1864,6.137990542582303
STAT,1840,23,35-39,1863,10.634852283648277
SIM,1891,37,20-24,1928,3
SIM,1893,34,20-24,1927,6
SIM,1857,92,na,1949,71
SIM,1881,33,45-49,1914,6
STAT,1822,43,40-44,1865,7.36826945789151
STAT,1838,51,25-29,1889,0.0048636366069674305
SIM,1876,48,35-39,1924,1
SIM,1896,25,35-39,1921,38
SIM,1830,43,40-44,1873,9
SIM,1927,25,30-34,1952,130
SIM,1836,40,30-34,1876,2
STAT,1900,21,na,1921,6645.9825699798785
STAT,1853,26,na,1879,3993.7546374412295
SIM,1842,62,na,1904,2566
STAT,1938,28,45-49,1966,3.4555939717293147
SIM,1829,34,35-39,1863,19
SIM,1814,42,45-49,1856,6
STAT,1862,41,20-24,1903,0.2753836858210238
STAT,1848,41,40-44,1889,3.7311101982058537
STAT,1861,45,20-24,1906,0.0203732086945245
STAT,1872,18,35-39,1890,1.110819184343184
STAT,1857,16,na,1873,4272.245855333719
STAT,1847,40,35-39,1887,2.8477358720977066
SIM,1795,67,na,1862,1525
SIM,1929,36,50-100,1965,4
STAT,1875,27,20-24,1902,24.393811723193718
SIM,1931,34,na,1965,10010
SIM,1880,18,35-39,1898,2
STAT,1858,57,na,1915,3163.9998696583175
STAT,1818,43,20-24,1861,0.7540707630513941
STAT,1821,88,na,1909,152.1714636182166
STAT,1855,17,45-49,1872,0.11715836417312928
STAT,1845,24,50-100,1869,0.7689298194508369
STAT,1883,37,20-24,1920,1.5295749224368216
STAT,1891,31,40-44,1922,10.870343719941197
STAT,1874,34,45-49,1908,3.5752019588975883
STAT,1823,36,na,1859,3471.7350276391167
STAT,1882,48,50-100,1930,0.47712129082279764
STAT,1885,41,15-19,1926,0.02788746349011343
SIM,1881,31,25-29,1912,26
STAT,1828,48,40-44,1876,0.3043363885998698
STAT,1863,42,20-24,1905,0.2804199968493826
SIM,1818,44,30-34,1862,6
SIM,1811,79,na,1890,565
SIM,1926,16,25-29,1942,126
STAT,1836,50,30-34,1886,0.00833338120595748
STAT,1886,42,15-19,1928,0.02940551595411805
SIM,1918,12,na,1930,8960
SIM,1855,40,35-39,1895,5
SIM,1841,22,40-44,1863,5
SIM,1883,27,20-24,1910,26
STAT,1864,39,50-100,1903,2.1941480242795484
STAT,1923,45,20-24,1968,0.026223893272930857
SIM,1891,21,40-44,1912,10
STAT,1942,4,na,1946,8457.173766957087
STAT,1877,35,30-34,1912,11.283116787393064
SIM,1881,18,na,1899,4362
SIM,1885,35,30-34,1920,15
STAT,1881,41,25-29,1922,1.259214705431331
STAT,1919,25,30-34,1944,86.06554607652001
STAT,1863,53,30-34,1916,0.01035454989468953
STAT,1893,43,45-49,1936,0.26412565463879023
SIM,1868,38,35-39,1906,18
STAT,1818,54,30-34,1872,0.024179473670141696
STAT,1868,3,na,1871,6073.883341182671
SIM,1824,30,40-44,1854,12
SIM,1831,36,40-44,1867,16
SIM,1849,40,50-100,1889,4
STAT,1771,96,na,1867,2.274024848287404
STAT,1828,40,30-34,1868,2.235861265962421
STAT,1861,85,na,1946,460.8222783670046
STAT,1906,37,50-100,1943,0.7798728257741658
STAT,1861,28,30-34,1889,42.332383894835026
STAT,1868,48,35-39,1916,0.2656335286812382
SIM,1827,62,na,1889,2221
STAT,1819,51,15-19,1870,1.0110165499772638E-4
STAT,1826,52,45-49,1878,0.02791127040527051
STAT,1814,50,25-29,1864,0.018306115888454596
SIM,1815,43,45-49,1858,5
STAT,1885,34,20-24,1919,5.387425369466268
STAT,1885,45,30-34,1930,0.19653671577156867
STAT,1873,33,45-49,1906,3.563320068395598
STAT,1890,30,40-44,1920,10.776615636512151
SIM,1832,40,40-44,1872,9
SIM,1778,95,na,1873,5
SIM,1814,40,25-29,1854,2
SIM,1911,33,na,1944,7505
STAT,1827,28,25-29,1855,174.8736304266232
STAT,1895,31,30-34,1926,46.135296345248335
SIM,1871,42,20-24,1913,1
SIM,1812,72,na,1884,1171
STAT,1836,54,na,1890,2784.089966525265
STAT,1859,23,15-19,1882,5.462687437136169
STAT,1859,44,20-24,1903,0.25184429230876143
SIM,1882,34,45-49,1916,5
STAT,1920,23,50-100,1943,1.4724611921320045
STAT,1787,71,na,1858,1129.6874378548227
STAT,1883,56,na,1939,4047.19146998766
STAT,1828,48,35-39,1876,0.24887321555045944
STAT,1886,21,na,1907,5057.370483833543
STAT,1832,40,na,1872,3419.731113902476
STAT,1855,31,30-34,1886,27.087257099499794
SIM,1819,51,na,1870,2635
STAT,1853,37,35-39,1890,11.190786650656381
SIM,1906,23,45-49,1929,2
STAT,1825,48,15-19,1873,8.555599301692691E-4
SIM,1781,83,na,1864,195
STAT,1898,48,20-24,1946,0.018267813252035397
SIM,1817,48,30-34,1865,1
SIM,1835,28,25-29,1863,85
SIM,1842,26,20-24,1868,27
SIM,1825,42,20-24,1867,1
STAT,1824,33,50-100,1857,3.6169061368680193
SIM,1850,4,na,1854,4938
STAT,1886,28,35-39,1914,20.498551498149347
STAT,1900,27,25-29,1927,118.5126978687519
SIM,1852,69,na,1921,2399
SIM,1812,43,25-29,1855,2
SIM,1878,45,50-100,1923,2
STAT,1848,53,35-39,1901,0.013889683781439755
SIM,1907,20,na,1927,7123
SIM,1863,39,50-100,1902,3
STAT,1884,33,20-24,1917,5.3678817753117825
SIM,1892,33,20-24,1925,11
STAT,1764,113,na,1877,7.137504922162523E-4
STAT,1829,52,na,1881,2689.5856128894598
SIM,1938,15,35-39,1953,9
STAT,1819,37,35-39,1856,41.13441104480547
SIM,1827,28,50-100,1855,3
STAT,1881,24,35-39,1905,11.320019663884468
STAT,1855,4,na,1859,4780.517313049704
SIM,1855,26,na,1881,4362
SIM,1852,40,15-19,1892,1
STAT,1813,54,25-29,1867,0.0200074405005531
SIM,1914,22,na,1936,7653
SIM,1953,15,30-34,1968,38
SIM,1878,45,35-39,1923,1
SIM,1897,34,40-44,1931,14
STAT,1844,16,30-34,1860,3.2913332253801033
STAT,1865,41,40-44,1906,4.145670270325794
SIM,1867,23,15-19,1890,2
SIM,1861,37,35-39,1898,21
SIM,1877,44,35-39,1921,8
SIM,1863,31,30-34,1894,45
SIM,1849,46,25-29,1895,1
STAT,1812,53,25-29,1865,0.02301516389953269
STAT,1869,33,25-29,1902,19.959571008306035
STAT,1869,49,na,1918,4310.875205107296
SIM,1788,73,na,1861,872
SIM,1836,48,35-39,1884,2
STAT,1891,46,45-49,1937,0.3332710455476362
SIM,1908,17,20-24,1925,60
SIM,1827,37,35-39,1864,18
STAT,1896,35,40-44,1931,11.783150639689525
SIM,1825,39,20-24,1864,2
STAT,1797,108,na,1905,8.863272061592708E-4
STAT,1861,25,20-24,1886,20.15229098173909
STAT,1900,38,35-39,1938,4.255824216045595
STAT,1810,96,na,1906,7.765367446481302
SIM,1872,0,na,1872,7186
STAT,1832,32,45-49,1864,2.9635736378023756
STAT,1935,17,50-100,1952,1.0345952989633969
SIM,1884,39,30-34,1923,16
STAT,1833,25,15-19,1858,0.8013589911261665
STAT,1820,44,15-19,1864,0.052788044644536534
STAT,1876,39,30-34,1915,11.020694342066548
STAT,1934,30,na,1964,10442.200328591938
STAT,1824,77,na,1901,924.1527372730429
STAT,1880,45,25-29,1925,0.12376995758556887
SIM,1770,91,na,1861,9
STAT,1874,95,na,1969,126.26534215301972
STAT,1837,54,40-44,1891,0.014273007030419872
STAT,1871,34,25-29,1905,20.37598190681385
STAT,1869,44,35-39,1913,3.4958204138892652
STAT,1829,27,45-49,1856,3.217426859067546
STAT,1809,48,30-34,1857,0.7368578076190246
SIM,1837,44,40-44,1881,9
SIM,1840,32,45-49,1872,5
SIM,1845,67,na,1912,2576
SIM,1869,34,35-39,1903,27
STAT,1854,38,35-39,1892,10.788918856533122
SIM,1873,41,40-44,1914,6
SIM,1837,27,45-49,1864,5
SIM,1872,81,na,1953,1008
STAT,1844,40,15-19,1884,0.023433467592506297
STAT,1850,45,45-49,1895,0.36545917047691384
STAT,1904,11,na,1915,7497.192579010642
SIM,1811,43,30-34,1854,4
SIM,1873,20,35-39,1893,14
SIM,1832,49,na,1881,3122
SIM,1877,33,25-29,1910,27
STAT,1832,29,45-49,1861,1.9094169835045978
STAT,1838,37,na,1875,3497.663052066814
STAT,1845,27,35-39,1872,18.09746904710092
STAT,1866,52,45-49,1918,0.026899622363250542
SIM,1840,29,45-49,1869,5
STAT,1831,45,35-39,1876,0.21980642533475872
STAT,1842,36,20-24,1878,1.360333368037058
STAT,1870,34,30-34,1904,34.32320421989964
STAT,1945,15,30-34,1960,26.902891795860988
STAT,1854,30,30-34,1884,27.984690695027425
SIM,1893,3,na,1896,7028
STAT,1827,47,35-39,1874,0.2528381610848552
STAT,1836,39,30-34,1875,8.520992657261665
SIM,1943,17,50-100,1960,1
SIM,1828,38,35-39,1866,7
STAT,1866,44,na,1910,4248.812708064997
SIM,1894,28,35-39,1922,34
STAT,1860,44,15-19,1904,0.022343541925622823
SIM,1853,27,35-39,1880,23
STAT,1874,26,15-19,1900,0.9414379197512122
SIM,1860,56,na,1916,3528
STAT,1864,37,40-44,1901,7.902747377747863
STAT,1849,29,na,1878,3998.2517150548797
STAT,1919,41,na,1960,8138.406399517715
STAT,1889,45,45-49,1934,0.5935540198738675
STAT,1910,42,30-34,1952,0.24410932980460456
SIM,1850,36,20-24,1886,1
SIM,1859,45,30-34,1904,1
SIM,1874,16,na,1890,4927
STAT,1854,38,40-44,1892,6.677371273232177
SIM,1876,29,25-29,1905,77
SIM,1857,54,50-100,1911,1
STAT,1831,47,na,1878,3114.943886818604
SIM,1833,30,50-100,1863,5
STAT,1811,70,na,1881,1525.0949755019788
STAT,1892,39,15-19,1931,0.14054642949618987
STAT,1920,39,45-49,1959,1.5038935491723824
STAT,1854,50,25-29,1904,0.005507890082053315
SIM,1838,89,na,1927,142
SIM,1884,18,na,1902,5478
STAT,1865,20,35-39,1885,10.99447091798869
SIM,1883,84,na,1967,1205
SIM,1895,29,35-39,1924,32
SIM,1834,29,50-100,1863,4
STAT,1858,97,na,1955,8.458156691488812
STAT,1835,38,30-34,1873,8.449345958172211
STAT,1840,23,40-44,1863,3.7976308578837723
SIM,1879,71,na,1950,2567
SIM,1892,69,na,1961,4531
STAT,1843,48,30-34,1891,0.13389534723313803
STAT,1880,23,35-39,1903,12.377046304446855
SIM,1822,33,35-39,1855,26
STAT,1895,39,35-39,1934,18.425981462917612
SIM,1834,75,na,1909,1207
STAT,1852,25,25-29,1877,79.66727491334478
STAT,1768,113,na,1881,8.456551171036494E-4
STAT,1888,44,45-49,1932,3.5243544880925963
SIM,1948,22,40-44,1970,10
STAT,1830,33,25-29,1863,19.95069657300931
STAT,1834,26,20-24,1860,20.62523379009213
STAT,1929,31,25-29,1960,23.722136461246404
STAT,1857,20,50-100,1877,0.7518433157222716
SIM,1843,38,30-34,1881,16
STAT,1887,29,35-39,1916,21.639156438324875
SIM,1866,43,20-24,1909,1
SIM,1860,25,25-29,1885,91
STAT,1826,29,50-100,1855,2.7373632697327337
STAT,1861,45,15-19,1906,6.791063591190578E-4
STAT,1939,21,40-44,1960,6.822792797523125
STAT,1858,43,20-24,1901,0.24823192765761146
STAT,1849,54,50-100,1903,0.02323255717883276
SIM,1947,21,40-44,1968,8
STAT,1875,27,15-19,1902,0.9434070907816896
SIM,1896,44,45-49,1940,2
SIM,1893,16,25-29,1909,19
STAT,1898,27,45-49,1925,3.0345558417343264
SIM,1963,5,na,1968,10475
STAT,1870,35,20-24,1905,1.5429761514018059
SIM,1895,24,35-39,1919,17
STAT,1759,100,na,1859,0.17195930486680333
SIM,1868,43,25-29,1911,2
STAT,1838,37,45-49,1875,3.255545681092477
STAT,1872,69,na,1941,2978.7322597820416
STAT,1921,35,45-49,1956,1.5396107118915845
SIM,1811,44,20-24,1855,1
STAT,1843,67,na,1910,2220.601227432118
STAT,1885,17,30-34,1902,3.2041496567803844
SIM,1916,27,20-24,1943,41
STAT,1864,43,45-49,1907,2.6823808063099546
SIM,1828,33,35-39,1861,7
SIM,1854,44,35-39,1898,6
STAT,1849,53,20-24,1902,0.001148498310530813
STAT,1855,34,40-44,1889,6.521688765270426
STAT,1890,35,40-44,1925,10.893712624040353
STAT,1894,72,na,1966,3897.2822821693458
STAT,1943,15,na,1958,7886.860892075306
STAT,1855,46,35-39,1901,0.21171019613935962
STAT,1876,39,25-29,1915,5.9537084049860765
STAT,1763,114,na,1877,2.7834080605434043E-4
SIM,1796,60,na,1856,2006
STAT,1887,24,35-39,1911,13.098623402072889
SIM,1886,15,25-29,1901,16
STAT,1797,70,na,1867,1319.4727234842508
STAT,1844,48,25-29,1892,0.09185025952341479
STAT,1835,54,30-34,1889,0.007555097045168732
SIM,1923,47,na,1970,9026
STAT,1906,45,20-24,1951,0.02011938988187578
STAT,1809,48,25-29,1857,0.4384608399772335
STAT,1939,21,35-39,1960,19.106489355848435
STAT,1893,35,15-19,1928,0.14511403014608154
STAT,1871,18,40-44,1889,0.36719236275155537
SIM,1863,34,40-44,1897,16
SIM,1889,46,na,1935,5721
SIM,1857,36,na,1893,4192
STAT,1901,36,30-34,1937,3.268097024413293
SIM,1854,25,30-34,1879,61
SIM,1792,70,na,1862,1223
STAT,1824,85,na,1909,293.0869803757805
SIM,1824,44,50-100,1868,5
SIM,1843,22,20-24,1865,152
STAT,1846,25,30-34,1871,47.33914294050406
STAT,1908,27,20-24,1935,35.16959764435951
STAT,1927,28,50-100,1955,2.434884652513919
STAT,1916,21,40-44,1937,7.137147175351582
STAT,1826,44,15-19,1870,0.028010738177188767
STAT,1816,49,25-29,1865,0.2744719779072986
STAT,1859,113,na,1972,2.6956653305435174E-4
SIM,1847,15,na,1862,4468
STAT,1846,44,35-39,1890,2.736201066783203
SIM,1868,35,30-34,1903,14
SIM,1889,28,20-24,1917,29
SIM,1838,54,na,1892,2876
SIM,1861,15,20-24,1876,44
SIM,1921,32,na,1953,8483
SIM,1894,17,na,1911,6831
STAT,1919,33,30-34,1952,34.17740943711073
STAT,1886,45,25-29,1931,0.12402415306742068
SIM,1880,31,30-34,1911,45
SIM,1812,42,35-39,1854,8
SIM,1843,19,20-24,1862,31
STAT,1840,50,50-100,1890,0.02211319199745897
STAT,1842,100,na,1942,1.5805924237502769
STAT,1872,31,30-34,1903,35.58352061528891
STAT,1837,50,25-29,1887,0.005156060756887911
STAT,1869,25,25-29,1894,83.34293856466894
STAT,1823,44,40-44,1867,7.1176421224375
SIM,1831,44,40-44,1875,15
STAT,1926,46,na,1972,9176.177945826244
SIM,1872,43,45-49,1915,10
SIM,1809,52,na,1861,2456
SIM,1938,15,40-44,1953,1
STAT,1853,15,20-24,1868,34.14348020438651
STAT,1885,16,25-29,1901,11.419781017335115
STAT,1835,22,20-24,1857,118.69391234378097
STAT,1862,24,30-34,1886,31.025588247578334
SIM,1868,87,na,1955,255
STAT,1932,35,20-24,1967,0.7166145889129288
STAT,1862,109,na,1971,0.020932913462031084
SIM,1884,23,20-24,1907,135
SIM,1927,28,35-39,1955,55
STAT,1816,100,na,1916,1.042803505552063
STAT,1815,49,na,1864,2750.4238467936566
SIM,1946,22,30-34,1968,80
STAT,1883,43,50-100,1926,2.081146224670586
STAT,1896,18,45-49,1914,0.1737214305438426
SIM,1817,39,40-44,1856,10
SIM,1865,26,45-49,1891,2
SIM,1879,25,35-39,1904,22
SIM,1943,1,na,1944,8900
STAT,1864,45,40-44,1909,0.3121502698946059
SIM,1924,21,40-44,1945,12
SIM,1908,17,15-19,1925,13
STAT,1836,109,na,1945,9.459449278290704E-4
STAT,1835,38,25-29,1873,4.564589170737502
STAT,1815,49,50-100,1864,1.2788405670466991
STAT,1896,20,50-100,1916,1.0938316029965396
STAT,1829,44,40-44,1873,3.5895266299041095
STAT,1871,52,20-24,1923,0.0014727640896763314
SIM,1917,27,na,1944,8133
STAT,1926,23,20-24,1949,271.93763763501477
SIM,1831,42,45-49,1873,7
SIM,1858,77,na,1935,1358
STAT,1919,17,25-29,1936,96.69713201515869
SIM,1927,33,30-34,1960,52
SIM,1921,43,na,1964,8458
STAT,1904,6,na,1910,7572.543851002326
STAT,1890,33,45-49,1923,4.280652715921186
STAT,1774,104,na,1878,0.04782132848134557
STAT,1914,10,na,1924,8277.08774863454
SIM,1843,38,25-29,1881,9
SIM,1894,33,25-29,1927,33
STAT,1875,80,na,1955,1286.2791708908162
SIM,1824,49,25-29,1873,1
SIM,1852,16,30-34,1868,5
SIM,1856,51,na,1907,3629
STAT,1910,45,40-44,1955,0.298592982612191
SIM,1900,41,na,1941,6796
STAT,1917,46,35-39,1963,0.27263134536368455
SIM,1820,38,30-34,1858,6
SIM,1894,27,50-100,1921,5
SIM,1794,82,na,1876,345
SIM,1947,21,35-39,1968,29
STAT,1869,48,50-100,1917,0.4745852874459101
STAT,1924,31,na,1955,8914.180964020918
STAT,1896,74,na,1970,3803.862810772549
STAT,1835,43,20-24,1878,0.24342805029571482
STAT,1919,28,35-39,1947,32.64014381719081
SIM,1846,37,45-49,1883,4
STAT,1857,26,45-49,1883,1.8133176882762256
STAT,1874,46,45-49,1920,0.4894134973301648
STAT,1920,22,15-19,1942,11.949132492378519
SIM,1872,45,40-44,1917,1
SIM,1883,76,na,1959,2330
STAT,1892,60,na,1952,4821.914545709132
SIM,1917,38,na,1955,8012
STAT,1883,16,15-19,1899,11.804692584982494
STAT,1838,80,na,1918,837.1878711280601
STAT,1874,40,30-34,1914,2.4014049524771255
SIM,1858,36,25-29,1894,8
STAT,1867,33,15-19,1900,0.2682167061862402
SIM,1879,39,na,1918,4784
SIM,1866,72,na,1938,2349
STAT,1874,23,40-44,1897,4.29582392027218
STAT,1901,28,50-100,1929,1.8022799916106413
SIM,1895,45,35-39,1940,1
SIM,1831,39,45-49,1870,5
SIM,1919,15,30-34,1934,7
SIM,1843,25,na,1868,3988
SIM,1903,45,45-49,1948,1
SIM,1850,89,na,1939,132
SIM,1853,28,40-44,1881,7
STAT,1811,59,na,1870,2258.5598198388775
STAT,1938,34,50-100,1972,1.6771075306820025
SIM,1880,15,30-34,1895,5
SIM,1882,46,45-49,1928,1
STAT,1878,32,50-100,1910,1.9326373688520633
STAT,1841,101,na,1942,0.8279348171421765
STAT,1885,49,25-29,1934,0.11337538826413605
STAT,1910,26,50-100,1936,1.9485538424255844
STAT,1872,15,30-34,1887,3.284358774702763
SIM,1946,19,na,1965,8034
STAT,1858,30,45-49,1888,2.803118932515253
STAT,1938,22,30-34,1960,57.4579899710263
SIM,1832,60,na,1892,2496
SIM,1935,0,na,1935,11888
STAT,1870,54,25-29,1924,0.0068300663161449775
STAT,1919,40,50-100,1959,0.257778897148134
SIM,1882,40,30-34,1922,5
STAT,1825,30,na,1855,3409.360056879123
SIM,1850,19,30-34,1869,3
STAT,1867,45,15-19,1912,7.641118731405018E-4
SIM,1844,26,50-100,1870,1
SIM,1927,17,25-29,1944,143
STAT,1813,53,40-44,1866,0.06067368884505331
STAT,1887,45,35-39,1932,0.3193836618881511
SIM,1868,84,na,1952,504
STAT,1845,28,40-44,1873,5.578120123037098
STAT,1842,19,30-34,1861,3.011422295869026
SIM,1893,54,na,1947,5490
STAT,1872,40,na,1912,4738.553042734383
STAT,1876,54,na,1930,4373.98245989107
STAT,1897,13,na,1910,6961.043536927276
SIM,1887,38,45-49,1925,7
STAT,1825,62,na,1887,2186.774043275118
STAT,1846,21,na,1867,4070.1084219020336
SIM,1923,20,40-44,1943,10
STAT,1886,25,30-34,1911,54.05058992223918
STAT,1867,2,na,1869,6363.538690414124
STAT,1847,37,40-44,1884,6.923337952679737
STAT,1836,42,25-29,1878,1.0159363043519867
SIM,1853,44,25-29,1897,1
STAT,1899,44,15-19,1943,0.0026178195176784326
SIM,1844,34,30-34,1878,45
SIM,1933,32,50-100,1965,3
STAT,1818,50,15-19,1868,1.0822445696504092E-4
STAT,1882,53,35-39,1935,0.016665485755900183
SIM,1892,13,na,1905,7396
SIM,1863,21,na,1884,4528
SIM,1919,23,25-29,1942,226
STAT,1902,35,35-39,1937,4.394285227108696
STAT,1909,43,15-19,1952,0.0028850949589689055
STAT,1931,17,50-100,1948,0.9904318530410019
SIM,1878,86,na,1964,804
SIM,1860,29,40-44,1889,8
STAT,1836,53,35-39,1889,0.011357180962438831
SIM,1827,34,30-34,1861,50
STAT,1836,34,30-34,1870,28.74646789125699
SIM,1866,30,45-49,1896,6
STAT,1878,51,25-29,1929,0.007506916905667277
STAT,1831,30,30-34,1861,30.094185841751216
STAT,1910,28,na,1938,7282.871190222924
SIM,1953,18,35-39,1971,12
STAT,1845,44,25-29,1889,0.9821578289002145
SIM,1843,29,40-44,1872,10
SIM,1889,49,na,1938,5586
SIM,1925,45,50-100,1970,3
SIM,1848,27,20-24,1875,29
SIM,1907,16,15-19,1923,15
STAT,1894,16,20-24,1910,46.10780952576603
STAT,1926,43,15-19,1969,0.0038168165231166466
STAT,1863,44,40-44,1907,3.922821030021916
STAT,1846,32,na,1878,3922.940012107084
STAT,1927,22,25-29,1949,229.8058914270089
STAT,1915,20,40-44,1935,6.776613542473546
STAT,1847,40,40-44,1887,3.5372734436177486
SIM,1908,20,15-19,1928,11
STAT,1893,40,40-44,1933,5.815970857013045
STAT,1879,38,45-49,1917,4.1903075146067605
SIM,1838,24,35-39,1862,8
SIM,1855,37,40-44,1892,16
STAT,1861,28,25-29,1889,71.11139373145731
SIM,1894,25,30-34,1919,7
STAT,1857,72,na,1929,1988.0452867461224
STAT,1851,42,20-24,1893,0.24588610295646532
STAT,1852,34,15-19,1886,0.23017112232561981
SIM,1853,32,25-29,1885,19
STAT,1934,17,20-24,1951,370.4106370904799
SIM,1871,44,40-44,1915,4
STAT,1904,3,na,1907,7663.228861020928
SIM,1942,17,20-24,1959,279
STAT,1851,39,20-24,1890,1.1829298434323787
SIM,1861,35,15-19,1896,2
STAT,1853,35,15-19,1888,0.09071226501802855
SIM,1958,12,na,1970,10839
SIM,1889,78,na,1967,2621
SIM,1835,25,20-24,1860,22
STAT,1835,19,20-24,1854,59.28340749792065
STAT,1769,112,na,1881,0.0010167862934703886
STAT,1852,22,15-19,1874,6.246279663973517
STAT,1877,36,15-19,1913,0.11833180926070838
SIM,1934,19,50-100,1953,3
STAT,1830,51,20-24,1881,0.0011426759741281801
STAT,1888,25,35-39,1913,23.188881465788583
STAT,1904,41,50-100,1945,0.21362010981530388
SIM,1860,22,15-19,1882,6
SIM,1873,36,50-100,1909,3
STAT,1848,36,na,1884,4022.5668644885964
SIM,1828,35,30-34,1863,11
SIM,1858,33,20-24,1891,6
SIM,1895,26,30-34,1921,83
STAT,1823,39,15-19,1862,0.20046008967608525
SIM,1934,23,20-24,1957,287
SIM,1889,38,na,1927,5903
STAT,1826,39,40-44,1865,9.699059103942837
STAT,1862,41,15-19,1903,0.02394640875606399
SIM,1918,22,25-29,1940,230
SIM,1937,22,35-39,1959,23
STAT,1842,15,45-49,1857,0.12636999749297195
STAT,1945,23,30-34,1968,63.59203211120138
SIM,1853,24,30-34,1877,41
SIM,1855,40,40-44,1895,7
STAT,1879,19,na,1898,5306.673107184439
SIM,1831,26,45-49,1857,2
SIM,1835,89,na,1924,90
STAT,1893,23,15-19,1916,8.419003840541768
STAT,1894,36,15-19,1930,0.1463884166618119
SIM,1939,30,na,1969,7973
STAT,1843,32,15-19,1875,0.239821911350134
SIM,1925,17,na,1942,8981
SIM,1932,27,na,1959,9937
STAT,1887,26,30-34,1913,57.075890190009424
STAT,1935,33,15-19,1968,0.3589024584274584
STAT,1810,93,na,1903,26.430065475212942
SIM,1935,22,25-29,1957,288
SIM,1870,24,30-34,1894,36
STAT,1847,24,35-39,1871,10.748699561129762
STAT,1826,32,15-19,1858,0.4281368620245807
SIM,1856,44,45-49,1900,2
SIM,1907,21,40-44,1928,8
STAT,1786,110,na,1896,2.5682017429698206E-4
STAT,1797,100,na,1897,0.5137046226774564
SIM,1935,24,na,1959,10318
STAT,1836,35,15-19,1871,0.09358813781929512
STAT,1916,48,50-100,1964,0.467221679593647
STAT,1929,22,35-39,1951,24.045633174065053
SIM,1931,10,na,1941,10525
STAT,1890,17,45-49,1907,0.1610301606693571
STAT,1926,35,na,1961,9300.520824277348
STAT,1899,31,45-49,1930,4.845117438980148
SIM,1908,33,20-24,1941,6
SIM,1893,43,na,1936,6072
STAT,1862,32,25-29,1894,17.680796292861302
SIM,1908,45,50-100,1953,1
STAT,1814,86,na,1900,190.9532041712514
STAT,1888,38,40-44,1926,10.397555363271454
SIM,1855,24,35-39,1879,14
STAT,1845,24,30-34,1869,33.58685087102537
STAT,1852,29,40-44,1881,4.988006983313004
STAT,1872,61,na,1933,3792.845317595234
SIM,1835,50,50-100,1885,1
STAT,1827,45,15-19,1872,7.41946739800128E-4
STAT,1857,26,15-19,1883,0.7409749862599706
STAT,1861,33,20-24,1894,4.52468933101235
STAT,1835,29,40-44,1864,4.986320573415213
SIM,1850,39,25-29,1889,9
SIM,1854,23,35-39,1877,14
STAT,1945,18,35-39,1963,9.25378092240303
STAT,1920,36,40-44,1956,3.312463609578777
SIM,1899,34,20-24,1933,9
STAT,1842,39,25-29,1881,4.481878928449824
STAT,1897,15,35-39,1912,1.4882006279338271
SIM,1908,20,45-49,1928,1
SIM,1876,26,20-24,1902,25
STAT,1900,35,30-34,1935,15.073281825568664
SIM,1921,35,na,1956,8516
SIM,1900,70,na,1970,4868
STAT,1797,81,na,1878,413.87694493725974
STAT,1801,57,na,1858,2222.752534689906
STAT,1946,22,35-39,1968,21.160137024166396
SIM,1839,36,45-49,1875,6
STAT,1846,23,35-39,1869,10.94939055930628
STAT,1859,50,na,1909,3510.932587787503
STAT,1843,53,50-100,1896,0.020816513638425366
STAT,1793,96,na,1889,3.185293642182731
SIM,1825,41,50-100,1866,6
STAT,1867,50,40-44,1917,0.020198402709462455
STAT,1841,52,35-39,1893,0.012424644418596835
STAT,1900,24,20-24,1924,191.8582999979556
SIM,1833,23,na,1856,3730
SIM,1910,35,35-39,1945,7
SIM,1803,53,50-100,1856,1
SIM,1861,39,30-34,1900,16
SIM,1846,44,na,1890,3462
SIM,1812,64,na,1876,1904
SIM,1896,38,40-44,1934,18
SIM,1880,34,35-39,1914,28
STAT,1844,45,20-24,1889,0.01968457416650776
STAT,1838,53,45-49,1891,0.019325823671780092
STAT,1825,70,na,1895,1623.4069650796753
STAT,1860,29,20-24,1889,19.16845609587803
SIM,1829,50,40-44,1879,1
SIM,1871,25,30-34,1896,57
SIM,1839,33,40-44,1872,13
STAT,1842,15,15-19,1857,11.480716595426797
STAT,1876,35,15-19,1911,0.11841300572664198
STAT,1904,35,45-49,1939,1.2591052231944535
SIM,1880,25,na,1905,5339
STAT,1888,41,40-44,1929,5.393462133315034
STAT,1883,24,na,1907,4663.52458883283
STAT,1855,37,45-49,1892,3.0060471373840283
STAT,1921,48,20-24,1969,0.025084580920375122
SIM,1822,71,na,1893,1455
SIM,1878,24,35-39,1902,9
STAT,1840,44,40-44,1884,3.3010982504297273
STAT,1854,18,40-44,1872,0.3334354458171233
SIM,1955,15,40-44,1970,5
STAT,1836,22,na,1858,3751.6697097600963
SIM,1843,25,25-29,1868,90
SIM,1826,29,35-39,1855,18
STAT,1870,15,20-24,1885,35.90924432472178
STAT,1884,50,40-44,1934,0.021296687222016785
STAT,1903,58,na,1961,5942.36819324672
SIM,1856,36,45-49,1892,6
STAT,1898,24,40-44,1922,5.659579226205823
SIM,1900,49,50-100,1949,1
SIM,1913,30,25-29,1943,26
SIM,1833,39,25-29,1872,9
SIM,1845,99,na,1944,1
SIM,1854,41,30-34,1895,2
SIM,1862,54,40-44,1916,1
SIM,1813,43,35-39,1856,5
STAT,1917,43,50-100,1960,0.24719398967797393
STAT,1910,46,25-29,1956,0.10023917040041505
SIM,1912,35,45-49,1947,2
STAT,1931,24,40-44,1955,8.752550236183332
SIM,1811,47,25-29,1858,1
SIM,1844,74,na,1918,1507
SIM,1881,23,25-29,1904,116
SIM,1836,24,25-29,1860,109
STAT,1832,26,40-44,1858,5.3201200368580235
STAT,1860,32,20-24,1892,4.433240245165505
SIM,1845,35,50-100,1880,7
STAT,1863,25,30-34,1888,45.165343364262554
STAT,1932,38,25-29,1970,2.6692993996785015
STAT,1848,98,na,1946,5.326656513201099
SIM,1893,29,25-29,1922,119
STAT,1876,23,20-24,1899,143.50373261231857
SIM,1821,33,25-29,1854,25
STAT,1868,24,na,1892,4516.053931611186
STAT,1891,40,30-34,1931,2.8989706412453704
STAT,1900,41,50-100,1941,0.20646328966082797
STAT,1854,54,40-44,1908,0.015694947707140687
STAT,1895,15,25-29,1910,14.98202244160787
STAT,1853,39,30-34,1892,8.347596714606428
SIM,1879,40,50-100,1919,5
STAT,1833,29,30-34,1862,43.11841876199233
SIM,1938,31,40-44,1969,10
STAT,1848,36,45-49,1884,3.4036550410708584
SIM,1871,40,25-29,1911,2
STAT,1863,40,25-29,1903,1.1467251324249308
SIM,1846,102,na,1948,1
STAT,1846,41,30-34,1887,1.8052565410615855
STAT,1910,48,45-49,1958,0.4085446982565382
STAT,1905,30,25-29,1935,30.156872931423717
SIM,1878,54,na,1932,4564
SIM,1829,29,na,1858,3540
STAT,1845,43,35-39,1888,2.805290812640283
STAT,1861,44,30-34,1905,1.906515452439788
SIM,1826,38,25-29,1864,7
SIM,1841,29,30-34,1870,57
STAT,1912,48,50-100,1960,0.43789968778509347
STAT,1874,28,na,1902,4917.755108702605
STAT,1859,28,na,1887,3874.5086451868865
STAT,1867,49,30-34,1916,0.17926712390021685
SIM,1901,45,40-44,1946,2
SIM,1854,95,na,1949,23
SIM,1914,48,25-29,1962,1
SIM,1840,22,25-29,1862,146
STAT,1845,32,25-29,1877,18.76628708703731
STAT,1898,27,15-19,1925,1.2400088454834963
STAT,1860,36,na,1896,3882.5953437575276
SIM,1906,23,50-100,1929,2
STAT,1928,15,30-34,1943,31.157227940774696
STAT,1943,23,20-24,1966,238.8416070201744
SIM,1840,26,40-44,1866,6
SIM,1853,43,35-39,1896,6
STAT,1828,28,40-44,1856,8.550064343510039
STAT,1876,26,25-29,1902,88.66496887049944
SIM,1874,17,20-24,1891,31
STAT,1814,54,40-44,1868,0.05023020897697229
STAT,1885,29,25-29,1914,84.43059954614405
SIM,1852,19,35-39,1871,2
SIM,1924,24,45-49,1948,7
STAT,1912,54,na,1966,6946.418419449947
STAT,1882,90,na,1972,532.8173286552001
STAT,1837,108,na,1945,0.0025529748806478974
SIM,1870,27,35-39,1897,25
STAT,1865,44,45-49,1909,2.7089856686162315
SIM,1879,22,30-34,1901,45
STAT,1862,27,35-39,1889,16.717394040124137
STAT,1774,93,na,1867,9.623034858368268
STAT,1887,42,30-34,1929,2.5936650191462185
SIM,1873,44,45-49,1917,7
SIM,1792,78,na,1870,619
SIM,1910,40,na,1950,7413
SIM,1895,42,30-34,1937,1
SIM,1907,28,na,1935,7078
STAT,1896,47,35-39,1943,0.20959056888836053
STAT,1906,17,45-49,1923,0.1922404873995466
STAT,1832,22,25-29,1854,180.24856964594883
STAT,1791,102,na,1893,0.11569678487874749
STAT,1912,7,na,1919,8138.929931821593
STAT,1881,45,40-44,1926,0.33752810797914445
STAT,1895,19,40-44,1914,0.47875198413274167
SIM,1839,36,15-19,1875,2
STAT,1929,3,na,1932,10453.28505046847
SIM,1890,34,50-100,1924,6
SIM,1850,15,15-19,1865,12
SIM,1869,36,30-34,1905,13
STAT,1837,35,50-100,1872,2.127613817303545
STAT,1861,21,na,1882,4113.894766209494
SIM,1890,54,na,1944,5507
STAT,1906,48,25-29,1954,0.09441831292690439
STAT,1834,42,20-24,1876,0.25485418084838285
SIM,1825,82,na,1907,444
SIM,1936,15,30-34,1951,24
SIM,1894,68,na,1962,4372
STAT,1859,9,na,1868,4546.07420597997
STAT,1874,32,50-100,1906,1.8947177499130412
SIM,1859,62,na,1921,3195
SIM,1874,45,50-100,1919,1
STAT,1863,87,na,1950,311.4701255300643
STAT,1842,51,45-49,1893,0.02170966892255972
SIM,1948,17,15-19,1965,105
SIM,1846,34,40-44,1880,14
STAT,1917,17,20-24,1934,58.91686992561078
SIM,1925,17,20-24,1942,326
STAT,1916,24,45-49,1940,2.3662649751694995
STAT,1947,15,40-44,1962,3.183591744354123
STAT,1896,42,na,1938,6176.4249428440435
SIM,1852,25,20-24,1877,26
STAT,1829,47,45-49,1876,0.372373350309541
STAT,1838,88,na,1926,185.79509523798578
STAT,1834,39,20-24,1873,1.2501065348701932
STAT,1880,44,40-44,1924,4.720903333271579
SIM,1842,39,20-24,1881,2
STAT,1844,25,20-24,1869,23.528889237115568
SIM,1830,27,35-39,1857,20
SIM,1944,20,na,1964,8049
STAT,1896,38,45-49,1934,5.2891245566095835
STAT,1838,34,40-44,1872,7.143354240830497
STAT,1866,17,20-24,1883,33.909549568021944
SIM,1852,48,25-29,1900,1
STAT,1844,19,35-39,1863,1.113178047714725
STAT,1893,31,na,1924,6133.629151639015
SIM,1856,43,na,1899,3874
SIM,1884,26,25-29,1910,90
SIM,1905,21,30-34,1926,72
STAT,1836,37,35-39,1873,11.545570857036887
SIM,1949,21,15-19,1970,10
STAT,1895,35,25-29,1930,7.648942777733639
SIM,1891,16,15-19,1907,14
SIM,1866,10,na,1876,5295
STAT,1851,45,25-29,1896,0.09018070642408035
STAT,1893,39,30-34,1932,13.505757760066517
STAT,1942,23,50-100,1965,1.3929085547078124
SIM,1896,34,25-29,1930,39
STAT,1899,18,50-100,1917,0.1352121353901759
STAT,1931,20,25-29,1951,243.40516479903363
SIM,1876,28,na,1904,5097
SIM,1930,17,na,1947,10157
SIM,1879,6,na,1885,5599
STAT,1800,86,na,1886,156.97524817264843
STAT,1851,26,20-24,1877,21.447143057544988
SIM,1923,23,45-49,1946,5
SIM,1836,44,25-29,1880,3
STAT,1886,44,35-39,1930,3.808440790458682
SIM,1832,43,45-49,1875,7
STAT,1915,23,45-49,1938,2.3419076110018313
STAT,1819,42,25-29,1861,2.973096439584524
STAT,1886,33,25-29,1919,21.7444935346433
SIM,1808,67,na,1875,1653
STAT,1873,27,40-44,1900,6.1470652403413
STAT,1888,34,25-29,1922,24.240434491799295
STAT,1830,54,25-29,1884,0.005168344054931381
STAT,1819,53,35-39,1872,0.03400168421523271
STAT,1895,23,50-100,1918,1.069837652972364
STAT,1821,44,30-34,1865,3.455303399705419
STAT,1823,42,45-49,1865,4.984221405391709
STAT,1823,39,45-49,1862,7.116332337195081
STAT,1885,46,20-24,1931,0.0241920463364341
SIM,1882,31,40-44,1913,10
SIM,1887,35,40-44,1922,13
STAT,1840,35,35-39,1875,12.328543829970062
SIM,1833,26,na,1859,3719
SIM,1939,32,40-44,1971,13
SIM,1827,42,25-29,1869,2
STAT,1879,15,40-44,1894,0.38817369563073184
STAT,1879,54,45-49,1933,0.02981409132127842
SIM,1881,27,40-44,1908,7
SIM,1949,18,15-19,1967,101
SIM,1836,28,40-44,1864,2
SIM,1836,74,na,1910,1320
STAT,1873,30,40-44,1903,8.970718559846045
SIM,1815,40,40-44,1855,5
STAT,1948,1,na,1949,9490.356172782385
SIM,1866,21,na,1887,4653
STAT,1859,105,na,1964,0.23832660093191577
STAT,1862,62,na,1924,3155.0317591790213
STAT,1824,43,45-49,1867,3.7962684238684816
STAT,1879,35,40-44,1914,9.335197941128598
SIM,1858,21,na,1879,4170
SIM,1819,48,35-39,1867,1
SIM,1822,93,na,1915,15
STAT,1880,13,na,1893,5485.960284037326
SIM,1843,33,na,1876,3737
STAT,1808,49,20-24,1857,0.07267838536665909
STAT,1905,34,40-44,1939,7.210890921618118
STAT,1818,38,25-29,1856,17.863416000497025
STAT,1889,24,45-49,1913,1.725622341065941
SIM,1777,78,na,1855,565
SIM,1913,34,40-44,1947,11
SIM,1928,41,25-29,1969,1
STAT,1842,48,15-19,1890,5.880424640167594E-4
SIM,1829,43,25-29,1872,3
STAT,1793,99,na,1892,0.6874205385943993
SIM,1886,39,35-39,1925,22
STAT,1809,53,20-24,1862,0.005330965095198291
STAT,1850,29,na,1879,3847.4513145232736
SIM,1865,23,40-44,1888,5
STAT,1854,52,20-24,1906,0.0011251989618913385
STAT,1878,39,35-39,1917,14.76876579641036
STAT,1882,79,na,1961,1768.8604390685555
STAT,1873,65,na,1938,3467.897924052328
SIM,1865,36,na,1901,4406
STAT,1857,23,40-44,1880,3.759756885564968
STAT,1938,23,na,1961,7298.072840280354
STAT,1839,54,45-49,1893,0.022036956997680674
SIM,1884,44,20-24,1928,2
STAT,1852,95,na,1947,21.190565065891267
STAT,1891,34,45-49,1925,4.315975739400316
STAT,1831,33,35-39,1864,16.90116119649417
STAT,1861,15,25-29,1876,11.078951965068986
SIM,1838,21,30-34,1859,40
STAT,1825,36,20-24,1861,2.1056582954678484
STAT,1876,44,20-24,1920,0.32726030509031845
STAT,1882,39,na,1921,4588.491012323052
STAT,1815,101,na,1916,0.5303944619481804
STAT,1901,14,na,1915,7278.067831190589
STAT,1905,28,na,1933,6945.97472981216
STAT,1862,45,30-34,1907,0.16876215841963654
STAT,1883,52,45-49,1935,0.028643297705360345
STAT,1875,43,20-24,1918,0.32784263363900634
SIM,1876,5,na,1881,5935
SIM,1949,21,45-49,1970,3
STAT,1837,38,35-39,1875,11.88106774165178
STAT,1904,43,na,1947,6674.25601963069
STAT,1833,45,45-49,1878,0.3734880088918813
STAT,1892,27,20-24,1919,29.660580190695924
SIM,1835,49,30-34,1884,1
STAT,1873,23,50-100,1896,0.8342230658626015
STAT,1918,17,50-100,1935,0.16520611182917613
SIM,1892,17,15-19,1909,18
SIM,1929,28,45-49,1957,6
STAT,1881,36,35-39,1917,13.873371012610646
SIM,1906,43,na,1949,6746
SIM,1899,37,25-29,1936,2
STAT,1780,78,na,1858,544.8256914826759
SIM,1834,96,na,1930,2
STAT,1873,54,na,1927,4296.917281571547
STAT,1830,32,35-39,1862,20.058400234887404
SIM,1830,82,na,1912,473
STAT,1904,22,30-34,1926,51.63317251510319
STAT,1869,45,25-29,1914,0.11384348345250184
STAT,1847,62,na,1909,2786.0870394736958
STAT,1859,36,20-24,1895,1.2450952558394337
SIM,1880,87,na,1967,741
SIM,1912,22,30-34,1934,72
STAT,1871,33,35-39,1904,20.234359173843156
SIM,1864,30,50-100,1894,2
STAT,1835,25,25-29,1860,72.47270875077118
STAT,1808,52,20-24,1860,0.004379347494637524
SIM,1868,76,na,1944,1723
STAT,1849,21,na,1870,4118.616174490966
STAT,1921,32,50-100,1953,1.8577872327035931
SIM,1831,23,40-44,1854,5
SIM,1844,37,35-39,1881,20
STAT,1872,34,35-39,1906,20.379329711245248
STAT,1810,53,15-19,1863,1.4900325147158453E-4
SIM,1879,79,na,1958,1482
STAT,1826,48,30-34,1874,0.19042143580675533
STAT,1880,24,25-29,1904,121.03176551900037
STAT,1827,49,30-34,1876,0.17021347786880808
STAT,1811,54,15-19,1865,1.5301021079445532E-4
STAT,1897,16,na,1913,6834.977891108567
STAT,1911,22,30-34,1933,55.067022727267435
SIM,1919,20,20-24,1939,245
SIM,1845,38,35-39,1883,24
SIM,1871,51,na,1922,4188
SIM,1867,39,25-29,1906,10
SIM,1891,28,na,1919,6144
STAT,1847,73,na,1920,1810.5410671383268
STAT,1856,30,50-100,1886,1.4755341883747657
SIM,1849,22,45-49,1871,3
STAT,1908,34,50-100,1942,1.563710984729897
STAT,1813,102,na,1915,0.26051554209036853
STAT,1834,44,na,1878,3283.0451033685945
STAT,1850,33,45-49,1883,2.7681172016314686
STAT,1886,39,50-100,1925,2.5911333177769778
STAT,1820,43,30-34,1863,4.520675166454486
STAT,1875,19,50-100,1894,0.10132502503391862
STAT,1913,17,na,1930,7977.317814816548
STAT,1814,45,35-39,1859,0.748253746922314
SIM,1877,13,na,1890,5369
SIM,1822,45,35-39,1867,1
STAT,1832,45,15-19,1877,6.325563650516529E-4
SIM,1877,29,40-44,1906,9
STAT,1845,47,na,1892,3450.6972446164036
SIM,1808,56,na,1864,2373
SIM,1916,34,50-100,1950,1
STAT,1822,65,na,1887,1929.6812191341123
STAT,1834,42,15-19,1876,0.022161234314198135
STAT,1873,57,na,1930,4123.875594887194
STAT,1910,43,20-24,1953,0.033518484036827126
STAT,1865,20,40-44,1885,3.926048139705449
SIM,1891,17,na,1908,6494
SIM,1887,16,30-34,1903,3
STAT,1826,55,na,1881,2667.169734875312
STAT,1845,25,15-19,1870,0.8633142962168281
STAT,1847,33,25-29,1880,18.142552948729573
STAT,1829,53,30-34,1882,0.008094393665685037
STAT,1875,58,na,1933,4112.120437430464
STAT,1873,51,40-44,1924,0.021706691312681485
SIM,1866,42,45-49,1908,7
SIM,1802,73,na,1875,1142
STAT,1830,60,na,1890,2633.5922346715993
STAT,1836,30,15-19,1866,0.24441004452674356
STAT,1766,104,na,1870,0.038083446601133206
STAT,1865,17,40-44,1882,0.3458220450429919
STAT,1858,42,45-49,1900,2.3534366830687534
SIM,1830,80,na,1910,648
SIM,1903,32,30-34,1935,43
SIM,1813,49,na,1862,2829
STAT,1860,92,na,1952,68.30848866910983
SIM,1857,28,50-100,1885,1
STAT,1856,54,45-49,1910,0.021991904898506134
STAT,1894,43,25-29,1937,0.11485543638350434
STAT,1861,47,35-39,1908,0.23424400289304145
SIM,1817,39,na,1856,3172
SIM,1919,42,35-39,1961,1
STAT,1864,82,na,1946,842.3256903180913
SIM,1910,35,40-44,1945,4
SIM,1858,23,na,1881,4147
SIM,1870,45,30-34,1915,1
STAT,1922,21,35-39,1943,21.867568673996622
SIM,1901,46,50-100,1947,1
SIM,1926,12,na,1938,10081
STAT,1934,19,na,1953,10002.40524719875
SIM,1837,40,25-29,1877,3
SIM,1926,10,na,1936,10115
SIM,1896,40,na,1936,6597
SIM,1914,33,45-49,1947,4
SIM,1900,28,35-39,1928,31
STAT,1833,42,40-44,1875,3.5892379659090397
STAT,1827,74,na,1901,1341.9945079047623
STAT,1896,28,na,1924,6341.093627942431
SIM,1821,78,na,1899,898
STAT,1896,31,25-29,1927,27.422780844830076
STAT,1902,35,40-44,1937,2.719667682375441
SIM,1822,85,na,1907,226
SIM,1855,33,25-29,1888,23
SIM,1905,40,40-44,1945,1
STAT,1813,50,30-34,1863,0.03643804318976854
SIM,1887,12,na,1899,6390
STAT,1880,21,20-24,1901,147.05901000802805
STAT,1911,8,na,1919,8036.548188410902
SIM,1889,24,40-44,1913,7
STAT,1863,44,35-39,1907,3.1581268299086815
STAT,1848,58,na,1906,3242.680914134745
STAT,1940,2,na,1942,8352.87322803542
STAT,1880,41,30-34,1921,2.457070692717232
STAT,1918,4,na,1922,8870.974232947632
STAT,1856,42,35-39,1898,2.818201603319717
STAT,1866,103,na,1969,2.2619134440937305
STAT,1805,61,na,1866,2131.58113100249
STAT,1831,54,40-44,1885,0.01362343954514227
STAT,1829,40,25-29,1869,1.090236093142841
STAT,1873,23,25-29,1896,117.10822175282117
SIM,1850,35,na,1885,3880
SIM,1910,22,20-24,1932,215
SIM,1892,32,45-49,1924,7
SIM,1905,24,35-39,1929,19
STAT,1865,48,50-100,1913,0.4449674622380091
STAT,1859,39,50-100,1898,1.9537199770280014
STAT,1886,27,50-100,1913,1.3637874336683873
STAT,1882,44,45-49,1926,2.9047398938560622
STAT,1805,93,na,1898,21.860868399834697
STAT,1839,30,40-44,1869,8.507943975517508
STAT,1839,27,40-44,1866,5.8924212342053215
STAT,1871,15,15-19,1886,12.127106590755044
STAT,1921,22,30-34,1943,65.54655628592288
SIM,1950,3,na,1953,9267
SIM,1868,19,25-29,1887,14
SIM,1871,44,35-39,1915,5
STAT,1836,26,50-100,1862,1.1087609758924337
STAT,1827,96,na,1923,10.383281571635612
STAT,1844,50,50-100,1894,0.024740131408413992
STAT,1930,40,25-29,1970,0.19028107822105197
STAT,1852,63,na,1915,2843.842367827824
STAT,1827,52,25-29,1879,0.0061742828815163206
SIM,1928,17,40-44,1945,4
STAT,1879,36,50-100,1915,2.606061523924573
SIM,1841,42,40-44,1883,10
SIM,1873,32,35-39,1905,27
STAT,1871,15,50-100,1886,0.10011368302226702
STAT,1917,49,45-49,1966,0.4557517004967609
SIM,1919,21,50-100,1940,1
SIM,1842,48,na,1890,3180
STAT,1944,22,25-29,1966,201.40836694696588
SIM,1869,72,na,1941,2313
SIM,1825,41,45-49,1866,5
STAT,1894,27,na,1921,6191.588289147272
STAT,1877,16,20-24,1893,37.27084865489443
SIM,1825,68,na,1893,1641
SIM,1909,17,30-34,1926,6
STAT,1815,53,45-49,1868,0.07322998600811001
STAT,1875,43,15-19,1918,0.028508056638788856
SIM,1873,20,40-44,1893,6
SIM,1935,27,25-29,1962,206
STAT,1938,5,na,1943,8011.644024377206
STAT,1809,110,na,1919,2.456131484732569E-4
STAT,1869,20,na,1889,4675.802494894599
STAT,1896,44,30-34,1940,0.210001744043078
STAT,1884,32,45-49,1916,3.4776531051521635
SIM,1872,40,35-39,1912,6
STAT,1913,25,na,1938,7591.6720546226425
SIM,1863,30,25-29,1893,25
STAT,1850,82,na,1932,715.3967335846345
STAT,1866,16,45-49,1882,0.12568332100267213
STAT,1922,34,40-44,1956,8.883863407312628
SIM,1870,32,25-29,1902,22
STAT,1811,104,na,1915,0.06200198255937596
SIM,1855,66,na,1921,2790
SIM,1927,40,50-100,1967,1
STAT,1850,29,30-34,1879,44.78687938569673
STAT,1946,12,na,1958,8798.54624612702
STAT,1955,3,na,1958,10545.174324331196
STAT,1817,49,40-44,1866,0.8014282204204359
STAT,1847,44,50-100,1891,1.5886565162077337
SIM,1827,49,na,1876,2989
STAT,1904,32,40-44,1936,7.2182757144782865
STAT,1904,17,50-100,1921,0.1420147044854253
SIM,1910,19,35-39,1929,1
SIM,1874,16,45-49,1890,1
SIM,1880,79,na,1959,1762
SIM,1890,44,45-49,1934,8
SIM,1923,48,50-100,1971,2
STAT,1885,68,na,1953,3072.1296910634123
STAT,1927,27,25-29,1954,161.5822225800401
STAT,1902,22,20-24,1924,196.49337526108025
STAT,1930,29,na,1959,9610.62032332572
SIM,1912,32,40-44,1944,11
STAT,1864,40,35-39,1904,3.302065495766766
STAT,1845,41,20-24,1886,0.2524168569459505
STAT,1832,50,40-44,1882,0.014853145280745808
SIM,1940,23,45-49,1963,2
SIM,1825,49,40-44,1874,2
STAT,1808,52,15-19,1860,1.459781214139214E-4
STAT,1877,31,15-19,1908,0.2998719001507116
STAT,1856,87,na,1943,274.531271478468
STAT,1822,38,50-100,1860,4.693461157727827
STAT,1788,96,na,1884,3.306442499910149
STAT,1928,22,40-44,1950,8.477237592674562
SIM,1806,49,30-34,1855,1
SIM,1894,26,15-19,1920,5
STAT,1908,27,15-19,1935,1.360150196046681
STAT,1940,17,50-100,1957,0.7683233433657252
STAT,1850,21,35-39,1871,10.816761541570227
SIM,1880,33,na,1913,5261
STAT,1937,32,35-39,1969,18.263176678956192
STAT,1797,59,na,1856,1954.0475344192994
STAT,1880,27,na,1907,5077.50244305889
SIM,1851,84,na,1935,404
STAT,1924,39,35-39,1963,5.746402128213174
SIM,1886,32,50-100,1918,1
SIM,1928,5,na,1933,10385
STAT,1778,101,na,1879,0.2843433825180955
STAT,1853,42,25-29,1895,1.0147709047707547
STAT,1881,20,25-29,1901,112.41483930708458
STAT,1932,23,45-49,1955,2.9726256107536995
STAT,1872,18,na,1890,5112.894101645798
SIM,1857,16,45-49,1873,2
STAT,1843,53,20-24,1896,0.0010170935405181896
STAT,1881,40,35-39,1921,3.570523644223293
STAT,1815,71,na,1886,1398.0255202489916
STAT,1834,41,45-49,1875,2.4326917663671037
STAT,1917,33,20-24,1950,5.136283680505578
SIM,1815,91,na,1906,47
STAT,1920,19,na,1939,8293.562453765211
STAT,1855,15,30-34,1870,2.8926396098819684
STAT,1869,15,15-19,1884,11.914313271671773
SIM,1900,27,na,1927,6977
STAT,1922,28,20-24,1950,41.55800620976292
SIM,1932,39,35-39,1971,10
STAT,1889,21,40-44,1910,5.204835784031395
STAT,1897,43,35-39,1940,0.33701859592431155
STAT,1923,49,na,1972,8626.068331117222
SIM,1930,28,20-24,1958,50
SIM,1881,34,50-100,1915,2
STAT,1814,42,30-34,1856,6.639166311711053
STAT,1895,32,20-24,1927,7.113451967166899
SIM,1809,97,na,1906,10
STAT,1880,47,45-49,1927,0.4997663817191771
SIM,1870,55,na,1925,3996
SIM,1897,18,40-44,1915,1
SIM,1925,20,15-19,1945,8
STAT,1840,32,30-34,1872,30.695934721857846
STAT,1831,49,15-19,1880,5.966224964853033E-4
STAT,1814,78,na,1892,672.4380283566824
SIM,1863,15,30-34,1878,4
SIM,1916,27,15-19,1943,3
SIM,1919,22,40-44,1941,10
STAT,1926,41,50-100,1967,0.2928702444818986
STAT,1921,12,na,1933,9119.326079666887
SIM,1883,45,50-100,1928,2
SIM,1888,43,35-39,1931,8
STAT,1855,38,na,1893,3535.037780189067
STAT,1927,43,30-34,1970,0.32325944418619995
STAT,1907,39,35-39,1946,4.485976618930484
SIM,1915,39,35-39,1954,4
STAT,1879,19,35-39,1898,1.152919300753961
SIM,1847,27,40-44,1874,8
SIM,1888,15,35-39,1903,4
STAT,1767,114,na,1881,5.024058212178427E-4
SIM,1873,85,na,1958,589
STAT,1923,30,40-44,1953,9.130410547698313
STAT,1908,30,15-19,1938,0.24710937914423425
SIM,1836,41,20-24,1877,2
STAT,1794,110,na,1904,1.0824149258644061E-4
SIM,1877,15,15-19,1892,11
STAT,1817,107,na,1924,0.0047566309306988405
SIM,1825,36,na,1861,3079
SIM,1842,22,35-39,1864,1
SIM,1804,66,na,1870,1611
STAT,1934,33,20-24,1967,6.722717007361942
SIM,1851,31,45-49,1882,5
STAT,1871,50,50-100,1921,0.03073937338331811
STAT,1877,39,na,1916,4891.12932103369
SIM,1847,30,40-44,1877,13
STAT,1953,17,25-29,1970,105.86367810854165
SIM,1832,39,30-34,1871,16
STAT,1860,32,15-19,1892,0.2335603813389572
SIM,1901,35,50-100,1936,3
STAT,1841,31,35-39,1872,18.013882103392444
STAT,1917,20,15-19,1937,11.493315841428657
SIM,1912,41,50-100,1953,1
STAT,1833,44,50-100,1877,1.6431161798447256
STAT,1843,31,45-49,1874,2.9673396655707296
SIM,1829,40,na,1869,3349
STAT,1845,93,na,1938,45.0344518903899
STAT,1886,42,20-24,1928,0.3381634152078577
SIM,1920,47,na,1967,8374
STAT,1929,32,na,1961,9701.388058061033
STAT,1934,17,15-19,1951,123.99339138975945
STAT,1820,46,35-39,1866,0.5285742606647815
SIM,1848,26,45-49,1874,2
SIM,1841,49,25-29,1890,1
SIM,1888,31,40-44,1919,18
STAT,1889,18,40-44,1907,0.4542778701928258
SIM,1822,42,30-34,1864,4
STAT,1934,20,15-19,1954,14.497170665734297
SIM,1838,86,na,1924,229
SIM,1843,87,na,1930,204
SIM,1942,17,15-19,1959,98
STAT,1860,31,45-49,1891,2.8717006648540764
STAT,1793,100,na,1893,0.38534733131986243
STAT,1771,106,na,1877,0.019343950926062902
SIM,1925,17,15-19,1942,101
SIM,1781,86,na,1867,129
STAT,1917,17,15-19,1934,19.722172585344367
STAT,1897,33,50-100,1930,2.4630965912064657
STAT,1933,29,35-39,1962,40.22537481848038
SIM,1941,29,35-39,1970,40
SIM,1876,20,na,1896,5122
SIM,1931,30,40-44,1961,16
STAT,1843,39,40-44,1882,6.380492651573227
SIM,1851,39,40-44,1890,11
STAT,1881,33,30-34,1914,33.93895805242328
SIM,1916,34,na,1950,7915
STAT,1915,23,50-100,1938,1.3695366668042201
STAT,1908,43,20-24,1951,0.03282280592866807
SIM,1815,39,30-34,1854,17
SIM,1818,80,na,1898,507
SIM,1878,41,25-29,1919,2
STAT,1819,51,20-24,1870,0.0030330523179056073
STAT,1890,30,35-39,1920,25.165467452950264
SIM,1832,95,na,1927,13
SIM,1846,15,30-34,1861,4
STAT,1856,53,na,1909,3301.2733673365356
STAT,1843,35,na,1878,3576.060065239711
SIM,1925,33,20-24,1958,7
SIM,1836,25,15-19,1861,3
STAT,1860,108,na,1968,0.03388483028748306
STAT,1860,39,na,1899,3825.1082937952215
STAT,1824,39,30-34,1863,14.80602460471246
SIM,1883,23,35-39,1906,17
SIM,1810,60,na,1870,2142
SIM,1900,25,30-34,1925,98
SIM,1909,34,20-24,1943,7
STAT,1886,26,15-19,1912,0.9705871659572828
SIM,1951,19,na,1970,9103
STAT,1796,93,na,1889,14.544946191191237
STAT,1860,39,40-44,1899,7.107209074057725
SIM,1830,37,na,1867,3184
SIM,1783,95,na,1878,2
SIM,1889,60,na,1949,4748
STAT,1817,41,50-100,1858,5.95643026775165
STAT,1879,48,na,1927,4693.018837887839
STAT,1839,107,na,1946,0.007363623884837183
STAT,1850,49,25-29,1899,0.08647235996788406
SIM,1888,28,40-44,1916,12
STAT,1814,49,15-19,1863,0.002008727758947487
SIM,1855,58,na,1913,3451
SIM,1832,31,35-39,1863,28
SIM,1889,30,50-100,1919,3
STAT,1819,35,15-19,1854,0.37368298900673963
STAT,1896,16,30-34,1912,4.260376528705595
STAT,1860,48,30-34,1908,0.1567651933452084
STAT,1891,22,35-39,1913,14.567587960971707
SIM,1936,22,40-44,1958,2
SIM,1877,42,20-24,1919,4
SIM,1925,19,50-100,1944,4
STAT,1899,43,45-49,1942,0.2855105972848257
STAT,1849,15,50-100,1864,0.09652422414130239
STAT,1885,50,20-24,1935,0.0015047541297868033
SIM,1875,26,50-100,1901,1
SIM,1926,32,25-29,1958,27
STAT,1829,25,30-34,1854,143.38681038454305
STAT,1869,42,20-24,1911,0.3104048704330159
SIM,1942,20,15-19,1962,16
STAT,1824,31,35-39,1855,53.80848897297015
STAT,1856,85,na,1941,427.166187414686
STAT,1860,100,na,1960,3.852071155270697
STAT,1847,32,50-100,1879,1.6398702125106497
STAT,1918,32,25-29,1950,19.832416125197586
STAT,1914,40,40-44,1954,0.5041370571533114
STAT,1846,53,30-34,1899,0.008971181967612306
SIM,1884,71,na,1955,2709
STAT,1858,19,20-24,1877,32.22211363761167
STAT,1882,36,15-19,1918,0.11101003625680786
STAT,1884,49,na,1933,4393.1102479370475
STAT,1871,84,na,1955,667.4936912143295
SIM,1808,49,40-44,1857,1
STAT,1942,30,na,1972,8145.933843745976
STAT,1950,17,na,1967,8789.095250645178
STAT,1926,39,45-49,1965,1.6787779727009609
SIM,1837,25,30-34,1862,59
STAT,1857,47,50-100,1904,0.384820311001482
STAT,1834,49,40-44,1883,0.23556958705132494
STAT,1882,46,50-100,1928,0.4845644964917767
SIM,1892,58,na,1950,5580
STAT,1921,32,40-44,1953,8.793163053146726
SIM,1900,59,na,1959,5759
SIM,1933,14,na,1947,11195
STAT,1815,45,15-19,1860,0.0022184023982256868
STAT,1831,29,50-100,1860,1.0919232782767012
STAT,1902,33,na,1935,6775.485147453897
STAT,1868,56,na,1924,3919.2105888725255
STAT,1877,43,25-29,1920,1.3369765956453388
SIM,1858,17,15-19,1875,13
SIM,1842,49,40-44,1891,1
STAT,1936,33,30-34,1969,30.893635486372293
SIM,1935,24,20-24,1959,285
STAT,1768,102,na,1870,0.14446589430382065
SIM,1919,27,40-44,1946,17
STAT,1850,46,20-24,1896,0.018451476737527554
SIM,1865,47,50-100,1912,2
SIM,1889,27,45-49,1916,6
STAT,1927,24,20-24,1951,274.90941961076766
STAT,1850,15,na,1865,4351.927053078464
STAT,1889,26,na,1915,5963.393381590946
STAT,1885,36,na,1921,4759.007550393406
STAT,1868,50,20-24,1918,0.001438307847354054
SIM,1890,36,15-19,1926,1
SIM,1921,31,50-100,1952,5
STAT,1922,19,50-100,1941,0.87076300542724
STAT,1772,83,na,1855,203.1343
SIM,1926,17,30-34,1943,32
SIM,1883,46,25-29,1929,1
SIM,1905,48,na,1953,6718
STAT,1895,16,15-19,1911,15.655902075458592
SIM,1818,66,na,1884,1759
STAT,1883,40,45-49,1923,2.999709037357915
STAT,1865,23,45-49,1888,1.2857081521854277
SIM,1910,25,50-100,1935,3
SIM,1830,69,na,1899,1783
STAT,1875,46,25-29,1921,0.12011070080152507
SIM,1896,48,na,1944,6222
STAT,1933,24,15-19,1957,14.252214881137537
SIM,1909,32,25-29,1941,23
STAT,1884,33,15-19,1917,0.2828009413185894
STAT,1951,17,15-19,1968,109.13719885459263
SIM,1941,24,15-19,1965,10
STAT,1834,22,35-39,1856,10.38877045351937
STAT,1817,64,na,1881,1991.1670326478556
SIM,1860,67,na,1927,2714
STAT,1832,43,na,1875,3290.7909097955676
STAT,1911,32,15-19,1943,0.2527950775005152
SIM,1899,70,na,1969,4529
STAT,1918,17,30-34,1935,5.374706597575448
STAT,1817,42,15-19,1859,0.07495550317422178
STAT,1852,43,20-24,1895,0.2512893685285267
STAT,1876,51,na,1927,4519.184908171865
SIM,1891,40,45-49,1931,7
SIM,1873,23,45-49,1896,2
STAT,1849,83,na,1932,627.9533344891754
STAT,1954,15,45-49,1969,1.247729970756196
SIM,1948,13,na,1961,9329
STAT,1840,39,15-19,1879,0.09389870706332885
SIM,1846,18,35-39,1864,1
SIM,1871,47,45-49,1918,2
SIM,1868,16,20-24,1884,35
STAT,1854,19,30-34,1873,2.8885373382087254
SIM,1922,1,na,1923,10093
STAT,1863,33,na,1896,4200.957734671847
STAT,1863,55,na,1918,3655.5121979256205
SIM,1879,15,25-29,1894,15
SIM,1814,98,na,1912,1
STAT,1860,50,na,1910,3582.12069031666
SIM,1834,39,40-44,1873,18
STAT,1921,1,na,1922,9611.423152787564
STAT,1856,23,25-29,1879,102.85614423862047
SIM,1829,48,50-100,1877,1
STAT,1850,37,na,1887,3669.5521058935365
STAT,1877,19,25-29,1896,11.82029445567212
STAT,1928,42,35-39,1970,0.5183697292879808
STAT,1886,83,na,1969,1566.880464835578
STAT,1915,46,30-34,1961,0.1818856474894107
SIM,1878,26,30-34,1904,71
STAT,1938,25,35-39,1963,30.070916326330522
STAT,1949,16,20-24,1965,318.51855581948735
STAT,1940,30,40-44,1970,8.18956643213823
SIM,1864,23,25-29,1887,119
STAT,1837,54,35-39,1891,0.011671851570484282
SIM,1866,19,20-24,1885,43
SIM,1828,30,30-34,1858,45
STAT,1839,33,45-49,1872,3.316171681701874
STAT,1789,91,na,1880,38.59131430346322
SIM,1844,42,25-29,1886,2
STAT,1910,42,na,1952,7091.393389329635
SIM,1928,32,35-39,1960,22
STAT,1826,53,20-24,1879,0.0013913172501138916
SIM,1878,22,15-19,1900,8
STAT,1891,47,20-24,1938,0.016819230034579587
SIM,1936,25,50-100,1961,2
STAT,1887,21,30-34,1908,40.3557253702802
SIM,1870,25,15-19,1895,3
SIM,1814,44,na,1858,2802
STAT,1937,17,40-44,1954,2.7486848164483164
SIM,1908,47,na,1955,6674
SIM,1946,25,35-39,1971,39
STAT,1849,16,45-49,1865,0.12794092861481351
STAT,1909,12,na,1921,7825.998252067173
SIM,1862,15,15-19,1877,17
STAT,1882,21,50-100,1903,0.8047076651994025
STAT,1865,14,na,1879,4915.113478736206
STAT,1929,23,50-100,1952,1.6751457004361647
STAT,1856,46,15-19,1902,6.250635947947413E-4
STAT,1917,43,30-34,1960,0.2690052246516297
STAT,1854,15,15-19,1869,11.012231197455792
STAT,1892,78,na,1970,2885.308162632155
SIM,1898,34,35-39,1932,44
SIM,1862,19,30-34,1881,4
STAT,1844,52,25-29,1896,0.005689595548979437
STAT,1862,25,15-19,1887,0.7974797598916803
SIM,1895,21,30-34,1916,59
STAT,1863,47,45-49,1910,0.41527943571497117
SIM,1863,43,30-34,1906,4
SIM,1945,17,40-44,1962,3
STAT,1893,44,20-24,1937,0.02785004313405862
SIM,1879,34,25-29,1913,25
SIM,1847,33,45-49,1880,1
STAT,1860,32,50-100,1892,1.5027186032253164
STAT,1874,43,40-44,1917,4.617710793304458
SIM,1915,36,30-34,1951,5
SIM,1835,60,na,1895,2555
SIM,1910,32,30-34,1942,43
STAT,1828,29,30-34,1857,64.0958068444585
STAT,1878,15,25-29,1893,12.00836878306698
SIM,1888,40,30-34,1928,5
SIM,1846,52,na,1898,3338
STAT,1817,41,45-49,1858,8.438276236829134
STAT,1780,92,na,1872,20.3602690287021
STAT,1807,52,40-44,1859,0.0685721569105309
STAT,1834,45,25-29,1879,0.0916753413942462
STAT,1834,84,na,1918,442.0887136677053
SIM,1837,21,15-19,1858,5
STAT,1854,51,30-34,1905,0.009168843185786422
STAT,1818,60,na,1878,2273.7972616050383
STAT,1822,33,na,1855,3201.623502197976
SIM,1883,22,na,1905,4908
STAT,1819,45,na,1864,2893.4168895959806
STAT,1849,33,35-39,1882,16.705632135741876
STAT,1860,44,50-100,1904,1.7092808324069622
SIM,1839,50,na,1889,2987
SIM,1956,3,na,1959,10711
STAT,1902,32,30-34,1934,49.78369825900343
SIM,1909,37,25-29,1946,3
STAT,1855,30,25-29,1885,16.056386382067892
STAT,1846,20,30-34,1866,34.1524130976938
SIM,1930,34,40-44,1964,14
STAT,1893,23,na,1916,6035.528424772839
STAT,1858,43,15-19,1901,0.021585386179550737
SIM,1820,59,na,1879,2228
STAT,1901,39,40-44,1940,2.6445402176946513
STAT,1939,7,na,1946,8064.3254846968275
STAT,1897,45,50-100,1942,0.3777339685217931
SIM,1872,39,50-100,1911,4
STAT,1869,21,50-100,1890,0.8004304690322946
SIM,1818,88,na,1906,95
STAT,1787,82,na,1869,315.28443423882595
STAT,1841,35,15-19,1876,0.09800955514825242
STAT,1881,20,na,1901,4644.313362300805
SIM,1812,61,na,1873,2132
SIM,1836,29,30-34,1865,42
SIM,1882,43,40-44,1925,8
STAT,1841,43,45-49,1884,2.2277559884514577
STAT,1852,48,40-44,1900,0.2694318123277611
STAT,1884,17,50-100,1901,0.09770305703018543
STAT,1838,18,35-39,1856,0.9751481784681325
STAT,1907,36,30-34,1943,3.4310683429740427
STAT,1911,42,25-29,1953,0.13768948519851412
STAT,1869,101,na,1970,8.998405849187256
SIM,1854,20,30-34,1874,51
STAT,1862,20,15-19,1882,5.91430673095819
STAT,1902,33,50-100,1935,2.6015083541609156
STAT,1868,26,20-24,1894,22.619652473157068
SIM,1832,38,na,1870,3469
SIM,1892,40,50-100,1932,6
STAT,1928,25,45-49,1953,4.327072296012657
SIM,1849,94,na,1943,20
STAT,1913,29,50-100,1942,1.9891906018357426
STAT,1850,46,15-19,1896,6.150486835664737E-4
SIM,1857,33,35-39,1890,21
STAT,1890,80,na,1970,2430.9599596782664
SIM,1898,21,na,1919,6720
STAT,1883,16,45-49,1899,0.12993605059145583
STAT,1819,54,25-29,1873,0.013712977408209611
SIM,1913,4,na,1917,8505
SIM,1841,23,50-100,1864,3
STAT,1951,13,na,1964,9444.75275125758
STAT,1788,98,na,1886,1.2391367822266635
STAT,1875,23,35-39,1898,12.09652056685605
STAT,1907,34,15-19,1941,0.24064633980821584
SIM,1920,16,25-29,1936,139
STAT,1842,23,50-100,1865,0.7602643519605585
SIM,1876,42,na,1918,5020
STAT,1906,33,45-49,1939,2.9343427568255493
SIM,1840,90,na,1930,94
STAT,1901,46,na,1947,6380.376545605115
SIM,1904,44,40-44,1948,1
STAT,1799,109,na,1908,4.8383658605176616E-4
STAT,1917,24,30-34,1941,61.30114683792258
STAT,1812,54,30-34,1866,0.0379099523945138
STAT,1935,20,50-100,1955,1.8112170514003378
STAT,1854,72,na,1926,1936.0018250116004
SIM,1936,25,45-49,1961,3
STAT,1830,62,na,1892,2523.883094632408
SIM,1901,16,15-19,1917,16
STAT,1909,34,na,1943,7230.515612359669
SIM,1870,20,15-19,1890,3
STAT,1798,74,na,1872,881.4890668538371
STAT,1879,16,30-34,1895,3.375282164792301
STAT,1856,31,na,1887,3803.249834080687
SIM,1943,20,50-100,1963,6
STAT,1943,13,na,1956,8411.056639870229
SIM,1821,46,na,1867,2940
SIM,1925,24,30-34,1949,83
STAT,1912,16,25-29,1928,17.745896063710333
STAT,1908,46,25-29,1954,0.09768157637955545
SIM,1807,96,na,1903,8
STAT,1913,31,35-39,1944,18.44205493960758
STAT,1857,50,45-49,1907,0.023173695647705706
STAT,1835,69,na,1904,1900.676863150085
STAT,1897,24,25-29,1921,153.5751893028475
STAT,1905,21,35-39,1926,17.09561514165339
STAT,1868,40,50-100,1908,2.0504836169927154
SIM,1847,37,na,1884,3639
SIM,1912,29,50-100,1941,2
STAT,1822,43,35-39,1865,5.931937574229295
SIM,1863,24,na,1887,4431
SIM,1899,37,na,1936,6608
SIM,1909,40,na,1949,7194
STAT,1853,41,50-100,1894,1.6790829458601848
STAT,1867,54,20-24,1921,0.0013573375301091108
SIM,1830,43,35-39,1873,9
SIM,1941,26,30-34,1967,103
SIM,1859,70,na,1929,2341
SIM,1878,7,na,1885,5839
STAT,1763,106,na,1869,0.01170214954204555
STAT,1841,54,na,1895,3038.184769537578
STAT,1860,35,25-29,1895,4.766968429917171
STAT,1933,26,30-34,1959,105.13202725785455
STAT,1848,53,40-44,1901,0.016985098984991027
STAT,1889,72,na,1961,3528.5284363896735
SIM,1887,19,35-39,1906,2
SIM,1913,21,35-39,1934,23
STAT,1843,80,na,1923,866.5406445613659
STAT,1911,28,45-49,1939,3.391651550329217
STAT,1783,75,na,1858,689.9300213750469
SIM,1848,23,40-44,1871,5
SIM,1921,31,35-39,1952,35
SIM,1838,33,25-29,1871,23
STAT,1904,29,50-100,1933,1.8410486902685173
STAT,1865,36,15-19,1901,0.10352892454444408
STAT,1904,48,20-24,1952,0.019375022306682598
STAT,1872,43,30-34,1915,2.316671298084055
STAT,1896,19,35-39,1915,1.4552473211453996
STAT,1877,52,20-24,1929,0.001539295377790708
STAT,1844,12,na,1856,4900.5988712676
STAT,1901,35,25-29,1936,1.7737538882051305
SIM,1853,46,na,1899,3708
SIM,1898,7,na,1905,7343
SIM,1900,23,15-19,1923,10
STAT,1891,47,15-19,1938,5.606405079941599E-4
SIM,1895,63,na,1958,5026
STAT,1774,101,na,1875,0.19431437177715744
SIM,1837,28,35-39,1865,23
STAT,1892,42,45-49,1934,3.7792905631674576
SIM,1891,73,na,1964,3731
SIM,1834,64,na,1898,2271
SIM,1930,30,25-29,1960,26
SIM,1902,31,25-29,1933,36
STAT,1916,14,na,1930,8434.935716109476
STAT,1914,43,45-49,1957,0.33259151176679835
STAT,1899,40,40-44,1939,0.4365725349615773
SIM,1887,69,na,1956,3475
SIM,1918,24,20-24,1942,242
STAT,1866,40,45-49,1906,2.8171002213008838
STAT,1869,71,na,1940,2612.124093513886
SIM,1884,19,15-19,1903,12
SIM,1885,56,na,1941,4315
SIM,1845,30,30-34,1875,52
STAT,1829,28,35-39,1857,23.645407796288158
STAT,1867,71,na,1938,2524.6747164641397
SIM,1934,36,40-44,1970,7
SIM,1880,43,30-34,1923,3
SIM,1902,50,na,1952,6335
STAT,1865,81,na,1946,992.2007911841638
SIM,1927,32,40-44,1959,11
SIM,1892,49,30-34,1941,2
SIM,1849,19,20-24,1868,31
SIM,1900,49,40-44,1949,1
STAT,1872,51,25-29,1923,0.007223765431835475
STAT,1878,31,30-34,1909,36.97829545971285
SIM,1869,19,40-44,1888,3
STAT,1849,28,50-100,1877,1.1908579982022838
SIM,1920,35,35-39,1955,11
STAT,1836,18,25-29,1854,18.62638979742864
SIM,1832,22,45-49,1854,2
STAT,1867,17,15-19,1884,11.475067425136546
SIM,1949,8,na,1957,9616
STAT,1805,52,30-34,1857,0.04673834611595517
SIM,1879,41,40-44,1920,9
SIM,1847,23,25-29,1870,7
STAT,1820,84,na,1904,372.4189017624764
STAT,1799,82,na,1881,349.8081948420399
STAT,1909,63,na,1972,6128.6031605388835
STAT,1921,47,45-49,1968,0.4947053535950225
STAT,1831,110,na,1941,3.5679339624843093E-4
STAT,1878,34,na,1912,4990.35315723522
SIM,1887,36,50-100,1923,4
STAT,1853,46,40-44,1899,0.2716419475668562
SIM,1819,40,30-34,1859,3
SIM,1923,40,35-39,1963,2
STAT,1846,24,na,1870,3983.0662515311947
STAT,1912,35,35-39,1947,4.814359336653281
SIM,1875,17,15-19,1892,12
STAT,1915,49,35-39,1964,0.2608673061046648
STAT,1833,46,20-24,1879,0.01874913211942219
SIM,1879,38,40-44,1917,14
STAT,1852,41,na,1893,3700.345350013982
SIM,1863,18,35-39,1881,1
SIM,1886,31,30-34,1917,47
SIM,1908,28,50-100,1936,2
SIM,1849,27,na,1876,4227
STAT,1808,50,na,1858,2555.8974250786328
SIM,1843,18,15-19,1861,12
SIM,1830,38,50-100,1868,5
STAT,1926,43,na,1969,9230.658730510211
SIM,1854,47,45-49,1901,2
STAT,1831,50,25-29,1881,0.004961476439313107
STAT,1873,30,35-39,1903,20.948350907358446
STAT,1884,49,30-34,1933,0.1890147415025498
STAT,1867,93,na,1960,102.77031230352041
STAT,1871,19,30-34,1890,3.1809720994530255
STAT,1879,81,na,1960,1494.6772933160769
STAT,1837,30,30-34,1867,31.15821164832933
SIM,1887,34,na,1921,5812
STAT,1915,48,50-100,1963,0.45905426471199484
STAT,1916,36,na,1952,7818.401497663989
STAT,1831,52,50-100,1883,0.02033359143672764
STAT,1859,42,na,1901,3710.7187854696717
STAT,1821,40,20-24,1861,0.5345647619421421
STAT,1851,46,50-100,1897,0.3818057999917531
STAT,1862,48,40-44,1910,0.2918123619795499
SIM,1883,44,na,1927,4730
STAT,1885,48,35-39,1933,0.27790514390104776
SIM,1874,19,na,1893,4895
STAT,1907,19,20-24,1926,52.342490152875236
STAT,1796,101,na,1897,0.25422216163098277
SIM,1929,25,35-39,1954,55
SIM,1829,75,na,1904,1230
STAT,1806,51,35-39,1857,0.051253627425075214
SIM,1893,48,35-39,1941,1
SIM,1844,18,25-29,1862,6
SIM,1870,26,na,1896,4674
STAT,1918,48,na,1966,7872.36735139805
STAT,1922,30,25-29,1952,21.254743932769703
SIM,1902,53,na,1955,6201
STAT,1825,51,45-49,1876,0.03094556008310136
SIM,1892,36,25-29,1928,13
STAT,1951,10,na,1961,9448.909667754977
STAT,1855,18,35-39,1873,0.9783339130904397
STAT,1837,51,30-34,1888,0.008495125068803767
STAT,1856,33,45-49,1889,2.7221422362110475
STAT,1908,0,na,1908,8802.813109844254
STAT,1862,106,na,1968,0.20385017980832096
STAT,1897,47,15-19,1944,6.06288846224964E-4
STAT,1920,21,25-29,1941,207.9707679285027
STAT,1932,20,40-44,1952,8.963808829817095
STAT,1871,28,50-100,1899,1.2790342802853703
STAT,1920,52,na,1972,8061.9008068667945
SIM,1920,42,40-44,1962,1
SIM,1779,90,na,1869,37
SIM,1862,93,na,1955,52
STAT,1859,1,na,1860,5923.504255172471
STAT,1926,36,40-44,1962,3.6976626079649164
SIM,1880,30,25-29,1910,29
SIM,1890,20,40-44,1910,6
STAT,1949,19,25-29,1968,101.71423399230991
STAT,1827,42,na,1869,3242.69783432944
SIM,1870,48,40-44,1918,1
STAT,1860,52,45-49,1912,0.023674853220340228
STAT,1882,20,40-44,1902,4.124139599026429
SIM,1890,17,40-44,1907,1
STAT,1892,36,50-100,1928,3.1190371819727636
STAT,1892,30,45-49,1922,4.444337849663715
SIM,1949,18,50-100,1967,1
SIM,1879,19,40-44,1898,1
SIM,1915,26,na,1941,7775
STAT,1891,43,40-44,1934,5.574490052476478
SIM,1893,51,na,1944,5699
STAT,1884,36,25-29,1920,5.7695339794386244
STAT,1912,42,40-44,1954,0.4873381935409361
STAT,1872,30,25-29,1902,20.956940525266628
STAT,1830,94,na,1924,27.598437546858204
SIM,1803,81,na,1884,541
STAT,1945,22,40-44,1967,7.441908569956536
SIM,1873,31,na,1904,5172
SIM,1885,16,20-24,1901,30
SIM,1865,34,na,1899,4405
SIM,1836,20,na,1856,3701
STAT,1841,86,na,1927,321.92678366019567
STAT,1878,52,30-34,1930,0.012488876174715263
STAT,1831,79,na,1910,902.6484178432308
SIM,1849,49,na,1898,3610
SIM,1881,42,35-39,1923,5
STAT,1865,99,na,1964,12.598655493242129
STAT,1868,29,25-29,1897,80.70234962653471
SIM,1864,33,45-49,1897,4
SIM,1820,36,35-39,1856,17
SIM,1838,57,na,1895,2790
STAT,1838,50,35-39,1888,0.01205779240359201
SIM,1864,30,40-44,1894,14
STAT,1863,23,35-39,1886,10.446597797018981
STAT,1894,47,40-44,1941,0.24937559607086837
SIM,1868,21,50-100,1889,1
STAT,1874,47,20-24,1921,0.024699289973114578
SIM,1904,31,na,1935,7100
SIM,1880,37,45-49,1917,5
STAT,1898,54,na,1952,5723.125030454599
STAT,1815,49,30-34,1864,0.5040381401054788
STAT,1897,28,40-44,1925,8.058483831347973
SIM,1841,21,na,1862,3909
SIM,1940,20,40-44,1960,7
STAT,1891,11,na,1902,6456.549798364519
SIM,1886,19,na,1905,5302
STAT,1873,42,35-39,1915,3.7113166320498814
SIM,1798,94,na,1892,3
STAT,1841,52,40-44,1893,0.015193565139703167
STAT,1911,25,40-44,1936,9.245195833913971
SIM,1829,50,35-39,1879,1
STAT,1910,20,na,1930,7283.631080882718
SIM,1940,25,na,1965,7896
STAT,1790,69,na,1859,1248.1909981136166
SIM,1881,30,35-39,1911,21
STAT,1892,43,15-19,1935,0.03466311495762395
SIM,1864,43,50-100,1907,5
STAT,1836,51,20-24,1887,0.0010128054425050201
STAT,1875,45,50-100,1920,0.5157800936584455
STAT,1888,41,35-39,1929,4.342088853649172
STAT,1852,49,na,1901,3510.950078203115
STAT,1941,30,35-39,1971,19.400110830118013
SIM,1917,42,25-29,1959,1
STAT,1915,40,35-39,1955,0.41060842449613194
STAT,1945,25,na,1970,8306.99289625244
STAT,1868,41,15-19,1909,0.02665602093168058
SIM,1913,48,na,1961,7312
SIM,1938,19,15-19,1957,91
SIM,1859,29,25-29,1888,80
STAT,1858,15,50-100,1873,0.09117328182342314
STAT,1841,40,40-44,1881,3.479245843841513
SIM,1784,72,na,1856,918
SIM,1903,42,40-44,1945,1
STAT,1872,37,45-49,1909,4.046260721774709
STAT,1766,95,na,1861,2.872003349451976
SIM,1865,5,na,1870,5346
STAT,1857,47,20-24,1904,0.01880229607023738
STAT,1851,41,45-49,1892,2.330563343286594
SIM,1876,71,na,1947,2941
STAT,1935,18,na,1953,10137.622593660939
STAT,1930,40,na,1970,9896.328228812594
SIM,1910,47,35-39,1957,1
SIM,1819,65,na,1884,1829
STAT,1845,61,na,1906,2879.4472256414324
SIM,1890,32,35-39,1922,39
STAT,1822,40,30-34,1862,4.080931268313576
SIM,1869,31,30-34,1900,55
SIM,1810,44,50-100,1854,2
STAT,1822,46,45-49,1868,0.7443212505781297
SIM,1849,27,15-19,1876,1
SIM,1860,19,20-24,1879,34
SIM,1899,18,15-19,1917,14
STAT,1881,53,50-100,1934,0.02900843268397261
SIM,1919,34,50-100,1953,3
STAT,1870,37,35-39,1907,14.024381429893939
SIM,1859,17,30-34,1876,2
SIM,1855,32,50-100,1887,2
STAT,1852,19,20-24,1871,33.77306849391545
SIM,1838,40,40-44,1878,9
STAT,1894,70,na,1964,4124.9731590353185
STAT,1847,104,na,1951,0.10167366292294815
STAT,1909,42,25-29,1951,0.13496670687327125
STAT,1764,116,na,1880,1.756560589411221E-4
STAT,1858,46,25-29,1904,0.09094397046937884
STAT,1850,42,40-44,1892,3.4445006677425107
STAT,1830,103,na,1933,0.19817747079274642
SIM,1840,41,35-39,1881,7
STAT,1930,38,20-24,1968,0.6937239496197524
SIM,1871,23,35-39,1894,13
STAT,1897,31,40-44,1928,11.75542626345613
STAT,1852,22,20-24,1874,130.47698517453065
STAT,1853,17,50-100,1870,0.09324552615766248
STAT,1917,19,50-100,1936,0.8071636075250647
STAT,1919,32,40-44,1951,8.52510161327706
STAT,1925,38,50-100,1963,1.0164878200296228
SIM,1929,24,50-100,1953,3
STAT,1841,16,40-44,1857,0.34429779101498165
SIM,1798,72,na,1870,974
STAT,1812,50,15-19,1862,1.6974332106315176E-4
SIM,1847,45,50-100,1892,2
SIM,1841,44,50-100,1885,3
STAT,1867,4,na,1871,5663.572088666308
STAT,1906,23,na,1929,6938.699054263111
STAT,1887,41,25-29,1928,1.4570627700780199
SIM,1904,63,na,1967,5745
SIM,1858,29,15-19,1887,1
STAT,1831,42,30-34,1873,1.8204376719988262
STAT,1902,47,35-39,1949,0.2241257577380884
SIM,1874,93,na,1967,125
SIM,1810,47,30-34,1857,1
STAT,1821,47,40-44,1868,0.5010931264056071
STAT,1925,43,20-24,1968,0.04310496489996864
STAT,1899,29,50-100,1928,1.757466179985714
STAT,1921,48,15-19,1969,8.361519618380818E-4
SIM,1849,43,20-24,1892,1
STAT,1899,17,na,1916,6988.702372357836
SIM,1838,37,40-44,1875,15
SIM,1868,19,30-34,1887,5
STAT,1906,30,40-44,1936,7.387257536328162
STAT,1877,40,20-24,1917,0.3364167084191832
STAT,1832,41,35-39,1873,2.925612187899999
STAT,1934,33,na,1967,10423.937122819096
SIM,1908,46,40-44,1954,1
STAT,1852,46,50-100,1898,0.39255116280952157
STAT,1932,40,35-39,1972,0.5527599812031665
SIM,1885,40,20-24,1925,2
STAT,1843,44,15-19,1887,0.019414037609065
SIM,1914,30,40-44,1944,8
SIM,1927,26,na,1953,9456
SIM,1952,18,na,1970,9098
SIM,1910,38,45-49,1948,3
STAT,1912,32,30-34,1944,31.318476589838326
STAT,1830,30,20-24,1860,5.534905612219036
STAT,1839,46,15-19,1885,6.445621621199813E-4
STAT,1880,59,na,1939,4134.86187748798
STAT,1931,0,na,1931,11909.689944593121
SIM,1810,51,na,1861,2625
STAT,1873,54,45-49,1927,0.028961349792769108
STAT,1851,42,15-19,1893,0.02138140141191194
STAT,1815,41,35-39,1856,11.294001111871697
STAT,1826,29,20-24,1855,50.20107233079941
STAT,1921,15,na,1936,8510.77155725913
STAT,1812,45,40-44,1857,1.2302124101201608
STAT,1935,32,25-29,1967,25.829903455890328
SIM,1927,35,45-49,1962,4
STAT,1802,53,25-29,1855,0.022250292967198413
STAT,1901,32,20-24,1933,7.642544488980052
STAT,1868,53,50-100,1921,0.028554379188539515
SIM,1861,42,25-29,1903,2
STAT,1879,51,35-39,1930,0.01827345571059057
STAT,1870,60,na,1930,3781.6078274889583
SIM,1896,47,50-100,1943,1
SIM,1861,12,na,1873,5282
SIM,1816,54,na,1870,2532
STAT,1899,47,25-29,1946,0.08948849227756457
SIM,1830,41,50-100,1871,4
SIM,1860,22,20-24,1882,123
STAT,1882,17,40-44,1899,0.3598428689819524
SIM,1854,40,25-29,1894,1
SIM,1827,91,na,1918,36
STAT,1813,53,35-39,1866,0.049616334450329036
STAT,1865,67,na,1932,2908.5754925962165
STAT,1833,57,na,1890,2641.916786599725
SIM,1869,15,na,1884,5090
SIM,1799,57,na,1856,1988
STAT,1917,5,na,1922,8709.114990145403
SIM,1848,64,na,1912,2578
SIM,1830,40,30-34,1870,4
STAT,1833,49,25-29,1882,0.07880791442748528
STAT,1914,46,15-19,1960,7.397976608313719E-4
STAT,1882,32,35-39,1914,19.923956007967597
STAT,1878,88,na,1966,676.6035655346899
STAT,1894,40,20-24,1934,0.41618149499903884
STAT,1933,25,50-100,1958,2.671776796067748
STAT,1837,33,35-39,1870,17.51822785361511
SIM,1944,17,25-29,1961,109
STAT,1890,4,na,1894,6485.055502224791
STAT,1913,40,25-29,1953,0.1422706399162418
SIM,1948,10,na,1958,9331
STAT,1838,34,na,1872,3569.7518381237
STAT,1822,41,50-100,1863,3.652098649385614
STAT,1925,46,25-29,1971,0.1301137534520611
SIM,1810,101,na,1911,4
SIM,1918,27,25-29,1945,163
STAT,1932,8,na,1940,10666.926408674095
SIM,1931,33,45-49,1964,7
STAT,1875,42,45-49,1917,3.1082096793935516
SIM,1845,33,35-39,1878,9
STAT,1888,22,50-100,1910,0.9734222645764653
STAT,1882,37,na,1919,4635.141651332708
STAT,1902,38,45-49,1940,1.2207822478494965
SIM,1933,38,50-100,1971,2
SIM,1883,42,45-49,1925,8
STAT,1834,48,50-100,1882,0.3423007747122778
STAT,1791,87,na,1878,116.76239672857514
STAT,1868,6,na,1874,5363.234325417421
STAT,1908,34,30-34,1942,29.797636448601946
STAT,1808,51,45-49,1859,0.08790943795150188
SIM,1823,41,35-39,1864,5
SIM,1878,52,na,1930,4695
STAT,1841,39,30-34,1880,8.923552911932829
STAT,1828,27,na,1855,3478.5066172825236
STAT,1922,40,35-39,1962,0.4679600608660102
SIM,1885,85,na,1970,1212
STAT,1883,9,na,1892,5148.461365050279
SIM,1774,84,na,1858,189
STAT,1917,46,40-44,1963,0.33338918727590056
STAT,1897,34,45-49,1931,4.66739009055552
SIM,1827,94,na,1921,14
STAT,1884,45,15-19,1929,8.056603187379317E-4
STAT,1923,33,45-49,1956,3.6398640476647817
STAT,1836,54,25-29,1890,0.0045810376586360845
SIM,1949,18,20-24,1967,330
SIM,1871,41,30-34,1912,5
STAT,1915,24,20-24,1939,230.7020040283556
STAT,1856,27,40-44,1883,4.836905414451721
STAT,1936,17,25-29,1953,83.80863693507642
SIM,1913,45,na,1958,7377
SIM,1921,38,20-24,1959,1
SIM,1904,34,na,1938,6991
STAT,1846,40,25-29,1886,1.0213431943940277
STAT,1878,34,35-39,1912,21.178142643073407
SIM,1930,40,35-39,1970,2
SIM,1890,41,40-44,1931,11
STAT,1846,44,40-44,1890,3.3987321172455633
STAT,1913,38,20-24,1951,0.5229202224398651
STAT,1876,19,15-19,1895,12.32996455512725
SIM,1916,34,30-34,1950,48
SIM,1797,79,na,1876,518
SIM,1911,21,25-29,1932,192
SIM,1862,90,na,1952,156
SIM,1912,5,na,1917,8356
STAT,1832,72,na,1904,1646.4586547589915
STAT,1912,45,45-49,1957,0.4239420911992676
SIM,1956,0,na,1956,10719
STAT,1864,23,50-100,1887,0.7426555769368096
STAT,1858,50,50-100,1908,0.024119746068733995
STAT,1894,31,15-19,1925,0.3709718708662363
SIM,1850,57,na,1907,3209
SIM,1886,34,35-39,1920,26
STAT,1857,19,na,1876,4197.199037635655
STAT,1802,52,20-24,1854,0.004730412711088592
SIM,1813,46,45-49,1859,1
STAT,1882,41,40-44,1923,4.445240873917051
STAT,1820,39,na,1859,3088.4480017424694
STAT,1915,35,50-100,1950,0.8648048955325727
STAT,1817,54,15-19,1871,1.0939820844529756E-4
SIM,1903,38,na,1941,6955
SIM,1819,43,35-39,1862,7
STAT,1827,40,15-19,1867,0.027206913341546783
STAT,1917,2,na,1919,8858.733771675448
SIM,1923,35,50-100,1958,1
STAT,1921,44,40-44,1965,0.5669378676020617
SIM,1941,25,50-100,1966,3
SIM,1852,83,na,1935,556
SIM,1844,15,20-24,1859,37
SIM,1885,29,50-100,1914,2
STAT,1863,41,30-34,1904,2.0416958165000407
STAT,1893,23,20-24,1916,175.8624810897263
SIM,1864,27,40-44,1891,6
SIM,1903,18,40-44,1921,1
STAT,1842,35,50-100,1877,2.189238508124328
SIM,1887,37,na,1924,5822
SIM,1814,76,na,1890,892
STAT,1850,25,15-19,1875,0.8305225982901753
STAT,1871,31,20-24,1902,5.445892747791566
STAT,1847,52,35-39,1899,0.013053287826199297
STAT,1826,32,20-24,1858,8.12652195669991
STAT,1903,21,25-29,1924,165.11030998260242
SIM,1854,44,40-44,1898,3
STAT,1873,34,50-100,1907,1.8640898830662342
STAT,1890,66,na,1956,4093.8656355463227
SIM,1834,32,20-24,1866,6
SIM,1852,16,na,1868,4575
STAT,1856,30,40-44,1886,6.983906703885673
STAT,1888,47,50-100,1935,0.5835300052760645
SIM,1872,23,50-100,1895,2
SIM,1878,24,50-100,1902,1
STAT,1817,45,25-29,1862,0.2870150298434523
SIM,1825,50,na,1875,2644
STAT,1824,52,40-44,1876,0.024555856048869566
SIM,1842,41,45-49,1883,6
STAT,1819,108,na,1927,0.001916672867211643
SIM,1834,29,20-24,1863,23
SIM,1850,35,50-100,1885,3
SIM,1897,44,na,1941,6262
SIM,1915,6,na,1921,8528
STAT,1766,98,na,1864,0.6589043173185389
STAT,1878,19,40-44,1897,0.38372859228436756
STAT,1893,77,na,1970,3112.605222392471
STAT,1791,65,na,1856,1596.4000431999998
STAT,1863,20,30-34,1883,32.584144432222594
SIM,1932,34,50-100,1966,3
SIM,1864,42,35-39,1906,6
SIM,1904,31,35-39,1935,24
SIM,1859,26,20-24,1885,24
STAT,1818,68,na,1886,1687.3488309602212
SIM,1932,36,30-34,1968,8
STAT,1874,41,na,1915,4801.07279969173
STAT,1854,54,35-39,1908,0.012834653528428183
STAT,1833,101,na,1934,0.7501576393448343
STAT,1867,33,20-24,1900,5.091056494572684
SIM,1875,33,20-24,1908,7
SIM,1915,19,20-24,1934,55
STAT,1947,15,35-39,1962,9.550774680083872
SIM,1885,19,25-29,1904,13
STAT,1902,42,15-19,1944,0.0027310257271465598
SIM,1829,72,na,1901,1535
STAT,1815,50,40-44,1865,0.056406419359514424
STAT,1945,25,45-49,1970,3.830934728521368
STAT,1832,94,na,1926,26.056206666233546
STAT,1835,83,na,1918,514.1544731920923
SIM,1823,32,45-49,1855,4
SIM,1903,16,na,1919,7484
STAT,1838,21,50-100,1859,0.7212196249859575
SIM,1861,75,na,1936,1796
STAT,1845,29,30-34,1874,46.5552091372492
STAT,1851,46,30-34,1897,0.15048371960372775
STAT,1885,33,na,1918,4776.947842099787
SIM,1890,23,45-49,1913,1
STAT,1793,103,na,1896,0.05209192167479984
STAT,1910,35,25-29,1945,1.92059233090359
SIM,1869,15,25-29,1884,18
SIM,1863,6,na,1869,5218
SIM,1872,38,na,1910,4950
SIM,1878,29,35-39,1907,24
SIM,1898,29,na,1927,6693
SIM,1923,24,20-24,1947,282
SIM,1852,61,na,1913,2986
STAT,1821,43,25-29,1864,1.9848306344261528
STAT,1899,24,35-39,1923,16.046495847085904
STAT,1832,53,45-49,1885,0.01929401169352437
STAT,1895,39,50-100,1934,3.1984471341116616
SIM,1820,41,25-29,1861,3
STAT,1924,36,30-34,1960,4.343210839251976
STAT,1902,44,30-34,1946,0.22456544805241355
SIM,1853,29,30-34,1882,59
SIM,1863,53,na,1916,3940
STAT,1882,23,45-49,1905,1.367668948227626
STAT,1842,31,na,1873,3938.54239508641
SIM,1955,15,35-39,1970,11
SIM,1901,32,20-24,1933,10
STAT,1916,43,20-24,1959,0.03649291896083248
STAT,1889,58,na,1947,4924.678218264444
STAT,1897,40,30-34,1937,0.21770152179534197
SIM,1903,16,25-29,1919,18
STAT,1839,23,25-29,1862,114.02440627406122
STAT,1935,36,40-44,1971,4.232236054599595
SIM,1928,22,na,1950,9270
SIM,1927,29,na,1956,9356
STAT,1807,76,na,1883,873.4115192324798
SIM,1947,9,na,1956,9314
STAT,1816,87,na,1903,173.05401725338263
STAT,1913,44,40-44,1957,0.49110471827627417
SIM,1800,92,na,1892,16
SIM,1918,29,40-44,1947,13
STAT,1849,52,45-49,1901,0.02283350611422373
SIM,1877,59,na,1936,3851
SIM,1918,15,na,1933,8793
STAT,1803,69,na,1872,1464.404471734675
STAT,1858,23,35-39,1881,9.523749157085325
STAT,1924,34,15-19,1958,0.3023152233711573
STAT,1889,40,na,1929,5813.600511467069
SIM,1930,21,35-39,1951,29
STAT,1880,26,50-100,1906,1.3656628304524636
STAT,1912,33,35-39,1945,18.0888292344237
SIM,1851,35,25-29,1886,8
SIM,1887,66,na,1953,3874
STAT,1891,26,15-19,1917,1.1365017329120692
SIM,1920,33,35-39,1953,27
STAT,1771,103,na,1874,0.07860107176554774
SIM,1930,15,na,1945,10089
SIM,1874,40,45-49,1914,6
SIM,1861,97,na,1958,10
STAT,1880,44,35-39,1924,3.800635146010473
STAT,1865,53,40-44,1918,0.019006106500684652
STAT,1857,30,na,1887,3859.0312634946663
STAT,1876,22,na,1898,4940.254798803449
SIM,1879,44,45-49,1923,8
STAT,1887,45,40-44,1932,0.3905605913511187
STAT,1934,24,30-34,1958,77.96582891614204
STAT,1890,37,na,1927,5807.85109811283
STAT,1844,97,na,1941,8.675709413526704
STAT,1843,35,25-29,1878,4.807244043116803
STAT,1909,46,40-44,1955,0.2934784142830802
SIM,1888,24,25-29,1912,156
STAT,1861,23,na,1884,4055.031318515269
SIM,1871,20,30-34,1891,43
SIM,1900,21,15-19,1921,7
STAT,1863,89,na,1952,185.72419154266518
SIM,1929,19,15-19,1948,113
STAT,1804,51,50-100,1855,0.09011601856202722
STAT,1805,95,na,1900,9.945187299132122
STAT,1939,10,na,1949,8017.802769221494
SIM,1827,39,30-34,1866,17
SIM,1852,47,35-39,1899,1
SIM,1886,81,na,1967,1612
STAT,1824,35,15-19,1859,0.18505867827031078
SIM,1942,24,30-34,1966,64
SIM,1920,32,30-34,1952,52
SIM,1785,76,na,1861,562
SIM,1838,34,50-100,1872,2
STAT,1856,51,40-44,1907,0.016483053946916102
SIM,1801,77,na,1878,633
STAT,1841,19,45-49,1860,0.12080347488623015
STAT,1844,47,35-39,1891,0.22503393022261714
SIM,1805,62,na,1867,1817
STAT,1853,30,15-19,1883,0.23689955676150806
SIM,1876,74,na,1950,2415
STAT,1868,53,25-29,1921,0.0066967924660298805
SIM,1866,23,35-39,1889,16
STAT,1819,39,30-34,1858,27.19986855557799
STAT,1881,52,na,1933,4180.782765844283
STAT,1932,29,na,1961,9900.562349587037
STAT,1841,22,45-49,1863,1.2817044255663346
STAT,1902,46,50-100,1948,0.3961437692031651
STAT,1953,19,50-100,1972,0.9146346393283037
SIM,1825,39,na,1864,2969
STAT,1919,35,45-49,1954,1.4870587373118134
STAT,1854,109,na,1963,0.005316065066230835
STAT,1956,11,na,1967,10497.659916314595
SIM,1821,55,na,1876,2485
SIM,1889,23,35-39,1912,20
STAT,1916,25,20-24,1941,38.37650598199833
SIM,1944,19,40-44,1963,6
SIM,1898,52,na,1950,5967
SIM,1901,38,30-34,1939,7
SIM,1918,16,35-39,1934,2
STAT,1941,17,25-29,1958,90.15151475226943
SIM,1889,21,40-44,1910,8
STAT,1829,74,na,1903,1313.4448753388351
STAT,1916,27,15-19,1943,1.4741730026987878
STAT,1825,84,na,1909,384.90319428860624
SIM,1919,43,40-44,1962,1
SIM,1936,31,na,1967,6629
SIM,1928,36,na,1964,9739
STAT,1848,17,45-49,1865,0.1327784395712797
SIM,1829,28,40-44,1857,9
SIM,1857,78,na,1935,1260
SIM,1910,26,na,1936,7618
STAT,1911,47,na,1958,7026.250379727717
STAT,1861,38,40-44,1899,7.322120223639772
SIM,1843,31,45-49,1874,6
SIM,1903,35,30-34,1938,8
STAT,1920,27,35-39,1947,33.25444066694586
SIM,1873,16,35-39,1889,1
STAT,1841,23,na,1864,3901.7456609276137
STAT,1856,76,na,1932,1476.2786520190089
SIM,1853,88,na,1941,158
STAT,1931,15,45-49,1946,1.326711391833314
SIM,1924,25,20-24,1949,55
STAT,1865,16,35-39,1881,1.0436129553680413
STAT,1922,24,35-39,1946,21.665264565094482
SIM,1933,18,25-29,1951,150
STAT,1830,42,50-100,1872,1.8936893879745007
STAT,1850,21,50-100,1871,0.7558883862753261
STAT,1876,16,50-100,1892,0.10258850448298056
STAT,1920,2,na,1922,9265.017281770914
STAT,1860,81,na,1941,886.8985822264881
STAT,1872,15,na,1887,5204.31374320082
SIM,1802,96,na,1898,3
SIM,1893,29,na,1922,6207
SIM,1907,28,25-29,1935,148
SIM,1912,28,35-39,1940,29
STAT,1844,106,na,1950,0.019607785268715944
STAT,1883,78,na,1961,1944.4200661807106
SIM,1855,30,25-29,1885,22
SIM,1848,40,50-100,1888,4
STAT,1926,8,na,1934,9874.236800494873
SIM,1950,15,20-24,1965,306
STAT,1900,33,15-19,1933,0.3972891653852484
STAT,1911,21,25-29,1932,177.51023716297567
STAT,1877,15,15-19,1892,12.503516341657281
SIM,1837,30,na,1867,3660
SIM,1793,94,na,1887,3
STAT,1807,54,50-100,1861,0.0944691535236536
SIM,1823,46,50-100,1869,2
STAT,1862,51,30-34,1913,0.010324461715038886
SIM,1866,101,na,1967,5
STAT,1816,48,na,1864,2887.3139617470924
SIM,1903,33,35-39,1936,23
STAT,1904,28,35-39,1932,27.871278621208965
SIM,1861,83,na,1944,619
SIM,1860,44,25-29,1904,1
STAT,1908,47,50-100,1955,0.41338794574668564
SIM,1837,34,50-100,1871,1
STAT,1847,30,25-29,1877,18.716609625936357
STAT,1911,36,25-29,1947,1.9304700119915343
SIM,1868,16,25-29,1884,19
STAT,1903,4,na,1907,7564.706743804874
STAT,1931,33,45-49,1964,4.161822673259116
STAT,1925,18,25-29,1943,105.42597445468482
SIM,1895,25,50-100,1920,3
STAT,1870,53,50-100,1923,0.029465325820526318
SIM,1906,29,20-24,1935,29
SIM,1930,22,40-44,1952,15
STAT,1859,17,20-24,1876,33.08069727062127
STAT,1813,50,50-100,1863,0.0924502415732352
STAT,1921,25,30-34,1946,88.77177237750752
STAT,1835,31,45-49,1866,2.9067091030161363
SIM,1831,36,50-100,1867,4
SIM,1950,17,15-19,1967,94
STAT,1902,29,40-44,1931,8.480342731316913
SIM,1826,78,na,1904,826
SIM,1826,86,na,1912,191
STAT,1928,42,30-34,1970,0.3291079498161294
SIM,1822,96,na,1918,8
STAT,1777,100,na,1877,0.3801703270505683
SIM,1920,32,25-29,1952,26
STAT,1896,25,25-29,1921,113.55893560382061
SIM,1888,22,na,1910,5552
SIM,1910,29,40-44,1939,14
STAT,1848,18,50-100,1866,0.09899728092165365
STAT,1904,26,40-44,1930,8.713159049524233
STAT,1923,16,50-100,1939,0.890398437459227
STAT,1850,51,na,1901,3317.1828037104788
SIM,1907,26,30-34,1933,91
STAT,1926,45,30-34,1971,0.2231560888296181
STAT,1929,41,35-39,1970,0.5273767400454709
SIM,1851,53,na,1904,3306
STAT,1798,97,na,1895,2.908265636323066
STAT,1839,24,40-44,1863,4.12082349152173
STAT,1889,18,45-49,1907,0.16224205704421762
STAT,1909,48,35-39,1957,0.2387333169373121
STAT,1862,17,na,1879,4538.134037409156
SIM,1800,61,na,1861,1900
STAT,1873,20,25-29,1893,118.17210791059404
SIM,1852,47,na,1899,3641
SIM,1899,43,45-49,1942,1
STAT,1843,54,25-29,1897,0.004825270539595953
SIM,1911,28,45-49,1939,6
STAT,1870,46,40-44,1916,0.34042381505087427
STAT,1811,43,25-29,1854,4.938053726548684
STAT,1903,28,45-49,1931,3.181507437173667
SIM,1905,30,35-39,1935,27
STAT,1867,48,na,1915,4201.93488351339
STAT,1856,37,50-100,1893,1.9131131942679334
STAT,1892,49,25-29,1941,0.08043218492321785
STAT,1907,32,15-19,1939,0.2427244496505233
STAT,1912,32,25-29,1944,18.37273516734193
SIM,1912,26,40-44,1938,11
SIM,1806,49,50-100,1855,1
SIM,1867,60,na,1927,3799
STAT,1936,19,40-44,1955,2.6905560479454746
STAT,1871,0,na,1871,7467.543805446426
SIM,1842,37,na,1879,3628
STAT,1915,27,25-29,1942,135.59863687956008
SIM,1851,73,na,1924,1714
SIM,1797,76,na,1873,701
SIM,1869,31,50-100,1900,4
SIM,1834,73,na,1907,1405
STAT,1888,19,40-44,1907,0.4342601078274301
STAT,1900,15,15-19,1915,16.703631556750793
STAT,1826,58,na,1884,2513.317023235586
STAT,1855,35,na,1890,3586.3990013871253
STAT,1898,20,30-34,1918,48.97300021279193
STAT,1911,5,na,1916,8101.75538444171
SIM,1917,48,35-39,1965,2
SIM,1830,91,na,1921,53
SIM,1922,28,20-24,1950,48
STAT,1834,111,na,1945,1.4263819231536667E-4
STAT,1854,2,na,1856,5491.9811565710515
SIM,1913,25,45-49,1938,7
STAT,1835,48,40-44,1883,0.23084804343228235
STAT,1914,28,20-24,1942,37.04013284689848
SIM,1865,21,25-29,1886,115
STAT,1927,44,35-39,1971,0.5082668675203285
SIM,1867,17,20-24,1884,37
STAT,1922,22,40-44,1944,7.78525042611816
STAT,1942,17,15-19,1959,95.7869507049431
STAT,1905,25,45-49,1930,3.2649531388762987
SIM,1909,23,30-34,1932,79
STAT,1925,44,50-100,1969,0.286239919558429
STAT,1940,5,na,1945,8211.798132331618
STAT,1864,71,na,1935,2409.7282185915874
SIM,1888,24,30-34,1912,54
STAT,1835,94,na,1929,25.884805778700944
SIM,1899,15,45-49,1914,2
STAT,1918,39,45-49,1957,1.4478520817693403
STAT,1912,21,50-100,1933,1.2777515306310943
STAT,1940,20,35-39,1960,19.38682458157246
SIM,1893,39,40-44,1932,11
STAT,1937,35,35-39,1972,4.8941676899664035
SIM,1820,81,na,1901,494
STAT,1930,26,na,1956,9624.472921619432
STAT,1906,24,50-100,1930,1.192591558777986
SIM,1904,31,30-34,1935,36
SIM,1814,73,na,1887,1191
SIM,1854,42,na,1896,3852
SIM,1942,21,20-24,1963,272
SIM,1921,31,30-34,1952,58
STAT,1796,62,na,1858,1828.7944311710664
STAT,1874,81,na,1955,1118.2549297722874
STAT,1874,21,25-29,1895,118.73644486752933
STAT,1913,19,45-49,1932,0.20521958367107787
SIM,1925,21,20-24,1946,248
SIM,1923,27,25-29,1950,178
STAT,1874,10,na,1884,5473.866886604832
SIM,1852,27,50-100,1879,2
SIM,1858,42,45-49,1900,6
STAT,1930,19,45-49,1949,1.2973185670361032
SIM,1916,11,na,1927,8616
SIM,1843,48,40-44,1891,1
STAT,1937,33,40-44,1970,7.8159966745157465
SIM,1925,23,15-19,1948,14
STAT,1864,18,40-44,1882,0.33956917550002813
STAT,1816,56,na,1872,2502.977669013687
STAT,1810,47,25-29,1857,0.37572255463540943
STAT,1782,82,na,1864,317.8834063650317
STAT,1905,43,45-49,1948,0.30136322488651296
SIM,1865,65,na,1930,3075
SIM,1943,13,na,1956,8599
STAT,1837,23,50-100,1860,0.7388637345962251
SIM,1888,27,35-39,1915,29
STAT,1799,106,na,1905,0.00825709910023848
STAT,1908,33,15-19,1941,0.24410443145411231
SIM,1926,39,45-49,1965,4
STAT,1934,21,20-24,1955,301.94051346051214
STAT,1829,34,25-29,1863,18.613583450051735
STAT,1920,45,35-39,1965,0.2891247391404541
SIM,1842,17,na,1859,4272
SIM,1881,3,na,1884,4938
STAT,1885,39,40-44,1924,8.71150832137235
SIM,1879,14,na,1893,5375
STAT,1917,21,20-24,1938,239.37758384311834
STAT,1805,64,na,1869,1905.9951583399493
STAT,1871,53,na,1924,4250.995243260757
SIM,1843,78,na,1921,1099
SIM,1826,48,40-44,1874,1
SIM,1847,24,40-44,1871,5
STAT,1864,51,na,1915,3905.7325311594677
STAT,1942,15,20-24,1957,286.30007769812596
STAT,1821,53,35-39,1874,0.023760191593445574
STAT,1807,51,na,1858,2675.9760639486835
STAT,1873,88,na,1961,490.313709201948
STAT,1841,15,na,1856,4346.55527719819
SIM,1906,27,25-29,1933,130
SIM,1929,30,50-100,1959,4
STAT,1847,18,40-44,1865,0.34592873425177345
STAT,1890,12,na,1902,6366.287692644265
SIM,1837,34,25-29,1871,22
SIM,1916,31,20-24,1947,6
STAT,1889,15,40-44,1904,0.4575873903925341
STAT,1869,21,15-19,1890,6.475481748993545
STAT,1887,68,na,1955,3451.881422152553
SIM,1892,1,na,1893,7667
SIM,1847,26,35-39,1873,31
STAT,1847,48,na,1895,3386.434297250422
SIM,1848,23,45-49,1871,1
SIM,1905,59,na,1964,6174
STAT,1842,96,na,1938,12.783939395396256
STAT,1859,24,50-100,1883,0.670391343103069
SIM,1884,32,45-49,1916,3
STAT,1914,30,35-39,1944,18.73039575682886
STAT,1891,73,na,1964,3510.1649796682814
SIM,1867,49,40-44,1916,1
STAT,1891,53,na,1944,5288.970751935482
SIM,1863,78,na,1941,1380
STAT,1824,43,na,1867,2900.6073617683833
SIM,1921,19,45-49,1940,2
SIM,1811,45,na,1856,2717
SIM,1848,22,na,1870,3944
SIM,1872,18,40-44,1890,1
SIM,1897,17,35-39,1914,2
STAT,1876,49,40-44,1925,0.35014610374451327
STAT,1903,41,15-19,1944,0.002770092714820948
STAT,1875,35,na,1910,4945.430329748973
STAT,1889,17,35-39,1906,1.3664135351340876
STAT,1860,54,30-34,1914,0.009494207139768018
STAT,1902,30,na,1932,6858.891984118083
SIM,1884,49,40-44,1933,1
SIM,1941,22,15-19,1963,11
SIM,1786,92,na,1878,13
SIM,1874,30,na,1904,4671
SIM,1812,86,na,1898,177
STAT,1876,32,45-49,1908,3.6425999581757056
STAT,1928,43,40-44,1971,0.6428680352236732
STAT,1891,39,50-100,1930,3.034068045764106
STAT,1917,23,15-19,1940,11.389843204384231
SIM,1866,20,30-34,1886,44
STAT,1913,31,30-34,1944,31.795296601176677
SIM,1901,23,30-34,1924,63
STAT,1908,31,20-24,1939,4.672029121401836
SIM,1882,37,na,1919,4878
STAT,1820,61,na,1881,2197.0898962632064
SIM,1878,35,25-29,1913,9
STAT,1839,26,35-39,1865,19.117177211388253
SIM,1927,6,na,1933,10308
STAT,1831,33,na,1864,3586.2549250413235
STAT,1897,1,na,1898,7348.064868209405
STAT,1903,45,35-39,1948,0.2293519025498404
STAT,1933,22,15-19,1955,14.26191133359362
STAT,1904,57,na,1961,6073.521219479332
SIM,1939,18,20-24,1957,267
SIM,1888,25,40-44,1913,10
STAT,1834,49,35-39,1883,0.19263868144416224
STAT,1858,20,30-34,1878,32.64359683896077
SIM,1806,86,na,1892,120
STAT,1922,21,30-34,1943,66.7488055825052
SIM,1803,58,na,1861,2243
SIM,1931,20,35-39,1951,37
SIM,1916,19,35-39,1935,9
SIM,1942,23,15-19,1965,15
STAT,1908,19,35-39,1927,1.636147884520495
STAT,1934,23,15-19,1957,14.445155431789113
SIM,1817,41,45-49,1858,5
STAT,1915,29,na,1944,7662.418825332185
SIM,1868,22,na,1890,4551
SIM,1930,21,30-34,1951,85
SIM,1902,37,35-39,1939,9
STAT,1909,49,45-49,1958,0.401192634534717
STAT,1934,22,50-100,1956,1.7861465476141858
STAT,1938,32,45-49,1970,3.196035910983773
STAT,1920,41,15-19,1961,0.0034295542778598137
STAT,1778,77,na,1855,676.72008
STAT,1859,49,40-44,1908,0.269456137302904
STAT,1852,43,50-100,1895,1.6716205500850996
STAT,1923,20,35-39,1943,22.251466690502806
STAT,1836,56,na,1892,2711.863059407504
SIM,1922,15,45-49,1937,1
STAT,1912,35,30-34,1947,3.6277092390774786
STAT,1933,25,20-24,1958,48.99826839725374
STAT,1927,43,25-29,1970,0.18055932992384224
SIM,1862,37,na,1899,4299
STAT,1907,22,na,1929,7020.321307372246
SIM,1912,29,45-49,1941,4
STAT,1818,82,na,1900,478.6869459437749
STAT,1878,63,na,1941,3763.6341639241577
SIM,1900,5,na,1905,7676
SIM,1905,31,45-49,1936,5
STAT,1908,47,na,1955,6714.578310763461
SIM,1905,28,20-24,1933,5
STAT,1779,100,na,1879,0.37054748973518126
STAT,1937,6,na,1943,7876.452870398258
SIM,1890,21,50-100,1911,1
STAT,1841,37,50-100,1878,2.0988024859557233
STAT,1941,16,15-19,1957,94.43872087717723
SIM,1895,49,50-100,1944,1
STAT,1823,38,na,1861,3405.3998086281517
SIM,1902,18,25-29,1920,23
STAT,1920,26,25-29,1946,146.2895654324917
STAT,1862,54,35-39,1916,0.014452301811144989
STAT,1838,33,50-100,1871,1.5249746673711582
STAT,1856,43,50-100,1899,1.6343097611541824
SIM,1839,30,40-44,1869,15
SIM,1849,63,na,1912,2873
STAT,1887,35,25-29,1922,6.5652741080617565
SIM,1924,45,50-100,1969,1
STAT,1902,25,50-100,1927,1.8363589488603245
STAT,1837,41,20-24,1878,0.2646214764050663
SIM,1879,34,30-34,1913,43
SIM,1920,16,na,1936,8493
SIM,1858,27,20-24,1885,19
STAT,1936,11,na,1947,7674.320776100487
SIM,1881,20,25-29,1901,113
STAT,1913,31,50-100,1944,1.6685435653181753
SIM,1923,44,45-49,1967,1
STAT,1904,29,45-49,1933,3.195476677945957
SIM,1826,31,45-49,1857,5
STAT,1849,74,na,1923,1755.46162503263
STAT,1914,15,45-49,1929,0.20970031693139715
STAT,1826,54,25-29,1880,0.0065470355016443394
SIM,1907,25,20-24,1932,36
STAT,1903,42,25-29,1945,0.1280712253321994
STAT,1916,40,15-19,1956,0.0031871414946235983
STAT,1885,22,45-49,1907,1.4018228942616486
STAT,1919,37,40-44,1956,3.247326892463754
SIM,1923,9,na,1932,9897
STAT,1919,19,40-44,1938,3.104322691274774
SIM,1867,103,na,1970,3
SIM,1918,44,35-39,1962,1
SIM,1877,21,15-19,1898,7
SIM,1878,32,20-24,1910,4
STAT,1879,29,40-44,1908,6.282832351019404
STAT,1778,97,na,1875,1.9777291272542912
SIM,1856,31,25-29,1887,25
STAT,1893,45,25-29,1938,0.0840027051114367
SIM,1790,66,na,1856,1626
STAT,1855,15,na,1870,4165.89159438746
STAT,1882,17,na,1899,4968.869106002752
SIM,1908,27,30-34,1935,84
STAT,1876,76,na,1952,1978.9933446558175
STAT,1931,28,20-24,1959,47.57449160639139
STAT,1826,41,45-49,1867,3.2267611583220583
STAT,1830,31,na,1861,3910.687914156708
STAT,1915,44,45-49,1959,0.3373030162484458
SIM,1864,101,na,1965,7
STAT,1910,38,30-34,1948,3.5042254715806567
SIM,1886,27,na,1913,4988
STAT,1893,32,45-49,1925,4.463972153203234
STAT,1835,51,50-100,1886,0.02034213034991559
SIM,1926,41,na,1967,9491
SIM,1927,19,40-44,1946,3
STAT,1819,76,na,1895,991.3410943706835
SIM,1913,22,40-44,1935,12
SIM,1833,88,na,1921,141
SIM,1854,34,25-29,1888,26
STAT,1888,30,15-19,1918,0.3426688492301203
STAT,1921,28,35-39,1949,33.666473396132425
STAT,1876,17,20-24,1893,37.03241536903809
STAT,1908,18,25-29,1926,16.94371800206308
SIM,1879,16,30-34,1895,5
SIM,1933,15,20-24,1948,383
STAT,1905,38,20-24,1943,0.4835519180083916
STAT,1910,23,30-34,1933,54.36255543269728
STAT,1922,25,45-49,1947,3.9738583551659423
SIM,1808,81,na,1889,362
STAT,1868,33,na,1901,4566.009444125335
STAT,1860,53,20-24,1913,0.0011908170733660511
STAT,1936,34,35-39,1970,17.90706351455952
STAT,1822,100,na,1922,1.1986857224998864
STAT,1911,33,20-24,1944,4.7780875567313394
SIM,1793,66,na,1859,1552
STAT,1909,2,na,1911,8077.977275585763
STAT,1852,31,45-49,1883,2.9076921646095513
STAT,1868,10,na,1878,5196.382364983387
STAT,1931,30,40-44,1961,10.368182702715835
SIM,1931,21,45-49,1952,6
STAT,1839,76,na,1915,1479.3029217467547
STAT,1925,15,20-24,1940,332.2312273887019
SIM,1810,91,na,1901,55
STAT,1848,31,25-29,1879,19.79024132483722
SIM,1921,47,45-49,1968,1
SIM,1892,67,na,1959,4759
STAT,1902,31,25-29,1933,29.32456154268494
STAT,1913,47,45-49,1960,0.42853396675485106
SIM,1930,25,45-49,1955,5
STAT,1795,69,na,1864,1468.394259097035
STAT,1858,21,40-44,1879,3.791462882782376
STAT,1905,22,40-44,1927,6.0863485580166365
STAT,1884,71,na,1955,2661.9534498478934
STAT,1815,94,na,1909,18.577053403604793
STAT,1860,61,na,1921,3064.7171244819324
SIM,1823,81,na,1904,575
STAT,1790,77,na,1867,619.35633254739
STAT,1895,43,na,1938,6059.245660520274
SIM,1884,60,na,1944,4054
STAT,1875,47,30-34,1922,0.20034284920730733
SIM,1941,25,20-24,1966,45
STAT,1921,40,25-29,1961,0.162849050684333
SIM,1840,81,na,1921,862
SIM,1916,18,25-29,1934,21
STAT,1852,44,25-29,1896,1.0096614407479083
SIM,1911,25,40-44,1936,15
SIM,1901,39,40-44,1940,2
STAT,1867,43,50-100,1910,1.9837645433737483
STAT,1923,21,45-49,1944,2.651189693367192
STAT,1899,21,30-34,1920,49.43786531475215
STAT,1838,28,40-44,1866,5.120121261460251
STAT,1846,34,25-29,1880,18.15905923303689
SIM,1852,21,45-49,1873,3
SIM,1860,31,45-49,1891,3
SIM,1895,32,na,1927,6606
STAT,1916,28,25-29,1944,136.9622193528103
SIM,1924,28,25-29,1952,177
SIM,1868,2,na,1870,6229
STAT,1901,16,15-19,1917,16.820374788368913
SIM,1880,25,50-100,1905,2
STAT,1842,17,na,1859,4388.503126737406
SIM,1864,24,40-44,1888,4
SIM,1908,16,na,1924,7642
STAT,1902,22,na,1924,6743.572274877265
STAT,1880,47,40-44,1927,0.3625423918317392
SIM,1902,36,25-29,1938,1
SIM,1903,24,na,1927,6924
STAT,1818,54,50-100,1872,0.06134792064097339
STAT,1863,31,20-24,1894,4.798268315398445
STAT,1856,24,40-44,1880,3.7172043185834522
STAT,1801,54,20-24,1855,0.004440150542302583
STAT,1928,25,50-100,1953,2.493008582491686
STAT,1945,27,40-44,1972,10.326754706562934
STAT,1903,25,40-44,1928,8.67237063337748
SIM,1907,44,30-34,1951,2
STAT,1951,21,20-24,1972,268.3716906105807
SIM,1943,21,na,1964,7988
SIM,1846,28,40-44,1874,8
STAT,1917,52,na,1969,7618.8396978835535
STAT,1887,22,50-100,1909,0.9211139881051336
SIM,1859,23,20-24,1882,136
STAT,1930,16,40-44,1946,3.6610477849117746
STAT,1918,43,50-100,1961,0.2518219715531022
STAT,1938,22,50-100,1960,1.3154303159914096
STAT,1844,21,45-49,1865,1.4161954884152517
STAT,1908,27,na,1935,7154.533570534129
STAT,1924,47,20-24,1971,0.026563950643762796
SIM,1848,21,25-29,1869,124
SIM,1904,2,na,1906,7755
SIM,1925,24,25-29,1949,256
STAT,1897,24,30-34,1921,47.78575467983593
STAT,1895,0,na,1895,7727.352835558781
STAT,1917,30,50-100,1947,1.7624587604368174
STAT,1919,19,na,1938,8169.11385600615
SIM,1910,31,25-29,1941,23
STAT,1834,46,30-34,1880,0.15210425188393092
STAT,1857,20,40-44,1877,3.8419190638266194
SIM,1841,20,25-29,1861,124
STAT,1823,58,na,1881,2569.3689882021554
STAT,1913,32,40-44,1945,7.865304081694136
SIM,1950,15,na,1965,8590
STAT,1851,48,25-29,1899,0.0881685798117404
SIM,1904,34,35-39,1938,23
SIM,1851,20,50-100,1871,1
STAT,1884,40,50-100,1924,2.1281096885662483
STAT,1812,66,na,1878,1835.2103367079958
STAT,1937,32,30-34,1969,31.48689889975249
STAT,1821,50,30-34,1871,0.01743961925678072
STAT,1918,36,40-44,1954,3.2014601118857735
STAT,1773,103,na,1876,0.09673021740091173
STAT,1799,59,na,1858,2040.7242653258113
SIM,1836,45,na,1881,3077
STAT,1900,33,45-49,1933,4.864918052160603
SIM,1911,42,30-34,1953,1
STAT,1924,7,na,1931,9611.069434468583
STAT,1915,44,15-19,1959,0.003112369457252896
STAT,1921,23,35-39,1944,21.40734618469724
STAT,1829,31,20-24,1860,5.332890130299401
STAT,1968,2,na,1970,9924.999663909874
STAT,1874,22,35-39,1896,12.067275665853384
SIM,1838,33,30-34,1871,45
SIM,1915,35,20-24,1950,1
SIM,1918,49,35-39,1967,2
STAT,1843,20,50-100,1863,0.7274315645129443
STAT,1926,17,30-34,1943,30.176204228880035
STAT,1909,47,25-29,1956,0.09849552410577836
SIM,1896,31,25-29,1927,41
SIM,1881,75,na,1956,1632
SIM,1827,40,na,1867,3321
SIM,1829,40,25-29,1869,2
SIM,1866,21,40-44,1887,4
STAT,1923,18,20-24,1941,320.57406530246413
SIM,1848,22,35-39,1870,19
STAT,1896,22,20-24,1918,183.7502245140884
SIM,1891,42,na,1933,5949
SIM,1901,20,20-24,1921,195
STAT,1831,25,na,1856,3751.9992367931677
STAT,1843,58,na,1901,2770.2535926918354
STAT,1924,19,20-24,1943,324.2260796542676
SIM,1917,29,25-29,1946,153
STAT,1901,37,na,1938,6713.778700295059
SIM,1921,8,na,1929,9227
SIM,1884,40,na,1924,5034
STAT,1872,24,25-29,1896,115.46634391702685
SIM,1875,55,na,1930,4658
SIM,1796,82,na,1878,332
STAT,1866,86,na,1952,413.46176909567055
SIM,1839,17,na,1856,4089
STAT,1917,24,25-29,1941,197.01133304666968
SIM,1903,32,25-29,1935,20
STAT,1917,42,25-29,1959,0.1504929500019068
SIM,1921,32,40-44,1953,13
SIM,1931,18,20-24,1949,389
STAT,1932,29,20-24,1961,48.24262794951203
SIM,1786,84,na,1870,205
SIM,1820,61,na,1881,2049
SIM,1932,19,20-24,1951,311
SIM,1937,26,45-49,1963,4
STAT,1881,12,na,1893,5041.2677066925735
STAT,1905,40,40-44,1945,0.46081269236269234
STAT,1917,32,na,1949,7997.837130063799
STAT,1909,29,25-29,1938,126.20215791569376
SIM,1865,20,40-44,1885,4
SIM,1882,14,na,1896,5367
SIM,1964,7,na,1971,10481
STAT,1843,89,na,1932,147.1608347789539
SIM,1819,73,na,1892,1139
SIM,1940,29,20-24,1969,40
SIM,1930,24,35-39,1954,28
STAT,1854,15,50-100,1869,0.09090998048211003
STAT,1938,19,15-19,1957,90.3685308814285
STAT,1878,42,20-24,1920,0.3345720155329188
STAT,1901,44,15-19,1945,0.0026747997274065554
STAT,1903,42,30-34,1945,0.2292888057049973
STAT,1850,91,na,1941,88.84963543643521
SIM,1887,29,40-44,1916,6
SIM,1917,47,25-29,1964,1
STAT,1907,35,20-24,1942,0.4985694112665548
STAT,1896,48,50-100,1944,0.36476234671994506
SIM,1836,20,15-19,1856,8
STAT,1855,53,40-44,1908,0.015620114379115617
STAT,1925,19,na,1944,8929.935547161385
STAT,1806,66,na,1872,1581.5103279647922
STAT,1905,5,na,1910,7654.310302469047
STAT,1904,25,30-34,1929,73.4910001567401
STAT,1949,17,50-100,1966,0.879963080138706
SIM,1892,27,na,1919,6848
SIM,1912,25,30-34,1937,105
SIM,1900,37,50-100,1937,2
STAT,1819,84,na,1903,348.09100793140954
SIM,1844,32,na,1876,3635
SIM,1844,71,na,1915,1896
SIM,1927,37,40-44,1964,6
SIM,1789,89,na,1878,46
STAT,1942,18,25-29,1960,91.43488083125352
SIM,1915,18,na,1933,8205
SIM,1933,34,30-34,1967,49
SIM,1837,31,20-24,1868,9
SIM,1950,18,25-29,1968,114
SIM,1906,24,20-24,1930,186
STAT,1864,20,na,1884,4401.279595861972
STAT,1883,15,40-44,1898,0.3646158927745
SIM,1920,35,30-34,1955,8
SIM,1933,16,30-34,1949,38
STAT,1868,25,15-19,1893,0.8777159908331905
SIM,1946,19,15-19,1965,99
SIM,1888,21,25-29,1909,140
SIM,1915,49,na,1964,7489
STAT,1889,32,25-29,1921,25.50646979928586
STAT,1898,21,40-44,1919,5.712426775271218
SIM,1838,32,na,1870,3771
STAT,1848,33,na,1881,4109.509085808567
SIM,1889,22,25-29,1911,156
STAT,1788,67,na,1855,1503.8674000000003
STAT,1888,31,25-29,1919,24.549680808350736
STAT,1931,41,50-100,1972,0.31743600278575573
STAT,1878,15,30-34,1893,3.3775700143062553
SIM,1934,17,30-34,1951,39
SIM,1831,53,na,1884,2928
SIM,1846,98,na,1944,5
STAT,1856,23,30-34,1879,32.00424820058747
STAT,1925,34,30-34,1959,37.72895443280013
STAT,1958,9,na,1967,10421.81321909327
SIM,1897,32,25-29,1929,32
SIM,1926,36,40-44,1962,7
STAT,1929,38,50-100,1967,1.0874157975740417
STAT,1943,24,na,1967,7841.166628328358
STAT,1818,106,na,1924,0.012456680887225353
STAT,1925,16,30-34,1941,29.803868544640242
STAT,1877,78,na,1955,1638.5782922761464
STAT,1899,22,40-44,1921,5.76618800365358
STAT,1923,36,15-19,1959,0.044964359662054906
STAT,1911,34,30-34,1945,30.728273937238004
SIM,1864,23,30-34,1887,35
SIM,1911,24,30-34,1935,76
SIM,1868,15,15-19,1883,13
STAT,1858,44,50-100,1902,1.6408458203231469
STAT,1861,7,na,1868,4782.25384915522
STAT,1901,21,50-100,1922,1.1564548886315726
STAT,1921,41,35-39,1962,0.4586060525056698
STAT,1862,48,na,1910,3834.87938704761
STAT,1808,92,na,1900,32.72814786614824
STAT,1915,26,15-19,1941,1.4593498298371743
SIM,1839,17,40-44,1856,3
STAT,1781,97,na,1878,1.8523081777120514
SIM,1940,16,na,1956,7739
STAT,1867,29,15-19,1896,0.852010827622681
STAT,1898,24,45-49,1922,1.8939101393658544
SIM,1866,47,30-34,1913,1
SIM,1900,26,15-19,1926,1
SIM,1900,24,20-24,1924,204
STAT,1820,100,na,1920,1.1885194655292106
SIM,1911,26,25-29,1937,132
STAT,1944,16,35-39,1960,9.1219709219015
STAT,1814,109,na,1923,6.123033091394424E-4
SIM,1936,27,40-44,1963,10
SIM,1952,16,35-39,1968,16
STAT,1779,109,na,1888,0.005523241298528837
SIM,1843,44,25-29,1887,1
STAT,1857,25,40-44,1882,4.927656292916587
SIM,1898,31,30-34,1929,62
SIM,1850,7,na,1857,4816
SIM,1879,25,na,1904,4957
SIM,1950,19,35-39,1969,13
STAT,1905,21,30-34,1926,52.182842473954786
STAT,1905,40,35-39,1945,0.3709842779406491
SIM,1839,96,na,1935,10
STAT,1901,33,30-34,1934,49.15674309641268
STAT,1935,19,25-29,1954,119.02645763426106
STAT,1955,16,45-49,1971,1.339497738579084
SIM,1925,27,30-34,1952,114
STAT,1848,50,35-39,1898,0.01431919440207104
SIM,1839,73,na,1912,1539
STAT,1814,52,40-44,1866,0.05227827487751739
STAT,1928,27,40-44,1955,11.595640219042311
SIM,1948,18,50-100,1966,1
STAT,1811,56,na,1867,2396.8175682527262
STAT,1949,18,na,1967,8642.321491890587
STAT,1888,53,na,1941,5057.365884593772
SIM,1877,22,25-29,1899,133
SIM,1920,15,40-44,1935,3
STAT,1907,34,50-100,1941,1.5483093902945646
STAT,1918,40,50-100,1958,0.25292058553980185
STAT,1912,38,35-39,1950,4.745412358160054
STAT,1942,19,35-39,1961,8.850537956478185
SIM,1828,33,na,1861,3611
SIM,1916,47,50-100,1963,1
SIM,1928,39,50-100,1967,2
SIM,1955,1,na,1956,10131
SIM,1821,86,na,1907,209
STAT,1762,107,na,1869,0.017968700513362964
SIM,1906,3,na,1909,7750
STAT,1869,22,25-29,1891,112.02620060862331
SIM,1920,38,35-39,1958,7
STAT,1822,96,na,1918,9.695051931355074
STAT,1829,43,na,1872,3046.9993223546285
STAT,1881,43,40-44,1924,4.359051314599703
STAT,1953,19,45-49,1972,1.2195128524377383
SIM,1872,46,45-49,1918,1
SIM,1845,44,25-29,1889,1
SIM,1856,32,35-39,1888,24
STAT,1925,45,15-19,1970,9.055682855576854E-4
STAT,1903,26,25-29,1929,122.05781272778815
SIM,1879,35,40-44,1914,11
STAT,1864,46,45-49,1910,0.427262683809296
STAT,1837,44,25-29,1881,0.9369781156158846
STAT,1848,32,35-39,1880,19.364876887459758
STAT,1912,15,40-44,1927,0.5740296097116809
STAT,1893,16,50-100,1909,0.1257212519928054
STAT,1811,47,40-44,1858,1.1621775921131383
SIM,1831,45,45-49,1876,1
STAT,1803,51,25-29,1854,0.02655101437386576
STAT,1857,61,na,1918,2941.600386803763
SIM,1896,17,na,1913,7030
STAT,1929,26,45-49,1955,4.368262066156657
STAT,1893,49,40-44,1942,0.24204857097025545
STAT,1928,24,na,1952,9149.342177427916
STAT,1919,34,35-39,1953,19.73730753814675
SIM,1934,7,na,1941,10824
SIM,1904,54,na,1958,6286
STAT,1892,30,50-100,1922,2.335160550662667
STAT,1889,33,35-39,1922,25.112329349436624
STAT,1860,36,30-34,1896,8.78301969900051
STAT,1924,34,na,1958,8897.52181601145
SIM,1897,33,35-39,1930,31
SIM,1935,29,45-49,1964,5
STAT,1785,111,na,1896,1.6773408551562022E-4
STAT,1927,29,45-49,1956,4.224032230636471
STAT,1873,24,40-44,1897,4.249323599427828
SIM,1889,5,na,1894,6675
STAT,1802,96,na,1898,6.590111360527874
SIM,1894,2,na,1896,7170
SIM,1951,5,na,1956,9806
STAT,1841,15,35-39,1856,1.0390131004030239
STAT,1863,34,25-29,1897,17.952874378263246
SIM,1907,22,15-19,1929,11
STAT,1924,35,20-24,1959,0.6287002383374928
STAT,1890,36,45-49,1926,4.937908162121255
SIM,1790,97,na,1887,2
STAT,1961,8,na,1969,10252.67037575616
STAT,1942,30,45-49,1972,3.389226878189654
SIM,1916,15,20-24,1931,59
STAT,1823,45,45-49,1868,0.7502677720107032
STAT,1857,23,45-49,1880,1.2581574358303933
STAT,1934,36,25-29,1970,2.747015830205367
STAT,1812,97,na,1909,5.09238258095253
STAT,1869,24,20-24,1893,134.0133518739567
SIM,1857,39,na,1896,4083
STAT,1858,47,30-34,1905,0.15169318004536392
SIM,1855,44,50-100,1899,5
SIM,1875,35,na,1910,5339
STAT,1912,36,40-44,1948,2.9658302051132552
SIM,1943,4,na,1947,8737
STAT,1905,15,50-100,1920,0.14375936999174074
SIM,1904,16,40-44,1920,4
STAT,1858,106,na,1964,0.10403540414394719
SIM,1943,19,25-29,1962,107
STAT,1944,26,40-44,1970,10.178134642478728
STAT,1835,44,25-29,1879,0.9717659285855792
STAT,1870,42,25-29,1912,1.271718841287079
STAT,1908,15,20-24,1923,53.395116881495525
SIM,1915,17,25-29,1932,29
SIM,1913,14,na,1927,8343
STAT,1896,40,15-19,1936,0.0025828607983930884
SIM,1901,23,25-29,1924,174
STAT,1875,91,na,1966,343.5117617196347
SIM,1847,91,na,1938,80
SIM,1865,25,40-44,1890,14
SIM,1931,16,50-100,1947,3
SIM,1913,40,35-39,1953,1
STAT,1918,17,na,1935,8516.627241482012
STAT,1859,73,na,1932,1909.2995524431217
STAT,1902,46,25-29,1948,0.0929066813726839
SIM,1879,37,35-39,1916,23
STAT,1905,50,na,1955,6379.479962320426
STAT,1868,26,25-29,1894,81.56223942212948
SIM,1860,81,na,1941,956
STAT,1922,43,45-49,1965,0.3850896436153046
STAT,1858,24,45-49,1882,1.129886907587563
STAT,1935,37,25-29,1972,2.781118338993528
SIM,1927,34,35-39,1961,34
SIM,1900,36,20-24,1936,1
STAT,1823,36,50-100,1859,4.9383430823483785
STAT,1900,30,40-44,1930,12.24751350565517
SIM,1920,36,40-44,1956,6
STAT,1907,17,25-29,1924,16.820903535774853
SIM,1880,24,25-29,1904,137
SIM,1843,47,na,1890,3358
STAT,1866,30,30-34,1896,32.797356930135734
SIM,1920,21,50-100,1941,4
STAT,1913,35,45-49,1948,1.3719682986630721
STAT,1785,70,na,1855,1372.8449999999998
STAT,1847,34,40-44,1881,6.918004310017585
SIM,1866,24,45-49,1890,1
STAT,1930,31,50-100,1961,2.156177285699896
STAT,1844,27,50-100,1871,1.264625402736079
SIM,1854,73,na,1927,1948
STAT,1826,89,na,1915,125.76010137946017
STAT,1775,100,na,1875,0.318504411811539
STAT,1895,12,na,1907,6796.209906086318
SIM,1896,15,25-29,1911,23
STAT,1945,24,35-39,1969,20.826086790379726
STAT,1833,21,35-39,1854,12.766190833175706
SIM,1910,16,30-34,1926,6
STAT,1867,17,na,1884,4883.520545067685
SIM,1928,32,30-34,1960,41
STAT,1802,53,30-34,1855,0.03739285381915095
SIM,1899,45,na,1944,6331
STAT,1822,33,25-29,1855,56.53379356477378
STAT,1851,45,20-24,1896,0.01878764804807497
SIM,1841,21,35-39,1862,13
STAT,1817,49,35-39,1866,0.6553735462477044
SIM,1908,23,15-19,1931,10
STAT,1887,17,na,1904,5704.820623582633
STAT,1897,25,40-44,1922,8.14181441843505
STAT,1916,47,35-39,1963,0.26707404296373216
STAT,1800,61,na,1861,2016.2894638150715
STAT,1840,42,40-44,1882,3.3867767494775203
STAT,1925,30,15-19,1955,0.30847662807192133
STAT,1888,15,25-29,1903,13.58969758162233
STAT,1897,27,35-39,1924,26.04865175514917
SIM,1879,43,50-100,1922,6
STAT,1926,12,na,1938,9809.522242737718
STAT,1902,16,30-34,1918,4.555835326036635
SIM,1885,15,15-19,1900,13
STAT,1793,74,na,1867,886.6709545446456
STAT,1789,69,na,1858,1400.7063876529517
STAT,1884,2,na,1886,6254.036870925176
SIM,1835,22,20-24,1857,122
STAT,1935,35,30-34,1970,5.156945259113972
SIM,1851,39,35-39,1890,14
STAT,1846,106,na,1952,0.01859753722532346
STAT,1954,17,40-44,1971,3.49179338051264
STAT,1808,81,na,1889,453.03460379716506
STAT,1911,37,35-39,1948,4.719600289690705
SIM,1857,30,30-34,1887,45
STAT,1936,15,50-100,1951,0.7279366607325986
SIM,1924,47,35-39,1971,1
STAT,1904,41,30-34,1945,0.2324689435444312
STAT,1916,22,15-19,1938,11.265307681491368
STAT,1854,10,na,1864,4432.610432626413
SIM,1924,22,15-19,1946,12
SIM,1838,36,35-39,1874,23
SIM,1919,39,na,1958,8211
SIM,1912,20,30-34,1932,67
STAT,1951,20,15-19,1971,12.852292114213828
STAT,1901,15,30-34,1916,4.527394709215648
STAT,1877,19,30-34,1896,3.324670722142158
SIM,1849,24,45-49,1873,1
STAT,1861,34,25-29,1895,17.070491035728743
SIM,1869,45,25-29,1914,1
STAT,1849,30,30-34,1879,32.65155573840015
STAT,1941,26,50-100,1967,2.080542282670342
SIM,1844,40,na,1884,3400
SIM,1904,35,45-49,1939,3
STAT,1843,39,35-39,1882,10.30923916998375
STAT,1800,72,na,1872,1192.5728389903973
SIM,1855,34,40-44,1889,10
STAT,1844,43,na,1887,3773.992736534768
SIM,1836,24,50-100,1860,1
STAT,1947,22,45-49,1969,2.5680870329841956
SIM,1923,13,na,1936,9832
STAT,1854,36,50-100,1890,1.891172756677022
STAT,1898,26,40-44,1924,8.215235050185814
SIM,1830,60,na,1890,2268
STAT,1820,46,50-100,1866,0.9272702716077718
STAT,1900,18,20-24,1918,49.53855629899444
SIM,1924,40,45-49,1964,1
SIM,1838,18,35-39,1856,1
SIM,1870,80,na,1950,1063
STAT,1921,21,15-19,1942,12.176569900676155
STAT,1881,24,50-100,1905,0.7910566728733165
STAT,1813,90,na,1903,70.05779424112522
STAT,1901,48,30-34,1949,0.1524437337356727
SIM,1826,55,na,1881,2498
SIM,1824,32,50-100,1856,3
SIM,1907,40,45-49,1947,1
STAT,1899,25,45-49,1924,3.093206615168711
SIM,1924,29,35-39,1953,45
STAT,1878,45,25-29,1923,0.12270697834366442
STAT,1921,41,30-34,1962,0.29116456688303133
STAT,1853,88,na,1941,217.21029653299095
STAT,1875,20,30-34,1895,37.25898877728287
STAT,1904,20,30-34,1924,51.94124542751683
SIM,1905,18,15-19,1923,17
SIM,1834,33,na,1867,3566
SIM,1839,35,40-44,1874,12
SIM,1865,25,na,1890,4487
SIM,1904,47,45-49,1951,1
STAT,1939,25,20-24,1964,37.097910126168706
SIM,1913,21,30-34,1934,81
STAT,1915,41,40-44,1956,0.5093529046430636
SIM,1779,82,na,1861,282
SIM,1864,26,35-39,1890,20
SIM,1825,49,35-39,1874,2
STAT,1831,23,25-29,1854,212.27722196067407
STAT,1876,42,20-24,1918,0.33132972325774795
SIM,1860,44,30-34,1904,6
STAT,1942,30,15-19,1972,0.2767781704234895
SIM,1897,67,na,1964,4715
STAT,1836,25,na,1861,3775.670008882023
STAT,1888,35,40-44,1923,10.548623378421055
STAT,1896,8,na,1904,6931.503674719501
STAT,1930,31,30-34,1961,41.08750754162971
STAT,1916,40,45-49,1956,0.34540643522957165
STAT,1922,39,na,1961,8625.048542736597
STAT,1892,19,50-100,1911,0.12320169821944273
STAT,1840,30,na,1870,3890.203952374382
SIM,1838,34,40-44,1872,11
STAT,1898,63,na,1961,5161.163258395149
SIM,1792,92,na,1884,8
SIM,1895,35,25-29,1930,11
SIM,1871,65,na,1936,3205
SIM,1905,28,na,1933,7403
STAT,1931,30,35-39,1961,24.211698101899074
SIM,1903,38,35-39,1941,5
STAT,1833,88,na,1921,180.4768247701035
SIM,1828,44,25-29,1872,3
STAT,1895,35,na,1930,6258.944226624053
SIM,1885,65,na,1950,3530
SIM,1894,39,na,1933,6277
SIM,1909,39,45-49,1948,1
STAT,1946,25,35-39,1971,33.80319170303311
SIM,1839,33,45-49,1872,2
STAT,1827,27,50-100,1854,3.8092137214522546
STAT,1916,29,35-39,1945,31.12728192565823
SIM,1881,72,na,1953,1981
STAT,1933,27,15-19,1960,1.8933124138046207
STAT,1886,21,15-19,1907,7.054563996695895
STAT,1870,54,20-24,1924,0.0014229305489059582
STAT,1938,16,45-49,1954,0.9978116165236609
SIM,1869,15,30-34,1884,4
STAT,1920,24,30-34,1944,64.11256952564587
SIM,1860,0,na,1860,6607
STAT,1918,19,25-29,1937,94.73380730064422
STAT,1878,18,35-39,1896,1.1543602007528897
STAT,1881,46,45-49,1927,0.46199916894172527
SIM,1855,38,50-100,1893,3
STAT,1893,19,15-19,1912,15.110256151113697
STAT,1853,15,25-29,1868,10.913584782599273
STAT,1849,43,na,1892,3629.505497795917
STAT,1929,29,15-19,1958,1.7824313005513477
SIM,1870,48,35-39,1918,1
STAT,1864,43,40-44,1907,4.031305874000897
SIM,1872,43,40-44,1915,12
STAT,1944,27,25-29,1971,143.6643730988687
STAT,1833,99,na,1932,2.489730248905921
STAT,1807,48,50-100,1855,1.657783407102119
STAT,1820,37,40-44,1857,21.767377521192227
STAT,1916,43,15-19,1959,0.0031732974723345008
STAT,1899,48,30-34,1947,0.14919628465341242
STAT,1916,26,30-34,1942,82.10196779925248
STAT,1924,17,25-29,1941,104.19404185238798
SIM,1853,37,50-100,1890,1
SIM,1890,32,na,1922,6242
SIM,1908,39,30-34,1947,7
STAT,1839,19,50-100,1858,0.09889424284330335
SIM,1891,15,40-44,1906,1
SIM,1918,46,na,1964,8168
STAT,1877,29,40-44,1906,6.23727155360752
STAT,1855,91,na,1946,87.38150509362636
STAT,1897,21,25-29,1918,155.00923095639106
SIM,1932,17,25-29,1949,141
STAT,1936,36,30-34,1972,3.617637286714564
SIM,1859,29,30-34,1888,49
STAT,1847,38,50-100,1885,1.9217057362224217
SIM,1889,24,45-49,1913,3
STAT,1839,23,30-34,1862,35.47931362129994
STAT,1874,40,35-39,1914,3.7823930896286635
STAT,1908,24,na,1932,7045.769384291268
SIM,1894,21,15-19,1915,9
SIM,1902,22,na,1924,6923
STAT,1761,97,na,1858,0.14044831982979133
STAT,1927,26,40-44,1953,11.481669551035052
SIM,1903,17,35-39,1920,2
STAT,1912,18,45-49,1930,0.20352777773010938
SIM,1950,16,30-34,1966,37
STAT,1889,30,30-34,1919,43.82825033987634
SIM,1878,4,na,1882,5942
STAT,1845,37,50-100,1882,1.9877732557634176
SIM,1818,38,40-44,1856,10
SIM,1831,45,na,1876,3345
SIM,1920,18,45-49,1938,1
STAT,1856,26,35-39,1882,15.692696480357373
SIM,1882,22,35-39,1904,18
SIM,1929,32,45-49,1961,4
SIM,1833,43,50-100,1876,5
STAT,1821,43,50-100,1864,3.2653665070785665
STAT,1826,28,15-19,1854,3.4869759447066904
STAT,1901,36,35-39,1937,4.337115349016786
SIM,1924,26,30-34,1950,113
SIM,1912,41,35-39,1953,1
STAT,1942,16,30-34,1958,25.73314473491433
SIM,1888,50,na,1938,5141
SIM,1922,30,35-39,1952,35
SIM,1897,30,30-34,1927,61
STAT,1798,66,na,1864,1495.016036460754
STAT,1874,25,40-44,1899,6.2365969616876535
STAT,1874,47,15-19,1921,8.233089415598888E-4
SIM,1841,52,na,1893,3055
STAT,1901,18,35-39,1919,1.5473385431778255
SIM,1900,39,25-29,1939,4
SIM,1882,40,35-39,1922,7
SIM,1859,73,na,1932,1902
STAT,1817,41,na,1858,3113.6895313776986
STAT,1851,49,40-44,1900,0.25985009756626243
STAT,1860,39,35-39,1899,11.483426465113762
STAT,1835,41,20-24,1876,0.24974611428328383
SIM,1869,34,50-100,1903,2
STAT,1865,21,50-100,1886,0.7627904887762041
STAT,1836,28,40-44,1864,5.117836079018857
STAT,1777,109,na,1886,0.0056666756866752925
SIM,1847,42,35-39,1889,9
STAT,1851,25,na,1876,3983.4375217808915
SIM,1901,69,na,1970,4926
SIM,1788,96,na,1884,2
SIM,1923,29,20-24,1952,42
STAT,1820,51,25-29,1871,0.012931300565923334
SIM,1871,73,na,1944,2178
SIM,1831,42,40-44,1873,5
SIM,1909,26,35-39,1935,39
STAT,1872,21,20-24,1893,140.29677376736907
SIM,1885,29,40-44,1914,7
SIM,1910,25,25-29,1935,157
STAT,1918,37,25-29,1955,2.095597156613148
SIM,1864,20,25-29,1884,145
SIM,1875,24,na,1899,5259
STAT,1902,25,25-29,1927,121.43429270280727
STAT,1864,43,na,1907,4142.361847758558
SIM,1880,21,20-24,1901,144
STAT,1953,16,40-44,1969,3.4178827819322803
STAT,1864,40,na,1904,4214.605141029977
STAT,1892,46,20-24,1938,0.01716262386744693
SIM,1878,21,30-34,1899,48
SIM,1912,21,na,1933,7570
STAT,1919,31,30-34,1950,34.46251175211137
SIM,1844,28,40-44,1872,6
STAT,1852,18,15-19,1870,11.372374874745494
SIM,1927,31,30-34,1958,56
STAT,1915,29,20-24,1944,37.336790328809585
SIM,1867,91,na,1958,137
SIM,1860,18,15-19,1878,12
STAT,1961,5,na,1966,10257.080290526226
SIM,1940,27,50-100,1967,4
STAT,1861,52,25-29,1913,0.0059224563820972935
STAT,1848,35,40-44,1883,7.552108528724503
SIM,1921,35,45-49,1956,3
SIM,1836,23,20-24,1859,126
STAT,1877,61,na,1938,3918.824419309403
SIM,1928,35,35-39,1963,7
STAT,1922,37,45-49,1959,1.5662110336835302
SIM,1938,21,35-39,1959,24
STAT,1874,50,na,1924,4516.552626490687
SIM,1926,19,25-29,1945,140
STAT,1806,89,na,1895,71.53258257357668
STAT,1909,45,30-34,1954,0.1671185871037007
SIM,1946,16,45-49,1962,2
SIM,1900,8,na,1908,7618
STAT,1909,18,40-44,1927,0.552814600208696
STAT,1882,16,35-39,1898,1.082179885161083
STAT,1920,35,50-100,1955,0.9297974112726113
STAT,1839,42,35-39,1881,2.9800145858686276
STAT,1798,107,na,1905,0.002552983567491842
STAT,1856,20,25-29,1876,105.1038653321533
STAT,1816,49,20-24,1865,0.05718166473138625
STAT,1823,42,40-44,1865,7.49070414670825
STAT,1911,18,30-34,1929,4.914568661263811
SIM,1863,33,50-100,1896,2
SIM,1854,70,na,1924,2211
STAT,1832,111,na,1943,1.399312673339717E-4
STAT,1857,21,25-29,1878,104.78594948502337
STAT,1894,16,25-29,1910,14.737849961022379
SIM,1899,49,50-100,1948,1
STAT,1883,46,50-100,1929,0.4887211816279084
STAT,1933,37,20-24,1970,0.7252300456091713
SIM,1817,41,na,1858,3118
STAT,1934,24,25-29,1958,250.56875244877995
SIM,1873,21,50-100,1894,1
SIM,1844,63,na,1907,2503
STAT,1848,17,40-44,1865,0.37177972120711306
STAT,1890,33,40-44,1923,10.645567732234243
SIM,1819,96,na,1915,8
STAT,1840,92,na,1932,60.11844442859323
STAT,1898,23,na,1921,6443.911924792174
SIM,1857,47,na,1904,3980
SIM,1864,104,na,1968,1
STAT,1861,31,20-24,1892,4.5624335434666055
SIM,1858,32,na,1890,4056
STAT,1902,43,20-24,1945,0.031218353400881933
STAT,1817,46,30-34,1863,0.4748668121036822
SIM,1835,25,25-29,1860,78
SIM,1912,23,35-39,1935,1
SIM,1930,37,45-49,1967,2
STAT,1902,19,35-39,1921,1.5561692984466582
SIM,1876,23,20-24,1899,137
STAT,1912,32,na,1944,7518.061184424035
SIM,1765,90,na,1855,42
SIM,1868,37,50-100,1905,4
STAT,1871,76,na,1947,1900.9796612279342
STAT,1836,18,30-34,1854,5.239007628020812
SIM,1935,16,50-100,1951,1
SIM,1854,21,15-19,1875,4
SIM,1942,24,25-29,1966,195
SIM,1859,25,15-19,1884,4
SIM,1864,40,na,1904,4451
STAT,1913,16,40-44,1929,0.5791320045129731
STAT,1863,58,na,1921,3496.195911389571
SIM,1875,32,na,1907,5296
STAT,1862,18,40-44,1880,0.35947305964484316
STAT,1906,36,15-19,1942,0.035841544481541754
SIM,1915,37,50-100,1952,1
SIM,1879,31,25-29,1910,25
STAT,1945,26,50-100,1971,2.2062358268523115
SIM,1793,63,na,1856,1728
SIM,1898,60,na,1958,5453
SIM,1924,44,30-34,1968,2
STAT,1847,37,45-49,1884,3.152843701205252
STAT,1839,73,na,1912,1854.5906689651588
STAT,1881,83,na,1964,1263.2993777918555
STAT,1874,47,50-100,1921,0.5055121147685309
SIM,1891,31,50-100,1922,6
STAT,1846,31,20-24,1877,4.943871978458736
STAT,1910,34,15-19,1944,0.24819136246259066
STAT,1891,50,na,1941,5452.521567483928
SIM,1848,25,na,1873,4172
STAT,1863,52,50-100,1915,0.026558022295760746
STAT,1855,33,50-100,1888,1.3922605291880663
STAT,1952,19,30-34,1971,29.477733742086926
SIM,1837,20,30-34,1857,40
STAT,1904,65,na,1969,5537.428529278605
STAT,1889,9,na,1898,6461.240574686498
SIM,1909,36,40-44,1945,3
STAT,1882,68,na,1950,3006.570773709482
STAT,1881,43,na,1924,4479.136146545744
STAT,1874,20,50-100,1894,0.8483072904006388
STAT,1923,24,na,1947,8524.951060160374
SIM,1849,21,40-44,1870,7
STAT,1901,15,50-100,1916,0.13916169432632944
SIM,1904,32,40-44,1936,13
STAT,1922,40,40-44,1962,0.5812697421112125
SIM,1758,97,na,1855,3
STAT,1907,47,20-24,1954,0.01999916990956808
STAT,1927,16,50-100,1943,0.9429851283584049
SIM,1902,34,30-34,1936,37
SIM,1924,21,50-100,1945,1
SIM,1945,15,45-49,1960,2
STAT,1916,21,50-100,1937,1.3967020928779101
SIM,1882,32,50-100,1914,4
STAT,1823,89,na,1912,126.0643777769893
STAT,1921,46,na,1967,8383.054541777841
SIM,1889,24,na,1913,5982
SIM,1882,47,50-100,1929,2
STAT,1884,37,30-34,1921,10.6286195969807
SIM,1932,35,20-24,1967,1
STAT,1868,23,20-24,1891,132.00800661634796
STAT,1810,44,20-24,1854,1.1160744384105645
STAT,1936,32,15-19,1968,0.2521358188633067
SIM,1930,40,40-44,1970,1
STAT,1916,44,30-34,1960,0.26371468610447907
SIM,1806,78,na,1884,596
SIM,1859,17,na,1876,4770
STAT,1930,31,35-39,1961,23.831766091662562
STAT,1897,67,na,1964,4728.829451588084
SIM,1854,31,20-24,1885,7
SIM,1926,37,25-29,1963,2
SIM,1915,22,50-100,1937,2
SIM,1892,37,30-34,1929,21
STAT,1906,21,45-49,1927,2.058374188076603
STAT,1839,84,na,1923,519.4297381504114
STAT,1879,40,15-19,1919,0.02946731456386457
SIM,1816,45,na,1861,2952
STAT,1933,1,na,1934,11291.448590734542
STAT,1945,21,30-34,1966,63.634023637056664
STAT,1828,81,na,1909,664.0889101517577
STAT,1943,17,30-34,1960,26.103435090524673
STAT,1840,45,45-49,1885,0.35243618902804613
SIM,1921,16,40-44,1937,3
STAT,1861,21,45-49,1882,1.2129592435915686
SIM,1914,21,45-49,1935,6
SIM,1844,18,30-34,1862,4
STAT,1917,36,25-29,1953,2.0751904398086456
SIM,1807,71,na,1878,1091
SIM,1911,36,na,1947,7500
STAT,1939,28,25-29,1967,133.58762482661874
STAT,1907,37,50-100,1944,0.7866085779896568
STAT,1894,26,50-100,1920,1.6653112593795594
STAT,1950,7,na,1957,9385.733394884739
SIM,1883,20,30-34,1903,38
SIM,1842,42,50-100,1884,3
SIM,1853,20,15-19,1873,1
STAT,1885,27,50-100,1912,1.28597116556733
STAT,1921,44,35-39,1965,0.4564219669627101
SIM,1935,26,40-44,1961,18
STAT,1907,37,15-19,1944,0.03597794366532606
SIM,1873,48,50-100,1921,2
STAT,1834,42,50-100,1876,1.695334301152096
SIM,1854,34,50-100,1888,2
SIM,1847,23,30-34,1870,1
SIM,1925,36,25-29,1961,3
STAT,1876,45,25-29,1921,0.1215178415673578
STAT,1971,1,na,1972,10070.734293063795
SIM,1922,28,na,1950,8854
SIM,1889,28,50-100,1917,1
STAT,1887,22,15-19,1909,7.451811305894699
STAT,1928,16,na,1944,9388.307979657211
STAT,1810,71,na,1881,1312.8648791618057
STAT,1855,43,30-34,1898,1.7211009380559301
STAT,1932,26,15-19,1958,1.8684262517157284
STAT,1898,22,25-29,1920,156.45727883518106
SIM,1851,36,30-34,1887,11
STAT,1917,27,30-34,1944,82.98210910088112
SIM,1895,24,na,1919,6523
STAT,1920,42,30-34,1962,0.28509923845741403
SIM,1878,83,na,1961,1159
SIM,1937,29,15-19,1966,1
STAT,1904,41,35-39,1945,0.3661560390756743
STAT,1775,103,na,1878,0.07838485625481603
STAT,1843,36,30-34,1879,8.806593951686672
SIM,1884,9,na,1893,5666
STAT,1939,19,na,1958,7436.842011730635
SIM,1876,26,25-29,1902,93
STAT,1842,39,20-24,1881,1.199935666895923
STAT,1908,34,25-29,1942,17.480546396069922
STAT,1800,64,na,1864,1802.904848400483
STAT,1929,39,20-24,1968,0.6819787183716364
SIM,1906,38,50-100,1944,3
SIM,1862,14,na,1876,5035
STAT,1844,51,na,1895,3493.817693720546
STAT,1939,31,50-100,1970,1.7049177026962608
SIM,1879,19,35-39,1898,1
SIM,1850,39,20-24,1889,3
SIM,1893,27,50-100,1920,3
STAT,1833,46,15-19,1879,6.249705209020419E-4
STAT,1946,22,30-34,1968,64.5894334839701
STAT,1845,36,na,1881,3854.2522267767345
STAT,1904,23,35-39,1927,16.86326881649456
SIM,1848,20,40-44,1868,3
STAT,1874,50,45-49,1924,0.030441698525182307
SIM,1851,22,na,1873,4086
STAT,1845,20,15-19,1865,6.402551874055089
STAT,1809,54,25-29,1863,0.025078384520890784
STAT,1846,21,15-19,1867,6.279973356980959
STAT,1940,18,20-24,1958,277.9416932754061
STAT,1843,107,na,1950,0.006606191592487099
SIM,1929,38,na,1967,9945
SIM,1875,29,15-19,1904,1
STAT,1854,53,25-29,1907,0.005342678463223038
STAT,1941,19,20-24,1960,281.85280523608867
SIM,1839,31,25-29,1870,27
STAT,1905,24,35-39,1929,16.93745795285359
STAT,1886,75,na,1961,2581.186309463179
STAT,1870,91,na,1961,224.3366290494128
STAT,1810,48,40-44,1858,1.0954165762727603
STAT,1865,32,35-39,1897,18.58125452192348
SIM,1805,93,na,1898,7
SIM,1916,34,25-29,1950,26
STAT,1927,40,20-24,1967,0.04484927078970188
SIM,1934,29,30-34,1963,127
STAT,1901,32,15-19,1933,0.4026390419947767
STAT,1815,63,na,1878,1995.4115316444888
SIM,1885,19,30-34,1904,3
STAT,1887,32,20-24,1919,6.105649287236454
STAT,1926,29,30-34,1955,94.16910134173169
STAT,1927,16,35-39,1943,10.561435394396684
SIM,1895,32,20-24,1927,10
STAT,1866,33,35-39,1899,18.79194406880627
SIM,1838,30,25-29,1868,6
STAT,1883,31,50-100,1914,1.8255114865325632
SIM,1844,38,50-100,1882,3
SIM,1829,47,45-49,1876,1
SIM,1813,71,na,1884,1260
STAT,1843,54,30-34,1897,0.00810913529053121
SIM,1919,25,45-49,1944,7
SIM,1913,24,35-39,1937,23
STAT,1967,3,na,1970,9922.148767098053
SIM,1935,16,35-39,1951,12
SIM,1853,77,na,1930,1258
SIM,1926,17,50-100,1943,1
STAT,1867,30,45-49,1897,3.3248204607845318
STAT,1862,93,na,1955,50.4489108218698
STAT,1826,29,25-29,1855,181.015684725983
SIM,1848,43,35-39,1891,8
SIM,1927,19,45-49,1946,1
SIM,1944,16,40-44,1960,1
SIM,1848,41,40-44,1889,2
STAT,1853,54,20-24,1907,0.0011354306263779632
STAT,1813,52,25-29,1865,0.020827960916076544
SIM,1851,76,na,1927,1321
SIM,1877,81,na,1958,1163
STAT,1834,100,na,1934,1.4108602952165679
SIM,1851,28,15-19,1879,1
STAT,1948,15,20-24,1963,313.4964786661805
SIM,1860,26,30-34,1886,55
SIM,1839,42,na,1881,3354
STAT,1944,24,20-24,1968,242.29134726954427
STAT,1835,29,35-39,1864,16.061299976284474
SIM,1845,17,35-39,1862,1
SIM,1876,35,25-29,1911,9
SIM,1896,38,45-49,1934,8
STAT,1843,28,15-19,1871,0.7765474399318725
SIM,1860,9,na,1869,4916
STAT,1831,52,45-49,1883,0.01953879310646922
STAT,1927,25,30-34,1952,96.84195754705397
SIM,1804,74,na,1878,884
SIM,1815,41,45-49,1856,3
STAT,1836,38,50-100,1874,1.9834185172921468
SIM,1893,32,20-24,1925,10
STAT,1878,19,45-49,1897,0.1370458924897039
STAT,1815,40,25-29,1855,4.157284261706892
STAT,1845,23,20-24,1868,130.88116316885848
STAT,1846,55,na,1901,3167.1357466958693
STAT,1911,15,25-29,1926,17.600197070328935
STAT,1852,26,30-34,1878,47.08515610667466
SIM,1811,54,50-100,1865,1
STAT,1857,47,15-19,1904,6.267426510370555E-4
STAT,1816,59,na,1875,2358.596193580727
STAT,1792,104,na,1896,0.024991978545722823
STAT,1868,35,25-29,1903,5.584995740601808
STAT,1888,38,45-49,1926,4.734980028287483
STAT,1820,48,30-34,1868,0.35502375534230196
STAT,1831,36,40-44,1867,7.235497150617392
STAT,1877,47,na,1924,4696.275210542913
SIM,1884,20,45-49,1904,2
SIM,1800,84,na,1884,164
STAT,1882,31,25-29,1913,20.23361652931872
SIM,1904,28,50-100,1932,8
STAT,1942,27,20-24,1969,38.69363225512711
STAT,1871,54,40-44,1925,0.020542993866232265
SIM,1834,29,25-29,1863,77
STAT,1865,107,na,1972,0.15723447812951738
STAT,1843,35,20-24,1878,1.2870458303084864
STAT,1859,42,20-24,1901,0.254975927042775
SIM,1869,49,40-44,1918,1
STAT,1902,24,15-19,1926,9.347772190936361
SIM,1830,29,na,1859,3359
SIM,1890,31,25-29,1921,34
STAT,1931,27,45-49,1958,4.504768594555869
STAT,1939,30,na,1969,7803.202998819913
SIM,1882,32,45-49,1914,4
STAT,1833,24,40-44,1857,3.6571873967011617
STAT,1850,36,50-100,1886,1.9322306140281513
STAT,1916,37,20-24,1953,0.5451949142149086
SIM,1939,18,25-29,1957,128
SIM,1851,26,20-24,1877,25
SIM,1884,69,na,1953,3014
SIM,1797,87,na,1884,87
SIM,1823,40,25-29,1863,3
SIM,1853,48,35-39,1901,1
SIM,1935,25,30-34,1960,12
SIM,1864,36,45-49,1900,7
STAT,1942,28,na,1970,7937.064218177356
STAT,1801,71,na,1872,1312.1705310134146
STAT,1843,26,20-24,1869,20.370772053165116
STAT,1900,36,15-19,1936,0.03412043952939384
STAT,1850,48,50-100,1898,0.3718394254262435
STAT,1835,91,na,1926,75.05064291221865
SIM,1837,49,50-100,1886,2
SIM,1871,26,50-100,1897,1
SIM,1895,22,15-19,1917,9
SIM,1956,15,20-24,1971,366
STAT,1820,64,na,1884,1964.5711081828847
STAT,1851,20,40-44,1871,3.9135867951576975
SIM,1915,34,50-100,1949,5
SIM,1857,67,na,1924,2837
SIM,1857,34,45-49,1891,5
SIM,1918,28,35-39,1946,44
SIM,1841,24,40-44,1865,5
STAT,1874,32,45-49,1906,3.6060757398366343
SIM,1843,29,35-39,1872,23
SIM,1909,19,25-29,1928,17
STAT,1837,17,35-39,1854,1.4975032159289452
SIM,1791,82,na,1873,227
SIM,1922,18,15-19,1940,101
STAT,1915,26,na,1941,7744.0624923129735
STAT,1834,23,45-49,1857,1.2325120630283821
SIM,1881,33,40-44,1914,11
SIM,1887,47,35-39,1934,1
SIM,1811,49,40-44,1860,1
SIM,1837,37,50-100,1874,5
STAT,1839,30,50-100,1869,1.7975271922903273
SIM,1828,31,15-19,1859,3
SIM,1836,85,na,1921,286
STAT,1816,47,50-100,1863,1.206734352237214
STAT,1937,15,45-49,1952,0.9862339055204536
STAT,1927,31,na,1958,9400.044583381958
SIM,1851,35,20-24,1886,1
SIM,1905,50,na,1955,6591
SIM,1799,88,na,1887,61
SIM,1860,43,50-100,1903,2
SIM,1886,38,50-100,1924,2
SIM,1880,28,40-44,1908,9
STAT,1876,54,50-100,1930,0.030679989146416592
SIM,1907,51,na,1958,6545
STAT,1914,18,15-19,1932,18.91348847511458
SIM,1872,33,30-34,1905,52
SIM,1909,32,na,1941,7387
STAT,1893,29,25-29,1922,107.51253502630598
SIM,1879,17,na,1896,5254
SIM,1938,19,20-24,1957,259
STAT,1857,40,30-34,1897,1.8280657844884447
STAT,1872,37,40-44,1909,8.885194788054742
SIM,1882,25,40-44,1907,9
STAT,1770,104,na,1874,0.05445692976622871
STAT,1833,31,45-49,1864,2.988962540626982
STAT,1851,22,35-39,1873,10.802759783293169
STAT,1861,19,35-39,1880,1.0477224378786454
STAT,1796,85,na,1881,182.61102990471042
STAT,1841,46,na,1887,3321.4417890055825
SIM,1941,24,45-49,1965,2
STAT,1826,38,25-29,1864,6.594455200685377
STAT,1864,29,na,1893,4277.620022467768
STAT,1801,53,45-49,1854,0.08909915896968766
STAT,1861,24,15-19,1885,5.615780675790666
STAT,1933,24,45-49,1957,3.0125203119688684
SIM,1839,18,20-24,1857,36
STAT,1950,21,40-44,1971,8.057990886019246
SIM,1942,20,45-49,1962,5
STAT,1847,46,45-49,1893,0.3607660551166505
SIM,1834,38,25-29,1872,9
STAT,1914,49,20-24,1963,0.022009143138714146
SIM,1855,37,45-49,1892,7
STAT,1943,26,25-29,1969,141.63305036254184
SIM,1783,87,na,1870,85
STAT,1898,41,30-34,1939,0.21918422494424214
SIM,1862,39,45-49,1901,5
STAT,1945,23,25-29,1968,204.3738439429003
SIM,1820,84,na,1904,291
SIM,1889,42,40-44,1931,10
SIM,1835,34,25-29,1869,27
SIM,1917,36,35-39,1953,8
STAT,1872,28,40-44,1900,6.0588150321946115
STAT,1862,6,na,1868,4932.190232562572
STAT,1879,47,35-39,1926,0.29436800954236086
STAT,1833,82,na,1915,613.3822356049394
STAT,1905,37,45-49,1942,1.2567435492196521
STAT,1919,19,45-49,1938,1.1086864058504056
STAT,1936,16,40-44,1952,2.7117064256514025
STAT,1884,27,20-24,1911,23.39568689804042
SIM,1853,23,20-24,1876,143
SIM,1852,31,20-24,1883,9
SIM,1872,9,na,1881,5705
STAT,1920,15,35-39,1935,1.9160057494322844
SIM,1893,0,na,1893,7290
SIM,1874,30,30-34,1904,41
STAT,1880,43,25-29,1923,1.356366592126942
SIM,1793,97,na,1890,1
STAT,1845,16,50-100,1861,0.09598231964926841
STAT,1813,110,na,1923,2.4555425661708255E-4
STAT,1910,41,25-29,1951,0.1371351402981367
SIM,1826,75,na,1901,1103
SIM,1905,42,35-39,1947,1
SIM,1849,47,30-34,1896,1
STAT,1898,0,na,1898,8025.265263403551
SIM,1841,31,45-49,1872,5
SIM,1942,28,40-44,1970,17
STAT,1865,50,35-39,1915,0.016022993687011086
SIM,1813,46,40-44,1859,2
STAT,1934,28,40-44,1962,12.659279156827482
SIM,1844,49,na,1893,3134
SIM,1888,53,na,1941,4970
STAT,1866,83,na,1949,739.7772148965058
SIM,1919,24,35-39,1943,28
STAT,1842,52,20-24,1894,0.001092776464515179
SIM,1900,20,40-44,1920,7
STAT,1862,47,25-29,1909,0.09896564657475063
SIM,1880,37,40-44,1917,17
STAT,1812,53,20-24,1865,0.004794826036067948
STAT,1892,46,25-29,1938,0.08238059072091952
STAT,1894,25,25-29,1919,110.49122897450856
STAT,1899,70,na,1969,4595.017123296776
SIM,1932,38,25-29,1970,4
STAT,1934,35,15-19,1969,0.05362052528779709
STAT,1874,19,na,1893,5194.729849405845
STAT,1825,30,40-44,1855,19.336385777751758
STAT,1902,17,40-44,1919,0.5215199340101799
SIM,1894,24,20-24,1918,174
STAT,1813,82,na,1895,414.6055403975706
STAT,1833,37,na,1870,3519.7018540347435
SIM,1799,82,na,1881,280
STAT,1871,38,35-39,1909,14.121531210467182
STAT,1943,21,50-100,1964,1.4142809981346287
SIM,1915,31,40-44,1946,13
SIM,1873,39,20-24,1912,3
STAT,1868,23,50-100,1891,0.7811587703832289
STAT,1917,35,15-19,1952,0.040662250217243755
SIM,1802,93,na,1895,20
STAT,1839,45,40-44,1884,0.27942998099125954
STAT,1825,32,35-39,1857,35.94120633374187
STAT,1926,33,30-34,1959,38.444803857204725
STAT,1861,30,50-100,1891,1.5525969447452246
STAT,1934,20,45-49,1954,3.064297125803513
SIM,1837,61,na,1898,2459
STAT,1809,77,na,1886,789.2255194590507
STAT,1837,72,na,1909,1760.166745639016
SIM,1877,24,20-24,1901,135
SIM,1827,33,20-24,1860,6
STAT,1875,66,na,1941,3408.0783263705835
STAT,1889,43,45-49,1932,3.700059651069006
STAT,1947,2,na,1949,9167.903475527468
STAT,1876,42,50-100,1918,2.204062899655806
SIM,1891,46,50-100,1937,1
SIM,1919,2,na,1921,9240
SIM,1934,33,30-34,1967,50
SIM,1806,55,na,1861,2402
STAT,1892,21,40-44,1913,5.284391357098403
STAT,1788,110,na,1898,1.7189734181498063E-4
STAT,1850,24,50-100,1874,0.7397231742270514
STAT,1910,19,25-29,1929,17.255256644380633
SIM,1860,59,na,1919,3330
STAT,1867,39,25-29,1906,5.390974969358092
SIM,1837,22,25-29,1859,103
STAT,1844,74,na,1918,1792.2131333989175
STAT,1890,23,30-34,1913,43.77437338435526
SIM,1965,6,na,1971,10573
SIM,1926,34,20-24,1960,8
STAT,1892,23,35-39,1915,14.708231020759168
SIM,1864,37,50-100,1901,3
SIM,1874,39,na,1913,4516
STAT,1810,44,25-29,1854,4.512822671566053
STAT,1844,34,25-29,1878,19.373635667514886
STAT,1902,53,na,1955,6041.016919299352
SIM,1942,2,na,1944,8682
SIM,1842,23,45-49,1865,1
SIM,1877,48,50-100,1925,2
SIM,1833,30,40-44,1863,8
SIM,1861,52,na,1913,4080
STAT,1865,39,20-24,1904,1.400127274729603
STAT,1928,23,25-29,1951,232.16386862844507
STAT,1907,31,40-44,1938,7.421853030943627
STAT,1920,48,35-39,1968,0.2869703272348342
STAT,1849,49,15-19,1898,6.195080827197586E-4
SIM,1936,24,35-39,1960,21
STAT,1835,110,na,1945,3.5789702244191256E-4
STAT,1851,49,50-100,1900,0.37277560698403134
SIM,1875,39,25-29,1914,11
SIM,1905,49,20-24,1954,1
STAT,1849,34,45-49,1883,2.8468978142427814
STAT,1879,54,40-44,1933,0.021627849277744672
SIM,1852,24,15-19,1876,5
STAT,1924,31,40-44,1955,9.223591098967294
SIM,1856,35,40-44,1891,14
SIM,1944,27,50-100,1971,6
SIM,1949,15,na,1964,8994
STAT,1879,28,na,1907,5023.729729863793
STAT,1903,22,50-100,1925,1.1726267641034802
STAT,1768,110,na,1878,0.0034361852344657095
SIM,1863,37,40-44,1900,2
SIM,1897,43,45-49,1940,1
STAT,1818,109,na,1927,7.29917115060098E-4
SIM,1898,17,15-19,1915,18
STAT,1816,109,na,1925,6.988331397038509E-4
SIM,1883,21,40-44,1904,5
STAT,1851,22,na,1873,3958.145774454965
STAT,1821,47,35-39,1868,0.4097724173981657
STAT,1854,5,na,1859,4611.228615407808
SIM,1889,44,35-39,1933,9
STAT,1886,24,20-24,1910,145.99775026058768
SIM,1886,15,30-34,1901,4
STAT,1948,13,na,1961,9076.853784073941
STAT,1824,74,na,1898,1186.5148850215546
SIM,1836,99,na,1935,2
SIM,1861,24,25-29,1885,117
SIM,1936,23,25-29,1959,182
STAT,1928,24,35-39,1952,23.59096819934095
STAT,1915,20,na,1935,7691.214337967707
SIM,1821,38,45-49,1859,5
STAT,1864,74,na,1938,2003.5118462157754
STAT,1844,24,15-19,1868,6.556727523206266
STAT,1865,36,50-100,1901,2.263518473269187
STAT,1872,53,45-49,1925,0.028983480013783897
STAT,1911,16,na,1927,7827.137383809808
SIM,1932,31,40-44,1963,12
STAT,1861,46,na,1907,3792.7390318102925
SIM,1836,24,30-34,1860,40
SIM,1893,25,15-19,1918,2
STAT,1953,15,30-34,1968,29.79185387581653
STAT,1870,24,25-29,1894,112.79757790643461
SIM,1902,25,35-39,1927,35
SIM,1837,47,na,1884,3119
STAT,1834,21,50-100,1855,0.7312300831117364
STAT,1838,46,35-39,1884,0.1974463734711273
STAT,1855,53,45-49,1908,0.021532400682437607
STAT,1895,15,30-34,1910,4.213963667054701
STAT,1827,53,50-100,1880,0.025809307916231365
STAT,1853,24,25-29,1877,105.48585223646177
SIM,1919,28,50-100,1947,4
STAT,1918,34,20-24,1952,5.189033202131941
STAT,1808,51,50-100,1859,0.09148541493826245
STAT,1904,68,na,1972,5225.391146473279
STAT,1880,29,45-49,1909,2.345367510777702
STAT,1908,38,40-44,1946,2.818493305052697
STAT,1871,16,25-29,1887,11.511613210020409
STAT,1908,30,45-49,1938,3.025924148450541
SIM,1906,41,40-44,1947,1
SIM,1916,38,40-44,1954,4
SIM,1955,15,na,1970,9504
SIM,1892,44,na,1936,6588
STAT,1840,50,30-34,1890,0.008715622927050581
STAT,1943,25,15-19,1968,1.5197190446946265
STAT,1885,32,20-24,1917,5.433948668735677
STAT,1923,32,35-39,1955,21.151245653771213
SIM,1861,15,25-29,1876,23
SIM,1901,19,25-29,1920,22
STAT,1919,33,25-29,1952,20.0499053806975
SIM,1871,96,na,1967,53
STAT,1891,40,35-39,1931,4.566096405011601
SIM,1882,68,na,1950,3013
SIM,1931,32,35-39,1963,29
STAT,1885,25,15-19,1910,0.9182643092824925
SIM,1854,47,40-44,1901,1
SIM,1901,26,30-34,1927,84
STAT,1794,84,na,1878,227.4286131101938
SIM,1847,8,na,1855,4725
SIM,1847,45,40-44,1892,1
STAT,1818,41,20-24,1859,0.81255245759088
SIM,1856,42,45-49,1898,3
SIM,1868,34,20-24,1902,7
SIM,1828,32,25-29,1860,25
SIM,1780,90,na,1870,43
SIM,1912,38,na,1950,7577
STAT,1899,47,20-24,1946,0.0186434367608238
SIM,1787,77,na,1864,541
SIM,1898,35,45-49,1933,7
SIM,1939,15,20-24,1954,273
STAT,1850,24,40-44,1874,3.7799851452919726
SIM,1776,85,na,1861,112
SIM,1901,66,na,1967,5171
STAT,1903,48,35-39,1951,0.22423456553829407
SIM,1817,39,35-39,1856,16
STAT,1889,36,40-44,1925,10.953468431800824
SIM,1911,20,15-19,1931,8
STAT,1810,54,na,1864,2359.716224668577
STAT,1870,20,50-100,1890,0.8134023717999703
STAT,1868,29,30-34,1897,48.041849081273114
SIM,1826,41,20-24,1867,1
STAT,1849,16,15-19,1865,11.623435716726153
STAT,1823,32,30-34,1855,99.99698775849691
STAT,1925,36,na,1961,9125.973370957287
STAT,1862,48,35-39,1910,0.23863160497284097
STAT,1892,38,na,1930,5927.062641032378
STAT,1895,66,na,1961,4616.863393511682
STAT,1847,17,na,1864,4367.1449676280645
STAT,1861,49,30-34,1910,0.15932410959832843
SIM,1878,23,25-29,1901,119
STAT,1774,84,na,1858,149.28542385197616
STAT,1835,34,15-19,1869,0.23009330377487158
SIM,1916,30,45-49,1946,7
STAT,1858,39,15-19,1897,0.0875209559366218
SIM,1857,16,15-19,1873,13
SIM,1831,32,30-34,1863,37
STAT,1911,36,na,1947,7376.354934909592
SIM,1811,56,na,1867,2244
SIM,1833,32,35-39,1865,27
SIM,1815,48,50-100,1863,1
STAT,1899,38,20-24,1937,0.45811560777128346
SIM,1927,33,25-29,1960,30
SIM,1864,41,25-29,1905,3
STAT,1838,53,40-44,1891,0.014019411057590043
SIM,1874,31,40-44,1905,9
STAT,1856,22,50-100,1878,0.7379968870523554
SIM,1911,48,35-39,1959,1
STAT,1903,20,15-19,1923,9.543151585979846
SIM,1862,68,na,1930,2756
STAT,1869,28,35-39,1897,18.815903600738483
STAT,1824,54,na,1878,2468.07424554973
STAT,1888,7,na,1895,6219.154886012408
STAT,1948,17,15-19,1965,104.88600628265647
SIM,1897,36,40-44,1933,17
SIM,1893,35,25-29,1928,2
STAT,1831,56,na,1887,2662.906858371206
STAT,1895,32,na,1927,6279.889063158127
STAT,1905,28,15-19,1933,1.320501021813499
STAT,1831,39,45-49,1870,3.1913908329698257
SIM,1911,23,20-24,1934,206
STAT,1881,43,45-49,1924,2.9004585475420623
STAT,1916,45,50-100,1961,0.4707293173302017
SIM,1879,38,45-49,1917,7
STAT,1837,18,45-49,1855,0.14134381542095772
STAT,1856,41,25-29,1897,1.0051599474958317
SIM,1933,30,45-49,1963,8
SIM,1826,44,25-29,1870,2
STAT,1952,16,25-29,1968,104.90263420549142
STAT,1839,15,45-49,1854,0.13501187740499554
STAT,1849,97,na,1946,8.497803448464378
SIM,1838,31,50-100,1869,1
SIM,1820,39,na,1859,3041
SIM,1859,38,50-100,1897,3
SIM,1860,25,20-24,1885,26
SIM,1908,46,35-39,1954,1
STAT,1824,38,20-24,1862,2.238944830538931
STAT,1888,44,40-44,1932,5.2966942339011664
STAT,1929,16,35-39,1945,10.840856999069466
SIM,1909,16,20-24,1925,67
STAT,1848,42,45-49,1890,2.4510304009471957
STAT,1843,29,25-29,1872,71.88234793746426
STAT,1893,17,20-24,1910,45.38287840315939
SIM,1822,37,50-100,1859,3
STAT,1891,29,20-24,1920,29.076871112391974
STAT,1851,56,na,1907,3161.8052071557645
STAT,1860,35,20-24,1895,1.276262820424491
STAT,1889,19,20-24,1908,43.91141375148174
SIM,1855,80,na,1935,899
SIM,1872,36,35-39,1908,18
SIM,1896,44,40-44,1940,1
SIM,1937,16,35-39,1953,11
STAT,1894,19,30-34,1913,4.112953955296939
SIM,1851,29,25-29,1880,87
SIM,1819,42,na,1861,3015
STAT,1953,18,35-39,1971,10.247496482198393
STAT,1863,43,25-29,1906,1.1270689138062548
STAT,1879,44,30-34,1923,2.3958656442219013
STAT,1842,93,na,1935,43.51118702110871
STAT,1887,37,na,1924,5321.663968528588
SIM,1820,39,40-44,1859,17
STAT,1839,22,na,1861,4289.619375711292
SIM,1874,33,35-39,1907,26
SIM,1887,44,30-34,1931,5
SIM,1853,26,25-29,1879,94
SIM,1908,13,na,1921,7810
STAT,1866,55,na,1921,3853.142299560432
STAT,1885,35,25-29,1920,5.843008797436907
SIM,1901,29,35-39,1930,38
SIM,1935,15,na,1950,10514
STAT,1903,15,35-39,1918,1.585178285695681
SIM,1900,27,25-29,1927,128
STAT,1847,31,na,1878,3919.374124561402
STAT,1911,25,35-39,1936,29.77944587431219
STAT,1897,37,45-49,1934,5.381700288023008
STAT,1925,30,45-49,1955,3.777383445937902
SIM,1811,76,na,1887,764
SIM,1897,19,20-24,1916,48
STAT,1881,51,30-34,1932,0.011675457025872926
STAT,1908,37,30-34,1945,3.4486001223627314
STAT,1818,44,25-29,1862,2.9383417358352784
STAT,1901,26,20-24,1927,33.28296942849448
SIM,1876,29,30-34,1905,51
STAT,1845,26,25-29,1871,79.91405988729993
STAT,1870,39,30-34,1909,10.461273546100838
SIM,1880,4,na,1884,6073
STAT,1848,18,20-24,1866,35.82382325902406
STAT,1883,22,45-49,1905,1.3836766297723777
SIM,1941,21,40-44,1962,10
STAT,1898,44,35-39,1942,0.3390375666615063
STAT,1935,34,20-24,1969,6.807810366307895
SIM,1914,32,35-39,1946,27
SIM,1918,43,na,1961,8226
SIM,1854,38,40-44,1892,13
SIM,1918,23,na,1941,8107
STAT,1876,7,na,1883,5625.966167821792
SIM,1920,39,45-49,1959,1
SIM,1835,38,na,1873,3570
STAT,1803,52,na,1855,2399.561208319636
SIM,1836,49,45-49,1885,1
STAT,1868,103,na,1971,2.9272800740278435
SIM,1916,37,30-34,1953,5
SIM,1916,42,na,1958,7793
STAT,1926,26,25-29,1952,159.87400436664365
SIM,1849,9,na,1858,4950
STAT,1825,52,20-24,1877,0.001542553177199871
STAT,1921,20,50-100,1941,1.5095616190643752
STAT,1934,0,na,1934,12308.656125395652
STAT,1908,45,15-19,1953,6.831668734890441E-4
STAT,1912,39,45-49,1951,1.3306223064094507
SIM,1893,20,na,1913,6270
STAT,1916,33,50-100,1949,1.7166693872323264
SIM,1839,20,35-39,1859,10
STAT,1893,26,20-24,1919,30.134143430237454
STAT,1918,31,15-19,1949,0.27686611580413384
STAT,1910,47,50-100,1957,0.42634871437093547
SIM,1875,37,30-34,1912,20
STAT,1858,37,20-24,1895,1.213638613150454
SIM,1832,38,20-24,1870,2
SIM,1824,31,45-49,1855,1
STAT,1838,43,30-34,1881,1.6348165067883467
STAT,1832,32,40-44,1864,7.370119928988395
SIM,1900,23,45-49,1923,3
STAT,1805,49,45-49,1854,1.8812196934123204
STAT,1892,43,20-24,1935,0.39862580048254964
SIM,1918,25,30-34,1943,103
STAT,1763,98,na,1861,0.5155537402204934
STAT,1822,42,25-29,1864,2.161088910672176
SIM,1943,10,na,1953,8631
SIM,1846,43,30-34,1889,6
SIM,1914,33,na,1947,7753
STAT,1918,35,30-34,1953,3.915924251632113
SIM,1875,43,50-100,1918,6
STAT,1903,23,20-24,1926,197.54985474044176
STAT,1842,73,na,1915,1768.3432635980434
SIM,1883,28,25-29,1911,98
SIM,1848,40,30-34,1888,3
SIM,1856,18,20-24,1874,33
SIM,1891,22,45-49,1913,2
STAT,1826,35,20-24,1861,1.955098624541085
STAT,1807,110,na,1917,2.2057511498447432E-4
STAT,1819,36,25-29,1855,18.020820928303966
SIM,1813,49,45-49,1862,1
SIM,1877,25,30-34,1902,68
SIM,1840,32,40-44,1872,13
SIM,1917,33,30-34,1950,37
STAT,1814,52,45-49,1866,0.0720658462753875
STAT,1948,18,25-29,1966,100.12052179071924
SIM,1929,32,na,1961,9906
SIM,1830,42,25-29,1872,2
STAT,1855,46,na,1901,3402.244506946342
SIM,1852,34,25-29,1886,20
STAT,1857,92,na,1949,65.5643795265446
STAT,1898,48,15-19,1946,6.089265727686188E-4
SIM,1840,47,50-100,1887,1
SIM,1854,22,50-100,1876,1
STAT,1909,44,50-100,1953,0.21931486262424776
SIM,1871,7,na,1878,5304
STAT,1846,47,40-44,1893,0.2610060795563158
STAT,1830,111,na,1941,1.4821360575766336E-4
STAT,1878,32,15-19,1910,0.3003806034544222
STAT,1817,39,25-29,1856,17.95927251462289
SIM,1825,39,25-29,1864,4
STAT,1868,64,na,1932,3340.3015672172746
STAT,1876,20,45-49,1896,1.4652979004864444
STAT,1887,49,50-100,1936,0.306396795435944
SIM,1834,26,20-24,1860,22
STAT,1941,31,40-44,1972,8.303146006202047
STAT,1842,54,45-49,1896,0.021012132277572915
SIM,1861,18,30-34,1879,5
SIM,1901,12,na,1913,7367
SIM,1888,20,15-19,1908,8
STAT,1863,8,na,1871,4953.8784866866945
SIM,1867,100,na,1967,10
STAT,1834,45,20-24,1879,0.0190990303480513
STAT,1817,48,25-29,1865,0.27387872246147255
STAT,1844,31,20-24,1875,5.274544967794423
STAT,1848,50,30-34,1898,0.009900700124945217
STAT,1882,14,na,1896,5064.371320640517
SIM,1948,23,15-19,1971,14
STAT,1846,38,40-44,1884,6.9296368779150965
STAT,1846,22,50-100,1868,0.7706902183012472
STAT,1931,18,15-19,1949,119.66000331535801
STAT,1933,21,40-44,1954,9.035648476508987
SIM,1834,35,20-24,1869,2
STAT,1878,16,40-44,1894,0.386745070855619
STAT,1924,38,25-29,1962,2.341829478126778
SIM,1909,38,35-39,1947,6
SIM,1936,21,30-34,1957,57
STAT,1822,73,na,1895,1341.0717340555354
STAT,1887,39,40-44,1926,9.788354255013086
STAT,1932,15,50-100,1947,1.0066647059499771
STAT,1853,18,30-34,1871,3.0157205654064754
STAT,1892,20,30-34,1912,45.303425188039974
SIM,1831,35,35-39,1866,27
SIM,1909,18,na,1927,7705
SIM,1871,21,15-19,1892,6
STAT,1907,34,45-49,1941,2.94678240617038
SIM,1922,42,na,1964,9010
STAT,1830,53,40-44,1883,0.01566884539962344
SIM,1900,46,35-39,1946,1
SIM,1827,36,25-29,1863,9
STAT,1811,81,na,1892,502.67542444579993
STAT,1779,93,na,1872,11.499790173624323
STAT,1863,22,25-29,1885,103.22145268582639
STAT,1876,19,50-100,1895,0.10178834942283972
SIM,1899,31,45-49,1930,7
STAT,1867,36,20-24,1903,1.4650199934000898
STAT,1886,27,25-29,1913,90.18419983047329
STAT,1930,34,35-39,1964,23.787228413972333
SIM,1817,92,na,1909,22
SIM,1812,44,30-34,1856,4
SIM,1878,30,50-100,1908,2
SIM,1802,65,na,1867,1770
STAT,1926,36,35-39,1962,5.974474116198062
SIM,1820,50,na,1870,2685
STAT,1867,37,30-34,1904,10.080494521399586
SIM,1924,47,30-34,1971,1
STAT,1951,20,45-49,1971,2.7166157241053495
SIM,1885,16,25-29,1901,14
STAT,1839,48,45-49,1887,0.3706713889454299
STAT,1866,31,40-44,1897,8.11440889746303
STAT,1917,21,na,1938,7861.514269947012
SIM,1823,35,45-49,1858,7
SIM,1871,22,25-29,1893,122
SIM,1828,48,40-44,1876,1
SIM,1875,36,20-24,1911,1
SIM,1934,26,25-29,1960,179
SIM,1890,26,45-49,1916,2
STAT,1928,21,30-34,1949,72.68173186206386
SIM,1936,20,20-24,1956,201
SIM,1894,27,25-29,1921,111
STAT,1823,35,35-39,1858,29.392065899257
STAT,1837,41,na,1878,3502.3371459821415
STAT,1936,30,20-24,1966,4.791235630076502
STAT,1873,33,40-44,1906,8.86163107758011
SIM,1864,63,na,1927,3301
STAT,1840,42,45-49,1882,2.253519140446474
SIM,1895,39,40-44,1934,16
SIM,1899,30,35-39,1929,38
STAT,1821,46,25-29,1867,0.17104795494065228
SIM,1871,11,na,1882,5152
STAT,1891,76,na,1967,3111.5278147665585
STAT,1839,20,25-29,1859,116.5161880247477
SIM,1926,26,35-39,1952,46
SIM,1949,15,15-19,1964,102
SIM,1859,48,na,1907,3926
SIM,1899,17,na,1916,7109
STAT,1854,39,45-49,1893,3.025232584447263
SIM,1902,28,na,1930,6961
SIM,1928,15,45-49,1943,1
STAT,1882,26,45-49,1908,2.1919029803040497
STAT,1841,30,25-29,1871,18.409570899681963
STAT,1842,36,15-19,1878,0.09909714523889401
STAT,1875,24,45-49,1899,1.4408996042963025
STAT,1877,25,25-29,1902,89.31462837116374
STAT,1897,28,45-49,1925,2.986869936652005
STAT,1958,0,na,1958,10504.869520873104
STAT,1874,64,na,1938,3594.7771096797774
STAT,1899,40,35-39,1939,0.3514693699538213
SIM,1875,27,20-24,1902,28
STAT,1916,47,30-34,1963,0.18466262390838167
STAT,1947,21,35-39,1968,21.49792621096868
SIM,1847,48,45-49,1895,1
SIM,1857,61,na,1918,3294
SIM,1897,32,50-100,1929,2
SIM,1813,57,na,1870,2441
SIM,1838,37,45-49,1875,5
SIM,1885,25,25-29,1910,108
STAT,1890,35,50-100,1925,3.055321130822606
SIM,1864,94,na,1958,27
STAT,1889,32,50-100,1921,2.2816647776977814
SIM,1901,16,20-24,1917,40
SIM,1934,36,35-39,1970,8
STAT,1839,49,20-24,1888,0.018607767256889715
STAT,1857,17,50-100,1874,0.09064594746987954
STAT,1863,107,na,1970,0.1177806437571493
STAT,1863,21,15-19,1884,5.991598845710703
SIM,1924,37,20-24,1961,1
SIM,1814,42,40-44,1856,9
STAT,1890,26,35-39,1916,23.867740879861365
STAT,1852,111,na,1963,6.244449404593148E-4
STAT,1910,22,15-19,1932,10.099730844981002
SIM,1915,34,45-49,1949,5
SIM,1828,56,na,1884,2668
STAT,1831,27,40-44,1858,5.221472971466267
STAT,1883,37,15-19,1920,0.11142600174633266
STAT,1887,20,20-24,1907,156.58778681153825
SIM,1829,41,50-100,1870,2
SIM,1890,16,35-39,1906,2
STAT,1853,28,40-44,1881,4.960569867823383
SIM,1848,43,50-100,1891,5
SIM,1935,28,35-39,1963,52
STAT,1872,50,40-44,1922,0.021675469498530338
STAT,1898,31,50-100,1929,2.5144131417121223
SIM,1929,21,25-29,1950,273
STAT,1904,44,35-39,1948,0.3595865759213502
STAT,1817,38,15-19,1855,0.3857170119271485
SIM,1851,38,25-29,1889,9
SIM,1895,48,40-44,1943,1
STAT,1850,28,20-24,1878,21.01568436775431
SIM,1839,28,na,1867,3631
SIM,1925,25,na,1950,8969
SIM,1884,49,na,1933,4754
STAT,1924,37,15-19,1961,0.04572016215413249
STAT,1943,29,30-34,1972,84.19234565685896
STAT,1847,21,30-34,1868,33.526434707610036
STAT,1870,21,20-24,1891,137.0541036652037
STAT,1928,20,20-24,1948,282.01875767277807
STAT,1843,38,25-29,1881,4.240419093102535
STAT,1835,19,25-29,1854,18.949283730216145
SIM,1918,26,40-44,1944,10
STAT,1814,44,na,1858,2705.9724645910605
SIM,1859,22,45-49,1881,4
STAT,1884,29,15-19,1913,0.8983387630523577
SIM,1809,66,na,1875,1602
SIM,1855,21,30-34,1876,46
SIM,1902,22,30-34,1924,65
STAT,1933,17,na,1950,9952.169742215212
STAT,1859,45,25-29,1904,0.09351447253577955
SIM,1875,86,na,1961,721
SIM,1834,36,30-34,1870,3
STAT,1796,65,na,1861,1635.2524802899657
SIM,1879,47,45-49,1926,1
STAT,1875,46,20-24,1921,0.025023063834240755
STAT,1874,6,na,1880,5649.628667981727
SIM,1838,46,45-49,1884,1
SIM,1861,28,40-44,1889,5
SIM,1827,71,na,1898,1545
SIM,1889,41,30-34,1930,7
STAT,1864,36,35-39,1900,12.830269253315038
STAT,1918,26,35-39,1944,32.374122671941805
SIM,1861,19,40-44,1880,1
STAT,1827,28,30-34,1855,104.1017095552797
STAT,1844,49,30-34,1893,0.15305975871024485
SIM,1873,77,na,1950,1576
SIM,1843,19,25-29,1862,16
STAT,1887,48,40-44,1935,0.3818463398138411
STAT,1935,26,na,1961,10319.73912244351
SIM,1872,92,na,1964,247
STAT,1897,42,25-29,1939,0.12023611456170553
STAT,1927,28,35-39,1955,36.72707100543778
SIM,1868,37,25-29,1905,5
SIM,1886,10,na,1896,5486
SIM,1895,20,20-24,1915,207
STAT,1837,31,15-19,1868,0.2515122319822327
SIM,1867,77,na,1944,1667
STAT,1816,46,15-19,1862,0.001995718401709691
STAT,1934,27,30-34,1961,106.47003344122618
SIM,1858,30,45-49,1888,4
STAT,1838,26,na,1864,3751.0989399722394
STAT,1764,94,na,1858,5.898829432851236
STAT,1853,3,na,1856,5377.401509520001
SIM,1835,28,30-34,1863,64
SIM,1942,27,30-34,1969,97
STAT,1853,19,40-44,1872,0.34402797763153475
STAT,1841,16,45-49,1857,0.12296346688941778
STAT,1875,12,na,1887,5415.819074965033
STAT,1920,45,30-34,1965,0.1999091052579486
STAT,1944,21,15-19,1965,11.610853032023282
STAT,1893,46,50-100,1939,0.35564946537144493
SIM,1908,36,25-29,1944,4
SIM,1873,20,na,1893,5039
STAT,1907,16,15-19,1923,17.659162204247
STAT,1920,27,na,1947,8297.575436369632
SIM,1900,19,na,1919,7373
STAT,1826,36,30-34,1862,13.071313547403049
STAT,1841,25,45-49,1866,2.029950297789889
STAT,1864,33,30-34,1897,31.387178328449696
STAT,1871,35,30-34,1906,10.79543891565955
SIM,1915,16,15-19,1931,16
SIM,1893,17,30-34,1910,6
STAT,1893,27,30-34,1920,64.462592406102
SIM,1844,43,na,1887,3260
SIM,1860,87,na,1947,259
SIM,1865,11,na,1876,5119
STAT,1866,53,20-24,1919,0.0013530191414127654
STAT,1894,19,na,1913,6517.285188077908
STAT,1828,98,na,1926,3.98938938361487
SIM,1877,49,35-39,1926,1
SIM,1908,28,40-44,1936,11
STAT,1917,39,30-34,1956,3.7996880528779933
SIM,1855,35,na,1890,4124
SIM,1893,74,na,1967,3497
SIM,1874,34,45-49,1908,6
SIM,1929,31,35-39,1960,28
STAT,1884,40,na,1924,4655.746074745572
STAT,1841,22,40-44,1863,3.8301224489458363
SIM,1909,31,15-19,1940,1
SIM,1867,32,45-49,1899,2
SIM,1782,88,na,1870,67
SIM,1830,28,45-49,1858,1
SIM,1851,45,na,1896,3608
SIM,1932,16,15-19,1948,115
STAT,1892,45,45-49,1937,0.3399315063518813
STAT,1897,20,15-19,1917,8.959322942333948
STAT,1938,29,20-24,1967,36.493149124140245
SIM,1875,15,20-24,1890,36
STAT,1924,16,15-19,1940,109.38648342368379
STAT,1903,24,30-34,1927,50.89968332376273
STAT,1818,38,30-34,1856,33.06632341647556
STAT,1906,39,20-24,1945,0.48472177430470537
STAT,1878,23,na,1901,4973.1838655287
SIM,1869,1,na,1870,6564
STAT,1866,34,45-49,1900,3.221755709231055
SIM,1857,4,na,1861,5305
SIM,1833,22,50-100,1855,3
STAT,1839,41,25-29,1880,1.1762739285779416
SIM,1845,90,na,1935,88
SIM,1863,28,40-44,1891,7
SIM,1891,33,35-39,1924,7
SIM,1927,37,na,1964,9699
SIM,1943,16,25-29,1959,129
STAT,1825,54,45-49,1879,0.029155196532283715
STAT,1921,29,45-49,1950,3.859902949847612
STAT,1820,95,na,1915,14.884453418315372
STAT,1935,16,25-29,1951,119.96212092880032
SIM,1824,42,35-39,1866,7
STAT,1837,53,25-29,1890,0.004858639142337583
STAT,1927,42,15-19,1969,0.0038891414452678816
STAT,1829,38,40-44,1867,7.512368029979449
SIM,1925,39,30-34,1964,5
STAT,1901,29,25-29,1930,118.7469099543039
STAT,1830,34,30-34,1864,33.44588321773564
SIM,1840,22,30-34,1862,63
STAT,1949,17,30-34,1966,28.62813802757301
SIM,1780,76,na,1856,596
STAT,1863,26,50-100,1889,1.139091277546047
STAT,1803,54,50-100,1857,0.10657197201278594
STAT,1860,17,25-29,1877,10.718850269753267
STAT,1829,49,50-100,1878,0.3775103868471671
SIM,1864,15,45-49,1879,1
SIM,1941,28,25-29,1969,148
STAT,1855,28,40-44,1883,4.674531918813237
STAT,1833,49,20-24,1882,0.016418316271594915
STAT,1859,32,45-49,1891,2.803175314456503
STAT,1933,28,25-29,1961,176.4401895833235
STAT,1785,76,na,1861,777.3887882456786
SIM,1865,32,45-49,1897,6
STAT,1827,110,na,1937,3.341575176412226E-4
SIM,1844,15,25-29,1859,17
SIM,1879,44,40-44,1923,10
STAT,1800,95,na,1895,11.35600375974123
SIM,1862,82,na,1944,811
STAT,1881,40,40-44,1921,4.435073698466577
STAT,1888,30,na,1918,5742.067401892935
STAT,1923,17,45-49,1940,1.184289281716602
STAT,1828,41,15-19,1869,0.026426171530382386
STAT,1856,15,45-49,1871,0.12178797145339047
SIM,1852,28,30-34,1880,3
STAT,1920,41,na,1961,8294.096649643403
STAT,1844,28,30-34,1872,49.42534686042296
SIM,1847,20,25-29,1867,112
STAT,1920,23,20-24,1943,248.83119048630527
STAT,1824,37,45-49,1861,6.055460350964358
STAT,1832,22,30-34,1854,56.085321916858135
STAT,1841,34,40-44,1875,7.4774914387954965
STAT,1922,28,15-19,1950,1.607215722656518
SIM,1845,28,na,1873,4228
SIM,1798,86,na,1884,112
SIM,1867,20,45-49,1887,4
STAT,1895,32,15-19,1927,0.3747643850115395
SIM,1930,28,15-19,1958,2
STAT,1857,32,45-49,1889,2.7620672980997893
SIM,1847,30,50-100,1877,3
STAT,1887,25,50-100,1912,1.4547353771961509
STAT,1852,4,na,1856,5137.990551880001
SIM,1848,7,na,1855,4709
STAT,1909,26,25-29,1935,128.62952618196138
SIM,1821,37,35-39,1858,14
STAT,1946,23,40-44,1969,7.553642392857931
SIM,1903,39,45-49,1942,3
SIM,1866,75,na,1941,1828
STAT,1869,50,50-100,1919,0.029979887775303957
STAT,1877,92,na,1969,316.49175184325793
SIM,1919,49,50-100,1968,1
STAT,1851,38,15-19,1889,0.08707317393241551
SIM,1837,38,40-44,1875,11
SIM,1906,0,na,1906,8032
SIM,1829,43,30-34,1872,4
SIM,1874,70,na,1944,2541
SIM,1884,15,na,1899,5524
STAT,1820,92,na,1912,46.626826528374814
STAT,1921,22,25-29,1943,210.6553481723712
SIM,1896,22,30-34,1918,63
STAT,1801,54,25-29,1855,0.02131272160887311
SIM,1905,27,45-49,1932,8
STAT,1853,21,20-24,1874,129.75928126534455
SIM,1899,28,50-100,1927,5
SIM,1920,17,35-39,1937,11
SIM,1813,42,25-29,1855,2
STAT,1912,17,35-39,1929,1.7141246562868049
STAT,1880,28,35-39,1908,20.45653839790666
STAT,1869,42,15-19,1911,0.026991729321587197
SIM,1902,33,20-24,1935,1
STAT,1813,68,na,1881,1606.761269006905
SIM,1882,21,25-29,1903,134
STAT,1896,29,40-44,1925,7.930368536676806
SIM,1876,82,na,1958,1257
SIM,1861,21,20-24,1882,139
STAT,1856,27,45-49,1883,1.7927947330060625
STAT,1867,15,20-24,1882,34.68736195950023
STAT,1873,26,35-39,1899,19.868091552522447
SIM,1857,1,na,1858,6397
STAT,1878,38,50-100,1916,2.576833841086356
SIM,1819,39,50-100,1858,3
SIM,1848,56,na,1904,3108
SIM,1864,27,45-49,1891,2
STAT,1869,49,35-39,1918,0.2682512186711463
SIM,1835,38,40-44,1873,10
STAT,1888,33,na,1921,5672.24159343679
STAT,1886,46,30-34,1932,0.2069579693301662
STAT,1894,29,40-44,1923,7.716135777242309
STAT,1869,27,50-100,1896,1.25183932562843
STAT,1906,15,na,1921,7467.251417774645
SIM,1847,103,na,1950,3
STAT,1871,17,35-39,1888,1.1081037555951216
STAT,1888,22,30-34,1910,42.51907990538781
SIM,1868,53,na,1921,4182
STAT,1808,61,na,1869,2020.2298325115173
STAT,1874,29,20-24,1903,24.086253685494675
SIM,1863,21,20-24,1884,116
SIM,1884,17,20-24,1901,43
STAT,1916,22,na,1938,7728.198599700589
STAT,1906,18,20-24,1924,52.03738268412962
SIM,1880,33,25-29,1913,28
SIM,1921,12,na,1933,9172
SIM,1896,34,30-34,1930,58
STAT,1926,18,40-44,1944,3.4537705969722787
STAT,1826,86,na,1912,265.609099882347
SIM,1892,39,25-29,1931,13
STAT,1836,36,25-29,1872,4.748949781424519
STAT,1970,2,na,1972,9947.40418793665
SIM,1823,32,40-44,1855,12
SIM,1922,24,40-44,1946,7
STAT,1886,52,na,1938,4566.117777870499
STAT,1892,24,45-49,1916,1.7519983651975621
STAT,1907,62,na,1969,6020.558760172364
STAT,1851,26,15-19,1877,0.8294475282130369
STAT,1825,33,45-49,1858,5.655646625797197
STAT,1910,29,35-39,1939,29.08153666213249
SIM,1869,100,na,1969,17
SIM,1922,26,50-100,1948,5
STAT,1867,27,20-24,1894,22.18915555761092
SIM,1858,63,na,1921,3037
STAT,1882,23,40-44,1905,4.087010575014716
SIM,1883,30,na,1913,5006
SIM,1890,23,40-44,1913,6
STAT,1875,21,40-44,1896,4.346052808406175
SIM,1858,46,na,1904,3870
STAT,1832,26,50-100,1858,1.1360933724195172
STAT,1857,43,35-39,1900,2.829985564018014
STAT,1888,34,30-34,1922,41.32065657313662
SIM,1934,18,40-44,1952,3
STAT,1855,21,20-24,1876,122.27706053926983
SIM,1882,29,20-24,1911,25
STAT,1909,33,30-34,1942,30.25253032522035
SIM,1833,33,45-49,1866,6
STAT,1872,33,25-29,1905,20.70209584781444
SIM,1914,18,20-24,1932,46
STAT,1783,98,na,1881,1.0212079381512198
STAT,1901,36,50-100,1937,0.7528518459812839
STAT,1838,24,25-29,1862,99.07960814141268
SIM,1865,43,35-39,1908,8
STAT,1889,21,35-39,1910,14.575576667466247
STAT,1914,24,40-44,1938,6.895457950038734
STAT,1827,38,40-44,1865,8.85708982163702
STAT,1865,31,25-29,1896,18.87004661523646
STAT,1900,19,30-34,1919,4.441476563289588
SIM,1829,31,30-34,1860,35
SIM,1889,27,15-19,1916,1
STAT,1884,39,25-29,1923,5.684108263192276
STAT,1845,45,30-34,1890,0.15064966082424902
SIM,1848,26,15-19,1874,1
SIM,1876,39,40-44,1915,16
SIM,1899,28,20-24,1927,35
SIM,1881,23,30-34,1904,40
STAT,1842,32,35-39,1874,18.213778120061434
STAT,1880,67,na,1947,3372.666681428678
STAT,1870,18,30-34,1888,3.1716815611654217
STAT,1878,54,25-29,1932,0.007265717942603749
STAT,1917,20,45-49,1937,2.4293660818993987
SIM,1824,40,na,1864,3417
SIM,1850,21,45-49,1871,2
STAT,1912,31,15-19,1943,0.25648855844735324
SIM,1915,38,25-29,1953,3
SIM,1846,24,25-29,1870,135
SIM,1833,21,45-49,1854,5
STAT,1953,14,na,1967,9592.534066043485
SIM,1940,22,35-39,1962,21
SIM,1926,35,30-34,1961,8
STAT,1851,53,na,1904,3284.211129433619
STAT,1882,50,35-39,1932,0.017180832486810172
SIM,1849,37,20-24,1886,3
SIM,1871,29,45-49,1900,4
STAT,1827,31,20-24,1858,7.025756152845641
SIM,1844,33,20-24,1877,6
STAT,1826,106,na,1932,0.014534878249238213
SIM,1809,83,na,1892,309
STAT,1871,22,na,1893,4745.505546630511
SIM,1876,23,50-100,1899,1
SIM,1838,22,40-44,1860,4
SIM,1866,41,na,1907,4502
STAT,1951,17,20-24,1968,326.03011261242744
SIM,1864,33,40-44,1897,12
SIM,1928,26,35-39,1954,43
STAT,1911,19,40-44,1930,0.5624160090126624
STAT,1881,18,40-44,1899,0.3561061863365651
STAT,1906,20,35-39,1926,17.275959090051305
SIM,1878,20,20-24,1898,147
SIM,1923,22,35-39,1945,29
SIM,1865,40,50-100,1905,4
STAT,1865,38,45-49,1903,3.639529758187555
STAT,1898,43,50-100,1941,0.19905688616687045
STAT,1894,22,20-24,1916,178.7863546179666
STAT,1926,44,20-24,1970,0.043816574216742475
SIM,1888,33,50-100,1921,5
STAT,1935,29,na,1964,10304.885820686284
SIM,1857,16,na,1873,4820
SIM,1902,32,50-100,1934,1
SIM,1919,21,30-34,1940,74
SIM,1853,45,30-34,1898,1
STAT,1879,70,na,1949,2963.962146549544
SIM,1884,42,50-100,1926,4
SIM,1885,22,20-24,1907,153
STAT,1868,39,40-44,1907,8.326829302468996
SIM,1905,20,25-29,1925,187
STAT,1933,14,na,1947,10678.65243355604
STAT,1925,33,15-19,1958,0.307937108434555
STAT,1851,44,45-49,1895,2.2887490663701464
SIM,1858,37,30-34,1895,14
SIM,1808,49,35-39,1857,1
SIM,1925,20,45-49,1945,4
STAT,1907,38,25-29,1945,1.8355374190762066
STAT,1922,22,na,1944,8455.424311433171
SIM,1830,49,45-49,1879,1
SIM,1817,61,na,1878,2206
STAT,1881,36,50-100,1917,2.4081888850834727
STAT,1840,16,na,1856,4315.282393649604
STAT,1863,47,40-44,1910,0.301253556481195
SIM,1850,32,35-39,1882,26
SIM,1918,3,na,1921,9160
STAT,1799,90,na,1889,64.37337845947513
STAT,1821,43,20-24,1864,0.49087209865671994
STAT,1861,42,50-100,1903,1.7737180617455446
SIM,1871,47,40-44,1918,1
SIM,1835,31,20-24,1866,9
SIM,1912,52,na,1964,7185
STAT,1831,32,25-29,1863,17.279197469250626
STAT,1939,27,15-19,1966,1.4334778771900443
STAT,1822,49,45-49,1871,0.7129203693822839
STAT,1936,33,25-29,1969,18.123505513409295
SIM,1914,20,35-39,1934,23
STAT,1847,43,40-44,1890,3.403897349905288
SIM,1889,45,45-49,1934,2
SIM,1918,29,45-49,1947,2
SIM,1928,27,50-100,1955,1
STAT,1891,22,na,1913,5904.064994660787
STAT,1906,12,na,1918,7600.18026357568
STAT,1842,21,45-49,1863,1.3189237435904113
SIM,1910,28,30-34,1938,100
SIM,1909,25,50-100,1934,7
STAT,1833,68,na,1901,2009.010983977666
STAT,1906,32,35-39,1938,17.11310767925313
STAT,1932,36,50-100,1968,1.1404270527906202
STAT,1836,54,20-24,1890,9.543828900684934E-4
SIM,1827,34,50-100,1861,5
SIM,1859,26,25-29,1885,90
STAT,1902,28,30-34,1930,71.5495691313581
SIM,1855,43,40-44,1898,8
SIM,1849,25,20-24,1874,28
STAT,1880,81,na,1961,1566.437017104839
STAT,1816,42,35-39,1858,9.97412329794728
SIM,1843,16,20-24,1859,1
SIM,1877,67,na,1944,3081
SIM,1895,44,25-29,1939,1
SIM,1907,29,35-39,1936,3
STAT,1897,34,40-44,1931,11.607346037898601
SIM,1860,16,20-24,1876,40
SIM,1835,80,na,1915,659
STAT,1839,53,na,1892,3308.036278318279
SIM,1913,37,na,1950,7638
SIM,1943,23,30-34,1966,88
STAT,1833,42,35-39,1875,2.889570702388344
SIM,1879,23,40-44,1902,4
SIM,1874,16,15-19,1890,13
STAT,1802,76,na,1878,836.5008872546915
STAT,1877,34,20-24,1911,5.620208315304443
STAT,1841,25,50-100,1866,1.1695398570264468
SIM,1869,33,25-29,1902,27
SIM,1933,33,15-19,1966,1
SIM,1889,33,45-49,1922,6
SIM,1885,34,20-24,1919,9
STAT,1834,98,na,1932,4.317109400306043
STAT,1931,36,na,1967,10072.376102858405
SIM,1784,83,na,1867,183
STAT,1884,74,na,1958,2408.5814937216537
SIM,1839,42,45-49,1881,5
STAT,1866,52,40-44,1918,0.01951362434062894
SIM,1887,25,25-29,1912,115
STAT,1880,21,15-19,1901,7.040105213869785
SIM,1819,49,45-49,1868,1
STAT,1858,49,25-29,1907,0.08879302984394892
STAT,1835,60,na,1895,2470.0682195876643
STAT,1879,25,25-29,1904,89.96703634381046
SIM,1942,22,50-100,1964,1
SIM,1923,44,na,1967,9104
STAT,1872,37,50-100,1909,2.491999222332157
STAT,1851,23,45-49,1874,1.2816272923227576
STAT,1872,25,50-100,1897,1.3072183914713666
STAT,1935,23,30-34,1958,79.03328340365238
SIM,1870,26,25-29,1896,85
STAT,1859,39,30-34,1898,8.481013200066927
STAT,1790,104,na,1894,0.026090506253635036
STAT,1929,23,40-44,1952,8.559993906456771
SIM,1928,33,40-44,1961,15
SIM,1853,23,na,1876,4104
STAT,1826,39,35-39,1865,15.671191158209487
STAT,1894,15,15-19,1909,15.46811437597167
STAT,1909,23,20-24,1932,208.18613446112676
SIM,1819,76,na,1895,856
SIM,1869,30,20-24,1899,5
STAT,1932,22,35-39,1954,24.953286433967005
STAT,1789,83,na,1872,277.23218623542016
SIM,1835,24,15-19,1859,6
STAT,1852,16,20-24,1868,34.376938191692496
SIM,1855,36,35-39,1891,15
SIM,1917,23,20-24,1940,225
STAT,1868,32,20-24,1900,5.193998712247417
STAT,1915,22,35-39,1937,19.65881314075043
STAT,1883,33,35-39,1916,20.010067098958896
STAT,1929,35,40-44,1964,3.887811528714427
SIM,1937,23,40-44,1960,9
STAT,1887,37,50-100,1924,2.773216359503225
SIM,1870,8,na,1878,5314
SIM,1862,38,35-39,1900,20
SIM,1876,32,20-24,1908,10
SIM,1933,37,na,1970,10805
STAT,1862,26,25-29,1888,73.81998140210007
SIM,1822,62,na,1884,2039
STAT,1872,38,na,1910,4758.303468393468
SIM,1834,39,35-39,1873,25
STAT,1875,8,na,1883,5571.018334996301
SIM,1848,44,45-49,1892,4
STAT,1887,44,25-29,1931,1.4309205816117885
STAT,1823,48,50-100,1871,0.7481481954592392
STAT,1905,27,50-100,1932,1.8684011584285376
STAT,1909,44,20-24,1953,0.03296890154584553
STAT,1946,16,35-39,1962,9.401459095508164
STAT,1826,80,na,1906,740.5247426949584
STAT,1882,17,45-49,1899,0.128515279098988
STAT,1872,16,40-44,1888,0.37467374134018316
SIM,1867,24,50-100,1891,4
STAT,1901,17,25-29,1918,16.021932324891818
STAT,1897,46,40-44,1943,0.2614474714439096
STAT,1898,33,45-49,1931,4.745906439822451
SIM,1841,42,35-39,1883,3
STAT,1847,36,35-39,1883,11.30309891806703
STAT,1860,67,na,1927,2599.8885544160867
SIM,1838,43,40-44,1881,4
STAT,1944,25,30-34,1969,85.59739263428648
SIM,1908,21,20-24,1929,211
SIM,1818,43,20-24,1861,1
SIM,1954,16,35-39,1970,10
SIM,1815,83,na,1898,380
STAT,1814,100,na,1914,0.9136831111105082
SIM,1933,27,20-24,1960,53
STAT,1852,37,20-24,1889,1.235253219571171
SIM,1843,26,30-34,1869,54
STAT,1946,0,na,1946,9961.06637331514
SIM,1902,15,25-29,1917,25
STAT,1852,29,35-39,1881,16.066732024796508
STAT,1897,49,45-49,1946,0.3518824876454905
SIM,1925,28,40-44,1953,15
STAT,1865,17,45-49,1882,0.12350784319561413
STAT,1873,85,na,1958,718.1345508123421
STAT,1923,39,20-24,1962,0.6153634410371397
STAT,1860,28,15-19,1888,0.7466826941584062
SIM,1828,38,50-100,1866,3
STAT,1850,49,20-24,1899,0.018015075833662398
SIM,1896,37,35-39,1933,21
STAT,1903,27,35-39,1930,27.746095760784197
SIM,1784,80,na,1864,330
STAT,1832,25,35-39,1857,17.36658716018807
SIM,1846,75,na,1921,1448
SIM,1913,15,35-39,1928,2
STAT,1844,38,40-44,1882,7.393128600883489
STAT,1863,29,45-49,1892,1.9488763791384431
SIM,1862,27,50-100,1889,3
SIM,1875,89,na,1964,437
STAT,1861,54,50-100,1915,0.024689699595984514
STAT,1846,26,40-44,1872,5.590890750477528
SIM,1933,19,35-39,1952,9
STAT,1804,54,na,1858,2240.793857396243
STAT,1854,17,35-39,1871,1.006232991856863
STAT,1905,15,35-39,1920,1.610105242221667
STAT,1879,32,30-34,1911,36.883253411443555
STAT,1917,28,40-44,1945,9.83655791084375
SIM,1897,36,na,1933,6465
SIM,1862,17,35-39,1879,1
SIM,1887,32,30-34,1919,47
SIM,1929,29,20-24,1958,46
STAT,1882,48,na,1930,4370.71228096044
STAT,1898,23,35-39,1921,15.899596949230043
STAT,1936,19,45-49,1955,0.9609126405962621
SIM,1919,22,na,1941,8114
STAT,1838,48,50-100,1886,0.33761471535720144
SIM,1873,31,25-29,1904,5
SIM,1916,16,30-34,1932,6
SIM,1880,30,20-24,1910,7
STAT,1809,46,na,1855,2847.052530428292
STAT,1866,16,15-19,1882,11.418332023659172
STAT,1873,23,30-34,1896,36.438859564983
SIM,1905,24,40-44,1929,8
SIM,1911,27,35-39,1938,37
STAT,1837,51,35-39,1888,0.012286337914994803
STAT,1887,23,25-29,1910,128.90641270150513
STAT,1925,19,35-39,1944,10.18032081604177
STAT,1835,26,30-34,1861,42.83300525485942
SIM,1891,30,30-34,1921,56
SIM,1831,76,na,1907,1130
SIM,1895,23,25-29,1918,165
STAT,1838,106,na,1944,0.01643216367666703
STAT,1875,49,25-29,1924,0.11726992988983664
SIM,1885,37,25-29,1922,7
SIM,1846,48,50-100,1894,2
SIM,1889,20,30-34,1909,60
STAT,1884,15,20-24,1899,35.51975342669554
STAT,1919,16,40-44,1935,0.6277137075303627
SIM,1870,97,na,1967,44
SIM,1927,16,40-44,1943,7
STAT,1862,23,20-24,1885,120.90044087295377
SIM,1789,72,na,1861,1050
STAT,1925,9,na,1934,9710.121110424625
SIM,1898,32,40-44,1930,18
SIM,1870,23,20-24,1893,141
STAT,1892,42,40-44,1934,5.679833456537429
STAT,1918,23,30-34,1941,62.40034169003822
STAT,1831,87,na,1918,227.47548443491084
STAT,1880,25,30-34,1905,53.93980976039289
STAT,1819,53,na,1872,2560.7682169714963
STAT,1825,39,na,1864,3240.950953047737
STAT,1812,53,50-100,1865,0.0981341023194715
STAT,1825,51,40-44,1876,0.02244864356523376
STAT,1877,37,25-29,1914,6.038131980602042
STAT,1886,49,35-39,1935,0.29224009311761123
STAT,1883,30,30-34,1913,34.92333259600902
STAT,1921,26,40-44,1947,10.524861141959118
SIM,1883,49,25-29,1932,1
STAT,1838,21,20-24,1859,121.87889150918542
STAT,1846,86,na,1932,339.8497763615939
STAT,1885,1,na,1886,6650.949949635412
SIM,1832,34,40-44,1866,12
SIM,1859,93,na,1952,23
STAT,1814,49,50-100,1863,1.2333598800662744
STAT,1910,26,30-34,1936,76.70606743915657
SIM,1899,38,30-34,1937,4
STAT,1856,45,na,1901,3540.7344498013385
SIM,1920,9,na,1929,9247
STAT,1839,27,45-49,1866,2.1840207422236375
SIM,1868,56,na,1924,3993
STAT,1872,30,20-24,1902,5.5306091614258355
SIM,1848,53,na,1901,3246
STAT,1879,73,na,1952,2509.1003069950857
SIM,1899,14,na,1913,7224
SIM,1860,31,50-100,1891,4
STAT,1875,5,na,1880,5704.647867220895
SIM,1876,25,15-19,1901,1
STAT,1891,21,25-29,1912,143.33836838378707
STAT,1822,46,40-44,1868,0.5399482965371136
STAT,1866,52,na,1918,3991.0243489154745
STAT,1889,80,na,1969,2423.627218253749
SIM,1870,44,20-24,1914,1
SIM,1926,23,30-34,1949,92
STAT,1826,47,20-24,1873,0.023928965546463767
STAT,1946,26,45-49,1972,3.888102824956454
STAT,1818,48,40-44,1866,0.7431720708296353
SIM,1903,36,40-44,1939,6
SIM,1922,27,45-49,1949,4
SIM,1881,36,45-49,1917,5
SIM,1840,25,35-39,1865,28
SIM,1865,40,30-34,1905,4
STAT,1834,20,40-44,1854,7.016771831434947
STAT,1945,20,20-24,1965,246.27715979987366
STAT,1861,19,50-100,1880,0.09354662890719824
SIM,1897,33,na,1930,6511
STAT,1888,37,35-39,1925,16.883524189718457
STAT,1908,49,30-34,1957,0.16197639800938443
SIM,1817,95,na,1912,1
SIM,1892,18,25-29,1910,15
STAT,1877,16,25-29,1893,11.913213424048063
SIM,1866,25,20-24,1891,21
STAT,1938,31,35-39,1969,18.571417561598285
SIM,1907,2,na,1909,7988
STAT,1891,25,40-44,1916,7.528805782865894
SIM,1856,39,20-24,1895,2
STAT,1884,18,25-29,1902,11.271380618951582
SIM,1814,45,45-49,1859,1
STAT,1923,37,50-100,1960,0.9821896780225979
SIM,1852,38,40-44,1890,11
SIM,1883,24,45-49,1907,1
SIM,1833,57,na,1890,2585
STAT,1929,40,na,1969,9739.684923362398
SIM,1830,46,40-44,1876,1
SIM,1876,22,45-49,1898,4
STAT,1862,44,20-24,1906,0.2704428333312761
SIM,1931,37,50-100,1968,1
STAT,1815,110,na,1925,2.5685617098063554E-4
SIM,1914,30,na,1944,7880
STAT,1824,34,40-44,1858,15.349687561144252
SIM,1860,104,na,1964,1
STAT,1893,38,20-24,1931,1.963491682010338
STAT,1854,19,na,1873,4159.983627483087
STAT,1914,27,45-49,1941,3.51798325781893
SIM,1964,4,na,1968,10486
STAT,1848,39,20-24,1887,1.2757708098309206
STAT,1824,30,25-29,1854,65.72967468018915
STAT,1861,16,30-34,1877,3.0978006419058968
STAT,1896,11,na,1907,6896.350998141009
SIM,1847,27,45-49,1874,4
STAT,1858,25,20-24,1883,19.182342515963292
STAT,1836,33,20-24,1869,4.496890976002792
STAT,1869,46,30-34,1915,0.18996957910282422
STAT,1904,34,na,1938,6916.408039165982
SIM,1790,69,na,1859,1439
SIM,1856,82,na,1938,669
SIM,1854,22,25-29,1876,124
STAT,1837,39,45-49,1876,3.3140601408861876
SIM,1845,39,45-49,1884,2
SIM,1842,20,40-44,1862,1
SIM,1936,11,na,1947,6873
SIM,1839,32,35-39,1871,26
SIM,1858,3,na,1861,5389
SIM,1860,29,35-39,1889,28
STAT,1873,36,45-49,1909,4.110435584867252
STAT,1852,31,50-100,1883,1.5277704499402376
SIM,1904,23,na,1927,6923
SIM,1854,26,40-44,1880,6
STAT,1904,22,25-29,1926,165.94012789881884
STAT,1925,6,na,1931,9776.451941572457
STAT,1947,19,20-24,1966,308.21085531894863
STAT,1830,37,35-39,1867,13.25538682913641
SIM,1912,22,25-29,1934,198
STAT,1896,36,50-100,1932,3.2894444988050937
STAT,1919,33,na,1952,8204.353571804313
SIM,1931,39,20-24,1970,3
SIM,1832,30,25-29,1862,28
STAT,1914,41,na,1955,7444.337513810362
SIM,1880,1,na,1881,7235
STAT,1925,27,20-24,1952,43.53409379133922
SIM,1844,36,25-29,1880,6
SIM,1928,23,30-34,1951,90
STAT,1905,39,50-100,1944,0.7662095813398513
STAT,1838,31,30-34,1869,29.669289633166745
STAT,1857,22,35-39,1879,10.604933766826344
SIM,1855,33,30-34,1888,42
SIM,1882,34,na,1916,4896
SIM,1895,55,na,1950,5660
STAT,1844,20,na,1864,4373.742836042344
STAT,1808,48,15-19,1856,0.0024811767518643254
STAT,1840,61,na,1901,2697.263981787435
SIM,1908,24,25-29,1932,178
STAT,1857,41,na,1898,3654.80920029801
STAT,1959,8,na,1967,10380.610471993927
STAT,1884,36,20-24,1920,1.5446801919057866
STAT,1909,36,35-39,1945,4.648537760810099
SIM,1926,38,35-39,1964,8
STAT,1815,47,45-49,1862,1.2682010239516888
SIM,1871,42,na,1913,4482
SIM,1838,25,45-49,1863,4
STAT,1876,23,15-19,1899,6.86990464656744
STAT,1924,34,45-49,1958,3.7019353049689743
STAT,1929,38,45-49,1967,1.765637721926501
STAT,1785,79,na,1864,584.9875940976021
STAT,1845,48,35-39,1893,0.2130203280626073
STAT,1846,22,25-29,1868,108.18948154379811
STAT,1878,52,35-39,1930,0.018062424227814965
STAT,1910,16,20-24,1926,54.40795585134209
SIM,1867,39,30-34,1906,16
STAT,1827,34,25-29,1861,22.940479204303767
STAT,1792,72,na,1864,1092.8118448593107
STAT,1816,79,na,1895,686.6978886240273
STAT,1851,41,40-44,1892,3.502565211256128
SIM,1844,94,na,1938,14
STAT,1897,16,45-49,1913,0.17678048517117523
SIM,1864,49,na,1913,4204
SIM,1949,22,20-24,1971,256
STAT,1840,17,40-44,1857,0.34182061448373385
STAT,1847,33,30-34,1880,30.92610406830858
STAT,1869,18,na,1887,4981.385080892318
SIM,1909,35,30-34,1944,5
STAT,1878,26,50-100,1904,1.3539340453051643
STAT,1806,80,na,1886,528.0315564195666
SIM,1932,34,45-49,1966,5
STAT,1807,65,na,1872,1858.5272752332928
STAT,1849,31,40-44,1880,8.026350239153677
STAT,1868,22,45-49,1890,1.3399218048351649
STAT,1915,47,15-19,1962,7.497290008368565E-4
STAT,1795,86,na,1881,154.05217690692183
SIM,1834,47,20-24,1881,1
SIM,1813,88,na,1901,100
STAT,1837,27,na,1864,3869.773151527761
STAT,1848,20,35-39,1868,11.819724583934406
STAT,1912,42,50-100,1954,0.22889560507293008
SIM,1863,24,25-29,1887,105
STAT,1834,48,25-29,1882,0.0802790084867056
SIM,1859,103,na,1962,1
SIM,1877,27,50-100,1904,1
STAT,1877,22,50-100,1899,0.8552010014878013
SIM,1846,31,30-34,1877,44
STAT,1870,35,15-19,1905,0.11240225033680795
STAT,1943,18,40-44,1961,2.9945177249342314
STAT,1861,107,na,1968,0.0854533840529535
SIM,1884,27,30-34,1911,9
SIM,1917,26,25-29,1943,165
STAT,1938,21,25-29,1959,184.72104641484103
SIM,1877,28,35-39,1905,30
SIM,1906,26,15-19,1932,3
STAT,1892,27,15-19,1919,1.147094270716047
SIM,1892,36,20-24,1928,4
STAT,1843,27,na,1870,3729.3838421964856
STAT,1832,35,45-49,1867,3.354577770261583
STAT,1855,24,25-29,1879,99.40329365402529
STAT,1859,20,45-49,1879,1.296585115782095
SIM,1918,24,50-100,1942,1
STAT,1817,72,na,1889,1317.103186635538
STAT,1899,25,na,1924,6648.643352174739
STAT,1817,45,20-24,1862,0.05979480067331382
SIM,1846,21,20-24,1867,123
SIM,1851,42,na,1893,3668
SIM,1828,36,40-44,1864,11
STAT,1859,35,15-19,1894,0.09112513544577056
STAT,1954,16,50-100,1970,0.9355635286976299
SIM,1831,23,35-39,1854,17
SIM,1886,26,50-100,1912,1
STAT,1903,43,50-100,1946,0.20943363407031307
STAT,1858,26,na,1884,3874.2361100319276
STAT,1853,34,na,1887,3808.198088079652
SIM,1894,70,na,1964,4154
STAT,1855,60,na,1915,2875.90179559094
STAT,1887,27,40-44,1914,6.766357792085793
SIM,1853,57,na,1910,3236
STAT,1927,21,15-19,1948,13.28353409882796
STAT,1836,19,40-44,1855,0.4659437045463024
SIM,1895,27,40-44,1922,13
SIM,1930,2,na,1932,11195
SIM,1951,18,40-44,1969,4
STAT,1865,35,40-44,1900,8.108171199100447
SIM,1935,21,15-19,1956,17
STAT,1918,38,35-39,1956,5.142761330070923
SIM,1888,42,25-29,1930,1
SIM,1873,35,40-44,1908,13
STAT,1850,111,na,1961,3.957227480720746E-4
STAT,1871,50,25-29,1921,0.007209234097672329
STAT,1889,18,na,1907,6272.8692696563285
STAT,1899,29,25-29,1928,116.21729109557792
SIM,1840,35,45-49,1875,5
STAT,1836,79,na,1915,929.5185757362713
STAT,1889,44,50-100,1933,2.5953001860270093
STAT,1834,38,15-19,1872,0.09201792003907958
STAT,1935,26,35-39,1961,41.35872641078456
SIM,1933,37,30-34,1970,6
STAT,1829,37,50-100,1866,2.14592999373184
SIM,1910,24,15-19,1934,10
STAT,1864,21,30-34,1885,32.91008429918592
STAT,1833,28,20-24,1861,20.240282612719636
STAT,1852,19,25-29,1871,10.795186787359935
STAT,1876,27,30-34,1903,52.60145635851916
SIM,1893,29,30-34,1922,77
SIM,1920,19,na,1939,8538
STAT,1866,37,15-19,1903,0.10464288711639237
STAT,1841,37,45-49,1878,3.407826930916203
SIM,1927,30,20-24,1957,6
STAT,1855,50,40-44,1905,0.016103135096280582
STAT,1895,18,35-39,1913,1.4402164645181432
SIM,1879,48,na,1927,4529
STAT,1870,28,40-44,1898,5.918778038956088
SIM,1856,20,35-39,1876,15
STAT,1848,103,na,1951,0.23532261887564396
STAT,1822,40,35-39,1862,6.427773130307079
SIM,1841,28,20-24,1869,24
SIM,1860,19,25-29,1879,17
SIM,1834,50,na,1884,2944
STAT,1842,42,na,1884,3560.09510284904
STAT,1903,45,30-34,1948,0.15858045826259623
SIM,1946,21,25-29,1967,222
SIM,1907,37,20-24,1944,1
STAT,1867,48,20-24,1915,0.022411906250811103
STAT,1869,25,30-34,1894,49.61378318032459
SIM,1888,28,45-49,1916,1
SIM,1857,31,40-44,1888,13
STAT,1815,91,na,1906,53.862478755872274
STAT,1908,16,30-34,1924,4.789980330777031
STAT,1952,20,50-100,1972,1.5987462404171193
STAT,1888,84,na,1972,1647.149809991078
SIM,1821,34,30-34,1855,38
SIM,1869,37,40-44,1906,15
STAT,1786,72,na,1858,962.9041887536034
SIM,1826,38,30-34,1864,15
STAT,1770,107,na,1877,0.01340200780116731
STAT,1825,36,15-19,1861,0.15339234545908392
STAT,1944,28,35-39,1972,32.7540268839691
SIM,1824,43,na,1867,3290
SIM,1847,41,25-29,1888,1
STAT,1850,20,25-29,1870,106.87899174175786
STAT,1925,37,30-34,1962,4.416990448451077
STAT,1843,32,50-100,1875,1.543005048976548
SIM,1811,44,15-19,1855,1
STAT,1843,17,25-29,1860,10.144286339995888
STAT,1887,41,20-24,1928,0.360348861720162
STAT,1914,38,50-100,1952,0.8425689153636637
STAT,1885,29,30-34,1914,50.261264263160804
SIM,1901,22,15-19,1923,10
STAT,1913,48,na,1961,7223.597257892842
SIM,1835,35,na,1870,3636
SIM,1945,25,na,1970,8632
STAT,1875,39,15-19,1914,0.11558988790693425
STAT,1888,47,45-49,1935,0.5607210157627123
SIM,1872,21,30-34,1893,48
STAT,1802,73,na,1875,1111.6242766010914
SIM,1865,22,35-39,1887,16
STAT,1854,31,15-19,1885,0.2258952502627397
STAT,1860,38,25-29,1898,4.698700141899457
SIM,1880,56,na,1936,4510
SIM,1881,26,35-39,1907,21
STAT,1828,27,35-39,1855,32.86172259846303
SIM,1851,17,25-29,1868,11
STAT,1870,18,50-100,1888,0.09749019210030936
STAT,1913,34,35-39,1947,18.209744890273946
SIM,1840,50,na,1890,3398
SIM,1921,34,35-39,1955,33
SIM,1930,26,na,1956,10120
SIM,1928,36,45-49,1964,5
SIM,1906,44,45-49,1950,1
STAT,1919,30,20-24,1949,5.356375083922405
SIM,1878,39,40-44,1917,12
STAT,1890,26,na,1916,5903.341352987685
STAT,1879,22,20-24,1901,145.57606619981502
SIM,1830,40,35-39,1870,6
STAT,1940,17,45-49,1957,1.024431124487634
SIM,1879,26,45-49,1905,5
SIM,1836,27,35-39,1863,1
SIM,1943,26,35-39,1969,46
SIM,1887,22,20-24,1909,164
STAT,1897,47,na,1944,6046.572288175969
STAT,1858,46,20-24,1904,0.018946661398263016
STAT,1815,41,30-34,1856,7.170452557587959
STAT,1925,16,15-19,1941,110.97055142198346
STAT,1857,44,15-19,1901,0.021445950442192507
STAT,1921,43,na,1964,8432.826395830894
SIM,1867,98,na,1965,19
SIM,1878,24,30-34,1902,41
STAT,1843,45,25-29,1888,0.08239536611888018
SIM,1883,28,30-34,1911,61
STAT,1927,24,25-29,1951,228.36726660641196
SIM,1863,84,na,1947,636
STAT,1924,23,45-49,1947,2.672409905874424
STAT,1847,26,na,1873,3992.166974823334
STAT,1856,51,45-49,1907,0.02272196691016337
STAT,1922,15,35-39,1937,9.85068643752183
SIM,1871,28,na,1899,4646
STAT,1833,32,35-39,1865,17.177751567935633
SIM,1913,39,20-24,1952,1
STAT,1944,21,20-24,1965,242.53622642941895
SIM,1822,86,na,1908,169
STAT,1863,49,45-49,1912,0.40851322757029324
STAT,1878,43,20-24,1921,0.3325645834397213
SIM,1781,87,na,1868,100
STAT,1870,27,40-44,1897,5.939685732735314
STAT,1904,42,50-100,1946,0.21239606658606222
STAT,1814,47,na,1861,2643.355513751422
SIM,1928,34,35-39,1962,35
STAT,1851,31,na,1882,3890.410790258781
STAT,1889,29,50-100,1918,1.5815976543288284
SIM,1841,32,35-39,1873,29
SIM,1837,43,25-29,1880,3
SIM,1789,67,na,1856,1490
SIM,1933,16,15-19,1949,119
STAT,1880,46,40-44,1926,0.36527464618520455
SIM,1888,44,na,1932,5378
STAT,1799,100,na,1899,0.7219842039301957
STAT,1823,83,na,1906,476.3849670082935
SIM,1926,35,na,1961,9530
SIM,1896,15,35-39,1911,2
STAT,1861,29,40-44,1890,4.999577915061783
SIM,1932,23,45-49,1955,6
STAT,1868,95,na,1963,70.24328078349446
SIM,1804,73,na,1877,982
STAT,1888,28,40-44,1916,7.125435991157669
STAT,1864,81,na,1945,976.2472941263429
STAT,1845,53,35-39,1898,0.013053006511804575
STAT,1911,36,40-44,1947,2.935067446166893
SIM,1827,29,30-34,1856,60
STAT,1820,45,30-34,1865,0.3708121855836031
STAT,1843,54,50-100,1897,0.020574417584810482
SIM,1834,42,45-49,1876,4
SIM,1883,13,na,1896,5351
SIM,1887,22,30-34,1909,50
STAT,1820,41,50-100,1861,4.397563487477538
STAT,1887,35,50-100,1922,2.7995539313096196
STAT,1894,26,15-19,1920,1.1811238674117424
SIM,1922,21,na,1943,8824
STAT,1882,32,30-34,1914,34.35018997701811
STAT,1906,36,50-100,1942,0.7836263962120211
SIM,1884,30,na,1914,5167
STAT,1877,17,25-29,1894,11.88402605115914
SIM,1896,28,40-44,1924,7
STAT,1879,22,30-34,1901,37.62804045155615
SIM,1895,36,25-29,1931,13
STAT,1871,40,30-34,1911,2.3301032881565193
STAT,1847,53,45-49,1900,0.02176668934630443
STAT,1941,20,40-44,1961,7.022773450343842
SIM,1842,90,na,1932,87
SIM,1829,37,40-44,1866,12
SIM,1853,19,30-34,1872,1
STAT,1918,31,20-24,1949,5.255232073474997
STAT,1829,43,25-29,1872,1.0407254865715028
STAT,1909,33,20-24,1942,4.683601959542682
STAT,1860,101,na,1961,2.47306820239534
STAT,1832,48,50-100,1880,0.3737341994502096
SIM,1862,43,35-39,1905,6
SIM,1949,19,30-34,1968,35
STAT,1896,34,25-29,1930,27.077342790785135
SIM,1930,15,35-39,1945,20
SIM,1938,20,na,1958,7322
STAT,1876,29,50-100,1905,1.3266774024543813
STAT,1917,42,50-100,1959,0.2475851742532942
STAT,1864,50,40-44,1914,0.01927878497061814
SIM,1889,25,45-49,1914,4
STAT,1802,100,na,1902,0.8147942325095888
SIM,1875,43,45-49,1918,10
SIM,1919,36,35-39,1955,8
STAT,1877,22,20-24,1899,144.52040192459808
STAT,1934,18,na,1952,10029.987713410626
STAT,1874,49,20-24,1923,0.02429686085524572
SIM,1872,45,na,1917,4810
SIM,1821,42,35-39,1863,6
STAT,1871,53,50-100,1924,0.029817332172831005
STAT,1909,20,15-19,1929,10.05696431349991
STAT,1805,86,na,1891,165.96546506769425
STAT,1847,47,50-100,1894,0.37263298305744935
SIM,1809,47,40-44,1856,1
STAT,1826,32,na,1858,3493.93326792891
STAT,1889,44,35-39,1933,4.448480235075373
STAT,1860,47,50-100,1907,0.4009264488356151
SIM,1939,6,na,1945,8324
STAT,1852,48,30-34,1900,0.1523422866919029
STAT,1827,35,15-19,1862,0.12296185880050373
STAT,1847,27,40-44,1874,5.488415508651807
STAT,1915,38,50-100,1953,0.8524199279047566
SIM,1880,64,na,1944,3777
STAT,1766,105,na,1871,0.023865753481532147
STAT,1861,27,15-19,1888,0.7682187955267088
STAT,1880,33,35-39,1913,21.455147933694704
STAT,1893,62,na,1955,4678.768824648811
SIM,1968,2,na,1970,10509
STAT,1901,29,35-39,1930,27.08609813695188
SIM,1917,33,20-24,1950,7
STAT,1933,21,45-49,1954,3.0236711213738667
SIM,1818,81,na,1899,423
SIM,1941,21,45-49,1962,3
STAT,1792,105,na,1897,0.010986223848914298
STAT,1836,18,50-100,1854,0.16103503779334688
STAT,1871,48,40-44,1919,0.33919908823560974
STAT,1919,18,40-44,1937,3.1128831198543754
SIM,1873,35,35-39,1908,23
SIM,1890,32,30-34,1922,62
SIM,1887,17,35-39,1904,1
SIM,1855,27,40-44,1882,6
STAT,1865,35,35-39,1900,13.100724456142116
SIM,1884,44,25-29,1928,1
SIM,1837,23,30-34,1860,1
SIM,1952,16,25-29,1968,145
STAT,1847,52,30-34,1899,0.009025416150024841
SIM,1823,41,30-34,1864,4
STAT,1815,50,45-49,1865,0.07775651273940523
SIM,1869,41,na,1910,4493
STAT,1909,18,50-100,1927,0.1480753033333958
STAT,1870,39,35-39,1909,13.883232268846923
SIM,1918,16,na,1934,8759
STAT,1898,22,40-44,1920,5.695232370677651
STAT,1922,20,30-34,1942,66.94495429860011
STAT,1834,101,na,1935,0.7583233000759528
STAT,1884,40,40-44,1924,4.530926362489131
SIM,1842,47,na,1889,3228
STAT,1826,64,na,1890,2080.9976333822715
SIM,1851,67,na,1918,2405
STAT,1822,40,50-100,1862,3.750044941032028
STAT,1880,28,na,1908,5059.629634459324
SIM,1839,43,na,1882,3305
SIM,1956,4,na,1960,10711
STAT,1843,50,20-24,1893,0.001048545118876783
SIM,1863,33,25-29,1896,24
SIM,1793,72,na,1865,1005
STAT,1845,53,50-100,1898,0.02289870278260694
STAT,1831,24,25-29,1855,112.37297634499654
STAT,1910,44,25-29,1954,0.13467470224657285
SIM,1890,41,45-49,1931,11
SIM,1797,86,na,1883,114
STAT,1882,41,45-49,1923,2.9578080086951344
SIM,1843,39,40-44,1882,12
STAT,1868,38,40-44,1906,8.369766203090856
STAT,1913,44,50-100,1957,0.23066468652343813
STAT,1920,29,45-49,1949,3.7992423128169857
STAT,1835,39,40-44,1874,6.868266325070316
STAT,1801,72,na,1873,1193.510949893871
STAT,1858,30,50-100,1888,1.4728251927383413
STAT,1889,57,na,1946,5004.449137516455
SIM,1876,38,40-44,1914,9
STAT,1858,17,15-19,1875,10.914409115363396
SIM,1866,17,15-19,1883,9
STAT,1867,43,45-49,1910,2.8103331111661816
SIM,1876,59,na,1935,4289
SIM,1834,28,na,1862,3679
SIM,1840,19,20-24,1859,36
SIM,1935,24,25-29,1959,302
STAT,1928,33,30-34,1961,39.756102315822204
SIM,1892,40,40-44,1932,12
STAT,1885,43,na,1928,4612.712799954417
SIM,1839,31,40-44,1870,11
STAT,1866,102,na,1968,3.80665338958891
STAT,1874,36,15-19,1910,0.11668175562294945
SIM,1936,33,30-34,1969,30
STAT,1856,62,na,1918,2848.0367889814306
STAT,1916,49,50-100,1965,0.46577796460370263
SIM,1821,69,na,1890,1619
STAT,1903,15,25-29,1918,16.370740304790807
STAT,1838,22,50-100,1860,0.7160412680785578
STAT,1903,6,na,1909,7511.996405821162
STAT,1848,31,40-44,1879,8.37918397830721
SIM,1881,17,40-44,1898,1
STAT,1818,100,na,1918,1.0891872223885661
STAT,1850,24,35-39,1874,10.585437384234362
SIM,1912,59,na,1971,6847
STAT,1870,25,15-19,1895,0.9057170347505226
STAT,1890,40,40-44,1930,5.60076487607165
SIM,1822,32,25-29,1854,19
STAT,1838,29,40-44,1867,5.083358790802968
STAT,1776,88,na,1864,86.01952230705317
STAT,1921,11,na,1932,9132.934151552701
SIM,1835,37,40-44,1872,10
STAT,1814,79,na,1893,601.6706502524254
SIM,1943,18,50-100,1961,1
SIM,1945,26,35-39,1971,51
SIM,1859,63,na,1922,3110
STAT,1891,36,15-19,1927,0.1408579521629514
STAT,1837,42,20-24,1879,0.26125284501042995
STAT,1853,25,15-19,1878,0.8436673702688434
STAT,1809,49,40-44,1858,1.2798277529855655
STAT,1881,23,25-29,1904,111.40278499425506
STAT,1880,12,na,1892,5494.476722957911
STAT,1829,26,35-39,1855,35.167059940671265
STAT,1831,70,na,1901,1811.5765960763827
STAT,1824,45,15-19,1869,9.963676372519985E-4
STAT,1913,56,na,1969,6973.808992130466
SIM,1817,49,40-44,1866,2
SIM,1877,60,na,1937,3778
STAT,1798,99,na,1897,1.025245717075761
STAT,1794,85,na,1879,184.05797659007985
STAT,1862,15,na,1877,4592.069305298022
STAT,1876,44,25-29,1920,1.3232699123711362
STAT,1866,29,na,1895,4415.45242119791
SIM,1880,25,25-29,1905,94
SIM,1913,23,35-39,1936,23
STAT,1944,16,25-29,1960,94.2060703063222
STAT,1905,23,35-39,1928,16.991490893896174
SIM,1892,65,na,1957,4906
STAT,1834,27,30-34,1861,43.95478357469078
STAT,1858,53,20-24,1911,0.0011431399572009659
STAT,1897,46,35-39,1943,0.21380050284204
STAT,1818,37,15-19,1855,0.3885694761870528
STAT,1835,84,na,1919,430.8460239007776
SIM,1861,25,15-19,1886,1
STAT,1813,42,35-39,1855,13.45569867894655
SIM,1857,22,45-49,1879,1
SIM,1872,22,50-100,1894,1
SIM,1842,27,30-34,1869,69
STAT,1809,53,25-29,1862,0.025588631263313222
STAT,1839,98,na,1937,5.072364292595731
SIM,1868,25,25-29,1893,75
STAT,1894,28,40-44,1922,7.744325120681593
STAT,1849,22,45-49,1871,1.3335867844726927
STAT,1855,29,40-44,1884,4.640968779636157
STAT,1896,37,50-100,1933,3.273688059655818
STAT,1933,37,30-34,1970,5.014173338306348
STAT,1855,109,na,1964,0.006246051825991028
STAT,1830,42,35-39,1872,3.2458826378278847
SIM,1863,16,35-39,1879,1
SIM,1856,31,40-44,1887,11
SIM,1907,26,15-19,1933,2
STAT,1869,54,35-39,1923,0.016384115670342113
STAT,1818,47,40-44,1865,0.7547293733254177
SIM,1846,29,40-44,1875,9
STAT,1896,17,35-39,1913,1.463093592145892
SIM,1867,41,45-49,1908,7
SIM,1852,27,15-19,1879,1
STAT,1871,51,na,1922,4341.034606792507
STAT,1822,34,na,1856,3201.929362068011
STAT,1826,48,na,1874,3019.3466317187317
STAT,1928,36,35-39,1964,6.17825506742152
SIM,1906,33,45-49,1939,6
STAT,1875,53,20-24,1928,0.0015097574986553271
SIM,1863,29,40-44,1892,7
STAT,1839,53,35-39,1892,0.01322659643508371
STAT,1844,27,15-19,1871,0.8969369768527634
STAT,1847,10,na,1857,4598.693197215314
STAT,1875,65,na,1940,3514.026216807325
STAT,1823,51,50-100,1874,0.04582106945721621
SIM,1873,40,30-34,1913,6
STAT,1865,40,30-34,1905,2.1307090452859114
STAT,1900,42,15-19,1942,0.0026834022223741747
SIM,1864,42,30-34,1906,6
SIM,1867,82,na,1949,856
STAT,1850,48,20-24,1898,0.018168050821580094
SIM,1904,22,30-34,1926,57
STAT,1893,78,na,1971,2953.4888434237673
STAT,1926,44,50-100,1970,0.29147546640725003
SIM,1837,26,35-39,1863,23
STAT,1874,30,30-34,1904,36.39542700500737
STAT,1937,31,30-34,1968,31.505171899454183
STAT,1824,34,35-39,1858,35.8444687796206
STAT,1874,21,40-44,1895,4.322148828250474
STAT,1796,92,na,1888,23.75926392758868
STAT,1862,51,50-100,1913,0.02619512180437226
SIM,1902,39,45-49,1941,1
STAT,1867,30,na,1897,4549.807798364441
STAT,1929,15,45-49,1944,1.2933975817898191
SIM,1783,94,na,1877,4
SIM,1878,44,25-29,1922,3
SIM,1854,32,na,1886,4080
STAT,1864,27,40-44,1891,5.407919943218816
STAT,1900,39,50-100,1939,0.7349513016048886
STAT,1857,21,40-44,1878,3.8143340849483445
STAT,1858,1,na,1859,5838.337404046533
STAT,1913,22,30-34,1935,56.26144228867423
SIM,1872,27,40-44,1899,11
STAT,1821,52,50-100,1873,0.04252035056464041
STAT,1885,28,15-19,1913,0.9088659737198005
STAT,1918,26,25-29,1944,141.92989371658842
SIM,1893,28,15-19,1921,1
STAT,1770,103,na,1873,0.086898893781781
SIM,1779,89,na,1868,61
SIM,1921,22,30-34,1943,74
STAT,1859,41,45-49,1900,2.416718724000517
SIM,1846,13,na,1859,4635
SIM,1865,21,40-44,1886,4
SIM,1926,31,20-24,1957,6
STAT,1838,21,30-34,1859,31.50286980281297
STAT,1855,16,35-39,1871,0.9899613135269016
STAT,1841,34,35-39,1875,17.46137876488512
SIM,1846,21,30-34,1867,46
SIM,1902,22,20-24,1924,189
STAT,1827,37,40-44,1864,9.097158565063479
STAT,1891,30,30-34,1921,43.93647737515869
STAT,1834,52,20-24,1886,0.001007175815096432
STAT,1863,32,20-24,1895,4.778739363354773
STAT,1869,26,50-100,1895,1.2561353083831004
STAT,1881,50,40-44,1931,0.020846151494491948
STAT,1937,26,35-39,1963,29.576545646648242
STAT,1833,35,15-19,1868,0.09441813846262587
STAT,1891,49,20-24,1940,0.016545191877473976
STAT,1850,7,na,1857,4637.474920465671
SIM,1852,5,na,1857,4991
STAT,1834,47,50-100,1881,0.3467144496564038
SIM,1882,30,30-34,1912,44
SIM,1900,28,30-34,1928,80
STAT,1835,37,15-19,1872,0.08995492057431294
SIM,1832,34,35-39,1866,30
SIM,1846,16,35-39,1862,1
STAT,1873,58,na,1931,4058.1410179046934
SIM,1840,83,na,1923,590
STAT,1875,28,30-34,1903,52.17770856877595
SIM,1909,55,na,1964,6691
SIM,1833,54,na,1887,2760
SIM,1909,31,20-24,1940,2
SIM,1937,15,45-49,1952,1
STAT,1907,47,30-34,1954,0.1613266312999195
STAT,1849,19,15-19,1868,11.419256956702476
STAT,1794,109,na,1903,2.786784392431724E-4
STAT,1833,48,20-24,1881,0.016630040507312423
STAT,1788,73,na,1861,1011.9006018534895
STAT,1859,11,na,1870,4474.800567721334
SIM,1834,71,na,1905,1658
STAT,1897,30,50-100,1927,2.493417533633455
STAT,1924,47,30-34,1971,0.21428252726255934
SIM,1909,23,na,1932,7176
STAT,1784,91,na,1875,30.027910828039897
STAT,1867,46,na,1913,4267.486067556579
SIM,1838,85,na,1923,300
STAT,1861,46,30-34,1907,0.16318360961255
SIM,1926,26,25-29,1952,184
SIM,1915,23,45-49,1938,4
STAT,1854,42,20-24,1896,0.2431586205629623
SIM,1852,37,40-44,1889,12
STAT,1868,24,20-24,1892,131.58822115530802
SIM,1829,49,na,1878,2995
STAT,1817,52,20-24,1869,0.003415769694177815
STAT,1838,33,na,1871,3607.0122749236652
STAT,1849,18,50-100,1867,0.09482866726141545
STAT,1829,39,40-44,1868,7.37659638391449
SIM,1837,39,40-44,1876,10
STAT,1873,17,40-44,1890,0.37532734049756333
STAT,1881,77,na,1958,1900.6175752407987
STAT,1848,43,35-39,1891,2.9477556010562442
SIM,1857,19,15-19,1876,10
STAT,1939,20,25-29,1959,187.50069448678107
STAT,1884,43,20-24,1927,0.31442825317678463
STAT,1902,38,50-100,1940,0.7518518013202894
SIM,1825,35,na,1860,3117
STAT,1850,35,15-19,1885,0.08929892122715692
STAT,1891,25,35-39,1916,24.250829115660448
SIM,1856,43,35-39,1899,4
STAT,1838,16,35-39,1854,0.9867377167681168
STAT,1867,27,50-100,1894,1.2099299196149822
STAT,1840,22,25-29,1862,105.08157039707253
SIM,1898,23,45-49,1921,5
STAT,1844,37,40-44,1881,7.4702967664812405
STAT,1859,48,40-44,1907,0.2717442236661732
SIM,1848,63,na,1911,2659
STAT,1941,23,45-49,1964,2.347690421714367
STAT,1861,9,na,1870,4707.277371547946
STAT,1873,51,45-49,1924,0.029922775434958675
SIM,1857,38,30-34,1895,13
STAT,1826,45,25-29,1871,0.11802440312850855
SIM,1818,97,na,1915,1
SIM,1871,46,40-44,1917,1
STAT,1947,20,na,1967,8340.595261922212
STAT,1885,31,45-49,1916,3.5199251883107903
STAT,1855,20,50-100,1875,0.7288086404562569
STAT,1870,17,15-19,1887,11.879283304766522
SIM,1887,34,25-29,1921,23
STAT,1944,24,25-29,1968,201.27143252010836
STAT,1908,16,15-19,1924,17.834824288351395
SIM,1862,40,30-34,1902,4
SIM,1805,90,na,1895,38
STAT,1869,40,15-19,1909,0.02729769354607512
STAT,1836,29,30-34,1865,42.71366046867358
SIM,1904,24,na,1928,6931
STAT,1876,38,15-19,1914,0.11671719982844148
SIM,1908,38,na,1946,7077
STAT,1928,41,30-34,1969,0.32958254868623726
STAT,1855,29,na,1884,3697.3939514308872
SIM,1901,59,na,1960,5757
STAT,1942,16,15-19,1958,95.81377856294068
SIM,1878,27,35-39,1905,24
STAT,1874,44,15-19,1918,0.028172077853791062
STAT,1827,105,na,1932,0.03545556370971171
STAT,1865,33,50-100,1898,1.6740432364687574
STAT,1851,15,na,1866,4377.725771621995
SIM,1868,17,25-29,1885,14
STAT,1926,33,20-24,1959,5.951904080225944
SIM,1826,40,45-49,1866,5
SIM,1854,49,45-49,1903,2
STAT,1856,42,30-34,1898,1.7892490618830312
STAT,1893,36,25-29,1929,7.405867762663739
SIM,1854,43,25-29,1897,2
STAT,1840,39,50-100,1879,2.0529669267712176
SIM,1880,31,35-39,1911,32
SIM,1848,32,45-49,1880,5
SIM,1881,81,na,1962,1090
STAT,1906,22,na,1928,6960.206091084564
SIM,1884,38,15-19,1922,2
SIM,1889,61,na,1950,4648
SIM,1888,60,na,1948,4390
STAT,1926,21,50-100,1947,1.6190550135670794
SIM,1836,78,na,1914,884
SIM,1893,31,45-49,1924,9
SIM,1931,27,20-24,1958,47
SIM,1862,48,40-44,1910,1
SIM,1913,44,na,1957,7395
STAT,1856,46,na,1902,3515.7368645857414
SIM,1867,48,40-44,1915,1
SIM,1838,26,na,1864,3831
SIM,1879,28,40-44,1907,7
STAT,1809,47,15-19,1856,0.003100509299824383
STAT,1866,19,15-19,1885,11.21775614136866
STAT,1867,54,25-29,1921,0.006515219840606822
SIM,1861,27,40-44,1888,6
SIM,1928,31,30-34,1959,53
STAT,1921,40,50-100,1961,0.267912952667572
SIM,1943,26,25-29,1969,161
STAT,1863,46,40-44,1909,0.3035239153681489
STAT,1853,27,40-44,1880,5.490598220995637
STAT,1882,35,35-39,1917,14.047396930530871
SIM,1918,24,25-29,1942,236
SIM,1934,21,50-100,1955,2
STAT,1919,43,30-34,1962,0.27930557891214874
STAT,1811,50,na,1861,2698.843738964906
SIM,1862,67,na,1929,2861
STAT,1812,72,na,1884,1307.9305083650906
SIM,1831,29,20-24,1860,27
SIM,1882,25,35-39,1907,26
SIM,1863,21,30-34,1884,34
STAT,1807,53,15-19,1860,1.5700462063691995E-4
STAT,1896,43,na,1939,6139.36639318698
STAT,1818,40,45-49,1858,7.946574391500822
SIM,1831,47,na,1878,3233
STAT,1844,49,35-39,1893,0.22136741972257332
STAT,1815,44,35-39,1859,10.137872891519937
STAT,1935,26,25-29,1961,181.3188793784237
STAT,1935,35,na,1970,10645.103064371959
SIM,1876,75,na,1951,2220
STAT,1884,51,20-24,1935,0.0014786519402513487
SIM,1823,44,35-39,1867,7
SIM,1859,24,20-24,1883,133
STAT,1928,15,50-100,1943,0.9577014837968555
STAT,1815,64,na,1879,1922.3794695863
SIM,1950,16,15-19,1966,97
STAT,1819,78,na,1897,817.5683248835683
STAT,1885,27,na,1912,4797.618553490378
STAT,1897,18,40-44,1915,0.492479079781412
STAT,1757,100,na,1857,0.688269723756696
SIM,1924,21,45-49,1945,3
SIM,1840,42,45-49,1882,6
SIM,1844,21,20-24,1865,128
SIM,1897,41,30-34,1938,1
STAT,1878,89,na,1967,581.466338184857
STAT,1871,52,25-29,1923,0.007069267300684706
STAT,1837,32,na,1869,3787.178108828647
STAT,1966,4,na,1970,9918.320207552973
SIM,1919,44,35-39,1963,1
STAT,1859,106,na,1965,0.12376538712995316
SIM,1876,28,15-19,1904,1
STAT,1916,26,15-19,1942,1.4792319760569024
SIM,1772,94,na,1866,7
STAT,1885,38,40-44,1923,8.756428801122107
STAT,1798,106,na,1904,0.0065729089557216396
STAT,1857,49,20-24,1906,0.01849594753027162
SIM,1824,39,30-34,1863,13
STAT,1855,21,30-34,1876,31.605787272433325
STAT,1904,2,na,1906,7727.054329784952
SIM,1843,32,na,1875,3765
STAT,1875,17,15-19,1892,12.340017500275971
STAT,1800,87,na,1887,127.0400683461244
SIM,1813,66,na,1879,1748
SIM,1906,30,40-44,1936,8
STAT,1895,30,15-19,1925,0.3777767943966804
STAT,1918,34,25-29,1952,19.662618895434157
STAT,1865,41,45-49,1906,2.758477453702945
SIM,1873,41,45-49,1914,5
SIM,1860,35,25-29,1895,7
STAT,1884,30,50-100,1914,1.8419290772031789
STAT,1773,101,na,1874,0.24631131034356762
STAT,1846,43,25-29,1889,0.9828325257167551
SIM,1828,45,50-100,1873,1
STAT,1852,35,25-29,1887,4.7106120777541145
STAT,1825,45,50-100,1870,0.547463840418702
STAT,1923,27,20-24,1950,42.3126192325751
SIM,1897,37,na,1934,6419
STAT,1872,16,35-39,1888,1.1240211589410616
SIM,1928,22,40-44,1950,11
SIM,1769,90,na,1859,36
SIM,1898,39,30-34,1937,1
SIM,1893,38,40-44,1931,2
SIM,1820,38,35-39,1858,9
STAT,1910,41,20-24,1951,0.03391514265759615
SIM,1847,78,na,1925,1177
STAT,1832,42,45-49,1874,2.387014025697836
SIM,1873,30,na,1903,5066
SIM,1890,58,na,1948,5164
SIM,1916,16,15-19,1932,14
STAT,1889,41,30-34,1930,2.8758957365873528
STAT,1839,45,35-39,1884,0.2285058261039253
STAT,1765,111,na,1876,0.0022413456443573475
STAT,1844,30,45-49,1874,3.438280544787999
SIM,1843,64,na,1907,2603
SIM,1822,70,na,1892,1555
SIM,1846,37,40-44,1883,12
STAT,1830,53,na,1883,3025.1284163473915
SIM,1949,15,50-100,1964,1
SIM,1874,22,45-49,1896,4
SIM,1892,30,50-100,1922,3
STAT,1924,31,45-49,1955,3.708866570712651
STAT,1820,48,35-39,1868,0.5134641091988286
STAT,1881,20,20-24,1901,135.32542859047663
SIM,1838,27,40-44,1865,5
SIM,1844,29,30-34,1873,56
STAT,1842,43,50-100,1885,1.6065796559210213
STAT,1872,25,25-29,1897,86.44341612784594
SIM,1852,30,45-49,1882,4
SIM,1859,49,50-100,1908,1
STAT,1836,21,20-24,1857,121.82449523834906
SIM,1865,49,20-24,1914,1
STAT,1838,37,40-44,1875,7.14886150619327
STAT,1880,30,30-34,1910,37.44541502431946
SIM,1840,99,na,1939,3
SIM,1847,45,35-39,1892,1
STAT,1916,21,45-49,1937,2.3883604878178537
STAT,1821,49,na,1870,2806.7199409623563
STAT,1873,43,45-49,1916,3.0490040512715892
STAT,1852,32,45-49,1884,2.8776557045491344
SIM,1913,20,30-34,1933,79
STAT,1888,40,25-29,1928,1.548337879883026
STAT,1831,30,35-39,1861,17.455368811870027
STAT,1897,43,30-34,1940,0.21396986144795016
STAT,1876,82,na,1958,1181.8385738796426
SIM,1895,20,15-19,1915,9
STAT,1906,40,40-44,1946,0.4643094431340704
SIM,1911,15,25-29,1926,28
STAT,1929,24,35-39,1953,23.895103331264373
STAT,1861,49,35-39,1910,0.230427431341676
SIM,1850,43,50-100,1893,4
SIM,1863,52,na,1915,3979
STAT,1866,22,45-49,1888,1.3100547099953508
STAT,1922,23,35-39,1945,21.734379893154713
STAT,1876,41,20-24,1917,0.333239183780812
STAT,1856,45,35-39,1901,0.22032795800371083
SIM,1901,43,na,1944,6529
STAT,1817,71,na,1888,1448.050382747384
STAT,1851,22,50-100,1873,0.7549099264628963
SIM,1863,30,20-24,1893,4
STAT,1826,53,25-29,1879,0.006678322489021479
STAT,1898,49,30-34,1947,0.14611958059212987
STAT,1845,25,50-100,1870,1.2172195123138958
SIM,1850,29,30-34,1879,66
STAT,1780,77,na,1857,598.9925915352044
STAT,1862,31,na,1893,4136.08697025118
SIM,1932,31,45-49,1963,6
STAT,1831,103,na,1934,0.18529914645918216
STAT,1918,23,na,1941,7928.446008823387
STAT,1939,33,na,1972,7789.555348174435
SIM,1854,35,25-29,1889,7
STAT,1880,38,40-44,1918,9.267262108160407
SIM,1832,40,45-49,1872,5
STAT,1820,37,30-34,1857,26.501623553446255
SIM,1875,46,25-29,1921,1
STAT,1848,34,45-49,1882,2.97204580440739
STAT,1893,44,25-29,1937,0.11261104253804093
STAT,1876,23,na,1899,4924.989411475141
SIM,1887,38,40-44,1925,14
STAT,1825,47,na,1872,2982.5736490138424
STAT,1840,52,45-49,1892,0.02083628807214063
STAT,1821,33,na,1854,3077.23331797706
STAT,1905,20,30-34,1925,52.33618750333955
SIM,1896,40,25-29,1936,1
STAT,1809,50,20-24,1859,0.00566302542967973
SIM,1848,24,45-49,1872,2
STAT,1832,50,45-49,1882,0.020475130195402813
STAT,1884,58,na,1942,3943.864260856098
STAT,1819,48,50-100,1867,1.015266464898256
STAT,1858,50,40-44,1908,0.016813112907096636
STAT,1866,16,50-100,1882,0.09426249075200407
STAT,1823,99,na,1922,2.2726431647750003
SIM,1900,36,30-34,1936,7
STAT,1931,29,20-24,1960,47.55022861567213
STAT,1794,69,na,1863,1419.8387410858247
STAT,1908,40,50-100,1948,0.22215093776402906
SIM,1856,40,30-34,1896,4
STAT,1879,38,40-44,1917,9.201507527374716
SIM,1884,49,30-34,1933,1
STAT,1849,27,15-19,1876,0.8507255725529921
SIM,1909,22,30-34,1931,64
STAT,1892,24,15-19,1916,8.288693381747848
SIM,1860,32,45-49,1892,5
SIM,1849,17,15-19,1866,13
SIM,1871,32,20-24,1903,5
SIM,1945,23,30-34,1968,2
SIM,1872,23,25-29,1895,129
SIM,1923,38,50-100,1961,3
STAT,1824,40,45-49,1864,4.0841425918382575
STAT,1859,38,15-19,1897,0.08982012218970986
SIM,1825,29,20-24,1854,18
STAT,1848,11,na,1859,4874.572349057269
STAT,1924,39,30-34,1963,4.330020805315455
STAT,1937,23,30-34,1960,56.51845975564387
SIM,1932,39,30-34,1971,8
STAT,1869,51,30-34,1920,0.011704514421555264
SIM,1782,72,na,1854,1033
SIM,1786,86,na,1872,139
SIM,1825,51,na,1876,2590
SIM,1829,65,na,1894,2180
SIM,1833,86,na,1919,242
SIM,1857,27,15-19,1884,1
SIM,1926,34,25-29,1960,30
STAT,1913,30,30-34,1943,31.92042466586688
SIM,1950,17,na,1967,8623
STAT,1887,36,25-29,1923,6.534811236200351
STAT,1925,41,na,1966,9092.293635079151
STAT,1864,97,na,1961,22.501896310110315
STAT,1874,24,45-49,1898,1.4329744278049272
STAT,1891,31,45-49,1922,4.371036617132785
STAT,1905,53,na,1958,6300.573476334762
STAT,1816,39,30-34,1855,35.44695053716852
SIM,1865,59,na,1924,3594
STAT,1848,40,30-34,1888,1.9316656127031955
SIM,1908,18,30-34,1926,6
SIM,1861,45,na,1906,4365
STAT,1826,42,45-49,1868,3.1612719162069243
SIM,1861,39,35-39,1900,18
SIM,1883,29,na,1912,4887
STAT,1918,23,20-24,1941,241.41560824713102
STAT,1862,5,na,1867,4971.314477500501
STAT,1847,24,50-100,1871,0.7511321327179072
SIM,1831,79,na,1910,778
SIM,1872,61,na,1933,3845
STAT,1860,17,30-34,1877,3.0148697057012437
SIM,1870,19,30-34,1889,5
SIM,1813,48,45-49,1861,1
SIM,1851,19,20-24,1870,43
STAT,1862,19,30-34,1881,2.833831074312859
SIM,1810,85,na,1895,232
SIM,1960,8,na,1968,10822
SIM,1856,34,45-49,1890,2
STAT,1866,34,15-19,1900,0.26310178775305504
STAT,1795,103,na,1898,0.06133284597905611
STAT,1888,15,35-39,1903,1.3158900034138743
SIM,1830,31,20-24,1861,4
STAT,1825,33,15-19,1858,0.4618633044967653
STAT,1833,34,na,1867,3592.15506222891
STAT,1852,43,25-29,1895,1.0160830858504835
SIM,1921,30,30-34,1951,12
STAT,1837,48,na,1885,3213.6084929209856
STAT,1878,33,50-100,1911,1.9244816391555066
STAT,1943,20,15-19,1963,11.445652392585524
SIM,1926,23,20-24,1949,282
SIM,1898,20,40-44,1918,10
STAT,1829,40,20-24,1869,0.2696282845448192
SIM,1934,33,20-24,1967,8
STAT,1843,19,20-24,1862,31.36394935754923
STAT,1846,35,25-29,1881,4.702017431441682
SIM,1937,24,35-39,1961,22
STAT,1811,51,15-19,1862,1.625079033504654E-4
SIM,1904,25,35-39,1929,40
STAT,1896,31,20-24,1927,7.23696680769487
SIM,1831,26,40-44,1857,8
STAT,1833,43,15-19,1876,0.021755915992616014
STAT,1874,33,35-39,1907,20.85353493866403
SIM,1948,15,20-24,1963,321
STAT,1868,27,25-29,1895,81.28329656330581
STAT,1937,34,35-39,1971,18.23962476756393
SIM,1881,43,45-49,1924,8
STAT,1854,45,25-29,1899,0.08918038031354417
STAT,1870,20,45-49,1890,1.3909180027799912
SIM,1949,20,na,1969,8915
STAT,1830,51,25-29,1881,0.005484844419962506
STAT,1901,27,50-100,1928,1.8086464270337999
STAT,1842,29,30-34,1871,45.700055046658285
STAT,1879,17,35-39,1896,1.159135506854443
STAT,1830,69,na,1899,2026.5059028400608
STAT,1867,46,25-29,1913,0.10925537404573246
STAT,1900,34,15-19,1934,0.3955569846241687
SIM,1815,42,35-39,1857,6
STAT,1898,41,50-100,1939,0.20141253058786449
SIM,1842,19,30-34,1861,3
STAT,1924,20,40-44,1944,8.058522884452351
STAT,1893,33,45-49,1926,4.445134190716716
SIM,1871,23,30-34,1894,38
SIM,1940,30,40-44,1970,9
STAT,1872,31,35-39,1903,20.63931814705988
SIM,1882,33,35-39,1915,26
STAT,1806,52,45-49,1858,0.08468352158100043
STAT,1862,18,50-100,1880,0.09628740327588896
STAT,1867,14,na,1881,5026.541099600243
STAT,1872,39,45-49,1911,4.005536907386816
STAT,1948,24,45-49,1972,2.607221152679269
STAT,1890,17,40-44,1907,0.4508845595180481
STAT,1881,53,45-49,1934,0.027874552624840957
SIM,1859,32,20-24,1891,7
STAT,1868,36,15-19,1904,0.10842181289168167
SIM,1932,20,40-44,1952,14
STAT,1880,49,45-49,1929,0.49162361549574796
STAT,1895,26,50-100,1921,1.689211134140245
STAT,1852,96,na,1948,13.685502636504554
STAT,1841,31,30-34,1872,31.057098912870845
SIM,1873,46,na,1919,4748
STAT,1883,8,na,1891,5158.210382673531
SIM,1880,39,45-49,1919,9
SIM,1813,50,na,1863,2769
STAT,1849,38,30-34,1887,8.537332403682736
STAT,1906,38,na,1944,6953.558271193122
STAT,1863,23,30-34,1886,31.887309272796514
STAT,1932,30,40-44,1962,10.519158271193428
SIM,1888,76,na,1964,2763
STAT,1905,39,20-24,1944,0.48107129666900855
SIM,1792,71,na,1863,1116
SIM,1796,85,na,1881,172
SIM,1885,31,na,1916,5048
SIM,1918,21,20-24,1939,244
STAT,1901,38,25-29,1939,1.7483517603973273
STAT,1855,37,40-44,1892,6.60098698385818
STAT,1844,23,20-24,1867,137.95235131546934
STAT,1893,38,15-19,1931,0.14303583589095506
SIM,1834,42,20-24,1876,3
STAT,1872,22,20-24,1894,139.87448047832933
SIM,1915,20,40-44,1935,8
STAT,1886,40,15-19,1926,0.02973884161018758
STAT,1895,41,30-34,1936,0.21104770827404792
SIM,1852,33,25-29,1885,23
SIM,1863,47,50-100,1910,3
SIM,1939,25,20-24,1964,41
SIM,1788,66,na,1854,1443
STAT,1762,108,na,1870,0.011260445550709168
SIM,1852,52,na,1904,3472
SIM,1902,48,35-39,1950,2
SIM,1951,20,15-19,1971,7
SIM,1948,19,na,1967,8701
SIM,1904,40,na,1944,6868
STAT,1883,20,30-34,1903,35.55532419685744
STAT,1850,30,45-49,1880,3.138136786691969
SIM,1828,36,35-39,1864,19
SIM,1908,54,na,1962,6448
STAT,1910,11,na,1921,7917.968457687586
SIM,1854,41,35-39,1895,5
STAT,1854,44,na,1898,3495.2759403251175
STAT,1808,52,50-100,1860,0.08963064184153631
STAT,1893,33,20-24,1926,6.890300453250777
SIM,1895,27,35-39,1922,28
STAT,1918,17,35-39,1935,1.8503087953049433
STAT,1887,27,35-39,1914,21.79492887500522
STAT,1830,104,na,1934,0.09210496132563685
STAT,1829,34,35-39,1863,18.403619065208964
STAT,1949,17,15-19,1966,106.59288267716313
SIM,1812,49,na,1861,2752
STAT,1860,24,50-100,1884,0.6795826872410333
STAT,1791,93,na,1884,14.199368603826876
STAT,1834,52,45-49,1886,0.019807790278518596
SIM,1850,37,30-34,1887,14
STAT,1853,17,15-19,1870,11.29514368753671
STAT,1867,6,na,1873,5300.964388988311
SIM,1901,19,35-39,1920,2
STAT,1835,40,20-24,1875,0.2529663762529844
STAT,1839,42,30-34,1881,1.891982566429011
STAT,1901,15,15-19,1916,16.85712331720041
SIM,1833,70,na,1903,1747
SIM,1891,20,30-34,1911,50
SIM,1861,17,15-19,1878,17
SIM,1828,59,na,1887,2490
STAT,1850,30,na,1880,3900.131039253579
STAT,1899,29,30-34,1928,69.18377947217002
SIM,1881,65,na,1946,2812
SIM,1889,45,na,1934,5763
SIM,1865,33,35-39,1898,25
SIM,1928,24,50-100,1952,2
STAT,1894,17,25-29,1911,14.701742228617872
STAT,1835,45,15-19,1880,6.159317616172934E-4
STAT,1842,38,20-24,1880,1.3323740403307487
SIM,1840,67,na,1907,2413
SIM,1900,32,15-19,1932,1
SIM,1882,22,30-34,1904,53
SIM,1803,72,na,1875,1156
SIM,1840,48,50-100,1888,2
STAT,1826,42,20-24,1868,0.33545215801814676
SIM,1852,23,20-24,1875,143
STAT,1774,100,na,1874,0.3100744758439967
STAT,1863,80,na,1943,1093.6167961520423
STAT,1826,47,15-19,1873,7.976314832582953E-4
STAT,1835,48,30-34,1883,0.1305262304068392
STAT,1891,28,na,1919,5936.702873148213
STAT,1806,71,na,1877,1239.1809491123552
SIM,1928,25,45-49,1953,6
STAT,1870,52,30-34,1922,0.011740044571130172
STAT,1864,23,25-29,1887,104.25397900015574
STAT,1795,70,na,1865,1414.651029214084
STAT,1857,33,35-39,1890,15.874721032653135
SIM,1873,33,50-100,1906,4
STAT,1865,32,30-34,1897,32.03528569246761
SIM,1836,36,50-100,1872,3
STAT,1799,84,na,1883,229.11264554892702
SIM,1850,38,20-24,1888,2
STAT,1882,33,45-49,1915,3.4163120512686547
STAT,1910,16,30-34,1926,4.891503779499723
STAT,1862,105,na,1967,0.3925404475329204
SIM,1893,50,na,1943,5765
STAT,1945,1,na,1946,9108.044619106267
SIM,1897,64,na,1961,5017
STAT,1815,42,45-49,1857,9.034206627478286
SIM,1902,25,25-29,1927,120
SIM,1835,30,45-49,1865,4
SIM,1860,32,20-24,1892,6
STAT,1927,15,35-39,1942,10.584509625380011
SIM,1824,34,na,1858,3516
SIM,1871,30,30-34,1901,42
STAT,1843,17,30-34,1860,2.853263251443529
STAT,1874,43,na,1917,4744.9212766342
STAT,1855,24,35-39,1879,10.132932855734069
STAT,1940,19,20-24,1959,277.8444136827599
STAT,1829,47,40-44,1876,0.2701284640459816
STAT,1894,21,45-49,1915,1.8145907847607836
STAT,1887,42,35-39,1929,4.085217128877263
SIM,1907,21,45-49,1928,3
STAT,1797,107,na,1904,0.0022819371441499207
STAT,1853,16,25-29,1869,10.849303768229763
STAT,1878,57,na,1935,4238.916035440883
STAT,1862,17,40-44,1879,0.3616029007301438
STAT,1920,49,15-19,1969,8.173809935232699E-4
STAT,1861,22,45-49,1883,1.2042501962225811
STAT,1854,52,25-29,1906,0.005400954765138888
SIM,1826,43,25-29,1869,2
SIM,1851,17,30-34,1868,4
STAT,1939,31,40-44,1970,8.069610495808831
STAT,1842,37,30-34,1879,9.308062952475675
SIM,1844,24,25-29,1868,106
SIM,1875,27,50-100,1902,1
SIM,1906,31,50-100,1937,1
SIM,1879,24,na,1903,4866
STAT,1847,19,40-44,1866,0.3438912140070303
STAT,1879,50,25-29,1929,0.007589946698505814
SIM,1761,94,na,1855,1
SIM,1894,16,15-19,1910,14
STAT,1909,24,30-34,1933,53.64017265612461
SIM,1893,34,25-29,1927,33
STAT,1946,20,40-44,1966,7.561352352545371
SIM,1855,33,na,1888,4171
STAT,1870,66,na,1936,3249.8739793318423
SIM,1824,66,na,1890,1919
STAT,1885,34,25-29,1919,20.41437927664186
SIM,1795,100,na,1895,2
STAT,1823,51,30-34,1874,0.018059770093308145
STAT,1861,35,15-19,1896,0.0952927827221822
SIM,1845,43,35-39,1888,8
STAT,1933,26,15-19,1959,1.894164787959202
STAT,1924,9,na,1933,9571.512336172918
STAT,1876,49,30-34,1925,0.1979798066896767
SIM,1862,6,na,1868,5270
STAT,1910,48,40-44,1958,0.296368018125974
STAT,1837,43,35-39,1880,2.9409295621860765
STAT,1831,38,45-49,1869,3.225560739348102
STAT,1868,31,na,1899,4604.098342151098
SIM,1847,42,30-34,1889,4
STAT,1836,24,25-29,1860,99.03538751278627
STAT,1876,30,40-44,1906,9.131608328060523
STAT,1853,39,35-39,1892,11.07815636067943
SIM,1914,27,20-24,1941,36
STAT,1887,20,15-19,1907,7.4962730559661725
STAT,1827,30,45-49,1857,4.784181129390412
STAT,1842,51,40-44,1893,0.015748708966747932
STAT,1858,10,na,1868,4445.44854199834
STAT,1815,48,na,1863,2785.873289547717
SIM,1870,81,na,1951,896
STAT,1854,40,30-34,1894,1.7802102993355229
SIM,1863,24,35-39,1887,14
STAT,1816,70,na,1886,1592.6446457037678
STAT,1841,32,45-49,1873,3.0698438209023595
STAT,1853,65,na,1918,2673.8611524329162
SIM,1846,49,50-100,1895,2
STAT,1856,50,30-34,1906,0.009408770504031515
SIM,1874,95,na,1969,72
SIM,1866,76,na,1942,1828
STAT,1827,29,40-44,1856,9.63752449839772
STAT,1818,43,25-29,1861,3.0490686985984046
SIM,1884,30,40-44,1914,15
STAT,1924,35,na,1959,8972.72854810985
SIM,1884,48,40-44,1932,1
SIM,1891,64,na,1955,4685
STAT,1899,19,na,1918,6951.2233942188695
SIM,1941,26,15-19,1967,2
STAT,1821,53,25-29,1874,0.009775621585514363
SIM,1933,21,na,1954,10254
SIM,1917,24,30-34,1941,73
STAT,1855,30,20-24,1885,4.237335956409979
STAT,1949,16,25-29,1965,101.810923870627
STAT,1920,42,na,1962,8282.153150467917
SIM,1867,33,45-49,1900,4
STAT,1875,53,45-49,1928,0.029691896346738918
STAT,1919,46,35-39,1965,0.2830705457301629
STAT,1867,48,15-19,1915,7.470628845517361E-4
SIM,1835,29,40-44,1864,9
SIM,1901,36,50-100,1937,1
STAT,1876,48,40-44,1924,0.35311936883006245
SIM,1830,40,50-100,1870,4
SIM,1895,42,35-39,1937,1
STAT,1816,86,na,1902,217.93843870459364
STAT,1852,32,20-24,1884,4.460588039560988
SIM,1861,16,25-29,1877,19
STAT,1882,46,15-19,1928,7.891923280747064E-4
STAT,1906,27,20-24,1933,34.525006604478165
STAT,1917,30,15-19,1947,0.27393055446195747
STAT,1843,49,40-44,1892,0.23481273476836992
STAT,1838,33,25-29,1871,17.04751753113599
STAT,1853,16,50-100,1869,0.09379799635620048
STAT,1936,20,na,1956,7057.3710797500835
SIM,1869,30,15-19,1899,2
STAT,1912,19,45-49,1931,0.20296807634135153
SIM,1847,17,40-44,1864,3
SIM,1872,49,50-100,1921,1
STAT,1836,26,na,1862,3748.560698218252
STAT,1862,51,20-24,1913,0.0012798919955133064
STAT,1841,45,15-19,1886,5.981340793725246E-4
STAT,1864,22,50-100,1886,0.7480264065357358
STAT,1883,39,20-24,1922,1.514180431197421
STAT,1916,21,na,1937,7751.530707129051
SIM,1873,8,na,1881,5671
STAT,1926,41,20-24,1967,0.04402624674176497
STAT,1946,21,30-34,1967,64.61075503313101
SIM,1885,28,40-44,1913,13
SIM,1876,27,25-29,1903,91
STAT,1857,48,30-34,1905,0.15046757486943735
STAT,1806,48,50-100,1854,1.475640204068743
SIM,1818,37,40-44,1855,10
SIM,1838,58,na,1896,2743
STAT,1836,85,na,1921,364.4845245993181
STAT,1863,38,40-44,1901,7.700604761890715
STAT,1937,20,15-19,1957,10.478503499342693
SIM,1846,33,25-29,1879,23
STAT,1920,15,25-29,1935,19.787321608860136
STAT,1863,26,35-39,1889,17.181711745119024
STAT,1880,27,50-100,1907,1.3609922635723153
STAT,1898,34,35-39,1932,27.441190515513384
SIM,1923,43,na,1966,9126
STAT,1916,49,25-29,1965,0.10923782806150893
SIM,1948,15,45-49,1963,3
SIM,1891,39,20-24,1930,3
STAT,1935,18,50-100,1953,1.031884659280113
SIM,1903,39,na,1942,6913
STAT,1920,38,35-39,1958,5.341820263693894
STAT,1856,17,40-44,1873,0.3370011777946892
SIM,1852,84,na,1936,456
SIM,1924,26,15-19,1950,2
STAT,1941,31,45-49,1972,3.3387495525031405
SIM,1856,98,na,1954,2
SIM,1885,18,15-19,1903,11
SIM,1871,38,40-44,1909,13
STAT,1897,12,na,1909,6971.849904278909
STAT,1845,62,na,1907,2816.4161258721415
STAT,1859,34,20-24,1893,4.307936362491069
STAT,1849,76,na,1925,1498.6014439844046
SIM,1868,83,na,1951,615
SIM,1935,15,35-39,1950,14
STAT,1885,0,na,1885,7049.97874669855
SIM,1867,44,25-29,1911,2
SIM,1905,34,50-100,1939,2
SIM,1948,22,45-49,1970,3
STAT,1802,53,15-19,1855,1.545157946737033E-4
SIM,1830,34,25-29,1864,19
SIM,1938,30,25-29,1968,23
STAT,1839,17,40-44,1856,0.3735932305857373
STAT,1853,81,na,1934,855.5983877998901
STAT,1897,44,45-49,1941,0.27678593841065213
STAT,1921,42,35-39,1963,0.4579456597900615
STAT,1953,18,50-100,1971,0.9149548735340406
SIM,1904,27,50-100,1931,2
SIM,1918,15,35-39,1933,3
STAT,1845,99,na,1944,2.9183272739815105
SIM,1880,16,35-39,1896,1
STAT,1861,37,40-44,1898,7.358618973749573
STAT,1852,37,15-19,1889,0.08998534519762
STAT,1835,47,40-44,1882,0.23382463098471779
SIM,1891,80,na,1971,2538
SIM,1839,43,35-39,1882,6
SIM,1874,39,20-24,1913,2
STAT,1891,33,50-100,1924,2.2776465916054267
STAT,1822,32,35-39,1854,64.96759821057641
SIM,1919,33,30-34,1952,42
STAT,1866,39,20-24,1905,1.4220039259450232
SIM,1921,36,na,1957,8520
STAT,1867,43,20-24,1910,0.29821297625725673
STAT,1925,27,30-34,1952,93.44719232220982
SIM,1864,40,40-44,1904,3
STAT,1801,56,na,1857,2267.2125732513664
SIM,1892,18,30-34,1910,4
STAT,1864,52,30-34,1916,0.010688986594119843
SIM,1945,20,15-19,1965,12
STAT,1817,54,50-100,1871,0.06717055641141509
STAT,1877,28,40-44,1905,6.260058165329321
STAT,1884,18,30-34,1902,3.1702788185590984
STAT,1865,50,na,1915,4007.428869856642
STAT,1907,36,15-19,1943,0.03615110747010789
SIM,1935,1,na,1936,11625
STAT,1901,18,30-34,1919,4.4946501350495005
SIM,1933,27,30-34,1960,125
SIM,1848,21,40-44,1869,9
STAT,1859,44,25-29,1903,1.0183269080636337
SIM,1830,32,35-39,1862,16
STAT,1937,17,50-100,1954,0.7362546825098873
STAT,1804,85,na,1889,184.4313610189715
STAT,1846,32,20-24,1878,4.892801780921258
STAT,1873,52,35-39,1925,0.017572225973529573
SIM,1815,45,50-100,1860,2
SIM,1890,35,35-39,1925,33
SIM,1835,49,35-39,1884,1
SIM,1958,1,na,1959,10853
STAT,1862,50,30-34,1912,0.01042295867451303
SIM,1934,36,25-29,1970,5
SIM,1865,46,50-100,1911,3
SIM,1869,34,30-34,1903,46
SIM,1859,35,25-29,1894,6
SIM,1890,30,40-44,1920,16
STAT,1883,38,30-34,1921,10.522885606305998
STAT,1883,52,40-44,1935,0.02077852780798887
SIM,1871,44,na,1915,4424
STAT,1856,43,45-49,1899,2.315272168269802
SIM,1936,15,50-100,1951,2
STAT,1930,20,na,1950,9504.447632007254
STAT,1946,15,45-49,1961,1.119500988775957
SIM,1917,36,25-29,1953,4
STAT,1846,49,45-49,1895,0.3539358579545097
SIM,1871,26,35-39,1897,25
STAT,1757,116,na,1873,3.893867234114908E-4
STAT,1892,29,20-24,1921,29.44859047161241
STAT,1900,22,na,1922,6625.978162444238
SIM,1830,101,na,1931,7
SIM,1854,26,35-39,1880,25
STAT,1920,47,50-100,1967,0.5048313751863626
STAT,1904,36,na,1940,6916.382764565689
STAT,1882,30,40-44,1912,8.600623389506598
SIM,1939,17,45-49,1956,1
STAT,1893,32,50-100,1925,2.3454768795773755
SIM,1835,26,25-29,1861,73
SIM,1894,18,40-44,1912,2
STAT,1808,67,na,1875,1615.25328096317
STAT,1827,49,35-39,1876,0.24617651769041587
STAT,1846,41,35-39,1887,2.8434145848141053
STAT,1902,42,25-29,1944,0.12699268783077378
SIM,1890,40,30-34,1930,4
STAT,1867,20,35-39,1887,11.243720043639664
SIM,1899,41,40-44,1940,1
SIM,1771,93,na,1864,8
SIM,1819,66,na,1885,1766
STAT,1825,63,na,1888,2106.73811329125
SIM,1854,48,na,1902,3708
STAT,1816,47,30-34,1863,0.4756184267032432
SIM,1843,48,na,1891,3333
SIM,1902,44,na,1946,6659
STAT,1816,48,20-24,1864,0.05806435681724977
SIM,1842,47,50-100,1889,1
SIM,1876,31,45-49,1907,4
STAT,1886,18,40-44,1904,0.3889171761186297
STAT,1926,36,25-29,1962,2.43204863604105
STAT,1879,34,25-29,1913,21.452017580115648
SIM,1815,52,na,1867,2420
SIM,1823,71,na,1894,1347
SIM,1899,23,na,1922,6573
SIM,1928,30,40-44,1958,15
STAT,1825,38,20-24,1863,1.9517185047786754
SIM,1918,16,25-29,1934,30
STAT,1894,18,15-19,1912,15.356240583001188
STAT,1882,40,30-34,1922,2.284676378226621
STAT,1861,38,30-34,1899,8.91462802953898
STAT,1924,48,20-24,1972,0.02649010286097314
SIM,1854,32,20-24,1886,7
SIM,1919,38,na,1957,8245
STAT,1878,44,35-39,1922,3.7679939756887606
STAT,1911,32,25-29,1943,18.182165922290803
SIM,1867,39,na,1906,4722
STAT,1817,44,na,1861,2999.735566258449
SIM,1915,24,na,1939,7606
STAT,1902,49,45-49,1951,0.3716562454598171
STAT,1827,27,15-19,1854,2.701689078926782
STAT,1861,30,20-24,1891,4.580388667041409
STAT,1836,27,40-44,1863,5.154847886846412
SIM,1833,38,20-24,1871,2
SIM,1891,38,30-34,1929,24
STAT,1843,47,15-19,1890,5.577143444974156E-4
SIM,1860,42,50-100,1902,5
STAT,1846,26,35-39,1872,18.00866433594548
SIM,1871,35,25-29,1906,2
STAT,1852,47,40-44,1899,0.2715882228169275
STAT,1884,42,na,1926,4603.562481477224
STAT,1935,19,na,1954,10109.744131528378
SIM,1829,29,40-44,1858,5
SIM,1909,25,35-39,1934,37
SIM,1919,17,na,1936,8284
SIM,1844,27,40-44,1871,3
SIM,1939,32,45-49,1971,1
STAT,1800,71,na,1871,1311.1391525560407
STAT,1863,104,na,1967,0.8431562921397469
STAT,1921,17,45-49,1938,1.1497133770702856
STAT,1929,21,30-34,1950,73.61874588885185
SIM,1832,38,50-100,1870,2
STAT,1907,23,45-49,1930,2.063507121983925
SIM,1836,51,na,1887,2774
SIM,1886,44,35-39,1930,9
SIM,1937,21,30-34,1958,75
SIM,1852,29,40-44,1881,6
STAT,1828,53,35-39,1881,0.013360936216767426
SIM,1873,51,na,1924,4546
SIM,1901,16,30-34,1917,4
STAT,1846,84,na,1930,509.54324869906907
STAT,1883,23,35-39,1906,11.543408034486255
STAT,1904,40,30-34,1944,0.2337569443075659
SIM,1810,44,25-29,1854,1
SIM,1822,36,40-44,1858,12
STAT,1851,45,50-100,1896,0.3845205148264277
STAT,1878,46,25-29,1924,0.12184066707655816
STAT,1948,21,40-44,1969,7.799043757012197
SIM,1826,48,30-34,1874,1
STAT,1833,30,45-49,1863,3.020334400581015
STAT,1950,17,50-100,1967,0.8946212461848321
STAT,1878,41,30-34,1919,2.435968519029853
SIM,1939,28,25-29,1967,139
STAT,1885,39,30-34,1924,10.606197916628021
STAT,1951,17,30-34,1968,29.31147666035814
SIM,1863,25,na,1888,4500
STAT,1840,28,45-49,1868,1.9839308383848124
STAT,1844,26,25-29,1870,84.23162048456916
STAT,1905,21,na,1926,6928.643450819847
SIM,1912,43,na,1955,7365
STAT,1927,21,20-24,1948,277.47644596745295
SIM,1837,41,35-39,1878,10
SIM,1864,49,50-100,1913,2
SIM,1828,33,30-34,1861,9
SIM,1847,62,na,1909,2772
STAT,1857,30,30-34,1887,28.235043060678006
SIM,1886,41,30-34,1927,6
STAT,1818,45,15-19,1863,0.001818699136977663
STAT,1866,24,na,1890,4379.630153334617
SIM,1935,21,20-24,1956,323
STAT,1836,47,na,1883,3130.4488801906696
STAT,1864,65,na,1929,3050.905368866468
STAT,1909,36,25-29,1945,1.8922954055674952
STAT,1850,14,na,1864,4432.281581025116
STAT,1910,19,35-39,1929,1.6708259759501347
STAT,1827,70,na,1897,1696.645579001471
SIM,1846,24,35-39,1870,12
SIM,1900,37,20-24,1937,1
STAT,1829,41,35-39,1870,3.027079109159573
SIM,1891,23,35-39,1914,20
STAT,1844,29,40-44,1873,5.837277513629187
SIM,1827,27,40-44,1854,1
STAT,1832,33,na,1865,3612.505675419372
STAT,1934,30,15-19,1964,0.35479948126047717
SIM,1877,76,na,1953,1713
SIM,1909,39,na,1948,7233
STAT,1821,50,20-24,1871,0.0021619363515136317
STAT,1864,20,20-24,1884,128.2439407493978
STAT,1930,32,35-39,1962,23.81794366732939
SIM,1841,30,45-49,1871,4
SIM,1875,10,na,1885,5908
STAT,1833,47,30-34,1880,0.1493174318631501
STAT,1912,33,50-100,1945,1.6365854956009145
SIM,1830,37,40-44,1867,17
SIM,1832,48,na,1880,3119
STAT,1795,108,na,1903,7.828088027347093E-4
STAT,1923,42,45-49,1965,0.39273500692516367
SIM,1890,26,50-100,1916,2
SIM,1875,20,35-39,1895,17
STAT,1843,42,20-24,1885,0.2290560687560281
STAT,1865,46,15-19,1911,7.360076236286232E-4
STAT,1941,28,15-19,1969,1.4742549193192278
SIM,1817,42,45-49,1859,7
SIM,1852,26,25-29,1878,87
SIM,1900,58,na,1958,5809
STAT,1856,49,50-100,1905,0.37471226264960733
SIM,1884,33,45-49,1917,5
STAT,1851,19,30-34,1870,2.968743577875576
STAT,1903,29,45-49,1932,3.1699267501023547
SIM,1911,29,45-49,1940,6
SIM,1829,81,na,1910,686
STAT,1876,33,45-49,1909,3.6272281863522045
SIM,1905,25,na,1930,7227
STAT,1856,41,40-44,1897,3.5207618492156474
SIM,1832,31,30-34,1863,41
SIM,1837,49,45-49,1886,3
SIM,1869,43,20-24,1912,2
SIM,1920,33,50-100,1953,5
STAT,1881,27,40-44,1908,5.84758420088386
SIM,1782,93,na,1875,2
STAT,1835,43,25-29,1878,0.9842960168804672
SIM,1824,32,35-39,1856,21
STAT,1822,37,40-44,1859,17.533834202083952
STAT,1882,26,50-100,1908,1.2628476179893056
STAT,1895,44,35-39,1939,0.32645187618279975
SIM,1861,66,na,1927,3089
SIM,1852,30,20-24,1882,6
SIM,1952,19,na,1971,9117
STAT,1857,47,na,1904,3525.180895525917
STAT,1934,34,na,1968,10416.953084946796
STAT,1896,32,35-39,1928,27.003095486011357
SIM,1858,43,45-49,1901,6
STAT,1838,24,35-39,1862,10.099937132502877
STAT,1939,21,50-100,1960,1.3351845976335004
STAT,1861,31,50-100,1892,1.546510764721823
STAT,1915,41,45-49,1956,0.33891708983541036
SIM,1872,29,na,1901,5016
STAT,1948,17,45-49,1965,1.1544962582097786
SIM,1843,43,25-29,1886,2
SIM,1891,43,na,1934,5939
STAT,1870,16,25-29,1886,11.410386329523483
SIM,1850,22,35-39,1872,9
SIM,1906,10,na,1916,7618
STAT,1848,32,na,1880,4144.199260314075
STAT,1822,34,25-29,1856,48.77815364733754
SIM,1872,20,20-24,1892,149
STAT,1860,50,20-24,1910,0.001227640703643598
SIM,1871,33,35-39,1904,27
SIM,1890,79,na,1969,2579
STAT,1864,19,40-44,1883,0.3375691130563329
STAT,1818,51,50-100,1869,0.06513592087320576
SIM,1826,39,40-44,1865,11
SIM,1895,57,na,1952,5486
SIM,1893,31,20-24,1924,11
STAT,1854,43,35-39,1897,2.7559016151300675
SIM,1839,34,45-49,1873,4
STAT,1911,30,20-24,1941,4.836906247900817
STAT,1897,42,40-44,1939,0.42114961514473814
SIM,1882,28,na,1910,4961
SIM,1889,22,40-44,1911,6
STAT,1908,15,25-29,1923,17.067156938153413
STAT,1868,31,45-49,1899,3.36449385333397
SIM,1895,33,20-24,1928,9
STAT,1930,30,30-34,1960,41.11011810658834
STAT,1818,39,40-44,1857,24.700173782763233
STAT,1842,22,35-39,1864,10.95806047742455
SIM,1811,86,na,1897,169
STAT,1785,92,na,1877,24.03457582040402
STAT,1887,33,20-24,1920,6.079883447244314
SIM,1947,21,50-100,1968,1
SIM,1808,82,na,1890,288
STAT,1834,99,na,1933,2.51683160928442
STAT,1904,42,35-39,1946,0.3640579649717707
STAT,1874,31,45-49,1905,3.6208124464938654
SIM,1894,15,25-29,1909,22
STAT,1860,51,na,1911,3548.2696497931665
SIM,1858,40,40-44,1898,5
STAT,1866,27,15-19,1893,0.845465482442731
SIM,1819,82,na,1901,357
SIM,1911,38,35-39,1949,6
SIM,1894,24,50-100,1918,1
SIM,1849,30,35-39,1879,28
STAT,1818,48,30-34,1866,0.42020476979910815
STAT,1910,34,50-100,1944,1.5968537788568995
STAT,1898,45,15-19,1943,6.228231033086919E-4
STAT,1832,51,35-39,1883,0.011908068578676932
SIM,1843,44,50-100,1887,3
SIM,1877,26,50-100,1903,3
SIM,1893,4,na,1897,6994
STAT,1936,28,45-49,1964,3.338215825569616
SIM,1868,24,na,1892,4851
SIM,1879,30,50-100,1909,5
SIM,1873,32,30-34,1905,45
STAT,1886,24,50-100,1910,0.8639432258357782
SIM,1864,10,na,1874,5266
SIM,1950,7,na,1957,9186
SIM,1828,42,20-24,1870,1
SIM,1887,75,na,1962,2884
STAT,1840,20,35-39,1860,10.867256307554774
SIM,1859,47,30-34,1906,1
SIM,1911,58,na,1969,6831
SIM,1916,15,25-29,1931,27
STAT,1818,40,20-24,1858,0.843235127865605
STAT,1844,35,15-19,1879,0.10751628700097897
SIM,1815,40,45-49,1855,4
STAT,1885,31,20-24,1916,5.456155220483043
SIM,1895,24,30-34,1919,62
STAT,1851,112,na,1963,1.8352816878403107E-4
STAT,1886,15,25-29,1901,12.137270334128734
STAT,1887,24,30-34,1911,39.9823812101751
SIM,1893,39,30-34,1932,15
STAT,1846,23,30-34,1869,33.42203939476539
STAT,1942,3,na,1945,8498.817975034757
STAT,1855,33,25-29,1888,15.563921347072156
SIM,1856,41,45-49,1897,6
STAT,1861,14,na,1875,4570.654508093538
SIM,1799,66,na,1865,1453
STAT,1897,41,40-44,1938,0.4235767096912693
SIM,1876,24,50-100,1900,1
SIM,1899,60,na,1959,5569
SIM,1859,38,40-44,1897,14
SIM,1882,31,45-49,1913,5
STAT,1840,15,na,1855,4340.850000150492
STAT,1810,49,na,1859,2581.551197755539
STAT,1835,32,45-49,1867,2.8766827979819785
SIM,1915,39,30-34,1954,4
SIM,1859,47,na,1906,3960
SIM,1917,27,35-39,1944,40
STAT,1954,15,50-100,1969,0.9357974780671469
STAT,1820,41,15-19,1861,0.05748449423298071
STAT,1946,24,35-39,1970,21.14575057498579
SIM,1878,61,na,1939,4016
STAT,1923,40,40-44,1963,0.5918733201735764
SIM,1920,16,40-44,1936,3
STAT,1763,107,na,1870,0.0073333860535136864
STAT,1881,21,35-39,1902,11.425722803764248
STAT,1850,21,30-34,1871,33.01720113169915
SIM,1940,17,20-24,1957,295
STAT,1837,48,40-44,1885,0.24459779986398825
STAT,1903,38,35-39,1941,4.368139979247849
STAT,1909,3,na,1912,8011.253183289424
STAT,1932,17,20-24,1949,362.59381110882697
STAT,1780,93,na,1873,12.464149493990849
STAT,1915,38,15-19,1953,0.03898802657827347
STAT,1892,17,15-19,1909,15.004300384655393
STAT,1957,15,20-24,1972,361.1387839011767
SIM,1903,40,50-100,1943,1
STAT,1859,41,20-24,1900,0.25644535894955606
SIM,1876,24,20-24,1900,145
STAT,1910,43,na,1953,7048.845028993655
SIM,1793,101,na,1894,1
STAT,1914,57,na,1971,7036.630104130974
SIM,1844,70,na,1914,2010
SIM,1933,37,50-100,1970,2
STAT,1841,30,40-44,1871,7.794608413214714
STAT,1907,39,30-34,1946,3.380266758004913
STAT,1912,16,40-44,1928,0.5727782251625094
STAT,1875,50,40-44,1925,0.0222052629053236
SIM,1822,38,45-49,1860,3
SIM,1833,29,30-34,1862,58
SIM,1910,46,40-44,1956,1
SIM,1909,34,25-29,1943,23
STAT,1870,19,40-44,1889,0.36181972749583924
SIM,1837,63,na,1900,2330
SIM,1848,84,na,1932,400
SIM,1859,26,50-100,1885,2
SIM,1864,43,45-49,1907,5
STAT,1862,54,25-29,1916,0.005946089828011758
STAT,1896,38,40-44,1934,11.614402821563036
SIM,1827,85,na,1912,242
STAT,1946,19,na,1965,8238.904621505098
STAT,1968,1,na,1969,9930.858870643553
SIM,1854,23,30-34,1877,45
STAT,1909,27,35-39,1936,28.993860221765082
SIM,1868,22,20-24,1890,124
SIM,1929,16,na,1945,9731
STAT,1900,30,45-49,1930,4.924805634603859
SIM,1878,42,35-39,1920,5
STAT,1852,19,50-100,1871,0.09333012629901752
STAT,1914,29,20-24,1943,36.90530676333578
SIM,1908,2,na,1910,8034
STAT,1829,77,na,1906,1023.0159706589649
STAT,1838,30,20-24,1868,4.641250581480279
STAT,1842,33,15-19,1875,0.2534779575936454
STAT,1881,29,45-49,1910,2.1519111079324795
STAT,1915,4,na,1919,8504.339647204617
STAT,1858,28,30-34,1886,40.294886974577494
SIM,1768,89,na,1857,53
SIM,1845,48,40-44,1893,1
SIM,1908,17,na,1925,7642
STAT,1898,31,30-34,1929,47.9139491952003
STAT,1830,37,na,1867,3720.259505794937
STAT,1832,52,35-39,1884,0.011674544606916522
STAT,1859,46,15-19,1905,6.448207153706054E-4
STAT,1863,35,25-29,1898,5.138476243139907
STAT,1883,57,na,1940,3987.657283464143
SIM,1890,33,45-49,1923,6
SIM,1850,33,15-19,1883,1
STAT,1916,17,25-29,1933,18.568660301454116
SIM,1924,17,25-29,1941,132
STAT,1845,19,30-34,1864,3.067772995932293
SIM,1858,62,na,1920,3131
STAT,1880,42,25-29,1922,1.3645539156206663
STAT,1898,25,45-49,1923,3.055143264968274
SIM,1846,30,20-24,1876,6
SIM,1807,97,na,1904,5
STAT,1820,36,40-44,1856,23.207842179674063
STAT,1860,41,45-49,1901,2.465720411160986
SIM,1829,44,na,1873,3167
SIM,1837,47,40-44,1884,1
STAT,1926,42,na,1968,9245.266251187091
SIM,1957,0,na,1957,10345
STAT,1944,28,40-44,1972,10.168671175738302
STAT,1837,40,30-34,1877,1.94032974893159
STAT,1853,20,45-49,1873,1.3225224347082571
SIM,1869,37,35-39,1906,22
SIM,1894,13,na,1907,6998
STAT,1840,51,30-34,1891,0.008633260290389955
STAT,1813,51,25-29,1864,0.021250758550502184
STAT,1935,23,20-24,1958,305.76544403292263
SIM,1941,29,30-34,1970,104
STAT,1815,40,40-44,1855,14.561670370399407
STAT,1859,49,30-34,1908,0.1523560405330139
SIM,1878,48,40-44,1926,1
STAT,1895,42,na,1937,6095.820584024416
STAT,1903,49,15-19,1952,6.352752086891469E-4
SIM,1865,32,na,1897,4418
STAT,1811,71,na,1882,1387.180636867335
STAT,1899,56,na,1955,5643.950144942361
SIM,1887,25,35-39,1912,29
STAT,1889,42,45-49,1931,3.722394015159966
STAT,1913,25,35-39,1938,30.425370620530952
STAT,1922,30,35-39,1952,21.014986808795683
SIM,1898,38,na,1936,6703
STAT,1851,16,15-19,1867,11.251345601708598
SIM,1863,39,45-49,1902,4
SIM,1956,9,na,1965,10699
STAT,1896,27,na,1923,6363.493123737991
SIM,1845,40,30-34,1885,4
SIM,1929,38,20-24,1967,2
STAT,1857,24,45-49,1881,1.136702712644094
SIM,1823,42,45-49,1865,9
SIM,1858,29,50-100,1887,2
SIM,1885,37,30-34,1922,15
STAT,1827,33,na,1860,3483.689010256287
STAT,1892,13,na,1905,6519.226739851541
SIM,1880,80,na,1960,1640
STAT,1885,36,15-19,1921,0.11343063378807351
SIM,1839,70,na,1909,1870
SIM,1846,77,na,1923,1174
SIM,1809,45,na,1854,2729
STAT,1824,31,30-34,1855,92.7693183953358
SIM,1842,63,na,1905,2503
STAT,1922,49,25-29,1971,0.12231931207889903
STAT,1877,37,30-34,1914,11.176967770128412
STAT,1844,77,na,1921,1395.91900103067
SIM,1866,28,30-34,1894,57
SIM,1922,29,20-24,1951,45
SIM,1844,33,na,1877,3567
STAT,1891,22,30-34,1913,44.46626468214627
SIM,1848,47,na,1895,3435
SIM,1865,24,45-49,1889,1
SIM,1921,25,35-39,1946,46
STAT,1861,33,25-29,1894,17.14524430088058
STAT,1884,46,25-29,1930,0.11519611534858529
SIM,1880,22,20-24,1902,138
STAT,1840,26,40-44,1866,5.430283717006354
SIM,1885,79,na,1964,2141
SIM,1943,23,20-24,1966,247
STAT,1933,29,30-34,1962,104.98070969966028
STAT,1879,25,35-39,1904,20.521426422269982
STAT,1907,20,40-44,1927,6.222405974541864
SIM,1904,3,na,1907,7714
SIM,1930,30,35-39,1960,28
STAT,1816,43,15-19,1859,0.07314199076703823
STAT,1836,51,50-100,1887,0.0207287505692306
STAT,1809,52,na,1861,2606.263654684665
STAT,1837,45,25-29,1882,0.08551916362316749
SIM,1819,38,50-100,1857,4
STAT,1856,40,40-44,1896,3.5402687299174933
STAT,1920,20,50-100,1940,1.4858379735118246
STAT,1935,17,35-39,1952,11.587469495272286
SIM,1887,31,20-24,1918,10
STAT,1765,106,na,1871,0.023190724276205582
SIM,1886,49,40-44,1935,1
STAT,1859,37,25-29,1896,4.62827832376294
STAT,1825,29,30-34,1854,169.7649593024261
SIM,1829,25,25-29,1854,81
STAT,1902,46,40-44,1948,0.2761393051185319
SIM,1817,39,50-100,1856,2
STAT,1879,31,20-24,1910,5.733485016787433
STAT,1883,34,15-19,1917,0.28015645467643735
STAT,1876,50,na,1926,4562.298630227517
STAT,1821,51,20-24,1872,0.002119318928616034
STAT,1888,16,25-29,1904,13.560072040894388
SIM,1865,30,30-34,1895,44
SIM,1888,43,30-34,1931,5
STAT,1846,25,na,1871,4066.7054778774104
STAT,1907,47,50-100,1954,0.4093163279432556
SIM,1843,32,45-49,1875,4
SIM,1896,16,25-29,1912,18
STAT,1924,43,15-19,1967,0.003682294704450286
SIM,1943,17,35-39,1960,10
STAT,1881,13,na,1894,5033.4537417472
STAT,1861,42,15-19,1903,0.023185858710554043
STAT,1911,37,30-34,1948,3.5563065360147523
SIM,1835,23,20-24,1858,125
STAT,1878,49,40-44,1927,0.35357252741755285
STAT,1868,28,15-19,1896,0.8687326629098425
SIM,1885,24,25-29,1909,154
SIM,1889,26,35-39,1915,28
STAT,1934,17,30-34,1951,33.30147223772772
STAT,1790,92,na,1882,21.05244995263686
SIM,1882,23,45-49,1905,1
SIM,1887,32,35-39,1919,31
SIM,1875,80,na,1955,1228
SIM,1946,15,35-39,1961,10
STAT,1929,34,na,1963,9688.87729742273
STAT,1810,51,45-49,1861,0.09153810878671657
STAT,1882,42,35-39,1924,3.5582028818013502
STAT,1866,53,50-100,1919,0.02769179066452414
STAT,1858,30,35-39,1888,16.278821653505403
STAT,1913,21,40-44,1934,6.60173891633684
SIM,1821,43,25-29,1864,2
STAT,1912,39,15-19,1951,0.037482322947971373
STAT,1916,22,20-24,1938,235.31821538861968
STAT,1918,16,20-24,1934,59.92942410971545
STAT,1927,18,50-100,1945,0.9382102467791671
SIM,1935,27,40-44,1962,16
STAT,1828,36,50-100,1864,2.523647613186645
SIM,1928,37,na,1965,9762
SIM,1924,22,20-24,1946,262
STAT,1866,26,15-19,1892,0.848366897231262
STAT,1873,53,35-39,1926,0.017382621655275186
STAT,1784,86,na,1870,114.34253565851616
STAT,1904,43,35-39,1947,0.3618736171819401
STAT,1877,24,25-29,1901,119.30155075169652
SIM,1914,39,na,1953,7659
SIM,1928,24,30-34,1952,103
STAT,1840,25,40-44,1865,5.469555122787972
SIM,1926,38,40-44,1964,6
STAT,1900,27,15-19,1927,1.2711041597055113
SIM,1903,45,35-39,1948,1
STAT,1865,33,45-49,1898,3.1860823084307124
STAT,1919,28,45-49,1947,3.7559044824188055
STAT,1915,40,45-49,1955,0.3393684498737425
SIM,1841,68,na,1909,2090
STAT,1825,85,na,1910,317.1833262854688
SIM,1902,16,35-39,1918,2
STAT,1889,5,na,1894,6526.000130781159
SIM,1890,42,35-39,1932,9
STAT,1804,50,20-24,1854,0.004492765867750099
SIM,1848,30,30-34,1878,43
SIM,1839,32,30-34,1871,46
STAT,1933,38,20-24,1971,0.7244975632631059
STAT,1963,6,na,1969,10084.57321700115
SIM,1854,11,na,1865,4856
SIM,1917,32,30-34,1949,8
SIM,1823,40,40-44,1863,10
SIM,1851,49,40-44,1900,1
SIM,1907,25,25-29,1932,129
STAT,1836,63,na,1899,2372.380896637146
STAT,1883,33,50-100,1916,1.8104093501991934
STAT,1922,38,45-49,1960,1.5646291605395102
SIM,1822,39,45-49,1861,5
SIM,1823,55,na,1878,2531
STAT,1907,48,20-24,1955,0.01984037650048611
SIM,1927,28,45-49,1955,8
SIM,1867,33,20-24,1900,6
SIM,1910,35,25-29,1945,3
STAT,1875,24,15-19,1899,6.816887076573897
SIM,1824,30,45-49,1854,9
STAT,1891,20,40-44,1911,5.233021066753976
STAT,1894,21,20-24,1915,179.32612625800311
STAT,1929,22,30-34,1951,73.39715346372643
SIM,1833,39,20-24,1872,2
STAT,1796,71,na,1867,1234.3950006976297
SIM,1926,16,20-24,1942,332
SIM,1938,28,20-24,1966,35
STAT,1878,53,25-29,1931,0.007351212544496238
SIM,1849,58,na,1907,3208
SIM,1930,38,45-49,1968,2
SIM,1933,15,25-29,1948,153
SIM,1890,31,40-44,1921,17
STAT,1912,42,30-34,1954,0.249092276655385
STAT,1952,17,35-39,1969,10.154874717569895
STAT,1882,31,40-44,1913,8.566908945819728
STAT,1883,21,45-49,1904,1.3878540705246571
SIM,1891,21,45-49,1912,2
SIM,1930,0,na,1930,11496
STAT,1885,43,15-19,1928,0.027561302314369186
STAT,1876,45,15-19,1921,8.43873196838075E-4
SIM,1878,39,na,1917,5091
STAT,1818,52,15-19,1870,1.0398680615513566E-4
STAT,1935,0,na,1935,12440.744096583077
STAT,1890,27,na,1917,5883.151925560469
STAT,1902,35,25-29,1937,1.7887959986285678
STAT,1865,20,25-29,1885,107.85491592525682
STAT,1911,12,na,1923,7983.877620303704
SIM,1874,20,30-34,1894,48
STAT,1918,2,na,1920,8988.904397907494
STAT,1945,18,45-49,1963,1.1016403818925862
STAT,1853,53,50-100,1906,0.023511922896415426
SIM,1859,39,40-44,1898,14
STAT,1825,39,20-24,1864,1.8800035221433604
STAT,1905,49,25-29,1954,0.09291822624829077
SIM,1853,53,na,1906,3467
SIM,1876,31,20-24,1907,7
STAT,1902,48,45-49,1950,0.3748121638796839
STAT,1883,15,35-39,1898,1.0938476149910241
STAT,1859,36,25-29,1895,4.6505544797208005
STAT,1862,95,na,1957,30.37129296600553
STAT,1911,33,25-29,1944,18.105437182098733
STAT,1827,30,20-24,1857,7.415849328714537
SIM,1918,17,25-29,1935,119
STAT,1868,52,50-100,1920,0.028865841619615154
STAT,1886,19,40-44,1905,0.3878476538843035
SIM,1893,28,na,1921,6221
SIM,1835,50,na,1885,3064
SIM,1937,22,30-34,1959,72
STAT,1822,109,na,1931,8.032973638013459E-4
STAT,1908,44,50-100,1952,0.21696308137129922
SIM,1908,34,30-34,1942,33
SIM,1855,20,20-24,1875,144
STAT,1929,17,35-39,1946,10.814296899421748
STAT,1881,52,30-34,1933,0.011558001928192644
STAT,1817,40,50-100,1857,6.177690848511199
STAT,1879,23,20-24,1902,145.12623615525752
SIM,1838,23,25-29,1861,125
SIM,1939,25,45-49,1964,5
SIM,1919,4,na,1923,9139
STAT,1836,20,45-49,1856,1.488703534803678
STAT,1896,37,40-44,1933,11.67229741675011
STAT,1907,16,45-49,1923,0.19437709004746312
STAT,1918,38,40-44,1956,3.1829071315807105
SIM,1864,41,40-44,1905,13
STAT,1791,106,na,1897,0.004791522242159453
STAT,1863,30,30-34,1893,31.115159783096686
STAT,1828,34,na,1862,3465.7287609337977
SIM,1789,88,na,1877,64
SIM,1830,38,40-44,1868,12
STAT,1862,52,20-24,1914,0.0012670162820384424
SIM,1862,30,na,1892,4406
STAT,1877,45,na,1922,4765.311184804674
STAT,1840,68,na,1908,2205.861999756917
SIM,1791,92,na,1883,6
SIM,1910,48,45-49,1958,2
STAT,1822,38,40-44,1860,16.734482195204397
SIM,1907,29,30-34,1936,10
STAT,1813,42,50-100,1855,7.850226468186525
SIM,1866,30,35-39,1896,33
STAT,1847,51,40-44,1898,0.016124518879151353
STAT,1848,41,45-49,1889,2.482634336045049
STAT,1900,49,35-39,1949,0.21662942767850954
STAT,1924,36,15-19,1960,0.045761805397043796
STAT,1843,33,na,1876,3612.0637142739633
STAT,1846,33,35-39,1879,18.141624944286516
SIM,1898,43,na,1941,6480
STAT,1813,43,25-29,1856,4.47743100878739
STAT,1815,51,35-39,1866,0.045213714080452376
SIM,1835,30,20-24,1865,6
SIM,1888,41,40-44,1929,8
SIM,1841,22,45-49,1863,1
STAT,1885,64,na,1949,3494.6152781201104
SIM,1894,19,40-44,1913,1
STAT,1925,39,25-29,1964,2.3811103432382725
STAT,1898,23,30-34,1921,48.53210347368647
SIM,1826,79,na,1905,705
SIM,1827,28,40-44,1855,6
SIM,1880,20,30-34,1900,58
STAT,1948,22,40-44,1970,7.796470072572382
STAT,1879,32,35-39,1911,21.39319517277716
SIM,1878,20,15-19,1898,7
SIM,1906,17,20-24,1923,48
STAT,1920,43,50-100,1963,0.2615691501412056
STAT,1880,34,25-29,1914,21.605315115197953
SIM,1793,93,na,1886,4
SIM,1844,20,45-49,1864,1
SIM,1942,17,30-34,1959,39
SIM,1889,31,30-34,1920,60
SIM,1909,37,40-44,1946,4
STAT,1905,22,45-49,1927,2.0367233649400025
SIM,1913,22,45-49,1935,2
SIM,1838,54,50-100,1892,1
STAT,1830,40,20-24,1870,0.29278042300898505
STAT,1916,22,50-100,1938,1.3924980195783478
STAT,1930,33,35-39,1963,23.80317654225565
SIM,1815,41,50-100,1856,4
SIM,1937,17,35-39,1954,9
STAT,1847,20,20-24,1867,130.6457336023188
SIM,1837,33,35-39,1870,29
STAT,1839,30,25-29,1869,20.094351059672274
STAT,1853,20,20-24,1873,130.697690684459
STAT,1874,22,30-34,1896,36.834284109890966
SIM,1919,35,45-49,1954,4
STAT,1861,30,na,1891,4043.6531838455435
SIM,1936,35,45-49,1971,2
SIM,1906,23,40-44,1929,8
SIM,1882,21,50-100,1903,1
SIM,1810,48,40-44,1858,1
SIM,1902,21,30-34,1923,68
SIM,1911,27,40-44,1938,12
STAT,1870,20,20-24,1890,137.45685224227353
STAT,1896,24,35-39,1920,15.462481635214234
STAT,1899,25,15-19,1924,1.2639752780179927
STAT,1838,31,35-39,1869,17.20891854846674
STAT,1913,48,20-24,1961,0.021729287722629487
STAT,1815,85,na,1900,254.8078727507751
STAT,1857,22,30-34,1879,32.370615717282796
SIM,1883,9,na,1892,5394
SIM,1907,49,25-29,1956,1
SIM,1937,28,15-19,1965,1
STAT,1918,25,35-39,1943,32.482288693290485
STAT,1885,20,40-44,1905,4.214067343117099
STAT,1855,31,35-39,1886,15.711276100307352
SIM,1869,78,na,1947,1317
SIM,1887,23,20-24,1910,152
STAT,1859,33,45-49,1892,2.791345914629497
STAT,1957,15,45-49,1972,1.330651110131049
SIM,1855,3,na,1858,5339
STAT,1917,46,25-29,1963,0.11216832381773612
SIM,1838,64,na,1902,2377
STAT,1939,27,45-49,1966,3.5080142226952074
STAT,1854,66,na,1920,2512.5817033612598
STAT,1935,25,35-39,1960,41.37610437462191
SIM,1878,45,na,1923,4999
SIM,1941,2,na,1943,8537
STAT,1844,42,15-19,1886,0.02284064896898151
SIM,1852,25,25-29,1877,102
STAT,1833,22,45-49,1855,1.2750097952239794
SIM,1949,19,50-100,1968,1
STAT,1906,43,na,1949,6776.035454702713
SIM,1783,73,na,1856,939
STAT,1828,50,na,1878,2947.8991030498837
SIM,1847,30,25-29,1877,27
SIM,1872,21,35-39,1893,15
STAT,1851,52,45-49,1903,0.02237712954934577
SIM,1846,83,na,1929,511
STAT,1839,28,na,1867,4224.706425351076
SIM,1903,19,45-49,1922,1
STAT,1835,32,20-24,1867,4.459079959428189
STAT,1928,35,45-49,1963,1.742756090969367
SIM,1873,20,25-29,1893,130
STAT,1842,97,na,1939,7.998271682729668
SIM,1897,34,45-49,1931,2
STAT,1821,109,na,1930,7.88614817957814E-4
SIM,1943,25,35-39,1968,43
STAT,1844,25,25-29,1869,84.84077726533427
STAT,1866,51,na,1917,4031.5820644841856
SIM,1823,49,na,1872,2857
STAT,1834,51,45-49,1885,0.020203990532868137
SIM,1944,15,50-100,1959,1
STAT,1818,49,30-34,1867,0.4137730937059404
STAT,1892,35,50-100,1927,3.1335769791560466
STAT,1850,22,45-49,1872,1.2832884452048328
STAT,1903,27,40-44,1930,8.613930897762375
STAT,1904,17,45-49,1921,0.1893529393139004
STAT,1886,28,na,1914,5070.020968657151
STAT,1953,17,40-44,1970,3.4169257747533397
SIM,1841,78,na,1919,929
STAT,1828,51,30-34,1879,0.010562424606469105
STAT,1840,29,45-49,1869,1.9696862149652103
SIM,1865,22,30-34,1887,40
SIM,1934,24,30-34,1958,103
SIM,1832,85,na,1917,430
SIM,1893,20,40-44,1913,4
STAT,1809,54,15-19,1863,1.7415530299267097E-4
STAT,1885,23,20-24,1908,138.1064516099912
STAT,1926,24,30-34,1950,70.06605830017243
STAT,1848,44,50-100,1892,1.7088893947361314
STAT,1851,15,15-19,1866,11.318008672791338
STAT,1864,21,35-39,1885,10.781669008143108
STAT,1865,103,na,1968,1.976287341730391
STAT,1883,3,na,1886,5901.19141033984
STAT,1895,42,30-34,1937,0.20983840490563765
SIM,1778,94,na,1872,9
SIM,1868,26,15-19,1894,1
STAT,1849,23,35-39,1872,11.079885935152367
STAT,1929,28,15-19,1957,1.783340804361572
SIM,1873,30,40-44,1903,13
SIM,1833,33,na,1866,3560
STAT,1845,54,25-29,1899,0.005307922251107327
STAT,1828,54,25-29,1882,0.005389165562680174
SIM,1886,74,na,1960,2520
STAT,1868,23,45-49,1891,1.335781446458224
STAT,1861,20,na,1881,4143.64614553443
STAT,1899,72,na,1971,4341.380690360015
STAT,1949,18,15-19,1967,106.55877295470646
SIM,1945,25,45-49,1970,5
STAT,1856,52,35-39,1908,0.013343532854308037
SIM,1893,23,20-24,1916,186
STAT,1848,39,15-19,1887,0.09293695810445789
SIM,1845,49,40-44,1894,2
SIM,1901,28,25-29,1929,133
SIM,1866,24,15-19,1890,9
STAT,1844,30,20-24,1874,5.3295997330366935
STAT,1907,24,20-24,1931,203.27669039208055
STAT,1854,41,30-34,1895,1.770401340586185
SIM,1826,32,20-24,1858,6
STAT,1871,41,20-24,1912,0.32010259781934464
STAT,1943,24,30-34,1967,61.71341474882877
SIM,1828,43,35-39,1871,10
STAT,1886,12,na,1898,5505.76113466299
STAT,1833,98,na,1931,4.270622564548143
SIM,1928,15,na,1943,9550
SIM,1931,19,na,1950,9692
SIM,1896,58,na,1954,5405
STAT,1879,58,na,1937,4177.62941880023
STAT,1881,26,40-44,1907,5.8676515692506985
STAT,1873,79,na,1952,1434.6032105081463
STAT,1889,34,45-49,1923,4.305344362318413
STAT,1924,24,20-24,1948,263.25988180495176
SIM,1930,27,50-100,1957,3
STAT,1944,17,na,1961,7999.335723867009
SIM,1853,63,na,1916,2830
STAT,1908,27,30-34,1935,75.49255925067688
STAT,1894,47,na,1941,5810.847629076337
SIM,1846,31,35-39,1877,27
SIM,1926,25,35-39,1951,51
SIM,1936,8,na,1944,6913
STAT,1875,52,45-49,1927,0.030015766466916952
SIM,1878,23,na,1901,5153
SIM,1898,24,35-39,1922,18
STAT,1859,27,50-100,1886,1.0460480457534096
SIM,1861,20,20-24,1881,142
SIM,1915,24,20-24,1939,238
STAT,1824,38,50-100,1862,3.5660015326804553
STAT,1837,49,40-44,1886,0.24148406987171978
STAT,1890,36,50-100,1926,3.041144440775589
SIM,1916,27,30-34,1943,99
SIM,1878,34,35-39,1912,31
STAT,1938,15,35-39,1953,8.39993098125237
SIM,1879,24,25-29,1903,127
STAT,1849,34,15-19,1883,0.23248935427705406
STAT,1923,43,45-49,1966,0.39211448561422185
SIM,1932,24,20-24,1956,295
SIM,1847,43,45-49,1890,5
STAT,1870,15,25-29,1885,11.477991700640256
STAT,1895,45,25-29,1940,0.08635727197993667
STAT,1806,49,na,1855,2436.6778452683266
SIM,1910,32,20-24,1942,6
SIM,1850,47,50-100,1897,1
STAT,1874,80,na,1954,1279.2044313211097
STAT,1892,16,15-19,1908,15.041151205107903
STAT,1927,27,40-44,1954,11.442402241170505
SIM,1863,31,35-39,1894,23
SIM,1921,21,40-44,1942,11
STAT,1910,28,25-29,1938,127.96079699308844
SIM,1878,55,na,1933,4490
STAT,1876,33,20-24,1909,5.622483134178875
STAT,1918,49,35-39,1967,0.275422898124097
STAT,1945,27,50-100,1972,2.2052430207302294
SIM,1876,23,45-49,1899,2
STAT,1839,43,45-49,1882,2.431632499810419
STAT,1825,79,na,1904,808.8897437285422
STAT,1894,57,na,1951,5213.780261942676
STAT,1820,48,na,1868,2848.6845154859548
SIM,1846,22,20-24,1868,129
STAT,1937,25,45-49,1962,3.4048059653419216
SIM,1861,82,na,1943,734
STAT,1841,16,na,1857,4320.954066615494
SIM,1822,35,40-44,1857,8
STAT,1838,22,20-24,1860,121.00380106814947
STAT,1909,35,35-39,1944,4.670207523720159
SIM,1873,24,na,1897,4974
STAT,1913,24,45-49,1937,2.280901219063154
SIM,1856,33,45-49,1889,3
SIM,1881,50,30-34,1931,2
STAT,1848,31,50-100,1879,1.7703232524276815
STAT,1887,47,40-44,1934,0.3849024653890299
SIM,1900,38,35-39,1938,8
STAT,1868,25,na,1893,4616.878738879491
STAT,1870,29,30-34,1899,49.5744882721321
STAT,1920,27,30-34,1947,86.78787451042841
SIM,1811,43,50-100,1854,5
SIM,1878,37,50-100,1915,5
STAT,1931,10,na,1941,10506.282085124523
STAT,1838,25,25-29,1863,73.883091890582
STAT,1792,89,na,1881,76.24656432755549
SIM,1871,50,na,1921,4233
STAT,1935,16,20-24,1951,375.30512501623616
STAT,1901,44,na,1945,6468.784471722721
STAT,1845,83,na,1928,611.7314251895427
STAT,1824,49,30-34,1873,0.2279403354556948
STAT,1872,20,30-34,1892,36.370029854249545
SIM,1943,16,20-24,1959,278
SIM,1871,34,25-29,1905,22
STAT,1764,106,na,1870,0.018805032504954813
SIM,1929,15,35-39,1944,12
STAT,1806,50,40-44,1856,0.06394550275292525
STAT,1911,16,35-39,1927,1.7005113330289698
STAT,1904,58,na,1962,6026.087018755197
SIM,1917,35,35-39,1952,8
STAT,1854,44,25-29,1898,0.9711307617105344
STAT,1842,18,15-19,1860,11.279044857761113
SIM,1906,45,50-100,1951,1
SIM,1833,25,15-19,1858,1
SIM,1945,24,30-34,1969,71
SIM,1832,32,45-49,1864,5
STAT,1859,81,na,1940,869.2730936785523
STAT,1822,39,50-100,1861,4.466972277203119
STAT,1882,1,na,1883,6611.503712356032
SIM,1830,39,50-100,1869,4
STAT,1914,17,15-19,1931,18.96317198571716
SIM,1904,21,40-44,1925,7
SIM,1841,84,na,1925,431
SIM,1889,43,50-100,1932,4
STAT,1830,43,25-29,1873,1.135032750561717
SIM,1922,17,15-19,1939,110
STAT,1869,52,30-34,1921,0.01158676700647442
STAT,1861,52,na,1913,3600.224545623368
STAT,1898,26,35-39,1924,26.46186753820119
STAT,1937,24,30-34,1961,56.49867829472938
STAT,1873,50,30-34,1923,0.012390499820034005
SIM,1898,26,50-100,1924,2
SIM,1921,24,45-49,1945,4
SIM,1942,4,na,1946,8606
STAT,1912,45,35-39,1957,0.2514910714010146
SIM,1840,40,40-44,1880,3
STAT,1916,29,30-34,1945,81.23638778564543
STAT,1916,35,50-100,1951,0.876586976177646
SIM,1954,17,35-39,1971,13
SIM,1869,44,35-39,1913,5
STAT,1835,31,50-100,1866,1.5272539260553606
SIM,1916,19,30-34,1935,35
STAT,1804,53,25-29,1857,0.02029916811107185
SIM,1861,36,30-34,1897,11
STAT,1819,51,na,1870,2664.234906321816
SIM,1892,20,35-39,1912,20
SIM,1893,26,25-29,1919,119
SIM,1950,19,30-34,1969,35
STAT,1877,36,50-100,1913,2.5871633209325475
STAT,1942,19,30-34,1961,25.70870595625933
SIM,1928,27,35-39,1955,7
STAT,1944,16,50-100,1960,0.8144615385551295
SIM,1863,23,35-39,1886,14
STAT,1855,23,35-39,1878,10.20621346843745
SIM,1858,2,na,1860,5724
STAT,1868,101,na,1969,7.966529543963774
STAT,1900,46,30-34,1946,0.15341216864264207
SIM,1952,16,50-100,1968,1
STAT,1845,15,15-19,1860,11.695547447369318
STAT,1857,31,45-49,1888,2.79089726686652
STAT,1848,33,45-49,1881,3.003067491595571
STAT,1909,48,40-44,1957,0.2919367411815306
STAT,1844,22,45-49,1866,1.4060272048084301
SIM,1918,27,40-44,1945,15
STAT,1889,33,30-34,1922,43.29528149799349
SIM,1869,46,na,1915,4357
STAT,1844,82,na,1926,753.4905109938679
SIM,1880,29,40-44,1909,9
SIM,1833,49,na,1882,3070
STAT,1865,30,40-44,1895,8.021016116664889
SIM,1880,0,na,1880,7663
SIM,1889,23,30-34,1912,53
STAT,1932,40,45-49,1972,0.4568569147195489
STAT,1831,39,20-24,1870,1.2340589307490846
STAT,1884,20,35-39,1904,11.706961691986193
SIM,1826,35,25-29,1861,6
STAT,1760,109,na,1869,7.845578348181091E-4
STAT,1872,29,40-44,1901,6.0367609454774245
SIM,1881,41,40-44,1922,5
SIM,1901,25,20-24,1926,37
STAT,1871,44,25-29,1915,1.2711054317213435
STAT,1911,25,25-29,1936,130.55469118683348
STAT,1933,20,50-100,1953,1.773424928364313
STAT,1944,15,35-39,1959,9.12425198489772
STAT,1946,23,45-49,1969,2.5277356045721553
STAT,1953,16,na,1969,8994.25619332834
STAT,1931,28,45-49,1959,4.502606305630483
SIM,1805,68,na,1873,1456
SIM,1941,20,50-100,1961,2
STAT,1832,97,na,1929,7.003888262990675
STAT,1885,26,25-29,1911,85.33021413384378
STAT,1861,106,na,1967,0.1729895624376564
STAT,1946,17,35-39,1963,9.398826686961424
SIM,1835,34,na,1869,3561
STAT,1858,52,45-49,1910,0.02272697570630116
SIM,1803,67,na,1870,1635
SIM,1906,34,20-24,1940,7
SIM,1853,15,15-19,1868,11
STAT,1767,104,na,1871,0.05378555032847926
SIM,1839,39,15-19,1878,1
STAT,1774,92,na,1866,15.719289846725259
STAT,1845,30,na,1875,4054.1207310173654
STAT,1916,43,na,1959,7674.360514870177
SIM,1888,44,45-49,1932,2
STAT,1864,44,na,1908,4116.182120880724
STAT,1820,39,45-49,1859,8.793768611934684
STAT,1872,95,na,1967,107.19184259471801
SIM,1883,17,15-19,1900,6
SIM,1787,71,na,1858,991
SIM,1865,31,45-49,1896,6
STAT,1879,74,na,1953,2344.402962843928
STAT,1848,32,30-34,1880,33.386301380097464
STAT,1894,41,na,1935,6023.404787429606
STAT,1928,32,40-44,1960,9.880910556985695
STAT,1941,2,na,1943,8459.22423491732
SIM,1845,34,na,1879,4078
SIM,1924,35,50-100,1959,1
STAT,1807,66,na,1873,1790.5051769597558
SIM,1920,28,35-39,1948,45
STAT,1923,19,20-24,1942,319.6924866228825
STAT,1822,54,50-100,1876,0.043412911588144726
STAT,1853,36,30-34,1889,8.520482313733403
SIM,1830,33,25-29,1863,22
STAT,1857,36,15-19,1893,0.08882380495981256
STAT,1912,28,35-39,1940,29.783583535580657
STAT,1873,41,40-44,1914,4.636524936004856
SIM,1830,35,na,1865,3261
STAT,1829,33,35-39,1862,18.90055756820425
SIM,1821,48,na,1869,2863
STAT,1903,45,50-100,1948,0.40234876496573196
SIM,1833,45,50-100,1878,1
SIM,1856,32,30-34,1888,44
SIM,1850,18,15-19,1868,11
SIM,1858,43,20-24,1901,1
SIM,1952,15,35-39,1967,8
STAT,1774,86,na,1860,97.77695006849112
STAT,1917,34,30-34,1951,33.03186266053073
SIM,1876,6,na,1882,5882
STAT,1874,23,45-49,1897,1.437545823523732
SIM,1895,47,40-44,1942,1
SIM,1868,29,40-44,1897,5
STAT,1837,52,25-29,1889,0.0049558228279945596
SIM,1848,22,30-34,1870,46
SIM,1941,17,25-29,1958,125
STAT,1909,48,30-34,1957,0.16506703620756566
STAT,1824,32,45-49,1856,7.845497073862629
STAT,1933,17,25-29,1950,117.17126514572558
STAT,1940,19,na,1959,7543.240686841621
STAT,1847,96,na,1943,13.089001299486192
SIM,1872,15,25-29,1887,12
STAT,1844,22,20-24,1866,138.95001240453394
STAT,1846,30,30-34,1876,32.26699609013483
SIM,1852,39,30-34,1891,20
STAT,1864,15,25-29,1879,11.767791822654287
STAT,1877,21,45-49,1898,1.4668087511637575
STAT,1844,39,30-34,1883,8.908099052941475
SIM,1839,35,35-39,1874,22
SIM,1908,60,na,1968,6182
SIM,1908,37,35-39,1945,6
STAT,1891,23,45-49,1914,1.7354020751649524
SIM,1888,31,25-29,1919,29
STAT,1811,54,30-34,1865,0.037028502213361555
SIM,1925,34,30-34,1959,53
SIM,1859,34,25-29,1893,21
STAT,1897,34,50-100,1931,2.4523574900688057
SIM,1852,22,20-24,1874,140
STAT,1874,27,na,1901,4935.126754879783
STAT,1830,40,50-100,1870,1.9476262550632686
SIM,1903,42,30-34,1945,1
STAT,1879,30,50-100,1909,1.9511059689963126
SIM,1887,30,50-100,1917,4
SIM,1839,41,45-49,1880,6
SIM,1934,27,35-39,1961,53
STAT,1935,22,30-34,1957,79.0593729967413
SIM,1921,1,na,1922,9518
SIM,1887,26,25-29,1913,116
SIM,1903,16,40-44,1919,3
STAT,1931,39,25-29,1970,2.6280417380821675
STAT,1898,32,45-49,1930,4.766019040171974
SIM,1841,21,30-34,1862,37
STAT,1885,23,45-49,1908,1.39749126151838
STAT,1797,87,na,1884,116.28627982652324
SIM,1829,30,20-24,1859,5
STAT,1851,29,20-24,1880,20.988480612599563
SIM,1871,42,25-29,1913,2
STAT,1888,21,20-24,1909,164.99524674929975
SIM,1891,19,15-19,1910,12
STAT,1915,17,20-24,1932,57.31180101586292
STAT,1875,38,na,1913,4874.60626890477
STAT,1932,38,15-19,1970,0.05206081028553193
STAT,1857,25,35-39,1882,15.872338076801942
SIM,1845,38,50-100,1883,5
SIM,1921,42,na,1963,8470
STAT,1886,16,15-19,1902,12.683195246508731
STAT,1899,31,35-39,1930,28.137515595413454
SIM,1854,30,30-34,1884,47
SIM,1876,47,30-34,1923,1
STAT,1905,16,50-100,1921,0.14344597456515873
STAT,1868,47,30-34,1915,0.1851365957465938
STAT,1883,19,15-19,1902,11.71262004183661
STAT,1845,18,40-44,1863,0.35412533638867627
STAT,1927,37,na,1964,9445.42145380199
STAT,1919,4,na,1923,9006.26288802576
STAT,1901,27,20-24,1928,33.16914167304905
STAT,1904,35,35-39,1939,4.467324682408114
STAT,1805,49,20-24,1854,0.09565524227822739
SIM,1896,21,20-24,1917,176
STAT,1835,44,15-19,1879,0.020898193408333907
SIM,1878,29,na,1907,5149
SIM,1912,22,na,1934,7539
SIM,1923,17,20-24,1940,312
SIM,1936,32,40-44,1968,7
STAT,1837,38,50-100,1875,2.0623578258205564
STAT,1926,27,35-39,1953,36.3424457286464
SIM,1826,32,45-49,1858,4
STAT,1863,42,25-29,1905,1.1338721466863735
SIM,1902,24,35-39,1926,1
STAT,1786,71,na,1857,1058.636706084857
SIM,1845,12,na,1857,4908
STAT,1843,98,na,1941,4.550614054688186
STAT,1926,44,25-29,1970,0.17717136304749925
SIM,1791,86,na,1877,104
STAT,1879,26,25-29,1905,89.66744611278556
SIM,1908,44,50-100,1952,1
STAT,1846,46,40-44,1892,0.26297311848256516
STAT,1795,91,na,1886,40.45620472193845
STAT,1866,20,30-34,1886,33.949617615303225
SIM,1867,30,40-44,1897,13
SIM,1931,19,20-24,1950,348
SIM,1838,80,na,1918,739
STAT,1907,24,45-49,1931,2.0569451693360175
SIM,1902,37,30-34,1939,3
SIM,1943,22,30-34,1965,79
STAT,1879,35,50-100,1914,2.618210018409996
STAT,1870,32,15-19,1902,0.28236981642892256
STAT,1870,23,25-29,1893,113.15741849725593
STAT,1904,42,na,1946,6714.5432793065265
SIM,1888,23,na,1911,5532
SIM,1842,16,15-19,1858,12
SIM,1798,65,na,1863,1561
STAT,1925,5,na,1930,9807.44346291527
STAT,1924,19,na,1943,8802.463664343166
STAT,1887,23,na,1910,5325.647207131066
SIM,1903,61,na,1964,5915
SIM,1852,22,45-49,1874,1
STAT,1793,110,na,1903,1.0030296418852227E-4
STAT,1906,48,15-19,1954,6.556821824844482E-4
STAT,1841,41,35-39,1882,2.7653628859824937
STAT,1859,30,40-44,1889,7.072775475987449
SIM,1862,41,30-34,1903,5
SIM,1828,86,na,1914,284
STAT,1855,83,na,1938,598.6303377932973
STAT,1841,32,na,1873,3815.255352263687
STAT,1863,33,35-39,1896,17.828093391228755
STAT,1870,50,na,1920,4330.712066628426
STAT,1925,15,25-29,1940,106.19402725876185
STAT,1930,25,35-39,1955,38.58849447943759
SIM,1886,58,na,1944,4035
SIM,1891,27,na,1918,6139
STAT,1832,40,40-44,1872,3.6812136370273034
SIM,1924,29,30-34,1953,113
STAT,1902,23,30-34,1925,50.63204724319707
SIM,1847,40,40-44,1887,8
SIM,1897,33,30-34,1930,52
STAT,1859,50,50-100,1909,0.02462638446195406
SIM,1895,31,30-34,1926,67
SIM,1916,17,15-19,1933,17
SIM,1828,40,30-34,1868,5
SIM,1873,33,45-49,1906,4
STAT,1917,46,50-100,1963,0.47827327298576516
STAT,1940,18,50-100,1958,0.7680774798958484
STAT,1907,60,na,1967,6159.091424362044
STAT,1880,31,30-34,1911,37.29862899742412
STAT,1927,17,25-29,1944,108.80474220436741
SIM,1935,17,25-29,1952,141
SIM,1830,41,25-29,1871,2
STAT,1895,49,40-44,1944,0.24883310898029062
SIM,1912,35,35-39,1947,10
SIM,1894,45,na,1939,6126
STAT,1845,51,20-24,1896,0.0011425268367112541
SIM,1896,74,na,1970,3733
SIM,1805,52,na,1857,2331
STAT,1909,32,30-34,1941,30.380737035510197
STAT,1786,93,na,1879,12.473976253405073
STAT,1908,19,30-34,1927,4.752620131220929
STAT,1842,20,45-49,1862,1.3284621014790308
STAT,1840,84,na,1924,480.17947428054424
STAT,1859,33,20-24,1892,4.326801215791923
STAT,1887,31,30-34,1918,39.599049877185884
SIM,1865,25,35-39,1890,21
STAT,1911,22,na,1933,7311.594161737378
STAT,1908,17,15-19,1925,17.791128968844927
SIM,1808,66,na,1874,1720
STAT,1839,40,40-44,1879,4.173246189127213
SIM,1910,23,30-34,1933,2
SIM,1827,48,50-100,1875,2
SIM,1846,25,25-29,1871,90
SIM,1859,31,45-49,1890,3
SIM,1919,34,30-34,1953,40
STAT,1844,33,25-29,1877,19.575854241833024
STAT,1850,39,30-34,1889,8.130468986862496
SIM,1893,23,45-49,1916,3
SIM,1938,15,na,1953,7403
SIM,1821,40,30-34,1861,2
STAT,1907,27,25-29,1934,125.56594628667699
STAT,1841,36,50-100,1877,2.120709414204455
SIM,1844,23,25-29,1867,119
SIM,1850,20,45-49,1870,3
STAT,1894,63,na,1957,4728.112989387235
STAT,1905,38,45-49,1943,1.2505101012155226
SIM,1867,36,25-29,1903,6
STAT,1854,110,na,1964,0.0022257832825801883
SIM,1928,33,45-49,1961,6
STAT,1822,41,25-29,1863,2.219903114561019
STAT,1950,6,na,1956,9387.047581546156
SIM,1913,38,45-49,1951,3
SIM,1905,29,20-24,1934,45
STAT,1894,37,30-34,1931,13.827039619958626
STAT,1855,61,na,1916,2817.779820302047
STAT,1913,40,35-39,1953,0.4011879054092601
SIM,1833,27,na,1860,3690
SIM,1915,27,25-29,1942,139
SIM,1941,19,na,1960,7736
STAT,1833,21,30-34,1854,38.96766040415348
STAT,1827,46,30-34,1873,0.1771694726538074
STAT,1836,23,25-29,1859,99.75160402971966
SIM,1869,25,na,1894,4649
STAT,1861,34,15-19,1895,0.23733894645953166
SIM,1923,16,na,1939,9169
STAT,1873,38,50-100,1911,2.5069008445764585
STAT,1816,49,na,1865,2850.5699328550504
SIM,1798,87,na,1885,83
STAT,1884,80,na,1964,1774.9251989213644
SIM,1842,69,na,1911,2020
STAT,1933,39,35-39,1972,6.640179705129851
SIM,1859,31,20-24,1890,5
STAT,1824,84,na,1908,355.6621852483807
STAT,1853,29,30-34,1882,41.40111050722855
SIM,1925,23,na,1948,8750
STAT,1855,20,30-34,1875,31.834357962604837
STAT,1931,17,15-19,1948,119.9743360758768
SIM,1871,31,20-24,1902,7
STAT,1908,36,20-24,1944,0.5011924879060339
SIM,1911,23,25-29,1934,195
STAT,1901,60,na,1961,5661.030448065662
STAT,1855,25,25-29,1880,74.1244623089821
SIM,1854,46,40-44,1900,1
SIM,1870,9,na,1879,5272
STAT,1869,96,na,1965,59.39118739779909
SIM,1823,87,na,1910,180
SIM,1856,35,35-39,1891,19
SIM,1854,39,40-44,1893,19
STAT,1826,52,50-100,1878,0.029046644068967044
STAT,1876,36,25-29,1912,6.04318590634039
STAT,1921,18,35-39,1939,9.632291260022102
STAT,1952,16,20-24,1968,328.19106514790235
STAT,1879,4,na,1883,6072.591879448189
STAT,1839,52,35-39,1891,0.013370868101903249
STAT,1900,22,45-49,1922,1.9536332154110694
STAT,1809,45,25-29,1854,0.4629516233831817
SIM,1838,40,25-29,1878,2
SIM,1927,36,na,1963,9702
SIM,1876,81,na,1957,1351
SIM,1891,30,35-39,1921,41
SIM,1908,17,30-34,1925,5
STAT,1843,41,45-49,1884,2.1864377921691154
STAT,1937,22,40-44,1959,6.61411809078173
SIM,1861,29,30-34,1890,64
SIM,1945,22,40-44,1967,9
STAT,1924,27,25-29,1951,154.73502828106308
STAT,1920,20,20-24,1940,251.0917325321002
STAT,1830,91,na,1921,80.01916255322088
STAT,1844,46,30-34,1890,0.1567675097995699
SIM,1916,36,20-24,1952,4
STAT,1854,41,20-24,1895,0.24455994907113993
SIM,1863,25,25-29,1888,85
SIM,1874,21,45-49,1895,2
STAT,1897,31,25-29,1928,27.764365030343384
STAT,1887,7,na,1894,5884.959455073588
SIM,1913,38,na,1951,7606
STAT,1940,29,25-29,1969,135.42975454131104
SIM,1922,28,45-49,1950,8
SIM,1851,46,na,1897,3575
STAT,1860,19,20-24,1879,33.140377328094104
SIM,1884,29,50-100,1913,2
SIM,1925,42,50-100,1967,1
STAT,1829,34,50-100,1863,1.665066082406688
STAT,1894,73,na,1967,3769.802178719586
SIM,1828,49,40-44,1877,2
SIM,1932,27,25-29,1959,190
SIM,1946,18,na,1964,8059
STAT,1823,50,40-44,1873,0.032582251581661135
STAT,1889,31,40-44,1920,10.843567220239958
STAT,1903,23,25-29,1926,164.10467276619067
SIM,1864,96,na,1960,19
STAT,1914,28,45-49,1942,3.5055999567514062
STAT,1837,30,15-19,1867,0.2541374720687024
STAT,1815,46,50-100,1861,1.3407712342388727
STAT,1926,21,na,1947,8985.56300458948
SIM,1939,30,50-100,1969,2
STAT,1883,26,15-19,1909,0.9033593584557467
SIM,1939,21,na,1960,7585
STAT,1846,42,25-29,1888,0.995505308291303
STAT,1848,35,35-39,1883,12.202269842141119
STAT,1941,16,45-49,1957,1.0395013953434071
STAT,1890,41,40-44,1931,5.569904661604494
SIM,1940,18,na,1958,7730
STAT,1830,40,30-34,1870,2.119475635161006
STAT,1934,26,20-24,1960,49.623354431276816
SIM,1848,57,na,1905,3056
STAT,1922,38,20-24,1960,0.6050166494579517
STAT,1926,26,20-24,1952,44.33785099436959
STAT,1929,23,45-49,1952,2.864499038600227
STAT,1906,16,na,1922,7450.972809683894
SIM,1882,32,35-39,1914,29
STAT,1869,74,na,1943,2171.789135705723
STAT,1875,9,na,1884,5527.17442069988
SIM,1807,65,na,1872,1545
STAT,1863,53,40-44,1916,0.01831300556493951
STAT,1829,30,30-34,1859,35.46072588483567
STAT,1889,36,35-39,1925,17.69799480553567
SIM,1843,35,25-29,1878,8
SIM,1908,44,na,1952,6845
SIM,1851,41,45-49,1892,4
SIM,1854,42,25-29,1896,1
SIM,1878,33,20-24,1911,7
SIM,1821,42,50-100,1863,5
SIM,1833,22,35-39,1855,12
SIM,1884,40,45-49,1924,4
STAT,1881,15,25-29,1896,11.113309765223997
STAT,1945,18,na,1963,8117.196765979761
SIM,1936,15,40-44,1951,2
SIM,1820,35,30-34,1855,14
SIM,1825,40,50-100,1865,4
STAT,1860,8,na,1868,4644.958598280711
STAT,1933,33,50-100,1966,2.24912398920078
SIM,1866,30,50-100,1896,4
SIM,1902,37,40-44,1939,8
STAT,1863,20,15-19,1883,6.034929640529706
STAT,1874,59,na,1933,4018.9182985463963
STAT,1895,26,na,1921,6302.000305223363
SIM,1884,14,na,1898,5606
STAT,1875,18,50-100,1893,0.10160443723631851
STAT,1917,29,25-29,1946,138.3999088193777
STAT,1910,17,20-24,1927,54.274656359506295
SIM,1902,30,20-24,1932,9
STAT,1827,39,30-34,1866,10.502517817994404
STAT,1907,49,35-39,1956,0.2307558051639422
STAT,1947,21,50-100,1968,1.502301099032659
STAT,1926,36,na,1962,9292.894397201444
SIM,1897,36,35-39,1933,25
STAT,1876,40,45-49,1916,3.1578166092817535
SIM,1919,18,45-49,1937,1
SIM,1942,26,20-24,1968,47
SIM,1925,37,35-39,1962,3
SIM,1815,41,35-39,1856,5
SIM,1868,77,na,1945,1539
SIM,1914,4,na,1918,8609
STAT,1787,72,na,1859,1027.529802849611
STAT,1813,47,40-44,1860,1.056300087073328
SIM,1903,28,35-39,1931,41
SIM,1943,0,na,1943,9117
SIM,1830,30,20-24,1860,7
SIM,1895,35,50-100,1930,6
STAT,1874,32,35-39,1906,20.941909798011636
SIM,1863,20,30-34,1883,45
SIM,1891,70,na,1961,4127
SIM,1925,29,25-29,1954,167
STAT,1905,27,15-19,1932,1.3251656047421911
STAT,1826,111,na,1937,1.2848824934335337E-4
SIM,1877,8,na,1885,5518
STAT,1875,30,35-39,1905,21.22699569003416
SIM,1862,83,na,1945,700
SIM,1899,20,45-49,1919,4
STAT,1874,20,40-44,1894,4.334849938570484
STAT,1928,15,40-44,1943,3.5754197422942537
STAT,1840,29,20-24,1869,20.811684153666153
STAT,1845,67,na,1912,2442.7187178835684
SIM,1926,24,20-24,1950,238
SIM,1958,13,na,1971,10835
STAT,1807,49,30-34,1856,0.640604037022568
SIM,1909,27,25-29,1936,145
STAT,1935,34,25-29,1969,25.796593610174124
STAT,1941,10,na,1951,8220.158989239839
SIM,1871,20,15-19,1891,5
STAT,1949,20,50-100,1969,1.55162768794454
SIM,1930,38,20-24,1968,3
STAT,1835,35,25-29,1870,4.709019389548088
STAT,1882,78,na,1960,1874.4878281868864
SIM,1900,16,25-29,1916,21
SIM,1865,40,35-39,1905,6
STAT,1894,19,50-100,1913,0.1264227393163297
STAT,1937,27,35-39,1964,29.56323620110726
STAT,1851,23,15-19,1874,6.0633707580801115
STAT,1910,26,35-39,1936,29.391402691209784
SIM,1832,64,na,1896,2250
STAT,1870,34,na,1904,4691.132146080185
SIM,1883,30,35-39,1913,25
SIM,1902,15,20-24,1917,44
SIM,1930,23,35-39,1953,29
SIM,1848,31,45-49,1879,5
STAT,1816,102,na,1918,0.2879718692660142
SIM,1910,18,25-29,1928,22
STAT,1855,67,na,1922,2390.404466743829
SIM,1889,34,35-39,1923,45
STAT,1836,25,15-19,1861,0.792077071711686
STAT,1919,17,40-44,1936,3.1210602978347026
STAT,1826,49,40-44,1875,0.3322330388556533
STAT,1840,31,na,1871,3850.0181455463567
STAT,1948,0,na,1948,10238.150699903324
STAT,1856,30,25-29,1886,16.49482806653545
STAT,1848,46,15-19,1894,6.577445170366617E-4
STAT,1761,109,na,1870,4.802906153189496E-4
STAT,1869,19,40-44,1888,0.3586244560586779
STAT,1833,24,35-39,1857,10.241555641669322
SIM,1926,38,30-34,1964,5
SIM,1848,29,15-19,1877,1
SIM,1899,44,na,1943,6371
STAT,1884,42,45-49,1926,2.9810306522702628
SIM,1907,47,35-39,1954,1
SIM,1919,32,40-44,1951,16
STAT,1950,17,25-29,1967,103.47787836013723
SIM,1921,26,na,1947,8451
SIM,1875,42,45-49,1917,11
SIM,1888,81,na,1969,1969
STAT,1863,86,na,1949,392.25505387578147
STAT,1820,91,na,1911,64.87300905525616
STAT,1918,24,20-24,1942,240.6479066129052
STAT,1925,28,20-24,1953,43.38085378119372
STAT,1864,51,40-44,1915,0.0190966004526458
SIM,1951,3,na,1954,9839
STAT,1886,28,50-100,1914,1.3589869019018757
STAT,1900,49,25-29,1949,0.08912753505976943
SIM,1921,44,50-100,1965,1
STAT,1867,42,45-49,1909,2.8272968925213107
STAT,1921,32,30-34,1953,35.4014706678792
STAT,1940,18,45-49,1958,1.0241033065277978
STAT,1872,36,40-44,1908,8.927959715090022
STAT,1836,20,20-24,1856,147.12046390014794
SIM,1877,44,na,1921,4675
STAT,1831,28,40-44,1859,5.164405338311504
STAT,1845,51,30-34,1896,0.009216382808378294
STAT,1911,38,45-49,1949,1.3236106906396972
SIM,1928,20,15-19,1948,13
SIM,1919,37,35-39,1956,10
STAT,1842,47,50-100,1889,0.3657139143395703
STAT,1936,17,40-44,1953,2.705062744908557
STAT,1900,35,15-19,1935,0.15881812215113875
SIM,1880,23,35-39,1903,11
SIM,1841,24,35-39,1865,12
SIM,1912,32,30-34,1944,42
SIM,1818,39,30-34,1857,12
STAT,1927,39,35-39,1966,6.059607317516216
SIM,1847,94,na,1941,29
SIM,1879,15,35-39,1894,1
SIM,1915,49,35-39,1964,1
SIM,1934,26,20-24,1960,53
STAT,1861,25,25-29,1886,72.66539501027157
STAT,1857,107,na,1964,0.04385471096370086
SIM,1767,88,na,1855,51
STAT,1811,43,15-19,1854,0.10619471088923887
STAT,1864,59,na,1923,3508.5542748912417
SIM,1910,39,40-44,1949,7
SIM,1834,49,40-44,1883,1
SIM,1844,20,20-24,1864,125
STAT,1898,37,15-19,1935,0.15347534386189088
STAT,1942,28,20-24,1970,38.67505931164466
SIM,1829,33,25-29,1862,22
SIM,1831,84,na,1915,305
SIM,1835,39,30-34,1874,13
STAT,1914,36,20-24,1950,0.5342100190918145
SIM,1856,45,na,1901,3841
SIM,1867,12,na,1879,5483
STAT,1806,50,na,1856,2410.8983055616027
STAT,1922,27,50-100,1949,2.274079056699221
STAT,1906,43,45-49,1949,0.3036500370914544
STAT,1863,96,na,1959,26.591176632953555
SIM,1937,25,35-39,1962,42
STAT,1888,24,25-29,1912,135.7935567172708
STAT,1911,22,20-24,1933,213.04432677784771
STAT,1850,46,na,1896,3459.406928089701
STAT,1853,32,15-19,1885,0.23203049120992783
SIM,1887,59,na,1946,4659
SIM,1896,24,25-29,1920,175
STAT,1902,39,40-44,1941,2.6669669287723834
STAT,1887,40,20-24,1927,0.36234538479035683
STAT,1840,16,50-100,1856,0.09210154902415654
SIM,1913,38,20-24,1951,1
SIM,1837,32,20-24,1869,5
SIM,1890,26,na,1916,6274
SIM,1942,25,na,1967,8061
SIM,1896,22,35-39,1918,25
STAT,1905,16,35-39,1921,1.6065952127936234
SIM,1914,43,45-49,1957,1
STAT,1913,7,na,1920,8229.214378163815
STAT,1888,22,35-39,1910,13.929670975714274
STAT,1904,32,30-34,1936,29.06093909942009
SIM,1913,16,35-39,1929,1
SIM,1828,64,na,1892,2059
SIM,1930,16,35-39,1946,11
STAT,1846,31,na,1877,3963.886964449851
STAT,1831,54,na,1885,2770.42412434971
STAT,1854,48,40-44,1902,0.25914976107346244
STAT,1874,21,50-100,1895,0.8458217500397649
STAT,1829,32,20-24,1861,5.184944334696826
STAT,1847,21,35-39,1868,10.983591495981496
STAT,1876,44,na,1920,4762.688681718014
STAT,1923,18,na,1941,8703.314565456092
STAT,1930,22,30-34,1952,74.36048752573349
SIM,1874,19,15-19,1893,11
STAT,1831,35,40-44,1866,7.3128073450467825
SIM,1880,36,40-44,1916,15
STAT,1855,45,na,1900,3426.4351390278784
SIM,1863,31,na,1894,4458
STAT,1911,37,40-44,1948,2.9210084730997536
SIM,1834,41,45-49,1875,5
STAT,1824,107,na,1931,0.005041995807852627
SIM,1850,98,na,1948,5
SIM,1863,46,na,1909,4210
STAT,1950,21,45-49,1971,2.6965097637091526
STAT,1862,15,15-19,1877,11.872164437601427
STAT,1866,38,30-34,1904,9.882299583415056
STAT,1846,39,40-44,1885,6.858053728966229
SIM,1933,28,20-24,1961,57
SIM,1874,38,30-34,1912,10
STAT,1929,25,35-39,1954,38.088583675050394
STAT,1890,49,50-100,1939,0.3343892014517645
SIM,1763,95,na,1858,12
SIM,1917,48,40-44,1965,1
STAT,1763,113,na,1876,4.441584981798082E-4
STAT,1847,40,25-29,1887,1.00987392534298
STAT,1932,33,45-49,1965,4.22242476352067
SIM,1904,33,35-39,1937,28
SIM,1908,36,20-24,1944,1
STAT,1866,21,45-49,1887,1.3195289276962094
STAT,1956,3,na,1959,10511.00159910435
SIM,1822,39,50-100,1861,2
SIM,1948,23,20-24,1971,269
SIM,1821,91,na,1912,57
STAT,1909,26,20-24,1935,35.672821156421094
STAT,1794,103,na,1897,0.05621476293739991
STAT,1902,26,35-39,1928,27.60685054716121
STAT,1896,23,20-24,1919,183.18243632033975
STAT,1929,39,45-49,1968,1.763660207677943
SIM,1868,93,na,1961,79
SIM,1937,20,40-44,1957,8
STAT,1892,48,50-100,1940,0.34586609453858436
SIM,1816,79,na,1895,610
SIM,1867,27,50-100,1894,5
STAT,1922,16,35-39,1938,9.82921194108803
SIM,1923,33,45-49,1956,4
SIM,1927,17,40-44,1944,3
STAT,1916,38,20-24,1954,0.542490747440403
STAT,1944,28,30-34,1972,85.48188806984315
STAT,1817,51,45-49,1868,0.06853267926425982
STAT,1842,25,15-19,1867,0.8474564198254029
SIM,1830,45,40-44,1875,1
SIM,1881,49,na,1930,3789
SIM,1910,26,35-39,1936,35
SIM,1933,15,15-19,1948,118
STAT,1878,31,15-19,1909,0.3016081486193027
SIM,1947,20,25-29,1967,250
SIM,1917,26,20-24,1943,39
SIM,1944,17,40-44,1961,4
STAT,1883,30,35-39,1913,20.2563928397495
STAT,1925,37,35-39,1962,5.86182017465558
SIM,1855,21,35-39,1876,16
SIM,1788,87,na,1875,78
SIM,1928,15,40-44,1943,2
STAT,1827,42,15-19,1869,0.026232436592905296
STAT,1909,41,20-24,1950,0.03357122654473909
STAT,1902,18,25-29,1920,16.11547098267094
STAT,1925,15,15-19,1940,111.21299575272438
SIM,1831,29,45-49,1860,3
SIM,1884,33,20-24,1917,3
STAT,1901,28,35-39,1929,27.18505172523172
STAT,1857,29,15-19,1886,0.7251287079034766
SIM,1865,29,15-19,1894,1
SIM,1881,59,na,1940,3305
SIM,1892,42,45-49,1934,8
STAT,1962,4,na,1966,10174.381131125934
SIM,1848,79,na,1927,911
SIM,1885,17,25-29,1902,14
SIM,1809,49,30-34,1858,1
SIM,1918,39,35-39,1957,7
STAT,1813,51,na,1864,2587.31282643181
STAT,1822,45,40-44,1867,0.547767829438977
SIM,1864,30,25-29,1894,26
SIM,1895,1,na,1896,7472
STAT,1894,33,15-19,1927,0.3679028856470261
SIM,1848,33,35-39,1881,23
STAT,1812,99,na,1911,1.7952085826085864
STAT,1915,33,45-49,1948,3.2232954017500504
STAT,1872,50,50-100,1922,0.031095182856023605
SIM,1933,37,35-39,1970,8
STAT,1920,27,40-44,1947,10.324027438616271
SIM,1910,38,50-100,1948,1
SIM,1850,25,15-19,1875,1
SIM,1891,15,35-39,1906,4
STAT,1862,100,na,1962,5.3651994560887655
SIM,1824,33,50-100,1857,2
STAT,1869,15,25-29,1884,11.376628241851366
STAT,1790,76,na,1866,680.9331140510241
STAT,1902,32,20-24,1934,7.707356185170658
STAT,1854,30,15-19,1884,0.22825310483569244
STAT,1917,17,30-34,1934,5.296874095120226
STAT,1868,43,15-19,1911,0.026344262240151586
STAT,1801,66,na,1867,1674.6636141681051
STAT,1831,32,na,1863,3623.6560192796096
STAT,1916,25,25-29,1941,138.37850837023325
SIM,1911,20,20-24,1931,207
STAT,1855,22,20-24,1877,121.39911124459789
SIM,1907,27,15-19,1934,1
STAT,1920,23,25-29,1943,206.70408055945435
SIM,1863,22,20-24,1885,123
STAT,1906,26,45-49,1932,3.2787735452187747
STAT,1872,0,na,1872,7530.196014181452
SIM,1934,20,15-19,1954,14
SIM,1833,37,30-34,1870,17
STAT,1894,24,25-29,1918,147.58808497013848
STAT,1837,64,na,1901,2422.8466344853996
STAT,1861,44,50-100,1905,1.751933114613741
STAT,1880,31,20-24,1911,5.774456879560822
STAT,1889,47,15-19,1936,5.592595037884448E-4
SIM,1869,21,50-100,1890,1
SIM,1882,20,40-44,1902,2
STAT,1834,23,15-19,1857,5.83100691340871
STAT,1823,53,45-49,1876,0.042312426110948084
STAT,1912,5,na,1917,8186.670757769655
STAT,1840,18,40-44,1858,0.33980729106442453
STAT,1920,28,45-49,1948,3.813122077177913
STAT,1921,15,30-34,1936,28.183350489471064
STAT,1872,32,25-29,1904,20.789828925881654
STAT,1905,29,50-100,1934,1.855047345584552
SIM,1811,45,30-34,1856,1
SIM,1918,22,na,1940,8124
STAT,1827,33,25-29,1860,24.05758732684957
SIM,1901,26,35-39,1927,35
SIM,1925,17,30-34,1942,39
STAT,1872,27,50-100,1899,1.298409554716308
STAT,1903,16,25-29,1919,16.33505209092636
SIM,1839,27,na,1866,3693
STAT,1929,20,40-44,1949,8.637758378424598
STAT,1955,15,35-39,1970,11.25459673793633
SIM,1844,16,25-29,1860,13
STAT,1888,42,50-100,1930,2.518714686805059
STAT,1940,26,20-24,1966,37.61286477028303
SIM,1921,33,35-39,1954,24
STAT,1877,26,15-19,1903,0.9547512527218736
SIM,1842,23,15-19,1865,6
STAT,1915,46,15-19,1961,7.5159295135622E-4
STAT,1818,50,na,1868,2771.5475225592268
STAT,1926,20,15-19,1946,13.136643918538573
SIM,1835,33,25-29,1868,24
STAT,1865,42,35-39,1907,3.31841093008601
SIM,1874,30,35-39,1904,23
STAT,1920,26,na,1946,8326.050529179414
STAT,1825,37,30-34,1862,14.018366637102961
STAT,1952,19,25-29,1971,104.80300812853565
SIM,1873,42,35-39,1915,8
SIM,1933,17,15-19,1950,123
SIM,1942,29,25-29,1971,154
SIM,1838,20,20-24,1858,122
STAT,1934,29,25-29,1963,178.67500258725264
SIM,1868,3,na,1871,5864
SIM,1895,34,35-39,1929,42
SIM,1919,15,40-44,1934,2
SIM,1939,22,40-44,1961,5
SIM,1903,23,na,1926,6901
SIM,1909,15,30-34,1924,6
STAT,1905,59,na,1964,6053.473677132861
SIM,1813,41,25-29,1854,2
SIM,1907,22,20-24,1929,209
SIM,1828,80,na,1908,702
STAT,1800,55,na,1855,2310.744216800558
STAT,1892,28,30-34,1920,63.44318496561398
SIM,1898,21,30-34,1919,62
STAT,1887,34,35-39,1921,22.67909638352305
STAT,1870,36,30-34,1906,10.618494651707078
SIM,1928,20,50-100,1948,2
SIM,1952,5,na,1957,9774
STAT,1816,65,na,1881,1919.0472858388873
STAT,1913,33,35-39,1946,18.289487053828644
STAT,1880,53,40-44,1933,0.022038713556417573
SIM,1932,16,45-49,1948,1
STAT,1871,30,50-100,1901,1.8532382688048794
STAT,1928,18,45-49,1946,1.2676998229534053
SIM,1860,39,40-44,1899,15
SIM,1913,7,na,1920,8457
STAT,1809,79,na,1888,652.9401507003098
STAT,1868,34,25-29,1902,19.51292994066483
SIM,1843,32,20-24,1875,6
SIM,1878,36,25-29,1914,4
STAT,1852,39,40-44,1891,6.906689292661726
SIM,1903,25,30-34,1928,88
STAT,1866,23,35-39,1889,10.884373574005545
STAT,1911,45,50-100,1956,0.4346122148693839
SIM,1856,44,50-100,1900,3
SIM,1933,11,na,1944,11255
STAT,1926,29,25-29,1955,158.1884936951644
SIM,1829,31,35-39,1860,21
STAT,1797,101,na,1898,0.27611109764290603
SIM,1832,32,na,1864,3579
SIM,1900,20,45-49,1920,4
SIM,1855,23,25-29,1878,125
SIM,1876,34,25-29,1910,25
STAT,1891,32,35-39,1923,25.281026264820596
STAT,1847,23,25-29,1870,106.20648030499666
STAT,1868,31,20-24,1899,5.21522467668151
STAT,1903,20,20-24,1923,199.34452425879564
SIM,1874,23,35-39,1897,18
STAT,1812,52,30-34,1864,0.03946214775870698
SIM,1893,44,na,1937,6029
SIM,1916,39,25-29,1955,3
STAT,1935,31,20-24,1966,6.820556872903539
STAT,1905,37,na,1942,6935.591010807165
SIM,1877,15,25-29,1892,15
STAT,1897,8,na,1905,7017.844007981431
STAT,1918,38,30-34,1956,3.8751662447443667
SIM,1936,18,45-49,1954,5
SIM,1816,39,20-24,1855,2
STAT,1831,52,40-44,1883,0.01417390413888464
SIM,1924,25,25-29,1949,205
STAT,1860,20,50-100,1880,0.7686326824948215
STAT,1880,34,na,1914,5033.583313233819
SIM,1925,26,20-24,1951,52
SIM,1776,87,na,1863,81
SIM,1947,18,20-24,1965,300
STAT,1813,104,na,1917,0.059269712579936525
STAT,1856,31,50-100,1887,1.4602919202088545
STAT,1895,58,na,1953,5204.3059460802515
STAT,1908,39,25-29,1947,1.8442862003958027
STAT,1893,49,30-34,1942,0.1368592389797643
STAT,1924,16,45-49,1940,1.204033696078016
SIM,1814,51,na,1865,2598
SIM,1832,69,na,1901,1871
SIM,1914,26,45-49,1940,5
SIM,1902,33,25-29,1935,3
SIM,1885,21,20-24,1906,133
SIM,1832,41,35-39,1873,5
SIM,1903,45,na,1948,6704
STAT,1834,46,na,1880,3211.560216469993
STAT,1898,41,35-39,1939,0.34523160990799734
STAT,1872,63,na,1935,3621.6746119709023
STAT,1888,9,na,1897,6193.5581797541345
STAT,1893,45,15-19,1938,5.833516329052052E-4
STAT,1917,26,20-24,1943,38.79140885362311
STAT,1849,40,35-39,1889,2.914402888620989
SIM,1864,31,50-100,1895,3
SIM,1918,37,na,1955,8254
SIM,1844,25,15-19,1869,1
STAT,1921,29,15-19,1950,1.5772699696913068
STAT,1939,18,20-24,1957,274.0212790727686
STAT,1918,22,30-34,1940,62.593756397305874
SIM,1872,67,na,1939,3211
STAT,1939,24,40-44,1963,6.815904095604848
SIM,1855,27,na,1882,4343
STAT,1918,27,25-29,1945,141.44449348007768
SIM,1771,88,na,1859,64
SIM,1920,41,na,1961,8473
SIM,1930,20,30-34,1950,89
SIM,1934,22,na,1956,10452
STAT,1851,27,30-34,1878,45.70636827606168
SIM,1899,1,na,1900,7506
STAT,1854,82,na,1936,715.2649306626447
STAT,1766,111,na,1877,0.0014454683207640385
STAT,1804,50,30-34,1854,0.036241643325237174
STAT,1881,19,40-44,1900,0.35512689432413946
STAT,1914,39,25-29,1953,1.9657839853915158
STAT,1838,27,na,1865,3724.1660495832357
SIM,1854,33,35-39,1887,22
STAT,1884,44,50-100,1928,2.078412273091073
STAT,1885,47,30-34,1932,0.193689450792366
SIM,1857,40,35-39,1897,2
SIM,1792,87,na,1879,91
SIM,1913,23,na,1936,7540
STAT,1834,29,20-24,1863,20.184148460808288
SIM,1934,29,25-29,1963,199
SIM,1837,35,25-29,1872,10
STAT,1796,86,na,1882,147.78710650188214
STAT,1831,37,50-100,1868,2.0078236055905037
STAT,1875,81,na,1956,1199.1852082297992
SIM,1913,27,15-19,1940,4
STAT,1869,52,20-24,1921,0.0014363761283421473
SIM,1828,31,50-100,1859,3
SIM,1889,32,45-49,1921,8
SIM,1910,15,20-24,1925,52
SIM,1906,26,45-49,1932,3
STAT,1917,22,na,1939,7837.851111994471
STAT,1824,41,35-39,1865,4.822714314837099
SIM,1790,91,na,1881,25
STAT,1853,23,25-29,1876,106.24871803193103
SIM,1855,97,na,1952,1
STAT,1928,29,50-100,1957,2.4737583255386433
STAT,1901,25,30-34,1926,71.68155676502403
SIM,1909,24,20-24,1933,211
STAT,1930,40,35-39,1970,0.5365721785989137
STAT,1882,20,25-29,1902,113.29680989352045
STAT,1909,44,25-29,1953,0.13330903498211716
SIM,1922,39,25-29,1961,4
STAT,1887,43,25-29,1930,1.440021517603039
SIM,1841,46,na,1887,3257
SIM,1842,29,20-24,1871,23
SIM,1892,44,50-100,1936,1
STAT,1874,25,35-39,1899,20.088530843142937
SIM,1902,38,45-49,1940,2
STAT,1896,21,30-34,1917,47.6385680586066
STAT,1830,47,40-44,1877,0.2955215840783322
SIM,1922,37,na,1959,9069
STAT,1822,48,45-49,1870,0.7232341141069841
STAT,1849,20,30-34,1869,34.559443238695245
SIM,1902,60,na,1962,5857
STAT,1917,43,20-24,1960,0.03715988150963021
SIM,1937,23,45-49,1960,4
SIM,1944,26,30-34,1970,99
STAT,1895,1,na,1896,7162.946984449568
STAT,1886,22,na,1908,5042.147798677196
SIM,1901,38,na,1939,6709
STAT,1861,22,20-24,1883,119.00948938330727
STAT,1899,18,15-19,1917,16.37869998125591
STAT,1930,42,50-100,1972,0.31217653246013427
SIM,1926,27,25-29,1953,176
SIM,1923,30,40-44,1953,14
STAT,1793,68,na,1861,1395.7405213687898
SIM,1802,66,na,1868,1700
STAT,1806,65,na,1871,1641.5926177753713
SIM,1914,19,20-24,1933,60
STAT,1907,31,45-49,1938,2.9843758579335926
SIM,1878,20,25-29,1898,137
STAT,1917,37,35-39,1954,5.073411832375675
STAT,1867,101,na,1968,7.01687187420494
SIM,1879,41,25-29,1920,3
STAT,1852,44,15-19,1896,0.02171315071356575
STAT,1925,17,15-19,1942,110.69867357099957
STAT,1930,19,50-100,1949,0.972988925277077
SIM,1897,31,40-44,1928,19
STAT,1836,53,na,1889,2839.7780133674023
SIM,1837,30,30-34,1867,52
STAT,1841,23,50-100,1864,0.7441531206296669
SIM,1819,50,na,1869,2688
STAT,1906,19,20-24,1925,51.89427988174826
STAT,1938,21,na,1959,7302.891953684857
SIM,1915,31,45-49,1946,5
SIM,1853,31,na,1884,4062
SIM,1857,20,30-34,1877,46
STAT,1923,48,15-19,1971,8.676154378458319E-4
SIM,1900,47,25-29,1947,1
SIM,1835,22,45-49,1857,1
SIM,1822,39,20-24,1861,3
SIM,1880,32,25-29,1912,24
STAT,1831,31,25-29,1862,17.466080612155416
SIM,1867,40,45-49,1907,6
STAT,1858,107,na,1965,0.051391408939027036
SIM,1906,37,25-29,1943,1
SIM,1788,72,na,1860,952
STAT,1872,53,40-44,1925,0.021025304126416823
STAT,1895,42,20-24,1937,0.02898668705249649
SIM,1841,39,30-34,1880,15
SIM,1859,27,25-29,1886,81
SIM,1929,5,na,1934,10691
STAT,1954,17,na,1971,9188.754045199721
SIM,1917,44,25-29,1961,1
STAT,1944,17,25-29,1961,94.17969260663642
SIM,1878,31,30-34,1909,44
SIM,1872,35,50-100,1907,8
STAT,1850,31,35-39,1881,16.41289168240256
STAT,1942,15,25-29,1957,91.51264465483037
SIM,1952,17,25-29,1969,125
STAT,1821,54,na,1875,2562.2733835160398
STAT,1811,47,30-34,1858,0.6571191070385811
STAT,1857,40,35-39,1897,2.8793408556533553
SIM,1861,23,25-29,1884,117
SIM,1884,36,25-29,1920,7
STAT,1902,15,20-24,1917,50.78504355509761
SIM,1855,37,50-100,1892,5
STAT,1848,30,40-44,1878,8.46664441511535
SIM,1918,36,30-34,1954,6
STAT,1856,21,35-39,1877,10.637108657818947
STAT,1915,30,40-44,1945,8.11470070870306
SIM,1950,15,25-29,1965,131
STAT,1833,39,30-34,1872,8.595185609146949
STAT,1865,45,na,1910,4169.187855443806
STAT,1824,68,na,1892,1633.8509686724767
SIM,1791,76,na,1867,596
SIM,1830,48,45-49,1878,1
STAT,1912,26,45-49,1938,3.451108966991801
SIM,1876,20,40-44,1896,9
STAT,1800,101,na,1901,0.4873818184187557
SIM,1947,24,40-44,1971,11
STAT,1871,41,30-34,1912,2.3172644190387772
STAT,1932,16,45-49,1948,1.3392935691880077
SIM,1823,65,na,1888,1841
STAT,1806,87,na,1893,119.96424530707044
STAT,1862,32,15-19,1894,0.24582430323359183
SIM,1898,41,50-100,1939,2
SIM,1920,26,45-49,1946,3
SIM,1935,6,na,1941,11358
STAT,1872,23,35-39,1895,11.807910750850535
STAT,1868,20,40-44,1888,4.062217704873346
STAT,1921,35,35-39,1956,5.462562467244238
SIM,1838,79,na,1917,847
SIM,1879,21,20-24,1900,134
SIM,1885,49,50-100,1934,1
STAT,1915,15,50-100,1930,0.1591140431786943
STAT,1928,44,35-39,1972,0.5166449913817532
SIM,1890,20,25-29,1910,155
STAT,1871,45,na,1916,4559.345327981314
SIM,1837,47,50-100,1884,2
STAT,1828,51,20-24,1879,0.0013093915286005475
SIM,1871,82,na,1953,735
STAT,1936,14,na,1950,7638.078360310487
STAT,1886,44,na,1930,4860.919371633555
STAT,1829,35,25-29,1864,5.215260472604495
SIM,1856,30,40-44,1886,13
SIM,1926,22,30-34,1948,88
SIM,1933,19,30-34,1952,41
STAT,1943,27,35-39,1970,32.29187499713103
STAT,1925,19,30-34,1944,29.57140861798518
SIM,1911,27,30-34,1938,96
STAT,1811,48,50-100,1859,1.6388378691761574
STAT,1896,26,25-29,1922,113.18078434825988
SIM,1908,39,25-29,1947,2
STAT,1775,87,na,1862,81.28220207211382
STAT,1877,49,50-100,1926,0.5043079512466201
SIM,1904,24,45-49,1928,3
STAT,1861,100,na,1961,4.552968789001101
STAT,1903,27,30-34,1930,72.41212387718156
SIM,1883,24,15-19,1907,7
SIM,1854,16,na,1870,4713
SIM,1904,30,30-34,1934,69
STAT,1829,47,50-100,1876,0.3875207401941687
SIM,1854,10,na,1864,4882
STAT,1900,39,30-34,1939,3.190391542087453
SIM,1820,85,na,1905,231
STAT,1925,47,35-39,1972,0.3154644126988127
SIM,1865,97,na,1962,11
STAT,1842,21,35-39,1863,11.037308351387514
STAT,1875,39,25-29,1914,5.926608070574564
STAT,1880,20,15-19,1900,7.060793338351151
STAT,1845,22,15-19,1867,6.310941296058891
STAT,1872,38,45-49,1910,4.026191268594706
SIM,1937,23,35-39,1960,18
STAT,1921,17,50-100,1938,0.8622850328027148
SIM,1858,37,20-24,1895,3
SIM,1872,35,na,1907,5016
STAT,1874,25,45-49,1899,2.311589172570708
STAT,1932,23,50-100,1955,1.7383776163855245
SIM,1830,44,40-44,1874,10
STAT,1856,34,40-44,1890,6.69977243489435
STAT,1859,35,20-24,1894,1.2508994291908793
STAT,1796,70,na,1866,1357.1192988968742
SIM,1860,8,na,1868,4970
STAT,1831,42,40-44,1873,3.5616070415268566
STAT,1915,34,45-49,1949,3.20924183379842
SIM,1912,20,25-29,1932,200
STAT,1889,40,30-34,1929,2.89182971833538
SIM,1924,22,na,1946,9033
STAT,1849,27,na,1876,4056.29094144084
SIM,1923,34,45-49,1957,9
STAT,1839,37,45-49,1876,3.719699447292317
STAT,1941,31,35-39,1972,19.389440769161446
STAT,1871,51,25-29,1922,0.007141106835449321
STAT,1911,18,25-29,1929,17.47290289888524
STAT,1841,47,na,1888,3279.159835031542
STAT,1920,25,40-44,1945,10.394069030678791
STAT,1857,48,20-24,1905,0.0186530058394397
STAT,1918,44,40-44,1962,0.5352121127809736
SIM,1940,31,40-44,1971,13
SIM,1914,36,45-49,1950,1
SIM,1848,40,35-39,1888,4
STAT,1869,21,45-49,1890,1.3687360498924617
SIM,1924,36,30-34,1960,9
SIM,1907,39,35-39,1946,5
SIM,1816,48,25-29,1864,1
SIM,1783,88,na,1871,70
SIM,1877,21,45-49,1898,2
STAT,1784,85,na,1869,141.28572304277296
STAT,1934,27,35-39,1961,40.79603780887111
STAT,1822,44,40-44,1866,7.172451481226812
STAT,1858,63,na,1921,2809.2413023838253
SIM,1853,38,50-100,1891,6
SIM,1891,38,20-24,1929,1
STAT,1935,34,15-19,1969,0.35866199378031194
SIM,1864,21,35-39,1885,12
SIM,1883,39,25-29,1922,10
SIM,1885,18,25-29,1903,14
SIM,1877,82,na,1959,1067
STAT,1825,45,20-24,1870,0.02674904863652581
SIM,1799,87,na,1886,85
SIM,1853,22,15-19,1875,8
STAT,1930,29,15-19,1959,1.8110981345252617
STAT,1932,31,40-44,1963,10.51337273414427
SIM,1910,34,35-39,1944,27
SIM,1880,38,45-49,1918,6
SIM,1844,24,15-19,1868,6
SIM,1876,25,20-24,1901,30
SIM,1838,95,na,1933,16
STAT,1814,45,45-49,1859,1.2613420287677592
STAT,1833,21,40-44,1854,4.558716844637691
STAT,1920,16,25-29,1936,98.4113276325552
STAT,1808,48,25-29,1856,0.3572897498858642
SIM,1928,23,40-44,1951,5
STAT,1861,16,20-24,1877,34.45668411163184
STAT,1902,41,25-29,1943,0.12772454949940548
SIM,1841,21,40-44,1862,9
SIM,1912,37,na,1949,7625
STAT,1948,18,20-24,1966,313.2300817660483
SIM,1781,77,na,1858,571
SIM,1908,26,20-24,1934,41
STAT,1904,20,25-29,1924,166.93022120507703
SIM,1942,27,35-39,1969,46
STAT,1936,19,na,1955,7080.275112316616
SIM,1933,29,35-39,1962,59
STAT,1862,28,50-100,1890,1.1003508774871298
STAT,1868,28,25-29,1896,80.99717935940298
SIM,1926,44,40-44,1970,1
SIM,1795,73,na,1868,1066
SIM,1822,45,45-49,1867,1
STAT,1892,36,20-24,1928,1.9583144064403857
SIM,1813,47,45-49,1860,2
STAT,1836,42,15-19,1878,0.021848094025891808
STAT,1853,32,na,1885,3888.1115771541827
SIM,1824,99,na,1923,3
STAT,1883,38,20-24,1921,1.5219882308215358
STAT,1885,65,na,1950,3397.3251887772462
STAT,1844,19,25-29,1863,11.496213956863595
SIM,1881,37,50-100,1918,4
SIM,1832,23,40-44,1855,3
SIM,1835,24,20-24,1859,104
SIM,1901,65,na,1966,5274
STAT,1848,35,45-49,1883,3.4391817889507204
SIM,1907,15,20-24,1922,52
STAT,1926,34,20-24,1960,5.947916304492191
STAT,1909,37,25-29,1946,1.883231310574827
STAT,1946,20,30-34,1966,64.63402328151236
STAT,1853,53,30-34,1906,0.00926691425998523
STAT,1954,15,40-44,1969,3.493644767684379
SIM,1910,25,20-24,1935,42
SIM,1882,22,40-44,1904,4
SIM,1874,40,35-39,1914,8
STAT,1912,21,15-19,1933,10.337008692776772
STAT,1909,44,15-19,1953,0.0028668611588282206
STAT,1906,41,40-44,1947,0.46175109810240167
SIM,1920,21,15-19,1941,12
STAT,1865,27,45-49,1892,2.0371966459702286
SIM,1899,38,20-24,1937,1
STAT,1883,22,35-39,1905,11.579187724555132
STAT,1902,34,35-39,1936,16.43851323822953
SIM,1896,73,na,1969,3927
STAT,1937,18,45-49,1955,0.9791009269889489
STAT,1944,18,na,1962,7996.775936435376
SIM,1845,16,30-34,1861,4
SIM,1909,18,35-39,1927,1
STAT,1866,46,20-24,1912,0.022425246686753254
SIM,1936,28,50-100,1964,4
STAT,1850,54,45-49,1904,0.02163954559117619
STAT,1866,40,35-39,1906,3.4084638213906
STAT,1934,18,20-24,1952,369.4401612213029
SIM,1868,30,na,1898,4620
STAT,1907,29,15-19,1936,1.3258734465026887
SIM,1843,30,50-100,1873,2
STAT,1923,7,na,1930,9476.679636279834
SIM,1824,31,35-39,1855,7
STAT,1897,22,35-39,1919,15.753706646595402
STAT,1841,46,15-19,1887,5.905198325421125E-4
SIM,1922,43,na,1965,8975
SIM,1856,35,45-49,1891,4
SIM,1886,59,na,1945,3961
SIM,1924,38,na,1962,9285
SIM,1851,77,na,1928,1188
STAT,1822,108,na,1930,0.0020681685945298676
STAT,1854,6,na,1860,4574.938246204549
STAT,1943,29,25-29,1972,141.4291965237121
STAT,1805,92,na,1897,31.15415191653796
SIM,1847,68,na,1915,2263
STAT,1826,54,na,1880,2720.4100429212685
SIM,1793,62,na,1855,1780
SIM,1924,29,40-44,1953,9
SIM,1915,29,15-19,1944,5
SIM,1839,33,na,1872,3551
STAT,1905,27,na,1932,6970.510928279707
SIM,1768,95,na,1863,2
STAT,1916,36,30-34,1952,3.7875695794972217
STAT,1851,21,na,1872,3986.7707887179586
STAT,1877,25,15-19,1902,0.9579411969075757
SIM,1921,19,15-19,1940,97
SIM,1859,41,na,1900,4152
SIM,1882,48,50-100,1930,2
STAT,1913,19,15-19,1932,18.644202949281162
SIM,1910,16,35-39,1926,6
STAT,1805,52,40-44,1857,0.08266120702711818
STAT,1822,40,na,1862,3191.394254869641
SIM,1885,25,15-19,1910,3
STAT,1915,41,35-39,1956,0.410062315291552
SIM,1917,37,25-29,1954,4
STAT,1900,46,20-24,1946,0.01901803813888379
SIM,1829,43,na,1872,3184
SIM,1934,34,20-24,1968,7
STAT,1876,13,na,1889,5401.558347056863
SIM,1911,21,50-100,1932,1
STAT,1835,90,na,1925,102.10971824791653
STAT,1902,25,20-24,1927,33.67736735433323
SIM,1838,31,35-39,1869,28
STAT,1929,23,35-39,1952,23.971332167557197
STAT,1883,2,na,1885,6255.237874008734
SIM,1940,26,45-49,1966,7
STAT,1872,43,40-44,1915,4.532466524437349
STAT,1891,38,50-100,1929,3.0497130738328684
SIM,1783,72,na,1855,1036
SIM,1809,98,na,1907,3
STAT,1881,54,45-49,1935,0.02755037157781405
STAT,1903,23,15-19,1926,9.457235991738822
SIM,1841,16,45-49,1857,1
SIM,1902,26,25-29,1928,119
STAT,1933,19,15-19,1952,122.05097914332997
SIM,1931,15,40-44,1946,5
STAT,1882,47,15-19,1929,7.832891694607076E-4
SIM,1833,35,50-100,1868,3
SIM,1861,51,na,1912,4133
SIM,1863,43,40-44,1906,7
SIM,1898,44,na,1942,6437
STAT,1865,47,15-19,1912,7.30502286603881E-4
STAT,1928,25,40-44,1953,11.67430884974432
STAT,1919,35,na,1954,8206.631510021354
STAT,1932,26,45-49,1958,4.572422057830552
SIM,1923,41,35-39,1964,1
SIM,1888,38,45-49,1926,7
SIM,1874,40,50-100,1914,5
SIM,1850,37,20-24,1887,2
SIM,1872,39,na,1911,4914
STAT,1904,39,15-19,1943,0.034780475396725394
SIM,1880,43,40-44,1923,9
SIM,1951,16,20-24,1967,327
STAT,1941,25,50-100,1966,2.0814164775909307
SIM,1879,32,35-39,1911,34
STAT,1917,36,20-24,1953,0.5555917649897549
SIM,1929,31,50-100,1960,5
STAT,1869,27,30-34,1896,49.27945517538852
STAT,1926,16,20-24,1942,336.4727931511158
STAT,1804,53,35-39,1857,0.04933825632339575
SIM,1843,26,20-24,1869,17
SIM,1897,20,35-39,1917,20
STAT,1819,50,15-19,1869,1.0313863947034532E-4
STAT,1760,110,na,1870,4.916588583454645E-4
STAT,1858,43,50-100,1901,1.6512819220706332
STAT,1896,47,45-49,1943,0.35330981563354724
SIM,1836,29,na,1865,3603
STAT,1850,16,45-49,1866,0.12311543370991507
STAT,1892,20,35-39,1912,14.84185001995583
STAT,1842,37,20-24,1879,1.3462811243452353
STAT,1923,40,na,1963,8788.318268007546
SIM,1836,23,50-100,1859,1
SIM,1934,16,20-24,1950,345
STAT,1877,43,15-19,1920,0.02875218677287833
STAT,1943,16,20-24,1959,290.4285440762392
STAT,1920,23,15-19,1943,11.91220967297707
STAT,1835,26,20-24,1861,19.954543542629146
STAT,1916,29,40-44,1945,9.663639088341762
SIM,1852,19,25-29,1871,13
STAT,1839,20,20-24,1859,140.26264841339182
SIM,1919,25,40-44,1944,15
STAT,1942,26,30-34,1968,83.09439401546837
STAT,1923,15,40-44,1938,3.3314174649393666
STAT,1851,38,25-29,1889,4.464478551738769
SIM,1925,18,20-24,1943,334
STAT,1815,86,na,1901,206.23384796829487
SIM,1945,15,40-44,1960,3
SIM,1893,17,20-24,1910,43
SIM,1942,18,20-24,1960,284
STAT,1869,41,15-19,1910,0.027147283254636254
STAT,1918,42,15-19,1960,0.0032969999783268315
STAT,1946,13,na,1959,8797.050493265178
SIM,1852,15,na,1867,4617
STAT,1845,40,15-19,1885,0.022232310405303365
SIM,1840,34,na,1874,4014
STAT,1903,33,40-44,1936,7.130343308065153
STAT,1937,20,na,1957,7188.4371346222615
SIM,1832,48,50-100,1880,2
SIM,1844,48,na,1892,3130
STAT,1910,18,35-39,1928,1.6754334178492196
SIM,1889,41,35-39,1930,9
STAT,1878,20,50-100,1898,0.8652847474370031
SIM,1877,23,15-19,1900,6
SIM,1911,33,40-44,1944,12
SIM,1876,29,50-100,1905,6
STAT,1934,36,20-24,1970,0.735459909741744
STAT,1830,50,25-29,1880,0.006147902904502678
SIM,1902,35,40-44,1937,3
SIM,1918,38,na,1956,8269
STAT,1794,75,na,1869,851.5816657819066
SIM,1917,52,na,1969,7772
STAT,1894,15,20-24,1909,46.20854415201744
STAT,1885,17,20-24,1902,35.639598971142924
STAT,1846,78,na,1924,1196.774437726116
SIM,1897,28,45-49,1925,5
STAT,1917,16,na,1933,8413.909860839729
STAT,1942,19,40-44,1961,2.9501794896379345
SIM,1904,18,na,1922,7421
SIM,1847,20,20-24,1867,120
SIM,1916,37,35-39,1953,8
STAT,1917,18,20-24,1935,58.76250772640569
STAT,1912,23,40-44,1935,6.489541784887173
STAT,1828,40,15-19,1868,0.02685719428754738
STAT,1923,33,40-44,1956,9.051988523016902
STAT,1921,21,na,1942,8353.34046048034
STAT,1810,55,na,1865,2313.785627596867
STAT,1850,83,na,1933,608.6881568031503
SIM,1823,50,na,1873,2798
SIM,1852,24,20-24,1876,136
STAT,1925,35,na,1960,9133.462810461868
STAT,1814,69,na,1883,1494.610090360177
STAT,1840,35,45-49,1875,3.474771823016325
SIM,1892,43,na,1935,6632
STAT,1889,20,35-39,1909,14.618408604677954
SIM,1925,45,35-39,1970,1
STAT,1881,36,45-49,1917,3.9101778238953617
SIM,1905,25,40-44,1930,9
SIM,1931,33,40-44,1964,12
STAT,1887,60,na,1947,4307.9234729745585
STAT,1914,48,15-19,1962,7.359114255963916E-4
STAT,1898,49,20-24,1947,0.018113998264453254
SIM,1871,97,na,1968,42
STAT,1870,47,25-29,1917,0.11367839179646777
STAT,1886,41,15-19,1927,0.029574980592915443
SIM,1911,16,25-29,1927,24
STAT,1871,44,35-39,1915,3.584380628405413
STAT,1906,44,na,1950,6733.210910628993
SIM,1901,36,35-39,1937,5
STAT,1908,46,20-24,1954,0.02035032936169368
SIM,1890,39,50-100,1929,7
SIM,1868,38,50-100,1906,4
SIM,1878,24,na,1902,5172
STAT,1844,24,20-24,1868,136.96185343302423
SIM,1883,20,35-39,1903,18
SIM,1941,19,15-19,1960,91
SIM,1857,41,50-100,1898,3
SIM,1901,18,35-39,1919,2
SIM,1946,21,35-39,1967,25
STAT,1889,28,45-49,1917,2.755180816954708
STAT,1895,31,15-19,1926,0.3762959093626455
STAT,1910,36,35-39,1946,4.696159108068188
SIM,1911,23,15-19,1934,11
SIM,1920,23,40-44,1943,8
SIM,1873,46,50-100,1919,1
SIM,1936,25,40-44,1961,12
STAT,1840,53,45-49,1893,0.02061146452384224
STAT,1908,37,35-39,1945,4.576662324156589
SIM,1836,18,30-34,1854,4
STAT,1821,86,na,1907,245.93779602076046
SIM,1854,48,45-49,1902,1
STAT,1835,47,na,1882,3071.285874196206
SIM,1916,28,20-24,1944,39
STAT,1900,43,na,1943,6450.651369119446
SIM,1884,24,na,1908,5426
STAT,1876,27,20-24,1903,24.505356209921672
STAT,1899,41,na,1940,6446.646310559577
STAT,1858,59,na,1917,3059.8255675514006
STAT,1938,29,45-49,1967,3.453831618803733
STAT,1889,33,40-44,1922,10.753860290588603
STAT,1900,23,45-49,1923,1.9475964887754496
SIM,1928,37,50-100,1965,1
STAT,1770,113,na,1883,8.117144814309123E-4
SIM,1897,33,40-44,1930,19
SIM,1886,43,na,1929,4761
SIM,1847,37,45-49,1884,8
SIM,1925,36,20-24,1961,1
STAT,1917,45,35-39,1962,0.2732351951449548
STAT,1927,32,15-19,1959,0.3192044263828423
SIM,1950,19,40-44,1969,1
SIM,1918,25,50-100,1943,4
STAT,1886,23,15-19,1909,7.011596770110327
SIM,1894,23,15-19,1917,10
SIM,1881,12,na,1893,4469
STAT,1834,38,25-29,1872,4.718009139174693
STAT,1882,36,50-100,1918,2.427082758670957
SIM,1842,38,25-29,1880,1
STAT,1908,28,20-24,1936,34.750820221356484
STAT,1810,52,20-24,1862,0.004561358865862238
STAT,1844,83,na,1927,641.0998663740228
STAT,1915,21,na,1936,7647.3434873823035
STAT,1937,27,50-100,1964,1.9599458419666043
STAT,1820,69,na,1889,1630.4255135558305
STAT,1938,21,35-39,1959,18.83001952507964
SIM,1884,27,20-24,1911,3
SIM,1902,23,na,1925,6863
STAT,1846,48,45-49,1894,0.3569413037319327
SIM,1906,37,na,1943,6984
SIM,1907,36,30-34,1943,5
SIM,1841,24,45-49,1865,2
SIM,1964,3,na,1967,10488
STAT,1916,39,35-39,1955,4.952086894739375
STAT,1875,36,20-24,1911,1.6105805287149977
STAT,1814,42,40-44,1856,12.98923981269557
STAT,1907,17,20-24,1924,52.62470566127197
SIM,1894,15,15-19,1909,19
SIM,1836,20,45-49,1856,1
STAT,1910,41,30-34,1951,0.24551613727116836
SIM,1810,102,na,1912,2
STAT,1882,24,40-44,1906,4.0740138813861675
SIM,1814,41,na,1855,2937
STAT,1869,19,30-34,1888,3.1251558496420513
STAT,1839,46,50-100,1885,0.39576149999744253
STAT,1827,71,na,1898,1614.0868051272587
STAT,1840,50,40-44,1890,0.015414407462254774
STAT,1892,49,50-100,1941,0.3429539020225694
SIM,1825,29,na,1854,3243
SIM,1883,42,50-100,1925,5
STAT,1921,20,25-29,1941,211.91223794818328
STAT,1820,53,20-24,1873,0.0025888401876304292
SIM,1823,33,40-44,1856,11
SIM,1861,29,50-100,1890,2
STAT,1902,4,na,1906,7501.00141195287
STAT,1853,28,na,1881,3952.015601875783
STAT,1804,79,na,1883,584.0512280742794
SIM,1873,52,na,1925,4493
STAT,1842,45,20-24,1887,0.018332534217946124
SIM,1795,69,na,1864,1416
SIM,1938,27,45-49,1965,4
SIM,1890,24,40-44,1914,11
STAT,1827,34,15-19,1861,0.3189521118186052
STAT,1881,33,40-44,1914,8.429898147695878
STAT,1922,45,45-49,1967,0.5064969818881809
STAT,1911,15,20-24,1926,55.06274906318674
STAT,1809,54,50-100,1863,0.10693144586426853
STAT,1950,18,na,1968,8786.282740164974
STAT,1886,15,15-19,1901,12.710905019451136
SIM,1832,25,50-100,1857,1
STAT,1829,33,50-100,1862,1.7100265569442015
STAT,1850,36,15-19,1886,0.08837646337088038
SIM,1910,31,30-34,1941,47
STAT,1824,46,15-19,1870,9.824539497155006E-4
STAT,1900,15,45-49,1915,0.18385941856547114
STAT,1875,75,na,1950,2140.6135908036617
SIM,1931,36,45-49,1967,1
SIM,1802,56,na,1858,2301
SIM,1847,46,50-100,1893,1
SIM,1833,21,35-39,1854,12
STAT,1969,3,na,1972,9922.839606623427
STAT,1847,31,35-39,1878,18.31432144801715
SIM,1935,7,na,1942,11336
SIM,1835,27,25-29,1862,95
STAT,1894,25,15-19,1919,1.1850701510146204
SIM,1915,17,20-24,1932,61
STAT,1874,22,40-44,1896,4.309139160277439
SIM,1903,21,15-19,1924,11
SIM,1843,31,50-100,1874,4
STAT,1854,51,25-29,1905,0.0054558405207779095
STAT,1937,15,40-44,1952,2.7614556069742098
SIM,1895,2,na,1897,7423
SIM,1888,21,20-24,1909,156
STAT,1903,31,15-19,1934,0.4111756362627538
STAT,1951,18,20-24,1969,325.9257829763915
SIM,1856,42,35-39,1898,5
STAT,1868,25,20-24,1893,22.6952275810018
STAT,1883,46,20-24,1929,0.023878886041253693
STAT,1943,26,20-24,1969,39.27908797762388
SIM,1901,17,20-24,1918,36
SIM,1859,20,40-44,1879,6
SIM,1863,15,na,1878,4886
STAT,1931,29,50-100,1960,2.5928181060004554
SIM,1830,99,na,1929,7
SIM,1916,29,35-39,1945,2
STAT,1835,78,na,1913,1011.9366890187353
SIM,1901,37,na,1938,6732
SIM,1870,96,na,1966,63
SIM,1855,31,35-39,1886,23
STAT,1830,43,35-39,1873,3.200670300188772
STAT,1891,37,15-19,1928,0.14018324257209078
STAT,1922,27,15-19,1949,1.6128931063910148
SIM,1834,34,na,1868,3554
SIM,1882,29,na,1911,4931
STAT,1848,42,35-39,1890,2.965548894422782
STAT,1876,52,50-100,1928,0.031379581614694244
SIM,1849,16,15-19,1865,10
STAT,1851,53,20-24,1904,0.0011255431099100165
STAT,1863,15,50-100,1878,0.10000794743055305
STAT,1848,32,40-44,1880,8.2926270078113
STAT,1908,29,35-39,1937,28.47794765777173
SIM,1910,28,25-29,1938,159
STAT,1923,36,45-49,1959,1.5962345781716205
SIM,1822,42,40-44,1864,9
STAT,1822,52,40-44,1874,0.0314907277423807
SIM,1856,32,40-44,1888,18
SIM,1933,26,30-34,1959,131
SIM,1846,35,50-100,1881,3
STAT,1902,28,25-29,1930,120.19142589408762
STAT,1876,29,na,1905,4949.482765193705
STAT,1899,57,na,1956,5605.006888942256
SIM,1907,29,40-44,1936,2
SIM,1882,25,45-49,1907,3
SIM,1924,39,35-39,1963,10
STAT,1911,35,40-44,1946,2.948749644517455
SIM,1883,82,na,1965,1493
SIM,1948,16,20-24,1964,318
SIM,1846,20,30-34,1866,47
SIM,1826,34,20-24,1860,8
STAT,1866,23,na,1889,4411.3033111083805
SIM,1838,48,na,1886,3162
SIM,1856,4,na,1860,5126
SIM,1863,46,45-49,1909,1
STAT,1867,102,na,1969,4.3391633982895925
SIM,1876,28,25-29,1904,100
SIM,1912,53,na,1965,7149
SIM,1931,18,45-49,1949,3
STAT,1893,56,na,1949,5221.214347061382
SIM,1789,73,na,1862,948
STAT,1885,25,20-24,1910,23.74369123535573
STAT,1867,40,na,1907,4415.646112015573
STAT,1902,16,35-39,1918,1.5684022970722207
STAT,1861,54,20-24,1915,0.0012063371615723619
STAT,1925,44,30-34,1969,0.3114963837324263
SIM,1835,19,25-29,1854,13
SIM,1885,15,20-24,1900,36
STAT,1841,23,40-44,1864,3.8026221697624063
STAT,1868,89,na,1957,253.35155946983355
STAT,1816,64,na,1880,1991.9527567354032
SIM,1907,38,na,1945,7055
STAT,1864,75,na,1939,1858.4976587866777
SIM,1861,67,na,1928,2970
STAT,1918,47,45-49,1965,0.4670217190140073
SIM,1782,94,na,1876,1
STAT,1908,47,35-39,1955,0.23564459519652717
SIM,1927,27,50-100,1954,3
STAT,1838,20,30-34,1858,31.730696201540017
SIM,1828,65,na,1893,2059
SIM,1893,25,20-24,1918,33
SIM,1895,49,45-49,1944,1
STAT,1943,19,25-29,1962,92.74410030591118
SIM,1942,19,35-39,1961,14
STAT,1894,43,15-19,1937,0.0024700095495575757
STAT,1855,46,45-49,1901,0.3568829015659645
SIM,1842,20,50-100,1862,1
STAT,1923,18,45-49,1941,1.1811864437985045
SIM,1937,22,50-100,1959,5
SIM,1848,32,35-39,1880,29
STAT,1866,30,35-39,1896,19.02327460461867
STAT,1819,38,50-100,1857,6.673602689328631
SIM,1861,17,25-29,1878,20
STAT,1829,78,na,1907,924.7143660383447
STAT,1922,28,50-100,1950,2.2660742984196376
STAT,1882,84,na,1966,1193.1466947323825
STAT,1909,19,25-29,1928,17.080279913443686
STAT,1881,51,40-44,1932,0.020649155362869
STAT,1853,17,25-29,1870,10.785401369034894
STAT,1929,16,45-49,1945,1.290577975061518
SIM,1870,43,30-34,1913,2
SIM,1838,44,40-44,1882,8
STAT,1910,33,30-34,1943,30.56244848146271
SIM,1867,35,20-24,1902,2
SIM,1937,16,45-49,1953,2
STAT,1834,35,20-24,1869,1.3031229783238003
STAT,1765,105,na,1870,0.03700627806693407
STAT,1927,36,30-34,1963,4.5799356877292805
SIM,1904,19,15-19,1923,15
SIM,1865,81,na,1946,890
SIM,1887,21,30-34,1908,59
SIM,1827,38,50-100,1865,3
STAT,1791,105,na,1896,0.011570930311904015
SIM,1901,49,50-100,1950,3
STAT,1879,21,30-34,1900,37.741642796373235
SIM,1813,87,na,1900,130
SIM,1887,35,50-100,1922,5
STAT,1915,26,45-49,1941,3.571328194469182
SIM,1917,19,25-29,1936,116
STAT,1935,27,25-29,1962,181.23728588270347
STAT,1837,26,na,1863,3897.759061589977
STAT,1889,36,45-49,1925,4.988139274378036
SIM,1890,64,na,1954,4465
STAT,1904,29,15-19,1933,1.3057658362037523
SIM,1771,87,na,1858,85
SIM,1943,27,25-29,1970,160
STAT,1900,59,na,1959,5623.878067677874
STAT,1831,37,45-49,1868,3.2601044650206004
SIM,1841,47,na,1888,3212
SIM,1841,31,35-39,1872,30
STAT,1917,39,25-29,1956,2.052705028792485
STAT,1892,30,35-39,1922,25.810029814782265
STAT,1873,49,15-19,1922,8.03683625768963E-4
STAT,1920,36,na,1956,8324.819698823203
STAT,1812,105,na,1917,0.0277932502853622
SIM,1889,26,45-49,1915,2
SIM,1871,81,na,1952,876
STAT,1828,65,na,1893,2075.368027728915
STAT,1829,53,40-44,1882,0.014315704473115181
STAT,1860,25,20-24,1885,19.728999660460655
SIM,1914,41,40-44,1955,1
SIM,1804,83,na,1887,196
SIM,1895,48,50-100,1943,2
STAT,1816,47,20-24,1863,0.05896096417011323
SIM,1888,54,na,1942,4918
STAT,1897,35,40-44,1932,11.92992415390071
STAT,1915,16,45-49,1931,0.21168956608608636
STAT,1896,44,40-44,1940,0.41085926852717286
SIM,1901,35,20-24,1936,1
STAT,1824,90,na,1914,84.29128624270197
SIM,1923,16,45-49,1939,2
STAT,1886,43,na,1929,4891.835773723487
SIM,1925,39,25-29,1964,3
SIM,1859,57,na,1916,3564
STAT,1926,46,40-44,1972,0.3938005246330157
STAT,1805,96,na,1901,6.4229003133985
SIM,1897,36,45-49,1933,10
STAT,1833,31,35-39,1864,17.35808907837352
STAT,1795,109,na,1904,3.0405076707018845E-4
STAT,1827,27,25-29,1854,251.89474765021342
STAT,1863,45,40-44,1908,0.3056820305035035
STAT,1938,26,40-44,1964,9.331763481453336
STAT,1910,15,30-34,1925,4.902190554909428
STAT,1833,23,50-100,1856,0.7254070578282891
STAT,1802,72,na,1874,1222.142635092507
SIM,1899,7,na,1906,7324
STAT,1942,29,35-39,1971,31.793386199893586
SIM,1877,19,30-34,1896,4
SIM,1842,35,20-24,1877,2
STAT,1768,90,na,1858,49.76180795065873
STAT,1894,18,25-29,1912,14.663223663978902
SIM,1928,30,30-34,1958,49
STAT,1820,54,50-100,1874,0.051940302826486054
STAT,1887,48,50-100,1935,0.5477889076506407
SIM,1777,88,na,1865,66
SIM,1905,46,45-49,1951,1
SIM,1907,22,na,1929,7064
STAT,1934,37,35-39,1971,6.742069148671776
STAT,1871,36,35-39,1907,14.260229649307835
SIM,1881,44,na,1925,3885
SIM,1919,23,na,1942,8096
STAT,1912,20,50-100,1932,1.281506344219658
STAT,1876,60,na,1936,3983.8308218080883
SIM,1848,85,na,1933,400
SIM,1911,36,45-49,1947,1
SIM,1832,70,na,1902,1787
STAT,1887,49,45-49,1936,0.2944203739480431
STAT,1920,37,35-39,1957,5.347220956860323
SIM,1836,84,na,1920,347
SIM,1864,34,40-44,1898,15
SIM,1936,21,25-29,1957,172
STAT,1870,99,na,1969,23.492096701273816
STAT,1934,19,35-39,1953,11.402959608248397
SIM,1951,19,25-29,1970,141
STAT,1852,5,na,1857,4847.180286643593
STAT,1853,42,15-19,1895,0.021823031667632314
STAT,1833,24,45-49,1857,1.2238337896396556
STAT,1911,23,20-24,1934,212.38601980810424
SIM,1907,47,50-100,1954,2
STAT,1903,36,45-49,1939,1.2432423170706823
SIM,1886,17,30-34,1903,3
STAT,1847,63,na,1910,2719.889611415801
SIM,1842,84,na,1926,421
SIM,1913,22,na,1935,7515
SIM,1935,36,30-34,1971,5
STAT,1853,24,15-19,1877,6.079074907338284
STAT,1873,21,35-39,1894,12.010885363938533
SIM,1861,24,15-19,1885,6
SIM,1889,33,35-39,1922,33
STAT,1846,46,na,1892,3455.8857773376035
STAT,1932,21,na,1953,9706.91115141748
STAT,1936,31,25-29,1967,18.145273316348625
SIM,1919,28,45-49,1947,8
STAT,1845,54,35-39,1899,0.012901200046072286
STAT,1889,43,35-39,1932,4.476773443236629
STAT,1849,11,na,1860,4669.3120763212855
STAT,1941,24,45-49,1965,2.3468687300667685
STAT,1832,48,15-19,1880,6.086871099320275E-4
STAT,1840,32,40-44,1872,7.62438265941718
SIM,1894,14,na,1908,6979
SIM,1905,20,35-39,1925,23
STAT,1857,46,na,1903,3551.747970344092
STAT,1928,21,25-29,1949,233.58657416548687
STAT,1924,17,20-24,1941,325.97421253135974
SIM,1868,25,15-19,1893,1
SIM,1824,44,na,1868,3242
SIM,1818,36,50-100,1854,3
STAT,1818,37,25-29,1855,19.92301433325438
SIM,1869,29,45-49,1898,4
STAT,1907,31,35-39,1938,17.331452395683808
SIM,1868,62,na,1930,3544
STAT,1897,21,20-24,1918,186.60072588238626
SIM,1881,26,45-49,1907,2
STAT,1859,112,na,1971,7.768487984275269E-4
STAT,1883,23,50-100,1906,0.8066673225412344
STAT,1900,28,na,1928,6662.6068022579575
SIM,1879,40,35-39,1919,6
STAT,1826,85,na,1911,328.16771054319634
SIM,1856,21,25-29,1877,121
SIM,1906,31,40-44,1937,12
STAT,1821,42,30-34,1863,3.6552856438813994
SIM,1865,22,40-44,1887,4
SIM,1908,27,35-39,1935,35
SIM,1866,36,20-24,1902,4
STAT,1835,62,na,1897,2367.1710980661583
SIM,1898,17,20-24,1915,53
STAT,1896,39,45-49,1935,5.261991347634177
STAT,1874,58,na,1932,4089.5031224397053
STAT,1908,44,30-34,1952,0.23610688318687975
STAT,1882,27,45-49,1909,2.18440667211141
SIM,1823,86,na,1909,229
STAT,1864,31,35-39,1895,18.357202206130893
STAT,1838,23,35-39,1861,10.172979122603167
STAT,1853,87,na,1940,278.75349263749774
SIM,1838,30,20-24,1868,1
SIM,1934,35,35-39,1969,2
STAT,1829,48,45-49,1877,0.36753223296004217
STAT,1906,38,15-19,1944,0.03549294096059713
SIM,1828,58,na,1886,2545
SIM,1834,36,20-24,1870,1
STAT,1896,23,50-100,1919,1.083983997483376
STAT,1848,21,25-29,1869,115.11806580961232
SIM,1870,28,50-100,1898,1
STAT,1926,35,35-39,1961,5.979377205506577
STAT,1893,27,20-24,1920,30.031084659706043
STAT,1923,38,50-100,1961,0.9811976664477949
SIM,1929,26,40-44,1955,24
SIM,1856,77,na,1933,1327
STAT,1903,37,35-39,1940,4.389913952452012
STAT,1844,34,15-19,1878,0.2693606334343207
STAT,1867,32,15-19,1899,0.2693533774390328
STAT,1863,39,50-100,1902,2.148681862467975
STAT,1914,36,na,1950,7624.1763509851435
STAT,1885,28,25-29,1913,84.73904968700477
STAT,1889,25,40-44,1914,7.510260365076965
STAT,1851,27,20-24,1878,21.293152570391815
SIM,1941,21,35-39,1962,26
STAT,1779,108,na,1887,0.008813636042141536
STAT,1870,24,15-19,1894,6.500444475932516
SIM,1913,22,35-39,1935,22
SIM,1850,88,na,1938,176
STAT,1800,93,na,1893,24.962034024376283
STAT,1888,78,na,1966,2587.747410825409
STAT,1871,14,na,1885,5249.767520970706
SIM,1946,24,50-100,1970,2
STAT,1922,42,40-44,1964,0.5796607381733745
STAT,1904,47,15-19,1951,6.510024683912873E-4
SIM,1881,21,35-39,1902,17
SIM,1890,27,45-49,1917,3
STAT,1843,66,na,1909,2295.954452565311
SIM,1829,42,50-100,1871,6
SIM,1919,16,na,1935,8313
SIM,1823,36,45-49,1859,3
STAT,1861,46,20-24,1907,0.02022937384114116
SIM,1864,20,20-24,1884,134
STAT,1847,34,50-100,1881,1.461610572357101
SIM,1846,16,45-49,1862,1
STAT,1875,20,35-39,1895,12.206413114071538
SIM,1832,63,na,1895,2312
SIM,1897,25,40-44,1922,6
SIM,1911,37,35-39,1948,3
SIM,1892,26,20-24,1918,33
STAT,1848,45,50-100,1893,0.40672696508907996
STAT,1868,24,50-100,1892,0.7786746854934105
STAT,1961,9,na,1970,10251.44005531107
STAT,1905,22,35-39,1927,17.04415734007701
STAT,1880,65,na,1945,3595.518641917091
SIM,1912,29,15-19,1941,5
STAT,1884,79,na,1963,1892.082976847779
SIM,1856,76,na,1932,1466
SIM,1892,28,na,1920,6851
SIM,1915,24,45-49,1939,2
STAT,1855,38,45-49,1893,2.9911371435826024
STAT,1913,17,45-49,1930,0.20632606807733267
SIM,1879,22,35-39,1901,15
SIM,1920,25,30-34,1945,122
SIM,1916,26,30-34,1942,99
STAT,1795,92,na,1887,24.766479406676282
SIM,1942,19,na,1961,7929
STAT,1827,111,na,1938,1.297901214270273E-4
SIM,1921,17,45-49,1938,1
STAT,1764,93,na,1857,9.63577613259374
STAT,1858,31,na,1889,3796.267286820222
STAT,1939,17,45-49,1956,1.009981351649538
STAT,1853,47,25-29,1900,0.090709927973887
SIM,1788,88,na,1876,61
SIM,1877,7,na,1884,5518
STAT,1830,54,40-44,1884,0.015361467171744888
SIM,1958,2,na,1960,10850
SIM,1872,28,45-49,1900,3
STAT,1858,32,na,1890,3757.0518457473713
STAT,1821,55,na,1876,2512.1837205222273
STAT,1826,105,na,1931,0.03509992332585899
SIM,1861,47,25-29,1908,1
STAT,1852,42,50-100,1894,1.681710814974949
STAT,1841,26,45-49,1867,2.015375254651758
STAT,1873,37,50-100,1910,2.5193970539641204
STAT,1759,114,na,1873,2.4772528997824656E-4
STAT,1806,81,na,1887,427.33593861035536
STAT,1895,27,na,1922,6280.4474641795
STAT,1759,115,na,1874,1.5524200747066782E-4
SIM,1822,34,40-44,1856,8
SIM,1846,23,35-39,1869,13
SIM,1932,21,40-44,1953,14
STAT,1874,45,50-100,1919,0.5129432212901046
STAT,1880,48,45-49,1928,0.49579823664832695
SIM,1893,28,25-29,1921,132
STAT,1870,39,25-29,1909,5.6514925743417335
SIM,1881,43,na,1924,3924
STAT,1855,98,na,1953,4.8985869359952
STAT,1889,22,25-29,1911,142.5549027742005
STAT,1857,18,20-24,1875,32.60855112514457
STAT,1791,71,na,1862,1205.0666525148044
STAT,1795,85,na,1880,190.35237477687113
STAT,1913,30,50-100,1943,1.675109996504473
SIM,1897,22,25-29,1919,176
STAT,1845,40,50-100,1885,1.700771621724322
STAT,1914,35,na,1949,7659.717439906313
STAT,1923,44,45-49,1967,0.3914282852643969
STAT,1845,20,45-49,1865,1.3533207104919711
STAT,1838,41,35-39,1879,2.903066349123617
STAT,1857,22,40-44,1879,3.786947166218417
STAT,1881,25,40-44,1906,5.887256132170825
SIM,1826,37,25-29,1863,8
STAT,1932,28,15-19,1960,1.866689018881703
STAT,1820,45,20-24,1865,0.045968454459561194
STAT,1930,37,15-19,1967,0.05058728127271362
STAT,1785,71,na,1856,1248.6986266499998
STAT,1789,85,na,1874,181.57779193363945
SIM,1915,31,35-39,1946,31
STAT,1861,39,30-34,1900,8.868895987747447
STAT,1825,37,20-24,1862,2.0275606744433454
STAT,1818,44,15-19,1862,0.06319014907699291
STAT,1928,28,50-100,1956,2.4750205860375205
SIM,1822,64,na,1886,1887
SIM,1879,31,20-24,1910,6
STAT,1866,39,na,1905,4346.12910348385
SIM,1902,43,40-44,1945,1
SIM,1932,17,20-24,1949,342
SIM,1879,48,45-49,1927,4
STAT,1909,16,20-24,1925,53.85623260270933
SIM,1860,26,20-24,1886,22
STAT,1908,26,30-34,1934,75.75162982467725
SIM,1801,71,na,1872,1179
STAT,1849,46,20-24,1895,0.019035471963892676
SIM,1947,17,45-49,1964,2
STAT,1852,112,na,1964,2.312382059014889E-4
STAT,1912,25,30-34,1937,78.53336662552785
SIM,1939,29,25-29,1968,13
STAT,1824,99,na,1923,2.0248013631334763
STAT,1862,43,30-34,1905,1.9702227202047877
SIM,1853,32,na,1885,4018
SIM,1829,41,35-39,1870,7
SIM,1830,40,25-29,1870,4
STAT,1832,25,45-49,1857,1.9983748516730988
STAT,1885,35,15-19,1920,0.1139594054292653
STAT,1878,79,na,1957,1632.5689876777637
SIM,1846,41,35-39,1887,7
SIM,1867,38,25-29,1905,8
SIM,1831,85,na,1916,247
STAT,1911,24,35-39,1935,17.927564436997358
STAT,1866,16,20-24,1882,34.11046017847313
STAT,1921,39,15-19,1960,0.043202156486006366
SIM,1936,19,na,1955,6324
STAT,1888,32,35-39,1920,24.17396611853728
STAT,1896,47,50-100,1943,0.3676817397334284
STAT,1916,19,15-19,1935,19.341970647442754
STAT,1868,35,15-19,1903,0.10892723526330339
STAT,1849,16,20-24,1865,34.723175007602514
STAT,1876,5,na,1881,5715.575318315139
SIM,1869,22,25-29,1891,119
SIM,1838,47,45-49,1885,1
SIM,1923,23,40-44,1946,9
STAT,1874,65,na,1939,3494.6985149462926
STAT,1836,84,na,1920,442.3033815490595
STAT,1825,35,50-100,1860,3.4745714052038363
SIM,1878,18,30-34,1896,3
STAT,1911,21,30-34,1932,55.2332748846703
STAT,1920,33,40-44,1953,8.618449354851684
SIM,1907,19,15-19,1926,13
STAT,1860,7,na,1867,4681.804398900054
SIM,1896,32,35-39,1928,36
SIM,1857,16,20-24,1873,36
STAT,1932,23,40-44,1955,8.883108973450147
SIM,1794,88,na,1882,100
STAT,1846,15,40-44,1861,0.35611301859964356
SIM,1878,46,40-44,1924,1
SIM,1940,23,40-44,1963,8
SIM,1871,34,35-39,1905,30
SIM,1880,46,45-49,1926,1
STAT,1897,38,45-49,1935,5.355007054594414
SIM,1950,15,15-19,1965,95
STAT,1872,46,45-49,1918,0.48037878345979956
SIM,1914,15,40-44,1929,1
SIM,1853,25,na,1878,4357
STAT,1866,40,50-100,1906,1.9885413269845569
STAT,1911,26,25-29,1937,130.11994406518127
SIM,1840,89,na,1929,134
STAT,1897,30,35-39,1927,27.559210378711526
STAT,1916,25,15-19,1941,1.4841742763973054
STAT,1934,34,30-34,1968,43.39457917744312
STAT,1925,26,30-34,1951,93.76787846656543
STAT,1886,19,30-34,1905,3.3798151348277163
SIM,1859,23,45-49,1882,1
SIM,1840,25,45-49,1865,3
SIM,1869,17,30-34,1886,5
STAT,1843,28,25-29,1871,72.40219570260899
STAT,1887,21,50-100,1908,0.92389491178962
STAT,1822,40,25-29,1862,2.2794390961320956
SIM,1821,43,35-39,1864,4
STAT,1906,15,40-44,1921,0.5407743927759028
STAT,1852,10,na,1862,4659.422401137516
STAT,1856,20,20-24,1876,126.52444917646213
SIM,1865,18,20-24,1883,36
STAT,1924,21,40-44,1945,8.034911412400913
SIM,1860,29,25-29,1889,98
SIM,1827,28,30-34,1855,46
SIM,1866,43,50-100,1909,7
SIM,1874,16,20-24,1890,44
STAT,1934,16,30-34,1950,33.38326122773565
SIM,1857,105,na,1962,1
STAT,1851,52,na,1903,3320.0342995255005
STAT,1852,29,25-29,1881,70.4374166910976
STAT,1880,34,35-39,1914,21.361603488703793
SIM,1843,70,na,1913,2043
SIM,1862,77,na,1939,1422
STAT,1802,54,15-19,1856,1.514148550085857E-4
SIM,1942,16,30-34,1958,35
STAT,1838,35,50-100,1873,2.0470903999730905
STAT,1930,19,15-19,1949,117.86141566517823
STAT,1879,24,35-39,1903,12.250146937745846
SIM,1851,28,25-29,1879,95
STAT,1838,32,50-100,1870,1.5408920825842538
SIM,1887,24,35-39,1911,20
SIM,1934,17,35-39,1951,14
STAT,1935,24,20-24,1959,305.6584261275111
STAT,1877,33,15-19,1910,0.29739111251829586
STAT,1902,45,40-44,1947,0.2781027102529175
STAT,1873,80,na,1953,1269.3943047860282
STAT,1926,17,35-39,1943,10.388529137349094
STAT,1877,94,na,1971,199.03880443391563
SIM,1943,24,20-24,1967,233
STAT,1818,99,na,1917,1.9429994869303848
SIM,1933,19,40-44,1952,10
STAT,1863,105,na,1968,0.4591323273217777
STAT,1824,48,50-100,1872,0.5865085152516273
SIM,1868,18,25-29,1886,14
STAT,1813,43,35-39,1856,12.625873961678973
STAT,1898,23,40-44,1921,5.677634102652257
STAT,1947,19,45-49,1966,1.1356329894958779
SIM,1924,19,15-19,1943,111
SIM,1894,19,30-34,1913,5
SIM,1924,25,15-19,1949,1
STAT,1840,24,40-44,1864,3.7703638683241674
STAT,1804,86,na,1890,149.26030047265368
SIM,1928,33,35-39,1961,38
STAT,1915,23,40-44,1938,6.998331858214368
SIM,1825,38,25-29,1863,7
SIM,1862,44,35-39,1906,5
SIM,1889,30,30-34,1919,44
STAT,1820,38,na,1858,3115.440305893095
STAT,1879,42,35-39,1921,3.820593093272915
STAT,1863,41,25-29,1904,1.14040667694527
STAT,1884,29,25-29,1913,83.75753442115872
STAT,1912,30,25-29,1942,18.52041782359836
SIM,1792,93,na,1885,7
STAT,1878,50,20-24,1928,0.0015788613345792955
STAT,1916,18,25-29,1934,18.520010411464305
STAT,1925,19,40-44,1944,3.3934404684900787
STAT,1796,108,na,1904,8.160628826066626E-4
SIM,1875,37,20-24,1912,1
STAT,1826,36,20-24,1862,1.8905826904174956
STAT,1813,50,25-29,1863,0.02168214119320697
STAT,1882,39,50-100,1921,2.391146531622546
STAT,1942,15,15-19,1957,95.83773799744006
SIM,1809,82,na,1891,371
SIM,1839,32,40-44,1871,12
SIM,1849,24,15-19,1873,5
SIM,1838,21,35-39,1859,15
SIM,1900,20,35-39,1920,20
STAT,1912,49,15-19,1961,7.109873143858916E-4
SIM,1887,42,35-39,1929,9
STAT,1836,32,15-19,1868,0.23938661373382145
STAT,1859,45,15-19,1904,6.494055183300153E-4
STAT,1883,15,45-49,1898,0.13021993003894067
SIM,1892,29,25-29,1921,130
SIM,1924,18,25-29,1942,109
STAT,1867,37,20-24,1904,1.4580025476317042
SIM,1939,31,na,1970,7975
SIM,1888,82,na,1970,1780
SIM,1902,54,na,1956,6165
STAT,1898,30,30-34,1928,48.10251103847109
SIM,1857,0,na,1857,6774
STAT,1880,41,25-29,1921,1.372417870015857
STAT,1817,38,25-29,1855,19.776760729155498
STAT,1886,50,na,1936,4656.52387695447
SIM,1853,18,30-34,1871,4
SIM,1889,23,40-44,1912,6
STAT,1905,15,45-49,1920,0.19167915998898769
STAT,1869,75,na,1944,2014.595038063343
SIM,1920,30,25-29,1950,32
SIM,1837,33,50-100,1870,4
STAT,1927,41,50-100,1968,0.29794834443819856
SIM,1871,41,25-29,1912,2
STAT,1831,45,45-49,1876,0.37053083076203913
STAT,1907,54,na,1961,6441.445142800122
STAT,1917,27,35-39,1944,31.79618856988711
STAT,1939,28,20-24,1967,37.04785044772514
SIM,1868,31,45-49,1899,3
STAT,1898,19,20-24,1917,48.19378479212823
SIM,1840,20,35-39,1860,16
SIM,1920,18,50-100,1938,4
STAT,1867,42,50-100,1909,1.9957389772371719
STAT,1812,46,25-29,1858,0.4069176046330636
STAT,1881,1,na,1882,6599.575981884247
SIM,1903,30,25-29,1933,34
STAT,1911,33,15-19,1944,0.25172828227346294
SIM,1903,35,35-39,1938,7
SIM,1868,61,na,1929,3628
SIM,1874,62,na,1936,3455
STAT,1877,54,30-34,1931,0.012140151691028916
STAT,1865,46,50-100,1911,0.45190906052998564
STAT,1906,33,40-44,1939,7.2974255657773055
SIM,1895,16,40-44,1911,1
SIM,1839,28,20-24,1867,23
STAT,1951,16,30-34,1967,29.319686172486428
STAT,1887,16,40-44,1903,0.4141547672810543
STAT,1894,78,na,1972,3024.010128268478
STAT,1871,13,na,1884,5273.710165120352
STAT,1834,34,50-100,1868,1.530169528917809
SIM,1817,86,na,1903,189
STAT,1880,50,50-100,1930,0.03259395554175606
SIM,1869,47,na,1916,4314
STAT,1896,36,40-44,1932,11.728476820721363
SIM,1822,49,na,1871,2793
STAT,1931,36,20-24,1967,0.7057502322218272
STAT,1833,67,na,1900,2083.9714365503837
STAT,1926,42,25-29,1968,0.1777628217296569
SIM,1914,33,40-44,1947,14
SIM,1890,57,na,1947,5263
SIM,1902,46,45-49,1948,1
SIM,1872,36,50-100,1908,3
SIM,1847,99,na,1946,5
STAT,1845,18,30-34,1863,3.085949236937857
STAT,1770,93,na,1863,10.958309818276007
STAT,1826,31,15-19,1857,0.45925469175326206
STAT,1939,32,40-44,1971,8.064930121721263
SIM,1855,36,45-49,1891,5
SIM,1873,21,25-29,1894,137
SIM,1925,27,35-39,1952,44
STAT,1767,89,na,1856,58.29201761000001
SIM,1887,28,na,1915,5837
STAT,1839,34,40-44,1873,8.161805554058098
STAT,1924,31,35-39,1955,21.538856857244983
STAT,1867,50,45-49,1917,0.02784359254544738
SIM,1869,26,40-44,1895,10
STAT,1833,45,50-100,1878,0.3886807408186309
STAT,1861,49,25-29,1910,0.09480442793818648
SIM,1906,34,45-49,1940,5
SIM,1929,29,45-49,1958,7
STAT,1857,50,35-39,1907,0.013747107606786761
STAT,1847,30,20-24,1877,4.939378080652239
SIM,1890,36,50-100,1926,7
STAT,1941,1,na,1942,8637.590478294092
STAT,1790,106,na,1896,0.0047493649291950706
STAT,1865,21,25-29,1886,107.08051762891351
STAT,1867,79,na,1946,1322.304869419548
SIM,1868,54,30-34,1922,1
STAT,1899,37,20-24,1936,0.4603991877424863
SIM,1863,38,45-49,1901,4
STAT,1849,49,25-29,1898,0.08920923822170218
STAT,1858,24,15-19,1882,5.3454879405601
STAT,1893,42,50-100,1935,2.701058453012066
SIM,1870,37,25-29,1907,7
SIM,1934,37,25-29,1971,4
SIM,1937,20,30-34,1957,67
STAT,1887,19,45-49,1906,0.1467587152056733
SIM,1908,24,30-34,1932,62
STAT,1847,36,45-49,1883,3.1857525247862957
STAT,1826,39,25-29,1865,6.379322822427048
STAT,1879,64,na,1943,3672.24236240923
STAT,1946,23,35-39,1969,21.153154178948427
SIM,1917,34,20-24,1951,6
STAT,1893,22,15-19,1915,8.445099197060685
SIM,1865,25,45-49,1890,1
STAT,1916,15,20-24,1931,58.36252234876928
STAT,1921,43,35-39,1964,0.4572221056475934
STAT,1871,33,30-34,1904,34.88534512959069
SIM,1815,67,na,1882,1647
STAT,1964,6,na,1970,9997.687270420194
STAT,1835,99,na,1934,2.4528264535227393
STAT,1863,7,na,1870,4993.174772143464
STAT,1923,38,15-19,1961,0.04487806941824674
SIM,1908,47,25-29,1955,1
SIM,1910,45,40-44,1955,2
STAT,1831,85,na,1916,353.9481491236631
STAT,1857,25,45-49,1882,1.826431466203567
SIM,1834,39,25-29,1873,7
SIM,1841,74,na,1915,1423
STAT,1856,37,45-49,1893,3.10632310993695
STAT,1860,66,na,1926,2688.112403498922
SIM,1929,21,35-39,1950,28
SIM,1873,24,40-44,1897,4
STAT,1865,13,na,1878,4937.5298643202195
SIM,1919,21,25-29,1940,219
STAT,1837,33,na,1870,3748.056558964446
STAT,1879,17,45-49,1896,0.13799229667788432
STAT,1852,21,15-19,1873,6.291452291425954
STAT,1921,25,35-39,1946,34.0146092306101
STAT,1784,92,na,1876,18.382486450709465
STAT,1888,37,45-49,1925,4.758582597973429
STAT,1929,20,30-34,1949,73.8350826811075
SIM,1863,35,40-44,1898,13
STAT,1818,66,na,1884,1817.9904226474532
STAT,1946,2,na,1948,9042.838102144522
STAT,1935,34,na,1969,10555.878988325356
STAT,1891,17,45-49,1908,0.16306993174613468
STAT,1840,47,15-19,1887,5.822372675028726E-4
STAT,1924,35,50-100,1959,1.0013404452526924
SIM,1767,89,na,1856,41
SIM,1843,49,30-34,1892,1
SIM,1908,42,30-34,1950,1
SIM,1891,40,35-39,1931,10
STAT,1837,19,35-39,1856,1.0842078254046517
SIM,1832,26,45-49,1858,1
STAT,1865,24,40-44,1889,3.814500617944172
STAT,1926,37,25-29,1963,2.4298354717822517
STAT,1894,48,25-29,1942,0.08323588662463575
STAT,1872,94,na,1966,139.72917928242308
STAT,1881,28,45-49,1909,2.1597726804894606
STAT,1908,19,40-44,1927,0.5453826597505038
SIM,1916,19,40-44,1935,5
STAT,1898,26,45-49,1924,3.044969637895931
STAT,1905,46,20-24,1951,0.019826896024919622
SIM,1888,30,35-39,1918,40
SIM,1829,46,45-49,1875,1
SIM,1812,42,30-34,1854,8
SIM,1845,33,na,1878,4185
STAT,1825,48,na,1873,2944.607441392904
SIM,1871,29,na,1900,4605
STAT,1909,34,20-24,1943,4.6631814549990755
SIM,1932,31,35-39,1963,38
STAT,1918,48,35-39,1966,0.2762765927958361
STAT,1878,17,30-34,1895,3.361949904741463
SIM,1860,11,na,1871,4864
SIM,1870,22,15-19,1892,6
STAT,1850,51,40-44,1901,0.016218958703769975
SIM,1908,29,25-29,1937,130
STAT,1911,31,25-29,1942,18.256469754190366
SIM,1896,37,45-49,1933,5
SIM,1901,38,25-29,1939,1
STAT,1859,38,25-29,1897,4.605322063277073
STAT,1881,48,15-19,1929,7.710206738269408E-4
STAT,1913,37,15-19,1950,0.038283416677490245
STAT,1849,98,na,1947,5.1385367672519235
STAT,1836,53,30-34,1889,0.007852679404756202
STAT,1857,32,35-39,1889,16.040418556340125
STAT,1860,28,25-29,1888,69.61772555061305
STAT,1846,53,40-44,1899,0.015866387913319836
STAT,1943,17,35-39,1960,8.986428311725431
SIM,1864,47,na,1911,4281
SIM,1899,6,na,1905,7338
SIM,1928,26,45-49,1954,6
STAT,1873,20,20-24,1893,142.2560513274991
SIM,1860,21,15-19,1881,8
STAT,1761,108,na,1869,7.664171179711006E-4
STAT,1907,21,40-44,1928,6.2041743250364565
STAT,1874,18,20-24,1892,36.565040613618315
STAT,1847,32,na,1879,3878.886989854683
SIM,1813,56,na,1869,2493
SIM,1865,32,35-39,1897,30
STAT,1893,40,45-49,1933,3.8698746968130413
STAT,1864,36,50-100,1900,2.2271235866449492
STAT,1923,41,40-44,1964,0.5910861286577455
STAT,1954,18,45-49,1972,1.2466696992092046
SIM,1880,58,na,1938,4356
STAT,1870,36,20-24,1906,1.5358167420593016
SIM,1897,27,na,1924,6518
STAT,1839,31,25-29,1870,19.886776413225867
STAT,1883,40,35-39,1923,3.6294057453914235
SIM,1845,19,35-39,1864,1
SIM,1898,31,35-39,1929,43
SIM,1866,39,25-29,1905,9
STAT,1911,29,40-44,1940,9.117264174751453
STAT,1862,22,15-19,1884,5.8296821830079475
SIM,1822,37,45-49,1859,8
SIM,1847,31,25-29,1878,19
SIM,1915,21,40-44,1936,9
STAT,1926,44,15-19,1970,0.0038101370942011928
STAT,1831,48,na,1879,3075.2906645711055
STAT,1892,28,20-24,1920,29.556174948424687
SIM,1940,24,na,1964,7694
STAT,1846,18,45-49,1864,0.12494907380102743
STAT,1849,30,35-39,1879,18.93870632327896
SIM,1888,35,40-44,1923,14
STAT,1947,16,40-44,1963,3.1827958464180335
SIM,1868,29,30-34,1897,53
SIM,1837,17,30-34,1854,3
SIM,1917,16,20-24,1933,64
SIM,1835,44,na,1879,3329
STAT,1946,16,45-49,1962,1.1192211135287633
STAT,1836,41,50-100,1877,1.6929300706464854
STAT,1913,57,na,1970,6925.689710084767
STAT,1926,19,25-29,1945,106.71094528045728
STAT,1852,26,20-24,1878,21.935486248318668
STAT,1958,1,na,1959,10442.785742004744
SIM,1814,45,na,1859,2792
STAT,1906,18,45-49,1924,0.19173681732255982
STAT,1860,14,na,1874,4474.649622713941
SIM,1879,46,na,1925,4619
STAT,1822,49,20-24,1871,0.036250189649380336
SIM,1828,96,na,1924,9
SIM,1809,67,na,1876,1533
STAT,1830,63,na,1893,2463.915632303942
SIM,1844,11,na,1855,4293
SIM,1903,30,50-100,1933,3
STAT,1873,26,45-49,1899,2.2862232022373705
SIM,1891,22,35-39,1913,17
STAT,1864,28,na,1892,4293.247443160875
STAT,1828,104,na,1932,0.08191136272575791
STAT,1862,46,35-39,1908,0.2423543147933741
STAT,1951,19,35-39,1970,10.084076315380958
SIM,1931,2,na,1933,10780
STAT,1852,47,na,1899,3569.1019749139946
STAT,1870,17,25-29,1887,11.34317915404259
SIM,1914,3,na,1917,8638
STAT,1927,41,25-29,1968,0.18110585756163114
SIM,1896,42,na,1938,6521
SIM,1812,71,na,1883,1286
SIM,1857,30,35-39,1887,28
SIM,1797,92,na,1889,13
STAT,1827,29,50-100,1856,2.0580602755773083
SIM,1835,29,50-100,1864,2
STAT,1833,28,15-19,1861,0.7827733669892031
STAT,1854,44,35-39,1898,2.738484316922445
STAT,1892,46,na,1938,5705.473842017566
SIM,1859,17,20-24,1876,42
SIM,1828,32,50-100,1860,1
SIM,1939,26,20-24,1965,34
SIM,1901,33,30-34,1934,68
SIM,1954,16,45-49,1970,4
SIM,1938,22,35-39,1960,22
SIM,1839,35,45-49,1874,7
SIM,1879,61,na,1940,3858
STAT,1918,40,25-29,1958,0.15373604315722852
STAT,1928,28,45-49,1956,4.295850838668216
SIM,1841,28,15-19,1869,1
STAT,1846,47,na,1893,3430.035751723118
STAT,1838,16,45-49,1854,0.11746875404156053
SIM,1827,48,na,1875,3031
STAT,1835,54,50-100,1889,0.019168717246902247
SIM,1858,47,na,1905,3842
STAT,1925,29,35-39,1954,35.550173361693965
STAT,1871,30,15-19,1901,0.288039980236484
STAT,1820,48,25-29,1868,0.21125380279574935
SIM,1844,41,50-100,1885,5
SIM,1878,49,45-49,1927,2
SIM,1934,19,25-29,1953,141
STAT,1882,13,na,1895,5072.944597009463
STAT,1933,34,50-100,1967,2.2476170761280168
SIM,1865,10,na,1875,5118
STAT,1884,26,20-24,1910,23.47597473162258
SIM,1902,23,20-24,1925,203
SIM,1910,58,na,1968,6751
STAT,1880,45,40-44,1925,0.36787182124318124
STAT,1844,27,25-29,1871,83.62683744948994
STAT,1898,33,35-39,1931,27.56135803655275
SIM,1827,30,45-49,1857,5
STAT,1884,43,50-100,1927,2.0916313834343794
STAT,1866,38,20-24,1904,1.4293364217887996
SIM,1924,15,20-24,1939,329
STAT,1906,36,45-49,1942,1.2723746777782659
STAT,1883,79,na,1962,1834.851995451428
STAT,1910,24,50-100,1934,1.2406064190348618
SIM,1867,76,na,1943,1829
SIM,1859,10,na,1869,4993
SIM,1927,42,na,1969,9661
SIM,1808,49,25-29,1857,1
STAT,1817,81,na,1898,545.4288360544614
STAT,1836,36,30-34,1872,8.790609218125756
STAT,1908,23,15-19,1931,9.859549896159821
SIM,1863,62,na,1925,3313
STAT,1886,21,45-49,1907,1.4911378694028252
STAT,1919,43,40-44,1962,0.5464492038878692
STAT,1836,28,50-100,1864,1.092896327567952
STAT,1878,24,na,1902,4957.36914083632
SIM,1901,15,30-34,1916,5
STAT,1890,49,15-19,1939,5.446073624612703E-4
STAT,1828,54,35-39,1882,0.01309866643036004
STAT,1919,3,na,1922,9050.610881344348
STAT,1840,27,45-49,1867,1.9982784778558167
STAT,1813,54,40-44,1867,0.059466559728475046
STAT,1894,42,na,1936,6009.573610169405
SIM,1873,27,45-49,1900,3
STAT,1874,29,15-19,1903,0.9315125809410525
SIM,1871,39,50-100,1910,3
STAT,1843,25,20-24,1868,20.51809195339046
STAT,1930,22,40-44,1952,8.699224011480554
STAT,1861,51,na,1912,3636.8108629041835
SIM,1839,42,35-39,1881,6
SIM,1847,34,40-44,1881,9
STAT,1924,24,45-49,1948,2.663911642373744
STAT,1895,45,35-39,1940,0.2098961492915259
STAT,1918,46,30-34,1964,0.19203430627911694
SIM,1936,28,45-49,1964,3
STAT,1874,47,45-49,1921,0.4857526843701351
SIM,1916,23,15-19,1939,8
STAT,1920,36,45-49,1956,1.5084746834999936
SIM,1882,47,45-49,1929,1
SIM,1886,20,50-100,1906,1
SIM,1906,27,20-24,1933,36
STAT,1821,45,35-39,1866,0.4218007083233359
SIM,1874,38,20-24,1912,4
STAT,1936,36,35-39,1972,4.8009927753604416
SIM,1909,61,na,1970,6288
SIM,1871,31,30-34,1902,42
SIM,1874,19,25-29,1893,14
STAT,1870,28,na,1898,4715.40645072253
SIM,1828,28,45-49,1856,2
SIM,1849,95,na,1944,11
SIM,1850,21,35-39,1871,14
STAT,1855,51,na,1906,3262.3704603300143
SIM,1837,48,45-49,1885,1
SIM,1909,17,na,1926,7696
SIM,1955,16,40-44,1971,5
STAT,1885,17,50-100,1902,0.09848818663966999
SIM,1851,25,20-24,1876,24
SIM,1868,102,na,1970,2
STAT,1829,99,na,1928,2.2414088584640397
STAT,1925,42,na,1967,9079.200732244644
SIM,1826,30,na,1856,3489
SIM,1927,43,40-44,1970,4
SIM,1942,20,na,1962,7826
STAT,1819,35,50-100,1854,8.170067954295137
STAT,1926,32,30-34,1958,38.46865442294695
SIM,1852,27,25-29,1879,87
SIM,1857,62,na,1919,3222
STAT,1908,49,25-29,1957,0.09638264912624886
SIM,1916,49,25-29,1965,2
SIM,1934,32,30-34,1966,55
STAT,1950,21,35-39,1971,22.565527293917288
SIM,1902,43,50-100,1945,1
STAT,1866,19,25-29,1885,10.711506271329485
STAT,1926,20,na,1946,9011.96807103762
SIM,1833,48,na,1881,3109
SIM,1894,21,45-49,1915,1
STAT,1896,40,25-29,1936,0.12010301910388212
SIM,1802,97,na,1899,2
SIM,1909,54,na,1963,6734
SIM,1862,36,35-39,1898,25
SIM,1874,27,15-19,1901,1
SIM,1844,27,na,1871,3862
STAT,1921,40,30-34,1961,0.29155233148390486
SIM,1882,66,na,1948,3287
STAT,1843,31,15-19,1874,0.24232512994243938
SIM,1859,41,45-49,1900,3
STAT,1884,50,45-49,1934,0.029357582879554943
STAT,1809,85,na,1894,243.65450766923223
STAT,1840,30,35-39,1870,18.178016034665774
SIM,1895,45,50-100,1940,1
STAT,1936,30,50-100,1966,1.6240669387596296
STAT,1927,38,35-39,1965,6.066401687406106
SIM,1884,39,50-100,1923,6
STAT,1914,18,50-100,1932,0.15613773787445787
STAT,1938,24,50-100,1962,1.314535975308737
SIM,1881,20,20-24,1901,120
STAT,1863,34,35-39,1897,17.750362904042998
SIM,1876,39,30-34,1915,18
STAT,1823,84,na,1907,399.1963108039395
STAT,1946,8,na,1954,8818.55761860041
SIM,1880,65,na,1945,3654
STAT,1868,39,30-34,1907,10.137854013557453
STAT,1940,25,na,1965,7722.319399493956
SIM,1926,36,na,1962,9526
SIM,1869,20,20-24,1889,116
STAT,1811,53,30-34,1864,0.03777931449263693
STAT,1868,96,na,1964,52.58060783048478
STAT,1911,46,45-49,1957,0.416701166654995
SIM,1852,46,na,1898,3666
SIM,1855,33,40-44,1888,11
STAT,1877,7,na,1884,5632.191646630151
SIM,1827,39,35-39,1866,20
SIM,1844,36,30-34,1880,14
STAT,1921,42,na,1963,8446.171346558463
STAT,1824,53,40-44,1877,0.024072419570137265
STAT,1883,63,na,1946,3540.547408957036
SIM,1863,83,na,1946,636
STAT,1853,44,20-24,1897,0.24788248025040302
STAT,1884,11,na,1895,5157.906970038691
STAT,1875,44,na,1919,4741.009679793031
SIM,1880,24,35-39,1904,15
STAT,1857,37,15-19,1894,0.088398338934055
STAT,1927,45,40-44,1972,0.4015160129585331
STAT,1820,51,30-34,1871,0.021731769216068824
STAT,1913,32,35-39,1945,18.366995776003378
STAT,1819,39,35-39,1858,36.097143543287174
STAT,1847,25,na,1872,4021.0380278633907
SIM,1844,28,50-100,1872,2
STAT,1888,34,40-44,1922,10.263394821061427
STAT,1856,31,25-29,1887,16.324436492608136
STAT,1887,42,25-29,1929,1.4487138004054723
STAT,1854,76,na,1930,1452.357751240596
STAT,1859,10,na,1869,4510.296601978908
STAT,1920,19,40-44,1939,3.1516140637210937
SIM,1855,15,25-29,1870,14
SIM,1931,38,50-100,1969,3
SIM,1870,34,20-24,1904,8
SIM,1874,43,50-100,1917,4
STAT,1910,48,50-100,1958,0.42516346494498436
STAT,1900,16,20-24,1916,49.79067541701317
STAT,1901,45,20-24,1946,0.019329261859741046
STAT,1899,15,50-100,1914,0.136197187321342
SIM,1830,30,30-34,1860,40
STAT,1786,87,na,1873,102.57437529231889
STAT,1864,30,20-24,1894,4.919082596429515
STAT,1855,34,50-100,1889,1.3778784779215543
SIM,1912,25,35-39,1937,37
STAT,1856,61,na,1917,2911.775555900083
SIM,1852,6,na,1858,4944
SIM,1858,20,45-49,1878,1
SIM,1800,86,na,1886,96
SIM,1922,36,na,1958,9043
SIM,1886,42,30-34,1928,5
STAT,1950,18,25-29,1968,103.44476543906195
STAT,1871,78,na,1949,1567.7558068491746
SIM,1909,26,50-100,1935,2
STAT,1895,37,35-39,1932,18.613316211382124
SIM,1846,32,50-100,1878,3
STAT,1896,42,35-39,1938,0.33488155514948387
STAT,1901,38,na,1939,6680.478357941592
STAT,1904,25,35-39,1929,28.159487924469968
STAT,1941,18,15-19,1959,94.38206610636033
STAT,1879,50,35-39,1929,0.01844778730058106
STAT,1894,45,20-24,1939,0.01773655134530014
SIM,1835,38,30-34,1873,15
STAT,1837,70,na,1907,1955.5424187194271
SIM,1929,34,50-100,1963,3
SIM,1853,43,30-34,1896,2
STAT,1803,54,35-39,1857,0.06074949563148919
SIM,1843,79,na,1922,968
SIM,1844,17,na,1861,4110
STAT,1831,23,35-39,1854,21.639029833516638
STAT,1942,23,15-19,1965,11.26862891030639
SIM,1864,31,25-29,1895,23
SIM,1921,32,35-39,1953,30
STAT,1828,46,35-39,1874,0.2555081899074233
STAT,1917,16,30-34,1933,5.309883309227836
SIM,1861,98,na,1959,10
STAT,1833,51,40-44,1884,0.01457337490054891
STAT,1899,43,15-19,1942,0.0026344693640592883
STAT,1853,30,45-49,1883,2.9009019894120165
STAT,1843,17,50-100,1860,0.08770274604546754
STAT,1867,18,30-34,1885,3.0637588844128416
SIM,1899,0,na,1899,7666
STAT,1847,15,25-29,1862,10.909246236003503
STAT,1870,45,35-39,1915,0.280363326634111
SIM,1851,31,15-19,1882,1
STAT,1860,53,25-29,1913,0.005715921685525172
STAT,1856,77,na,1933,1346.927116529103
STAT,1847,33,40-44,1880,7.681553069431075
SIM,1821,54,na,1875,2522
STAT,1900,40,50-100,1940,0.20760720536237473
STAT,1845,43,30-34,1888,1.781052125196836
STAT,1850,43,40-44,1893,3.4238336637360547
SIM,1939,21,40-44,1960,7
STAT,1798,72,na,1870,1065.4784606813173
SIM,1785,74,na,1859,706
SIM,1856,12,na,1868,4841
STAT,1838,49,50-100,1887,0.33331688003070425
SIM,1814,72,na,1886,1311
SIM,1940,27,20-24,1967,36
SIM,1814,82,na,1896,378
SIM,1776,93,na,1869,11
STAT,1816,54,45-49,1870,0.06572484257479297
STAT,1907,35,15-19,1942,0.036319630555887196
STAT,1863,59,na,1922,3435.851569958986
STAT,1868,29,50-100,1897,1.2204005856355247
STAT,1834,52,na,1886,2933.928394529355
STAT,1878,42,30-34,1920,2.4220104194158116
STAT,1925,40,15-19,1965,0.003764610400292565
SIM,1836,46,35-39,1882,1
STAT,1863,49,na,1912,3894.447950342771
SIM,1853,29,35-39,1882,20
SIM,1864,31,na,1895,4540
STAT,1827,54,20-24,1881,0.0011250067869279154
STAT,1859,51,50-100,1910,0.024393665128788603
STAT,1960,7,na,1967,10337.138249492444
STAT,1852,54,30-34,1906,0.009226341607692477
SIM,1831,28,50-100,1859,1
STAT,1845,29,35-39,1874,17.83852235954785
STAT,1831,30,25-29,1861,17.654514738646824
STAT,1864,96,na,1960,30.86722219798668
STAT,1895,64,na,1959,4773.078730346932
STAT,1932,27,20-24,1959,48.29042364742729
SIM,1833,26,15-19,1859,1
SIM,1870,26,30-34,1896,56
STAT,1881,16,50-100,1897,0.09587101307071237
STAT,1811,44,15-19,1855,0.09975380250085199
SIM,1869,45,35-39,1914,1
STAT,1912,24,30-34,1936,57.62380067361881
SIM,1869,35,50-100,1904,3
SIM,1882,50,na,1932,4490
STAT,1869,44,30-34,1913,2.2194627200179475
SIM,1861,29,na,1890,4471
SIM,1872,31,35-39,1903,26
STAT,1920,35,30-34,1955,4.036210005072827
STAT,1918,16,50-100,1934,0.16561186088835256
SIM,1874,45,45-49,1919,4
STAT,1903,35,30-34,1938,3.339297107247655
SIM,1917,53,na,1970,7737
SIM,1825,54,50-100,1879,1
STAT,1866,45,45-49,1911,0.44416564421711324
STAT,1862,26,30-34,1888,43.944797420569984
STAT,1865,54,40-44,1919,0.01878506548208169
SIM,1773,89,na,1862,56
SIM,1898,20,30-34,1918,60
SIM,1857,99,na,1956,4
SIM,1872,1,na,1873,7186
SIM,1880,31,25-29,1911,27
STAT,1897,32,25-29,1929,27.651364064669878
STAT,1850,52,na,1902,3283.811944705151
SIM,1846,12,na,1858,4657
STAT,1788,72,na,1860,1112.5043722346707
SIM,1822,40,35-39,1862,8
STAT,1872,31,25-29,1903,20.874789318407583
STAT,1924,28,25-29,1952,154.19036098151378
SIM,1874,31,na,1905,4650
SIM,1912,27,45-49,1939,3
STAT,1840,54,35-39,1894,0.012084938350746642
SIM,1845,41,30-34,1886,5
STAT,1881,44,na,1925,4450.828006099579
STAT,1909,17,35-39,1926,1.6628002412362086
STAT,1904,27,45-49,1931,3.2184797552561832
SIM,1925,16,30-34,1941,40
STAT,1848,54,40-44,1902,0.01678756228379558
STAT,1823,54,35-39,1877,0.024606140483822342
STAT,1890,11,na,1901,6375.7876161923905
STAT,1907,33,50-100,1940,1.5550895808671452
SIM,1869,19,na,1888,4957
SIM,1806,53,na,1859,2508
SIM,1920,24,30-34,1944,73
SIM,1870,65,na,1935,3335
SIM,1898,27,15-19,1925,1
STAT,1818,101,na,1919,0.5854272401616305
STAT,1849,15,45-49,1864,0.12869896552173654
STAT,1889,21,25-29,1910,142.98528849256303
SIM,1846,40,20-24,1886,2
STAT,1827,38,30-34,1865,10.783442332617222
SIM,1902,29,40-44,1931,13
SIM,1879,47,50-100,1926,2
STAT,1761,95,na,1856,0.37476435239999994
STAT,1835,49,30-34,1884,0.12886463149376012
SIM,1823,59,na,1882,2312
SIM,1895,21,50-100,1916,1
STAT,1908,40,15-19,1948,0.002903934039181466
SIM,1901,44,na,1945,6534
STAT,1915,28,15-19,1943,1.449239510255096
SIM,1915,28,25-29,1943,139
STAT,1855,35,40-44,1890,6.66367735710824
STAT,1866,61,na,1927,3482.1644946006677
STAT,1814,40,35-39,1854,11.263030561168586
STAT,1870,42,15-19,1912,0.027348794112304776
STAT,1888,31,20-24,1919,6.478745760863737
SIM,1897,21,25-29,1918,7
STAT,1870,28,30-34,1898,49.75559865122255
STAT,1922,46,20-24,1968,0.025697168274784656
STAT,1819,53,30-34,1872,0.023509735932449715
STAT,1829,51,35-39,1880,0.013384798553748498
SIM,1862,46,na,1908,4135
SIM,1873,83,na,1956,737
SIM,1896,31,20-24,1927,8
STAT,1881,78,na,1959,1803.4580047944894
STAT,1890,45,35-39,1935,0.3485625478019945
SIM,1851,40,50-100,1891,3
SIM,1910,48,50-100,1958,1
SIM,1869,40,na,1909,4504
SIM,1923,28,15-19,1951,4
SIM,1911,35,30-34,1946,3
STAT,1881,31,35-39,1912,19.849643988832607
STAT,1899,20,40-44,1919,5.800592365138257
STAT,1928,43,35-39,1971,0.5175507051157057
SIM,1808,72,na,1880,1137
SIM,1873,54,40-44,1927,1
STAT,1886,44,30-34,1930,2.4179423869244783
STAT,1907,28,25-29,1935,125.12395415574788
STAT,1919,46,45-49,1965,0.47717606213704716
STAT,1803,51,15-19,1854,1.8438189067527353E-4
STAT,1894,29,30-34,1923,64.86490156311397
STAT,1857,25,na,1882,3925.7938239327086
SIM,1852,38,30-34,1890,18
STAT,1799,105,na,1904,0.019939867423903593
STAT,1838,40,20-24,1878,0.25788932612137133
SIM,1918,28,50-100,1946,2
STAT,1933,18,25-29,1951,116.86427643104379
STAT,1822,67,na,1889,1791.013477667399
SIM,1882,60,na,1942,3905
STAT,1857,46,50-100,1903,0.3877204600426008
STAT,1891,44,40-44,1935,5.5392592753448255
SIM,1815,53,40-44,1868,1
STAT,1869,22,20-24,1891,134.85758378670968
SIM,1921,25,45-49,1946,7
SIM,1880,31,na,1911,5302
STAT,1837,41,30-34,1878,1.9156293512276903
SIM,1842,91,na,1933,64
STAT,1875,0,na,1875,7633.953006834715
SIM,1909,24,na,1933,7168
SIM,1900,29,50-100,1929,2
STAT,1870,42,30-34,1912,2.2767869484726964
STAT,1854,23,50-100,1877,0.7292407878362354
SIM,1888,32,25-29,1920,29
SIM,1906,28,15-19,1934,2
SIM,1878,52,35-39,1930,1
STAT,1880,23,30-34,1903,37.779831392211
SIM,1842,34,50-100,1876,6
STAT,1772,102,na,1874,0.13409705009137102
STAT,1848,20,25-29,1868,115.95059105337553
STAT,1944,1,na,1945,8985.595501419328
SIM,1941,18,25-29,1959,125
SIM,1932,28,25-29,1960,191
STAT,1811,49,45-49,1860,1.5480427097222471
STAT,1841,20,25-29,1861,106.74706627909636
SIM,1812,87,na,1899,177
SIM,1900,25,na,1925,6988
STAT,1938,15,na,1953,7368.219884091321
STAT,1913,25,45-49,1938,3.5010503180663006
SIM,1873,14,na,1887,5486
STAT,1844,38,30-34,1882,9.001080211526542
STAT,1851,33,15-19,1884,0.22739589080161657
STAT,1803,53,50-100,1856,0.10874040027662576
STAT,1915,42,na,1957,7552.138832001373
SIM,1870,0,na,1870,7161
STAT,1810,86,na,1896,200.6543394404449
STAT,1933,25,15-19,1958,1.894960671441207
SIM,1842,15,15-19,1857,13
SIM,1932,20,na,1952,9794
SIM,1899,21,45-49,1920,3
STAT,1912,17,40-44,1929,0.5713749185108612
SIM,1861,28,30-34,1889,54
STAT,1913,23,na,1936,7426.382744795583
STAT,1875,34,na,1909,4919.497154312183
SIM,1917,17,35-39,1934,5
SIM,1867,83,na,1950,731
SIM,1877,44,30-34,1921,7
STAT,1854,36,35-39,1890,10.894885141624819
SIM,1877,22,20-24,1899,142
STAT,1807,53,40-44,1860,0.06719803413076192
STAT,1853,28,30-34,1881,41.7005202425702
SIM,1902,45,30-34,1947,1
STAT,1890,21,35-39,1911,14.428799003989305
STAT,1912,18,50-100,1930,0.15264583329758205
SIM,1889,18,45-49,1907,3
SIM,1882,44,40-44,1926,7
STAT,1829,45,40-44,1874,0.2772920806572828
STAT,1874,44,40-44,1918,4.588526861090774
STAT,1930,25,45-49,1955,4.440381764150784
SIM,1855,30,20-24,1885,4
SIM,1856,20,25-29,1876,128
STAT,1873,23,40-44,1896,4.262879556417232
STAT,1807,50,na,1857,2729.501414786269
SIM,1920,17,40-44,1937,5
SIM,1887,40,25-29,1927,3
STAT,1830,32,30-34,1862,34.58198052775823
SIM,1891,23,50-100,1914,1
SIM,1938,21,na,1959,7337
STAT,1861,52,30-34,1913,0.009953017071394807
SIM,1845,36,35-39,1881,22
SIM,1905,24,na,1929,7037
STAT,1858,22,45-49,1880,1.2596577161680036
STAT,1817,101,na,1918,0.5755454705334198
SIM,1897,9,na,1906,7195
SIM,1935,35,30-34,1970,8
STAT,1863,31,30-34,1894,30.993188356746952
STAT,1848,42,na,1890,3785.0907658958263
SIM,1870,20,45-49,1890,1
SIM,1891,27,15-19,1918,1
STAT,1905,58,na,1963,6106.785918198735
SIM,1891,33,na,1924,6263
STAT,1822,33,35-39,1855,55.8960827649964
STAT,1875,42,50-100,1917,2.1940303556375835
SIM,1849,7,na,1856,5039
STAT,1941,17,20-24,1958,282.04174161429523
SIM,1927,38,45-49,1965,3
STAT,1877,26,50-100,1903,1.3461399391992914
SIM,1843,29,50-100,1872,2
STAT,1893,48,40-44,1941,0.24410392602740622
STAT,1805,55,na,1860,2442.8728411770135
STAT,1903,57,na,1960,5989.14340322591
SIM,1866,22,45-49,1888,2
SIM,1845,98,na,1943,2
STAT,1864,33,25-29,1897,18.413038495807534
STAT,1882,50,25-29,1932,0.007068685294671573
STAT,1850,46,45-49,1896,0.362879028733347
STAT,1883,27,15-19,1910,0.9002698694498282
STAT,1931,20,35-39,1951,24.81213751560251
SIM,1857,26,15-19,1883,1
SIM,1880,21,30-34,1901,51
STAT,1848,21,50-100,1869,0.8200461449971083
STAT,1900,19,25-29,1919,15.79090538091633
SIM,1848,22,40-44,1870,3
STAT,1839,49,15-19,1888,6.202583629626008E-4
STAT,1907,23,na,1930,6998.628514532464
STAT,1919,36,35-39,1955,5.251626116134449
SIM,1880,40,50-100,1920,5
SIM,1909,38,40-44,1947,4
SIM,1856,21,50-100,1877,1
STAT,1837,36,35-39,1873,12.130387119269821
SIM,1879,40,na,1919,4785
SIM,1810,52,na,1862,2568
SIM,1898,37,na,1935,6740
STAT,1803,51,30-34,1854,0.04462045514168102
STAT,1840,52,na,1892,3091.42380937431
SIM,1831,30,35-39,1861,29
SIM,1886,45,35-39,1931,1
STAT,1933,33,15-19,1966,0.34957060854164945
SIM,1913,8,na,1921,8451
SIM,1815,85,na,1900,245
STAT,1836,39,35-39,1875,11.308271378296537
SIM,1933,23,15-19,1956,15
STAT,1849,26,15-19,1875,0.8568779562790756
SIM,1819,44,na,1863,2924
STAT,1836,30,45-49,1866,2.992870033580034
SIM,1881,23,40-44,1904,5
SIM,1908,24,15-19,1932,9
STAT,1900,17,15-19,1917,16.626382956739192
STAT,1820,38,30-34,1858,24.934461852911276
STAT,1930,17,45-49,1947,1.304313332051664
STAT,1845,46,35-39,1891,0.2163434958690766
SIM,1944,21,na,1965,8090
SIM,1851,4,na,1855,4994
SIM,1844,39,35-39,1883,17
STAT,1925,23,15-19,1948,12.826245078273221
STAT,1945,26,35-39,1971,33.27820058493811
STAT,1798,68,na,1866,1387.5835262736284
STAT,1856,53,35-39,1909,0.013199556134810055
STAT,1825,43,15-19,1868,0.031192336894229077
SIM,1915,5,na,1920,8554
STAT,1836,57,na,1893,2671.9715538036194
SIM,1854,17,na,1871,4681
STAT,1813,84,na,1897,295.6047926678466
SIM,1933,9,na,1942,11285
SIM,1799,56,na,1855,2024
STAT,1917,6,na,1923,8681.594186776543
STAT,1878,37,35-39,1915,14.918918070858792
STAT,1860,49,40-44,1909,0.2749196632037289
SIM,1771,94,na,1865,8
STAT,1820,70,na,1890,1570.751939759687
STAT,1878,45,35-39,1923,0.29824613092824004
SIM,1924,25,50-100,1949,6
SIM,1846,46,na,1892,3476
SIM,1868,37,30-34,1905,16
SIM,1928,41,35-39,1969,1
STAT,1846,105,na,1951,0.0449107394960721
SIM,1853,46,35-39,1899,1
STAT,1893,45,50-100,1938,0.3581782034880708
STAT,1820,34,15-19,1854,0.9160153518569651
STAT,1840,20,25-29,1860,106.6069503600958
STAT,1850,25,50-100,1875,1.1709852558754967
SIM,1887,38,na,1925,5754
SIM,1921,22,40-44,1943,3
STAT,1891,47,45-49,1938,0.33077817812693994
SIM,1836,37,50-100,1873,3
STAT,1915,35,20-24,1950,0.5429752153869637
STAT,1822,71,na,1893,1507.1011307419203
SIM,1829,71,na,1900,1641
STAT,1868,58,na,1926,3800.005750632514
SIM,1871,25,50-100,1896,2
SIM,1874,8,na,1882,5251
STAT,1884,48,15-19,1932,7.876842944626768E-4
STAT,1869,10,na,1879,5270.015212631074
SIM,1869,42,30-34,1911,3
STAT,1881,21,25-29,1902,112.08546382791482
STAT,1808,66,na,1874,1676.6174807589464
STAT,1863,25,50-100,1888,1.147329100487548
STAT,1810,50,45-49,1860,0.09340690501279338
STAT,1903,35,50-100,1938,0.7692537806225886
STAT,1868,17,20-24,1885,34.68263158146479
SIM,1778,88,na,1866,73
STAT,1938,9,na,1947,7932.141955696584
SIM,1923,35,20-24,1958,1
STAT,1923,19,na,1942,8679.380450401088
SIM,1872,66,na,1938,3319
SIM,1935,28,40-44,1963,17
STAT,1878,52,25-29,1930,0.007431397321596264
SIM,1886,37,35-39,1923,18
STAT,1927,35,30-34,1962,4.583694317069278
SIM,1828,27,na,1855,3600
SIM,1780,92,na,1872,13
STAT,1862,20,45-49,1882,1.2501193187738193
STAT,1930,25,na,1955,9628.51689871689
STAT,1850,28,15-19,1878,0.8127612804077836
SIM,1830,33,35-39,1863,23
SIM,1915,25,20-24,1940,36
SIM,1932,36,na,1968,10295
STAT,1919,27,50-100,1946,2.1715787076483224
SIM,1878,42,25-29,1920,3
STAT,1924,18,15-19,1942,108.83259610456285
SIM,1849,27,50-100,1876,2
SIM,1932,18,15-19,1950,111
SIM,1893,38,na,1931,6235
SIM,1885,26,50-100,1911,1
STAT,1853,59,na,1912,3074.9518069515507
STAT,1828,37,50-100,1865,2.4725037878375207
STAT,1800,56,na,1856,2265.430522709099
STAT,1828,28,na,1856,3503.1061488061937
STAT,1866,17,50-100,1883,0.09370728468147481
SIM,1889,39,na,1928,5862
STAT,1923,24,50-100,1947,1.5360600940994924
STAT,1845,26,30-34,1871,47.57258273574674
STAT,1896,32,25-29,1928,27.31117012679162
STAT,1834,20,50-100,1854,1.3731452723936832
STAT,1849,19,25-29,1868,10.903913488951781
STAT,1844,40,45-49,1884,2.5396018720377533
STAT,1842,26,15-19,1868,0.8413716827310566
STAT,1927,28,40-44,1955,11.402124985281587
STAT,1816,71,na,1887,1448.6217903927775
SIM,1886,80,na,1966,1741
STAT,1876,46,15-19,1922,8.379154520683983E-4
STAT,1929,22,50-100,1951,1.6803379446852418
STAT,1911,23,50-100,1934,1.2567965105484804
SIM,1878,35,35-39,1913,17
STAT,1921,24,40-44,1945,7.620103336077093
STAT,1793,69,na,1862,1344.6564182866928
STAT,1815,52,35-39,1867,0.04431875744789382
STAT,1941,25,20-24,1966,38.17152816266949
STAT,1859,44,na,1903,3665.14344048903
SIM,1916,40,na,1956,7816
STAT,1883,45,45-49,1928,0.4729571518143266
STAT,1893,63,na,1956,4617.851254551883
SIM,1891,45,45-49,1936,1
SIM,1887,65,na,1952,3993
STAT,1893,17,50-100,1910,0.125413234925423
SIM,1879,5,na,1884,5648
SIM,1901,38,40-44,1939,5
STAT,1847,50,40-44,1897,0.01627834927984589
SIM,1912,6,na,1918,8326
SIM,1938,16,40-44,1954,6
SIM,1875,18,30-34,1893,8
SIM,1916,36,na,1952,7933
STAT,1833,102,na,1935,0.38541599194258913
STAT,1866,44,15-19,1910,0.025386972179423394
STAT,1886,47,35-39,1933,0.2970804683240998
STAT,1930,15,35-39,1945,11.007138280275427
SIM,1873,79,na,1952,1221
STAT,1877,31,45-49,1908,3.672016121970656
STAT,1907,25,20-24,1932,35.059450685301805
STAT,1884,32,15-19,1916,0.2839994188662049
STAT,1829,41,25-29,1870,1.0734732431624276
SIM,1868,15,20-24,1883,33
SIM,1853,26,30-34,1879,57
SIM,1908,19,35-39,1927,1
STAT,1910,38,25-29,1948,1.8930873133356403
STAT,1941,15,50-100,1956,0.7798210017579946
SIM,1837,41,25-29,1878,3
STAT,1890,42,30-34,1932,2.8306222111484094
SIM,1857,19,25-29,1876,15
STAT,1913,22,40-44,1935,6.581867682198666
SIM,1904,55,na,1959,6244
SIM,1871,13,na,1884,5111
SIM,1934,21,na,1955,9778
STAT,1899,21,35-39,1920,16.196333483898176
STAT,1940,28,50-100,1968,2.049046745134696
SIM,1830,25,35-39,1855,26
STAT,1844,76,na,1920,1529.9754499557969
STAT,1855,41,35-39,1896,2.74294361819798
STAT,1901,48,40-44,1949,0.2696112310659969
STAT,1928,40,30-34,1968,0.3300214772509811
STAT,1899,23,45-49,1922,1.9236230657659155
SIM,1866,66,na,1932,3143
SIM,1870,29,35-39,1899,23
SIM,1928,23,50-100,1951,2
STAT,1810,70,na,1880,1443.3907001789905
SIM,1910,24,50-100,1934,1
STAT,1907,43,15-19,1950,0.0028260454930759986
STAT,1862,29,35-39,1891,16.53694874904671
STAT,1866,42,40-44,1908,4.186319517164161
STAT,1933,39,na,1972,10328.354860708594
SIM,1885,31,45-49,1916,5
SIM,1876,17,20-24,1893,44
STAT,1902,47,30-34,1949,0.15496695242296527
SIM,1858,31,na,1889,4083
STAT,1911,41,15-19,1952,0.0029781290751807656
SIM,1896,34,40-44,1930,17
STAT,1830,50,50-100,1880,0.026213975069405947
SIM,1835,26,50-100,1861,2
STAT,1915,27,20-24,1942,37.605564336886935
STAT,1858,42,15-19,1900,0.021715680261117448
STAT,1839,51,45-49,1890,0.022768514597205566
SIM,1850,82,na,1932,700
SIM,1818,40,45-49,1858,5
STAT,1874,52,40-44,1926,0.021654387937581798
STAT,1902,24,50-100,1926,1.1554725917282
SIM,1834,27,na,1861,3706
STAT,1940,6,na,1946,8185.84885023345
SIM,1874,42,40-44,1916,4
SIM,1923,27,20-24,1950,50
SIM,1865,41,50-100,1906,7
STAT,1856,4,na,1860,4911.055904578659
STAT,1870,35,na,1905,4715.86149323202
STAT,1923,37,20-24,1960,0.6166762638950463
SIM,1890,43,35-39,1933,8
SIM,1827,86,na,1913,188
STAT,1861,24,na,1885,4025.9161936483306
STAT,1891,29,15-19,1920,1.1245198862912458
STAT,1905,30,35-39,1935,29.816698279357432
STAT,1844,28,50-100,1872,1.2555453923444344
STAT,1837,51,25-29,1888,0.0050549504054453395
STAT,1818,50,45-49,1868,0.06385248335292705
SIM,1863,31,25-29,1894,22
SIM,1889,23,na,1912,5998
SIM,1829,43,40-44,1872,9
SIM,1802,87,na,1889,114
STAT,1898,38,15-19,1936,0.03296199816612825
STAT,1819,36,30-34,1855,33.357689986568715
STAT,1900,50,na,1950,6119.222750609381
STAT,1953,18,40-44,1971,3.4158323585054173
SIM,1878,51,na,1929,4752
SIM,1927,36,35-39,1963,10
SIM,1883,14,na,1897,5339
STAT,1851,51,45-49,1902,0.022604531132539116
STAT,1817,41,15-19,1858,0.07786183925502002
STAT,1830,35,35-39,1865,13.630573982477866
SIM,1850,44,45-49,1894,5
STAT,1771,102,na,1873,0.12542657501643248
STAT,1858,20,35-39,1878,10.694365081333071
SIM,1837,69,na,1906,1892
SIM,1872,7,na,1879,5796
STAT,1812,43,20-24,1855,1.2328804720807123
SIM,1836,21,20-24,1857,109
STAT,1848,24,40-44,1872,4.100820045426595
STAT,1865,44,na,1909,4183.447351473445
STAT,1844,52,30-34,1896,0.00956168150085566
SIM,1804,52,na,1856,2387
SIM,1900,17,25-29,1917,19
SIM,1844,30,45-49,1874,7
STAT,1939,29,15-19,1968,1.4320590850070105
STAT,1837,44,35-39,1881,2.642177527559842
SIM,1917,3,na,1920,8985
STAT,1882,43,35-39,1925,3.5368536645105415
STAT,1919,38,45-49,1957,1.4773182403178666
SIM,1888,32,50-100,1920,4
SIM,1913,30,35-39,1943,29
SIM,1827,36,30-34,1863,15
SIM,1864,41,na,1905,4421
STAT,1896,25,35-39,1921,25.902724334271408
SIM,1852,40,45-49,1892,2
STAT,1862,40,15-19,1902,0.02407908451172358
STAT,1817,40,na,1857,3152.664996476
STAT,1860,35,na,1895,3900.694566546303
SIM,1856,24,40-44,1880,5
STAT,1859,3,na,1862,5271.939874778648
SIM,1792,86,na,1878,123
SIM,1854,3,na,1857,5396
STAT,1886,27,30-34,1913,53.68636400081243
STAT,1842,44,45-49,1886,2.2470145270490667
SIM,1900,24,15-19,1924,10
SIM,1920,27,35-39,1947,50
SIM,1928,21,na,1949,9350
SIM,1849,28,30-34,1877,64
STAT,1832,22,40-44,1854,6.561263855914134
SIM,1821,85,na,1906,266
STAT,1811,46,40-44,1857,1.1823826321459383
STAT,1830,38,na,1868,3681.9901572918443
STAT,1915,5,na,1920,8471.853069752295
STAT,1925,24,50-100,1949,1.580402854243039
SIM,1837,34,35-39,1871,23
STAT,1844,51,50-100,1895,0.02450633716660448
SIM,1845,44,35-39,1889,7
STAT,1868,62,na,1930,3512.0336192998498
STAT,1859,75,na,1934,1654.849154684329
SIM,1866,20,35-39,1886,19
STAT,1933,15,20-24,1948,368.2770038162344
SIM,1912,17,35-39,1929,5
STAT,1824,38,15-19,1862,0.16310196181833497
SIM,1903,34,40-44,1937,10
STAT,1838,43,25-29,1881,0.9131407552755473
SIM,1907,53,na,1960,6481
SIM,1857,83,na,1940,592
STAT,1875,16,15-19,1891,12.370324796026235
STAT,1904,17,35-39,1921,1.5905649849305892
SIM,1846,43,25-29,1889,1
SIM,1933,24,50-100,1957,2
SIM,1894,27,30-34,1921,76
STAT,1851,52,20-24,1903,0.0011378201897574993
STAT,1912,27,35-39,1939,29.88879208371533
SIM,1840,22,40-44,1862,7
SIM,1883,16,15-19,1899,11
SIM,1803,73,na,1876,1062
STAT,1875,22,45-49,1897,1.4499767105100472
SIM,1918,35,30-34,1953,9
STAT,1865,82,na,1947,856.09068664952
STAT,1865,39,15-19,1904,0.10199603946864044
STAT,1920,31,15-19,1951,0.2853706340740733
STAT,1830,90,na,1920,108.86960891594686
SIM,1840,68,na,1908,2319
STAT,1949,17,na,1966,8645.087920024998
SIM,1929,37,na,1966,9967
STAT,1812,53,30-34,1865,0.03867826192615683
STAT,1928,22,na,1950,9206.979469077372
SIM,1942,29,na,1971,8045
STAT,1899,17,15-19,1916,16.421724900495207
STAT,1874,50,35-39,1924,0.018058634743503887
STAT,1928,33,40-44,1961,9.874784392440361
STAT,1827,43,na,1870,3201.5034803048134
STAT,1823,32,25-29,1855,58.66243743844503
SIM,1817,39,25-29,1856,6
SIM,1831,32,25-29,1863,26
SIM,1866,97,na,1963,22
SIM,1922,20,35-39,1942,34
SIM,1878,82,na,1960,1159
SIM,1850,8,na,1858,4768
STAT,1869,23,15-19,1892,6.436041538132885
SIM,1830,102,na,1932,3
SIM,1877,27,30-34,1904,60
SIM,1923,38,25-29,1961,4
STAT,1917,42,30-34,1959,0.2694309255139417
STAT,1923,40,50-100,1963,0.2779942215554562
STAT,1929,39,50-100,1968,1.0861978918807582
SIM,1896,42,25-29,1938,1
STAT,1804,70,na,1874,1370.6475424363541
STAT,1901,46,35-39,1947,0.22391595997628364
SIM,1845,33,30-34,1878,11
STAT,1846,45,40-44,1891,0.26484290942309224
STAT,1846,31,30-34,1877,31.933678020523732
SIM,1911,27,na,1938,7489
STAT,1887,45,50-100,1932,0.5602901937253625
SIM,1923,22,na,1945,8929
STAT,1914,46,45-49,1960,0.4364809872691579
SIM,1796,86,na,1882,172
SIM,1839,71,na,1910,1746
STAT,1888,42,25-29,1930,1.5309834467011862
STAT,1910,44,35-39,1954,0.37976817801429047
SIM,1936,33,40-44,1969,10
STAT,1915,38,25-29,1953,1.9990222082455154
STAT,1916,37,na,1953,7780.9513544901765
SIM,1909,23,20-24,1932,212
SIM,1834,65,na,1899,2179
STAT,1854,45,na,1899,3483.3621120380235
SIM,1831,32,40-44,1863,12
SIM,1858,78,na,1936,1212
STAT,1810,51,20-24,1861,0.0046544802844379835
SIM,1878,92,na,1970,243
STAT,1858,40,50-100,1898,1.6800804791630062
SIM,1833,80,na,1913,748
SIM,1847,90,na,1937,113
STAT,1845,68,na,1913,2354.854125601296
STAT,1803,53,20-24,1856,0.00531304908380828
STAT,1871,16,30-34,1887,3.237848561853236
STAT,1878,34,30-34,1912,36.51248892835555
STAT,1914,20,35-39,1934,18.75785923364171
SIM,1925,42,30-34,1967,1
SIM,1896,30,25-29,1926,36
STAT,1898,62,na,1960,5229.248068243681
STAT,1911,45,30-34,1956,0.17129667144965344
STAT,1866,22,35-39,1888,10.963088549793055
STAT,1817,49,na,1866,2849.524233696595
SIM,1860,82,na,1942,805
SIM,1927,35,40-44,1962,6
SIM,1874,22,35-39,1896,11
SIM,1919,36,45-49,1955,2
SIM,1907,42,50-100,1949,1
STAT,1862,18,30-34,1880,3.1325508234552646
STAT,1870,44,20-24,1914,0.3106482646254275
SIM,1877,38,na,1915,4787
STAT,1853,50,na,1903,3455.70141723024
STAT,1865,50,25-29,1915,0.006592317336132705
SIM,1870,18,30-34,1888,5
STAT,1891,48,20-24,1939,0.01668568534810502
STAT,1854,19,35-39,1873,0.9944144755483664
STAT,1915,45,15-19,1960,7.532576507644093E-4
STAT,1811,55,na,1866,2444.7592980882337
STAT,1937,26,45-49,1963,3.4033759468364786
STAT,1841,42,35-39,1883,2.7301598164439365
SIM,1822,33,na,1855,3283
SIM,1910,33,20-24,1943,7
STAT,1860,45,25-29,1905,0.09541058352406581
SIM,1859,39,30-34,1898,14
STAT,1872,21,30-34,1893,36.263465666776575
STAT,1916,4,na,1920,8620.20256157301
STAT,1866,30,na,1896,4482.586602803924
SIM,1813,50,35-39,1863,1
STAT,1822,98,na,1920,3.667873720850977
STAT,1850,47,20-24,1897,0.018313459691530847
SIM,1883,45,na,1928,4731
STAT,1879,44,25-29,1923,1.3382312662119238
SIM,1846,50,na,1896,3379
STAT,1795,102,na,1897,0.1252918082592256
SIM,1859,26,na,1885,4371
SIM,1887,44,25-29,1931,4
STAT,1796,102,na,1898,0.13061426220276634
STAT,1830,27,50-100,1857,1.4760558085512794
STAT,1838,46,45-49,1884,0.33283817195875043
STAT,1897,31,50-100,1928,2.4836433369016118
SIM,1763,96,na,1859,7
SIM,1963,7,na,1970,10474
SIM,1944,25,30-34,1969,106
SIM,1798,71,na,1869,1087
SIM,1954,14,na,1968,9911
STAT,1893,25,na,1918,6150.655333122818
STAT,1909,18,30-34,1927,4.817384181203373
STAT,1856,30,na,1886,3842.947481565255
STAT,1837,33,30-34,1870,30.20255889903227
STAT,1851,41,15-19,1892,0.02150462290113544
STAT,1869,30,20-24,1899,5.3322420632266905
SIM,1849,26,na,1875,4272
STAT,1855,43,40-44,1898,3.367259046791706
STAT,1793,90,na,1883,60.516618454943725
SIM,1855,41,25-29,1896,3
SIM,1945,26,45-49,1971,5
SIM,1807,66,na,1873,1493
SIM,1859,25,20-24,1884,23
STAT,1886,77,na,1963,2357.351394388673
SIM,1891,74,na,1965,3570
STAT,1878,58,na,1936,4171.347713835954
STAT,1806,54,35-39,1860,0.04826092556304675
SIM,1900,39,35-39,1939,7
SIM,1848,25,45-49,1873,1
SIM,1898,30,40-44,1928,18
STAT,1833,36,15-19,1869,0.0934393382818059
SIM,1955,2,na,1957,10131
STAT,1783,73,na,1856,833.9361255791999
SIM,1922,18,50-100,1940,2
SIM,1846,46,45-49,1892,1
STAT,1853,97,na,1950,8.49996956616906
STAT,1876,39,50-100,1915,2.538771039366496
STAT,1872,41,35-39,1913,3.6921127703990555
SIM,1880,41,35-39,1921,9
SIM,1897,29,50-100,1926,3
STAT,1835,29,25-29,1864,70.41360229847949
STAT,1937,33,35-39,1970,18.25185350941524
SIM,1841,13,na,1854,4448
SIM,1904,22,40-44,1926,9
SIM,1843,29,25-29,1872,87
SIM,1816,46,na,1862,2903
STAT,1766,94,na,1860,4.691436096331106
SIM,1942,26,na,1968,8021
STAT,1890,23,25-29,1913,140.68330037178706
STAT,1855,39,50-100,1894,1.8327224516513614
STAT,1942,27,30-34,1969,83.05700153816142
SIM,1872,33,40-44,1905,17
SIM,1911,37,na,1948,7462
STAT,1805,50,35-39,1855,0.07038364630082
STAT,1913,15,35-39,1928,1.7411917108754704
STAT,1874,48,50-100,1922,0.5014983485772688
SIM,1897,65,na,1962,4933
STAT,1917,47,25-29,1964,0.11189014637466813
SIM,1890,27,na,1917,6309
SIM,1909,19,35-39,1928,2
STAT,1811,48,30-34,1859,0.6459263279562601
SIM,1881,42,30-34,1923,4
STAT,1873,31,25-29,1904,21.104293388061027
SIM,1839,64,na,1903,2294
SIM,1904,15,35-39,1919,3
STAT,1877,18,25-29,1895,11.852889902905106
SIM,1926,16,50-100,1942,1
SIM,1949,17,30-34,1966,37
STAT,1946,24,50-100,1970,1.4776906394098293
STAT,1900,17,50-100,1917,0.1372568485880007
SIM,1930,15,45-49,1945,5
STAT,1857,17,45-49,1874,0.12086126329317273
STAT,1811,65,na,1876,1837.653729774927
SIM,1878,32,30-34,1910,40
SIM,1921,15,35-39,1936,13
STAT,1785,105,na,1890,0.045820949159316275
STAT,1829,50,20-24,1879,0.0011702369091555254
STAT,1873,40,40-44,1913,4.662213733677418
SIM,1859,16,na,1875,4812
STAT,1945,25,40-44,1970,10.335744851127636
STAT,1816,53,15-19,1869,1.1364433292950007E-4
SIM,1844,28,30-34,1872,44
STAT,1862,30,na,1892,4152.364238064395
SIM,1860,43,25-29,1903,2
STAT,1945,24,na,1969,8077.031542406928
STAT,1941,28,25-29,1969,137.45366695619927
STAT,1883,44,15-19,1927,0.02703259518491822
STAT,1916,37,30-34,1953,3.7694271212114305
SIM,1814,51,30-34,1865,1
SIM,1891,49,25-29,1940,1
SIM,1918,28,40-44,1946,17
SIM,1903,24,30-34,1927,65
SIM,1877,45,na,1922,4681
SIM,1871,48,45-49,1919,1
STAT,1828,29,35-39,1857,24.55953919522423
SIM,1881,40,40-44,1921,9
STAT,1873,45,35-39,1918,0.29015199412332215
SIM,1828,41,30-34,1869,4
STAT,1860,45,na,1905,3726.7122047100634
STAT,1941,21,40-44,1962,7.020245251901716
STAT,1896,41,20-24,1937,0.02953923461159061
SIM,1935,16,25-29,1951,150
SIM,1948,14,na,1962,9324
STAT,1802,52,25-29,1854,0.022705979954054333
SIM,1765,91,na,1856,21
SIM,1827,79,na,1906,708
STAT,1883,49,25-29,1932,0.11190777078518309
STAT,1887,32,30-34,1919,39.437881744185724
STAT,1843,40,50-100,1883,1.5632682537432803
SIM,1887,47,45-49,1934,1
SIM,1836,29,35-39,1865,23
SIM,1848,18,20-24,1866,40
STAT,1924,25,na,1949,8866.470587314241
SIM,1889,30,na,1919,6090
SIM,1886,34,30-34,1920,44
SIM,1895,46,40-44,1941,1
STAT,1817,43,na,1860,3037.2698381015066
STAT,1887,46,40-44,1933,0.38780323357617985
STAT,1888,30,25-29,1918,24.64629428193593
SIM,1873,9,na,1882,5619
SIM,1890,21,25-29,1911,162
STAT,1842,16,na,1858,4414.504558587486
SIM,1848,78,na,1926,1026
STAT,1929,31,35-39,1960,23.45454673019824
SIM,1895,32,30-34,1927,60
STAT,1962,5,na,1967,10172.244511088396
STAT,1936,28,35-39,1964,29.01028105199427
STAT,1902,31,30-34,1933,49.9871459429914
STAT,1916,32,50-100,1948,1.7239444327384832
SIM,1849,30,45-49,1879,6
SIM,1937,31,35-39,1968,4
STAT,1902,48,50-100,1950,0.3900587597358777
STAT,1927,16,25-29,1943,109.07196852725917
SIM,1886,20,20-24,1906,135
STAT,1879,47,45-49,1926,0.49622035825106003
STAT,1844,45,na,1889,3690.5963255295137
SIM,1836,50,na,1886,2831
STAT,1936,10,na,1946,7686.080479233715
SIM,1923,12,na,1935,9850
SIM,1899,15,15-19,1914,12
STAT,1827,49,na,1876,2977.7537367487303
SIM,1847,93,na,1940,54
STAT,1857,18,50-100,1875,0.09011204283928198
SIM,1948,18,25-29,1966,110
SIM,1815,51,na,1866,2459
SIM,1840,30,25-29,1870,23
STAT,1857,108,na,1965,0.02055382593446732
SIM,1924,37,30-34,1961,6
SIM,1819,43,30-34,1862,1
STAT,1874,37,15-19,1911,0.11612285001351558
STAT,1902,36,25-29,1938,1.7804959851949311
STAT,1855,40,20-24,1895,0.24189606646451003
STAT,1872,30,na,1902,4882.525691569822
SIM,1830,68,na,1898,1863
STAT,1855,2,na,1857,5371.34628208645
STAT,1863,48,45-49,1911,0.4119821169953942
SIM,1840,44,35-39,1884,6
STAT,1836,28,30-34,1864,43.022562467187974
STAT,1873,70,na,1943,2879.187011729706
STAT,1842,43,15-19,1885,0.021001042788489764
STAT,1849,41,50-100,1890,1.6786550512344047
SIM,1860,72,na,1932,2191
STAT,1771,88,na,1859,65.96313726852536
STAT,1919,35,40-44,1954,3.265436275816404
STAT,1922,22,35-39,1944,21.801747292287885
STAT,1898,18,45-49,1916,0.17806438266081498
STAT,1831,40,35-39,1871,2.942280012522774
STAT,1886,25,50-100,1911,1.3730398154212395
SIM,1910,36,25-29,1946,1
STAT,1939,5,na,1944,8111.628700546882
SIM,1889,19,20-24,1908,42
SIM,1915,33,50-100,1948,4
SIM,1828,31,na,1859,3576
SIM,1839,20,25-29,1859,105
STAT,1861,19,25-29,1880,10.820228927427044
STAT,1922,15,45-49,1937,1.1727005490981124
STAT,1890,26,45-49,1916,2.746463234290897
SIM,1938,19,45-49,1957,2
SIM,1922,43,40-44,1965,1
STAT,1915,52,na,1967,7351.300203841568
STAT,1832,30,25-29,1862,17.786722035162445
SIM,1852,53,na,1905,3440
SIM,1879,16,25-29,1895,11
STAT,1853,54,30-34,1907,0.0091591400471416
STAT,1925,46,20-24,1971,0.027107033233647142
SIM,1780,98,na,1878,2
SIM,1831,35,45-49,1866,7
SIM,1892,12,na,1904,7406
SIM,1872,33,25-29,1905,30
STAT,1832,44,35-39,1876,2.8144998856270464
STAT,1866,15,45-49,1881,0.12642798181556586
STAT,1867,18,na,1885,4854.756609057235
SIM,1839,27,45-49,1866,2
SIM,1854,31,30-34,1885,41
SIM,1919,43,35-39,1962,1
STAT,1900,12,na,1912,7235.220882553647
SIM,1895,30,na,1925,6645
STAT,1912,34,50-100,1946,1.6294499828400935
STAT,1850,45,na,1895,3484.003996303606
SIM,1865,37,15-19,1902,1
STAT,1900,38,30-34,1938,3.2068426448555623
STAT,1936,35,40-44,1971,2.9738216414959395
SIM,1809,51,na,1860,2517
STAT,1823,35,45-49,1858,8.284086410813789
SIM,1940,23,50-100,1963,2
STAT,1840,90,na,1930,113.80165559682813
SIM,1908,18,20-24,1926,40
STAT,1914,43,40-44,1957,0.4998462976898449
STAT,1842,48,25-29,1890,0.08467818535416617
STAT,1896,22,30-34,1918,47.495175968750196
SIM,1863,102,na,1965,3
STAT,1897,22,na,1919,6384.784371819552
STAT,1829,31,30-34,1860,34.44644138882031
SIM,1923,31,40-44,1954,11
STAT,1885,37,na,1922,4736.211904227019
STAT,1850,32,35-39,1882,16.243346511323338
SIM,1842,21,45-49,1863,2
SIM,1845,22,25-29,1867,122
STAT,1840,32,25-29,1872,18.007525932525606
SIM,1878,3,na,1881,6341
STAT,1765,112,na,1877,0.001404584074949419
STAT,1842,41,40-44,1883,3.509323280832613
STAT,1879,40,25-29,1919,1.37023003570528
STAT,1886,81,na,1967,1846.0245168528822
STAT,1832,41,30-34,1873,1.857443007791725
STAT,1932,34,45-49,1966,4.219595738929111
SIM,1830,47,45-49,1877,3
SIM,1932,35,15-19,1967,1
SIM,1880,35,40-44,1915,12
STAT,1928,18,na,1946,9340.769521749264
SIM,1896,32,50-100,1928,4
STAT,1890,20,20-24,1910,170.8936443493456
STAT,1857,41,50-100,1898,1.670588288997332
STAT,1921,47,15-19,1968,8.384829444235796E-4
STAT,1878,20,20-24,1898,146.22445397195176
SIM,1865,26,na,1891,4478
SIM,1876,41,45-49,1917,5
STAT,1860,31,15-19,1891,0.2345148568061584
SIM,1836,22,15-19,1858,5
SIM,1867,45,na,1912,4614
SIM,1849,64,na,1913,2798
SIM,1872,53,45-49,1925,2
STAT,1842,20,50-100,1862,0.7768784515188535
SIM,1837,31,30-34,1868,44
STAT,1815,48,15-19,1863,0.002115873187142443
STAT,1888,40,35-39,1928,4.366146319871665
SIM,1938,33,50-100,1971,3
SIM,1813,44,40-44,1857,6
STAT,1825,48,25-29,1873,0.12320073256887455
STAT,1849,22,35-39,1871,11.160014841715885
STAT,1937,30,30-34,1967,31.522509279557937
SIM,1910,42,na,1952,7361
STAT,1917,44,20-24,1961,0.03709485171698834
STAT,1832,102,na,1934,0.3822174720836344
SIM,1827,31,20-24,1858,6
SIM,1822,39,na,1861,3110
SIM,1909,26,25-29,1935,145
STAT,1834,21,45-49,1855,1.2504033944771202
STAT,1945,21,25-29,1966,204.50879747822793
SIM,1918,38,35-39,1956,4
STAT,1931,11,na,1942,10490.207473534283
STAT,1882,39,15-19,1921,0.10936638325267153
STAT,1846,35,50-100,1881,2.005026929357738
STAT,1892,39,25-29,1931,7.206197864065829
SIM,1866,40,50-100,1906,2
STAT,1901,49,50-100,1950,0.38352205150322394
STAT,1900,30,35-39,1930,28.600296503280262
SIM,1854,35,50-100,1889,3
STAT,1852,40,20-24,1892,0.2556718856078637
SIM,1879,30,na,1909,4969
STAT,1902,43,15-19,1945,0.0027146395727836803
STAT,1911,43,40-44,1954,0.4793896298856645
STAT,1901,43,30-34,1944,0.22409333137774692
SIM,1856,27,45-49,1883,4
STAT,1852,49,30-34,1901,0.15105956463795706
SIM,1930,22,35-39,1952,33
STAT,1852,16,na,1868,4451.032987246681
SIM,1854,34,35-39,1888,26
STAT,1841,53,40-44,1894,0.015029626571845768
STAT,1867,20,45-49,1887,1.343589293668281
SIM,1842,53,na,1895,3035
STAT,1862,64,na,1926,3000.7564483129686
SIM,1892,59,na,1951,5463
STAT,1854,33,30-34,1887,27.126372929464498
SIM,1933,15,na,1948,10458
STAT,1864,33,40-44,1897,7.796076592678611
SIM,1859,19,na,1878,4726
SIM,1862,33,30-34,1895,14
STAT,1872,35,40-44,1907,8.9695785596066
STAT,1936,18,40-44,1954,2.6979754805168965
SIM,1833,48,25-29,1881,1
STAT,1846,34,35-39,1880,17.954221958612038
SIM,1837,79,na,1916,878
STAT,1882,21,25-29,1903,112.96485024053243
STAT,1837,22,25-29,1859,104.47178766341102
STAT,1914,41,50-100,1955,0.23548109536285325
STAT,1924,35,15-19,1959,0.045799360872959605
SIM,1850,41,40-44,1891,3
STAT,1848,27,45-49,1875,2.1734189920449145
SIM,1840,41,30-34,1881,3
SIM,1881,71,na,1952,2123
STAT,1814,42,25-29,1856,3.7083631802726185
SIM,1853,21,20-24,1874,139
SIM,1886,46,50-100,1932,1
SIM,1939,24,45-49,1963,3
STAT,1824,42,35-39,1866,4.706404602561183
STAT,1843,97,na,1940,7.525532181263435
STAT,1871,82,na,1953,936.2046537210576
SIM,1897,58,na,1955,5423
STAT,1915,49,30-34,1964,0.18037110871062842
STAT,1820,54,35-39,1874,0.029607664567540118
SIM,1898,33,45-49,1931,10
SIM,1838,27,na,1865,3810
SIM,1908,48,na,1956,6657
STAT,1810,54,25-29,1864,0.02102721878977678
STAT,1878,46,50-100,1924,0.5195150702275203
SIM,1885,29,30-34,1914,72
STAT,1901,22,15-19,1923,9.327558257864153
SIM,1852,16,20-24,1868,39
SIM,1863,41,35-39,1904,9
STAT,1776,94,na,1870,7.912844940009178
STAT,1835,31,na,1866,3610.6563757696663
STAT,1806,51,30-34,1857,0.03543822237499227
STAT,1854,16,30-34,1870,2.940185004447759
STAT,1913,19,na,1932,7934.5370947258425
STAT,1816,51,40-44,1867,0.05062128628869411
STAT,1874,96,na,1970,94.51592186864292
SIM,1904,25,45-49,1929,7
STAT,1844,16,20-24,1860,36.60933751478175
STAT,1906,44,45-49,1950,0.30173096885703643
SIM,1818,65,na,1883,1838
SIM,1880,27,na,1907,5305
STAT,1823,108,na,1931,0.0021980709647049105
STAT,1864,36,45-49,1900,3.6161819836949918
STAT,1845,31,na,1876,4012.2416638659565
STAT,1868,41,45-49,1909,2.8888460656510646
SIM,1894,44,na,1938,6179
STAT,1877,29,30-34,1906,52.432981615022456
STAT,1878,23,25-29,1901,120.37509562253898
SIM,1846,43,40-44,1889,12
SIM,1787,72,na,1859,908
STAT,1844,54,20-24,1898,0.0011589060521911398
SIM,1836,43,30-34,1879,6
STAT,1832,98,na,1930,4.235181193747829
SIM,1875,20,45-49,1895,1
SIM,1872,36,45-49,1908,6
STAT,1872,24,35-39,1896,11.770361594662837
STAT,1857,15,na,1872,4297.558474749995
STAT,1955,17,na,1972,9867.033252973055
STAT,1966,3,na,1969,9921.09811502518
SIM,1840,34,50-100,1874,4
STAT,1833,47,20-24,1880,0.018510426122639707
SIM,1803,66,na,1869,1701
STAT,1921,0,na,1921,10368.757176995301
SIM,1857,22,35-39,1879,18
SIM,1877,11,na,1888,5414
SIM,1886,23,25-29,1909,125
STAT,1838,43,40-44,1881,3.198447313930047
STAT,1915,31,40-44,1946,8.082891081924942
STAT,1828,43,30-34,1871,2.1300872487308244
STAT,1852,45,15-19,1897,6.43879392830257E-4
SIM,1879,77,na,1956,1671
STAT,1883,42,40-44,1925,4.4576832566880515
SIM,1908,16,30-34,1924,5
STAT,1879,41,20-24,1920,0.3370069028950677
STAT,1873,42,30-34,1915,2.356279193945515
STAT,1911,48,35-39,1959,0.24589706305131084
STAT,1884,48,na,1932,4430.414336651655
SIM,1932,26,na,1958,9961
SIM,1859,28,25-29,1887,91
STAT,1826,50,20-24,1876,0.001476706754301501
STAT,1901,48,25-29,1949,0.0907103200263126
STAT,1832,34,50-100,1866,1.5238245662861145
SIM,1907,59,na,1966,6241
STAT,1856,49,15-19,1905,6.102800454007325E-4
STAT,1805,65,na,1870,1836.2357355447068
STAT,1903,19,40-44,1922,0.5231285985044436
SIM,1911,19,40-44,1930,1
STAT,1843,105,na,1948,0.04107291550064159
SIM,1818,38,30-34,1856,13
STAT,1831,34,40-44,1865,7.159924471172203
STAT,1866,49,25-29,1915,0.10509532821953246
STAT,1928,36,45-49,1964,1.7413270309747721
STAT,1901,26,30-34,1927,71.44285718099651
STAT,1846,51,35-39,1897,0.013249667305419308
STAT,1937,23,40-44,1960,6.611935431811773
SIM,1962,5,na,1967,10319
SIM,1887,41,20-24,1928,2
SIM,1824,72,na,1896,1510
STAT,1830,32,na,1862,3870.888200606919
STAT,1841,31,na,1872,3855.0783112185763
STAT,1822,47,45-49,1869,0.7337001409271
SIM,1904,32,35-39,1936,29
STAT,1895,34,30-34,1929,45.55414131642517
STAT,1967,5,na,1972,9917.287497624524
SIM,1906,38,25-29,1944,2
STAT,1847,41,25-29,1888,0.9970182302733639
STAT,1874,17,45-49,1891,0.13508137547990087
SIM,1891,42,40-44,1933,12
STAT,1879,44,40-44,1923,4.687406814452312
STAT,1837,97,na,1934,7.487592339506492
STAT,1921,27,45-49,1948,3.88768899084053
STAT,1910,35,20-24,1945,0.5142011366681642
SIM,1828,44,35-39,1872,7
STAT,1858,96,na,1954,13.51899095578808
STAT,1900,20,40-44,1920,5.872883063326552
STAT,1853,50,50-100,1903,0.024238981968053092
SIM,1898,23,35-39,1921,20
SIM,1919,40,30-34,1959,1
SIM,1868,32,20-24,1900,8
STAT,1893,41,20-24,1934,0.40838150053093625
STAT,1835,68,na,1903,1979.2326052525598
STAT,1834,83,na,1917,527.5710510730759
STAT,1812,45,50-100,1857,1.764837428182564
STAT,1887,35,35-39,1922,16.127991703410256
STAT,1803,91,na,1894,40.89538388398038
STAT,1846,41,25-29,1887,1.0083414955293926
SIM,1895,35,35-39,1930,28
STAT,1859,27,20-24,1886,19.183691907828333
SIM,1909,16,30-34,1925,8
SIM,1894,0,na,1894,7316
STAT,1875,37,na,1912,4898.904836895777
STAT,1877,15,20-24,1892,37.352276617921504
STAT,1954,16,35-39,1970,10.478313462795493
STAT,1918,22,na,1940,7953.020843228972
STAT,1906,37,20-24,1943,0.4896498825765706
STAT,1899,0,na,1899,8125.250257781712
STAT,1876,81,na,1957,1277.1524621282756
STAT,1893,46,15-19,1939,5.792331703768946E-4
SIM,1824,65,na,1889,1995
STAT,1936,25,30-34,1961,75.81371372855277
STAT,1808,51,15-19,1859,1.489989219654543E-4
SIM,1873,32,50-100,1905,3
STAT,1858,16,15-19,1874,10.97907587225095
STAT,1823,50,na,1873,3010.295634205212
STAT,1841,38,15-19,1879,0.0950035064734457
STAT,1849,82,na,1931,738.03927235341
SIM,1836,26,30-34,1862,54
SIM,1877,47,35-39,1924,1
STAT,1764,112,na,1876,0.0011389574931243752
STAT,1776,87,na,1863,106.28879563456464
STAT,1909,17,50-100,1926,0.14846427974633122
STAT,1917,19,35-39,1936,9.04023407922088
SIM,1826,29,25-29,1855,75
STAT,1855,43,25-29,1898,0.9613356630276033
SIM,1882,31,50-100,1913,3
SIM,1832,42,35-39,1874,9
STAT,1876,15,50-100,1891,0.1028126360295249
SIM,1842,94,na,1936,17
SIM,1858,18,30-34,1876,2
SIM,1939,5,na,1944,8346
STAT,1829,53,25-29,1882,0.004816498663738971
SIM,1944,18,40-44,1962,2
STAT,1845,21,20-24,1866,132.78105392116217
STAT,1895,17,30-34,1912,4.194475522056183
STAT,1940,18,na,1958,7545.881745452524
STAT,1889,48,15-19,1937,5.548189833283644E-4
STAT,1867,15,na,1882,4941.5606969600185
STAT,1823,52,45-49,1875,0.04316267907579118
SIM,1932,25,20-24,1957,48
STAT,1839,50,30-34,1889,0.009525750021840454
STAT,1924,25,20-24,1949,43.20379253880811
STAT,1904,24,40-44,1928,6.002605360658454
SIM,1861,30,45-49,1891,4
SIM,1912,24,40-44,1936,7
STAT,1891,33,35-39,1924,25.174340333983057
STAT,1828,83,na,1911,487.5221253610726
STAT,1890,43,45-49,1933,3.6627996425836153
STAT,1834,41,15-19,1875,0.022446984425940352
STAT,1843,53,25-29,1896,0.0048820487667532945
STAT,1902,33,20-24,1935,7.67483114206924
STAT,1828,26,30-34,1854,124.47205710126525
SIM,1918,48,45-49,1966,2
SIM,1925,19,35-39,1944,11
STAT,1878,30,15-19,1908,0.30279510543259847
STAT,1919,31,25-29,1950,20.217158385934756
SIM,1838,44,50-100,1882,3
STAT,1906,37,na,1943,6988.219841607501
STAT,1892,77,na,1969,3040.751372810212
STAT,1869,47,35-39,1916,0.2726942659413359
STAT,1874,31,50-100,1905,1.9024607652275172
SIM,1873,45,na,1918,4787
SIM,1903,27,35-39,1930,40
STAT,1833,54,45-49,1887,0.01893062172052972
SIM,1927,31,25-29,1958,35
STAT,1867,51,20-24,1918,0.0014023968631820107
STAT,1921,17,35-39,1938,9.657594156712689
SIM,1913,19,50-100,1932,1
SIM,1811,92,na,1903,27
STAT,1823,32,40-44,1855,24.83766356581864
STAT,1905,19,50-100,1924,0.14232714528712614
STAT,1896,44,25-29,1940,0.11729827192741026
STAT,1891,40,25-29,1931,1.6192448693027264
SIM,1863,34,50-100,1897,5
SIM,1914,37,20-24,1951,1
SIM,1938,14,na,1952,7926
SIM,1847,43,50-100,1890,4
SIM,1866,16,15-19,1882,9
STAT,1872,17,50-100,1889,0.09976789886492457
STAT,1860,42,20-24,1902,0.260145850412971
STAT,1930,32,50-100,1962,2.1549267028741914
STAT,1928,26,35-39,1954,37.47857432358286
STAT,1950,15,20-24,1965,323.90532052341956
SIM,1922,46,45-49,1968,1
STAT,1864,53,45-49,1917,0.025778739368198425
STAT,1890,23,40-44,1913,5.121040658870294
STAT,1875,42,15-19,1917,0.028680137463570277
SIM,1839,24,40-44,1863,4
STAT,1836,24,15-19,1860,5.707339196709854
STAT,1848,47,15-19,1895,6.528245880492275E-4
STAT,1841,40,45-49,1881,2.3150469261445297
STAT,1857,52,40-44,1909,0.016484369132285962
STAT,1871,19,35-39,1890,1.095088735800511
SIM,1857,93,na,1950,48
SIM,1832,91,na,1923,71
SIM,1849,20,35-39,1869,13
STAT,1839,43,50-100,1882,1.7164464655357154
SIM,1867,27,20-24,1894,24
SIM,1825,30,50-100,1855,2
STAT,1860,47,15-19,1907,6.529741238453969E-4
SIM,1899,19,30-34,1918,6
SIM,1873,43,35-39,1916,6
SIM,1872,30,20-24,1902,6
STAT,1910,12,na,1922,7906.170684685631
STAT,1880,26,35-39,1906,20.59924920539043
STAT,1934,30,50-100,1964,2.2827663572404044
SIM,1885,30,na,1915,5057
SIM,1857,32,45-49,1889,3
SIM,1919,33,40-44,1952,11
STAT,1817,50,na,1867,2817.4004378020963
STAT,1883,47,50-100,1930,0.4850655471893318
STAT,1816,43,50-100,1859,5.595361884805582
SIM,1855,64,na,1919,2984
STAT,1856,108,na,1964,0.017261668460058048
SIM,1891,47,50-100,1938,1
STAT,1851,35,20-24,1886,1.2330973542841073
STAT,1874,48,20-24,1922,0.02450317761072804
STAT,1887,22,na,1909,5342.154464426141
SIM,1872,60,na,1932,3943
SIM,1949,19,20-24,1968,327
STAT,1890,22,50-100,1912,1.0052669463800543
SIM,1821,35,35-39,1856,20
SIM,1824,43,50-100,1867,3
STAT,1916,33,15-19,1949,0.26681373069737585
SIM,1887,44,40-44,1931,9
SIM,1894,22,20-24,1916,182
SIM,1835,40,45-49,1875,3
STAT,1865,43,35-39,1908,3.298500464505493
SIM,1936,26,35-39,1962,32
SIM,1854,41,25-29,1895,2
STAT,1888,32,50-100,1920,2.1871378079824346
STAT,1894,31,45-49,1925,4.54265534694583
STAT,1855,82,na,1937,703.5756873128876
STAT,1870,33,50-100,1903,1.8090899376318315
SIM,1844,17,25-29,1861,10
STAT,1910,38,40-44,1948,2.878231162156664
SIM,1850,20,50-100,1870,1
SIM,1903,60,na,1963,5990
STAT,1849,32,45-49,1881,2.9066388077816754
STAT,1827,40,45-49,1867,2.948549026378693
STAT,1898,15,40-44,1913,0.5022126670978616
STAT,1905,52,na,1957,6329.18137615498
STAT,1841,33,50-100,1874,1.5963068098274955
STAT,1886,22,20-24,1908,146.91747921472984
STAT,1818,38,50-100,1856,7.617289951291119
STAT,1842,66,na,1908,2440.181908797209
STAT,1845,37,30-34,1882,8.628836997671717
STAT,1887,78,na,1965,2411.2970480118306
STAT,1847,45,40-44,1892,0.26356905421616084
SIM,1887,46,45-49,1933,1
STAT,1829,44,50-100,1873,1.685948035198026
SIM,1933,34,50-100,1967,3
STAT,1846,56,na,1902,3124.1260432557383
SIM,1864,27,35-39,1891,19
STAT,1920,46,50-100,1966,0.5060864696310475
STAT,1884,39,35-39,1923,13.963354675089883
SIM,1945,18,na,1963,8405
STAT,1947,21,45-49,1968,2.5689347814620778
SIM,1901,23,15-19,1924,8
STAT,1913,15,50-100,1928,0.15546351681018733
SIM,1842,34,20-24,1876,6
STAT,1850,50,40-44,1900,0.016373690074978523
SIM,1901,3,na,1904,7546
STAT,1924,21,50-100,1945,1.5723898232820352
STAT,1886,36,35-39,1922,15.151638709166017
SIM,1889,43,45-49,1932,8
SIM,1848,19,20-24,1867,36
SIM,1840,37,20-24,1877,5
SIM,1825,37,25-29,1862,8
STAT,1840,31,40-44,1871,7.703964613878545
SIM,1903,31,25-29,1934,40
STAT,1819,45,35-39,1864,0.6054644391098823
STAT,1863,17,25-29,1880,11.431723368428083
SIM,1844,42,30-34,1886,4
STAT,1895,73,na,1968,3860.786128782138
STAT,1936,28,50-100,1964,1.9232867246113328
STAT,1836,31,20-24,1867,4.591256405418088
SIM,1862,39,na,1901,4253
SIM,1871,17,25-29,1888,18
SIM,1875,25,45-49,1900,3
STAT,1892,47,15-19,1939,5.678077485675721E-4
STAT,1852,32,50-100,1884,1.5119885811923552
STAT,1920,47,45-49,1967,0.485098553500202
STAT,1854,51,na,1905,3316.571654168163
STAT,1899,63,na,1962,5266.885215853652
STAT,1817,48,35-39,1865,0.6656774571445628
SIM,1919,23,30-34,1942,84
STAT,1823,34,45-49,1857,7.77553452328946
SIM,1875,81,na,1956,1125
SIM,1892,22,40-44,1914,6
STAT,1856,27,35-39,1883,15.580022919628403
STAT,1836,42,30-34,1878,1.8188536987367263
SIM,1885,49,45-49,1934,2
SIM,1917,15,20-24,1932,55
SIM,1949,16,50-100,1965,2
STAT,1883,88,na,1971,760.437942727794
SIM,1855,32,35-39,1887,27
SIM,1892,28,25-29,1920,131
STAT,1834,45,30-34,1879,0.1540655057724137
STAT,1841,26,50-100,1867,1.1611425608529977
SIM,1890,25,40-44,1915,13
STAT,1844,104,na,1948,0.10771483173015917
SIM,1808,51,na,1859,2653
SIM,1922,28,50-100,1950,3
STAT,1825,31,45-49,1856,6.8576768398611225
STAT,1911,37,na,1948,7341.022194771379
STAT,1817,37,25-29,1854,21.557860321483716
STAT,1852,27,20-24,1879,21.777989457055746
SIM,1878,20,50-100,1898,1
STAT,1939,29,20-24,1968,37.028956043996814
STAT,1877,49,45-49,1926,0.48459558912731077
SIM,1892,39,35-39,1931,35
STAT,1884,28,25-29,1912,84.06352565454127
SIM,1873,28,45-49,1901,1
STAT,1892,43,50-100,1935,2.6517281004871007
STAT,1894,44,15-19,1938,0.0024543990892043712
STAT,1824,53,na,1877,2517.4412582059863
STAT,1834,34,20-24,1868,4.514224501489879
SIM,1832,27,15-19,1859,1
SIM,1901,34,25-29,1935,24
SIM,1853,78,na,1931,1109
STAT,1858,35,45-49,1893,3.168389491569381
STAT,1847,32,35-39,1879,18.12513450745913
STAT,1812,68,na,1880,1703.3313144196104
STAT,1894,46,40-44,1940,0.25125498334629864
SIM,1908,20,20-24,1928,215
SIM,1831,34,45-49,1865,2
STAT,1884,22,40-44,1906,4.155678433407091
STAT,1831,42,25-29,1873,1.0168210461776803
SIM,1886,25,20-24,1911,28
STAT,1919,23,35-39,1942,20.754738697792423
SIM,1906,19,na,1925,7380
SIM,1848,42,45-49,1890,7
STAT,1763,93,na,1856,5.996229638399999
STAT,1893,15,15-19,1908,15.26230924055789
SIM,1898,50,na,1948,6121
STAT,1833,50,35-39,1883,0.012155856967497233
STAT,1862,21,20-24,1883,122.65544995143836
STAT,1899,36,45-49,1935,5.542804171328926
STAT,1819,47,30-34,1866,0.4062204162382269
STAT,1851,46,15-19,1897,6.218330281096665E-4
SIM,1851,27,25-29,1878,102
SIM,1853,35,35-39,1888,17
STAT,1927,42,25-29,1969,0.18084506512674242
STAT,1829,52,40-44,1881,0.01460228311566289
SIM,1838,37,35-39,1875,19
STAT,1825,94,na,1919,23.124605717741623
STAT,1843,27,25-29,1870,72.92580296791863
STAT,1832,37,20-24,1869,1.2698158236185122
SIM,1834,24,15-19,1858,4
SIM,1865,63,na,1928,3266
SIM,1857,42,40-44,1899,6
STAT,1896,43,40-44,1939,0.4134724141848209
STAT,1936,20,30-34,1956,55.544600583734486
SIM,1910,24,na,1934,7490
SIM,1894,60,na,1954,5068
STAT,1874,12,na,1886,5406.131778711151
STAT,1881,37,50-100,1918,2.3966536603239246
SIM,1914,38,na,1952,7682
SIM,1851,38,35-39,1889,20
SIM,1870,21,20-24,1891,131
SIM,1907,44,na,1951,6809
STAT,1873,30,na,1903,4936.205731129056
STAT,1949,20,40-44,1969,7.928816908545088
SIM,1825,31,40-44,1856,10
STAT,1769,90,na,1859,37.494835921056534
STAT,1890,25,45-49,1915,2.7556395138720906
STAT,1923,22,na,1945,8578.654930998655
STAT,1770,87,na,1857,90.11094466069002
SIM,1861,73,na,1934,2126
STAT,1841,25,na,1866,3955.074457592374
STAT,1923,37,15-19,1960,0.04492344209476244
STAT,1816,58,na,1874,2405.773410153843
STAT,1927,31,15-19,1958,0.31938967239283006
STAT,1897,20,25-29,1917,155.46474265236247
STAT,1860,24,20-24,1884,114.84266614539688
STAT,1897,39,45-49,1936,1.14990181289838
STAT,1821,39,40-44,1860,15.193983870205896
SIM,1853,37,30-34,1890,8
STAT,1878,25,20-24,1903,24.91303747875664
STAT,1843,38,35-39,1881,10.416845180700383
SIM,1836,21,15-19,1857,5
SIM,1880,9,na,1889,5866
STAT,1849,42,40-44,1891,3.553520231639087
STAT,1879,46,45-49,1925,0.49996005949609085
STAT,1760,100,na,1860,0.05263502362667981
STAT,1817,99,na,1916,1.9102024593915303
STAT,1855,40,15-19,1895,0.021034441698219726
STAT,1865,32,50-100,1897,1.681137637298156
SIM,1869,27,40-44,1896,10
SIM,1903,20,15-19,1923,10
STAT,1853,43,15-19,1896,0.021692093477626528
STAT,1831,53,35-39,1884,0.011363507590157081
STAT,1851,21,45-49,1872,1.3002315878655974
SIM,1902,29,na,1931,6927
STAT,1850,61,na,1911,2865.122424999773
SIM,1818,49,50-100,1867,2
STAT,1863,28,50-100,1891,1.1269317898136162
STAT,1885,9,na,1894,5215.9810005147865
SIM,1815,44,50-100,1859,3
SIM,1855,34,30-34,1889,43
STAT,1939,16,15-19,1955,91.78252347146375
STAT,1948,14,na,1962,9075.038413317126
STAT,1772,111,na,1883,0.0019988001149457806
STAT,1897,28,35-39,1925,25.956960500971043
STAT,1845,35,35-39,1880,12.8480166428888
STAT,1821,37,45-49,1858,7.805150075121716
SIM,1857,68,na,1925,2723
STAT,1847,34,30-34,1881,27.85203972462522
STAT,1925,34,15-19,1959,0.3077307905719039
SIM,1947,16,15-19,1963,115
STAT,1820,63,na,1883,2039.2060495981777
SIM,1852,37,na,1889,3836
STAT,1898,40,40-44,1938,0.43120030628320655
STAT,1915,27,na,1942,7717.577798589264
STAT,1862,32,30-34,1894,30.138985825690124
STAT,1902,60,na,1962,5747.738792472742
STAT,1919,36,40-44,1955,3.250284651496617
SIM,1869,16,30-34,1885,4
STAT,1880,51,35-39,1931,0.018404039032527894
SIM,1841,37,50-100,1878,3
SIM,1870,38,45-49,1908,6
SIM,1920,34,35-39,1954,33
SIM,1879,49,45-49,1928,1
STAT,1917,28,30-34,1945,82.69001207684596
STAT,1838,45,45-49,1883,0.3371298347551841
STAT,1855,54,35-39,1909,0.012624902732643153
STAT,1873,22,35-39,1895,11.974732598993073
SIM,1819,35,na,1854,3262
STAT,1851,49,25-29,1900,0.08742620036972555
SIM,1925,39,40-44,1964,3
STAT,1805,52,25-29,1857,0.0278112470075689
SIM,1860,32,na,1892,4148
STAT,1861,51,25-29,1912,0.005982641758184632
STAT,1936,29,na,1965,7234.8903179919
SIM,1877,22,15-19,1899,7
SIM,1872,32,40-44,1904,13
SIM,1822,41,40-44,1863,6
STAT,1870,43,20-24,1913,0.3126240486126596
SIM,1924,32,50-100,1956,5
STAT,1879,27,na,1906,5041.475724413734
SIM,1823,40,na,1863,3214
STAT,1860,21,40-44,1881,3.548555672129853
STAT,1888,49,20-24,1937,0.015820675303332764
STAT,1933,23,50-100,1956,1.7623246655361637
SIM,1843,19,15-19,1862,9
STAT,1843,30,50-100,1873,1.575384382790433
SIM,1922,31,35-39,1953,29
SIM,1887,40,30-34,1927,8
STAT,1899,39,25-29,1938,1.702329327931669
SIM,1879,38,35-39,1917,18
STAT,1917,39,40-44,1956,3.1209123525190083
SIM,1832,27,45-49,1859,2
SIM,1877,38,30-34,1915,19
STAT,1872,54,35-39,1926,0.016993628412552125
SIM,1891,12,na,1903,6659
SIM,1911,32,50-100,1943,3
SIM,1786,90,na,1876,41
STAT,1862,38,45-49,1900,3.4240910740491293
STAT,1839,38,15-19,1877,0.10369789830409606
STAT,1841,27,45-49,1868,2.000904860323358
SIM,1799,81,na,1880,339
SIM,1846,45,45-49,1891,2
SIM,1927,23,35-39,1950,26
SIM,1936,29,45-49,1965,6
SIM,1890,70,na,1960,3925
STAT,1895,25,20-24,1920,31.082297132785172
SIM,1895,26,na,1921,6670
STAT,1938,27,50-100,1965,1.9918693152145683
SIM,1886,65,na,1951,3409
STAT,1869,38,30-34,1907,10.377930348830308
SIM,1802,94,na,1896,10
STAT,1878,16,30-34,1894,3.370206911675066
STAT,1831,23,na,1854,3397.892399584448
STAT,1860,38,35-39,1898,11.542640209387919
STAT,1879,40,30-34,1919,2.453153763564323
SIM,1822,42,25-29,1864,2
STAT,1820,52,20-24,1872,0.002640907026336208
STAT,1886,38,30-34,1924,11.305996470525912
STAT,1912,47,40-44,1959,0.3060969862813014
STAT,1890,20,15-19,1910,8.18113243476451
STAT,1904,67,na,1971,5337.587230048906
STAT,1947,23,40-44,1970,7.671692233224584
SIM,1934,18,30-34,1952,33
SIM,1811,55,na,1866,2292
STAT,1828,34,20-24,1862,5.706573519223621
STAT,1891,18,45-49,1909,0.1626426885249598
STAT,1841,16,35-39,1857,1.0328933132416505
STAT,1840,99,na,1939,2.733684081125938
STAT,1881,33,25-29,1914,19.91001977264178
SIM,1856,27,na,1883,4182
SIM,1888,20,25-29,1908,153
STAT,1883,36,50-100,1919,2.447902729800024
SIM,1827,47,30-34,1874,1
STAT,1892,22,45-49,1914,1.763035272418432
STAT,1810,45,15-19,1855,0.0027119033239058274
STAT,1832,64,na,1896,2266.3289261574823
SIM,1894,38,30-34,1932,19
STAT,1860,27,25-29,1887,70.12119573599753
STAT,1903,41,30-34,1944,0.23061020216339356
SIM,1875,25,15-19,1900,1
SIM,1880,43,25-29,1923,4
SIM,1868,48,30-34,1916,1
STAT,1837,24,20-24,1861,123.96407038881176
STAT,1896,41,15-19,1937,0.0025686292353939424
STAT,1928,29,45-49,1957,4.293659954740497
STAT,1829,84,na,1913,393.70991503221694
STAT,1854,24,20-24,1878,122.3495647720825
STAT,1882,28,45-49,1910,2.176717560625579
SIM,1934,29,40-44,1963,19
STAT,1879,41,15-19,1920,0.029304949660617675
STAT,1875,46,30-34,1921,0.20185270745910128
STAT,1943,18,30-34,1961,26.095081991295704
SIM,1902,13,na,1915,7596
SIM,1879,30,25-29,1909,21
SIM,1915,18,20-24,1933,74
SIM,1951,18,30-34,1969,30
STAT,1880,19,50-100,1899,0.10367481456446576
SIM,1903,54,na,1957,6256
SIM,1898,30,35-39,1928,35
SIM,1874,32,45-49,1906,5
STAT,1820,79,na,1899,782.653494375617
SIM,1831,31,40-44,1862,14
SIM,1896,30,30-34,1926,68
STAT,1875,35,20-24,1910,1.618088459165526
STAT,1835,19,15-19,1854,19.844869484708425
STAT,1924,18,20-24,1942,325.1201600945276
STAT,1834,31,40-44,1865,7.4716666058929135
STAT,1830,24,35-39,1854,31.162193218613226
SIM,1833,31,45-49,1864,4
STAT,1870,41,25-29,1911,1.2790477850956776
STAT,1891,18,15-19,1909,14.776091242521268
SIM,1932,18,20-24,1950,338
STAT,1850,17,15-19,1867,11.119159533744389
SIM,1894,36,35-39,1930,24
SIM,1863,43,25-29,1906,3
STAT,1844,73,na,1917,1918.1184269434877
SIM,1847,9,na,1856,4685
STAT,1873,24,30-34,1897,36.32298399156635
SIM,1911,47,45-49,1958,1
STAT,1913,15,40-44,1928,0.5803972705628
STAT,1927,31,50-100,1958,2.0549409948351123
SIM,1845,24,20-24,1869,122
SIM,1823,37,45-49,1860,8
SIM,1864,7,na,1871,5413
STAT,1861,53,20-24,1914,0.001220531948129103
SIM,1883,35,20-24,1918,2
STAT,1872,43,25-29,1915,1.2939965862061953
STAT,1820,50,25-29,1870,0.01319137571709421
SIM,1888,40,50-100,1928,4
STAT,1807,81,na,1888,483.8079125081953
STAT,1862,86,na,1948,383.00294359640213
STAT,1853,10,na,1863,4600.522071940861
SIM,1862,24,20-24,1886,134
SIM,1920,26,na,1946,8473
STAT,1782,72,na,1854,1036.0000000000002
SIM,1883,22,45-49,1905,2
SIM,1900,26,50-100,1926,2
STAT,1853,45,40-44,1898,0.2735733755985821
STAT,1803,52,20-24,1855,0.005421155033925466
SIM,1890,28,45-49,1918,3
STAT,1922,41,40-44,1963,0.5804966533542049
SIM,1921,15,40-44,1936,5
SIM,1892,25,20-24,1917,35
SIM,1835,19,40-44,1854,1
STAT,1830,26,30-34,1856,62.76343046961495
SIM,1877,36,35-39,1913,20
STAT,1959,3,na,1962,10390.165987201735
SIM,1891,20,50-100,1911,1
SIM,1945,19,45-49,1964,1
SIM,1849,57,na,1906,3262
STAT,1922,17,50-100,1939,0.8754579067120655
STAT,1854,26,50-100,1880,1.1378740374697918
STAT,1819,106,na,1925,0.012704781182623439
STAT,1847,48,20-24,1895,0.018062261814739997
STAT,1861,40,45-49,1901,2.5412506859208994
STAT,1843,21,40-44,1864,3.6904857075486412
STAT,1881,32,40-44,1913,8.465623077081165
STAT,1869,36,35-39,1905,13.907898485930787
STAT,1849,48,25-29,1897,0.08996675832681396
STAT,1909,18,25-29,1927,17.127380209018487
SIM,1851,21,40-44,1872,5
SIM,1930,41,40-44,1971,1
STAT,1861,45,na,1906,3819.706157280693
SIM,1841,53,na,1894,3018
STAT,1943,29,40-44,1972,10.015271045478064
STAT,1814,41,40-44,1855,13.489537354936406
SIM,1852,43,50-100,1895,4
STAT,1907,18,20-24,1925,52.48682893243943
SIM,1849,33,na,1882,4034
STAT,1936,32,25-29,1968,18.134749057825143
STAT,1862,37,30-34,1899,9.199923778694721
STAT,1821,34,40-44,1855,21.801083290759024
STAT,1835,41,50-100,1876,1.6613545546494
SIM,1890,28,20-24,1918,34
STAT,1880,17,25-29,1897,12.05637852469518
STAT,1934,24,15-19,1958,14.440099627387987
SIM,1826,29,na,1855,3478
SIM,1843,41,50-100,1884,7
SIM,1870,32,30-34,1902,44
SIM,1808,48,35-39,1856,1
STAT,1892,1,na,1893,6881.683862609479
STAT,1919,37,50-100,1956,0.9107663122430711
STAT,1891,43,na,1934,5728.0582609750745
STAT,1857,19,20-24,1876,32.416486759017474
SIM,1919,15,25-29,1934,25
SIM,1875,39,35-39,1914,24
SIM,1847,27,35-39,1874,28
STAT,1910,23,15-19,1933,10.068522676670014
SIM,1842,37,25-29,1879,9
STAT,1867,39,35-39,1906,13.243255064146643
STAT,1897,36,40-44,1933,11.874569305826617
STAT,1858,38,25-29,1896,4.51057681254795
STAT,1859,16,20-24,1875,33.27669701604578
STAT,1847,48,50-100,1895,0.36967427717197326
SIM,1890,17,35-39,1907,1
STAT,1819,82,na,1901,488.22097621773435
SIM,1842,48,35-39,1890,1
STAT,1915,15,45-49,1930,0.21215205757159242
SIM,1919,26,35-39,1945,49
STAT,1811,86,na,1897,206.24819821172755
STAT,1815,92,na,1907,38.713117980995634
STAT,1834,37,25-29,1871,4.767254882106859
SIM,1938,21,45-49,1959,3
SIM,1864,24,30-34,1888,44
SIM,1837,48,na,1885,3082
STAT,1838,40,15-19,1878,0.022425160004365036
SIM,1903,43,50-100,1946,2
STAT,1863,50,20-24,1913,0.0013233153698258904
SIM,1838,45,40-44,1883,1
SIM,1942,24,15-19,1966,12
STAT,1926,29,40-44,1955,11.202076230188753
STAT,1927,6,na,1933,10063.339522455903
STAT,1832,88,na,1920,178.97906982434029
STAT,1847,37,35-39,1884,11.186337906243402
STAT,1823,47,20-24,1870,0.03707836919190551
STAT,1872,40,50-100,1912,2.1659601872894654
SIM,1902,30,50-100,1932,3
STAT,1882,47,na,1929,4405.693487249196
STAT,1919,20,30-34,1939,63.927521301893776
STAT,1873,86,na,1959,639.340827897212
SIM,1847,38,45-49,1885,7
STAT,1956,16,15-19,1972,121.29903417769661
STAT,1814,51,na,1865,2498.194864129078
STAT,1863,16,40-44,1879,0.37116398590649713
STAT,1839,27,35-39,1866,18.97991587901048
SIM,1854,17,25-29,1871,12
STAT,1864,34,30-34,1898,31.250330230937664
STAT,1870,2,na,1872,6587.698017240433
SIM,1838,34,30-34,1872,45
STAT,1940,21,35-39,1961,19.379845324723085
STAT,1874,54,45-49,1928,0.029185168747228447
STAT,1926,18,30-34,1944,30.097142573800376
STAT,1858,46,30-34,1904,0.15283639628961015
STAT,1916,52,na,1968,7482.093278429417
STAT,1847,48,45-49,1895,0.3552244688756844
STAT,1833,89,na,1922,138.10628061882633
STAT,1890,38,20-24,1928,1.8908374057276813
STAT,1906,22,40-44,1928,6.132533145307411
STAT,1930,15,40-44,1945,3.669046305858546
SIM,1864,35,40-44,1899,15
STAT,1874,34,50-100,1908,1.8784959329096118
STAT,1899,49,20-24,1948,0.018339676538652677
SIM,1845,43,na,1888,3765
STAT,1890,42,na,1932,5690.551774250061
STAT,1882,28,20-24,1910,22.99917520836097
STAT,1934,35,25-29,1969,2.7492702317954376
SIM,1927,37,50-100,1964,4
STAT,1869,25,na,1894,4701.966403684367
STAT,1898,22,na,1920,6463.885330463306
STAT,1791,89,na,1880,76.47545714930234
STAT,1896,46,45-49,1942,0.3559724898576826
STAT,1846,17,25-29,1863,10.903556286450112
SIM,1820,91,na,1911,45
STAT,1936,23,35-39,1959,18.178405742102704
STAT,1874,71,na,1945,2760.253960307209
STAT,1938,31,45-49,1969,3.1978906875825706
STAT,1839,38,45-49,1877,3.6812749520017887
SIM,1855,37,35-39,1892,26
SIM,1869,19,35-39,1888,2
STAT,1877,46,40-44,1923,0.3600528468977099
STAT,1865,28,15-19,1893,0.8295282647370983
STAT,1916,25,50-100,1941,2.0925935048473057
SIM,1938,26,15-19,1964,2
STAT,1830,27,45-49,1857,2.561964784801177
STAT,1864,35,45-49,1899,3.6330392859819454
SIM,1888,28,35-39,1916,33
SIM,1900,7,na,1907,7631
STAT,1856,24,30-34,1880,31.774457698507256
SIM,1929,33,40-44,1962,18
STAT,1836,47,30-34,1883,0.13472200828444866
STAT,1818,84,na,1902,341.2934503307071
STAT,1893,18,25-29,1911,14.468127696984007
STAT,1848,63,na,1911,2925.7365984288454
SIM,1869,93,na,1962,91
STAT,1867,25,15-19,1892,0.863966076117515
STAT,1908,34,15-19,1942,0.24304013613297237
SIM,1828,71,na,1899,1638
SIM,1882,18,15-19,1900,8
SIM,1834,38,35-39,1872,20
SIM,1836,47,na,1883,2983
STAT,1938,20,35-39,1958,18.836800773358046
SIM,1898,49,25-29,1947,1
STAT,1871,17,50-100,1888,0.0989378169901675
STAT,1903,44,35-39,1947,0.3567114458564909
STAT,1858,81,na,1939,851.3895458873163
STAT,1812,45,25-29,1857,0.41390323756588904
STAT,1897,25,30-34,1922,68.44332526580773
SIM,1888,39,45-49,1927,7
STAT,1841,84,na,1925,482.67096405244513
SIM,1834,27,25-29,1861,77
SIM,1911,44,35-39,1955,1
STAT,1832,49,15-19,1881,5.468489530900513E-4
SIM,1908,25,20-24,1933,38
STAT,1812,42,15-19,1854,0.1130695436413391
STAT,1918,19,50-100,1937,0.8190241053085282
SIM,1872,97,na,1969,49
SIM,1919,29,45-49,1948,4
STAT,1908,45,25-29,1953,0.09837611172835768
SIM,1868,49,45-49,1917,1
SIM,1881,22,35-39,1903,12
SIM,1944,23,35-39,1967,24
SIM,1882,35,na,1917,4999
STAT,1903,42,na,1945,6660.856110355165
SIM,1885,46,40-44,1931,1
SIM,1889,14,na,1903,6568
SIM,1886,49,na,1935,4549
STAT,1834,48,35-39,1882,0.19512259204084215
STAT,1849,45,45-49,1894,0.3770260718163496
SIM,1836,37,30-34,1873,14
STAT,1826,38,35-39,1864,16.199676816930857
STAT,1901,47,35-39,1948,0.22224106859566103
STAT,1971,0,na,1971,10130.606175561363
STAT,1861,17,20-24,1878,34.253734242214314
STAT,1936,21,15-19,1957,10.283746511707632
SIM,1858,29,30-34,1887,48
SIM,1927,36,40-44,1963,5
STAT,1931,19,50-100,1950,0.9851203700516734
STAT,1788,69,na,1857,1395.798826934344
SIM,1944,2,na,1946,8922
SIM,1864,38,45-49,1902,6
SIM,1840,24,45-49,1864,2
SIM,1812,96,na,1908,3
SIM,1881,20,15-19,1901,6
STAT,1832,24,45-49,1856,1.274052502949259
STAT,1895,28,30-34,1923,66.03618816354648
SIM,1944,21,15-19,1965,7
STAT,1893,29,35-39,1922,24.523544029866805
STAT,1850,17,45-49,1867,0.12239028380536367
STAT,1877,76,na,1953,1986.855346564966
SIM,1849,35,45-49,1884,8
STAT,1914,31,35-39,1945,18.656972605462094
STAT,1810,48,25-29,1858,0.3685513685871139
SIM,1795,91,na,1886,33
SIM,1906,15,15-19,1921,15
STAT,1833,111,na,1944,1.4110225759513497E-4
STAT,1951,18,na,1969,8848.609171049822
SIM,1878,14,na,1892,5613
SIM,1877,34,50-100,1911,1
STAT,1828,37,30-34,1865,10.733031093721022
SIM,1870,50,na,1920,4266
STAT,1881,30,15-19,1911,0.2802258877001845
STAT,1840,34,45-49,1874,3.0028017771265785
SIM,1908,39,40-44,1947,5
STAT,1881,35,45-49,1916,3.928405626000001
SIM,1837,91,na,1928,45
STAT,1888,45,50-100,1933,0.5921079868932341
STAT,1927,30,30-34,1957,39.17992623334759
STAT,1876,19,30-34,1895,3.3115149744879764
SIM,1840,21,35-39,1861,13
SIM,1913,26,50-100,1939,4
SIM,1824,46,50-100,1870,1
STAT,1860,24,45-49,1884,1.1620863509033503
STAT,1864,48,20-24,1912,0.02139150939834582
STAT,1900,16,15-19,1916,16.66721763995709
SIM,1827,48,45-49,1875,2
STAT,1821,51,50-100,1872,0.04337539235499623
STAT,1876,28,20-24,1904,24.41909735606275
SIM,1823,33,50-100,1856,2
STAT,1855,51,30-34,1906,0.009019001029908423
STAT,1865,28,45-49,1893,2.0300257137764124
STAT,1886,39,45-49,1925,4.207224815580347
STAT,1879,43,na,1922,4847.171434199203
STAT,1893,15,45-49,1908,0.16799456414023295
STAT,1905,26,50-100,1931,1.874813018953358
SIM,1879,33,50-100,1912,2
STAT,1890,58,na,1948,4875.086165837042
SIM,1939,19,15-19,1958,87
SIM,1938,26,45-49,1964,4
SIM,1846,25,50-100,1871,1
STAT,1860,35,30-34,1895,8.823962886795236
STAT,1814,44,45-49,1858,8.047919013819133
STAT,1932,39,na,1971,10188.009766338937
STAT,1888,63,na,1951,4259.250446048363
SIM,1822,44,45-49,1866,4
STAT,1864,30,15-19,1894,0.2591564507050562
SIM,1903,34,35-39,1937,22
STAT,1828,37,25-29,1865,5.798304122250188
SIM,1965,5,na,1970,10577
SIM,1908,28,30-34,1936,95
SIM,1877,29,na,1906,4874
SIM,1895,18,25-29,1913,23
STAT,1894,42,50-100,1936,0.19009629450049634
SIM,1869,5,na,1874,5437
STAT,1908,41,50-100,1949,0.22092688609694922
SIM,1894,39,45-49,1933,7
SIM,1845,15,30-34,1860,4
STAT,1889,17,45-49,1906,0.16266824785359396
SIM,1872,48,20-24,1920,1
SIM,1898,46,45-49,1944,1
SIM,1945,16,35-39,1961,12
STAT,1789,67,na,1856,1509.1549245599997
STAT,1865,35,na,1900,4363.827288323098
STAT,1871,25,35-39,1896,19.49206930865896
SIM,1884,28,20-24,1912,27
SIM,1828,27,25-29,1855,81
SIM,1839,29,20-24,1868,4
SIM,1885,43,30-34,1928,3
STAT,1804,92,na,1896,28.018347516674485
STAT,1857,40,na,1897,3675.0587741435397
SIM,1881,48,50-100,1929,3
STAT,1880,17,30-34,1897,3.391073618887975
SIM,1851,12,na,1863,4697
STAT,1854,27,25-29,1881,67.98136274409072
STAT,1877,32,20-24,1909,5.668741819803867
STAT,1918,41,15-19,1959,0.003301754504813764
STAT,1838,44,30-34,1882,1.6140052926569308
STAT,1944,24,na,1968,7957.206574917013
STAT,1837,26,40-44,1863,5.398772070986969
SIM,1862,27,25-29,1889,76
SIM,1922,6,na,1928,9869
STAT,1877,43,30-34,1920,2.3936193791844635
STAT,1873,48,50-100,1921,0.49765239390714855
SIM,1946,20,35-39,1966,26
SIM,1837,32,na,1869,3621
STAT,1858,54,50-100,1912,0.023124164986194237
STAT,1911,18,40-44,1929,0.5639669180372651
STAT,1919,17,na,1936,8213.159345880445
SIM,1885,32,20-24,1917,6
SIM,1823,34,40-44,1857,6
STAT,1937,16,35-39,1953,8.266306422643709
SIM,1845,26,40-44,1871,8
SIM,1924,16,na,1940,9254
STAT,1861,61,na,1922,3141.1920823700852
SIM,1846,44,30-34,1890,4
STAT,1865,75,na,1940,1888.8685874538385
SIM,1914,22,40-44,1936,7
STAT,1876,78,na,1954,1632.0944253532537
SIM,1886,25,na,1911,5018
SIM,1853,38,45-49,1891,8
STAT,1879,45,30-34,1924,0.2065264402476326
STAT,1877,60,na,1937,3999.6574973304505
STAT,1834,34,45-49,1868,2.912258153659566
STAT,1808,47,25-29,1855,0.366004874033942
STAT,1926,15,20-24,1941,337.2079063870396
SIM,1862,15,na,1877,4913
STAT,1845,15,na,1860,4523.75510160739
SIM,1866,29,na,1895,4602
STAT,1875,49,35-39,1924,0.2850310824696106
STAT,1922,44,45-49,1966,0.3844157367389778
STAT,1854,27,30-34,1881,40.46908651860429
SIM,1836,37,25-29,1873,7
STAT,1849,45,20-24,1894,0.019170817938538757
SIM,1862,27,30-34,1889,48
STAT,1891,5,na,1896,6542.115071280256
STAT,1894,49,45-49,1943,0.33816440482267074
STAT,1895,28,25-29,1923,110.92985901026721
STAT,1844,51,25-29,1895,0.005747414539244235
STAT,1882,25,40-44,1907,5.9334456457207665
SIM,1829,42,35-39,1871,8
STAT,1841,24,40-44,1865,3.7753193425835123
STAT,1881,41,30-34,1922,2.254400511790289
SIM,1881,25,45-49,1906,1
STAT,1870,81,na,1951,1072.2425970478298
STAT,1866,32,45-49,1898,3.2495772927805873
SIM,1798,56,na,1854,2091
SIM,1850,73,na,1923,1767
STAT,1945,26,40-44,1971,10.331403838290164
STAT,1837,28,50-100,1865,1.1363931889914478
SIM,1871,16,40-44,1887,1
SIM,1824,81,na,1905,615
STAT,1855,92,na,1947,62.804582970993
SIM,1927,20,30-34,1947,103
SIM,1833,58,na,1891,2533
STAT,1881,30,20-24,1911,5.319004344691368
STAT,1846,53,25-29,1899,0.005338223929278951
SIM,1842,34,45-49,1876,4
SIM,1861,46,25-29,1907,1
STAT,1887,18,25-29,1905,12.766428792812551
STAT,1874,51,35-39,1925,0.017887980645177777
SIM,1935,30,30-34,1965,54
SIM,1875,28,25-29,1903,99
STAT,1819,48,45-49,1867,0.9755817838334548
STAT,1929,42,35-39,1971,0.5266173175398055
SIM,1883,31,50-100,1914,2
STAT,1910,39,30-34,1949,3.486248794911448
STAT,1875,38,25-29,1913,5.957168344180209
STAT,1900,37,na,1937,6652.6466973675
SIM,1882,75,na,1957,2070
SIM,1953,13,na,1966,9951
STAT,1803,54,40-44,1857,0.07428795448661879
STAT,1788,103,na,1891,0.08927415992514534
SIM,1844,31,20-24,1875,5
STAT,1956,16,45-49,1972,1.3351569579760718
STAT,1855,42,40-44,1897,3.3875845541164042
SIM,1873,17,35-39,1890,1
STAT,1903,44,40-44,1947,0.443083902838642
STAT,1894,32,na,1926,6191.037788686231
SIM,1870,35,40-44,1905,15
STAT,1810,61,na,1871,2018.9433120857477
SIM,1834,24,45-49,1858,1
STAT,1835,27,20-24,1862,19.81126991999307
STAT,1865,17,35-39,1882,1.0374660750609237
SIM,1874,41,35-39,1915,4
STAT,1821,64,na,1885,1960.0733724104823
STAT,1947,20,30-34,1967,65.64413677826089
SIM,1879,35,30-34,1914,13
STAT,1866,41,35-39,1907,3.389683185734738
SIM,1896,33,35-39,1929,6
SIM,1883,38,25-29,1921,6
STAT,1870,45,40-44,1915,0.34284429577907455
SIM,1843,27,20-24,1870,24
SIM,1911,44,40-44,1955,1
STAT,1921,21,25-29,1942,211.29133509099506
SIM,1879,46,40-44,1925,1
STAT,1828,43,na,1871,3208.7143117488604
STAT,1848,16,45-49,1864,0.13356513823548666
STAT,1888,33,35-39,1921,24.07195198151705
STAT,1836,78,na,1914,1038.846814493575
STAT,1906,3,na,1909,7780.089691952246
SIM,1934,15,20-24,1949,347
STAT,1843,37,20-24,1880,1.2605928026991153
STAT,1907,16,na,1923,7515.3267722169185
SIM,1865,19,20-24,1884,37
SIM,1849,17,na,1866,4683
SIM,1826,38,50-100,1864,5
STAT,1917,24,15-19,1941,11.35362350299429
SIM,1899,26,45-49,1925,1
STAT,1823,33,30-34,1856,86.99348139920559
STAT,1825,41,40-44,1866,5.308487319025734
STAT,1858,35,20-24,1893,1.225164686120321
STAT,1853,45,35-39,1898,0.2237165459820463
SIM,1945,16,40-44,1961,4
STAT,1874,19,20-24,1893,36.46448675193086
STAT,1803,52,15-19,1855,1.8070500884323276E-4
STAT,1876,15,15-19,1891,12.454039831191071
SIM,1805,86,na,1891,120
SIM,1826,45,na,1871,3023
STAT,1915,28,20-24,1943,37.47319275042109
SIM,1820,41,30-34,1861,3
STAT,1901,47,40-44,1948,0.2717690775416777
STAT,1891,27,na,1918,5957.673885224201
SIM,1875,36,30-34,1911,15
STAT,1886,53,na,1939,4516.849367047276
STAT,1891,25,50-100,1916,1.607750632107765
STAT,1853,34,25-29,1887,16.345675554378836
SIM,1860,32,50-100,1892,3
SIM,1934,18,25-29,1952,125
STAT,1855,42,35-39,1897,2.727226551265705
STAT,1946,16,50-100,1962,0.839415835146572
SIM,1775,90,na,1865,18
STAT,1908,30,20-24,1938,4.690415550359246
SIM,1923,28,20-24,1951,43
SIM,1853,22,na,1875,4171
SIM,1875,25,20-24,1900,28
SIM,1865,42,45-49,1907,4
STAT,1791,92,na,1883,23.194760697551175
STAT,1937,16,40-44,1953,2.7554356337510066
SIM,1927,16,50-100,1943,2
STAT,1863,53,25-29,1916,0.006161385001920319
STAT,1874,51,40-44,1925,0.021874444852800986
SIM,1938,23,35-39,1961,27
STAT,1810,45,20-24,1855,0.08135717128165178
SIM,1780,74,na,1854,736
SIM,1892,37,15-19,1929,1
SIM,1784,88,na,1872,50
SIM,1866,28,50-100,1894,1
SIM,1869,101,na,1970,11
SIM,1880,42,40-44,1922,8
SIM,1893,75,na,1968,3344
SIM,1916,38,30-34,1954,7
STAT,1828,99,na,1927,2.3257741167536334
STAT,1820,101,na,1921,0.6388173275272954
STAT,1817,59,na,1876,2357.6658472982494
STAT,1885,41,45-49,1926,3.0223036435514476
SIM,1920,37,45-49,1957,3
STAT,1892,32,40-44,1924,10.96450253945408
STAT,1919,22,20-24,1941,245.85706600196667
SIM,1831,33,30-34,1864,42
SIM,1872,32,35-39,1904,30
SIM,1817,71,na,1888,1376
STAT,1842,47,na,1889,3350.155039121335
STAT,1862,47,35-39,1909,0.24054150451871967
STAT,1855,45,45-49,1900,0.3594204096581509
STAT,1862,35,40-44,1897,7.628215311949472
STAT,1901,5,na,1906,7409.512094079634
STAT,1921,24,35-39,1945,21.339270823829914
STAT,1819,43,15-19,1862,0.06188930606913298
STAT,1918,16,na,1934,8537.544224832847
STAT,1861,0,na,1861,6501.537948567791
SIM,1834,40,na,1874,3406
SIM,1888,36,40-44,1924,17
STAT,1868,37,50-100,1905,2.3591401212896748
SIM,1854,21,50-100,1875,1
SIM,1916,30,20-24,1946,6
STAT,1910,36,na,1946,7304.56100653507
SIM,1894,34,15-19,1928,1
SIM,1884,15,15-19,1899,13
SIM,1893,41,45-49,1934,8
STAT,1890,24,30-34,1914,43.635170876993
STAT,1909,17,40-44,1926,0.5542667791701217
SIM,1852,77,na,1929,1301
SIM,1908,28,25-29,1936,141
STAT,1886,34,15-19,1920,0.3010056372625311
SIM,1841,37,na,1878,3625
SIM,1868,27,50-100,1895,1
SIM,1849,39,30-34,1888,12
STAT,1877,17,na,1894,5296.595615307579
STAT,1917,23,25-29,1940,197.63982769875167
SIM,1862,98,na,1960,3
STAT,1908,17,na,1925,7571.488743410956
STAT,1910,34,30-34,1944,30.429196206083528
STAT,1839,24,30-34,1863,35.22457214949903
STAT,1853,46,25-29,1899,0.09139355174090896
STAT,1890,22,35-39,1912,14.3853683189873
STAT,1901,33,15-19,1934,0.40093990523755857
SIM,1820,49,40-44,1869,2
SIM,1927,22,20-24,1949,286
SIM,1894,22,15-19,1916,8
STAT,1810,110,na,1920,2.499071118880773E-4
SIM,1854,63,na,1917,2889
STAT,1919,20,25-29,1939,205.45204844787986
SIM,1913,13,na,1926,8359
STAT,1908,49,40-44,1957,0.28647065379983433
STAT,1863,19,45-49,1882,0.11850929385515442
STAT,1920,44,35-39,1964,0.44755860099419653
SIM,1918,2,na,1920,9211
STAT,1823,31,35-39,1854,66.19866582313229
SIM,1900,65,na,1965,5402
STAT,1839,35,40-44,1874,8.339502225067308
SIM,1861,34,25-29,1895,26
SIM,1916,49,40-44,1965,1
STAT,1812,49,40-44,1861,1.1494688747042776
STAT,1864,6,na,1870,5119.886587855213
SIM,1927,39,45-49,1966,4
STAT,1941,18,20-24,1959,281.95148825697873
STAT,1867,29,30-34,1896,47.289246491654346
STAT,1821,46,35-39,1867,0.41574156134267987
STAT,1875,35,45-49,1910,4.184526805685498
STAT,1908,38,30-34,1946,3.4314950657558145
STAT,1817,46,15-19,1863,0.0019622579007005226
STAT,1886,22,15-19,1908,7.0333297590658415
STAT,1808,82,na,1890,366.6409048530456
STAT,1828,26,50-100,1854,3.1619468085972544
STAT,1949,23,15-19,1972,12.539867179494552
SIM,1883,35,45-49,1918,5
SIM,1798,96,na,1894,1
STAT,1907,18,15-19,1925,17.569743606033654
STAT,1884,37,15-19,1921,0.1119873843656197
STAT,1912,37,45-49,1949,1.3441505841608494
SIM,1925,23,25-29,1948,265
SIM,1942,20,20-24,1962,247
SIM,1875,25,na,1900,5356
SIM,1901,37,35-39,1938,6
SIM,1828,55,na,1883,2715
STAT,1855,44,30-34,1899,1.7102235801274162
SIM,1833,41,40-44,1874,12
SIM,1824,41,na,1865,3387
STAT,1865,91,na,1956,120.31024475374107
STAT,1933,39,50-100,1972,1.1526259152382794
SIM,1847,24,30-34,1871,46
STAT,1821,35,25-29,1856,12.837951481619859
SIM,1890,28,15-19,1918,1
SIM,1884,19,30-34,1903,5
STAT,1848,101,na,1949,0.9356556368887419
SIM,1838,30,na,1868,3850
SIM,1879,36,45-49,1915,6
STAT,1870,43,15-19,1913,0.027184701347630954
STAT,1917,35,25-29,1952,2.0848642097418484
STAT,1859,51,45-49,1910,0.023440166856062185
STAT,1868,42,20-24,1910,0.3047877257531836
STAT,1930,18,45-49,1948,1.300896031121688
SIM,1816,44,45-49,1860,4
SIM,1847,35,40-44,1882,12
STAT,1854,11,na,1865,4397.725788521643
STAT,1858,25,na,1883,3902.254295876318
SIM,1831,31,35-39,1862,30
SIM,1823,37,15-19,1860,1
SIM,1811,71,na,1882,1228
SIM,1895,38,50-100,1933,4
STAT,1867,61,na,1928,3534.3832872769804
STAT,1829,44,na,1873,3008.246887299382
STAT,1830,24,40-44,1854,11.12779974840842
SIM,1860,29,na,1889,4092
SIM,1828,37,50-100,1865,7
STAT,1873,25,45-49,1898,2.293861761904513
SIM,1903,22,35-39,1925,16
SIM,1927,20,25-29,1947,288
SIM,1919,26,40-44,1945,15
STAT,1873,21,50-100,1894,0.8393352040344122
STAT,1938,33,40-44,1971,7.943303131358818
SIM,1925,35,25-29,1960,3
SIM,1849,20,40-44,1869,1
SIM,1925,24,15-19,1949,12
SIM,1892,33,50-100,1925,5
STAT,1945,0,na,1945,9825.714830312276
STAT,1816,41,45-49,1857,8.584508111594133
STAT,1856,23,40-44,1879,3.7440868622544388
SIM,1812,56,na,1868,2423
SIM,1873,25,40-44,1898,13
SIM,1897,68,na,1965,4607
SIM,1845,25,35-39,1870,28
STAT,1845,33,15-19,1878,0.25822111845175644
STAT,1839,43,na,1882,3755.1348679835905
SIM,1860,18,30-34,1878,4
STAT,1853,66,na,1919,2593.2442386870644
STAT,1870,30,45-49,1900,3.485491632208527
SIM,1827,45,40-44,1872,1
STAT,1866,20,na,1886,4507.703769979815
STAT,1816,54,20-24,1870,0.0033419412746984395
STAT,1844,43,50-100,1887,1.725066268275207
STAT,1826,35,30-34,1861,13.51737073813444
STAT,1837,29,45-49,1866,1.9582562311909055
SIM,1865,3,na,1868,5725
SIM,1891,36,50-100,1927,7
SIM,1896,27,na,1923,6600
SIM,1936,18,50-100,1954,1
STAT,1903,32,50-100,1935,2.6347212548489622
STAT,1883,45,20-24,1928,0.024048669648975465
STAT,1846,50,20-24,1896,0.0011465204286025797
STAT,1894,35,25-29,1929,7.540721389214008
SIM,1843,18,30-34,1861,5
STAT,1931,38,na,1969,10053.046398261793
STAT,1837,18,35-39,1855,1.1872882695122962
SIM,1873,39,na,1912,4895
STAT,1919,39,45-49,1958,1.4756636438887114
STAT,1936,35,35-39,1971,4.804932820273064
SIM,1845,29,45-49,1874,3
STAT,1882,28,15-19,1910,0.8894708715435417
SIM,1872,34,30-34,1906,41
STAT,1901,45,15-19,1946,6.443081619026224E-4
STAT,1833,37,50-100,1870,2.0217395326951255
SIM,1864,65,na,1929,3196
SIM,1853,21,15-19,1874,7
STAT,1893,26,30-34,1919,64.68381103985831
STAT,1916,44,15-19,1960,0.003167744201757916
STAT,1831,63,na,1894,2303.80104149592
SIM,1864,23,40-44,1887,5
STAT,1877,47,25-29,1924,0.1202331528743214
STAT,1831,41,40-44,1872,3.607857696267801
STAT,1822,50,35-39,1872,0.02679756795475304
SIM,1834,35,30-34,1869,12
SIM,1874,24,na,1898,4856
STAT,1827,58,na,1885,2510.5086795566417
STAT,1861,41,50-100,1902,1.7839400381642256
SIM,1860,19,15-19,1879,13
STAT,1925,45,30-34,1970,0.21914770976407197
STAT,1805,51,40-44,1856,0.08434796027958781
SIM,1850,31,45-49,1881,2
STAT,1941,19,na,1960,7652.0651251417785
STAT,1862,21,15-19,1883,5.871842008629911
SIM,1829,45,45-49,1874,1
STAT,1893,15,20-24,1908,45.59373387486741
STAT,1828,35,35-39,1863,14.839104298770684
SIM,1942,28,30-34,1970,107
SIM,1860,51,na,1911,3776
SIM,1915,18,15-19,1933,22
STAT,1934,20,20-24,1954,302.8277989113222
STAT,1886,36,40-44,1922,9.37750282529129
STAT,1887,15,20-24,1902,40.23113212038324
SIM,1834,24,20-24,1858,115
SIM,1912,50,na,1962,7250
STAT,1822,52,25-29,1874,0.010595011120562688
SIM,1870,10,na,1880,5240
SIM,1896,36,45-49,1932,8
STAT,1852,19,15-19,1871,11.30539158673324
SIM,1885,64,na,1949,3639
SIM,1801,93,na,1894,22
SIM,1870,21,15-19,1891,7
STAT,1909,42,na,1951,7019.483196475053
STAT,1888,36,45-49,1924,4.781485915508717
SIM,1881,50,na,1931,3753
SIM,1894,36,40-44,1930,14
STAT,1949,23,45-49,1972,2.650577815635907
SIM,1895,15,20-24,1910,46
STAT,1856,35,40-44,1891,6.8859648653288925
STAT,1948,20,50-100,1968,1.526781407338387
SIM,1935,33,35-39,1968,41
SIM,1823,96,na,1919,2
SIM,1858,25,45-49,1883,2
SIM,1885,24,na,1909,4880
SIM,1801,53,na,1854,2409
SIM,1828,29,45-49,1857,3
STAT,1927,33,35-39,1960,22.685575814375145
STAT,1819,45,40-44,1864,0.7403965124040737
STAT,1934,28,30-34,1962,106.41892782517436
SIM,1839,74,na,1913,1421
STAT,1836,46,25-29,1882,0.08119882218821839
STAT,1872,42,40-44,1914,4.559825477301156
SIM,1851,29,15-19,1880,1
SIM,1851,15,na,1866,4563
STAT,1876,15,45-49,1891,0.13708351470603322
SIM,1819,35,35-39,1854,19
SIM,1876,50,na,1926,4740
STAT,1922,21,na,1943,8480.95197688359
STAT,1871,23,15-19,1894,6.599086875641443
STAT,1907,32,na,1939,7143.689497215533
SIM,1910,8,na,1918,8333
SIM,1870,33,20-24,1903,5
STAT,1785,77,na,1862,707.0895201246219
STAT,1842,44,20-24,1886,0.23843753153039313
SIM,1831,75,na,1906,1260
STAT,1863,25,na,1888,4280.381649949433
SIM,1794,66,na,1860,1502
SIM,1872,14,na,1886,5559
SIM,1920,41,50-100,1961,3
STAT,1878,26,35-39,1904,20.422335722253706
SIM,1935,31,50-100,1966,5
SIM,1838,35,45-49,1873,6
STAT,1926,18,25-29,1944,107.00520960687616
SIM,1905,18,na,1923,7585
SIM,1845,18,35-39,1863,1
SIM,1870,44,30-34,1914,5
STAT,1842,26,na,1868,4011.6912493943328
STAT,1846,19,45-49,1865,0.12421312375633939
SIM,1850,44,20-24,1894,1
STAT,1885,12,na,1897,5191.6082293213685
SIM,1886,26,35-39,1912,24
SIM,1834,29,15-19,1863,1
SIM,1867,16,20-24,1883,47
SIM,1839,95,na,1934,20
STAT,1817,45,30-34,1862,0.4823447075801262
STAT,1847,35,45-49,1882,3.219004844833424
STAT,1855,76,na,1931,1428.622541449967
STAT,1836,45,40-44,1881,0.2444528301324995
SIM,1842,78,na,1920,1086
STAT,1843,29,15-19,1872,0.7709718293131617
STAT,1894,46,35-39,1940,0.20546552423832365
SIM,1824,41,45-49,1865,4
STAT,1933,24,na,1957,9777.269312226863
SIM,1881,27,50-100,1908,1
STAT,1894,47,25-29,1941,0.08390206905291592
STAT,1899,20,35-39,1919,16.24392819350515
STAT,1841,27,15-19,1868,0.8176286267824455
STAT,1869,65,na,1934,3307.1544581508065
SIM,1835,81,na,1916,561
STAT,1827,44,25-29,1871,1.176525907352286
SIM,1853,35,40-44,1888,12
STAT,1826,29,15-19,1855,1.941477951012082
SIM,1855,35,45-49,1890,4
SIM,1910,24,25-29,1934,184
SIM,1954,3,na,1957,9931
STAT,1883,32,45-49,1915,3.460219944977907
STAT,1865,25,40-44,1890,5.533582973735076
STAT,1867,25,45-49,1892,2.1143020978373985
STAT,1921,37,40-44,1958,3.374988975675635
STAT,1852,18,30-34,1870,3.0543307342720785
SIM,1861,42,30-34,1903,4
STAT,1862,34,20-24,1896,4.62607472657972
SIM,1835,44,25-29,1879,2
SIM,1848,32,na,1880,3870
SIM,1918,33,35-39,1951,33
STAT,1858,47,15-19,1905,6.268307943184095E-4
SIM,1905,5,na,1910,7915
STAT,1902,24,25-29,1926,162.20522548306016
STAT,1892,47,20-24,1939,0.01703424744091843
SIM,1891,32,45-49,1923,8
STAT,1807,97,na,1904,4.288163722963383
STAT,1867,36,30-34,1903,10.129012491232587
STAT,1876,75,na,1951,2150.401878381615
STAT,1897,26,45-49,1923,3.007707216753718
STAT,1865,51,na,1916,3969.558667036496
STAT,1851,31,40-44,1882,7.070163235197489
STAT,1839,32,50-100,1871,1.7605820926470188
SIM,1862,26,50-100,1888,1
SIM,1892,36,30-34,1928,23
STAT,1825,48,50-100,1873,0.5253142384092798
SIM,1833,48,50-100,1881,4
SIM,1838,22,30-34,1860,46
SIM,1914,20,45-49,1934,3
STAT,1853,31,20-24,1884,4.450171471176859
SIM,1825,34,20-24,1859,4
SIM,1889,40,40-44,1929,11
STAT,1898,43,45-49,1941,0.2819972562111659
SIM,1820,44,35-39,1864,5
STAT,1912,20,15-19,1932,10.36738513121122
STAT,1863,51,35-39,1914,0.01529278323606619
STAT,1809,45,na,1854,2883.7219689050153
STAT,1850,53,45-49,1903,0.02189417484461912
SIM,1884,39,na,1923,5016
SIM,1940,27,15-19,1967,2
SIM,1893,40,50-100,1933,5
STAT,1908,33,25-29,1941,17.55709533171621
SIM,1881,34,35-39,1915,19
SIM,1899,29,50-100,1928,2
STAT,1853,4,na,1857,5073.040584081169
STAT,1897,47,50-100,1944,0.3722616642970831
STAT,1806,56,na,1862,2141.0987077962136
STAT,1887,38,na,1925,5295.268515244686
STAT,1833,33,na,1866,3629.6443144539367
STAT,1912,31,25-29,1943,18.44781778572985
STAT,1921,39,na,1960,8463.900269638163
STAT,1901,49,30-34,1950,0.15116015749761835
STAT,1947,23,35-39,1970,21.483739920793592
STAT,1904,24,35-39,1928,16.80964362165811
SIM,1844,44,20-24,1888,1
STAT,1892,68,na,1960,4130.449897073894
STAT,1888,30,30-34,1918,42.012492068525724
SIM,1838,33,40-44,1871,11
SIM,1907,0,na,1907,8227
STAT,1862,44,30-34,1906,1.9577709126130929
STAT,1939,16,45-49,1955,1.0102642256327157
STAT,1932,27,15-19,1959,1.8675854599024568
STAT,1942,25,50-100,1967,2.111722560712369
STAT,1885,40,50-100,1925,2.1452109132311845
STAT,1840,33,30-34,1873,30.378845716181054
SIM,1848,88,na,1936,191
STAT,1884,36,30-34,1920,10.679775722692392
STAT,1838,42,35-39,1880,2.866110314499273
STAT,1873,34,35-39,1907,20.603386540475903
STAT,1884,25,20-24,1909,23.554410919986143
SIM,1800,68,na,1868,1455
STAT,1843,51,na,1894,3030.626803678689
STAT,1906,20,45-49,1926,2.0644229473122264
SIM,1818,96,na,1914,4
STAT,1836,44,20-24,1880,0.24489688091127987
STAT,1880,80,na,1960,1680.2036030686154
SIM,1872,76,na,1948,1873
SIM,1861,31,20-24,1892,3
STAT,1929,25,50-100,1954,2.5251484882266078
SIM,1937,25,50-100,1962,2
STAT,1864,10,na,1874,4960.605254512189
SIM,1862,36,na,1898,4318
SIM,1920,34,40-44,1954,16
STAT,1757,101,na,1858,0.43131798778660885
STAT,1875,52,50-100,1927,0.031236746746473407
STAT,1831,50,30-34,1881,0.008338036874206435
STAT,1897,39,15-19,1936,0.032391604215488104
SIM,1831,78,na,1909,885
STAT,1910,35,15-19,1945,0.037458365662189165
STAT,1930,35,na,1965,9927.91629471317
STAT,1845,17,50-100,1862,0.09541698378653422
STAT,1903,47,45-49,1950,0.38102071442440805
SIM,1942,23,25-29,1965,210
STAT,1917,53,na,1970,7584.40254244912
SIM,1920,20,15-19,1940,13
STAT,1937,7,na,1944,7855.343976705592
STAT,1864,46,50-100,1910,0.44464286004755754
STAT,1899,23,na,1922,6524.195189759355
STAT,1910,7,na,1917,7976.115348338536
STAT,1849,52,50-100,1901,0.02376232666289528
STAT,1892,35,45-49,1927,5.087990933460471
STAT,1853,42,30-34,1895,1.8167672575595089
STAT,1875,47,15-19,1922,8.278623156761213E-4
SIM,1906,28,20-24,1934,37
STAT,1825,44,45-49,1869,3.3076250962368956
SIM,1938,20,30-34,1958,68
STAT,1928,26,40-44,1954,11.635433401274671
SIM,1920,31,25-29,1951,31
STAT,1878,61,na,1939,3941.5142841926527
STAT,1799,69,na,1868,1430.3521697395884
STAT,1821,48,na,1869,2842.9056544379723
SIM,1814,43,35-39,1857,5
SIM,1842,31,40-44,1873,14
STAT,1929,19,na,1948,9435.172593993986
SIM,1921,18,45-49,1939,1
SIM,1816,86,na,1902,153
SIM,1874,40,na,1914,4519
SIM,1899,23,40-44,1922,6
SIM,1833,44,45-49,1877,5
STAT,1913,18,45-49,1931,0.20578549377897
SIM,1836,35,35-39,1871,18
SIM,1841,18,20-24,1859,36
STAT,1855,14,na,1869,4242.811140248674
STAT,1942,20,na,1962,7738.367474686619
SIM,1887,50,na,1937,5303
STAT,1905,41,35-39,1946,0.3689401545691961
STAT,1920,30,50-100,1950,1.8432894920113756
STAT,1877,45,20-24,1922,0.025416792618281805
SIM,1884,61,na,1945,3961
STAT,1821,43,30-34,1864,3.5534870890303294
STAT,1868,45,25-29,1913,0.11178335045099087
STAT,1895,26,35-39,1921,25.479554936079317
SIM,1886,28,25-29,1914,99
STAT,1954,2,na,1956,9824.011494346818
STAT,1845,106,na,1951,0.018709563137304316
STAT,1929,16,na,1945,9509.342193336088
SIM,1903,47,40-44,1950,1
SIM,1906,19,30-34,1925,6
SIM,1840,33,35-39,1873,32
STAT,1845,21,15-19,1866,6.356581551599374
SIM,1861,14,na,1875,5222
SIM,1819,37,25-29,1856,7
SIM,1936,26,40-44,1962,10
STAT,1840,46,45-49,1886,0.34794967634171914
SIM,1916,22,15-19,1938,10
STAT,1789,102,na,1891,0.15004374727548186
STAT,1792,74,na,1866,904.1024562391186
STAT,1897,2,na,1899,7196.327328680881
SIM,1912,24,35-39,1936,27
SIM,1885,23,50-100,1908,1
STAT,1810,107,na,1917,0.004264885806906431
STAT,1823,49,50-100,1872,0.7375794508856663
SIM,1851,24,20-24,1875,128
SIM,1914,54,na,1968,7240
STAT,1888,60,na,1948,4552.562089857628
STAT,1842,31,45-49,1873,3.1690434633016813
STAT,1877,23,50-100,1900,0.8525584303932039
SIM,1849,23,45-49,1872,2
SIM,1901,34,30-34,1935,39
STAT,1876,51,45-49,1927,0.03045944018170632
STAT,1892,22,50-100,1914,1.0310148184766805
SIM,1863,42,40-44,1905,10
SIM,1903,14,na,1917,7622
SIM,1869,23,25-29,1892,145
SIM,1873,28,15-19,1901,1
STAT,1881,34,30-34,1915,33.79098419531471
SIM,1925,28,30-34,1953,105
SIM,1927,4,na,1931,10372
SIM,1887,49,50-100,1936,3
STAT,1920,41,30-34,1961,0.2855103733951029
STAT,1908,22,15-19,1930,9.890110337101463
STAT,1917,20,20-24,1937,240.08102123533783
SIM,1816,41,40-44,1857,9
STAT,1778,109,na,1887,0.006763233199331496
SIM,1850,40,35-39,1890,6
SIM,1896,24,na,1920,6497
SIM,1858,22,40-44,1880,5
STAT,1821,100,na,1921,1.176776328960604
STAT,1843,24,20-24,1867,119.43597823617802
SIM,1829,96,na,1925,7
SIM,1905,32,40-44,1937,13
SIM,1851,35,30-34,1886,14
SIM,1879,33,40-44,1912,10
STAT,1834,74,na,1908,1474.8400617862767
SIM,1916,33,25-29,1949,28
STAT,1875,32,40-44,1907,9.017558283294212
SIM,1883,32,40-44,1915,10
STAT,1816,108,na,1924,0.001799215106984504
SIM,1887,22,50-100,1909,1
SIM,1774,89,na,1863,52
STAT,1894,16,50-100,1910,0.12741654455194265
STAT,1895,24,15-19,1919,8.627462761898022
STAT,1814,43,30-34,1857,6.4055816059001645
STAT,1867,38,20-24,1905,1.450770854995451
SIM,1840,52,na,1892,3366
STAT,1832,48,na,1880,3097.8043556202065
SIM,1875,38,20-24,1913,6
STAT,1906,37,15-19,1943,0.035669863483475145
STAT,1856,38,15-19,1894,0.08706805957456722
SIM,1935,16,na,1951,10477
STAT,1812,44,35-39,1856,13.307694281511857
STAT,1864,32,35-39,1896,18.282488393151947
SIM,1925,20,20-24,1945,248
SIM,1822,43,30-34,1865,2
SIM,1926,42,na,1968,9463
STAT,1834,46,15-19,1880,6.285294368481122E-4
STAT,1843,35,30-34,1878,8.898515618020832
STAT,1879,22,50-100,1901,0.8614479059620319
STAT,1897,24,40-44,1921,5.590320859229028
STAT,1842,40,35-39,1882,2.861663139524938
STAT,1828,33,15-19,1861,0.3096983789371609
STAT,1872,51,30-34,1923,0.012139939245504272
SIM,1935,31,15-19,1966,5
STAT,1880,83,na,1963,1329.57040336669
SIM,1862,25,35-39,1887,24
SIM,1838,33,na,1871,3634
SIM,1828,26,40-44,1854,10
STAT,1821,33,20-24,1854,17.7631866708196
STAT,1877,79,na,1956,1546.244405506385
SIM,1899,16,na,1915,7104
STAT,1880,43,na,1923,4881.809641547721
SIM,1829,34,50-100,1863,2
STAT,1827,52,50-100,1879,0.026326456361077083
SIM,1900,19,20-24,1919,41
SIM,1815,45,na,1860,2724
STAT,1887,17,40-44,1904,0.4131400881012158
SIM,1859,32,na,1891,4256
STAT,1879,43,35-39,1922,3.7976695347132767
STAT,1877,44,20-24,1921,0.3285604212076141
SIM,1866,38,25-29,1904,9
SIM,1764,90,na,1854,26
STAT,1860,36,15-19,1896,0.09254140614856413
STAT,1826,37,20-24,1863,1.8266764658172663
STAT,1922,24,na,1946,8402.491885690855
SIM,1827,70,na,1897,1618
STAT,1868,53,30-34,1921,0.011254331891656734
SIM,1929,31,45-49,1960,5
STAT,1931,31,35-39,1962,24.19838166794303
SIM,1929,20,35-39,1949,35
SIM,1858,25,15-19,1883,1
STAT,1893,28,20-24,1921,29.925375241703875
SIM,1891,41,35-39,1932,9
SIM,1895,17,40-44,1912,2
SIM,1896,45,35-39,1941,1
SIM,1856,29,20-24,1885,21
SIM,1827,30,na,1857,3598
STAT,1809,48,na,1857,2775.1058218884073
STAT,1854,25,35-39,1879,17.28747533318705
STAT,1908,22,45-49,1930,2.090493198889619
STAT,1857,51,35-39,1908,0.013617197439902633
SIM,1845,22,30-34,1867,49
SIM,1870,36,25-29,1906,8
STAT,1866,76,na,1942,1765.4674982696113
STAT,1948,19,15-19,1967,104.81574440567977
STAT,1863,28,na,1891,4204.284674565553
STAT,1843,29,na,1872,3676.022148910132
STAT,1899,36,20-24,1935,2.143312225615588
STAT,1832,33,35-39,1865,17.02562660554755
STAT,1883,41,35-39,1924,3.6094077197343157
STAT,1943,23,na,1966,7843.911997527491
SIM,1916,22,45-49,1938,5
SIM,1858,39,50-100,1897,3
STAT,1831,44,45-49,1875,2.3094846809325245
SIM,1855,48,50-100,1903,2
SIM,1887,43,35-39,1930,10
SIM,1944,20,30-34,1964,91
SIM,1885,7,na,1892,5430
SIM,1849,73,na,1922,1802
STAT,1851,34,15-19,1885,0.22504689124963587
SIM,1834,37,20-24,1871,1
STAT,1830,29,35-39,1859,20.09165688139479
STAT,1779,92,na,1871,18.78498182499318
STAT,1899,47,30-34,1946,0.15039038430479243
STAT,1910,37,35-39,1947,4.6736645059405415
STAT,1810,45,50-100,1855,1.6651100396384086
STAT,1878,28,25-29,1906,88.91233885416304
STAT,1882,17,35-39,1899,1.0795285444424385
STAT,1934,36,50-100,1970,1.1713781999410844
SIM,1866,103,na,1969,2
STAT,1869,23,20-24,1892,134.44087385280866
SIM,1888,75,na,1963,2908
SIM,1838,32,40-44,1870,1
SIM,1860,88,na,1948,203
SIM,1870,47,35-39,1917,1
SIM,1854,16,40-44,1870,1
STAT,1816,50,35-39,1866,0.04223068293139314
STAT,1852,25,na,1877,4074.1388606219043
STAT,1912,34,40-44,1946,7.712411375122252
STAT,1846,52,40-44,1898,0.016039453617856504
SIM,1888,25,30-34,1913,81
SIM,1864,62,na,1926,3409
STAT,1848,29,20-24,1877,22.635738760772398
STAT,1934,23,25-29,1957,250.65648221755612
SIM,1886,23,30-34,1909,47
STAT,1932,37,50-100,1969,1.1393892641725811
STAT,1827,41,20-24,1868,0.3072174598490251
STAT,1908,57,na,1965,6419.7664515280885
SIM,1760,94,na,1854,4
STAT,1805,54,45-49,1859,0.10943707514021392
STAT,1897,23,40-44,1920,5.608154791465887
STAT,1923,22,40-44,1945,7.898713831164034
SIM,1860,27,20-24,1887,22
STAT,1788,66,na,1854,1561.0
SIM,1843,63,na,1906,2603
STAT,1835,50,45-49,1885,0.019937982079659078
STAT,1875,13,na,1888,5391.231256364692
SIM,1899,26,15-19,1925,2
SIM,1929,31,na,1960,9910
STAT,1858,49,35-39,1907,0.2158163941596303
STAT,1831,26,na,1857,3726.366475570914
STAT,1829,54,30-34,1883,0.007935536309370777
STAT,1881,47,45-49,1928,0.4585434151580409
SIM,1847,47,na,1894,3417
SIM,1931,22,40-44,1953,14
SIM,1827,35,50-100,1862,3
SIM,1879,34,40-44,1913,8
STAT,1818,81,na,1899,554.7935211791275
STAT,1819,85,na,1904,286.8478759959571
STAT,1896,45,30-34,1941,0.1470472085920066
SIM,1846,42,35-39,1888,6
STAT,1851,34,45-49,1885,2.7557627522042405
STAT,1856,38,45-49,1894,3.0909157473116626
STAT,1909,15,20-24,1924,53.97389569532515
STAT,1847,21,50-100,1868,0.7675466653764862
SIM,1866,49,35-39,1915,1
STAT,1878,19,35-39,1897,1.15118571020082
STAT,1862,15,50-100,1877,0.09800904266812906
SIM,1806,71,na,1877,1212
STAT,1836,54,30-34,1890,0.007698688361628934
SIM,1910,28,40-44,1938,12
STAT,1943,25,25-29,1968,141.69256123826187
STAT,1891,15,40-44,1906,0.45871733115587143
STAT,1894,32,20-24,1926,7.012806992897313
STAT,1843,88,na,1931,192.30928580812812
SIM,1879,23,30-34,1902,44
STAT,1838,58,na,1896,2676.41537913609
STAT,1869,34,15-19,1903,0.2762972327348092
STAT,1820,54,40-44,1874,0.03620594401623971
SIM,1826,48,na,1874,2896
STAT,1822,89,na,1911,118.61418088579327
STAT,1880,15,35-39,1895,1.172842763619348
SIM,1875,65,na,1940,3719
STAT,1859,19,25-29,1878,10.44968455164538
SIM,1796,92,na,1888,20
STAT,1932,3,na,1935,10847.866394368171
SIM,1918,30,30-34,1948,41
SIM,1880,45,45-49,1925,1
SIM,1928,16,35-39,1944,12
STAT,1888,45,35-39,1933,0.33752084045911107
SIM,1953,16,50-100,1969,1
STAT,1836,48,45-49,1884,0.32427325713374017
STAT,1872,40,20-24,1912,0.32560186442682226
STAT,1914,47,20-24,1961,0.02213890835309628
SIM,1896,64,na,1960,4964
STAT,1878,23,30-34,1901,37.45536512175268
STAT,1837,27,25-29,1864,75.69058759161523
SIM,1938,22,50-100,1960,1
STAT,1954,16,40-44,1970,3.492771356492459
STAT,1827,52,30-34,1879,0.010376225498108379
STAT,1871,27,30-34,1898,50.52786001455929
SIM,1910,17,30-34,1927,8
STAT,1902,28,40-44,1930,8.51132395049672
STAT,1836,43,20-24,1879,0.24805461617519006
STAT,1857,42,45-49,1899,2.3531057490534115
STAT,1873,38,20-24,1911,1.5739793253591676
SIM,1832,24,40-44,1856,3
STAT,1902,17,30-34,1919,4.544673529487848
SIM,1867,19,25-29,1886,16
SIM,1881,38,20-24,1919,1
SIM,1902,69,na,1971,5077
SIM,1844,48,45-49,1892,2
STAT,1872,45,45-49,1917,0.4837943717241721
SIM,1845,27,25-29,1872,84
STAT,1863,108,na,1971,0.055201432116100735
STAT,1898,44,50-100,1942,0.19779884664629577
STAT,1894,43,30-34,1937,0.2056282804259147
STAT,1846,16,40-44,1862,0.35401551292009165
SIM,1846,28,na,1874,4028
SIM,1857,30,40-44,1887,12
SIM,1905,40,na,1945,7073
SIM,1851,39,25-29,1890,9
SIM,1953,4,na,1957,9966
STAT,1831,41,35-39,1872,2.904560799963951
STAT,1844,18,35-39,1862,1.1197735137104796
STAT,1939,28,15-19,1967,1.4327898078089931
SIM,1836,28,35-39,1864,26
SIM,1881,31,30-34,1912,42
STAT,1809,61,na,1870,2143.327062666226
SIM,1908,32,20-24,1940,6
STAT,1871,1,na,1872,7044.880826058157
STAT,1850,29,15-19,1879,0.8069256544144556
STAT,1948,17,na,1965,8506.653756987887
SIM,1827,33,na,1860,3454
STAT,1805,71,na,1876,1386.1102425337995
STAT,1828,35,40-44,1863,9.184072109793174
STAT,1943,17,40-44,1960,2.9954762773429806
STAT,1852,15,20-24,1867,34.58061803190039
SIM,1855,22,30-34,1877,43
STAT,1876,52,20-24,1928,0.0015332043741251144
STAT,1926,7,na,1933,9896.305561897905
SIM,1838,36,45-49,1874,6
SIM,1887,43,50-100,1930,5
SIM,1897,29,20-24,1926,40
STAT,1861,15,30-34,1876,3.116154793640438
SIM,1884,79,na,1963,1901
SIM,1909,30,na,1939,7440
SIM,1876,37,50-100,1913,4
SIM,1928,40,35-39,1968,1
STAT,1897,27,45-49,1924,2.9974208580724198
SIM,1808,88,na,1896,102
STAT,1834,39,15-19,1873,0.09106737492507587
SIM,1814,40,30-34,1854,3
STAT,1819,35,30-34,1854,35.46590861563765
STAT,1863,49,50-100,1912,0.42513071409528486
STAT,1916,48,30-34,1964,0.18414926181391628
STAT,1827,98,na,1925,3.9282477167170233
SIM,1829,34,na,1863,3457
STAT,1873,33,na,1906,4876.179519007561
STAT,1889,29,20-24,1918,29.005247173838338
SIM,1880,89,na,1969,517
STAT,1873,31,30-34,1904,35.97473715257893
STAT,1864,48,15-19,1912,7.130496860553948E-4
STAT,1879,24,na,1903,4964.834529118016
SIM,1934,31,na,1965,10278
STAT,1834,46,20-24,1880,0.018855899691720617
STAT,1841,22,na,1863,3929.9627937870046
SIM,1862,25,40-44,1887,4
SIM,1852,18,35-39,1870,2
STAT,1828,28,35-39,1856,27.540376960479346
STAT,1877,23,na,1900,4944.55505390649
SIM,1853,25,30-34,1878,10
SIM,1838,70,na,1908,1877
SIM,1843,18,25-29,1861,14
STAT,1874,15,40-44,1889,0.3814033433619914
STAT,1843,11,na,1854,4293.0
SIM,1965,2,na,1967,10581
SIM,1931,25,15-19,1956,2
STAT,1836,47,25-29,1883,0.0801651611817624
SIM,1880,55,na,1935,4584
STAT,1834,44,50-100,1878,1.6524458236847346
STAT,1895,19,35-39,1914,1.4362558692407186
STAT,1861,48,na,1909,3734.4802512621613
SIM,1812,43,30-34,1855,3
SIM,1899,37,30-34,1936,3
STAT,1780,86,na,1866,126.64471662599823
STAT,1837,28,45-49,1865,1.9724181938225516
SIM,1845,28,45-49,1873,2
STAT,1771,112,na,1883,0.001171597967090166
STAT,1854,23,15-19,1877,5.899557294419652
STAT,1766,114,na,1880,3.5573393128074296E-4
STAT,1896,48,35-39,1944,0.20792641977138707
STAT,1845,25,30-34,1870,47.9166240967615
STAT,1900,27,30-34,1927,70.55022773900828
STAT,1911,6,na,1917,8076.153837426874
SIM,1816,83,na,1899,325
SIM,1855,88,na,1943,181
STAT,1823,38,50-100,1861,4.576853146345469
STAT,1918,45,30-34,1963,0.19245964208813165
SIM,1860,15,20-24,1875,33
STAT,1923,25,15-19,1948,1.6475015245040905
SIM,1892,74,na,1966,3809
SIM,1842,38,na,1880,3644
STAT,1835,93,na,1928,37.851030589157055
STAT,1820,40,20-24,1860,0.6790438003009492
STAT,1855,30,na,1885,3740.7998047091305
SIM,1842,16,na,1858,4293
STAT,1932,38,30-34,1970,4.941043596740827
STAT,1854,25,40-44,1879,5.366993583555487
STAT,1910,30,15-19,1940,0.2523468529228326
SIM,1797,71,na,1868,1178
SIM,1881,2,na,1883,5247
STAT,1840,52,50-100,1892,0.02168386585641216
STAT,1917,27,40-44,1944,9.871304904106202
SIM,1849,36,20-24,1885,1
STAT,1856,20,15-19,1876,6.057061272754298
STAT,1823,47,15-19,1870,0.001235944552551243
SIM,1827,35,30-34,1862,13
STAT,1822,43,na,1865,3072.2605114535454
STAT,1947,22,35-39,1969,21.490831895319058
SIM,1853,40,50-100,1893,1
SIM,1917,25,25-29,1942,157
SIM,1921,7,na,1928,9246
STAT,1913,47,na,1960,7243.734840750134
SIM,1834,80,na,1914,694
SIM,1838,30,50-100,1868,1
SIM,1933,22,15-19,1955,14
SIM,1922,12,na,1934,9767
STAT,1916,46,50-100,1962,0.4696890055389017
SIM,1935,30,25-29,1965,31
STAT,1886,26,30-34,1912,53.8706014577981
SIM,1914,23,50-100,1937,1
STAT,1792,71,na,1863,1201.4598599990225
STAT,1866,41,40-44,1907,4.210445369129272
STAT,1919,24,40-44,1943,7.387802870376812
SIM,1874,41,40-44,1915,5
SIM,1914,17,na,1931,8294
STAT,1825,44,15-19,1869,0.03052018757516319
STAT,1890,38,15-19,1928,0.1377431396018106
SIM,1826,85,na,1911,251
SIM,1833,32,50-100,1865,3
SIM,1841,17,20-24,1858,26
SIM,1877,29,35-39,1906,26
STAT,1812,42,50-100,1854,8.649819456489599
STAT,1841,15,45-49,1856,0.12369201284507525
SIM,1894,26,30-34,1920,87
STAT,1865,52,45-49,1917,0.026485788304475868
SIM,1917,28,50-100,1945,1
STAT,1859,20,na,1879,3975.5899740692003
SIM,1910,27,na,1937,7553
SIM,1916,18,na,1934,8397
SIM,1934,22,20-24,1956,7
SIM,1915,17,15-19,1932,20
STAT,1871,34,30-34,1905,34.73324502482567
STAT,1852,87,na,1939,280.79873592647823
SIM,1943,14,na,1957,8599
STAT,1847,22,30-34,1869,33.285714906409396
STAT,1849,30,40-44,1879,8.110127859946932
STAT,1943,15,15-19,1958,97.24403563470742
STAT,1956,12,na,1968,10496.085267327147
STAT,1858,28,50-100,1886,1.0236055564535005
SIM,1869,28,30-34,1897,59
STAT,1843,39,25-29,1882,4.196615563870785
STAT,1845,47,35-39,1892,0.21472524651997582
STAT,1885,74,na,1959,2483.9046090797547
STAT,1925,22,15-19,1947,12.866001021429433
SIM,1898,53,na,1951,5911
STAT,1851,33,45-49,1884,2.784526915238656
STAT,1930,19,na,1949,9559.008774442076
SIM,1840,30,30-34,1870,48
SIM,1864,20,15-19,1884,7
STAT,1885,19,35-39,1904,1.0971523677459711
STAT,1892,35,15-19,1927,0.14332370531118385
STAT,1945,25,35-39,1970,33.2921833019249
SIM,1826,28,35-39,1854,23
SIM,1859,39,50-100,1898,4
STAT,1826,33,na,1859,3465.6109560539776
STAT,1808,49,15-19,1857,0.0024226107145443746
SIM,1927,24,40-44,1951,13
STAT,1860,36,20-24,1896,1.2703409609377212
SIM,1930,41,na,1971,10452
SIM,1843,25,30-34,1868,57
SIM,1882,45,50-100,1927,2
STAT,1784,76,na,1860,594.5742073270927
STAT,1839,83,na,1922,619.866747199078
SIM,1817,49,na,1866,2820
STAT,1877,48,25-29,1925,0.11927850164049932
STAT,1899,24,45-49,1923,1.9175059444167804
SIM,1872,37,35-39,1909,22
STAT,1860,82,na,1942,765.2338347166583
STAT,1927,30,25-29,1957,22.98459206648799
STAT,1835,25,30-34,1860,43.142770345943276
SIM,1919,27,50-100,1946,3
SIM,1833,43,45-49,1876,10
SIM,1936,19,40-44,1955,3
STAT,1860,60,na,1920,3127.9326432010243
SIM,1856,25,40-44,1881,7
SIM,1884,19,25-29,1903,17
SIM,1951,15,15-19,1966,104
SIM,1880,42,35-39,1922,6
STAT,1820,60,na,1880,2280.5583311845608
STAT,1925,46,15-19,1971,9.035669796466027E-4
STAT,1832,30,30-34,1862,30.319548646103307
SIM,1833,55,na,1888,2705
SIM,1879,15,na,1894,5290
STAT,1892,34,45-49,1926,4.371151268089753
SIM,1877,36,40-44,1913,15
STAT,1896,12,na,1908,6886.075435153779
STAT,1880,18,45-49,1898,0.13861427534314802
SIM,1852,44,25-29,1896,3
STAT,1880,27,35-39,1907,20.528799773108
STAT,1830,36,35-39,1866,13.442708936789247
SIM,1839,25,40-44,1864,4
STAT,1850,41,45-49,1891,2.305136349245029
STAT,1875,47,20-24,1922,0.02483589131676064
STAT,1777,107,na,1884,0.01442947561972368
SIM,1927,35,35-39,1962,8
STAT,1849,31,50-100,1880,1.6957778343676888
STAT,1879,52,30-34,1931,0.012507683390235738
STAT,1912,35,40-44,1947,2.9796558080626654
STAT,1858,47,20-24,1905,0.018804940371004008
STAT,1926,22,20-24,1948,272.7805294710803
SIM,1920,35,40-44,1955,4
STAT,1898,16,40-44,1914,0.5011178434835885
STAT,1914,35,45-49,1949,1.3879567676997733
SIM,1867,29,35-39,1896,24
SIM,1919,19,40-44,1938,5
STAT,1885,58,na,1943,3975.5566633367025
STAT,1920,40,25-29,1960,0.1596866465094302
STAT,1816,55,na,1871,2553.042839088207
SIM,1875,42,50-100,1917,6
SIM,1822,46,35-39,1868,1
STAT,1863,18,45-49,1881,0.11921144929148125
SIM,1821,36,35-39,1857,18
SIM,1929,22,25-29,1951,264
STAT,1825,43,45-49,1868,3.380469273576427
STAT,1869,36,40-44,1905,8.607739390379054
SIM,1868,48,25-29,1916,1
SIM,1946,22,25-29,1968,241
STAT,1827,80,na,1907,748.0279073400623
STAT,1842,63,na,1905,2656.497860984429
STAT,1872,42,35-39,1914,3.670956964224669
SIM,1893,16,30-34,1909,6
STAT,1924,17,15-19,1941,109.11848653929579
SIM,1898,31,40-44,1929,16
STAT,1844,44,25-29,1888,1.035221406803018
STAT,1860,29,15-19,1889,0.741321512414349
STAT,1860,37,50-100,1897,2.0135998310944165
STAT,1865,28,20-24,1893,21.449230673364706
STAT,1814,46,35-39,1860,0.7366704904186909
STAT,1868,80,na,1948,1188.6490973883542
STAT,1897,21,15-19,1918,8.933072126112908
SIM,1892,2,na,1894,7606
STAT,1848,25,40-44,1873,5.9489381052932835
STAT,1907,17,15-19,1924,17.61589725684659
SIM,1905,58,na,1963,6260
SIM,1925,27,40-44,1952,17
STAT,1876,26,30-34,1902,52.78197069830735
STAT,1848,28,20-24,1876,22.79943873085998
STAT,1864,44,40-44,1908,4.0058280208772095
SIM,1889,70,na,1959,3738
STAT,1824,39,15-19,1863,0.1560021932486672
STAT,1870,53,25-29,1923,0.006910434671373047
STAT,1858,36,20-24,1894,1.2194799219767227
SIM,1868,20,15-19,1888,6
STAT,1787,104,na,1891,0.04905865985276861
STAT,1855,36,na,1891,3569.758110020689
SIM,1862,23,15-19,1885,5
STAT,1919,35,35-39,1954,5.276107253792046
SIM,1836,22,20-24,1858,119
STAT,1881,37,35-39,1918,13.806917565460244
SIM,1830,90,na,1920,76
STAT,1821,36,25-29,1857,12.010612193032408
SIM,1872,44,40-44,1916,12
STAT,1843,46,50-100,1889,0.3468523252832031
STAT,1906,38,20-24,1944,0.4872212191589909
STAT,1871,18,35-39,1889,1.1015770244746672
STAT,1940,25,45-49,1965,3.561300935456667
SIM,1879,37,45-49,1916,7
STAT,1864,72,na,1936,2279.916159456059
STAT,1908,46,15-19,1954,6.783437153622113E-4
STAT,1823,43,40-44,1866,7.3021289771064675
STAT,1901,22,na,1923,6686.86510486744
SIM,1901,37,40-44,1938,4
STAT,1885,45,25-29,1930,0.11694746610885193
SIM,1928,3,na,1931,10454
SIM,1860,105,na,1965,1
STAT,1919,22,15-19,1941,11.769830438357257
STAT,1844,107,na,1951,0.007615859876221963
STAT,1880,37,na,1917,5012.5134473356
SIM,1884,45,na,1929,4881
STAT,1888,42,30-34,1930,2.740954224008491
STAT,1805,51,35-39,1856,0.06897613590172043
STAT,1866,45,15-19,1911,7.528224921532534E-4
SIM,1825,46,20-24,1871,1
STAT,1869,48,35-39,1917,0.2705290734697617
STAT,1790,70,na,1860,1202.5072075826586
SIM,1858,39,35-39,1897,18
SIM,1917,43,na,1960,7995
STAT,1886,48,35-39,1934,0.29472164940560663
SIM,1866,23,45-49,1889,6
SIM,1877,26,30-34,1903,63
SIM,1926,45,30-34,1971,1
STAT,1873,27,50-100,1900,1.3126846821122786
STAT,1814,48,na,1862,2609.7190977997557
STAT,1870,31,20-24,1901,5.381601655950043
STAT,1901,35,50-100,1936,0.7563613627042314
STAT,1858,23,45-49,1881,1.138058165213798
SIM,1905,21,50-100,1926,1
STAT,1815,95,na,1910,12.358199006214058
SIM,1922,35,45-49,1957,4
STAT,1818,54,25-29,1872,0.014387785846871457
STAT,1890,34,40-44,1924,10.599153056921699
STAT,1923,38,20-24,1961,0.6160534208685126
STAT,1938,22,25-29,1960,184.66008846952403
SIM,1932,17,15-19,1949,112
SIM,1915,23,50-100,1938,1
STAT,1918,19,40-44,1937,3.057690736705753
SIM,1856,28,20-24,1884,20
SIM,1836,35,40-44,1871,12
SIM,1877,48,35-39,1925,2
STAT,1848,66,na,1914,2687.4968063201472
SIM,1888,21,15-19,1909,9
STAT,1841,51,45-49,1892,0.02115724242090483
SIM,1884,26,30-34,1910,65
STAT,1867,26,20-24,1893,22.265302893506703
STAT,1928,19,40-44,1947,3.5397990764233973
STAT,1890,27,35-39,1917,23.786113206052242
STAT,1895,26,40-44,1921,7.910270598695731
STAT,1798,90,na,1888,60.16294687175523
STAT,1917,37,na,1954,7891.352355842471
STAT,1932,26,50-100,1958,2.6343649130729747
SIM,1904,39,na,1943,6881
STAT,1811,106,na,1917,0.011286482471647626
STAT,1861,41,20-24,1902,0.26817399777732
STAT,1838,51,30-34,1889,0.008173611598818575
SIM,1835,68,na,1903,1985
STAT,1796,61,na,1857,1898.2711554609368
SIM,1831,43,40-44,1874,7
STAT,1854,18,35-39,1872,1.0003062795348263
SIM,1873,43,50-100,1916,3
STAT,1903,40,25-29,1943,0.12952297422428125
STAT,1884,37,20-24,1921,1.5372811737865575
SIM,1847,32,50-100,1879,1
STAT,1853,7,na,1860,4710.872743127941
SIM,1876,18,20-24,1894,31
STAT,1840,36,35-39,1876,12.20118997220647
STAT,1868,18,20-24,1886,34.47835088144996
STAT,1824,51,45-49,1875,0.034530165668945866
SIM,1927,22,15-19,1949,15
STAT,1879,40,na,1919,4931.706692181839
STAT,1835,54,25-29,1889,0.0044955948926402745
STAT,1857,15,40-44,1872,0.34243360767153574
STAT,1873,89,na,1962,421.37069855106216
STAT,1875,23,45-49,1898,1.4454962824745718
STAT,1897,43,na,1940,6215.839690364634
STAT,1865,38,na,1903,4301.33242968105
STAT,1817,46,20-24,1863,0.0588677888030829
STAT,1913,27,40-44,1940,9.38207570843455
SIM,1766,91,na,1857,21
SIM,1868,36,30-34,1904,14
SIM,1863,42,35-39,1905,6
SIM,1892,37,20-24,1929,4
STAT,1839,38,20-24,1877,1.4234891521679283
SIM,1921,27,40-44,1948,12
STAT,1891,42,45-49,1933,3.73158588718975
SIM,1853,28,35-39,1881,23
STAT,1867,55,na,1922,3910.9243024511793
SIM,1953,15,25-29,1968,146
SIM,1883,20,40-44,1903,2
STAT,1932,28,20-24,1960,48.26724424407651
STAT,1899,21,40-44,1920,5.783596629508399
STAT,1861,18,35-39,1879,1.0539300860856902
STAT,1810,104,na,1914,0.06032036624959058
SIM,1886,19,35-39,1905,1
STAT,1908,48,40-44,1956,0.28735859184864665
SIM,1872,20,na,1892,5070
STAT,1846,53,na,1899,3245.0732568195344
STAT,1906,25,15-19,1931,1.3442798400577742
SIM,1852,15,30-34,1867,6
STAT,1836,54,50-100,1890,0.01953303571003783
SIM,1949,0,na,1949,9999
STAT,1851,30,40-44,1881,7.1439603455672
STAT,1849,42,na,1891,3651.413981686036
STAT,1869,29,35-39,1898,18.74741371163179
STAT,1850,39,na,1889,3594.1307332544884
STAT,1845,35,40-44,1880,7.951767771177987
SIM,1910,16,40-44,1926,1
SIM,1882,34,50-100,1916,4
SIM,1911,34,30-34,1945,46
STAT,1881,32,35-39,1913,19.76885593779806
STAT,1803,54,na,1857,2306.3734556923882
STAT,1841,47,50-100,1888,0.3579638449595496
SIM,1825,60,na,1885,2085
SIM,1940,28,20-24,1968,33
SIM,1890,33,na,1923,6234
STAT,1859,52,20-24,1911,0.001179882694479771
SIM,1908,35,25-29,1943,1
STAT,1902,57,na,1959,5901.301742566636
STAT,1819,54,30-34,1873,0.023045420588682933
SIM,1894,23,na,1917,6329
SIM,1897,12,na,1909,7150
STAT,1814,41,35-39,1855,10.859957545257178
STAT,1823,36,35-39,1859,28.449373798435907
STAT,1925,41,15-19,1966,0.0037596034684601767
STAT,1859,15,15-19,1874,11.20523215496324
STAT,1856,23,50-100,1879,0.7326980694033198
STAT,1876,19,25-29,1895,11.773521459470938
STAT,1810,49,30-34,1859,0.6075740385586748
STAT,1845,28,35-39,1873,17.96752921934273
SIM,1859,94,na,1953,17
SIM,1787,93,na,1880,11
SIM,1785,92,na,1877,8
SIM,1814,66,na,1880,1756
SIM,1949,17,25-29,1966,127
SIM,1874,77,na,1951,1501
STAT,1873,22,40-44,1895,4.276092682807106
SIM,1899,13,na,1912,7236
SIM,1926,19,40-44,1945,1
SIM,1926,19,50-100,1945,2
STAT,1845,52,na,1897,3300.2300743606793
SIM,1860,35,na,1895,4143
STAT,1816,54,15-19,1870,1.113979445005204E-4
STAT,1929,43,40-44,1972,0.6530964697853656
SIM,1831,36,35-39,1867,23
STAT,1851,46,20-24,1897,0.01865500725285556
STAT,1866,30,40-44,1896,8.146342560299399
STAT,1945,15,25-29,1960,95.64860081279515
SIM,1904,27,40-44,1931,9
STAT,1909,19,30-34,1928,4.804136374705062
SIM,1822,41,35-39,1863,5
SIM,1851,36,20-24,1887,4
SIM,1877,51,na,1928,4396
SIM,1934,37,na,1971,10349
SIM,1882,38,na,1920,4867
SIM,1930,25,na,1955,10118
SIM,1856,83,na,1939,551
STAT,1895,38,35-39,1933,18.520994162973665
STAT,1883,45,15-19,1928,8.016216164988284E-4
STAT,1904,33,25-29,1937,16.976424640109773
STAT,1845,44,30-34,1889,1.758379331643081
STAT,1828,47,50-100,1875,0.4423761550634551
STAT,1829,28,na,1857,3349.601620559813
STAT,1773,110,na,1883,0.003671423607690901
SIM,1915,42,na,1957,7632
STAT,1822,49,na,1871,2868.0648304198903
STAT,1866,44,45-49,1910,2.7513129167811057
SIM,1853,44,30-34,1897,4
STAT,1941,28,30-34,1969,81.82572569617075
STAT,1873,8,na,1881,5537.50190673234
STAT,1923,44,15-19,1967,0.003611795273317233
SIM,1912,33,25-29,1945,24
STAT,1828,47,35-39,1875,0.2521688187986063
STAT,1844,15,30-34,1859,3.310834037863117
SIM,1874,44,45-49,1918,3
SIM,1917,19,30-34,1936,34
STAT,1935,10,na,1945,10974.758153707322
STAT,1817,39,15-19,1856,0.35026954239848884
SIM,1849,37,50-100,1886,3
SIM,1819,97,na,1916,8
STAT,1914,42,na,1956,7433.617667790477
SIM,1914,21,35-39,1935,22
STAT,1887,18,30-34,1905,3.5907880461818076
STAT,1889,26,40-44,1915,7.485251198061258
SIM,1842,32,na,1874,3768
SIM,1904,17,50-100,1921,2
STAT,1901,22,50-100,1923,1.1529739594167914
STAT,1886,29,35-39,1915,20.423936770696073
SIM,1836,69,na,1905,1813
SIM,1875,26,20-24,1901,24
SIM,1827,38,35-39,1865,20
SIM,1828,27,30-34,1855,54
SIM,1845,23,15-19,1868,6
SIM,1933,36,na,1969,10797
STAT,1915,38,30-34,1953,3.7003177249370593
STAT,1825,49,15-19,1874,8.438671513958872E-4
STAT,1884,27,na,1911,4759.37282565361
STAT,1921,30,50-100,1951,1.8727203904934377
STAT,1806,96,na,1902,5.846789124670626
STAT,1852,25,30-34,1877,47.4256724347562
STAT,1777,82,na,1859,279.45412392742963
STAT,1822,51,35-39,1873,0.026269461753694545
STAT,1903,34,30-34,1937,28.581759092291442
SIM,1832,79,na,1911,860
SIM,1838,41,50-100,1879,5
SIM,1866,20,40-44,1886,2
STAT,1837,23,15-19,1860,5.977406924745674
STAT,1843,36,20-24,1879,1.2737506468813993
STAT,1882,16,45-49,1898,0.12883091484034684
SIM,1860,25,30-34,1885,65
SIM,1943,9,na,1952,8644
STAT,1842,47,25-29,1889,0.08577003793710555
STAT,1910,37,50-100,1947,0.8112712408242021
STAT,1923,25,na,1948,8742.492376460601
STAT,1924,0,na,1924,10832.04445561066
SIM,1936,22,25-29,1958,190
SIM,1865,66,na,1931,2974
SIM,1804,98,na,1902,1
SIM,1918,47,na,1965,8145
STAT,1804,52,na,1856,2331.3319363535
STAT,1885,16,30-34,1901,3.212019103584165
STAT,1927,15,na,1942,9284.480367653376
STAT,1928,22,25-29,1950,232.88347857724875
STAT,1928,38,40-44,1966,3.8164465526962936
SIM,1917,22,20-24,1939,248
STAT,1841,109,na,1950,0.0010322782264442962
STAT,1926,15,15-19,1941,112.87891796194901
SIM,1812,46,35-39,1858,1
STAT,1911,40,15-19,1951,0.0029946294836356
STAT,1840,29,50-100,1869,1.1348191809156374
SIM,1864,36,50-100,1900,3
SIM,1877,23,20-24,1900,134
SIM,1897,26,40-44,1923,11
STAT,1842,44,15-19,1886,0.02073369951379229
STAT,1850,35,50-100,1885,1.9523988946094673
SIM,1862,37,35-39,1899,16
SIM,1906,22,45-49,1928,2
SIM,1859,72,na,1931,2063
STAT,1875,6,na,1881,5659.752288505866
SIM,1867,15,15-19,1882,15
SIM,1810,76,na,1886,780
STAT,1854,22,30-34,1876,32.08359436566056
SIM,1885,80,na,1965,2001
STAT,1838,25,50-100,1863,1.1172781093622943
STAT,1864,50,na,1914,3942.993822784783
STAT,1909,22,20-24,1931,208.83142355992692
STAT,1864,37,35-39,1901,12.76881226359165
STAT,1889,42,50-100,1931,2.627572238465624
STAT,1837,57,na,1894,2800.934299324632
STAT,1862,24,na,1886,4119.462042082301
STAT,1759,108,na,1867,0.004090128172879556
STAT,1825,38,na,1863,3273.1773417032923
STAT,1871,37,35-39,1908,14.191923149287646
STAT,1819,38,35-39,1857,38.446056566947014
STAT,1871,25,40-44,1896,6.051422136172919
SIM,1852,93,na,1945,31
SIM,1894,29,35-39,1923,36
STAT,1906,21,35-39,1927,17.22534052991745
SIM,1862,22,30-34,1884,42
SIM,1895,18,30-34,1913,5
STAT,1827,53,20-24,1880,0.001261041153326843
STAT,1867,19,50-100,1886,0.09361821901717997
SIM,1909,40,25-29,1949,2
STAT,1813,66,na,1879,1731.1634351701423
STAT,1877,20,15-19,1897,6.959855465962782
STAT,1816,46,50-100,1862,1.2253721280122316
STAT,1948,9,na,1957,9081.847780553364
STAT,1871,15,30-34,1886,3.2570324831791617
STAT,1912,16,na,1928,7909.174456209165
SIM,1864,37,45-49,1901,8
SIM,1877,69,na,1946,2833
STAT,1890,25,50-100,1915,1.5876399764956093
SIM,1901,27,30-34,1928,98
STAT,1867,22,40-44,1889,3.9576040682177185
STAT,1910,49,35-39,1959,0.24160814152093224
STAT,1923,48,30-34,1971,0.20996311287864197
SIM,1858,29,25-29,1887,73
STAT,1814,104,na,1918,0.05740402746466116
SIM,1889,16,40-44,1905,4
SIM,1854,17,30-34,1871,4
STAT,1898,19,45-49,1917,0.1775747056084977
STAT,1881,84,na,1965,1147.9348786119028
STAT,1812,81,na,1893,512.5941090030215
SIM,1820,35,na,1855,3192
STAT,1852,65,na,1917,2693.4795490525803
STAT,1830,33,30-34,1863,34.00829641758538
STAT,1900,17,20-24,1917,49.66868826224151
SIM,1833,40,40-44,1873,10
STAT,1854,37,35-39,1891,10.84269864179643
SIM,1887,19,40-44,1906,1
STAT,1909,43,50-100,1952,0.22070974823308087
STAT,1939,18,na,1957,7439.445817766854
SIM,1900,43,na,1943,6717
SIM,1862,52,na,1914,3917
STAT,1899,48,20-24,1947,0.018495407872942855
STAT,1930,23,25-29,1953,238.24335209337804
STAT,1888,33,40-44,1921,10.30833917988573
SIM,1758,96,na,1854,4
STAT,1894,44,20-24,1938,0.028225588001361733
SIM,1934,15,15-19,1949,110
STAT,1915,28,50-100,1943,2.0433376553927514
SIM,1896,33,40-44,1929,3
STAT,1846,17,30-34,1863,3.066821599811701
SIM,1868,39,35-39,1907,20
SIM,1922,32,40-44,1954,15
STAT,1828,32,30-34,1860,39.13830540401259
STAT,1862,37,25-29,1899,4.970073738219212
STAT,1890,37,45-49,1927,4.914255582024696
STAT,1926,25,25-29,1951,160.40816355126938
SIM,1811,43,25-29,1854,3
STAT,1840,62,na,1902,2638.220873226108
STAT,1838,54,40-44,1892,0.013856365306990267
STAT,1870,34,25-29,1904,20.135434730290132
STAT,1848,104,na,1952,0.10936854034864425
SIM,1887,10,na,1897,6412
SIM,1927,25,25-29,1952,185
STAT,1878,24,15-19,1902,6.915071373763778
SIM,1927,21,na,1948,9302
SIM,1886,24,15-19,1910,7
STAT,1818,51,20-24,1869,0.0031825369764873278
STAT,1823,46,45-49,1869,0.7396613697184791
STAT,1874,49,na,1923,4555.338847351866
SIM,1839,28,45-49,1867,5
STAT,1858,20,40-44,1878,3.8188824588368253
SIM,1875,22,40-44,1897,4
SIM,1889,76,na,1965,2947
SIM,1923,38,30-34,1961,8
STAT,1840,31,35-39,1871,17.990237129027665
SIM,1882,18,20-24,1900,39
SIM,1944,24,40-44,1968,10
SIM,1923,19,30-34,1942,38
SIM,1935,19,na,1954,10440
SIM,1896,23,30-34,1919,70
STAT,1895,23,30-34,1918,46.730503613780066
STAT,1936,24,40-44,1960,6.489108691555705
STAT,1850,21,na,1871,3963.2760375979947
SIM,1867,26,30-34,1893,57
STAT,1888,23,30-34,1911,42.387695948480136
STAT,1914,32,40-44,1946,7.956963758449748
STAT,1885,42,20-24,1927,0.3188681685072765
SIM,1926,15,25-29,1941,135
SIM,1934,25,25-29,1959,190
SIM,1891,48,25-29,1939,1
STAT,1907,44,50-100,1951,0.21482612804721812
SIM,1908,25,15-19,1933,2
STAT,1940,22,40-44,1962,6.918122554909345
STAT,1797,65,na,1862,1589.8904727877837
SIM,1826,51,na,1877,2755
SIM,1886,29,45-49,1915,5
SIM,1920,20,50-100,1940,2
SIM,1921,11,na,1932,9186
STAT,1858,39,25-29,1897,4.487437553499581
STAT,1915,19,30-34,1934,5.124939472286843
STAT,1901,37,30-34,1938,3.2524428396663527
STAT,1838,54,35-39,1892,0.01133113987997809
STAT,1838,107,na,1945,0.006382416693654243
SIM,1855,32,40-44,1887,12
STAT,1918,15,25-29,1933,19.197626601587462
SIM,1871,72,na,1943,2337
STAT,1853,43,20-24,1896,0.24945906151920433
SIM,1853,47,35-39,1900,1
STAT,1886,45,30-34,1931,0.2084294814693398
STAT,1844,41,20-24,1885,0.2660543204557925
SIM,1942,10,na,1952,8490
STAT,1902,29,30-34,1931,71.28912869971997
SIM,1819,38,45-49,1857,6
SIM,1829,32,30-34,1861,41
STAT,1794,100,na,1894,0.41584583909073075
STAT,1919,25,25-29,1944,144.57586298387108
STAT,1846,21,50-100,1867,0.7762637923301777
STAT,1871,20,na,1891,4773.819935296014
STAT,1889,48,na,1937,5533.258793123949
SIM,1836,32,30-34,1868,35
SIM,1864,26,45-49,1890,4
SIM,1884,22,15-19,1906,7
STAT,1864,47,45-49,1911,0.42406675893440243
STAT,1904,64,na,1968,5625.638541611067
STAT,1952,15,25-29,1967,104.92886642209697
STAT,1902,16,40-44,1918,0.5228007959602826
SIM,1835,84,na,1919,300
SIM,1872,47,45-49,1919,2
STAT,1817,49,25-29,1866,0.26963939916382995
STAT,1934,38,40-44,1972,4.168520494192831
STAT,1857,18,45-49,1875,0.120149390452376
STAT,1847,32,40-44,1879,7.761731758496343
SIM,1868,55,na,1923,4064
SIM,1910,29,30-34,1939,100
STAT,1857,77,na,1934,1360.7234661167836
SIM,1834,25,20-24,1859,19
SIM,1848,54,na,1902,3206
STAT,1833,50,40-44,1883,0.014864876485973651
SIM,1901,28,na,1929,6737
STAT,1829,52,35-39,1881,0.011941119397822672
SIM,1937,26,na,1963,7477
SIM,1811,52,na,1863,2436
SIM,1885,27,na,1912,5008
STAT,1904,28,45-49,1932,3.2071507065176807
SIM,1912,28,45-49,1940,4
STAT,1918,19,na,1937,8046.400535231494
STAT,1955,1,na,1956,10555.410706193123
SIM,1904,19,20-24,1923,47
SIM,1902,46,50-100,1948,2
STAT,1800,96,na,1896,7.33404790815368
STAT,1825,40,40-44,1865,5.426257609262842
STAT,1878,29,45-49,1907,2.325224682685753
SIM,1891,49,na,1940,5696
SIM,1901,10,na,1911,7388
STAT,1823,90,na,1913,94.60879423407494
STAT,1856,26,45-49,1882,1.8057600904555329
SIM,1920,38,45-49,1958,2
SIM,1929,32,35-39,1961,27
STAT,1883,48,25-29,1931,0.11285803544361835
SIM,1889,54,na,1943,5296
STAT,1892,31,40-44,1923,11.009310432916049
STAT,1893,16,20-24,1909,45.494339535020195
STAT,1896,43,35-39,1939,0.33287226581858675
STAT,1912,38,45-49,1950,1.3374835972634118
SIM,1893,78,na,1971,2868
SIM,1807,87,na,1894,110
SIM,1910,19,45-49,1929,1
SIM,1873,28,20-24,1901,23
STAT,1825,54,na,1879,2653.248855456774
SIM,1936,15,25-29,1951,102
STAT,1784,106,na,1890,0.021961943934058238
SIM,1934,19,30-34,1953,45
SIM,1767,95,na,1862,6
SIM,1888,24,40-44,1912,6
STAT,1852,31,na,1883,3978.9939462361444
STAT,1869,33,30-34,1902,34.02342393080304
SIM,1945,15,35-39,1960,11
SIM,1943,3,na,1946,8770
STAT,1906,44,15-19,1950,0.0027841383164100048
STAT,1866,33,45-49,1899,3.2358640766050524
SIM,1887,44,na,1931,5562
SIM,1831,43,35-39,1874,7
STAT,1919,32,25-29,1951,20.134874551303998
STAT,1851,37,25-29,1888,4.511077987348076
STAT,1832,33,40-44,1865,7.290889161578084
SIM,1872,25,35-39,1897,29
STAT,1888,31,15-19,1919,0.3413255873411382
STAT,1936,8,na,1944,7713.438987495845
SIM,1870,35,35-39,1905,19
STAT,1864,25,35-39,1889,17.60548796310038
SIM,1820,54,na,1874,2483
SIM,1813,81,na,1894,487
STAT,1915,27,15-19,1942,1.4543588534191303
STAT,1856,38,20-24,1894,1.1952068492386383
STAT,1914,28,50-100,1942,2.019723771894698
STAT,1851,86,na,1937,343.9486044010579
SIM,1849,32,40-44,1881,9
SIM,1923,27,15-19,1950,2
SIM,1857,12,na,1869,4980
STAT,1880,50,20-24,1930,0.0015925386074382441
STAT,1878,28,30-34,1906,52.92922925369517
SIM,1782,87,na,1869,87
STAT,1895,35,30-34,1930,14.158681389697161
STAT,1879,43,50-100,1922,2.2156089111506354
SIM,1886,16,30-34,1902,2
STAT,1954,18,50-100,1972,0.9350022744069033
STAT,1840,46,na,1886,3317.082073231691
STAT,1943,26,15-19,1969,1.5190807626958551
STAT,1845,38,50-100,1883,1.9672395580313822
STAT,1814,50,30-34,1864,0.030764445053489485
STAT,1844,17,20-24,1861,36.39370851681967
SIM,1840,21,40-44,1861,6
SIM,1868,33,20-24,1901,1
STAT,1873,27,35-39,1900,19.800142679412833
STAT,1874,34,na,1908,4892.439139249583
SIM,1877,33,30-34,1910,44
SIM,1886,28,30-34,1914,65
SIM,1779,80,na,1859,430
STAT,1905,45,45-49,1950,0.39270141232988837
STAT,1920,34,30-34,1954,34.546785837206514
SIM,1944,22,15-19,1966,11
STAT,1870,43,50-100,1913,2.0796295011279
SIM,1875,59,na,1934,4352
STAT,1909,29,40-44,1938,8.936972344589284
SIM,1875,29,25-29,1904,102
SIM,1889,27,50-100,1916,2
SIM,1906,1,na,1907,7857
SIM,1840,33,40-44,1873,18
SIM,1923,15,15-19,1938,98
SIM,1932,21,50-100,1953,2
STAT,1901,21,15-19,1922,9.355718971969786
STAT,1910,33,25-29,1943,17.929217291419487
STAT,1902,19,45-49,1921,0.18525821549113494
SIM,1819,37,30-34,1856,13
SIM,1837,94,na,1931,10
SIM,1852,17,20-24,1869,34
STAT,1847,37,50-100,1884,1.9417641599951723
STAT,1833,31,50-100,1864,1.5704718336858023
STAT,1925,34,50-100,1959,1.9799281929863035
STAT,1928,22,30-34,1950,72.46295984915903
SIM,1862,61,na,1923,3419
STAT,1862,49,na,1911,3802.589702608669
SIM,1831,38,50-100,1869,5
SIM,1794,72,na,1866,981
STAT,1812,42,20-24,1854,1.3002996816450836
STAT,1869,45,30-34,1914,0.19132030042381637
SIM,1832,39,20-24,1871,1
STAT,1783,97,na,1880,1.6681497895246822
SIM,1936,22,30-34,1958,69
STAT,1836,94,na,1930,26.573152568530418
STAT,1845,38,45-49,1883,3.194208121194527
STAT,1849,67,na,1916,2507.494794204553
SIM,1827,32,20-24,1859,6
STAT,1929,36,50-100,1965,1.0895066489745107
SIM,1884,29,35-39,1913,30
STAT,1838,35,35-39,1873,11.793113401981254
STAT,1835,21,15-19,1856,5.72328587907441
SIM,1868,52,na,1920,4227
SIM,1877,45,30-34,1922,1
SIM,1881,27,35-39,1908,19
STAT,1932,34,15-19,1966,0.34458949799530025
SIM,1918,34,40-44,1952,14
STAT,1888,45,40-44,1933,0.41273976966674475
STAT,1855,32,30-34,1887,26.80744573366196
STAT,1824,39,20-24,1863,2.1414843833446433
SIM,1904,38,50-100,1942,3
STAT,1837,27,30-34,1864,45.0583632667078
STAT,1919,44,25-29,1963,0.15573550727900412
STAT,1871,27,25-29,1898,84.87843625413403
STAT,1871,28,45-49,1899,2.219997892803794
STAT,1889,29,45-49,1918,2.7451519587809936
STAT,1903,30,15-19,1933,0.4127937879113662
STAT,1926,11,na,1937,9824.16024149755
STAT,1870,50,20-24,1920,0.0014841929874460944
STAT,1916,45,20-24,1961,0.022999804688971035
STAT,1847,48,15-19,1895,6.020748642191018E-4
SIM,1894,23,20-24,1917,184
SIM,1843,21,15-19,1864,8
SIM,1902,44,30-34,1946,1
STAT,1889,19,50-100,1908,0.12134691854050947
STAT,1923,21,35-39,1944,22.18626989309965
STAT,1886,23,20-24,1909,146.46350420395623
SIM,1931,21,35-39,1952,26
STAT,1937,15,35-39,1952,8.284366341267672
SIM,1917,29,40-44,1946,15
SIM,1845,27,30-34,1872,64
SIM,1937,32,25-29,1969,25
STAT,1815,49,15-19,1864,0.002082800476821748
SIM,1847,23,40-44,1870,2
STAT,1823,43,35-39,1866,5.878690172598758
STAT,1869,26,30-34,1895,49.448569282334105
STAT,1805,50,50-100,1855,0.1234730248499504
STAT,1868,54,20-24,1922,0.0013789393913340967
SIM,1862,34,30-34,1896,35
STAT,1926,19,30-34,1945,30.014375431722428
SIM,1869,45,50-100,1914,3
SIM,1846,35,35-39,1881,15
SIM,1906,4,na,1910,7717
SIM,1922,9,na,1931,9813
SIM,1871,28,50-100,1899,4
SIM,1865,54,45-49,1919,2
SIM,1927,32,25-29,1959,31
STAT,1862,46,na,1908,3894.704418004204
STAT,1882,63,na,1945,3510.434245579176
STAT,1870,59,na,1929,3853.5536745936215
STAT,1857,54,45-49,1911,0.022217164308874715
SIM,1897,29,45-49,1926,6
SIM,1914,29,30-34,1943,79
STAT,1886,35,20-24,1921,1.6590131780785053
STAT,1899,25,50-100,1924,1.7821266000435447
STAT,1825,32,50-100,1857,3.2517780016554845
SIM,1911,30,15-19,1941,4
STAT,1917,36,15-19,1953,0.04047357737623574
SIM,1829,42,40-44,1871,10
SIM,1845,27,na,1872,4260
SIM,1863,32,30-34,1895,36
STAT,1838,47,35-39,1885,0.19493288113683993
STAT,1933,2,na,1935,11058.280177335873
SIM,1877,38,25-29,1915,9
STAT,1890,34,35-39,1924,24.751058243098775
STAT,1847,30,15-19,1877,0.26022569594609346
STAT,1903,21,50-100,1924,1.1761670268543116
STAT,1863,15,40-44,1878,0.3733630945332981
STAT,1869,38,25-29,1907,5.606468088707106
STAT,1871,43,50-100,1914,2.104473712907404
STAT,1787,87,na,1874,109.45868639118436
STAT,1891,18,20-24,1909,44.14123454083857
SIM,1846,46,50-100,1892,1
STAT,1840,40,30-34,1880,1.9516550991047898
STAT,1819,44,20-24,1863,0.688671176854439
STAT,1910,46,30-34,1956,0.16845749632426657
STAT,1939,23,45-49,1962,2.2816589343153995
SIM,1896,45,40-44,1941,1
SIM,1807,72,na,1879,984
SIM,1834,21,40-44,1855,4
SIM,1966,4,na,1970,9437
STAT,1970,1,na,1971,9953.276621143124
SIM,1870,22,20-24,1892,134
SIM,1819,75,na,1894,945
STAT,1888,38,35-39,1926,16.799781909737458
SIM,1854,57,na,1911,3329
SIM,1906,37,50-100,1943,1
STAT,1841,27,20-24,1868,21.141540037290024
STAT,1857,96,na,1953,13.517089951188055
SIM,1857,31,50-100,1888,2
STAT,1839,23,40-44,1862,4.150624978870015
SIM,1821,33,30-34,1854,40
SIM,1929,20,50-100,1949,2
SIM,1858,26,20-24,1884,25
STAT,1833,41,45-49,1874,2.4190639804213334
SIM,1853,22,20-24,1875,131
SIM,1903,35,40-44,1938,5
STAT,1884,73,na,1957,2499.5656846426464
SIM,1857,15,na,1872,4840
STAT,1893,19,25-29,1912,14.428340345817308
STAT,1799,75,na,1874,857.8873417907217
STAT,1925,44,25-29,1969,0.1739889718056627
SIM,1843,28,35-39,1871,29
STAT,1882,44,na,1926,4485.7477676796425
STAT,1800,62,na,1862,1942.4932694394395
STAT,1916,32,15-19,1948,0.26794445630297437
SIM,1857,31,na,1888,4261
STAT,1935,28,na,1963,10310.143994123293
STAT,1845,34,20-24,1879,4.850698204329015
SIM,1779,83,na,1862,217
SIM,1832,54,na,1886,2806
STAT,1929,32,25-29,1961,23.708377622098876
SIM,1861,43,20-24,1904,1
STAT,1815,79,na,1894,649.8181266435383
STAT,1920,11,na,1931,8989.40473882127
SIM,1914,33,35-39,1947,27
STAT,1862,22,20-24,1884,121.77478382078696
SIM,1792,62,na,1854,1780
STAT,1861,20,50-100,1881,0.7144627606382179
STAT,1865,29,na,1894,4347.523415648483
STAT,1896,40,30-34,1936,0.21502314622557128
STAT,1879,36,35-39,1915,15.013298428142972
SIM,1896,38,35-39,1934,26
SIM,1860,28,35-39,1888,26
SIM,1869,24,15-19,1893,8
STAT,1902,38,na,1940,6737.131365898194
SIM,1867,28,20-24,1895,3
STAT,1841,39,15-19,1880,0.09402212025157504
STAT,1866,45,20-24,1911,0.02258469463084703
STAT,1900,23,15-19,1923,9.214066889273647
SIM,1853,34,20-24,1887,4
STAT,1821,34,35-39,1855,50.90971697402205
STAT,1850,29,20-24,1879,20.864791753993817
STAT,1871,22,30-34,1893,35.74061360738612
STAT,1886,59,na,1945,4143.353948002036
SIM,1882,1,na,1883,6724
STAT,1870,75,na,1945,2041.2454592748322
SIM,1912,37,40-44,1949,6
STAT,1850,50,35-39,1900,0.013389699858547535
SIM,1907,18,25-29,1925,17
SIM,1878,17,40-44,1895,1
STAT,1895,36,na,1931,6229.902725412518
STAT,1852,28,35-39,1880,17.78343469059313
STAT,1832,37,15-19,1869,0.09250315110725241
STAT,1842,43,45-49,1885,2.2759878524102484
SIM,1844,64,na,1908,2428
STAT,1836,32,20-24,1868,4.54382872675012
SIM,1829,47,35-39,1876,1
SIM,1850,43,45-49,1893,5
SIM,1903,23,40-44,1926,8
SIM,1906,59,na,1965,6076
SIM,1905,31,35-39,1936,13
STAT,1871,24,20-24,1895,137.4083349637149
STAT,1915,15,15-19,1930,19.274018330589747
STAT,1945,19,40-44,1964,3.0835142115585255
SIM,1864,16,na,1880,5021
SIM,1908,29,30-34,1937,78
STAT,1832,26,35-39,1858,17.13649224187235
STAT,1936,22,15-19,1958,10.280352875358767
STAT,1793,75,na,1868,806.4893001251733
SIM,1891,3,na,1894,6770
STAT,1830,84,na,1914,459.3689898466191
STAT,1877,14,na,1891,5398.396769757689
SIM,1881,22,40-44,1903,3
STAT,1837,25,40-44,1862,5.437815586900919
STAT,1883,44,45-49,1927,2.9296572974804223
STAT,1907,23,50-100,1930,1.2067293570815525
STAT,1897,39,20-24,1936,0.4446483291961082
STAT,1851,83,na,1934,615.4023410384015
SIM,1780,77,na,1857,537
STAT,1859,28,20-24,1887,19.045952999930126
STAT,1922,43,50-100,1965,0.2718279829494923
SIM,1887,36,35-39,1923,22
STAT,1850,17,20-24,1867,33.21672970342757
STAT,1892,35,20-24,1927,1.9674433435544785
SIM,1822,61,na,1883,2119
STAT,1856,15,na,1871,4279.6469864470555
STAT,1864,44,35-39,1908,3.224952872413257
STAT,1807,51,45-49,1858,0.09646002979146977
STAT,1945,22,25-29,1967,204.4413095750601
SIM,1919,25,35-39,1944,48
STAT,1825,44,20-24,1869,0.3509821381575264
STAT,1932,15,15-19,1947,121.94067605615106
SIM,1883,60,na,1943,3935
STAT,1904,37,40-44,1941,2.738861244716542
STAT,1871,23,na,1894,4730.841934491423
STAT,1769,102,na,1871,0.10885305872490401
STAT,1919,29,40-44,1948,10.096430270975642
SIM,1866,42,na,1908,4466
STAT,1833,53,45-49,1886,0.01930927843383202
STAT,1813,69,na,1882,1547.953806561253
SIM,1814,43,40-44,1857,9
STAT,1883,20,50-100,1903,0.8139956056073949
SIM,1927,29,40-44,1956,15
SIM,1872,44,35-39,1916,10
SIM,1940,15,15-19,1955,91
SIM,1912,25,40-44,1937,13
SIM,1841,41,45-49,1882,3
STAT,1879,48,35-39,1927,0.29203072754659454
STAT,1902,25,15-19,1927,1.3024396318812828
STAT,1934,1,na,1935,11409.631881996753
SIM,1845,25,40-44,1870,5
STAT,1921,25,40-44,1946,10.560026028634468
STAT,1926,14,na,1940,9777.765086714762
SIM,1940,26,50-100,1966,4
SIM,1877,66,na,1943,3197
SIM,1934,15,na,1949,10016
STAT,1845,22,20-24,1867,131.82768595400822
SIM,1856,67,na,1923,2581
SIM,1840,26,35-39,1866,24
SIM,1891,44,45-49,1935,1
STAT,1847,47,45-49,1894,0.35806752502437783
SIM,1913,16,na,1929,8211
SIM,1882,81,na,1963,1532
SIM,1945,21,na,1966,8368
STAT,1826,28,25-29,1854,325.11177267044064
STAT,1877,46,35-39,1923,0.2944357399645129
SIM,1887,48,35-39,1935,1
STAT,1896,3,na,1899,7049.080765597555
STAT,1941,17,15-19,1958,94.41227803533165
STAT,1876,16,20-24,1892,37.12336761970638
STAT,1816,53,45-49,1869,0.06705021286343267
STAT,1931,35,45-49,1966,1.8266333862763462
SIM,1881,34,40-44,1915,8
STAT,1904,25,40-44,1929,8.74227081132595
SIM,1817,41,50-100,1858,4
STAT,1888,49,15-19,1937,5.273553795646653E-4
STAT,1935,19,40-44,1954,3.841776313034395
SIM,1943,19,40-44,1962,3
SIM,1882,18,45-49,1900,2
STAT,1880,53,25-29,1933,0.00741489422293952
SIM,1786,68,na,1854,1478
SIM,1915,36,50-100,1951,1
STAT,1825,32,na,1857,3378.2864141442747
STAT,1901,34,20-24,1935,7.577112073969163
SIM,1843,17,na,1860,4371
STAT,1947,13,na,1960,8934.532565147387
SIM,1834,28,25-29,1862,83
STAT,1890,15,35-39,1905,1.3589382261350493
STAT,1873,34,40-44,1907,8.822994366081863
STAT,1832,36,45-49,1868,3.3190530714355586
SIM,1847,38,20-24,1885,2
SIM,1882,42,45-49,1924,7
STAT,1836,45,35-39,1881,0.19990301575626768
STAT,1930,27,40-44,1957,11.969593984593656
SIM,1866,45,na,1911,4458
SIM,1827,42,30-34,1869,3
SIM,1831,24,35-39,1855,15
SIM,1893,28,50-100,1921,2
STAT,1857,51,40-44,1908,0.016651887116679767
SIM,1872,22,30-34,1894,48
STAT,1829,90,na,1919,93.30852848861187
STAT,1842,30,50-100,1872,1.6824705436980503
STAT,1886,33,30-34,1919,37.066033201911196
STAT,1885,28,50-100,1913,1.281444547064534
SIM,1829,50,na,1879,2928
SIM,1877,35,20-24,1912,2
SIM,1788,94,na,1882,6
STAT,1901,40,15-19,1941,0.0027387575066627912
SIM,1888,27,45-49,1915,6
STAT,1851,39,15-19,1890,0.08617370804569363
STAT,1830,53,50-100,1883,0.02247820343070726
STAT,1886,38,25-29,1924,6.1078371402042615
SIM,1887,43,40-44,1930,10
SIM,1944,20,25-29,1964,223
SIM,1843,15,20-24,1858,31
STAT,1854,37,50-100,1891,1.882114039172539
SIM,1871,75,na,1946,1846
STAT,1883,48,na,1931,4408.205070680087
STAT,1886,37,na,1923,5022.808015548187
STAT,1926,17,40-44,1943,3.462843246277524
SIM,1934,17,40-44,1951,6
STAT,1852,18,25-29,1870,10.859147164156818
SIM,1918,49,45-49,1967,2
SIM,1888,29,na,1917,5562
SIM,1893,22,na,1915,6246
STAT,1851,34,20-24,1885,4.271644572669906
STAT,1850,22,50-100,1872,0.7504611076618692
STAT,1869,35,20-24,1904,1.5228311148667353
STAT,1849,33,45-49,1882,2.87661322889729
STAT,1890,31,30-34,1921,43.21681839994657
SIM,1866,26,na,1892,4657
STAT,1840,43,35-39,1883,2.691866900607611
SIM,1862,28,45-49,1890,3
SIM,1862,37,50-100,1899,5
SIM,1894,38,25-29,1932,10
STAT,1935,25,na,1960,10324.07523404181
SIM,1868,24,30-34,1892,1
SIM,1949,21,20-24,1970,254
SIM,1816,41,50-100,1857,6
SIM,1908,31,50-100,1939,4
SIM,1855,82,na,1937,723
STAT,1819,47,25-29,1866,0.2417179312997155
STAT,1874,42,45-49,1916,3.091114032890527
STAT,1857,93,na,1950,46.00652511377635
SIM,1825,34,45-49,1859,6
SIM,1896,48,45-49,1944,1
STAT,1913,41,na,1954,7358.582998534236
STAT,1814,53,35-39,1867,0.041905149625829655
STAT,1954,15,35-39,1969,10.480933696219545
STAT,1852,50,45-49,1902,0.023462422313491813
STAT,1860,39,25-29,1899,4.674595810171515
STAT,1932,36,na,1968,10219.044304186575
STAT,1878,26,40-44,1904,6.340228556805985
STAT,1920,44,40-44,1964,0.5559283672587615
STAT,1952,19,40-44,1971,3.3826908921387986
SIM,1892,25,45-49,1917,2
STAT,1823,31,40-44,1854,28.348274418489858
SIM,1835,65,na,1900,2235
STAT,1872,85,na,1957,658.9038125931751
STAT,1936,20,25-29,1956,178.51078436556702
SIM,1937,29,na,1966,7483
STAT,1830,110,na,1940,3.8159060208970753E-4
STAT,1932,23,35-39,1955,24.876180778886045
STAT,1834,49,25-29,1883,0.07925705670866984
STAT,1899,33,40-44,1932,11.949654650329567
STAT,1783,91,na,1874,31.69277174370119
STAT,1896,34,50-100,1930,2.4221862063057107
SIM,1831,40,30-34,1871,3
SIM,1940,23,35-39,1963,27
STAT,1874,18,45-49,1892,0.1347274622761435
SIM,1817,65,na,1882,1872
STAT,1890,22,40-44,1912,5.136913722272115
SIM,1819,35,40-44,1854,9
STAT,1864,22,30-34,1886,32.67378989391776
SIM,1844,42,na,1886,3304
SIM,1850,30,50-100,1880,3
SIM,1886,26,40-44,1912,13
STAT,1921,28,45-49,1949,3.8740043255927707
STAT,1921,43,50-100,1964,0.2667492161674747
SIM,1891,41,40-44,1932,9
SIM,1931,26,na,1957,9779
STAT,1942,22,15-19,1964,11.27234878540558
STAT,1881,44,35-39,1925,3.487141759368264
STAT,1837,79,na,1916,974.3818031793503
STAT,1888,48,45-49,1936,0.3137819800967773
STAT,1911,37,50-100,1948,0.8192449368894329
SIM,1852,90,na,1942,86
SIM,1866,35,45-49,1901,6
STAT,1842,72,na,1914,1880.2161229112633
SIM,1936,25,35-39,1961,34
SIM,1901,39,30-34,1940,1
STAT,1875,96,na,1971,101.35622247617552
STAT,1934,20,50-100,1954,1.7919866915567289
SIM,1853,32,30-34,1885,33
SIM,1918,30,25-29,1948,28
STAT,1830,26,25-29,1856,105.43216812805788
STAT,1905,42,40-44,1947,0.4556477066171028
STAT,1855,35,35-39,1890,10.766793001335945
STAT,1900,29,20-24,1929,32.63221410962536
SIM,1849,39,25-29,1888,6
STAT,1862,35,35-39,1897,12.325238878165457
STAT,1906,33,35-39,1939,17.040890364846675
STAT,1928,40,na,1968,9587.147381821465
SIM,1900,49,na,1949,6357
STAT,1814,91,na,1905,49.871604512858426
STAT,1823,40,30-34,1863,4.025022497875322
STAT,1876,22,15-19,1898,6.891198449777248
SIM,1847,53,na,1900,3215
STAT,1820,43,25-29,1863,2.5250618150175668
STAT,1881,81,na,1962,1488.3596265739875
SIM,1836,34,20-24,1870,6
SIM,1890,30,na,1920,6343
STAT,1796,64,na,1860,1697.376458677564
SIM,1899,27,20-24,1926,35
STAT,1835,28,35-39,1863,16.177454096698774
STAT,1858,32,40-44,1890,6.8278059219466165
STAT,1934,36,15-19,1970,0.05357655645706109
STAT,1873,38,15-19,1911,0.11466075998209634
SIM,1830,29,45-49,1859,2
STAT,1849,45,na,1894,3594.273853368224
SIM,1828,48,50-100,1876,2
SIM,1846,32,30-34,1878,37
SIM,1869,56,na,1925,3943
SIM,1943,11,na,1954,8613
STAT,1910,37,40-44,1947,2.892578350776515
STAT,1838,32,30-34,1870,29.362805871256132
SIM,1890,48,na,1938,5914
STAT,1895,33,na,1928,6253.387931311606
SIM,1918,44,na,1962,8211
SIM,1866,32,40-44,1898,14
STAT,1895,16,30-34,1911,4.204777226260522
STAT,1774,109,na,1883,0.004621853333361398
STAT,1927,34,40-44,1961,9.708142084046038
SIM,1840,36,45-49,1876,11
SIM,1860,18,25-29,1878,15
SIM,1868,43,30-34,1911,7
STAT,1928,25,35-39,1953,37.60379496080234
SIM,1857,33,45-49,1890,5
STAT,1869,22,15-19,1891,6.455990548929078
STAT,1847,19,na,1866,4315.8515053393385
STAT,1928,34,25-29,1962,23.306975039263836
STAT,1905,12,na,1917,7542.942710921387
STAT,1919,48,40-44,1967,0.34433645006246477
SIM,1881,24,30-34,1905,40
STAT,1854,28,45-49,1882,1.7715237915810405
STAT,1879,43,40-44,1922,4.717219642593505
STAT,1892,22,na,1914,5979.542691285299
SIM,1908,23,25-29,1931,187
SIM,1880,71,na,1951,2933
SIM,1893,59,na,1952,5049
STAT,1925,38,30-34,1963,4.412529288098141
SIM,1908,27,40-44,1935,11
STAT,1848,52,45-49,1900,0.02366943150775436
STAT,1935,9,na,1944,10993.00654457131
STAT,1910,52,na,1962,6808.572551824463
SIM,1935,34,40-44,1969,16
SIM,1836,25,30-34,1861,49
SIM,1936,34,25-29,1970,19
SIM,1913,42,40-44,1955,1
SIM,1839,21,25-29,1860,113
SIM,1933,38,30-34,1971,8
SIM,1930,9,na,1939,10989
STAT,1837,42,na,1879,3457.7523941137906
STAT,1913,23,25-29,1936,187.8446511869287
STAT,1833,83,na,1916,521.8901413421066
SIM,1900,18,15-19,1918,11
STAT,1854,15,30-34,1869,2.957605299662774
SIM,1871,17,30-34,1888,3
STAT,1859,26,na,1885,3930.751598462096
STAT,1880,24,30-34,1904,37.65969152838375
STAT,1906,48,30-34,1954,0.15867522186478106
SIM,1881,37,45-49,1918,5
STAT,1854,34,30-34,1888,26.84615749710315
STAT,1936,36,40-44,1972,2.971383107749912
SIM,1841,29,20-24,1870,23
STAT,1834,68,na,1902,2030.8795903076348
STAT,1880,15,40-44,1895,0.3909476105085163
STAT,1838,46,50-100,1884,0.3463773512661712
STAT,1832,24,50-100,1856,0.7450599716340977
SIM,1850,40,40-44,1890,9
STAT,1859,19,30-34,1878,2.9391619992855
SIM,1917,15,15-19,1932,20
STAT,1858,41,na,1899,3655.323202137685
STAT,1888,35,30-34,1923,12.842872114926488
STAT,1843,24,45-49,1867,1.2085658124597214
STAT,1848,28,45-49,1876,2.157813843682031
STAT,1839,26,45-49,1865,2.199815416917103
STAT,1812,65,na,1877,1904.9308041395022
SIM,1820,51,na,1871,2631
STAT,1931,32,40-44,1963,10.356469963712044
STAT,1901,44,30-34,1945,0.2226770615234395
SIM,1840,24,50-100,1864,1
SIM,1899,69,na,1968,4676
STAT,1873,37,45-49,1910,4.090746598415739
STAT,1909,25,25-29,1934,129.05929362974837
SIM,1867,19,30-34,1886,5
STAT,1851,103,na,1954,0.22247449106441192
SIM,1855,44,40-44,1899,8
STAT,1906,29,30-34,1935,73.57925556050084
STAT,1875,20,40-44,1895,4.358824163204362
STAT,1904,45,50-100,1949,0.40559173640426927
SIM,1832,27,20-24,1859,24
SIM,1896,35,30-34,1931,21
STAT,1835,51,20-24,1886,9.939152030283595E-4
STAT,1892,38,25-29,1930,7.24335628179142
STAT,1904,21,25-29,1925,166.4411156569462
STAT,1929,30,35-39,1959,23.46745382980463
SIM,1863,35,35-39,1898,16
STAT,1854,52,50-100,1906,0.02302907117492821
STAT,1793,72,na,1865,1071.7419413390319
STAT,1811,80,na,1891,575.0250800130407
STAT,1845,32,30-34,1877,31.98933188011511
STAT,1866,48,25-29,1914,0.10598774503270784
STAT,1869,81,na,1950,1058.2434394637255
STAT,1816,50,40-44,1866,0.05164209215129669
STAT,1827,64,na,1891,2102.0827733770757
STAT,1876,29,35-39,1905,20.011204683123378
STAT,1856,36,50-100,1892,1.9223211123963113
STAT,1895,11,na,1906,6806.351369627063
SIM,1903,38,45-49,1941,2
SIM,1822,95,na,1917,11
SIM,1864,19,na,1883,4930
SIM,1948,19,25-29,1967,127
STAT,1862,25,25-29,1887,74.3538419875708
SIM,1847,26,45-49,1873,3
STAT,1769,87,na,1856,70.73638092000002
STAT,1902,23,na,1925,6722.7346365478925
SIM,1877,39,45-49,1916,4
STAT,1869,39,45-49,1908,3.8618697796154775
SIM,1870,25,25-29,1895,100
STAT,1870,46,25-29,1916,0.11453511445257304
STAT,1938,32,35-39,1970,18.56064613941257
STAT,1920,30,15-19,1950,0.2864936893362715
SIM,1841,50,na,1891,3103
SIM,1884,16,20-24,1900,39
SIM,1886,22,25-29,1908,132
STAT,1838,42,40-44,1880,3.5600969883801596
STAT,1909,15,15-19,1924,18.067532904422922
STAT,1841,106,na,1947,0.017616740570042422
SIM,1820,69,na,1889,1468
SIM,1898,34,45-49,1932,6
SIM,1817,38,35-39,1855,7
STAT,1878,22,25-29,1900,120.74820758397344
SIM,1846,42,40-44,1888,7
SIM,1853,37,25-29,1890,3
SIM,1937,30,35-39,1967,31
STAT,1836,35,25-29,1871,4.798518477294977
SIM,1909,48,na,1957,6856
STAT,1837,21,25-29,1858,105.22731981971666
SIM,1879,92,na,1971,301
STAT,1885,18,20-24,1903,35.546223221838524
STAT,1887,84,na,1971,1534.8358413381109
SIM,1901,33,25-29,1934,32
STAT,1781,87,na,1868,108.45027651201363
STAT,1891,77,na,1968,2967.4329616647196
STAT,1932,19,30-34,1951,32.42388656472703
SIM,1836,38,45-49,1874,4
SIM,1831,91,na,1922,36
STAT,1911,0,na,1911,9077.74189151487
STAT,1844,27,na,1871,4276.628623414947
STAT,1863,71,na,1934,2359.7948996468135
SIM,1858,36,30-34,1894,11
STAT,1825,47,25-29,1872,0.12490815817596325
SIM,1912,21,25-29,1933,200
STAT,1883,26,na,1909,4751.765558769214
STAT,1913,19,20-24,1932,55.69660620685148
STAT,1832,23,30-34,1855,35.0171572521727
STAT,1888,19,50-100,1907,0.11631964345345516
STAT,1873,20,15-19,1893,6.8101748311822705
SIM,1858,93,na,1951,37
STAT,1883,41,40-44,1924,4.483372983885717
STAT,1884,25,45-49,1909,2.2292668939313045
STAT,1763,116,na,1879,1.0930869006228918E-4
SIM,1815,39,20-24,1854,1
STAT,1933,18,na,1951,9926.095057490604
SIM,1810,92,na,1902,40
SIM,1907,48,30-34,1955,1
STAT,1828,44,30-34,1872,2.096099693309758
STAT,1865,16,45-49,1881,0.12423961452516734
STAT,1874,7,na,1881,5605.166090364711
STAT,1847,44,40-44,1891,3.382384718653887
STAT,1861,44,25-29,1905,1.0649005273414207
STAT,1864,32,40-44,1896,7.829115459919473
STAT,1839,53,50-100,1892,0.023203229104234818
SIM,1844,79,na,1923,871
SIM,1893,18,20-24,1911,46
STAT,1842,40,40-44,1882,3.554572995059721
SIM,1905,21,25-29,1926,196
SIM,1921,19,20-24,1940,294
STAT,1848,82,na,1930,765.0585906349228
STAT,1884,70,na,1954,2798.1094559756702
STAT,1846,52,35-39,1898,0.013116375652326788
STAT,1895,29,45-49,1924,2.9010241946351267
SIM,1840,23,30-34,1863,45
SIM,1844,35,25-29,1879,5
STAT,1845,37,25-29,1882,4.6615555938428805
STAT,1914,26,na,1940,7654.568037486826
SIM,1859,78,na,1937,1162
SIM,1921,23,25-29,1944,227
STAT,1949,8,na,1957,9230.750130166896
SIM,1862,15,30-34,1877,7
STAT,1868,104,na,1972,1.6672323661625583
SIM,1839,49,na,1888,3043
STAT,1928,15,25-29,1943,110.77416064985705
SIM,1819,72,na,1891,1213
STAT,1828,38,45-49,1866,3.933632822104684
STAT,1803,51,na,1854,2447.5576674727104
STAT,1925,21,50-100,1946,1.5951602088173815
SIM,1943,15,25-29,1958,119
STAT,1865,5,na,1870,5224.570765088407
SIM,1845,21,25-29,1866,139
STAT,1834,22,45-49,1856,1.2414254981047739
STAT,1878,36,50-100,1914,2.6021429117235053
STAT,1879,33,30-34,1912,36.72760608204727
STAT,1830,87,na,1917,243.28507191799594
SIM,1919,22,30-34,1941,89
SIM,1887,33,30-34,1920,47
STAT,1824,50,na,1874,2671.5464010613778
SIM,1814,46,45-49,1860,1
STAT,1898,25,na,1923,6566.828694521219
SIM,1940,19,30-34,1959,23
SIM,1836,44,30-34,1880,6
STAT,1864,41,30-34,1905,2.0848981509100213
STAT,1867,29,25-29,1896,79.43810192419296
SIM,1872,41,30-34,1913,6
STAT,1935,15,25-29,1950,120.22420970595932
SIM,1878,30,na,1908,5255
SIM,1881,34,na,1915,4068
STAT,1863,17,30-34,1880,3.2153781049340235
STAT,1819,42,30-34,1861,5.322801668445692
STAT,1852,53,50-100,1905,0.02368443231346316
SIM,1872,35,45-49,1907,8
SIM,1894,33,30-34,1927,52
STAT,1910,27,30-34,1937,76.44373268851471
STAT,1949,20,35-39,1969,22.203789615681092
SIM,1886,36,50-100,1922,2
STAT,1844,53,20-24,1897,0.0011725427240720987
SIM,1876,17,15-19,1893,14
SIM,1947,19,na,1966,8681
SIM,1846,90,na,1936,76
SIM,1806,62,na,1868,1951
STAT,1927,39,40-44,1966,3.750352409458408
STAT,1862,40,20-24,1902,0.2769094569287009
SIM,1919,34,25-29,1953,25
SIM,1939,31,45-49,1970,6
SIM,1825,69,na,1894,1566
STAT,1844,67,na,1911,2559.9905107690875
SIM,1942,16,25-29,1958,116
STAT,1836,53,25-29,1889,0.004672668691679928
STAT,1901,38,50-100,1939,0.745529427038264
SIM,1878,46,35-39,1924,1
SIM,1836,29,40-44,1865,6
SIM,1901,49,40-44,1950,3
SIM,1862,37,40-44,1899,16
STAT,1912,44,50-100,1956,0.22712406753746814
STAT,1934,16,25-29,1950,118.68843882025361
STAT,1889,79,na,1968,2583.6039764772186
STAT,1860,34,50-100,1894,1.4898529264297673
SIM,1881,30,25-29,1911,20
STAT,1871,69,na,1940,2944.647843569047
STAT,1897,74,na,1971,3884.672646860997
SIM,1940,19,25-29,1959,122
SIM,1829,59,na,1888,2483
STAT,1897,17,40-44,1914,0.4937727644242034
STAT,1829,103,na,1932,0.1698513328319437
SIM,1876,49,35-39,1925,1
STAT,1852,62,na,1914,2913.0565924647876
SIM,1873,92,na,1965,214
STAT,1860,43,20-24,1903,0.2585849753104932
SIM,1928,12,na,1940,10255
SIM,1955,14,na,1969,10118
STAT,1840,24,35-39,1864,10.558494044251683
STAT,1932,20,30-34,1952,76.62214397433718
STAT,1945,19,35-39,1964,9.250542099080189
STAT,1859,40,15-19,1899,0.02242314918683622
SIM,1811,49,na,1860,2568
SIM,1937,18,40-44,1955,6
STAT,1838,50,25-29,1888,0.0049609202531313385
STAT,1868,17,15-19,1885,11.609863976603174
STAT,1911,29,35-39,1940,29.367368727642575
SIM,1893,46,30-34,1939,1
SIM,1891,18,na,1909,6510
STAT,1831,31,30-34,1862,29.77297782751184
SIM,1807,102,na,1909,2
SIM,1867,22,15-19,1889,7
STAT,1932,19,25-29,1951,115.27754734924304
SIM,1870,40,20-24,1910,2
SIM,1859,16,30-34,1875,3
SIM,1833,64,na,1897,2230
SIM,1838,26,40-44,1864,9
SIM,1879,18,na,1897,5241
STAT,1857,30,50-100,1887,1.4817097008502944
SIM,1841,31,50-100,1872,3
SIM,1928,41,40-44,1969,2
STAT,1859,22,15-19,1881,5.502193184198713
STAT,1837,51,50-100,1888,0.021553747019715956
STAT,1913,26,35-39,1939,30.32405413636459
SIM,1830,25,50-100,1855,3
STAT,1839,106,na,1945,0.018958378735967615
SIM,1921,26,35-39,1947,46
STAT,1866,82,na,1948,869.4668972973836
STAT,1854,37,40-44,1891,6.710656127625198
STAT,1929,36,40-44,1965,3.884623523260881
STAT,1930,23,30-34,1953,74.13071361927895
STAT,1932,37,25-29,1969,2.6719981177774574
STAT,1798,81,na,1879,403.96453306798264
SIM,1890,20,50-100,1910,2
SIM,1846,32,25-29,1878,25
STAT,1911,47,35-39,1958,0.24658256257527006
SIM,1869,35,30-34,1904,13
STAT,1839,80,na,1919,965.8937828462233
STAT,1846,24,50-100,1870,0.7596628376968506
STAT,1955,4,na,1959,10542.221675520384
SIM,1874,46,na,1920,4352
STAT,1927,20,20-24,1947,278.2918410617638
STAT,1838,32,25-29,1870,17.225456496747398
STAT,1865,106,na,1971,0.3183013039586975
SIM,1862,19,40-44,1881,1
STAT,1906,30,30-34,1936,29.74126368494935
STAT,1936,26,30-34,1962,75.78187196878679
SIM,1822,34,35-39,1856,27
STAT,1887,44,na,1931,5150.142986526565
STAT,1855,26,50-100,1881,1.0127207069784303
STAT,1911,9,na,1920,8021.359112334806
STAT,1929,34,45-49,1963,4.031189546317987
STAT,1883,49,30-34,1932,0.1880672277154419
STAT,1847,16,na,1863,4393.01985457149
STAT,1932,0,na,1932,12048.904883487543
SIM,1871,24,30-34,1895,40
STAT,1793,101,na,1894,0.20712033711111283
STAT,1827,95,na,1922,16.0774221879374
STAT,1879,33,25-29,1912,21.54595795680733
STAT,1869,1,na,1870,6921.264894895667
STAT,1894,20,15-19,1914,8.610045162181525
STAT,1809,70,na,1879,1532.3156084547823
STAT,1863,24,30-34,1887,31.658358392217835
STAT,1898,16,na,1914,6919.656287748213
SIM,1899,18,25-29,1917,22
STAT,1926,4,na,1930,9992.526141720724
STAT,1904,33,30-34,1937,28.938301936420533
STAT,1772,88,na,1860,70.52303007813583
SIM,1810,46,50-100,1856,2
STAT,1856,52,na,1908,3337.282647098732
SIM,1859,1,na,1860,6284
STAT,1896,36,35-39,1932,18.950209528822857
STAT,1924,42,15-19,1966,0.0036881219371109213
SIM,1912,33,30-34,1945,33
STAT,1886,35,50-100,1921,2.642335556942235
SIM,1926,15,30-34,1941,33
STAT,1846,27,35-39,1873,17.8793621260134
SIM,1887,33,25-29,1920,25
STAT,1896,30,20-24,1926,7.2654473613513675
SIM,1854,27,35-39,1881,21
STAT,1901,13,na,1914,7290.388587904146
SIM,1905,43,na,1948,6984
SIM,1873,21,30-34,1894,53
STAT,1819,100,na,1919,1.1108806152004151
SIM,1835,48,35-39,1883,1
SIM,1830,26,40-44,1856,6
STAT,1885,30,45-49,1915,3.533777596489028
STAT,1902,36,30-34,1938,3.2958117353676264
STAT,1904,15,30-34,1919,4.641678840420197
SIM,1849,24,20-24,1873,120
STAT,1914,39,30-34,1953,3.6387916525078747
STAT,1916,18,30-34,1934,5.209086509618781
SIM,1940,20,30-34,1960,68
STAT,1811,50,15-19,1861,1.6580312245447176E-4
STAT,1918,15,30-34,1933,5.399678268275934
SIM,1914,26,50-100,1940,3
STAT,1894,39,35-39,1933,18.165280689399104
SIM,1879,20,50-100,1899,1
SIM,1811,44,30-34,1855,5
STAT,1848,57,na,1905,3295.206505837799
STAT,1815,39,50-100,1854,8.580048472266268
SIM,1924,18,30-34,1942,47
STAT,1865,21,30-34,1886,33.31868493624074
STAT,1848,24,35-39,1872,11.483900636208277
SIM,1893,30,45-49,1923,6
SIM,1879,27,40-44,1906,10
SIM,1922,39,30-34,1961,2
STAT,1900,26,25-29,1926,118.91940222435919
STAT,1899,30,45-49,1929,4.8641850443540156
SIM,1937,34,45-49,1971,7
SIM,1934,34,50-100,1968,5
STAT,1922,45,15-19,1967,8.584687382682315E-4
STAT,1940,15,40-44,1955,2.869928707410342
SIM,1910,36,30-34,1946,5
SIM,1912,15,30-34,1927,4
STAT,1844,48,35-39,1892,0.22324716081664953
SIM,1905,36,20-24,1941,2
SIM,1857,46,na,1903,3984
SIM,1905,24,50-100,1929,1
SIM,1922,23,45-49,1945,4
STAT,1950,19,15-19,1969,108.29588080883619
SIM,1858,21,35-39,1879,12
SIM,1816,44,50-100,1860,5
STAT,1872,32,30-34,1904,35.43869568638467
SIM,1859,36,50-100,1895,3
SIM,1936,35,na,1971,6694
STAT,1864,54,45-49,1918,0.025478932629346272
STAT,1840,26,50-100,1866,1.1596184481754734
SIM,1900,31,15-19,1931,2
STAT,1846,48,50-100,1894,0.37146094937537205
SIM,1932,24,15-19,1956,15
STAT,1890,46,40-44,1936,0.23873861924433915
SIM,1916,30,50-100,1946,2
STAT,1877,54,25-29,1931,0.007223891845700164
STAT,1829,45,35-39,1874,0.22675754311650134
STAT,1866,51,45-49,1917,0.027172982567883447
STAT,1912,41,40-44,1953,0.4901467343286392
STAT,1920,34,25-29,1954,20.26659710759421
STAT,1860,97,na,1957,11.899099485374315
STAT,1815,70,na,1885,1537.0180637542908
SIM,1853,84,na,1937,397
SIM,1884,76,na,1960,2257
STAT,1870,35,30-34,1905,10.667994144537737
STAT,1864,22,25-29,1886,105.00793598049572
STAT,1923,44,20-24,1967,0.04153564339977199
STAT,1839,31,30-34,1870,33.89933702696865
STAT,1917,47,30-34,1964,0.18803760891415222
STAT,1786,96,na,1882,2.861820063359565
STAT,1830,32,25-29,1862,20.287243792848788
SIM,1904,20,20-24,1924,190
STAT,1933,18,30-34,1951,32.87018269905919
SIM,1856,21,30-34,1877,49
STAT,1860,49,35-39,1909,0.22481748211028924
STAT,1919,47,35-39,1966,0.282368530776752
STAT,1854,19,40-44,1873,0.3314715110412606
STAT,1801,100,na,1901,0.8415307921544936
SIM,1850,36,na,1886,3852
SIM,1889,30,25-29,1919,25
SIM,1828,37,35-39,1865,30
SIM,1916,26,25-29,1942,150
SIM,1826,82,na,1908,451
STAT,1792,96,na,1888,3.2479149012151938
STAT,1906,44,20-24,1950,0.03201758890941727
SIM,1849,79,na,1928,989
SIM,1909,33,na,1942,7349
SIM,1935,20,20-24,1955,309
STAT,1821,42,25-29,1863,2.041691088719755
STAT,1887,28,35-39,1915,21.718210725365196
SIM,1886,38,40-44,1924,13
SIM,1950,4,na,1954,9229
STAT,1921,46,50-100,1967,0.5161089104512859
STAT,1940,31,45-49,1971,3.2912672665144496
SIM,1920,41,40-44,1961,1
STAT,1927,37,45-49,1964,1.7115300575293104
SIM,1879,44,50-100,1923,5
STAT,1915,49,50-100,1964,0.45763578703403485
SIM,1770,93,na,1863,4
SIM,1941,18,30-34,1959,35
SIM,1945,24,25-29,1969,232
STAT,1919,29,35-39,1948,32.521333693696235
SIM,1927,29,35-39,1956,50
SIM,1905,23,45-49,1928,2
STAT,1937,24,25-29,1961,181.5770258858144
SIM,1895,28,35-39,1923,37
STAT,1878,38,40-44,1916,9.187671653073986
STAT,1803,85,na,1888,189.83516661252767
STAT,1877,54,na,1931,4391.3591016787295
STAT,1881,25,35-39,1906,18.963278710989947
STAT,1894,26,na,1920,6212.836188913358
STAT,1883,54,na,1937,4155.096992073017
STAT,1927,44,50-100,1971,0.2965293821979908
SIM,1870,56,na,1926,3927
STAT,1832,42,na,1874,3333.221539722902
STAT,1860,107,na,1967,0.07229843451285112
SIM,1812,42,25-29,1854,3
SIM,1856,21,na,1877,4255
STAT,1839,19,45-49,1858,0.1318589904577378
SIM,1785,83,na,1868,159
STAT,1879,49,na,1928,4653.503619272824
SIM,1861,38,35-39,1899,15
SIM,1831,53,45-49,1884,1
STAT,1853,38,35-39,1891,11.135280348869125
STAT,1854,97,na,1951,8.235579083710498
SIM,1815,39,na,1854,2868
SIM,1949,14,na,1963,9609
SIM,1901,30,20-24,1931,7
STAT,1871,33,25-29,1904,20.46521022338782
STAT,1914,25,40-44,1939,9.555804195858851
STAT,1895,38,40-44,1933,11.462831078820571
STAT,1865,69,na,1934,2692.6650965923886
STAT,1890,44,45-49,1934,3.6396507488424885
SIM,1926,17,na,1943,9363
SIM,1878,28,35-39,1906,27
SIM,1922,25,40-44,1947,17
STAT,1885,46,30-34,1931,0.19514916655822137
STAT,1914,41,45-49,1955,0.33359821938667733
SIM,1881,28,na,1909,4092
STAT,1895,37,50-100,1932,3.2309653633604913
STAT,1908,26,25-29,1934,127.2501919014175
SIM,1766,88,na,1854,75
STAT,1828,37,na,1865,3409.2433762636774
STAT,1828,47,40-44,1875,0.30836644056259566
SIM,1870,41,50-100,1911,2
SIM,1847,31,30-34,1878,35
STAT,1914,23,45-49,1937,2.314843296230629
SIM,1872,22,25-29,1894,132
STAT,1932,34,20-24,1966,6.540698477269251
STAT,1824,75,na,1899,1100.6349376436935
SIM,1910,32,50-100,1942,2
STAT,1923,31,45-49,1954,3.6570061785528036
SIM,1948,1,na,1949,9491
STAT,1900,41,45-49,1941,0.2924896611910064
STAT,1884,49,20-24,1933,0.02343158039229739
SIM,1895,48,na,1943,6129
STAT,1855,32,25-29,1887,15.72637479874317
SIM,1802,72,na,1874,1251
STAT,1875,29,50-100,1904,1.3206385777728433
SIM,1931,26,20-24,1957,50
STAT,1767,113,na,1880,8.017071524372359E-4
SIM,1827,64,na,1891,2095
STAT,1903,34,25-29,1937,16.7672616167359
STAT,1851,49,na,1900,3414.8443065239467
STAT,1923,26,20-24,1949,42.45782499405476
SIM,1888,38,na,1926,5515
SIM,1911,34,25-29,1945,26
STAT,1872,53,50-100,1925,0.030162468981756892
SIM,1804,67,na,1871,1553
SIM,1899,22,35-39,1921,18
STAT,1828,29,40-44,1857,7.6246465568519595
SIM,1862,21,na,1883,4468
STAT,1889,22,30-34,1911,44.35673264216188
SIM,1931,31,45-49,1962,7
SIM,1925,16,25-29,1941,139
STAT,1903,48,na,1951,6389.455056379269
STAT,1840,77,na,1917,1247.6985013989938
SIM,1791,83,na,1874,190
SIM,1845,37,40-44,1882,15
SIM,1897,22,30-34,1919,65
STAT,1880,54,30-34,1934,0.012316218721178806
STAT,1921,16,45-49,1937,1.1525370929480092
STAT,1831,24,50-100,1855,0.8004914381203152
STAT,1888,26,na,1914,5716.336271759447
STAT,1898,18,50-100,1916,0.13354828699561125
STAT,1848,97,na,1945,8.80890458449966
STAT,1908,23,na,1931,7068.246407868287
SIM,1902,29,35-39,1931,32
STAT,1811,45,50-100,1856,1.7258076223147092
SIM,1868,46,na,1914,4342
SIM,1886,35,30-34,1921,17
STAT,1928,19,35-39,1947,10.619396614419765
STAT,1945,16,30-34,1961,26.896166072912024
SIM,1908,29,50-100,1937,4
STAT,1948,20,na,1968,8473.455450812262
SIM,1844,23,30-34,1867,37
SIM,1847,44,na,1891,3459
SIM,1915,28,30-34,1943,95
SIM,1878,43,30-34,1921,2
STAT,1778,106,na,1884,0.027481323753336603
STAT,1930,10,na,1940,10376.900554931084
SIM,1856,31,50-100,1887,3
SIM,1919,31,20-24,1950,7
SIM,1863,32,25-29,1895,24
STAT,1904,18,35-39,1922,1.586397704670071
SIM,1905,39,30-34,1944,7
STAT,1887,46,35-39,1933,0.3171288132352207
SIM,1912,18,35-39,1930,2
STAT,1851,40,45-49,1891,2.3434758954706365
STAT,1854,101,na,1955,0.8747587079414849
SIM,1821,39,na,1860,3137
SIM,1843,54,na,1897,3145
STAT,1819,53,25-29,1872,0.013989264221672492
STAT,1852,54,25-29,1906,0.005490054457450112
STAT,1930,26,35-39,1956,38.572287311756234
STAT,1906,26,20-24,1932,34.64348733115068
STAT,1836,23,30-34,1859,31.038253644502817
STAT,1862,43,25-29,1905,1.100484767139536
STAT,1850,104,na,1954,0.10226915621901113
SIM,1896,23,25-29,1919,205
STAT,1871,29,na,1900,4754.3697383519
SIM,1925,31,15-19,1956,2
STAT,1836,50,20-24,1886,0.0010330638240955336
STAT,1800,65,na,1865,1736.9185309490254
STAT,1907,28,30-34,1935,74.4858873356286
SIM,1923,19,25-29,1942,123
STAT,1766,88,na,1854,51.0
STAT,1933,36,30-34,1969,5.018740392063125
SIM,1819,44,30-34,1863,3
SIM,1939,29,30-34,1968,8
STAT,1888,23,25-29,1911,136.22675780709733
STAT,1813,75,na,1888,928.4216883226968
SIM,1857,21,45-49,1878,2
STAT,1910,30,20-24,1940,4.789828727393687
STAT,1931,39,30-34,1970,4.864673031239027
STAT,1902,32,50-100,1934,2.612533244452506
STAT,1918,41,na,1959,7985.023346360421
STAT,1834,53,20-24,1887,9.874250973623908E-4
STAT,1859,29,na,1888,3846.6896731144457
SIM,1870,43,25-29,1913,2
STAT,1910,49,40-44,1959,0.29545224094996464
SIM,1827,35,25-29,1862,7
SIM,1891,58,na,1949,5208
SIM,1886,71,na,1957,2850
STAT,1915,19,25-29,1934,18.220840105000068
SIM,1855,40,25-29,1895,2
STAT,1906,47,50-100,1953,0.4058113402785818
STAT,1886,26,25-29,1912,90.49368824426868
SIM,1888,32,30-34,1920,55
SIM,1932,29,15-19,1961,5
STAT,1825,50,45-49,1875,0.03156645513622493
SIM,1894,26,25-29,1920,125
STAT,1849,21,45-49,1870,1.3432311843765155
SIM,1914,26,20-24,1940,38
STAT,1788,91,na,1879,38.45610451230031
STAT,1924,29,15-19,1953,1.6477440968626182
STAT,1907,46,30-34,1953,0.1625424488170711
STAT,1904,19,50-100,1923,0.14125310873828437
STAT,1894,20,45-49,1914,1.819923159618466
SIM,1885,36,50-100,1921,4
STAT,1836,32,na,1868,3642.2126974334014
SIM,1903,48,na,1951,6519
STAT,1879,89,na,1968,608.7087851772022
STAT,1911,26,30-34,1937,77.4599840546372
STAT,1875,54,20-24,1929,0.001492199018945966
SIM,1913,49,30-34,1962,1
SIM,1913,30,40-44,1943,9
STAT,1854,26,na,1880,3847.9890313413316
STAT,1870,53,30-34,1923,0.011613369490207684
STAT,1904,36,35-39,1940,4.446596295881741
STAT,1918,18,35-39,1936,9.198367188776459
SIM,1898,22,45-49,1920,2
SIM,1910,39,35-39,1949,10
STAT,1926,31,50-100,1957,2.0199174883419055
SIM,1796,67,na,1863,1547
SIM,1792,77,na,1869,689
SIM,1860,26,na,1886,4243
SIM,1822,92,na,1914,22
SIM,1905,2,na,1907,8006
STAT,1861,47,50-100,1908,0.4109309066846028
STAT,1924,27,50-100,1951,2.3399407824731937
STAT,1915,34,15-19,1949,0.2620798533498313
STAT,1838,67,na,1905,2145.3816689225137
SIM,1915,33,na,1948,7789
SIM,1921,21,35-39,1942,28
SIM,1907,18,30-34,1925,6
SIM,1885,18,na,1903,5277
STAT,1817,43,50-100,1860,5.516278322276269
SIM,1868,36,25-29,1904,10
STAT,1902,39,35-39,1941,4.309134329991318
STAT,1936,29,35-39,1965,28.99548580865774
STAT,1928,37,35-39,1965,6.172632855310166
SIM,1928,28,40-44,1956,19
STAT,1762,114,na,1876,6.820072676035004E-4
STAT,1881,22,30-34,1903,34.77102437951939
SIM,1819,47,40-44,1866,1
STAT,1832,48,45-49,1880,0.359125697129908
STAT,1872,70,na,1942,2847.876551609816
SIM,1867,92,na,1959,100
STAT,1842,48,30-34,1890,0.14230639620283556
STAT,1905,49,30-34,1954,0.15615424283892515
STAT,1861,79,na,1940,1175.2017958132074
STAT,1848,21,30-34,1869,35.81961172873741
STAT,1886,44,25-29,1930,1.3505624198439965
STAT,1896,33,25-29,1929,27.195916988856556
SIM,1945,21,20-24,1966,265
SIM,1864,44,50-100,1908,4
SIM,1869,31,na,1900,4612
STAT,1829,42,25-29,1871,1.0569559794566923
STAT,1911,44,30-34,1955,0.24348095519415916
SIM,1886,9,na,1895,5495
SIM,1936,19,35-39,1955,12
SIM,1926,18,35-39,1944,15
SIM,1827,95,na,1922,12
STAT,1896,21,na,1917,6325.2716206566065
SIM,1907,33,20-24,1940,6
SIM,1875,31,na,1906,5329
STAT,1941,27,25-29,1968,137.51967640087165
SIM,1899,15,20-24,1914,44
STAT,1856,44,50-100,1900,1.623980923463688
SIM,1911,45,50-100,1956,2
STAT,1829,50,na,1879,2798.2487588985573
STAT,1902,20,15-19,1922,9.462785002146743
STAT,1913,21,35-39,1934,18.48745199779059
SIM,1904,26,35-39,1930,34
SIM,1953,16,30-34,1969,32
SIM,1829,32,25-29,1861,23
STAT,1867,21,35-39,1888,11.162990133726334
SIM,1837,42,25-29,1879,2
STAT,1888,41,25-29,1929,1.5398065381648707
SIM,1896,41,25-29,1937,1
SIM,1918,37,45-49,1955,2
STAT,1859,40,45-49,1899,2.43010862251055
STAT,1908,30,50-100,1938,1.5898923393715183
SIM,1912,36,35-39,1948,7
STAT,1812,50,na,1862,2797.6543569526652
STAT,1827,48,35-39,1875,0.24948492295580538
STAT,1846,45,35-39,1891,0.21657714605571873
SIM,1890,4,na,1894,6979
STAT,1943,21,15-19,1964,11.44153195772419
SIM,1780,83,na,1863,248
STAT,1909,21,15-19,1930,10.027497408061363
STAT,1847,54,45-49,1901,0.0215135427492069
SIM,1898,28,na,1926,6747
SIM,1854,27,50-100,1881,2
STAT,1837,34,30-34,1871,29.890566465605275
STAT,1866,4,na,1870,5602.376563672886
STAT,1828,31,25-29,1859,23.673933864614803
STAT,1922,31,25-29,1953,21.171425336553227
SIM,1856,24,35-39,1880,11
STAT,1840,21,25-29,1861,105.8415124565103
SIM,1853,25,25-29,1878,9
SIM,1911,31,20-24,1942,8
STAT,1829,42,30-34,1871,1.8922921490269367
STAT,1852,45,50-100,1897,0.3953422793013893
SIM,1876,30,45-49,1906,6
STAT,1822,41,30-34,1863,3.9743426565821105
STAT,1830,47,na,1877,3334.542837360501
SIM,1859,34,30-34,1893,36
SIM,1884,8,na,1892,5675
STAT,1920,19,35-39,1939,9.454841643739195
SIM,1917,21,15-19,1938,12
STAT,1851,32,50-100,1883,1.4783276301747121
STAT,1920,51,na,1971,8095.415828396357
STAT,1845,25,25-29,1870,80.49199239267939
SIM,1918,23,25-29,1941,225
STAT,1941,24,15-19,1965,11.103021382409716
STAT,1889,8,na,1897,6473.475443274286
STAT,1916,20,45-49,1936,2.3953789481358916
SIM,1880,86,na,1966,857
STAT,1882,69,na,1951,2887.239979700953
SIM,1816,92,na,1908,18
SIM,1854,26,na,1880,4260
STAT,1819,60,na,1879,2229.471392561811
STAT,1937,21,20-24,1958,218.8040603339104
SIM,1905,20,40-44,1925,7
STAT,1905,30,40-44,1935,12.768413601187374
STAT,1867,64,na,1931,3287.9738642318525
SIM,1849,27,25-29,1876,90
SIM,1900,17,30-34,1917,5
SIM,1862,21,25-29,1883,135
SIM,1922,27,na,1949,8906
SIM,1850,33,50-100,1883,2
SIM,1909,30,20-24,1939,6
STAT,1824,47,na,1871,2774.0513558555185
SIM,1866,11,na,1877,5268
SIM,1914,30,30-34,1944,35
STAT,1907,38,na,1945,7013.616070340372
SIM,1948,20,na,1968,8641
STAT,1877,51,20-24,1928,0.0015549380546201873
SIM,1837,42,30-34,1879,5
SIM,1928,6,na,1934,10355
STAT,1841,20,50-100,1861,0.7604151405453378
STAT,1921,34,45-49,1955,3.5055166152750976
SIM,1878,43,25-29,1921,3
STAT,1829,59,na,1888,2341.481325898285
STAT,1877,21,20-24,1898,144.95672165678494
STAT,1765,94,na,1859,7.274548815248007
SIM,1905,39,25-29,1944,5
SIM,1837,24,30-34,1861,46
SIM,1898,40,45-49,1938,2
STAT,1904,18,40-44,1922,0.5287992655068703
SIM,1813,72,na,1885,1147
SIM,1924,20,45-49,1944,4
STAT,1923,29,30-34,1952,90.17611668013365
SIM,1931,29,30-34,1960,119
STAT,1910,21,50-100,1931,1.2521908506649035
STAT,1952,15,30-34,1967,29.513133654103594
STAT,1920,33,50-100,1953,1.8208743634540232
SIM,1920,28,40-44,1948,20
STAT,1819,35,25-29,1854,19.159743629709972
STAT,1811,53,25-29,1864,0.022480253035155582
SIM,1839,89,na,1928,135
SIM,1904,23,25-29,1927,179
STAT,1860,85,na,1945,449.6031731967632
SIM,1897,43,na,1940,6305
STAT,1892,41,45-49,1933,3.801070698268536
SIM,1845,34,30-34,1879,53
STAT,1912,28,40-44,1940,9.246480394039189
STAT,1854,21,25-29,1875,103.85684127420384
STAT,1896,33,30-34,1929,46.35862226265982
SIM,1808,57,na,1865,2317
STAT,1925,41,20-24,1966,0.04323543755210847
SIM,1774,83,na,1857,231
SIM,1863,5,na,1868,5264
SIM,1897,74,na,1971,3728
STAT,1867,17,25-29,1884,10.957205268083326
STAT,1845,43,25-29,1888,0.9948219118379109
STAT,1945,19,50-100,1964,0.8259411058191928
STAT,1825,60,na,1885,2356.0832201518465
SIM,1874,86,na,1960,510
STAT,1856,16,40-44,1872,0.3389978752800889
SIM,1931,29,25-29,1960,177
STAT,1861,39,na,1900,3920.5575583778605
STAT,1917,31,15-19,1948,0.2728567466884664
SIM,1933,23,20-24,1956,309
STAT,1914,21,25-29,1935,183.47400093652223
STAT,1850,67,na,1917,2430.566573421347
STAT,1837,52,30-34,1889,0.008328535666204527
STAT,1878,53,30-34,1931,0.012354121200790083
SIM,1801,87,na,1888,91
SIM,1820,37,35-39,1857,15
SIM,1897,25,35-39,1922,37
STAT,1911,41,20-24,1952,0.03424848251478852
STAT,1825,106,na,1931,0.014048368813058001
STAT,1873,30,25-29,1903,21.187347791403337
STAT,1889,25,35-39,1914,24.191092980787456
STAT,1901,37,25-29,1938,1.7570668117837742
SIM,1848,26,na,1874,4010
SIM,1864,16,40-44,1880,1
STAT,1798,100,na,1898,0.5747219916211594
STAT,1868,49,35-39,1917,0.26339689436974223
STAT,1849,29,50-100,1878,1.1823076377751909
SIM,1885,58,na,1943,4188
SIM,1836,31,25-29,1867,23
STAT,1923,29,25-29,1952,151.480940793349
SIM,1856,52,na,1908,3589
STAT,1925,23,20-24,1948,267.92424914547456
STAT,1890,36,na,1926,5835.804602157167
STAT,1903,31,20-24,1934,7.804578704922364
STAT,1919,26,30-34,1945,85.77894780808516
SIM,1837,54,na,1891,2801
SIM,1908,20,na,1928,7145
SIM,1903,26,45-49,1929,1
SIM,1875,17,25-29,1892,16
STAT,1878,35,30-34,1913,11.348445663600543
STAT,1880,42,50-100,1922,2.2449112664259485
SIM,1949,18,30-34,1967,40
STAT,1840,21,30-34,1861,32.93316174408795
SIM,1878,25,30-34,1903,60
STAT,1858,29,20-24,1887,18.63733066356349
STAT,1915,37,25-29,1952,2.0089867826876455
SIM,1923,28,50-100,1951,3
SIM,1905,48,50-100,1953,1
SIM,1872,11,na,1883,5644
STAT,1895,22,25-29,1917,150.64930037441582
SIM,1858,19,20-24,1877,34
SIM,1927,26,30-34,1953,111
STAT,1771,94,na,1865,6.067879278603993
SIM,1880,17,35-39,1897,2
STAT,1868,49,na,1917,4232.86479989037
STAT,1881,22,25-29,1903,111.74808658179279
STAT,1919,44,30-34,1963,0.27881679414905236
STAT,1872,17,35-39,1889,1.1174006743148985
STAT,1865,97,na,1962,25.87813568026118
STAT,1873,49,45-49,1922,0.47417373830768617
STAT,1936,35,na,1971,7473.751231658136
STAT,1831,53,50-100,1884,0.019934838969059187
SIM,1922,21,25-29,1943,261
STAT,1873,64,na,1937,3567.209023259883
SIM,1881,49,45-49,1930,1
STAT,1868,5,na,1873,5405.777796677272
SIM,1916,27,na,1943,7946
STAT,1842,32,na,1874,3897.8572521451647
SIM,1866,29,20-24,1895,25
SIM,1845,89,na,1934,119
STAT,1946,18,40-44,1964,3.1319398688094475
SIM,1923,37,25-29,1960,4
SIM,1930,31,25-29,1961,27
STAT,1807,75,na,1882,960.2466211863622
STAT,1931,20,40-44,1951,8.860239575136164
STAT,1794,91,na,1885,39.11843595522501
SIM,1839,80,na,1919,719
SIM,1936,32,35-39,1968,27
STAT,1860,46,25-29,1906,0.09473698480438592
STAT,1923,47,25-29,1970,0.12528501947449813
STAT,1908,1,na,1909,8159.85564030123
STAT,1793,81,na,1874,406.3392634193182
SIM,1908,16,25-29,1924,30
SIM,1949,20,45-49,1969,5
SIM,1877,32,25-29,1909,25
SIM,1886,38,35-39,1924,26
SIM,1838,41,30-34,1879,4
STAT,1816,54,50-100,1870,0.06839839538075665
STAT,1905,35,40-44,1940,2.7858956130390786
STAT,1868,30,45-49,1898,3.3777345728595787
SIM,1855,45,50-100,1900,3
STAT,1928,16,30-34,1944,31.089305183863807
STAT,1907,42,45-49,1949,0.30812138713214365
STAT,1870,44,na,1914,4520.930130889362
SIM,1821,39,45-49,1860,8
SIM,1786,77,na,1863,723
STAT,1868,19,35-39,1887,1.0608411642254323
STAT,1884,44,20-24,1928,0.3124410666167073
SIM,1870,28,na,1898,4622
SIM,1904,23,30-34,1927,73
STAT,1808,85,na,1893,215.4150885221873
STAT,1909,28,35-39,1937,28.891801833784474
STAT,1851,38,30-34,1889,8.26403481134881
STAT,1878,38,35-39,1916,14.844920237227337
SIM,1859,30,15-19,1889,1
STAT,1910,27,25-29,1937,128.41281008458617
SIM,1906,65,na,1971,5564
SIM,1900,35,30-34,1935,4
STAT,1904,16,45-49,1920,0.1898179933977248
SIM,1926,5,na,1931,10211
STAT,1930,24,45-49,1954,2.892866785345506
SIM,1854,66,na,1920,2649
STAT,1832,45,40-44,1877,0.2707343518677067
STAT,1872,9,na,1881,5452.051742416634
STAT,1912,25,na,1937,7508.382219558673
SIM,1917,28,35-39,1945,47
STAT,1941,13,na,1954,8182.650051673469
STAT,1857,62,na,1919,2877.208754336628
STAT,1937,28,40-44,1965,9.173666854668513
SIM,1883,54,na,1937,4316
SIM,1943,18,35-39,1961,12
SIM,1936,16,30-34,1952,34
STAT,1853,23,30-34,1876,33.05986597163699
SIM,1843,26,na,1869,3995
SIM,1861,23,30-34,1884,42
STAT,1875,90,na,1965,413.02860647553143
STAT,1911,31,50-100,1942,1.6331207074531071
SIM,1836,43,25-29,1879,4
STAT,1806,53,45-49,1859,0.08300213361735348
STAT,1941,24,20-24,1965,231.9282571769446
STAT,1841,20,30-34,1861,33.21492973676905
SIM,1854,24,50-100,1878,1
STAT,1852,51,20-24,1903,0.001181730676506129
SIM,1913,33,45-49,1946,4
STAT,1920,20,na,1940,8246.224256572437
STAT,1935,18,35-39,1953,11.557110325194675
STAT,1853,111,na,1964,7.524567242275725E-4
SIM,1882,10,na,1892,5400
STAT,1873,44,45-49,1917,3.029734345667553
STAT,1884,64,na,1948,3466.756851417146
STAT,1910,21,na,1931,7262.290041815736
STAT,1924,46,30-34,1970,0.21481526913000176
SIM,1868,24,25-29,1892,2
STAT,1840,37,na,1877,3656.5692386668834
SIM,1878,16,35-39,1894,1
SIM,1852,62,na,1914,2925
STAT,1924,10,na,1934,9555.62362569487
STAT,1827,33,30-34,1860,41.00897218848522
STAT,1872,47,35-39,1919,0.2828388860821544
STAT,1909,21,45-49,1930,2.119532989920019
STAT,1909,28,50-100,1937,1.9154319400569588
SIM,1948,19,30-34,1967,34
STAT,1931,25,40-44,1956,12.16430868356508
SIM,1866,51,na,1917,4223
SIM,1909,33,25-29,1942,21
SIM,1877,44,25-29,1921,3
STAT,1838,95,na,1933,17.99374424760246
SIM,1782,78,na,1860,551
SIM,1858,19,15-19,1877,10
SIM,1881,44,45-49,1925,8
SIM,1893,17,15-19,1910,16
SIM,1900,29,30-34,1929,83
STAT,1859,26,30-34,1885,41.47614865750628
STAT,1934,31,15-19,1965,0.3546043415457838
SIM,1946,9,na,1955,8638
STAT,1825,69,na,1894,1698.0001099079307
STAT,1906,23,50-100,1929,1.1963960983708053
SIM,1835,33,30-34,1868,45
STAT,1845,77,na,1922,1331.972699946667
STAT,1940,30,30-34,1970,32.97137720268225
STAT,1836,38,35-39,1874,11.4263051100837
SIM,1876,19,35-39,1895,2
SIM,1823,39,50-100,1862,4
STAT,1773,104,na,1877,0.06061792533862935
SIM,1837,85,na,1922,301
STAT,1861,45,30-34,1906,0.16434387738690157
STAT,1871,21,25-29,1892,115.21096444997886
SIM,1903,17,na,1920,7462
STAT,1919,45,45-49,1964,0.47823295697195534
STAT,1848,29,na,1877,4174.0125603539245
SIM,1900,40,na,1940,6839
SIM,1870,25,na,1895,4678
SIM,1844,38,35-39,1882,18
STAT,1938,30,na,1968,7690.291088507203
STAT,1860,46,30-34,1906,0.1592107676640434
STAT,1885,17,15-19,1902,11.930204755765553
SIM,1845,37,35-39,1882,24
STAT,1861,70,na,1931,2358.579516539844
STAT,1781,96,na,1877,3.0257574205495956
SIM,1850,50,45-49,1900,1
SIM,1937,20,na,1957,7312
STAT,1830,36,40-44,1866,8.319828861682787
STAT,1869,44,25-29,1913,1.239699902739908
STAT,1871,15,25-29,1886,11.57981834004327
STAT,1902,32,15-19,1934,0.4060535748511926
SIM,1880,47,35-39,1927,1
STAT,1817,53,20-24,1870,0.0033481908593864956
STAT,1844,36,na,1880,4058.444991847546
STAT,1915,39,15-19,1954,0.038788018001926945
STAT,1835,109,na,1944,9.214413183025991E-4
SIM,1880,35,35-39,1915,21
STAT,1923,33,35-39,1956,21.138131881465874
SIM,1928,21,20-24,1949,266
SIM,1885,20,45-49,1905,1
SIM,1879,42,30-34,1921,3
SIM,1904,61,na,1965,5893
SIM,1877,26,25-29,1903,95
SIM,1883,51,na,1934,4464
STAT,1933,32,15-19,1965,0.34978747677725125
STAT,1811,49,na,1860,2727.7514062898817
STAT,1820,85,na,1905,306.8955201863862
STAT,1869,32,25-29,1901,20.04415735233287
STAT,1934,31,na,1965,10436.457118411216
STAT,1870,31,15-19,1901,0.28352375812448916
SIM,1808,97,na,1905,2
SIM,1917,21,45-49,1938,1
STAT,1888,20,20-24,1908,165.48010345241534
SIM,1824,59,na,1883,2561
SIM,1896,20,20-24,1916,182
SIM,1813,44,35-39,1857,5
SIM,1825,97,na,1922,2
SIM,1901,33,50-100,1934,1
STAT,1924,28,30-34,1952,91.78902580087096
SIM,1932,28,30-34,1960,126
SIM,1844,67,na,1911,2210
SIM,1931,33,35-39,1964,34
STAT,1825,48,30-34,1873,0.2070456775626127
STAT,1894,24,30-34,1918,45.92283463276222
SIM,1834,20,35-39,1854,12
SIM,1882,13,na,1895,5386
STAT,1926,34,50-100,1960,2.0161425925280336
SIM,1875,21,35-39,1896,17
STAT,1857,65,na,1922,2660.333808209196
SIM,1898,24,40-44,1922,6
SIM,1910,20,15-19,1930,9
STAT,1850,38,50-100,1888,1.8925169157456987
STAT,1892,39,30-34,1931,13.339132289685605
SIM,1876,72,na,1948,2765
STAT,1912,43,30-34,1955,0.24759772299545266
SIM,1884,26,50-100,1910,4
STAT,1881,52,50-100,1933,0.029324847791644446
SIM,1915,24,15-19,1939,13
SIM,1944,27,45-49,1971,3
STAT,1777,88,na,1865,78.51773540714433
SIM,1835,99,na,1934,4
STAT,1873,46,40-44,1919,0.3523094477794749
STAT,1822,44,35-39,1866,5.774291329052578
STAT,1781,93,na,1874,13.188539243166847
STAT,1896,9,na,1905,6918.403132774281
SIM,1875,28,na,1903,5290
SIM,1919,38,40-44,1957,1
SIM,1858,87,na,1945,251
STAT,1878,39,na,1917,4919.448799414485
STAT,1760,94,na,1854,1.0
STAT,1858,113,na,1971,2.2659375016171213E-4
SIM,1927,27,45-49,1954,5
STAT,1811,50,20-24,1861,0.004974098049016429
STAT,1877,36,30-34,1913,11.230763125499559
SIM,1810,67,na,1877,1650
STAT,1916,36,25-29,1952,2.046158267346855
STAT,1819,50,50-100,1869,0.06332717783219992
SIM,1913,47,na,1960,7342
STAT,1837,37,35-39,1874,12.005080220327763
SIM,1929,37,20-24,1966,1
SIM,1862,92,na,1954,83
STAT,1832,70,na,1902,1829.2129129391296
STAT,1925,38,25-29,1963,2.383780177036552
STAT,1856,31,30-34,1887,27.826911860397562
STAT,1872,35,35-39,1907,14.492537751319674
STAT,1833,52,na,1885,2916.8416097909685
STAT,1834,37,na,1871,3540.334403565592
SIM,1889,6,na,1895,6663
STAT,1931,23,45-49,1954,2.938279427697327
SIM,1885,36,30-34,1921,18
SIM,1880,29,35-39,1909,40
SIM,1931,32,na,1963,10032
STAT,1936,27,45-49,1963,3.3398189386601733
SIM,1933,38,25-29,1971,3
STAT,1819,69,na,1888,1593.9022433543923
SIM,1839,21,30-34,1860,41
SIM,1848,33,40-44,1881,9
STAT,1872,29,35-39,1901,19.444844550783305
SIM,1803,82,na,1885,452
SIM,1885,24,30-34,1909,55
STAT,1846,22,na,1868,4040.8850434327765
STAT,1886,48,40-44,1934,0.3604024732991552
SIM,1949,6,na,1955,9616
STAT,1919,27,45-49,1946,3.7691719677452693
SIM,1925,32,na,1957,9042
STAT,1820,44,30-34,1864,4.394604405171928
STAT,1831,46,35-39,1877,0.21700627146995088
STAT,1856,24,na,1880,3814.101210513001
STAT,1905,1,na,1906,7949.974984834432
STAT,1911,34,50-100,1945,1.6125486858774958
SIM,1847,84,na,1931,455
SIM,1830,44,35-39,1874,8
STAT,1853,53,25-29,1906,0.005514196861887498
STAT,1804,50,50-100,1854,0.09195193778600083
SIM,1912,31,40-44,1943,12
SIM,1851,46,50-100,1897,1
STAT,1907,24,15-19,1931,9.731394817694994
SIM,1967,3,na,1970,10513
STAT,1805,49,na,1854,2724.2869947949825
SIM,1871,66,na,1937,3107
SIM,1883,0,na,1883,7116
STAT,1880,23,25-29,1903,121.4178743594635
STAT,1889,40,25-29,1929,1.615256245679025
STAT,1897,20,50-100,1917,1.10745660985899
STAT,1928,31,na,1959,9554.992196250583
STAT,1907,42,15-19,1949,0.0028431041177826954
SIM,1898,29,50-100,1927,2
STAT,1905,33,45-49,1938,2.912243991766715
SIM,1850,67,na,1917,2499
STAT,1877,24,30-34,1901,37.12132580154249
SIM,1864,31,30-34,1895,41
STAT,1846,9,na,1855,4687.814249999999
SIM,1849,11,na,1860,4925
STAT,1888,57,na,1945,4797.120078187535
STAT,1916,48,25-29,1964,0.10957641919682717
STAT,1858,54,20-24,1912,0.001129845239498719
SIM,1904,21,35-39,1925,19
STAT,1888,0,na,1888,7149.526325720225
SIM,1918,53,na,1971,7999
SIM,1927,27,na,1954,9424
SIM,1827,39,40-44,1866,14
SIM,1894,38,na,1932,6321
SIM,1924,36,25-29,1960,5
STAT,1922,17,40-44,1939,3.2683769798459172
STAT,1911,44,25-29,1955,0.13599837192614717
STAT,1842,49,15-19,1891,5.830911464697383E-4
STAT,1845,47,40-44,1892,0.26257830085317757
SIM,1885,86,na,1971,1064
STAT,1872,79,na,1951,1419.0022486993144
STAT,1890,3,na,1893,6516.98874708551
SIM,1910,35,50-100,1945,1
SIM,1905,43,35-39,1948,1
SIM,1923,8,na,1931,9913
STAT,1942,26,25-29,1968,139.58481961210254
SIM,1930,17,40-44,1947,4
STAT,1882,52,45-49,1934,0.02839967992430759
STAT,1936,29,40-44,1965,9.00181103879273
STAT,1905,17,40-44,1922,0.5342197157714441
SIM,1830,26,35-39,1856,20
STAT,1819,39,40-44,1858,22.34088814151459
STAT,1821,70,na,1891,1555.2321648809568
STAT,1910,42,20-24,1952,0.03372080889016813
STAT,1831,34,35-39,1865,16.71979889812441
STAT,1939,15,na,1954,7460.174678490106
STAT,1887,16,na,1903,5718.831761398056
SIM,1861,11,na,1872,5301
SIM,1900,31,45-49,1931,7
SIM,1821,79,na,1900,814
SIM,1864,87,na,1951,239
STAT,1952,18,35-39,1970,10.151625157660273
SIM,1923,34,20-24,1957,10
STAT,1843,46,25-29,1889,0.08134647310818684
STAT,1904,31,40-44,1935,12.622385455631688
SIM,1923,16,20-24,1939,324
SIM,1849,70,na,1919,2172
STAT,1823,34,na,1857,3429.384081412278
STAT,1950,18,30-34,1968,29.095703521080896
STAT,1901,22,20-24,1923,194.84104875184343
SIM,1913,35,40-44,1948,5
SIM,1849,31,35-39,1880,23
STAT,1945,17,45-49,1962,1.101993019658877
SIM,1838,29,45-49,1867,1
STAT,1866,23,40-44,1889,3.8867331534950327
STAT,1868,34,30-34,1902,33.26207197674856
STAT,1915,34,20-24,1949,4.97457208562859
STAT,1941,29,15-19,1970,1.4735030493103742
SIM,1855,11,na,1866,5053
SIM,1915,20,50-100,1935,4
SIM,1818,56,na,1874,2466
SIM,1895,21,15-19,1916,9
STAT,1832,43,45-49,1875,2.3564039527715024
STAT,1865,43,50-100,1908,1.9243873001036798
SIM,1840,43,45-49,1883,12
SIM,1878,76,na,1954,1810
STAT,1799,66,na,1865,1599.6429384221876
STAT,1910,58,na,1968,6569.332195023183
SIM,1798,62,na,1860,1736
STAT,1901,40,20-24,1941,0.03149570962551147
STAT,1881,90,na,1971,512.6273225182199
STAT,1893,3,na,1896,6767.400072526521
SIM,1889,79,na,1968,2456
STAT,1897,32,30-34,1929,47.13498508789253
STAT,1917,16,25-29,1933,18.878376081674418
SIM,1876,10,na,1886,5655
SIM,1819,47,35-39,1866,1
STAT,1890,64,na,1954,4285.324557036314
STAT,1915,16,20-24,1931,57.452559787341904
SIM,1876,34,30-34,1910,44
STAT,1862,28,35-39,1890,16.597363150916042
STAT,1893,16,na,1909,6481.12244577417
STAT,1926,45,na,1971,9196.502215722996
SIM,1953,17,45-49,1970,1
STAT,1812,52,25-29,1864,0.02348160835738105
SIM,1903,24,25-29,1927,184
STAT,1831,28,35-39,1859,16.634923911627713
SIM,1874,23,40-44,1897,6
STAT,1931,41,45-49,1972,0.4497010052351636
SIM,1870,28,35-39,1898,27
SIM,1893,53,na,1946,5572
SIM,1890,34,45-49,1924,7
STAT,1868,16,30-34,1884,3.1365887764621703
SIM,1921,23,30-34,1944,74
SIM,1855,41,30-34,1896,5
STAT,1922,35,40-44,1957,3.445204649270346
STAT,1917,43,15-19,1960,0.00323129421884067
SIM,1879,15,40-44,1894,1
STAT,1910,24,20-24,1934,209.65005653318576
SIM,1843,85,na,1928,326
STAT,1930,21,40-44,1951,8.725487729546487
SIM,1869,38,35-39,1907,21
STAT,1863,65,na,1928,2987.685861505189
SIM,1846,99,na,1945,2
STAT,1870,84,na,1954,659.6136428562523
SIM,1872,51,na,1923,4551
STAT,1853,26,35-39,1879,17.81351587323554
STAT,1837,25,50-100,1862,1.1612268531381156
STAT,1892,31,na,1923,6057.956326708313
SIM,1803,57,na,1860,2287
SIM,1894,32,25-29,1926,34
STAT,1866,79,na,1945,1302.7684586177936
STAT,1823,37,na,1860,3438.2530943834054
SIM,1849,29,20-24,1878,16
STAT,1887,13,na,1900,5824.310993491413
SIM,1870,25,30-34,1895,59
STAT,1839,77,na,1916,1349.6863997433036
STAT,1880,27,40-44,1907,6.373280917940371
SIM,1844,17,30-34,1861,2
SIM,1853,29,40-44,1882,12
STAT,1826,70,na,1896,1679.6272151159521
SIM,1827,41,25-29,1868,4
STAT,1845,29,40-44,1874,5.538069220553691
STAT,1787,110,na,1897,2.0324989318161143E-4
STAT,1833,29,15-19,1862,0.7768649826482193
SIM,1918,39,40-44,1957,9
STAT,1830,39,45-49,1869,3.63270235655191
SIM,1861,26,35-39,1887,29
SIM,1864,25,na,1889,4574
SIM,1823,43,45-49,1866,6
SIM,1911,43,na,1954,7332
STAT,1849,23,40-44,1872,3.956549240826166
SIM,1845,25,50-100,1870,1
STAT,1815,49,20-24,1864,0.06248406926772036
STAT,1887,21,15-19,1908,7.474308975912193
STAT,1847,41,30-34,1888,1.7849842436700267
STAT,1851,35,50-100,1886,1.9639729373156976
STAT,1864,40,25-29,1904,1.170989864833639
STAT,1819,41,25-29,1860,3.0679326128308633
STAT,1820,40,15-19,1860,0.05904729017188652
SIM,1863,47,35-39,1910,1
STAT,1890,6,na,1896,6439.86809722124
SIM,1830,59,na,1889,2361
STAT,1838,36,na,1874,3534.1710388986357
STAT,1834,77,na,1911,1148.7234566930647
STAT,1879,30,20-24,1909,5.756048727800411
STAT,1875,50,na,1925,4541.531771968084
SIM,1841,29,15-19,1870,1
SIM,1940,16,20-24,1956,293
STAT,1854,15,25-29,1869,10.515256531373133
SIM,1878,79,na,1957,1467
SIM,1917,25,30-34,1942,108
STAT,1866,26,45-49,1892,2.076127709333679
SIM,1885,20,15-19,1905,5
SIM,1899,38,na,1937,6569
SIM,1835,59,na,1894,2616
SIM,1814,97,na,1911,1
SIM,1919,32,35-39,1951,24
STAT,1884,47,25-29,1931,0.11433444840577786
SIM,1866,31,35-39,1897,29
SIM,1887,30,20-24,1917,10
STAT,1924,42,45-49,1966,0.39970018687228503
STAT,1901,25,25-29,1926,120.41314325847276
STAT,1932,16,20-24,1948,363.48434776084105
STAT,1812,90,na,1902,74.7334742346479
SIM,1862,15,25-29,1877,23
SIM,1821,36,40-44,1857,13
SIM,1943,20,na,1963,7991
STAT,1909,25,30-34,1934,76.82858226295629
STAT,1886,32,25-29,1918,21.836644173053596
SIM,1911,40,na,1951,7471
SIM,1872,40,25-29,1912,3
STAT,1855,47,35-39,1902,0.21012660387223728
STAT,1817,96,na,1913,8.660721214237473
STAT,1841,39,20-24,1880,1.290667124703519
SIM,1864,44,45-49,1908,3
SIM,1885,18,30-34,1903,4
SIM,1840,74,na,1914,1727
SIM,1854,24,30-34,1878,42
SIM,1930,10,na,1940,10979
STAT,1923,30,30-34,1953,36.7592366064866
SIM,1943,15,30-34,1958,37
STAT,1861,41,15-19,1902,0.023319479327098314
STAT,1900,23,20-24,1923,192.4703557291744
STAT,1855,39,na,1894,3516.903036376696
STAT,1827,36,35-39,1863,15.092916365980967
SIM,1924,38,50-100,1962,3
STAT,1868,30,15-19,1898,0.27583966162560547
SIM,1854,20,15-19,1874,8
STAT,1850,36,na,1886,3707.854240194748
STAT,1905,4,na,1909,7683.6618908922555
STAT,1905,43,na,1948,6725.00460113407
SIM,1890,21,30-34,1911,54
STAT,1935,15,30-34,1950,33.81522445155991
STAT,1858,31,35-39,1889,16.110661425824695
STAT,1855,23,50-100,1878,0.7132225480787256
STAT,1916,38,50-100,1954,0.8640332760552161
SIM,1868,21,20-24,1889,132
STAT,1929,31,40-44,1960,10.043947544885642
SIM,1816,52,na,1868,2642
SIM,1937,31,40-44,1968,1
STAT,1856,19,45-49,1875,0.11894389793253601
STAT,1836,35,30-34,1871,8.882364038644956
SIM,1880,32,30-34,1912,46
STAT,1894,27,35-39,1921,25.033149208856113
STAT,1913,23,30-34,1936,58.44888396547458
SIM,1948,21,45-49,1969,4
SIM,1909,15,25-29,1924,27
STAT,1879,49,50-100,1928,0.5079917210171792
SIM,1900,4,na,1904,7702
SIM,1918,20,20-24,1938,262
STAT,1869,48,40-44,1917,0.3308184090801175
STAT,1878,64,na,1942,3666.7205842031112
STAT,1899,28,50-100,1927,1.7638867276744497
STAT,1859,29,35-39,1888,15.552512869117455
STAT,1863,62,na,1925,3231.2471049326814
SIM,1918,35,25-29,1953,1
SIM,1858,84,na,1942,534
STAT,1846,62,na,1908,2799.552472632197
STAT,1919,42,40-44,1961,0.5473139599445817
STAT,1945,22,30-34,1967,63.613024409256425
SIM,1929,23,50-100,1952,6
STAT,1883,51,45-49,1934,0.028934377543447423
SIM,1876,16,30-34,1892,5
STAT,1846,20,15-19,1866,6.325389654701716
STAT,1911,42,35-39,1953,0.38826954174235767
SIM,1854,39,35-39,1893,18
STAT,1856,44,45-49,1900,2.3006396481663374
STAT,1921,18,40-44,1939,3.210763939240104
STAT,1882,32,na,1914,4694.820430888726
STAT,1840,101,na,1941,0.8236611166664084
STAT,1859,27,15-19,1886,0.7419107427154936
STAT,1824,78,na,1902,835.3509007484764
SIM,1919,35,50-100,1954,3
STAT,1917,31,na,1948,8030.521351966299
STAT,1846,24,30-34,1870,33.182069151910966
SIM,1893,13,na,1906,6846
SIM,1898,20,25-29,1918,200
SIM,1928,24,25-29,1952,266
STAT,1835,44,50-100,1879,1.5987116789140388
STAT,1853,50,20-24,1903,0.0011843151267624343
STAT,1871,19,40-44,1890,0.3650295997349486
STAT,1931,20,na,1951,9622.951222916976
STAT,1870,47,30-34,1917,0.19104285472141852
SIM,1867,27,15-19,1894,1
SIM,1844,35,30-34,1879,10
SIM,1877,48,40-44,1925,2
SIM,1835,36,35-39,1871,17
STAT,1924,24,15-19,1948,12.602949430957052
STAT,1830,78,na,1908,1078.9291506385646
STAT,1905,31,25-29,1936,17.248198432967545
SIM,1839,58,na,1897,2645
STAT,1879,51,25-29,1930,0.007518221702204934
STAT,1895,16,25-29,1911,14.949361632685164
STAT,1901,43,25-29,1944,0.125169248669069
STAT,1851,77,na,1928,1339.965684274661
STAT,1940,29,30-34,1969,80.62089714731525
SIM,1927,32,30-34,1959,53
SIM,1918,13,na,1931,8943
STAT,1811,103,na,1914,0.1334064518447714
SIM,1776,78,na,1854,440
SIM,1834,74,na,1908,1306
SIM,1818,59,na,1877,2322
SIM,1839,18,na,1857,4034
STAT,1916,33,20-24,1949,5.064426432725048
STAT,1916,46,na,1962,7629.065244510344
STAT,1845,31,25-29,1876,18.96216626455011
STAT,1856,20,50-100,1876,0.7487097614415503
SIM,1775,93,na,1868,1
STAT,1854,33,25-29,1887,15.913470901241475
SIM,1907,20,45-49,1927,4
STAT,1911,43,na,1954,7118.125616106551
SIM,1797,77,na,1874,643
SIM,1924,33,20-24,1957,8
STAT,1807,49,25-29,1856,0.3811858695958129
STAT,1882,21,30-34,1903,35.149627003835306
SIM,1836,44,na,1880,3073
SIM,1935,23,25-29,1958,261
STAT,1893,40,15-19,1933,0.0357081888674401
SIM,1833,48,30-34,1881,1
STAT,1887,25,30-34,1912,57.266587927809034
STAT,1903,19,35-39,1922,1.569385704647765
STAT,1898,15,35-39,1913,1.5066379140610415
SIM,1931,30,30-34,1961,62
STAT,1841,39,50-100,1880,2.055665187500472
STAT,1877,39,35-39,1916,14.683747380580465
STAT,1881,28,na,1909,4642.288751073834
STAT,1906,47,25-29,1953,0.09517399444278009
STAT,1829,46,40-44,1875,0.273686752457805
SIM,1936,34,30-34,1970,29
SIM,1836,25,25-29,1861,74
STAT,1846,42,30-34,1888,1.7822756252938712
SIM,1862,33,25-29,1895,5
STAT,1887,75,na,1962,2782.495366739269
STAT,1937,22,35-39,1959,18.52211852977899
STAT,1925,35,20-24,1960,0.6399625504098891
SIM,1871,27,35-39,1898,3
SIM,1887,13,na,1900,6381
SIM,1913,31,25-29,1944,24
STAT,1900,28,50-100,1928,1.7858694141040299
STAT,1910,45,25-29,1955,0.10046118962949628
SIM,1922,0,na,1922,10312
SIM,1841,39,25-29,1880,8
STAT,1925,37,50-100,1962,1.0175155106954257
SIM,1914,47,25-29,1961,1
SIM,1885,39,35-39,1924,19
SIM,1854,42,30-34,1896,1
SIM,1839,24,35-39,1863,13
STAT,1890,49,45-49,1939,0.32131861430058056
SIM,1867,36,na,1903,4810
SIM,1875,19,20-24,1894,34
STAT,1867,19,20-24,1886,33.87731966648889
SIM,1848,36,45-49,1884,8
SIM,1922,20,40-44,1942,8
STAT,1863,27,35-39,1890,17.058347054789078
STAT,1833,39,25-29,1872,4.643376108187918
STAT,1873,24,na,1897,4822.830517003977
SIM,1876,13,na,1889,5575
STAT,1868,37,35-39,1905,13.590805262873912
SIM,1806,93,na,1899,6
SIM,1933,35,20-24,1968,3
STAT,1828,43,25-29,1871,1.1897784681230277
SIM,1902,17,35-39,1919,2
SIM,1931,35,na,1966,10144
SIM,1848,18,45-49,1866,1
STAT,1860,48,20-24,1908,0.019433702373593657
STAT,1928,5,na,1933,10230.437113738233
STAT,1787,81,na,1868,389.5767135040478
SIM,1903,28,40-44,1931,13
STAT,1931,21,25-29,1952,242.69198766617242
SIM,1851,43,20-24,1894,1
STAT,1834,110,na,1944,3.6723614818198985E-4
SIM,1859,28,30-34,1887,50
STAT,1928,34,30-34,1962,39.729465727270615
STAT,1898,56,na,1954,5574.498705834711
SIM,1892,68,na,1960,4653
SIM,1823,34,na,1857,3322
SIM,1876,37,35-39,1913,17
SIM,1914,29,25-29,1943,141
SIM,1945,22,35-39,1967,37
STAT,1839,16,40-44,1855,0.37580673223862276
SIM,1906,38,30-34,1944,5
STAT,1922,46,na,1968,8542.663554131572
SIM,1809,46,35-39,1855,1
SIM,1895,25,30-34,1920,92
STAT,1866,49,30-34,1915,0.17661853940449385
STAT,1914,20,40-44,1934,6.698299436001243
SIM,1911,19,35-39,1930,2
STAT,1862,25,30-34,1887,44.262602909459865
SIM,1834,45,50-100,1879,1
STAT,1867,50,50-100,1917,0.028976213211571865
SIM,1858,17,25-29,1875,13
STAT,1927,23,25-29,1950,229.09579122249943
STAT,1895,34,25-29,1929,26.723974641024167
STAT,1842,50,45-49,1892,0.021916782517348656
STAT,1826,45,50-100,1871,0.5032429446675708
STAT,1935,33,50-100,1968,2.309164756155858
SIM,1866,5,na,1871,5494
STAT,1951,12,na,1963,9446.358632225058
STAT,1920,31,20-24,1951,5.416657450689656
STAT,1933,8,na,1941,10784.01269656001
STAT,1829,81,na,1910,639.9997124826347
STAT,1843,43,20-24,1886,0.22614018500076385
SIM,1828,34,30-34,1862,37
STAT,1869,50,na,1919,4274.170458564141
SIM,1852,16,15-19,1868,14
STAT,1890,30,25-29,1920,25.452576845636425
STAT,1858,87,na,1945,277.3822542155718
STAT,1835,22,na,1857,3680.698569777555
SIM,1859,49,35-39,1908,1
STAT,1919,32,30-34,1951,34.3222493292803
STAT,1863,39,40-44,1902,7.661100659462215
STAT,1844,16,15-19,1860,12.254820624606744
STAT,1867,24,na,1891,4445.307406471426
STAT,1891,46,na,1937,5633.455621564938
STAT,1857,54,50-100,1911,0.023120913327534638
STAT,1942,23,20-24,1965,235.38759171279523
STAT,1890,28,50-100,1918,1.5713906536143691
SIM,1770,90,na,1860,21
SIM,1781,93,na,1874,11
STAT,1941,30,45-49,1971,3.340586875284547
STAT,1900,28,15-19,1928,1.266629873063348
STAT,1904,34,45-49,1938,2.877665897675484
SIM,1944,25,25-29,1969,161
STAT,1814,85,na,1899,235.92819621588575
STAT,1875,28,na,1903,4944.95313570267
SIM,1863,36,40-44,1899,16
SIM,1912,34,45-49,1946,5
SIM,1860,66,na,1926,2827
STAT,1908,41,15-19,1949,0.0028879333626255768
STAT,1936,25,25-29,1961,127.35448257741254
STAT,1855,36,40-44,1891,6.63275789417126
STAT,1864,104,na,1968,0.9787416697031417
STAT,1856,21,na,1877,3897.450978358179
STAT,1887,43,30-34,1930,2.5781030290313405
SIM,1852,99,na,1951,1
SIM,1871,39,40-44,1910,11
SIM,1853,31,25-29,1884,23
STAT,1906,29,25-29,1935,123.60096293251027
STAT,1870,13,na,1883,5227.336019384168
SIM,1848,18,15-19,1866,13
STAT,1904,21,30-34,1925,51.78905757841421
SIM,1867,61,na,1928,3706
SIM,1867,44,30-34,1911,3
STAT,1841,49,30-34,1890,0.13751752296134018
STAT,1870,26,35-39,1896,19.19781478106525
STAT,1927,21,na,1948,9112.73731034454
STAT,1873,42,25-29,1915,1.316119915516627
STAT,1925,20,na,1945,8878.965044171031
SIM,1868,35,50-100,1903,3
STAT,1872,14,na,1886,5293.812730359945
SIM,1843,57,na,1900,3002
SIM,1910,24,30-34,1934,72
SIM,1926,27,30-34,1953,118
STAT,1767,110,na,1877,0.0032576096612594975
SIM,1879,41,50-100,1920,2
STAT,1894,32,15-19,1926,0.3694620153518108
STAT,1919,16,50-100,1935,0.16813755934448787
STAT,1890,19,45-49,1909,0.16016658892887028
STAT,1901,16,na,1917,7158.358448927427
SIM,1844,41,25-29,1885,1
STAT,1845,12,na,1857,4649.403032129218
STAT,1928,17,45-49,1945,1.2710299213473346
SIM,1851,52,na,1903,3351
SIM,1894,63,na,1957,4830
STAT,1849,41,35-39,1890,2.8773025398488428
STAT,1900,38,25-29,1938,1.7324322239177703
STAT,1769,93,na,1862,8.602186787229405
SIM,1875,31,45-49,1906,5
STAT,1801,81,na,1882,452.5066544067926
STAT,1902,24,30-34,1926,50.47103733296372
STAT,1859,44,30-34,1903,1.823133650525551
SIM,1831,28,45-49,1859,2
SIM,1850,33,na,1883,3935
STAT,1855,47,50-100,1902,0.36862209824514536
STAT,1889,42,na,1931,5748.439190457609
SIM,1888,69,na,1957,3648
SIM,1881,42,25-29,1923,3
SIM,1909,19,40-44,1928,1
STAT,1918,27,30-34,1945,84.201451885767
SIM,1878,15,20-24,1893,42
STAT,1860,29,na,1889,3899.429388418487
STAT,1812,59,na,1871,2341.2463970183294
STAT,1919,17,35-39,1936,9.363180351387102
SIM,1858,25,na,1883,4206
SIM,1870,59,na,1929,3735
SIM,1850,22,40-44,1872,6
STAT,1871,52,30-34,1923,0.011880296550373494
STAT,1958,13,na,1971,10416.082392087252
STAT,1827,41,15-19,1868,0.026714563168878866
STAT,1939,17,20-24,1956,274.108993950833
STAT,1943,28,35-39,1971,32.2763748971324
SIM,1868,20,45-49,1888,2
STAT,1892,16,45-49,1908,0.16556024393442817
STAT,1881,19,35-39,1900,1.0653806212881476
STAT,1806,51,25-29,1857,0.021087206499239272
SIM,1890,47,50-100,1937,1
SIM,1858,44,20-24,1902,1
SIM,1954,16,50-100,1970,2
SIM,1839,30,50-100,1869,2
STAT,1880,52,40-44,1932,0.022279105100451425
SIM,1833,25,45-49,1858,3
STAT,1846,15,35-39,1861,1.0683389939433738
STAT,1834,28,20-24,1862,20.33011871316884
SIM,1842,28,20-24,1870,23
SIM,1947,17,20-24,1964,333
STAT,1842,22,40-44,1864,3.9130462277890867
STAT,1832,49,20-24,1881,0.016405483023510678
STAT,1858,41,45-49,1899,2.3669995907236
STAT,1782,75,na,1857,779.593372902603
SIM,1873,34,45-49,1907,7
SIM,1837,20,15-19,1857,6
SIM,1855,44,35-39,1899,8
STAT,1807,72,na,1879,1276.0697231752333
SIM,1830,28,50-100,1858,1
STAT,1847,44,35-39,1891,2.7230403445130635
SIM,1890,24,35-39,1914,20
STAT,1821,49,45-49,1870,0.6710777055007879
SIM,1825,30,35-39,1855,29
SIM,1884,34,20-24,1918,7
SIM,1920,23,na,1943,8314
SIM,1922,43,35-39,1965,1
SIM,1927,17,35-39,1944,13
STAT,1833,27,na,1860,3747.140429705229
STAT,1808,110,na,1918,2.1714672396869785E-4
STAT,1830,51,30-34,1881,0.009217585850163646
SIM,1877,91,na,1968,277
STAT,1860,31,50-100,1891,1.5088596620498598
STAT,1877,42,25-29,1919,1.3450468769067792
SIM,1953,10,na,1963,9959
STAT,1884,21,35-39,1905,11.672660294228669
SIM,1907,32,45-49,1939,5
STAT,1911,22,15-19,1933,10.198997502106305
SIM,1839,43,40-44,1882,7
SIM,1919,22,25-29,1941,227
SIM,1867,37,25-29,1904,7
STAT,1820,44,50-100,1864,4.0382851202152965
SIM,1906,21,50-100,1927,7
SIM,1910,17,25-29,1927,22
SIM,1841,34,50-100,1875,5
STAT,1902,17,25-29,1919,16.157804430278276
SIM,1905,35,45-49,1940,1
STAT,1876,34,20-24,1910,5.597969107713854
STAT,1837,22,30-34,1859,32.50696443162455
STAT,1851,15,45-49,1866,0.12457904658806765
STAT,1900,45,30-34,1945,0.15450295953697318
SIM,1892,21,35-39,1913,15
STAT,1934,35,30-34,1969,5.089074712323072
STAT,1881,29,50-100,1910,1.2398066160758148
STAT,1899,42,45-49,1941,0.2872340012925812
STAT,1914,43,35-39,1957,0.4024088765415844
SIM,1886,34,na,1920,4951
SIM,1905,17,15-19,1922,18
STAT,1891,2,na,1893,6654.505743202934
SIM,1793,87,na,1880,61
SIM,1825,38,30-34,1863,12
STAT,1926,40,20-24,1966,0.04408487963167508
STAT,1877,18,30-34,1895,3.333838778783813
SIM,1879,20,20-24,1899,143
STAT,1884,29,30-34,1913,49.86059075977394
STAT,1906,53,na,1959,6383.613660145538
STAT,1847,47,na,1894,3413.537787281437
STAT,1919,26,na,1945,8201.114433381763
SIM,1864,4,na,1868,5536
STAT,1909,9,na,1918,7862.738556098678
STAT,1851,46,na,1897,3497.5661976603265
STAT,1826,36,15-19,1862,0.13772458417952857
SIM,1901,50,na,1951,6281
STAT,1869,4,na,1873,5811.297203737504
STAT,1839,109,na,1948,0.0011108934425193035
STAT,1884,33,50-100,1917,1.819530491827431
STAT,1941,28,50-100,1969,2.078607827744592
SIM,1912,21,30-34,1933,79
STAT,1880,45,35-39,1925,0.3008297610561625
STAT,1882,24,35-39,1906,11.408832888570474
STAT,1864,19,na,1883,4661.303256479115
STAT,1861,26,25-29,1887,72.14365747409778
STAT,1923,49,15-19,1972,8.649345061428882E-4
STAT,1957,15,15-19,1972,120.8896778181407
STAT,1912,46,35-39,1958,0.2509352761332184
SIM,1889,37,45-49,1926,8
STAT,1841,56,na,1897,2959.3659281513947
STAT,1909,43,25-29,1952,0.13415690663203167
STAT,1813,54,35-39,1867,0.04862919615178531
SIM,1848,94,na,1942,22
SIM,1866,100,na,1966,7
SIM,1892,29,30-34,1921,92
STAT,1879,15,30-34,1894,3.3826563556476126
SIM,1887,21,25-29,1908,157
STAT,1897,45,45-49,1942,0.36296912344279075
SIM,1823,33,35-39,1856,28
SIM,1869,62,na,1931,3453
STAT,1910,19,40-44,1929,0.5569420242296572
STAT,1898,34,40-44,1932,11.751149202647593
STAT,1881,50,na,1931,4263.559487638298
SIM,1885,42,25-29,1927,3
STAT,1879,21,25-29,1900,121.29514278654412
STAT,1817,38,30-34,1855,36.6080466570512
SIM,1818,50,na,1868,2793
STAT,1856,83,na,1939,618.5994988138881
SIM,1865,33,40-44,1898,13
STAT,1876,26,50-100,1902,1.3408132530918897
SIM,1879,86,na,1965,741
STAT,1869,26,25-29,1895,83.06540657924862
STAT,1824,33,45-49,1857,6.8837891416938515
SIM,1846,39,45-49,1885,3
STAT,1832,79,na,1911,911.4360084685562
STAT,1952,4,na,1956,9517.151485578177
SIM,1890,23,50-100,1913,2
SIM,1916,38,25-29,1954,4
SIM,1927,7,na,1934,10282
STAT,1856,55,na,1911,3221.986089014829
STAT,1864,49,50-100,1913,0.4341264906109968
SIM,1862,30,20-24,1892,6
SIM,1837,39,35-39,1876,16
STAT,1903,16,30-34,1919,4.594527626620096
SIM,1826,36,25-29,1862,7
STAT,1876,27,15-19,1903,0.9477209659936024
STAT,1818,43,30-34,1861,5.458816518704356
STAT,1814,53,40-44,1867,0.05124401142426851
SIM,1893,27,25-29,1920,126
STAT,1818,44,na,1862,2954.0311938694167
SIM,1851,20,35-39,1871,12
STAT,1887,16,35-39,1903,1.2424642299059618
SIM,1843,36,25-29,1879,11
SIM,1874,26,45-49,1900,2
SIM,1925,35,30-34,1960,6
STAT,1927,32,20-24,1959,6.05886110205348
SIM,1921,45,40-44,1966,1
STAT,1855,100,na,1955,1.6008910522796265
STAT,1857,33,40-44,1890,6.798036524678271
STAT,1913,18,50-100,1931,0.1543391203342275
STAT,1805,53,30-34,1858,0.04580369951142199
SIM,1884,27,15-19,1911,1
STAT,1835,43,30-34,1878,1.7622073778501293
STAT,1829,39,35-39,1868,11.918687244857342
STAT,1891,24,45-49,1915,1.7298834965659282
STAT,1855,39,45-49,1894,2.975792610036024
STAT,1838,20,25-29,1858,101.97699520520334
SIM,1935,32,20-24,1967,7
SIM,1849,42,na,1891,3742
SIM,1787,87,na,1874,109
SIM,1774,80,na,1854,453
STAT,1853,31,15-19,1884,0.2344523843401617
STAT,1912,47,50-100,1959,0.4391204426155648
SIM,1906,28,na,1934,6926
STAT,1880,16,50-100,1896,0.10448979906861869
SIM,1843,43,30-34,1886,2
STAT,1809,46,25-29,1855,0.4546367090133335
SIM,1812,49,45-49,1861,2
STAT,1810,64,na,1874,1805.2778389854109
STAT,1828,40,20-24,1868,0.3088577176251212
SIM,1819,46,50-100,1865,2
STAT,1835,100,na,1935,1.3749809250512415
STAT,1825,91,na,1916,67.04769357922434
STAT,1886,38,50-100,1924,2.604494373915163
STAT,1908,54,na,1962,6539.357684213562
STAT,1801,87,na,1888,127.1400015907844
SIM,1826,43,30-34,1869,2
SIM,1852,36,35-39,1888,21
STAT,1925,26,na,1951,8964.916464121694
STAT,1830,44,25-29,1874,1.1192415695173725
SIM,1863,8,na,1871,5130
STAT,1928,18,50-100,1946,0.9507748672150539
SIM,1901,6,na,1907,7443
STAT,1844,36,35-39,1880,13.402272912661848
STAT,1917,35,30-34,1952,3.8592167498557157
SIM,1910,33,na,1943,7629
STAT,1885,34,30-34,1919,34.7986978339538
SIM,1893,34,30-34,1927,54
STAT,1829,49,45-49,1878,0.3627542811166572
STAT,1908,38,25-29,1946,1.8537961747723857
STAT,1840,43,40-44,1883,3.343663081456672
STAT,1841,33,45-49,1874,3.0381323342324396
SIM,1911,16,30-34,1927,6
STAT,1881,50,35-39,1931,0.01704708654181764
SIM,1898,42,35-39,1940,1
STAT,1849,49,30-34,1898,0.1499210823452784
STAT,1843,20,35-39,1863,10.409544469812582
STAT,1920,22,25-29,1942,207.344775917038
SIM,1889,19,15-19,1908,15
STAT,1902,63,na,1965,5545.306101859421
STAT,1852,93,na,1945,46.57973151134205
STAT,1837,49,50-100,1886,0.3464280812919434
SIM,1867,17,50-100,1884,1
STAT,1845,17,40-44,1862,0.3562234927610389
STAT,1840,18,35-39,1858,1.0194218141699631
SIM,1799,72,na,1871,974
STAT,1924,48,50-100,1972,0.5421640837555555
STAT,1775,93,na,1868,9.884654482004388
STAT,1843,28,30-34,1871,43.10079415524072
STAT,1928,30,15-19,1958,0.3248330574460032
SIM,1883,29,20-24,1912,29
SIM,1895,17,na,1912,7033
SIM,1863,44,30-34,1907,8
STAT,1903,22,25-29,1925,164.61332794955482
STAT,1923,25,45-49,1948,4.031773961661336
SIM,1925,28,25-29,1953,177
SIM,1863,20,25-29,1883,130
STAT,1864,13,na,1877,4876.978919650608
STAT,1873,27,na,1900,4897.279623689005
STAT,1878,16,25-29,1894,11.98219053911989
STAT,1860,28,30-34,1888,41.44320803250018
SIM,1928,34,50-100,1962,7
STAT,1876,37,25-29,1913,6.014239045849018
SIM,1942,28,25-29,1970,151
SIM,1846,20,25-29,1866,118
SIM,1944,22,20-24,1966,234
SIM,1936,17,45-49,1953,1
STAT,1913,45,40-44,1958,0.3123318322680816
STAT,1815,43,45-49,1858,8.713365742132597
SIM,1840,43,na,1883,3755
STAT,1948,23,na,1971,8464.815461972548
SIM,1851,28,30-34,1879,65
SIM,1914,57,na,1971,7163
SIM,1888,20,30-34,1908,54
SIM,1857,77,na,1934,1405
SIM,1902,32,25-29,1934,6
STAT,1902,35,50-100,1937,0.7627755959377555
STAT,1853,41,na,1894,3673.393282480437
SIM,1912,28,na,1940,7602
SIM,1816,38,20-24,1854,4
STAT,1835,36,25-29,1871,4.660375219254058
STAT,1890,33,na,1923,5857.8041547520115
STAT,1934,28,25-29,1962,178.7661733356538
STAT,1824,44,na,1868,2863.9269754041707
SIM,1930,35,40-44,1965,4
STAT,1882,34,45-49,1916,3.4014169307251216
STAT,1918,43,35-39,1961,0.43163602778704907
SIM,1825,66,na,1891,1764
STAT,1860,20,35-39,1880,10.999132399125916
STAT,1899,32,35-39,1931,28.022995906940128
SIM,1874,49,na,1923,4229
SIM,1931,25,45-49,1956,2
STAT,1881,44,40-44,1925,4.331502110291433
STAT,1821,54,25-29,1875,0.009582918973929383
STAT,1854,30,20-24,1884,4.332502133454902
STAT,1855,20,25-29,1875,102.31014626006605
STAT,1931,1,na,1932,11039.80619104004
STAT,1838,39,45-49,1877,3.188633503019636
SIM,1857,41,35-39,1898,4
STAT,1917,28,25-29,1945,138.90552493012336
SIM,1863,77,na,1940,1546
STAT,1944,27,40-44,1971,10.173554481889605
STAT,1875,29,20-24,1904,24.219464584286495
STAT,1860,42,45-49,1902,2.451591833205033
STAT,1804,54,25-29,1858,0.019893869197209486
SIM,1911,22,25-29,1933,208
STAT,1887,47,na,1934,5058.231668223977
SIM,1870,87,na,1957,405
SIM,1832,33,45-49,1865,3
STAT,1806,59,na,1865,2017.591816661607
STAT,1850,47,15-19,1897,6.104481194133964E-4
SIM,1941,25,na,1966,7925
STAT,1844,17,50-100,1861,0.1005721293277319
STAT,1854,52,30-34,1906,0.009076604623337411
SIM,1852,40,50-100,1892,5
SIM,1945,1,na,1946,9348
STAT,1845,103,na,1948,0.2211474159450079
STAT,1876,44,30-34,1920,2.369079994713311
STAT,1818,36,25-29,1854,22.086824233502977
STAT,1809,53,30-34,1862,0.04300311684308146
SIM,1829,28,na,1857,3602
STAT,1833,54,20-24,1887,9.625740223196011E-4
STAT,1907,20,50-100,1927,1.2176920601263224
STAT,1871,45,25-29,1916,0.11672749982695924
STAT,1883,85,na,1968,1113.7701234385881
STAT,1859,15,45-49,1874,0.12333769826658049
STAT,1885,27,25-29,1912,85.03838480150603
STAT,1908,45,30-34,1953,0.16532652269243872
SIM,1901,24,20-24,1925,177
SIM,1885,1,na,1886,6585
STAT,1821,39,35-39,1860,24.54957982346484
STAT,1891,46,50-100,1937,0.34682783327149214
STAT,1928,40,25-29,1968,0.18433632138088524
STAT,1890,16,40-44,1906,0.4519919397704857
SIM,1943,27,30-34,1970,100
STAT,1900,68,na,1968,4919.572210888796
SIM,1889,17,na,1906,6440
STAT,1842,29,25-29,1871,76.7685235030834
SIM,1861,25,20-24,1886,25
SIM,1868,18,30-34,1886,6
SIM,1909,43,35-39,1952,2
SIM,1825,40,45-49,1865,5
SIM,1865,18,15-19,1883,12
STAT,1889,70,na,1959,3734.675611667127
STAT,1867,44,20-24,1911,0.2963282702473109
STAT,1884,31,45-49,1915,3.4918649956846006
SIM,1861,42,50-100,1903,3
STAT,1877,32,15-19,1909,0.29865142151709806
SIM,1831,25,40-44,1856,10
STAT,1827,27,na,1854,3230.3710663887973
STAT,1870,23,30-34,1893,35.20954566333159
STAT,1813,48,40-44,1861,1.0380478194928355
STAT,1863,15,35-39,1878,1.120089218748061
STAT,1869,41,20-24,1910,0.31219374056646176
STAT,1940,25,15-19,1965,1.4552523966311441
SIM,1789,82,na,1871,261
SIM,1873,31,40-44,1904,1
STAT,1954,5,na,1959,9815.467011010043
STAT,1926,43,25-29,1969,0.17748195647132403
STAT,1834,38,30-34,1872,8.73333611407232
STAT,1909,36,na,1945,7230.489189917426
SIM,1892,19,20-24,1911,55
SIM,1871,45,35-39,1916,1
STAT,1869,56,na,1925,3991.44044279471
SIM,1874,32,50-100,1906,2
SIM,1919,16,30-34,1935,35
STAT,1921,21,30-34,1942,65.7444470716084
STAT,1855,54,40-44,1909,0.015438452448886503
SIM,1885,32,15-19,1917,5
SIM,1827,92,na,1919,24
STAT,1865,66,na,1931,3007.274232920673
SIM,1813,41,na,1854,3134
STAT,1897,35,35-39,1932,19.27569673667807
SIM,1812,65,na,1877,1837
STAT,1879,18,35-39,1897,1.1560985718264838
SIM,1821,70,na,1891,1536
SIM,1889,34,40-44,1923,15
SIM,1901,27,25-29,1928,130
STAT,1881,22,na,1903,4616.767100521574
STAT,1932,39,15-19,1971,0.052002502178012125
STAT,1817,40,45-49,1857,8.751728727136737
STAT,1936,22,20-24,1958,214.74373897211007
SIM,1906,16,20-24,1922,48
STAT,1871,42,20-24,1913,0.3182684099338397
SIM,1854,94,na,1948,36
STAT,1853,25,20-24,1878,21.814827542039883
SIM,1880,18,na,1898,5616
STAT,1895,16,50-100,1911,0.1292451753499866
STAT,1885,80,na,1965,1830.4321003315292
STAT,1884,19,20-24,1903,35.165882452146505
STAT,1909,37,30-34,1946,3.4859813812636844
STAT,1898,37,45-49,1935,5.448374059152206
SIM,1951,18,25-29,1969,143
STAT,1889,44,40-44,1933,5.525614630966265
STAT,1943,18,25-29,1961,92.77657210614831
STAT,1912,53,na,1965,6980.833930728438
SIM,1878,21,15-19,1899,7
SIM,1892,34,na,1926,6773
STAT,1893,19,30-34,1912,4.0582306047225805
SIM,1843,26,15-19,1869,1
SIM,1897,44,40-44,1941,1
STAT,1890,67,na,1957,4015.6728019073885
STAT,1900,48,35-39,1948,0.21846893612064536
STAT,1888,15,40-44,1903,0.43863002653411337
STAT,1819,109,na,1928,7.444549083536746E-4
SIM,1932,30,45-49,1962,6
STAT,1847,72,na,1919,1925.0835376271423
STAT,1875,35,15-19,1910,0.11787400854445272
STAT,1857,18,15-19,1875,10.915574331428802
SIM,1812,93,na,1905,22
STAT,1855,29,35-39,1884,14.948896817368786
STAT,1866,14,na,1880,4972.228765144997
STAT,1918,37,40-44,1955,3.1861251179498398
SIM,1892,31,45-49,1923,11
STAT,1835,26,15-19,1861,0.7717226846319056
STAT,1880,39,40-44,1919,9.219721053545543
STAT,1900,35,20-24,1935,2.180139402506067
STAT,1920,38,40-44,1958,3.3061067239336888
STAT,1933,21,na,1954,9813.459762518207
SIM,1864,34,35-39,1898,29
STAT,1895,31,20-24,1926,7.142522031836475
STAT,1861,48,35-39,1909,0.2323841055100707
STAT,1864,107,na,1971,0.1367205878723099
SIM,1875,62,na,1937,4052
SIM,1938,27,20-24,1965,38
SIM,1894,69,na,1963,4274
STAT,1844,33,30-34,1877,33.36933380984629
STAT,1851,28,20-24,1879,21.140267734936405
SIM,1844,31,15-19,1875,2
SIM,1934,31,50-100,1965,5
SIM,1887,37,40-44,1924,6
STAT,1826,28,30-34,1854,193.53799225745217
SIM,1880,44,30-34,1924,2
SIM,1926,37,40-44,1963,4
SIM,1867,34,20-24,1901,7
STAT,1812,46,30-34,1858,0.6838476477102793
STAT,1898,19,15-19,1917,16.132665269071385
SIM,1921,41,50-100,1962,1
STAT,1810,51,15-19,1861,1.551492063400711E-4
STAT,1814,110,na,1924,2.3782472830285079E-4
STAT,1828,110,na,1938,3.393585510557108E-4
SIM,1863,29,35-39,1892,21
STAT,1808,48,30-34,1856,0.6004452799007489
STAT,1932,9,na,1941,10646.7659177617
STAT,1830,54,35-39,1884,0.012561947482498994
SIM,1859,33,50-100,1892,2
STAT,1912,22,35-39,1934,18.229585550225703
STAT,1885,37,35-39,1922,14.218667014895011
STAT,1832,73,na,1905,1548.4943648008311
SIM,1839,28,15-19,1867,1
SIM,1875,29,30-34,1904,73
SIM,1893,37,35-39,1930,25
SIM,1906,40,45-49,1946,1
STAT,1864,52,25-29,1916,0.006360388655861712
SIM,1926,33,25-29,1959,6
SIM,1853,47,na,1900,3667
SIM,1886,6,na,1892,5515
STAT,1929,4,na,1933,10402.063953721174
SIM,1842,38,30-34,1880,5
SIM,1834,28,30-34,1862,58
SIM,1946,18,15-19,1964,92
STAT,1909,40,20-24,1949,0.03375722887584501
STAT,1848,43,40-44,1891,3.661511486390397
SIM,1939,15,na,1954,7669
STAT,1891,48,15-19,1939,5.561890223606859E-4
STAT,1903,11,na,1914,7437.247616575041
STAT,1908,35,20-24,1943,0.5035288618249012
SIM,1856,43,40-44,1899,7
SIM,1920,22,35-39,1942,33
STAT,1872,44,30-34,1916,2.3020299354801645
SIM,1834,49,na,1883,3015
STAT,1837,25,35-39,1862,17.515598139152836
SIM,1877,16,15-19,1893,11
STAT,1888,23,na,1911,5628.080380545857
SIM,1839,46,45-49,1885,1
SIM,1866,41,45-49,1907,7
SIM,1859,30,45-49,1889,5
STAT,1854,29,na,1883,3780.433590252637
STAT,1853,19,50-100,1872,0.09215032874264324
STAT,1863,45,35-39,1908,0.24997362365176287
STAT,1869,34,50-100,1903,1.7776858783584237
SIM,1852,33,30-34,1885,37
STAT,1858,39,30-34,1897,8.306533389309555
STAT,1938,18,15-19,1956,90.40017094125793
SIM,1904,33,na,1937,7028
STAT,1842,25,45-49,1867,2.0738995844773287
STAT,1856,34,35-39,1890,15.64525550872067
STAT,1844,41,15-19,1885,0.0231351595500537
SIM,1850,29,25-29,1879,96
SIM,1934,28,35-39,1962,49
STAT,1914,35,15-19,1949,0.03909737838765569
SIM,1851,18,20-24,1869,31
STAT,1926,28,35-39,1954,36.21452031968156
STAT,1791,86,na,1877,144.27578985367
STAT,1869,28,na,1897,4653.842287763038
STAT,1843,82,na,1925,653.5969358217519
STAT,1874,40,na,1914,4827.673279461566
SIM,1919,32,na,1951,8290
STAT,1836,31,15-19,1867,0.24188528876678234
STAT,1879,37,40-44,1916,9.247374504919113
SIM,1828,40,na,1868,3333
STAT,1935,27,30-34,1962,107.88997317388586
STAT,1869,16,15-19,1885,11.844137966501629
STAT,1934,38,35-39,1972,6.735259658831617
SIM,1873,61,na,1934,3837
STAT,1913,41,50-100,1954,0.23276848767250197
SIM,1854,48,50-100,1902,1
STAT,1876,38,na,1914,4896.896161949609
SIM,1836,75,na,1911,1201
SIM,1883,39,30-34,1922,16
STAT,1887,32,50-100,1919,2.0696087424328353
STAT,1904,46,45-49,1950,0.38698643819207673
STAT,1927,35,25-29,1962,2.476248640455896
STAT,1830,41,20-24,1871,0.2886972511891907
STAT,1950,20,45-49,1970,2.697480856817607
STAT,1870,46,50-100,1916,0.4883650053471658
STAT,1783,107,na,1890,0.014525958143903178
SIM,1896,45,50-100,1941,4
STAT,1863,31,na,1894,4236.001431520162
SIM,1862,49,40-44,1911,2
STAT,1846,27,50-100,1873,1.185343215387992
SIM,1895,32,50-100,1927,2
SIM,1916,35,20-24,1951,1
SIM,1832,30,40-44,1862,13
STAT,1896,52,na,1948,5710.860078229245
SIM,1876,44,na,1920,4933
SIM,1831,38,na,1869,3619
SIM,1869,25,20-24,1894,26
SIM,1908,38,35-39,1946,8
SIM,1918,32,20-24,1950,5
STAT,1901,19,30-34,1920,4.482289847178115
SIM,1893,24,20-24,1917,187
STAT,1894,23,na,1917,6116.914716006749
STAT,1838,98,na,1936,4.396468782717371
SIM,1845,52,na,1897,3485
SIM,1933,22,45-49,1955,2
STAT,1868,36,20-24,1904,1.4883356078933507
STAT,1897,37,na,1934,6360.294739621768
SIM,1912,46,45-49,1958,2
STAT,1820,47,35-39,1867,0.5209633487639624
STAT,1854,49,40-44,1903,0.25696772008522395
SIM,1847,22,35-39,1869,18
STAT,1939,24,50-100,1963,1.333836514968245
SIM,1861,76,na,1937,1638
STAT,1818,46,35-39,1864,0.6267880050199298
STAT,1877,50,45-49,1927,0.03087218943717504
STAT,1906,49,15-19,1955,6.501613385079293E-4
STAT,1843,30,45-49,1873,2.998312230916094
SIM,1860,33,20-24,1893,5
STAT,1839,22,35-39,1861,11.707433307948358
STAT,1834,34,15-19,1868,0.2378269477201047
STAT,1918,33,25-29,1951,19.74872332914925
SIM,1867,40,50-100,1907,7
STAT,1842,33,50-100,1875,1.6308675306996279
SIM,1935,35,25-29,1970,2
SIM,1945,15,na,1960,8450
STAT,1875,39,30-34,1914,10.97052989298689
SIM,1830,53,na,1883,2611
STAT,1908,48,35-39,1956,0.23498950322188084
STAT,1849,100,na,1949,1.6793082658299774
STAT,1935,30,50-100,1965,2.31321051646774
STAT,1826,43,20-24,1869,0.3286947695982469
STAT,1853,47,30-34,1900,0.15244307486978448
SIM,1825,43,50-100,1868,3
STAT,1831,43,30-34,1874,1.7971021587174858
SIM,1826,33,20-24,1859,6
SIM,1853,47,40-44,1900,1
SIM,1861,47,30-34,1908,1
STAT,1874,33,40-44,1907,8.930115489279856
SIM,1846,36,40-44,1882,12
SIM,1928,43,na,1971,9695
STAT,1815,109,na,1924,6.613016425443104E-4
SIM,1845,80,na,1925,852
STAT,1862,31,25-29,1893,17.753051211291254
STAT,1897,44,50-100,1941,0.19537830890646102
STAT,1926,33,15-19,1959,0.31356951344705875
STAT,1843,36,15-19,1879,0.09278979389756664
STAT,1868,40,na,1908,4485.9205812721175
STAT,1914,40,30-34,1954,0.2576786489896076
SIM,1948,15,15-19,1963,110
STAT,1795,76,na,1871,801.0619184184952
STAT,1845,46,na,1891,3476.7029829287103
SIM,1816,48,30-34,1864,1
SIM,1825,38,na,1863,3013
SIM,1886,16,25-29,1902,21
STAT,1859,97,na,1956,10.062219164155781
STAT,1936,32,30-34,1968,30.912801423254706
STAT,1862,53,35-39,1915,0.014622359856273455
STAT,1860,24,15-19,1884,5.497823306853344
STAT,1877,20,45-49,1897,1.4711191302152882
STAT,1882,38,na,1920,4612.151348742098
SIM,1845,15,25-29,1860,13
STAT,1816,39,25-29,1855,19.149501909213875
STAT,1822,54,45-49,1876,0.04171599003106111
SIM,1882,44,na,1926,4718
SIM,1868,28,40-44,1896,4
STAT,1857,31,na,1888,3819.1674705427686
STAT,1894,26,20-24,1920,30.54048832677235
STAT,1773,92,na,1865,19.925643401495382
STAT,1804,51,20-24,1855,0.004403062970519035
STAT,1903,26,40-44,1929,8.643491639168335
STAT,1924,30,45-49,1954,3.723462543884677
STAT,1913,49,20-24,1962,0.02166214422356656
STAT,1873,95,na,1968,116.8276222739562
SIM,1851,30,45-49,1881,9
SIM,1857,49,30-34,1906,1
STAT,1838,36,40-44,1874,7.223480055163104
STAT,1861,16,15-19,1877,11.534229018383332
SIM,1888,42,40-44,1930,4
STAT,1852,33,20-24,1885,4.414510165112324
SIM,1834,42,50-100,1876,5
SIM,1886,33,50-100,1919,7
STAT,1933,32,45-49,1965,4.283246457383868
SIM,1894,17,50-100,1911,4
STAT,1818,51,15-19,1869,1.0608447256739434E-4
SIM,1871,15,35-39,1886,2
SIM,1795,82,na,1877,314
SIM,1837,23,na,1860,4013
STAT,1871,37,40-44,1908,8.783525134363964
SIM,1816,55,na,1871,2475
STAT,1893,34,20-24,1927,6.860258743274601
STAT,1885,24,20-24,1909,137.66727309387147
SIM,1824,30,50-100,1854,3
SIM,1903,21,20-24,1924,189
STAT,1793,104,na,1897,0.024210241517579976
SIM,1835,35,20-24,1870,2
STAT,1836,41,25-29,1877,1.0290359317633342
STAT,1915,36,na,1951,7713.315477149843
STAT,1841,23,35-39,1864,10.64882990983612
SIM,1911,26,40-44,1937,16
STAT,1881,40,25-29,1921,1.2661914201563926
STAT,1844,98,na,1942,5.246114725265462
STAT,1846,50,50-100,1896,0.023465450509674215
STAT,1885,42,15-19,1927,0.027727668324315075
SIM,1824,39,25-29,1863,6
STAT,1921,36,na,1957,8489.682855175584
SIM,1918,17,50-100,1935,1
STAT,1850,98,na,1948,4.980889982960524
STAT,1794,60,na,1854,1985.9999999999998
STAT,1880,20,20-24,1900,147.49115910420332
STAT,1839,46,na,1885,3625.408636422761
STAT,1875,31,50-100,1906,1.9129824724120912
STAT,1913,48,45-49,1961,0.42734264232727254
SIM,1845,28,50-100,1873,4
STAT,1925,22,45-49,1947,2.719513404345672
STAT,1891,80,na,1971,2492.545130165383
SIM,1942,25,20-24,1967,40
STAT,1826,42,50-100,1868,2.2314860521043944
STAT,1833,32,40-44,1865,7.3560336796141685
SIM,1843,23,na,1866,3962
STAT,1827,35,20-24,1862,1.6879307584385976
STAT,1944,23,25-29,1967,201.34190218587335
SIM,1898,59,na,1957,5512
STAT,1955,15,50-100,1970,1.0048745225649542
STAT,1828,50,30-34,1878,0.010773933524087799
SIM,1805,83,na,1888,233
SIM,1833,22,40-44,1855,4
SIM,1888,23,35-39,1911,18
SIM,1838,44,35-39,1882,8
STAT,1824,30,40-44,1854,27.829930314612568
SIM,1841,32,40-44,1873,9
SIM,1867,47,35-39,1914,1
STAT,1859,47,35-39,1906,0.22399929859555973
STAT,1823,51,25-29,1874,0.010746309373438432
STAT,1899,48,15-19,1947,6.165130534588739E-4
STAT,1890,42,25-29,1932,1.5810682685518282
STAT,1891,21,40-44,1912,5.2176883150283855
STAT,1876,40,15-19,1916,0.029137871566186198
STAT,1911,17,35-39,1928,1.696345080263049
SIM,1801,56,na,1857,2236
SIM,1921,48,45-49,1969,1
STAT,1857,36,45-49,1893,3.153244701075435
SIM,1872,29,45-49,1901,5
SIM,1928,22,35-39,1950,30
STAT,1930,41,25-29,1971,0.190028004387018
STAT,1934,25,20-24,1959,49.64420499737573
SIM,1947,8,na,1955,9314
STAT,1837,17,na,1854,4236.225596442963
SIM,1830,50,na,1880,2741
SIM,1848,50,50-100,1898,1
SIM,1904,64,na,1968,5635
STAT,1926,25,30-34,1951,95.49046366551445
SIM,1837,44,50-100,1881,6
SIM,1879,23,25-29,1902,135
SIM,1911,38,40-44,1949,4
STAT,1848,26,na,1874,4265.227491129601
STAT,1789,76,na,1865,764.1357483407091
STAT,1863,54,30-34,1917,0.01023412647941429
STAT,1953,6,na,1959,9603.476601093394
SIM,1847,16,na,1863,4424
STAT,1932,15,45-49,1947,1.3422196079333024
STAT,1864,26,40-44,1890,5.426478499687749
SIM,1809,76,na,1885,739
SIM,1949,9,na,1958,9615
STAT,1889,35,45-49,1924,5.011392133879235
SIM,1822,55,na,1877,2481
STAT,1815,103,na,1918,0.133397169751274
STAT,1876,47,35-39,1923,0.29107699097078144
STAT,1917,25,20-24,1942,38.92101583635823
STAT,1825,29,25-29,1854,285.1770146644771
SIM,1874,18,na,1892,4979
SIM,1869,48,50-100,1917,3
STAT,1874,18,15-19,1892,12.239992424621843
STAT,1943,14,na,1957,8409.374428542254
STAT,1906,26,50-100,1932,1.8890395235155524
SIM,1796,61,na,1857,1929
SIM,1846,17,35-39,1863,2
STAT,1900,25,50-100,1925,1.8043366034479154
STAT,1838,17,35-39,1855,0.9809258316163528
STAT,1847,29,45-49,1876,2.005169038844723
STAT,1825,40,35-39,1865,4.368491351162506
SIM,1928,19,45-49,1947,5
STAT,1940,15,50-100,1955,0.7687307168344973
STAT,1797,71,na,1868,1200.1528050995696
STAT,1854,20,na,1874,3907.113688969435
SIM,1884,47,35-39,1931,2
SIM,1872,19,35-39,1891,3
STAT,1840,51,25-29,1891,0.005137146569563937
STAT,1867,95,na,1962,61.86986423153897
STAT,1867,47,25-29,1914,0.10843814384787034
SIM,1930,41,35-39,1971,1
STAT,1823,65,na,1888,2049.54488328668
SIM,1885,55,na,1940,4393
SIM,1862,42,20-24,1904,1
SIM,1842,40,45-49,1882,4
SIM,1912,42,50-100,1954,1
SIM,1934,25,30-34,1959,125
STAT,1892,31,35-39,1923,25.70885449790832
STAT,1821,36,30-34,1857,22.23240992616556
STAT,1830,48,40-44,1878,0.29172294891096484
STAT,1840,47,20-24,1887,0.017467133389758336
STAT,1853,35,30-34,1888,8.609417597515737
SIM,1951,15,20-24,1966,313
SIM,1865,36,45-49,1901,5
SIM,1886,0,na,1886,7060
STAT,1872,45,na,1917,4612.1199319656525
STAT,1816,80,na,1896,607.6177597700837
STAT,1912,24,25-29,1936,185.1929755236199
SIM,1872,26,40-44,1898,7
STAT,1785,86,na,1871,149.49959844391955
SIM,1871,35,na,1906,4685
SIM,1871,42,30-34,1913,3
STAT,1916,12,na,1928,8462.331503102154
STAT,1869,103,na,1972,3.3064402755274873
STAT,1850,20,40-44,1870,3.890523330360875
STAT,1849,45,15-19,1894,6.39026702508298E-4
SIM,1879,30,30-34,1909,38
SIM,1833,40,35-39,1873,7
STAT,1872,40,15-19,1912,0.02831320713155322
SIM,1929,18,15-19,1947,115
STAT,1833,34,50-100,1867,1.5220233804706478
STAT,1842,35,na,1877,3819.141403194366
SIM,1919,19,35-39,1938,5
SIM,1784,76,na,1860,608
STAT,1931,29,na,1960,9758.465140814154
SIM,1833,29,25-29,1862,81
SIM,1925,25,20-24,1950,48
SIM,1939,19,20-24,1958,270
STAT,1895,46,25-29,1941,0.0857475896397583
SIM,1940,15,45-49,1955,1
STAT,1863,42,30-34,1905,2.0299968994714943
STAT,1872,54,40-44,1926,0.02078077983942659
STAT,1845,52,20-24,1897,0.0011310330167339391
SIM,1929,36,45-49,1965,2
SIM,1897,47,45-49,1944,1
STAT,1875,41,45-49,1916,3.126122360519328
SIM,1846,29,35-39,1875,24
SIM,1865,6,na,1871,5293
STAT,1896,15,30-34,1911,4.269684440786508
STAT,1907,30,45-49,1937,2.9961206508850617
SIM,1911,12,na,1923,8142
SIM,1874,15,na,1889,4973
STAT,1912,22,na,1934,7388.2277699377255
STAT,1921,36,35-39,1957,5.458083166021095
SIM,1861,35,30-34,1896,15
STAT,1922,41,35-39,1963,0.4673376739850584
SIM,1803,51,na,1854,2579
STAT,1823,68,na,1891,1833.8392613822741
SIM,1892,25,15-19,1917,4
STAT,1833,23,45-49,1856,1.2404460216218296
STAT,1848,28,15-19,1876,0.8817462563296337
SIM,1861,41,25-29,1902,2
STAT,1918,42,20-24,1960,0.037915497702909605
STAT,1879,46,50-100,1925,0.5202974169939719
STAT,1851,19,25-29,1870,10.554856762255456
STAT,1926,37,30-34,1963,4.4977805788400715
SIM,1858,56,na,1914,3497
STAT,1891,22,50-100,1913,1.0180006754724378
STAT,1808,50,45-49,1858,0.08972867311294035
STAT,1897,23,50-100,1920,1.0974863404071282
SIM,1858,53,na,1911,3652
STAT,1891,12,na,1903,6446.929539164957
SIM,1904,30,na,1934,7031
STAT,1916,15,na,1931,8314.323440071837
STAT,1859,66,na,1925,2634.6910819037375
SIM,1932,20,35-39,1952,24
SIM,1883,20,na,1903,4945
STAT,1865,60,na,1925,3499.314696798418
STAT,1867,92,na,1959,128.24167349262578
STAT,1868,16,50-100,1884,0.09641152065865376
SIM,1841,28,na,1869,3856
STAT,1935,23,15-19,1958,14.637803536416273
SIM,1866,82,na,1948,828
SIM,1883,41,45-49,1924,5
SIM,1902,26,30-34,1928,80
STAT,1835,46,35-39,1881,0.19367724268579312
STAT,1815,100,na,1915,0.9867987533687703
SIM,1907,36,25-29,1943,6
STAT,1870,25,20-24,1895,23.41925456791612
SIM,1825,34,15-19,1859,1
STAT,1808,51,na,1859,2505.7765191397243
STAT,1889,47,45-49,1936,0.3299633849597704
SIM,1915,30,45-49,1945,5
STAT,1838,29,35-39,1867,16.37386710783596
SIM,1833,95,na,1928,15
STAT,1879,18,na,1897,5321.306700611118
SIM,1926,42,20-24,1968,3
STAT,1909,47,40-44,1956,0.29275058781565805
STAT,1900,41,15-19,1941,0.0026988667287297934
SIM,1875,47,25-29,1922,1
STAT,1821,52,35-39,1873,0.024237984923147594
STAT,1924,41,na,1965,8932.283884029612
SIM,1876,36,20-24,1912,1
SIM,1929,22,na,1951,9546
STAT,1910,15,25-29,1925,17.428894672465095
STAT,1912,31,30-34,1943,31.446463697085463
SIM,1830,41,30-34,1871,3
STAT,1878,33,na,1911,5012.206377039116
STAT,1873,19,45-49,1892,0.13332658790422178
STAT,1873,24,50-100,1897,0.8315702365131586
SIM,1929,24,45-49,1953,3
STAT,1922,49,30-34,1971,0.20556440144712768
STAT,1855,50,25-29,1905,0.005417877186477424
SIM,1841,90,na,1931,88
SIM,1897,40,na,1937,6445
STAT,1839,41,40-44,1880,4.120120765139623
STAT,1853,72,na,1925,1998.1541583633514
STAT,1819,50,20-24,1869,0.003094161905838202
STAT,1930,2,na,1932,10678.689885743628
STAT,1886,41,20-24,1927,0.340112258448769
STAT,1908,4,na,1912,7886.511836599262
SIM,1856,28,15-19,1884,1
STAT,1879,80,na,1959,1603.2321416255422
STAT,1884,25,15-19,1909,0.9109440760327095
SIM,1847,41,40-44,1888,5
STAT,1822,53,30-34,1875,0.017454607992978058
STAT,1951,21,50-100,1972,1.5880923075545288
SIM,1897,35,45-49,1932,9
SIM,1870,37,30-34,1907,11
SIM,1823,36,50-100,1859,4
SIM,1926,30,20-24,1956,7
SIM,1869,23,30-34,1892,48
STAT,1920,16,30-34,1936,27.679958475999868
STAT,1847,22,25-29,1869,106.97455762877124
SIM,1841,35,45-49,1876,2
SIM,1946,21,40-44,1967,11
SIM,1869,28,25-29,1897,96
STAT,1894,36,30-34,1930,13.89358991565461
STAT,1843,18,20-24,1861,31.549777547302835
STAT,1882,23,50-100,1905,0.7998064329472094
STAT,1865,31,40-44,1896,7.989573733487564
SIM,1835,28,na,1863,3677
STAT,1878,30,na,1908,5073.907092119857
STAT,1912,56,na,1968,6866.763562272019
STAT,1921,43,40-44,1964,0.5679317481613443
STAT,1859,17,50-100,1876,0.09141679426857166
STAT,1918,30,20-24,1948,5.275913655002605
SIM,1814,91,na,1905,37
STAT,1856,22,35-39,1878,10.560734217655801
STAT,1868,52,25-29,1920,0.006769839029154456
STAT,1810,95,na,1905,12.023856814457837
SIM,1920,31,30-34,1951,52
STAT,1883,26,45-49,1909,2.210705535183816
STAT,1768,106,na,1874,0.02228029561946323
STAT,1831,53,40-44,1884,0.013895946392489304
STAT,1922,40,50-100,1962,0.27301387638922225
STAT,1858,53,45-49,1911,0.02248175163843017
SIM,1930,17,50-100,1947,1
SIM,1926,8,na,1934,10135
SIM,1902,5,na,1907,7690
STAT,1813,44,25-29,1857,4.215971442181999
STAT,1910,27,na,1937,7308.597453258387
SIM,1772,88,na,1860,61
SIM,1798,93,na,1891,5
STAT,1920,32,35-39,1952,20.211025177076447
STAT,1918,47,na,1965,7894.3135430477205
SIM,1844,47,30-34,1891,1
STAT,1938,21,40-44,1959,6.724067367907538
STAT,1898,40,35-39,1938,0.3471443754165425
SIM,1873,24,35-39,1897,13
STAT,1833,35,45-49,1868,3.35184351680705
STAT,1880,35,25-29,1915,6.183878754224094
SIM,1939,17,50-100,1956,1
SIM,1921,18,50-100,1939,1
SIM,1838,22,25-29,1860,119
SIM,1847,13,na,1860,4579
STAT,1893,47,na,1940,5733.533597507718
STAT,1841,87,na,1928,255.62596256537833
SIM,1874,27,20-24,1901,27
SIM,1889,40,35-39,1929,5
STAT,1930,41,na,1971,9883.16611226827
STAT,1884,33,na,1917,4738.866897351386
SIM,1849,48,na,1897,3650
STAT,1931,35,15-19,1966,0.05145446770444302
STAT,1852,46,35-39,1898,0.22376695016370682
SIM,1887,18,35-39,1905,1
STAT,1837,19,40-44,1856,0.36140262939299833
STAT,1827,45,30-34,1872,0.1795512623258276
SIM,1845,49,50-100,1894,1
STAT,1852,36,25-29,1888,4.661951454990916
STAT,1865,24,35-39,1889,10.682094212370895
STAT,1953,3,na,1956,9609.72160177115
SIM,1809,73,na,1882,997
SIM,1934,37,30-34,1971,5
STAT,1851,30,35-39,1881,16.682519598492856
STAT,1894,48,30-34,1942,0.13988253303679168
SIM,1897,29,15-19,1926,2
STAT,1935,30,20-24,1965,6.824310243537485
SIM,1900,71,na,1971,4702
SIM,1941,23,50-100,1964,1
STAT,1904,43,40-44,1947,0.44949601841432757
STAT,1812,47,45-49,1859,1.6391478519232334
STAT,1847,78,na,1925,1191.0181297609884
SIM,1863,26,50-100,1889,2
SIM,1803,88,na,1891,112
STAT,1904,27,na,1931,6917.909694088083
STAT,1804,53,50-100,1857,0.08655339797308693
STAT,1849,51,45-49,1900,0.023065545501973584
SIM,1835,90,na,1925,67
SIM,1894,38,50-100,1932,4
SIM,1903,31,30-34,1934,77
SIM,1829,39,45-49,1868,5
SIM,1860,36,25-29,1896,8
STAT,1868,2,na,1870,6438.290588491276
STAT,1862,33,15-19,1895,0.24478692467394608
STAT,1820,88,na,1908,153.68999372044235
SIM,1828,49,na,1877,2976
STAT,1889,29,15-19,1918,1.121749899695139
SIM,1841,23,45-49,1864,1
SIM,1872,85,na,1957,627
STAT,1925,26,25-29,1951,157.5145057165783
STAT,1893,37,25-29,1930,7.37039365608058
STAT,1942,22,50-100,1964,1.3933683662686815
SIM,1824,50,na,1874,3058
STAT,1842,19,15-19,1861,11.2126112835489
STAT,1927,45,35-39,1972,0.3283425347186129
STAT,1943,17,na,1960,7882.681407882768
SIM,1920,24,25-29,1944,239
STAT,1921,31,40-44,1952,8.829097479889878
STAT,1944,20,20-24,1964,242.62357091494835
STAT,1906,25,45-49,1931,3.289728340592952
STAT,1897,20,30-34,1917,48.37369947237875
STAT,1848,110,na,1958,6.730350088548823E-4
STAT,1948,23,50-100,1971,1.5252246192728034
STAT,1853,48,45-49,1901,0.36870776554001017
STAT,1860,20,na,1880,4030.096966110555
SIM,1855,29,45-49,1884,4
STAT,1762,117,na,1879,1.6784395962299035E-4
STAT,1845,40,20-24,1885,0.25567155585194584
SIM,1850,19,15-19,1869,12
SIM,1881,24,50-100,1905,1
STAT,1861,36,35-39,1897,11.946865849666791
SIM,1861,48,45-49,1909,2
SIM,1790,73,na,1863,1104
STAT,1901,21,45-49,1922,1.9775377842101378
STAT,1877,85,na,1962,938.5829629072456
SIM,1930,19,na,1949,10135
SIM,1917,37,30-34,1954,9
STAT,1813,52,50-100,1865,0.08880811175477701
STAT,1930,33,40-44,1963,10.193241393330794
STAT,1874,36,45-49,1910,4.142201832005606
SIM,1914,25,45-49,1939,5
SIM,1935,25,na,1960,11011
SIM,1889,48,na,1937,5635
SIM,1869,16,25-29,1885,22
STAT,1877,48,30-34,1925,0.20045415052223178
STAT,1870,48,45-49,1918,0.4620674579470887
SIM,1878,47,50-100,1925,3
STAT,1864,25,50-100,1889,1.1671862543850775
STAT,1935,37,40-44,1972,4.228384719789908
STAT,1892,62,na,1954,4621.0451433818625
STAT,1859,40,50-100,1899,1.7153707874447723
SIM,1821,44,25-29,1865,1
STAT,1779,86,na,1865,116.84613286283493
SIM,1837,20,50-100,1857,1
STAT,1872,48,na,1920,4509.213560720662
SIM,1882,24,45-49,1906,6
SIM,1855,22,25-29,1877,118
STAT,1826,46,25-29,1872,0.11643085657147094
STAT,1862,41,50-100,1903,1.8319001359754863
SIM,1878,18,25-29,1896,13
STAT,1822,51,40-44,1873,0.03212379887043674
SIM,1777,94,na,1871,3
SIM,1834,43,na,1877,3267
SIM,1841,17,15-19,1858,10
SIM,1784,73,na,1857,828
SIM,1891,26,45-49,1917,5
STAT,1937,19,45-49,1956,0.978758241664503
STAT,1917,32,50-100,1949,1.7484048339129743
SIM,1855,42,na,1897,4080
STAT,1819,91,na,1910,60.63524435177533
STAT,1817,65,na,1882,1918.2903192529434
STAT,1868,46,30-34,1914,0.18653185401462316
SIM,1824,35,45-49,1859,8
SIM,1908,35,30-34,1943,2
STAT,1840,107,na,1947,0.006807197944444409
SIM,1820,40,25-29,1860,4
SIM,1933,26,25-29,1959,195
SIM,1884,44,30-34,1928,2
STAT,1943,25,30-34,1968,84.3491258240819
STAT,1861,23,20-24,1884,118.15500124953512
STAT,1846,54,30-34,1900,0.008866847121328975
SIM,1833,26,20-24,1859,22
STAT,1847,26,40-44,1873,5.528107319203688
STAT,1875,31,35-39,1906,21.14378586692923
STAT,1822,51,50-100,1873,0.04608414133655019
STAT,1871,60,na,1931,3826.7846561895603
STAT,1855,17,35-39,1872,0.984130441390228
SIM,1807,47,na,1854,2504
STAT,1802,66,na,1868,1714.8378927691815
SIM,1832,35,50-100,1867,3
STAT,1925,29,na,1954,8870.40164647477
STAT,1919,40,15-19,1959,0.0033696590324829795
STAT,1871,43,35-39,1914,3.6071779933232158
SIM,1928,16,40-44,1944,4
STAT,1899,36,15-19,1935,0.15613534733813794
SIM,1868,15,na,1883,5075
STAT,1951,16,25-29,1967,104.24109720056336
STAT,1849,103,na,1952,0.22701180867617482
STAT,1867,40,40-44,1907,4.297263436440173
STAT,1847,41,na,1888,3588.449640089507
SIM,1880,49,na,1929,4872
STAT,1922,39,20-24,1961,0.604339030810559
STAT,1907,2,na,1909,7912.644678079567
STAT,1889,32,40-44,1921,10.799433901653583
SIM,1870,31,25-29,1901,27
SIM,1816,40,35-39,1856,8
STAT,1863,52,40-44,1915,0.018512758226200212
SIM,1847,44,45-49,1891,6
SIM,1897,32,40-44,1929,16
STAT,1895,43,20-24,1938,0.028812766930181515
STAT,1824,35,50-100,1859,4.046055136251357
SIM,1883,31,35-39,1914,33
SIM,1884,70,na,1954,2879
STAT,1896,58,na,1954,5273.1219058190145
STAT,1810,92,na,1902,37.665762398764365
STAT,1838,64,na,1902,2352.6370937635083
STAT,1884,43,45-49,1927,2.9631444683566417
SIM,1872,25,50-100,1897,1
STAT,1864,29,45-49,1893,1.990114651938346
SIM,1879,55,na,1934,4226
STAT,1827,51,25-29,1878,0.006297998782821244
STAT,1863,34,na,1897,4182.641558948676
STAT,1897,23,35-39,1920,15.705027693057417
STAT,1900,47,20-24,1947,0.01887578321360495
SIM,1820,34,30-34,1854,14
STAT,1885,30,15-19,1915,0.28858277506703367
STAT,1885,49,35-39,1934,0.275565182589401
STAT,1839,44,45-49,1883,2.400677818087832
STAT,1908,23,20-24,1931,205.95369000984326
STAT,1874,74,na,1948,2294.9482291707313
STAT,1937,14,na,1951,7761.250660578526
STAT,1845,50,30-34,1895,0.009304308523929427
SIM,1925,6,na,1931,9786
STAT,1817,52,45-49,1869,0.06717680143611848
SIM,1846,100,na,1946,1
SIM,1864,56,na,1920,3852
SIM,1901,15,25-29,1916,21
STAT,1792,65,na,1857,1591.6219807451203
SIM,1910,27,35-39,1937,41
STAT,1892,17,20-24,1909,44.822973243041304
STAT,1893,30,40-44,1923,11.190700532164948
STAT,1902,27,35-39,1929,27.51243511828993
SIM,1919,17,45-49,1936,1
STAT,1922,15,na,1937,8640.788102055998
SIM,1884,37,25-29,1921,8
STAT,1821,46,40-44,1867,0.5083925366980659
STAT,1867,37,15-19,1904,0.10621211948202428
STAT,1881,59,na,1940,3793.799975076184
SIM,1827,61,na,1888,2305
SIM,1863,17,35-39,1880,1
STAT,1841,53,na,1894,3073.9346292760592
STAT,1869,53,20-24,1922,0.0014208776299173356
SIM,1848,27,50-100,1875,2
SIM,1951,18,na,1969,9131
STAT,1911,39,45-49,1950,1.3168205677967157
SIM,1853,16,na,1869,4614
SIM,1916,23,20-24,1939,242
SIM,1818,87,na,1905,124
SIM,1932,11,na,1943,10753
STAT,1920,26,40-44,1946,10.35945678080663
SIM,1889,38,20-24,1927,2
STAT,1894,42,25-29,1936,0.11554872875604062
STAT,1898,30,25-29,1928,28.218955467352558
SIM,1892,43,45-49,1935,1
STAT,1903,48,50-100,1951,0.3933714937784496
SIM,1924,32,45-49,1956,9
STAT,1829,27,35-39,1856,27.96058203632109
STAT,1931,16,50-100,1947,0.9928643707493381
STAT,1850,23,45-49,1873,1.274074434168262
STAT,1899,32,na,1931,6603.253574039288
STAT,1921,33,30-34,1954,35.25207646166076
STAT,1826,79,na,1905,836.9024260826344
SIM,1875,40,40-44,1915,14
STAT,1918,45,25-29,1963,0.11452143881646946
STAT,1866,45,na,1911,4234.330410846653
STAT,1802,69,na,1871,1533.3560019921752
STAT,1858,19,na,1877,4172.032131543347
STAT,1909,33,na,1942,7262.178711541994
STAT,1918,49,40-44,1967,0.3368028575007612
SIM,1908,23,na,1931,7090
STAT,1880,42,30-34,1922,2.442991677647963
SIM,1790,76,na,1866,802
STAT,1836,43,15-19,1879,0.021569967788942213
STAT,1873,16,40-44,1889,0.3775511165741851
SIM,1946,0,na,1946,9130
SIM,1916,33,50-100,1949,3
STAT,1813,51,30-34,1864,0.03571308068601368
STAT,1912,34,35-39,1946,18.009961938961613
STAT,1858,35,15-19,1893,0.08925041882727826
SIM,1887,25,40-44,1912,10
SIM,1856,34,50-100,1890,4
SIM,1861,42,na,1903,4445
SIM,1876,41,na,1917,5055
STAT,1848,34,50-100,1882,1.5615833791168168
SIM,1902,22,15-19,1924,9
STAT,1908,33,50-100,1941,1.5705586203144675
STAT,1834,30,35-39,1864,17.62989346068917
SIM,1845,83,na,1928,524
STAT,1804,52,35-39,1856,0.050343423899047175
STAT,1892,4,na,1896,6651.157033974227
SIM,1837,27,35-39,1864,22
STAT,1773,98,na,1871,1.0487867112145062
STAT,1851,16,20-24,1867,33.611614665442985
STAT,1859,46,20-24,1905,0.01934463847730632
SIM,1911,32,35-39,1943,23
SIM,1859,19,35-39,1878,1
STAT,1828,52,20-24,1880,0.001283686157934044
SIM,1911,48,50-100,1959,2
SIM,1864,22,35-39,1886,14
STAT,1846,93,na,1939,44.764802326337815
STAT,1871,40,50-100,1911,2.1411759898236107
SIM,1842,30,35-39,1872,24
SIM,1947,10,na,1957,9313
STAT,1795,79,na,1874,602.8017016251971
STAT,1844,45,30-34,1889,0.15878889239981964
SIM,1898,22,na,1920,6703
STAT,1896,18,35-39,1914,1.459260286934469
SIM,1938,23,40-44,1961,8
STAT,1921,46,45-49,1967,0.4959352730722417
SIM,1891,23,40-44,1914,6
STAT,1879,25,40-44,1904,6.370991819857844
STAT,1889,16,50-100,1905,0.12230082290631596
SIM,1896,27,40-44,1923,10
SIM,1914,23,na,1937,7629
STAT,1893,27,15-19,1920,1.1614231729473494
STAT,1903,32,35-39,1935,29.121010168656156
STAT,1907,20,35-39,1927,17.425171340907763
STAT,1926,21,15-19,1947,13.098153551857255
SIM,1943,23,15-19,1966,9
SIM,1948,7,na,1955,9333
STAT,1860,18,20-24,1878,33.336730671750715
SIM,1811,47,35-39,1858,1
STAT,1881,48,20-24,1929,0.023130640561289873
SIM,1865,33,50-100,1898,3
SIM,1885,39,50-100,1924,5
SIM,1925,38,35-39,1963,9
SIM,1831,69,na,1900,1897
SIM,1854,97,na,1951,6
STAT,1914,47,15-19,1961,7.379629626325099E-4
SIM,1917,37,na,1954,8048
STAT,1817,68,na,1885,1715.2769874008761
STAT,1815,39,na,1854,2958.7743565334
STAT,1862,47,40-44,1909,0.2941478962759813
STAT,1814,54,na,1868,2354.089429258671
STAT,1872,50,25-29,1922,0.007292681269835418
SIM,1830,84,na,1914,323
STAT,1928,39,50-100,1967,1.0691864631376176
SIM,1852,68,na,1920,2499
STAT,1857,33,50-100,1890,1.4362642187648802
SIM,1883,23,na,1906,4876
STAT,1870,8,na,1878,5401.657510572543
SIM,1829,36,40-44,1865,16
SIM,1887,81,na,1968,1989
SIM,1935,22,na,1957,10280
SIM,1929,21,40-44,1950,15
STAT,1931,40,30-34,1971,0.3459051164179679
SIM,1824,32,40-44,1856,16
SIM,1866,39,30-34,1905,15
SIM,1882,21,40-44,1903,10
STAT,1888,27,40-44,1915,7.150606124716669
SIM,1800,77,na,1877,663
SIM,1915,20,35-39,1935,24
SIM,1848,37,20-24,1885,1
SIM,1872,82,na,1954,840
STAT,1788,97,na,1885,2.0241379695949946
STAT,1935,33,25-29,1968,25.813888915747672
SIM,1832,23,35-39,1855,13
STAT,1822,80,na,1902,698.4467634563408
STAT,1869,59,na,1928,3803.2418279108197
SIM,1887,15,30-34,1902,3
STAT,1839,34,35-39,1873,19.059383665133108
STAT,1860,30,45-49,1890,2.8830020328227404
STAT,1924,24,50-100,1948,1.5578431250739206
STAT,1917,38,35-39,1955,5.048247709687095
SIM,1932,24,50-100,1956,2
STAT,1767,98,na,1865,0.9305757352259714
STAT,1905,45,15-19,1950,6.655950538979085E-4
SIM,1821,76,na,1897,1117
SIM,1851,83,na,1934,493
SIM,1867,67,na,1934,3056
STAT,1778,100,na,1878,0.45373702669362737
SIM,1903,46,35-39,1949,1
STAT,1881,52,25-29,1933,0.00687748868437584
SIM,1934,21,15-19,1955,14
STAT,1847,8,na,1855,4671.94017
SIM,1946,24,45-49,1970,6
STAT,1885,36,20-24,1921,1.5570930497294138
SIM,1846,68,na,1914,2334
STAT,1812,49,35-39,1861,0.9399862314819613
STAT,1866,32,50-100,1898,1.7074050077008864
STAT,1889,73,na,1962,3413.1102712353663
STAT,1818,45,20-24,1863,0.05456102210302172
STAT,1916,32,45-49,1948,3.281055553530328
SIM,1851,24,15-19,1875,5
SIM,1893,36,20-24,1929,3
SIM,1869,26,35-39,1895,26
STAT,1861,33,30-34,1894,29.226074799067195
STAT,1877,39,50-100,1916,2.548856885694523
STAT,1870,38,35-39,1908,13.95482049800167
STAT,1938,24,45-49,1962,2.2478564321281733
STAT,1915,25,50-100,1940,2.064467253714787
SIM,1812,62,na,1874,2045
SIM,1847,34,35-39,1881,20
SIM,1887,8,na,1895,6415
STAT,1943,15,20-24,1958,290.5011693685814
STAT,1929,18,40-44,1947,3.595321355346572
STAT,1820,54,na,1874,2568.1100496728172
SIM,1841,20,40-44,1861,5
SIM,1846,24,40-44,1870,6
STAT,1820,35,35-39,1855,40.50475087476641
STAT,1843,24,15-19,1867,5.717717350730519
STAT,1843,42,45-49,1885,2.1586044390748036
STAT,1848,46,45-49,1894,0.3880695916832278
STAT,1948,19,20-24,1967,313.12045123743
SIM,1857,39,20-24,1896,4
SIM,1879,33,35-39,1912,22
STAT,1868,42,15-19,1910,0.026503281931742038
SIM,1920,44,45-49,1964,1
STAT,1918,40,30-34,1958,0.2752371083972941
STAT,1871,30,20-24,1901,5.467324660460573
STAT,1850,54,20-24,1904,0.0011003159192747318
SIM,1869,96,na,1965,48
SIM,1902,38,na,1940,6894
STAT,1913,41,25-29,1954,0.14148672869030327
SIM,1923,25,50-100,1948,1
STAT,1805,106,na,1911,0.009082097824982913
SIM,1815,76,na,1891,757
STAT,1779,83,na,1862,220.43762454692524
STAT,1768,103,na,1871,0.09053244198337529
STAT,1909,33,15-19,1942,0.2467504126137964
STAT,1829,53,na,1882,2636.8428402979466
STAT,1831,27,50-100,1858,1.1150276302137456
STAT,1844,35,20-24,1879,1.4759052085940092
SIM,1860,26,15-19,1886,1
SIM,1893,30,15-19,1923,4
STAT,1812,44,40-44,1856,16.529957725012153
SIM,1870,47,40-44,1917,1
STAT,1849,39,20-24,1888,1.2220501866412488
SIM,1860,97,na,1957,9
STAT,1942,22,45-49,1964,2.3826598155332865
SIM,1838,32,35-39,1870,5
STAT,1853,41,25-29,1894,1.0206190519383613
SIM,1888,35,35-39,1923,24
SIM,1902,36,40-44,1938,3
STAT,1880,74,na,1954,2361.1562213242273
STAT,1912,44,45-49,1956,0.32175909660012186
STAT,1883,23,40-44,1906,4.122069718289495
SIM,1855,26,40-44,1881,9
SIM,1820,44,40-44,1864,5
SIM,1843,33,20-24,1876,6
SIM,1837,17,25-29,1854,9
STAT,1838,24,40-44,1862,3.6066164243816945
SIM,1939,25,15-19,1964,1
STAT,1834,40,45-49,1874,2.4640592404986514
STAT,1864,19,35-39,1883,1.0127072805344515
SIM,1867,30,na,1897,4895
SIM,1941,20,45-49,1961,3
STAT,1875,59,na,1934,4041.145238680414
STAT,1927,42,30-34,1969,0.3237710023699444
STAT,1912,21,20-24,1933,215.9272082765565
SIM,1821,41,20-24,1862,1
STAT,1852,26,15-19,1878,0.8483337291126198
STAT,1865,34,45-49,1899,3.172190989565954
SIM,1920,21,20-24,1941,262
STAT,1903,38,40-44,1941,2.703486123377819
SIM,1906,19,25-29,1925,23
SIM,1875,96,na,1971,62
STAT,1869,18,40-44,1887,0.3607492692545874
SIM,1877,18,40-44,1895,1
SIM,1852,31,na,1883,4009
SIM,1969,1,na,1970,9608
STAT,1871,49,40-44,1920,0.3363430319126659
STAT,1877,44,15-19,1921,0.02857047295247374
STAT,1835,53,na,1888,2786.1087374962144
SIM,1892,37,na,1929,6754
STAT,1869,100,na,1969,14.015990170226718
STAT,1898,15,50-100,1913,0.13452121740329498
STAT,1880,32,20-24,1912,5.7509548400610075
SIM,1917,33,15-19,1950,1
SIM,1851,42,45-49,1893,5
SIM,1923,37,na,1960,9188
STAT,1835,33,20-24,1868,4.413017663447296
STAT,1813,41,20-24,1854,1.2271304783129802
STAT,1831,50,50-100,1881,0.02115518441131265
STAT,1933,20,45-49,1953,3.032556511953891
STAT,1850,97,na,1947,8.237096665995015
STAT,1861,32,40-44,1893,7.2900568393795355
STAT,1864,33,20-24,1897,4.859264608391789
STAT,1882,29,30-34,1911,49.18869428686142
SIM,1848,46,35-39,1894,1
STAT,1910,46,20-24,1956,0.02088316147422791
STAT,1887,38,20-24,1925,1.732551527651368
SIM,1816,40,30-34,1856,6
STAT,1879,23,na,1902,4980.673069478961
SIM,1924,21,15-19,1945,13
SIM,1858,36,50-100,1894,4
STAT,1842,27,35-39,1869,17.76504384760614
STAT,1861,49,na,1910,3703.0359275465353
SIM,1916,37,50-100,1953,3
STAT,1884,37,40-44,1921,8.729924596130465
SIM,1841,29,35-39,1870,21
STAT,1940,25,50-100,1965,2.0518154515491758
SIM,1821,35,50-100,1856,3
SIM,1834,31,35-39,1865,28
SIM,1859,44,45-49,1903,4
SIM,1965,1,na,1966,10587
SIM,1927,16,45-49,1943,1
SIM,1832,41,50-100,1873,4
SIM,1887,19,30-34,1906,4
STAT,1875,31,30-34,1906,36.45325562212467
SIM,1846,38,25-29,1884,7
SIM,1949,22,30-34,1971,86
STAT,1840,19,25-29,1859,10.465947930093698
SIM,1843,37,45-49,1880,7
SIM,1888,48,30-34,1936,1
SIM,1936,5,na,1941,6973
SIM,1883,39,40-44,1922,14
STAT,1849,44,35-39,1893,2.8256788302765603
STAT,1861,44,35-39,1905,3.002904972416227
STAT,1883,50,20-24,1933,0.0014852754448957165
SIM,1919,7,na,1926,9066
STAT,1880,16,15-19,1896,12.657200221770658
SIM,1860,34,40-44,1894,10
STAT,1866,53,25-29,1919,0.006494491575831279
STAT,1887,42,na,1929,5214.184011692898
SIM,1890,29,30-34,1919,75
SIM,1879,2,na,1881,6404
SIM,1844,14,na,1858,4247
SIM,1904,30,50-100,1934,4
SIM,1823,38,30-34,1861,13
SIM,1848,28,na,1876,3976
SIM,1881,23,20-24,1904,115
SIM,1927,43,50-100,1970,1
STAT,1833,21,25-29,1854,125.23535232105901
SIM,1916,17,na,1933,8417
SIM,1948,3,na,1951,9448
STAT,1811,50,30-34,1861,0.040124389443754266
STAT,1916,21,15-19,1937,11.299318630569378
SIM,1878,26,na,1904,5201
SIM,1832,23,25-29,1855,103
SIM,1919,19,50-100,1938,1
STAT,1889,46,30-34,1935,0.24173893903328836
STAT,1824,36,30-34,1860,16.89843713000597
SIM,1808,63,na,1871,1917
STAT,1828,31,na,1859,3569.0316817105513
STAT,1893,22,35-39,1915,14.938117339664327
SIM,1886,40,50-100,1926,2
STAT,1844,35,45-49,1879,3.8168277346205914
STAT,1888,17,30-34,1905,3.8046701692260685
STAT,1838,38,25-29,1876,4.653420121277939
SIM,1855,6,na,1861,5253
SIM,1894,32,45-49,1926,6
STAT,1871,51,40-44,1922,0.021224956592820015
STAT,1874,52,20-24,1926,0.001517830989190741
SIM,1835,53,na,1888,2910
SIM,1841,21,25-29,1862,131
STAT,1854,54,45-49,1908,0.021635558774902693
STAT,1895,61,na,1956,4964.987933794261
SIM,1799,85,na,1884,147
SIM,1852,35,45-49,1887,6
STAT,1863,52,45-49,1915,0.02551992374630775
SIM,1830,28,20-24,1858,21
SIM,1827,34,na,1861,3390
STAT,1806,52,15-19,1858,1.4353127170223007E-4
STAT,1891,27,30-34,1918,62.86364363832606
SIM,1910,12,na,1922,8279
STAT,1847,36,25-29,1883,4.601189288307677
STAT,1895,30,45-49,1925,4.62598355775855
SIM,1836,70,na,1906,1727
STAT,1856,111,na,1967,0.001263772316131868
SIM,1889,27,40-44,1916,11
STAT,1845,28,15-19,1873,0.8448517044955565
STAT,1864,45,15-19,1909,7.293224473077168E-4
SIM,1853,28,15-19,1881,2
STAT,1901,48,20-24,1949,0.01889798422035357
SIM,1863,35,20-24,1898,2
STAT,1871,23,50-100,1894,0.8157092256302806
SIM,1857,49,40-44,1906,1
STAT,1842,78,na,1920,1163.2593840662516
STAT,1900,39,15-19,1939,0.03361524049671175
STAT,1855,35,20-24,1890,1.1734288923653353
STAT,1908,15,30-34,1923,4.800445301534376
STAT,1887,25,15-19,1912,1.03177268819689
SIM,1827,41,45-49,1868,6
SIM,1844,48,50-100,1892,1
SIM,1795,71,na,1866,1285
SIM,1829,26,30-34,1855,50
SIM,1939,15,25-29,1954,103
STAT,1882,11,na,1893,5088.40158616795
SIM,1820,87,na,1907,144
STAT,1855,47,15-19,1902,6.003612191980028E-4
STAT,1853,30,na,1883,3969.702018316909
STAT,1831,26,20-24,1857,20.70727387850658
STAT,1871,18,15-19,1889,11.914080283669934
STAT,1873,26,25-29,1899,87.10278116184766
SIM,1842,30,30-34,1872,36
STAT,1886,32,45-49,1918,3.717728762699804
STAT,1919,37,na,1956,8161.119356821624
SIM,1938,16,20-24,1954,277
SIM,1896,17,30-34,1913,5
STAT,1819,70,na,1889,1535.5654212476209
SIM,1825,33,35-39,1858,20
SIM,1883,48,50-100,1931,2
STAT,1870,42,35-39,1912,3.5861103774174397
STAT,1873,43,15-19,1916,0.028133834051541073
STAT,1884,24,35-39,1908,11.564672653968076
STAT,1802,52,30-34,1854,0.0381586611238868
STAT,1835,42,40-44,1877,3.492136909287386
STAT,1812,48,na,1860,2864.1310930354625
STAT,1856,34,25-29,1890,15.823750099211653
STAT,1915,23,na,1938,7600.765819286312
STAT,1793,107,na,1900,0.0017117587615908167
STAT,1853,33,45-49,1886,2.8119284952682477
STAT,1851,25,35-39,1876,17.76749799776104
STAT,1879,39,25-29,1918,6.021023120811707
STAT,1898,44,30-34,1942,0.21525168652861146
STAT,1866,80,na,1946,1152.741642923368
STAT,1949,19,35-39,1968,9.848986183208504
STAT,1823,44,15-19,1867,0.04370003142164568
SIM,1840,22,20-24,1862,163
SIM,1869,97,na,1966,36
SIM,1912,9,na,1921,8271
SIM,1890,21,20-24,1911,188
STAT,1869,40,45-49,1909,2.958387330353727
SIM,1894,64,na,1958,4773
STAT,1803,51,35-39,1854,0.06453371614324656
STAT,1890,35,15-19,1925,0.13974443528845096
SIM,1872,4,na,1876,5950
STAT,1919,21,40-44,1940,7.456788082717309
SIM,1865,83,na,1948,630
STAT,1896,36,20-24,1932,2.065306110625372
SIM,1899,49,45-49,1948,1
STAT,1847,49,30-34,1896,0.1444754270531524
SIM,1869,35,15-19,1904,3
STAT,1852,34,40-44,1886,7.009361762332977
SIM,1828,34,15-19,1862,1
SIM,1887,39,25-29,1926,11
STAT,1889,2,na,1891,6638.1139550833095
STAT,1923,42,na,1965,8763.991457792323
STAT,1889,33,25-29,1922,25.39883249673287
SIM,1864,34,25-29,1898,24
STAT,1847,16,30-34,1863,3.0503489950270493
SIM,1892,24,35-39,1916,22
SIM,1877,40,45-49,1917,9
STAT,1833,34,30-34,1867,29.003249194012938
STAT,1835,37,45-49,1872,3.1933993006148333
STAT,1875,51,25-29,1926,0.00740032923352231
STAT,1882,21,20-24,1903,135.98753392956758
SIM,1890,50,na,1940,5800
STAT,1883,16,40-44,1899,0.3638210301282515
SIM,1822,46,50-100,1868,1
SIM,1927,21,40-44,1948,12
STAT,1834,30,30-34,1864,30.395077634536356
STAT,1832,22,20-24,1854,216.98394171543464
SIM,1886,45,na,1931,4736
STAT,1829,45,20-24,1874,0.019436361549076568
STAT,1821,84,na,1905,368.7392262073269
STAT,1833,29,35-39,1862,16.521650132138053
STAT,1912,49,35-39,1961,0.2488457698312421
SIM,1855,16,30-34,1871,3
SIM,1821,53,45-49,1874,1
STAT,1866,19,45-49,1885,0.12347555169389055
STAT,1919,16,45-49,1935,0.22418341245931714
STAT,1825,98,na,1923,3.7586781722732523
SIM,1843,42,40-44,1885,7
SIM,1897,33,25-29,1930,27
SIM,1874,33,30-34,1907,40
STAT,1948,18,na,1966,8503.931627785652
SIM,1854,43,50-100,1897,4
SIM,1838,19,35-39,1857,3
SIM,1876,41,40-44,1917,6
SIM,1892,37,40-44,1929,17
SIM,1890,16,25-29,1906,23
STAT,1950,20,50-100,1970,1.577474245379737
SIM,1841,34,30-34,1875,39
STAT,1817,46,40-44,1863,0.8398470876189225
SIM,1920,49,35-39,1969,1
SIM,1808,49,45-49,1857,2
STAT,1865,31,na,1896,4396.323370242514
SIM,1831,30,50-100,1861,2
SIM,1778,91,na,1869,37
SIM,1824,37,35-39,1861,10
STAT,1852,51,30-34,1903,0.009532627104352952
STAT,1892,43,25-29,1935,1.6118347378788844
SIM,1881,14,na,1895,4452
STAT,1878,81,na,1959,1427.783783767054
SIM,1875,32,35-39,1907,34
SIM,1852,33,na,1885,3987
SIM,1827,66,na,1893,1955
SIM,1836,29,50-100,1865,1
STAT,1791,69,na,1860,1375.2077107993164
STAT,1818,45,45-49,1863,1.0730333939708405
STAT,1868,41,40-44,1909,4.341599107087337
STAT,1825,52,25-29,1877,0.0074042549051714516
SIM,1857,64,na,1921,3139
SIM,1853,50,na,1903,3600
STAT,1850,26,30-34,1876,45.76560957487434
STAT,1885,36,45-49,1921,4.0267870205931535
STAT,1877,19,20-24,1896,36.98014885088372
STAT,1836,50,na,1886,3013.6150358250707
STAT,1820,67,na,1887,1756.659864337459
SIM,1882,31,na,1913,4994
STAT,1841,40,15-19,1881,0.021361449491848806
STAT,1803,87,na,1890,124.33567275477253
SIM,1851,23,35-39,1874,16
SIM,1874,28,35-39,1902,23
STAT,1833,51,20-24,1884,0.001021498280390457
STAT,1890,15,20-24,1905,43.90664766612374
STAT,1963,3,na,1966,10091.131067786968
SIM,1856,32,25-29,1888,27
SIM,1896,34,20-24,1930,6
STAT,1798,91,na,1889,36.83055281595112
SIM,1953,17,na,1970,9313
STAT,1825,35,35-39,1860,20.01670986556768
STAT,1898,19,40-44,1917,0.4972092966126592
SIM,1876,45,50-100,1921,1
STAT,1854,39,20-24,1893,1.169808238421288
STAT,1813,53,45-49,1866,0.08363896367109715
SIM,1894,29,15-19,1923,1
SIM,1823,52,na,1875,2698
STAT,1874,47,25-29,1921,0.1185565863406145
SIM,1949,17,35-39,1966,10
STAT,1865,37,30-34,1902,9.778769209552959
SIM,1865,39,50-100,1904,4
STAT,1834,38,40-44,1872,7.173214268593491
STAT,1837,39,20-24,1876,1.2814931570428676
STAT,1882,41,15-19,1923,0.02729234801713149
SIM,1839,28,40-44,1867,6
STAT,1830,53,45-49,1883,0.021599576621983963
STAT,1827,40,40-44,1867,4.431325702099642
SIM,1857,25,50-100,1882,1
STAT,1862,98,na,1960,11.742258879897088
STAT,1814,46,15-19,1860,0.0021047710552818304
STAT,1892,26,35-39,1918,24.479064609964134
SIM,1842,38,40-44,1880,2
STAT,1840,24,20-24,1864,124.6876260147673
STAT,1940,22,na,1962,7513.6518979546145
STAT,1875,26,35-39,1901,20.132367250276264
SIM,1939,32,15-19,1971,1
STAT,1865,32,25-29,1897,18.79324552551245
SIM,1893,33,40-44,1926,17
STAT,1899,40,30-34,1939,0.22314451873482657
STAT,1860,23,35-39,1883,9.795156338705032
SIM,1923,45,50-100,1968,1
STAT,1894,31,40-44,1925,11.297142839979507
STAT,1946,5,na,1951,8890.109907202906
STAT,1857,12,na,1869,4416.923762330885
STAT,1809,52,40-44,1861,0.07760252722786203
SIM,1843,37,50-100,1880,4
SIM,1917,48,50-100,1965,2
SIM,1816,50,na,1866,2734
STAT,1876,43,40-44,1919,4.664481379783868
STAT,1815,50,15-19,1865,1.317905886323161E-4
STAT,1888,34,20-24,1922,6.397134587257811
SIM,1867,42,na,1909,4672
STAT,1843,23,35-39,1866,10.186928939880133
STAT,1848,51,na,1899,3547.4570703849895
SIM,1858,48,45-49,1906,1
STAT,1881,37,15-19,1918,0.10961826858893656
STAT,1864,14,na,1878,4854.8374353553945
STAT,1897,35,25-29,1932,7.8466206473434665
SIM,1864,39,30-34,1903,4
STAT,1792,86,na,1878,143.84396905938706
STAT,1848,45,30-34,1893,0.16030606808765688
STAT,1870,6,na,1876,5487.693922157618
SIM,1915,26,50-100,1941,4
STAT,1872,27,20-24,1899,23.811801923417548
SIM,1840,32,na,1872,4087
STAT,1855,18,30-34,1873,2.841827132131421
SIM,1826,42,40-44,1868,6
STAT,1853,8,na,1861,4673.798174639524
STAT,1838,18,30-34,1856,2.832573331394979
STAT,1899,48,40-44,1947,0.26386780873280663
STAT,1777,106,na,1883,0.023025636490854325
STAT,1880,44,45-49,1924,3.1412303817682377
STAT,1923,10,na,1933,9422.00911594851
SIM,1879,27,50-100,1906,2
SIM,1897,36,50-100,1933,5
SIM,1898,45,35-39,1943,1
SIM,1903,42,na,1945,6844
STAT,1831,46,15-19,1877,6.200173957626405E-4
STAT,1845,102,na,1947,0.45176380116237935
STAT,1871,59,na,1930,3899.5900015178995
SIM,1887,36,20-24,1923,3
SIM,1844,46,na,1890,3180
SIM,1835,40,40-44,1875,5
STAT,1848,28,40-44,1876,5.82171582263858
STAT,1936,17,na,1953,7118.449899847267
SIM,1842,25,35-39,1867,29
SIM,1856,28,40-44,1884,9
SIM,1907,56,na,1963,6352
STAT,1839,42,25-29,1881,1.056783059446333
SIM,1863,18,30-34,1881,3
SIM,1889,10,na,1899,6617
STAT,1872,50,45-49,1922,0.02987973601821572
SIM,1873,37,30-34,1910,18
STAT,1868,28,na,1896,4569.625485974393
SIM,1845,39,20-24,1884,1
STAT,1819,41,45-49,1860,7.150262274803227
STAT,1865,54,20-24,1919,0.0013167102485125682
STAT,1891,47,25-29,1938,0.08073230040004441
SIM,1766,90,na,1856,39
SIM,1838,44,25-29,1882,2
STAT,1854,26,15-19,1880,0.807038429719411
SIM,1848,29,45-49,1877,4
SIM,1882,27,30-34,1909,67
SIM,1884,43,40-44,1927,7
SIM,1867,43,40-44,1910,9
STAT,1855,50,45-49,1905,0.02219824699876293
SIM,1817,47,45-49,1864,1
STAT,1870,25,45-49,1895,2.2164752523913105
SIM,1916,15,30-34,1931,3
STAT,1820,43,35-39,1863,7.120402784384707
STAT,1875,21,50-100,1896,0.8504996329937391
STAT,1876,38,45-49,1914,4.143460101150936
STAT,1908,53,na,1961,6571.756443479919
STAT,1840,87,na,1927,254.30645192853223
STAT,1875,39,40-44,1914,9.01075608845545
STAT,1877,64,na,1941,3645.612606755493
SIM,1832,36,30-34,1868,17
STAT,1838,43,20-24,1881,0.22583051225460465
STAT,1863,29,20-24,1892,20.59180764378056
SIM,1836,27,na,1863,3809
STAT,1860,17,50-100,1877,0.09267015653936507
SIM,1841,46,25-29,1887,1
STAT,1881,25,20-24,1906,23.05611259078479
STAT,1849,25,na,1874,4115.172674011891
STAT,1858,61,na,1919,2942.014085010029
SIM,1871,41,50-100,1912,4
SIM,1867,38,45-49,1905,7
SIM,1847,35,50-100,1882,3
SIM,1862,11,na,1873,5113
STAT,1808,48,40-44,1856,1.0619445426501353
SIM,1883,26,35-39,1909,29
SIM,1851,36,40-44,1887,10
SIM,1866,25,na,1891,4641
SIM,1868,42,45-49,1910,8
SIM,1888,35,25-29,1923,5
SIM,1846,18,30-34,1864,4
SIM,1861,30,40-44,1891,14
STAT,1873,50,na,1923,4481.915510105416
STAT,1874,18,40-44,1892,0.37723698610780204
STAT,1845,11,na,1856,4670.607590590499
STAT,1832,68,na,1900,1992.3384492010912
SIM,1895,38,na,1933,6505
STAT,1899,35,35-39,1934,19.757629786474595
STAT,1829,28,30-34,1857,61.71009475471152
STAT,1809,47,45-49,1856,1.8293020265888937
STAT,1860,36,40-44,1896,7.2140223854078105
STAT,1857,18,40-44,1875,0.33641837507518774
SIM,1891,24,na,1915,5994
SIM,1879,75,na,1954,1918
STAT,1841,23,25-29,1864,104.46420416179924
STAT,1864,28,25-29,1892,76.098344219964
SIM,1836,28,15-19,1864,1
STAT,1872,47,15-19,1919,8.08110421791872E-4
SIM,1875,61,na,1936,4172
SIM,1883,80,na,1963,1786
STAT,1843,36,40-44,1879,7.233385337151682
SIM,1852,40,40-44,1892,6
STAT,1819,38,15-19,1857,0.3052375836214072
STAT,1834,50,25-29,1884,0.005029777342898228
STAT,1858,93,na,1951,46.01299533896448
STAT,1850,46,25-29,1896,0.08856708420872376
STAT,1908,21,na,1929,7111.560784739497
STAT,1902,44,20-24,1946,0.03102105340738836
SIM,1816,82,na,1898,377
SIM,1831,24,20-24,1855,140
STAT,1886,29,15-19,1915,0.9603545141118328
SIM,1855,33,20-24,1888,4
STAT,1848,32,25-29,1880,19.585808131951655
STAT,1865,41,15-19,1906,0.02545308094458922
SIM,1884,38,45-49,1922,5
STAT,1849,53,25-29,1902,0.0055127916333914855
SIM,1833,35,35-39,1868,18
SIM,1883,31,30-34,1914,37
STAT,1896,19,30-34,1915,4.2271470567025755
STAT,1844,40,40-44,1884,3.816725768498678
STAT,1859,43,40-44,1902,3.5895676738272906
STAT,1874,27,30-34,1901,52.07402345371181
STAT,1939,17,25-29,1956,87.61589993896052
SIM,1893,38,50-100,1931,2
STAT,1812,91,na,1903,54.929103562466224
SIM,1820,41,35-39,1861,7
SIM,1922,34,50-100,1956,3
STAT,1890,23,20-24,1913,169.35511393054165
STAT,1948,16,50-100,1964,0.8661147057749503
SIM,1839,36,40-44,1875,15
STAT,1922,21,50-100,1943,1.5281321616666295
SIM,1876,44,45-49,1920,10
SIM,1944,16,45-49,1960,1
SIM,1785,93,na,1878,3
SIM,1826,44,50-100,1870,2
STAT,1818,44,50-100,1862,4.834046051149153
STAT,1847,33,20-24,1880,4.7878825360468715
STAT,1856,39,30-34,1895,8.221157403866405
STAT,1811,53,35-39,1864,0.054639504456261014
SIM,1896,23,na,1919,6449
STAT,1843,52,na,1895,3000.138698033681
SIM,1866,57,na,1923,3900
STAT,1893,47,35-39,1940,0.20121534683192546
STAT,1898,27,40-44,1925,8.187138946314183
STAT,1827,35,45-49,1862,4.365145468295332
STAT,1849,41,30-34,1890,1.8267716774108145
SIM,1893,28,45-49,1921,5
SIM,1896,29,25-29,1925,139
SIM,1925,16,50-100,1941,1
SIM,1947,17,25-29,1964,112
STAT,1842,24,30-34,1866,32.96990738726292
SIM,1816,43,35-39,1859,6
STAT,1833,46,25-29,1879,0.08999582997517099
STAT,1837,47,20-24,1884,0.017365772548771752
STAT,1888,29,25-29,1917,100.25455046499528
SIM,1893,41,40-44,1934,10
SIM,1834,79,na,1913,790
SIM,1893,47,na,1940,5948
STAT,1824,40,15-19,1864,0.037685286076838145
STAT,1865,24,25-29,1889,104.79052441676762
STAT,1803,55,na,1858,2261.5537011308757
SIM,1873,24,25-29,1897,123
SIM,1826,37,45-49,1863,6
STAT,1840,16,20-24,1856,33.32848724133029
STAT,1855,38,25-29,1893,4.320105870695252
STAT,1807,69,na,1876,1601.0153911725151
STAT,1814,54,15-19,1868,1.1736020267492494E-4
SIM,1800,67,na,1867,1516
STAT,1936,16,45-49,1952,0.9684663450829353
SIM,1929,26,20-24,1955,55
STAT,1910,49,25-29,1959,0.0994044915083754
STAT,1925,15,30-34,1940,29.868982927422017
STAT,1868,44,45-49,1912,2.8370152455593973
STAT,1911,15,50-100,1926,0.15216305635255417
STAT,1857,43,30-34,1900,1.7967305850642885
STAT,1894,26,45-49,1920,2.8904522292085892
STAT,1900,57,na,1957,5718.064997633714
STAT,1892,18,35-39,1910,1.3836643526827106
SIM,1841,26,30-34,1867,52
STAT,1824,49,na,1873,2703.8791470344545
SIM,1931,38,na,1969,10087
STAT,1860,28,40-44,1888,4.9299607725777745
SIM,1833,27,35-39,1860,21
STAT,1843,44,40-44,1887,3.1620611555080465
STAT,1859,51,40-44,1910,0.017004053229228544
STAT,1927,23,40-44,1950,8.339361235669148
STAT,1820,35,na,1855,3192.6760465046646
SIM,1824,42,30-34,1866,4
STAT,1841,36,30-34,1877,9.205907062860733
SIM,1858,81,na,1939,912
SIM,1883,34,35-39,1917,28
STAT,1826,47,45-49,1873,0.47060297122093864
SIM,1843,34,40-44,1877,11
STAT,1890,43,50-100,1933,2.5855056226499236
STAT,1853,30,40-44,1883,7.214261623700296
STAT,1916,40,na,1956,7707.841151006149
STAT,1862,66,na,1928,2829.261344819859
STAT,1854,51,40-44,1905,0.01621597056299655
STAT,1883,33,30-34,1916,34.49865107247005
STAT,1850,30,15-19,1880,0.2562731235104552
STAT,1847,19,35-39,1866,1.031673582288418
STAT,1867,32,35-39,1899,19.15458176740668
SIM,1859,41,40-44,1900,5
SIM,1855,19,35-39,1874,2
SIM,1891,33,30-34,1924,10
STAT,1823,32,20-24,1855,15.481220340224558
SIM,1908,21,30-34,1929,72
STAT,1818,37,45-49,1855,13.794214764170894
SIM,1831,32,20-24,1863,6
STAT,1875,34,35-39,1909,20.877442774799242
STAT,1882,24,25-29,1906,111.91977505609512
STAT,1861,103,na,1964,1.0740674896555906
STAT,1907,36,na,1943,7082.502197849175
STAT,1835,34,40-44,1869,7.0069919673365275
STAT,1903,22,na,1925,6800.84482903976
STAT,1851,38,50-100,1889,1.9037359712704596
STAT,1869,45,na,1914,4446.696409755559
SIM,1935,23,40-44,1958,17
SIM,1850,24,30-34,1874,45
STAT,1861,41,30-34,1902,1.9413465163799837
SIM,1881,26,25-29,1907,69
STAT,1885,28,45-49,1913,2.224181351568983
SIM,1878,38,20-24,1916,3
SIM,1823,33,25-29,1856,19
STAT,1896,39,25-29,1935,7.599905527980768
STAT,1840,44,15-19,1884,0.02026768061503999
STAT,1856,27,na,1883,3853.4938872049843
STAT,1844,52,35-39,1896,0.013828878209983781
STAT,1852,13,na,1865,4580.873434229769
STAT,1833,26,30-34,1859,44.12414597002331
STAT,1853,50,35-39,1903,0.013817009307131171
STAT,1858,34,35-39,1892,15.807730089968647
STAT,1873,35,15-19,1908,0.11632668748340379
SIM,1840,25,25-29,1865,99
STAT,1774,108,na,1882,0.007375258642286048
STAT,1842,15,40-44,1857,0.35383607902440645
SIM,1919,19,15-19,1938,96
STAT,1873,23,20-24,1896,140.97534095901474
SIM,1840,17,25-29,1857,12
SIM,1828,51,na,1879,2923
SIM,1868,34,45-49,1902,8
STAT,1885,41,40-44,1926,4.542170299833033
SIM,1933,15,30-34,1948,44
SIM,1865,43,30-34,1908,2
SIM,1857,96,na,1953,13
STAT,1848,48,35-39,1896,0.22667459739121215
SIM,1853,82,na,1935,572
STAT,1899,11,na,1910,7156.824516427831
SIM,1896,25,50-100,1921,6
SIM,1902,57,na,1959,6046
SIM,1835,35,45-49,1870,6
SIM,1910,44,na,1954,7252
SIM,1829,29,35-39,1858,22
STAT,1835,45,45-49,1880,0.3634000452218614
SIM,1907,24,na,1931,6977
STAT,1818,50,40-44,1868,0.04632010652564107
STAT,1832,25,25-29,1857,76.1360514643877
STAT,1891,31,15-19,1922,0.3569567813619803
STAT,1937,20,50-100,1957,1.2952416199827932
SIM,1867,20,50-100,1887,1
SIM,1903,10,na,1913,7671
SIM,1915,2,na,1917,8660
STAT,1790,109,na,1899,2.782958621859538E-4
SIM,1824,34,30-34,1858,45
SIM,1900,32,50-100,1932,3
STAT,1881,45,15-19,1926,7.886164116712393E-4
STAT,1897,48,30-34,1945,0.14555705154405682
SIM,1852,27,45-49,1879,3
STAT,1829,48,25-29,1877,0.08970278150163334
SIM,1847,34,25-29,1881,19
STAT,1882,19,50-100,1901,0.09586955850210924
SIM,1881,31,50-100,1912,2
STAT,1856,31,20-24,1887,4.3080753086206585
STAT,1895,27,15-19,1922,1.193977464141927
STAT,1857,52,20-24,1909,0.0011554464794093378
SIM,1838,16,30-34,1854,3
STAT,1844,27,45-49,1871,2.1949886508388667
STAT,1852,37,45-49,1889,3.1944793746137887
STAT,1880,41,40-44,1921,4.807151826902321
SIM,1897,30,20-24,1927,7
STAT,1836,18,20-24,1854,58.27322405940232
STAT,1889,30,20-24,1919,6.785352397582529
SIM,1938,19,25-29,1957,131
STAT,1857,44,na,1901,3589.235696613476
SIM,1944,24,na,1968,8050
STAT,1771,92,na,1863,16.191185847173422
SIM,1844,18,20-24,1862,33
STAT,1847,54,50-100,1901,0.02238866987511683
STAT,1820,51,35-39,1871,0.03143024474822725
STAT,1834,33,35-39,1867,17.089167428474003
STAT,1947,16,20-24,1963,308.50384155034493
SIM,1829,38,25-29,1867,7
STAT,1879,44,20-24,1923,0.3309604249046706
SIM,1940,10,na,1950,8333
SIM,1864,31,20-24,1895,7
SIM,1955,16,20-24,1971,340
SIM,1842,33,35-39,1875,21
STAT,1897,40,20-24,1937,0.030072883397925035
STAT,1839,34,25-29,1873,19.276829579034747
STAT,1883,25,30-34,1908,50.30677094122794
STAT,1886,25,na,1911,5122.4486749979515
STAT,1840,27,25-29,1867,76.13237971986678
STAT,1887,74,na,1961,2896.5619774096617
SIM,1853,31,45-49,1884,5
SIM,1871,79,na,1950,1185
STAT,1883,60,na,1943,3784.3658445386554
SIM,1848,38,35-39,1886,18
SIM,1854,24,15-19,1878,5
SIM,1898,42,30-34,1940,1
STAT,1910,38,20-24,1948,0.5068372046822112
SIM,1882,22,25-29,1904,145
STAT,1889,38,30-34,1927,13.206061116394316
STAT,1828,36,15-19,1864,0.11542672454756474
SIM,1819,47,na,1866,2831
STAT,1880,48,50-100,1928,0.5159662996645985
STAT,1763,110,na,1873,0.0018047675019518135
STAT,1854,79,na,1933,1071.7194571974885
SIM,1822,35,na,1857,3261
STAT,1827,43,45-49,1870,2.7918854886210416
STAT,1850,65,na,1915,2591.1684286141945
STAT,1891,47,na,1938,5591.3173735156315
SIM,1856,15,na,1871,4695
SIM,1859,29,20-24,1888,20
SIM,1863,27,20-24,1890,23
SIM,1896,37,25-29,1933,10
SIM,1826,49,na,1875,2857
STAT,1842,32,30-34,1874,31.401732586298117
SIM,1876,36,45-49,1912,7
STAT,1870,30,40-44,1900,8.668079312485554
SIM,1891,25,30-34,1916,74
STAT,1861,52,35-39,1913,0.014394859407301014
SIM,1812,68,na,1880,1626
SIM,1912,39,50-100,1951,3
STAT,1833,54,25-29,1887,0.004620355091607352
STAT,1824,44,30-34,1868,2.8462920436209895
STAT,1906,15,20-24,1921,52.416487149552886
STAT,1851,42,25-29,1893,0.9942350992512952
SIM,1871,29,20-24,1900,27
STAT,1884,45,40-44,1929,0.34482290633694396
STAT,1812,107,na,1919,0.004470282523776074
SIM,1825,33,50-100,1858,5
SIM,1811,83,na,1894,299
STAT,1832,36,na,1868,3539.9223747015894
STAT,1891,9,na,1900,6477.195601552082
STAT,1868,36,45-49,1904,3.848973899917572
SIM,1868,31,50-100,1899,2
STAT,1888,37,25-29,1925,6.8728311778679085
SIM,1881,46,na,1927,3890
STAT,1829,37,20-24,1866,1.347340662120483
SIM,1909,33,40-44,1942,11
STAT,1876,52,30-34,1928,0.012367848160216363
STAT,1933,17,50-100,1950,1.0130078515612837
STAT,1845,31,45-49,1876,3.22834362121475
STAT,1866,45,25-29,1911,0.10840652917120226
SIM,1836,36,15-19,1872,2
SIM,1849,42,35-39,1891,8
SIM,1861,42,35-39,1903,8
SIM,1833,44,25-29,1877,3
STAT,1917,16,35-39,1933,1.8279925816860854
SIM,1921,23,50-100,1944,6
STAT,1817,54,40-44,1871,0.04682247258156575
STAT,1929,15,na,1944,9530.117850249633
STAT,1831,51,na,1882,2940.0156480825285
STAT,1852,21,35-39,1873,11.128638086208808
SIM,1866,47,40-44,1913,1
STAT,1831,41,45-49,1872,2.400623653685139
STAT,1894,12,na,1906,6700.053444457578
SIM,1957,8,na,1965,10323
STAT,1860,39,45-49,1899,3.236577430633521
STAT,1898,26,na,1924,6544.961154968462
SIM,1878,58,na,1936,4272
STAT,1878,48,20-24,1926,0.02499356788539383
STAT,1937,20,45-49,1957,2.214863085777951
SIM,1903,49,35-39,1952,1
SIM,1809,45,45-49,1854,2
SIM,1841,37,35-39,1878,20
SIM,1857,44,35-39,1901,7
SIM,1861,33,45-49,1894,6
SIM,1874,44,na,1918,4392
SIM,1925,16,35-39,1941,14
STAT,1841,53,20-24,1894,0.0010534785389671756
STAT,1849,16,40-44,1865,0.35823468723519425
STAT,1886,17,50-100,1903,0.10444787169447321
SIM,1857,16,40-44,1873,1
SIM,1870,30,na,1900,4646
STAT,1852,29,45-49,1881,1.84880039646065
STAT,1858,47,40-44,1905,0.2682838055335301
STAT,1833,37,35-39,1870,11.647069215241116
STAT,1897,32,20-24,1929,7.297290710808025
STAT,1816,42,30-34,1858,6.332474842444145
SIM,1880,20,50-100,1900,4
STAT,1860,20,30-34,1880,33.57387193019423
STAT,1857,26,40-44,1883,4.892275720733445
SIM,1849,13,na,1862,4874
SIM,1883,23,30-34,1906,51
SIM,1860,29,45-49,1889,6
STAT,1828,63,na,1891,2191.2249261988177
STAT,1892,35,25-29,1927,7.348596352008017
STAT,1811,45,35-39,1856,0.9837665629385159
SIM,1842,22,30-34,1864,1
SIM,1865,35,30-34,1900,17
SIM,1815,39,35-39,1854,21
SIM,1846,80,na,1926,800
SIM,1884,35,40-44,1919,16
STAT,1870,17,45-49,1887,0.13075708201347183
STAT,1921,47,35-39,1968,0.2934692779654924
STAT,1837,67,na,1904,2209.406104330552
SIM,1806,72,na,1878,1101
SIM,1932,23,na,1955,9666
STAT,1825,44,25-29,1869,1.4191886274608365
STAT,1838,51,20-24,1889,0.001013257673717202
SIM,1851,44,40-44,1895,6
STAT,1851,17,35-39,1868,1.0341731411628834
STAT,1854,34,15-19,1888,0.21896682255311198
SIM,1865,26,40-44,1891,8
STAT,1829,80,na,1909,732.1143385602905
SIM,1837,37,20-24,1874,5
SIM,1817,44,40-44,1861,6
SIM,1922,49,45-49,1971,1
STAT,1902,47,25-29,1949,0.09221173939601622
SIM,1813,51,45-49,1864,1
SIM,1860,21,35-39,1881,15
SIM,1855,36,25-29,1891,7
STAT,1826,39,45-49,1865,4.41688931155636
SIM,1834,39,45-49,1873,7
STAT,1876,35,40-44,1911,9.230830928417575
STAT,1896,28,20-24,1924,31.17096444112397
SIM,1805,98,na,1903,1
STAT,1850,51,20-24,1901,0.001136842943977297
STAT,1826,31,35-39,1857,32.65907273519947
SIM,1888,27,25-29,1915,108
SIM,1856,37,30-34,1893,14
STAT,1922,25,na,1947,8616.908265575721
STAT,1903,48,30-34,1951,0.15504218524478774
SIM,1892,27,50-100,1919,4
STAT,1790,95,na,1885,4.829921304434345
STAT,1834,22,30-34,1856,31.710796457579058
STAT,1926,39,na,1965,9264.672513207268
STAT,1848,83,na,1931,650.9424512558176
SIM,1920,22,na,1942,8292
STAT,1914,49,45-49,1963,0.4328464653013992
SIM,1924,36,na,1960,9293
STAT,1869,37,15-19,1906,0.10989108201262891
STAT,1871,21,45-49,1892,1.4034104735879294
SIM,1822,37,25-29,1859,5
SIM,1893,7,na,1900,6924
STAT,1808,49,50-100,1857,1.4874842282775638
SIM,1872,33,20-24,1905,8
SIM,1860,35,50-100,1895,3
SIM,1816,49,50-100,1865,1
STAT,1912,26,50-100,1938,1.9883292178299685
STAT,1832,42,15-19,1874,0.0220255058203929
STAT,1848,37,30-34,1885,9.005657062287057
STAT,1841,28,30-34,1869,45.055092525600536
STAT,1880,52,45-49,1932,0.030711850516949964
SIM,1835,43,45-49,1878,8
SIM,1827,33,45-49,1860,5
STAT,1820,40,30-34,1860,4.915686558389965
SIM,1857,41,30-34,1898,3
STAT,1846,24,15-19,1870,6.145671649458579
SIM,1880,42,45-49,1922,7
STAT,1796,105,na,1901,0.013062839449452898
STAT,1930,35,50-100,1965,1.1079376880373484
STAT,1841,20,20-24,1861,128.50254098156543
STAT,1849,49,40-44,1898,0.26514968233422753
STAT,1894,34,45-49,1928,4.485432630105952
STAT,1889,49,35-39,1938,0.19255175495704183
SIM,1850,32,30-34,1882,41
STAT,1860,40,25-29,1900,1.0638178022833367
SIM,1875,34,50-100,1909,2
STAT,1805,51,45-49,1856,0.11627405750080343
STAT,1819,102,na,1921,0.30677147284932255
STAT,1872,42,45-49,1914,3.0340511791274305
STAT,1867,34,50-100,1901,1.7181720432237937
STAT,1876,58,na,1934,4130.9237457761055
SIM,1906,16,25-29,1922,20
STAT,1886,24,45-49,1910,1.477342859888189
SIM,1861,26,na,1887,4546
SIM,1889,39,35-39,1928,28
STAT,1881,28,25-29,1909,82.28514475922924
SIM,1919,22,45-49,1941,4
SIM,1842,26,50-100,1868,2
SIM,1894,24,45-49,1918,3
STAT,1833,29,50-100,1862,1.095331352042513
STAT,1855,41,50-100,1896,1.6002683402841278
STAT,1834,49,45-49,1883,0.3247337768388791
SIM,1900,29,15-19,1929,4
STAT,1908,37,50-100,1945,0.7944332584918168
SIM,1891,36,35-39,1927,23
SIM,1876,28,45-49,1904,4
STAT,1835,51,30-34,1886,0.008017582341036457
SIM,1879,29,25-29,1908,96
STAT,1872,44,na,1916,4627.8943485039235
SIM,1867,31,na,1898,4871
STAT,1839,39,30-34,1878,9.740205564217515
STAT,1856,43,15-19,1899,0.021363527850705423
STAT,1820,34,45-49,1854,11.216866729763247
SIM,1886,13,na,1899,5452
STAT,1836,48,50-100,1884,0.3374640331408839
STAT,1917,41,25-29,1958,0.15070997236210817
SIM,1902,37,25-29,1939,2
SIM,1870,20,40-44,1890,8
STAT,1830,47,50-100,1877,0.4239491880644411
SIM,1894,37,15-19,1931,1
STAT,1827,32,40-44,1859,10.704485641941165
SIM,1873,21,20-24,1894,142
STAT,1768,93,na,1861,11.416515270611212
STAT,1810,53,50-100,1863,0.09148807325725954
STAT,1823,35,25-29,1858,11.964723989164385
STAT,1865,45,30-34,1910,0.179380420771897
SIM,1870,32,35-39,1902,25
SIM,1822,67,na,1889,1690
SIM,1875,41,25-29,1916,2
STAT,1821,52,na,1873,2665.800922958527
STAT,1859,38,45-49,1897,3.18861395853052
STAT,1867,41,25-29,1908,1.220087349202055
SIM,1891,17,30-34,1908,5
SIM,1908,24,35-39,1932,25
STAT,1868,39,na,1907,4481.509337068998
STAT,1825,66,na,1891,1896.3932738923834
STAT,1938,26,20-24,1964,36.54574978031872
SIM,1763,93,na,1856,18
SIM,1880,19,20-24,1899,49
STAT,1842,40,30-34,1882,1.816842372734741
STAT,1851,46,40-44,1897,0.2661447597977404
STAT,1863,37,20-24,1900,1.362784264101939
STAT,1894,23,40-44,1917,5.389521768756241
STAT,1857,76,na,1933,1491.3999277897187
SIM,1847,39,30-34,1886,17
STAT,1853,62,na,1915,2891.8388707165013
SIM,1871,37,20-24,1908,1
STAT,1881,17,20-24,1898,34.60753420451804
SIM,1831,35,25-29,1866,11
STAT,1864,52,50-100,1916,0.027119990710064518
SIM,1879,17,30-34,1896,4
STAT,1844,35,50-100,1879,2.350696705050316
STAT,1818,54,35-39,1872,0.03497031317514352
STAT,1887,28,50-100,1915,1.4398463184669803
SIM,1863,42,45-49,1905,8
SIM,1866,43,25-29,1909,2
STAT,1797,104,na,1901,0.032274553300059294
STAT,1865,21,20-24,1886,128.90395103655655
STAT,1953,16,45-49,1969,1.2206721252816675
STAT,1872,33,na,1905,4823.15224993983
STAT,1872,19,20-24,1891,35.79134184270662
STAT,1914,38,na,1952,7550.021769794457
STAT,1898,34,50-100,1932,2.482739695184114
STAT,1910,24,na,1934,7195.1041951676125
STAT,1866,28,35-39,1894,17.9172908340162
STAT,1874,31,15-19,1905,0.29569039795957036
STAT,1872,35,20-24,1907,1.579482629505716
SIM,1845,18,15-19,1863,10
SIM,1883,40,20-24,1923,1
SIM,1948,22,15-19,1970,12
SIM,1835,96,na,1931,17
STAT,1854,21,45-49,1875,1.2651033648907501
SIM,1919,30,45-49,1949,6
SIM,1824,45,35-39,1869,1
STAT,1844,26,na,1870,4307.556881826459
STAT,1857,22,25-29,1879,104.03358636772096
STAT,1879,52,20-24,1931,0.0015505393206368394
STAT,1899,32,30-34,1931,48.31345907126336
SIM,1847,26,25-29,1873,102
STAT,1834,41,35-39,1875,2.943360627201292
SIM,1871,47,na,1918,4340
STAT,1882,75,na,1957,2163.0490118335592
STAT,1883,17,30-34,1900,3.1626727003309263
STAT,1819,59,na,1878,2274.065823357858
SIM,1850,40,30-34,1890,5
STAT,1819,46,15-19,1865,0.0017040499933723735
STAT,1846,48,25-29,1894,0.08711787676335515
STAT,1769,116,na,1885,1.568141692508764E-4
STAT,1846,16,15-19,1862,11.486538584268787
STAT,1826,53,30-34,1879,0.011223292068885131
SIM,1862,21,45-49,1883,1
STAT,1815,105,na,1920,0.02725355514585336
STAT,1894,42,45-49,1936,0.2693030846474257
STAT,1842,41,20-24,1883,0.24778031225521438
STAT,1886,37,15-19,1923,0.11971830062600954
SIM,1884,46,45-49,1930,1
SIM,1860,84,na,1944,547
STAT,1893,44,30-34,1937,0.20161009146096084
SIM,1854,16,15-19,1870,11
STAT,1833,43,20-24,1876,0.25019302040194175
SIM,1864,98,na,1962,14
STAT,1824,41,50-100,1865,2.8136331279529148
STAT,1827,51,45-49,1878,0.025804300792922143
SIM,1843,29,na,1872,3856
STAT,1880,49,15-19,1929,8.33259663905905E-4
STAT,1889,37,40-44,1926,10.901001318012502
STAT,1837,18,15-19,1855,12.841088229463471
STAT,1856,47,30-34,1903,0.15013405133012314
SIM,1847,31,20-24,1878,6
STAT,1842,48,40-44,1890,0.2516823862064315
STAT,1890,39,30-34,1929,13.006009752628135
STAT,1833,30,15-19,1863,0.24665289740250954
STAT,1876,46,45-49,1922,0.49437053282365256
STAT,1879,47,25-29,1926,0.12111140841814655
SIM,1870,25,50-100,1895,1
SIM,1882,19,30-34,1901,5
STAT,1847,7,na,1854,4709.0
STAT,1873,45,50-100,1918,0.509009496716487
SIM,1819,41,50-100,1860,3
STAT,1815,45,na,1860,2894.9860578228695
SIM,1851,47,45-49,1898,1
SIM,1854,99,na,1953,2
SIM,1863,38,25-29,1901,8
SIM,1831,48,30-34,1879,1
STAT,1921,39,35-39,1960,5.441507341164164
SIM,1945,20,45-49,1965,3
STAT,1876,27,40-44,1903,6.257312808038344
STAT,1901,30,50-100,1931,2.611387593778147
STAT,1839,31,20-24,1870,5.248189147151997
SIM,1899,63,na,1962,5334
STAT,1843,47,45-49,1890,0.32905174021074723
SIM,1828,26,15-19,1854,1
SIM,1842,66,na,1908,2272
SIM,1882,38,35-39,1920,21
STAT,1843,20,30-34,1863,31.774207291924448
STAT,1885,45,35-39,1930,0.28424731632736383
STAT,1924,43,50-100,1967,0.2816955243059606
SIM,1851,48,na,1899,3516
STAT,1863,83,na,1946,701.8335744076004
STAT,1892,47,40-44,1939,0.2430219207127108
STAT,1836,21,50-100,1857,0.7208977344800014
STAT,1853,41,45-49,1894,2.378700846785069
STAT,1874,38,35-39,1912,14.553653118186695
SIM,1883,18,35-39,1901,1
STAT,1900,25,na,1925,6731.503005065083
STAT,1843,28,40-44,1871,5.1271422879631565
SIM,1937,15,15-19,1952,80
STAT,1928,36,50-100,1964,1.072443400313518
SIM,1880,35,20-24,1915,3
STAT,1850,33,na,1883,3787.994383250937
SIM,1835,27,45-49,1862,3
STAT,1905,23,50-100,1928,1.1873859456769178
STAT,1938,31,50-100,1969,1.6802476390356715
SIM,1825,86,na,1911,187
SIM,1850,48,40-44,1898,2
SIM,1851,28,40-44,1879,13
STAT,1823,48,30-34,1871,0.2948727422945247
STAT,1824,81,na,1905,578.1507846488518
STAT,1867,97,na,1964,33.761485601739274
SIM,1832,44,30-34,1876,7
STAT,1807,53,20-24,1860,0.004710142762306013
STAT,1870,50,35-39,1920,0.017315584220545972
SIM,1935,26,45-49,1961,8
STAT,1862,20,40-44,1882,3.735736548292562
STAT,1837,54,45-49,1891,0.01967540690567275
SIM,1889,42,na,1931,5799
STAT,1807,47,35-39,1854,0.9639067326163888
STAT,1897,44,15-19,1941,0.002553965008933904
STAT,1942,0,na,1942,9439.777895534482
STAT,1920,27,25-29,1947,145.7892551187126
STAT,1855,27,20-24,1882,18.43914442120578
STAT,1876,51,40-44,1927,0.0220960006540349
SIM,1814,48,na,1862,2676
SIM,1894,41,35-39,1935,2
STAT,1949,20,15-19,1969,12.552666550369082
SIM,1914,15,20-24,1929,58
STAT,1823,40,20-24,1863,0.5560091231995217
STAT,1838,84,na,1922,450.2154216184467
STAT,1834,70,na,1904,1864.5984434546754
SIM,1895,17,15-19,1912,19
STAT,1859,5,na,1864,4692.045256658951
STAT,1861,19,45-49,1880,0.124728838542931
STAT,1891,35,30-34,1926,13.431018545368696
STAT,1942,15,30-34,1957,25.739579629821787
STAT,1828,29,50-100,1857,1.6282171004165216
STAT,1878,40,50-100,1918,2.250859790561354
STAT,1874,44,20-24,1918,0.32397887782021645
STAT,1927,26,45-49,1953,4.255670709563586
STAT,1894,18,45-49,1912,0.16902848074381835
SIM,1835,32,40-44,1867,11
SIM,1858,32,35-39,1890,23
STAT,1808,51,35-39,1859,0.05214966665410082
STAT,1895,22,45-49,1917,1.8350927534847836
STAT,1852,43,30-34,1895,1.8191164849668309
STAT,1861,81,na,1942,909.0296726246925
STAT,1912,58,na,1970,6766.123513292607
SIM,1850,85,na,1935,398
SIM,1946,15,na,1961,8104
STAT,1822,36,20-24,1858,3.221524773498493
STAT,1861,1,na,1862,6133.550900678854
SIM,1830,36,20-24,1866,1
STAT,1857,46,35-39,1903,0.22101329222631902
SIM,1851,20,30-34,1871,43
SIM,1916,23,30-34,1939,77
STAT,1865,95,na,1960,47.42317207216207
SIM,1865,46,35-39,1911,1
STAT,1890,26,25-29,1916,104.63745877103669
SIM,1897,61,na,1958,5247
STAT,1853,42,35-39,1895,2.861544827484551
STAT,1945,4,na,1949,8802.937804694311
STAT,1887,17,15-19,1904,13.40491981139252
SIM,1950,15,30-34,1965,38
STAT,1908,23,30-34,1931,53.23425739640906
STAT,1888,1,na,1889,6744.863135684461
STAT,1962,2,na,1964,10181.0995735755
STAT,1828,31,45-49,1859,4.03053070596533
SIM,1892,33,25-29,1925,35
STAT,1800,90,na,1890,67.33941510839935
STAT,1841,105,na,1946,0.04254223755141855
STAT,1887,46,20-24,1933,0.02718247069956361
SIM,1924,25,30-34,1949,129
STAT,1877,31,40-44,1908,9.131947610443445
STAT,1943,19,na,1962,7877.4008941998045
STAT,1842,35,35-39,1877,12.612016543399276
SIM,1945,17,15-19,1962,92
SIM,1825,42,25-29,1867,2
STAT,1873,50,50-100,1923,0.03143705318119054
STAT,1833,25,40-44,1858,5.290960165425205
SIM,1823,46,30-34,1869,1
SIM,1907,25,30-34,1932,89
STAT,1898,23,25-29,1921,155.97382584358033
STAT,1865,16,25-29,1881,10.777788735320419
SIM,1927,24,45-49,1951,1
STAT,1929,15,15-19,1944,117.50519408346979
STAT,1860,54,50-100,1914,0.024088608135366337
STAT,1878,22,45-49,1900,1.4708608681415205
STAT,1911,29,25-29,1940,128.74812282905853
SIM,1873,16,25-29,1889,16
STAT,1845,36,15-19,1881,0.09186584980858842
STAT,1884,29,40-44,1913,5.931267587935565
SIM,1813,85,na,1898,229
SIM,1836,31,45-49,1867,4
SIM,1840,46,30-34,1886,1
SIM,1872,36,25-29,1908,8
SIM,1843,45,45-49,1888,1
STAT,1842,19,35-39,1861,1.0367191323406275
STAT,1883,42,20-24,1925,0.3147404957844036
STAT,1946,15,15-19,1961,101.70668541123963
STAT,1869,19,50-100,1888,0.09606009879915518
STAT,1909,48,50-100,1957,0.41880644615549556
SIM,1880,29,na,1909,5206
SIM,1828,39,20-24,1867,2
STAT,1827,27,45-49,1854,6.611587011551049
STAT,1886,57,na,1943,4284.417873505627
STAT,1838,19,50-100,1857,0.08655396215083652
STAT,1882,43,na,1925,4514.27800466915
STAT,1928,41,na,1969,9574.396475803647
STAT,1863,41,40-44,1904,3.9944889674350574
SIM,1881,27,15-19,1908,4
SIM,1845,95,na,1940,13
STAT,1867,48,45-49,1915,0.44076747287203494
STAT,1832,46,30-34,1878,0.15112857273110203
STAT,1866,33,30-34,1899,32.398528110725394
SIM,1875,29,40-44,1904,8
STAT,1780,110,na,1890,0.00375150608011508
STAT,1816,51,20-24,1867,0.003548221139436029
SIM,1818,40,40-44,1858,5
SIM,1834,20,30-34,1854,44
STAT,1928,41,50-100,1969,0.3028596386687039
SIM,1850,35,35-39,1885,20
SIM,1925,42,na,1967,9071
STAT,1840,42,50-100,1882,1.5907193886979238
STAT,1918,32,50-100,1950,1.7740959719473144
SIM,1892,29,40-44,1921,16
STAT,1937,17,15-19,1954,89.18500192180555
SIM,1881,18,25-29,1899,8
STAT,1887,20,45-49,1907,1.5845028322615786
STAT,1828,95,na,1923,16.327661089065685
STAT,1868,53,35-39,1921,0.016276926296962493
SIM,1850,19,35-39,1869,1
STAT,1906,20,50-100,1926,1.207264927469387
SIM,1885,31,40-44,1916,11
SIM,1869,27,15-19,1896,4
SIM,1871,41,40-44,1912,8
STAT,1864,49,30-34,1913,0.1711052296404787
STAT,1868,33,40-44,1901,8.297949456713308
SIM,1847,11,na,1858,4626
SIM,1856,47,na,1903,3767
STAT,1878,38,na,1916,4944.815703975883
SIM,1830,43,45-49,1873,4
SIM,1954,15,15-19,1969,113
SIM,1876,33,40-44,1909,15
STAT,1857,51,30-34,1908,0.009415319368465876
STAT,1916,25,30-34,1941,82.37628081436428
STAT,1897,19,25-29,1916,15.216096917494841
STAT,1799,65,na,1864,1660.414094272564
STAT,1846,28,na,1874,3979.736081890656
STAT,1842,14,na,1856,4522.6529513424
STAT,1817,38,40-44,1855,30.0683907267194
STAT,1849,25,50-100,1874,1.2168818848818357
STAT,1884,21,30-34,1905,35.629755837309496
STAT,1806,52,na,1858,2317.270162183256
SIM,1864,77,na,1941,1512
SIM,1860,63,na,1923,3105
STAT,1783,93,na,1876,11.877321078289192
STAT,1884,51,50-100,1935,0.030263075178949935
SIM,1838,28,25-29,1866,83
SIM,1860,30,25-29,1890,23
STAT,1873,18,25-29,1891,11.597978275310703
SIM,1890,24,25-29,1914,163
STAT,1919,24,45-49,1943,2.4722394023668293
SIM,1872,49,30-34,1921,3
STAT,1850,34,30-34,1884,27.428994628745595
SIM,1861,38,15-19,1899,2
SIM,1825,38,40-44,1863,9
SIM,1839,32,25-29,1871,25
SIM,1938,27,25-29,1965,131
STAT,1853,38,15-19,1891,0.08840714419480597
STAT,1866,42,20-24,1908,0.29558050773735783
STAT,1862,36,15-19,1898,0.0974006231549732
STAT,1864,101,na,1965,4.676717286592236
STAT,1831,34,20-24,1865,4.462753433464074
SIM,1919,27,15-19,1946,2
STAT,1864,41,20-24,1905,0.28800395363248255
SIM,1876,9,na,1885,5713
STAT,1893,38,45-49,1931,5.077771570257683
STAT,1892,32,20-24,1924,6.834132336337798
SIM,1895,20,45-49,1915,3
SIM,1929,35,na,1964,9987
STAT,1822,43,45-49,1865,4.902754885714646
STAT,1835,50,40-44,1885,0.014463485292053182
SIM,1844,30,40-44,1874,10
STAT,1870,34,35-39,1904,19.90830360435557
SIM,1918,26,45-49,1944,6
SIM,1891,49,40-44,1940,1
STAT,1867,54,30-34,1921,0.010949189004324282
STAT,1846,52,45-49,1898,0.022110461783098282
STAT,1847,66,na,1913,2498.4117326722785
SIM,1825,30,30-34,1855,36
SIM,1925,21,na,1946,8874
STAT,1909,48,25-29,1957,0.09822170654876433
SIM,1854,29,20-24,1883,22
STAT,1921,44,30-34,1965,0.28977791200205694
SIM,1827,30,40-44,1857,10
STAT,1865,29,30-34,1894,45.8738037656654
STAT,1871,26,15-19,1897,0.913485078867983
STAT,1894,39,15-19,1933,0.14422093911716616
SIM,1834,40,25-29,1874,2
SIM,1864,66,na,1930,3091
SIM,1943,25,50-100,1968,6
SIM,1860,52,na,1912,3738
STAT,1834,50,50-100,1884,0.021446411877264804
STAT,1826,29,na,1855,3337.9237369542648
STAT,1819,81,na,1900,565.8433696689165
STAT,1858,43,25-29,1901,1.0037203903129992
SIM,1865,22,25-29,1887,115
STAT,1873,27,15-19,1900,0.9310230743328143
SIM,1894,21,40-44,1915,7
STAT,1849,52,35-39,1901,0.013545300256134762
STAT,1816,45,35-39,1861,0.7092909734812486
STAT,1886,21,40-44,1907,4.455973244805994
STAT,1894,43,35-39,1937,0.3238799795565146
SIM,1910,39,25-29,1949,4
STAT,1913,37,50-100,1950,0.8370145952029131
STAT,1912,15,45-49,1927,0.20501052504358436
SIM,1877,32,45-49,1909,4
SIM,1910,30,25-29,1940,25
SIM,1899,30,30-34,1929,66
STAT,1902,39,25-29,1941,1.7541333456210793
STAT,1856,18,25-29,1874,10.379520604549851
STAT,1869,32,45-49,1901,3.4125545904532677
SIM,1855,28,25-29,1883,97
STAT,1827,52,35-39,1879,0.015006937710676536
STAT,1848,28,50-100,1876,1.2432074307322694
STAT,1864,36,25-29,1900,5.22285949033808
STAT,1868,52,45-49,1920,0.027737535152350626
STAT,1897,6,na,1903,7052.429287645376
STAT,1836,30,40-44,1866,7.442977221148865
STAT,1883,36,35-39,1919,14.102159088787992
STAT,1883,49,40-44,1932,0.33261476575645016
STAT,1827,48,15-19,1875,7.128134646307714E-4
STAT,1813,106,na,1919,0.010789115839843221
STAT,1877,43,35-39,1920,3.7701302271778347
STAT,1893,27,na,1920,6109.208456977568
STAT,1843,63,na,1906,2499.485005674753
SIM,1866,39,40-44,1905,16
STAT,1815,46,30-34,1861,0.5284472956416709
STAT,1814,71,na,1885,1309.6965383929717
STAT,1879,12,na,1891,5455.49142079011
STAT,1917,35,50-100,1952,0.889024540112105
SIM,1864,18,25-29,1882,9
SIM,1885,43,35-39,1928,4
SIM,1879,43,na,1922,4688
STAT,1847,28,25-29,1875,76.94738531920359
SIM,1890,37,30-34,1927,16
STAT,1825,41,20-24,1866,0.37481261777597413
STAT,1902,30,25-29,1932,29.43996621022905
SIM,1843,26,40-44,1869,5
STAT,1764,90,na,1854,42.0
STAT,1843,84,na,1927,466.0004941483912
STAT,1847,98,na,1945,4.951887234693702
STAT,1834,48,na,1882,3130.4466080576126
STAT,1893,31,25-29,1924,26.326968756535475
STAT,1848,54,20-24,1902,0.0011766983366494589
STAT,1835,26,40-44,1861,5.095286916796515
SIM,1886,19,15-19,1905,10
STAT,1861,35,45-49,1896,3.382893384328713
STAT,1883,41,30-34,1924,2.2915782067828663
SIM,1909,36,45-49,1945,2
STAT,1830,34,na,1864,3792.4900035903606
SIM,1891,41,30-34,1932,4
STAT,1847,77,na,1924,1317.6291110409093
STAT,1846,29,20-24,1875,21.4272142120665
STAT,1816,50,30-34,1866,0.029199500756473592
STAT,1826,40,25-29,1866,1.4133885130925554
SIM,1856,48,35-39,1904,2
STAT,1811,74,na,1885,1043.8579454831909
STAT,1924,16,na,1940,8871.659558398489
SIM,1833,41,20-24,1874,2
STAT,1882,37,30-34,1919,10.48539361609437
STAT,1884,48,45-49,1932,0.4647341248918147
SIM,1811,43,35-39,1854,6
SIM,1911,18,na,1929,7912
SIM,1836,59,na,1895,2448
STAT,1876,22,35-39,1898,12.189499335841338
SIM,1874,36,35-39,1910,20
STAT,1928,30,45-49,1958,3.977672543813754
STAT,1799,103,na,1902,0.09759907892123483
STAT,1818,51,30-34,1869,0.025672463993542824
STAT,1847,52,25-29,1899,0.0053704955085852974
STAT,1868,49,15-19,1917,7.525619208738338E-4
SIM,1870,62,na,1932,3555
SIM,1905,25,20-24,1930,33
STAT,1861,16,40-44,1877,0.3554853337343067
SIM,1882,26,40-44,1908,8
STAT,1844,51,45-49,1895,0.023548434775313893
STAT,1865,48,35-39,1913,0.2536459482999869
STAT,1930,29,35-39,1959,38.51676984022811
SIM,1874,76,na,1950,1650
STAT,1844,32,40-44,1876,8.374925513400274
STAT,1882,33,15-19,1915,0.27899005676802763
STAT,1835,33,na,1868,3536.4455042164
SIM,1942,28,50-100,1970,4
SIM,1884,22,35-39,1906,21
STAT,1794,66,na,1860,1587.8851823531634
STAT,1900,46,50-100,1946,0.3892358318316232
SIM,1865,27,30-34,1892,61
STAT,1932,35,na,1967,10227.430797440484
SIM,1848,43,30-34,1891,5
STAT,1788,92,na,1880,23.54205806034
SIM,1907,21,15-19,1928,10
STAT,1891,79,na,1970,2657.0709642731786
STAT,1839,111,na,1950,1.6759197100948574E-4
STAT,1852,49,50-100,1901,0.38326682829796577
STAT,1880,37,20-24,1917,1.6400372909423708
STAT,1864,17,20-24,1881,33.10896550313318
STAT,1854,47,na,1901,3432.89797910209
STAT,1855,0,na,1855,6035.196400884564
STAT,1934,28,50-100,1962,2.7033456106328906
STAT,1850,43,20-24,1893,0.24174420719346068
STAT,1874,26,40-44,1900,6.2158290938052305
STAT,1925,40,50-100,1965,0.28799267457774
SIM,1885,39,na,1924,4918
STAT,1828,28,15-19,1856,1.2949768514895603
STAT,1869,13,na,1882,5181.172816535106
STAT,1908,49,20-24,1957,0.020079719504631617
SIM,1829,26,50-100,1855,1
SIM,1873,48,35-39,1921,1
STAT,1874,22,25-29,1896,118.37904816847802
STAT,1895,19,15-19,1914,15.53379142251672
SIM,1838,48,40-44,1886,1
STAT,1848,41,15-19,1889,0.022907815551055075
SIM,1872,17,20-24,1889,40
SIM,1948,17,40-44,1965,1
STAT,1866,36,35-39,1902,13.243682968944169
SIM,1899,38,40-44,1937,6
SIM,1852,32,40-44,1884,11
SIM,1852,41,30-34,1893,3
SIM,1923,16,25-29,1939,132
SIM,1883,43,25-29,1926,3
STAT,1813,46,20-24,1859,0.075343216122111
STAT,1896,43,45-49,1939,0.2751194035909957
STAT,1923,39,45-49,1962,1.5913869230528657
SIM,1802,90,na,1892,56
STAT,1915,16,25-29,1931,18.36407356435667
STAT,1835,54,35-39,1889,0.010926793252096619
STAT,1839,100,na,1939,1.6576826574722119
STAT,1873,61,na,1934,3834.545064724493
SIM,1892,21,30-34,1913,62
STAT,1822,40,40-44,1862,7.984164338487794
STAT,1872,38,25-29,1910,5.815036790711972
SIM,1849,77,na,1926,1262
STAT,1829,52,45-49,1881,0.020129315528267532
SIM,1845,63,na,1908,2938
STAT,1877,75,na,1952,2158.944839740697
SIM,1873,26,50-100,1899,1
SIM,1885,28,na,1913,5017
STAT,1834,46,40-44,1880,0.26901082514749985
SIM,1817,67,na,1884,1732
SIM,1860,43,30-34,1903,4
SIM,1879,26,20-24,1905,23
STAT,1839,47,na,1886,3579.257184481097
SIM,1939,31,25-29,1970,22
SIM,1813,53,na,1866,2601
STAT,1851,22,30-34,1873,32.9744620117274
SIM,1822,34,20-24,1856,6
SIM,1861,41,45-49,1902,7
SIM,1931,39,45-49,1970,2
STAT,1902,69,na,1971,4960.800386624665
SIM,1906,39,na,1945,6890
SIM,1938,24,20-24,1962,213
STAT,1941,31,15-19,1972,0.27265598493591126
SIM,1902,25,na,1927,7024
STAT,1873,39,na,1912,4785.939300185374
STAT,1854,18,15-19,1872,10.818788934274087
SIM,1839,37,30-34,1876,15
SIM,1916,26,35-39,1942,42
SIM,1885,3,na,1888,5844
STAT,1833,85,na,1918,360.3847438510313
STAT,1856,38,40-44,1894,6.787350192373259
STAT,1867,65,na,1932,3196.436671851638
STAT,1808,52,25-29,1860,0.02102086699369505
STAT,1886,40,45-49,1926,3.2229467332277544
STAT,1898,47,35-39,1945,0.2148302321930063
SIM,1820,40,45-49,1860,5
SIM,1868,19,20-24,1887,34
STAT,1818,42,40-44,1860,11.085787112382112
SIM,1909,34,50-100,1943,2
SIM,1950,18,35-39,1968,13
STAT,1939,30,20-24,1969,5.032525128842797
SIM,1869,42,50-100,1911,6
STAT,1860,32,na,1892,3913.747791995754
SIM,1927,0,na,1927,10659
SIM,1817,39,45-49,1856,5
STAT,1837,99,na,1936,2.639587622743395
SIM,1869,30,45-49,1899,7
STAT,1942,18,35-39,1960,8.853636729333452
STAT,1863,51,na,1914,3824.7996746295507
SIM,1881,30,45-49,1911,8
STAT,1823,44,50-100,1867,3.3430521594672706
STAT,1824,53,20-24,1877,0.0016873191943210504
STAT,1895,33,50-100,1928,2.4010444405194353
SIM,1851,70,na,1921,2090
STAT,1912,3,na,1915,8258.530561087295
STAT,1891,38,35-39,1929,17.569137212352036
STAT,1875,47,40-44,1922,0.3543253690158844
SIM,1830,40,40-44,1870,6
SIM,1853,32,50-100,1885,3
STAT,1885,33,40-44,1918,8.68129429782487
STAT,1841,29,na,1870,3842.702235340697
SIM,1956,15,25-29,1971,150
STAT,1852,30,25-29,1882,17.257036451515468
SIM,1911,27,25-29,1938,136
STAT,1875,43,25-29,1918,1.3256245451683544
STAT,1843,53,30-34,1896,0.00820455425653471
STAT,1903,27,25-29,1930,121.64037500825911
STAT,1839,58,na,1897,3087.8767647914624
STAT,1842,44,25-29,1886,0.9641169630002504
STAT,1918,20,na,1938,8000.473094839952
STAT,1905,48,40-44,1953,0.2785187469035586
STAT,1840,31,45-49,1871,3.0978147786241776
SIM,1841,25,40-44,1866,9
SIM,1936,30,45-49,1966,4
STAT,1846,45,20-24,1891,0.018563756054824646
STAT,1888,27,na,1915,5696.7864017100355
SIM,1815,97,na,1912,2
STAT,1824,47,35-39,1871,0.33905965768329643
STAT,1891,44,20-24,1935,0.3911065704331159
SIM,1894,40,45-49,1934,4
SIM,1912,39,35-39,1951,10
STAT,1897,39,40-44,1936,2.52507247982234
STAT,1849,28,35-39,1877,17.96254545865749
STAT,1778,105,na,1883,0.043852942941798076
STAT,1779,88,na,1867,76.53030151124466
SIM,1838,25,20-24,1863,22
STAT,1838,101,na,1939,0.7722631990180275
STAT,1849,19,45-49,1868,0.12569350188166095
SIM,1889,19,40-44,1908,3
STAT,1845,32,50-100,1877,1.6787260876005894
STAT,1878,35,15-19,1913,0.11957175952021153
STAT,1885,42,30-34,1927,2.308328224386935
STAT,1948,15,25-29,1963,100.20567260539923
SIM,1868,80,na,1948,1046
STAT,1862,23,45-49,1885,1.2233846258739831
SIM,1915,43,na,1958,7633
STAT,1816,104,na,1920,0.06551628277357475
SIM,1871,44,45-49,1915,5
SIM,1870,23,45-49,1893,6
STAT,1863,44,45-49,1907,2.6101963399459716
SIM,1873,29,30-34,1902,57
STAT,1904,39,35-39,1943,4.380758452688897
SIM,1832,47,35-39,1879,1
SIM,1878,1,na,1879,7147
SIM,1857,28,35-39,1885,22
SIM,1791,89,na,1880,52
SIM,1935,4,na,1939,11435
STAT,1954,17,15-19,1971,113.29621988233636
STAT,1832,26,15-19,1858,0.8057754910471963
STAT,1873,30,45-49,1903,3.6071848616109703
SIM,1858,37,40-44,1895,11
SIM,1893,36,45-49,1929,6
STAT,1869,41,35-39,1910,3.5596872680518152
SIM,1843,29,45-49,1872,2
SIM,1822,41,45-49,1863,7
STAT,1892,23,30-34,1915,44.895565094745166
STAT,1832,49,35-39,1881,0.1913972949442019
STAT,1902,48,15-19,1950,6.352743193332862E-4
STAT,1810,89,na,1899,95.00544251472047
STAT,1915,41,15-19,1956,0.0031272628708656786
STAT,1916,28,35-39,1944,31.240999162610134
STAT,1837,51,40-44,1888,0.01502443604425986
STAT,1889,42,15-19,1931,0.034347352032308515
SIM,1871,24,15-19,1895,7
SIM,1838,29,na,1867,3746
STAT,1842,16,30-34,1858,3.065267171469037
STAT,1867,45,40-44,1912,0.3270401566700232
STAT,1881,32,45-49,1913,3.4040826500163575
STAT,1848,16,25-29,1864,11.586778080467514
SIM,1856,16,25-29,1872,15
STAT,1825,32,30-34,1857,61.96496644910917
STAT,1931,38,40-44,1969,4.000128719226981
STAT,1892,42,35-39,1934,4.572636449948776
SIM,1883,47,40-44,1930,1
SIM,1917,30,35-39,1947,26
STAT,1841,29,50-100,1870,1.1363106993569432
SIM,1892,30,20-24,1922,6
STAT,1883,28,na,1911,4718.845509445866
SIM,1857,32,na,1889,4231
STAT,1884,30,20-24,1914,5.4339608868030576
STAT,1897,16,20-24,1913,47.9782333220995
SIM,1875,45,40-44,1920,1
STAT,1892,64,na,1956,4446.828473473242
STAT,1825,51,35-39,1876,0.01835753566810986
SIM,1833,32,30-34,1865,43
SIM,1833,30,na,1863,3686
SIM,1837,44,na,1881,3204
SIM,1842,42,25-29,1884,1
STAT,1887,49,25-29,1936,0.07185853132169172
SIM,1850,44,25-29,1894,2
SIM,1849,26,35-39,1875,24
STAT,1868,28,45-49,1896,2.125966912849385
STAT,1866,23,50-100,1889,0.7606131969216471
SIM,1897,37,40-44,1934,19
STAT,1874,35,30-34,1909,11.125781680150022
SIM,1885,40,30-34,1925,2
STAT,1908,26,35-39,1934,29.025691591588473
SIM,1818,43,45-49,1861,6
STAT,1841,32,15-19,1873,0.2506960397673514
STAT,1859,52,30-34,1911,0.009517720049892034
STAT,1916,20,25-29,1936,196.64518972297742
SIM,1792,74,na,1866,918
STAT,1827,42,50-100,1869,2.006781252714665
SIM,1815,44,30-34,1859,4
STAT,1814,41,45-49,1855,8.975770437129212
SIM,1904,16,15-19,1920,18
SIM,1950,20,na,1970,8505
STAT,1841,27,40-44,1868,5.398380179571898
STAT,1839,49,50-100,1888,0.38083895477926544
STAT,1832,41,25-29,1873,1.0374906932817074
STAT,1877,34,45-49,1911,3.62576063421496
STAT,1904,39,na,1943,6813.97640841933
SIM,1796,88,na,1884,111
STAT,1838,27,20-24,1865,20.19681478998665
SIM,1885,34,45-49,1919,7
STAT,1818,85,na,1903,281.2462806795224
STAT,1834,42,25-29,1876,1.0304973267857354
SIM,1867,10,na,1877,5536
STAT,1858,31,30-34,1889,27.77582325574244
SIM,1898,29,35-39,1927,36
SIM,1840,49,35-39,1889,1
STAT,1842,104,na,1946,0.09930398165411897
STAT,1923,15,20-24,1938,322.9095221103665
SIM,1846,27,20-24,1873,26
STAT,1850,18,30-34,1868,2.968734086397557
STAT,1840,40,20-24,1880,0.26959800622578817
STAT,1909,30,35-39,1939,17.763220288723637
SIM,1904,37,35-39,1941,5
SIM,1931,15,20-24,1946,342
STAT,1863,24,15-19,1887,5.8634642327073605
SIM,1924,28,35-39,1952,50
STAT,1853,17,45-49,1870,0.12432736821021664
SIM,1899,33,35-39,1932,38
STAT,1898,20,20-24,1918,189.4676585712587
SIM,1855,84,na,1939,512
SIM,1865,51,na,1916,4050
SIM,1882,35,30-34,1917,4
SIM,1877,41,35-39,1918,5
SIM,1880,38,25-29,1918,10
STAT,1888,38,15-19,1926,0.13337973496880018
SIM,1859,98,na,1957,7
STAT,1858,39,40-44,1897,6.822655518173974
STAT,1877,40,30-34,1917,2.435364391606338
STAT,1774,89,na,1863,51.82807845125208
STAT,1854,9,na,1863,4467.771796666176
SIM,1832,28,30-34,1860,59
SIM,1930,27,35-39,1957,48
STAT,1789,66,na,1855,1566.4883999999997
SIM,1924,20,25-29,1944,256
SIM,1905,49,45-49,1954,2
SIM,1918,23,40-44,1941,11
STAT,1840,48,30-34,1888,0.13910786089080704
SIM,1835,85,na,1920,232
STAT,1865,26,50-100,1891,1.1777426632984087
STAT,1898,28,30-34,1926,68.58207956517724
STAT,1851,50,25-29,1901,0.005569671454185506
STAT,1870,22,40-44,1892,4.131832949037167
SIM,1887,28,20-24,1915,30
SIM,1831,71,na,1902,1704
STAT,1882,28,40-44,1910,5.872717473387629
SIM,1872,10,na,1882,5663
STAT,1870,31,30-34,1901,34.76108104429557
STAT,1836,33,45-49,1869,2.9010757897973396
STAT,1848,62,na,1910,2996.943987573594
STAT,1859,46,45-49,1905,0.3804445422823798
STAT,1899,31,50-100,1930,2.5457396556137764
STAT,1847,37,15-19,1884,0.08881250918747811
SIM,1867,46,45-49,1913,1
STAT,1760,112,na,1872,1.930819505953833E-4
STAT,1895,48,20-24,1943,0.017589678832959425
STAT,1893,35,40-44,1928,11.31229690015704
SIM,1935,20,na,1955,10307
STAT,1837,34,15-19,1871,0.24379810645126546
STAT,1879,19,30-34,1898,3.3489561244901007
STAT,1909,21,50-100,1930,1.2394930237896458
SIM,1840,41,25-29,1881,1
SIM,1839,99,na,1938,1
STAT,1938,19,na,1957,7329.2313243801555
STAT,1831,37,25-29,1868,4.708575957017586
STAT,1891,19,30-34,1910,3.9575690802233376
SIM,1866,31,30-34,1897,44
SIM,1889,44,30-34,1933,6
STAT,1861,40,40-44,1901,3.819203743690203
STAT,1889,17,25-29,1906,14.111473349393133
STAT,1870,39,50-100,1909,2.409900636873256
SIM,1844,33,45-49,1877,5
STAT,1835,29,45-49,1864,1.8481753301169066
STAT,1903,54,na,1957,6100.71273331445
STAT,1857,27,30-34,1884,40.83112487936599
STAT,1934,16,35-39,1950,11.492597920322975
STAT,1815,42,15-19,1857,0.08336062063899394
STAT,1937,34,na,1971,7548.743973346585
SIM,1896,41,45-49,1937,1
SIM,1921,39,na,1960,8477
STAT,1826,44,40-44,1870,4.562248663093048
STAT,1793,92,na,1885,22.67947132470487
STAT,1911,26,20-24,1937,36.086158686104795
SIM,1874,23,50-100,1897,1
STAT,1869,29,15-19,1898,0.8815226754775181
STAT,1848,36,40-44,1884,7.4740952476227775
SIM,1901,62,na,1963,5547
STAT,1880,20,35-39,1900,12.48948732729158
SIM,1947,18,50-100,1965,1
STAT,1861,28,50-100,1889,1.07536381476921
SIM,1920,38,30-34,1958,7
STAT,1850,37,35-39,1887,11.016428433225357
STAT,1883,45,25-29,1928,0.11543360893042497
STAT,1877,43,50-100,1920,2.199542127396885
SIM,1776,89,na,1865,69
SIM,1897,17,25-29,1914,18
STAT,1912,38,30-34,1950,3.5757564093453644
SIM,1848,46,50-100,1894,1
STAT,1933,20,na,1953,9842.297694763862
STAT,1935,20,35-39,1955,25.918512971950012
STAT,1818,96,na,1914,8.809420589412698
SIM,1834,44,40-44,1878,7
STAT,1865,100,na,1965,8.37747597023135
STAT,1878,52,40-44,1930,0.022087764433362526
STAT,1821,48,20-24,1869,0.03461926689657303
STAT,1844,103,na,1947,0.23176441976538253
STAT,1851,41,35-39,1892,2.8197934808947798
SIM,1842,17,35-39,1859,1
STAT,1816,54,25-29,1870,0.016041317370269616
SIM,1855,37,15-19,1892,1
STAT,1801,53,na,1854,2405.6377137593067
STAT,1874,24,na,1898,4860.102290991528
STAT,1902,17,50-100,1919,0.1396928054972076
STAT,1835,21,35-39,1856,10.1236366838431
SIM,1864,15,20-24,1879,45
SIM,1866,34,35-39,1900,26
SIM,1942,16,35-39,1958,7
STAT,1805,67,na,1872,1704.2830276447403
SIM,1888,32,20-24,1920,8
STAT,1857,39,50-100,1896,1.9132570379837879
STAT,1939,18,50-100,1957,0.7572436182127579
STAT,1860,32,25-29,1892,16.79871953349162
STAT,1856,15,20-24,1871,33.05326209823479
STAT,1830,25,15-19,1855,1.2599296622201057
STAT,1894,36,50-100,1930,3.2005827052167537
SIM,1843,21,35-39,1864,13
SIM,1856,36,40-44,1892,13
STAT,1838,46,25-29,1884,0.08123507855123233
STAT,1876,79,na,1955,1460.3328080290771
SIM,1943,20,35-39,1963,26
STAT,1872,65,na,1937,3430.1853756112114
SIM,1837,33,na,1870,3556
STAT,1820,38,50-100,1858,5.744001935770007
STAT,1879,28,20-24,1907,24.695188237145402
STAT,1871,34,15-19,1905,0.28329671763511916
SIM,1841,29,50-100,1870,2
STAT,1867,16,35-39,1883,1.0672720853601827
STAT,1855,32,na,1887,3663.9140573761188
SIM,1884,43,na,1927,4939
STAT,1847,48,40-44,1895,0.2576882585425975
STAT,1912,42,15-19,1954,0.0029920996313613055
SIM,1852,35,50-100,1887,5
SIM,1855,17,50-100,1872,1
STAT,1950,21,na,1971,8751.642954268666
SIM,1831,50,na,1881,3113
SIM,1797,73,na,1870,964
STAT,1932,34,40-44,1966,10.49372495795893
STAT,1847,13,na,1860,4521.168008754452
SIM,1872,44,25-29,1916,4
STAT,1862,49,20-24,1911,0.02028191447219833
SIM,1848,27,30-34,1875,66
SIM,1892,62,na,1954,5237
STAT,1771,100,na,1871,0.31938296919316206
STAT,1844,16,40-44,1860,0.37769399173964013
STAT,1882,48,35-39,1930,0.2719746780049501
STAT,1810,48,45-49,1858,1.5100368705382368
STAT,1921,48,25-29,1969,0.12040598280119588
SIM,1846,16,na,1862,4500
STAT,1832,54,30-34,1886,0.007758620578574525
STAT,1915,37,45-49,1952,1.390974010018058
SIM,1871,15,na,1886,4982
SIM,1931,36,40-44,1967,6
STAT,1791,108,na,1899,7.228602005951072E-4
SIM,1945,19,na,1964,8378
STAT,1903,44,15-19,1947,0.0027203925321610707
STAT,1875,27,25-29,1902,87.95952610441591
SIM,1939,9,na,1948,8283
STAT,1900,30,15-19,1930,0.40217983104307053
SIM,1867,47,50-100,1914,1
SIM,1875,16,35-39,1891,1
SIM,1890,17,15-19,1907,14
SIM,1806,51,na,1857,2621
SIM,1892,6,na,1898,7483
SIM,1895,28,50-100,1923,1
SIM,1937,19,30-34,1956,31
STAT,1810,68,na,1878,1555.144034781785
SIM,1859,44,na,1903,4051
SIM,1867,63,na,1930,3516
STAT,1891,26,40-44,1917,7.50373485960895
STAT,1850,45,35-39,1895,0.2167978132970155
STAT,1868,82,na,1950,896.5504534568912
SIM,1890,28,40-44,1918,8
SIM,1832,35,40-44,1867,11
STAT,1925,22,na,1947,8826.302298065066
SIM,1829,46,na,1875,3116
STAT,1952,20,35-39,1972,22.87805602264533
STAT,1824,35,40-44,1859,14.426163413951084
SIM,1905,54,na,1959,6468
STAT,1924,19,50-100,1943,0.8959819854396638
SIM,1924,19,50-100,1943,1
STAT,1858,18,35-39,1876,1.0032034530214853
SIM,1883,27,25-29,1910,101
STAT,1885,49,15-19,1934,7.873284293334142E-4
STAT,1929,19,30-34,1948,31.2444969714146
STAT,1930,26,30-34,1956,100.66646028782347
STAT,1809,71,na,1880,1393.7483079822155
STAT,1909,45,20-24,1954,0.020717180986196747
SIM,1846,26,na,1872,4072
SIM,1880,8,na,1888,5903
STAT,1906,44,40-44,1950,0.45346649672559497
SIM,1823,37,40-44,1860,14
STAT,1855,42,na,1897,3480.907043925507
STAT,1867,29,40-44,1896,5.625388121155843
SIM,1884,33,na,1917,5148
STAT,1794,106,na,1900,0.00475589394491236
STAT,1869,0,na,1869,7336.511442543637
SIM,1910,41,50-100,1951,1
SIM,1839,29,30-34,1868,8
STAT,1833,53,35-39,1886,0.011454656714004783
STAT,1855,10,na,1865,4335.245312839132
SIM,1797,83,na,1880,201
SIM,1884,19,40-44,1903,3
STAT,1919,40,45-49,1959,0.36518677200634614
SIM,1912,36,30-34,1948,4
STAT,1864,44,25-29,1908,1.143643920147364
SIM,1889,28,30-34,1917,77
STAT,1856,52,50-100,1908,0.02340836899333688
STAT,1927,35,na,1962,9461.783278491092
SIM,1914,37,na,1951,7729
STAT,1862,25,50-100,1887,1.1243969069773792
SIM,1869,76,na,1945,1614
STAT,1823,86,na,1909,266.25174074520146
STAT,1896,40,40-44,1936,0.420683423260177
STAT,1831,45,25-29,1876,0.09043464265372186
SIM,1852,2,na,1854,5625
STAT,1904,36,30-34,1940,3.350592952671326
SIM,1855,62,na,1917,3152
STAT,1830,46,20-24,1876,0.020983862061284192
STAT,1881,49,30-34,1930,0.1850160963992996
SIM,1857,43,na,1900,4047
STAT,1868,60,na,1928,3664.696073825396
STAT,1917,25,na,1942,7987.540488059722
SIM,1844,17,45-49,1861,2
SIM,1864,0,na,1864,6923
STAT,1918,41,40-44,1959,0.5377732275444033
STAT,1917,35,na,1952,7966.297485388289
SIM,1878,17,15-19,1895,14
SIM,1859,66,na,1925,2813
SIM,1906,18,na,1924,7401
SIM,1864,38,40-44,1902,16
STAT,1900,43,35-39,1943,0.34974992527362675
STAT,1813,54,20-24,1867,0.0041682169653842974
SIM,1855,17,20-24,1872,42
STAT,1899,19,35-39,1918,1.5102116624062203
SIM,1888,16,20-24,1904,45
STAT,1909,5,na,1914,7941.5450101682245
SIM,1928,17,50-100,1945,1
STAT,1853,46,15-19,1899,6.346769139677027E-4
SIM,1923,37,45-49,1960,6
SIM,1854,45,na,1899,3801
STAT,1938,1,na,1939,8321.11151290167
SIM,1907,41,30-34,1948,1
SIM,1856,26,na,1882,4201
SIM,1905,28,25-29,1933,12
STAT,1806,51,50-100,1857,0.08991350612411626
STAT,1948,19,40-44,1967,3.2304248356155307
SIM,1821,40,na,1861,3152
STAT,1891,40,50-100,1931,2.6639189617851775
SIM,1914,29,50-100,1943,7
STAT,1847,17,20-24,1864,33.72904066459809
SIM,1860,45,45-49,1905,1
SIM,1891,40,50-100,1931,6
STAT,1840,23,50-100,1863,0.743176347196835
SIM,1893,17,40-44,1910,1
SIM,1865,19,30-34,1884,5
SIM,1870,44,50-100,1914,7
STAT,1871,48,na,1919,4457.616472297508
STAT,1840,43,25-29,1883,0.9545991326137213
SIM,1904,34,30-34,1938,40
STAT,1903,30,40-44,1933,12.570738516108197
SIM,1895,27,na,1922,6624
STAT,1942,28,50-100,1970,2.1088730160347366
SIM,1839,46,na,1885,3182
SIM,1760,96,na,1856,1
STAT,1907,18,40-44,1925,0.5415001002201792
STAT,1954,9,na,1963,9810.06961320086
STAT,1823,43,25-29,1866,2.084721402236077
STAT,1929,31,15-19,1960,0.3298198548417508
SIM,1921,34,30-34,1955,50
SIM,1880,61,na,1941,4082
STAT,1834,104,na,1938,0.08864021032081473
SIM,1831,43,25-29,1874,4
STAT,1820,42,45-49,1862,6.0547375073766965
STAT,1845,32,na,1877,3970.795207478218
SIM,1842,26,25-29,1868,101
SIM,1894,43,na,1937,6210
SIM,1789,86,na,1875,112
SIM,1804,70,na,1874,1294
STAT,1865,53,30-34,1918,0.01074644341515943
STAT,1877,43,na,1920,4812.021523554468
STAT,1834,26,25-29,1860,74.37073838871828
STAT,1913,34,30-34,1947,31.39477903704485
STAT,1880,45,20-24,1925,0.025785409033144503
SIM,1925,35,50-100,1960,1
STAT,1922,44,25-29,1966,0.1649396246320725
STAT,1857,19,30-34,1876,2.9143783297626937
SIM,1871,25,na,1896,4668
STAT,1761,93,na,1854,1.0
SIM,1853,46,50-100,1899,2
SIM,1856,28,50-100,1884,2
STAT,1885,17,40-44,1902,0.36768931953428124
SIM,1854,13,na,1867,4824
SIM,1911,30,40-44,1941,14
SIM,1830,33,50-100,1863,4
SIM,1862,32,na,1894,4373
SIM,1867,95,na,1962,53
SIM,1848,32,50-100,1880,2
STAT,1884,13,na,1897,5142.23884503592
STAT,1831,83,na,1914,512.5690050028375
STAT,1910,41,50-100,1951,0.22560942294329359
STAT,1892,10,na,1902,6549.110612096096
SIM,1828,52,50-100,1880,1
SIM,1906,45,45-49,1951,1
SIM,1872,32,na,1904,5054
STAT,1835,38,20-24,1873,1.2220797210578038
SIM,1844,21,50-100,1865,2
STAT,1895,39,30-34,1934,13.884319494639858
STAT,1903,24,20-24,1927,196.92164620236727
SIM,1911,24,20-24,1935,238
STAT,1810,53,40-44,1863,0.06377344524870326
STAT,1850,28,45-49,1878,1.9889934659580903
SIM,1927,40,45-49,1967,1
STAT,1881,36,25-29,1917,5.647478320649672
STAT,1890,34,25-29,1924,25.033439697518475
STAT,1802,53,50-100,1855,0.09487277762664996
STAT,1851,49,45-49,1900,0.3582045740745758
STAT,1814,45,25-29,1859,0.3078529670557695
STAT,1830,33,15-19,1863,0.2773837785838289
STAT,1828,48,30-34,1876,0.1720780518169075
SIM,1884,65,na,1949,3548
SIM,1934,35,na,1969,10383
STAT,1839,18,25-29,1857,11.506543270740202
SIM,1875,82,na,1957,1043
STAT,1854,47,20-24,1901,0.01831008566508402
STAT,1923,36,40-44,1959,3.505175798029788
SIM,1912,18,15-19,1930,21
STAT,1935,25,50-100,1960,2.7431003552574227
SIM,1922,24,na,1946,8833
STAT,1854,38,30-34,1892,8.129650879510399
STAT,1871,47,20-24,1918,0.023965927413499746
STAT,1888,80,na,1968,2290.7236721109607
SIM,1875,50,na,1925,4929
STAT,1775,107,na,1882,0.012088927825231653
STAT,1894,22,50-100,1916,1.0579701376793234
STAT,1890,47,30-34,1937,0.13397801603825016
STAT,1865,36,40-44,1901,8.070549284736623
STAT,1872,12,na,1884,5342.209884619028
SIM,1932,35,45-49,1967,3
STAT,1858,82,na,1940,734.5959279824941
SIM,1839,24,na,1863,3687
STAT,1885,30,na,1915,4835.752503278782
STAT,1891,46,35-39,1937,0.1977031628886209
SIM,1816,71,na,1887,1291
STAT,1880,34,50-100,1914,1.9326895057343012
STAT,1800,68,na,1868,1553.0998385516807
STAT,1913,46,25-29,1959,0.10485137153024257
SIM,1830,86,na,1916,214
STAT,1875,18,35-39,1893,1.1379699078855003
STAT,1784,88,na,1872,74.89052923795818
SIM,1880,83,na,1963,1234
STAT,1851,54,40-44,1905,0.015870996137745643
STAT,1792,108,na,1900,6.863323657769185E-4
SIM,1873,36,40-44,1909,12
STAT,1905,24,na,1929,6864.544279114245
STAT,1923,18,25-29,1941,102.4679446804454
STAT,1855,46,25-29,1901,0.087103622675514
STAT,1935,22,na,1957,10045.104775382344
SIM,1931,18,25-29,1949,156
SIM,1921,37,50-100,1958,1
STAT,1849,50,20-24,1899,0.0011840133179213516
STAT,1856,28,50-100,1884,1.0254882937936305
SIM,1915,35,45-49,1950,3
STAT,1924,35,45-49,1959,1.6258771176335145
STAT,1908,42,na,1950,6944.211102330012
SIM,1864,45,na,1909,4378
SIM,1847,18,25-29,1865,10
SIM,1880,34,50-100,1914,1
STAT,1920,44,15-19,1964,0.0034132212184155614
SIM,1872,64,na,1936,3549
STAT,1860,44,40-44,1904,3.6392041378599167
STAT,1898,20,50-100,1918,1.1211768663930803
STAT,1885,62,na,1947,3674.2809283238576
STAT,1904,18,15-19,1922,17.157646896532192
STAT,1922,24,30-34,1946,66.13129030977585
STAT,1872,46,25-29,1918,0.11724499019763435
STAT,1838,19,20-24,1857,31.32100006780704
STAT,1844,48,15-19,1892,6.37848493148776E-4
STAT,1907,35,45-49,1942,1.289346731399137
STAT,1928,19,na,1947,9315.082405564455
STAT,1900,26,45-49,1926,3.1213273897230533
STAT,1861,43,45-49,1904,2.497690657772139
SIM,1929,17,30-34,1946,39
STAT,1809,48,20-24,1857,0.09134601258962792
STAT,1843,103,na,1946,0.20103838386943274
SIM,1898,20,50-100,1918,2
SIM,1902,34,20-24,1936,6
SIM,1930,24,30-34,1954,93
SIM,1846,19,20-24,1865,38
SIM,1866,14,na,1880,5195
STAT,1839,49,45-49,1888,0.3659527421641546
STAT,1874,19,30-34,1893,3.278310533333292
STAT,1842,43,35-39,1885,2.753761543237711
STAT,1891,29,45-49,1920,2.751930683817801
SIM,1802,69,na,1871,1513
SIM,1832,38,45-49,1870,6
STAT,1840,35,25-29,1875,5.018620488246669
STAT,1873,29,na,1902,4862.277849447754
SIM,1895,59,na,1954,5259
SIM,1923,34,40-44,1957,15
STAT,1900,31,40-44,1931,12.199503252713004
STAT,1921,45,20-24,1966,0.02527290185342448
STAT,1953,18,na,1971,8988.86044549769
STAT,1932,37,45-49,1969,1.8500270726885497
STAT,1813,86,na,1899,197.15936367732016
STAT,1821,43,15-19,1864,0.042684532623404194
STAT,1824,52,30-34,1876,0.013884385922517646
SIM,1809,48,na,1857,2615
STAT,1907,30,25-29,1937,17.598169400987505
STAT,1872,97,na,1969,58.49303041690959
STAT,1917,47,20-24,1964,0.023310448248756818
STAT,1913,53,na,1966,7089.657594468801
STAT,1875,62,na,1937,3800.495623055814
SIM,1857,37,25-29,1894,6
SIM,1877,49,30-34,1926,1
STAT,1773,94,na,1867,7.467420845514748
SIM,1855,94,na,1949,13
STAT,1824,38,45-49,1862,5.790118955964148
SIM,1864,42,25-29,1906,1
STAT,1873,38,40-44,1911,8.938326352106646
STAT,1856,59,na,1915,3028.376151667506
STAT,1830,49,25-29,1879,0.09688818208809102
SIM,1887,27,50-100,1914,2
STAT,1914,20,15-19,1934,10.604547972854832
SIM,1934,25,na,1959,10026
SIM,1793,69,na,1862,1378
SIM,1872,41,20-24,1913,1
SIM,1881,47,30-34,1928,1
STAT,1829,29,20-24,1858,25.49388132468237
STAT,1852,18,40-44,1870,0.35049698347910746
SIM,1821,72,na,1893,1442
SIM,1942,6,na,1948,8552
SIM,1864,27,15-19,1891,1
SIM,1900,41,35-39,1941,1
STAT,1891,43,30-34,1934,2.8492788719780986
STAT,1845,40,35-39,1885,2.9152114982120216
STAT,1851,28,na,1879,3898.248870400837
STAT,1831,73,na,1904,1533.5645897677412
STAT,1899,16,30-34,1915,4.42128992536387
STAT,1844,19,45-49,1863,0.1325211716034921
SIM,1904,59,na,1963,6050
SIM,1847,43,na,1890,3479
STAT,1803,66,na,1869,1637.725534845542
STAT,1878,19,15-19,1897,12.450621852145908
STAT,1880,28,30-34,1908,53.38774166061883
STAT,1947,6,na,1953,8984.581721210765
STAT,1910,45,45-49,1955,0.41161182220061615
STAT,1829,26,na,1855,3289.2517522399025
STAT,1838,50,45-49,1888,0.02032599288057595
SIM,1864,13,na,1877,5187
STAT,1849,37,25-29,1886,4.660262590379967
SIM,1917,34,50-100,1951,3
SIM,1885,60,na,1945,4024
STAT,1856,27,15-19,1883,0.7325887026001119
SIM,1800,56,na,1856,2172
SIM,1873,5,na,1878,5813
STAT,1831,42,20-24,1873,0.25147187484833716
STAT,1853,46,50-100,1899,0.38969195253327665
STAT,1873,47,30-34,1920,0.19771296740522956
SIM,1834,28,40-44,1862,11
SIM,1909,36,na,1945,7335
SIM,1914,18,25-29,1932,18
STAT,1923,40,25-29,1963,0.16897688083117376
SIM,1853,40,35-39,1893,4
SIM,1922,20,15-19,1942,13
SIM,1849,5,na,1854,5100
SIM,1844,34,50-100,1878,1
STAT,1844,21,50-100,1865,0.8281845277054702
STAT,1881,45,50-100,1926,0.4842108835229983
SIM,1905,7,na,1912,7858
STAT,1808,97,na,1905,4.221512949674563
STAT,1923,44,40-44,1967,0.5882711141999291
STAT,1876,54,45-49,1930,0.029480771378035828
STAT,1878,60,na,1938,4022.815383084796
STAT,1906,47,45-49,1953,0.3899490083999759
STAT,1796,89,na,1885,78.33668103267415
STAT,1900,40,30-34,1940,0.2259254886842375
STAT,1921,36,30-34,1957,4.1127671086538085
SIM,1898,38,25-29,1936,2
SIM,1860,42,40-44,1902,10
SIM,1810,46,45-49,1856,2
STAT,1848,29,30-34,1877,48.58826839193354
SIM,1817,77,na,1894,811
STAT,1904,40,15-19,1944,0.00280789142193459
SIM,1804,92,na,1896,17
SIM,1856,29,30-34,1885,53
STAT,1882,17,15-19,1899,11.67561546877228
STAT,1836,46,15-19,1882,5.638802399356029E-4
STAT,1831,44,50-100,1875,1.6302244759866336
SIM,1888,19,25-29,1907,13
SIM,1941,20,25-29,1961,200
STAT,1864,25,na,1889,4354.463443156885
STAT,1858,15,30-34,1873,2.9661713717083975
STAT,1875,84,na,1959,924.9018193346113
STAT,1769,99,na,1868,0.4527763047869327
STAT,1826,28,40-44,1854,23.022703963565213
SIM,1964,0,na,1964,10497
STAT,1892,32,na,1924,6033.300444458613
STAT,1891,58,na,1949,4936.838943804463
SIM,1908,40,35-39,1948,2
SIM,1881,38,40-44,1919,9
SIM,1904,37,na,1941,6972
STAT,1888,37,na,1925,5623.870941550417
STAT,1819,50,35-39,1869,0.036098554248486764
STAT,1854,15,na,1869,4259.453205055053
STAT,1869,49,30-34,1918,0.1854765568257105
STAT,1933,20,25-29,1953,248.95336543844124
SIM,1866,15,30-34,1881,3
STAT,1920,24,20-24,1944,248.03990730055872
SIM,1883,42,35-39,1925,7
SIM,1850,43,35-39,1893,4
SIM,1871,48,25-29,1919,1
STAT,1877,18,45-49,1895,0.13663270905656685
STAT,1934,32,35-39,1966,25.20242510787382
STAT,1881,58,na,1939,3860.431014384459
STAT,1911,46,15-19,1957,7.062725693638749E-4
STAT,1903,9,na,1912,7461.02935068137
SIM,1814,47,40-44,1861,1
SIM,1919,36,na,1955,8237
STAT,1846,101,na,1947,0.8740293654620086
SIM,1913,36,50-100,1949,1
STAT,1843,52,40-44,1895,0.014668810411823616
STAT,1893,19,40-44,1912,0.4656986125495184
STAT,1915,34,40-44,1949,7.981072882589271
STAT,1875,42,35-39,1917,3.760682762154903
STAT,1860,16,25-29,1876,10.782358360496591
STAT,1938,29,25-29,1967,131.5874755221282
SIM,1831,40,20-24,1871,2
STAT,1869,16,45-49,1885,0.13037023191822655
SIM,1867,27,40-44,1894,6
STAT,1890,31,20-24,1921,6.690692420344368
STAT,1805,52,20-24,1857,0.00579401006351799
STAT,1863,48,25-29,1911,0.10055156666336804
SIM,1896,18,20-24,1914,45
SIM,1923,42,40-44,1965,1
STAT,1886,41,35-39,1927,3.878019059292099
STAT,1919,29,15-19,1948,1.5291865602761558
STAT,1781,81,na,1862,385.98766068837296
SIM,1840,64,na,1904,2690
STAT,1847,101,na,1948,0.8698254135396035
STAT,1829,48,na,1877,2869.4776141388934
SIM,1846,48,na,1894,3444
STAT,1863,61,na,1924,3303.562078838455
SIM,1876,14,na,1890,5547
STAT,1864,46,na,1910,4073.1907094311787
STAT,1923,31,20-24,1954,5.66864131621648
STAT,1859,14,na,1873,4414.130063650206
STAT,1880,31,na,1911,5097.799039201893
STAT,1817,90,na,1907,79.52060148601866
SIM,1834,90,na,1924,66
SIM,1907,28,35-39,1935,38
STAT,1802,54,45-49,1856,0.08933483964668582
SIM,1877,0,na,1877,7185
STAT,1898,37,na,1935,6439.092296729795
STAT,1809,46,50-100,1855,1.9385204257184607
STAT,1868,50,30-34,1918,0.011602349539260433
STAT,1900,23,40-44,1923,5.820010358356109
SIM,1826,29,45-49,1855,2
SIM,1918,19,20-24,1937,295
STAT,1913,23,50-100,1936,1.3381156205223963
SIM,1909,58,na,1967,6525
SIM,1829,27,20-24,1856,24
SIM,1821,50,na,1871,2764
STAT,1917,20,40-44,1937,7.259684355758593
STAT,1804,50,na,1854,2425.528157944684
STAT,1926,30,35-39,1956,22.338001613543767
SIM,1886,4,na,1890,5556
SIM,1891,44,35-39,1935,1
STAT,1850,25,40-44,1875,5.483512424142657
SIM,1787,73,na,1860,809
STAT,1839,26,na,1865,4286.032902549072
SIM,1862,38,30-34,1900,14
STAT,1870,38,15-19,1908,0.11079252513878196
STAT,1908,42,35-39,1950,0.3765103979655544
STAT,1841,16,15-19,1857,11.171233227468125
STAT,1855,17,50-100,1872,0.08786877312984694
SIM,1806,83,na,1889,222
STAT,1841,47,35-39,1888,0.2040510523066256
STAT,1915,42,40-44,1957,0.5086194364603777
STAT,1888,49,40-44,1937,0.2257082922226695
STAT,1763,94,na,1857,3.6707718600357113
SIM,1941,17,50-100,1958,1
STAT,1801,85,na,1886,194.11680373263727
STAT,1883,44,35-39,1927,3.5446487959607644
STAT,1888,18,20-24,1906,42.208282885473714
SIM,1843,23,50-100,1866,1
STAT,1866,17,30-34,1883,3.048610948117821
SIM,1934,30,35-39,1964,34
SIM,1901,30,na,1931,6806
STAT,1922,48,50-100,1970,0.523172562567455
STAT,1902,36,20-24,1938,0.4766930725947457
SIM,1899,17,35-39,1916,2
SIM,1847,15,20-24,1862,35
STAT,1821,35,15-19,1856,0.25038560928008796
SIM,1811,72,na,1883,1119
SIM,1847,46,40-44,1893,1
STAT,1857,54,35-39,1911,0.01317967376092647
STAT,1848,94,na,1942,32.77131640858687
SIM,1839,16,25-29,1855,11
STAT,1940,8,na,1948,8145.705254285873
STAT,1942,24,na,1966,7727.771353946073
STAT,1859,27,40-44,1886,4.898454038048828
STAT,1938,29,na,1967,7489.283100714306
STAT,1922,36,na,1958,8651.322015335883
SIM,1842,41,35-39,1883,7
SIM,1869,44,na,1913,4405
SIM,1931,31,20-24,1962,8
STAT,1918,52,na,1970,7761.480107859721
SIM,1874,17,30-34,1891,3
STAT,1888,59,na,1947,4639.175496374949
STAT,1916,41,30-34,1957,0.26497662237196395
SIM,1840,86,na,1926,287
STAT,1896,47,25-29,1943,0.08623154747247451
SIM,1823,41,25-29,1864,1
SIM,1840,37,40-44,1877,19
SIM,1921,43,20-24,1964,1
STAT,1865,39,45-49,1904,3.620858970528053
STAT,1786,69,na,1855,1208.1036
SIM,1826,71,na,1897,1455
STAT,1875,40,20-24,1915,0.333560248951071
STAT,1797,85,na,1882,177.54538835494196
STAT,1816,53,35-39,1869,0.039775550059182
SIM,1859,28,45-49,1887,1
STAT,1850,42,30-34,1892,1.7605813060430784
SIM,1847,65,na,1912,2532
STAT,1863,29,na,1892,4188.981078350133
STAT,1882,32,25-29,1914,20.15126571004439
SIM,1903,33,50-100,1936,4
STAT,1849,79,na,1928,1105.8434636579273
STAT,1839,15,20-24,1854,36.642230895108874
SIM,1861,15,na,1876,5100
STAT,1851,19,50-100,1870,0.0912523455215038
SIM,1912,24,na,1936,7464
STAT,1839,46,40-44,1885,0.27587283733324075
SIM,1779,86,na,1865,113
SIM,1916,42,35-39,1958,2
STAT,1879,51,45-49,1930,0.030803825297766447
SIM,1839,78,na,1917,939
STAT,1789,87,na,1876,118.92736904472613
SIM,1821,37,30-34,1858,12
SIM,1873,39,45-49,1912,9
STAT,1815,41,25-29,1856,4.005117661165778
STAT,1927,42,45-49,1969,0.4214856745392822
STAT,1930,23,na,1953,9418.88048378798
STAT,1897,28,15-19,1925,1.2205229809316784
SIM,1780,94,na,1874,9
STAT,1832,37,40-44,1869,7.211040231409253
STAT,1840,34,na,1874,3731.9343329334374
SIM,1849,39,40-44,1888,10
SIM,1834,47,na,1881,3110
SIM,1841,18,30-34,1859,4
STAT,1776,107,na,1883,0.01580810492704254
STAT,1872,43,20-24,1915,0.3200206651935867
STAT,1822,47,25-29,1869,0.1790725752112647
SIM,1870,83,na,1953,764
STAT,1810,45,40-44,1855,1.1606955985109249
SIM,1814,70,na,1884,1424
SIM,1925,20,40-44,1945,11
STAT,1835,53,45-49,1888,0.01878788181889587
STAT,1930,30,15-19,1960,0.33530876579093843
SIM,1885,82,na,1967,1690
SIM,1897,22,50-100,1919,1
SIM,1915,30,25-29,1945,26
STAT,1945,19,15-19,1964,100.04901953040373
STAT,1877,47,15-19,1924,8.349517550123214E-4
SIM,1921,37,35-39,1958,8
STAT,1935,35,20-24,1970,0.7458800071587646
SIM,1806,48,45-49,1854,1
STAT,1913,37,35-39,1950,4.821969777431981
SIM,1890,32,25-29,1922,35
SIM,1877,31,na,1908,4955
STAT,1913,43,20-24,1956,0.03473587203208211
STAT,1894,40,30-34,1934,3.0127920760203093
STAT,1806,84,na,1890,226.5155595037749
STAT,1839,27,15-19,1866,0.8924551665290608
SIM,1909,48,50-100,1957,1
SIM,1893,44,45-49,1937,1
STAT,1901,30,30-34,1931,49.761867062174225
STAT,1828,44,15-19,1872,0.02517837647903279
SIM,1881,78,na,1959,1380
STAT,1807,52,30-34,1859,0.038772107483871505
STAT,1849,57,na,1906,3178.830800140995
STAT,1858,23,50-100,1881,0.665531116126943
STAT,1880,63,na,1943,3796.2375663090575
STAT,1825,43,35-39,1868,4.090094889484287
SIM,1908,41,na,1949,6986
SIM,1862,96,na,1958,16
SIM,1859,12,na,1871,4970
STAT,1864,40,45-49,1904,2.729161853060068
STAT,1890,38,40-44,1928,10.737702547209805
STAT,1840,32,20-24,1872,4.75224843898212
STAT,1878,59,na,1937,4099.350252295147
STAT,1893,39,20-24,1932,1.9534189696816249
SIM,1790,94,na,1884,8
STAT,1931,18,na,1949,9704.881068887553
STAT,1787,75,na,1862,773.2195219705354
STAT,1884,6,na,1890,5209.747021752885
SIM,1824,69,na,1893,1778
STAT,1826,48,20-24,1874,0.02360596399018166
STAT,1888,45,25-29,1933,0.1388657158161645
SIM,1873,59,na,1932,3995
SIM,1925,40,35-39,1965,1
STAT,1895,47,50-100,1942,0.36288337317750796
STAT,1892,34,35-39,1926,25.385006354288844
SIM,1856,79,na,1935,1066
STAT,1830,37,30-34,1867,9.988180338244492
STAT,1911,34,20-24,1945,4.757255094983991
STAT,1885,44,45-49,1929,2.9680783671430278
SIM,1893,24,50-100,1917,1
SIM,1841,42,30-34,1883,3
STAT,1871,30,35-39,1901,20.483445970417623
STAT,1910,42,40-44,1952,0.47758927499004317
STAT,1872,34,50-100,1906,1.8438183579079672
STAT,1859,47,50-100,1906,0.3929587683430201
STAT,1860,31,35-39,1891,16.677102931007372
SIM,1920,31,45-49,1951,7
SIM,1929,29,25-29,1958,184
STAT,1843,16,25-29,1859,10.20439019826366
STAT,1931,20,15-19,1951,14.02726714791508
STAT,1922,48,40-44,1970,0.364687063424105
SIM,1809,46,50-100,1855,2
STAT,1900,34,45-49,1934,4.843707009453182
SIM,1833,43,35-39,1876,8
SIM,1811,49,30-34,1860,1
STAT,1838,94,na,1932,27.048500161749836
STAT,1895,35,15-19,1930,0.149181526390199
SIM,1932,30,25-29,1962,26
STAT,1913,30,15-19,1943,0.2603543529231347
STAT,1907,32,40-44,1939,7.3916460891076845
STAT,1855,64,na,1919,2621.330413615381
STAT,1927,25,50-100,1952,2.4600631317203936
SIM,1873,49,na,1922,4646
STAT,1815,48,45-49,1863,1.2483662311427381
SIM,1915,32,40-44,1947,10
STAT,1783,72,na,1855,916.8465599999998
STAT,1891,26,na,1917,5978.119052383353
SIM,1910,36,20-24,1946,1
STAT,1817,47,na,1864,2923.45652544181
SIM,1831,47,40-44,1878,1
STAT,1870,31,na,1901,4750.979065784615
STAT,1823,54,na,1877,2781.0234406296895
STAT,1902,41,50-100,1943,0.2101274833394729
STAT,1924,30,25-29,1954,21.87032240712932
STAT,1823,47,40-44,1870,0.528984713246953
STAT,1847,17,50-100,1864,0.0932084576720877
SIM,1879,18,20-24,1897,35
SIM,1872,40,45-49,1912,7
STAT,1818,53,45-49,1871,0.06013911691050906
STAT,1925,2,na,1927,9975.93104661425
STAT,1851,71,na,1922,2069.1847163893694
STAT,1912,26,na,1938,7483.379306767543
SIM,1854,67,na,1921,2555
SIM,1851,16,25-29,1867,19
STAT,1773,109,na,1882,0.005858623530232658
STAT,1836,82,na,1918,620.360146639691
STAT,1916,8,na,1924,8518.158487053704
STAT,1912,31,45-49,1943,3.140774848348056
STAT,1865,17,15-19,1882,11.220689824893894
SIM,1823,84,na,1907,364
STAT,1910,18,50-100,1928,0.1495922417349369
STAT,1920,45,na,1965,8238.469042409202
SIM,1932,19,50-100,1951,1
STAT,1852,38,20-24,1890,1.2224930538130006
SIM,1790,72,na,1862,1202
STAT,1917,40,35-39,1957,0.4255518994043752
STAT,1911,29,50-100,1940,1.9469604692698488
SIM,1862,86,na,1948,365
STAT,1851,33,35-39,1884,16.170850446891965
STAT,1914,48,50-100,1962,0.4518499948885781
STAT,1896,44,20-24,1940,0.029009250417208192
STAT,1947,19,25-29,1966,98.51618172211519
STAT,1904,44,30-34,1948,0.22829805464418237
STAT,1861,71,na,1932,2243.811037265015
STAT,1859,54,45-49,1913,0.022687028915311828
STAT,1888,69,na,1957,3619.534459996021
STAT,1923,47,45-49,1970,0.5133205703667759
STAT,1950,20,25-29,1970,221.44581143446922
SIM,1884,11,na,1895,5640
STAT,1890,30,45-49,1920,4.333347939085701
STAT,1947,19,50-100,1966,0.8517247421219083
SIM,1849,15,30-34,1864,4
SIM,1894,35,50-100,1929,5
STAT,1804,72,na,1876,1133.960814557565
STAT,1823,64,na,1887,2127.4080166978188
SIM,1902,41,45-49,1943,1
STAT,1893,43,40-44,1936,0.39695009020156635
SIM,1841,49,na,1890,3132
STAT,1841,31,25-29,1872,18.21940003228824
SIM,1912,25,50-100,1937,5
SIM,1841,27,na,1868,3902
STAT,1823,32,na,1855,3445.342457618734
SIM,1855,44,25-29,1899,2
STAT,1886,49,30-34,1935,0.20206315000689254
SIM,1878,40,50-100,1918,4
STAT,1897,43,25-29,1940,0.11951469787433532
STAT,1841,38,45-49,1879,3.3726240787198387
STAT,1772,109,na,1881,0.005089692638512858
STAT,1899,28,25-29,1927,116.64186749325337
SIM,1873,17,15-19,1890,12
SIM,1901,31,35-39,1932,40
STAT,1883,40,50-100,1923,2.1174416673613154
STAT,1833,64,na,1897,2285.294302171617
STAT,1864,48,40-44,1912,0.30518552222285417
STAT,1906,29,50-100,1935,1.869123863753697
STAT,1874,43,30-34,1917,2.360242044816732
STAT,1905,30,15-19,1935,0.41928497751339106
STAT,1866,15,15-19,1881,11.485984472200432
SIM,1902,40,40-44,1942,1
STAT,1902,26,na,1928,6828.156182905321
STAT,1876,3,na,1879,6421.969051803724
STAT,1814,46,50-100,1860,1.2923305135532939
STAT,1925,18,35-39,1943,10.208393899264745
STAT,1894,76,na,1970,3341.678924835626
SIM,1940,30,25-29,1970,22
STAT,1847,44,25-29,1891,0.9656539669021516
SIM,1870,31,45-49,1901,3
STAT,1922,41,20-24,1963,0.040986717529507784
SIM,1933,18,35-39,1951,14
SIM,1820,66,na,1886,1677
SIM,1841,17,na,1858,4293
SIM,1840,103,na,1943,1
STAT,1906,19,na,1925,7392.8577837686
STAT,1892,28,50-100,1920,1.6116386352164618
STAT,1959,13,na,1972,10373.657313595935
SIM,1882,43,30-34,1925,2
STAT,1813,50,40-44,1863,0.06444414238150188
STAT,1862,44,50-100,1906,1.799032726561531
STAT,1856,46,40-44,1902,0.2675274435014728
SIM,1874,15,15-19,1889,7
STAT,1915,45,45-49,1960,0.44442238801379236
STAT,1870,33,45-49,1903,3.4431066767470373
STAT,1873,34,25-29,1907,20.838447773015037
STAT,1845,48,30-34,1893,0.14728834105082664
STAT,1868,45,50-100,1913,0.476631789313202
STAT,1888,39,50-100,1927,2.9012057252478227
SIM,1859,52,45-49,1911,1
STAT,1873,31,20-24,1904,5.569496092080169
SIM,1910,43,45-49,1953,3
STAT,1876,32,50-100,1908,1.913908440786293
STAT,1858,42,35-39,1900,2.847468375288798
STAT,1899,45,50-100,1944,0.3871781139629827
STAT,1866,59,na,1925,3621.606030129698
STAT,1941,18,na,1959,7654.744285641754
STAT,1969,0,na,1969,9991.521771151898
STAT,1911,41,45-49,1952,0.32275471586278454
STAT,1920,30,40-44,1950,8.724543248055594
STAT,1836,50,35-39,1886,0.012052410840524337
SIM,1906,60,na,1966,6000
SIM,1857,8,na,1865,5100
STAT,1826,52,40-44,1878,0.0202474978348487
STAT,1874,78,na,1952,1615.7294734436186
STAT,1870,63,na,1933,3537.9670849291
STAT,1820,99,na,1919,2.1201981296344985
STAT,1846,53,20-24,1899,0.0011121300371442237
SIM,1928,17,15-19,1945,111
SIM,1869,12,na,1881,5201
SIM,1872,48,40-44,1920,1
SIM,1872,96,na,1968,76
STAT,1912,46,30-34,1958,0.17350381941919754
SIM,1881,31,20-24,1912,6
SIM,1923,45,45-49,1968,1
SIM,1868,15,40-44,1883,1
STAT,1822,33,50-100,1855,5.057193980250196
STAT,1869,45,15-19,1914,7.905790876559765E-4
STAT,1852,54,35-39,1906,0.013343882496511451
STAT,1906,18,25-29,1924,16.633172259775982
STAT,1843,40,25-29,1883,0.9502218856993022
SIM,1815,87,na,1902,147
STAT,1807,47,na,1854,2830.261445356054
SIM,1866,42,35-39,1908,8
STAT,1842,27,50-100,1869,1.1777642875297258
STAT,1829,53,20-24,1882,0.0010034372684198452
STAT,1855,96,na,1951,12.948116088280278
STAT,1902,42,40-44,1944,0.4448157843513706
SIM,1773,92,na,1865,9
SIM,1939,19,40-44,1958,1
STAT,1802,91,na,1893,44.4739486031295
STAT,1852,45,45-49,1897,0.3798891615161195
STAT,1848,53,30-34,1901,0.009603724210243312
STAT,1859,34,50-100,1893,1.4602448221671889
STAT,1898,40,15-19,1938,0.0026474310747090853
SIM,1917,23,na,1940,8020
SIM,1855,48,40-44,1903,1
STAT,1867,49,20-24,1916,0.022223198000179273
STAT,1795,72,na,1867,1170.3656729656952
SIM,1833,84,na,1917,362
STAT,1886,47,na,1933,4774.16964278559
STAT,1906,40,25-29,1946,0.13255803018498202
STAT,1840,106,na,1946,0.017525805062805825
STAT,1845,46,50-100,1891,0.37952830302934193
SIM,1837,29,20-24,1866,24
SIM,1916,23,50-100,1939,1
SIM,1852,21,50-100,1873,1
STAT,1920,31,45-49,1951,3.494444022698802
STAT,1905,56,na,1961,6197.618908862726
STAT,1925,40,35-39,1965,0.4936345042485339
SIM,1851,40,25-29,1891,2
SIM,1910,42,40-44,1952,1
SIM,1823,45,40-44,1868,1
SIM,1840,33,25-29,1873,29
STAT,1842,50,50-100,1892,0.022808312616188715
STAT,1842,46,na,1888,3393.3524153689805
STAT,1916,19,50-100,1935,0.15967501431052517
SIM,1824,47,na,1871,3152
STAT,1882,36,40-44,1918,8.653735877709812
STAT,1837,45,na,1882,3339.5284321691283
STAT,1932,32,25-29,1964,24.81643892991962
SIM,1900,21,40-44,1921,11
SIM,1899,26,25-29,1925,124
SIM,1837,65,na,1902,2202
STAT,1832,33,25-29,1865,17.219869661988255
STAT,1839,79,na,1918,1091.6027562567506
STAT,1867,21,50-100,1888,0.7800832592788096
STAT,1791,91,na,1882,37.88879201795416
STAT,1880,24,15-19,1904,6.974974872536374
STAT,1866,41,30-34,1907,2.152077215842997
STAT,1880,21,50-100,1901,0.8702232415758616
STAT,1902,43,45-49,1945,0.29419904304533406
SIM,1884,45,50-100,1929,2
SIM,1892,17,25-29,1909,21
SIM,1805,87,na,1892,94
SIM,1885,42,45-49,1927,8
SIM,1899,4,na,1903,7372
SIM,1922,46,40-44,1968,1
STAT,1815,45,40-44,1860,0.9494770247333675
STAT,1768,117,na,1885,1.304214125553841E-4
STAT,1853,33,50-100,1886,1.4774539460206635
STAT,1850,54,25-29,1904,0.005281516166150652
SIM,1774,87,na,1861,95
SIM,1890,36,40-44,1926,20
SIM,1938,31,30-34,1969,31
STAT,1920,23,na,1943,8171.984708885803
SIM,1837,97,na,1934,4
SIM,1841,45,35-39,1886,2
STAT,1855,43,20-24,1898,0.2377496831412725
STAT,1930,34,30-34,1964,41.01072170205135
STAT,1833,45,35-39,1878,0.2215606835498225
STAT,1856,42,25-29,1898,0.9994003809966805
STAT,1901,63,na,1964,5461.651585068853
STAT,1914,46,40-44,1960,0.3166336650522391
STAT,1867,53,40-44,1920,0.019592542614271135
STAT,1901,31,35-39,1932,28.749964822347494
STAT,1834,27,na,1861,3769.400155120042
STAT,1884,17,25-29,1901,11.300989210683573
STAT,1816,84,na,1900,326.7592559948824
STAT,1845,44,15-19,1889,0.021121675150456178
STAT,1843,48,20-24,1891,0.016598597378742145
STAT,1814,50,na,1864,2548.164313313519
STAT,1910,40,25-29,1950,0.13789494142539058
SIM,1865,15,15-19,1880,14
SIM,1863,19,20-24,1882,38
STAT,1892,31,30-34,1923,44.32372947127135
SIM,1898,18,30-34,1916,6
SIM,1886,30,45-49,1916,5
STAT,1959,4,na,1963,10387.25674072532
STAT,1881,40,45-49,1921,2.951042896561465
STAT,1884,41,25-29,1925,1.2864293792559618
STAT,1829,50,50-100,1879,0.023950847792439695
STAT,1894,44,na,1938,5935.763546323409
STAT,1767,107,na,1874,0.013236779381186838
SIM,1851,31,35-39,1882,21
STAT,1862,34,na,1896,4083.9856956777276
STAT,1876,45,50-100,1921,0.5181385781160804
STAT,1906,42,25-29,1948,0.13107226308759928
SIM,1810,88,na,1898,131
SIM,1951,0,na,1951,10153
SIM,1877,41,na,1918,4767
SIM,1873,39,50-100,1912,7
SIM,1832,35,na,1867,3558
STAT,1878,30,45-49,1908,3.7078115963633027
SIM,1833,40,30-34,1873,5
SIM,1916,30,40-44,1946,11
STAT,1786,90,na,1876,54.3710226798294
STAT,1876,19,40-44,1895,0.38000993025417934
SIM,1845,31,na,1876,4197
STAT,1881,48,na,1929,4336.688024874104
STAT,1911,37,25-29,1948,1.9212230606340959
STAT,1877,42,45-49,1919,3.134826984649502
SIM,1894,11,na,1905,7024
SIM,1838,17,20-24,1855,28
STAT,1867,11,na,1878,5095.628955610269
STAT,1855,19,20-24,1874,31.423323382893408
SIM,1826,28,na,1854,3489
STAT,1817,41,35-39,1858,10.20963295897601
STAT,1817,50,25-29,1867,0.01706422588876117
SIM,1912,47,35-39,1959,1
STAT,1857,15,15-19,1872,11.110747138239955
STAT,1815,54,30-34,1869,0.02944216426109434
STAT,1870,85,na,1955,543.5612185321235
STAT,1899,21,na,1920,6564.1756082286365
SIM,1842,98,na,1940,5
STAT,1875,1,na,1876,7201.8712666478705
STAT,1825,40,30-34,1865,2.7735130952676945
SIM,1912,56,na,1968,7046
STAT,1795,106,na,1901,0.005188895150920775
STAT,1950,22,40-44,1972,8.055331749026859
SIM,1815,65,na,1880,1709
STAT,1882,45,30-34,1927,0.19234264338466345
STAT,1830,33,50-100,1863,1.7846766729924222
SIM,1849,17,30-34,1866,5
STAT,1903,41,45-49,1944,0.30020877689169223
SIM,1923,19,na,1942,9125
STAT,1865,39,50-100,1904,2.2300040356205013
STAT,1822,44,20-24,1866,0.5064202199211757
SIM,1830,44,20-24,1874,1
STAT,1838,54,25-29,1892,0.004661954646432767
STAT,1860,53,30-34,1913,0.009605924036310318
STAT,1877,51,35-39,1928,0.01814094330740507
SIM,1892,41,25-29,1933,3
STAT,1864,78,na,1942,1410.5473488149194
STAT,1832,30,20-24,1862,4.69397752600401
STAT,1854,113,na,1967,1.1275569266267989E-4
SIM,1847,42,25-29,1889,3
SIM,1903,46,50-100,1949,1
SIM,1872,15,50-100,1887,2
STAT,1842,52,25-29,1894,0.0052453267849929324
STAT,1858,51,25-29,1909,0.005603291953056265
STAT,1812,45,15-19,1857,0.002874325644376657
SIM,1848,54,35-39,1902,1
STAT,1892,40,20-24,1932,0.40557788281340557
STAT,1864,15,50-100,1879,0.10173881366785202
STAT,1921,32,15-19,1953,0.28874700398703845
STAT,1898,16,15-19,1914,16.25948365076045
STAT,1928,41,15-19,1969,0.003958949814375511
SIM,1825,41,35-39,1866,8
SIM,1882,46,35-39,1928,1
SIM,1916,18,35-39,1934,2
STAT,1852,42,40-44,1894,3.580505227992564
STAT,1874,46,35-39,1920,0.2903300411938275
SIM,1840,30,20-24,1870,7
STAT,1884,32,35-39,1916,20.196108704075932
SIM,1851,27,na,1878,4029
STAT,1831,49,40-44,1880,0.2553546431904954
STAT,1846,82,na,1928,714.6685683820792
STAT,1911,41,na,1952,7202.361701671858
SIM,1844,41,45-49,1885,7
STAT,1879,77,na,1956,1908.6851606752207
STAT,1770,100,na,1870,0.35309985083169704
SIM,1888,43,25-29,1931,2
SIM,1947,21,na,1968,8655
STAT,1767,87,na,1854,89.0
SIM,1820,49,30-34,1869,1
SIM,1839,25,15-19,1864,1
SIM,1900,24,na,1924,6832
STAT,1881,26,na,1907,4674.674718012719
STAT,1812,49,30-34,1861,0.649933336901565
SIM,1914,1,na,1915,8716
STAT,1908,18,35-39,1926,1.6406596986918982
SIM,1892,32,35-39,1924,46
SIM,1955,6,na,1961,10124
STAT,1869,77,na,1946,1691.5631652660145
SIM,1904,27,na,1931,7000
SIM,1881,34,25-29,1915,19
STAT,1863,45,20-24,1908,0.021426311381986824
STAT,1849,15,15-19,1864,11.692303383655887
STAT,1851,30,30-34,1881,28.761743765866363
STAT,1932,5,na,1937,10753.476049772451
SIM,1923,20,30-34,1943,86
STAT,1841,44,30-34,1885,1.6895019274040217
SIM,1865,2,na,1867,6083
SIM,1810,66,na,1876,1716
STAT,1892,0,na,1892,7423.927529353455
SIM,1849,18,35-39,1867,1
STAT,1841,35,40-44,1876,7.640289403948338
STAT,1899,43,na,1942,6371.248785036871
STAT,1822,46,50-100,1868,0.7745987239057676
STAT,1836,41,45-49,1877,2.398317606955209
STAT,1850,21,25-29,1871,106.11160058105202
SIM,1942,22,na,1964,7862
STAT,1940,31,20-24,1971,5.101717825660845
SIM,1828,61,na,1889,2279
SIM,1798,68,na,1866,1364
STAT,1915,20,30-34,1935,57.9261191718706
SIM,1828,83,na,1911,510
STAT,1871,54,45-49,1925,0.028318613065726844
STAT,1856,49,na,1905,3432.585214054873
SIM,1814,43,25-29,1857,1
STAT,1893,46,45-49,1939,0.34174785816574715
SIM,1861,100,na,1961,3
SIM,1903,20,na,1923,7021
STAT,1886,45,15-19,1931,8.612781233126596E-4
STAT,1949,13,na,1962,9224.567173204923
SIM,1883,59,na,1942,3935
STAT,1796,90,na,1886,63.39787595974319
STAT,1934,20,40-44,1954,9.157051327644659
SIM,1800,88,na,1888,57
SIM,1830,54,na,1884,2563
STAT,1813,54,na,1867,2438.0668629041393
STAT,1830,50,40-44,1880,0.01827293377508067
STAT,1879,51,50-100,1930,0.03205686220638345
STAT,1930,37,35-39,1967,6.371697267106812
STAT,1879,55,na,1934,4367.997585343414
SIM,1873,27,na,1900,5038
SIM,1871,3,na,1874,5770
SIM,1884,15,25-29,1899,16
SIM,1812,47,30-34,1859,1
SIM,1906,42,40-44,1948,1
SIM,1860,20,na,1880,4309
STAT,1914,42,25-29,1956,0.14292945345042882
STAT,1876,15,25-29,1891,11.89199730088929
STAT,1862,40,35-39,1902,3.1573697359969803
SIM,1870,40,35-39,1910,7
STAT,1882,4,na,1886,5551.21262075231
STAT,1932,30,25-29,1962,24.844505295506355
SIM,1910,40,40-44,1950,1
SIM,1832,31,25-29,1863,25
STAT,1858,27,25-29,1885,68.17825624137105
STAT,1849,17,30-34,1866,3.1033721306519917
SIM,1832,98,na,1930,6
SIM,1857,15,15-19,1872,12
STAT,1847,41,20-24,1888,0.2465744041857712
SIM,1839,21,50-100,1860,1
STAT,1897,18,50-100,1915,0.13191400714896878
STAT,1808,65,na,1873,1740.3129341487927
STAT,1844,43,45-49,1887,2.443843887059692
STAT,1925,42,35-39,1967,0.4922680820805681
STAT,1856,49,45-49,1905,0.3600655298474854
STAT,1868,92,na,1960,145.5977961350645
SIM,1908,16,35-39,1924,3
SIM,1927,33,na,1960,9613
STAT,1903,12,na,1915,7426.166117626344
STAT,1944,23,50-100,1967,1.4342635932311132
STAT,1899,43,35-39,1942,0.34544477122633777
SIM,1942,20,40-44,1962,7
STAT,1845,64,na,1909,2678.698503194343
SIM,1890,39,45-49,1929,9
SIM,1886,77,na,1963,2174
STAT,1936,36,50-100,1972,0.8333733328748795
STAT,1897,47,40-44,1944,0.2594918443575091
STAT,1862,31,45-49,1893,3.0224895634534055
SIM,1864,49,45-49,1913,1
SIM,1892,30,na,1922,6900
STAT,1885,50,30-34,1935,0.01213834953104759
SIM,1863,43,20-24,1906,1
SIM,1914,44,40-44,1958,2
STAT,1860,40,50-100,1900,1.7501518572713153
SIM,1858,29,40-44,1887,5
STAT,1877,11,na,1888,5456.9723366464705
STAT,1820,47,15-19,1867,0.0014884654558619185
STAT,1824,31,25-29,1855,54.42238269933436
STAT,1940,32,25-29,1972,19.320545426361424
SIM,1888,28,15-19,1916,1
STAT,1882,39,45-49,1921,3.8825061437449087
STAT,1880,48,25-29,1928,0.12100838212956191
STAT,1891,22,25-29,1913,142.90691989495193
STAT,1825,29,50-100,1854,4.312516268942525
SIM,1922,48,50-100,1970,1
STAT,1860,47,45-49,1907,0.38525505733143567
SIM,1847,97,na,1944,10
STAT,1833,42,30-34,1875,1.8345606156787417
STAT,1910,31,35-39,1941,17.87484815671166
SIM,1784,87,na,1871,69
SIM,1932,32,40-44,1964,2
STAT,1908,30,40-44,1938,7.525179595888184
STAT,1904,47,35-39,1951,0.2278510560329673
STAT,1820,49,30-34,1869,0.34991459012173953
STAT,1781,91,na,1872,35.19155212790952
STAT,1926,45,20-24,1971,0.027663978977911185
STAT,1847,40,50-100,1887,1.6614054796369664
STAT,1894,47,15-19,1941,5.826527719698417E-4
STAT,1897,41,50-100,1938,0.198947770859334
STAT,1949,16,30-34,1965,28.636156151295367
SIM,1873,32,25-29,1905,24
SIM,1928,18,na,1946,9500
SIM,1823,48,45-49,1871,2
STAT,1928,19,15-19,1947,114.85383320214603
SIM,1897,18,na,1915,6954
SIM,1936,19,15-19,1955,72
STAT,1918,46,50-100,1964,0.48722753616028586
SIM,1857,17,30-34,1874,4
STAT,1814,42,20-24,1856,0.9171220885594689
SIM,1886,15,35-39,1901,1
SIM,1855,40,50-100,1895,3
STAT,1841,83,na,1924,576.0002912424612
SIM,1866,27,25-29,1893,74
STAT,1822,51,45-49,1873,0.04428280689449362
STAT,1862,12,na,1874,4719.614672380005
STAT,1914,41,20-24,1955,0.03539911958555708
STAT,1922,35,50-100,1957,0.9662643882944587
SIM,1922,42,25-29,1964,1
STAT,1828,53,na,1881,2777.861894725543
STAT,1881,33,20-24,1914,5.25432315017467
SIM,1877,63,na,1940,3510
STAT,1890,43,15-19,1933,0.03379746158930648
STAT,1811,44,45-49,1855,10.810817587025024
SIM,1852,43,45-49,1895,4
STAT,1866,44,35-39,1910,3.3288664944417823
STAT,1847,45,na,1892,3463.7173223937066
SIM,1898,16,15-19,1914,16
STAT,1924,32,40-44,1956,9.218241416129898
STAT,1883,81,na,1964,1604.6929376287155
STAT,1825,52,50-100,1877,0.03157092044338201
STAT,1868,17,40-44,1885,0.3578164057393715
SIM,1869,19,15-19,1888,12
STAT,1875,30,na,1905,5001.8647407225
SIM,1847,27,15-19,1874,1
STAT,1920,48,30-34,1968,0.19841948331245218
STAT,1817,79,na,1896,705.1353403775555
STAT,1861,48,15-19,1909,6.639540274066961E-4
STAT,1902,40,40-44,1942,0.4498579850520948
SIM,1822,42,20-24,1864,2
SIM,1862,64,na,1926,3140
SIM,1868,26,na,1894,4581
SIM,1874,44,35-39,1918,7
STAT,1782,76,na,1858,709.0947441910206
STAT,1834,54,40-44,1888,0.013811012924436632
SIM,1867,34,50-100,1901,5
STAT,1866,50,20-24,1916,0.0013948585454120665
STAT,1871,38,30-34,1909,10.640836227597555
STAT,1888,42,20-24,1930,0.3786303196132327
STAT,1832,46,na,1878,3178.2064246233763
SIM,1889,22,50-100,1911,1
STAT,1843,31,35-39,1874,17.2325164804385
SIM,1871,22,35-39,1893,16
STAT,1831,30,50-100,1861,1.579273210424621
STAT,1914,31,20-24,1945,4.979812799208441
STAT,1846,19,50-100,1865,0.09315984281725455
STAT,1911,30,40-44,1941,7.760205425964761
STAT,1830,52,20-24,1882,0.0011202599162743263
STAT,1811,51,50-100,1862,0.09977993647639508
SIM,1776,90,na,1866,44
STAT,1848,20,45-49,1868,1.4124200303319998
STAT,1894,49,50-100,1943,0.35192024444087644
STAT,1932,22,25-29,1954,244.78982485559308
STAT,1925,45,40-44,1970,0.3875835520877107
STAT,1915,18,40-44,1933,0.5897295881072795
STAT,1918,19,20-24,1937,296.3775824981813
SIM,1806,50,na,1856,2681
SIM,1874,23,15-19,1897,8
STAT,1857,25,50-100,1882,1.052284087042914
SIM,1910,32,40-44,1942,11
STAT,1874,14,na,1888,5357.155531186225
STAT,1833,105,na,1938,0.0385457693447128
SIM,1914,25,35-39,1939,45
STAT,1929,38,35-39,1967,6.264509772536248
SIM,1865,61,na,1926,3449
SIM,1896,22,40-44,1918,5
STAT,1920,41,45-49,1961,0.3716779187683309
STAT,1840,65,na,1905,2439.3600818807495
STAT,1921,29,20-24,1950,40.78369460358521
STAT,1844,79,na,1923,1128.9948756437484
STAT,1911,43,45-49,1954,0.3189798993528454
SIM,1931,22,30-34,1953,94
STAT,1868,31,50-100,1899,1.76778489507655
STAT,1888,22,40-44,1910,4.974187410094732
SIM,1795,61,na,1856,1903
SIM,1923,18,40-44,1941,3
STAT,1866,23,15-19,1889,6.1533600547020635
STAT,1915,23,35-39,1938,19.598067408145504
STAT,1923,20,na,1943,8629.840071877055
STAT,1839,22,45-49,1861,1.3990015749096283
STAT,1946,17,na,1963,8244.427464530454
STAT,1931,41,20-24,1972,0.04771913858332941
STAT,1885,24,50-100,1909,0.8146475394069239
STAT,1912,39,50-100,1951,0.8194997754212432
SIM,1842,13,na,1855,4447
STAT,1896,30,50-100,1926,2.462741089333721
SIM,1884,44,na,1928,4890
STAT,1912,36,15-19,1948,0.038045639854713265
SIM,1922,23,na,1945,8850
SIM,1879,25,45-49,1904,2
STAT,1847,12,na,1859,4541.78772502607
STAT,1941,20,25-29,1961,192.92698741737476
STAT,1875,21,15-19,1896,6.880541238809914
SIM,1876,25,na,1901,5141
SIM,1899,23,20-24,1922,184
SIM,1907,22,40-44,1929,9
SIM,1931,24,25-29,1955,258
STAT,1921,34,15-19,1955,0.28627486740670544
SIM,1894,74,na,1968,3593
STAT,1902,32,40-44,1934,12.365479962313064
SIM,1905,32,30-34,1937,48
SIM,1940,30,50-100,1970,3
SIM,1940,22,25-29,1962,218
STAT,1934,38,45-49,1972,1.8983174984797437
SIM,1829,31,40-44,1860,9
STAT,1862,48,30-34,1910,0.16499670964930613
STAT,1927,17,20-24,1944,340.3989280883568
STAT,1923,42,25-29,1965,0.16850913849579358
STAT,1910,29,45-49,1939,3.3464152154685882
SIM,1888,58,na,1946,4600
SIM,1926,19,20-24,1945,381
SIM,1859,77,na,1936,1301
STAT,1921,41,na,1962,8458.351372534915
SIM,1867,96,na,1963,40
SIM,1904,35,20-24,1939,1
STAT,1917,36,na,1953,7929.33386505609
STAT,1897,15,45-49,1912,0.1771667085959143
STAT,1867,15,30-34,1882,3.11853954942483
STAT,1917,46,45-49,1963,0.4595785529723736
SIM,1901,61,na,1962,5616
STAT,1927,40,45-49,1967,0.4226556211397939
SIM,1935,17,20-24,1952,342
STAT,1931,19,35-39,1950,11.033350188795866
SIM,1855,21,40-44,1876,6
SIM,1901,1,na,1902,7656
SIM,1922,26,25-29,1948,163
STAT,1859,20,20-24,1879,128.13444669159358
STAT,1904,25,50-100,1929,1.8668819236848848
SIM,1933,17,50-100,1950,1
STAT,1930,27,20-24,1957,46.87621879855456
SIM,1907,40,40-44,1947,1
SIM,1808,48,50-100,1856,1
SIM,1916,39,na,1955,7808
STAT,1814,49,na,1863,2576.510672167308
SIM,1838,24,45-49,1862,3
SIM,1852,43,na,1895,3734
STAT,1914,20,50-100,1934,1.3108219028039023
STAT,1907,19,45-49,1926,0.19286101558121801
SIM,1892,63,na,1955,5078
STAT,1924,16,40-44,1940,3.371295168833114
SIM,1922,24,30-34,1946,71
SIM,1818,43,50-100,1861,4
SIM,1856,20,45-49,1876,4
SIM,1808,85,na,1893,186
SIM,1905,27,35-39,1932,38
STAT,1846,30,35-39,1876,18.715652258087353
STAT,1923,45,50-100,1968,0.5367156610693407
STAT,1903,31,45-49,1934,5.0349618105582685
SIM,1932,16,40-44,1948,4
STAT,1857,25,15-19,1882,0.7463336619527915
SIM,1922,31,20-24,1953,8
SIM,1884,64,na,1948,3675
STAT,1855,31,na,1886,3702.1573427264884
STAT,1897,62,na,1959,5122.931742103957
SIM,1833,52,na,1885,2883
SIM,1850,27,50-100,1877,1
SIM,1869,33,35-39,1902,31
STAT,1829,27,50-100,1856,1.8536951140349496
STAT,1942,23,na,1965,7730.47702090339
SIM,1797,72,na,1869,1077
SIM,1939,28,45-49,1967,6
SIM,1905,34,25-29,1939,23
SIM,1911,31,45-49,1942,6
STAT,1950,22,na,1972,8748.754912093753
STAT,1944,14,na,1958,8533.823175238524
SIM,1923,23,35-39,1946,26
STAT,1880,46,25-29,1926,0.1228961416850148
STAT,1915,30,25-29,1945,19.165575755326053
SIM,1867,20,20-24,1887,142
STAT,1932,15,35-39,1947,11.274646795563383
SIM,1940,15,35-39,1955,10
STAT,1929,37,na,1966,9753.876853539954
STAT,1867,20,50-100,1887,0.7857247630777076
STAT,1900,37,35-39,1937,4.277038326143266
STAT,1943,18,15-19,1961,97.1614015019106
SIM,1829,47,na,1876,3077
SIM,1825,33,na,1858,3155
STAT,1916,47,40-44,1963,0.3265934003567735
STAT,1852,98,na,1950,5.177558184575487
STAT,1920,23,45-49,1943,2.5179085426062033
STAT,1909,26,15-19,1935,1.3796118789896374
SIM,1860,100,na,1960,4
STAT,1811,47,15-19,1858,0.0027153659228689037
STAT,1928,39,30-34,1967,4.641291799143558
STAT,1863,22,35-39,1885,10.522146811122845
STAT,1905,29,35-39,1934,27.980978692107957
STAT,1859,16,35-39,1875,1.029934600302201
SIM,1910,27,45-49,1937,3
SIM,1951,18,15-19,1969,110
SIM,1906,30,25-29,1936,18
STAT,1890,48,35-39,1938,0.19223132532189663
STAT,1895,30,30-34,1925,46.3168584302951
STAT,1877,42,na,1919,4841.067931141314
SIM,1862,33,na,1895,4433
STAT,1826,50,na,1876,2944.685208533485
STAT,1889,75,na,1964,3159.3572363634685
STAT,1849,47,na,1896,3542.2029208293175
STAT,1908,15,45-49,1923,0.1967395215391255
STAT,1899,22,15-19,1921,9.128856941896956
STAT,1878,30,30-34,1908,37.12382083739545
STAT,1908,43,na,1951,6902.545835716032
STAT,1800,69,na,1869,1496.25638446069
STAT,1852,48,15-19,1900,6.2951305092827E-4
SIM,1910,22,na,1932,7529
STAT,1925,15,45-49,1940,1.2241383956865481
STAT,1847,41,50-100,1888,1.6402557878811876
SIM,1876,45,na,1921,4932
SIM,1858,18,35-39,1876,1
STAT,1761,112,na,1873,1.1820090851548168E-4
SIM,1837,30,35-39,1867,31
SIM,1849,67,na,1916,2487
SIM,1930,25,20-24,1955,55
STAT,1889,23,na,1912,5871.323116209661
STAT,1914,26,25-29,1940,134.49154888659425
SIM,1923,30,25-29,1953,29
SIM,1902,15,15-19,1917,17
SIM,1821,51,na,1872,2698
SIM,1886,30,30-34,1916,42
STAT,1899,18,30-34,1917,4.398902365702308
SIM,1898,24,15-19,1922,8
STAT,1918,42,45-49,1960,0.3573123475650205
STAT,1919,18,25-29,1937,96.44378552927895
SIM,1904,28,30-34,1932,89
STAT,1807,91,na,1898,46.25437808080155
STAT,1847,21,40-44,1868,3.922163174721593
SIM,1913,29,35-39,1942,33
STAT,1874,1,na,1875,7188.989252020603
STAT,1940,17,35-39,1957,8.605223040039093
SIM,1934,28,50-100,1962,3
STAT,1897,42,na,1939,6253.359849461399
STAT,1825,88,na,1913,158.84201696863067
STAT,1832,78,na,1910,1018.6374094377893
SIM,1940,19,50-100,1959,1
STAT,1775,108,na,1883,0.007575768400237921
SIM,1929,36,35-39,1965,10
STAT,1832,41,50-100,1873,1.7068395169279884
SIM,1866,24,20-24,1890,134
SIM,1933,15,45-49,1948,1
SIM,1867,16,35-39,1883,1
STAT,1840,97,na,1937,7.754511275968074
STAT,1822,68,na,1890,1725.4623843847717
SIM,1793,90,na,1883,27
STAT,1903,8,na,1911,7475.157398163899
SIM,1889,16,15-19,1905,12
STAT,1885,61,na,1946,3756.51095308693
SIM,1807,99,na,1906,2
SIM,1853,72,na,1925,1935
SIM,1817,46,na,1863,2951
STAT,1883,15,15-19,1898,11.830483038005342
STAT,1933,32,40-44,1965,10.652018115447566
STAT,1858,24,20-24,1882,111.66057049828076
STAT,1904,37,20-24,1941,0.48229509691098793
STAT,1913,35,20-24,1948,0.5305178275812261
STAT,1926,41,40-44,1967,0.6235456370699013
STAT,1839,22,50-100,1861,0.8181296071436219
SIM,1901,34,40-44,1935,8
STAT,1903,38,15-19,1941,0.0346802926293347
SIM,1828,40,35-39,1868,5
SIM,1872,21,40-44,1893,4
SIM,1899,19,35-39,1918,1
STAT,1886,41,50-100,1927,2.262485850030205
SIM,1922,27,35-39,1949,51
SIM,1785,71,na,1856,952
STAT,1920,38,15-19,1958,0.04241070359428208
STAT,1844,49,50-100,1893,0.3883417008484292
SIM,1890,43,50-100,1933,7
STAT,1795,105,na,1900,0.012530536466845626
STAT,1908,23,50-100,1931,1.2187331311770147
STAT,1914,27,35-39,1941,30.57252388051421
STAT,1784,89,na,1873,60.608905312279546
SIM,1911,41,45-49,1952,1
STAT,1780,75,na,1855,724.01772
SIM,1926,42,45-49,1968,1
SIM,1858,25,25-29,1883,85
STAT,1909,17,na,1926,7653.560242262837
SIM,1878,31,35-39,1909,27
STAT,1923,22,30-34,1945,67.5177706122374
STAT,1870,36,15-19,1906,0.11188070389524514
STAT,1913,28,30-34,1941,78.59183372135756
STAT,1935,21,na,1956,10048.42075423125
STAT,1864,21,40-44,1885,3.850058076290206
SIM,1866,21,15-19,1887,8
SIM,1921,28,30-34,1949,107
SIM,1866,17,30-34,1883,3
STAT,1813,87,na,1900,156.55439272797605
STAT,1923,24,25-29,1947,215.63209348504176
SIM,1836,80,na,1916,674
STAT,1913,32,15-19,1945,0.258278275440767
SIM,1918,18,na,1936,8230
STAT,1808,96,na,1904,6.747403419922579
STAT,1835,24,50-100,1859,0.6923226174223984
STAT,1871,53,20-24,1924,0.0014568729651487236
SIM,1835,31,na,1866,3642
STAT,1860,45,45-49,1905,0.3909183664497854
STAT,1849,31,15-19,1880,0.2635666563327177
STAT,1858,17,30-34,1875,2.9313327756635177
SIM,1883,70,na,1953,2789
STAT,1792,76,na,1868,747.9798605979055
STAT,1854,53,20-24,1907,0.0011130580650925313
STAT,1922,25,20-24,1947,41.987746236311885
STAT,1858,83,na,1941,625.0235993646254
STAT,1911,28,50-100,1939,1.9540732960675347
STAT,1859,21,30-34,1880,32.88198582801027
SIM,1840,54,na,1894,3268
STAT,1908,48,45-49,1956,0.39612516202179293
STAT,1893,38,50-100,1931,3.1272831076274454
SIM,1930,22,na,1952,9945
STAT,1860,50,40-44,1910,0.0175143400246677
STAT,1810,54,45-49,1864,0.08615318884627125
SIM,1816,40,na,1856,3049
STAT,1923,17,35-39,1940,9.948031809552921
SIM,1901,29,45-49,1930,3
STAT,1940,24,25-29,1964,189.9228439819922
SIM,1906,26,40-44,1932,12
SIM,1931,17,35-39,1948,13
STAT,1892,43,na,1935,5801.285883648668
STAT,1904,29,20-24,1933,33.76337349398177
SIM,1898,24,na,1922,6661
STAT,1939,2,na,1941,8250.982929280026
STAT,1813,52,20-24,1865,0.00433915872659231
STAT,1896,57,na,1953,5358.536985365745
SIM,1936,15,na,1951,6407
SIM,1867,21,30-34,1888,44
SIM,1910,35,45-49,1945,6
STAT,1922,18,30-34,1940,28.406947976375722
STAT,1926,17,na,1943,9112.570939822805
STAT,1867,12,na,1879,5072.494800151799
SIM,1903,36,15-19,1939,2
SIM,1783,92,na,1875,13
SIM,1872,63,na,1935,3655
STAT,1852,16,50-100,1868,0.09499888894555748
SIM,1847,32,na,1879,3801
STAT,1932,18,40-44,1950,3.7310343609036503
SIM,1948,23,40-44,1971,14
STAT,1910,17,50-100,1927,0.14998520296670972
SIM,1854,22,35-39,1876,18
STAT,1927,39,50-100,1966,1.0518481035898588
SIM,1907,25,45-49,1932,4
STAT,1931,31,20-24,1962,6.458894124916845
SIM,1913,34,30-34,1947,42
STAT,1848,35,15-19,1883,0.09687837177333926
STAT,1947,18,50-100,1965,0.8520229501544623
SIM,1870,20,na,1890,4642
SIM,1930,18,30-34,1948,42
STAT,1837,46,na,1883,3297.016235227623
STAT,1833,32,na,1865,3667.5249143576684
STAT,1868,21,25-29,1889,110.79445770418124
STAT,1858,21,15-19,1879,6.002531002371376
SIM,1940,18,40-44,1958,3
STAT,1915,22,25-29,1937,192.85144817808603
STAT,1915,48,35-39,1963,0.26167588458804186
STAT,1845,96,na,1941,13.231486959717582
STAT,1841,82,na,1923,676.9783875258111
STAT,1896,4,na,1900,7014.540269846127
SIM,1883,27,na,1910,4912
SIM,1923,22,25-29,1945,239
STAT,1881,47,na,1928,4371.396916390246
SIM,1906,49,na,1955,6468
STAT,1941,30,25-29,1971,19.621444053865716
STAT,1834,20,15-19,1854,11.10874397479154
STAT,1846,22,35-39,1868,11.028575733069719
STAT,1799,102,na,1901,0.19937710189825714
STAT,1902,35,45-49,1937,1.2385192201154922
SIM,1879,10,na,1889,5419
SIM,1875,51,na,1926,4875
SIM,1913,42,na,1955,7420
STAT,1830,99,na,1929,2.61520902530899
SIM,1879,22,40-44,1901,4
SIM,1824,101,na,1925,1
SIM,1842,20,15-19,1862,6
STAT,1933,10,na,1943,10745.763285248657
SIM,1905,31,20-24,1936,6
STAT,1779,98,na,1877,0.9887479621852671
STAT,1923,25,35-39,1948,35.03754756358503
STAT,1919,49,30-34,1968,0.19409330177199996
SIM,1907,47,40-44,1954,1
STAT,1854,32,35-39,1886,15.898192574145758
STAT,1938,33,30-34,1971,31.97991565847744
STAT,1901,33,35-39,1934,28.512121406116048
STAT,1805,68,na,1873,1641.9062688329425
STAT,1878,15,35-39,1893,1.1627699839556453
STAT,1883,38,na,1921,4651.715248069648
STAT,1880,43,20-24,1923,0.3354455055646142
STAT,1854,44,50-100,1898,1.597666726964888
STAT,1876,20,20-24,1896,144.80741251138852
SIM,1931,25,35-39,1956,51
STAT,1911,40,40-44,1951,0.4877502432014345
SIM,1876,77,na,1953,1833
STAT,1819,42,50-100,1861,4.8912231440546305
SIM,1895,31,35-39,1926,43
SIM,1939,25,40-44,1964,22
STAT,1917,43,40-44,1960,0.5262970092652399
SIM,1856,17,15-19,1873,9
STAT,1881,16,na,1897,4942.297064837219
STAT,1826,39,50-100,1865,2.720260874513789
SIM,1928,37,30-34,1965,3
STAT,1838,63,na,1901,2414.8186746353695
STAT,1863,3,na,1866,5699.645696477314
SIM,1929,39,40-44,1968,5
STAT,1884,15,30-34,1899,3.193375038906074
SIM,1919,39,30-34,1958,7
STAT,1874,25,15-19,1899,0.9445833824146532
STAT,1932,4,na,1936,10794.711849035768
STAT,1923,21,20-24,1944,262.00264085952426
SIM,1912,57,na,1969,6984
SIM,1865,1,na,1866,6464
STAT,1887,31,35-39,1918,22.968423995274083
STAT,1914,19,35-39,1933,1.7439339449768374
STAT,1898,68,na,1966,4725.504117806746
SIM,1818,83,na,1901,314
STAT,1924,19,45-49,1943,1.1946426472528853
STAT,1801,53,40-44,1854,0.06463464407499456
SIM,1858,30,20-24,1888,6
SIM,1866,79,na,1945,1298
SIM,1899,10,na,1909,7280
STAT,1848,17,15-19,1865,12.062923676054066
STAT,1905,41,20-24,1946,0.0323570016764881
STAT,1930,19,20-24,1949,352.092329886302
SIM,1857,9,na,1866,5072
SIM,1934,2,na,1936,11006
STAT,1848,52,50-100,1900,0.024632255799818783
SIM,1904,38,25-29,1942,3
STAT,1961,0,na,1961,10333.138573698629
SIM,1931,21,20-24,1952,273
STAT,1885,47,15-19,1932,8.003689569627811E-4
SIM,1854,30,50-100,1884,2
STAT,1862,13,na,1875,4698.1876217674
SIM,1933,37,40-44,1970,6
STAT,1902,17,15-19,1919,16.92145859671808
SIM,1938,26,50-100,1964,2
STAT,1910,34,40-44,1944,7.558129048549934
STAT,1875,95,na,1970,135.4034098940291
STAT,1902,27,45-49,1929,3.16585855018868
SIM,1788,91,na,1879,20
STAT,1907,24,40-44,1931,6.146777456778651
STAT,1781,92,na,1873,21.543564381663643
STAT,1931,16,30-34,1947,32.301194095542165
STAT,1860,65,na,1925,2771.67851059331
SIM,1858,23,30-34,1881,43
STAT,1916,19,na,1935,8231.490721524786
STAT,1846,30,50-100,1876,1.693297262600429
STAT,1911,1,na,1912,8414.703623758624
STAT,1921,26,15-19,1947,1.5940759035719447
SIM,1829,34,45-49,1863,5
STAT,1907,42,40-44,1949,0.46307055095576316
STAT,1838,31,40-44,1869,7.369380324986931
STAT,1953,15,20-24,1968,331.373324742854
STAT,1867,18,35-39,1885,1.0547366461045533
STAT,1846,50,na,1896,3345.420640565808
SIM,1910,17,15-19,1927,16
SIM,1881,48,35-39,1929,2
STAT,1899,25,20-24,1924,32.682789069556975
STAT,1836,34,50-100,1870,1.5085480921038905
SIM,1896,25,45-49,1921,3
SIM,1879,30,40-44,1909,12
STAT,1769,88,na,1857,57.24695307855602
SIM,1896,45,na,1941,6380
SIM,1857,42,na,1899,4071
STAT,1835,98,na,1933,4.207321658214959
SIM,1838,21,40-44,1859,5
SIM,1817,66,na,1883,1809
STAT,1888,25,45-49,1913,2.6683468163446853
SIM,1813,52,na,1865,2655
SIM,1846,31,40-44,1877,14
SIM,1909,47,50-100,1956,1
STAT,1905,34,30-34,1939,29.031207758576357
STAT,1864,79,na,1943,1262.101345825637
SIM,1932,19,45-49,1951,4
SIM,1922,19,35-39,1941,11
SIM,1859,97,na,1956,7
SIM,1905,24,30-34,1929,66
SIM,1915,24,40-44,1939,10
SIM,1875,18,35-39,1893,1
SIM,1924,17,45-49,1941,2
SIM,1824,79,na,1903,792
STAT,1828,42,35-39,1870,3.409589590486973
SIM,1917,18,15-19,1935,1
SIM,1930,28,25-29,1958,182
SIM,1897,21,45-49,1918,2
STAT,1893,49,15-19,1942,5.655335688383873E-4
SIM,1854,30,35-39,1884,29
STAT,1951,20,40-44,1971,8.118073607694377
SIM,1913,26,30-34,1939,96
STAT,1915,15,35-39,1930,1.7820776137779324
STAT,1818,86,na,1904,227.632302193585
STAT,1931,23,20-24,1954,290.37415601226394
SIM,1836,42,35-39,1878,6
SIM,1838,19,20-24,1857,33
SIM,1906,29,45-49,1935,4
STAT,1881,27,na,1908,4658.687330477114
STAT,1836,35,50-100,1871,2.046176754612153
SIM,1893,25,na,1918,6303
STAT,1901,40,25-29,1941,0.1273522155542666
SIM,1931,16,na,1947,9767
SIM,1909,27,20-24,1936,42
STAT,1821,47,30-34,1868,0.28332835704404846
STAT,1938,18,na,1956,7331.797453488876
SIM,1844,35,50-100,1879,2
STAT,1916,17,45-49,1933,0.21404791416454236
SIM,1847,96,na,1943,12
STAT,1809,82,na,1891,414.70497622161434
STAT,1909,18,15-19,1927,17.93685870674717
SIM,1858,15,30-34,1873,4
SIM,1818,51,na,1869,2724
STAT,1857,97,na,1954,8.456967327960808
STAT,1931,24,30-34,1955,74.81631715623529
SIM,1887,32,40-44,1919,13
SIM,1800,89,na,1889,41
STAT,1853,83,na,1936,628.1134018340838
STAT,1889,36,15-19,1925,0.1405109821856277
SIM,1925,46,45-49,1971,1
STAT,1935,16,15-19,1951,125.63180048566916
STAT,1937,29,30-34,1966,77.07815669421866
STAT,1957,15,40-44,1972,3.725824014394156
SIM,1871,2,na,1873,6126
SIM,1902,25,45-49,1927,4
SIM,1760,95,na,1855,2
SIM,1860,43,45-49,1903,7
SIM,1943,16,15-19,1959,92
SIM,1923,15,35-39,1938,11
STAT,1928,43,15-19,1971,0.0039470027933387174
STAT,1860,53,45-49,1913,0.023419401554092764
STAT,1863,50,na,1913,3861.288854302712
SIM,1914,28,40-44,1942,12
STAT,1855,11,na,1866,4301.126932227087
STAT,1779,104,na,1883,0.057147797077884505
STAT,1889,21,45-49,1910,1.7417357141088619
STAT,1905,26,30-34,1931,73.80321279119961
STAT,1844,46,15-19,1890,6.477990814194598E-4
STAT,1858,25,30-34,1883,41.1754534014519
STAT,1844,102,na,1946,0.473452401874045
STAT,1909,44,45-49,1953,0.3106960562746905
SIM,1840,102,na,1942,2
STAT,1869,23,na,1892,4613.955805479245
STAT,1860,103,na,1963,0.9087223276626133
SIM,1841,16,na,1857,4308
SIM,1878,0,na,1878,7579
STAT,1857,66,na,1923,2580.1247438916894
STAT,1920,15,45-49,1935,0.22809588029071814
SIM,1900,31,40-44,1931,23
SIM,1902,36,50-100,1938,3
STAT,1906,28,40-44,1934,8.784745886707265
SIM,1862,32,35-39,1894,22
STAT,1778,93,na,1871,14.081543514732623
STAT,1911,31,na,1942,7470.485769999096
STAT,1940,16,25-29,1956,88.8943083920104
SIM,1889,43,na,1932,5811
SIM,1870,52,na,1922,4166
STAT,1887,23,35-39,1910,13.14040990557261
STAT,1881,47,30-34,1928,0.1880805196146729
SIM,1922,18,25-29,1940,123
SIM,1935,25,20-24,1960,6
SIM,1824,40,50-100,1864,5
STAT,1915,40,25-29,1955,0.14561137691444512
SIM,1855,24,45-49,1879,2
SIM,1892,5,na,1897,7507
SIM,1905,55,na,1960,6424
STAT,1913,36,30-34,1949,3.6509318110254734
STAT,1915,31,50-100,1946,1.7077235762118783
STAT,1917,28,15-19,1945,1.4898267756953287
STAT,1875,31,na,1906,4982.2574309388665
STAT,1843,30,na,1873,3726.354646731763
STAT,1879,32,40-44,1911,9.161214352363586
STAT,1903,46,15-19,1949,6.506642460617814E-4
STAT,1781,110,na,1891,0.0024603177477319697
STAT,1925,30,40-44,1955,9.39398591593028
STAT,1933,22,40-44,1955,9.008451174594692
STAT,1919,15,20-24,1934,60.97631874968124
STAT,1936,23,50-100,1959,1.270328991597741
SIM,1877,62,na,1939,3612
STAT,1791,109,na,1900,2.8076613051314565E-4
STAT,1847,24,45-49,1871,1.2844358980069364
SIM,1889,26,15-19,1915,1
SIM,1828,32,35-39,1860,27
SIM,1866,25,30-34,1891,57
SIM,1905,35,35-39,1940,6
STAT,1910,26,40-44,1936,9.124725653409644
SIM,1872,29,50-100,1901,3
STAT,1850,51,50-100,1901,0.023267384665518698
STAT,1919,48,20-24,1967,0.02413573341898409
SIM,1921,36,30-34,1957,4
SIM,1923,40,na,1963,9180
STAT,1839,57,na,1896,3137.8948080314844
STAT,1833,52,50-100,1885,0.020496682387747676
SIM,1944,23,50-100,1967,1
STAT,1897,20,40-44,1917,5.6591028646582355
SIM,1899,16,30-34,1915,9
STAT,1923,32,25-29,1955,21.392557336360202
SIM,1876,21,25-29,1897,123
STAT,1949,16,45-49,1965,1.1736127184127634
SIM,1925,28,15-19,1953,2
SIM,1931,32,25-29,1963,28
STAT,1935,34,45-49,1969,4.391917424865524
SIM,1898,2,na,1900,7471
SIM,1912,29,20-24,1941,42
STAT,1914,18,25-29,1932,18.05993532581729
STAT,1927,25,20-24,1952,45.115607628462996
STAT,1903,44,na,1947,6579.0469427392945
STAT,1887,32,na,1919,5390.181920025865
SIM,1920,39,20-24,1959,1
STAT,1821,54,20-24,1875,0.001996441546030403
STAT,1817,69,na,1886,1652.4978496620042
SIM,1897,18,15-19,1915,15
STAT,1912,39,20-24,1951,0.5145300048225252
STAT,1922,28,25-29,1950,149.85040359967746
STAT,1889,18,15-19,1907,14.73969386513061
STAT,1905,33,20-24,1938,4.514202549464912
SIM,1927,15,20-24,1942,351
SIM,1933,30,40-44,1963,14
STAT,1898,47,50-100,1945,0.376873606188525
STAT,1872,20,35-39,1892,11.91518138148621
SIM,1895,23,35-39,1918,24
SIM,1923,48,35-39,1971,1
STAT,1929,37,25-29,1966,2.552692614790505
SIM,1858,22,20-24,1880,119
STAT,1895,33,35-39,1928,26.538230349445477
STAT,1939,27,40-44,1966,9.464515192588268
STAT,1889,22,50-100,1911,1.0154930735524867
SIM,1913,33,20-24,1946,8
SIM,1935,10,na,1945,11271
SIM,1883,21,15-19,1904,7
STAT,1878,41,35-39,1919,3.836833301866545
STAT,1908,38,15-19,1946,0.036155603591899024
SIM,1784,77,na,1861,550
STAT,1858,32,20-24,1890,4.255745216849335
STAT,1864,29,50-100,1893,1.1465888637905568
STAT,1911,48,15-19,1959,7.02562444974623E-4
STAT,1851,20,15-19,1871,6.19587393960351
STAT,1838,34,45-49,1872,2.8723896649691016
SIM,1877,43,35-39,1920,12
STAT,1882,64,na,1946,3420.040563755512
STAT,1893,28,na,1921,6087.704043209009
SIM,1883,79,na,1962,1953
SIM,1902,18,20-24,1920,47
STAT,1842,36,na,1878,3779.689672499366
SIM,1930,36,25-29,1966,4
STAT,1922,22,15-19,1944,12.325376375491615
STAT,1915,45,30-34,1960,0.18228850508564992
STAT,1901,44,40-44,1945,0.4356579752810689
STAT,1823,49,35-39,1872,0.4204443136707578
STAT,1905,18,30-34,1923,4.643146053056909
STAT,1924,42,40-44,1966,0.6007028187001228
STAT,1933,19,na,1952,9898.798296082507
SIM,1924,25,45-49,1949,7
STAT,1953,7,na,1960,9602.13211436924
STAT,1931,15,20-24,1946,360.0695441401867
SIM,1837,22,35-39,1859,11
STAT,1819,48,na,1867,2784.344720462084
SIM,1917,36,45-49,1953,3
STAT,1876,21,30-34,1897,37.31969325247448
SIM,1871,49,50-100,1920,2
SIM,1904,39,35-39,1943,6
STAT,1872,49,30-34,1921,0.19237655234827317
STAT,1785,74,na,1859,939.6497819391129
STAT,1927,43,20-24,1970,0.04465445850869402
SIM,1858,26,35-39,1884,24
STAT,1789,88,na,1877,96.24791976789683
STAT,1922,36,25-29,1958,2.264142365987272
SIM,1941,22,40-44,1963,8
SIM,1913,18,30-34,1931,4
STAT,1876,23,25-29,1899,119.20855680715646
SIM,1857,11,na,1868,5005
SIM,1850,52,na,1902,3439
SIM,1842,16,30-34,1858,5
SIM,1900,32,30-34,1932,71
SIM,1930,17,20-24,1947,343
STAT,1905,37,35-39,1942,4.458945426850212
SIM,1889,20,na,1909,6055
SIM,1906,40,na,1946,6882
SIM,1921,24,15-19,1945,13
SIM,1900,46,40-44,1946,1
STAT,1835,48,15-19,1883,5.393641339764853E-4
STAT,1773,108,na,1881,0.009348817607724415
STAT,1872,43,na,1915,4657.328665670964
STAT,1876,57,na,1933,4197.837271890032
SIM,1822,49,40-44,1871,1
SIM,1829,78,na,1907,923
STAT,1931,34,25-29,1965,24.42871894720986
SIM,1859,13,na,1872,4952
SIM,1928,36,20-24,1964,5
STAT,1837,102,na,1939,0.40861425947091357
STAT,1922,17,20-24,1939,316.79909820541695
STAT,1793,70,na,1863,1295.4419933773997
STAT,1910,30,25-29,1940,18.149927582357712
SIM,1822,33,50-100,1855,3
STAT,1860,42,40-44,1902,3.684456932663444
STAT,1925,17,50-100,1942,0.9138578797782677
SIM,1906,20,30-34,1926,77
SIM,1923,31,50-100,1954,3
SIM,1930,22,15-19,1952,13
STAT,1911,17,45-49,1928,0.2019458054727011
STAT,1933,36,35-39,1969,6.660406904857792
STAT,1814,49,40-44,1863,0.8597362036708153
SIM,1942,28,15-19,1970,2
SIM,1906,34,40-44,1940,11
SIM,1816,49,na,1865,2778
SIM,1948,15,50-100,1963,1
STAT,1872,21,50-100,1893,0.8302076373546258
SIM,1803,86,na,1889,170
SIM,1812,46,na,1858,2866
SIM,1838,51,na,1889,3001
SIM,1876,22,35-39,1898,13
SIM,1852,66,na,1918,2592
SIM,1947,24,35-39,1971,28
STAT,1825,44,na,1869,3082.646492677587
SIM,1932,24,40-44,1956,11
STAT,1907,46,35-39,1953,0.23508205418080994
STAT,1923,16,25-29,1939,102.98944005229487
STAT,1910,25,na,1935,7355.741115084625
SIM,1915,20,25-29,1935,207
STAT,1877,15,40-44,1892,0.38535880226430536
STAT,1905,0,na,1905,8576.394865835022
STAT,1934,28,15-19,1962,1.9173508883683885
STAT,1833,63,na,1896,2345.695973488958
SIM,1884,46,50-100,1930,1
SIM,1899,27,35-39,1926,37
STAT,1829,58,na,1887,2388.316206711905
STAT,1843,53,45-49,1896,0.02000283887107768
STAT,1857,29,30-34,1886,40.246894868580526
STAT,1924,43,30-34,1967,0.30655101241741745
STAT,1849,34,20-24,1883,4.41291093996712
STAT,1880,22,35-39,1902,12.415409921103057
SIM,1858,33,25-29,1891,19
STAT,1953,8,na,1961,9600.883837194373
SIM,1912,38,30-34,1950,5
SIM,1905,19,35-39,1924,2
STAT,1861,38,15-19,1899,0.09392808412337063
STAT,1941,18,50-100,1959,0.7791583407341448
STAT,1927,32,45-49,1959,3.9087483665295046
STAT,1932,30,50-100,1962,2.222449170667672
STAT,1868,22,35-39,1890,11.213028955301095
STAT,1844,15,na,1859,4768.162491320044
STAT,1850,32,na,1882,3827.5327970444027
SIM,1827,99,na,1926,3
SIM,1922,20,50-100,1942,2
STAT,1886,40,30-34,1926,2.4757583885685173
STAT,1914,39,na,1953,7511.2901581154065
SIM,1880,49,30-34,1929,1
SIM,1845,40,35-39,1885,7
STAT,1867,25,25-29,1892,80.55276175910558
SIM,1865,29,30-34,1894,51
STAT,1910,46,na,1956,6942.314441548183
SIM,1898,28,30-34,1926,74
SIM,1846,34,45-49,1880,4
STAT,1840,46,30-34,1886,0.14271834195580466
STAT,1884,76,na,1960,2215.6987485347763
STAT,1939,24,35-39,1963,19.08719829516651
STAT,1806,85,na,1891,186.66241196468076
SIM,1931,16,25-29,1947,151
STAT,1905,44,25-29,1949,0.12848743142163618
SIM,1900,0,na,1900,7977
SIM,1879,33,45-49,1912,5
STAT,1880,62,na,1942,3888.6314495503743
SIM,1919,43,50-100,1962,1
STAT,1869,43,35-39,1912,3.5180545184458434
SIM,1867,32,na,1899,4954
SIM,1916,37,40-44,1953,2
SIM,1894,40,30-34,1934,5
STAT,1837,40,35-39,1877,3.0561650280554553
SIM,1875,39,na,1914,5202
STAT,1838,111,na,1949,1.4526024281276965E-4
STAT,1815,104,na,1919,0.0619976686136021
STAT,1870,46,15-19,1916,7.953820767111999E-4
STAT,1909,41,40-44,1950,0.4754707337611703
SIM,1913,37,35-39,1950,9
STAT,1802,71,na,1873,1343.6487956864307
SIM,1855,41,50-100,1896,4
STAT,1909,36,45-49,1945,1.3101797140246332
SIM,1888,39,50-100,1927,7
STAT,1904,45,20-24,1949,0.019817186602412416
STAT,1779,105,na,1884,0.035812809994797884
STAT,1942,15,45-49,1957,1.0549005900287511
SIM,1950,15,45-49,1965,1
STAT,1826,82,na,1908,558.5481832425925
SIM,1857,34,20-24,1891,4
STAT,1922,29,35-39,1951,34.05636811057651
SIM,1929,33,30-34,1962,52
STAT,1907,20,25-29,1927,170.93959354440804
SIM,1860,85,na,1945,447
STAT,1778,92,na,1870,23.002292650417566
STAT,1840,105,na,1945,0.0423226396107361
SIM,1930,29,35-39,1959,51
STAT,1910,23,35-39,1933,17.80971065840365
SIM,1864,99,na,1963,14
SIM,1832,67,na,1899,2036
STAT,1943,28,45-49,1971,3.7140455578667515
SIM,1857,27,30-34,1884,56
SIM,1861,47,na,1908,4283
STAT,1823,33,na,1856,3442.4361691472227
SIM,1948,15,40-44,1963,5
STAT,1868,0,na,1868,7234.005433069589
STAT,1873,48,35-39,1921,0.28367807556413943
STAT,1911,15,15-19,1926,18.4320219560004
STAT,1855,95,na,1950,20.048799356301622
STAT,1908,37,40-44,1945,2.8325427169286623
STAT,1925,41,25-29,1966,0.17482154960748042
SIM,1887,35,45-49,1922,9
STAT,1926,28,45-49,1954,4.1672083296918965
STAT,1840,39,40-44,1879,7.319830148552535
STAT,1875,24,20-24,1899,142.39626175507613
SIM,1917,41,40-44,1958,1
STAT,1831,52,na,1883,2882.3619412664375
STAT,1925,37,40-44,1962,3.6279399413034046
SIM,1826,31,50-100,1857,1
STAT,1848,43,15-19,1891,0.022480501864735603
STAT,1879,13,na,1892,5447.0354090878855
SIM,1820,34,na,1854,3250
STAT,1838,16,15-19,1854,10.672038464225308
STAT,1932,26,40-44,1958,12.336255010965774
SIM,1868,20,35-39,1888,17
SIM,1948,18,45-49,1966,3
STAT,1921,38,30-34,1959,4.104874375849443
SIM,1907,44,35-39,1951,1
SIM,1906,61,na,1967,5923
SIM,1927,30,45-49,1957,4
SIM,1930,34,50-100,1964,3
STAT,1878,27,na,1905,5033.895094369611
SIM,1940,26,40-44,1966,14
SIM,1824,48,na,1872,3149
SIM,1935,32,45-49,1967,4
STAT,1866,27,30-34,1893,46.92595951037119
SIM,1848,19,30-34,1867,5
SIM,1914,16,25-29,1930,1
SIM,1840,41,50-100,1881,4
SIM,1880,20,35-39,1900,15
SIM,1926,9,na,1935,10115
STAT,1920,27,50-100,1947,2.2046606220216383
STAT,1891,17,50-100,1908,0.12230244880960102
SIM,1943,8,na,1951,8657
STAT,1916,44,35-39,1960,0.4153704294339231
STAT,1936,30,45-49,1966,3.0909661283326413
SIM,1846,16,15-19,1862,10
STAT,1858,28,35-39,1886,15.439759708787031
STAT,1811,52,na,1863,2594.0331395621683
STAT,1937,34,50-100,1971,1.650228710379517
STAT,1838,62,na,1900,2473.5912015850304
STAT,1866,31,15-19,1897,0.2664582976690904
SIM,1883,58,na,1941,4029
STAT,1941,24,40-44,1965,7.013157190111083
STAT,1924,24,40-44,1948,7.960577789965496
STAT,1879,35,45-49,1914,4.251189271614203
STAT,1932,19,50-100,1951,0.9966356548960663
STAT,1943,25,50-100,1968,2.142709419435738
STAT,1829,47,na,1876,2906.47665203758
SIM,1895,60,na,1955,5137
STAT,1912,57,na,1969,6819.382893692343
STAT,1935,26,45-49,1961,4.759152618426427
STAT,1912,32,20-24,1944,4.848628420472131
STAT,1904,38,30-34,1942,3.318004276110389
SIM,1858,31,30-34,1889,44
STAT,1924,38,na,1962,8948.165638624261
SIM,1913,25,20-24,1938,42
SIM,1873,28,na,1901,5018
SIM,1920,32,20-24,1952,6
STAT,1847,76,na,1923,1444.1670258454915
SIM,1942,23,na,1965,7884
STAT,1919,30,45-49,1949,3.4555541061512574
SIM,1934,28,45-49,1962,9
SIM,1890,38,35-39,1928,31
SIM,1904,27,20-24,1931,35
SIM,1847,22,50-100,1869,2
SIM,1863,0,na,1863,6818
STAT,1862,44,15-19,1906,0.023516769385924213
STAT,1900,33,50-100,1933,2.5561433675596237
SIM,1821,82,na,1903,511
STAT,1868,47,15-19,1915,7.650266105209152E-4
SIM,1834,21,20-24,1855,125
STAT,1849,27,30-34,1876,47.2179108444716
STAT,1905,25,20-24,1930,34.497461060829224
STAT,1906,36,40-44,1942,2.794010972800025
STAT,1909,29,20-24,1938,34.999639215901134
SIM,1889,36,50-100,1925,6
SIM,1933,34,35-39,1967,31
STAT,1930,28,30-34,1958,100.57286222371118
SIM,1831,23,45-49,1854,1
SIM,1943,26,45-49,1969,3
SIM,1899,3,na,1902,7404
SIM,1845,84,na,1929,420
STAT,1848,51,50-100,1899,0.024882574499281548
SIM,1945,20,na,1965,8379
SIM,1849,98,na,1947,2
STAT,1846,81,na,1927,828.2939296516995
SIM,1849,21,15-19,1870,4
STAT,1945,20,45-49,1965,2.4920644525993336
SIM,1905,26,25-29,1931,140
SIM,1904,46,25-29,1950,1
STAT,1930,35,20-24,1965,0.6956282369642944
SIM,1838,32,45-49,1870,1
STAT,1877,20,35-39,1897,12.310943328391213
STAT,1878,28,na,1906,5016.17578363743
SIM,1825,85,na,1910,242
SIM,1849,28,35-39,1877,28
SIM,1840,47,35-39,1887,1
SIM,1837,66,na,1903,2117
SIM,1942,27,40-44,1969,12
STAT,1917,38,45-49,1955,1.4228370470310445
STAT,1853,29,na,1882,3923.640129854314
STAT,1812,53,15-19,1865,1.5982739394597691E-4
STAT,1916,25,45-49,1941,3.6320787041137286
STAT,1947,23,na,1970,8332.090744444311
STAT,1934,27,40-44,1961,12.665358528921363
SIM,1849,35,25-29,1884,9
SIM,1886,41,35-39,1927,9
SIM,1832,66,na,1898,2108
SIM,1846,42,50-100,1888,4
SIM,1917,29,20-24,1946,42
STAT,1889,44,15-19,1933,0.03392549510685953
STAT,1829,26,50-100,1855,2.331461022603725
SIM,1914,36,40-44,1950,1
SIM,1914,22,30-34,1936,75
STAT,1875,17,30-34,1892,3.314214939946015
SIM,1925,38,45-49,1963,3
SIM,1839,39,30-34,1878,14
STAT,1925,34,35-39,1959,21.883722589268153
SIM,1843,24,50-100,1867,4
STAT,1931,33,50-100,1964,2.1867203741460597
SIM,1884,39,20-24,1923,2
SIM,1925,20,na,1945,8923
SIM,1929,34,na,1963,9862
STAT,1799,87,na,1886,121.44445249484498
SIM,1922,15,20-24,1937,321
SIM,1908,38,45-49,1946,1
SIM,1851,26,na,1877,4073
SIM,1887,17,15-19,1904,15
STAT,1832,47,35-39,1879,0.21578978599077467
STAT,1857,41,15-19,1898,0.0218377570074917
STAT,1931,27,35-39,1958,39.14803890187764
STAT,1935,31,40-44,1966,10.942722422246256
SIM,1860,62,na,1922,3196
STAT,1831,48,30-34,1879,0.14624581010019194
STAT,1921,24,50-100,1945,1.4912140685848378
SIM,1833,28,50-100,1861,1
STAT,1862,44,na,1906,3935.8119555720114
SIM,1786,89,na,1875,74
SIM,1860,40,40-44,1900,6
STAT,1916,43,45-49,1959,0.34390608941932677
STAT,1876,16,35-39,1892,1.1489914630901468
STAT,1876,39,20-24,1915,1.5939893021411422
STAT,1906,22,30-34,1928,52.42055542551404
STAT,1914,15,20-24,1929,56.91267745820897
SIM,1845,85,na,1930,326
SIM,1841,71,na,1912,1756
SIM,1859,25,40-44,1884,7
SIM,1869,15,35-39,1884,2
STAT,1897,23,45-49,1920,1.8767015705884873
STAT,1809,47,50-100,1856,1.9037143092897038
STAT,1811,50,50-100,1861,0.10180320270588104
STAT,1870,32,na,1902,4731.642580986872
STAT,1943,20,na,1963,7851.918233744068
SIM,1868,58,na,1926,3855
STAT,1929,35,30-34,1964,4.73338221292056
SIM,1864,44,na,1908,4386
SIM,1894,10,na,1904,7035
STAT,1853,36,15-19,1889,0.08977520732039235
STAT,1901,47,45-49,1948,0.37463494368183886
SIM,1821,71,na,1892,1536
SIM,1924,18,50-100,1942,1
STAT,1810,51,40-44,1861,0.06640391614403925
STAT,1863,22,50-100,1885,0.7353003523878302
STAT,1899,29,35-39,1928,26.509093609567515
STAT,1935,19,20-24,1954,372.3778740889325
SIM,1934,26,15-19,1960,4
SIM,1900,35,35-39,1935,7
STAT,1837,77,na,1914,1204.7513258561287
STAT,1858,35,25-29,1893,4.576111821734674
STAT,1803,97,na,1900,3.79134060135021
SIM,1864,22,45-49,1886,5
SIM,1881,8,na,1889,4519
STAT,1867,43,na,1910,4339.956739849341
STAT,1822,37,na,1859,3228.826925425798
STAT,1883,16,50-100,1899,0.09745203794359183
STAT,1901,32,na,1933,6746.981883418848
SIM,1921,17,na,1938,8491
STAT,1890,37,30-34,1927,13.138240297331492
STAT,1914,34,25-29,1948,18.63212887127441
SIM,1850,18,30-34,1868,2
STAT,1918,42,na,1960,7973.52491274166
STAT,1904,34,15-19,1938,0.2350020021893972
SIM,1834,78,na,1912,886
SIM,1843,20,30-34,1863,49
SIM,1938,25,25-29,1963,140
SIM,1930,33,20-24,1963,9
STAT,1918,35,20-24,1953,0.5663836752345851
STAT,1892,27,50-100,1919,1.6173316425984081
STAT,1811,85,na,1896,254.8256028908009
STAT,1933,33,30-34,1966,42.858673765478784
STAT,1946,19,30-34,1965,27.283065352535488
STAT,1864,24,na,1888,4276.229720255072
SIM,1871,22,50-100,1893,1
STAT,1844,70,na,1914,2265.844212847881
SIM,1857,23,15-19,1880,1
SIM,1867,23,25-29,1890,120
STAT,1840,49,35-39,1889,0.1986279184271351
STAT,1899,30,15-19,1929,0.3972293049607607
STAT,1916,40,40-44,1956,0.5191056348088793
STAT,1810,90,na,1900,71.2996844984474
STAT,1818,63,na,1881,2033.1605063644056
STAT,1833,32,15-19,1865,0.24155502102923415
STAT,1872,98,na,1970,41.44289698068461
STAT,1896,56,na,1952,5438.537877544423
STAT,1924,20,25-29,1944,221.380705802954
SIM,1936,16,na,1952,6346
STAT,1926,26,15-19,1952,1.7147235328679469
SIM,1834,37,na,1871,3467
SIM,1869,41,35-39,1910,5
STAT,1842,18,30-34,1860,3.0292646647443715
STAT,1856,22,45-49,1878,1.261974628774682
STAT,1931,18,25-29,1949,114.25982699097804
STAT,1921,18,15-19,1939,104.17781856182381
SIM,1947,21,30-34,1968,88
STAT,1922,33,20-24,1955,5.540990417144198
STAT,1932,24,na,1956,9644.412550157025
STAT,1859,23,25-29,1882,94.79011997567675
SIM,1891,46,na,1937,5834
STAT,1849,23,15-19,1872,6.263890802760413
STAT,1886,43,35-39,1929,3.832663222021862
STAT,1823,46,30-34,1869,0.30338652820388834
SIM,1874,65,na,1939,3151
STAT,1953,19,na,1972,8985.714344341772
SIM,1893,30,50-100,1923,4
STAT,1933,25,45-49,1958,4.637357222348339
STAT,1913,39,35-39,1952,4.773438796434288
SIM,1849,32,20-24,1881,4
SIM,1908,35,40-44,1943,7
STAT,1911,33,45-49,1944,3.0824839219665816
STAT,1912,21,45-49,1933,2.1849550341261295
STAT,1902,21,35-39,1923,16.689208236471977
STAT,1939,21,30-34,1960,58.32085689957251
STAT,1854,14,na,1868,4338.1002842520575
STAT,1882,38,35-39,1920,13.84622258804226
STAT,1819,52,35-39,1871,0.034686745112494505
STAT,1843,38,50-100,1881,1.8081928868618538
STAT,1942,30,40-44,1972,8.428678214769025
SIM,1926,35,20-24,1961,1
STAT,1835,20,30-34,1855,37.78898939819262
STAT,1846,102,na,1948,0.44905880738707066
SIM,1831,46,30-34,1877,1
STAT,1841,51,na,1892,3139.0429396174977
STAT,1888,38,na,1926,5595.976541680323
SIM,1851,38,50-100,1889,4
SIM,1941,25,45-49,1966,4
SIM,1894,43,35-39,1937,1
SIM,1910,21,35-39,1931,22
SIM,1915,21,na,1936,7649
STAT,1815,47,35-39,1862,0.75232264237608
STAT,1824,70,na,1894,1500.077103321589
SIM,1843,38,20-24,1881,3
SIM,1791,67,na,1858,1331
SIM,1870,51,na,1921,4215
SIM,1921,39,35-39,1960,12
SIM,1920,21,45-49,1941,3
STAT,1907,16,40-44,1923,0.5442559844823405
STAT,1907,43,30-34,1950,0.2352682706229667
SIM,1918,17,20-24,1935,325
SIM,1866,28,35-39,1894,24
STAT,1839,20,15-19,1859,6.71474534169921
STAT,1869,40,30-34,1909,2.2725328266356057
STAT,1820,37,15-19,1857,0.27923169853927504
SIM,1932,20,25-29,1952,270
SIM,1888,20,40-44,1908,7
SIM,1926,26,45-49,1952,5
SIM,1834,24,25-29,1858,102
SIM,1942,7,na,1949,8536
STAT,1929,15,50-100,1944,0.9700481863423642
STAT,1873,83,na,1956,878.2144947824853
STAT,1924,46,35-39,1970,0.31068324061806935
SIM,1845,45,50-100,1890,1
SIM,1915,54,na,1969,7339
SIM,1921,27,20-24,1948,43
SIM,1904,58,na,1962,6109
STAT,1913,27,20-24,1940,36.74278628491943
STAT,1920,7,na,1927,9055.419896264575
SIM,1823,47,35-39,1870,1
SIM,1879,15,15-19,1894,11
SIM,1891,15,15-19,1906,14
SIM,1922,34,25-29,1956,26
STAT,1827,46,15-19,1873,7.321046420105949E-4
SIM,1912,34,15-19,1946,3
STAT,1901,32,45-49,1933,4.930428802420526
SIM,1899,32,30-34,1931,53
STAT,1910,20,30-34,1930,54.85641973496702
STAT,1850,55,na,1905,3170.3626943252184
STAT,1920,20,40-44,1940,7.592631492252675
SIM,1831,44,50-100,1875,5
STAT,1773,93,na,1866,12.19808037752744
SIM,1886,5,na,1891,5533
STAT,1802,52,45-49,1854,0.09303144645417272
STAT,1837,45,50-100,1882,0.36464421413231585
SIM,1812,67,na,1879,1685
SIM,1881,47,na,1928,3853
SIM,1883,24,20-24,1907,135
SIM,1835,21,35-39,1856,18
STAT,1900,34,30-34,1934,48.49677674673238
STAT,1830,31,35-39,1861,20.396061646541273
STAT,1863,4,na,1867,5377.045750056698
SIM,1877,40,30-34,1917,5
SIM,1847,20,15-19,1867,7
STAT,1902,58,na,1960,5855.212575957189
SIM,1840,85,na,1925,367
SIM,1826,70,na,1896,1552
SIM,1906,23,35-39,1929,20
SIM,1860,49,50-100,1909,2
SIM,1943,19,20-24,1962,278
STAT,1873,28,na,1901,4880.0411994136175
SIM,1831,39,40-44,1870,14
STAT,1894,37,15-19,1931,0.14568721614600186
SIM,1796,66,na,1862,1615
STAT,1867,76,na,1943,1791.9425776094463
SIM,1842,33,na,1875,3742
STAT,1854,25,na,1879,3875.817400275309
STAT,1851,52,40-44,1903,0.016232900743025712
SIM,1880,33,50-100,1913,3
SIM,1928,39,25-29,1967,5
SIM,1938,29,40-44,1967,10
STAT,1922,34,50-100,1956,1.8769500708032238
SIM,1900,55,na,1955,5939
STAT,1893,15,25-29,1908,14.573531380515426
STAT,1947,7,na,1954,8960.503042197919
SIM,1928,29,30-34,1957,116
STAT,1817,104,na,1921,0.0672753580856145
SIM,1891,19,30-34,1910,4
STAT,1820,89,na,1909,117.60819389469412
STAT,1869,24,na,1893,4599.283426017815
STAT,1861,102,na,1963,1.8075858122780046
STAT,1883,19,30-34,1902,3.145711934986956
SIM,1817,45,na,1862,2978
STAT,1865,10,na,1875,5022.194475881075
SIM,1883,17,30-34,1900,2
SIM,1934,25,40-44,1959,17
STAT,1936,29,15-19,1965,1.3633975661912037
STAT,1876,49,15-19,1925,8.180976854014343E-4
STAT,1823,39,40-44,1862,15.626773295216186
SIM,1803,53,na,1856,2470
SIM,1820,39,30-34,1859,15
SIM,1854,14,na,1868,4805
STAT,1901,29,15-19,1930,1.2736161939562893
SIM,1773,93,na,1866,5
STAT,1856,48,35-39,1904,0.21541196471289523
STAT,1867,47,50-100,1914,0.4623681999464946
STAT,1939,31,25-29,1970,19.0590801589917
STAT,1922,40,45-49,1962,0.3867696593264032
STAT,1801,86,na,1887,157.09872926082335
SIM,1842,23,20-24,1865,117
SIM,1846,70,na,1916,2094
SIM,1882,36,35-39,1918,18
SIM,1875,20,50-100,1895,1
STAT,1922,26,30-34,1948,89.82778659093964
STAT,1956,15,25-29,1971,115.85385294439412
SIM,1938,18,35-39,1956,10
SIM,1930,26,30-34,1956,121
STAT,1905,28,25-29,1933,123.11826488697699
STAT,1858,36,50-100,1894,1.9422842454743647
SIM,1913,28,25-29,1941,139
SIM,1925,32,35-39,1957,32
STAT,1879,17,15-19,1896,12.536602690040823
STAT,1845,42,35-39,1887,2.841462631944943
STAT,1926,44,45-49,1970,0.41292357859355655
STAT,1830,34,50-100,1864,1.7551625301482703
STAT,1850,11,na,1861,4493.2015706557795
STAT,1892,21,15-19,1913,8.36609085471751
STAT,1887,19,15-19,1906,13.33303197445258
SIM,1842,39,50-100,1881,6
STAT,1863,30,35-39,1893,18.047558837784244
SIM,1839,77,na,1916,1067
STAT,1884,51,40-44,1935,0.021095433527768732
STAT,1944,25,20-24,1969,39.877120185551604
SIM,1875,15,30-34,1890,4
SIM,1878,23,35-39,1901,19
SIM,1931,31,50-100,1962,2
STAT,1801,75,na,1876,898.1208755057455
STAT,1814,105,na,1919,0.025234236433190393
SIM,1835,42,50-100,1877,3
STAT,1914,24,30-34,1938,58.94199461944978
STAT,1880,47,15-19,1927,8.470609509733644E-4
STAT,1926,25,40-44,1951,11.359261562402969
STAT,1821,35,50-100,1856,5.474339220078907
STAT,1861,28,20-24,1889,19.721319871594677
STAT,1946,26,20-24,1972,41.08165419201053
STAT,1919,45,15-19,1964,8.105636516125114E-4
STAT,1908,5,na,1913,7856.385361383453
SIM,1903,39,20-24,1942,3
SIM,1828,28,15-19,1856,1
STAT,1876,46,50-100,1922,0.5144805197545812
STAT,1824,59,na,1883,2235.50609805879
STAT,1867,22,20-24,1889,130.87974349589376
SIM,1884,31,50-100,1915,3
SIM,1895,19,15-19,1914,16
STAT,1824,48,na,1872,2738.740522984553
STAT,1843,50,40-44,1893,0.014959243114624765
STAT,1864,47,30-34,1911,0.17393924704862052
STAT,1853,84,na,1937,526.3401873349072
STAT,1940,21,20-24,1961,228.86094323164153
SIM,1875,22,20-24,1897,147
STAT,1907,57,na,1964,6323.644526577067
STAT,1794,88,na,1882,97.56257731098388
STAT,1903,15,45-49,1918,0.18871166571427167
STAT,1906,32,25-29,1938,17.308348795355943
SIM,1901,26,40-44,1927,10
STAT,1903,43,na,1946,6620.8909736930345
SIM,1924,40,40-44,1964,2
STAT,1891,57,na,1948,5016.8068449123675
STAT,1948,17,40-44,1965,3.2325903090724957
SIM,1856,25,na,1881,4241
SIM,1826,59,na,1885,2302
STAT,1825,30,15-19,1855,0.6349618934070997
STAT,1932,40,25-29,1972,0.19602165266084098
SIM,1898,35,20-24,1933,3
STAT,1883,50,na,1933,4333.870558535034
SIM,1859,21,25-29,1880,133
SIM,1818,52,na,1870,2670
SIM,1933,31,30-34,1964,63
SIM,1885,15,40-44,1900,1
STAT,1881,32,50-100,1913,1.788585788120249
STAT,1938,27,25-29,1965,131.71784394310373
SIM,1839,17,15-19,1856,8
SIM,1884,21,30-34,1905,50
SIM,1869,6,na,1875,5390
SIM,1889,64,na,1953,4268
STAT,1937,33,15-19,1970,0.25665913497776455
SIM,1917,21,50-100,1938,5
STAT,1885,30,50-100,1915,1.8567305900835387
SIM,1885,50,na,1935,4653
STAT,1846,18,15-19,1864,11.351625651891325
STAT,1906,25,35-39,1931,28.588907587791315
SIM,1875,25,25-29,1900,95
STAT,1836,29,na,1865,3668.395055164626
SIM,1904,36,30-34,1940,6
STAT,1874,36,35-39,1910,14.69659575923858
SIM,1911,15,45-49,1926,1
SIM,1924,22,40-44,1946,16
STAT,1872,48,50-100,1920,0.4922405448784064
STAT,1929,42,20-24,1971,0.046185694930388155
SIM,1853,42,35-39,1895,7
STAT,1947,23,30-34,1970,65.57720250186689
SIM,1914,32,25-29,1946,26
STAT,1898,26,15-19,1924,1.24426422914718
SIM,1854,18,15-19,1872,11
SIM,1872,47,30-34,1919,1
SIM,1902,30,40-44,1932,19
STAT,1871,17,na,1888,5100.395488167483
SIM,1872,24,45-49,1896,1
STAT,1941,27,45-49,1968,3.609536581474394
STAT,1925,31,30-34,1956,37.79959570226093
STAT,1864,24,45-49,1888,1.260822811878471
STAT,1928,38,20-24,1966,0.6720506427768167
STAT,1800,54,35-39,1854,0.05171263480974677
STAT,1815,89,na,1904,97.64721780939517
STAT,1952,16,15-19,1968,109.86056856019964
STAT,1930,24,15-19,1954,13.68613479001027
STAT,1874,54,35-39,1928,0.017313235721644647
SIM,1873,80,na,1953,1085
SIM,1885,61,na,1946,3933
STAT,1916,22,40-44,1938,7.115664362353778
SIM,1869,43,na,1912,4422
SIM,1820,86,na,1906,176
STAT,1834,23,20-24,1857,121.8024557852457
SIM,1908,37,50-100,1945,1
STAT,1918,53,na,1971,7726.398217772196
SIM,1815,45,35-39,1860,1
SIM,1849,25,30-34,1874,64
SIM,1835,64,na,1899,2288
SIM,1842,31,20-24,1873,6
STAT,1877,19,50-100,1896,0.102192726829996
STAT,1918,38,25-29,1956,2.0934806034849696
STAT,1919,22,45-49,1941,2.487813547556526
STAT,1836,36,15-19,1872,0.09262137235562182
STAT,1869,24,45-49,1893,1.3560734200855649
STAT,1881,24,45-49,1905,1.3527068590713676
STAT,1884,25,25-29,1909,84.93280368400782
STAT,1888,41,45-49,1929,3.5887426452227027
STAT,1942,30,20-24,1972,5.253562770665104
SIM,1822,33,45-49,1855,4
SIM,1839,21,20-24,1860,125
STAT,1884,23,30-34,1907,35.41274571549797
STAT,1946,16,na,1962,8246.73655076467
STAT,1837,31,50-100,1868,1.6182201269397445
STAT,1861,20,25-29,1881,100.29627186157639
SIM,1956,7,na,1963,10705
STAT,1833,35,35-39,1868,11.892392310320224
SIM,1825,34,25-29,1859,21
SIM,1910,20,25-29,1930,191
SIM,1887,43,45-49,1930,7
SIM,1878,20,30-34,1898,50
SIM,1883,25,30-34,1908,70
SIM,1924,33,30-34,1957,54
SIM,1843,23,35-39,1866,15
SIM,1894,75,na,1969,3436
SIM,1924,35,na,1959,9320
SIM,1945,25,15-19,1970,2
STAT,1841,34,15-19,1875,0.24554341108439603
STAT,1813,49,25-29,1862,0.3432229860775312
STAT,1898,38,30-34,1936,3.128392913619185
SIM,1943,18,na,1961,8007
STAT,1939,20,20-24,1959,225.71407830884624
SIM,1907,36,35-39,1943,12
SIM,1918,24,45-49,1942,2
SIM,1846,24,15-19,1870,6
STAT,1897,73,na,1970,4031.4161964103328
STAT,1849,38,35-39,1887,11.329955974706147
SIM,1914,39,45-49,1953,2
STAT,1811,108,na,1919,0.0017027050217326035
STAT,1841,52,30-34,1893,0.008590754136965261
STAT,1873,37,30-34,1910,10.936592716517627
SIM,1927,22,45-49,1949,3
SIM,1881,37,30-34,1918,10
STAT,1925,33,25-29,1958,22.148230315822197
SIM,1841,35,35-39,1876,20
STAT,1840,66,na,1906,2365.8133754120445
SIM,1916,16,na,1932,8459
STAT,1823,31,45-49,1854,11.399027363636861
SIM,1857,38,35-39,1895,13
STAT,1911,19,30-34,1930,4.901053597445335
STAT,1835,23,35-39,1858,9.978783158830893
STAT,1946,23,15-19,1969,11.958701442088978
SIM,1868,26,45-49,1894,2
STAT,1858,36,35-39,1894,11.189334074382787
SIM,1948,2,na,1950,9491
SIM,1821,49,25-29,1870,1
SIM,1872,39,30-34,1911,19
SIM,1867,39,20-24,1906,4
STAT,1903,42,20-24,1945,0.031673529250282925
SIM,1808,62,na,1870,1977
STAT,1834,31,20-24,1865,4.657061109150004
STAT,1919,38,na,1957,8152.876626271234
SIM,1892,25,25-29,1917,132
STAT,1900,41,40-44,1941,0.43957788784877927
STAT,1828,32,na,1860,3534.347389080899
STAT,1826,32,25-29,1858,30.793540522022166
STAT,1923,43,na,1966,8750.144351289005
SIM,1913,23,50-100,1936,1
SIM,1839,47,30-34,1886,1
STAT,1894,29,15-19,1923,1.1686715810581974
STAT,1847,22,15-19,1869,6.164867944062496
SIM,1858,37,na,1895,4048
SIM,1865,84,na,1949,504
STAT,1830,48,15-19,1878,6.815951019597232E-4
SIM,1837,26,15-19,1863,1
SIM,1899,19,na,1918,7055
SIM,1901,2,na,1903,7583
STAT,1780,96,na,1876,2.8595655763637473
STAT,1842,67,na,1909,2360.0951385504845
STAT,1920,19,25-29,1939,97.64375311553479
SIM,1942,24,35-39,1966,28
STAT,1827,38,15-19,1865,0.11361865859140806
STAT,1893,23,25-29,1916,146.08897054871804
STAT,1838,24,15-19,1862,5.709887600198758
STAT,1866,52,35-39,1918,0.01595740311908963
STAT,1934,24,35-39,1958,25.542376424120864
SIM,1947,20,20-24,1967,247
STAT,1889,54,na,1943,5214.583420823208
STAT,1896,17,15-19,1913,15.824054180561811
STAT,1901,17,35-39,1918,1.551403219613212
SIM,1882,29,45-49,1911,5
STAT,1951,21,30-34,1972,69.36786447084444
SIM,1881,13,na,1894,4462
SIM,1816,81,na,1897,450
STAT,1822,105,na,1927,0.03310548106102987
SIM,1938,22,20-24,1960,235
SIM,1859,33,40-44,1892,12
STAT,1836,51,na,1887,2954.5180449725403
STAT,1874,29,45-49,1903,2.279602241902969
STAT,1931,30,45-49,1961,4.169114373408134
SIM,1858,41,25-29,1899,2
SIM,1778,92,na,1870,23
STAT,1921,40,15-19,1961,0.003502130356142706
STAT,1943,22,35-39,1965,20.231680056166024
SIM,1838,18,30-34,1856,3
STAT,1897,63,na,1960,5056.231170821764
SIM,1833,33,20-24,1866,4
STAT,1819,101,na,1920,0.5970872218640708
STAT,1820,66,na,1886,1823.3961639375748
SIM,1851,24,25-29,1875,117
SIM,1892,18,35-39,1910,5
SIM,1835,54,na,1889,2852
STAT,1864,39,30-34,1903,9.524700865844148
STAT,1872,31,40-44,1903,8.838381368690966
SIM,1823,39,35-39,1862,16
SIM,1799,84,na,1883,179
SIM,1921,3,na,1924,9393
STAT,1902,28,20-24,1930,33.33268315386443
STAT,1944,28,25-29,1972,143.5954141997813
STAT,1926,37,20-24,1963,0.6505410551750134
STAT,1913,16,15-19,1929,18.790764450835603
SIM,1831,31,45-49,1862,4
SIM,1834,32,25-29,1866,21
SIM,1905,20,15-19,1925,9
STAT,1916,40,20-24,1956,0.036652125208558255
SIM,1874,27,30-34,1901,64
STAT,1859,24,na,1883,3888.0465965325607
SIM,1880,51,na,1931,4775
STAT,1777,105,na,1882,0.0367428415128446
SIM,1873,38,35-39,1911,19
STAT,1945,20,50-100,1965,1.4573476886281425
SIM,1899,35,35-39,1934,33
SIM,1930,20,50-100,1950,2
SIM,1827,35,na,1862,3439
STAT,1889,47,35-39,1936,0.19574099135071082
STAT,1890,22,45-49,1912,1.7190064128108273
STAT,1863,39,na,1902,4123.213397376261
SIM,1841,28,45-49,1869,1
STAT,1849,24,na,1873,4030.536631247591
SIM,1922,38,40-44,1960,9
STAT,1828,53,50-100,1881,0.023438899463387227
STAT,1917,32,35-39,1949,19.324744450139587
STAT,1902,20,25-29,1922,164.20096078712646
SIM,1850,31,na,1881,3965
SIM,1897,47,35-39,1944,1
SIM,1848,27,na,1875,3946
STAT,1833,28,30-34,1861,43.446352438900895
STAT,1846,44,45-49,1890,2.2614740935152047
STAT,1937,25,15-19,1962,1.3913039450827782
SIM,1849,43,50-100,1892,4
STAT,1865,38,35-39,1903,12.913107516034103
SIM,1855,40,45-49,1895,6
SIM,1836,81,na,1917,574
SIM,1890,51,na,1941,5730
STAT,1879,25,15-19,1904,0.9649385778023611
SIM,1841,28,30-34,1869,55
STAT,1812,47,na,1859,2901.0340493769677
STAT,1850,96,na,1946,13.165662376720235
STAT,1815,39,35-39,1854,49.42892831174544
STAT,1877,37,15-19,1914,0.11776499989434958
STAT,1843,24,25-29,1867,99.21547221945596
STAT,1860,21,20-24,1881,117.35232937498185
STAT,1916,33,30-34,1949,32.712368719484864
SIM,1880,31,40-44,1911,9
SIM,1921,16,15-19,1937,98
STAT,1879,43,45-49,1922,3.13877929979131
SIM,1933,33,25-29,1966,34
STAT,1833,28,45-49,1861,1.9156068944209377
SIM,1892,23,30-34,1915,58
SIM,1934,37,20-24,1971,3
STAT,1926,3,na,1929,10041.730621767385
STAT,1838,52,na,1890,2898.5134667329116
STAT,1877,42,50-100,1919,2.212819041646766
STAT,1851,19,35-39,1870,1.0220264591980146
SIM,1874,34,20-24,1908,6
SIM,1877,42,50-100,1919,5
STAT,1847,40,45-49,1887,2.353657769563745
SIM,1852,12,na,1864,4740
STAT,1866,34,20-24,1900,4.9939695566308115
STAT,1850,86,na,1936,340.1960442572184
STAT,1884,18,35-39,1902,1.0914074424444
SIM,1825,54,na,1879,2444
SIM,1825,32,30-34,1857,41
STAT,1882,53,30-34,1935,0.011522993003143328
SIM,1827,45,na,1872,3152
STAT,1856,112,na,1968,4.679875263867921E-4
SIM,1910,28,20-24,1938,43
STAT,1832,36,30-34,1868,8.873473527022057
SIM,1909,31,40-44,1940,13
SIM,1840,36,30-34,1876,18
SIM,1928,1,na,1929,10587
SIM,1926,23,40-44,1949,10
STAT,1898,27,na,1925,6522.577387818473
STAT,1932,29,45-49,1961,4.565840925906523
STAT,1918,23,40-44,1941,7.300040233957801
SIM,1888,57,na,1945,4676
SIM,1940,29,45-49,1969,4
SIM,1842,12,na,1854,4465
STAT,1852,77,na,1929,1377.67704811775
SIM,1875,26,35-39,1901,22
STAT,1855,112,na,1967,3.817897793208756E-4
SIM,1850,21,na,1871,4130
STAT,1867,33,25-29,1900,19.291359243332586
SIM,1933,18,na,1951,10359
STAT,1908,41,25-29,1949,0.13428889239325184
SIM,1833,29,35-39,1862,17
STAT,1838,42,45-49,1880,2.3688442724777223
SIM,1891,13,na,1904,6660
STAT,1850,27,35-39,1877,17.4100638450441
STAT,1905,40,45-49,1945,0.30661903609684393
SIM,1879,74,na,1953,2093
STAT,1922,49,50-100,1971,0.5215559593491217
STAT,1851,26,25-29,1877,77.33438960019515
STAT,1834,24,30-34,1858,31.257064188111535
SIM,1886,76,na,1962,2292
SIM,1853,15,45-49,1868,2
STAT,1874,33,15-19,1907,0.29324420316134664
SIM,1941,25,30-34,1966,92
STAT,1766,108,na,1874,0.005873430906098988
SIM,1852,28,20-24,1880,2
STAT,1836,20,50-100,1856,0.8705868956301432
STAT,1845,15,45-49,1860,0.12873467342550074
SIM,1902,29,25-29,1931,126
STAT,1878,53,50-100,1931,0.031344753709463
SIM,1851,24,50-100,1875,1
STAT,1858,40,20-24,1898,0.2525611225971606
SIM,1837,44,45-49,1881,5
SIM,1875,33,25-29,1908,30
SIM,1926,16,na,1942,9382
STAT,1810,108,na,1918,0.0016565242962605267
STAT,1890,29,30-34,1919,61.63363142236334
SIM,1846,42,45-49,1888,2
STAT,1853,28,15-19,1881,0.7513186908241148
STAT,1899,34,30-34,1933,47.89981852142808
SIM,1842,24,30-34,1866,41
STAT,1798,92,na,1890,22.546927822868952
STAT,1870,28,15-19,1898,0.8964471191811338
STAT,1933,25,30-34,1958,105.17620126238474
SIM,1955,15,30-34,1970,33
STAT,1862,2,na,1864,5920.844033322135
SIM,1884,75,na,1959,2379
STAT,1855,42,45-49,1897,2.2540566436095477
SIM,1843,30,25-29,1873,26
STAT,1897,49,35-39,1946,0.2087438488942652
SIM,1873,25,50-100,1898,1
STAT,1856,45,15-19,1901,6.295079207149888E-4
SIM,1861,28,15-19,1889,4
STAT,1860,46,35-39,1906,0.23026350705647877
STAT,1899,36,25-29,1935,8.005484098930935
SIM,1858,27,na,1885,4170
SIM,1953,18,na,1971,9313
STAT,1840,38,30-34,1878,9.00486008447645
SIM,1847,16,30-34,1863,3
STAT,1947,15,30-34,1962,27.74272695198608
STAT,1826,51,na,1877,2886.9399373448355
SIM,1898,39,35-39,1937,2
STAT,1874,51,30-34,1925,0.012368260897632205
STAT,1942,23,30-34,1965,60.84223907112759
SIM,1862,30,50-100,1892,3
SIM,1830,96,na,1926,7
SIM,1930,21,na,1951,10033
STAT,1772,87,na,1859,87.14077607578875
STAT,1917,29,50-100,1946,2.092917127651223
SIM,1856,39,30-34,1895,14
STAT,1882,35,15-19,1917,0.11152752396801947
STAT,1887,45,45-49,1932,0.5383896007180329
STAT,1888,48,30-34,1936,0.1287037953472353
SIM,1876,56,na,1932,4521
STAT,1857,37,30-34,1894,8.389805002209542
STAT,1868,25,40-44,1893,5.7951060579339995
STAT,1862,38,50-100,1900,2.1088191988731695
SIM,1896,48,30-34,1944,1
SIM,1817,40,25-29,1857,1
STAT,1913,43,na,1956,7304.858377010268
STAT,1839,16,30-34,1855,3.274887107526857
SIM,1851,17,35-39,1868,1
STAT,1860,24,25-29,1884,95.39980766955783
STAT,1829,26,15-19,1855,1.6535913296853615
STAT,1843,17,35-39,1860,0.9822709377006568
STAT,1840,23,45-49,1863,1.270831505284269
STAT,1848,39,30-34,1887,8.820561171139103
SIM,1916,34,35-39,1950,24
SIM,1891,23,na,1914,6069
STAT,1833,50,30-34,1883,0.008404906813717757
STAT,1927,21,40-44,1948,8.39046503349725
STAT,1825,99,na,1924,2.1912717876535845
STAT,1860,17,35-39,1877,1.0379059455401518
STAT,1885,29,20-24,1914,23.415134667279702
SIM,1946,24,20-24,1970,225
SIM,1901,22,25-29,1923,189
STAT,1858,62,na,1920,2877.6133966891584
STAT,1910,15,35-39,1925,1.6876393409272794
SIM,1888,17,30-34,1905,3
SIM,1826,38,20-24,1864,2
STAT,1815,44,15-19,1859,0.07731457464133165
STAT,1813,49,50-100,1862,1.4634646870714167
SIM,1878,45,45-49,1923,2
STAT,1825,36,25-29,1861,7.864842928943023
SIM,1863,28,na,1891,4422
STAT,1938,17,30-34,1955,24.286959202529186
STAT,1817,47,50-100,1864,1.1861584466597719
STAT,1835,30,25-29,1865,17.251202020361394
STAT,1924,35,30-34,1959,4.346775194911805
STAT,1875,32,20-24,1907,5.620609456463321
SIM,1841,32,15-19,1873,3
SIM,1884,31,25-29,1915,25
SIM,1911,19,25-29,1930,25
SIM,1947,16,35-39,1963,15
STAT,1830,66,na,1896,2263.2814575362318
STAT,1871,49,15-19,1920,7.858475446850221E-4
STAT,1839,23,20-24,1862,137.26303167734474
SIM,1925,31,25-29,1956,5
STAT,1889,44,na,1933,5677.83640044527
SIM,1876,46,na,1922,4899
STAT,1814,48,30-34,1862,0.49373931807454485
STAT,1909,38,na,1947,7160.1637051701
SIM,1839,48,50-100,1887,2
STAT,1843,22,30-34,1865,31.31956771185642
STAT,1928,27,15-19,1955,1.7562541120826944
SIM,1853,83,na,1936,471
STAT,1818,38,20-24,1856,4.782581219571127
STAT,1876,31,25-29,1907,21.482798727280333
SIM,1936,27,15-19,1963,1
STAT,1881,39,30-34,1920,10.299059691350434
SIM,1851,22,30-34,1873,43
SIM,1878,27,15-19,1905,3
STAT,1934,31,25-29,1965,25.504748899776267
STAT,1944,21,40-44,1965,7.333926020701265
SIM,1816,41,20-24,1857,4
SIM,1936,20,45-49,1956,3
SIM,1848,82,na,1930,580
SIM,1893,29,20-24,1922,33
SIM,1883,32,20-24,1915,7
SIM,1901,20,30-34,1921,67
STAT,1841,37,35-39,1878,12.091022323958619
SIM,1932,35,30-34,1967,5
STAT,1903,19,25-29,1922,16.207644301388054
STAT,1859,35,40-44,1894,7.103617659793979
STAT,1939,16,35-39,1955,8.486221067609543
SIM,1808,52,na,1860,2595
STAT,1875,25,30-34,1900,52.71726404582246
STAT,1825,29,35-39,1854,65.04870407640477
STAT,1866,36,50-100,1902,2.2988854038712145
STAT,1938,24,20-24,1962,222.14341092381434
STAT,1805,99,na,1904,1.4166302865067637
SIM,1901,15,35-39,1916,3
SIM,1826,30,25-29,1856,24
SIM,1833,36,25-29,1869,7
STAT,1908,34,35-39,1942,17.283362861764708
SIM,1873,35,15-19,1908,4
STAT,1928,20,45-49,1948,2.853731631198212
STAT,1878,41,50-100,1919,2.238457553115361
SIM,1915,35,30-34,1950,6
STAT,1904,60,na,1964,5915.476795281584
SIM,1832,37,35-39,1869,20
STAT,1865,35,15-19,1900,0.10401153808114055
STAT,1917,39,20-24,1956,0.5495717347538117
SIM,1926,38,25-29,1964,2
SIM,1935,21,40-44,1956,10
STAT,1885,21,25-29,1906,115.4280729078907
SIM,1817,47,50-100,1864,4
STAT,1824,37,35-39,1861,21.484866388350262
STAT,1836,49,50-100,1885,0.33316811599900037
STAT,1839,49,30-34,1888,0.15010265031703976
SIM,1836,20,40-44,1856,4
SIM,1866,36,50-100,1902,5
STAT,1892,27,25-29,1919,106.95050888972224
STAT,1831,33,45-49,1864,2.9102822022245847
STAT,1917,31,25-29,1948,19.62509195336708
STAT,1849,45,25-29,1894,0.09201992181251224
STAT,1866,81,na,1947,1007.7036894107501
SIM,1845,64,na,1909,2852
SIM,1903,43,na,1946,6800
STAT,1910,22,25-29,1932,175.2534278292314
STAT,1919,37,15-19,1956,0.04165667651108279
SIM,1847,23,20-24,1870,9
STAT,1899,41,20-24,1940,0.030654924397225822
STAT,1823,38,30-34,1861,19.86791986842003
STAT,1876,24,35-39,1900,12.113190951463991
STAT,1907,35,30-34,1942,3.447062713966848
STAT,1891,28,35-39,1919,24.002624511170733
SIM,1925,39,20-24,1964,1
STAT,1848,46,35-39,1894,0.23021077504827347
STAT,1869,44,na,1913,4461.905043186919
SIM,1831,38,30-34,1869,13
SIM,1893,21,25-29,1914,7
STAT,1848,47,30-34,1895,0.1579836834287507
STAT,1870,26,50-100,1896,1.272752313009108
SIM,1843,73,na,1916,1711
SIM,1917,33,40-44,1950,9
STAT,1822,46,15-19,1868,0.0012615603798229657
STAT,1898,15,25-29,1913,15.559623953352668
STAT,1919,0,na,1919,10052.663416226282
STAT,1851,16,30-34,1867,3.021825348857453
STAT,1926,22,35-39,1948,23.09893682206375
SIM,1938,23,30-34,1961,77
STAT,1855,34,45-49,1889,2.6224138935226553
SIM,1825,31,20-24,1856,4
STAT,1883,26,35-39,1909,19.211816206622444
STAT,1904,48,25-29,1952,0.09300010273387997
STAT,1908,31,30-34,1939,30.177778533793784
SIM,1842,97,na,1939,7
STAT,1918,31,40-44,1949,8.431356400381684
STAT,1916,41,na,1957,7697.589722275313
SIM,1886,29,15-19,1915,1
STAT,1848,39,45-49,1887,3.299261620345362
SIM,1892,22,20-24,1914,202
STAT,1837,21,45-49,1858,1.2817974699508228
SIM,1919,21,40-44,1940,7
STAT,1900,44,45-49,1944,0.28724189835998587
STAT,1905,22,15-19,1927,9.635725586722081
STAT,1884,22,20-24,1906,137.43015168788142
STAT,1878,29,15-19,1907,0.9501552532376575
SIM,1935,24,45-49,1959,5
STAT,1920,16,20-24,1936,307.8828161271929
SIM,1947,22,na,1969,8617
SIM,1876,25,40-44,1901,8
STAT,1839,36,50-100,1875,2.314789393886007
STAT,1786,91,na,1877,33.28485266413796
STAT,1816,51,na,1867,2763.2362543766058
SIM,1843,22,25-29,1865,125
SIM,1897,15,30-34,1912,5
SIM,1913,22,15-19,1935,9
STAT,1818,48,15-19,1866,0.0017363818831590875
SIM,1856,39,45-49,1895,8
STAT,1870,18,20-24,1888,35.27845794122088
STAT,1899,44,25-29,1943,0.12172859944208199
STAT,1867,35,50-100,1902,2.344236916311334
STAT,1877,29,15-19,1906,0.9446855548528165
STAT,1891,78,na,1969,2815.737788664418
STAT,1909,33,40-44,1942,7.514248049623886
STAT,1884,26,35-39,1910,19.30860851303481
SIM,1879,41,45-49,1920,2
STAT,1892,25,30-34,1917,64.09923366664789
STAT,1898,28,50-100,1926,1.7421812787399578
SIM,1901,23,35-39,1924,22
STAT,1920,42,20-24,1962,0.03938307864943223
SIM,1889,38,30-34,1927,14
STAT,1894,45,na,1939,5896.267990825871
STAT,1932,34,na,1966,10141.707525649304
SIM,1833,34,30-34,1867,19
SIM,1894,16,45-49,1910,1
SIM,1900,49,45-49,1949,2
SIM,1884,16,35-39,1900,1
SIM,1874,75,na,1949,1809
SIM,1930,11,na,1941,10961
SIM,1807,90,na,1897,61
STAT,1943,21,25-29,1964,198.53674577925182
SIM,1824,35,35-39,1859,22
SIM,1893,58,na,1951,5155
SIM,1822,48,30-34,1870,1
SIM,1915,44,na,1959,7615
SIM,1868,27,na,1895,4590
SIM,1918,21,40-44,1939,9
SIM,1827,42,50-100,1869,3
SIM,1834,68,na,1902,1946
SIM,1909,38,25-29,1947,3
SIM,1828,82,na,1910,598
SIM,1889,74,na,1963,3252
SIM,1916,31,30-34,1947,33
STAT,1811,75,na,1886,949.4618714731464
STAT,1845,20,40-44,1865,4.044133678939507
SIM,1832,34,30-34,1866,51
SIM,1926,31,40-44,1957,9
STAT,1912,47,20-24,1959,0.02145539706847681
SIM,1891,26,35-39,1917,33
STAT,1812,92,na,1904,39.47974389448696
STAT,1825,34,30-34,1859,52.14179924009849
STAT,1930,16,50-100,1946,0.9806375610633523
STAT,1886,16,45-49,1902,0.13960586329102737
STAT,1909,37,20-24,1946,0.5041984521780656
SIM,1876,31,50-100,1907,5
STAT,1869,78,na,1947,1529.020860715603
SIM,1874,37,25-29,1911,10
SIM,1834,22,30-34,1856,38
SIM,1840,29,40-44,1869,8
STAT,1955,17,30-34,1972,32.674600015860634
STAT,1777,86,na,1863,119.88053832669257
SIM,1884,23,25-29,1907,121
SIM,1840,31,na,1871,4127
SIM,1802,91,na,1893,39
SIM,1850,25,35-39,1875,27
STAT,1897,31,45-49,1928,4.726934121991973
SIM,1909,34,45-49,1943,3
SIM,1859,36,45-49,1895,8
SIM,1848,44,20-24,1892,1
SIM,1826,81,na,1907,541
STAT,1888,25,50-100,1913,1.537346977156262
STAT,1870,86,na,1956,483.92168163477885
STAT,1945,27,15-19,1972,1.5640710711330053
SIM,1892,26,35-39,1918,32
STAT,1822,47,na,1869,2942.494889153501
STAT,1832,29,40-44,1861,5.151548683140979
STAT,1854,48,na,1902,3405.6407691480217
STAT,1948,21,25-29,1969,214.2523929350132
STAT,1938,21,15-19,1959,10.645342994437904
SIM,1813,43,45-49,1856,5
SIM,1951,1,na,1952,9924
SIM,1851,21,20-24,1872,121
SIM,1900,45,na,1945,6602
SIM,1873,28,40-44,1901,8
SIM,1830,39,25-29,1869,9
SIM,1825,35,35-39,1860,16
SIM,1914,0,na,1914,8905
STAT,1822,39,25-29,1861,10.475560804514421
STAT,1842,25,35-39,1867,18.022923909970753
SIM,1845,30,na,1875,4206
SIM,1940,21,na,1961,7664
STAT,1855,18,50-100,1873,0.08735122605611215
SIM,1943,23,40-44,1966,9
STAT,1912,17,25-29,1929,17.702418618354244
SIM,1946,21,15-19,1967,9
STAT,1838,49,30-34,1887,0.1313724514263882
STAT,1852,67,na,1919,2526.5364018125565
SIM,1866,33,30-34,1899,49
SIM,1875,29,na,1904,5260
STAT,1893,20,20-24,1913,177.4601286033044
SIM,1938,17,na,1955,7410
SIM,1868,23,40-44,1891,6
STAT,1817,42,25-29,1859,3.485430664817643
STAT,1896,46,na,1942,6017.190064669429
STAT,1865,35,30-34,1900,9.871639365663267
STAT,1866,37,25-29,1903,5.365325553490996
STAT,1928,35,15-19,1963,0.049091726710582734
STAT,1848,21,20-24,1869,138.57958335586656
STAT,1844,38,15-19,1882,0.09483897886799371
STAT,1883,52,35-39,1935,0.016991786798054416
SIM,1906,37,45-49,1943,1
STAT,1851,31,20-24,1882,4.406805599705355
STAT,1843,21,20-24,1864,122.04601937271319
STAT,1889,15,30-34,1904,3.987547100172355
SIM,1898,57,na,1955,5631
SIM,1934,22,35-39,1956,1
SIM,1920,17,25-29,1937,130
SIM,1854,41,40-44,1895,7
SIM,1938,30,20-24,1968,4
STAT,1767,108,na,1875,0.008295092534808356
STAT,1839,19,35-39,1858,1.1076157250598233
SIM,1844,28,15-19,1872,1
STAT,1855,45,15-19,1900,6.091866222713297E-4
SIM,1945,20,50-100,1965,5
SIM,1887,40,40-44,1927,10
SIM,1860,21,na,1881,4255
STAT,1858,33,30-34,1891,27.37289584772424
SIM,1873,35,30-34,1908,17
SIM,1885,29,na,1914,4962
STAT,1829,44,45-49,1873,2.3884263900415488
SIM,1923,18,na,1941,9162
SIM,1856,21,20-24,1877,135
STAT,1839,101,na,1940,0.8909878515647391
STAT,1883,19,45-49,1902,0.12892259407506101
SIM,1941,28,35-39,1969,48
STAT,1835,34,na,1869,3499.914022157849
SIM,1839,24,25-29,1863,100
STAT,1862,102,na,1964,2.130051591896686
SIM,1815,64,na,1879,1778
STAT,1836,28,15-19,1864,0.7751379388247677
SIM,1848,37,30-34,1885,10
STAT,1859,20,50-100,1879,0.7582369387050875
STAT,1896,35,45-49,1931,5.36597123072959
STAT,1879,40,40-44,1919,4.7994885255618
STAT,1844,28,20-24,1872,23.02570716594693
STAT,1842,105,na,1947,0.04365303729533416
STAT,1855,49,30-34,1904,0.14292034652494992
STAT,1914,34,50-100,1948,1.666725051081081
STAT,1846,41,40-44,1887,3.531905819850286
STAT,1854,112,na,1966,3.2494435925844355E-4
SIM,1938,15,30-34,1953,35
SIM,1955,5,na,1960,10124
STAT,1851,24,30-34,1875,32.50264864989441
STAT,1937,33,na,1970,7553.805022711801
STAT,1842,51,35-39,1893,0.012878617175404651
SIM,1900,27,35-39,1927,38
STAT,1933,28,35-39,1961,40.24590022759646
SIM,1889,20,20-24,1909,167
STAT,1847,25,20-24,1872,21.806155355251107
STAT,1825,34,na,1859,3332.1951089355325
STAT,1859,49,15-19,1908,6.295698849345576E-4
STAT,1855,16,15-19,1871,10.706903198813125
SIM,1875,30,20-24,1905,6
STAT,1894,15,40-44,1909,0.47672781530684616
SIM,1843,15,35-39,1858,1
STAT,1884,33,25-29,1917,20.34032343064171
STAT,1850,24,30-34,1874,32.31110474600863
SIM,1863,16,15-19,1879,10
STAT,1874,29,30-34,1903,51.70184065983094
STAT,1899,37,35-39,1936,4.224391255966483
STAT,1884,50,50-100,1934,0.03055178959058092
STAT,1947,18,35-39,1965,9.54265880975748
SIM,1829,28,30-34,1857,53
STAT,1877,30,50-100,1907,1.9369572636328585
STAT,1837,28,15-19,1865,0.8059881362851109
SIM,1825,64,na,1889,1914
SIM,1878,20,45-49,1898,2
SIM,1866,35,25-29,1901,9
SIM,1928,17,na,1945,9432
STAT,1851,23,20-24,1874,126.65624644901511
SIM,1896,19,30-34,1915,7
STAT,1956,16,na,1972,9837.81270140064
SIM,1908,32,35-39,1940,27
SIM,1936,35,50-100,1971,1
SIM,1858,34,35-39,1892,22
STAT,1863,47,15-19,1910,7.038628579344226E-4
SIM,1844,78,na,1922,992
STAT,1888,19,30-34,1907,3.784266503065894
SIM,1905,44,na,1949,6926
SIM,1890,20,45-49,1910,5
SIM,1847,19,35-39,1866,1
STAT,1901,22,30-34,1923,50.361897085437946
SIM,1879,23,15-19,1902,6
STAT,1860,96,na,1956,16.322719770331986
SIM,1865,36,35-39,1901,21
STAT,1889,1,na,1890,6778.081334643703
STAT,1943,25,40-44,1968,10.033921147895839
SIM,1871,18,15-19,1889,9
SIM,1902,26,na,1928,7003
STAT,1949,14,na,1963,9222.722259770282
SIM,1949,4,na,1953,9643
STAT,1830,38,20-24,1868,1.42449462955611
SIM,1882,29,30-34,1911,64
SIM,1824,36,50-100,1860,3
SIM,1830,55,na,1885,2516
SIM,1855,25,20-24,1880,26
STAT,1950,17,45-49,1967,1.1928283282464431
STAT,1841,40,50-100,1881,1.6341507667132689
STAT,1887,42,40-44,1929,5.0743926791024
STAT,1925,26,35-39,1951,35.92896321659671
STAT,1841,29,35-39,1870,17.13977033632088
STAT,1914,38,40-44,1952,3.004169852171931
STAT,1879,54,na,1933,4423.436240003524
STAT,1899,33,20-24,1932,7.448173864708022
STAT,1835,38,50-100,1873,1.9464249850680087
STAT,1889,48,30-34,1937,0.13426630710147222
STAT,1935,23,40-44,1958,9.245881241072711
STAT,1882,20,45-49,1902,1.3800937296875162
STAT,1887,63,na,1950,4030.3733615597785
STAT,1941,17,na,1958,7657.194587909885
STAT,1951,16,35-39,1967,10.093662270793525
SIM,1818,62,na,1880,2051
STAT,1825,33,20-24,1858,8.766687986729467
STAT,1903,20,40-44,1923,6.027874742956593
SIM,1868,31,40-44,1899,13
STAT,1904,39,50-100,1943,0.7604275705170279
SIM,1768,92,na,1860,12
STAT,1934,15,na,1949,10103.058512404794
STAT,1863,18,15-19,1881,10.830362359718375
STAT,1928,35,50-100,1963,1.073323525604513
SIM,1897,22,20-24,1919,194
STAT,1848,52,na,1900,3511.7696522569163
SIM,1869,30,30-34,1899,51
SIM,1902,26,20-24,1928,36
SIM,1798,67,na,1865,1431
STAT,1884,45,na,1929,4531.522402694046
STAT,1839,26,25-29,1865,83.81073233299068
SIM,1835,24,40-44,1859,4
STAT,1782,77,na,1859,644.9713064738266
STAT,1832,47,na,1879,3137.747871535381
SIM,1851,32,25-29,1883,26
STAT,1899,44,na,1943,6330.982492715437
STAT,1856,81,na,1937,842.6388170249393
STAT,1889,22,20-24,1911,171.60815631194544
SIM,1820,38,50-100,1858,2
STAT,1913,24,15-19,1937,10.790929497663933
STAT,1920,39,50-100,1959,0.9262135617806077
SIM,1855,18,30-34,1873,5
STAT,1859,39,20-24,1898,1.2266599447026805
SIM,1838,40,45-49,1878,7
SIM,1901,30,25-29,1931,39
SIM,1933,26,35-39,1959,53
STAT,1940,28,40-44,1968,9.595315763557162
SIM,1838,22,15-19,1860,6
SIM,1956,15,50-100,1971,1
SIM,1932,27,45-49,1959,5
SIM,1838,82,na,1920,561
STAT,1849,39,50-100,1888,1.9463779451529255
STAT,1892,24,20-24,1916,173.14045826737245
STAT,1873,15,20-24,1888,36.812313355347776
STAT,1930,38,25-29,1968,2.591127872717391
STAT,1824,34,30-34,1858,61.79818464329473
SIM,1834,39,50-100,1873,4
STAT,1881,35,15-19,1916,0.11065932656854935
STAT,1924,27,45-49,1951,4.0613951372883825
STAT,1897,46,15-19,1943,6.108580645477815E-4
SIM,1905,16,30-34,1921,4
STAT,1843,25,35-39,1868,16.875797895148086
SIM,1845,28,15-19,1873,1
STAT,1815,99,na,1914,1.7603488473674485
SIM,1911,20,40-44,1931,7
STAT,1835,22,25-29,1857,98.5990380509633
STAT,1911,42,na,1953,7161.092169121279
SIM,1899,34,25-29,1933,29
STAT,1891,25,30-34,1916,63.29013123819526
STAT,1885,39,15-19,1924,0.11175114057940949
STAT,1906,39,45-49,1945,1.2535354580821372
SIM,1853,28,na,1881,4112
STAT,1853,22,40-44,1875,3.895550666097245
STAT,1868,38,na,1906,4504.618027550333
STAT,1862,26,15-19,1888,0.7917538552156582
STAT,1871,39,20-24,1910,1.5311528215938561
STAT,1861,15,50-100,1876,0.0957834270520771
STAT,1884,27,50-100,1911,1.2757196412629568
STAT,1924,31,15-19,1955,0.3028812589657642
SIM,1878,27,na,1905,5204
SIM,1926,20,35-39,1946,30
STAT,1927,24,45-49,1951,2.781792647168005
SIM,1841,36,30-34,1877,12
SIM,1861,22,40-44,1883,5
STAT,1934,21,30-34,1955,78.044627465488
SIM,1881,15,20-24,1896,36
STAT,1907,38,35-39,1945,4.509108344738994
SIM,1865,29,na,1894,4416
SIM,1920,11,na,1931,9224
SIM,1895,42,40-44,1937,1
STAT,1843,32,25-29,1875,17.24907710657525
STAT,1833,84,na,1917,437.3282817404451
STAT,1892,17,30-34,1909,4.029773579911903
STAT,1831,30,40-44,1861,7.47491779482253
SIM,1899,31,50-100,1930,3
SIM,1915,38,35-39,1953,8
SIM,1866,46,na,1912,4427
SIM,1905,23,20-24,1928,198
STAT,1844,48,na,1892,3587.646889145759
SIM,1902,19,30-34,1921,4
SIM,1942,21,30-34,1963,97
STAT,1847,18,30-34,1865,3.0145217068780013
STAT,1918,20,35-39,1938,20.62868594265548
SIM,1925,35,40-44,1960,4
STAT,1852,35,50-100,1887,2.0086918450148983
STAT,1891,18,40-44,1909,0.4553996386116901
SIM,1896,12,na,1908,7195
STAT,1920,49,20-24,1969,0.02452145137558326
STAT,1833,36,30-34,1869,8.868241611470339
STAT,1871,27,na,1898,4788.594721249598
SIM,1833,26,30-34,1859,46
STAT,1832,67,na,1899,2066.6768142081582
SIM,1832,27,40-44,1859,9
SIM,1866,32,20-24,1898,3
SIM,1872,32,45-49,1904,4
SIM,1888,46,30-34,1934,2
STAT,1917,35,40-44,1952,3.1698068520520466
SIM,1851,25,35-39,1876,21
SIM,1838,37,50-100,1875,7
SIM,1857,39,50-100,1896,3
STAT,1845,65,na,1910,2604.123536865414
STAT,1909,22,35-39,1931,17.683754293701504
SIM,1865,25,50-100,1890,1
SIM,1865,30,na,1895,4454
SIM,1929,27,50-100,1956,5
SIM,1827,76,na,1903,1029
STAT,1874,45,na,1919,4698.862280620199
SIM,1897,18,35-39,1915,2
SIM,1909,33,50-100,1942,3
SIM,1931,20,45-49,1951,3
STAT,1793,93,na,1886,13.883918755557826
STAT,1897,38,30-34,1935,14.316587385994278
SIM,1903,21,45-49,1924,1
SIM,1906,22,25-29,1928,178
SIM,1896,26,20-24,1922,36
STAT,1823,53,na,1876,2836.6501344908634
STAT,1838,20,35-39,1858,10.39528980639563
STAT,1901,32,25-29,1933,28.959621922726416
SIM,1835,95,na,1930,17
SIM,1845,31,50-100,1876,3
STAT,1919,43,50-100,1962,0.2566591800587616
SIM,1893,25,40-44,1918,10
SIM,1833,37,35-39,1870,18
STAT,1950,21,15-19,1971,12.757170940484396
SIM,1853,23,45-49,1876,2
SIM,1934,33,40-44,1967,13
SIM,1856,38,35-39,1894,18
STAT,1797,105,na,1902,0.014187570885173067
STAT,1851,34,25-29,1885,16.18639080101659
SIM,1939,22,20-24,1961,224
SIM,1856,24,25-29,1880,111
STAT,1787,76,na,1863,703.2972805987399
SIM,1863,31,40-44,1894,9
STAT,1872,37,15-19,1909,0.11397918881617075
STAT,1897,24,20-24,1921,184.87442086270585
STAT,1899,26,30-34,1925,69.92093800923985
STAT,1900,15,40-44,1915,0.5148064971713839
SIM,1917,22,35-39,1939,25
STAT,1892,28,35-39,1920,24.309474590342383
SIM,1885,42,50-100,1927,4
STAT,1840,34,15-19,1874,0.2452211114475265
SIM,1882,25,30-34,1907,72
SIM,1820,55,na,1875,2435
SIM,1936,21,40-44,1957,9
STAT,1851,48,35-39,1899,0.21429863364936336
STAT,1841,19,40-44,1860,0.3382498119353391
STAT,1952,19,20-24,1971,327.8793819517629
STAT,1850,17,40-44,1867,0.34269287798935544
STAT,1859,24,35-39,1883,9.593298996973344
SIM,1938,26,35-39,1964,40
SIM,1829,35,20-24,1864,1
STAT,1845,23,45-49,1868,1.3243789822532
STAT,1848,38,35-39,1886,11.828014321512352
SIM,1862,39,20-24,1901,1
STAT,1828,38,15-19,1866,0.11080657154675566
STAT,1916,7,na,1923,8537.196435103986
STAT,1938,32,20-24,1970,4.954101887868222
SIM,1882,25,15-19,1907,1
SIM,1937,32,na,1969,7661
SIM,1838,33,20-24,1871,5
SIM,1843,28,na,1871,3869
SIM,1881,77,na,1958,1472
SIM,1875,23,30-34,1898,66
STAT,1923,20,45-49,1943,2.658980506250506
SIM,1849,47,40-44,1896,2
SIM,1861,18,20-24,1879,32
SIM,1835,20,25-29,1855,115
SIM,1948,20,20-24,1968,267
STAT,1853,18,20-24,1871,33.54371145950561
STAT,1929,34,20-24,1963,6.24865436371812
STAT,1910,19,15-19,1929,18.070778869960783
STAT,1834,80,na,1914,822.0760357668842
SIM,1888,39,40-44,1927,14
SIM,1897,62,na,1959,5185
STAT,1787,86,na,1873,135.25106436572884
STAT,1855,31,40-44,1886,6.728044452529429
STAT,1902,27,na,1929,6804.803888759787
SIM,1879,27,30-34,1906,61
STAT,1861,82,na,1943,784.3289821340371
STAT,1859,78,na,1937,1255.9838732067612
STAT,1876,2,na,1878,6807.259965872083
STAT,1848,24,25-29,1872,112.65618389928252
STAT,1857,36,35-39,1893,11.187760659945557
STAT,1944,24,45-49,1968,2.4517322442466374
SIM,1864,23,20-24,1887,122
SIM,1900,20,15-19,1920,10
STAT,1924,38,35-39,1962,5.752845314965935
SIM,1844,68,na,1912,2110
SIM,1900,45,50-100,1945,2
STAT,1816,46,25-29,1862,0.28738368923281904
SIM,1928,22,45-49,1950,3
SIM,1820,65,na,1885,1753
STAT,1845,49,20-24,1894,0.01810514611045401
SIM,1937,34,20-24,1971,6
STAT,1766,91,na,1857,20.448826678258193
SIM,1932,38,35-39,1970,11
SIM,1849,33,30-34,1882,52
SIM,1900,33,50-100,1933,4
STAT,1895,29,15-19,1924,1.1854438836931234
STAT,1883,37,25-29,1920,5.7131142972763
STAT,1883,23,15-19,1906,6.5259378880722
STAT,1943,29,na,1972,8049.423300126468
SIM,1841,24,15-19,1865,6
STAT,1829,41,40-44,1870,3.760042021268205
STAT,1874,55,na,1929,4275.855508792598
SIM,1891,37,25-29,1928,11
STAT,1941,19,45-49,1960,1.0385141804198506
SIM,1792,73,na,1865,1011
SIM,1847,45,30-34,1892,1
STAT,1804,73,na,1877,1031.4167380971244
STAT,1841,26,30-34,1867,45.70911906052014
SIM,1803,63,na,1866,1889
SIM,1865,29,45-49,1894,4
SIM,1948,17,na,1965,8727
STAT,1802,92,na,1894,31.965205819013295
STAT,1869,39,15-19,1908,0.10878507715172507
STAT,1839,38,40-44,1877,8.08372155578164
SIM,1805,88,na,1893,74
STAT,1831,36,15-19,1867,0.09281688421933158
STAT,1867,23,30-34,1890,33.586486553173984
STAT,1889,39,35-39,1928,17.435952171282207
SIM,1867,35,40-44,1902,10
SIM,1833,25,35-39,1858,22
STAT,1882,74,na,1956,2251.721816986487
SIM,1891,23,15-19,1914,10
STAT,1805,53,50-100,1858,0.11621269184860801
STAT,1865,85,na,1950,502.9849332319924
STAT,1861,27,50-100,1888,1.0831407654652503
STAT,1902,24,40-44,1926,5.904464514158906
STAT,1907,27,45-49,1934,3.295782017316734
STAT,1928,21,40-44,1949,8.502831114328687
STAT,1825,65,na,1890,1955.3469855053693
STAT,1929,20,45-49,1949,2.89052198413306
STAT,1927,39,15-19,1966,0.04810948275208563
SIM,1946,25,30-34,1971,92
SIM,1897,39,35-39,1936,8
STAT,1914,16,30-34,1930,5.105534391875325
SIM,1852,87,na,1939,237
STAT,1896,46,15-19,1942,6.033426953248674E-4
STAT,1922,20,50-100,1942,1.5326227463133273
STAT,1884,7,na,1891,5195.784899734587
SIM,1877,39,15-19,1916,1
STAT,1857,29,45-49,1886,1.7745385967144258
SIM,1884,20,20-24,1904,147
SIM,1915,27,45-49,1942,5
STAT,1896,32,40-44,1928,11.563543637440567
SIM,1803,76,na,1879,891
SIM,1922,16,30-34,1938,46
STAT,1825,37,35-39,1862,18.603876401386557
STAT,1856,30,45-49,1886,2.8082747629518887
STAT,1889,25,25-29,1914,106.05505175981133
SIM,1905,30,45-49,1935,4
SIM,1865,20,na,1885,4551
STAT,1947,25,25-29,1972,150.5110305192194
STAT,1926,33,40-44,1959,9.549078681902593
STAT,1827,46,na,1873,3094.42925730654
STAT,1888,26,20-24,1914,28.099839730380765
STAT,1839,45,30-34,1884,0.1579954568345429
STAT,1833,24,15-19,1857,5.789950055918991
STAT,1856,19,35-39,1875,0.9991289277481071
SIM,1769,87,na,1856,97
SIM,1846,20,35-39,1866,12
STAT,1867,30,20-24,1897,5.1537278617515385
STAT,1808,86,na,1894,174.3505101972027
SIM,1929,28,35-39,1957,50
SIM,1854,78,na,1932,1244
STAT,1877,26,45-49,1903,2.3364720355850777
SIM,1862,97,na,1959,13
STAT,1889,18,35-39,1907,1.3628335316720366
SIM,1879,48,30-34,1927,1
SIM,1877,27,15-19,1904,1
STAT,1912,37,na,1949,7417.96424136474
STAT,1906,21,20-24,1927,203.41791253277
STAT,1933,6,na,1939,10837.158376997744
STAT,1842,13,na,1855,4543.27944
SIM,1926,27,20-24,1953,46
STAT,1890,62,na,1952,4505.642263450105
STAT,1938,25,30-34,1963,78.4794710180537
STAT,1817,46,na,1863,2961.138805856529
SIM,1847,38,40-44,1885,15
SIM,1892,47,35-39,1939,1
STAT,1953,18,25-29,1971,105.82980173154685
STAT,1869,42,50-100,1911,2.064867142214289
STAT,1891,29,30-34,1920,62.414345409168874
STAT,1910,37,45-49,1947,1.3172616295523312
STAT,1892,74,na,1966,3465.966137967513
SIM,1909,16,15-19,1925,18
SIM,1879,34,20-24,1913,3
STAT,1892,16,35-39,1908,1.3907063067139678
SIM,1852,97,na,1949,7
STAT,1873,22,45-49,1895,1.4309430021471343
STAT,1888,58,na,1946,4720.653984141227
STAT,1863,102,na,1965,2.4914006973025753
SIM,1914,21,20-24,1935,246
SIM,1885,26,45-49,1911,4
STAT,1810,44,30-34,1854,8.079408298295276
STAT,1910,56,na,1966,6667.045148765502
SIM,1914,17,35-39,1931,3
STAT,1861,24,40-44,1885,3.5471743472370485
SIM,1926,0,na,1926,10620
STAT,1935,27,20-24,1962,50.262528970393646
SIM,1864,19,35-39,1883,2
STAT,1898,48,25-29,1946,0.08768549951948489
SIM,1835,28,20-24,1863,24
SIM,1887,21,35-39,1908,21
STAT,1776,91,na,1867,34.49016279614696
STAT,1937,1,na,1938,8206.631256051078
SIM,1885,19,20-24,1904,36
SIM,1856,46,na,1902,3808
SIM,1944,18,25-29,1962,107
STAT,1887,48,15-19,1935,8.921635952535086E-4
SIM,1889,37,35-39,1926,21
STAT,1918,27,20-24,1945,39.22679550523742
STAT,1806,51,na,1857,2363.6206776063527
SIM,1867,11,na,1878,5512
SIM,1938,33,25-29,1971,20
SIM,1864,30,45-49,1894,7
STAT,1921,37,20-24,1958,0.594312924116555
STAT,1841,38,30-34,1879,9.016695375158207
SIM,1855,30,na,1885,4314
SIM,1910,24,40-44,1934,9
STAT,1865,28,40-44,1893,5.476947352459762
STAT,1865,25,50-100,1890,1.1816776498724844
SIM,1918,32,45-49,1950,7
SIM,1860,26,40-44,1886,5
STAT,1833,53,na,1886,2859.642345830279
SIM,1796,102,na,1898,1
SIM,1841,27,35-39,1868,22
STAT,1936,18,25-29,1954,83.58905830630657
STAT,1907,26,50-100,1933,1.905355135157795
SIM,1889,23,25-29,1912,146
STAT,1833,27,35-39,1860,16.775554670961117
STAT,1898,37,35-39,1935,19.330914895016495
STAT,1911,22,40-44,1933,6.442135901597092
STAT,1915,45,50-100,1960,0.462500586088671
SIM,1864,16,30-34,1880,6
STAT,1854,30,50-100,1884,1.4685717882210096
STAT,1894,19,20-24,1913,45.748184465531644
STAT,1902,37,na,1939,6770.714107873246
STAT,1851,15,35-39,1866,1.0464641852246692
STAT,1893,59,na,1952,4975.031215379517
STAT,1826,36,40-44,1862,10.736256067873873
STAT,1814,52,50-100,1866,0.07499733820409701
STAT,1906,17,35-39,1923,1.6148203933439673
STAT,1851,82,na,1933,723.2879754576669
STAT,1905,55,na,1960,6235.468200841839
SIM,1854,68,na,1922,2441
STAT,1827,28,20-24,1855,48.497696666924654
STAT,1856,26,na,1882,3881.36206684493
STAT,1856,37,30-34,1893,8.304740927351432
SIM,1896,33,45-49,1929,1
STAT,1831,29,25-29,1860,72.20643385954241
STAT,1850,53,35-39,1903,0.012988069841185704
SIM,1934,29,20-24,1963,54
SIM,1829,42,45-49,1871,6
SIM,1943,27,20-24,1970,40
SIM,1897,25,25-29,1922,126
SIM,1880,34,45-49,1914,7
SIM,1902,22,40-44,1924,7
SIM,1816,48,50-100,1864,1
STAT,1925,23,30-34,1948,69.25221121829937
STAT,1898,34,15-19,1932,0.3858803828793905
STAT,1882,33,na,1915,4675.008288670373
SIM,1774,88,na,1862,72
SIM,1891,77,na,1968,3115
STAT,1862,15,45-49,1877,0.1306787235575054
STAT,1879,21,35-39,1900,12.364535342868468
STAT,1888,33,45-49,1921,4.145050899765735
STAT,1915,26,40-44,1941,9.635334354004751
STAT,1863,41,50-100,1904,1.8761529083424662
STAT,1842,18,45-49,1860,0.12415016593704216
STAT,1893,27,40-44,1920,7.668278276419434
STAT,1830,35,na,1865,3798.0024145003954
STAT,1856,23,20-24,1879,123.81863362569425
STAT,1882,16,25-29,1898,11.176084118049497
SIM,1892,15,30-34,1907,5
STAT,1956,16,35-39,1972,11.215320524930895
SIM,1850,29,35-39,1879,27
STAT,1872,34,45-49,1906,3.5092027028418853
SIM,1865,44,20-24,1909,1
STAT,1926,29,20-24,1955,43.87040838981657
SIM,1925,29,50-100,1954,4
STAT,1874,24,50-100,1898,0.8379967733364652
STAT,1930,16,15-19,1946,118.78792060090609
STAT,1882,43,50-100,1925,2.063445601281623
STAT,1842,29,35-39,1871,17.51085364860098
STAT,1854,19,50-100,1873,0.0887869902952712
STAT,1851,27,35-39,1878,17.513272683676966
STAT,1857,44,20-24,1901,0.2466284167645987
SIM,1904,31,50-100,1935,2
SIM,1895,27,15-19,1922,1
STAT,1842,36,25-29,1878,5.0809802775879005
SIM,1887,62,na,1949,4352
SIM,1917,22,na,1939,7997
SIM,1952,17,20-24,1969,348
SIM,1929,35,25-29,1964,3
SIM,1895,20,30-34,1915,66
SIM,1848,22,25-29,1870,138
SIM,1863,41,50-100,1904,6
STAT,1901,42,na,1943,6549.222546982566
STAT,1833,39,35-39,1872,11.406733384781276
STAT,1853,25,45-49,1878,2.0646270034724754
STAT,1927,28,25-29,1955,161.0134531565584
STAT,1838,83,na,1921,537.2691404447016
STAT,1871,37,50-100,1908,2.463484293399723
STAT,1852,26,40-44,1878,5.601110135937587
SIM,1929,21,15-19,1950,13
STAT,1867,26,35-39,1893,18.312850559332162
STAT,1944,17,20-24,1961,294.64401791214516
SIM,1844,49,50-100,1893,1
SIM,1875,30,na,1905,5332
SIM,1908,39,20-24,1947,1
STAT,1889,36,50-100,1925,3.072080631319897
STAT,1917,24,35-39,1941,20.08286180665934
SIM,1907,26,50-100,1933,2
SIM,1824,39,35-39,1863,17
STAT,1951,20,20-24,1971,268.4683392126973
STAT,1816,39,35-39,1855,47.04190607015171
STAT,1847,32,45-49,1879,3.121043326947668
SIM,1899,24,30-34,1923,52
SIM,1821,49,50-100,1870,1
SIM,1855,32,45-49,1887,6
STAT,1821,49,50-100,1870,0.6983757805097851
SIM,1825,47,50-100,1872,2
STAT,1897,17,30-34,1914,4.302876775592076
STAT,1892,46,30-34,1938,0.13844516074030422
SIM,1874,49,40-44,1923,1
STAT,1887,20,30-34,1907,40.47431511356293
SIM,1935,28,25-29,1963,204
STAT,1836,25,45-49,1861,1.9383749670989787
SIM,1947,23,25-29,1970,245
SIM,1899,31,20-24,1930,8
SIM,1937,27,30-34,1964,95
STAT,1885,38,50-100,1923,2.4558846804506027
STAT,1887,27,15-19,1914,1.0248199729979985
SIM,1850,36,25-29,1886,7
STAT,1851,72,na,1923,1957.717735717474
STAT,1926,28,50-100,1954,2.4009042188932144
SIM,1810,45,35-39,1855,1
SIM,1874,36,50-100,1910,3
SIM,1937,22,na,1959,7299
SIM,1925,24,35-39,1949,28
STAT,1880,39,15-19,1919,0.11827048836422402
STAT,1842,22,15-19,1864,6.195018129461284
STAT,1866,49,40-44,1915,0.3123666724175812
STAT,1835,65,na,1900,2188.741186231043
STAT,1912,28,15-19,1940,1.400454731913417
STAT,1873,60,na,1933,3913.6397235371787
STAT,1843,24,50-100,1867,0.7067636599470989
SIM,1850,22,15-19,1872,5
SIM,1908,43,40-44,1951,1
SIM,1839,39,45-49,1878,7
SIM,1838,26,30-34,1864,65
SIM,1918,28,25-29,1946,164
SIM,1833,83,na,1916,450
SIM,1876,29,20-24,1905,19
STAT,1901,39,45-49,1940,1.2043066545257008
STAT,1901,25,35-39,1926,27.466164943011446
SIM,1861,25,45-49,1886,4
SIM,1848,36,35-39,1884,20
SIM,1886,41,50-100,1927,5
SIM,1894,41,50-100,1935,1
STAT,1813,48,15-19,1861,0.002425343333486692
SIM,1828,36,15-19,1864,1
STAT,1861,27,na,1888,4040.911936112755
STAT,1929,27,30-34,1956,99.02848572441314
SIM,1841,39,35-39,1880,17
STAT,1844,20,25-29,1864,117.10131932764409
SIM,1882,28,35-39,1910,24
SIM,1931,37,na,1968,10103
SIM,1857,35,30-34,1892,11
STAT,1888,15,15-19,1903,14.23197724428588
STAT,1930,22,na,1952,9448.075035648137
STAT,1936,22,45-49,1958,2.172979576122837
SIM,1793,68,na,1861,1444
SIM,1907,33,30-34,1940,40
STAT,1850,32,50-100,1882,1.4696155818565577
SIM,1913,36,25-29,1949,1
STAT,1908,45,40-44,1953,0.2923956676911168
STAT,1816,43,20-24,1859,0.8411328483906233
STAT,1921,38,50-100,1959,0.9456152091856341
SIM,1808,46,40-44,1854,1
STAT,1901,44,50-100,1945,0.2046221641941377
SIM,1877,21,40-44,1898,7
STAT,1817,49,45-49,1866,1.1047725478488322
STAT,1939,23,25-29,1962,187.30950874004438
STAT,1903,28,50-100,1931,1.8330004223511307
STAT,1929,23,15-19,1952,13.551927156388318
STAT,1851,27,na,1878,3926.4407147326147
SIM,1864,37,30-34,1901,14
STAT,1891,25,15-19,1916,1.140298928343453
SIM,1911,28,50-100,1939,2
STAT,1870,96,na,1966,66.192532010143
STAT,1855,20,35-39,1875,10.429250424254935
STAT,1898,58,na,1956,5449.601421820584
SIM,1811,51,na,1862,2479
SIM,1883,28,35-39,1911,28
STAT,1865,20,45-49,1885,1.3138048046040707
STAT,1867,37,40-44,1904,8.279716501334148
STAT,1900,56,na,1956,5757.793774678998
STAT,1834,34,25-29,1868,17.10559029469279
STAT,1843,46,35-39,1889,0.19771712413312395
STAT,1843,94,na,1937,27.996851809377944
STAT,1883,34,20-24,1917,5.31768642735687
STAT,1939,14,na,1953,7967.728934700635
STAT,1886,27,15-19,1913,0.9672677578497092
SIM,1842,34,25-29,1876,21
SIM,1880,82,na,1962,1374
STAT,1877,23,40-44,1900,4.356573262352039
SIM,1779,87,na,1866,98
STAT,1847,47,30-34,1894,0.14686837480920678
STAT,1916,36,35-39,1952,5.026511158020329
STAT,1824,34,15-19,1858,0.5040480050954376
SIM,1809,47,na,1856,2654
SIM,1825,49,45-49,1874,2
SIM,1865,37,30-34,1902,11
SIM,1836,49,na,1885,2889
SIM,1875,37,40-44,1912,16
STAT,1865,41,na,1906,4259.876798716131
STAT,1926,36,45-49,1962,1.6838918369125668
SIM,1833,22,15-19,1855,5
STAT,1819,36,15-19,1855,0.3514699548694212
STAT,1874,28,35-39,1902,19.882926909812596
STAT,1924,15,na,1939,8891.042030023942
SIM,1833,48,40-44,1881,1
SIM,1852,20,25-29,1872,129
SIM,1854,26,15-19,1880,2
SIM,1916,45,40-44,1961,1
STAT,1908,22,na,1930,7090.154986777433
STAT,1850,28,30-34,1878,45.11077474839019
STAT,1900,18,45-49,1918,0.18252964752626685
SIM,1911,23,45-49,1934,2
SIM,1864,26,25-29,1890,85
SIM,1866,56,na,1922,3964
SIM,1904,24,15-19,1928,9
SIM,1914,24,25-29,1938,209
SIM,1909,37,na,1946,7294
STAT,1843,53,na,1896,2967.767201481899
STAT,1905,36,25-29,1941,1.8238536959250082
SIM,1851,16,na,1867,4509
STAT,1911,18,20-24,1929,54.66450539628901
SIM,1888,25,50-100,1913,1
SIM,1826,50,na,1876,2803
STAT,1866,24,50-100,1890,0.7551519941677497
SIM,1918,32,50-100,1950,1
STAT,1847,97,na,1944,8.189133663023538
STAT,1864,32,45-49,1896,3.148138755933794
STAT,1881,21,40-44,1902,4.080045151159942
SIM,1895,45,45-49,1940,1
STAT,1889,36,30-34,1925,13.335768018059513
STAT,1879,36,20-24,1915,1.636238213468031
STAT,1933,21,15-19,1954,14.30496929116001
SIM,1888,24,20-24,1912,162
STAT,1806,49,35-39,1855,0.8272155205668232
STAT,1892,39,40-44,1931,10.956231710451334
SIM,1814,49,35-39,1863,1
SIM,1866,15,na,1881,5102
STAT,1951,17,na,1968,8851.44163237218
SIM,1905,6,na,1911,7881
SIM,1891,27,30-34,1918,84
STAT,1883,5,na,1888,5252.081363443878
SIM,1863,20,35-39,1883,13
SIM,1929,25,30-34,1954,117
SIM,1872,28,25-29,1900,87
SIM,1873,20,45-49,1893,1
SIM,1941,21,15-19,1962,13
STAT,1909,48,na,1957,6802.5899368793125
STAT,1875,28,35-39,1903,19.99289098304925
STAT,1886,26,na,1912,5105.390920910208
SIM,1919,20,45-49,1939,1
STAT,1825,48,40-44,1873,0.36617995798594655
STAT,1828,49,20-24,1877,0.021053212829202604
SIM,1847,42,na,1889,3522
STAT,1938,28,35-39,1966,30.030338827579776
STAT,1892,33,na,1925,6007.839916582997
SIM,1834,36,40-44,1870,4
SIM,1883,35,50-100,1918,5
SIM,1909,20,35-39,1929,21
STAT,1846,26,15-19,1872,0.8467859199879706
SIM,1844,22,40-44,1866,3
STAT,1856,26,25-29,1882,68.7976247620183
SIM,1890,27,30-34,1917,69
SIM,1880,27,20-24,1907,28
STAT,1941,22,50-100,1963,1.3733716402249547
STAT,1940,9,na,1949,8130.309871355273
SIM,1904,38,na,1942,6921
STAT,1903,23,45-49,1926,1.9989956478906479
SIM,1901,37,45-49,1938,3
SIM,1849,36,35-39,1885,18
STAT,1889,29,40-44,1918,7.406336112253427
STAT,1906,24,25-29,1930,167.41598553319997
STAT,1879,29,30-34,1908,52.815983771098416
SIM,1948,23,25-29,1971,261
SIM,1824,36,30-34,1860,18
SIM,1922,5,na,1927,9902
STAT,1883,59,na,1942,3856.364163470652
STAT,1862,67,na,1929,2736.404987482872
SIM,1894,27,15-19,1921,1
STAT,1866,16,40-44,1882,0.3519133843840157
STAT,1943,29,20-24,1972,39.222553200963574
SIM,1926,16,15-19,1942,100
STAT,1810,47,35-39,1857,0.9132145517318979
STAT,1838,35,20-24,1873,1.2852833703692992
STAT,1856,16,30-34,1872,2.9541242239610535
STAT,1915,55,na,1970,7242.453001677694
SIM,1891,34,20-24,1925,8
SIM,1893,48,na,1941,5900
STAT,1914,30,45-49,1944,3.225265813276141
STAT,1848,35,30-34,1883,9.194637115480397
STAT,1810,54,50-100,1864,0.08965772519446481
STAT,1854,49,15-19,1903,6.003913645659109E-4
STAT,1875,35,50-100,1910,2.577154133810396
SIM,1840,39,35-39,1879,23
STAT,1857,33,15-19,1890,0.22323169349087196
SIM,1859,22,35-39,1881,16
STAT,1890,52,na,1942,5279.782159347256
SIM,1898,36,30-34,1934,22
STAT,1832,39,35-39,1871,11.405360855651086
SIM,1849,23,na,1872,4238
SIM,1861,57,na,1918,3838
SIM,1933,23,30-34,1956,104
SIM,1885,23,40-44,1908,6
SIM,1883,48,na,1931,4613
STAT,1875,85,na,1960,832.3191472192168
SIM,1896,15,15-19,1911,14
SIM,1897,29,40-44,1926,10
SIM,1887,29,30-34,1916,81
STAT,1882,27,30-34,1909,49.54278585175343
STAT,1941,16,40-44,1957,2.9106046147477875
SIM,1898,47,na,1945,6281
STAT,1918,49,15-19,1967,7.869219026324221E-4
STAT,1931,26,25-29,1957,171.70437349571668
SIM,1822,36,na,1858,3219
SIM,1934,36,45-49,1970,3
STAT,1896,44,50-100,1940,0.1929745751836893
SIM,1842,27,35-39,1869,26
STAT,1839,48,35-39,1887,0.2198898073080728
STAT,1851,45,30-34,1896,0.15155368864556545
SIM,1944,22,45-49,1966,3
STAT,1817,91,na,1908,58.44764209222373
STAT,1916,43,25-29,1959,0.14755832260848295
STAT,1812,108,na,1920,0.0017363024350598648
SIM,1906,8,na,1914,7648
SIM,1933,30,20-24,1963,8
STAT,1834,27,35-39,1861,16.84211937045843
SIM,1846,35,20-24,1881,1
STAT,1799,64,na,1863,1723.4939737103632
STAT,1839,30,45-49,1869,3.4211001612838134
STAT,1829,27,na,1856,3333.4260595237206
SIM,1924,36,35-39,1960,14
STAT,1829,30,35-39,1859,20.568094179763108
SIM,1922,30,45-49,1952,7
SIM,1856,35,30-34,1891,15
STAT,1880,18,15-19,1898,12.593109463214507
STAT,1896,21,35-39,1917,15.606865912601151
SIM,1847,48,35-39,1895,1
STAT,1947,22,20-24,1969,253.79005745318784
SIM,1840,21,45-49,1861,2
STAT,1864,102,na,1966,2.892035202855773
SIM,1905,38,40-44,1943,10
STAT,1925,30,20-24,1955,5.855235354649975
STAT,1860,86,na,1946,363.89532029026424
STAT,1888,2,na,1890,6363.10388220472
SIM,1879,37,25-29,1916,9
STAT,1915,29,45-49,1944,3.533676596218551
STAT,1839,27,na,1866,4255.259186308771
STAT,1864,25,20-24,1889,21.40527062220027
SIM,1810,55,na,1865,2432
SIM,1846,28,30-34,1874,58
STAT,1898,45,20-24,1943,0.018684709534953436
SIM,1867,31,25-29,1898,29
STAT,1884,47,35-39,1931,0.2778962315683031
STAT,1873,44,50-100,1917,2.138636002577972
SIM,1860,15,35-39,1875,1
SIM,1882,18,40-44,1900,1
SIM,1780,95,na,1875,3
STAT,1844,24,40-44,1868,4.141517807560358
STAT,1929,14,na,1943,10178.501043076045
STAT,1824,38,30-34,1862,15.479857106302376
SIM,1934,18,15-19,1952,100
STAT,1876,26,na,1902,5002.219888003109
STAT,1888,30,40-44,1918,10.435235770099471
SIM,1900,24,30-34,1924,70
STAT,1864,45,na,1909,4102.151901858296
SIM,1903,17,25-29,1920,25
STAT,1769,98,na,1867,0.7396130301331842
STAT,1880,29,20-24,1909,24.781128835507374
STAT,1857,47,25-29,1904,0.09025101692718014
SIM,1861,16,na,1877,5061
SIM,1832,38,30-34,1870,16
STAT,1851,38,40-44,1889,6.78774887976672
STAT,1901,36,40-44,1937,2.684284665157368
SIM,1850,26,30-34,1876,53
SIM,1847,30,45-49,1877,4
STAT,1840,20,40-44,1860,3.880620698188436
SIM,1854,44,45-49,1898,8
STAT,1929,41,45-49,1970,0.43587762961347887
SIM,1831,27,25-29,1858,75
SIM,1852,24,40-44,1876,6
STAT,1871,16,15-19,1887,12.055677932935494
SIM,1910,45,na,1955,7195
STAT,1848,17,35-39,1865,1.1153390990445315
STAT,1904,26,15-19,1930,1.3196788724806878
STAT,1907,26,na,1933,7108.376449007245
SIM,1881,44,50-100,1925,5
STAT,1856,71,na,1927,2079.9346105054037
STAT,1917,9,na,1926,8622.691697249811
STAT,1926,18,15-19,1944,112.06251640246582
SIM,1896,30,40-44,1926,16
STAT,1824,80,na,1904,661.3635460075178
SIM,1874,16,40-44,1890,1
SIM,1923,29,45-49,1952,10
STAT,1890,8,na,1898,6408.2868320915795
STAT,1903,49,20-24,1952,0.019058273024965978
STAT,1819,54,50-100,1873,0.05847061241693641
SIM,1849,43,25-29,1892,5
STAT,1879,46,15-19,1925,8.47389218115565E-4
STAT,1906,41,na,1947,6856.223236309765
STAT,1841,15,25-29,1856,10.730284279984687
STAT,1887,73,na,1960,3005.979636166108
STAT,1846,37,20-24,1883,1.2329994647823515
SIM,1886,33,35-39,1919,30
STAT,1797,86,na,1883,143.68748279565457
SIM,1882,63,na,1945,3608
STAT,1863,18,50-100,1881,0.08940858696861094
SIM,1830,65,na,1895,2088
SIM,1819,42,35-39,1861,5
SIM,1856,17,35-39,1873,2
STAT,1905,42,50-100,1947,0.2140110479509419
STAT,1849,78,na,1927,1235.9107063994002
SIM,1860,31,na,1891,4134
SIM,1922,23,20-24,1945,256
SIM,1908,46,45-49,1954,2
SIM,1877,24,45-49,1901,2
SIM,1939,21,25-29,1960,203
SIM,1823,36,30-34,1859,11
STAT,1918,16,15-19,1934,20.061120808427827
STAT,1861,27,45-49,1888,1.8799888744234834
STAT,1878,33,35-39,1911,21.27088369598791
STAT,1868,29,20-24,1897,22.3811792718402
STAT,1890,18,25-29,1908,13.932769510025372
SIM,1837,41,40-44,1878,9
SIM,1897,36,30-34,1933,22
STAT,1872,16,15-19,1888,12.156824289753061
SIM,1880,16,15-19,1896,17
SIM,1944,15,20-24,1959,298
SIM,1885,81,na,1966,1851
STAT,1950,21,50-100,1971,1.5769063546514
STAT,1883,27,30-34,1910,49.967773161066205
STAT,1838,28,30-34,1866,43.04177261827838
STAT,1850,24,15-19,1874,5.984359790558624
STAT,1936,15,20-24,1951,263.4160659269668
STAT,1836,22,40-44,1858,3.657337563409097
STAT,1892,49,35-39,1941,0.1954948958833441
SIM,1853,31,50-100,1884,3
STAT,1852,15,35-39,1867,1.0702917718580887
SIM,1940,11,na,1951,8319
STAT,1914,23,20-24,1937,228.76335793916746
SIM,1838,29,35-39,1867,22
SIM,1843,83,na,1926,484
SIM,1926,34,45-49,1960,8
SIM,1918,25,20-24,1943,43
STAT,1917,21,30-34,1938,61.87355959791744
STAT,1913,38,25-29,1951,1.9531589824946876
STAT,1816,61,na,1877,2227.7123273511866
SIM,1845,32,35-39,1877,25
SIM,1854,37,20-24,1891,1
STAT,1893,16,35-39,1909,1.408078283202805
SIM,1881,22,45-49,1903,2
STAT,1854,0,na,1854,6170.74066149921
SIM,1853,26,15-19,1879,1
STAT,1945,21,na,1966,8085.194841347133
STAT,1849,42,20-24,1891,0.25090089516969544
SIM,1856,7,na,1863,5017
STAT,1842,33,20-24,1875,4.8112983735699535
SIM,1901,19,15-19,1920,15
SIM,1929,32,20-24,1961,7
STAT,1934,35,40-44,1969,4.179963173700875
SIM,1878,42,40-44,1920,11
STAT,1843,39,45-49,1882,2.905635432589667
SIM,1872,18,30-34,1890,4
SIM,1834,25,35-39,1859,21
SIM,1906,48,35-39,1954,1
SIM,1851,46,35-39,1897,2
SIM,1899,20,15-19,1919,8
STAT,1842,26,30-34,1868,46.69874091481294
SIM,1874,34,na,1908,4577
SIM,1850,33,20-24,1883,7
SIM,1920,39,50-100,1959,1
SIM,1888,31,45-49,1919,8
SIM,1921,38,25-29,1959,4
STAT,1866,26,na,1892,4462.499409265703
STAT,1837,32,35-39,1869,17.701080010119647
STAT,1923,28,40-44,1951,10.766271879900575
STAT,1867,8,na,1875,5217.8555348068985
SIM,1906,15,35-39,1921,1
STAT,1864,18,30-34,1882,2.9591026971077716
SIM,1931,28,40-44,1959,16
STAT,1782,87,na,1869,110.3609829970685
SIM,1937,23,15-19,1960,11
STAT,1865,39,30-34,1904,9.680350247055348
SIM,1872,25,20-24,1897,25
SIM,1895,38,20-24,1933,4
STAT,1897,27,25-29,1924,114.1986892597078
STAT,1849,35,30-34,1884,8.807465977811896
STAT,1823,34,15-19,1857,0.6349820465752569
STAT,1948,22,20-24,1970,257.83276590657425
SIM,1896,22,na,1918,6517
STAT,1918,34,45-49,1952,3.347596967658883
SIM,1816,44,25-29,1860,3
STAT,1885,25,40-44,1910,6.062825694284166
STAT,1854,28,15-19,1882,0.7238967697788286
SIM,1874,26,35-39,1900,24
SIM,1883,35,25-29,1918,11
SIM,1846,49,na,1895,3411
SIM,1925,21,30-34,1946,83
SIM,1867,24,35-39,1891,15
SIM,1873,39,30-34,1912,20
STAT,1859,31,25-29,1890,16.532161579420137
STAT,1852,22,25-29,1874,108.3872371544806
STAT,1875,35,25-29,1910,6.043721150703014
STAT,1879,44,na,1923,4816.537310735064
STAT,1940,20,45-49,1960,2.3166647555192887
STAT,1894,11,na,1905,6710.05142107498
STAT,1903,16,20-24,1919,51.10470471567012
SIM,1858,82,na,1940,781
STAT,1907,31,15-19,1938,0.24371637529798607
SIM,1860,22,25-29,1882,117
SIM,1911,16,20-24,1927,46
STAT,1869,21,40-44,1890,4.090199399177501
SIM,1848,26,40-44,1874,8
STAT,1839,45,15-19,1884,6.528732384453914E-4
STAT,1833,24,30-34,1857,31.261436357170233
STAT,1845,26,15-19,1871,0.8571156995699908
SIM,1908,28,15-19,1936,1
STAT,1911,25,45-49,1936,3.426723695511699
SIM,1841,24,30-34,1865,46
SIM,1927,22,na,1949,9264
STAT,1850,50,30-34,1900,0.009258021040857357
SIM,1838,36,25-29,1874,8
STAT,1903,23,na,1926,6779.830218518028
SIM,1826,34,40-44,1860,15
SIM,1862,28,15-19,1890,3
STAT,1848,93,na,1941,47.92108970927802
STAT,1890,25,15-19,1915,1.126035423428663
STAT,1933,17,45-49,1950,1.3506771354150446
SIM,1870,31,na,1901,4654
STAT,1942,26,35-39,1968,31.839212691067612
STAT,1841,72,na,1913,1832.371947173712
STAT,1868,39,15-19,1907,0.10681648201816439
SIM,1851,39,45-49,1890,6
SIM,1821,38,20-24,1859,2
SIM,1941,17,45-49,1958,1
STAT,1860,16,45-49,1876,0.12429229030907389
STAT,1810,69,na,1879,1498.2257631087723
STAT,1841,35,20-24,1876,1.3454037241257264
STAT,1925,45,na,1970,9031.312607179992
SIM,1889,29,35-39,1918,36
SIM,1901,63,na,1964,5472
SIM,1859,67,na,1926,2722
SIM,1867,86,na,1953,364
STAT,1815,43,25-29,1858,3.7386067671968672
STAT,1910,48,15-19,1958,6.924480582904929E-4
STAT,1849,39,40-44,1888,6.939788351006309
SIM,1954,17,15-19,1971,116
STAT,1861,34,35-39,1895,16.877932995580334
SIM,1863,72,na,1935,2179
STAT,1847,14,na,1861,4500.641905994707
STAT,1877,41,35-39,1918,3.814746047344073
STAT,1855,45,20-24,1900,0.01827561474397917
SIM,1892,7,na,1899,7466
STAT,1814,59,na,1873,2132.402874708904
STAT,1865,27,50-100,1892,1.1737147833899277
STAT,1886,47,45-49,1933,0.5007927887624744
SIM,1813,41,45-49,1854,6
STAT,1864,35,15-19,1899,0.10233914698701875
STAT,1921,31,na,1952,8532.92083747418
SIM,1866,24,35-39,1890,12
STAT,1835,24,40-44,1859,3.537768317642389
SIM,1843,24,40-44,1867,4
SIM,1907,22,25-29,1929,194
SIM,1892,61,na,1953,5355
STAT,1872,32,45-49,1904,3.539506544908378
STAT,1890,44,50-100,1934,2.569165227114778
STAT,1832,40,20-24,1872,0.2599168533268808
STAT,1845,26,20-24,1871,22.162562911181396
SIM,1880,32,45-49,1912,6
STAT,1946,17,15-19,1963,101.65278798743964
SIM,1848,44,40-44,1892,8
SIM,1857,39,40-44,1896,8
STAT,1885,18,45-49,1903,0.13097353012089874
SIM,1862,19,25-29,1881,13
STAT,1856,50,na,1906,3403.3586268132826
SIM,1894,47,45-49,1941,1
STAT,1798,71,na,1869,1171.4089742200351
SIM,1885,41,35-39,1926,9
STAT,1853,20,50-100,1873,0.7734049620468699
STAT,1839,70,na,1909,2190.7998356350663
STAT,1882,34,25-29,1916,19.97873861742025
SIM,1839,35,30-34,1874,12
STAT,1936,31,40-44,1967,7.68270487250384
STAT,1877,52,45-49,1929,0.030272807947688975
STAT,1850,44,30-34,1894,1.7389577055957528
STAT,1945,24,45-49,1969,2.488652077066725
STAT,1882,23,15-19,1905,6.470433297646401
STAT,1884,31,25-29,1915,20.509999055372983
SIM,1848,33,30-34,1881,41
SIM,1922,33,na,1955,9001
STAT,1946,15,na,1961,8248.798750452283
SIM,1933,29,50-100,1962,3
STAT,1892,41,30-34,1933,2.9198536140110987
STAT,1872,13,na,1885,5317.956251742858
STAT,1896,49,25-29,1945,0.08482656434868477
SIM,1909,30,35-39,1939,21
STAT,1912,27,50-100,1939,1.9815291319049897
STAT,1861,42,40-44,1903,3.776396474657482
STAT,1824,38,25-29,1862,8.36268137933803
STAT,1875,44,35-39,1919,3.7144937556154947
SIM,1890,34,25-29,1924,37
STAT,1858,24,35-39,1882,9.455368638137454
SIM,1947,17,50-100,1964,2
SIM,1832,38,25-29,1870,9
STAT,1856,16,25-29,1872,10.502880165935565
STAT,1817,40,25-29,1857,3.7550670099539007
SIM,1865,40,25-29,1905,4
STAT,1826,46,35-39,1872,0.2829916681335587
STAT,1926,15,50-100,1941,0.9318565915264586
STAT,1836,53,40-44,1889,0.013888209830611679
STAT,1810,45,na,1855,2717.1300588829954
SIM,1823,43,25-29,1866,2
STAT,1852,41,30-34,1893,1.8406439572460773
STAT,1823,95,na,1918,15.95466520309486
SIM,1888,56,na,1944,4775
STAT,1833,27,40-44,1860,5.208064945538476
SIM,1854,36,na,1890,3959
SIM,1857,37,45-49,1894,4
STAT,1866,35,25-29,1901,5.416280700407507
SIM,1821,41,na,1862,3135
SIM,1864,16,25-29,1880,11
SIM,1883,44,35-39,1927,8
STAT,1808,53,35-39,1861,0.050056584356104696
SIM,1841,27,40-44,1868,6
SIM,1874,35,25-29,1909,4
SIM,1891,32,20-24,1923,8
STAT,1893,37,35-39,1930,18.10581641826203
SIM,1858,42,50-100,1900,4
SIM,1815,39,50-100,1854,4
STAT,1820,41,40-44,1861,9.362786346579494
STAT,1851,23,40-44,1874,3.829891951366292
STAT,1874,28,40-44,1902,6.172766068531188
STAT,1893,40,35-39,1933,4.682235938099185
SIM,1890,23,15-19,1913,7
SIM,1836,29,25-29,1865,77
STAT,1844,57,na,1901,3245.3812875344306
SIM,1809,92,na,1901,53
STAT,1832,48,30-34,1880,0.14730240472408693
STAT,1879,37,30-34,1916,11.258611091230797
STAT,1831,28,15-19,1859,0.7821912322681993
STAT,1880,39,20-24,1919,1.6235310450976228
STAT,1869,47,15-19,1916,7.791258172543826E-4
STAT,1838,45,15-19,1883,5.714060186418926E-4
SIM,1855,29,35-39,1884,22
STAT,1843,30,25-29,1873,17.61104197894278
STAT,1889,77,na,1966,2885.384584293066
SIM,1841,47,35-39,1888,2
SIM,1806,52,na,1858,2559
STAT,1883,32,20-24,1915,5.36360749356466
SIM,1855,23,20-24,1878,149
STAT,1834,26,45-49,1860,1.9520399395270767
STAT,1841,33,25-29,1874,17.844931399757286
STAT,1871,79,na,1950,1402.7651857363674
SIM,1935,20,35-39,1955,31
STAT,1833,47,35-39,1880,0.2159549635363058
SIM,1943,19,na,1962,8064
SIM,1869,77,na,1946,1451
STAT,1919,34,45-49,1953,3.3986501980714046
STAT,1931,39,45-49,1970,1.819592735211806
SIM,1838,26,25-29,1864,88
STAT,1849,54,35-39,1903,0.013243314392967177
SIM,1921,22,50-100,1943,2
SIM,1872,38,25-29,1910,9
STAT,1927,36,na,1963,9454.024616202729
SIM,1834,46,35-39,1880,1
STAT,1853,20,40-44,1873,3.952099068529305
STAT,1864,38,25-29,1902,5.1720606970922
STAT,1847,29,35-39,1876,17.425631059584557
STAT,1889,21,na,1910,5907.302719567155
SIM,1840,48,30-34,1888,1
STAT,1831,31,15-19,1862,0.24283901163650679
STAT,1813,48,20-24,1861,0.07276036400703974
STAT,1841,22,15-19,1863,6.063735674976297
STAT,1899,25,35-39,1924,26.88106400149256
STAT,1877,44,na,1921,4781.609547525604
STAT,1904,20,40-44,1924,6.076460018539961
SIM,1872,26,30-34,1898,64
SIM,1908,31,30-34,1939,37
STAT,1896,18,20-24,1914,47.14800572931348
STAT,1897,72,na,1969,4167.743072305442
STAT,1881,89,na,1970,606.1359092360682
STAT,1864,26,30-34,1890,45.617133222919804
SIM,1882,28,40-44,1910,8
STAT,1845,46,45-49,1891,0.364693321099456
SIM,1811,44,45-49,1855,10
STAT,1870,35,45-49,1905,3.9902794124148753
STAT,1882,36,20-24,1918,1.523864851435399
STAT,1836,23,45-49,1859,1.2150965537076552
STAT,1887,43,15-19,1930,0.030968206747928384
STAT,1898,26,30-34,1924,69.0605282529897
STAT,1828,29,25-29,1857,107.67033976576595
STAT,1866,51,30-34,1917,0.011145528453584963
STAT,1823,104,na,1927,0.08004014546173516
SIM,1853,26,20-24,1879,22
STAT,1881,35,20-24,1916,1.5190505645022907
SIM,1889,45,40-44,1934,1
SIM,1874,22,50-100,1896,3
STAT,1821,40,45-49,1861,5.037691751054754
SIM,1912,20,40-44,1932,5
STAT,1920,49,40-44,1969,0.3498393593627571
STAT,1847,23,20-24,1870,127.85178144584964
STAT,1880,26,15-19,1906,0.9685978851097408
SIM,1919,21,35-39,1940,31
SIM,1829,27,50-100,1856,1
SIM,1861,20,40-44,1881,8
STAT,1815,45,20-24,1860,0.06655213048824071
STAT,1829,27,20-24,1856,33.99529888044559
STAT,1871,33,40-44,1904,8.664965666754478
SIM,1837,27,20-24,1864,25
SIM,1851,30,25-29,1881,26
SIM,1889,34,30-34,1923,55
STAT,1909,47,50-100,1956,0.4199739738026668
SIM,1873,82,na,1955,807
SIM,1929,23,15-19,1952,11
STAT,1897,17,25-29,1914,15.298137693828624
SIM,1905,53,na,1958,6491
STAT,1868,44,50-100,1912,2.002598991126752
STAT,1879,15,50-100,1894,0.10397507175980285
STAT,1931,41,na,1972,10035.203633356248
STAT,1889,40,15-19,1929,0.034736695775444484
STAT,1865,39,25-29,1904,5.22961447257553
SIM,1853,46,45-49,1899,1
STAT,1934,29,50-100,1963,2.7019669043714685
STAT,1884,14,na,1898,5133.54846138781
SIM,1858,38,45-49,1896,8
SIM,1855,61,na,1916,3248
STAT,1920,38,30-34,1958,4.025160850906638
STAT,1874,25,30-34,1899,52.42731072745117
SIM,1810,45,40-44,1855,1
STAT,1761,94,na,1855,0.61218
STAT,1857,25,30-34,1882,41.423835661316964
SIM,1867,94,na,1961,76
SIM,1858,47,35-39,1905,1
STAT,1878,17,15-19,1895,12.51775198992874
SIM,1785,73,na,1858,780
STAT,1899,42,25-29,1941,0.12324227087231744
STAT,1891,45,30-34,1936,0.13766956253252088
SIM,1873,36,20-24,1909,3
STAT,1847,53,50-100,1900,0.022652113960477182
SIM,1912,47,na,1959,7318
STAT,1772,86,na,1858,107.67425685875294
STAT,1839,48,40-44,1887,0.2688938208880576
SIM,1850,31,20-24,1881,6
STAT,1903,49,40-44,1952,0.2718980179229309
SIM,1877,27,20-24,1904,26
SIM,1827,36,20-24,1863,3
SIM,1812,42,40-44,1854,9
STAT,1867,47,35-39,1914,0.26356493562321587
STAT,1814,44,20-24,1858,0.8539891133376939
STAT,1839,49,25-29,1888,0.08931727866666767
SIM,1830,85,na,1915,268
SIM,1926,15,na,1941,9391
STAT,1874,45,30-34,1919,0.2021698043532085
STAT,1878,50,40-44,1928,0.02252508749795445
STAT,1917,31,30-34,1948,33.45326524966574
STAT,1809,54,35-39,1863,0.060954407436702385
SIM,1875,47,35-39,1922,1
STAT,1843,49,45-49,1892,0.3236904524291811
STAT,1851,52,25-29,1903,0.00546153665607048
STAT,1827,77,na,1904,1045.252709040433
SIM,1789,87,na,1876,85
SIM,1888,48,na,1936,5233
STAT,1867,50,35-39,1917,0.016517385431342995
STAT,1814,45,50-100,1859,1.3126508549008067
STAT,1825,33,40-44,1858,14.065044099600485
STAT,1886,18,50-100,1904,0.10417421827063375
STAT,1828,33,50-100,1861,1.9925875816335168
STAT,1862,41,45-49,1903,2.595191866735462
STAT,1871,36,45-49,1907,4.019213044017474
STAT,1834,43,35-39,1877,2.86889964575813
SIM,1949,15,40-44,1964,1
SIM,1842,25,50-100,1867,1
SIM,1848,47,50-100,1895,1
SIM,1933,17,na,1950,10397
STAT,1825,51,50-100,1876,0.032204362474269395
SIM,1887,37,30-34,1924,7
SIM,1888,17,25-29,1905,14
SIM,1909,35,na,1944,7377
SIM,1833,33,40-44,1866,10
STAT,1834,28,40-44,1862,5.191188045711661
STAT,1876,45,35-39,1921,0.29535586790110674
SIM,1842,26,45-49,1868,3
STAT,1873,19,35-39,1892,1.1199435458943396
SIM,1922,25,na,1947,8970
SIM,1865,25,30-34,1890,62
SIM,1934,21,30-34,1955,86
STAT,1845,46,15-19,1891,6.181237527852022E-4
STAT,1935,31,na,1966,10575.643137722556
STAT,1865,36,20-24,1901,1.4211696035772687
SIM,1913,40,na,1953,7529
STAT,1807,54,30-34,1861,0.03723377070322681
STAT,1876,25,40-44,1901,6.299764472731609
SIM,1843,44,35-39,1887,5
STAT,1849,37,45-49,1886,3.2266534548355086
STAT,1905,49,45-49,1954,0.3807066247449516
SIM,1946,23,15-19,1969,12
STAT,1890,28,25-29,1918,103.91253447474934
SIM,1811,46,50-100,1857,1
SIM,1810,97,na,1907,11
SIM,1856,38,40-44,1894,12
STAT,1868,31,40-44,1899,8.367169583072524
SIM,1821,35,45-49,1856,7
STAT,1860,18,40-44,1878,0.3439309130868297
SIM,1883,24,40-44,1907,4
SIM,1911,49,40-44,1960,1
STAT,1884,19,40-44,1903,0.36280204499836494
STAT,1927,20,35-39,1947,23.565632295112177
STAT,1938,0,na,1938,8976.77517142236
STAT,1881,57,na,1938,3922.963045326971
SIM,1821,49,na,1870,2817
STAT,1850,28,50-100,1878,1.1459429013290743
SIM,1892,53,na,1945,6024
SIM,1831,37,25-29,1868,9
SIM,1884,25,40-44,1909,6
SIM,1913,49,45-49,1962,1
STAT,1809,80,na,1889,593.8947728724806
STAT,1886,27,20-24,1913,25.01078039529136
STAT,1928,21,35-39,1949,23.81125398377559
SIM,1833,22,30-34,1855,38
SIM,1927,34,45-49,1961,5
STAT,1851,43,35-39,1894,2.786814247863757
SIM,1894,27,20-24,1921,30
STAT,1938,23,15-19,1961,10.638318227339424
STAT,1926,21,30-34,1947,70.72031532279559
STAT,1823,37,25-29,1860,11.172171477064913
STAT,1903,38,30-34,1941,3.2914746599111924
SIM,1936,21,35-39,1957,18
STAT,1881,22,15-19,1903,6.439963034660205
STAT,1897,24,50-100,1921,1.0939963338446341
SIM,1876,79,na,1955,1466
STAT,1819,36,20-24,1855,4.82472331890848
SIM,1911,38,30-34,1949,4
STAT,1869,30,50-100,1899,1.8074498340236353
STAT,1800,59,na,1859,2134.7516894902255
STAT,1881,19,15-19,1900,11.52259894013889
STAT,1877,24,45-49,1901,1.453238818367027
STAT,1885,46,45-49,1931,0.47577689322733663
STAT,1886,47,15-19,1933,8.488006224638519E-4
SIM,1842,28,40-44,1870,9
STAT,1850,28,25-29,1878,75.77863020030044
STAT,1844,17,45-49,1861,0.13409617243697586
SIM,1858,26,na,1884,4179
STAT,1835,44,35-39,1879,2.740275419207039
SIM,1862,31,na,1893,4389
SIM,1868,30,50-100,1898,4
SIM,1878,28,20-24,1906,29
STAT,1846,100,na,1946,1.626131398653014
STAT,1855,42,50-100,1897,1.5910988026942996
STAT,1861,17,45-49,1878,0.12621122827951103
STAT,1830,35,45-49,1865,3.8417460374124737
STAT,1880,26,45-49,1906,2.3703575835422512
STAT,1826,52,na,1878,2830.3270508103233
STAT,1883,15,30-34,1898,3.1773669389414043
SIM,1854,44,na,1898,3796
STAT,1882,30,50-100,1912,1.8171081588893452
SIM,1872,33,na,1905,5004
STAT,1847,51,20-24,1898,0.0011302233298449062
STAT,1858,24,50-100,1882,0.6607526027131516
STAT,1879,50,50-100,1929,0.032362689623323865
SIM,1829,69,na,1898,1841
STAT,1825,53,35-39,1878,0.017642472954379866
STAT,1782,110,na,1892,0.0015517708665805164
STAT,1851,59,na,1910,3012.724350495718
SIM,1809,49,na,1858,2574
STAT,1841,54,50-100,1895,0.021310436566437992
STAT,1943,21,30-34,1964,61.77578729876502
SIM,1879,27,25-29,1906,91
STAT,1923,33,50-100,1956,1.9124709284928174
STAT,1856,46,20-24,1902,0.018751924338659298
SIM,1884,45,35-39,1929,1
SIM,1841,44,30-34,1885,4
STAT,1891,29,25-29,1920,104.84576304298588
STAT,1848,50,25-29,1898,0.005891325637402531
STAT,1944,20,35-39,1964,20.545258662613072
SIM,1869,38,50-100,1907,3
SIM,1880,84,na,1964,1080
STAT,1840,67,na,1907,2288.1673804310212
STAT,1937,21,50-100,1958,1.2947753329995992
SIM,1847,48,40-44,1895,1
SIM,1868,37,20-24,1905,2
STAT,1885,31,na,1916,4816.796353465929
STAT,1850,27,40-44,1877,5.405051873957863
STAT,1856,44,25-29,1900,0.9871256655652489
STAT,1872,29,15-19,1901,0.9143165908807892
SIM,1842,43,35-39,1885,6
SIM,1898,38,45-49,1936,1
STAT,1901,11,na,1912,7312.602009558865
SIM,1851,18,40-44,1869,2
SIM,1867,62,na,1929,3612
STAT,1871,19,25-29,1890,11.309398738466882
STAT,1892,44,35-39,1936,0.31363328712649896
STAT,1854,19,25-29,1873,10.26969728353465
STAT,1950,20,na,1970,8754.79468035359
STAT,1838,36,30-34,1874,8.794534343027035
STAT,1870,52,35-39,1922,0.016979403313048216
STAT,1909,21,25-29,1930,174.00001250377795
STAT,1840,37,25-29,1877,4.91547132043131
STAT,1905,25,na,1930,7017.801163200985
SIM,1870,41,45-49,1911,4
STAT,1889,39,40-44,1928,10.79128758851209
STAT,1900,20,50-100,1920,1.1492922682193885
STAT,1830,65,na,1895,2333.64072540726
STAT,1879,49,25-29,1928,0.1191381226554132
SIM,1877,47,45-49,1924,2
STAT,1843,18,40-44,1861,0.32549513947164693
SIM,1880,32,15-19,1912,1
SIM,1884,66,na,1950,3429
STAT,1872,32,15-19,1904,0.2890506244966962
STAT,1896,23,na,1919,6286.746294489415
SIM,1813,54,na,1867,2541
SIM,1913,1,na,1914,8675
SIM,1864,44,25-29,1908,1
SIM,1880,29,15-19,1909,2
STAT,1895,37,15-19,1932,0.14777806024527235
SIM,1939,30,20-24,1969,7
SIM,1870,30,35-39,1900,29
STAT,1918,1,na,1919,9178.439166699847
SIM,1846,36,30-34,1882,14
STAT,1866,34,40-44,1900,8.012193675924218
STAT,1824,54,30-34,1878,0.01334307764782919
STAT,1897,64,na,1961,4984.02818970243
SIM,1899,39,45-49,1938,2
SIM,1897,39,40-44,1936,5
SIM,1874,34,40-44,1908,11
STAT,1828,46,15-19,1874,7.300227842694554E-4
SIM,1937,17,15-19,1954,76
STAT,1902,42,50-100,1944,0.20892345285993769
STAT,1805,98,na,1903,2.4299392554019175
STAT,1832,43,25-29,1875,1.011052218488055
STAT,1855,48,25-29,1903,0.0857656580025326
SIM,1863,36,30-34,1899,13
STAT,1883,80,na,1963,1721.2379598930759
STAT,1916,22,25-29,1938,195.47885156894475
SIM,1830,38,20-24,1868,2
STAT,1940,29,45-49,1969,3.5546815265328955
SIM,1852,45,45-49,1897,1
SIM,1847,16,25-29,1863,11
SIM,1939,25,25-29,1964,143
STAT,1771,109,na,1880,0.004760602228759217
STAT,1882,31,20-24,1913,5.339721454613592
STAT,1848,109,na,1957,0.001607478107561399
STAT,1894,41,35-39,1935,4.719226700973216
STAT,1813,105,na,1918,0.026054372953014292
STAT,1940,31,50-100,1971,1.7293099090190536
SIM,1912,55,na,1967,7101
SIM,1930,12,na,1942,10948
STAT,1857,33,30-34,1890,27.36904674381607
SIM,1847,36,50-100,1883,1
SIM,1945,10,na,1955,9038
STAT,1918,43,na,1961,7960.926743379527
SIM,1883,41,30-34,1924,3
STAT,1939,13,na,1952,7981.2171917547
STAT,1846,42,45-49,1888,2.320169621872359
STAT,1884,47,50-100,1931,0.4875093876138225
STAT,1961,2,na,1963,10266.00920359048
SIM,1919,40,45-49,1959,2
STAT,1834,40,25-29,1874,1.0572434147642642
STAT,1762,112,na,1874,0.0017366455722001822
STAT,1897,32,na,1929,6442.185360498052
STAT,1862,11,na,1873,4741.139445462404
STAT,1839,16,25-29,1855,11.64329738348044
STAT,1839,78,na,1917,1219.9950335919696
STAT,1883,18,40-44,1901,0.3619787928726937
SIM,1856,70,na,1926,2273
STAT,1835,52,40-44,1887,0.013901789362541238
STAT,1794,65,na,1859,1648.209655753751
STAT,1918,49,30-34,1967,0.19043526090236074
SIM,1891,18,40-44,1909,2
SIM,1834,30,25-29,1864,23
SIM,1890,31,20-24,1921,10
STAT,1898,43,20-24,1941,0.02992358476544285
SIM,1862,16,20-24,1878,1
STAT,1849,51,30-34,1900,0.009460783079202834
STAT,1818,65,na,1883,1887.0566977864364
STAT,1858,41,25-29,1899,1.0155984437840893
STAT,1890,49,30-34,1939,0.13179509276933105
SIM,1873,34,25-29,1907,26
SIM,1843,27,45-49,1870,3
SIM,1843,84,na,1927,405
SIM,1907,18,40-44,1925,1
STAT,1775,106,na,1881,0.019290739663988466
STAT,1878,29,50-100,1907,1.3396598655166387
STAT,1833,44,30-34,1877,1.7880970231665902
STAT,1827,50,35-39,1877,0.015614359736057378
STAT,1830,97,na,1927,7.418438734668759
STAT,1858,5,na,1863,4624.584054195713
STAT,1888,44,15-19,1932,0.032519997559678215
STAT,1863,52,na,1915,3786.322189902778
SIM,1908,24,50-100,1932,1
STAT,1855,36,30-34,1891,8.075334415518876
STAT,1919,31,40-44,1950,8.559940571402667
STAT,1874,29,25-29,1903,86.85052930012027
SIM,1895,58,na,1953,5377
STAT,1788,93,na,1881,14.41197710337894
STAT,1815,40,20-24,1855,1.0281455832359274
SIM,1802,54,45-49,1856,1
SIM,1854,42,45-49,1896,6
SIM,1947,3,na,1950,9433
STAT,1860,30,25-29,1890,16.93375002839706
STAT,1822,38,20-24,1860,2.946830084094532
SIM,1870,26,20-24,1896,22
SIM,1842,40,25-29,1882,2
STAT,1778,104,na,1882,0.06997772821708088
STAT,1862,43,40-44,1905,3.854654966545922
STAT,1830,48,50-100,1878,0.418499744160095
STAT,1862,26,20-24,1888,20.472492377856117
STAT,1834,47,na,1881,3170.8110325013527
STAT,1854,16,20-24,1870,32.70353313171363
SIM,1846,48,25-29,1894,1
SIM,1870,43,40-44,1913,10
STAT,1882,39,30-34,1921,10.379862793251464
STAT,1835,27,45-49,1862,1.875003722631991
SIM,1890,39,30-34,1929,20
STAT,1904,23,45-49,1927,2.0151077534973876
SIM,1898,35,40-44,1933,22
STAT,1869,27,15-19,1896,0.8878684374086494
STAT,1860,87,na,1947,288.95107907648435
SIM,1886,29,50-100,1915,2
STAT,1847,35,15-19,1882,0.090676203595826
SIM,1817,44,na,1861,2989
SIM,1882,29,25-29,1911,90
STAT,1848,38,40-44,1886,7.320477992289262
STAT,1868,51,35-39,1919,0.016621684171334396
SIM,1939,16,35-39,1955,11
STAT,1826,30,25-29,1856,35.66906809395992
SIM,1898,26,na,1924,6754
STAT,1876,33,50-100,1909,1.9058317471661754
STAT,1891,28,40-44,1919,7.451749272644998
SIM,1830,29,30-34,1859,51
SIM,1832,42,50-100,1874,4
SIM,1881,19,35-39,1900,1
SIM,1872,23,20-24,1895,141
STAT,1834,23,40-44,1857,3.6831207156951757
STAT,1845,98,na,1943,5.005793022147053
SIM,1810,65,na,1875,1776
STAT,1826,60,na,1886,2415.7112309235363
SIM,1864,46,na,1910,4331
SIM,1906,9,na,1915,7635
STAT,1841,18,30-34,1859,2.965069646721582
SIM,1832,37,40-44,1869,11
SIM,1872,41,na,1913,4904
STAT,1891,24,25-29,1915,142.0122977391868
STAT,1836,20,40-44,1856,4.4486987130103195
STAT,1931,36,40-44,1967,4.007820050135834
SIM,1883,27,45-49,1910,3
STAT,1871,31,45-49,1902,3.513304567257807
SIM,1814,79,na,1893,610
STAT,1824,37,40-44,1861,13.297201650926242
STAT,1875,41,30-34,1916,2.401381188821657
STAT,1881,38,25-29,1919,5.592549582072272
SIM,1836,26,20-24,1862,22
SIM,1843,52,na,1895,3195
STAT,1838,48,25-29,1886,0.07917999783137893
STAT,1849,24,50-100,1873,0.7687165368031724
SIM,1798,91,na,1889,14
STAT,1820,44,45-49,1864,5.720903936698989
STAT,1833,54,na,1887,2803.564759435718
SIM,1832,33,na,1865,3608
STAT,1861,45,45-49,1906,0.40067308911999155
SIM,1876,23,na,1899,5076
STAT,1847,26,25-29,1873,78.06436519806738
SIM,1916,38,50-100,1954,2
STAT,1864,23,20-24,1887,125.50135264543763
STAT,1883,51,30-34,1934,0.011867998935767258
STAT,1808,50,30-34,1858,0.03680396426061513
STAT,1875,27,45-49,1902,2.3087105458097827
STAT,1815,48,25-29,1863,0.30468599274771396
STAT,1800,67,na,1867,1612.1028010708749
STAT,1830,30,45-49,1860,3.5707293674918077
STAT,1842,31,20-24,1873,4.912261514435471
STAT,1852,44,35-39,1896,2.847136688389257
SIM,1831,25,30-34,1856,52
SIM,1877,64,na,1941,3388
SIM,1834,49,45-49,1883,2
SIM,1840,95,na,1935,16
STAT,1892,9,na,1901,6560.000212448761
STAT,1844,45,45-49,1889,0.38712994391629535
STAT,1876,28,45-49,1904,2.3111036612410496
SIM,1842,43,na,1885,3394
STAT,1836,36,20-24,1872,1.2714386787328573
SIM,1875,35,50-100,1910,1
STAT,1841,30,20-24,1871,4.85834949776879
STAT,1814,47,25-29,1861,0.2984043025778701
STAT,1895,17,20-24,1912,46.65494484129953
SIM,1847,74,na,1921,1736
STAT,1893,21,25-29,1914,146.98420712677927
SIM,1871,39,20-24,1910,2
SIM,1924,22,25-29,1946,229
STAT,1904,38,50-100,1942,0.7643486792415374
STAT,1861,31,30-34,1892,29.46987389679954
STAT,1888,36,15-19,1924,0.1346897601167416
STAT,1859,28,45-49,1887,1.802571613034457
STAT,1886,80,na,1966,1980.0968763505805
SIM,1855,26,25-29,1881,87
SIM,1926,30,35-39,1956,27
STAT,1832,32,15-19,1864,0.24201758066558315
STAT,1945,21,40-44,1966,7.444365210475993
STAT,1925,39,20-24,1964,0.637495852359989
SIM,1840,43,25-29,1883,5
STAT,1828,26,20-24,1854,57.98759784631344
SIM,1809,57,na,1866,2224
SIM,1824,38,na,1862,3425
STAT,1846,72,na,1918,1934.3876560316219
STAT,1810,51,25-29,1861,0.022341504323133185
STAT,1824,33,25-29,1857,40.43298036092809
STAT,1914,39,45-49,1953,1.3610614348250043
STAT,1860,18,50-100,1878,0.09212432931734821
STAT,1905,33,na,1938,6999.515743971057
STAT,1921,46,25-29,1967,0.12104182830731125
SIM,1779,77,na,1856,665
SIM,1871,35,50-100,1906,1
STAT,1890,16,30-34,1906,3.938786746695468
SIM,1849,24,35-39,1873,10
SIM,1918,20,35-39,1938,29
SIM,1832,33,25-29,1865,18
SIM,1842,23,40-44,1865,6
STAT,1936,34,45-49,1970,3.0834927632864666
SIM,1822,47,25-29,1869,1
SIM,1912,38,50-100,1950,2
STAT,1863,39,20-24,1902,1.3490684466501943
STAT,1902,68,na,1970,5077.2210656602565
STAT,1808,55,na,1863,2315.260028811075
STAT,1826,49,45-49,1875,0.4579847969710464
STAT,1918,30,35-39,1948,19.766320642778616
SIM,1861,23,45-49,1884,5
STAT,1900,41,35-39,1941,0.3538888750787755
SIM,1896,43,na,1939,6476
STAT,1847,46,na,1893,3439.2634780976077
SIM,1884,28,45-49,1912,5
STAT,1843,51,30-34,1894,0.00837833305445061
STAT,1892,25,25-29,1917,107.6760962594839
STAT,1860,105,na,1965,0.2818336480487403
STAT,1905,46,40-44,1951,0.282863705629451
SIM,1917,24,35-39,1941,25
STAT,1838,85,na,1923,371.0045203388971
SIM,1858,44,30-34,1902,2
STAT,1876,53,40-44,1929,0.02163769750381966
SIM,1792,75,na,1867,833
SIM,1858,35,40-44,1893,10
STAT,1854,24,na,1878,3796.1041359187675
STAT,1937,30,45-49,1967,3.1483700442676428
SIM,1930,20,na,1950,10027
SIM,1833,34,25-29,1867,3
SIM,1874,30,25-29,1904,20
STAT,1843,32,na,1875,3649.765794935649
STAT,1809,51,30-34,1860,0.04477081706597131
STAT,1858,38,na,1896,3690.8955289643595
STAT,1913,20,na,1933,7514.756118531611
SIM,1885,30,50-100,1915,3
STAT,1892,15,50-100,1907,0.12444146534527378
STAT,1909,4,na,1913,7971.998042691305
SIM,1838,39,30-34,1877,15
STAT,1886,42,45-49,1928,3.1868225677874205
STAT,1854,16,15-19,1870,10.947369155702777
STAT,1819,40,35-39,1859,8.906746729668743
STAT,1847,22,na,1869,3995.5075464054594
STAT,1819,51,45-49,1870,0.05965002665507492
SIM,1839,43,30-34,1882,4
SIM,1885,51,na,1936,4605
STAT,1821,42,40-44,1863,7.151407207336905
STAT,1850,23,25-29,1873,104.5933083043859
SIM,1844,20,40-44,1864,5
SIM,1896,36,15-19,1932,1
STAT,1855,17,20-24,1872,31.796786429741253
SIM,1817,37,45-49,1854,6
SIM,1853,30,35-39,1883,34
STAT,1825,34,25-29,1859,30.588571760156185
STAT,1913,38,50-100,1951,0.8328630028107066
STAT,1853,40,35-39,1893,2.8939818134052184
STAT,1898,34,30-34,1932,47.31038891204547
STAT,1912,27,na,1939,7457.786149538394
STAT,1816,82,na,1898,458.30176394972307
STAT,1853,23,45-49,1876,1.2942393495546343
SIM,1800,87,na,1887,74
SIM,1840,18,35-39,1858,1
STAT,1849,34,40-44,1883,7.07995848286169
SIM,1890,38,na,1928,6140
STAT,1816,41,20-24,1857,0.9109282111403305
STAT,1871,49,50-100,1920,0.48251079776531997
SIM,1913,46,40-44,1959,1
SIM,1940,19,na,1959,7763
SIM,1920,42,na,1962,8464
SIM,1891,15,30-34,1906,2
STAT,1861,34,50-100,1895,1.5270297473827024
SIM,1853,41,45-49,1894,5
SIM,1884,42,30-34,1926,2
STAT,1864,51,20-24,1915,0.001338546812718485
STAT,1932,23,20-24,1955,293.7684022582898
STAT,1890,41,20-24,1931,0.3932703275933854
SIM,1873,38,40-44,1911,13
STAT,1917,34,35-39,1951,19.159293702595484
SIM,1863,17,20-24,1880,37
STAT,1832,24,15-19,1856,6.0275344766112235
STAT,1927,41,40-44,1968,0.6343573433870021
STAT,1849,88,na,1937,217.15494303257003
STAT,1828,26,15-19,1854,2.242614299330455
SIM,1827,40,35-39,1867,6
STAT,1831,43,50-100,1874,1.651391169251715
SIM,1937,20,45-49,1957,6
STAT,1898,45,40-44,1943,0.26656851233920215
SIM,1848,28,35-39,1876,28
STAT,1831,31,45-49,1862,2.9736322920704215
STAT,1909,24,35-39,1933,17.57305091838644
SIM,1940,23,20-24,1963,235
STAT,1838,33,20-24,1871,4.498898898128583
STAT,1872,64,na,1936,3528.4164907126515
STAT,1840,34,20-24,1874,4.654574093436198
SIM,1846,33,20-24,1879,7
SIM,1838,23,20-24,1861,126
STAT,1876,42,30-34,1918,2.398539043124084
SIM,1905,22,15-19,1927,9
STAT,1815,48,30-34,1863,0.5120417427471148
STAT,1855,113,na,1968,1.3248105342434383E-4
STAT,1865,38,40-44,1903,7.992053172548569
STAT,1947,17,30-34,1964,27.728025248692415
STAT,1810,52,50-100,1862,0.09335580775844637
STAT,1823,50,20-24,1873,0.0022838027697113937
STAT,1860,53,50-100,1913,0.024372055136605064
SIM,1783,90,na,1873,41
SIM,1857,34,40-44,1891,11
SIM,1875,31,25-29,1906,27
STAT,1897,47,20-24,1944,0.018188681386118722
SIM,1824,41,20-24,1865,2
STAT,1877,54,40-44,1931,0.02147101204186998
STAT,1895,17,15-19,1912,15.617545115373721
STAT,1888,28,na,1916,5676.733713576018
SIM,1864,29,30-34,1893,56
SIM,1885,21,40-44,1906,4
SIM,1776,88,na,1864,69
STAT,1874,40,25-29,1914,1.3413252942590328
SIM,1927,31,40-44,1958,20
SIM,1865,38,50-100,1903,4
STAT,1866,38,35-39,1904,13.114871708714412
SIM,1889,46,25-29,1935,1
STAT,1937,27,15-19,1964,1.3900937736070018
STAT,1892,42,15-19,1934,0.03487234905193554
SIM,1871,48,na,1919,4310
SIM,1894,31,35-39,1925,4
STAT,1842,50,30-34,1892,0.00898959554947265
STAT,1845,30,35-39,1875,18.943960922646315
SIM,1899,36,40-44,1935,4
STAT,1835,41,30-34,1876,1.8079446663799361
SIM,1894,42,45-49,1936,1
SIM,1948,19,40-44,1967,6
STAT,1886,31,35-39,1917,21.678554833643545
STAT,1881,49,na,1930,4300.173111704665
STAT,1866,18,35-39,1884,1.0433400995827324
SIM,1882,40,25-29,1922,3
SIM,1826,45,50-100,1871,2
STAT,1852,36,35-39,1888,11.452364844214003
STAT,1910,28,20-24,1938,35.487362518231016
SIM,1840,24,15-19,1864,6
SIM,1864,49,30-34,1913,1
SIM,1879,24,20-24,1903,130
STAT,1880,64,na,1944,3698.4844489766
STAT,1851,24,25-29,1875,104.45791748388501
STAT,1929,17,15-19,1946,116.96177263010496
SIM,1909,27,na,1936,7277
SIM,1905,13,na,1918,7783
SIM,1827,97,na,1924,7
SIM,1823,83,na,1906,426
STAT,1864,77,na,1941,1560.4953466771244
STAT,1943,24,35-39,1967,20.21792485048688
STAT,1846,39,15-19,1885,0.08797504382640776
SIM,1865,42,20-24,1907,1
STAT,1887,29,50-100,1916,1.43460527786776
STAT,1929,32,50-100,1961,2.1208176036268207
SIM,1865,33,30-34,1898,40
STAT,1805,90,na,1895,58.97348310514295
STAT,1887,43,45-49,1930,3.3561791706764437
STAT,1818,40,40-44,1858,11.942775592221642
STAT,1925,21,na,1946,8852.949676591612
STAT,1854,8,na,1862,4503.21207570195
SIM,1842,40,30-34,1882,4
SIM,1860,36,35-39,1896,17
STAT,1856,49,30-34,1905,0.14768789543233726
SIM,1900,31,50-100,1931,4
STAT,1879,34,20-24,1913,5.661261710248911
STAT,1867,42,na,1909,4366.1536618202645
STAT,1875,41,25-29,1916,1.3413120208658331
SIM,1847,44,25-29,1891,6
SIM,1883,41,25-29,1924,2
SIM,1843,41,30-34,1884,4
SIM,1909,15,40-44,1924,1
SIM,1829,39,35-39,1868,17
STAT,1846,42,15-19,1888,0.02140871773717737
STAT,1929,35,na,1964,9770.772999878922
SIM,1825,31,na,1856,3234
SIM,1844,69,na,1913,2110
SIM,1859,99,na,1958,7
STAT,1847,43,15-19,1890,0.020898833994195905
SIM,1874,38,35-39,1912,18
STAT,1834,40,30-34,1874,1.8928067509464517
STAT,1896,46,20-24,1942,0.018100296781369787
SIM,1937,32,50-100,1969,5
STAT,1856,29,30-34,1885,40.07915269801935
STAT,1874,48,35-39,1922,0.2858703950081613
STAT,1873,16,25-29,1889,11.69734214592803
STAT,1808,50,25-29,1858,0.021899879348967574
STAT,1891,41,15-19,1932,0.03463060080908646
SIM,1824,32,30-34,1856,44
STAT,1884,5,na,1889,5251.0729659952685
SIM,1923,10,na,1933,9876
STAT,1844,20,50-100,1864,0.8341738962807661
STAT,1879,46,20-24,1925,0.025421698905239806
SIM,1934,21,25-29,1955,266
STAT,1855,39,35-39,1894,10.558157913771531
STAT,1863,42,15-19,1905,0.024384348869140027
SIM,1891,34,40-44,1925,16
SIM,1829,77,na,1906,1006
STAT,1807,54,25-29,1861,0.02215563194045341
STAT,1859,25,40-44,1884,4.96956073745573
STAT,1883,23,30-34,1906,35.235224827243215
STAT,1894,36,45-49,1930,5.196788173469116
SIM,1914,33,20-24,1947,7
STAT,1885,31,40-44,1916,8.753712223650005
SIM,1908,22,40-44,1930,7
SIM,1830,25,45-49,1855,3
STAT,1892,29,40-44,1921,7.519541473226569
STAT,1920,45,25-29,1965,0.11895417718884506
STAT,1839,44,25-29,1883,1.0300486175122836
SIM,1908,42,na,1950,6944
SIM,1850,34,30-34,1884,42
STAT,1825,38,40-44,1863,11.083434618289298
STAT,1825,67,na,1892,1834.1536466432349
SIM,1841,26,na,1867,3921
SIM,1833,38,40-44,1871,14
STAT,1926,21,25-29,1947,227.2829190628717
STAT,1867,7,na,1874,5259.245799246973
STAT,1863,39,15-19,1902,0.09827652172335853
SIM,1891,23,30-34,1914,55
STAT,1920,34,15-19,1954,0.2817758900882641
STAT,1881,44,50-100,1925,2.034443040891169
STAT,1852,44,na,1896,3633.954850224446
STAT,1861,18,na,1879,4408.958246721607
SIM,1887,34,20-24,1921,7
STAT,1916,18,40-44,1934,0.5977640495236743
STAT,1899,46,40-44,1945,0.26798420933700984
SIM,1824,43,40-44,1867,8
STAT,1897,26,15-19,1923,1.2290377069705214
STAT,1822,54,20-24,1876,0.002121152115976002
STAT,1936,35,50-100,1971,0.8340572598279382
SIM,1826,36,35-39,1862,19
SIM,1941,22,25-29,1963,206
STAT,1827,45,45-49,1872,0.4377489449279425
STAT,1836,81,na,1917,718.9913848075973
SIM,1817,43,30-34,1860,3
STAT,1925,29,50-100,1954,2.3568601890355443
STAT,1832,28,30-34,1860,43.73345549568743
STAT,1883,34,40-44,1917,8.531556526460115
STAT,1802,93,na,1895,22.42998492320163
STAT,1885,27,35-39,1912,19.39720399484792
STAT,1834,24,25-29,1858,100.45482344900708
SIM,1790,71,na,1861,1202
SIM,1929,12,na,1941,10542
SIM,1924,18,40-44,1942,3
STAT,1861,80,na,1941,1039.8655570073583
STAT,1870,54,na,1924,4151.955001973799
SIM,1896,26,50-100,1922,3
STAT,1837,36,15-19,1873,0.09630766802391429
SIM,1833,82,na,1915,536
STAT,1913,22,50-100,1935,1.2880368221241705
SIM,1840,28,30-34,1868,70
STAT,1940,26,40-44,1966,9.604245637482965
STAT,1874,45,25-29,1919,0.12029938655487774
STAT,1891,42,20-24,1933,0.3959699044775011
SIM,1872,29,35-39,1901,28
SIM,1893,30,35-39,1923,39
STAT,1885,30,35-39,1915,20.52204585011301
SIM,1864,49,25-29,1913,1
STAT,1795,95,na,1890,5.682005979886327
SIM,1801,72,na,1873,1068
STAT,1791,81,na,1872,415.57150261980127
SIM,1893,27,35-39,1920,33
SIM,1842,24,25-29,1866,136
STAT,1824,51,20-24,1875,0.0017557712023411232
STAT,1874,47,na,1921,4630.788964338386
SIM,1848,59,na,1907,2935
SIM,1843,33,30-34,1876,42
STAT,1933,22,25-29,1955,247.4767780421527
STAT,1797,103,na,1900,0.06944348330333787
STAT,1863,26,15-19,1889,0.8079017586006263
SIM,1852,30,40-44,1882,11
SIM,1925,34,35-39,1959,31
STAT,1919,31,35-39,1950,19.98910540327494
STAT,1823,34,20-24,1857,12.052677546153024
STAT,1865,34,25-29,1899,18.632345259586625
STAT,1894,24,45-49,1918,1.7978034053677754
STAT,1920,47,20-24,1967,0.024666029080160808
SIM,1835,33,45-49,1868,4
STAT,1826,32,50-100,1858,2.7546162735414885
STAT,1866,39,40-44,1905,8.075287241255937
STAT,1812,52,40-44,1864,0.06979255871665628
STAT,1833,44,25-29,1877,0.9987568999091891
STAT,1849,45,50-100,1894,0.39236272494075936
STAT,1856,49,25-29,1905,0.08788039974085843
STAT,1823,53,25-29,1876,0.010327100520315527
STAT,1838,39,50-100,1877,1.9638062784896388
SIM,1850,22,30-34,1872,45
SIM,1876,44,50-100,1920,7
STAT,1829,51,50-100,1880,0.02348076082013548
SIM,1790,92,na,1882,21
STAT,1827,33,45-49,1860,4.095848412301339
STAT,1882,42,na,1924,4541.527167675202
STAT,1891,16,na,1907,6320.362811982363
STAT,1904,46,25-29,1950,0.09445092646612364
SIM,1861,35,45-49,1896,7
STAT,1850,41,20-24,1891,0.24460501449306613
SIM,1922,36,40-44,1958,7
STAT,1811,43,35-39,1854,13.92478049243872
STAT,1870,65,na,1935,3350.903726691595
SIM,1811,82,na,1893,362
STAT,1842,34,30-34,1876,30.756323635407572
STAT,1890,25,20-24,1915,29.116058572345267
STAT,1907,32,25-29,1939,17.457840795707508
SIM,1867,25,40-44,1892,11
STAT,1823,63,na,1886,2208.229205623646
SIM,1882,24,25-29,1906,132
SIM,1820,56,na,1876,2387
SIM,1867,37,35-39,1904,21
STAT,1843,34,40-44,1877,7.153149649353731
STAT,1873,16,30-34,1889,3.2900881704164857
STAT,1884,54,na,1938,4176.031057697231
STAT,1859,87,na,1946,283.2087044270731
STAT,1914,36,40-44,1950,3.0336761190418837
SIM,1867,40,35-39,1907,7
SIM,1831,34,20-24,1865,4
SIM,1794,85,na,1879,204
STAT,1908,41,30-34,1949,0.2404204353977881
STAT,1858,27,45-49,1885,1.7895032653145764
STAT,1906,33,20-24,1939,4.548457337817347
STAT,1842,22,30-34,1864,33.44850354757177
STAT,1844,30,40-44,1874,8.550669921394713
SIM,1898,4,na,1902,7405
STAT,1929,33,15-19,1962,0.32942418961916037
STAT,1785,96,na,1881,3.375615791797473
STAT,1811,54,45-49,1865,0.09027610035259208
SIM,1908,50,na,1958,6597
STAT,1763,111,na,1874,0.001130993650448143
STAT,1876,34,30-34,1910,36.15865132298648
STAT,1874,79,na,1953,1445.6901036584127
SIM,1831,28,35-39,1859,18
SIM,1884,34,30-34,1918,49
SIM,1851,34,40-44,1885,10
STAT,1871,49,20-24,1920,0.02357544707829894
STAT,1939,23,30-34,1962,58.28237148516012
STAT,1836,39,25-29,1875,4.603294858538877
SIM,1819,70,na,1889,1420
STAT,1861,29,na,1890,3983.09275941867
STAT,1769,115,na,1884,2.502340454320079E-4
STAT,1843,46,40-44,1889,0.241779796953791
SIM,1903,33,45-49,1936,4
SIM,1833,85,na,1918,297
SIM,1864,29,50-100,1893,1
STAT,1944,22,50-100,1966,1.434737056459745
SIM,1927,31,35-39,1958,33
STAT,1874,26,20-24,1900,24.342894586956778
SIM,1841,44,25-29,1885,3
STAT,1875,24,40-44,1899,4.305846036736504
STAT,1842,33,40-44,1875,7.719120824538793
SIM,1850,33,40-44,1883,12
SIM,1882,26,20-24,1908,25
SIM,1863,100,na,1963,15
SIM,1865,39,na,1904,4367
STAT,1867,49,50-100,1916,0.4548347677289039
STAT,1853,112,na,1965,2.7864224954871243E-4
SIM,1900,47,45-49,1947,2
STAT,1848,39,na,1887,3899.1908143266864
STAT,1938,20,na,1958,7305.521941583829
SIM,1874,13,na,1887,5081
STAT,1897,7,na,1904,7033.528777154485
STAT,1875,25,25-29,1900,88.55627241122771
STAT,1927,44,45-49,1971,0.4200832926509563
STAT,1859,6,na,1865,4655.118860489045
STAT,1865,62,na,1927,3353.5416340371926
STAT,1799,88,na,1887,98.28499540407803
STAT,1857,45,30-34,1902,0.15390144907196518
STAT,1795,74,na,1869,968.2641020078421
STAT,1814,70,na,1884,1439.9073610529938
SIM,1866,27,45-49,1893,2
STAT,1827,101,na,1928,0.6900176705842805
STAT,1945,21,35-39,1966,20.847135311898036
SIM,1823,48,25-29,1871,1
SIM,1857,7,na,1864,5151
SIM,1881,25,20-24,1906,23
SIM,1833,74,na,1907,1435
STAT,1843,54,35-39,1897,0.011728088235422008
STAT,1822,38,15-19,1860,0.21466976823426934
STAT,1846,80,na,1926,947.5095857279961
STAT,1863,35,50-100,1898,2.191141014167095
SIM,1881,29,30-34,1910,54
STAT,1841,54,30-34,1895,0.008399227463192408
STAT,1861,23,30-34,1884,30.540330444626512
STAT,1826,46,40-44,1872,0.34605838194812993
STAT,1882,39,25-29,1921,5.607512052928899
STAT,1916,17,na,1933,8275.872529345796
SIM,1820,34,45-49,1854,1
SIM,1844,77,na,1921,1143
STAT,1828,46,45-49,1874,0.43071380524348774
SIM,1881,44,25-29,1925,2
SIM,1890,39,25-29,1929,10
SIM,1860,41,30-34,1901,7
STAT,1873,29,30-34,1902,51.305342972244134
STAT,1893,37,40-44,1930,11.205873362974549
STAT,1873,33,15-19,1906,0.2909953345143538
STAT,1912,25,50-100,1937,1.9949724761756338
STAT,1878,37,15-19,1915,0.11844685538203427
STAT,1884,35,40-44,1919,8.81283374785499
STAT,1836,73,na,1909,1579.2159439956636
STAT,1890,44,25-29,1934,1.5616494615920138
STAT,1882,15,15-19,1897,11.729862081014003
SIM,1805,67,na,1872,1513
SIM,1871,42,45-49,1913,6
SIM,1915,32,25-29,1947,20
STAT,1822,41,15-19,1863,0.04773985511447515
STAT,1930,36,25-29,1966,2.5961100178669776
SIM,1825,44,40-44,1869,7
SIM,1822,45,50-100,1867,1
STAT,1873,44,25-29,1917,1.299955225424659
STAT,1876,4,na,1880,6058.485603471633
SIM,1875,34,35-39,1909,26
SIM,1871,4,na,1875,5441
SIM,1880,28,na,1908,5280
STAT,1898,49,35-39,1947,0.21132997202653594
STAT,1949,12,na,1961,9226.135616259688
STAT,1867,34,35-39,1901,18.990587884823185
STAT,1835,33,30-34,1868,28.504760191493332
STAT,1817,44,40-44,1861,11.298755641923547
STAT,1847,54,25-29,1901,0.0052507629304120495
STAT,1890,33,15-19,1923,0.34957566120916056
SIM,1832,44,na,1876,3272
SIM,1841,18,na,1859,4251
STAT,1878,37,45-49,1915,4.204862866001189
SIM,1831,53,25-29,1884,1
STAT,1847,26,30-34,1873,46.47146543844658
STAT,1934,31,30-34,1965,43.4758283985492
SIM,1872,35,20-24,1907,2
STAT,1870,20,40-44,1890,4.156485817497734
STAT,1816,85,na,1901,269.2692324951427
SIM,1908,31,25-29,1939,23
STAT,1957,15,25-29,1972,115.43400710171123
SIM,1892,35,40-44,1927,19
SIM,1911,17,na,1928,7933
STAT,1918,47,50-100,1965,0.48601921187060837
STAT,1823,42,15-19,1865,0.04599051215984715
STAT,1827,37,na,1864,3400.104841385061
STAT,1887,40,40-44,1927,5.131913358948843
SIM,1874,35,30-34,1909,12
SIM,1870,29,25-29,1899,91
STAT,1863,42,45-49,1905,2.6426536231578863
SIM,1890,19,30-34,1909,5
SIM,1821,36,50-100,1857,3
SIM,1769,86,na,1855,116
STAT,1806,53,25-29,1859,0.02025814768974644
SIM,1891,35,30-34,1926,19
STAT,1830,48,20-24,1878,0.020447871045419938
SIM,1810,57,na,1867,2331
SIM,1960,4,na,1964,10829
STAT,1893,24,35-39,1917,14.844602128873232
SIM,1855,26,30-34,1881,70
STAT,1857,44,40-44,1901,3.4930089351708795
STAT,1899,28,45-49,1927,3.061547981112892
SIM,1842,99,na,1941,3
STAT,1868,46,45-49,1914,0.4547677428308937
STAT,1877,50,25-29,1927,0.007534907186932425
SIM,1886,37,45-49,1923,7
STAT,1864,43,15-19,1907,0.024750920365714246
SIM,1865,44,40-44,1909,8
SIM,1819,46,45-49,1865,1
STAT,1816,43,40-44,1859,11.91300091707808
STAT,1826,33,35-39,1859,28.481060662738642
SIM,1881,69,na,1950,2392
STAT,1837,44,na,1881,3371.5161732377305
SIM,1883,25,na,1908,4951
STAT,1921,23,45-49,1944,2.5581107523110367
STAT,1933,16,50-100,1949,1.015495816311246
SIM,1951,2,na,1953,9840
STAT,1863,84,na,1947,588.115480346337
STAT,1866,35,30-34,1901,10.025881351534693
STAT,1894,67,na,1961,4421.957620069957
SIM,1810,89,na,1899,100
STAT,1862,29,25-29,1891,72.49887208165354
STAT,1842,53,35-39,1895,0.012611495947707455
STAT,1882,19,30-34,1901,3.1189569373845223
SIM,1876,46,45-49,1922,1
SIM,1869,10,na,1879,5248
STAT,1873,25,15-19,1898,0.9373394405727271
STAT,1885,39,na,1924,4688.54403807803
SIM,1834,33,35-39,1867,27
SIM,1816,59,na,1875,2301
STAT,1902,23,35-39,1925,16.587559290886386
STAT,1853,53,40-44,1906,0.016389418578200327
SIM,1909,21,45-49,1930,2
STAT,1941,8,na,1949,8249.418543342967
SIM,1827,40,50-100,1867,3
STAT,1912,35,na,1947,7488.413546625292
STAT,1816,44,30-34,1860,5.862512799694317
STAT,1902,28,na,1930,6780.8509790713515
SIM,1814,53,25-29,1867,1
STAT,1883,35,30-34,1918,10.675774567860014
SIM,1918,44,45-49,1962,1
STAT,1851,28,40-44,1879,5.398055303910235
SIM,1910,23,35-39,1933,1
STAT,1873,45,15-19,1918,8.290049985794537E-4
STAT,1856,25,15-19,1881,0.7432230709661419
STAT,1893,45,35-39,1938,0.20417324365061626
SIM,1887,31,na,1918,5833
STAT,1857,40,25-29,1897,1.021081793711837
SIM,1824,44,30-34,1868,5
SIM,1855,21,na,1876,4442
STAT,1806,54,15-19,1860,1.3788824250103888E-4
STAT,1846,29,na,1875,3951.1615768226816
SIM,1891,76,na,1967,3285
SIM,1869,38,20-24,1907,5
SIM,1875,47,40-44,1922,1
SIM,1931,33,50-100,1964,5
STAT,1841,38,25-29,1879,4.871088279380785
STAT,1826,54,35-39,1880,0.01591293367151902
STAT,1869,47,45-49,1916,0.45968461908883773
SIM,1876,34,45-49,1910,4
SIM,1874,15,30-34,1889,6
SIM,1948,15,25-29,1963,142
STAT,1833,62,na,1895,2402.7861729584506
STAT,1867,47,40-44,1914,0.3223022633902666
STAT,1868,34,45-49,1902,3.3221121482793947
SIM,1869,21,na,1890,4638
SIM,1891,18,35-39,1909,1
STAT,1823,55,na,1878,2726.652921101722
STAT,1864,54,25-29,1918,0.006218586892740822
STAT,1866,15,30-34,1881,3.0848433834800715
SIM,1820,64,na,1884,1836
STAT,1883,18,35-39,1901,1.08593631574366
STAT,1859,79,na,1938,1123.8041303904822
STAT,1852,52,40-44,1904,0.01668975186491124
STAT,1907,30,50-100,1937,1.5742328746456438
SIM,1831,59,na,1890,2608
SIM,1830,34,na,1864,3266
SIM,1816,38,40-44,1854,8
STAT,1903,34,15-19,1937,0.23312300734631763
SIM,1931,33,20-24,1964,7
SIM,1829,36,30-34,1865,17
STAT,1916,18,50-100,1934,0.16011533147207346
SIM,1915,30,50-100,1945,3
STAT,1875,29,40-44,1904,6.1843118969120825
SIM,1830,41,45-49,1871,10
STAT,1818,43,45-49,1861,7.106297184524721
SIM,1834,48,na,1882,3051
STAT,1888,27,30-34,1915,60.11083472174381
SIM,1822,90,na,1912,44
STAT,1824,35,20-24,1859,2.5403506275489938
STAT,1843,16,45-49,1859,0.11762983445221355
STAT,1901,38,20-24,1939,0.4680870833578372
STAT,1838,39,35-39,1877,11.313320673115136
STAT,1811,51,40-44,1862,0.0695534411125173
STAT,1809,46,35-39,1855,1.1050197900026424
STAT,1871,24,50-100,1895,0.8131152702927765
SIM,1917,21,25-29,1938,218
SIM,1818,85,na,1903,211
STAT,1837,47,na,1884,3255.045218553169
STAT,1807,51,20-24,1858,0.004904747463668905
STAT,1858,45,40-44,1903,0.27222761910137244
STAT,1898,29,35-39,1927,26.182886847753096
SIM,1925,22,40-44,1947,12
SIM,1826,43,45-49,1869,5
SIM,1851,49,45-49,1900,2
SIM,1857,95,na,1952,24
SIM,1892,47,40-44,1939,1
STAT,1854,36,15-19,1890,0.08649855697609743
SIM,1839,19,30-34,1858,3
STAT,1845,95,na,1940,20.487569421856506
STAT,1835,88,na,1923,177.80172379655465
SIM,1832,35,20-24,1867,2
STAT,1874,42,20-24,1916,0.32800749207852425
SIM,1896,27,30-34,1923,84
SIM,1897,35,50-100,1932,5
SIM,1900,22,na,1922,6922
SIM,1876,31,40-44,1907,14
STAT,1824,54,25-29,1878,0.0079396824907818
SIM,1846,39,35-39,1885,23
STAT,1923,33,20-24,1956,5.642069692692924
STAT,1831,107,na,1938,0.006088994747533923
SIM,1854,27,20-24,1881,23
SIM,1907,25,na,1932,7195
SIM,1911,34,15-19,1945,1
SIM,1919,30,50-100,1949,2
SIM,1849,6,na,1855,5071
SIM,1877,41,50-100,1918,2
STAT,1840,22,20-24,1862,126.49761044534978
SIM,1893,34,45-49,1927,4
STAT,1884,47,40-44,1931,0.339827390962701
STAT,1833,43,40-44,1876,3.5434945706824847
SIM,1913,16,15-19,1929,20
STAT,1898,30,15-19,1928,0.3923412130788761
STAT,1859,47,na,1906,3599.7339622930463
STAT,1816,47,35-39,1863,0.6878778901717925
STAT,1901,43,na,1944,6509.92721170067
STAT,1822,70,na,1892,1584.1877044399685
STAT,1889,35,50-100,1924,3.086401534439698
STAT,1905,16,15-19,1921,17.37609256848041
STAT,1813,85,na,1898,243.5960854458655
STAT,1771,93,na,1864,9.911920151922626
STAT,1801,54,30-34,1855,0.03581721304900178
SIM,1867,34,30-34,1901,49
STAT,1891,26,20-24,1917,29.386687429674865
SIM,1911,45,25-29,1956,1
STAT,1833,32,30-34,1865,29.615555741070956
STAT,1903,45,25-29,1948,0.09436192466829661
SIM,1841,43,40-44,1884,9
STAT,1837,49,15-19,1886,5.642146421469865E-4
SIM,1938,17,30-34,1955,33
SIM,1832,89,na,1921,142
SIM,1889,26,30-34,1915,77
STAT,1861,40,na,1901,3924.416645908781
STAT,1885,34,45-49,1919,3.4755855527970176
SIM,1841,32,30-34,1873,47
STAT,1845,29,25-29,1874,78.20504074218215
SIM,1856,34,25-29,1890,24
STAT,1898,41,25-29,1939,0.12242722524454112
STAT,1854,111,na,1965,8.774928013244134E-4
STAT,1886,24,na,1910,5010.583077132195
STAT,1885,24,30-34,1909,35.5838006621325
STAT,1832,44,15-19,1876,0.021464252295700984
SIM,1884,37,35-39,1921,23
STAT,1850,44,25-29,1894,0.9713097134059703
STAT,1847,18,50-100,1865,0.09265945985639916
STAT,1876,40,35-39,1916,3.820703142166842
SIM,1780,93,na,1873,13
SIM,1889,21,50-100,1910,1
SIM,1868,36,na,1904,4559
SIM,1836,46,45-49,1882,2
STAT,1843,23,50-100,1866,0.7118749218862422
STAT,1848,34,25-29,1882,17.456762136065894
STAT,1866,54,35-39,1920,0.015601640598975022
SIM,1850,17,35-39,1867,1
SIM,1849,44,35-39,1893,8
SIM,1895,28,20-24,1923,37
SIM,1878,44,20-24,1922,1
SIM,1948,20,15-19,1968,9
SIM,1853,29,25-29,1882,89
SIM,1874,54,35-39,1928,1
SIM,1810,86,na,1896,174
STAT,1846,27,20-24,1873,21.73825489312015
STAT,1870,62,na,1932,3624.075109531571
SIM,1836,26,na,1862,3679
SIM,1891,68,na,1959,4384
STAT,1858,24,40-44,1882,3.3764455542149796
STAT,1874,76,na,1950,1959.1500498000246
STAT,1895,37,45-49,1932,5.24612051481514
STAT,1862,30,35-39,1892,17.621871512685722
SIM,1826,33,30-34,1859,28
SIM,1869,13,na,1882,5184
SIM,1903,30,40-44,1933,15
SIM,1883,28,na,1911,4902
SIM,1840,15,30-34,1855,3
STAT,1812,60,na,1872,2295.3345551728003
STAT,1887,28,20-24,1915,26.405640047056494
SIM,1886,17,15-19,1903,10
STAT,1842,17,35-39,1859,1.0490404352522145
SIM,1893,24,30-34,1917,55
SIM,1848,25,30-34,1873,11
STAT,1864,69,na,1933,2649.370004431743
STAT,1876,37,35-39,1913,14.774340848110489
STAT,1822,41,45-49,1863,5.173806434789158
SIM,1783,93,na,1876,9
SIM,1821,39,30-34,1860,18
SIM,1884,40,35-39,1924,6
STAT,1935,23,na,1958,10041.789890806478
SIM,1906,22,30-34,1928,58
STAT,1860,55,na,1915,3391.2215252435312
STAT,1864,35,20-24,1899,1.4048372046165765
STAT,1891,45,25-29,1936,0.08191907774222368
SIM,1859,46,50-100,1905,1
STAT,1917,22,40-44,1939,7.216625856019628
SIM,1883,25,25-29,1908,95
STAT,1833,41,20-24,1874,0.2566942212266147
SIM,1902,23,50-100,1925,1
STAT,1867,52,30-34,1919,0.011198862174826968
SIM,1916,44,35-39,1960,1
STAT,1801,110,na,1911,2.1904403131560026E-4
STAT,1842,37,35-39,1879,12.352798096024772
STAT,1884,17,45-49,1901,0.13027074270691394
SIM,1851,46,40-44,1897,1
SIM,1831,48,na,1879,3209
STAT,1864,29,35-39,1893,17.29480309098102
STAT,1844,33,45-49,1877,3.332825126082755
SIM,1878,57,na,1935,4346
STAT,1837,36,na,1873,3672.375821815278
SIM,1868,28,na,1896,4563
STAT,1889,44,30-34,1933,2.8242972674623243
STAT,1852,23,35-39,1875,10.969404551292925
SIM,1925,31,30-34,1956,9
STAT,1881,23,20-24,1904,134.10711360212917
STAT,1936,16,na,1952,7135.932935539338
SIM,1839,38,35-39,1877,10
SIM,1850,37,35-39,1887,18
SIM,1883,29,40-44,1912,14
SIM,1947,23,30-34,1970,88
STAT,1883,83,na,1966,1362.041507615812
SIM,1839,47,50-100,1886,1
SIM,1852,33,45-49,1885,5
STAT,1872,33,50-100,1905,1.8518926096861992
STAT,1946,20,45-49,1966,2.5303156498798582
STAT,1903,21,na,1924,6821.377174334506
STAT,1908,44,35-39,1952,0.3718860671369097
STAT,1812,71,na,1883,1437.965751250691
STAT,1833,22,na,1855,3768.372721545676
STAT,1885,15,40-44,1900,0.36939765773671224
STAT,1872,17,20-24,1889,36.102684261497636
SIM,1841,23,25-29,1864,118
STAT,1849,35,25-29,1884,4.75805630672222
SIM,1845,16,15-19,1861,12
STAT,1914,47,50-100,1961,0.45310963968690765
STAT,1888,23,15-19,1911,7.850651509519929
SIM,1939,29,40-44,1968,1
STAT,1836,51,45-49,1887,0.01991850628001913
STAT,1857,48,35-39,1905,0.21761839350483042
SIM,1900,44,40-44,1944,1
SIM,1918,41,40-44,1959,1
SIM,1827,39,25-29,1866,8
SIM,1866,41,25-29,1907,5
STAT,1914,22,15-19,1936,10.985454307694459
STAT,1861,26,35-39,1887,16.455924512511746
SIM,1891,30,25-29,1921,34
STAT,1855,33,20-24,1888,4.107372728669481
STAT,1922,45,35-39,1967,0.30046431170847376
STAT,1926,2,na,1928,10125.366146134456
SIM,1873,39,25-29,1912,9
STAT,1852,29,50-100,1881,1.0651717698217418
STAT,1847,39,30-34,1886,8.255867495945616
SIM,1810,48,45-49,1858,2
SIM,1896,23,15-19,1919,12
STAT,1853,35,45-49,1888,3.220285025169369
SIM,1939,18,30-34,1957,32
STAT,1917,0,na,1917,9758.267712684215
SIM,1858,58,na,1916,3360
SIM,1863,33,20-24,1896,6
SIM,1922,22,15-19,1944,14
STAT,1898,46,30-34,1944,0.14965921137867652
STAT,1893,42,30-34,1935,2.939387146492734
SIM,1877,61,na,1938,3697
STAT,1819,39,25-29,1858,14.694181782696539
STAT,1883,30,25-29,1913,20.4874952683893
STAT,1870,23,45-49,1893,1.378395771976811
STAT,1830,108,na,1938,0.002529396217701001
STAT,1851,40,30-34,1891,1.8001787143435073
STAT,1902,36,na,1938,6803.301924089637
STAT,1826,51,30-34,1877,0.011677924312694096
STAT,1839,46,20-24,1885,0.019336881872964624
STAT,1833,23,25-29,1856,101.83263214063237
SIM,1809,45,50-100,1854,2
STAT,1916,49,20-24,1965,0.022757881907739624
STAT,1834,39,50-100,1873,1.991063718299801
STAT,1894,75,na,1969,3489.530324692863
SIM,1857,35,25-29,1892,8
SIM,1856,43,30-34,1899,3
SIM,1921,2,na,1923,9438
STAT,1878,53,45-49,1931,0.03011955165953668
STAT,1923,31,50-100,1954,1.921477810768213
SIM,1879,20,na,1899,4915
STAT,1916,9,na,1925,8502.059167513173
STAT,1890,19,35-39,1909,1.345399596273026
STAT,1850,66,na,1916,2513.044700491477
STAT,1950,12,na,1962,9379.82186842142
SIM,1862,36,45-49,1898,6
STAT,1838,45,20-24,1883,0.01714219563810288
STAT,1854,49,20-24,1903,0.01801175678071836
SIM,1877,72,na,1949,2385
SIM,1891,38,35-39,1929,32
SIM,1891,79,na,1970,2744
STAT,1894,21,40-44,1915,5.422548882353701
SIM,1866,24,40-44,1890,6
STAT,1895,38,na,1933,6169.309186360658
STAT,1854,36,45-49,1890,3.0706984074703216
STAT,1860,34,40-44,1894,7.051679264820807
STAT,1848,52,20-24,1900,0.0012035304613228458
STAT,1890,18,50-100,1908,0.12045619623630252
STAT,1827,30,40-44,1857,11.897794013229714
STAT,1786,81,na,1867,365.07461704136404
SIM,1855,39,30-34,1894,14
STAT,1934,38,na,1972,10476.245361505271
STAT,1883,38,35-39,1921,13.96499808240881
SIM,1904,19,35-39,1923,1
STAT,1900,58,na,1958,5673.406910002193
SIM,1897,35,25-29,1932,12
SIM,1892,31,25-29,1923,34
STAT,1921,20,40-44,1941,7.713859312206424
STAT,1825,50,30-34,1875,0.012947596864668074
SIM,1886,34,40-44,1920,16
SIM,1835,30,40-44,1865,14
STAT,1835,36,35-39,1871,11.448492726086368
STAT,1850,25,20-24,1875,21.474941297888126
STAT,1871,28,na,1899,4771.738867830798
SIM,1912,0,na,1912,8475
SIM,1844,40,35-39,1884,1
STAT,1829,43,20-24,1872,0.2573837257739565
STAT,1841,52,50-100,1893,0.021796376142441076
STAT,1848,43,30-34,1891,1.871501647588831
SIM,1963,8,na,1971,10471
STAT,1923,46,35-39,1969,0.3052692709764914
SIM,1825,40,25-29,1865,2
SIM,1855,22,15-19,1877,6
SIM,1779,85,na,1864,139
SIM,1824,47,35-39,1871,1
STAT,1934,34,35-39,1968,25.169924448572065
STAT,1860,95,na,1955,21.805784209915153
SIM,1903,20,50-100,1923,2
SIM,1846,45,20-24,1891,1
SIM,1865,28,35-39,1893,20
STAT,1837,52,45-49,1889,0.02030510759684778
STAT,1888,38,50-100,1926,2.916165655058271
SIM,1928,30,45-49,1958,5
STAT,1889,35,25-29,1924,7.237964539465059
SIM,1908,10,na,1918,7844
STAT,1934,6,na,1940,10950.586785640935
STAT,1873,49,30-34,1922,0.1944916013193732
SIM,1880,17,20-24,1897,48
SIM,1923,44,50-100,1967,1
SIM,1843,36,35-39,1879,26
STAT,1896,34,20-24,1930,7.145804509261917
STAT,1878,34,40-44,1912,9.069122343398925
SIM,1949,18,45-49,1967,5
SIM,1822,34,na,1856,3232
SIM,1847,66,na,1913,2448
SIM,1932,24,na,1956,9667
STAT,1884,46,na,1930,4499.529854531027
STAT,1774,107,na,1881,0.011768967147439717
SIM,1910,20,30-34,1930,66
SIM,1860,44,35-39,1904,7
SIM,1845,52,45-49,1897,1
SIM,1882,42,20-24,1924,1
STAT,1931,5,na,1936,10629.228699025802
STAT,1857,28,35-39,1885,15.532896810905907
STAT,1881,50,45-49,1931,0.028736517273288385
STAT,1915,46,na,1961,7495.702980444817
SIM,1768,93,na,1861,7
SIM,1923,23,15-19,1946,14
SIM,1919,17,20-24,1936,300
STAT,1899,25,40-44,1924,8.345376941084997
STAT,1915,23,15-19,1938,11.079550358933636
STAT,1873,41,20-24,1914,0.3273678440219964
SIM,1840,101,na,1941,2
SIM,1898,36,25-29,1934,12
STAT,1828,54,50-100,1882,0.02297880332520103
STAT,1871,16,20-24,1887,36.014430234102655
STAT,1806,50,20-24,1856,0.004482161582102448
STAT,1836,40,35-39,1876,2.939186513928103
STAT,1902,20,30-34,1922,51.092021217658385
SIM,1837,43,20-24,1880,1
STAT,1915,44,50-100,1959,0.23809624608131336
SIM,1919,13,na,1932,8975
SIM,1819,43,40-44,1862,6
SIM,1890,15,15-19,1905,16
STAT,1846,26,45-49,1872,2.0722587339253553
SIM,1920,21,na,1941,8375
SIM,1875,92,na,1967,206
SIM,1845,31,45-49,1876,4
STAT,1821,83,na,1904,440.0386961434503
STAT,1835,43,45-49,1878,2.2940447411735554
SIM,1922,22,na,1944,8842
SIM,1834,70,na,1904,1753
SIM,1942,22,40-44,1964,10
STAT,1834,27,50-100,1861,1.1165774141059321
SIM,1883,45,40-44,1928,1
SIM,1860,20,30-34,1880,41
SIM,1881,48,40-44,1929,1
STAT,1831,28,na,1859,3674.537339947764
STAT,1925,44,35-39,1969,0.4906301904884866
SIM,1841,46,45-49,1887,1
STAT,1850,32,30-34,1882,28.004580932790745
STAT,1875,45,40-44,1920,0.3595340069169931
STAT,1946,18,20-24,1964,303.5744444997287
STAT,1849,26,na,1875,4085.6257342124863
STAT,1760,113,na,1873,1.2099866597960887E-4
STAT,1946,21,20-24,1967,249.96729670343828
STAT,1852,40,40-44,1892,3.6210919755960824
STAT,1904,62,na,1966,5782.423605461877
SIM,1851,42,25-29,1893,2
SIM,1848,29,25-29,1877,83
STAT,1845,33,50-100,1878,1.6613848471156756
SIM,1818,42,40-44,1860,2
STAT,1888,26,50-100,1914,1.5322276117223315
STAT,1921,46,30-34,1967,0.20341751897696242
STAT,1849,30,25-29,1879,19.1547754458138
SIM,1865,26,20-24,1891,17
SIM,1918,33,50-100,1951,3
STAT,1906,16,50-100,1922,0.14453447501344285
STAT,1813,88,na,1901,121.9903139014935
SIM,1884,3,na,1887,6131
STAT,1929,29,50-100,1958,2.513117375557997
STAT,1929,24,25-29,1953,234.4091298292608
STAT,1782,85,na,1867,168.49867082065293
STAT,1859,21,50-100,1880,0.7527927974851852
STAT,1873,48,40-44,1921,0.3468977601755902
SIM,1854,26,45-49,1880,3
SIM,1913,32,15-19,1945,1
STAT,1822,45,30-34,1867,0.30971919385480773
STAT,1887,65,na,1952,3817.2749471692246
SIM,1867,97,na,1964,26
STAT,1898,27,20-24,1925,32.063085604705215
SIM,1836,22,35-39,1858,11
SIM,1812,49,30-34,1861,1
STAT,1837,31,45-49,1868,3.0798383251228776
STAT,1853,16,35-39,1869,1.0505377538290812
SIM,1849,31,50-100,1880,2
STAT,1874,38,50-100,1912,2.52627466278525
SIM,1843,43,45-49,1886,5
SIM,1897,32,20-24,1929,10
STAT,1793,108,na,1901,6.648642205894892E-4
STAT,1908,32,40-44,1940,7.465173470642384
SIM,1938,33,30-34,1971,39
STAT,1889,32,20-24,1921,6.7312456881521365
SIM,1928,15,15-19,1943,111
SIM,1869,98,na,1967,36
STAT,1908,52,na,1960,6601.595655844334
SIM,1855,50,45-49,1905,1
STAT,1759,99,na,1858,0.28089663965958267
SIM,1852,32,na,1884,3984
STAT,1863,23,40-44,1886,3.7304065064315446
SIM,1871,23,40-44,1894,5
STAT,1917,22,50-100,1939,1.4122556518701648
SIM,1825,34,na,1859,3118
SIM,1922,32,25-29,1954,30
STAT,1903,29,50-100,1932,1.8263283008137723
STAT,1878,80,na,1958,1531.4803159607573
STAT,1885,44,50-100,1929,2.0951141355089065
STAT,1852,97,na,1949,8.562334724529077
STAT,1877,33,na,1910,4983.352927003909
STAT,1857,21,na,1878,3913.762872267005
STAT,1899,32,50-100,1931,2.5353784952154275
SIM,1908,29,20-24,1937,32
STAT,1905,32,15-19,1937,0.23883366928622626
SIM,1846,39,50-100,1885,6
STAT,1846,43,20-24,1889,0.24306611161619382
STAT,1807,70,na,1877,1542.4182278556013
SIM,1920,35,25-29,1955,3
STAT,1899,44,50-100,1943,0.2002631784684628
SIM,1861,16,35-39,1877,4
STAT,1827,49,25-29,1876,0.10128405197056765
SIM,1924,37,na,1961,9298
SIM,1859,43,40-44,1902,9
STAT,1837,33,40-44,1870,7.501835941025566
SIM,1834,32,50-100,1866,2
STAT,1857,26,20-24,1883,19.159495919672374
STAT,1914,32,25-29,1946,18.793027268571443
STAT,1889,16,15-19,1905,14.81470934589501
STAT,1847,11,na,1858,4562.501481753229
SIM,1937,24,25-29,1961,224
STAT,1861,33,45-49,1894,2.9190093210180823
STAT,1859,34,30-34,1893,27.826014373370423
STAT,1914,43,20-24,1957,0.03529229478448557
SIM,1894,65,na,1959,4678
STAT,1858,25,25-29,1883,69.16794211674835
SIM,1845,33,40-44,1878,4
STAT,1911,39,25-29,1950,1.9018868050888302
SIM,1877,23,35-39,1900,12
STAT,1929,8,na,1937,10278.926593355663
STAT,1845,45,50-100,1890,0.3822268244096741
STAT,1870,27,50-100,1897,1.268399500098617
STAT,1889,3,na,1892,6583.283133814321
STAT,1844,46,20-24,1890,0.019433989537368114
SIM,1897,16,15-19,1913,13
SIM,1842,44,40-44,1886,10
STAT,1845,10,na,1855,4707.656849999999
STAT,1852,20,30-34,1872,34.214839049015886
STAT,1863,21,45-49,1884,1.2664567138796945
STAT,1910,27,15-19,1937,1.37728749740182
STAT,1831,38,35-39,1869,11.44433907512346
STAT,1912,35,25-29,1947,1.9597969344907185
SIM,1943,21,45-49,1964,5
SIM,1849,41,30-34,1890,3
STAT,1920,40,40-44,1960,0.5593325263907
STAT,1934,22,40-44,1956,9.127208194269462
SIM,1932,32,na,1964,10332
STAT,1827,36,50-100,1863,2.619881887611268
SIM,1842,51,50-100,1893,1
STAT,1904,29,40-44,1933,8.621298445804138
STAT,1887,27,45-49,1914,2.5079445579071735
STAT,1877,53,35-39,1930,0.017764673791675244
STAT,1930,33,20-24,1963,6.3534082250964925
STAT,1952,15,40-44,1967,3.386753177286261
SIM,1876,24,30-34,1900,42
STAT,1927,25,na,1952,9258.821611719859
STAT,1930,39,35-39,1969,6.358132759591824
SIM,1841,20,20-24,1861,125
SIM,1866,25,25-29,1891,99
SIM,1914,27,na,1941,7789
STAT,1925,41,50-100,1966,0.28760964432055164
SIM,1907,21,35-39,1928,20
STAT,1894,13,na,1907,6689.668361618668
SIM,1928,27,na,1955,9770
STAT,1875,20,25-29,1895,119.74397585727392
SIM,1869,66,na,1935,3026
STAT,1870,50,50-100,1920,0.030376481940378997
SIM,1943,18,45-49,1961,1
STAT,1856,29,50-100,1885,1.0181252878441922
STAT,1841,54,25-29,1895,0.004997887367945575
STAT,1935,18,45-49,1953,1.3758462123734845
STAT,1843,42,25-29,1885,0.9261832227016189
STAT,1845,101,na,1946,0.879294252719801
STAT,1903,43,45-49,1946,0.2966976491165021
SIM,1840,47,40-44,1887,1
STAT,1860,102,na,1962,1.5293206456792545
STAT,1935,21,45-49,1956,3.0960660547087535
STAT,1833,46,45-49,1879,0.3687329176884515
STAT,1813,48,50-100,1861,1.4891620577175897
SIM,1836,71,na,1907,1630
SIM,1912,29,40-44,1941,9
STAT,1877,3,na,1880,6429.075356933786
STAT,1920,5,na,1925,9108.536611702059
SIM,1932,17,30-34,1949,39
STAT,1857,13,na,1870,4396.870928449904
STAT,1899,23,20-24,1922,190.10119287573752
SIM,1835,23,30-34,1858,40
STAT,1864,15,na,1879,4766.822230715466
SIM,1882,62,na,1944,3704
STAT,1858,41,30-34,1899,1.818248819335385
STAT,1796,99,na,1895,0.8437487969964595
STAT,1907,42,35-39,1949,0.3728020013968928
SIM,1911,40,40-44,1951,1
SIM,1856,15,15-19,1871,8
SIM,1875,60,na,1935,4253
STAT,1853,39,25-29,1892,4.509621188883012
STAT,1883,16,20-24,1899,35.264651220934006
SIM,1852,23,30-34,1875,50
STAT,1854,70,na,1924,2150.8949086263724
STAT,1872,10,na,1882,5409.144095203815
SIM,1822,32,20-24,1854,6
STAT,1909,28,45-49,1937,3.324582410556498
SIM,1915,17,30-34,1932,6
STAT,1832,47,40-44,1879,0.26388008054589535
STAT,1871,32,35-39,1903,20.32011003820438
STAT,1924,42,35-39,1966,0.48360495521459695
STAT,1780,76,na,1856,658.5447975804001
STAT,1858,60,na,1918,3002.6986242052158
STAT,1834,44,40-44,1878,3.5181975747511633
STAT,1871,52,45-49,1923,0.028964359331095573
SIM,1934,19,20-24,1953,358
STAT,1926,19,20-24,1945,333.8484210599498
STAT,1868,27,35-39,1895,18.540670645290056
STAT,1858,50,20-24,1908,0.0011784892682588529
SIM,1836,28,na,1864,3601
SIM,1816,73,na,1889,1052
SIM,1918,49,na,1967,8087
SIM,1820,39,50-100,1859,6
SIM,1861,92,na,1953,43
STAT,1915,42,25-29,1957,0.14520831227530118
STAT,1935,20,na,1955,10052.039488447088
STAT,1909,31,45-49,1940,3.0467335945186633
SIM,1895,27,45-49,1922,3
STAT,1907,17,30-34,1924,4.731182096612858
SIM,1917,28,45-49,1945,3
STAT,1885,84,na,1969,1316.176159948726
STAT,1841,20,na,1861,3987.01072786733
STAT,1865,15,15-19,1880,12.476974353511604
SIM,1828,36,45-49,1864,4
SIM,1880,39,35-39,1919,27
STAT,1904,43,20-24,1947,0.03173724814937907
STAT,1812,49,na,1861,2827.697241783702
STAT,1915,32,na,1947,7779.952511636163
STAT,1839,25,15-19,1864,0.9054101806554763
STAT,1859,44,45-49,1903,2.373358672772725
STAT,1932,26,na,1958,9914.832865796872
STAT,1854,78,na,1932,1197.773098034656
SIM,1920,25,50-100,1945,5
STAT,1821,41,35-39,1862,5.923314195689807
SIM,1854,49,35-39,1903,1
STAT,1848,31,20-24,1879,5.222713203103885
STAT,1878,82,na,1960,1321.2282799845186
STAT,1875,50,20-24,1925,0.0015564437220750922
SIM,1898,31,25-29,1929,37
STAT,1803,64,na,1867,1764.5250837552287
STAT,1929,38,na,1967,9744.025437917871
SIM,1878,27,45-49,1905,4
STAT,1817,105,na,1922,0.02957357466085529
SIM,1879,19,30-34,1898,3
STAT,1865,43,30-34,1908,2.0941861841200753
STAT,1924,17,30-34,1941,29.3064510082538
SIM,1827,65,na,1892,2025
SIM,1867,44,45-49,1911,7
SIM,1873,43,30-34,1916,4
STAT,1872,39,35-39,1911,14.21170650636103
SIM,1878,35,na,1913,5184
STAT,1791,68,na,1859,1427.4524712469547
SIM,1882,40,na,1922,4849
SIM,1873,27,50-100,1900,2
STAT,1881,43,15-19,1924,0.026763171867840076
SIM,1927,19,15-19,1946,120
STAT,1874,33,30-34,1907,35.95284423178993
SIM,1869,37,45-49,1906,9
STAT,1821,85,na,1906,303.86324674841
SIM,1887,4,na,1891,6453
SIM,1912,43,20-24,1955,1
STAT,1861,50,35-39,1911,0.014679868062177021
SIM,1887,18,na,1905,6244
STAT,1809,53,45-49,1862,0.1048423095601045
STAT,1954,7,na,1961,9812.5225907732
SIM,1857,30,25-29,1887,26
STAT,1859,15,30-34,1874,3.0094404495546403
SIM,1929,24,20-24,1953,264
SIM,1876,0,na,1876,7575
SIM,1837,30,50-100,1867,4
SIM,1916,32,40-44,1948,15
STAT,1899,21,25-29,1920,158.88478847537178
STAT,1870,94,na,1964,115.26927224223213
SIM,1827,43,na,1870,3207
SIM,1901,33,35-39,1934,34
SIM,1815,42,30-34,1857,8
SIM,1872,3,na,1875,6341
SIM,1931,39,na,1970,10072
STAT,1860,51,30-34,1911,0.009809384928847153
SIM,1829,91,na,1920,48
STAT,1824,42,30-34,1866,2.988050964861807
SIM,1910,43,na,1953,7297
SIM,1917,31,45-49,1948,4
STAT,1857,35,na,1892,3743.9946917435636
SIM,1892,64,na,1956,5000
STAT,1923,41,na,1964,8776.629804711105
SIM,1903,33,na,1936,7014
SIM,1766,89,na,1855,64
SIM,1856,31,20-24,1887,7
STAT,1933,32,35-39,1965,24.87450830892683
SIM,1816,51,na,1867,2682
SIM,1906,27,30-34,1933,88
SIM,1891,29,50-100,1920,3
STAT,1891,33,30-34,1924,43.40219244976331
STAT,1820,58,na,1878,2372.703327647575
STAT,1876,44,45-49,1920,3.0840726078005094
STAT,1808,54,40-44,1862,0.059971146803272916
STAT,1904,49,35-39,1953,0.2241386456930488
STAT,1919,19,15-19,1938,100.72418035363759
STAT,1891,0,na,1891,7330.217863121027
SIM,1863,39,35-39,1902,20
SIM,1882,33,30-34,1915,43
STAT,1868,30,35-39,1898,19.61584222012353
STAT,1819,40,50-100,1859,5.196309800848893
STAT,1884,15,25-29,1899,11.353495254694648
SIM,1898,55,na,1953,5810
STAT,1910,33,35-39,1943,17.726972673159548
SIM,1892,40,20-24,1932,4
STAT,1814,52,15-19,1866,1.2214539935387505E-4
SIM,1870,42,35-39,1912,5
STAT,1854,56,na,1910,3126.7330012420753
STAT,1855,110,na,1965,0.002615159439024184
STAT,1908,16,35-39,1924,1.6490095923324501
SIM,1849,78,na,1927,1131
SIM,1857,87,na,1944,302
SIM,1884,44,45-49,1928,5
SIM,1832,42,30-34,1874,4
STAT,1838,42,50-100,1880,1.6721253640161131
SIM,1907,57,na,1964,6301
STAT,1885,47,20-24,1932,0.024011089829837576
SIM,1831,45,50-100,1876,1
STAT,1862,42,35-39,1904,3.1219805855888905
STAT,1867,31,30-34,1898,33.15869486733826
SIM,1770,94,na,1864,1
STAT,1848,15,15-19,1863,12.206290314110081
SIM,1867,15,30-34,1882,6
STAT,1923,43,30-34,1966,0.30120905103089
SIM,1916,16,35-39,1932,1
STAT,1803,86,na,1889,153.6336003395187
STAT,1938,30,50-100,1968,1.681172283791757
STAT,1884,40,20-24,1924,0.31991192006584734
STAT,1844,23,30-34,1867,35.65748677781185
SIM,1877,10,na,1887,5441
SIM,1910,42,50-100,1952,1
SIM,1911,30,na,1941,7628
STAT,1883,37,45-49,1920,3.9556225915745444
STAT,1810,91,na,1901,52.40526810635889
SIM,1935,24,50-100,1959,2
SIM,1822,38,35-39,1860,17
STAT,1881,29,35-39,1910,18.700871753664167
STAT,1905,42,25-29,1947,0.1300851476114113
STAT,1936,24,50-100,1960,1.2698843764506813
SIM,1909,38,na,1947,7260
STAT,1850,35,35-39,1885,11.247603706380021
STAT,1927,24,50-100,1951,1.6267793878141918
SIM,1854,23,40-44,1877,5
SIM,1851,17,na,1868,4510
STAT,1760,98,na,1858,0.14044831982979133
STAT,1863,26,45-49,1889,1.9771012199135114
SIM,1942,25,45-49,1967,4
SIM,1847,63,na,1910,2711
STAT,1834,58,na,1892,2628.10418165884
STAT,1855,1,na,1856,5693.6042845944985
STAT,1896,17,45-49,1913,0.17417777631779527
STAT,1905,22,na,1927,6907.7882340328815
STAT,1894,23,50-100,1917,1.0547010099538936
SIM,1948,22,35-39,1970,30
STAT,1898,42,15-19,1940,0.0026177575349174754
SIM,1779,88,na,1867,78
STAT,1950,22,25-29,1972,221.29304013234184
SIM,1880,81,na,1961,1508
SIM,1866,35,50-100,1901,7
STAT,1829,26,45-49,1855,4.046676963325524
SIM,1835,42,40-44,1877,5
SIM,1871,26,45-49,1897,4
STAT,1925,38,15-19,1963,0.04649217228088346
STAT,1793,106,na,1899,0.004407092406454046
STAT,1846,23,40-44,1869,3.909950261084228
STAT,1890,31,na,1921,5906.668991287192
STAT,1820,49,15-19,1869,0.0014459268399806622
STAT,1864,19,15-19,1883,10.952911667614378
STAT,1868,47,20-24,1915,0.022950818503931637
STAT,1867,22,50-100,1889,0.774482261477188
SIM,1880,33,20-24,1913,8
SIM,1928,41,na,1969,9714
SIM,1928,18,50-100,1946,1
SIM,1937,21,20-24,1958,217
SIM,1849,44,na,1893,3719
STAT,1825,54,40-44,1879,0.021149871363452248
STAT,1921,29,40-44,1950,10.413900227200727
STAT,1864,22,15-19,1886,6.0515329322027
STAT,1912,33,45-49,1945,3.1147917689195816
SIM,1819,56,na,1875,2367
SIM,1849,46,na,1895,3702
SIM,1933,16,35-39,1949,14
STAT,1869,23,35-39,1892,11.384394837309317
STAT,1898,57,na,1955,5492.497829871883
SIM,1878,89,na,1967,488
STAT,1816,46,45-49,1862,1.177474848069339
STAT,1925,16,35-39,1941,10.260348002463411
SIM,1872,19,15-19,1891,11
STAT,1894,33,40-44,1927,11.203683558783217
SIM,1891,37,45-49,1928,7
STAT,1857,29,25-29,1886,67.60811757207453
SIM,1901,43,45-49,1944,2
STAT,1929,21,20-24,1950,284.81758009324227
STAT,1892,45,40-44,1937,0.24659438065409214
STAT,1942,9,na,1951,8341.264749060434
SIM,1842,19,35-39,1861,3
STAT,1868,43,40-44,1911,4.290821413738505
SIM,1882,21,20-24,1903,135
STAT,1859,40,35-39,1899,2.9402352316921303
SIM,1937,18,20-24,1955,280
STAT,1931,35,35-39,1966,6.480923327059216
STAT,1929,18,20-24,1947,348.4893481247588
SIM,1809,52,40-44,1861,1
STAT,1859,37,35-39,1896,11.369644767011764
STAT,1901,40,30-34,1941,0.22800154626912628
STAT,1934,25,45-49,1959,4.698490785956528
STAT,1836,59,na,1895,2583.997222787896
STAT,1870,53,40-44,1923,0.020539347655367
SIM,1824,46,45-49,1870,2
SIM,1847,25,15-19,1872,1
SIM,1865,29,25-29,1894,84
SIM,1900,21,25-29,1921,184
SIM,1813,42,20-24,1855,1
SIM,1898,23,na,1921,6656
SIM,1872,86,na,1958,627
STAT,1865,101,na,1966,5.37842334764823
STAT,1937,35,na,1972,7612.550095705425
SIM,1854,47,na,1901,3739
STAT,1865,64,na,1929,3189.559551578547
STAT,1880,47,50-100,1927,0.5200958607993453
SIM,1903,39,40-44,1942,6
STAT,1931,32,25-29,1963,24.460262525074146
SIM,1874,11,na,1885,5128
STAT,1872,33,20-24,1905,5.463354768726749
STAT,1830,46,50-100,1876,0.42946969318378764
STAT,1918,21,45-49,1939,2.4578406592056
SIM,1879,76,na,1955,1752
STAT,1816,53,na,1869,2655.924824059615
SIM,1839,39,25-29,1878,8
SIM,1856,48,na,1904,3735
STAT,1914,46,25-29,1960,0.10653095189852153
SIM,1866,22,20-24,1888,138
SIM,1773,83,na,1856,251
SIM,1872,22,15-19,1894,6
SIM,1920,33,45-49,1953,5
SIM,1962,9,na,1971,10315
SIM,1846,89,na,1935,103
STAT,1837,36,45-49,1873,3.4189218082555413
STAT,1952,18,45-49,1970,1.2085265805721197
SIM,1884,33,50-100,1917,4
SIM,1926,18,45-49,1944,2
SIM,1859,30,35-39,1889,24
STAT,1831,42,na,1873,3308.996024806495
STAT,1818,62,na,1880,2110.401189915305
STAT,1842,30,15-19,1872,0.26149836764798456
STAT,1838,29,20-24,1867,19.907829723877224
STAT,1865,31,20-24,1896,4.979870633355801
SIM,1809,46,na,1855,2683
SIM,1846,29,20-24,1875,23
STAT,1906,16,25-29,1922,16.717824317350654
SIM,1856,36,20-24,1892,1
STAT,1822,48,35-39,1870,0.4290371869327686
SIM,1861,78,na,1939,1308
STAT,1832,77,na,1909,1126.9234873358955
SIM,1841,40,na,1881,3526
STAT,1908,35,45-49,1943,1.3021723304480144
SIM,1892,15,25-29,1907,27
SIM,1943,15,40-44,1958,1
SIM,1850,36,45-49,1886,3
STAT,1868,15,40-44,1883,0.3620690178348929
STAT,1918,18,45-49,1936,1.0950435100640477
STAT,1884,20,50-100,1904,0.8180966500494662
STAT,1935,15,40-44,1950,3.8804357474945674
SIM,1848,26,20-24,1874,23
SIM,1861,32,40-44,1893,12
STAT,1946,24,25-29,1970,207.43819029163132
STAT,1850,54,40-44,1904,0.015697839838265268
STAT,1840,42,15-19,1882,0.02079371901878959
STAT,1941,17,30-34,1958,25.356737328130638
SIM,1820,35,20-24,1855,2
SIM,1837,26,45-49,1863,1
STAT,1889,74,na,1963,3288.873057362399
SIM,1785,70,na,1855,1050
SIM,1896,14,na,1910,7168
STAT,1851,44,40-44,1895,3.439723224110289
SIM,1830,88,na,1918,129
STAT,1858,22,20-24,1880,124.48511286867921
STAT,1831,35,30-34,1866,8.90328966769773
SIM,1811,50,na,1861,2532
STAT,1915,54,na,1969,7281.994230348488
SIM,1834,45,na,1879,3194
SIM,1876,15,40-44,1891,1
SIM,1844,39,25-29,1883,8
STAT,1924,32,25-29,1956,21.77195568066226
STAT,1926,40,35-39,1966,0.5026634565245637
SIM,1845,62,na,1907,3025
STAT,1848,36,20-24,1884,1.3161380477846185
SIM,1917,19,20-24,1936,279
SIM,1866,16,na,1882,5097
SIM,1864,35,na,1899,4501
STAT,1841,52,na,1893,3107.464167644949
STAT,1921,36,50-100,1957,0.9474334105478377
STAT,1839,48,na,1887,3533.6932405226535
SIM,1869,54,20-24,1923,1
SIM,1902,20,45-49,1922,3
STAT,1844,49,25-29,1893,0.09107688033822763
STAT,1853,32,40-44,1885,7.065984804476826
SIM,1932,32,25-29,1964,6
SIM,1845,36,45-49,1881,6
STAT,1870,16,35-39,1886,1.104867361170359
SIM,1846,32,15-19,1878,1
STAT,1849,77,na,1926,1367.2939854624913
STAT,1931,22,15-19,1953,13.94406889173362
SIM,1917,25,40-44,1942,19
STAT,1895,52,na,1947,5636.33149265199
SIM,1841,58,na,1899,2787
STAT,1830,39,30-34,1869,9.712013486567079
STAT,1870,7,na,1877,5444.505770990237
STAT,1948,18,30-34,1966,28.16070011889335
STAT,1844,17,na,1861,4712.158954742257
SIM,1871,70,na,1941,2625
SIM,1838,22,45-49,1860,4
SIM,1872,19,20-24,1891,34
SIM,1852,26,35-39,1878,25
STAT,1832,106,na,1938,0.01582933804729354
STAT,1889,37,20-24,1926,1.9195932240962323
SIM,1843,22,50-100,1865,3
SIM,1897,37,20-24,1934,4
SIM,1892,43,25-29,1935,1
STAT,1831,32,20-24,1863,4.560040035915869
STAT,1940,21,na,1961,7516.13222158774
STAT,1844,26,35-39,1870,19.213181543481788
STAT,1905,45,35-39,1950,0.2329584652662247
STAT,1917,8,na,1925,8639.019443998968
STAT,1902,46,20-24,1948,0.019355559522192197
SIM,1864,40,45-49,1904,1
SIM,1791,88,na,1879,66
SIM,1867,41,40-44,1908,8
STAT,1829,71,na,1900,1579.748672635314
STAT,1806,75,na,1881,848.1628360204744
STAT,1867,19,40-44,1886,0.3495081026557679
SIM,1854,46,30-34,1900,1
STAT,1858,53,25-29,1911,0.005487071538607988
STAT,1947,17,25-29,1964,98.58222076882156
SIM,1895,24,40-44,1919,7
SIM,1926,40,45-49,1966,1
STAT,1839,53,30-34,1892,0.00914524667382776
SIM,1901,30,30-34,1931,60
SIM,1875,31,30-34,1906,37
STAT,1850,40,15-19,1890,0.021387849459600265
STAT,1891,36,35-39,1927,17.741697246162268
SIM,1885,17,35-39,1902,2
STAT,1892,12,na,1904,6529.347228055027
STAT,1842,50,25-29,1892,0.005349180771272066
SIM,1823,53,na,1876,2634
SIM,1828,33,40-44,1861,3
SIM,1863,59,na,1922,3563
SIM,1916,35,45-49,1951,1
STAT,1914,48,40-44,1962,0.3149703549732047
SIM,1858,29,na,1887,4093
SIM,1854,98,na,1952,4
STAT,1867,51,40-44,1918,0.020007527803858033
STAT,1875,40,na,1915,4854.373101900856
SIM,1832,45,35-39,1877,2
SIM,1872,30,na,1902,5113
SIM,1890,30,45-49,1920,6
STAT,1915,22,30-34,1937,60.00677605623011
SIM,1913,11,na,1924,8400
STAT,1899,26,25-29,1925,117.45559534752613
SIM,1935,24,15-19,1959,14
STAT,1840,28,35-39,1868,17.2410635550927
STAT,1887,24,40-44,1911,4.677426173938918
SIM,1844,23,na,1867,3710
STAT,1809,51,na,1860,2658.3946266288644
STAT,1927,24,15-19,1951,13.160643732322333
STAT,1802,53,35-39,1855,0.054080573729891626
STAT,1937,31,20-24,1968,4.8775320033643474
SIM,1922,48,40-44,1970,1
SIM,1885,20,35-39,1905,16
STAT,1890,40,45-49,1930,3.7266793128052798
STAT,1824,45,35-39,1869,0.3487289670436195
STAT,1840,56,na,1896,2944.0900352752283
SIM,1923,22,30-34,1945,98
STAT,1848,92,na,1940,68.29284553124985
SIM,1899,16,25-29,1915,22
STAT,1827,45,na,1872,3134.328303934033
STAT,1829,49,35-39,1878,0.21519321791157545
STAT,1937,28,20-24,1965,35.926599951342276
STAT,1918,40,45-49,1958,0.35830416387481934
STAT,1818,36,35-39,1854,54.257615467297086
SIM,1929,27,25-29,1956,193
SIM,1799,76,na,1875,660
SIM,1813,47,50-100,1860,2
STAT,1880,53,na,1933,4507.468263560982
STAT,1857,47,45-49,1904,0.3697784753481377
SIM,1876,43,40-44,1919,9
SIM,1834,30,30-34,1864,48
SIM,1906,23,15-19,1929,9
STAT,1827,42,40-44,1869,4.272607812710864
STAT,1893,21,30-34,1914,45.734934760326134
STAT,1836,52,35-39,1888,0.011584350067257755
STAT,1818,45,50-100,1863,1.1166822081628067
STAT,1855,16,45-49,1871,0.11785251548936164
STAT,1872,36,30-34,1908,10.869725911598467
STAT,1833,25,20-24,1858,20.720853747265032
STAT,1865,52,20-24,1917,0.0013467350496416447
STAT,1824,40,na,1864,3013.465515343893
SIM,1819,41,45-49,1860,7
STAT,1878,32,45-49,1910,3.6782453376176925
STAT,1956,14,na,1970,10492.202072645136
STAT,1884,43,25-29,1927,1.2713837900793488
STAT,1775,97,na,1872,1.388283114095532
STAT,1898,35,na,1933,6500.245136518859
SIM,1841,25,20-24,1866,24
STAT,1914,35,50-100,1949,0.8548107557986152
SIM,1935,21,na,1956,10244
SIM,1844,16,35-39,1860,1
STAT,1816,40,50-100,1856,6.29002771555328
STAT,1887,44,20-24,1931,0.353883589221177
SIM,1922,35,50-100,1957,1
STAT,1864,50,45-49,1914,0.026575895194015164
STAT,1865,46,35-39,1911,0.25760288544912213
STAT,1817,52,25-29,1869,0.016395693767239945
SIM,1889,27,20-24,1916,30
SIM,1869,34,40-44,1903,17
SIM,1873,46,35-39,1919,1
STAT,1852,46,na,1898,3596.000055327847
SIM,1900,31,35-39,1931,40
STAT,1872,75,na,1947,2089.5408801703675
STAT,1933,21,35-39,1954,25.30335107088116
STAT,1910,40,50-100,1950,0.22685941833833775
SIM,1823,75,na,1898,1008
SIM,1865,47,45-49,1912,1
SIM,1837,18,15-19,1855,7
STAT,1826,30,30-34,1856,60.802099627915624
SIM,1854,76,na,1930,1535
STAT,1909,25,40-44,1934,9.139299652481293
SIM,1873,18,na,1891,5335
STAT,1887,43,na,1930,5182.898907622736
SIM,1846,29,15-19,1875,1
STAT,1835,32,na,1867,3573.3582954079675
STAT,1945,22,na,1967,8082.526727049484
STAT,1851,42,50-100,1893,1.6356770884865657
STAT,1862,46,15-19,1908,6.92440315628547E-4
STAT,1822,99,na,1921,2.1383337005189107
STAT,1837,98,na,1935,4.527672211776182
STAT,1848,19,30-34,1867,3.2017421992982085
SIM,1852,10,na,1862,4790
SIM,1837,49,35-39,1886,2
STAT,1829,89,na,1918,124.33179896681042
SIM,1879,23,45-49,1902,2
STAT,1842,103,na,1945,0.21366722965427096
SIM,1880,36,30-34,1916,14
SIM,1939,17,40-44,1956,4
STAT,1883,31,15-19,1914,0.28373053878355636
STAT,1838,32,15-19,1870,0.23949350306711847
STAT,1862,31,50-100,1893,1.588087726926536
STAT,1869,18,50-100,1887,0.09662924505251448
STAT,1893,41,40-44,1934,5.783924857590901
STAT,1838,29,15-19,1867,0.7699160728424845
SIM,1893,31,40-44,1924,13
STAT,1816,40,15-19,1856,0.08222259052533078
SIM,1826,40,40-44,1866,5
SIM,1915,20,na,1935,7709
STAT,1883,51,25-29,1934,0.007061949711898627
SIM,1840,40,50-100,1880,3
STAT,1864,19,20-24,1883,32.72009050904841
SIM,1856,19,30-34,1875,3
STAT,1826,50,40-44,1876,0.021067682209296047
STAT,1916,39,50-100,1955,0.8596007853490528
SIM,1852,64,na,1916,2774
STAT,1844,49,na,1893,3557.43890233915
STAT,1856,41,20-24,1897,0.24858794718049515
STAT,1887,11,na,1898,5842.057355621038
STAT,1910,23,na,1933,7218.057618394109
STAT,1935,30,35-39,1965,25.56742078438999
SIM,1925,11,na,1936,9695
SIM,1831,81,na,1912,563
SIM,1906,29,50-100,1935,1
STAT,1899,45,35-39,1944,0.2207041372940019
STAT,1810,99,na,1909,1.7127238745386053
STAT,1936,35,20-24,1971,0.5236700470124457
STAT,1904,32,50-100,1936,1.5250508131648082
STAT,1927,45,50-100,1972,0.576006616300222
STAT,1866,37,45-49,1903,3.714822050848739
STAT,1922,42,25-29,1964,0.16549024958264266
SIM,1861,40,35-39,1901,1
SIM,1917,35,50-100,1952,2
STAT,1928,21,na,1949,9234.776145274654
SIM,1796,97,na,1893,2
SIM,1861,20,50-100,1881,1
SIM,1937,29,50-100,1966,1
STAT,1912,30,40-44,1942,7.84154097728402
SIM,1862,44,50-100,1906,4
SIM,1870,31,50-100,1901,6
STAT,1863,43,20-24,1906,0.27873747686828637
SIM,1891,19,25-29,1910,17
SIM,1893,44,50-100,1937,1
STAT,1863,81,na,1944,956.0179308601923
SIM,1903,19,na,1922,7428
STAT,1872,48,25-29,1920,0.11544403576944864
SIM,1825,87,na,1912,146
SIM,1867,18,35-39,1885,3
SIM,1837,23,40-44,1860,1
STAT,1850,31,na,1881,3867.483905791227
STAT,1867,96,na,1963,46.31268687051848
STAT,1901,43,35-39,1944,0.3529638211001106
STAT,1800,81,na,1881,452.1509798933487
STAT,1905,23,25-29,1928,166.68522164240667
SIM,1874,37,45-49,1911,7
STAT,1842,54,40-44,1896,0.015242699333219001
STAT,1832,91,na,1923,75.54760421511669
STAT,1872,54,50-100,1926,0.02981167946749905
SIM,1865,31,na,1896,4441
STAT,1892,20,25-29,1912,145.59740964510624
SIM,1792,72,na,1864,1011
STAT,1859,18,35-39,1877,1.0178377013047886
STAT,1829,57,na,1886,2436.087890239502
STAT,1881,26,30-34,1907,49.325809243616376
STAT,1797,106,na,1903,0.005875073103550167
SIM,1901,24,45-49,1925,3
SIM,1925,22,50-100,1947,1
STAT,1911,48,30-34,1959,0.1700202549470001
STAT,1870,47,20-24,1917,0.023682999395676883
SIM,1850,86,na,1936,308
STAT,1841,37,40-44,1878,7.483256311740744
STAT,1853,52,35-39,1905,0.013548752997172843
SIM,1822,35,30-34,1857,14
STAT,1910,21,40-44,1931,6.398694781368334
STAT,1868,18,45-49,1886,0.1270388502178809
SIM,1801,74,na,1875,856
STAT,1865,96,na,1961,35.49861545461692
SIM,1882,38,50-100,1920,2
STAT,1918,15,40-44,1933,0.6196352358152373
STAT,1856,0,na,1856,6199.99572827566
STAT,1845,41,45-49,1886,2.378754472037969
STAT,1876,59,na,1935,4059.6240019240095
SIM,1803,84,na,1887,290
SIM,1852,42,40-44,1894,8
SIM,1835,94,na,1929,31
STAT,1962,1,na,1963,10187.109968456889
STAT,1865,19,na,1884,4719.176444003895
SIM,1937,21,na,1958,7283
SIM,1856,39,25-29,1895,8
STAT,1849,51,25-29,1900,0.005629556819318382
STAT,1768,95,na,1863,4.278502952055321
STAT,1878,69,na,1947,3095.4902632729313
STAT,1925,35,45-49,1960,1.6550025010413172
SIM,1807,77,na,1884,655
SIM,1832,30,20-24,1862,8
STAT,1933,7,na,1940,10808.11479254739
STAT,1876,56,na,1932,4260.5093646439445
STAT,1808,87,na,1895,138.4430226220888
STAT,1860,42,25-29,1902,1.051894077360471
STAT,1793,91,na,1884,37.047063485747444
STAT,1878,37,na,1915,4969.464246639211
STAT,1866,49,na,1915,4104.995775808783
SIM,1788,68,na,1856,1325
SIM,1914,32,30-34,1946,47
STAT,1860,49,45-49,1909,0.37897804074330027
STAT,1843,33,35-39,1876,16.878331552830502
STAT,1859,41,40-44,1900,3.6320467119930107
SIM,1849,29,40-44,1878,7
SIM,1859,22,na,1881,4388
STAT,1909,40,35-39,1949,0.3849057883608498
SIM,1829,29,20-24,1858,21
SIM,1871,56,na,1927,3972
STAT,1844,42,40-44,1886,3.720170441911992
STAT,1920,46,15-19,1966,8.242443721462654E-4
STAT,1813,51,45-49,1864,0.087069080929431
STAT,1860,30,30-34,1890,28.8655580680889
STAT,1891,21,20-24,1912,172.55129531438254
STAT,1841,45,35-39,1886,0.20934710427614162
STAT,1879,33,15-19,1912,0.29956343676505787
SIM,1763,92,na,1855,24
STAT,1880,42,45-49,1922,3.180290969883626
SIM,1850,54,na,1904,3356
STAT,1821,45,15-19,1866,0.0012051438648937175
STAT,1821,51,na,1872,2719.1229057520836
STAT,1921,43,20-24,1964,0.04009955613598536
STAT,1853,36,20-24,1889,1.2323685999830665
STAT,1848,39,25-29,1887,4.765130721469347
STAT,1824,30,20-24,1854,17.34628871640455
STAT,1856,53,30-34,1909,0.009126550237647019
STAT,1874,44,na,1918,4714.933374165874
STAT,1922,49,45-49,1971,0.5011694080152403
STAT,1793,94,na,1887,8.49945738377739
STAT,1906,32,30-34,1938,29.504105492123934
STAT,1902,49,25-29,1951,0.09070932013689234
STAT,1844,46,na,1890,3643.6150343055237
SIM,1917,47,50-100,1964,1
STAT,1893,29,na,1922,6065.544800491725
STAT,1910,43,45-49,1953,0.31587527379603136
STAT,1940,25,35-39,1965,30.948969882946066
STAT,1843,39,50-100,1882,1.7895142543405713
SIM,1803,52,na,1855,2513
STAT,1891,48,na,1939,5546.922313569918
SIM,1859,24,30-34,1883,45
SIM,1929,26,na,1955,9594
STAT,1776,90,na,1866,56.33990459692732
SIM,1866,41,30-34,1907,4
SIM,1913,23,25-29,1936,214
STAT,1879,14,na,1893,5437.829919246527
STAT,1892,27,45-49,1919,2.8071748301634885
SIM,1942,29,50-100,1971,6
SIM,1833,36,45-49,1869,5
SIM,1803,87,na,1890,135
SIM,1920,30,40-44,1950,15
SIM,1898,16,30-34,1914,9
STAT,1822,42,20-24,1864,0.5344628557046202
STAT,1909,19,20-24,1928,53.436172506752605
STAT,1799,85,na,1884,185.4208640427466
STAT,1846,27,na,1873,4008.5172356425687
SIM,1889,41,25-29,1930,3
STAT,1866,22,50-100,1888,0.7661138946854888
SIM,1835,36,50-100,1871,4
SIM,1786,87,na,1873,118
STAT,1834,51,50-100,1885,0.02102584774035164
STAT,1912,39,40-44,1951,2.9219170969766584
STAT,1851,40,25-29,1891,1.0055052319455278
STAT,1825,36,45-49,1861,5.445427616202962
STAT,1880,21,45-49,1901,1.4880816863945516
SIM,1933,35,45-49,1968,2
SIM,1920,39,40-44,1959,5
STAT,1900,33,40-44,1933,12.098578902096179
SIM,1949,5,na,1954,9643
STAT,1910,22,45-49,1932,2.1348011217674943
SIM,1848,40,25-29,1888,4
SIM,1889,41,na,1930,5843
SIM,1940,25,35-39,1965,43
STAT,1847,50,45-49,1897,0.022439780569785867
SIM,1796,65,na,1861,1667
STAT,1815,52,30-34,1867,0.030643255135799814
SIM,1844,36,20-24,1880,3
STAT,1851,19,na,1870,4275.4942145967
SIM,1847,12,na,1859,4605
STAT,1842,18,25-29,1860,10.77002906873444
SIM,1850,18,25-29,1868,13
STAT,1817,43,35-39,1860,9.455189507532882
STAT,1913,49,50-100,1962,0.4433518675555351
STAT,1937,34,25-29,1971,18.447718163787524
STAT,1920,43,45-49,1963,0.3705562970952515
STAT,1823,45,50-100,1868,0.7807871377254352
SIM,1934,4,na,1938,10916
STAT,1850,34,na,1884,3748.864401271955
STAT,1883,52,50-100,1935,0.02980844874950431
SIM,1928,34,25-29,1962,31
STAT,1901,42,50-100,1943,0.2071666009604622
SIM,1902,56,na,1958,6081
STAT,1892,63,na,1955,4511.24911077511
SIM,1928,19,30-34,1947,30
SIM,1960,10,na,1970,10820
STAT,1854,45,50-100,1899,0.38025523540835715
SIM,1878,19,15-19,1897,7
STAT,1943,10,na,1953,8437.950136035777
STAT,1840,25,30-34,1865,45.97925242322061
SIM,1939,11,na,1950,8253
STAT,1921,18,na,1939,8449.217041170541
STAT,1921,24,20-24,1945,252.00023874220182
SIM,1805,65,na,1870,1640
STAT,1847,29,50-100,1876,1.1552623300962466
STAT,1890,45,15-19,1935,9.958921541053673E-4
STAT,1831,47,25-29,1878,0.08814519394308128
STAT,1910,26,na,1936,7333.678634187311
STAT,1842,36,45-49,1878,3.517948237610657
SIM,1808,47,50-100,1855,1
STAT,1887,47,30-34,1934,0.21763176821668173
STAT,1921,25,25-29,1946,149.12187495650247
STAT,1852,12,na,1864,4601.765449369908
STAT,1893,44,45-49,1937,0.2624563805014731
STAT,1897,42,20-24,1939,0.029735813658628853
STAT,1879,18,20-24,1897,37.352994922265
SIM,1879,34,na,1913,4848
SIM,1915,23,na,1938,7648
SIM,1857,15,30-34,1872,4
SIM,1860,61,na,1921,3262
STAT,1827,46,20-24,1873,0.021963158579843475
SIM,1861,49,na,1910,4218
STAT,1867,54,45-49,1921,0.02669430374575615
SIM,1851,33,35-39,1884,29
SIM,1868,81,na,1949,905
SIM,1837,46,30-34,1883,1
SIM,1907,43,45-49,1950,1
STAT,1890,63,na,1953,4398.588203270531
STAT,1906,35,35-39,1941,4.5354493964019245
STAT,1927,37,50-100,1964,1.0540921274322745
STAT,1936,19,15-19,1955,87.2989310636208
STAT,1850,20,20-24,1870,128.66135337578942
SIM,1837,75,na,1912,1360
SIM,1935,3,na,1938,11481
STAT,1861,26,na,1887,4070.135509067862
STAT,1936,36,25-29,1972,1.9543557648532648
SIM,1869,17,15-19,1886,11
SIM,1947,24,15-19,1971,14
STAT,1900,31,25-29,1931,28.813201146957226
STAT,1892,41,na,1933,5869.938453220933
STAT,1915,44,40-44,1959,0.5069271400697064
STAT,1939,4,na,1943,8142.733944213779
STAT,1877,37,20-24,1914,1.6165920678841972
SIM,1938,18,na,1956,7354
STAT,1826,53,45-49,1879,0.027362571547155892
SIM,1849,22,20-24,1871,130
SIM,1944,19,15-19,1963,96
SIM,1922,32,30-34,1954,46
SIM,1895,69,na,1964,4411
STAT,1912,46,15-19,1958,7.169573273583528E-4
STAT,1779,87,na,1866,94.56357532589232
STAT,1883,29,50-100,1912,1.2602524738465113
STAT,1939,24,15-19,1963,10.790736163829797
SIM,1847,34,na,1881,3741
STAT,1825,64,na,1889,2029.631498344789
SIM,1897,70,na,1967,4359
STAT,1768,107,na,1875,0.013962392855849024
STAT,1849,15,30-34,1864,3.140255397176467
SIM,1871,43,20-24,1914,3
SIM,1794,87,na,1881,126
STAT,1829,46,30-34,1875,0.15474811733063795
SIM,1890,43,30-34,1933,8
STAT,1812,51,35-39,1863,0.05823005798133076
STAT,1883,19,25-29,1902,11.18403729326613
SIM,1860,93,na,1953,38
SIM,1903,32,20-24,1935,6
STAT,1851,26,45-49,1877,2.0298281349513703
SIM,1812,66,na,1878,1770
STAT,1896,37,30-34,1933,14.210937070458455
STAT,1893,26,na,1919,6130.173650863525
SIM,1902,34,na,1936,6965
SIM,1922,29,30-34,1951,113
SIM,1885,2,na,1887,6215
STAT,1943,18,na,1961,7880.1589498322455
STAT,1932,25,35-39,1957,39.75266764447113
SIM,1885,37,20-24,1922,1
STAT,1855,86,na,1941,334.57472535563574
SIM,1856,57,na,1913,3332
SIM,1900,2,na,1902,7759
STAT,1874,18,50-100,1892,0.10104559670710761
STAT,1914,32,30-34,1946,32.03491364797695
SIM,1847,41,20-24,1888,1
STAT,1882,43,30-34,1925,2.245514335734028
STAT,1898,48,45-49,1946,0.3592669803224127
SIM,1825,43,35-39,1868,6
STAT,1831,54,30-34,1885,0.007702972841199374
SIM,1923,44,40-44,1967,1
SIM,1919,44,25-29,1963,1
STAT,1901,19,50-100,1920,0.13777527466852454
SIM,1814,92,na,1906,24
SIM,1887,63,na,1950,4228
STAT,1836,19,45-49,1855,0.16640842544301665
STAT,1855,16,50-100,1871,0.0883893866170212
STAT,1882,34,na,1916,4654.6252525317705
STAT,1897,49,40-44,1946,0.25526390605917654
STAT,1884,34,35-39,1918,20.023197683638227
STAT,1820,106,na,1926,0.013592711524733011
SIM,1853,33,50-100,1886,3
SIM,1892,34,35-39,1926,42
STAT,1870,40,35-39,1910,3.6267606620836093
SIM,1848,47,45-49,1895,1
SIM,1849,44,50-100,1893,6
SIM,1818,46,20-24,1864,1
STAT,1833,28,25-29,1861,72.98267638679563
STAT,1854,52,45-49,1906,0.022128912077397866
SIM,1841,28,25-29,1869,87
SIM,1907,42,40-44,1949,1
STAT,1846,46,30-34,1892,0.14869040838948802
SIM,1812,43,50-100,1855,6
SIM,1866,44,35-39,1910,8
STAT,1907,59,na,1966,6219.482600412044
SIM,1913,17,20-24,1930,60
STAT,1841,51,20-24,1892,0.0010757920283302454
SIM,1839,68,na,1907,2067
SIM,1873,19,30-34,1892,7
STAT,1830,35,15-19,1865,0.10821821110676144
STAT,1934,36,na,1970,10496.38878073336
STAT,1820,36,na,1856,3168.3717137357207
SIM,1875,15,25-29,1890,12
SIM,1933,18,50-100,1951,1
STAT,1874,41,15-19,1915,0.028686767332860238
SIM,1876,30,35-39,1906,29
STAT,1830,68,na,1898,2110.2622099530986
SIM,1933,33,45-49,1966,9
STAT,1921,23,50-100,1944,1.4959712571826782
SIM,1772,84,na,1856,148
SIM,1903,34,20-24,1937,6
STAT,1839,41,20-24,1880,0.29090645917160307
SIM,1917,33,na,1950,8144
SIM,1876,27,35-39,1903,24
STAT,1799,56,na,1855,2165.647209398011
STAT,1840,18,15-19,1858,11.025532547519745
STAT,1883,17,50-100,1900,0.09721328045063003
SIM,1913,20,20-24,1933,234
SIM,1909,19,20-24,1928,45
STAT,1830,43,na,1873,3496.4644989563512
STAT,1835,104,na,1939,0.08638601482859223
SIM,1891,17,50-100,1908,2
STAT,1869,55,na,1924,4046.390424762992
SIM,1887,18,20-24,1905,34
STAT,1816,50,na,1866,2818.5071338448
SIM,1843,40,40-44,1883,10
STAT,1925,18,50-100,1943,0.9114635721332484
STAT,1901,37,15-19,1938,0.034269037770096884
STAT,1858,44,35-39,1902,2.812495540906032
SIM,1862,31,45-49,1893,5
STAT,1827,90,na,1917,95.33672491591156
SIM,1906,44,40-44,1950,1
STAT,1866,30,25-29,1896,19.24030855516402
STAT,1839,29,30-34,1868,48.82527776978178
STAT,1881,45,30-34,1926,0.19084533243529053
STAT,1925,33,45-49,1958,3.770776875580582
STAT,1856,16,50-100,1872,0.09080298022614748
STAT,1863,46,25-29,1909,0.10212019502980053
STAT,1865,19,30-34,1884,2.9781964208987333
STAT,1807,50,15-19,1857,1.6683472471270134E-4
STAT,1867,15,25-29,1882,11.087430553757077
STAT,1805,54,20-24,1859,0.005564597252205853
SIM,1891,16,20-24,1907,46
SIM,1924,21,35-39,1945,30
SIM,1863,27,na,1890,4451
SIM,1781,80,na,1861,383
STAT,1843,30,30-34,1873,30.020081436789958
STAT,1835,35,na,1870,3501.214793085045
SIM,1826,80,na,1906,608
STAT,1940,22,30-34,1962,59.13573041307142
STAT,1835,40,40-44,1875,3.5827737295692996
STAT,1872,45,20-24,1917,0.024599714750049413
STAT,1843,83,na,1926,556.1064168745794
SIM,1880,45,20-24,1925,1
STAT,1881,33,50-100,1914,1.7810379560943812
STAT,1814,54,30-34,1868,0.028401192978857664
STAT,1813,107,na,1920,0.004190600483353505
SIM,1857,41,na,1898,4091
STAT,1952,8,na,1960,9511.061952228863
STAT,1915,47,45-49,1962,0.44234048280423177
STAT,1845,42,na,1887,3626.712744490515
STAT,1856,51,50-100,1907,0.023646250271063783
STAT,1931,26,50-100,1957,2.596555353593504
STAT,1921,49,35-39,1970,0.29174913426362653
SIM,1862,42,na,1904,4209
STAT,1894,37,20-24,1931,1.999887897295854
SIM,1830,32,na,1862,3356
STAT,1829,30,50-100,1859,1.8608968093244507
SIM,1787,83,na,1870,231
STAT,1841,42,30-34,1883,1.7333521791375126
SIM,1841,72,na,1913,1645
STAT,1836,47,50-100,1883,0.3418153424502759
STAT,1822,45,25-29,1867,0.18429571688119073
SIM,1844,47,50-100,1891,2
STAT,1860,46,40-44,1906,0.2815793736939967
STAT,1860,33,35-39,1893,16.539136183623004
SIM,1828,28,na,1856,3592
STAT,1834,52,25-29,1886,0.0048344436869495
STAT,1930,36,30-34,1966,4.805565378601338
STAT,1916,21,35-39,1937,19.98680460976091
SIM,1803,55,na,1858,2361
SIM,1933,32,40-44,1965,16
STAT,1904,48,na,1952,6440.9547055888825
STAT,1814,72,na,1886,1191.2606804260952
STAT,1816,53,50-100,1869,0.06977767903480453
STAT,1911,36,20-24,1947,0.5168456931215776
SIM,1923,42,25-29,1965,1
SIM,1898,58,na,1956,5577
SIM,1914,35,35-39,1949,11
STAT,1886,48,50-100,1934,0.5170259776730672
STAT,1910,40,40-44,1950,0.48300297895858507
STAT,1867,45,na,1912,4297.8287384500345
STAT,1909,37,na,1946,7195.855146697722
STAT,1827,79,na,1906,845.3821112744256
STAT,1821,49,30-34,1870,0.2752556014982985
SIM,1898,21,50-100,1919,6
SIM,1908,36,50-100,1944,2
STAT,1870,32,40-44,1902,8.598959652783375
SIM,1866,29,40-44,1895,5
SIM,1813,62,na,1875,2057
STAT,1858,29,40-44,1887,4.75894359052593
SIM,1890,38,40-44,1928,19
STAT,1894,35,50-100,1929,3.2155026374545437
STAT,1925,32,40-44,1957,9.383373708526785
SIM,1898,19,35-39,1917,4
STAT,1903,40,40-44,1943,0.4536785885488958
SIM,1907,23,na,1930,7051
STAT,1876,88,na,1964,605.2218266042324
SIM,1849,25,25-29,1874,93
STAT,1940,19,30-34,1959,24.979379915604383
SIM,1861,39,25-29,1900,10
SIM,1884,74,na,1958,2495
STAT,1915,46,40-44,1961,0.3216820536414129
SIM,1839,18,25-29,1857,22
SIM,1861,46,na,1907,4326
SIM,1830,45,25-29,1875,1
STAT,1853,93,na,1946,46.240460456713706
STAT,1905,17,20-24,1922,51.7811516980903
SIM,1926,26,50-100,1952,3
SIM,1901,21,40-44,1922,6
STAT,1892,24,40-44,1916,5.235503705227936
STAT,1777,87,na,1864,97.0193196677923
SIM,1901,22,45-49,1923,4
STAT,1843,61,na,1904,2617.6178193473634
STAT,1861,30,40-44,1891,7.348655352257119
STAT,1836,111,na,1947,1.4270745406668004E-4
STAT,1838,31,na,1869,3682.703961479066
STAT,1925,41,30-34,1966,0.312986966565066
STAT,1918,34,15-19,1952,0.2733785011520849
STAT,1899,42,30-34,1941,0.22064341952993596
SIM,1838,38,na,1876,3447
STAT,1877,50,30-34,1927,0.012662830255637303
STAT,1831,44,20-24,1875,0.24506642916634064
STAT,1854,31,45-49,1885,2.766151147955128
STAT,1843,86,na,1929,310.80808964707677
STAT,1818,94,na,1912,20.504575150466252
STAT,1840,21,15-19,1861,6.099571353765894
STAT,1850,47,35-39,1897,0.21365702192403982
SIM,1950,18,na,1968,8574
STAT,1905,20,20-24,1925,202.4792204218278
SIM,1894,33,na,1927,6401
STAT,1921,22,20-24,1943,253.58774208117947
STAT,1830,51,45-49,1881,0.022472626638345032
STAT,1819,79,na,1898,731.5274343728215
SIM,1849,12,na,1861,4893
SIM,1836,79,na,1915,791
SIM,1894,48,50-100,1942,1
STAT,1852,43,45-49,1895,2.368129119406736
SIM,1850,15,20-24,1865,39
STAT,1868,24,30-34,1892,34.01250657360145
STAT,1838,17,20-24,1855,31.693247012317467
SIM,1861,36,20-24,1897,2
STAT,1929,43,30-34,1972,0.3338160002449436
SIM,1855,19,20-24,1874,29
STAT,1873,40,45-49,1913,3.1021790519009866
STAT,1891,48,35-39,1939,0.19466632194496608
SIM,1874,96,na,1970,56
STAT,1909,15,na,1924,7689.119799344953
STAT,1797,75,na,1872,821.4498516623697
STAT,1878,54,20-24,1932,0.0015136913086519397
STAT,1897,45,25-29,1942,0.08858907342575273
STAT,1910,30,30-34,1940,30.938674994114553
SIM,1904,60,na,1964,5983
SIM,1905,45,na,1950,6884
STAT,1892,41,25-29,1933,1.6309092325168932
SIM,1863,29,15-19,1892,1
STAT,1900,36,45-49,1936,1.2112754592432056
SIM,1812,69,na,1881,1570
STAT,1817,40,30-34,1857,6.7227812322499485
STAT,1937,32,na,1969,7558.49128730993
SIM,1915,52,na,1967,7415
STAT,1805,76,na,1881,862.9356506214065
SIM,1835,26,35-39,1861,21
SIM,1916,37,na,1953,7897
STAT,1882,38,40-44,1920,8.569567551820617
SIM,1940,22,30-34,1962,82
STAT,1855,32,15-19,1887,0.2186510756222129
STAT,1816,39,na,1855,3079.8531349358955
SIM,1851,39,50-100,1890,3
SIM,1938,17,25-29,1955,102
STAT,1859,53,40-44,1912,0.01665136446516663
STAT,1884,31,30-34,1915,34.9616929337275
SIM,1885,59,na,1944,4106
STAT,1922,46,40-44,1968,0.3666129198061713
STAT,1815,47,40-44,1862,0.9199831148411625
STAT,1806,50,50-100,1856,0.09173490341500519
STAT,1868,59,na,1927,3734.4176513765965
SIM,1874,67,na,1941,2936
STAT,1839,16,na,1855,4716.392815477858
STAT,1918,26,50-100,1944,2.1462984189739234
STAT,1856,82,na,1938,727.045624105458
STAT,1833,40,15-19,1873,0.022609376538593604
SIM,1846,17,20-24,1863,44
STAT,1847,19,20-24,1866,33.33288269682077
STAT,1821,34,50-100,1855,4.606052901769608
STAT,1825,50,25-29,1875,0.007704355084887869
STAT,1859,45,na,1904,3652.6506100678967
SIM,1884,41,40-44,1925,8
SIM,1838,20,na,1858,3935
STAT,1829,39,15-19,1868,0.09462690375603412
SIM,1842,57,na,1899,2840
STAT,1858,35,50-100,1893,1.9513384559097862
SIM,1823,47,40-44,1870,1
SIM,1892,31,30-34,1923,69
STAT,1911,44,15-19,1955,0.0029246963657883164
SIM,1833,29,50-100,1862,2
SIM,1854,90,na,1944,97
STAT,1840,36,50-100,1876,2.117925776593961
STAT,1863,30,na,1893,4252.671905389292
SIM,1885,5,na,1890,5457
STAT,1858,111,na,1969,0.0017634088345928423
SIM,1881,15,na,1896,4377
STAT,1865,30,na,1895,4413.6247793776765
SIM,1877,42,45-49,1919,5
SIM,1825,40,30-34,1865,4
STAT,1839,102,na,1941,0.4577717383769317
STAT,1829,42,15-19,1871,0.0227302376354469
STAT,1871,36,15-19,1907,0.11321728230986473
STAT,1869,42,45-49,1911,2.925228459852861
SIM,1903,35,25-29,1938,3
STAT,1876,70,na,1946,2930.8252085890704
STAT,1926,40,na,1966,9270.928968747357
SIM,1951,14,na,1965,9796
SIM,1820,38,25-29,1858,3
STAT,1862,103,na,1965,1.2656766559050108
STAT,1849,18,35-39,1867,1.062081270106228
SIM,1847,29,30-34,1876,52
STAT,1955,9,na,1964,10534.211995586125
SIM,1939,32,35-39,1971,26
SIM,1927,9,na,1936,10249
STAT,1866,51,25-29,1917,0.00663204992499132
STAT,1896,33,15-19,1929,0.37811743508879925
SIM,1814,47,na,1861,2721
SIM,1882,41,50-100,1923,5
SIM,1926,15,40-44,1941,5
STAT,1859,4,na,1863,4973.548077866177
STAT,1900,35,40-44,1935,12.380593034943018
SIM,1922,35,35-39,1957,7
SIM,1872,19,na,1891,5371
STAT,1838,18,50-100,1856,0.0870667855175348
SIM,1893,43,40-44,1936,1
STAT,1842,68,na,1910,2275.202516416824
STAT,1894,22,na,1916,6135.874568423176
STAT,1828,41,45-49,1869,2.863936138534245
STAT,1855,29,15-19,1884,0.7029125041236038
STAT,1872,16,45-49,1888,0.13381201793889286
SIM,1845,53,na,1898,3440
SIM,1885,37,na,1922,5000
SIM,1865,82,na,1947,746
STAT,1922,32,15-19,1954,0.29315810673210296
STAT,1928,40,45-49,1968,0.42962255400699445
STAT,1809,50,40-44,1859,0.08079249299031495
STAT,1900,47,50-100,1947,0.3863243478095226
SIM,1851,30,30-34,1881,53
STAT,1876,41,40-44,1917,4.719680974988565
STAT,1895,32,45-49,1927,4.589095753924131
STAT,1846,49,35-39,1895,0.20996194992673745
SIM,1935,29,na,1964,10594
STAT,1936,33,20-24,1969,4.782855851920105
STAT,1939,28,30-34,1967,79.52428325501936
STAT,1774,98,na,1872,0.8273851924770121
STAT,1918,29,na,1947,7992.756966605565
STAT,1914,35,35-39,1949,4.9244919425633995
SIM,1889,44,na,1933,5758
SIM,1883,20,25-29,1903,127
STAT,1930,22,50-100,1952,1.7023922983135238
STAT,1939,1,na,1940,8424.958318558254
STAT,1817,102,na,1919,0.29570375185066045
STAT,1901,18,40-44,1919,0.5157795442556289
STAT,1818,52,40-44,1870,0.044506390454081696
STAT,1875,53,25-29,1928,0.007246835655500815
SIM,1857,18,35-39,1875,3
SIM,1881,40,45-49,1921,2
STAT,1867,74,na,1941,2099.0814081239964
STAT,1894,20,35-39,1914,15.229882080869132
SIM,1928,28,20-24,1956,55
STAT,1842,15,20-24,1857,34.2968242154114
STAT,1882,52,20-24,1934,0.0014440515763771253
STAT,1856,48,40-44,1904,0.26341805909858246
STAT,1910,24,45-49,1934,2.1214368957167946
SIM,1878,24,40-44,1902,3
STAT,1882,46,35-39,1928,0.27621754769884754
STAT,1932,22,30-34,1954,76.16768419280397
STAT,1844,50,35-39,1894,0.014102680813090315
STAT,1944,24,15-19,1968,11.59913001654734
SIM,1844,22,50-100,1866,1
STAT,1860,54,35-39,1914,0.013731291324068995
SIM,1836,41,45-49,1877,2
SIM,1928,31,20-24,1959,8
STAT,1916,48,15-19,1964,7.609467216749391E-4
SIM,1874,45,na,1919,4388
SIM,1822,76,na,1898,979
STAT,1871,6,na,1877,5536.377824772258
SIM,1950,9,na,1959,9182
SIM,1850,83,na,1933,592
SIM,1851,3,na,1854,5308
STAT,1904,46,30-34,1950,0.15873003072983055
STAT,1900,16,na,1916,7093.178345562215
STAT,1837,53,20-24,1890,0.0010122165352040849
STAT,1907,37,na,1944,7048.57701232148
SIM,1827,68,na,1895,1795
STAT,1857,67,na,1924,2495.4450497971648
STAT,1874,41,50-100,1915,2.194537540601204
STAT,1894,17,35-39,1911,1.4235692527527442
STAT,1789,97,na,1886,2.0312547401474137
STAT,1836,22,50-100,1858,0.7157216887464347
STAT,1885,43,40-44,1928,4.489046802030898
SIM,1864,48,40-44,1912,1
STAT,1949,17,35-39,1966,9.855588323559394
STAT,1918,11,na,1929,8721.5055659255
STAT,1919,39,na,1958,8143.745404449811
STAT,1909,35,50-100,1944,0.8106711656044524
SIM,1859,27,40-44,1886,11
SIM,1882,20,45-49,1902,2
STAT,1847,16,15-19,1863,11.357549423513294
SIM,1854,22,na,1876,4212
SIM,1942,25,40-44,1967,16
STAT,1913,15,25-29,1928,17.98195040697711
STAT,1765,109,na,1874,0.005707304267769614
STAT,1831,39,40-44,1870,7.007983702867293
STAT,1923,37,30-34,1960,4.2636425497121015
STAT,1889,43,na,1932,5713.948555314861
STAT,1927,34,na,1961,9382.477435638139
SIM,1912,32,50-100,1944,2
STAT,1878,91,na,1969,408.994807099522
SIM,1920,34,20-24,1954,4
SIM,1872,6,na,1878,5846
STAT,1878,16,45-49,1894,0.1381232060031751
STAT,1882,42,50-100,1924,2.075901007325576
SIM,1860,22,50-100,1882,1
SIM,1869,75,na,1944,1795
STAT,1811,107,na,1918,0.004383782656812654
STAT,1912,34,20-24,1946,4.807116399508513
SIM,1843,25,50-100,1868,1
SIM,1850,32,na,1882,3968
STAT,1885,53,na,1938,4259.122720913871
STAT,1937,31,15-19,1968,0.2569674034564341
SIM,1869,30,25-29,1899,24
STAT,1853,20,na,1873,4055.118995204759
SIM,1872,45,30-34,1917,2
STAT,1916,41,25-29,1957,0.14800496084936116
STAT,1893,15,30-34,1908,4.099068198404245
STAT,1812,46,na,1858,2938.412141862254
SIM,1918,30,45-49,1948,4
STAT,1946,24,20-24,1970,249.71491468812448
SIM,1928,2,na,1930,10509
SIM,1921,15,25-29,1936,132
SIM,1846,27,na,1873,4039
SIM,1933,32,35-39,1965,40
STAT,1955,17,25-29,1972,116.16891586783355
STAT,1902,27,15-19,1929,1.2936629973300762
STAT,1899,73,na,1972,4199.37412797834
STAT,1906,38,40-44,1944,2.766835747045521
SIM,1920,44,na,1964,8442
STAT,1865,50,50-100,1915,0.028108908839863105
STAT,1871,36,50-100,1907,2.4753411776406233
SIM,1843,17,35-39,1860,1
SIM,1855,16,15-19,1871,13
STAT,1929,25,30-34,1954,99.40408420569045
SIM,1880,30,na,1910,5327
SIM,1882,65,na,1947,3394
SIM,1940,28,40-44,1968,16
SIM,1950,0,na,1950,9610
STAT,1927,28,30-34,1955,95.8507906200867
STAT,1864,45,30-34,1909,0.17649618096837924
SIM,1919,29,30-34,1948,92
SIM,1900,25,35-39,1925,36
STAT,1822,48,30-34,1870,0.29664856911622317
STAT,1932,28,40-44,1960,12.324784958436654
STAT,1908,35,40-44,1943,2.8594437183403056
SIM,1907,54,na,1961,6436
SIM,1929,30,20-24,1959,6
SIM,1914,38,40-44,1952,8
SIM,1912,42,45-49,1954,2
SIM,1905,29,30-34,1934,109
STAT,1914,44,25-29,1958,0.14245389357037766
STAT,1925,32,35-39,1957,21.91197994115577
SIM,1883,36,50-100,1919,4
STAT,1926,27,50-100,1953,2.409385254990782
SIM,1890,60,na,1950,4956
SIM,1935,28,30-34,1963,141
SIM,1901,26,50-100,1927,1
STAT,1901,34,45-49,1935,4.8882164392413765
SIM,1875,46,50-100,1921,1
SIM,1937,27,25-29,1964,129
SIM,1855,63,na,1918,3063
SIM,1871,14,na,1885,5089
STAT,1805,49,40-44,1854,1.3646814034680457
STAT,1933,27,45-49,1960,4.633323598025413
SIM,1868,30,35-39,1898,26
SIM,1902,20,40-44,1922,6
STAT,1868,81,na,1949,1039.0932679549514
STAT,1859,33,25-29,1892,16.395393906414736
STAT,1884,12,na,1896,5150.221688653333
SIM,1859,45,na,1904,4034
SIM,1903,19,25-29,1922,19
STAT,1859,31,30-34,1890,28.181003573427176
STAT,1938,2,na,1940,8149.28056016025
STAT,1904,42,45-49,1946,0.30089442852583975
STAT,1928,28,20-24,1956,45.38991548316435
STAT,1842,76,na,1918,1410.5082055391924
STAT,1902,45,45-49,1947,0.3833658859786604
STAT,1913,22,na,1935,7470.184742076169
STAT,1869,23,40-44,1892,4.06528722537811
STAT,1875,31,15-19,1906,0.29732573669637136
STAT,1902,50,na,1952,6227.823254640083
SIM,1942,23,45-49,1965,2
SIM,1863,50,na,1913,4062
STAT,1930,30,20-24,1960,6.364539681513259
SIM,1839,15,20-24,1854,42
STAT,1900,32,50-100,1932,2.566976006306235
SIM,1808,61,na,1869,2052
STAT,1850,50,25-29,1900,0.005508905029069023
SIM,1941,27,45-49,1968,4
STAT,1900,31,20-24,1931,7.603903539318731
SIM,1804,71,na,1875,1175
SIM,1907,42,35-39,1949,1
SIM,1937,25,30-34,1962,98
STAT,1937,33,50-100,1970,1.6513351048998
SIM,1936,28,20-24,1964,29
SIM,1844,91,na,1935,48
SIM,1910,45,45-49,1955,2
STAT,1827,99,na,1926,2.2901291363688565
STAT,1904,22,20-24,1926,199.7593828953768
STAT,1929,27,25-29,1956,166.3514546327722
SIM,1910,30,45-49,1940,5
STAT,1899,53,na,1952,5862.610330010895
SIM,1886,55,na,1941,4216
STAT,1934,25,40-44,1959,12.676384587675948
STAT,1853,32,50-100,1885,1.4928753483693191
SIM,1893,9,na,1902,6896
STAT,1865,30,45-49,1895,3.2253032706075375
SIM,1863,19,na,1882,4799
SIM,1838,83,na,1921,473
SIM,1879,73,na,1952,2255
STAT,1912,18,15-19,1930,18.490502348441964
SIM,1943,24,45-49,1967,3
STAT,1794,107,na,1901,0.00184723676714341
STAT,1913,33,25-29,1946,18.498149322089052
SIM,1781,89,na,1870,62
SIM,1813,49,40-44,1862,1
STAT,1788,79,na,1867,572.999998324616
SIM,1867,31,30-34,1898,50
SIM,1920,18,15-19,1938,93
SIM,1905,16,25-29,1921,19
STAT,1945,26,25-29,1971,145.89341987614944
SIM,1880,50,na,1930,4829
STAT,1784,97,na,1881,1.5805197958937145
SIM,1900,23,40-44,1923,8
SIM,1925,28,45-49,1953,4
STAT,1917,28,45-49,1945,3.6459115286356614
SIM,1921,33,25-29,1954,27
SIM,1889,34,50-100,1923,2
STAT,1876,17,na,1893,5275.636945663348
STAT,1848,53,na,1901,3473.8776577090657
STAT,1935,24,45-49,1959,3.0929400802283444
STAT,1944,27,20-24,1971,39.8424346277659
STAT,1943,19,50-100,1962,0.8018220310161307
STAT,1833,53,50-100,1886,0.02009474057440935
SIM,1877,19,na,1896,5220
STAT,1859,54,50-100,1913,0.023609891069701724
STAT,1919,47,na,1966,8045.954165910214
STAT,1937,19,30-34,1956,23.881705952009376
SIM,1901,21,35-39,1922,23
SIM,1825,65,na,1890,1832
STAT,1902,30,45-49,1932,5.0122082992834525
SIM,1852,20,30-34,1872,45
STAT,1867,20,na,1887,4556.942034416989
STAT,1913,45,20-24,1958,0.02189241900042173
SIM,1932,21,na,1953,9733
SIM,1872,55,na,1927,4316
SIM,1849,35,30-34,1884,13
SIM,1835,20,30-34,1855,39
STAT,1896,25,na,1921,6406.665150557525
SIM,1932,36,35-39,1968,12
STAT,1868,24,35-39,1892,11.142833445216478
STAT,1904,42,15-19,1946,0.002776419373942386
SIM,1843,50,na,1893,3276
SIM,1921,17,20-24,1938,310
STAT,1860,20,15-19,1880,6.21823768552013
STAT,1934,23,45-49,1957,3.0533025575838706
SIM,1805,96,na,1901,4
STAT,1934,38,15-19,1972,0.0534737387108766
STAT,1810,109,na,1919,6.434106019105513E-4
SIM,1857,98,na,1955,8
STAT,1912,1,na,1913,8502.899041387209
SIM,1900,40,30-34,1940,1
SIM,1904,37,50-100,1941,1
SIM,1928,16,na,1944,9511
SIM,1914,36,na,1950,7794
STAT,1770,101,na,1871,0.2212770835206996
STAT,1910,21,35-39,1931,17.918848975733187
SIM,1852,22,25-29,1874,135
STAT,1845,33,na,1878,3929.7768929849713
SIM,1915,34,40-44,1949,13
SIM,1921,30,20-24,1951,1
STAT,1909,34,45-49,1943,3.0083546376200494
SIM,1867,15,25-29,1882,15
SIM,1894,42,na,1936,6255
STAT,1840,44,30-34,1884,1.687284291608838
STAT,1907,34,40-44,1941,7.328361766037864
SIM,1926,37,20-24,1963,1
SIM,1905,47,30-34,1952,1
STAT,1902,8,na,1910,7412.206196111554
SIM,1912,22,20-24,1934,227
STAT,1877,17,40-44,1894,0.3835766492111844
SIM,1891,14,na,1905,6648
SIM,1867,40,na,1907,4726
SIM,1875,83,na,1958,950
STAT,1864,32,50-100,1896,1.6541067937544607
STAT,1839,22,15-19,1861,6.618667759830162
STAT,1913,17,20-24,1930,55.996906135088196
STAT,1853,26,50-100,1879,1.180977824249378
SIM,1840,22,na,1862,4222
STAT,1928,26,25-29,1954,164.30808409228527
STAT,1844,22,25-29,1866,115.42578123615368
STAT,1858,35,30-34,1893,8.470675120773423
STAT,1922,33,50-100,1955,1.8782084704784456
SIM,1886,75,na,1961,2412
STAT,1912,16,20-24,1928,55.51857277239076
STAT,1907,36,35-39,1943,4.5533957721190434
SIM,1888,41,45-49,1929,8
STAT,1947,20,20-24,1967,253.96526331380107
SIM,1837,20,35-39,1857,14
STAT,1915,45,25-29,1960,0.10846919206340605
SIM,1932,34,40-44,1966,15
STAT,1843,104,na,1947,0.09343459928715754
STAT,1924,34,40-44,1958,9.206353713960572
STAT,1933,29,40-44,1962,12.488193005976552
SIM,1874,42,na,1916,4478
SIM,1903,44,na,1947,6755
STAT,1927,45,20-24,1972,0.02814364686184843
SIM,1847,22,15-19,1869,7
SIM,1941,29,40-44,1970,16
STAT,1917,38,15-19,1955,0.040079921584258195
STAT,1930,32,15-19,1962,0.33492997384909107
SIM,1920,16,20-24,1936,338
SIM,1936,26,25-29,1962,128
STAT,1885,20,20-24,1905,139.36109914854845
STAT,1904,40,20-24,1944,0.03229074960819635
SIM,1926,24,45-49,1950,2
SIM,1858,49,50-100,1907,2
SIM,1915,36,35-39,1951,6
STAT,1819,43,50-100,1862,4.734531568319739
STAT,1869,25,35-39,1894,19.01047373656526
STAT,1918,39,15-19,1957,0.040784570533925674
SIM,1884,18,35-39,1902,1
STAT,1861,51,50-100,1912,0.02550931989888432
SIM,1808,53,na,1861,2530
STAT,1928,44,25-29,1972,0.183214430301484
STAT,1846,58,na,1904,3029.104116981845
STAT,1889,31,45-49,1920,4.360269610707953
SIM,1819,45,na,1864,2902
STAT,1839,16,50-100,1855,0.10066249308531008
STAT,1904,24,15-19,1928,9.503145853273308
STAT,1918,37,20-24,1955,0.5610552653941351
SIM,1856,17,na,1873,4654
STAT,1923,19,30-34,1942,28.741697461786202
SIM,1893,20,20-24,1913,171
STAT,1812,109,na,1921,6.74397228801602E-4
SIM,1917,34,45-49,1951,8
STAT,1953,18,30-34,1971,29.76653793748293
SIM,1836,21,30-34,1857,39
SIM,1878,28,50-100,1906,2
SIM,1916,35,40-44,1951,5
STAT,1919,36,25-29,1955,2.1377965464967343
STAT,1940,24,na,1964,7508.543482490804
STAT,1928,29,30-34,1957,97.38107760509
SIM,1897,31,45-49,1928,8
SIM,1848,81,na,1929,681
STAT,1943,18,45-49,1961,1.0694703559794336
SIM,1941,26,35-39,1967,44
SIM,1915,18,35-39,1933,3
STAT,1811,84,na,1895,309.231855557606
SIM,1931,19,30-34,1950,42
STAT,1851,30,15-19,1881,0.2345910264505493
SIM,1951,18,45-49,1969,1
STAT,1943,28,15-19,1971,1.5176683457079925
SIM,1831,44,30-34,1875,6
SIM,1890,80,na,1970,2412
SIM,1945,19,30-34,1964,38
SIM,1879,0,na,1879,7232
STAT,1844,20,30-34,1864,36.43671183788134
STAT,1916,42,50-100,1958,0.24314140231011103
STAT,1946,3,na,1949,8968.144259420807
SIM,1835,63,na,1898,2358
SIM,1880,7,na,1887,5966
SIM,1931,37,30-34,1968,5
STAT,1862,96,na,1958,22.734431349703442
SIM,1828,81,na,1909,598
STAT,1908,33,45-49,1941,2.9891277151793334
SIM,1900,22,30-34,1922,65
STAT,1907,18,35-39,1925,1.6245002066039078
SIM,1839,45,na,1884,3229
SIM,1956,6,na,1962,10707
SIM,1930,36,30-34,1966,9
STAT,1839,40,45-49,1879,2.776826127215004
SIM,1829,39,50-100,1868,3
STAT,1866,100,na,1966,9.588244140675949
STAT,1858,51,na,1909,3406.206466402586
SIM,1934,36,na,1970,10353
STAT,1860,10,na,1870,4572.134644279979
STAT,1876,30,20-24,1906,5.691696411488737
STAT,1868,100,na,1968,12.408731240889978
SIM,1903,64,na,1967,5760
SIM,1916,33,45-49,1949,6
STAT,1868,9,na,1877,5237.602295045394
SIM,1863,9,na,1872,5094
STAT,1924,36,35-39,1960,5.763906718258327
STAT,1938,18,35-39,1956,8.358408617907793
STAT,1868,32,50-100,1900,1.7605900105535888
SIM,1859,40,50-100,1899,4
SIM,1946,18,35-39,1964,10
STAT,1810,49,20-24,1859,0.07531909847660394
STAT,1865,33,na,1898,4359.953358115617
SIM,1927,36,25-29,1963,4
STAT,1834,30,15-19,1864,0.24791307924077235
SIM,1847,40,45-49,1887,2
STAT,1890,35,30-34,1925,13.263015757441142
STAT,1922,36,30-34,1958,4.191072062174242
STAT,1938,30,20-24,1968,4.959704772114887
SIM,1912,24,15-19,1936,7
STAT,1771,90,na,1861,43.203644486154246
STAT,1880,45,15-19,1925,8.595128783813367E-4
SIM,1935,29,15-19,1964,1
STAT,1886,27,na,1913,5087.930483960694
STAT,1849,15,na,1864,4522.500320688443
STAT,1823,44,30-34,1867,3.63802735799179
STAT,1807,79,na,1886,657.2450117861343
STAT,1867,25,30-34,1892,47.95279990507592
SIM,1887,60,na,1947,4568
SIM,1925,25,40-44,1950,17
STAT,1904,0,na,1904,8511.675226270672
STAT,1906,37,30-34,1943,3.3853939190536293
STAT,1888,49,35-39,1937,0.1845745384582069
STAT,1915,32,50-100,1947,1.7007731412566964
SIM,1950,17,45-49,1967,1
STAT,1905,23,20-24,1928,200.65632969361639
STAT,1852,15,na,1867,4477.40490212017
STAT,1920,40,35-39,1960,0.4502991711618326
STAT,1840,47,40-44,1887,0.24919776000948615
STAT,1860,2,na,1862,5664.850925510522
SIM,1923,32,50-100,1955,4
STAT,1813,54,15-19,1867,1.3894044329606194E-4
SIM,1858,83,na,1941,652
STAT,1927,29,15-19,1956,1.7260639127349358
SIM,1946,15,30-34,1961,30
SIM,1915,39,40-44,1954,2
STAT,1916,42,35-39,1958,0.41675707817091123
SIM,1936,29,30-34,1965,84
SIM,1939,0,na,1939,8719
SIM,1902,59,na,1961,5921
SIM,1876,24,35-39,1900,15
SIM,1839,16,30-34,1855,4
SIM,1869,35,na,1904,4631
STAT,1844,71,na,1915,2155.5882334507037
STAT,1859,48,50-100,1907,0.38983867572237657
STAT,1930,15,25-29,1945,113.67491209749267
SIM,1822,39,40-44,1861,11
SIM,1927,38,20-24,1965,1
STAT,1879,27,50-100,1906,1.35133553058049
SIM,1931,36,na,1967,10117
SIM,1914,37,30-34,1951,7
STAT,1905,47,na,1952,6541.871812123229
SIM,1875,22,50-100,1897,3
STAT,1942,17,45-49,1959,1.0543415665590774
SIM,1895,20,25-29,1915,190
SIM,1879,65,na,1944,3438
SIM,1851,93,na,1944,20
STAT,1762,110,na,1872,0.0044221491275894705
STAT,1826,38,na,1864,3363.260404060884
STAT,1860,41,na,1901,3807.776336009382
SIM,1922,4,na,1926,9935
STAT,1878,51,na,1929,4563.408282319427
STAT,1937,24,na,1961,7178.594031659861
STAT,1839,110,na,1949,4.314821220089228E-4
STAT,1933,26,35-39,1959,40.283355046585086
SIM,1851,24,30-34,1875,41
STAT,1900,55,na,1955,5792.957023813545
STAT,1914,43,15-19,1957,0.0030688953644046153
STAT,1801,54,na,1855,2358.463275975704
STAT,1893,18,35-39,1911,1.4009483647614667
STAT,1922,23,25-29,1945,213.21259872800056
SIM,1930,23,25-29,1953,264
STAT,1903,28,15-19,1931,1.3000575932101326
STAT,1907,34,na,1941,7082.528079501216
STAT,1843,24,30-34,1867,30.871433318396654
SIM,1824,71,na,1895,1590
SIM,1908,41,40-44,1949,1
STAT,1919,38,20-24,1957,0.5712549366215538
STAT,1873,20,na,1893,4882.169500070944
SIM,1911,28,15-19,1939,1
STAT,1887,20,25-29,1907,130.07748118900003
SIM,1897,23,50-100,1920,1
STAT,1924,14,na,1938,9495.9455904589
SIM,1826,30,30-34,1856,40
STAT,1889,23,50-100,1912,1.0123551999552103
SIM,1866,55,na,1921,4025
SIM,1843,49,50-100,1892,2
STAT,1852,17,35-39,1869,1.057720865454779
STAT,1828,61,na,1889,2329.827243572611
STAT,1832,37,35-39,1869,11.651190976866502
SIM,1933,35,40-44,1968,4
STAT,1916,27,45-49,1943,3.607603537152492
SIM,1822,37,na,1859,3198
STAT,1908,32,35-39,1940,17.432613943247304
STAT,1885,21,30-34,1906,35.91607212194665
STAT,1901,15,35-39,1916,1.558611265228452
STAT,1953,19,15-19,1972,110.79276506353392
STAT,1862,47,20-24,1909,0.02061784399817149
STAT,1897,10,na,1907,6992.952679536887
STAT,1907,39,40-44,1946,2.776416414467604
SIM,1893,49,na,1942,5837
STAT,1881,48,40-44,1929,0.3299971258499532
SIM,1947,17,40-44,1964,1
STAT,1925,35,40-44,1960,3.63422443772239
STAT,1939,17,40-44,1956,2.8279484723050485
SIM,1924,27,45-49,1951,5
STAT,1866,27,na,1893,4447.237661286008
STAT,1893,37,50-100,1930,3.142871751514959
STAT,1922,38,25-29,1960,2.2597972936178263
SIM,1858,41,30-34,1899,4
STAT,1822,49,40-44,1871,0.5171693522327662
SIM,1869,7,na,1876,5340
SIM,1925,28,50-100,1953,3
STAT,1954,16,25-29,1970,108.21353665990709
SIM,1893,21,30-34,1914,4
SIM,1830,49,40-44,1879,1
STAT,1888,81,na,1969,2135.6187722723275
SIM,1891,22,na,1913,6100
STAT,1917,25,40-44,1942,9.93827507784209
STAT,1871,81,na,1952,1085.0521009261
STAT,1901,30,25-29,1931,29.192403479243495
STAT,1905,36,50-100,1941,0.7777248444646977
STAT,1794,87,na,1881,120.55180688370677
SIM,1896,49,35-39,1945,1
SIM,1860,17,35-39,1877,1
SIM,1913,23,20-24,1936,235
STAT,1859,15,25-29,1874,10.699547484096717
STAT,1959,5,na,1964,10385.075416809766
SIM,1856,8,na,1864,4972
SIM,1901,24,40-44,1925,5
SIM,1879,45,na,1924,4663
SIM,1921,32,45-49,1953,8
STAT,1911,20,40-44,1931,6.480573353194491
STAT,1921,49,na,1970,8313.24990703387
SIM,1916,32,35-39,1948,23
SIM,1899,26,30-34,1925,92
SIM,1848,34,50-100,1882,2
STAT,1904,25,25-29,1929,123.45270847130747
STAT,1921,42,45-49,1963,0.37849274252001014
SIM,1861,24,na,1885,4535
SIM,1903,48,50-100,1951,1
STAT,1831,84,na,1915,429.51744912222773
STAT,1869,26,45-49,1895,2.1802525394899868
STAT,1913,42,na,1955,7316.418317952639
SIM,1912,25,25-29,1937,145
STAT,1883,6,na,1889,5210.747483113575
SIM,1904,15,25-29,1919,16
SIM,1855,83,na,1938,608
STAT,1899,36,30-34,1935,14.818662136812899
SIM,1835,22,25-29,1857,105
STAT,1798,104,na,1902,0.03610809545496299
SIM,1892,25,30-34,1917,96
STAT,1930,14,na,1944,10312.09337319026
STAT,1852,35,na,1887,3854.5795314029674
SIM,1900,41,40-44,1941,2
SIM,1921,18,30-34,1939,33
STAT,1934,22,35-39,1956,25.559754104760508
SIM,1928,34,20-24,1962,3
SIM,1909,38,30-34,1947,5
STAT,1926,31,40-44,1957,9.560547901411264
STAT,1924,37,45-49,1961,1.6230655634495141
SIM,1932,33,30-34,1965,61
SIM,1835,23,35-39,1858,12
SIM,1900,28,40-44,1928,11
STAT,1916,45,45-49,1961,0.452329475050399
SIM,1814,61,na,1875,2136
SIM,1846,78,na,1924,1043
SIM,1930,39,35-39,1969,11
SIM,1909,46,50-100,1955,2
SIM,1896,17,15-19,1913,15
SIM,1879,20,40-44,1899,6
SIM,1838,91,na,1929,81
STAT,1855,94,na,1949,30.137693698968224
STAT,1862,3,na,1865,5585.724261036103
SIM,1910,46,na,1956,7180
STAT,1790,97,na,1887,1.8100823297993005
STAT,1863,49,30-34,1912,0.16755966299157649
SIM,1904,33,25-29,1937,22
STAT,1931,39,na,1970,10041.786986295743
SIM,1897,39,na,1936,6422
SIM,1898,15,25-29,1913,24
SIM,1840,37,35-39,1877,27
SIM,1924,45,45-49,1969,1
STAT,1900,19,35-39,1919,1.5290328876561776
STAT,1859,25,na,1884,3959.178500092765
SIM,1932,32,20-24,1964,1
STAT,1872,35,na,1907,4827.437744224196
STAT,1924,33,30-34,1957,37.08983567840433
STAT,1936,35,15-19,1971,0.03814815391975088
SIM,1861,32,50-100,1893,3
STAT,1936,20,45-49,1956,2.1744797087937147
SIM,1773,94,na,1867,2
STAT,1945,23,20-24,1968,246.02604242225848
SIM,1825,34,30-34,1859,32
STAT,1840,47,35-39,1887,0.20378321543097588
STAT,1783,95,na,1878,4.4511965421519175
STAT,1815,43,50-100,1858,6.150611094468234
SIM,1814,44,50-100,1858,3
SIM,1877,25,35-39,1902,21
SIM,1871,49,30-34,1920,1
STAT,1868,21,30-34,1889,34.47429757222702
SIM,1951,15,40-44,1966,5
STAT,1913,18,30-34,1931,5.021167069061579
SIM,1862,65,na,1927,3059
STAT,1850,45,50-100,1895,0.3803253056005061
SIM,1852,98,na,1950,3
SIM,1853,37,na,1890,3907
SIM,1921,38,na,1959,8479
STAT,1862,68,na,1930,2637.9765000831126
STAT,1810,46,45-49,1856,1.569419546890789
STAT,1844,48,50-100,1892,0.3916393037863099
STAT,1835,22,50-100,1857,0.7023724772082145
STAT,1943,15,40-44,1958,2.9970645117396866
STAT,1895,63,na,1958,4842.225713536231
STAT,1861,101,na,1962,2.9230514922265964
STAT,1872,66,na,1938,3326.765286536534
STAT,1877,19,na,1896,5268.191058824787
SIM,1904,48,25-29,1952,1
SIM,1876,21,30-34,1897,54
SIM,1849,38,35-39,1887,24
SIM,1903,18,15-19,1921,18
STAT,1912,17,30-34,1929,4.979124091388804
STAT,1836,28,na,1864,3694.9246138923722
STAT,1895,20,50-100,1915,1.0795567440235796
STAT,1895,15,35-39,1910,1.4507087772501108
STAT,1806,86,na,1892,151.0789563718537
STAT,1890,7,na,1897,6422.609250720687
SIM,1938,26,na,1964,7547
SIM,1877,22,30-34,1899,46
SIM,1865,26,50-100,1891,5
SIM,1881,38,35-39,1919,12
STAT,1857,26,50-100,1883,1.0447286872979464
STAT,1918,21,40-44,1939,7.344775048736843
SIM,1860,30,na,1890,4153
STAT,1879,45,na,1924,4800.1198949320815
SIM,1920,17,30-34,1937,37
STAT,1767,117,na,1884,1.236435246022444E-4
SIM,1815,55,na,1870,2276
SIM,1930,20,15-19,1950,13
STAT,1938,33,25-29,1971,18.760763135515283
STAT,1835,63,na,1898,2310.9271127761062
STAT,1928,25,15-19,1953,1.7681691166492746
STAT,1869,22,30-34,1891,34.85756107024055
STAT,1946,25,30-34,1971,88.22001214685373
STAT,1901,16,45-49,1917,0.18514442911026413
SIM,1881,24,na,1905,4051
SIM,1844,12,na,1856,4293
STAT,1817,38,na,1855,3107.1906622746924
STAT,1867,28,35-39,1895,18.18597983387057
STAT,1948,19,35-39,1967,9.691273945733357
STAT,1835,43,na,1878,3221.014232791763
STAT,1888,17,15-19,1905,14.166159202635296
SIM,1863,39,30-34,1902,12
SIM,1934,31,40-44,1965,16
STAT,1906,40,na,1946,6894.210335257034
STAT,1938,15,30-34,1953,24.399799956998514
SIM,1927,33,20-24,1960,7
SIM,1886,47,na,1933,4640
SIM,1915,0,na,1915,8946
STAT,1848,61,na,1909,3064.015282098735
STAT,1884,25,30-34,1909,50.5602247706416
STAT,1914,16,na,1930,8090.103616778551
STAT,1922,39,35-39,1961,5.545110819837776
SIM,1807,68,na,1875,1360
SIM,1938,23,25-29,1961,188
STAT,1790,107,na,1897,0.0018447008321486574
SIM,1942,22,35-39,1964,24
SIM,1922,29,35-39,1951,53
SIM,1856,48,50-100,1904,1
STAT,1832,40,50-100,1872,1.7290120783018568
STAT,1840,29,40-44,1869,5.314153228217861
STAT,1919,33,20-24,1952,5.291239446450449
STAT,1877,10,na,1887,5500.259377950944
STAT,1883,58,na,1941,3924.094026365725
STAT,1891,25,na,1916,5998.092701077941
SIM,1854,31,50-100,1885,1
STAT,1881,48,35-39,1929,0.26985746335008765
STAT,1830,39,25-29,1869,5.246719900723598
STAT,1890,60,na,1950,4701.495288139959
STAT,1902,17,45-49,1919,0.1862570739962769
STAT,1914,47,na,1961,7359.769897363895
SIM,1944,26,na,1970,8294
STAT,1824,71,na,1895,1427.0833514739602
STAT,1873,38,35-39,1911,14.4420422019474
SIM,1890,29,na,1919,6223
SIM,1905,17,35-39,1922,2
STAT,1922,20,15-19,1942,12.398916590272753
SIM,1836,24,35-39,1860,13
STAT,1950,22,20-24,1972,266.3934377755358
SIM,1900,21,20-24,1921,217
STAT,1925,0,na,1925,10988.907483301484
STAT,1851,73,na,1924,1841.2335304422847
STAT,1903,29,25-29,1932,120.77098847699686
STAT,1766,92,na,1858,12.5183627158961
STAT,1863,45,15-19,1908,7.142097511563288E-4
STAT,1954,15,15-19,1969,113.3562907815102
STAT,1839,25,20-24,1864,23.41132019780784
STAT,1866,25,50-100,1891,1.200141078349235
STAT,1878,17,50-100,1895,0.1033386031113505
STAT,1893,30,20-24,1923,6.975120676742437
STAT,1952,18,15-19,1970,109.7946620625705
SIM,1876,32,50-100,1908,3
STAT,1929,40,20-24,1969,0.04631389572116267
SIM,1822,38,30-34,1860,18
STAT,1953,15,50-100,1968,0.9157330272180549
STAT,1904,9,na,1913,7521.165996281383
STAT,1931,26,30-34,1957,102.21506110106517
STAT,1886,42,50-100,1928,2.249521806109533
STAT,1886,78,na,1964,2236.843591107524
STAT,1888,46,30-34,1934,0.23172394928002737
STAT,1904,17,na,1921,7321.074792694139
SIM,1950,16,35-39,1966,12
STAT,1905,24,30-34,1929,51.700081742569644
STAT,1905,26,25-29,1931,123.97717398763983
SIM,1880,36,25-29,1916,9
SIM,1846,58,na,1904,3108
SIM,1929,15,30-34,1944,40
SIM,1878,22,45-49,1900,3
STAT,1927,45,15-19,1972,9.381207368586505E-4
SIM,1928,41,50-100,1969,1
STAT,1852,22,50-100,1874,0.772098934865856
STAT,1804,71,na,1875,1246.6998851738354
STAT,1860,24,30-34,1884,29.68416855935788
SIM,1868,50,na,1918,4273
STAT,1894,17,40-44,1911,0.47452311172523703
STAT,1892,48,45-49,1940,0.3323468992066795
STAT,1897,23,15-19,1920,8.878663471754153
STAT,1922,20,20-24,1942,258.9978904499013
SIM,1927,23,na,1950,9263
SIM,1830,63,na,1893,2226
STAT,1797,84,na,1881,219.38142636221679
STAT,1804,82,na,1886,347.9414347645023
STAT,1858,31,15-19,1889,0.226549507606928
SIM,1868,32,30-34,1900,39
STAT,1913,25,50-100,1938,2.0171025334421637
STAT,1872,54,25-29,1926,0.006991664190611198
SIM,1911,29,25-29,1940,136
SIM,1856,18,25-29,1874,14
SIM,1893,24,35-39,1917,18
SIM,1938,27,40-44,1965,12
STAT,1916,24,40-44,1940,7.071119066742975
STAT,1764,110,na,1874,0.0029002117445302627
SIM,1906,28,40-44,1934,11
SIM,1934,27,50-100,1961,5
SIM,1884,15,30-34,1899,4
STAT,1858,20,na,1878,3918.4298092624194
SIM,1941,25,25-29,1966,156
STAT,1859,76,na,1935,1522.9411285644412
SIM,1826,33,35-39,1859,18
STAT,1876,15,30-34,1891,3.344838438867135
STAT,1882,30,45-49,1912,3.4583671624603785
SIM,1898,46,30-34,1944,1
SIM,1901,27,45-49,1928,7
SIM,1858,25,30-34,1883,55
STAT,1911,20,45-49,1931,2.168645952633381
STAT,1902,19,50-100,1921,0.13894366161835126
SIM,1782,74,na,1856,849
STAT,1840,30,50-100,1870,1.6446546647983025
STAT,1933,25,25-29,1958,176.678598534135
SIM,1850,63,na,1913,2827
SIM,1848,50,na,1898,3342
SIM,1900,40,25-29,1940,1
STAT,1848,18,25-29,1866,11.450687804343463
STAT,1863,101,na,1964,4.028850235777705
STAT,1920,26,20-24,1946,40.570479108673545
STAT,1881,29,30-34,1910,48.805779873057794
STAT,1841,104,na,1945,0.09677708217070119
SIM,1923,46,35-39,1969,1
STAT,1845,24,35-39,1869,11.003384428468825
STAT,1875,36,50-100,1911,2.5651961386295157
STAT,1903,40,35-39,1943,0.36524085898544423
STAT,1920,44,20-24,1964,0.039252041891742064
SIM,1897,19,25-29,1916,19
SIM,1924,24,40-44,1948,8
STAT,1880,61,na,1941,3975.6586166692655
STAT,1840,33,na,1873,3770.88760186066
STAT,1831,53,25-29,1884,0.0046752716470577415
SIM,1828,29,50-100,1857,1
SIM,1899,42,na,1941,6462
STAT,1903,47,25-29,1950,0.09299488542362698
STAT,1787,77,na,1864,639.6981075141958
STAT,1942,16,35-39,1958,8.858951306355229
SIM,1796,100,na,1896,1
SIM,1906,16,40-44,1922,1
STAT,1899,32,15-19,1931,0.3940617803693473
STAT,1921,39,50-100,1960,0.9445561201513463
SIM,1903,27,50-100,1930,2
STAT,1859,37,40-44,1896,7.036788427426786
STAT,1904,27,20-24,1931,34.00642377067329
SIM,1867,34,35-39,1901,30
STAT,1907,35,25-29,1942,1.8622062835298818
STAT,1924,32,20-24,1956,5.7456944826681
STAT,1849,45,30-34,1894,0.15464459231424757
SIM,1847,25,20-24,1872,28
SIM,1857,10,na,1867,5026
SIM,1912,27,20-24,1939,34
STAT,1904,43,25-29,1947,0.1283288713122093
STAT,1891,49,40-44,1940,0.23604472827871972
SIM,1933,38,45-49,1971,6
SIM,1878,80,na,1958,1367
SIM,1932,37,45-49,1969,1
SIM,1870,29,na,1899,4598
STAT,1924,39,40-44,1963,3.556506542093029
SIM,1830,32,50-100,1862,3
SIM,1780,96,na,1876,3
SIM,1928,35,30-34,1963,6
SIM,1930,20,20-24,1950,284
STAT,1876,25,na,1901,5018.932934675578
SIM,1933,31,na,1964,10741
STAT,1796,107,na,1903,0.0021010346865597248
STAT,1889,19,25-29,1908,14.03579641067238
SIM,1913,26,25-29,1939,149
SIM,1951,19,50-100,1970,1
STAT,1871,25,na,1896,4821.082120185009
SIM,1833,29,na,1862,3635
STAT,1866,35,na,1901,4432.011037953583
STAT,1922,35,20-24,1957,0.6066774333323317
SIM,1930,35,20-24,1965,3
STAT,1872,36,25-29,1908,5.872150747594697
STAT,1900,16,30-34,1916,4.476390872901289
STAT,1923,22,25-29,1945,216.9904916758802
SIM,1866,35,30-34,1901,15
STAT,1868,23,25-29,1891,109.65905673155683
SIM,1835,26,40-44,1861,3
SIM,1890,42,50-100,1932,8
STAT,1888,50,na,1938,5213.754784012345
SIM,1932,39,40-44,1971,5
SIM,1889,24,15-19,1913,9
STAT,1841,74,na,1915,1610.2253969338365
STAT,1909,60,na,1969,6352.329246114787
STAT,1853,51,na,1904,3423.045038837414
STAT,1859,19,40-44,1878,0.33728089860952937
STAT,1841,16,50-100,1857,0.09222260016706332
STAT,1925,38,45-49,1963,1.6504719196898878
STAT,1828,84,na,1912,408.528915388818
SIM,1900,44,45-49,1944,1
SIM,1862,88,na,1950,221
SIM,1865,21,20-24,1886,125
STAT,1924,18,40-44,1942,3.3542243426708187
SIM,1843,81,na,1924,706
STAT,1851,81,na,1932,838.2837387377053
STAT,1811,53,na,1864,2543.1642505155783
SIM,1923,25,35-39,1948,46
STAT,1856,25,na,1881,3909.4317870761365
SIM,1913,42,30-34,1955,1
STAT,1807,48,na,1855,2794.2777683783142
STAT,1843,20,15-19,1863,5.884920679419239
STAT,1832,52,30-34,1884,0.008072113695981339
SIM,1876,23,25-29,1899,127
SIM,1848,23,15-19,1871,7
SIM,1915,35,25-29,1950,5
STAT,1872,46,50-100,1918,0.49991961450831546
STAT,1810,100,na,1910,0.9601016223501063
STAT,1831,35,25-29,1866,4.809823127410858
SIM,1827,31,30-34,1858,36
SIM,1851,25,na,1876,4100
STAT,1852,52,50-100,1904,0.02394277485413932
SIM,1887,49,na,1936,5353
STAT,1926,31,45-49,1957,3.8443591144463567
SIM,1838,38,50-100,1876,7
STAT,1921,36,15-19,1957,0.043333758142396046
STAT,1897,41,45-49,1938,0.28184267619171294
STAT,1921,42,15-19,1963,0.0034924361623362497
STAT,1911,35,45-49,1946,1.3428416764704696
STAT,1902,30,40-44,1932,12.464875447529993
SIM,1872,95,na,1967,108
STAT,1840,28,30-34,1868,44.995953329415286
SIM,1828,30,na,1858,3581
STAT,1848,48,50-100,1896,0.39765200678742846
STAT,1857,21,20-24,1878,126.14174082110844
STAT,1873,35,30-34,1908,11.040458862771061
STAT,1815,66,na,1881,1784.2364350548633
STAT,1830,54,20-24,1884,0.0010767383950042234
STAT,1930,33,25-29,1963,24.074743743374622
STAT,1906,34,25-29,1940,17.16016162246294
SIM,1859,27,35-39,1886,22
SIM,1932,18,40-44,1950,4
STAT,1923,46,50-100,1969,0.5355295194583776
STAT,1851,47,45-49,1898,0.3641375195534276
SIM,1861,26,50-100,1887,1
STAT,1905,42,30-34,1947,0.23289437622238254
STAT,1825,33,na,1858,3356.2179096749005
SIM,1904,30,20-24,1934,12
SIM,1913,36,30-34,1949,5
STAT,1921,27,20-24,1948,41.07728162502641
SIM,1948,16,na,1964,8721
SIM,1810,53,50-100,1863,1
SIM,1814,44,30-34,1858,4
SIM,1910,30,40-44,1940,11
SIM,1925,23,45-49,1948,2
STAT,1821,46,20-24,1867,0.03563499227490924
STAT,1855,66,na,1921,2471.5197447670835
SIM,1876,27,40-44,1903,8
STAT,1880,49,35-39,1929,0.2916411282430352
SIM,1818,44,50-100,1862,6
SIM,1883,50,na,1933,4511
SIM,1934,31,45-49,1965,6
STAT,1916,42,40-44,1958,0.5176687063915704
SIM,1894,22,30-34,1916,55
STAT,1946,21,15-19,1967,11.966598093668269
SIM,1825,96,na,1921,3
SIM,1852,33,50-100,1885,2
STAT,1917,23,45-49,1940,2.4074948553266178
SIM,1839,15,15-19,1854,16
STAT,1932,27,30-34,1959,103.65679201986453
STAT,1776,93,na,1869,12.925683524468585
SIM,1837,49,30-34,1886,1
STAT,1920,24,na,1944,8145.997797511543
SIM,1904,32,45-49,1936,5
STAT,1886,22,30-34,1908,37.97476463847144
SIM,1860,42,35-39,1902,10
SIM,1859,23,25-29,1882,133
STAT,1884,43,na,1927,4575.941106588361
STAT,1847,99,na,1946,2.8869007389540826
STAT,1910,57,na,1967,6621.042537239018
SIM,1914,34,25-29,1948,25
SIM,1896,20,40-44,1916,7
STAT,1869,86,na,1955,434.19827595392684
STAT,1921,24,15-19,1945,12.063920426015077
SIM,1805,56,na,1861,2199
SIM,1924,26,35-39,1950,41
SIM,1881,43,50-100,1924,5
SIM,1815,63,na,1878,1778
STAT,1865,15,20-24,1880,37.27298662812047
STAT,1877,17,35-39,1894,1.1507298810076623
STAT,1915,46,35-39,1961,0.2630577547526566
SIM,1827,43,50-100,1870,4
SIM,1839,35,50-100,1874,4
STAT,1926,28,15-19,1954,1.7028439940776217
STAT,1931,16,25-29,1947,114.84133539489828
STAT,1867,40,20-24,1907,0.30341384674923305
SIM,1853,21,30-34,1874,46
SIM,1907,26,35-39,1933,46
STAT,1829,49,30-34,1878,0.14879073917428962
STAT,1915,27,30-34,1942,80.72143225991346
STAT,1896,27,50-100,1923,1.7056938933712256
STAT,1905,36,30-34,1941,3.3760696258830154
STAT,1887,47,25-29,1934,0.1294998938890978
STAT,1768,116,na,1884,2.0811816834280254E-4
STAT,1926,46,45-49,1972,0.5428558638910767
SIM,1859,14,na,1873,4922
SIM,1864,22,15-19,1886,7
STAT,1832,34,30-34,1866,29.037572084003315
STAT,1850,48,40-44,1898,0.25919751498152976
STAT,1840,19,50-100,1859,0.09048368142164111
STAT,1901,45,50-100,1946,0.39560554373297463
SIM,1839,31,20-24,1870,4
SIM,1881,35,30-34,1916,16
SIM,1905,32,25-29,1937,22
SIM,1855,32,na,1887,4201
SIM,1913,24,30-34,1937,79
SIM,1801,83,na,1884,236
STAT,1822,44,15-19,1866,0.04403654324116277
SIM,1914,33,50-100,1947,3
SIM,1868,17,35-39,1885,2
STAT,1897,19,na,1916,6781.667413749687
SIM,1851,20,15-19,1871,7
SIM,1840,34,30-34,1874,46
STAT,1794,104,na,1898,0.02612637322278598
STAT,1931,16,na,1947,9754.272618386834
STAT,1791,99,na,1890,0.7473841019463633
STAT,1917,41,45-49,1958,0.3512514666425722
STAT,1916,26,35-39,1942,31.458945529213015
STAT,1856,22,15-19,1878,5.970394128923106
STAT,1931,32,30-34,1963,41.69537917438252
STAT,1850,15,50-100,1865,0.09288366004007231
SIM,1842,88,na,1930,154
SIM,1909,24,45-49,1933,3
STAT,1804,74,na,1878,938.1457224710016
STAT,1857,23,15-19,1880,5.95233501281736
SIM,1934,28,15-19,1962,2
STAT,1853,19,45-49,1872,0.12286710499019098
STAT,1845,21,30-34,1866,34.32082620839564
SIM,1849,20,25-29,1869,127
STAT,1827,48,na,1875,3016.148397920526
STAT,1888,20,40-44,1908,5.003866244992412
SIM,1879,17,15-19,1896,11
STAT,1866,58,na,1924,3685.2128031114003
STAT,1882,65,na,1947,3324.8266344605586
STAT,1915,25,35-39,1940,31.139805878402125
STAT,1814,81,na,1895,465.3979224464875
STAT,1930,17,20-24,1947,353.9907094932189
STAT,1776,82,na,1858,306.153891503935
STAT,1917,44,45-49,1961,0.3495786512794822
SIM,1944,18,30-34,1962,33
STAT,1878,30,25-29,1908,21.77839419132607
STAT,1952,18,50-100,1970,0.9063949354290898
SIM,1880,39,na,1919,5164
SIM,1922,26,30-34,1948,112
STAT,1787,85,na,1872,167.12104827101058
SIM,1866,1,na,1867,6618
SIM,1884,30,20-24,1914,10
SIM,1911,39,na,1950,7448
STAT,1900,32,30-34,1932,48.915572350097435
STAT,1933,4,na,1937,10913.20078303403
STAT,1783,92,na,1875,19.401681006058993
STAT,1863,49,35-39,1912,0.24233835567615147
STAT,1912,34,15-19,1946,0.2532576348945528
SIM,1873,29,na,1902,5028
SIM,1923,27,30-34,1950,116
SIM,1871,49,35-39,1920,1
STAT,1906,19,30-34,1925,4.665513750774862
STAT,1909,47,20-24,1956,0.02051990181256688
SIM,1888,24,50-100,1912,1
SIM,1914,19,30-34,1933,10
STAT,1936,18,30-34,1954,23.510928250104147
STAT,1898,22,20-24,1920,188.3438916514667
STAT,1951,16,na,1967,8853.920730176624
SIM,1865,23,15-19,1888,10
SIM,1839,19,35-39,1858,1
SIM,1852,95,na,1947,15
SIM,1908,23,45-49,1931,2
SIM,1886,30,25-29,1916,26
STAT,1864,100,na,1964,7.284492899786976
SIM,1856,88,na,1944,166
STAT,1828,100,na,1928,1.3037591966285842
SIM,1855,45,30-34,1900,2
STAT,1904,26,50-100,1930,1.8606652068790137
STAT,1922,36,50-100,1958,0.9654720514960572
SIM,1911,26,20-24,1937,40
SIM,1930,36,50-100,1966,1
SIM,1950,15,50-100,1965,1
SIM,1892,21,15-19,1913,7
STAT,1893,33,25-29,1926,26.109170361762974
STAT,1937,15,15-19,1952,89.59936844749058
STAT,1933,22,20-24,1955,297.91352512865245
STAT,1942,15,50-100,1957,0.7911754425215634
STAT,1875,48,45-49,1923,0.4845609702916505
STAT,1920,29,25-29,1949,144.74727202063056
SIM,1877,20,35-39,1897,20
SIM,1856,5,na,1861,5090
SIM,1872,29,30-34,1901,63
STAT,1934,28,45-49,1962,4.69215067307375
SIM,1828,31,45-49,1859,2
SIM,1925,41,45-49,1966,2
STAT,1862,65,na,1927,2917.215388791936
STAT,1855,39,30-34,1894,7.955768220253727
SIM,1835,29,45-49,1864,2
SIM,1929,18,35-39,1947,15
STAT,1826,42,25-29,1868,1.356393491177838
SIM,1900,47,na,1947,6482
STAT,1927,30,45-49,1957,3.9131689991976852
STAT,1898,40,20-24,1938,0.030445455714768963
SIM,1873,18,25-29,1891,16
STAT,1916,42,na,1958,7686.505193075234
SIM,1895,22,45-49,1917,2
STAT,1887,22,45-49,1909,1.5751048596437738
STAT,1901,31,40-44,1932,12.311606014588925
STAT,1860,41,50-100,1901,1.7405085205377506
SIM,1836,48,na,1884,2932
SIM,1942,28,45-49,1970,6
STAT,1896,5,na,1901,6987.744726015314
SIM,1837,28,50-100,1865,2
SIM,1947,23,na,1970,8615
STAT,1830,36,20-24,1866,1.4650660652739345
STAT,1848,84,na,1932,545.4702458788375
STAT,1893,68,na,1961,4228.053643393052
STAT,1862,76,na,1938,1635.409363579094
SIM,1847,88,na,1935,170
SIM,1883,48,45-49,1931,1
SIM,1919,45,30-34,1964,1
SIM,1867,33,50-100,1900,2
STAT,1893,57,na,1950,5144.410284016109
STAT,1884,21,15-19,1905,6.599009221637815
STAT,1856,28,na,1884,3825.82580109485
STAT,1939,29,40-44,1968,9.455147639460925
STAT,1876,18,35-39,1894,1.1431734517484815
STAT,1880,20,50-100,1900,0.8727804884068939
SIM,1802,68,na,1870,1569
SIM,1857,45,30-34,1902,1
SIM,1840,30,na,1870,4205
STAT,1889,16,20-24,1905,44.25660001405905
STAT,1941,15,35-39,1956,8.73399683789123
SIM,1842,96,na,1938,9
SIM,1903,31,45-49,1934,8
STAT,1829,28,50-100,1857,1.5676131793109973
STAT,1855,54,25-29,1909,0.005194245643300744
SIM,1828,40,50-100,1868,3
STAT,1869,41,50-100,1910,2.076767017222977
STAT,1769,89,na,1858,46.32995912647539
STAT,1856,40,45-49,1896,2.355650795826439
SIM,1834,42,25-29,1876,3
SIM,1872,48,35-39,1920,1
SIM,1900,24,25-29,1924,195
STAT,1931,29,35-39,1960,39.10929192680471
STAT,1929,24,20-24,1953,282.1826384772161
STAT,1859,34,35-39,1893,16.139773509929025
STAT,1864,48,35-39,1912,0.24956760052412716
SIM,1940,27,30-34,1967,91
SIM,1851,23,50-100,1874,1
STAT,1880,35,50-100,1915,2.636919920201334
SIM,1897,16,20-24,1913,43
STAT,1914,16,25-29,1930,18.151848681917922
STAT,1869,20,35-39,1889,11.53699429022317
SIM,1910,54,na,1964,6952
STAT,1835,74,na,1909,1437.3336320632995
STAT,1873,53,30-34,1926,0.012018841253343621
STAT,1827,29,45-49,1856,3.57213996956003
SIM,1866,20,25-29,1886,119
SIM,1922,16,25-29,1938,110
STAT,1899,38,50-100,1937,0.7296477059972958
STAT,1814,53,25-29,1867,0.0172409756720764
STAT,1803,89,na,1892,74.13918835071247
SIM,1848,73,na,1921,1674
STAT,1876,28,na,1904,4967.564700704268
STAT,1845,73,na,1918,1830.250450109919
STAT,1908,38,45-49,1946,1.2835237748700488
SIM,1923,43,30-34,1966,3
STAT,1849,41,15-19,1890,0.021943204887577186
SIM,1816,44,30-34,1860,7
SIM,1854,21,45-49,1875,2
STAT,1811,52,50-100,1863,0.09779690300603942
STAT,1773,100,na,1873,0.39304787263403007
STAT,1903,44,20-24,1947,0.03128451243014862
SIM,1858,80,na,1938,1076
SIM,1883,35,30-34,1918,16
SIM,1929,28,50-100,1957,4
STAT,1851,25,50-100,1876,1.1779269896560731
STAT,1913,30,20-24,1943,4.941820135615373
SIM,1815,86,na,1901,206
STAT,1862,22,40-44,1884,3.6822839576439135
SIM,1860,22,na,1882,4255
SIM,1941,24,40-44,1965,10
STAT,1918,24,45-49,1942,2.435102362516253
STAT,1858,20,25-29,1878,104.9109006995481
STAT,1879,53,na,1932,4475.486143856577
STAT,1767,109,na,1876,0.005198285638788353
SIM,1939,19,35-39,1958,13
STAT,1831,46,50-100,1877,0.3806910007942023
STAT,1835,66,na,1901,2122.7506394661764
STAT,1875,35,30-34,1910,11.187313680797638
STAT,1922,22,45-49,1944,2.6052404481335016
SIM,1870,37,50-100,1907,3
SIM,1930,22,45-49,1952,5
STAT,1935,37,20-24,1972,0.7445901913220414
SIM,1853,29,na,1882,4047
SIM,1918,28,30-34,1946,101
SIM,1870,22,40-44,1892,4
SIM,1900,44,na,1944,6662
STAT,1852,32,25-29,1884,16.902347557804166
SIM,1927,17,20-24,1944,337
STAT,1919,17,20-24,1936,302.5199032717999
STAT,1772,101,na,1873,0.21398351619093142
STAT,1810,49,15-19,1859,0.0025106344074472303
STAT,1911,17,15-19,1928,18.346780139773397
SIM,1931,34,25-29,1965,31
STAT,1915,43,30-34,1958,0.25955896714368665
STAT,1846,46,25-29,1892,0.08847693637076905
SIM,1860,32,25-29,1892,22
SIM,1900,26,45-49,1926,4
STAT,1848,15,20-24,1863,36.46436089120702
STAT,1872,26,15-19,1898,0.9240587050829121
STAT,1814,41,na,1855,2808.491089550352
STAT,1923,38,40-44,1961,3.498449082104647
SIM,1873,40,na,1913,4918
SIM,1888,23,15-19,1911,10
SIM,1831,28,30-34,1859,56
SIM,1846,47,na,1893,3449
STAT,1903,26,20-24,1929,33.85028813697782
STAT,1911,32,40-44,1943,7.698325194032752
STAT,1846,21,45-49,1867,1.3274110343064434
SIM,1941,22,20-24,1963,231
STAT,1834,47,45-49,1881,0.3331620938652062
STAT,1881,44,25-29,1925,1.236622248314969
SIM,1902,39,25-29,1941,3
STAT,1923,34,25-29,1957,21.364969823864627
STAT,1897,37,50-100,1934,3.3144658376576053
STAT,1839,28,25-29,1867,82.61153086108645
SIM,1856,15,20-24,1871,32
SIM,1917,24,na,1941,7953
STAT,1871,37,20-24,1908,1.5467198690953028
STAT,1847,22,45-49,1869,1.3030809636945166
SIM,1868,35,35-39,1903,13
SIM,1855,22,45-49,1877,5
SIM,1932,35,25-29,1967,4
STAT,1913,48,25-29,1961,0.10430057620328932
STAT,1924,35,25-29,1959,2.348257851027435
STAT,1868,27,40-44,1895,5.756055090187797
SIM,1931,38,40-44,1969,7
SIM,1918,24,15-19,1942,10
STAT,1874,21,20-24,1895,142.93540239037878
STAT,1770,97,na,1867,1.5390762021511715
STAT,1822,48,na,1870,2905.0415077427665
STAT,1858,91,na,1949,91.2341045608267
SIM,1915,18,40-44,1933,2
STAT,1861,21,50-100,1882,0.7093329180168355
SIM,1886,24,na,1910,4918
STAT,1891,20,45-49,1911,1.7511675800825761
STAT,1869,46,na,1915,4415.302733102684
STAT,1866,8,na,1874,5161.476026646081
STAT,1890,19,30-34,1909,3.9080655644142044
SIM,1847,28,25-29,1875,81
SIM,1858,22,50-100,1880,1
STAT,1906,32,na,1938,7082.517875516939
STAT,1933,24,40-44,1957,9.002326468272079
STAT,1798,69,na,1867,1336.7979692120136
STAT,1907,37,45-49,1944,1.2772168482267563
STAT,1863,46,30-34,1909,0.171618662745784
STAT,1836,32,40-44,1868,7.2899995436719225
SIM,1905,48,40-44,1953,1
STAT,1906,31,20-24,1937,4.586399819065952
STAT,1921,21,45-49,1942,2.5737869139514324
STAT,1765,117,na,1882,1.357507579766142E-4
STAT,1812,106,na,1918,0.011509184943168486
STAT,1842,99,na,1941,2.8196165041837364
SIM,1925,21,25-29,1946,231
STAT,1930,19,40-44,1949,3.6324928710325053
STAT,1901,40,na,1941,6623.461132206669
STAT,1880,49,30-34,1929,0.20164900857951615
STAT,1940,22,25-29,1962,190.05205743003202
SIM,1922,47,50-100,1969,1
STAT,1852,66,na,1918,2612.271140648644
SIM,1859,20,20-24,1879,151
SIM,1936,23,20-24,1959,170
SIM,1839,22,na,1861,3758
STAT,1833,27,50-100,1860,1.1121643923002664
STAT,1886,25,35-39,1911,20.710521437721667
SIM,1852,23,35-39,1875,12
SIM,1927,31,na,1958,9620
SIM,1904,18,30-34,1922,6
STAT,1844,23,35-39,1867,11.681745224521242
STAT,1887,16,50-100,1903,0.11093428568811775
STAT,1905,20,15-19,1925,9.693217813136249
SIM,1908,20,40-44,1928,11
STAT,1915,57,na,1972,7148.821721905004
SIM,1829,55,na,1884,2686
STAT,1822,47,50-100,1869,0.7635455691345449
STAT,1823,47,35-39,1870,0.43258095809205227
SIM,1913,39,35-39,1952,5
SIM,1787,74,na,1861,736
STAT,1868,50,na,1918,4196.824269316111
STAT,1937,35,30-34,1972,3.6878463166041504
SIM,1841,27,50-100,1868,1
SIM,1919,25,15-19,1944,2
SIM,1899,29,35-39,1928,36
STAT,1870,40,na,1910,4629.031178000141
STAT,1917,21,25-29,1938,198.85096911738916
SIM,1869,32,45-49,1901,5
SIM,1819,48,na,1867,2775
STAT,1788,70,na,1858,1344.7125898685474
SIM,1844,32,40-44,1876,10
SIM,1916,38,45-49,1954,5
STAT,1900,35,35-39,1935,20.003862026546173
STAT,1890,38,35-39,1928,17.349372492112366
SIM,1827,34,35-39,1861,36
SIM,1835,55,na,1890,2800
SIM,1915,32,20-24,1947,5
STAT,1855,29,20-24,1884,18.175308889466123
STAT,1955,0,na,1955,10618.16405576268
SIM,1878,21,35-39,1899,15
STAT,1821,49,25-29,1870,0.16378845551132698
STAT,1920,47,25-29,1967,0.11839693406188372
SIM,1913,20,15-19,1933,7
SIM,1795,92,na,1887,17
STAT,1893,43,35-39,1936,0.3195707171971683
STAT,1864,91,na,1955,104.61374366151212
STAT,1915,19,45-49,1934,0.21003846025959585
SIM,1848,25,35-39,1873,2
STAT,1875,94,na,1969,176.50417119955827
SIM,1845,22,na,1867,4289
SIM,1847,49,50-100,1896,1
STAT,1937,33,45-49,1970,3.1428636061455864
SIM,1771,90,na,1861,32
SIM,1829,32,45-49,1861,4
STAT,1857,98,na,1955,5.113843573544621
STAT,1907,32,20-24,1939,4.60718462826411
STAT,1839,25,na,1864,4317.029172004059
STAT,1866,15,35-39,1881,1.061995244013189
STAT,1868,61,na,1929,3590.632566173385
STAT,1790,74,na,1864,823.0613327689996
SIM,1866,47,na,1913,4386
SIM,1896,38,50-100,1934,5
STAT,1831,31,50-100,1862,1.5624169573752975
STAT,1926,43,40-44,1969,0.6216639479369838
SIM,1822,45,na,1867,2950
SIM,1873,30,45-49,1903,6
STAT,1888,23,45-49,1911,1.659408543293743
SIM,1853,24,35-39,1877,11
STAT,1842,53,30-34,1895,0.008719948622748913
SIM,1858,28,35-39,1886,26
SIM,1909,49,50-100,1958,1
STAT,1796,104,na,1900,0.029715961349104616
SIM,1896,23,45-49,1919,4
STAT,1865,18,25-29,1883,10.651200288142928
STAT,1874,13,na,1887,5381.587940435803
SIM,1937,24,20-24,1961,237
STAT,1821,74,na,1895,1230.1408435669937
SIM,1831,47,35-39,1878,2
STAT,1885,24,35-39,1909,11.65760492446829
STAT,1786,92,na,1878,20.37632110393197
STAT,1828,33,na,1861,3499.9230943025213
STAT,1857,10,na,1867,4472.264775063463
STAT,1928,23,20-24,1951,279.47978415503945
SIM,1874,15,35-39,1889,1
STAT,1899,45,na,1944,6288.857217939305
STAT,1850,88,na,1938,210.49277829333147
SIM,1885,43,50-100,1928,4
SIM,1943,16,na,1959,8046
SIM,1769,89,na,1858,62
SIM,1906,6,na,1912,7682
SIM,1914,31,20-24,1945,5
STAT,1929,43,25-29,1972,0.1864557846834821
SIM,1945,15,15-19,1960,91
STAT,1928,41,20-24,1969,0.045527920406315855
SIM,1895,40,45-49,1935,1
STAT,1891,15,50-100,1906,0.12287068382338097
STAT,1894,53,na,1947,5496.630060692521
STAT,1905,39,35-39,1944,4.414068124467894
STAT,1867,43,25-29,1910,1.2058176711989808
SIM,1850,26,50-100,1876,1
SIM,1909,21,40-44,1930,9
SIM,1901,18,na,1919,7181
SIM,1875,43,25-29,1918,2
STAT,1900,47,na,1947,6274.989663852477
SIM,1830,47,50-100,1877,2
SIM,1935,30,45-49,1965,5
STAT,1834,34,30-34,1868,29.158479906245063
SIM,1842,34,30-34,1876,40
SIM,1893,57,na,1950,5249
SIM,1838,16,15-19,1854,10
STAT,1917,41,40-44,1958,0.527890036118909
SIM,1912,26,50-100,1938,6
STAT,1876,1,na,1877,7215.666701157603
SIM,1889,75,na,1964,3108
STAT,1842,26,50-100,1868,1.1862817907875804
STAT,1853,16,40-44,1869,0.35017927155132267
SIM,1798,66,na,1864,1493
SIM,1885,33,40-44,1918,16
STAT,1846,36,15-19,1882,0.09075870175364813
STAT,1887,40,45-49,1927,3.414711342661807
STAT,1910,54,na,1964,6744.383260717036
STAT,1877,33,40-44,1910,9.05640060960586
SIM,1877,39,na,1916,4780
SIM,1903,17,30-34,1920,8
SIM,1832,24,30-34,1856,47
SIM,1886,44,na,1930,4730
STAT,1870,41,45-49,1911,2.9810065211965084
SIM,1833,51,na,1884,2954
SIM,1922,25,20-24,1947,50
STAT,1895,60,na,1955,5018.992290843739
STAT,1847,19,15-19,1866,11.158041256159338
SIM,1921,5,na,1926,9300
SIM,1882,54,na,1936,4273
SIM,1926,18,15-19,1944,106
SIM,1852,29,45-49,1881,5
STAT,1927,41,35-39,1968,0.5106990430019422
SIM,1862,30,35-39,1892,23
STAT,1829,39,20-24,1868,1.298969151765658
STAT,1949,18,45-49,1967,1.1729086559374153
STAT,1858,48,45-49,1906,0.36689402591728026
SIM,1868,36,45-49,1904,7
STAT,1859,22,na,1881,3944.4860687562896
SIM,1873,19,35-39,1892,2
STAT,1912,37,20-24,1949,0.5197611698068629
STAT,1924,15,35-39,1939,10.135981360282848
SIM,1878,49,na,1927,4809
STAT,1920,22,40-44,1942,7.547598222883615
SIM,1887,30,40-44,1917,13
STAT,1897,16,50-100,1913,0.1325853638783814
SIM,1874,25,50-100,1899,4
SIM,1899,22,15-19,1921,12
STAT,1879,30,40-44,1909,9.23485349524398
SIM,1863,42,50-100,1905,4
STAT,1879,53,50-100,1932,0.031391956318425014
SIM,1920,37,20-24,1957,5
SIM,1837,46,25-29,1883,1
SIM,1844,15,na,1859,4154
STAT,1868,42,30-34,1910,2.2063980644299517
SIM,1811,50,45-49,1861,1
STAT,1844,29,45-49,1873,2.1635817707457425
SIM,1837,39,20-24,1876,1
SIM,1885,35,35-39,1920,19
SIM,1914,26,40-44,1940,13
STAT,1828,40,35-39,1868,3.5216493548999654
SIM,1941,6,na,1947,8431
STAT,1865,19,35-39,1884,1.0252807165735283
SIM,1869,17,20-24,1886,30
STAT,1828,30,na,1858,3604.002027966337
SIM,1821,36,20-24,1857,2
SIM,1919,40,40-44,1959,1
STAT,1856,28,25-29,1884,67.8132375531065
STAT,1850,47,30-34,1897,0.14772856937767473
STAT,1879,22,na,1901,4996.111052631587
SIM,1872,32,50-100,1904,3
STAT,1930,26,15-19,1956,1.813708623139318
SIM,1883,38,35-39,1921,17
SIM,1855,19,15-19,1874,11
STAT,1860,19,na,1879,4290.9264308127285
STAT,1922,27,35-39,1949,34.30152754921671
STAT,1877,18,15-19,1895,12.41308412964943
STAT,1891,70,na,1961,3840.8743054616507
SIM,1965,0,na,1965,10600
STAT,1877,35,35-39,1912,14.973906416421874
STAT,1930,37,40-44,1967,3.94350804365792
STAT,1898,25,25-29,1923,116.39785431544882
STAT,1903,25,45-49,1928,3.2144065393013226
STAT,1892,44,30-34,1936,0.19912275406604996
STAT,1936,32,45-49,1968,3.0874743226258192
SIM,1830,27,30-34,1857,51
SIM,1859,42,na,1901,4108
SIM,1901,40,na,1941,6653
STAT,1848,15,50-100,1863,0.10076737350656872
STAT,1865,28,35-39,1893,17.641644392294502
SIM,1863,29,20-24,1892,21
SIM,1880,53,na,1933,4647
STAT,1875,47,35-39,1922,0.2897520547699762
STAT,1829,46,25-29,1875,0.09208152347456401
SIM,1905,26,30-34,1931,94
STAT,1894,32,30-34,1926,45.29743518987226
STAT,1880,27,20-24,1907,24.959519191591678
STAT,1896,37,25-29,1933,7.67717285798995
STAT,1901,37,45-49,1938,1.2165506961608095
STAT,1911,10,na,1921,8008.0436562083305
SIM,1903,30,35-39,1933,44
STAT,1818,103,na,1921,0.1472382208630427
STAT,1891,15,30-34,1906,3.997393726431761
STAT,1798,60,na,1858,1869.846687536313
STAT,1873,25,20-24,1898,24.236919626191373
SIM,1853,51,na,1904,3569
STAT,1868,84,na,1952,639.2211031629066
STAT,1923,2,na,1925,9696.027529342724
SIM,1799,62,na,1861,1710
SIM,1816,47,35-39,1863,1
SIM,1914,13,na,1927,8453
SIM,1894,26,45-49,1920,4
STAT,1927,11,na,1938,9963.203366307946
SIM,1888,36,30-34,1924,19
SIM,1825,47,45-49,1872,2
STAT,1870,23,na,1893,4674.992323163417
SIM,1826,30,50-100,1856,1
SIM,1859,45,35-39,1904,1
SIM,1912,47,40-44,1959,1
SIM,1818,60,na,1878,2229
STAT,1890,49,25-29,1939,0.07842352552013093
SIM,1864,28,25-29,1892,95
SIM,1843,36,40-44,1879,15
STAT,1884,38,45-49,1922,3.955832935895122
SIM,1836,40,35-39,1876,5
STAT,1921,28,30-34,1949,87.86320292003762
STAT,1919,47,15-19,1966,8.067665506237106E-4
SIM,1835,41,30-34,1876,3
SIM,1841,48,40-44,1889,1
SIM,1865,62,na,1927,3359
SIM,1910,23,na,1933,8012
SIM,1876,42,30-34,1918,3
STAT,1814,50,20-24,1864,0.003813774321330013
STAT,1866,54,30-34,1920,0.010787420066402702
STAT,1895,31,35-39,1926,26.759607891899943
STAT,1882,16,30-34,1898,3.143474961205129
STAT,1761,111,na,1872,1.8861746775094017E-4
STAT,1840,64,na,1904,2509.2166740873404
STAT,1929,37,30-34,1966,4.725196993742017
STAT,1931,32,50-100,1963,2.1880769818748216
STAT,1881,41,20-24,1922,0.3114186945694676
SIM,1892,38,45-49,1930,12
STAT,1946,6,na,1952,8862.017159896144
SIM,1907,23,30-34,1930,68
SIM,1890,15,20-24,1905,52
SIM,1911,25,45-49,1936,5
STAT,1833,48,40-44,1881,0.23725523535070495
SIM,1919,8,na,1927,9054
STAT,1875,22,20-24,1897,143.29330273457055
STAT,1923,21,na,1944,8604.554640466451
SIM,1869,52,na,1921,4108
STAT,1847,35,20-24,1882,1.2447368200260842
SIM,1859,76,na,1935,1467
STAT,1812,69,na,1881,1640.9893883118527
STAT,1817,47,45-49,1864,1.1397939489879902
SIM,1940,21,20-24,1961,242
SIM,1855,52,na,1907,3796
SIM,1863,36,25-29,1899,8
STAT,1849,18,40-44,1867,0.3540271105331567
SIM,1818,44,35-39,1862,8
STAT,1914,25,20-24,1939,37.42315477515603
SIM,1910,33,45-49,1943,4
SIM,1921,25,50-100,1946,2
STAT,1906,63,na,1969,5859.790206583937
STAT,1887,46,15-19,1933,9.060815596319081E-4
STAT,1904,47,40-44,1951,0.278629290734906
STAT,1906,26,40-44,1932,8.84603084873975
SIM,1901,60,na,1961,5692
STAT,1835,36,40-44,1871,7.085588228767295
SIM,1886,39,30-34,1925,11
STAT,1875,32,na,1907,4961.979643194945
SIM,1923,24,25-29,1947,254
STAT,1913,36,25-29,1949,1.9723424617960557
SIM,1857,48,35-39,1905,1
STAT,1913,11,na,1924,8169.222363543567
STAT,1845,47,20-24,1892,0.0184050218031011
SIM,1826,39,45-49,1865,5
STAT,1818,39,45-49,1857,11.24830072747175
STAT,1957,15,50-100,1972,0.9979883325982866
STAT,1868,47,50-100,1915,0.4697267334494237
SIM,1865,24,25-29,1889,105
SIM,1834,38,50-100,1872,3
STAT,1889,34,15-19,1923,0.35159208234595335
SIM,1819,48,30-34,1867,1
STAT,1909,20,50-100,1929,1.243135410542535
SIM,1888,27,30-34,1915,66
STAT,1919,16,na,1935,8667.74783556568
SIM,1873,26,na,1899,5051
STAT,1902,33,45-49,1935,4.9512578659024875
SIM,1903,41,na,1944,6885
SIM,1921,36,25-29,1957,3
SIM,1889,37,50-100,1926,7
SIM,1907,27,50-100,1934,4
STAT,1915,24,25-29,1939,191.64416459490954
STAT,1932,21,20-24,1953,295.56862179705723
SIM,1838,38,25-29,1876,6
SIM,1877,40,25-29,1917,3
STAT,1937,30,40-44,1967,7.829690651551932
STAT,1891,48,30-34,1939,0.13459785682666575
STAT,1895,38,20-24,1933,2.0185276770405425
SIM,1788,90,na,1878,33
STAT,1935,36,45-49,1971,1.927333156052761
SIM,1906,25,35-39,1931,31
STAT,1808,95,na,1903,10.44764631547401
STAT,1876,37,40-44,1913,9.14398935351848
SIM,1857,32,20-24,1889,2
STAT,1873,37,na,1910,4834.597372308753
STAT,1874,48,30-34,1922,0.19765895874464007
SIM,1872,22,45-49,1894,5
STAT,1911,2,na,1913,8240.939993928007
STAT,1943,19,20-24,1962,290.1527239626509
SIM,1835,32,na,1867,3642
SIM,1840,33,na,1873,4026
SIM,1894,40,25-29,1934,3
STAT,1819,35,45-49,1854,13.265744532117813
STAT,1881,26,25-29,1907,82.85919004607554
STAT,1822,45,na,1867,3018.8564156474654
STAT,1813,96,na,1909,7.6301111091756
STAT,1874,24,25-29,1898,117.63797475266482
STAT,1904,21,45-49,1925,2.0274563802478536
STAT,1899,42,na,1941,6409.707027200069
STAT,1834,46,35-39,1880,0.21998548836157564
STAT,1859,21,25-29,1880,105.67704187208547
SIM,1817,46,40-44,1863,1
SIM,1847,38,35-39,1885,22
STAT,1849,46,na,1895,3568.898279963447
STAT,1862,14,na,1876,4676.8578499645755
SIM,1829,38,na,1867,3369
STAT,1815,97,na,1912,4.993497632296231
SIM,1822,35,25-29,1857,6
SIM,1874,49,50-100,1923,1
SIM,1897,16,na,1913,7004
STAT,1897,29,25-29,1926,113.38248984957407
STAT,1845,49,15-19,1894,6.035043394854873E-4
SIM,1842,37,35-39,1879,23
SIM,1808,84,na,1892,250
SIM,1921,33,20-24,1954,6
STAT,1878,39,30-34,1917,11.128539517503778
STAT,1931,30,na,1961,10020.376650303637
STAT,1822,32,50-100,1854,5.877938673505569
STAT,1874,23,15-19,1897,6.801020360573678
STAT,1949,23,25-29,1972,217.59537372442023
SIM,1768,90,na,1858,27
SIM,1884,37,40-44,1921,14
STAT,1869,40,25-29,1909,1.2693426651161
SIM,1867,21,25-29,1888,125
STAT,1877,41,na,1918,4868.967112697063
STAT,1919,36,na,1955,8168.5527398148615
STAT,1859,33,50-100,1892,1.4666393698196032
SIM,1912,58,na,1970,6918
STAT,1831,34,15-19,1865,0.23511525117057974
STAT,1864,22,45-49,1886,1.2791251064377802
STAT,1834,37,35-39,1871,11.711049062254657
STAT,1870,19,45-49,1889,0.1292212998251181
STAT,1886,26,45-49,1912,2.3752257615707766
STAT,1828,47,20-24,1875,0.021614470972880353
SIM,1926,36,45-49,1962,3
STAT,1917,28,50-100,1945,2.1005631776177496
SIM,1863,81,na,1944,902
STAT,1831,81,na,1912,698.2070642594977
STAT,1808,47,35-39,1855,0.8895951889205426
STAT,1776,99,na,1875,0.6803436577013899
STAT,1859,22,35-39,1881,9.732556775611204
STAT,1766,110,na,1876,0.0023065861151228533
STAT,1932,16,40-44,1948,3.750022905638204
SIM,1888,29,25-29,1917,98
SIM,1902,32,40-44,1934,2
STAT,1809,46,40-44,1855,1.3512813400870205
STAT,1827,41,30-34,1868,2.223987226174888
STAT,1849,32,20-24,1881,4.505514082459052
STAT,1929,39,25-29,1968,2.547258267126887
STAT,1840,18,20-24,1858,32.937033896839644
STAT,1881,25,15-19,1906,0.8916728697764833
SIM,1880,59,na,1939,4269
STAT,1913,45,na,1958,7277.82796558923
STAT,1835,97,na,1932,6.957815836569082
STAT,1851,46,35-39,1897,0.21764174332716182
SIM,1851,37,45-49,1888,5
STAT,1889,12,na,1901,6431.049065527066
SIM,1848,20,45-49,1868,5
STAT,1923,16,30-34,1939,28.96763505475717
STAT,1918,36,45-49,1954,1.4579244025653941
STAT,1843,37,45-49,1880,3.260009886399569
SIM,1951,19,20-24,1970,354
STAT,1850,17,35-39,1867,1.0280785744435392
STAT,1852,50,25-29,1902,0.005726421667388877
STAT,1893,51,na,1944,5538.370582857774
SIM,1827,35,45-49,1862,4
SIM,1940,16,40-44,1956,4
SIM,1906,24,25-29,1930,175
STAT,1866,89,na,1955,195.76510752468508
STAT,1938,20,45-49,1958,2.250938634883834
SIM,1831,25,25-29,1856,80
SIM,1888,79,na,1967,2292
STAT,1873,43,50-100,1916,2.152238147671254
STAT,1869,48,20-24,1917,0.023188207145080627
SIM,1841,47,30-34,1888,1
STAT,1875,38,35-39,1913,14.634143228350467
STAT,1832,69,na,1901,1913.2625361523
STAT,1872,35,15-19,1907,0.11506166298360934
SIM,1867,22,35-39,1889,15
STAT,1909,46,45-49,1955,0.4045613658526546
SIM,1883,81,na,1964,1644
SIM,1852,48,50-100,1900,1
SIM,1931,16,30-34,1947,38
SIM,1949,21,40-44,1970,11
STAT,1928,40,40-44,1968,0.6456726507651329
STAT,1837,38,30-34,1875,8.952605362951038
STAT,1948,19,na,1967,8500.955251715928
STAT,1818,54,na,1872,2560.4591295663045
STAT,1919,44,50-100,1963,0.25621002649365865
SIM,1866,23,30-34,1889,39
SIM,1845,38,30-34,1883,16
SIM,1915,15,35-39,1930,3
STAT,1906,33,50-100,1939,1.5417733033910173
SIM,1932,15,35-39,1947,12
STAT,1848,33,15-19,1881,0.24524281078109908
STAT,1841,17,25-29,1858,10.604253787261744
STAT,1931,20,50-100,1951,1.7339021956462253
SIM,1866,24,na,1890,4537
STAT,1954,13,na,1967,9804.675176485445
SIM,1921,26,15-19,1947,1
SIM,1926,38,na,1964,9518
STAT,1844,41,30-34,1885,1.9260018960286327
SIM,1858,53,35-39,1911,1
STAT,1858,23,30-34,1881,29.070395999659752
STAT,1862,0,na,1862,6652.607134877229
STAT,1890,16,25-29,1906,14.003678269239602
STAT,1881,19,20-24,1900,34.421941093123735
STAT,1886,48,20-24,1934,0.025261856586814915
SIM,1868,59,na,1927,3778
SIM,1946,20,45-49,1966,1
SIM,1867,37,40-44,1904,13
STAT,1864,53,50-100,1917,0.026827366010302924
SIM,1929,37,40-44,1966,8
SIM,1907,39,50-100,1946,1
SIM,1904,29,na,1933,6931
STAT,1852,69,na,1921,2338.9856655768904
STAT,1860,37,45-49,1897,3.2694833260439693
SIM,1823,61,na,1884,2128
SIM,1894,48,20-24,1942,1
SIM,1941,15,na,1956,8308
STAT,1892,47,35-39,1939,0.19873287954579796
SIM,1907,8,na,1915,7842
STAT,1839,38,35-39,1877,13.061220105246543
STAT,1940,18,25-29,1958,88.84097977190525
STAT,1922,42,30-34,1964,0.2962809294921768
STAT,1853,31,30-34,1884,28.74474572073881
STAT,1879,15,15-19,1894,12.59484957447908
STAT,1838,54,na,1892,2833.892522597117
STAT,1928,34,50-100,1962,2.0849103949013994
STAT,1824,54,50-100,1878,0.03385392419257629
SIM,1894,73,na,1967,3758
STAT,1855,51,20-24,1906,0.0011180580202928851
SIM,1793,91,na,1884,18
STAT,1857,110,na,1967,0.0038169639195079117
STAT,1899,49,45-49,1948,0.3606802915722504
STAT,1840,98,na,1938,4.689075423465134
STAT,1861,29,45-49,1890,1.8530891521252117
STAT,1904,36,15-19,1940,0.03530318659161829
STAT,1903,7,na,1910,7491.864255453561
STAT,1907,15,35-39,1922,1.6363350693629148
STAT,1865,33,15-19,1898,0.2601885515014953
STAT,1839,29,35-39,1868,18.708342747203254
SIM,1847,29,35-39,1876,18
STAT,1880,42,15-19,1922,0.02934524745711815
STAT,1886,40,25-29,1926,1.3828560425160388
STAT,1840,25,25-29,1865,77.23752885423104
STAT,1854,30,35-39,1884,16.231809683653694
STAT,1918,18,15-19,1936,99.48472302063553
SIM,1917,46,45-49,1963,1
STAT,1940,13,na,1953,8079.776189036556
SIM,1846,24,na,1870,4004
SIM,1888,59,na,1947,4508
STAT,1914,26,30-34,1940,80.06238633964122
STAT,1853,31,na,1884,3928.6949964676937
SIM,1861,31,30-34,1892,34
SIM,1879,39,25-29,1918,6
SIM,1871,28,30-34,1899,54
SIM,1909,18,15-19,1927,17
STAT,1846,39,20-24,1885,1.2076572678565356
SIM,1840,84,na,1924,473
STAT,1830,38,15-19,1868,0.10377114501046396
STAT,1839,43,15-19,1882,0.02243721033937931
STAT,1865,25,30-34,1890,46.517495964920705
SIM,1843,42,35-39,1885,7
SIM,1930,21,50-100,1951,2
SIM,1856,19,35-39,1875,1
SIM,1943,26,50-100,1969,2
SIM,1891,45,na,1936,5862
STAT,1899,22,na,1921,6544.417439647868
SIM,1868,33,40-44,1901,5
STAT,1906,29,45-49,1935,3.244206275688477
STAT,1891,18,35-39,1909,1.3661988367337827
SIM,1890,69,na,1959,4031
STAT,1875,2,na,1877,6794.245352955601
SIM,1866,47,35-39,1913,1
STAT,1802,79,na,1881,629.4696410529968
STAT,1914,28,25-29,1942,133.55979660038335
STAT,1935,26,50-100,1961,2.7419482531082155
STAT,1765,100,na,1865,0.3828960487640145
SIM,1931,26,40-44,1957,19
STAT,1832,24,20-24,1856,125.90767126226918
SIM,1925,44,45-49,1969,1
SIM,1818,45,45-49,1863,1
SIM,1879,42,na,1921,4727
SIM,1889,21,45-49,1910,2
STAT,1877,36,45-49,1913,4.200778729179821
SIM,1832,27,35-39,1859,20
STAT,1886,21,50-100,1907,0.8720104831692672
SIM,1858,31,25-29,1889,24
SIM,1848,28,40-44,1876,6
STAT,1834,21,20-24,1855,123.57055864857145
STAT,1879,76,na,1955,2001.368537653976
SIM,1903,37,20-24,1940,1
STAT,1846,83,na,1929,608.0686047222084
STAT,1767,88,na,1855,72.02770000000001
STAT,1822,79,na,1901,789.3480894357637
SIM,1885,36,45-49,1921,6
STAT,1840,15,15-19,1855,11.222671430784128
SIM,1873,25,30-34,1898,74
STAT,1858,47,35-39,1905,0.21939096297494898
SIM,1837,67,na,1904,2042
SIM,1898,33,20-24,1931,9
STAT,1916,23,30-34,1939,60.63635979030063
STAT,1923,26,40-44,1949,10.841380548028301
SIM,1874,37,50-100,1911,4
STAT,1860,52,40-44,1912,0.01717430028654956
STAT,1881,80,na,1961,1596.4556378101097
STAT,1917,16,50-100,1933,0.16321359312523018
SIM,1922,28,25-29,1950,181
SIM,1824,60,na,1884,2470
STAT,1839,26,30-34,1865,49.89225930552879
STAT,1912,4,na,1916,8218.063761337966
SIM,1906,38,na,1944,6933
STAT,1895,30,25-29,1925,27.171416568811885
STAT,1891,41,50-100,1932,2.6492407683057397
STAT,1837,78,na,1915,1088.9867709546138
STAT,1848,19,35-39,1867,1.1022390979133456
STAT,1865,16,30-34,1881,3.031447210738359
SIM,1892,47,50-100,1939,1
SIM,1858,47,40-44,1905,1
STAT,1789,106,na,1895,0.006213983846836231
SIM,1924,23,30-34,1947,84
STAT,1866,37,50-100,1903,2.2878737427866724
STAT,1824,103,na,1927,0.1534370710410374
STAT,1949,15,40-44,1964,3.2869381451933606
STAT,1920,25,45-49,1945,3.852552534317984
STAT,1872,51,20-24,1923,0.0015049512018341816
SIM,1920,15,45-49,1935,3
SIM,1844,17,15-19,1861,10
SIM,1840,53,na,1893,3320
SIM,1852,26,40-44,1878,10
STAT,1911,38,15-19,1949,0.037284812621109255
SIM,1845,30,35-39,1875,31
SIM,1873,16,30-34,1889,3
SIM,1864,15,na,1879,5025
SIM,1928,16,25-29,1944,133
STAT,1934,13,na,1947,10808.688504439791
STAT,1863,28,30-34,1891,44.362390192496804
STAT,1896,36,15-19,1932,0.15045278195502024
SIM,1798,69,na,1867,1364
SIM,1889,72,na,1961,3526
STAT,1852,36,40-44,1888,7.087984721937357
SIM,1840,24,20-24,1864,134
STAT,1844,26,40-44,1870,5.964839866790612
SIM,1930,8,na,1938,11011
STAT,1837,32,50-100,1869,1.6015039130284567
STAT,1917,29,20-24,1946,38.3824409676712
SIM,1826,36,40-44,1862,14
SIM,1905,22,na,1927,7067
STAT,1876,43,35-39,1919,3.755211792831293
SIM,1955,7,na,1962,10124
STAT,1824,42,50-100,1866,2.7457765562801115
STAT,1854,33,40-44,1887,6.73776020343892
SIM,1839,48,na,1887,3083
STAT,1860,36,35-39,1896,11.656009372638064
STAT,1915,21,20-24,1936,232.85623404971844
STAT,1898,24,15-19,1922,8.960077103734474
STAT,1903,47,20-24,1950,0.019373935366995856
STAT,1835,49,50-100,1884,0.3269540641850187
SIM,1886,31,35-39,1917,33
SIM,1918,6,na,1924,9053
STAT,1871,50,na,1921,4382.448747455962
STAT,1908,38,50-100,1946,0.7904928695296978
STAT,1885,27,40-44,1912,6.021970667944449
SIM,1860,36,40-44,1896,9
STAT,1817,78,na,1895,788.0720420867667
STAT,1871,70,na,1941,2815.289463801059
STAT,1792,75,na,1867,822.3444711214152
SIM,1845,32,50-100,1877,6
SIM,1846,32,45-49,1878,5
STAT,1873,51,na,1924,4439.561408534916
STAT,1850,22,15-19,1872,6.071229662045568
SIM,1860,39,na,1899,4021
STAT,1913,33,20-24,1946,4.881725650116919
SIM,1819,40,35-39,1859,5
SIM,1888,39,35-39,1927,21
SIM,1849,23,30-34,1872,46
SIM,1870,24,35-39,1894,18
SIM,1947,20,na,1967,8655
STAT,1944,26,45-49,1970,3.7725166434603077
SIM,1923,16,40-44,1939,7
SIM,1832,58,na,1890,2584
STAT,1862,24,35-39,1886,10.164289469067056
STAT,1932,24,25-29,1956,243.9480125982854
SIM,1878,40,40-44,1918,6
SIM,1893,27,40-44,1920,12
SIM,1839,33,15-19,1872,1
STAT,1830,29,15-19,1859,0.9447303719485596
SIM,1842,21,20-24,1863,110
SIM,1898,16,35-39,1914,1
SIM,1832,75,na,1907,1357
STAT,1868,20,20-24,1888,134.33936343150478
STAT,1921,47,40-44,1968,0.35887100194163307
SIM,1898,49,35-39,1947,1
STAT,1915,49,40-44,1964,0.31900344787233154
SIM,1866,38,35-39,1904,25
STAT,1940,16,30-34,1956,25.003125394576966
STAT,1818,36,40-44,1854,33.58058835116931
STAT,1915,16,40-44,1931,0.5927309291783794
SIM,1884,43,35-39,1927,6
SIM,1925,29,20-24,1954,44
SIM,1928,38,35-39,1966,15
SIM,1854,39,20-24,1893,2
STAT,1901,34,40-44,1935,12.156519728923287
SIM,1869,39,30-34,1908,17
STAT,1884,23,na,1907,4701.972469201869
SIM,1887,71,na,1958,3386
SIM,1864,43,na,1907,4403
STAT,1860,27,35-39,1887,15.994602216735833
STAT,1875,60,na,1935,3965.69705707425
STAT,1860,33,na,1893,3897.231776313533
STAT,1931,17,35-39,1948,11.092838809298176
SIM,1862,33,40-44,1895,3
SIM,1844,35,45-49,1879,5
SIM,1900,46,50-100,1946,2
STAT,1858,29,na,1887,3791.382808696858
SIM,1908,22,35-39,1930,21
STAT,1890,46,20-24,1936,0.016734016017916287
SIM,1825,48,50-100,1873,2
STAT,1840,24,15-19,1864,5.969127671699197
SIM,1894,21,50-100,1915,1
STAT,1876,21,25-29,1897,119.93906959036534
STAT,1800,98,na,1898,2.7746485300176342
STAT,1836,35,45-49,1871,3.3223784974729225
STAT,1857,24,25-29,1881,93.31597439330923
STAT,1897,41,na,1938,6289.398100577713
SIM,1931,22,25-29,1953,264
STAT,1873,31,50-100,1904,1.8878709308132973
SIM,1914,29,45-49,1943,4
STAT,1934,21,25-29,1955,250.82199742133866
STAT,1809,52,35-39,1861,0.0634600107298781
STAT,1878,31,35-39,1909,21.448321901039552
STAT,1831,50,20-24,1881,0.0010336409730733753
STAT,1908,17,45-49,1925,0.19582966834018392
STAT,1809,49,na,1858,2739.81675864691
SIM,1920,13,na,1933,9195
SIM,1853,26,na,1879,4139
SIM,1888,26,20-24,1914,1
SIM,1942,21,25-29,1963,233
SIM,1902,35,45-49,1937,1
STAT,1836,34,35-39,1870,16.673659215074192
SIM,1839,76,na,1915,1187
SIM,1842,34,na,1876,3696
SIM,1859,28,15-19,1887,1
STAT,1906,33,15-19,1939,0.23963046701181837
STAT,1820,44,na,1864,2969.3926314825635
SIM,1876,20,20-24,1896,146
STAT,1810,45,35-39,1855,0.9491669635880092
STAT,1949,20,20-24,1969,262.20953519577756
STAT,1908,22,25-29,1930,171.61603262404634
SIM,1883,22,20-24,1905,130
STAT,1815,49,35-39,1864,0.7289807814746441
STAT,1880,46,30-34,1926,0.20653379565563726
SIM,1912,20,35-39,1932,27
STAT,1920,47,na,1967,8199.875776001427
STAT,1855,36,25-29,1891,4.362536959148861
SIM,1804,94,na,1898,6
SIM,1888,25,na,1913,5622
STAT,1829,36,15-19,1865,0.09994583773571435
STAT,1848,50,50-100,1898,0.02511995810335829
SIM,1919,23,20-24,1942,240
SIM,1940,24,25-29,1964,204
SIM,1827,32,40-44,1859,14
STAT,1817,48,50-100,1865,1.1677884498448445
STAT,1826,38,50-100,1864,2.811997287250241
SIM,1824,49,na,1873,3101
SIM,1910,18,20-24,1928,55
STAT,1945,22,45-49,1967,2.490345224184297
STAT,1855,35,15-19,1890,0.08548158569545164
STAT,1902,18,20-24,1920,50.417738574633674
STAT,1808,64,na,1872,1806.4282065069465
STAT,1880,84,na,1964,1208.154034131244
STAT,1838,47,15-19,1885,5.569506194096685E-4
STAT,1870,16,40-44,1886,0.3682891417136218
SIM,1849,24,40-44,1873,5
STAT,1851,43,30-34,1894,1.7693215321284488
STAT,1939,25,25-29,1964,133.7681306714125
SIM,1836,43,40-44,1879,13
STAT,1861,32,35-39,1893,17.023682973343863
STAT,1925,3,na,1928,9893.529856169216
SIM,1893,71,na,1964,3913
SIM,1874,39,40-44,1913,11
STAT,1899,27,35-39,1926,26.69992295716797
SIM,1872,72,na,1944,2588
SIM,1784,86,na,1870,85
STAT,1871,39,15-19,1910,0.1115409480570025
SIM,1923,21,20-24,1944,287
SIM,1856,27,50-100,1883,2
SIM,1921,19,40-44,1940,6
STAT,1908,31,25-29,1939,17.703553726492153
SIM,1894,23,40-44,1917,4
SIM,1835,86,na,1921,189
STAT,1838,32,45-49,1870,2.9326655946345808
STAT,1874,49,40-44,1923,0.3466352013971291
SIM,1916,22,25-29,1938,221
STAT,1878,50,45-49,1928,0.031050938401667595
STAT,1862,99,na,1961,8.068575766732483
STAT,1822,90,na,1912,89.01757047117017
STAT,1843,21,na,1864,3786.6861216566704
STAT,1921,40,na,1961,8469.615961764057
STAT,1841,20,15-19,1861,6.151757778802181
SIM,1858,21,15-19,1879,7
SIM,1887,15,15-19,1902,15
STAT,1898,22,50-100,1920,1.1145269638018427
SIM,1823,43,50-100,1866,4
STAT,1828,43,40-44,1871,4.167422955940218
STAT,1939,26,35-39,1965,30.499614251317468
STAT,1845,87,na,1932,271.4832557779793
STAT,1935,33,40-44,1968,10.929595090342545
STAT,1895,34,40-44,1929,11.314925193343987
SIM,1868,25,na,1893,4651
STAT,1866,18,40-44,1884,0.3477800533302945
STAT,1913,19,40-44,1932,0.5746149740110086
SIM,1882,49,40-44,1931,1
SIM,1847,35,30-34,1882,14
STAT,1848,27,50-100,1875,1.2521982139081296
STAT,1886,23,40-44,1909,4.428833252574233
STAT,1829,45,15-19,1874,6.478781484068582E-4
SIM,1909,60,na,1969,6365
STAT,1847,45,30-34,1892,0.14902736270677153
SIM,1828,84,na,1912,422
SIM,1920,3,na,1923,9413
SIM,1858,43,25-29,1901,3
SIM,1860,101,na,1961,2
STAT,1946,18,na,1964,8241.789247741806
STAT,1900,38,40-44,1938,2.633972758719994
STAT,1849,48,35-39,1897,0.21866920647315963
STAT,1891,18,50-100,1909,0.12198201639371986
STAT,1929,36,20-24,1965,0.6840561500616332
STAT,1862,25,45-49,1887,1.951596452604817
SIM,1940,19,45-49,1959,1
SIM,1917,47,na,1964,7919
STAT,1825,53,30-34,1878,0.012198509865786009
SIM,1913,27,35-39,1940,41
STAT,1839,35,30-34,1874,10.153283204496757
STAT,1858,26,35-39,1884,15.663885595035993
STAT,1880,33,na,1913,5055.6258419045225
STAT,1932,23,15-19,1955,14.063473297527846
SIM,1886,78,na,1964,2051
STAT,1888,36,20-24,1924,1.848922838069794
STAT,1793,71,na,1864,1178.2951739162818
STAT,1841,46,50-100,1887,0.36257948176238486
STAT,1830,88,na,1918,189.5725937399407
STAT,1855,26,15-19,1881,0.7182732905318634
SIM,1907,20,25-29,1927,180
STAT,1906,19,35-39,1925,1.6061604426126443
SIM,1847,26,30-34,1873,61
STAT,1906,49,na,1955,6484.116534129261
SIM,1873,57,na,1930,4161
SIM,1896,54,na,1950,5800
STAT,1932,19,45-49,1951,1.3288475398614215
SIM,1920,30,35-39,1950,33
SIM,1928,19,na,1947,9444
SIM,1905,36,40-44,1941,2
STAT,1842,52,50-100,1894,0.022365490754902365
STAT,1785,73,na,1858,1033.0703320680245
SIM,1857,33,na,1890,4164
SIM,1903,38,30-34,1941,6
STAT,1883,27,na,1910,4735.514520558225
SIM,1940,23,15-19,1963,10
SIM,1916,31,25-29,1947,20
STAT,1909,43,40-44,1952,0.4699098087379786
STAT,1896,27,15-19,1923,1.2097652955939315
STAT,1891,23,15-19,1914,8.210176436705291
SIM,1914,19,35-39,1933,2
STAT,1896,48,na,1944,5924.762362010796
SIM,1830,29,25-29,1859,82
SIM,1887,33,45-49,1920,5
SIM,1852,44,35-39,1896,6
STAT,1835,42,35-39,1877,2.8113980175315962
SIM,1839,34,25-29,1873,19
STAT,1871,21,50-100,1892,0.8207079105625065
STAT,1940,15,20-24,1955,278.178077996467
STAT,1891,56,na,1947,5091.705837786202
STAT,1824,32,15-19,1856,0.6406954754608873
STAT,1924,31,50-100,1955,1.948726491226367
STAT,1928,43,45-49,1971,0.42775639769620466
SIM,1857,15,35-39,1872,1
SIM,1890,21,15-19,1911,8
STAT,1910,27,45-49,1937,3.3705048445511014
STAT,1814,106,na,1920,0.010449497306984142
STAT,1912,30,35-39,1942,18.311504362856216
STAT,1928,44,20-24,1972,0.045311096244887626
SIM,1815,66,na,1881,1709
SIM,1873,28,35-39,1901,26
SIM,1902,48,na,1950,6451
STAT,1905,27,35-39,1932,28.182403606429055
SIM,1932,31,50-100,1963,4
STAT,1919,32,45-49,1951,3.42799936013554
SIM,1866,26,35-39,1892,21
SIM,1866,48,45-49,1914,1
STAT,1844,44,35-39,1888,2.919213044059113
STAT,1849,15,35-39,1864,1.081071510679401
SIM,1881,55,na,1936,3538
STAT,1904,20,35-39,1924,17.016465560498908
SIM,1927,32,45-49,1959,9
STAT,1879,33,45-49,1912,3.668238900681871
STAT,1882,21,15-19,1903,6.510084262001898
SIM,1838,19,15-19,1857,9
SIM,1844,34,35-39,1878,25
STAT,1825,36,na,1861,3338.3888257064827
SIM,1870,46,45-49,1916,2
STAT,1802,70,na,1872,1477.2351723192617
STAT,1884,77,na,1961,2113.0897394901317
SIM,1851,15,35-39,1866,2
STAT,1876,33,25-29,1909,21.30507530149244
STAT,1872,29,20-24,1901,23.641614517501566
SIM,1895,21,35-39,1916,21
STAT,1922,23,20-24,1945,256.66617042379755
STAT,1896,33,45-49,1929,4.630154799254104
STAT,1891,44,15-19,1935,0.034009268831054054
SIM,1877,44,40-44,1921,10
STAT,1832,27,25-29,1859,74.24988948334813
STAT,1923,29,45-49,1952,3.9759837391988215
SIM,1822,68,na,1890,1620
STAT,1852,27,45-49,1879,2.0611405259897677
STAT,1799,96,na,1895,5.83945751528876
STAT,1841,27,35-39,1868,17.388573833861432
SIM,1839,30,45-49,1869,4
SIM,1854,28,30-34,1882,59
STAT,1848,100,na,1948,1.7407870600173805
STAT,1857,28,40-44,1885,4.82227484993858
STAT,1879,48,15-19,1927,8.343728038347539E-4
STAT,1881,16,15-19,1897,11.613177733293542
SIM,1826,42,35-39,1868,6
SIM,1898,34,30-34,1932,60
STAT,1846,31,50-100,1877,1.6758055018777667
STAT,1854,15,45-49,1869,0.12121330730948009
STAT,1931,28,25-29,1959,171.5447255165104
SIM,1930,16,15-19,1946,116
SIM,1884,12,na,1896,5626
SIM,1899,65,na,1964,5163
SIM,1880,29,20-24,1909,30
STAT,1925,17,45-49,1942,1.2184771730376904
SIM,1918,27,20-24,1945,41
STAT,1847,68,na,1915,2329.4954530759474
SIM,1866,44,30-34,1910,8
SIM,1933,17,45-49,1950,3
SIM,1828,30,35-39,1858,27
SIM,1837,42,45-49,1879,4
STAT,1931,19,na,1950,9678.19264594811
STAT,1857,75,na,1932,1620.5760442792146
STAT,1846,28,30-34,1874,46.32676161845781
STAT,1914,29,35-39,1943,30.35401632916369
SIM,1817,42,25-29,1859,2
STAT,1806,83,na,1889,279.8907197624798
STAT,1869,44,40-44,1913,4.3422821740130235
STAT,1835,25,50-100,1860,1.0959499520315483
SIM,1956,14,na,1970,10688
STAT,1829,42,45-49,1871,2.4633893307921655
STAT,1898,21,45-49,1919,1.9115949362412372
SIM,1908,44,45-49,1952,1
STAT,1789,89,na,1878,77.89344146815894
STAT,1845,56,na,1901,3142.9448290389573
SIM,1884,33,25-29,1917,19
SIM,1842,68,na,1910,2112
STAT,1853,85,na,1938,433.7358947752036
STAT,1887,21,35-39,1908,13.22093464028737
SIM,1931,7,na,1938,10586
STAT,1914,17,35-39,1931,1.753336730428094
STAT,1843,27,35-39,1870,16.634331425257173
SIM,1931,29,45-49,1960,5
SIM,1896,39,25-29,1935,4
SIM,1859,11,na,1870,4970
STAT,1863,27,20-24,1890,20.740040596459057
STAT,1919,39,30-34,1958,3.9451801453635222
STAT,1900,27,na,1927,6686.142022176012
STAT,1818,42,35-39,1860,8.9247817941045
STAT,1851,50,na,1901,3385.7687734148417
SIM,1871,45,na,1916,4419
SIM,1871,27,20-24,1898,2
SIM,1826,58,na,1884,2354
SIM,1831,70,na,1901,1791
STAT,1851,21,20-24,1872,128.49480767145425
STAT,1895,32,50-100,1927,2.4112197880248996
STAT,1928,10,na,1938,10112.103259280913
SIM,1889,22,20-24,1911,167
SIM,1922,17,35-39,1939,16
SIM,1884,21,25-29,1905,134
STAT,1884,26,50-100,1910,1.2800975749693517
STAT,1910,24,40-44,1934,6.339498340045585
SIM,1902,17,15-19,1919,17
STAT,1863,92,na,1955,73.63202659957854
STAT,1885,33,35-39,1918,20.272489663749557
STAT,1826,83,na,1909,475.23513623012724
SIM,1893,33,35-39,1926,37
SIM,1916,39,20-24,1955,1
STAT,1908,39,20-24,1947,0.49377165852722343
STAT,1827,68,na,1895,1847.9490264915732
STAT,1913,3,na,1916,8350.141726873704
STAT,1906,18,na,1924,7413.244205333265
STAT,1889,17,30-34,1906,3.9691060545876193
STAT,1862,21,30-34,1883,31.7035921690705
SIM,1887,27,15-19,1914,2
STAT,1905,38,25-29,1943,1.8061144542353893
SIM,1843,32,25-29,1875,34
SIM,1886,17,20-24,1903,36
SIM,1863,32,45-49,1895,5
SIM,1937,21,15-19,1958,8
STAT,1940,19,35-39,1959,8.599458504387249
STAT,1911,23,45-49,1934,2.149121951150202
SIM,1945,16,25-29,1961,110
SIM,1831,28,na,1859,3936
SIM,1897,17,30-34,1914,6
STAT,1880,23,40-44,1903,4.419756073856737
STAT,1902,16,50-100,1918,0.14003589343612613
STAT,1855,54,50-100,1909,0.02214768644087274
SIM,1845,37,20-24,1882,3
STAT,1860,33,30-34,1893,28.51454147640318
STAT,1908,17,50-100,1925,0.1468722512551379
STAT,1936,17,20-24,1953,262.19785644693303
STAT,1823,36,15-19,1859,0.22587019031862
SIM,1865,20,45-49,1885,1
SIM,1851,27,35-39,1878,22
STAT,1929,21,15-19,1950,13.634973678299263
STAT,1939,17,50-100,1956,0.7574860137371536
STAT,1922,16,15-19,1938,106.30760953568084
STAT,1899,39,35-39,1938,4.181874636984411
STAT,1841,39,35-39,1880,11.842512022437703
STAT,1826,37,45-49,1863,4.723954733889646
STAT,1832,38,na,1870,3467.1867941077808
STAT,1909,21,30-34,1930,54.14104940738465
STAT,1837,49,20-24,1886,0.016926454153482293
STAT,1875,15,50-100,1890,0.10234464925076436
STAT,1873,46,20-24,1919,0.024694588420866748
STAT,1890,27,15-19,1917,1.118447508287543
SIM,1927,39,30-34,1966,9
STAT,1867,31,25-29,1898,19.452284581746657
STAT,1869,27,20-24,1896,22.957740840348116
STAT,1821,48,15-19,1869,0.0011539745481437696
STAT,1859,43,35-39,1902,2.8898361387706557
STAT,1934,29,20-24,1963,49.55193105043086
SIM,1857,33,30-34,1890,45
SIM,1897,30,na,1927,6583
SIM,1930,23,20-24,1953,297
SIM,1904,19,40-44,1923,1
SIM,1917,21,30-34,1938,78
STAT,1872,18,30-34,1890,3.2266653079486343
SIM,1836,25,45-49,1861,2
SIM,1845,16,20-24,1861,39
STAT,1920,28,15-19,1948,1.5581539280248236
STAT,1937,16,25-29,1953,85.36929690879198
SIM,1929,27,30-34,1956,126
STAT,1897,32,15-19,1929,0.3844497268146415
STAT,1897,4,na,1901,7101.9149251877425
STAT,1903,52,na,1955,6158.77592611703
STAT,1944,23,40-44,1967,7.329086428192142
STAT,1843,15,35-39,1858,0.9939451292797524
STAT,1858,44,30-34,1902,1.7856263377994506
STAT,1895,16,45-49,1911,0.17232690046664886
STAT,1944,25,50-100,1969,2.174418972155618
SIM,1845,93,na,1938,35
SIM,1925,22,na,1947,8776
STAT,1875,18,na,1893,5237.863832283831
STAT,1880,30,na,1910,5117.8610545356705
SIM,1942,29,20-24,1971,42
SIM,1859,21,30-34,1880,41
STAT,1930,29,50-100,1959,2.5535358301373092
STAT,1862,46,45-49,1908,0.4085401300821452
SIM,1913,38,25-29,1951,3
STAT,1855,63,na,1918,2690.6137168235887
STAT,1845,22,40-44,1867,3.9862684041070073
STAT,1930,18,30-34,1948,31.74186961281649
STAT,1884,50,35-39,1934,0.017415515291811415
STAT,1857,20,45-49,1877,1.2856520208980617
SIM,1843,20,25-29,1863,127
SIM,1834,37,45-49,1871,3
STAT,1859,56,na,1915,3278.68962145433
STAT,1910,40,45-49,1950,0.32138417690027943
SIM,1899,30,50-100,1929,2
SIM,1880,18,30-34,1898,5
STAT,1899,20,15-19,1919,9.183324901313455
SIM,1877,33,na,1910,4897
STAT,1825,31,20-24,1856,10.629927424153607
STAT,1855,32,45-49,1887,2.6774441832244684
SIM,1901,20,25-29,1921,174
STAT,1837,37,20-24,1874,1.3083847700934035
STAT,1835,32,25-29,1867,16.896633043411995
SIM,1865,28,40-44,1893,9
SIM,1853,22,40-44,1875,4
STAT,1892,22,20-24,1914,174.2311757086872
SIM,1944,17,20-24,1961,276
SIM,1919,26,25-29,1945,161
SIM,1825,37,35-39,1862,18
STAT,1913,32,45-49,1945,3.1626904384726306
SIM,1914,22,25-29,1936,228
STAT,1872,89,na,1961,386.6166298171832
STAT,1941,18,40-44,1959,2.9088585127691142
SIM,1844,31,30-34,1875,42
STAT,1853,82,na,1935,738.2274009615012
STAT,1846,20,35-39,1866,11.188668205806282
SIM,1938,20,20-24,1958,219
SIM,1881,28,25-29,1909,71
STAT,1838,36,25-29,1874,4.751070251187135
STAT,1916,45,40-44,1961,0.3281305341440777
SIM,1855,38,25-29,1893,8
STAT,1862,45,na,1907,3922.3965375593734
SIM,1831,73,na,1904,1494
STAT,1877,95,na,1972,152.69062843343406
STAT,1878,38,20-24,1916,1.617887360615181
SIM,1794,76,na,1870,737
SIM,1848,21,20-24,1869,124
STAT,1863,20,35-39,1883,10.674887885062127
STAT,1860,30,na,1890,3945.2070529373195
SIM,1868,21,40-44,1889,9
SIM,1887,40,na,1927,5710
STAT,1849,33,30-34,1882,28.801591276322476
SIM,1836,33,50-100,1869,2
SIM,1875,28,35-39,1903,21
STAT,1866,32,20-24,1898,5.037095154535561
SIM,1918,40,na,1958,8252
STAT,1909,49,15-19,1958,6.799869438265711E-4
STAT,1820,37,50-100,1857,6.105019546442306
STAT,1886,58,na,1944,4216.124252601948
STAT,1904,37,na,1941,6883.253291123422
STAT,1817,50,50-100,1867,0.07275996367787174
STAT,1951,21,25-29,1972,222.93637484686425
STAT,1835,20,25-29,1855,121.44730661415298
STAT,1900,24,na,1924,6584.498387552338
SIM,1949,20,30-34,1969,90
SIM,1837,64,na,1901,2266
SIM,1943,7,na,1950,8676
SIM,1847,28,50-100,1875,2
STAT,1873,28,25-29,1901,86.49933643870519
SIM,1886,38,20-24,1924,5
STAT,1820,98,na,1918,3.636765861566232
STAT,1893,28,45-49,1921,2.8322359044095853
STAT,1877,21,40-44,1898,4.383270443698527
SIM,1915,12,na,1927,8429
STAT,1906,22,25-29,1928,168.47064102622159
STAT,1921,40,20-24,1961,0.04027449692038055
STAT,1857,38,50-100,1895,1.9231226572153026
SIM,1841,80,na,1921,720
SIM,1895,29,30-34,1924,78
SIM,1838,60,na,1898,2632
STAT,1926,34,45-49,1960,3.837174635272379
SIM,1828,39,na,1867,3340
SIM,1859,24,35-39,1883,14
SIM,1829,36,25-29,1865,9
SIM,1867,43,35-39,1910,9
STAT,1835,37,50-100,1872,1.9667414239776986
STAT,1831,53,na,1884,2825.8388236401606
STAT,1861,22,25-29,1883,98.86118791116962
SIM,1904,33,20-24,1937,6
STAT,1832,48,25-29,1880,0.08765101684229211
SIM,1846,36,25-29,1882,7
STAT,1873,82,na,1955,957.4533325874203
SIM,1839,38,40-44,1877,1
STAT,1842,45,na,1887,3437.1067847387067
SIM,1922,47,30-34,1969,1
STAT,1837,110,na,1947,3.851477340753614E-4
SIM,1905,39,45-49,1944,3
STAT,1816,103,na,1919,0.1409679894430991
SIM,1860,20,25-29,1880,122
STAT,1840,19,30-34,1859,2.9437363674091555
STAT,1898,29,40-44,1927,8.128623931632463
STAT,1866,49,50-100,1915,0.4481148054306685
SIM,1942,8,na,1950,8520
SIM,1837,98,na,1935,2
SIM,1896,27,25-29,1923,122
SIM,1849,27,45-49,1876,3
STAT,1877,39,15-19,1916,0.11657974755228485
STAT,1888,27,25-29,1915,100.97624660221464
SIM,1899,32,25-29,1931,33
STAT,1797,61,na,1858,1845.6129932302795
SIM,1831,36,15-19,1867,3
SIM,1952,1,na,1953,9906
SIM,1828,38,30-34,1866,6
SIM,1937,28,35-39,1965,44
STAT,1857,42,20-24,1899,0.24969519310189153
SIM,1917,28,15-19,1945,2
STAT,1900,34,25-29,1934,28.450248308901543
SIM,1934,34,45-49,1968,5
STAT,1852,20,25-29,1872,109.9606026759336
STAT,1821,45,45-49,1866,0.7110354787538034
STAT,1936,31,35-39,1967,17.940591549407042
SIM,1930,33,50-100,1963,4
SIM,1821,80,na,1901,704
STAT,1882,15,20-24,1897,35.04110693088681
SIM,1870,21,30-34,1891,47
SIM,1875,35,40-44,1910,4
STAT,1846,49,30-34,1895,0.14517369102641214
SIM,1938,32,20-24,1970,8
SIM,1964,1,na,1965,10493
STAT,1919,18,30-34,1937,27.126551820194805
STAT,1888,39,25-29,1927,6.803659189097976
STAT,1852,39,45-49,1891,3.145262008208311
SIM,1849,41,25-29,1890,2
STAT,1855,97,na,1952,8.100988830632556
STAT,1875,48,50-100,1923,0.5042719241871956
SIM,1907,24,40-44,1931,11
STAT,1888,36,na,1924,5650.938939068553
SIM,1879,34,50-100,1913,4
STAT,1875,23,30-34,1898,36.923551565290715
STAT,1878,29,na,1907,4997.916903784989
STAT,1897,39,35-39,1936,4.079869304388887
SIM,1875,38,na,1913,5223
SIM,1773,91,na,1864,19
STAT,1856,31,15-19,1887,0.22696620446312465
STAT,1781,83,na,1864,252.80898330437466
STAT,1929,28,35-39,1957,37.926452464867154
SIM,1894,8,na,1902,7052
SIM,1921,15,na,1936,8501
STAT,1882,25,30-34,1907,49.878900378463186
STAT,1909,28,15-19,1937,1.3585222390479335
SIM,1929,1,na,1930,10936
STAT,1887,29,30-34,1916,56.47415370145049
SIM,1904,26,15-19,1930,2
SIM,1777,84,na,1861,171
STAT,1837,30,35-39,1867,18.07252997970601
SIM,1860,39,45-49,1899,6
SIM,1824,46,na,1870,3188
STAT,1939,22,20-24,1961,225.5583624096456
SIM,1834,27,35-39,1861,24
SIM,1942,14,na,1956,8449
STAT,1914,47,30-34,1961,0.1785871874389113
STAT,1791,90,na,1881,61.89158747093039
SIM,1871,20,35-39,1891,11
STAT,1869,15,na,1884,5070.453312991259
SIM,1877,26,45-49,1903,1
STAT,1884,16,35-39,1900,1.0969619983771042
STAT,1902,59,na,1961,5804.096570169084
SIM,1829,48,25-29,1877,1
SIM,1830,26,20-24,1856,20
SIM,1849,48,45-49,1897,1
STAT,1833,31,na,1864,3705.8009973859316
STAT,1868,30,na,1898,4622.2174344943205
SIM,1834,20,15-19,1854,6
STAT,1817,37,35-39,1854,52.95818372324018
SIM,1828,53,na,1881,2804
STAT,1864,37,15-19,1901,0.10137636337987649
STAT,1867,35,40-44,1902,8.358349972229126
STAT,1853,50,40-44,1903,0.01689622848518433
STAT,1856,38,35-39,1894,10.966616574091368
SIM,1860,27,45-49,1887,3
SIM,1945,21,50-100,1966,2
SIM,1872,53,50-100,1925,1
SIM,1854,20,35-39,1874,15
STAT,1836,38,15-19,1874,0.09071769832751521
STAT,1836,31,30-34,1867,29.656047810120736
STAT,1879,37,25-29,1916,6.0822381423347815
SIM,1840,27,25-29,1867,82
SIM,1947,22,20-24,1969,267
SIM,1892,16,35-39,1908,2
STAT,1893,37,na,1930,6031.014241074048
STAT,1847,48,35-39,1895,0.21072638013527956
SIM,1889,29,40-44,1918,15
SIM,1907,45,40-44,1952,2
STAT,1831,28,20-24,1859,20.225230272197216
STAT,1836,103,na,1939,0.19081515604207208
STAT,1857,45,25-29,1902,0.09157772087921764
SIM,1929,20,45-49,1949,5
SIM,1859,31,40-44,1890,10
STAT,1838,103,na,1941,0.19422850810635836
STAT,1924,37,na,1961,8957.212423171666
STAT,1800,92,na,1892,35.57365544303304
STAT,1855,19,50-100,1874,0.08683672733464166
SIM,1823,34,30-34,1857,41
SIM,1840,15,25-29,1855,13
SIM,1893,6,na,1899,6947
SIM,1948,21,25-29,1969,241
STAT,1859,110,na,1969,0.005321209675953364
SIM,1892,28,35-39,1920,32
STAT,1906,16,30-34,1922,4.702189209773917
STAT,1813,51,15-19,1864,1.4757458922857867E-4
STAT,1757,106,na,1863,0.04168617942866019
STAT,1884,28,35-39,1912,19.174839214707077
SIM,1864,97,na,1961,19
SIM,1914,16,30-34,1930,1
STAT,1861,104,na,1965,0.6117351387333417
SIM,1890,25,30-34,1915,83
SIM,1890,30,50-100,1920,3
SIM,1936,34,50-100,1970,5
STAT,1842,17,40-44,1859,0.349680165330136
SIM,1887,37,25-29,1924,3
STAT,1854,16,na,1870,4234.36502567728
STAT,1896,48,15-19,1944,5.940749842096447E-4
STAT,1927,27,20-24,1954,44.81159108057988
SIM,1837,28,30-34,1865,61
SIM,1942,5,na,1947,8578
STAT,1775,83,na,1858,189.47734876743738
STAT,1860,64,na,1924,2851.0517924964106
SIM,1879,11,na,1890,5394
STAT,1864,23,na,1887,4307.155093828764
STAT,1928,22,50-100,1950,1.6589507259150214
STAT,1852,24,40-44,1876,3.888972359382641
STAT,1871,15,45-49,1886,0.13348491069635604
SIM,1875,52,na,1927,4805
STAT,1895,69,na,1964,4331.828532203068
SIM,1850,38,40-44,1888,14
SIM,1856,30,45-49,1886,1
STAT,1896,30,40-44,1926,11.656493044513603
STAT,1933,11,na,1944,10729.322267422225
STAT,1842,38,40-44,1880,7.566296331645634
STAT,1935,18,15-19,1953,124.99565368773416
STAT,1856,25,20-24,1881,19.21762496660873
SIM,1828,50,na,1878,2984
SIM,1943,18,15-19,1961,100
SIM,1883,44,30-34,1927,5
STAT,1820,50,45-49,1870,0.054047998199813194
STAT,1924,1,na,1925,10040.871928572857
STAT,1841,24,30-34,1865,32.27122172154093
SIM,1872,16,15-19,1888,12
SIM,1929,33,25-29,1962,29
STAT,1893,25,50-100,1918,1.6486440761290788
STAT,1860,15,35-39,1875,1.0502413536075854
STAT,1864,16,15-19,1880,12.251375974108937
SIM,1857,19,na,1876,4710
SIM,1936,14,na,1950,6862
STAT,1881,18,na,1899,4917.2713433233575
STAT,1854,37,20-24,1891,1.1817015387883487
STAT,1882,18,25-29,1900,11.119493110854943
STAT,1931,25,20-24,1956,47.638775059362374
SIM,1899,11,na,1910,7272
SIM,1918,41,35-39,1959,1
SIM,1931,19,35-39,1950,12
STAT,1850,29,35-39,1879,17.16095285880462
STAT,1929,15,20-24,1944,351.02817427649825
STAT,1953,17,na,1970,8991.737801594209
STAT,1801,77,na,1878,743.0311936716872
SIM,1835,44,35-39,1879,5
SIM,1935,27,20-24,1962,60
STAT,1867,17,45-49,1884,0.1263078162145228
STAT,1913,26,15-19,1939,1.4258682154663183
SIM,1824,91,na,1915,93
SIM,1845,19,25-29,1864,12
STAT,1837,19,25-29,1856,11.19702742984015
STAT,1834,25,35-39,1859,17.086602121577055
SIM,1875,38,45-49,1913,10
SIM,1879,46,30-34,1925,1
SIM,1933,31,25-29,1964,29
STAT,1830,32,40-44,1862,8.589614717820988
STAT,1922,26,25-29,1948,150.89580393493992
STAT,1938,27,30-34,1965,78.41120871088802
SIM,1930,26,25-29,1956,205
STAT,1839,31,15-19,1870,0.27649506698503684
SIM,1885,24,45-49,1909,2
SIM,1890,18,25-29,1908,18
STAT,1824,39,35-39,1863,19.64918302342841
SIM,1791,65,na,1856,1449
SIM,1860,24,40-44,1884,5
SIM,1813,51,na,1864,2712
SIM,1937,15,20-24,1952,254
STAT,1849,54,30-34,1903,0.009156805947559092
STAT,1844,36,50-100,1880,2.3264140080871467
SIM,1819,79,na,1898,580
STAT,1848,30,na,1878,4231.163597423644
STAT,1848,30,45-49,1878,3.4044933367490793
STAT,1870,50,40-44,1920,0.021174485798008288
SIM,1877,30,na,1907,4953
SIM,1852,36,50-100,1888,4
STAT,1840,36,15-19,1876,0.09686979828313219
STAT,1877,32,30-34,1909,36.61578957623597
SIM,1870,60,na,1930,3660
SIM,1908,34,35-39,1942,22
SIM,1926,15,45-49,1941,5
STAT,1873,49,25-29,1922,0.11573053851266259
SIM,1901,28,20-24,1929,36
STAT,1935,21,40-44,1956,9.251986544650842
STAT,1837,75,na,1912,1434.818452545524
STAT,1923,19,35-39,1942,9.894682554304811
SIM,1836,22,40-44,1858,5
STAT,1808,53,30-34,1861,0.03461055259625055
STAT,1826,34,40-44,1860,11.436690880957647
STAT,1845,25,45-49,1870,2.1127070588081556
STAT,1883,35,25-29,1918,5.767372436035297
STAT,1953,17,20-24,1970,331.19772007687294
STAT,1835,39,45-49,1874,3.1277644351907603
SIM,1913,35,20-24,1948,2
SIM,1826,32,25-29,1858,22
STAT,1948,10,na,1958,9080.848777297502
SIM,1903,16,20-24,1919,53
STAT,1796,68,na,1864,1462.1931414030819
STAT,1925,31,25-29,1956,22.174832140320945
SIM,1860,53,na,1913,3696
SIM,1893,23,25-29,1916,178
STAT,1885,23,25-29,1908,114.7250352481159
STAT,1875,63,na,1938,3710.1958470520076
STAT,1832,45,20-24,1877,0.018976707644093527
STAT,1814,95,na,1909,11.442533421503805
STAT,1875,44,30-34,1919,2.358296319105251
STAT,1905,35,20-24,1940,0.49057753373469504
SIM,1824,48,40-44,1872,1
SIM,1839,79,na,1918,833
SIM,1878,29,30-34,1907,80
SIM,1923,41,na,1964,9167
STAT,1816,44,25-29,1860,3.274556712326188
SIM,1843,39,45-49,1882,9
STAT,1897,36,30-34,1933,14.457201621828094
STAT,1781,111,na,1892,9.556120163965744E-4
SIM,1824,44,25-29,1868,3
SIM,1862,37,20-24,1899,1
SIM,1885,32,30-34,1917,41
STAT,1901,19,15-19,1920,16.689181648667663
STAT,1918,15,45-49,1933,0.22129824469123036
STAT,1860,15,50-100,1875,0.09377153205561295
STAT,1911,27,50-100,1938,1.9609759313458717
SIM,1834,34,40-44,1868,10
SIM,1898,48,50-100,1946,2
SIM,1878,25,15-19,1903,1
SIM,1911,22,40-44,1933,6
STAT,1878,17,20-24,1895,37.3948033646015
STAT,1881,22,45-49,1903,1.3612283853451204
SIM,1891,35,25-29,1926,14
STAT,1918,51,na,1969,7793.746217198926
STAT,1885,70,na,1955,2820.594715406054
STAT,1853,47,50-100,1900,0.3867770567283277
STAT,1831,38,30-34,1869,8.62352219575311
STAT,1867,34,na,1901,4474.884403509111
SIM,1864,25,20-24,1889,21
STAT,1862,28,15-19,1890,0.7804250866662071
SIM,1861,47,50-100,1908,1
STAT,1830,57,na,1887,2794.8075938609154
SIM,1891,39,40-44,1930,19
STAT,1908,44,na,1952,6858.921746034306
STAT,1870,22,35-39,1892,11.570748900594163
STAT,1899,24,30-34,1923,48.980499274767226
SIM,1888,70,na,1958,3541
STAT,1915,28,40-44,1943,9.568581127597042
STAT,1862,42,na,1904,3984.7530108312817
SIM,1923,28,40-44,1951,16
SIM,1898,37,35-39,1935,6
STAT,1816,48,40-44,1864,0.8283847917331542
STAT,1921,43,25-29,1964,0.16214168143472943
STAT,1847,38,25-29,1885,4.506619705458886
STAT,1903,22,40-44,1925,5.992122328619153
SIM,1936,22,50-100,1958,1
STAT,1819,50,na,1869,2717.525547680436
SIM,1900,13,na,1913,7574
STAT,1883,39,40-44,1922,8.598739914787462
SIM,1907,34,na,1941,7121
SIM,1818,41,30-34,1859,3
SIM,1902,23,45-49,1925,1
STAT,1893,25,40-44,1918,7.720302394144058
STAT,1868,45,35-39,1913,0.27169564619895886
STAT,1928,37,15-19,1965,0.0490068346556199
STAT,1774,87,na,1861,79.13088569042988
SIM,1926,33,40-44,1959,6
SIM,1875,25,30-34,1900,68
STAT,1809,49,45-49,1858,1.764248539603156
SIM,1837,24,15-19,1861,6
STAT,1834,43,30-34,1877,1.8214367608628999
SIM,1844,23,45-49,1867,3
SIM,1833,31,20-24,1864,6
STAT,1858,38,35-39,1896,11.080503907832226
SIM,1865,93,na,1958,54
STAT,1853,34,35-39,1887,16.161293556048182
STAT,1763,95,na,1858,2.2471731172766614
STAT,1928,22,45-49,1950,2.8368056332242713
STAT,1947,23,25-29,1970,210.7538398347202
STAT,1853,9,na,1862,4637.015383005111
SIM,1904,36,25-29,1940,5
STAT,1842,90,na,1932,117.37897167403806
STAT,1916,48,45-49,1964,0.44895894366934685
STAT,1896,15,15-19,1911,15.897575044067526
STAT,1917,22,35-39,1939,20.209376012889578
SIM,1890,28,35-39,1918,33
SIM,1842,65,na,1907,2348
STAT,1857,49,40-44,1906,0.2638755078437312
SIM,1915,33,30-34,1948,37
STAT,1849,36,35-39,1885,11.567710495888672
STAT,1918,33,40-44,1951,8.361605267741234
SIM,1838,35,20-24,1873,1
SIM,1847,47,30-34,1894,1
SIM,1861,34,35-39,1895,31
STAT,1845,43,40-44,1888,3.484550934096202
STAT,1846,43,50-100,1889,1.6169180160154004
STAT,1792,107,na,1899,0.0017670306268554323
STAT,1874,20,45-49,1894,1.4506054113128735
STAT,1888,24,20-24,1912,163.46882116151147
SIM,1873,71,na,1944,2586
STAT,1839,56,na,1895,3184.7423682687167
STAT,1930,32,45-49,1962,4.101312137239127
SIM,1806,49,35-39,1855,1
SIM,1893,26,na,1919,6289
STAT,1790,101,na,1891,0.22320613558227115
STAT,1804,51,na,1855,2377.9636786947385
SIM,1934,24,35-39,1958,32
STAT,1919,20,45-49,1939,2.5026572599957277
SIM,1862,34,na,1896,4347
SIM,1934,33,na,1967,10270
STAT,1919,35,15-19,1954,0.04188898349744972
STAT,1879,27,15-19,1906,0.9584362317016822
STAT,1824,57,na,1881,2325.83077806453
SIM,1924,26,na,1950,9167
STAT,1921,20,35-39,1941,21.60182424046197
SIM,1853,43,40-44,1896,6
STAT,1859,30,20-24,1889,4.408433799360445
STAT,1907,33,30-34,1940,29.633349402921823
STAT,1917,49,50-100,1966,0.4742907519414139
STAT,1937,34,20-24,1971,4.868416692839138
SIM,1943,21,40-44,1964,9
SIM,1817,49,45-49,1866,2
STAT,1898,6,na,1904,7139.801685041005
STAT,1829,49,na,1878,2832.949567738665
STAT,1882,28,35-39,1910,18.916448637284944
SIM,1936,22,45-49,1958,3
SIM,1891,48,na,1939,5734
STAT,1867,38,45-49,1905,3.7518279654293676
SIM,1925,22,35-39,1947,31
STAT,1915,42,20-24,1957,0.035911733602189834
SIM,1855,86,na,1941,307
SIM,1908,19,na,1927,7597
STAT,1842,34,25-29,1876,18.042952608293508
STAT,1910,20,25-29,1930,176.2990895868163
SIM,1850,34,25-29,1884,21
STAT,1839,47,30-34,1886,0.15399849612550226
STAT,1861,51,45-49,1912,0.02451221297240994
STAT,1815,43,na,1858,2925.6456406001953
STAT,1833,22,15-19,1855,6.0320634204159065
SIM,1848,24,25-29,1872,127
SIM,1857,36,35-39,1893,4
STAT,1850,43,15-19,1893,0.021021236543502207
SIM,1841,22,15-19,1863,3
SIM,1939,25,na,1964,7750
SIM,1869,31,35-39,1900,29
SIM,1872,26,25-29,1898,109
SIM,1907,27,45-49,1934,5
STAT,1897,26,20-24,1923,31.779403311144314
SIM,1864,38,35-39,1902,20
STAT,1864,26,25-29,1890,76.62922857295509
SIM,1849,45,40-44,1894,1
STAT,1904,28,30-34,1932,72.73882774480066
SIM,1867,30,20-24,1897,7
SIM,1920,19,25-29,1939,107
SIM,1882,23,15-19,1905,5
STAT,1876,48,na,1924,4640.5511387779
STAT,1846,45,15-19,1891,6.187913241842224E-4
STAT,1838,26,15-19,1864,0.7867410919989796
SIM,1908,21,50-100,1929,1
SIM,1821,39,25-29,1860,8
SIM,1808,47,45-49,1855,1
STAT,1827,44,35-39,1871,3.3176765403478568
SIM,1832,39,35-39,1871,18
SIM,1901,49,na,1950,6326
SIM,1927,20,45-49,1947,4
SIM,1831,29,40-44,1860,6
STAT,1831,50,na,1881,2998.8225584092693
STAT,1872,39,30-34,1911,10.708784989037133
SIM,1822,65,na,1887,1820
SIM,1865,49,40-44,1914,1
STAT,1912,19,25-29,1931,17.60748417629983
SIM,1919,5,na,1924,9113
STAT,1769,106,na,1875,0.016787895434843214
SIM,1850,94,na,1944,22
SIM,1859,42,30-34,1901,5
SIM,1906,21,20-24,1927,221
STAT,1840,21,45-49,1861,1.2892790875502573
SIM,1875,21,15-19,1896,7
STAT,1948,16,35-39,1964,9.700486501948662
SIM,1874,32,20-24,1906,6
STAT,1886,55,na,1941,4408.246569692625
SIM,1839,90,na,1929,135
STAT,1789,86,na,1875,146.9509070118944
SIM,1853,20,na,1873,4560
STAT,1894,35,35-39,1929,18.524236764712366
SIM,1867,33,25-29,1900,25
SIM,1840,87,na,1927,232
STAT,1863,2,na,1865,6041.600271864865
SIM,1917,31,40-44,1948,14
STAT,1921,49,30-34,1970,0.20172368702800553
STAT,1926,24,35-39,1950,22.954333462962413
SIM,1912,28,30-34,1940,96
STAT,1813,65,na,1878,1796.9311139403587
STAT,1911,19,na,1930,7766.088403559671
STAT,1926,18,na,1944,9088.696003960473
STAT,1955,15,30-34,1970,32.69192444738304
SIM,1826,72,na,1898,1371
SIM,1834,24,30-34,1858,37
SIM,1823,37,35-39,1860,17
SIM,1846,26,15-19,1872,1
SIM,1859,34,45-49,1893,4
STAT,1900,17,40-44,1917,0.512425692670982
SIM,1842,43,30-34,1885,3
STAT,1844,32,35-39,1876,19.557059705672998
STAT,1867,21,15-19,1888,6.310872841038145
SIM,1896,24,20-24,1920,187
SIM,1851,79,na,1930,940
SIM,1866,78,na,1944,1471
STAT,1848,16,30-34,1864,3.258990035531938
SIM,1905,29,35-39,1934,44
STAT,1861,26,40-44,1887,5.108833971874243
SIM,1864,35,30-34,1899,18
SIM,1882,85,na,1967,974
SIM,1868,18,15-19,1886,9
STAT,1933,23,30-34,1956,76.9783330421058
SIM,1864,12,na,1876,5213
STAT,1779,103,na,1882,0.09119280814126175
STAT,1828,64,na,1892,2134.8008843491984
STAT,1947,5,na,1952,9013.063000291688
SIM,1856,16,30-34,1872,6
SIM,1916,48,na,1964,7720
SIM,1941,23,30-34,1964,82
STAT,1886,44,40-44,1930,4.730599000305698
SIM,1877,23,40-44,1900,7
STAT,1856,35,30-34,1891,8.383612058252591
STAT,1919,23,50-100,1942,1.450366256254085
SIM,1829,33,20-24,1862,7
SIM,1880,39,30-34,1919,18
STAT,1920,26,50-100,1946,2.212226436434243
SIM,1889,25,25-29,1914,133
STAT,1862,49,15-19,1911,6.760632210517E-4
STAT,1898,46,25-29,1944,0.08905341417696157
SIM,1811,73,na,1884,1016
SIM,1852,32,35-39,1884,20
STAT,1816,106,na,1922,0.011926205366470835
STAT,1909,31,40-44,1940,7.576930668046996
SIM,1899,15,40-44,1914,2
SIM,1845,44,50-100,1889,7
SIM,1795,72,na,1867,1163
STAT,1819,53,40-44,1872,0.04157920231588386
STAT,1945,25,15-19,1970,1.5654327017167173
STAT,1942,25,na,1967,7947.788912801904
SIM,1834,26,50-100,1860,1
STAT,1923,33,15-19,1956,0.29724622986614996
STAT,1837,44,50-100,1881,1.5414801160010667
STAT,1821,43,na,1864,3007.416830815818
STAT,1778,94,na,1872,8.620439308849017
STAT,1883,52,na,1935,4249.728752010404
SIM,1856,23,na,1879,4156
STAT,1819,43,40-44,1862,10.080220024461918
STAT,1928,43,50-100,1971,0.3019456916261744
SIM,1841,18,25-29,1859,16
STAT,1908,26,40-44,1934,9.011188593354689
STAT,1938,4,na,1942,8042.365861969933
SIM,1881,34,30-34,1915,30
STAT,1925,30,25-29,1955,22.18703500957621
STAT,1859,52,25-29,1911,0.005663436669319312
STAT,1845,39,25-29,1884,4.565745284743796
SIM,1819,39,na,1858,3125
STAT,1886,47,50-100,1933,0.521164019991802
STAT,1881,53,20-24,1934,0.001417350187255327
STAT,1854,87,na,1941,270.0829003687005
STAT,1858,45,45-49,1903,0.375267045365172
STAT,1929,18,25-29,1947,111.39075524303738
SIM,1823,44,na,1867,3047
STAT,1846,41,50-100,1887,1.658884385443363
STAT,1879,47,na,1926,4730.579640231276
STAT,1926,17,45-49,1943,1.236729430071662
STAT,1841,51,25-29,1892,0.005163801495108179
SIM,1885,36,40-44,1921,13
SIM,1888,37,20-24,1925,4
STAT,1903,49,50-100,1952,0.39005930580083503
STAT,1875,33,na,1908,4941.040089100664
SIM,1843,26,35-39,1869,21
SIM,1868,39,45-49,1907,6
SIM,1883,42,40-44,1925,11
STAT,1909,8,na,1917,7877.627271642081
SIM,1924,32,25-29,1956,31
STAT,1905,30,50-100,1935,2.697663585537175
STAT,1835,35,50-100,1870,2.008012693397593
SIM,1897,22,15-19,1919,6
STAT,1835,26,35-39,1861,16.41228846621367
STAT,1874,40,50-100,1914,2.2066964379744434
SIM,1912,27,na,1939,7643
STAT,1890,38,na,1928,5779.044156666195
SIM,1808,87,na,1895,133
SIM,1823,49,40-44,1872,1
STAT,1866,30,20-24,1896,5.077584041218066
STAT,1873,52,50-100,1925,0.03082670489996029
STAT,1875,42,40-44,1917,4.671277064274436
SIM,1937,18,25-29,1955,89
STAT,1813,89,na,1902,93.35064790683988
STAT,1862,48,15-19,1910,6.818040108228284E-4
SIM,1864,37,35-39,1901,17
STAT,1882,18,20-24,1900,34.78767063949681
STAT,1862,36,20-24,1898,1.3370447496333115
SIM,1814,43,30-34,1857,4
STAT,1894,40,25-29,1934,1.6828208061038037
STAT,1903,45,20-24,1948,0.01965873522292048
SIM,1931,22,15-19,1953,15
SIM,1827,43,40-44,1870,5
SIM,1834,28,35-39,1862,15
SIM,1836,36,45-49,1872,8
STAT,1874,3,na,1877,6398.226027100073
STAT,1852,23,30-34,1875,33.48313032261213
STAT,1837,29,50-100,1866,1.128233885894489
SIM,1889,16,30-34,1905,7
STAT,1873,34,30-34,1907,35.521572199429855
SIM,1916,26,40-44,1942,11
SIM,1890,74,na,1964,3384
SIM,1891,16,na,1907,6536
SIM,1886,69,na,1955,3017
SIM,1921,6,na,1927,9275
SIM,1878,18,20-24,1896,28
SIM,1882,55,na,1937,4211
SIM,1920,46,na,1966,8396
STAT,1815,49,40-44,1864,0.8914393535760889
STAT,1895,27,45-49,1922,2.9219076153430894
STAT,1927,32,na,1959,9394.592557523601
STAT,1854,37,25-29,1891,4.413772648422829
SIM,1821,33,20-24,1854,6
SIM,1950,2,na,1952,9321
SIM,1811,59,na,1870,2106
STAT,1831,27,na,1858,3700.4921265165926
SIM,1827,30,35-39,1857,22
STAT,1848,35,50-100,1883,2.118113224242524
SIM,1872,36,30-34,1908,14
STAT,1916,32,25-29,1948,19.271777799742758
SIM,1853,33,40-44,1886,12
STAT,1895,6,na,1901,6874.759274041788
SIM,1928,26,na,1954,9422
STAT,1944,28,na,1972,8172.713281710809
STAT,1899,47,50-100,1946,0.38156899059754545
STAT,1932,20,15-19,1952,14.19123490424943
STAT,1940,14,na,1954,8066.121367277085
STAT,1838,49,35-39,1887,0.1900014794217895
STAT,1886,21,35-39,1907,12.478468553630822
SIM,1924,12,na,1936,9905
SIM,1894,21,35-39,1915,20
STAT,1863,41,35-39,1904,3.2158241947021478
SIM,1846,49,35-39,1895,1
STAT,1849,52,40-44,1901,0.01656396713216067
STAT,1865,39,na,1904,4279.266594316788
STAT,1917,24,40-44,1941,7.171448523911369
STAT,1880,24,20-24,1904,145.6985184774318
STAT,1847,47,35-39,1894,0.2124129388699067
SIM,1834,20,25-29,1854,112
STAT,1917,37,50-100,1954,0.8806607978026665
STAT,1923,22,15-19,1945,12.505008255712657
STAT,1866,44,40-44,1910,4.13490280594879
STAT,1956,13,na,1969,10494.300932831702
SIM,1943,15,na,1958,8090
STAT,1934,16,40-44,1950,3.830866195243576
SIM,1887,31,45-49,1918,7
SIM,1787,76,na,1863,617
STAT,1841,21,na,1862,3958.383990841243
STAT,1864,36,30-34,1900,9.667846343696112
STAT,1833,93,na,1926,38.42051510604928
SIM,1877,37,45-49,1914,8
SIM,1920,38,25-29,1958,3
SIM,1898,54,na,1952,5911
SIM,1873,19,na,1892,5320
SIM,1894,29,45-49,1923,4
STAT,1890,46,25-29,1936,0.08032327313914053
SIM,1892,35,45-49,1927,10
STAT,1849,49,na,1898,3484.4892943123837
SIM,1859,46,40-44,1905,1
SIM,1899,38,35-39,1937,7
SIM,1871,41,35-39,1912,7
STAT,1866,72,na,1938,2353.3790457131095
STAT,1796,60,na,1856,1970.3873318049996
STAT,1858,31,25-29,1889,16.294465769073582
STAT,1850,54,30-34,1904,0.008875881420325422
STAT,1825,41,15-19,1866,0.0325924033060808
SIM,1825,44,45-49,1869,4
STAT,1870,53,45-49,1923,0.028313586747006125
STAT,1912,38,25-29,1950,1.931730463410195
STAT,1901,43,45-49,1944,0.2917251027551334
STAT,1907,19,50-100,1926,0.14464576168591342
SIM,1874,44,40-44,1918,9
STAT,1856,23,15-19,1879,5.927526699077439
SIM,1869,73,na,1942,2126
SIM,1942,16,40-44,1958,6
SIM,1844,38,na,1882,3445
STAT,1914,46,35-39,1960,0.25892939958843797
SIM,1890,18,20-24,1908,41
SIM,1847,36,20-24,1883,2
STAT,1786,98,na,1884,1.0725081427302743
SIM,1894,40,na,1934,6301
STAT,1857,36,na,1893,3726.6225563738694
SIM,1861,18,na,1879,5015
SIM,1832,96,na,1928,8
STAT,1874,16,na,1890,5235.565459754533
SIM,1820,95,na,1915,13
SIM,1842,41,40-44,1883,7
STAT,1845,35,na,1880,3890.60640230984
STAT,1858,39,35-39,1897,11.023660922785048
STAT,1929,31,50-100,1960,2.1220483916940025
SIM,1938,27,30-34,1965,84
SIM,1927,8,na,1935,10263
STAT,1850,15,20-24,1865,33.61150720452782
STAT,1896,47,30-34,1943,0.14491690756570788
STAT,1845,44,20-24,1889,0.2428992511110465
SIM,1825,35,30-34,1860,10
STAT,1819,110,na,1929,2.8915373095365053E-4
STAT,1869,37,45-49,1906,3.901132947508213
SIM,1919,27,20-24,1946,45
STAT,1817,44,45-49,1861,7.518051523836148
SIM,1887,3,na,1890,6473
SIM,1835,61,na,1896,2497
STAT,1889,22,15-19,1911,8.215338019264205
SIM,1933,30,25-29,1963,31
STAT,1851,36,45-49,1887,3.155962727635527
SIM,1799,77,na,1876,596
STAT,1892,32,15-19,1924,0.3600487377909665
STAT,1884,35,45-49,1919,4.0133079681512696
SIM,1875,17,40-44,1892,1
STAT,1801,54,35-39,1855,0.05180175443318861
STAT,1886,34,40-44,1920,9.166473112512659
STAT,1875,23,25-29,1898,118.66593840288895
STAT,1912,43,20-24,1955,0.03420268903877414
STAT,1859,40,30-34,1899,1.8667270374921283
STAT,1884,26,30-34,1910,50.39185922215535
STAT,1909,23,50-100,1932,1.2319436447451932
SIM,1857,47,45-49,1904,1
SIM,1949,20,35-39,1969,30
STAT,1854,71,na,1925,2046.2323623726131
SIM,1894,34,40-44,1928,20
STAT,1858,85,na,1943,431.60227012262345
STAT,1862,90,na,1952,136.09468460314685
STAT,1882,27,35-39,1909,18.983269746793653
STAT,1872,41,50-100,1913,2.1540257466574997
SIM,1877,92,na,1969,223
STAT,1826,39,15-19,1865,0.1244194320234512
STAT,1828,47,25-29,1875,0.10374945583020177
STAT,1874,50,25-29,1924,0.007429838219495433
SIM,1849,44,30-34,1893,3
STAT,1760,104,na,1864,0.008117652211210125
STAT,1927,32,50-100,1959,2.053749129058107
STAT,1942,22,25-29,1964,195.60103082457113
SIM,1823,36,35-39,1859,22
SIM,1892,26,30-34,1918,81
STAT,1832,33,30-34,1865,29.353282457783852
STAT,1835,111,na,1946,1.3901078248666326E-4
SIM,1840,33,30-34,1873,55
SIM,1791,81,na,1872,277
STAT,1867,17,40-44,1884,0.3536619714024102
SIM,1858,7,na,1865,4978
SIM,1875,29,35-39,1904,29
SIM,1839,17,30-34,1856,4
SIM,1863,19,15-19,1882,11
SIM,1866,31,25-29,1897,26
STAT,1875,51,50-100,1926,0.031554181815537714
SIM,1890,27,35-39,1917,29
STAT,1908,49,15-19,1957,6.693233947280571E-4
STAT,1875,37,45-49,1912,4.145159721526856
STAT,1848,17,30-34,1865,3.2397945842226568
STAT,1948,18,35-39,1966,9.694667079211081
STAT,1865,21,15-19,1886,6.170974343777618
SIM,1870,54,na,1924,4060
STAT,1888,18,50-100,1906,0.11664040456601171
SIM,1866,49,na,1915,4305
STAT,1892,37,45-49,1929,5.040124262609229
STAT,1925,25,na,1950,8994.869379154274
STAT,1881,48,25-29,1929,0.11102706951508699
STAT,1848,21,15-19,1869,6.634172549279907
SIM,1852,41,25-29,1893,2
SIM,1868,44,40-44,1912,9
STAT,1895,35,20-24,1930,2.047855240976602
STAT,1834,41,40-44,1875,3.6560523339265596
STAT,1810,65,na,1875,1739.2046700785447
STAT,1871,26,45-49,1897,2.235485248764601
STAT,1916,26,50-100,1942,2.0856251684761635
STAT,1922,45,30-34,1967,0.2077496097157118
SIM,1862,26,45-49,1888,3
STAT,1825,46,45-49,1871,0.5188705952080049
STAT,1879,79,na,1958,1709.0569478355178
STAT,1899,37,30-34,1936,3.1831573252280045
STAT,1844,37,50-100,1881,2.09516776803689
STAT,1890,26,30-34,1916,62.290342546274815
SIM,1856,21,15-19,1877,6
STAT,1829,40,45-49,1869,2.540953466456688
STAT,1810,51,50-100,1861,0.09526169271650435
SIM,1863,30,45-49,1893,4
STAT,1854,26,45-49,1880,1.9749884771622226
STAT,1818,51,25-29,1869,0.015276176774547963
STAT,1886,17,na,1903,5384.447218924688
SIM,1841,89,na,1930,112
SIM,1816,46,45-49,1862,1
STAT,1877,45,50-100,1922,0.5201970016582071
SIM,1898,34,25-29,1932,38
STAT,1845,30,50-100,1875,1.713953472247549
STAT,1849,46,30-34,1895,0.15355280149250897
STAT,1882,52,25-29,1934,0.0069314472432774376
SIM,1856,17,30-34,1873,6
STAT,1949,22,35-39,1971,22.188471638656484
STAT,1840,35,30-34,1875,9.289786912217552
STAT,1886,29,45-49,1915,2.350184364852403
STAT,1839,39,25-29,1878,5.26195010350862
STAT,1828,44,20-24,1872,0.2895513138699591
STAT,1854,55,na,1909,3169.778594556148
SIM,1876,1,na,1877,7105
STAT,1879,31,45-49,1910,3.6988387448416304
STAT,1938,33,15-19,1971,0.2608395826482406
STAT,1819,38,45-49,1857,10.835932929902524
SIM,1837,40,45-49,1877,8
STAT,1897,24,15-19,1921,8.85042932191398
SIM,1851,34,45-49,1885,4
SIM,1857,88,na,1945,234
SIM,1853,74,na,1927,1676
STAT,1830,28,25-29,1858,92.1244801987904
STAT,1888,45,30-34,1933,0.23337155244025556
SIM,1925,24,40-44,1949,11
STAT,1857,37,50-100,1894,1.9327088933262009
STAT,1843,34,45-49,1877,2.8763284630823835
STAT,1844,100,na,1944,1.7144654637437058
STAT,1883,84,na,1967,1237.659877140336
STAT,1844,41,25-29,1885,1.075784847228372
SIM,1847,39,25-29,1886,7
SIM,1906,19,35-39,1925,3
SIM,1836,44,20-24,1880,1
STAT,1820,54,45-49,1874,0.04991006305855988
SIM,1827,38,45-49,1865,6
STAT,1795,59,na,1854,2095.0000000000005
STAT,1834,24,50-100,1858,0.7155922064566594
SIM,1862,37,25-29,1899,7
STAT,1829,29,15-19,1858,0.9859512193571768
STAT,1869,45,20-24,1914,0.02371739349228837
STAT,1819,49,25-29,1868,0.23455304806190558
STAT,1828,36,45-49,1864,4.097648234127963
STAT,1866,40,na,1906,4350.407090066442
STAT,1859,18,45-49,1877,0.12117113246710634
STAT,1937,17,20-24,1954,266.42608134597754
STAT,1891,1,na,1892,6794.818750398667
STAT,1907,12,na,1919,7665.822929093219
STAT,1838,54,30-34,1892,0.00783467385632008
STAT,1881,36,30-34,1917,10.453842906247084
STAT,1915,31,na,1946,7811.746319155124
SIM,1932,31,na,1963,10213
STAT,1881,40,15-19,1921,0.027229924832738107
STAT,1960,2,na,1962,10349.241394578421
SIM,1888,24,15-19,1912,8
STAT,1838,30,45-49,1868,2.994206390185543
STAT,1860,25,30-34,1885,42.348868783910525
STAT,1845,36,45-49,1881,3.2612372803640195
STAT,1874,91,na,1965,320.3289352983193
SIM,1832,25,20-24,1857,24
SIM,1929,21,20-24,1950,297
STAT,1855,30,45-49,1885,2.7336292611891686
STAT,1899,24,25-29,1923,157.4148927576629
STAT,1819,54,20-24,1873,0.0028568704266420694
STAT,1843,25,30-34,1868,44.04267822923439
STAT,1808,51,40-44,1859,0.06377159221852156
STAT,1865,29,25-29,1894,77.06039257424995
STAT,1927,2,na,1929,10268.672292838075
STAT,1918,40,35-39,1958,0.43351910961015516
STAT,1885,42,25-29,1927,1.2893364909689171
SIM,1851,25,30-34,1876,59
STAT,1815,96,na,1911,7.981295664183221
STAT,1866,42,15-19,1908,0.02570265423494938
SIM,1861,93,na,1954,26
STAT,1886,45,20-24,1931,0.02583836642766729
STAT,1954,17,20-24,1971,338.45452984380006
STAT,1891,16,20-24,1907,44.36588479212013
STAT,1814,45,30-34,1859,0.5173640190661144
STAT,1929,43,15-19,1972,0.004009802088955331
SIM,1848,18,35-39,1866,2
STAT,1845,19,na,1864,4418.113370771638
SIM,1906,24,30-34,1930,63
STAT,1807,61,na,1868,2157.4581055441554
STAT,1820,59,na,1879,2326.1746153924055
STAT,1896,31,45-49,1927,4.668778787257283
SIM,1904,8,na,1912,7662
SIM,1867,18,45-49,1885,2
SIM,1945,17,20-24,1962,287
STAT,1835,51,25-29,1886,0.004770792751991895
SIM,1898,47,30-34,1945,1
SIM,1853,36,45-49,1889,7
SIM,1883,37,45-49,1920,5
SIM,1886,85,na,1971,1033
SIM,1882,71,na,1953,2565
STAT,1823,35,30-34,1858,22.147467931305282
STAT,1790,71,na,1861,1093.7644808009588
STAT,1853,39,50-100,1892,1.9229856240963275
STAT,1788,107,na,1895,0.0029335801122778306
STAT,1846,52,na,1898,3280.469522972407
SIM,1873,21,15-19,1894,8
SIM,1884,27,35-39,1911,2
STAT,1860,34,45-49,1894,2.8355265549022115
STAT,1808,46,45-49,1854,1.5364981854937374
STAT,1849,33,25-29,1882,16.896224418833725
SIM,1941,19,50-100,1960,1
STAT,1938,21,20-24,1959,222.36792695565686
SIM,1896,47,na,1943,6287
SIM,1892,33,na,1925,6811
SIM,1926,40,35-39,1966,1
STAT,1929,39,na,1968,9733.112129427407
STAT,1939,28,35-39,1967,30.471256197980413
STAT,1866,39,50-100,1905,2.2648473112117644
STAT,1848,29,25-29,1877,81.62024356889751
STAT,1817,106,na,1923,0.012246417267060172
SIM,1856,29,25-29,1885,85
SIM,1883,20,20-24,1903,134
STAT,1899,46,45-49,1945,0.3694174851706456
STAT,1881,43,50-100,1924,2.047382498280301
SIM,1831,35,30-34,1866,15
SIM,1812,76,na,1888,776
SIM,1846,30,45-49,1876,4
SIM,1878,34,na,1912,5154
STAT,1918,25,50-100,1943,2.1534694723167394
STAT,1936,34,50-100,1970,1.6201402554545221
SIM,1799,61,na,1860,1780
STAT,1884,48,50-100,1932,0.4836385630761686
STAT,1890,22,na,1912,5830.213605366823
SIM,1881,38,na,1919,4006
SIM,1946,21,20-24,1967,237
STAT,1876,27,35-39,1903,20.15525808572637
SIM,1857,33,25-29,1890,23
STAT,1875,45,45-49,1920,0.49561930905254403
STAT,1943,17,45-49,1960,1.069812696042167
STAT,1836,43,40-44,1879,3.5132082591169347
STAT,1864,20,45-49,1884,1.2976930798720117
STAT,1885,17,35-39,1902,1.1030678947365253
SIM,1855,44,30-34,1899,5
SIM,1815,41,na,1856,2877
STAT,1871,18,45-49,1889,0.13114009766412718
SIM,1869,9,na,1878,5298
STAT,1902,15,50-100,1917,0.1403418386443708
SIM,1899,12,na,1911,7249
SIM,1843,23,30-34,1866,38
STAT,1876,52,25-29,1928,0.007359380652505879
SIM,1819,55,na,1874,2409
SIM,1866,42,40-44,1908,12
SIM,1931,34,50-100,1965,2
SIM,1929,37,30-34,1966,6
STAT,1913,21,50-100,1934,1.2919255179331497
STAT,1925,26,40-44,1951,11.154347950223572
STAT,1873,37,35-39,1910,14.514031799673782
STAT,1942,30,25-29,1972,19.907138493619247
SIM,1893,30,30-34,1923,55
SIM,1868,31,35-39,1899,24
STAT,1909,17,45-49,1926,0.1979523729951083
STAT,1899,45,30-34,1944,0.15260114628841182
SIM,1938,22,25-29,1960,203
STAT,1847,42,na,1889,3542.768676171167
STAT,1857,54,40-44,1911,0.016116858161908477
SIM,1888,28,na,1916,5560
STAT,1894,68,na,1962,4329.008070896088
STAT,1847,44,30-34,1891,1.728832094960989
STAT,1830,33,20-24,1863,5.265057898622277
SIM,1879,34,15-19,1913,5
STAT,1890,34,30-34,1924,42.6724267230206
STAT,1898,16,30-34,1914,4.366883890557946
STAT,1828,39,na,1867,3340.087063259417
STAT,1885,30,30-34,1915,35.38133558348321
STAT,1813,50,35-39,1863,0.05269964926528299
STAT,1888,83,na,1971,1812.6841242143312
SIM,1875,21,25-29,1896,131
SIM,1874,20,na,1894,4616
STAT,1910,38,15-19,1948,0.0369219202182357
SIM,1851,26,50-100,1877,1
STAT,1835,23,30-34,1858,30.45934675905814
STAT,1843,26,50-100,1869,1.11077713294624
STAT,1808,54,45-49,1862,0.0826705061827129
STAT,1902,28,15-19,1930,1.2891093035794745
SIM,1821,36,25-29,1857,6
SIM,1942,20,25-29,1962,222
SIM,1854,29,15-19,1883,1
STAT,1823,43,30-34,1866,3.7323237855067117
SIM,1910,28,15-19,1938,3
STAT,1867,29,35-39,1896,18.119782867275283
SIM,1838,69,na,1907,1957
SIM,1912,1,na,1913,8475
SIM,1858,17,40-44,1875,1
STAT,1854,34,20-24,1888,4.156237990935982
SIM,1877,34,40-44,1911,13
STAT,1861,52,40-44,1913,0.017602856606048174
SIM,1881,37,35-39,1918,20
SIM,1866,23,25-29,1889,127
STAT,1869,34,40-44,1903,8.414032301715118
SIM,1831,43,30-34,1874,5
STAT,1828,32,50-100,1860,2.0538876695651265
SIM,1839,25,30-34,1864,53
STAT,1928,27,20-24,1955,45.41171310545497
SIM,1883,45,45-49,1928,2
SIM,1875,35,45-49,1910,3
SIM,1840,100,na,1940,2
SIM,1903,38,25-29,1941,5
STAT,1923,34,50-100,1957,1.911189572970728
SIM,1928,17,20-24,1945,385
SIM,1899,26,40-44,1925,12
SIM,1911,53,na,1964,7076
SIM,1936,27,20-24,1963,34
STAT,1868,20,50-100,1888,0.7949545989070642
STAT,1903,48,25-29,1951,0.09225650603336338
STAT,1841,25,20-24,1866,21.448433828831924
SIM,1833,22,na,1855,3746
STAT,1774,81,na,1855,281.6364
STAT,1858,23,25-29,1881,93.42724832261275
STAT,1867,21,25-29,1888,109.50807649848964
SIM,1841,15,20-24,1856,28
STAT,1853,53,45-49,1906,0.022592890116722508
SIM,1891,44,40-44,1935,1
STAT,1866,33,25-29,1899,19.006338800756886
STAT,1834,22,25-29,1856,101.91304085382062
STAT,1829,43,50-100,1872,1.7121612735971024
STAT,1774,97,na,1871,1.3515390775213372
STAT,1877,40,na,1917,4895.943762830264
STAT,1894,43,50-100,1937,0.18895571673349332
SIM,1899,35,30-34,1934,20
STAT,1926,15,na,1941,9154.909273388168
SIM,1849,39,35-39,1888,19
STAT,1930,39,30-34,1969,4.790971205586512
SIM,1873,27,35-39,1900,29
SIM,1900,3,na,1903,7725
SIM,1849,47,35-39,1896,1
STAT,1820,40,25-29,1860,2.745698809613995
STAT,1875,20,20-24,1895,144.14827218448943
STAT,1825,90,na,1915,91.22135180846848
STAT,1874,75,na,1949,2128.8398763433534
SIM,1876,42,25-29,1918,3
SIM,1898,70,na,1968,4476
STAT,1904,31,na,1935,6945.563057289634
STAT,1862,25,40-44,1887,5.2653476020654395
STAT,1812,52,45-49,1864,0.09620936841210775
STAT,1895,24,40-44,1919,5.449485362324775
STAT,1871,38,15-19,1909,0.11211610366882356
STAT,1870,61,na,1931,3705.181533295407
STAT,1901,35,45-49,1936,1.2281044255358928
STAT,1892,39,50-100,1931,3.0728556383301444
STAT,1810,44,35-39,1854,12.725674644852136
SIM,1857,44,40-44,1901,7
STAT,1845,28,45-49,1873,2.067525312109005
SIM,1890,24,30-34,1914,52
SIM,1836,33,40-44,1869,11
STAT,1846,29,15-19,1875,0.828676799376197
SIM,1893,23,na,1916,6178
SIM,1840,28,35-39,1868,29
SIM,1870,25,40-44,1895,9
STAT,1841,80,na,1921,897.5398385905456
SIM,1906,16,30-34,1922,4
SIM,1862,34,20-24,1896,5
SIM,1885,47,20-24,1932,1
STAT,1828,33,40-44,1861,9.431191685756566
STAT,1917,1,na,1918,9045.52383894976
SIM,1840,36,35-39,1876,22
STAT,1832,28,35-39,1860,16.75731326692536
STAT,1803,110,na,1913,1.9501946360159288E-4
STAT,1903,46,na,1949,6489.132075644784
STAT,1871,34,20-24,1905,5.377292170629853
SIM,1858,25,40-44,1883,11
SIM,1803,56,na,1859,2321
SIM,1933,26,40-44,1959,18
STAT,1882,24,30-34,1906,34.824446181254494
STAT,1870,37,50-100,1907,2.4344018082513807
STAT,1834,44,45-49,1878,2.340964923595043
STAT,1889,27,20-24,1916,29.214045425362727
SIM,1844,43,40-44,1887,12
STAT,1821,35,20-24,1856,3.4371111131293217
SIM,1916,30,25-29,1946,21
STAT,1916,32,na,1948,7885.946393470615
STAT,1845,94,na,1939,30.79726026976204
SIM,1842,22,25-29,1864,5
STAT,1856,28,20-24,1884,18.8066423555645
STAT,1916,40,25-29,1956,0.14820206960193172
STAT,1839,23,15-19,1862,6.57114572531458
STAT,1868,7,na,1875,5321.025671276386
SIM,1908,24,40-44,1932,7
STAT,1852,26,35-39,1878,18.041581717215028
SIM,1930,23,50-100,1953,6
SIM,1860,26,35-39,1886,24
SIM,1842,44,45-49,1886,6
SIM,1878,41,45-49,1919,8
STAT,1821,104,na,1925,0.07393340194864058
SIM,1897,27,20-24,1924,37
SIM,1939,26,na,1965,7790
STAT,1895,38,25-29,1933,7.539401412763791
STAT,1824,73,na,1897,1269.8690922359199
SIM,1845,87,na,1932,203
STAT,1844,16,35-39,1860,1.1330819096148255
SIM,1853,58,na,1911,3170
SIM,1845,23,na,1868,4256
SIM,1774,85,na,1859,153
STAT,1807,77,na,1884,794.4289155482861
STAT,1897,37,20-24,1934,2.0810159741135363
SIM,1852,16,35-39,1868,1
STAT,1873,46,25-29,1919,0.11853401889087763
SIM,1841,73,na,1914,1538
SIM,1864,28,20-24,1892,23
STAT,1890,45,50-100,1935,0.6114782962873619
STAT,1908,30,25-29,1938,17.773224767581077
STAT,1906,26,30-34,1932,74.36324823626217
STAT,1923,30,15-19,1953,0.29982142658847744
SIM,1850,43,40-44,1893,9
STAT,1873,29,35-39,1902,19.65862735309635
STAT,1872,19,15-19,1891,11.98100003910891
STAT,1843,87,na,1930,246.79716358426134
STAT,1900,44,50-100,1944,0.20275898649660506
STAT,1852,18,35-39,1870,1.0514908895572508
STAT,1812,49,15-19,1861,0.002685672682860164
STAT,1817,43,30-34,1860,6.003008775650116
STAT,1922,48,35-39,1970,0.29822540302053824
SIM,1883,34,40-44,1917,15
STAT,1851,31,15-19,1882,0.2321677011473151
SIM,1898,31,20-24,1929,9
STAT,1832,30,50-100,1862,1.5910997287232373
STAT,1901,21,25-29,1922,162.34312030795132
STAT,1881,45,20-24,1926,0.02365851316095315
SIM,1932,17,35-39,1949,13
STAT,1894,52,na,1946,5556.585619527221
SIM,1862,23,40-44,1885,4
SIM,1867,66,na,1933,3177
STAT,1767,115,na,1882,3.148426559825855E-4
STAT,1854,51,35-39,1905,0.013260723621816248
SIM,1829,28,50-100,1857,2
STAT,1836,35,40-44,1871,7.2956198672101324
STAT,1933,28,na,1961,10042.069162661306
STAT,1810,81,na,1891,489.04187343044623
STAT,1924,17,35-39,1941,10.089105902861188
SIM,1868,103,na,1971,2
STAT,1859,41,50-100,1900,1.7059190944059524
STAT,1899,24,50-100,1923,1.1213485482334777
STAT,1849,49,35-39,1898,0.2168280117546556
STAT,1856,36,20-24,1892,1.206945896627364
STAT,1805,51,15-19,1856,1.970745078557631E-4
SIM,1838,38,20-24,1876,3
STAT,1845,20,35-39,1865,11.325156630630325
SIM,1869,38,25-29,1907,7
STAT,1875,34,40-44,1909,8.94035354908191
STAT,1884,34,30-34,1918,34.521289050493294
STAT,1870,100,na,1970,15.621069701512017
STAT,1820,51,40-44,1871,0.03843469920348308
SIM,1866,36,30-34,1902,18
STAT,1840,38,35-39,1878,11.95041536294131
STAT,1872,42,15-19,1914,0.02799586059646407
SIM,1896,48,35-39,1944,1
SIM,1919,22,15-19,1941,11
STAT,1826,33,50-100,1859,2.576821870332221
STAT,1840,52,20-24,1892,0.0010594723150618803
STAT,1842,43,40-44,1885,3.4205446061173106
SIM,1823,33,30-34,1856,42
SIM,1832,26,35-39,1858,18
SIM,1844,35,40-44,1879,10
SIM,1925,27,45-49,1952,5
STAT,1816,53,40-44,1869,0.04863981538877356
STAT,1913,16,20-24,1929,56.13443550206827
SIM,1905,32,15-19,1937,1
SIM,1892,34,30-34,1926,65
STAT,1863,34,50-100,1897,1.6059627792342754
STAT,1832,36,35-39,1868,11.776051306203367
STAT,1838,48,20-24,1886,0.016495833651022068
STAT,1858,27,40-44,1885,4.828025135184198
STAT,1938,24,25-29,1962,184.53454093760502
STAT,1877,47,20-24,1924,0.025048574683930017
STAT,1849,41,25-29,1890,1.0203589591249778
STAT,1873,23,15-19,1896,6.748863825878128
SIM,1879,51,na,1930,4446
SIM,1838,40,50-100,1878,5
SIM,1856,26,20-24,1882,27
STAT,1861,35,50-100,1896,2.083446486187434
STAT,1910,3,na,1913,8093.3234362257845
STAT,1857,15,30-34,1872,2.9840641764643983
SIM,1849,31,25-29,1880,21
SIM,1860,18,35-39,1878,1
STAT,1915,47,na,1962,7477.113637053315
STAT,1897,29,20-24,1926,31.444361203289574
STAT,1903,26,50-100,1929,1.8457879705327234
STAT,1911,33,na,1944,7408.683751547104
STAT,1881,20,45-49,1901,1.3693502491142067
SIM,1816,43,40-44,1859,9
SIM,1825,43,30-34,1868,6
SIM,1866,27,40-44,1893,7
STAT,1867,35,45-49,1902,3.806338971537813
SIM,1880,19,15-19,1899,15
SIM,1867,40,30-34,1907,9
SIM,1840,30,50-100,1870,3
SIM,1897,4,na,1901,7269
SIM,1807,49,50-100,1856,1
SIM,1808,55,na,1863,2431
STAT,1891,17,35-39,1908,1.3697876804565785
SIM,1911,26,50-100,1937,3
STAT,1869,21,na,1890,4642.230232981253
STAT,1923,49,40-44,1972,0.3701922798760996
STAT,1826,28,35-39,1854,74.15779815591556
STAT,1897,25,50-100,1922,1.7386565220653445
SIM,1862,35,na,1897,4354
STAT,1876,24,30-34,1900,36.974436429436764
STAT,1919,36,50-100,1955,0.9115958644797472
STAT,1939,25,30-34,1964,79.63173780366628
SIM,1921,16,20-24,1937,306
STAT,1860,28,35-39,1888,15.879760972819675
SIM,1864,3,na,1867,5859
SIM,1891,7,na,1898,6724
STAT,1860,31,40-44,1891,7.141640764433606
SIM,1861,53,45-49,1914,1
SIM,1805,53,30-34,1858,1
STAT,1862,33,40-44,1895,7.454454287716087
SIM,1928,10,na,1938,10284
SIM,1857,72,na,1929,2189
STAT,1860,24,na,1884,3941.3533324575196
STAT,1883,44,40-44,1927,4.40293363431475
STAT,1951,16,40-44,1967,3.364554285068189
SIM,1921,31,na,1952,8484
SIM,1933,4,na,1937,11400
STAT,1931,6,na,1937,10595.640336336879
STAT,1855,72,na,1927,1904.3626442157954
SIM,1865,15,30-34,1880,4
STAT,1843,33,30-34,1876,29.099336251444
STAT,1859,86,na,1945,356.66356580451236
SIM,1857,30,20-24,1887,7
SIM,1833,38,na,1871,3423
SIM,1850,93,na,1943,35
SIM,1903,50,na,1953,6410
SIM,1884,24,30-34,1908,1
STAT,1830,37,15-19,1867,0.10523946035004034
SIM,1879,39,20-24,1918,1
SIM,1821,96,na,1917,5
STAT,1880,41,35-39,1921,3.87007080970501
SIM,1907,64,na,1971,5801
SIM,1798,76,na,1874,715
SIM,1794,62,na,1856,1754
STAT,1934,20,25-29,1954,251.55906548320442
SIM,1828,75,na,1903,1169
SIM,1869,14,na,1883,5165
STAT,1852,29,15-19,1881,0.755474265332472
SIM,1946,24,25-29,1970,224
STAT,1816,38,na,1854,3094.821082584609
STAT,1893,19,35-39,1912,1.397095756758373
SIM,1842,33,40-44,1875,10
SIM,1851,33,30-34,1884,38
STAT,1861,41,25-29,1902,1.0843557162885187
STAT,1917,27,45-49,1944,3.6587904710939116
SIM,1883,23,25-29,1906,122
STAT,1804,96,na,1900,5.776406737948355
STAT,1869,48,25-29,1917,0.11130338910439302
STAT,1939,0,na,1939,9088.804607057753
STAT,1848,26,20-24,1874,23.13039883049317
SIM,1867,27,35-39,1894,24
SIM,1918,21,45-49,1939,7
STAT,1880,27,25-29,1907,89.99936151015949
STAT,1959,7,na,1966,10381.960126810412
SIM,1888,38,35-39,1926,24
STAT,1857,40,20-24,1897,0.252525608122936
STAT,1870,18,na,1888,5025.768215387397
STAT,1849,107,na,1956,0.009487233564386764
STAT,1888,48,35-39,1936,0.1861418528592821
STAT,1921,36,25-29,1957,2.2218396901797135
SIM,1882,19,25-29,1901,16
STAT,1904,49,30-34,1953,0.1549758635232482
SIM,1877,48,25-29,1925,1
SIM,1788,93,na,1881,10
STAT,1938,28,50-100,1966,1.9909132179432647
STAT,1915,20,15-19,1935,10.728532531468796
STAT,1841,39,40-44,1880,7.329450766389628
SIM,1872,44,30-34,1916,7
STAT,1831,41,15-19,1872,0.022151084864847875
SIM,1940,16,30-34,1956,35
STAT,1849,30,20-24,1879,5.0550115575290855
STAT,1899,28,40-44,1927,8.259962913667605
STAT,1881,39,35-39,1920,13.667957081480818
STAT,1864,44,30-34,1908,2.0474915260800772
SIM,1885,6,na,1891,5444
STAT,1932,16,30-34,1948,32.67876973211608
STAT,1940,30,na,1970,7914.8431895604035
STAT,1952,9,na,1961,9509.920624794597
STAT,1868,50,25-29,1918,0.006903877345252757
SIM,1906,27,35-39,1933,35
STAT,1861,41,na,1902,3902.793110189824
STAT,1836,46,20-24,1882,0.016916422078316243
STAT,1850,41,na,1891,3559.7886938841593
STAT,1865,55,na,1920,3793.864087571778
SIM,1954,7,na,1961,9927
STAT,1857,20,na,1877,3942.066912700192
STAT,1877,36,40-44,1913,9.224501295583593
STAT,1786,82,na,1868,295.4548875715759
STAT,1814,48,35-39,1862,0.7140857909272871
STAT,1876,15,40-44,1891,0.3838339345157063
STAT,1814,54,20-24,1868,0.0035208091772687376
STAT,1841,17,20-24,1858,33.1757288260539
STAT,1854,23,40-44,1877,3.726420154731958
SIM,1881,29,35-39,1910,25
SIM,1923,20,15-19,1943,13
STAT,1854,18,45-49,1872,0.11908405883355792
STAT,1850,16,35-39,1866,1.034169834770337
SIM,1835,48,45-49,1883,1
STAT,1851,35,30-34,1886,8.525520853447219
STAT,1897,3,na,1900,7136.885664945977
SIM,1894,47,50-100,1941,1
SIM,1828,50,45-49,1878,1
STAT,1857,19,25-29,1876,10.3615704808291
STAT,1874,16,20-24,1890,36.75113295216336
SIM,1819,71,na,1890,1288
STAT,1948,5,na,1953,9137.403723408292
SIM,1854,27,25-29,1881,76
STAT,1920,48,25-29,1968,0.11806779058519169
STAT,1872,46,30-34,1918,0.19703672153670265
STAT,1894,39,45-49,1933,5.119842729784888
STAT,1853,31,25-29,1884,16.862876425830827
STAT,1899,48,35-39,1947,0.215779750629581
STAT,1887,41,45-49,1928,3.395896283163741
SIM,1864,40,50-100,1904,2
SIM,1869,102,na,1971,5
SIM,1801,97,na,1898,5
STAT,1858,21,na,1879,3890.2954832319156
STAT,1895,27,20-24,1922,30.872845610988
SIM,1858,29,35-39,1887,23
STAT,1931,25,50-100,1956,2.5976463650668333
STAT,1806,60,na,1866,1978.0268411368731
STAT,1839,28,20-24,1867,22.910652424365196
STAT,1886,49,15-19,1935,8.349709906761982E-4
SIM,1921,39,30-34,1960,4
STAT,1942,26,40-44,1968,9.884661983602399
STAT,1879,49,20-24,1928,0.024820443377682445
SIM,1849,36,50-100,1885,3
STAT,1884,53,na,1937,4225.169782264973
STAT,1919,24,15-19,1943,11.696149254216614
SIM,1870,43,45-49,1913,5
SIM,1871,34,50-100,1905,3
SIM,1849,35,40-44,1884,10
SIM,1852,19,15-19,1871,11
SIM,1824,45,na,1869,3227
STAT,1859,27,35-39,1886,15.778275497288774
SIM,1911,49,50-100,1960,2
STAT,1800,82,na,1882,365.92578802768696
STAT,1888,67,na,1955,3784.0182065355134
STAT,1899,43,40-44,1942,0.42908916780804884
SIM,1947,16,40-44,1963,3
STAT,1812,45,20-24,1857,0.08622984518194281
SIM,1811,47,50-100,1858,1
SIM,1889,34,na,1923,5935
SIM,1885,20,na,1905,4982
STAT,1827,48,45-49,1875,0.4205602981106294
STAT,1842,52,30-34,1894,0.008815063154182543
STAT,1840,31,15-19,1871,0.2529802629195568
SIM,1880,46,30-34,1926,1
SIM,1865,19,25-29,1884,18
STAT,1846,27,25-29,1873,78.38408447326957
STAT,1873,90,na,1963,356.36584088558976
SIM,1855,20,45-49,1875,2
SIM,1960,3,na,1963,10830
SIM,1872,18,na,1890,5381
STAT,1855,49,35-39,1904,0.2067029806049641
STAT,1872,68,na,1940,3101.8444666639325
SIM,1901,33,45-49,1934,8
STAT,1849,42,15-19,1891,0.02181747032357136
SIM,1873,18,20-24,1891,31
SIM,1805,63,na,1868,1756
STAT,1814,41,15-19,1855,0.08282141699930072
SIM,1788,77,na,1865,592
STAT,1834,38,35-39,1872,11.590073925441565
STAT,1859,101,na,1960,2.0912972692591847
STAT,1844,45,40-44,1889,0.2808332471950166
STAT,1864,2,na,1866,6146.163981034969
SIM,1809,77,na,1886,672
STAT,1902,16,45-49,1918,0.18671452458150153
STAT,1843,16,40-44,1859,0.32936361655919205
SIM,1855,22,na,1877,4426
STAT,1943,29,15-19,1972,1.5168943348516817
SIM,1882,40,50-100,1922,5
SIM,1892,17,na,1909,7257
STAT,1833,54,30-34,1887,0.007764763492675807
SIM,1894,48,25-29,1942,1
SIM,1842,38,35-39,1880,4
SIM,1859,36,na,1895,4229
SIM,1882,16,20-24,1898,33
SIM,1891,75,na,1966,3421
STAT,1827,40,35-39,1867,3.567506262651649
STAT,1886,48,25-29,1934,0.12125690596041368
STAT,1836,46,45-49,1882,0.33268962158122095
STAT,1920,19,50-100,1939,0.8441821332126898
STAT,1910,30,40-44,1940,7.684675487744654
STAT,1899,21,20-24,1920,191.2661373664559
STAT,1900,17,na,1917,7075.800058615592
SIM,1847,37,35-39,1884,22
STAT,1865,18,20-24,1883,33.32260237451963
STAT,1793,95,na,1888,5.203197821200842
STAT,1894,31,35-39,1925,26.38099845443196
STAT,1847,20,45-49,1867,1.32199668397454
SIM,1863,101,na,1964,8
STAT,1901,32,40-44,1933,12.261497778109554
SIM,1881,54,na,1935,3576
STAT,1939,16,40-44,1955,2.828740519650551
STAT,1882,19,35-39,1901,1.0737392541619457
STAT,1843,31,40-44,1874,7.379485674436598
STAT,1816,81,na,1897,531.167293235812
SIM,1803,83,na,1886,354
SIM,1881,43,20-24,1924,1
SIM,1913,17,na,1930,8174
STAT,1898,41,20-24,1939,0.030277701253780584
STAT,1850,29,40-44,1879,5.327713972444056
SIM,1826,29,15-19,1855,4
SIM,1780,97,na,1877,3
SIM,1845,29,25-29,1874,100
STAT,1853,30,35-39,1883,16.84668658620328
SIM,1882,15,30-34,1897,4
SIM,1943,5,na,1948,8711
STAT,1921,5,na,1926,9253.968144568134
SIM,1887,54,na,1941,5070
SIM,1888,36,50-100,1924,8
SIM,1933,32,na,1965,10727
STAT,1917,39,15-19,1956,0.040035032072083816
STAT,1882,17,50-100,1899,0.09638645932424099
SIM,1927,24,15-19,1951,14
STAT,1843,36,35-39,1879,11.687294934970813
SIM,1828,37,25-29,1865,7
STAT,1888,47,20-24,1935,0.028511239171638975
STAT,1823,37,20-24,1860,2.9911310068887293
STAT,1818,88,na,1906,140.84512893926222
SIM,1884,40,30-34,1924,5
SIM,1835,30,50-100,1865,4
STAT,1876,40,30-34,1916,2.425727635951538
STAT,1940,32,50-100,1972,1.7283069092718226
SIM,1925,20,25-29,1945,219
STAT,1904,7,na,1911,7552.249433481639
SIM,1894,30,25-29,1924,40
STAT,1841,18,35-39,1859,1.0207616632497765
SIM,1844,46,45-49,1890,2
SIM,1883,40,na,1923,4847
STAT,1821,39,15-19,1860,0.19490827131221466
SIM,1847,28,20-24,1875,24
SIM,1861,38,45-49,1899,3
SIM,1921,47,na,1968,8368
STAT,1884,17,40-44,1901,0.36475816827942287
STAT,1916,16,na,1932,8296.198214972484
STAT,1919,37,20-24,1956,0.571832487433862
SIM,1880,41,50-100,1921,8
STAT,1837,29,25-29,1866,74.60757278524738
SIM,1903,18,na,1921,7423
SIM,1860,92,na,1952,51
SIM,1863,49,35-39,1912,1
STAT,1890,28,20-24,1918,28.81805887230278
SIM,1790,96,na,1886,2
SIM,1862,26,20-24,1888,22
STAT,1847,46,20-24,1893,0.018344037397008003
STAT,1874,15,30-34,1889,3.323657573943418
SIM,1861,31,25-29,1892,21
SIM,1914,50,na,1964,7399
STAT,1939,17,30-34,1956,24.643549990534936
STAT,1854,26,20-24,1880,20.86770780114144
SIM,1914,26,30-34,1940,93
SIM,1916,34,40-44,1950,17
STAT,1827,100,na,1927,1.2837776899742899
SIM,1851,31,40-44,1882,12
STAT,1853,38,45-49,1891,3.138453245676768
STAT,1892,36,30-34,1928,13.539604356224185
STAT,1925,44,45-49,1969,0.40550655386980555
STAT,1823,46,35-39,1869,0.43878216908876694
STAT,1906,49,40-44,1955,0.2782692868421479
STAT,1840,36,na,1876,3694.7358601017327
SIM,1884,16,30-34,1900,4
STAT,1895,19,45-49,1914,0.170982809897226
SIM,1858,21,25-29,1879,117
SIM,1831,37,20-24,1868,2
STAT,1862,43,45-49,1905,2.5648394888350325
SIM,1836,28,45-49,1864,3
SIM,1879,35,na,1914,4884
STAT,1896,43,15-19,1939,0.002538587523935884
SIM,1947,17,30-34,1964,40
SIM,1837,95,na,1932,8
STAT,1884,22,15-19,1906,6.579146203880686
SIM,1833,81,na,1914,644
SIM,1820,34,40-44,1854,1
STAT,1910,49,30-34,1959,0.16705477206162514
SIM,1859,42,25-29,1901,5
STAT,1814,108,na,1922,0.0015764354912063086
SIM,1892,22,15-19,1914,9
STAT,1920,21,na,1941,8222.062819500676
SIM,1908,25,50-100,1933,3
STAT,1887,28,25-29,1915,95.2138030488492
STAT,1825,45,30-34,1870,0.21577565101558804
SIM,1927,37,20-24,1964,1
SIM,1895,28,25-29,1923,135
SIM,1862,62,na,1924,3330
STAT,1920,16,15-19,1936,103.0624682436301
SIM,1861,30,35-39,1891,30
STAT,1808,48,35-39,1856,0.868412595291321
STAT,1845,48,15-19,1893,6.086289956286809E-4
STAT,1759,104,na,1863,0.026520475060309474
STAT,1890,37,35-39,1927,17.435854329587116
STAT,1828,28,45-49,1856,3.169073820651768
STAT,1947,23,15-19,1970,12.14559442997597
STAT,1875,39,35-39,1914,14.559070073589034
SIM,1885,32,25-29,1917,29
STAT,1847,39,35-39,1886,10.956421846913411
STAT,1821,42,45-49,1863,4.758457440499079
STAT,1882,17,30-34,1899,3.135773447550177
SIM,1891,30,20-24,1921,8
STAT,1908,34,40-44,1942,7.401259635483993
STAT,1887,17,45-49,1904,0.14754999558424245
STAT,1893,15,40-44,1908,0.47038489397849403
STAT,1817,41,40-44,1858,12.681746186056138
SIM,1879,21,45-49,1900,1
STAT,1832,35,20-24,1867,1.297160665348943
SIM,1885,45,50-100,1930,1
STAT,1882,26,20-24,1908,23.159624195457518
SIM,1816,48,35-39,1864,1
SIM,1924,36,40-44,1960,5
STAT,1866,53,30-34,1919,0.010914354003462983
SIM,1876,41,35-39,1917,8
SIM,1881,30,15-19,1911,1
STAT,1838,19,15-19,1857,10.484572070152607
STAT,1825,74,na,1899,1284.0650152245946
SIM,1834,24,40-44,1858,4
SIM,1883,39,35-39,1922,22
STAT,1911,18,15-19,1929,18.29871157580719
STAT,1817,46,35-39,1863,0.6867908442628435
STAT,1824,89,na,1913,112.3164990975135
STAT,1941,17,35-39,1958,8.729368430946925
STAT,1806,52,20-24,1858,0.004305941938716815
SIM,1836,20,35-39,1856,13
SIM,1875,69,na,1944,3155
STAT,1901,48,15-19,1949,6.299322532352455E-4
SIM,1823,35,20-24,1858,3
SIM,1928,16,30-34,1944,44
STAT,1868,36,na,1904,4548.861352065424
SIM,1818,41,25-29,1859,1
STAT,1845,47,25-29,1892,0.08834410053387838
SIM,1852,37,50-100,1889,5
STAT,1868,41,35-39,1909,3.4952705004549975
STAT,1873,30,15-19,1903,0.29457751347389294
SIM,1843,15,30-34,1858,3
STAT,1894,32,25-29,1926,26.573380033861156
SIM,1896,21,45-49,1917,3
STAT,1837,43,na,1880,3413.735206136721
STAT,1865,27,35-39,1892,17.70396233973036
SIM,1867,45,50-100,1912,1
SIM,1846,19,15-19,1865,13
SIM,1856,87,na,1943,222
SIM,1852,73,na,1925,1865
SIM,1938,16,15-19,1954,85
SIM,1816,40,25-29,1856,6
SIM,1829,30,45-49,1859,3
STAT,1877,13,na,1890,5407.5355047607345
SIM,1820,37,45-49,1857,6
SIM,1825,41,40-44,1866,8
STAT,1873,43,20-24,1916,0.3235390741180958
SIM,1808,46,35-39,1854,1
SIM,1859,31,50-100,1890,4
SIM,1880,17,25-29,1897,21
SIM,1835,88,na,1923,116
SIM,1831,74,na,1905,1383
SIM,1839,21,15-19,1860,7
SIM,1947,21,15-19,1968,17
STAT,1921,28,25-29,1949,147.5956287478546
SIM,1881,38,25-29,1919,5
STAT,1867,37,35-39,1904,13.37789765354065
STAT,1884,32,40-44,1916,8.64858565667248
SIM,1839,29,25-29,1868,13
SIM,1834,44,na,1878,3206
STAT,1868,20,na,1888,4610.472009336973
STAT,1880,16,20-24,1896,37.811382892096965
SIM,1850,46,45-49,1896,1
SIM,1908,39,15-19,1947,3
STAT,1757,105,na,1862,0.06652014525772765
STAT,1842,46,45-49,1888,0.3559501539528405
STAT,1868,42,25-29,1910,1.2324025275167552
SIM,1875,37,35-39,1912,26
STAT,1916,36,40-44,1952,3.1109587213941894
SIM,1813,46,50-100,1859,2
SIM,1838,39,35-39,1877,25
STAT,1806,92,na,1898,28.359735902170677
STAT,1872,17,25-29,1889,11.539822631105057
SIM,1851,36,35-39,1887,18
STAT,1864,38,20-24,1902,1.3847183738937088
SIM,1830,30,na,1860,3408
SIM,1898,49,50-100,1947,1
SIM,1828,26,45-49,1854,3
SIM,1892,32,40-44,1924,18
STAT,1909,37,15-19,1946,0.036729693190437264
SIM,1899,42,50-100,1941,1
SIM,1902,33,na,1935,7097
STAT,1868,49,45-49,1917,0.44401190703285787
STAT,1873,38,25-29,1911,5.8789691537311315
SIM,1868,72,na,1940,2434
SIM,1843,37,na,1880,3644
STAT,1856,35,na,1891,3706.034400098764
STAT,1852,21,na,1873,4077.548024763898
STAT,1893,20,15-19,1913,8.495487468370175
SIM,1854,40,45-49,1894,5
SIM,1847,73,na,1920,1878
SIM,1943,27,15-19,1970,2
SIM,1923,24,30-34,1947,94
STAT,1875,17,na,1892,5251.62308476592
SIM,1890,16,30-34,1906,8
SIM,1875,27,45-49,1902,6
SIM,1892,37,35-39,1929,30
SIM,1872,38,20-24,1910,3
STAT,1939,21,15-19,1960,10.801642151336178
STAT,1892,43,30-34,1935,2.8857041156859977
STAT,1871,24,na,1895,4715.797857139737
STAT,1887,2,na,1889,6329.699226403074
SIM,1942,24,40-44,1966,7
SIM,1864,29,35-39,1893,24
STAT,1856,29,35-39,1885,15.357096978076099
STAT,1870,45,45-49,1915,0.4726124642386362
SIM,1850,77,na,1927,1225
STAT,1827,41,25-29,1868,1.2422271043874578
STAT,1934,24,40-44,1958,9.121002746889909
SIM,1871,76,na,1947,1689
STAT,1883,47,45-49,1930,0.46610533112658525
SIM,1835,40,35-39,1875,5
SIM,1875,32,40-44,1907,14
SIM,1857,49,35-39,1906,1
STAT,1846,16,45-49,1862,0.12643408101156176
STAT,1893,27,35-39,1920,24.70008012638507
STAT,1873,15,50-100,1888,0.10172892212718526
STAT,1915,24,30-34,1939,59.63112320894042
SIM,1822,38,na,1860,3137
SIM,1929,0,na,1929,11163
STAT,1773,96,na,1869,2.798523137267594
SIM,1890,26,20-24,1916,34
STAT,1862,36,45-49,1898,3.457721710793876
STAT,1910,15,40-44,1925,0.5625464795465299
SIM,1899,27,30-34,1926,74
SIM,1820,49,50-100,1869,2
SIM,1856,35,50-100,1891,5
SIM,1877,29,45-49,1906,3
SIM,1937,30,45-49,1967,4
STAT,1826,36,35-39,1862,17.34703535260873
SIM,1868,51,na,1919,4273
STAT,1864,47,35-39,1911,0.2515650268372146
SIM,1855,47,35-39,1902,1
STAT,1877,32,25-29,1909,21.48036169312205
SIM,1918,30,35-39,1948,22
STAT,1884,37,35-39,1921,14.105318431052792
STAT,1883,30,20-24,1913,5.406720932829518
SIM,1876,49,45-49,1925,1
SIM,1855,39,35-39,1894,16
SIM,1872,47,35-39,1919,1
STAT,1803,54,45-49,1857,0.10240629249317511
SIM,1792,82,na,1874,310
SIM,1853,30,50-100,1883,3
STAT,1935,27,15-19,1962,1.943854727148044
SIM,1939,18,35-39,1957,9
SIM,1822,59,na,1881,2285
SIM,1926,25,50-100,1951,3
STAT,1900,39,20-24,1939,0.4614455160341
STAT,1764,117,na,1881,1.1007838245663301E-4
STAT,1888,21,45-49,1909,1.6695774370871912
STAT,1904,47,na,1951,6492.505196851881
STAT,1858,42,40-44,1900,3.53694117637075
STAT,1867,28,45-49,1895,2.092662445293454
SIM,1796,96,na,1892,5
SIM,1834,36,35-39,1870,8
STAT,1945,27,20-24,1972,40.4424088007427
SIM,1871,55,na,1926,3972
SIM,1835,41,25-29,1876,1
SIM,1802,98,na,1900,1
SIM,1870,36,20-24,1906,2
STAT,1821,60,na,1881,2275.3371667561028
STAT,1836,74,na,1910,1475.556209431788
SIM,1907,36,40-44,1943,5
SIM,1819,39,25-29,1858,6
STAT,1831,45,30-34,1876,0.15198044259115925
STAT,1847,53,20-24,1900,0.0011067808562215137
STAT,1846,8,na,1854,4725.0
SIM,1889,50,na,1939,5523
SIM,1924,26,50-100,1950,5
STAT,1900,33,na,1933,6657.334539772824
SIM,1821,33,50-100,1854,3
SIM,1902,65,na,1967,5524
SIM,1840,35,20-24,1875,1
STAT,1876,19,35-39,1895,1.1400297247561733
STAT,1877,54,45-49,1931,0.029597890458543687
STAT,1933,19,50-100,1952,1.0075752981199695
STAT,1846,40,45-49,1886,2.3803885658896804
STAT,1869,54,50-100,1923,0.028742419974411643
SIM,1927,22,50-100,1949,1
SIM,1877,65,na,1942,3301
SIM,1819,36,20-24,1855,2
STAT,1912,28,50-100,1940,1.9745541493606844
STAT,1912,49,40-44,1961,0.3043028264061617
STAT,1834,35,30-34,1869,9.00967152975181
STAT,1906,22,15-19,1928,9.708843648434756
SIM,1849,38,45-49,1887,8
STAT,1830,26,50-100,1856,1.5943709238175485
STAT,1860,16,40-44,1876,0.34801849749480157
SIM,1823,60,na,1883,2211
SIM,1875,21,na,1896,5296
STAT,1857,16,20-24,1873,32.99610048483832
STAT,1828,39,25-29,1867,5.568023039157743
STAT,1860,40,na,1900,3828.8734286009726
SIM,1830,89,na,1919,92
STAT,1852,51,25-29,1903,0.005672306982632052
SIM,1864,27,30-34,1891,52
SIM,1837,27,25-29,1864,87
STAT,1819,46,45-49,1865,1.00539034230971
STAT,1930,18,25-29,1948,112.85275347667924
STAT,1894,36,40-44,1930,11.411641109789883
SIM,1886,27,20-24,1913,28
SIM,1860,55,na,1915,3580
STAT,1841,32,50-100,1873,1.6129687772969732
SIM,1829,92,na,1921,34
STAT,1838,22,na,1860,3754.23461912602
STAT,1814,74,na,1888,985.550909116448
STAT,1878,27,20-24,1905,24.745158200393664
SIM,1920,49,40-44,1969,1
STAT,1864,53,20-24,1917,0.0013107834074496034
STAT,1922,41,15-19,1963,0.0035640625863683495
SIM,1833,59,na,1892,2484
STAT,1862,10,na,1872,4778.748193747195
STAT,1893,17,45-49,1910,0.1672176465672307
SIM,1841,16,35-39,1857,1
STAT,1844,40,35-39,1884,3.072713223379493
STAT,1935,31,45-49,1966,4.400140568785725
STAT,1874,19,25-29,1893,11.655468784638968
SIM,1836,39,25-29,1875,9
SIM,1905,36,30-34,1941,4
STAT,1910,33,45-49,1943,3.0524821620374394
STAT,1942,29,45-49,1971,3.6584680021097373
STAT,1930,28,50-100,1958,2.554838797924252
SIM,1895,44,50-100,1939,1
STAT,1775,82,na,1857,234.1249830315549
SIM,1842,35,30-34,1877,13
STAT,1848,108,na,1956,0.0036242009910298933
STAT,1857,113,na,1970,1.9336312478439449E-4
SIM,1879,37,30-34,1916,14
STAT,1875,32,15-19,1907,0.29611562094801713
STAT,1851,33,40-44,1884,6.924848112099957
SIM,1884,19,35-39,1903,2
STAT,1829,27,25-29,1856,122.58069436761592
SIM,1872,40,na,1912,4939
SIM,1923,27,35-39,1950,51
STAT,1872,49,35-39,1921,0.2782305510430114
SIM,1912,54,na,1966,7149
STAT,1856,27,30-34,1883,40.660947738096226
SIM,1893,45,50-100,1938,2
STAT,1862,40,40-44,1902,3.921880616897783
SIM,1880,49,35-39,1929,1
STAT,1868,46,40-44,1914,0.329899311447637
SIM,1834,26,45-49,1860,4
SIM,1870,40,40-44,1910,10
STAT,1866,47,45-49,1913,0.43773093160486887
STAT,1810,60,na,1870,2095.643878021329
STAT,1920,45,20-24,1965,0.024782121403693135
SIM,1874,47,45-49,1921,1
STAT,1880,17,na,1897,5373.411447895673
STAT,1847,49,25-29,1896,0.08596884832703944
SIM,1920,28,50-100,1948,3
SIM,1838,37,30-34,1875,15
STAT,1896,18,25-29,1914,15.070337141297998
STAT,1900,21,50-100,1921,1.1459248418735057
STAT,1905,32,na,1937,7029.178878839758
STAT,1921,33,20-24,1954,5.457616028109219
SIM,1884,38,50-100,1922,5
STAT,1850,25,na,1875,3959.962414197323
SIM,1884,20,15-19,1904,8
SIM,1876,17,35-39,1893,3
STAT,1912,46,25-29,1958,0.10324194113870647
SIM,1898,38,40-44,1936,3
STAT,1835,29,15-19,1864,0.7552188448242723
STAT,1888,41,15-19,1929,0.03311412131193348
STAT,1855,42,15-19,1897,0.020798678679235356
STAT,1841,15,30-34,1856,3.0180857270275854
SIM,1894,37,45-49,1931,9
STAT,1886,19,50-100,1905,0.10388773917038946
STAT,1834,26,40-44,1860,5.266544116231855
STAT,1908,13,na,1921,7730.077426632721
SIM,1900,69,na,1969,5013
SIM,1827,30,50-100,1857,3
SIM,1852,40,35-39,1892,6
SIM,1878,28,25-29,1906,107
SIM,1911,16,15-19,1927,20
STAT,1868,17,35-39,1885,1.0734491550666851
SIM,1843,29,15-19,1872,1
SIM,1858,73,na,1931,1920
STAT,1828,48,15-19,1876,7.110657306604018E-4
STAT,1925,41,40-44,1966,0.6123453723083518
STAT,1942,21,35-39,1963,19.94568106231704
SIM,1839,26,20-24,1865,23
STAT,1812,48,25-29,1860,0.3933372896347211
SIM,1798,92,na,1890,8
STAT,1763,97,na,1860,0.8421603780268768
SIM,1861,77,na,1938,1464
STAT,1858,48,50-100,1906,0.38181852803938404
STAT,1895,39,15-19,1934,0.14629073980058488
SIM,1832,37,na,1869,3520
SIM,1925,23,50-100,1948,4
STAT,1897,28,30-34,1925,67.74281525864308
SIM,1916,37,45-49,1953,2
STAT,1903,16,15-19,1919,17.10708338033047
STAT,1825,48,35-39,1873,0.2994462280155137
STAT,1852,17,45-49,1869,0.1259191273195575
STAT,1930,16,20-24,1946,354.86011677932805
STAT,1805,97,na,1902,4.018487581077772
SIM,1858,26,30-34,1884,48
STAT,1860,106,na,1966,0.14635903176819126
STAT,1904,28,25-29,1932,122.18918339621966
STAT,1886,37,45-49,1923,4.2499991667945
SIM,1866,48,50-100,1914,1
STAT,1954,6,na,1960,9813.896536288281
SIM,1914,22,15-19,1936,13
SIM,1855,28,50-100,1883,1
STAT,1832,37,25-29,1869,4.742888256343159
STAT,1844,48,45-49,1892,0.37633092770914073
STAT,1869,29,45-49,1898,2.1572666955037274
SIM,1896,20,na,1916,6605
SIM,1861,35,40-44,1896,16
SIM,1944,20,35-39,1964,28
STAT,1864,54,na,1918,3780.240448543238
STAT,1911,17,na,1928,7807.9608972194765
SIM,1863,36,na,1899,4422
SIM,1901,30,40-44,1931,20
STAT,1826,37,na,1863,3397.051933815904
SIM,1862,29,25-29,1891,80
STAT,1854,29,25-29,1883,67.0086549774903
STAT,1823,52,20-24,1875,0.0021947125786691717
STAT,1879,20,na,1899,5025.920696466203
SIM,1811,75,na,1886,842
STAT,1785,81,na,1866,430.618143414144
STAT,1836,58,na,1894,2629.380327235991
STAT,1832,44,na,1876,3248.9003952333924
SIM,1865,100,na,1965,1
SIM,1842,26,40-44,1868,13
STAT,1855,46,30-34,1901,0.1463824784071631
SIM,1912,46,50-100,1958,2
STAT,1890,43,20-24,1933,0.38867078728457766
STAT,1936,20,35-39,1956,18.196960337113197
SIM,1849,40,15-19,1889,1
SIM,1806,49,40-44,1855,1
SIM,1882,39,na,1921,4830
SIM,1863,46,30-34,1909,1
SIM,1840,37,25-29,1877,12
STAT,1853,35,40-44,1888,7.071432537134159
STAT,1861,25,na,1886,4099.57042471733
SIM,1797,81,na,1878,323
STAT,1834,31,15-19,1865,0.2453521371322152
SIM,1917,41,45-49,1958,4
STAT,1876,16,30-34,1892,3.337546691070405
STAT,1897,27,30-34,1924,67.98211229391765
SIM,1812,60,na,1872,2205
SIM,1912,28,25-29,1940,137
STAT,1871,51,35-39,1922,0.017356857066865704
STAT,1852,16,45-49,1868,0.12666518526074336
SIM,1888,29,20-24,1917,29
SIM,1944,6,na,1950,8778
SIM,1889,13,na,1902,6583
STAT,1880,39,na,1919,4962.064729054147
SIM,1833,43,40-44,1876,10
SIM,1868,47,45-49,1915,1
STAT,1931,20,20-24,1951,293.01210098771134
STAT,1867,25,40-44,1892,5.704322461762704
STAT,1940,30,15-19,1970,0.2689262961394191
SIM,1883,36,30-34,1919,14
STAT,1855,19,15-19,1874,10.518824366348692
SIM,1856,27,35-39,1883,22
STAT,1914,32,50-100,1946,1.681118113264501
SIM,1924,39,45-49,1963,4
STAT,1923,26,30-34,1949,91.1369501985931
SIM,1826,41,na,1867,3145
SIM,1833,48,35-39,1881,1
SIM,1899,22,25-29,1921,163
STAT,1908,37,45-49,1945,1.2899217869332371
STAT,1825,40,25-29,1865,1.5491694829744285
STAT,1869,21,35-39,1890,11.454158671219368
STAT,1916,31,35-39,1947,19.13225715740075
STAT,1832,38,25-29,1870,4.692580918447268
STAT,1816,52,50-100,1868,0.07118477905138315
SIM,1922,32,50-100,1954,3
STAT,1855,43,50-100,1898,1.5815522098781343
STAT,1831,54,20-24,1885,9.549140239191962E-4
SIM,1864,23,15-19,1887,10
STAT,1892,39,35-39,1931,17.702459554898628
STAT,1867,34,30-34,1901,32.74100290916463
STAT,1871,23,40-44,1894,4.168273839712997
STAT,1824,39,40-44,1863,12.16107860368904
SIM,1838,36,30-34,1874,16
STAT,1811,82,na,1893,433.7184097203251
STAT,1899,67,na,1966,4925.843199296351
STAT,1925,22,25-29,1947,223.25454173666571
STAT,1916,39,45-49,1955,1.3957343417264363
STAT,1841,16,30-34,1857,3.0003092020953943
SIM,1897,26,30-34,1923,85
SIM,1909,50,na,1959,6807
STAT,1849,37,40-44,1886,7.085416988944979
SIM,1898,27,na,1925,6748
SIM,1869,39,50-100,1908,5
SIM,1875,34,30-34,1909,50
SIM,1877,21,35-39,1898,16
SIM,1933,22,25-29,1955,276
STAT,1880,28,15-19,1908,0.961887476155859
STAT,1914,46,na,1960,7378.067504775738
SIM,1869,27,45-49,1896,3
STAT,1830,25,45-49,1855,3.0833061639762804
STAT,1910,32,na,1942,7367.666720950854
SIM,1840,38,25-29,1878,8
STAT,1914,43,30-34,1957,0.25548552097809296
STAT,1895,53,na,1948,5575.515475846274
STAT,1875,36,30-34,1911,11.135404545318737
SIM,1814,56,na,1870,2362
STAT,1834,106,na,1940,0.01613555145774525
SIM,1832,39,40-44,1871,10
STAT,1889,26,30-34,1915,62.92399410199978
SIM,1877,30,25-29,1907,26
STAT,1888,49,25-29,1937,0.07593923791364272
STAT,1900,16,35-39,1916,1.5410525677975404
SIM,1886,16,40-44,1902,1
STAT,1894,47,20-24,1941,0.01747959853473216
STAT,1813,109,na,1922,6.322037450556951E-4
SIM,1878,50,na,1928,4752
STAT,1831,59,na,1890,2509.3000460085177
SIM,1781,82,na,1863,241
SIM,1809,56,na,1865,2267
STAT,1944,20,30-34,1964,62.71257205396498
SIM,1839,37,50-100,1876,2
SIM,1901,49,30-34,1950,1
STAT,1917,20,25-29,1937,199.43531458913523
SIM,1924,31,35-39,1955,29
STAT,1848,50,20-24,1898,0.0012273595650451057
SIM,1880,91,na,1971,349
STAT,1871,37,25-29,1908,5.777152376381671
STAT,1909,41,45-49,1950,0.31637231459623816
SIM,1825,30,na,1855,3265
SIM,1904,26,25-29,1930,137
STAT,1837,26,20-24,1863,21.143074791747175
SIM,1816,45,30-34,1861,1
SIM,1931,26,30-34,1957,118
SIM,1890,19,35-39,1909,2
STAT,1811,50,25-29,1861,0.023875669521545184
STAT,1840,37,20-24,1877,1.3160215729052702
STAT,1898,17,20-24,1915,48.45363168586505
SIM,1857,37,40-44,1894,13
SIM,1909,28,na,1937,7282
STAT,1915,27,35-39,1942,30.92996682751613
SIM,1929,24,25-29,1953,256
STAT,1867,30,15-19,1897,0.27151847816516445
SIM,1905,14,na,1919,7769
STAT,1881,32,15-19,1913,0.2779913536933627
STAT,1893,24,30-34,1917,45.31182575537365
STAT,1858,20,20-24,1878,126.29215758781545
SIM,1906,20,15-19,1926,9
SIM,1864,26,30-34,1890,62
STAT,1860,21,15-19,1881,5.617967548179965
SIM,1834,33,30-34,1867,44
SIM,1900,45,45-49,1945,2
SIM,1929,27,na,1956,9629
STAT,1851,30,25-29,1881,16.872848193793264
STAT,1840,63,na,1903,2575.536745278256
STAT,1810,97,na,1907,4.858402142891026
STAT,1831,48,35-39,1879,0.21151253536472492
STAT,1889,28,35-39,1917,23.943499769156066
STAT,1824,102,na,1926,0.3134439267875417
SIM,1922,43,30-34,1965,1
SIM,1845,26,20-24,1871,28
STAT,1922,16,25-29,1938,101.510017857507
STAT,1914,40,15-19,1954,0.003095239246290039
SIM,1857,46,30-34,1903,1
STAT,1829,88,na,1917,162.47637830039378
STAT,1845,33,40-44,1878,7.8635634896981745
STAT,1853,46,20-24,1899,0.019040324167534237
STAT,1905,30,20-24,1935,7.958503175279916
STAT,1846,36,na,1882,3807.8015830934087
STAT,1885,50,25-29,1935,0.007222819486052192
SIM,1813,82,na,1895,407
SIM,1902,0,na,1902,8016
STAT,1806,48,25-29,1854,0.3460784819004078
STAT,1877,51,40-44,1928,0.02218378205046842
STAT,1913,39,30-34,1952,3.5968748514798805
STAT,1926,31,na,1957,9239.834376213003
SIM,1930,16,25-29,1946,144
STAT,1827,45,40-44,1872,0.31755347162421355
SIM,1897,28,35-39,1925,33
SIM,1910,47,na,1957,7164
SIM,1849,37,45-49,1886,6
STAT,1847,48,25-29,1895,0.08669885266649129
STAT,1830,50,35-39,1880,0.014942819710343589
SIM,1866,20,20-24,1886,131
SIM,1942,27,45-49,1969,5
STAT,1880,19,25-29,1899,11.991722638224834
STAT,1856,26,30-34,1882,40.9550046716386
SIM,1867,87,na,1954,282
STAT,1861,19,15-19,1880,11.331617274644453
STAT,1825,43,40-44,1868,5.080451518065876
STAT,1872,30,45-49,1902,3.567957601521781
SIM,1863,73,na,1936,2179
STAT,1852,42,35-39,1894,2.8825402786954175
STAT,1879,9,na,1888,5550.655764133471
STAT,1932,39,40-44,1971,4.053830932795034
SIM,1834,27,45-49,1861,4
STAT,1888,30,35-39,1918,24.368279893602423
STAT,1847,40,15-19,1887,0.021717720275055283
SIM,1846,88,na,1934,147
SIM,1856,25,30-34,1881,56
STAT,1883,68,na,1951,3032.3617017206902
SIM,1879,38,30-34,1917,15
SIM,1912,26,20-24,1938,34
STAT,1864,17,na,1881,4716.702378183541
STAT,1892,34,40-44,1926,10.870628845740686
STAT,1851,38,35-39,1889,10.967260750633477
SIM,1865,16,20-24,1881,36
STAT,1869,49,15-19,1918,7.664314071847885E-4
SIM,1928,42,na,1970,9721
SIM,1899,71,na,1970,4398
SIM,1842,74,na,1916,1468
STAT,1803,51,40-44,1854,0.07891551555889614
STAT,1863,91,na,1954,102.44598408267045
STAT,1830,36,25-29,1866,5.47216730687252
STAT,1853,49,25-29,1902,0.08923197794632692
STAT,1934,27,45-49,1961,4.694403986987506
SIM,1844,22,na,1866,3711
SIM,1848,36,na,1884,3741
SIM,1866,45,45-49,1911,1
SIM,1907,32,25-29,1939,20
STAT,1870,42,40-44,1912,4.454434531028552
SIM,1880,30,45-49,1910,6
STAT,1826,33,30-34,1859,49.103192364047366
STAT,1893,18,45-49,1911,0.16677953633322454
STAT,1848,25,30-34,1873,50.009136145970764
STAT,1856,17,50-100,1873,0.09026815067261547
STAT,1904,26,20-24,1930,34.1231248576866
SIM,1913,30,20-24,1943,6
SIM,1868,8,na,1876,5376
STAT,1896,49,20-24,1945,0.017672201730335086
SIM,1843,18,35-39,1861,1
SIM,1896,30,35-39,1926,40
SIM,1917,29,15-19,1946,2
SIM,1827,53,45-49,1880,1
SIM,1919,37,25-29,1956,5
STAT,1841,32,20-24,1873,4.758494426275609
STAT,1866,45,30-34,1911,0.18218319661301471
STAT,1868,53,40-44,1921,0.01990435554009812
SIM,1825,45,35-39,1870,1
SIM,1941,29,na,1970,7914
STAT,1923,34,30-34,1957,36.41909063494715
SIM,1944,21,35-39,1965,25
STAT,1880,46,50-100,1926,0.5240154967147717
STAT,1883,89,na,1972,653.512763600839
STAT,1921,26,20-24,1947,41.21824803330029
SIM,1893,18,na,1911,6662
STAT,1906,37,35-39,1943,4.492780911677961
STAT,1884,36,35-39,1920,14.173208097841453
STAT,1886,44,45-49,1930,3.1476817580640493
STAT,1860,19,45-49,1879,0.12210895602355874
SIM,1871,40,45-49,1911,3
STAT,1864,32,15-19,1896,0.2570899253496
SIM,1923,15,40-44,1938,6
STAT,1766,116,na,1882,1.3970215359444973E-4
SIM,1907,47,45-49,1954,1
STAT,1869,17,50-100,1886,0.0972017634391712
SIM,1874,41,25-29,1915,1
SIM,1881,22,15-19,1903,4
SIM,1894,44,45-49,1938,1
STAT,1901,28,45-49,1929,3.128186511721461
SIM,1793,83,na,1876,177
SIM,1802,61,na,1863,1970
STAT,1913,18,25-29,1931,17.851895188342272
STAT,1835,21,40-44,1856,3.6150793672686423
SIM,1876,48,na,1924,4818
STAT,1886,22,25-29,1908,122.04435625551064
STAT,1885,15,45-49,1900,0.1319277028244431
SIM,1840,34,20-24,1874,7
STAT,1908,50,na,1958,6654.059143330394
STAT,1936,21,35-39,1957,18.190409431391835
STAT,1856,51,na,1907,3371.1968877898985
STAT,1891,26,25-29,1917,105.9629027814101
STAT,1941,29,40-44,1970,9.728780763509665
STAT,1824,35,25-29,1859,9.4884619755816
SIM,1843,21,40-44,1864,6
STAT,1812,45,na,1857,2976.271478965113
STAT,1863,40,45-49,1903,2.672609372075133
STAT,1855,104,na,1959,0.2150951072471773
SIM,1861,72,na,1933,2295
STAT,1819,53,45-49,1872,0.05731712474005839
STAT,1796,81,na,1877,425.6854873510678
STAT,1817,45,35-39,1862,0.697605982353511
STAT,1882,20,15-19,1902,6.5292148615462295
STAT,1869,40,50-100,1909,2.0882734036772383
SIM,1919,26,30-34,1945,101
SIM,1809,93,na,1902,39
SIM,1876,40,35-39,1916,7
SIM,1952,17,15-19,1969,111
SIM,1834,23,40-44,1857,2
SIM,1921,18,25-29,1939,122
SIM,1882,18,35-39,1900,1
STAT,1814,53,50-100,1867,0.07351360512037963
STAT,1854,1,na,1855,5821.476740058354
STAT,1935,37,50-100,1972,1.1859201384761697
STAT,1801,83,na,1884,296.3766951384601
STAT,1826,53,na,1879,2774.8243428691367
STAT,1889,68,na,1957,3919.4051068363183
SIM,1832,35,25-29,1867,8
SIM,1931,21,25-29,1952,239
SIM,1885,46,45-49,1931,2
SIM,1768,94,na,1862,7
STAT,1826,52,35-39,1878,0.01655753331434489
STAT,1836,50,40-44,1886,0.014738376650995656
STAT,1864,70,na,1934,2532.983180137057
STAT,1851,20,na,1871,4015.6028169436127
STAT,1910,26,45-49,1936,3.382071529180899
SIM,1888,33,na,1921,5558
STAT,1944,17,15-19,1961,98.63083663201553
STAT,1818,105,na,1923,0.030081335153888798
STAT,1850,62,na,1912,2802.4048951165273
SIM,1781,98,na,1879,3
SIM,1882,40,20-24,1922,1
STAT,1875,30,25-29,1905,21.469171594475903
SIM,1883,30,25-29,1913,25
SIM,1892,36,35-39,1928,33
STAT,1912,24,50-100,1936,1.3192263489716094
SIM,1842,42,30-34,1884,4
SIM,1909,33,35-39,1942,26
STAT,1877,46,45-49,1923,0.4963345323911002
STAT,1866,41,25-29,1907,1.2020611525062068
STAT,1938,28,40-44,1966,9.323086957076498
SIM,1886,28,20-24,1914,29
STAT,1927,23,35-39,1950,23.353474363420677
STAT,1859,51,35-39,1910,0.013905183747557587
STAT,1839,37,50-100,1876,2.2908776194471647
SIM,1918,27,na,1945,8216
SIM,1923,19,50-100,1942,1
STAT,1815,42,20-24,1857,0.9586470855710687
SIM,1890,20,15-19,1910,5
SIM,1841,17,35-39,1858,1
SIM,1922,32,na,1954,9016
SIM,1851,78,na,1929,1067
SIM,1853,29,20-24,1882,24
STAT,1924,41,50-100,1965,0.28254817694672757
STAT,1845,21,25-29,1866,110.30122716066697
STAT,1827,30,50-100,1857,2.513722272806643
STAT,1932,27,35-39,1959,39.71809033687463
STAT,1869,26,40-44,1895,5.882254738359709
SIM,1793,61,na,1854,1866
SIM,1953,14,na,1967,9949
STAT,1838,42,15-19,1880,0.021857849492865556
STAT,1929,12,na,1941,10211.559747477113
STAT,1834,42,30-34,1876,1.8449226258904852
STAT,1867,32,40-44,1899,8.202572265800917
STAT,1901,18,50-100,1919,0.1381552014725741
SIM,1922,23,25-29,1945,220
STAT,1832,34,20-24,1866,4.495505931271524
SIM,1851,35,35-39,1886,21
STAT,1914,36,30-34,1950,3.6934785741486214
STAT,1895,20,25-29,1915,151.54815989550858
SIM,1834,21,15-19,1855,7
SIM,1935,23,35-39,1958,26
STAT,1770,108,na,1878,0.008398636228757519
SIM,1940,27,35-39,1967,43
SIM,1823,42,20-24,1865,1
STAT,1934,29,na,1963,10169.26323791179
STAT,1851,41,50-100,1892,1.64510353172334
STAT,1922,42,15-19,1964,0.003558930336243977
STAT,1878,28,20-24,1906,24.658055243528274
STAT,1909,29,15-19,1938,1.3535772180977987
SIM,1900,35,40-44,1935,3
SIM,1837,24,20-24,1861,128
STAT,1845,29,20-24,1874,21.68860070261009
SIM,1848,90,na,1938,95
STAT,1860,112,na,1972,9.186642615091757E-4
SIM,1901,64,na,1965,5389
SIM,1905,31,25-29,1936,19
STAT,1892,31,25-29,1923,26.002163319425396
SIM,1826,89,na,1915,77
SIM,1866,104,na,1970,2
STAT,1826,43,na,1869,3203.3506182646247
SIM,1853,21,25-29,1874,133
SIM,1901,54,na,1955,5999
SIM,1922,36,30-34,1958,8
SIM,1869,24,40-44,1893,6
STAT,1882,33,20-24,1915,5.2955468756067186
STAT,1896,15,20-24,1911,47.49148994365764
STAT,1891,6,na,1897,6521.44198765501
STAT,1870,30,35-39,1900,20.241630134685444
STAT,1851,42,na,1893,3578.432646205928
SIM,1903,23,15-19,1926,12
STAT,1845,43,45-49,1888,2.318576867240465
STAT,1855,20,40-44,1875,3.724211881780929
STAT,1880,29,15-19,1909,0.958386205742652
SIM,1853,43,45-49,1896,4
STAT,1801,53,50-100,1854,0.09272353138566301
STAT,1865,24,30-34,1889,32.60614110444836
SIM,1873,24,30-34,1897,41
STAT,1933,39,45-49,1972,1.8715194314401107
STAT,1864,92,na,1956,85.47256698376526
SIM,1890,33,20-24,1923,7
SIM,1924,44,40-44,1968,1
STAT,1902,39,30-34,1941,3.2470128065268766
SIM,1819,37,20-24,1856,2
STAT,1871,30,40-44,1901,8.771632179976685
STAT,1821,34,45-49,1855,8.766358802643731
STAT,1916,44,40-44,1960,0.5159463009532596
SIM,1910,39,30-34,1949,8
STAT,1831,33,50-100,1864,1.529131317153295
STAT,1865,36,25-29,1901,5.308209661359133
SIM,1929,26,15-19,1955,1
SIM,1868,32,25-29,1900,24
SIM,1858,35,45-49,1893,3
STAT,1841,19,35-39,1860,1.0147493770532354
STAT,1937,16,30-34,1953,24.011652422611576
STAT,1899,35,40-44,1934,12.228197404921016
STAT,1901,12,na,1913,7301.706232564622
SIM,1897,29,35-39,1926,46
STAT,1855,40,na,1895,3520.364798244251
STAT,1946,24,na,1970,8201.007520093777
SIM,1884,35,na,1919,5123
STAT,1918,49,20-24,1967,0.023607677845072197
STAT,1894,30,35-39,1924,26.48481894469519
STAT,1867,35,na,1902,4498.473798655691
SIM,1905,20,na,1925,7142
STAT,1826,59,na,1885,2464.030876409934
STAT,1909,15,40-44,1924,0.5568419834605103
SIM,1851,56,na,1907,3168
SIM,1873,33,20-24,1906,6
STAT,1912,0,na,1912,9172.886684848547
STAT,1871,33,45-49,1904,3.484239614806505
STAT,1801,61,na,1862,2017.8755330837325
STAT,1889,46,na,1935,5618.534310871417
STAT,1871,40,na,1911,4684.331716320938
STAT,1888,46,20-24,1934,0.02872611047801453
STAT,1867,53,35-39,1920,0.016021939090674817
STAT,1914,23,25-29,1937,190.03373120586116
STAT,1843,35,35-39,1878,11.809284847444923
SIM,1955,16,15-19,1971,115
SIM,1813,45,na,1858,2983
STAT,1849,53,30-34,1902,0.009264552695406669
SIM,1950,21,35-39,1971,20
STAT,1839,34,30-34,1873,32.85961128805874
SIM,1804,78,na,1882,585
SIM,1863,20,40-44,1883,9
SIM,1842,29,45-49,1871,3
SIM,1870,35,45-49,1905,4
STAT,1940,29,35-39,1969,30.891444868593847
SIM,1898,33,na,1931,6730
STAT,1819,39,20-24,1858,3.9340805716517675
STAT,1874,70,na,1944,2901.4379299800376
SIM,1890,40,50-100,1930,6
STAT,1937,27,25-29,1964,129.6068163594772
SIM,1783,83,na,1866,223
STAT,1851,37,35-39,1888,11.081735073947351
SIM,1845,27,20-24,1872,24
STAT,1843,55,na,1898,2896.489800941218
STAT,1835,50,35-39,1885,0.011827616504422135
SIM,1821,74,na,1895,1321
STAT,1835,95,na,1930,17.21960819622302
SIM,1942,16,50-100,1958,1
SIM,1818,76,na,1894,850
SIM,1884,22,40-44,1906,5
STAT,1889,29,35-39,1918,23.856345429996342
STAT,1834,29,45-49,1863,1.9102941737207708
SIM,1902,18,15-19,1920,15
SIM,1905,44,30-34,1949,2
STAT,1924,46,40-44,1970,0.3799212190796687
STAT,1860,35,35-39,1895,11.71034537517889
SIM,1856,24,30-34,1880,43
SIM,1905,20,45-49,1925,1
STAT,1894,43,40-44,1937,0.4023027773853216
STAT,1928,29,25-29,1957,163.5840818408071
STAT,1938,26,15-19,1964,1.4133715497978006
STAT,1874,40,20-24,1914,0.33172561464652794
STAT,1782,79,na,1861,533.5961036017239
SIM,1813,55,na,1868,2541
STAT,1866,18,na,1884,4802.3004250879285
SIM,1936,29,25-29,1965,123
STAT,1819,105,na,1924,0.03068046651201025
STAT,1954,16,30-34,1970,30.437006321784796
STAT,1827,52,40-44,1879,0.018351340929592713
STAT,1923,21,25-29,1944,217.64560494677005
SIM,1878,25,20-24,1903,22
STAT,1850,25,25-29,1875,77.434624859648
SIM,1862,36,50-100,1898,7
SIM,1864,43,20-24,1907,1
STAT,1794,96,na,1890,3.3633895271685295
STAT,1880,23,45-49,1903,1.4790182286065021
STAT,1946,14,na,1960,8795.291083166525
STAT,1876,51,35-39,1927,0.01806915945501585
SIM,1866,43,30-34,1909,5
STAT,1944,23,35-39,1967,20.524309616903878
SIM,1901,26,45-49,1927,4
STAT,1919,39,25-29,1958,2.1313042047612543
SIM,1826,37,50-100,1863,4
SIM,1883,43,30-34,1926,4
STAT,1928,26,30-34,1954,97.81207381599313
SIM,1838,74,na,1912,1435
SIM,1897,25,30-34,1922,87
STAT,1830,32,45-49,1862,3.453940503259574
SIM,1934,25,50-100,1959,3
STAT,1887,31,50-100,1918,2.078066472977855
SIM,1847,34,30-34,1881,36
STAT,1904,21,15-19,1925,9.591883539713145
SIM,1933,16,na,1949,10437
STAT,1901,18,na,1919,7122.111521094254
STAT,1843,50,50-100,1893,0.021460222583345123
STAT,1900,54,na,1954,5866.642047935617
STAT,1891,40,20-24,1931,0.4004584136537963
STAT,1899,47,35-39,1946,0.2175067542583925
SIM,1926,27,15-19,1953,1
STAT,1829,30,40-44,1859,8.807881107922924
SIM,1916,23,25-29,1939,228
STAT,1931,39,50-100,1970,1.1206454533953618
STAT,1947,16,15-19,1963,103.27035387283537
SIM,1894,22,25-29,1916,169
STAT,1841,26,na,1867,3926.6770229868625
STAT,1794,64,na,1858,1710.825883074269
STAT,1853,42,40-44,1895,3.554426035489973
STAT,1837,27,20-24,1864,20.991267514742432
STAT,1908,23,25-29,1931,171.085739083238
STAT,1838,26,50-100,1864,1.1092560525370727
STAT,1923,30,50-100,1953,1.9290396461812438
STAT,1896,21,40-44,1917,5.573101910938464
SIM,1812,49,50-100,1861,1
STAT,1844,72,na,1916,2039.4666953147134
STAT,1819,89,na,1908,109.92555576544451
SIM,1882,39,50-100,1921,5
STAT,1828,49,15-19,1877,7.017731436698519E-4
STAT,1808,52,30-34,1860,0.03532673514932259
STAT,1917,27,na,1944,7933.715556668922
SIM,1900,29,20-24,1929,33
STAT,1840,35,50-100,1875,2.1400323103599805
SIM,1931,34,30-34,1965,55
STAT,1907,46,40-44,1953,0.2874717684495904
STAT,1828,60,na,1888,2418.3384301148144
STAT,1844,52,40-44,1896,0.016910742457782058
SIM,1856,28,35-39,1884,25
SIM,1861,40,na,1901,4498
STAT,1858,34,40-44,1892,6.7693489733030345
SIM,1827,31,25-29,1858,24
STAT,1814,58,na,1872,2175.0557173256598
SIM,1945,16,30-34,1961,41
STAT,1918,27,15-19,1945,1.5170584018691131
STAT,1921,32,na,1953,8498.191849665654
STAT,1850,94,na,1944,30.644048705491922
SIM,1893,41,35-39,1934,10
STAT,1885,41,35-39,1926,3.656743394647529
STAT,1859,24,30-34,1883,29.282690690952997
SIM,1912,21,15-19,1933,14
STAT,1825,47,35-39,1872,0.3035962208523988
STAT,1894,15,na,1909,6582.868017232203
SIM,1837,30,40-44,1867,13
STAT,1847,45,20-24,1892,0.01847446713498097
STAT,1875,43,30-34,1918,2.3732955469620505
SIM,1927,39,25-29,1966,5
STAT,1892,38,35-39,1930,17.793741448529584
SIM,1896,68,na,1964,4569
SIM,1899,36,45-49,1935,2
STAT,1889,25,30-34,1914,63.1342310915346
STAT,1818,50,35-39,1868,0.037878591872339246
SIM,1877,44,45-49,1921,10
STAT,1777,84,na,1861,183.0330866647736
SIM,1927,21,35-39,1948,29
STAT,1863,17,20-24,1880,35.764492447456405
SIM,1922,39,35-39,1961,6
STAT,1875,86,na,1961,740.9970903863243
SIM,1813,77,na,1890,708
STAT,1899,46,na,1945,6244.457885980658
STAT,1897,33,na,1930,6414.999338276756
STAT,1836,31,25-29,1867,17.39748454757746
SIM,1864,39,25-29,1903,3
SIM,1894,41,40-44,1935,1
SIM,1913,33,25-29,1946,22
STAT,1824,32,20-24,1856,12.16112488952718
STAT,1817,76,na,1893,955.5754263798007
STAT,1899,33,15-19,1932,0.39239883965618855
SIM,1934,29,15-19,1963,5
STAT,1852,21,40-44,1873,3.9739582906467095
STAT,1929,30,45-49,1959,4.040959814440118
STAT,1913,15,20-24,1928,56.25707592759043
SIM,1831,31,15-19,1862,1
SIM,1921,37,40-44,1958,7
STAT,1918,39,50-100,1957,0.8916989066979065
STAT,1818,40,na,1858,3105.131141521815
STAT,1836,21,na,1857,3778.801504562856
STAT,1866,48,35-39,1914,0.2576091051095955
SIM,1857,40,25-29,1897,2
STAT,1896,32,na,1928,6362.927339041908
SIM,1891,41,25-29,1932,4
STAT,1883,41,25-29,1924,1.2799806252418786
STAT,1807,50,50-100,1857,0.10243660702451941
STAT,1835,89,na,1924,136.05921310083752
STAT,1901,25,40-44,1926,8.527024806857266
SIM,1831,58,na,1889,2663
SIM,1832,32,20-24,1864,7
STAT,1926,29,15-19,1955,1.6966456419391784
STAT,1956,16,40-44,1972,3.738440391428205
STAT,1848,28,35-39,1876,18.752168623614445
STAT,1825,52,30-34,1877,0.012443261835561721
STAT,1862,110,na,1972,0.008764401537417796
SIM,1909,30,30-34,1939,31
SIM,1892,33,30-34,1925,64
STAT,1885,38,na,1923,4712.720293182055
STAT,1816,75,na,1891,1011.1917101765162
STAT,1904,37,15-19,1941,0.035134084327844435
STAT,1843,19,45-49,1862,0.11556353371931737
SIM,1861,56,na,1917,3924
SIM,1854,24,20-24,1878,142
STAT,1914,39,35-39,1953,4.829066888183746
SIM,1872,31,50-100,1903,5
STAT,1906,33,na,1939,7052.629650082257
STAT,1854,39,15-19,1893,0.08521782941468738
STAT,1873,26,30-34,1899,51.85200538152318
STAT,1905,33,25-29,1938,17.1055071126656
SIM,1844,31,25-29,1875,20
SIM,1901,48,na,1949,6390
SIM,1949,2,na,1951,9722
SIM,1868,35,na,1903,4594
SIM,1920,23,15-19,1943,14
SIM,1914,21,25-29,1935,246
SIM,1830,57,na,1887,2476
SIM,1870,32,50-100,1902,3
STAT,1837,50,45-49,1887,0.021125526895976524
SIM,1891,69,na,1960,4264
SIM,1911,20,45-49,1931,1
STAT,1874,54,50-100,1928,0.030372362002318878
SIM,1945,11,na,1956,9036
SIM,1818,86,na,1904,167
STAT,1851,26,na,1877,3954.836440374504
STAT,1884,33,30-34,1917,34.67246098036771
SIM,1836,21,25-29,1857,113
STAT,1816,107,na,1923,0.00463225742639094
SIM,1828,34,20-24,1862,7
SIM,1860,21,40-44,1881,5
SIM,1871,29,15-19,1900,4
STAT,1849,40,25-29,1889,1.0335156128769012
SIM,1843,43,na,1886,3526
SIM,1888,71,na,1959,3415
SIM,1871,17,20-24,1888,41
SIM,1940,24,30-34,1964,89
SIM,1834,23,na,1857,3758
SIM,1878,31,40-44,1909,13
STAT,1870,39,na,1909,4624.479205538737
STAT,1854,15,40-44,1869,0.3393973429994897
STAT,1924,16,35-39,1940,10.113884920917432
STAT,1900,28,40-44,1928,8.362903863220819
SIM,1927,3,na,1930,10411
STAT,1912,23,15-19,1935,10.274049083234983
SIM,1868,29,na,1897,4563
SIM,1905,27,40-44,1932,12
SIM,1909,27,15-19,1936,2
SIM,1929,34,15-19,1963,1
SIM,1848,74,na,1922,1538
STAT,1897,47,25-29,1944,0.08730566658080299
SIM,1932,16,35-39,1948,15
STAT,1891,23,20-24,1914,171.50033729530733
STAT,1864,103,na,1967,1.718447317536901
STAT,1897,20,35-39,1917,15.847702232214452
STAT,1856,30,15-19,1886,0.22933523746615
STAT,1906,32,50-100,1938,1.548307159604549
STAT,1908,20,20-24,1928,207.82470535500147
STAT,1852,91,na,1943,92.35782334566558
STAT,1863,109,na,1972,0.02448404320077532
STAT,1862,21,25-29,1883,101.88988751076037
STAT,1878,51,45-49,1929,0.03075750703377184
SIM,1837,43,50-100,1880,2
SIM,1873,41,na,1914,4897
SIM,1931,37,25-29,1968,3
STAT,1790,66,na,1856,1395.9218982400002
STAT,1904,33,50-100,1937,1.5186150987332523
STAT,1868,31,30-34,1899,33.686411451486855
STAT,1869,30,25-29,1899,20.205275137640964
SIM,1849,34,40-44,1883,13
STAT,1906,21,25-29,1927,168.97926862478215
STAT,1854,92,na,1946,63.84802160462712
STAT,1832,42,20-24,1874,0.253293303253927
STAT,1893,40,30-34,1933,2.9727065125115386
STAT,1834,78,na,1912,1038.3426197394276
SIM,1830,28,15-19,1858,2
SIM,1916,20,20-24,1936,247
STAT,1846,24,20-24,1870,128.37540933667353
STAT,1825,101,na,1926,0.6602318753654113
STAT,1817,92,na,1909,42.00865827736487
SIM,1895,25,20-24,1920,36
SIM,1829,60,na,1889,2382
SIM,1850,40,25-29,1890,2
STAT,1821,38,na,1859,3131.688781732379
SIM,1908,27,na,1935,7199
SIM,1883,24,na,1907,4874
STAT,1933,36,40-44,1969,4.122193365798081
SIM,1833,75,na,1908,1305
SIM,1836,43,45-49,1879,6
STAT,1887,25,20-24,1912,26.678693580895136
SIM,1864,8,na,1872,5371
STAT,1816,50,25-29,1866,0.017374909373585254
STAT,1903,20,45-49,1923,2.0171558057976466
STAT,1923,17,40-44,1940,3.3160107951773776
SIM,1898,30,45-49,1928,7
STAT,1876,25,50-100,1901,1.3452930790451099
STAT,1913,37,40-44,1950,2.984365987025738
SIM,1926,19,15-19,1945,118
SIM,1947,24,na,1971,8643
SIM,1876,86,na,1962,783
SIM,1906,26,35-39,1932,37
STAT,1836,53,45-49,1889,0.01914496216713562
SIM,1836,89,na,1925,83
SIM,1866,32,15-19,1898,1
SIM,1903,13,na,1916,7634
STAT,1895,16,40-44,1911,0.4825154386423036
SIM,1931,17,40-44,1948,6
STAT,1907,6,na,1913,7754.423127477256
SIM,1851,32,30-34,1883,40
STAT,1895,34,45-49,1929,4.549805748046059
STAT,1893,67,na,1960,4318.835567011638
STAT,1836,37,na,1873,3495.3213292189
STAT,1903,38,20-24,1941,0.4760657752879193
SIM,1848,52,na,1900,3281
STAT,1885,16,na,1901,5089.686088183073
SIM,1886,20,25-29,1906,125
STAT,1765,99,na,1864,0.6254631787448374
STAT,1850,42,25-29,1892,0.9833877605520921
STAT,1923,37,25-29,1960,2.3033471119132067
SIM,1812,42,45-49,1854,6
STAT,1869,8,na,1877,5353.954854677256
STAT,1927,20,30-34,1947,71.93199353551009
SIM,1843,21,na,1864,4004
STAT,1862,35,45-49,1897,3.4738403299247276
SIM,1834,31,40-44,1865,10
SIM,1870,21,25-29,1891,130
SIM,1937,24,na,1961,7234
SIM,1900,38,45-49,1938,3
STAT,1938,32,25-29,1970,18.772402024770646
STAT,1931,23,25-29,1954,241.2138237953168
STAT,1865,19,50-100,1884,0.09154290416191253
STAT,1893,22,40-44,1915,5.3342965049945095
SIM,1873,19,50-100,1892,3
STAT,1901,41,50-100,1942,0.2083605066636449
STAT,1851,42,30-34,1893,1.7800015413767092
SIM,1928,27,25-29,1955,20
SIM,1825,29,45-49,1854,4
SIM,1921,15,20-24,1936,324
STAT,1849,32,50-100,1881,1.5272169912713807
STAT,1826,31,40-44,1857,13.98560446255002
STAT,1835,73,na,1908,1538.3081810686454
SIM,1935,20,30-34,1955,106
STAT,1906,11,na,1917,7611.521430507136
STAT,1874,18,35-39,1892,1.1317108927986912
SIM,1938,26,40-44,1964,8
SIM,1857,32,50-100,1889,5
SIM,1881,70,na,1951,2254
STAT,1834,49,15-19,1883,5.503957686711247E-4
SIM,1863,43,50-100,1906,6
STAT,1843,32,30-34,1875,29.403069964173906
STAT,1848,22,na,1870,4268.796554707856
STAT,1884,69,na,1953,2926.678439837742
SIM,1860,103,na,1963,1
SIM,1892,38,na,1930,6713
STAT,1914,20,20-24,1934,221.51576987774217
STAT,1867,50,30-34,1917,0.011420592207353048
SIM,1873,36,25-29,1909,9
STAT,1823,88,na,1911,164.74050648431103
SIM,1894,67,na,1961,4481
STAT,1845,40,40-44,1885,3.6210873052487544
STAT,1940,26,30-34,1966,80.73710285149328
STAT,1922,29,30-34,1951,88.88075524901387
SIM,1847,43,20-24,1890,3
SIM,1891,53,na,1944,5587
STAT,1910,37,15-19,1947,0.03710596580864659
STAT,1870,88,na,1958,371.1219811598512
SIM,1925,17,40-44,1942,4
SIM,1903,39,50-100,1942,2
SIM,1936,26,20-24,1962,34
STAT,1897,31,15-19,1928,0.3860208315992506
STAT,1901,33,40-44,1934,12.20975425748593
STAT,1927,34,15-19,1961,0.318792785270327
STAT,1769,97,na,1866,1.2081626811284005
SIM,1930,29,30-34,1959,123
STAT,1877,30,35-39,1907,21.408774103406394
STAT,1847,36,30-34,1883,8.517095112344222
SIM,1885,30,35-39,1915,30
STAT,1860,39,15-19,1899,0.09117120607159801
SIM,1908,21,25-29,1929,198
STAT,1851,54,50-100,1905,0.022768204723035267
SIM,1928,33,50-100,1961,3
STAT,1925,37,45-49,1962,1.652140581677382
SIM,1817,75,na,1892,990
STAT,1872,20,40-44,1892,4.25482736240615
STAT,1876,20,15-19,1896,6.932315264279054
STAT,1851,10,na,1861,4555.6910693231475
SIM,1897,32,na,1929,6504
STAT,1858,32,15-19,1890,0.22420925119334845
STAT,1919,32,15-19,1951,0.2799444903546865
SIM,1948,6,na,1954,9351
STAT,1905,42,15-19,1947,0.002797530242999797
SIM,1825,40,na,1865,2963
SIM,1888,65,na,1953,4016
SIM,1904,15,30-34,1919,5
STAT,1862,37,50-100,1899,2.1193310810351016
STAT,1917,17,40-44,1934,0.607838035146749
SIM,1840,88,na,1928,182
SIM,1858,22,15-19,1880,6
SIM,1879,48,50-100,1927,3
SIM,1853,40,40-44,1893,6
STAT,1879,43,15-19,1922,0.028962210105267963
SIM,1862,33,45-49,1895,1
SIM,1922,20,20-24,1942,275
SIM,1903,36,20-24,1939,1
STAT,1839,43,20-24,1882,0.25802790496655065
STAT,1825,44,30-34,1869,2.540805435542257
STAT,1869,91,na,1960,201.28583046230298
SIM,1886,2,na,1888,6272
STAT,1839,37,35-39,1876,13.197550805062837
STAT,1882,73,na,1955,2336.7806319909573
STAT,1851,34,30-34,1885,27.591596828582205
SIM,1836,25,40-44,1861,7
SIM,1867,41,50-100,1908,3
SIM,1870,39,25-29,1909,11
STAT,1842,43,na,1885,3514.7750921897723
SIM,1818,92,na,1910,51
STAT,1918,19,15-19,1937,99.21114003232876
STAT,1757,111,na,1868,0.004028901192542389
STAT,1765,116,na,1881,2.166223977158858E-4
SIM,1855,36,30-34,1891,11
STAT,1899,38,45-49,1937,1.1847294441556462
STAT,1921,39,40-44,1960,3.3678040669449754
STAT,1915,39,40-44,1954,3.023701949182492
STAT,1821,44,na,1865,2969.5274560189123
SIM,1863,41,na,1904,4338
SIM,1923,39,40-44,1962,4
STAT,1938,21,45-49,1959,2.2501282969752756
SIM,1851,21,15-19,1872,4
STAT,1762,103,na,1865,0.11650942310087
STAT,1842,40,25-29,1882,1.0148128609949294
SIM,1933,37,45-49,1970,1
SIM,1871,39,na,1910,4541
SIM,1883,18,na,1901,5233
STAT,1919,48,15-19,1967,8.045237396129765E-4
SIM,1946,21,45-49,1967,6
STAT,1821,38,50-100,1859,4.5200117278790035
STAT,1812,94,na,1906,18.944930011800164
STAT,1845,34,50-100,1879,1.6442227416449708
STAT,1854,33,45-49,1887,2.7092976381846086
STAT,1833,23,na,1856,3747.010884167504
STAT,1899,44,30-34,1943,0.21793345939979572
SIM,1849,42,40-44,1891,11
SIM,1878,71,na,1949,2663
SIM,1888,28,30-34,1916,73
STAT,1905,16,25-29,1921,16.591921073421634
SIM,1901,23,40-44,1924,7
SIM,1847,37,50-100,1884,5
SIM,1861,42,40-44,1903,9
STAT,1891,43,25-29,1934,1.5914891061750116
STAT,1825,95,na,1920,15.38341270767044
STAT,1889,38,50-100,1927,3.0422008328850003
STAT,1913,48,50-100,1961,0.44472607111528123
STAT,1862,39,25-29,1901,4.920052156732833
STAT,1847,74,na,1921,1691.697151491367
SIM,1842,95,na,1937,12
STAT,1875,4,na,1879,6046.902551643942
SIM,1833,44,30-34,1877,4
STAT,1858,46,35-39,1904,0.22104437489919493
SIM,1913,33,na,1946,7707
STAT,1947,24,15-19,1971,12.141343471925484
STAT,1843,21,15-19,1864,5.842666948941011
STAT,1878,52,50-100,1930,0.031686652692009785
STAT,1884,47,na,1931,4465.873371219135
STAT,1850,22,20-24,1872,126.82040914286682
SIM,1899,23,15-19,1922,9
SIM,1914,15,15-19,1929,18
STAT,1819,50,40-44,1869,0.04414337480777841
STAT,1830,58,na,1888,2740.0014169453043
SIM,1825,62,na,1887,1998
STAT,1907,49,45-49,1956,0.3889883567340741
STAT,1858,37,45-49,1895,3.138581998021365
SIM,1871,92,na,1963,130
SIM,1926,31,45-49,1957,7
STAT,1943,18,20-24,1961,290.2543129721911
SIM,1879,30,35-39,1909,21
STAT,1794,80,na,1874,530.1599802591828
STAT,1843,52,35-39,1895,0.011995522560696383
SIM,1907,31,35-39,1938,22
STAT,1892,35,30-34,1927,13.602720981578713
STAT,1928,26,20-24,1954,45.56755414061588
SIM,1843,17,45-49,1860,1
SIM,1915,49,45-49,1964,1
SIM,1859,68,na,1927,2608
SIM,1898,17,na,1915,7147
SIM,1808,46,50-100,1854,2
STAT,1827,35,50-100,1862,2.688393027621709
STAT,1882,29,25-29,1911,82.62885962810293
STAT,1844,56,na,1900,3293.833579488709
STAT,1952,19,15-19,1971,109.7562339308486
SIM,1870,4,na,1874,5474
STAT,1828,36,20-24,1864,1.584493928525877
SIM,1820,41,40-44,1861,8
SIM,1839,91,na,1930,103
STAT,1886,41,40-44,1927,4.817024628823009
SIM,1823,38,25-29,1861,8
STAT,1873,35,20-24,1908,1.5968479636362434
STAT,1806,55,na,1861,2183.9254865882076
SIM,1908,49,na,1957,6636
STAT,1824,52,25-29,1876,0.008261783279227598
SIM,1849,20,20-24,1869,129
STAT,1871,19,20-24,1890,35.38179614144994
STAT,1928,29,35-39,1957,37.31342984915016
SIM,1904,39,30-34,1943,5
STAT,1836,45,45-49,1881,0.33697936894792807
SIM,1913,16,25-29,1929,22
SIM,1845,60,na,1905,3169
SIM,1877,26,40-44,1903,11
STAT,1915,15,40-44,1930,0.5940259056527022
STAT,1864,21,45-49,1885,1.2883756435585303
SIM,1921,48,50-100,1969,1
STAT,1906,15,15-19,1921,17.546196992240347
STAT,1918,31,45-49,1949,3.3903037942175183
STAT,1890,22,15-19,1912,8.132608659963287
STAT,1919,21,35-39,1940,20.88192421481385
SIM,1890,29,25-29,1919,123
STAT,1945,22,15-19,1967,11.78180778475561
STAT,1825,36,50-100,1861,3.3537140382026482
SIM,1914,37,35-39,1951,9
STAT,1913,2,na,1915,8419.688352666732
STAT,1860,38,50-100,1898,2.003612375932188
SIM,1836,73,na,1909,1426
SIM,1936,29,35-39,1965,29
STAT,1823,31,15-19,1854,0.9308913364926282
STAT,1930,27,15-19,1957,1.8128924542589053
STAT,1853,86,na,1939,351.0528211542066
SIM,1877,49,na,1926,4510
STAT,1882,50,20-24,1932,0.0014726428384179394
STAT,1852,24,45-49,1876,1.3013978405044904
SIM,1838,49,25-29,1887,1
SIM,1918,38,30-34,1956,2
SIM,1843,27,na,1870,3923
STAT,1897,17,na,1914,6818.23219527535
SIM,1843,35,50-100,1878,4
STAT,1907,29,40-44,1936,8.754058627310371
SIM,1836,36,20-24,1872,3
STAT,1846,17,20-24,1863,34.11210575075193
STAT,1897,35,30-34,1932,14.524595746089943
STAT,1899,31,25-29,1930,28.45853268080638
SIM,1899,29,45-49,1928,5
STAT,1851,52,35-39,1903,0.01327456839523651
STAT,1916,26,na,1942,7849.567409406125
SIM,1832,29,50-100,1861,2
SIM,1815,54,50-100,1869,1
SIM,1858,67,na,1925,2663
STAT,1876,34,na,1910,4941.9923178915415
SIM,1908,25,40-44,1933,14
SIM,1873,20,15-19,1893,6
STAT,1773,106,na,1879,0.023805586061878464
SIM,1846,31,45-49,1877,6
SIM,1904,15,20-24,1919,46
STAT,1834,33,40-44,1867,7.318099267139851
STAT,1871,15,40-44,1886,0.37375784083835617
SIM,1904,37,40-44,1941,4
STAT,1861,19,na,1880,4382.9894826484215
SIM,1838,44,30-34,1882,1
SIM,1877,41,40-44,1918,5
STAT,1839,30,15-19,1869,0.2793810734740235
STAT,1931,39,35-39,1970,6.4559429888782285
SIM,1923,11,na,1934,9866
STAT,1811,44,na,1855,2852.9568010130333
SIM,1900,31,25-29,1931,41
STAT,1827,54,na,1881,2717.3892834105322
SIM,1938,15,25-29,1953,104
STAT,1864,49,na,1913,3976.8545661242465
STAT,1840,44,20-24,1884,0.23307831448419766
SIM,1865,18,35-39,1883,1
SIM,1877,40,50-100,1917,2
SIM,1769,95,na,1864,4
STAT,1924,42,25-29,1966,0.17149765862173494
SIM,1828,40,40-44,1868,6
STAT,1865,71,na,1936,2449.1071672214553
STAT,1902,48,20-24,1950,0.019058246344266682
SIM,1915,29,40-44,1944,12
SIM,1840,25,30-34,1865,60
STAT,1929,31,20-24,1960,6.260353942551164
STAT,1883,48,35-39,1931,0.2743077278046203
STAT,1920,38,20-24,1958,0.5821832215464029
SIM,1871,24,20-24,1895,135
SIM,1921,27,15-19,1948,1
SIM,1883,56,na,1939,4177
STAT,1853,20,30-34,1873,33.78232507842039
STAT,1842,19,50-100,1861,0.09256419109475472
SIM,1854,30,40-44,1884,13
STAT,1837,39,15-19,1876,0.09335381788757707
STAT,1859,111,na,1970,0.0020978337026478543
STAT,1913,27,15-19,1940,1.4209917461694235
STAT,1917,28,20-24,1945,38.52266346267532
STAT,1941,15,na,1956,7661.25451651582
STAT,1797,82,na,1879,334.9506115377243
STAT,1944,21,45-49,1965,2.454210162418188
SIM,1923,3,na,1926,10015
STAT,1838,31,45-49,1869,2.963276238174928
STAT,1862,32,40-44,1894,7.486045399301138
STAT,1876,0,na,1876,7648.5761089226235
STAT,1919,36,30-34,1955,3.9571978843866584
SIM,1854,41,50-100,1895,3
SIM,1861,20,30-34,1881,51
STAT,1865,53,25-29,1918,0.00639457783829956
SIM,1940,18,45-49,1958,1
STAT,1878,20,25-29,1898,121.46866015674998
STAT,1832,25,30-34,1857,45.32354647693561
SIM,1849,36,30-34,1885,14
SIM,1808,92,na,1900,22
STAT,1932,18,45-49,1950,1.3325119477176455
SIM,1849,15,na,1864,4745
SIM,1925,28,20-24,1953,52
SIM,1911,16,na,1927,7971
SIM,1918,20,30-34,1938,90
STAT,1907,16,35-39,1923,1.6327678589117043
SIM,1945,19,25-29,1964,132
STAT,1892,46,35-39,1938,0.20023060446721275
STAT,1826,75,na,1901,1232.3742500171202
STAT,1924,30,na,1954,8949.262071340565
STAT,1815,69,na,1884,1595.410072404289
STAT,1817,49,15-19,1866,0.0018724942677635689
STAT,1949,21,20-24,1970,262.11513976310687
STAT,1841,23,30-34,1864,32.50460478388925
STAT,1867,46,50-100,1913,0.46585277873140557
STAT,1869,37,20-24,1906,1.5085046632887686
STAT,1857,18,35-39,1875,1.009255066790895
STAT,1880,20,40-44,1900,4.459907971283999
STAT,1867,26,30-34,1893,47.79311708139201
STAT,1841,28,25-29,1869,75.68509328826462
STAT,1867,19,na,1886,4826.16209262989
STAT,1945,13,na,1958,8664.064036053567
SIM,1929,39,45-49,1968,2
STAT,1916,11,na,1927,8474.959192298678
STAT,1940,15,15-19,1955,93.11893300904735
STAT,1856,46,25-29,1902,0.09000923262688391
SIM,1866,71,na,1937,2497
STAT,1826,34,45-49,1860,4.5987685309149455
STAT,1823,47,25-29,1870,0.17797616381905262
SIM,1845,17,na,1862,4710
SIM,1835,30,30-34,1865,46
SIM,1937,31,50-100,1968,2
SIM,1929,11,na,1940,10560
SIM,1858,57,na,1915,3444
STAT,1947,22,25-29,1969,210.82341156053522
SIM,1927,36,30-34,1963,8
SIM,1858,52,na,1910,3705
SIM,1811,81,na,1892,420
SIM,1833,91,na,1924,58
SIM,1906,63,na,1969,5777
SIM,1911,48,na,1959,7216
STAT,1837,19,20-24,1856,35.030239102395726
STAT,1863,16,45-49,1879,0.13255853416024946
SIM,1931,30,na,1961,10024
STAT,1890,38,25-29,1928,7.062465563489803
STAT,1939,27,35-39,1966,30.48588942490436
STAT,1937,31,50-100,1968,1.6533184925575393
STAT,1808,62,na,1870,1946.2894206415963
SIM,1872,93,na,1965,184
STAT,1845,57,na,1902,3096.712110603795
STAT,1937,19,25-29,1956,84.90729460108565
SIM,1933,21,35-39,1954,30
STAT,1936,28,30-34,1964,75.71141119674016
STAT,1833,50,25-29,1883,0.005001266816159493
STAT,1851,45,35-39,1896,0.21918921921481846
STAT,1929,36,15-19,1965,0.04983191124101695
STAT,1821,38,25-29,1859,10.599944381602823
SIM,1803,62,na,1865,1958
STAT,1864,31,50-100,1895,1.6608665204928663
STAT,1930,29,40-44,1959,11.95774701670552
STAT,1954,16,20-24,1970,338.5493236544233
SIM,1922,27,40-44,1949,15
SIM,1845,19,20-24,1864,33
SIM,1934,15,40-44,1949,4
SIM,1896,37,30-34,1933,16
SIM,1834,34,45-49,1868,3
SIM,1866,86,na,1952,337
STAT,1914,27,40-44,1941,9.491411344768464
STAT,1910,20,50-100,1930,1.2558705513804487
SIM,1886,24,40-44,1910,6
SIM,1915,16,35-39,1931,3
STAT,1891,23,na,1914,5885.8214338272865
STAT,1827,30,30-34,1857,47.90078419176926
SIM,1853,25,40-44,1878,4
SIM,1883,34,na,1917,4888
SIM,1929,21,45-49,1950,3
STAT,1865,20,15-19,1885,6.215602368785498
STAT,1843,26,45-49,1869,1.9279568441004653
SIM,1845,34,20-24,1879,7
STAT,1905,49,35-39,1954,0.22584291329913908
STAT,1820,81,na,1901,605.3898592611761
STAT,1839,27,30-34,1866,49.53403288371508
STAT,1863,29,15-19,1892,0.7963682578022212
SIM,1935,32,50-100,1967,5
STAT,1837,34,20-24,1871,4.627563848880462
SIM,1847,27,30-34,1874,59
STAT,1894,21,30-34,1915,46.35164906568675
SIM,1782,77,na,1859,608
SIM,1913,49,35-39,1962,1
STAT,1860,23,40-44,1883,3.4977813492394993
STAT,1925,21,35-39,1946,22.826739916459296
SIM,1798,60,na,1858,1876
STAT,1878,24,40-44,1902,4.3678635620638095
STAT,1888,37,30-34,1925,12.72204927142121
STAT,1845,25,40-44,1870,5.700019095194981
STAT,1930,15,30-34,1945,31.973116533595476
STAT,1925,34,40-44,1959,9.371273054296223
SIM,1860,15,30-34,1875,5
SIM,1828,38,na,1866,3412
SIM,1828,54,na,1882,2756
STAT,1883,41,15-19,1924,0.027526466897392608
STAT,1901,36,45-49,1937,1.2224060210014065
STAT,1860,56,na,1916,3345.168736930724
STAT,1913,18,35-39,1931,1.7285984680114923
SIM,1849,37,na,1886,3956
STAT,1927,30,35-39,1957,22.725321961564212
SIM,1866,39,35-39,1905,22
STAT,1949,15,35-39,1964,9.860813864650689
SIM,1881,28,20-24,1909,18
SIM,1919,29,25-29,1948,133
STAT,1878,35,20-24,1913,1.6413939469005614
SIM,1928,40,45-49,1968,1
SIM,1844,42,40-44,1886,6
SIM,1920,39,25-29,1959,4
SIM,1874,39,50-100,1913,6
STAT,1922,23,50-100,1945,1.5188247684848857
SIM,1803,77,na,1880,811
SIM,1887,32,45-49,1919,6
STAT,1816,50,15-19,1866,1.2065899236477065E-4
SIM,1868,19,na,1887,4941
SIM,1914,28,45-49,1942,5
SIM,1845,26,45-49,1871,3
STAT,1907,43,50-100,1950,0.21619246442236748
SIM,1881,26,30-34,1907,48
SIM,1934,16,45-49,1950,2
SIM,1890,36,25-29,1926,11
SIM,1908,48,50-100,1956,2
STAT,1894,47,50-100,1941,0.3577491025132953
STAT,1828,43,45-49,1871,2.772951420254113
STAT,1865,17,30-34,1882,3.013591986667112
STAT,1830,109,na,1939,9.824427849172463E-4
SIM,1886,35,20-24,1921,1
STAT,1862,32,50-100,1894,1.5816242098779447
STAT,1867,99,na,1966,16.436629411476773
SIM,1954,17,25-29,1971,135
STAT,1931,15,na,1946,9775.583390177424
STAT,1882,40,50-100,1922,2.0994323429526025
STAT,1906,37,25-29,1943,1.8288909577251604
STAT,1872,41,na,1913,4712.443615468915
SIM,1933,34,40-44,1967,14
STAT,1893,25,45-49,1918,2.8615232847187
STAT,1856,34,30-34,1890,26.973433325622217
SIM,1926,1,na,1927,10398
STAT,1896,54,na,1950,5583.539237971584
SIM,1839,75,na,1914,1307
SIM,1858,34,30-34,1892,29
STAT,1879,32,45-49,1911,3.6837844711501253
STAT,1954,1,na,1955,9829.81108288572
STAT,1832,45,25-29,1877,0.09108819244263777
STAT,1882,36,25-29,1918,5.691786614795258
SIM,1905,23,25-29,1928,195
STAT,1931,32,15-19,1963,0.3400823635168986
SIM,1859,15,na,1874,4824
SIM,1873,17,30-34,1890,5
SIM,1828,27,20-24,1855,25
SIM,1784,84,na,1868,143
SIM,1859,40,35-39,1899,7
STAT,1812,44,45-49,1856,10.998828349058611
STAT,1815,107,na,1922,0.004383477643974594
STAT,1849,44,40-44,1893,3.5098756118724763
SIM,1895,18,20-24,1913,57
SIM,1900,18,40-44,1918,1
SIM,1858,28,45-49,1886,5
STAT,1950,1,na,1951,9751.203270184997
SIM,1937,17,25-29,1954,106
STAT,1840,48,50-100,1888,0.35294308415832387
STAT,1929,17,25-29,1946,111.68336566106937
STAT,1932,24,30-34,1956,75.90574973453118
SIM,1866,37,45-49,1903,4
SIM,1864,34,30-34,1898,38
SIM,1798,82,na,1880,278
SIM,1859,49,45-49,1908,2
SIM,1935,30,35-39,1965,30
STAT,1887,18,20-24,1905,39.940158751787315
STAT,1926,18,45-49,1944,1.2334891989648744
STAT,1846,30,40-44,1876,8.014609351052728
SIM,1820,44,45-49,1864,4
STAT,1902,17,20-24,1919,50.55018004635515
SIM,1914,37,25-29,1951,2
SIM,1892,20,25-29,1912,163
STAT,1866,31,20-24,1897,5.057679911776492
STAT,1785,97,na,1882,2.066484475422577
STAT,1940,17,40-44,1957,2.868407846090424
SIM,1929,32,25-29,1961,25
STAT,1879,16,50-100,1895,0.10374840610336644
STAT,1893,16,30-34,1909,4.090132229731724
STAT,1817,42,30-34,1859,6.240045196964992
STAT,1892,31,15-19,1923,0.36152012469848943
STAT,1921,17,30-34,1938,28.053012103979768
SIM,1861,45,45-49,1906,1
STAT,1874,51,25-29,1925,0.007359626248321203
SIM,1910,17,20-24,1927,59
SIM,1825,36,45-49,1861,9
STAT,1764,98,na,1862,0.8284806828064772
STAT,1916,48,na,1964,7588.988959151647
STAT,1926,25,50-100,1951,2.4257313156880134
STAT,1928,11,na,1939,10096.631741294213
SIM,1889,19,35-39,1908,2
STAT,1945,26,30-34,1971,86.84988345539124
STAT,1842,47,35-39,1889,0.20846884431190835
SIM,1848,89,na,1937,131
STAT,1906,28,45-49,1934,3.256058328002405
STAT,1884,27,45-49,1911,2.214244730626216
STAT,1876,18,45-49,1894,0.13609205237448277
STAT,1836,49,25-29,1885,0.0781371471749232
SIM,1849,45,45-49,1894,1
STAT,1927,17,15-19,1944,113.9470989565677
SIM,1892,27,45-49,1919,3
STAT,1873,22,15-19,1895,6.7697824536599365
SIM,1862,19,na,1881,4829
SIM,1895,31,40-44,1926,16
STAT,1863,27,25-29,1890,74.78471027618659
STAT,1827,38,na,1865,3365.7729719290646
SIM,1918,17,15-19,1935,104
SIM,1815,62,na,1877,1847
STAT,1856,39,25-29,1895,4.44131489495014
SIM,1860,24,45-49,1884,1
STAT,1880,60,na,1940,4057.664006235279
STAT,1912,39,25-29,1951,1.9218206861329004
STAT,1852,15,30-34,1867,3.1089428219403437
STAT,1910,16,na,1926,7750.955998061765
SIM,1825,42,30-34,1867,3
STAT,1835,57,na,1892,2602.7572203957525
SIM,1848,6,na,1854,4757
STAT,1884,20,25-29,1904,114.84439573744952
SIM,1938,28,30-34,1966,83
SIM,1854,17,20-24,1871,32
STAT,1842,40,15-19,1882,0.021823933952083437
STAT,1887,31,40-44,1918,9.83577506105469
SIM,1876,31,30-34,1907,51
SIM,1935,17,15-19,1952,108
SIM,1931,30,50-100,1961,3
STAT,1946,17,25-29,1963,97.06526530828442
SIM,1835,39,na,1874,3530
STAT,1865,93,na,1958,78.77331338631343
STAT,1915,9,na,1924,8387.784201670509
SIM,1839,28,35-39,1867,27
SIM,1949,22,25-29,1971,241
SIM,1809,72,na,1881,1088
STAT,1869,44,45-49,1913,2.889300569890672
SIM,1908,26,45-49,1934,5
STAT,1857,51,25-29,1908,0.005602504033024893
STAT,1929,38,40-44,1967,3.8771686164537016
SIM,1849,23,25-29,1872,124
STAT,1836,42,40-44,1878,3.5585080668073927
SIM,1871,27,25-29,1898,9
SIM,1919,15,15-19,1934,24
STAT,1837,26,45-49,1863,2.001050114531296
SIM,1869,35,20-24,1904,1
STAT,1848,37,na,1885,3981.0137487784295
STAT,1892,16,50-100,1908,0.12417018295082112
STAT,1818,37,50-100,1855,8.495540655600545
STAT,1898,19,35-39,1917,1.4916278034745025
SIM,1923,33,na,1956,9100
STAT,1841,35,25-29,1876,5.025216574331583
SIM,1942,9,na,1951,8502
STAT,1864,48,25-29,1912,0.10267924032235855
STAT,1839,23,na,1862,4258.819908593687
SIM,1923,17,30-34,1940,37
SIM,1924,47,45-49,1971,2
STAT,1906,34,30-34,1940,29.25150311893927
STAT,1924,29,40-44,1953,10.879204546095933
SIM,1853,36,20-24,1889,4
SIM,1903,26,50-100,1929,2
SIM,1842,42,na,1884,3443
STAT,1871,29,25-29,1900,84.27179418098248
SIM,1824,54,30-34,1878,2
STAT,1865,50,20-24,1915,0.0013733995090929167
STAT,1881,23,na,1904,4602.501290180958
SIM,1842,45,35-39,1887,1
SIM,1868,36,40-44,1904,15
STAT,1776,83,na,1859,247.77034439413458
STAT,1874,85,na,1959,776.1478236507712
SIM,1867,104,na,1971,2
SIM,1908,28,45-49,1936,6
STAT,1884,37,na,1921,4698.455698841632
SIM,1933,26,na,1959,10485
SIM,1870,86,na,1956,464
STAT,1832,27,20-24,1859,20.591718768182435
STAT,1835,24,45-49,1859,1.183871630683403
SIM,1835,24,na,1859,3736
STAT,1837,40,40-44,1877,3.7961706698207935
STAT,1883,45,30-34,1928,0.19399259465552568
SIM,1840,49,40-44,1889,1
SIM,1886,27,45-49,1913,4
SIM,1913,25,15-19,1938,1
SIM,1818,54,na,1872,2571
STAT,1900,16,25-29,1916,15.915037198716592
SIM,1885,39,45-49,1924,10
STAT,1816,54,30-34,1870,0.026958325284856876
STAT,1882,53,25-29,1935,0.006856656927522475
SIM,1937,34,25-29,1971,18
STAT,1850,18,25-29,1868,10.55482301693919
STAT,1877,39,45-49,1916,4.138580545927672
STAT,1932,15,40-44,1947,3.7582158161173402
SIM,1837,68,na,1905,1970
STAT,1817,38,35-39,1855,48.58280518226758
SIM,1856,93,na,1949,31
SIM,1789,83,na,1872,212
SIM,1940,15,40-44,1955,4
SIM,1867,24,30-34,1891,40
STAT,1927,38,30-34,1965,4.571146420627731
SIM,1897,18,30-34,1915,6
SIM,1936,26,30-34,1962,96
STAT,1914,52,na,1966,7235.930945144795
STAT,1940,22,15-19,1962,10.952565381194994
STAT,1855,31,45-49,1886,2.705390870921083
STAT,1905,25,15-19,1930,1.3341559633260387
STAT,1897,38,35-39,1935,18.999647327937932
STAT,1951,15,50-100,1966,0.9014450398919553
SIM,1914,34,30-34,1948,46
SIM,1837,17,20-24,1854,26
SIM,1824,61,na,1885,2384
SIM,1891,45,30-34,1936,1
STAT,1876,22,40-44,1898,4.352784372108331
SIM,1851,23,40-44,1874,7
SIM,1861,103,na,1964,2
STAT,1825,40,15-19,1865,0.033315474977199847
STAT,1916,47,45-49,1963,0.4502105289397994
SIM,1939,1,na,1940,8535
STAT,1832,49,40-44,1881,0.2340515487063028
STAT,1837,37,25-29,1874,4.886947103219087
STAT,1861,49,50-100,1910,0.4042355497548231
STAT,1834,36,45-49,1870,3.3351847969075803
STAT,1933,32,25-29,1965,25.158298188343736
SIM,1863,31,45-49,1894,5
STAT,1823,44,20-24,1867,0.502550334205745
SIM,1872,39,35-39,1911,20
STAT,1911,29,30-34,1940,76.64334328646524
STAT,1860,26,45-49,1886,1.853810773879274
STAT,1854,32,50-100,1886,1.438387804756456
STAT,1886,70,na,1956,3051.219864651036
STAT,1937,16,20-24,1953,267.0804283955466
STAT,1765,101,na,1866,0.23994946687894497
STAT,1884,29,35-39,1913,19.10504279996554
SIM,1931,37,35-39,1968,9
SIM,1871,6,na,1877,5348
STAT,1845,36,20-24,1881,1.2610674159829942
STAT,1879,47,30-34,1926,0.20353445221990976
STAT,1820,50,50-100,1870,0.05624656074607401
STAT,1931,36,30-34,1967,4.879491713471072
STAT,1768,114,na,1882,5.29946692235344E-4
STAT,1890,35,20-24,1925,1.9183097339696573
STAT,1923,37,35-39,1960,5.658311062046022
SIM,1945,16,20-24,1961,320
STAT,1858,43,30-34,1901,1.7969832720789896
STAT,1863,48,50-100,1911,0.42874071088090193
STAT,1847,32,15-19,1879,0.2548772014656134
SIM,1867,34,na,1901,4786
STAT,1896,22,na,1918,6306.232553078429
SIM,1862,19,20-24,1881,27
SIM,1849,75,na,1924,1524
STAT,1854,19,20-24,1873,32.12905868147706
SIM,1902,49,na,1951,6404
SIM,1907,44,40-44,1951,1
SIM,1840,27,20-24,1867,21
SIM,1855,32,15-19,1887,1
SIM,1888,35,30-34,1923,17
SIM,1880,20,40-44,1900,6
SIM,1842,36,45-49,1878,5
SIM,1919,33,na,1952,8249
STAT,1906,25,40-44,1931,8.87558655195777
STAT,1885,48,na,1933,4466.016595001826
SIM,1842,28,50-100,1870,1
STAT,1832,44,50-100,1876,1.642015180633281
STAT,1834,28,50-100,1862,1.1085603882726516
SIM,1840,44,50-100,1884,4
SIM,1918,34,50-100,1952,1
STAT,1843,23,40-44,1866,3.6376805861836337
STAT,1863,30,40-44,1893,7.728511506323625
SIM,1892,29,35-39,1921,33
STAT,1908,21,35-39,1929,17.54694221103197
SIM,1849,20,30-34,1869,50
SIM,1845,37,25-29,1882,8
SIM,1851,94,na,1945,14
SIM,1864,42,na,1906,4406
STAT,1901,40,40-44,1941,0.44607509785243304
STAT,1902,67,na,1969,5186.235740934702
SIM,1833,40,15-19,1873,2
SIM,1932,15,na,1947,9979
SIM,1929,36,40-44,1965,3
STAT,1877,43,40-44,1920,4.683012094711268
SIM,1834,25,30-34,1859,50
SIM,1909,31,45-49,1940,4
SIM,1885,43,40-44,1928,5
SIM,1894,20,35-39,1914,21
STAT,1854,50,45-49,1904,0.022567049838010497
SIM,1934,18,45-49,1952,2
SIM,1844,42,50-100,1886,7
STAT,1878,27,45-49,1905,2.3419631316028173
STAT,1932,27,25-29,1959,174.12624265565478
STAT,1881,52,20-24,1933,0.0014328102094149139
STAT,1908,48,15-19,1956,6.713980145931501E-4
STAT,1928,38,15-19,1966,0.04895733775261773
SIM,1838,90,na,1928,99
STAT,1937,10,na,1947,7810.026865747875
SIM,1843,53,na,1896,3146
SIM,1875,26,30-34,1901,54
STAT,1926,16,45-49,1942,1.239766858875908
SIM,1844,38,45-49,1882,3
SIM,1876,33,50-100,1909,5
STAT,1862,21,35-39,1883,10.386410257373038
STAT,1858,15,na,1873,4271.7898015013825
SIM,1907,48,na,1955,6583
SIM,1870,21,35-39,1891,13
STAT,1841,42,na,1883,3484.650929234876
STAT,1854,30,40-44,1884,6.950952704248081
STAT,1844,30,30-34,1874,34.42518790830852
STAT,1886,20,35-39,1906,12.515137907700378
SIM,1848,41,20-24,1889,1
SIM,1825,38,35-39,1863,19
SIM,1881,60,na,1941,3233
STAT,1867,22,15-19,1889,6.26556077403949
STAT,1838,46,30-34,1884,0.1365200638810261
SIM,1862,32,50-100,1894,2
SIM,1914,34,na,1948,7759
STAT,1815,45,25-29,1860,0.31945021144209035
SIM,1836,29,20-24,1865,18
STAT,1950,19,40-44,1969,3.337682758858185
STAT,1915,17,30-34,1932,5.15257165781049
STAT,1873,28,20-24,1901,23.988857383817017
STAT,1876,25,45-49,1901,2.335002154920611
SIM,1889,18,na,1907,6423
STAT,1908,38,20-24,1946,0.49631776868055477
SIM,1875,22,15-19,1897,5
SIM,1880,5,na,1885,6017
STAT,1871,26,20-24,1897,23.6201139927714
SIM,1837,41,45-49,1878,5
STAT,1905,46,30-34,1951,0.1599369553485196
SIM,1903,21,50-100,1924,2
STAT,1834,45,35-39,1879,0.22282201258174122
SIM,1897,69,na,1966,4502
STAT,1889,18,30-34,1907,3.9587069967246005
STAT,1936,24,15-19,1960,10.273363422784278
SIM,1903,27,30-34,1930,84
STAT,1856,43,20-24,1899,0.24568055701369204
SIM,1918,23,35-39,1941,28
STAT,1836,38,45-49,1874,3.2204779076332075
SIM,1904,18,25-29,1922,19
SIM,1862,30,40-44,1892,13
STAT,1948,17,35-39,1965,9.697770365728113
SIM,1896,33,15-19,1929,1
SIM,1906,39,40-44,1945,8
SIM,1852,30,30-34,1882,42
STAT,1828,29,20-24,1857,29.860210857667784
SIM,1823,39,na,1862,3234
SIM,1819,36,45-49,1855,4
STAT,1888,33,15-19,1921,0.3385018606255729
SIM,1859,20,15-19,1879,6
STAT,1856,37,35-39,1893,11.021282133473399
STAT,1931,19,30-34,1950,32.049255888289856
STAT,1914,32,15-19,1946,0.26128816583966435
SIM,1868,20,40-44,1888,5
STAT,1836,42,50-100,1878,1.6713790708471554
SIM,1841,94,na,1935,21
STAT,1879,84,na,1963,1152.8075383341936
STAT,1896,32,45-49,1928,4.649776857593146
STAT,1866,56,na,1922,3800.8166271324008
STAT,1829,41,45-49,1870,2.5018852113940295
STAT,1858,36,30-34,1894,8.431371188213033
STAT,1885,5,na,1890,5268.259600930142
SIM,1898,48,45-49,1946,1
SIM,1832,23,30-34,1855,36
SIM,1944,24,15-19,1968,11
SIM,1908,12,na,1920,7819
STAT,1811,76,na,1887,863.6020344358298
STAT,1921,48,30-34,1969,0.20234894526888633
STAT,1840,47,25-29,1887,0.08384223635983257
SIM,1812,92,na,1904,33
STAT,1931,15,15-19,1946,120.5317543383635
STAT,1880,16,45-49,1896,0.1393197320914916
STAT,1795,75,na,1870,880.7039792632731
STAT,1849,47,45-49,1896,0.3715640230265613
STAT,1802,62,na,1864,1990.6573127826289
SIM,1921,15,30-34,1936,36
STAT,1892,8,na,1900,6572.422090199238
SIM,1845,23,40-44,1868,6
STAT,1878,38,25-29,1916,6.042970027638504
SIM,1869,41,40-44,1910,4
STAT,1866,41,15-19,1907,0.02585077919976403
STAT,1889,0,na,1889,7184.737475772421
SIM,1831,38,35-39,1869,18
SIM,1886,48,na,1934,4587
STAT,1922,27,40-44,1949,10.649101428326293
STAT,1819,35,40-44,1854,29.130284052665093
STAT,1823,61,na,1884,2379.19953075122
STAT,1819,44,50-100,1863,4.581160350006952
STAT,1905,29,30-34,1934,73.02512442566558
SIM,1919,26,20-24,1945,44
STAT,1911,17,50-100,1928,0.15145935410452588
STAT,1839,36,20-24,1875,1.453360493463319
STAT,1843,39,15-19,1882,0.08184889515889518
STAT,1854,7,na,1861,4538.933482206919
SIM,1905,47,35-39,1952,1
STAT,1764,101,na,1865,0.1945716515992929
SIM,1884,25,45-49,1909,3
SIM,1884,19,na,1903,5457
STAT,1871,89,na,1960,352.4519578347289
STAT,1893,23,50-100,1916,1.0406680852612893
SIM,1855,38,20-24,1893,4
SIM,1916,38,20-24,1954,4
STAT,1909,27,50-100,1936,1.9221980772890157
SIM,1851,72,na,1923,1836
SIM,1940,27,25-29,1967,141
STAT,1823,38,35-39,1861,26.36686107256245
SIM,1858,32,40-44,1890,7
STAT,1792,100,na,1892,0.39779001089288635
SIM,1875,85,na,1960,839
STAT,1864,45,20-24,1909,0.021879692665337735
SIM,1866,34,40-44,1900,12
STAT,1798,101,na,1899,0.308907323276457
SIM,1862,1,na,1863,6362
STAT,1865,42,50-100,1907,1.9360033200238234
STAT,1926,15,40-44,1941,3.4789321210213955
STAT,1860,32,30-34,1892,28.63538279178451
STAT,1830,25,20-24,1855,32.57818100476462
STAT,1856,56,na,1912,3178.231517926007
STAT,1930,18,35-39,1948,10.927528686033098
SIM,1873,42,50-100,1915,6
STAT,1867,1,na,1868,6745.324030542849
SIM,1913,29,30-34,1942,88
SIM,1873,56,na,1929,4232
STAT,1906,30,15-19,1936,0.24258033979389185
SIM,1858,37,35-39,1895,20
SIM,1869,28,20-24,1897,24
SIM,1867,20,15-19,1887,4
STAT,1884,50,30-34,1934,0.012041584853452648
SIM,1849,27,40-44,1876,10
SIM,1886,38,25-29,1924,8
STAT,1847,38,20-24,1885,1.2065595273869867
SIM,1936,22,15-19,1958,13
STAT,1861,40,35-39,1901,3.0747081550565465
SIM,1905,25,15-19,1930,1
STAT,1810,51,35-39,1861,0.054302268000025716
SIM,1930,27,40-44,1957,15
STAT,1935,19,15-19,1954,124.65191564009284
SIM,1908,59,na,1967,6182
STAT,1838,41,50-100,1879,1.693685986625861
STAT,1913,15,30-34,1928,5.057747441849969
SIM,1832,28,25-29,1860,76
STAT,1861,16,35-39,1877,1.0664559394563895
STAT,1820,43,na,1863,3007.16256676394
STAT,1821,47,15-19,1868,0.0011707773483668792
STAT,1851,20,20-24,1871,129.424072512091
STAT,1813,95,na,1908,11.81442656608643
SIM,1846,41,50-100,1887,6
SIM,1870,28,45-49,1898,2
STAT,1848,6,na,1854,5071.0
SIM,1836,40,40-44,1876,4
STAT,1900,2,na,1902,7468.178242650884
STAT,1911,25,15-19,1936,1.4002601748247592
STAT,1825,30,20-24,1855,12.052295016223798
SIM,1916,21,35-39,1937,27
SIM,1817,91,na,1908,34
STAT,1862,28,45-49,1890,1.9098601710825263
STAT,1886,26,40-44,1912,6.408286534523221
STAT,1837,23,40-44,1860,3.775593409097965
STAT,1834,94,na,1928,26.56025553314532
STAT,1856,41,na,1897,3617.75315867077
STAT,1866,34,na,1900,4408.770164637943
SIM,1914,25,40-44,1939,10
STAT,1954,18,20-24,1972,338.34622439425
STAT,1851,26,50-100,1877,1.1694694738703424
STAT,1895,31,40-44,1926,11.459274872359865
STAT,1841,52,25-29,1893,0.005111853652067392
STAT,1919,17,15-19,1936,101.2672558871731
SIM,1879,48,35-39,1927,1
STAT,1876,18,na,1894,5261.814776865714
STAT,1934,17,40-44,1951,3.8214805730652293
SIM,1927,17,15-19,1944,104
STAT,1870,52,45-49,1922,0.02862242268780756
STAT,1828,40,40-44,1868,4.374365215143737
STAT,1853,45,45-49,1898,0.37712217698684936
STAT,1890,29,35-39,1919,23.616109402208192
STAT,1891,19,25-29,1910,14.070455622974356
SIM,1866,30,25-29,1896,27
SIM,1850,44,30-34,1894,2
STAT,1875,46,35-39,1921,0.2919357340607506
STAT,1897,44,20-24,1941,0.029370596016408484
STAT,1849,71,na,1920,2111.38527705026
STAT,1865,26,20-24,1891,21.598866793110894
SIM,1943,19,15-19,1962,91
SIM,1871,49,na,1920,4270
STAT,1892,21,20-24,1913,174.7571948652315
SIM,1887,70,na,1957,3386
SIM,1891,37,50-100,1928,6
SIM,1942,28,20-24,1970,40
STAT,1825,49,50-100,1874,0.5181348662114592
SIM,1858,89,na,1947,147
STAT,1888,39,20-24,1927,1.821547046837915
SIM,1915,42,25-29,1957,1
SIM,1927,39,35-39,1966,11
STAT,1906,48,na,1954,6539.176399412309
STAT,1908,27,40-44,1935,8.980370328365423
STAT,1923,15,15-19,1938,108.09259440551818
SIM,1840,21,15-19,1861,5
STAT,1854,49,na,1903,3376.9652738717955
STAT,1899,20,45-49,1919,1.9410984908198514
STAT,1859,15,40-44,1874,0.34534563912584765
STAT,1762,113,na,1875,0.0010883036807306883
STAT,1894,46,45-49,1940,0.3463561689474646
SIM,1873,29,25-29,1902,86
SIM,1901,27,50-100,1928,2
SIM,1931,15,15-19,1946,118
SIM,1940,20,15-19,1960,14
STAT,1819,46,20-24,1865,0.05112154476938425
STAT,1904,39,40-44,1943,2.7112958245339516
STAT,1928,22,15-19,1950,13.420909827595395
SIM,1834,76,na,1910,1102
SIM,1912,39,40-44,1951,5
SIM,1894,26,40-44,1920,10
STAT,1816,91,na,1907,56.91938855070375
STAT,1892,66,na,1958,4301.290792853061
STAT,1927,21,45-49,1948,2.8077682396166885
SIM,1833,49,50-100,1882,1
STAT,1863,24,20-24,1887,122.48044867009212
STAT,1886,37,20-24,1923,1.643405556372515
STAT,1883,37,50-100,1920,2.436177275724281
STAT,1864,39,35-39,1903,12.640299847726302
SIM,1899,33,40-44,1932,22
STAT,1910,23,40-44,1933,6.3597222568222795
STAT,1919,39,35-39,1958,5.235677287201787
SIM,1923,48,na,1971,8988
STAT,1853,25,50-100,1878,1.1895185675644915
STAT,1855,93,na,1948,44.069975870745786
SIM,1916,27,40-44,1943,15
STAT,1841,26,35-39,1867,17.5143266995643
SIM,1852,57,na,1909,3246
SIM,1932,29,40-44,1961,13
SIM,1938,24,15-19,1962,11
SIM,1798,97,na,1895,1
SIM,1888,20,35-39,1908,19
STAT,1858,30,25-29,1888,16.464544513902194
STAT,1884,24,40-44,1908,4.1296631641570505
SIM,1825,33,40-44,1858,11
SIM,1832,80,na,1912,860
SIM,1938,25,na,1963,7522
STAT,1869,41,40-44,1910,4.421613452370024
SIM,1830,26,25-29,1856,83
SIM,1935,21,45-49,1956,4
STAT,1934,28,20-24,1962,49.577215430300285
SIM,1827,35,40-44,1862,11
STAT,1848,49,50-100,1897,0.3943037768902783
SIM,1905,20,20-24,1925,206
SIM,1861,25,50-100,1886,1
SIM,1917,26,na,1943,8133
SIM,1920,36,20-24,1956,1
STAT,1834,72,na,1906,1678.3088634243923
STAT,1836,31,35-39,1867,17.201237965040256
STAT,1859,20,15-19,1879,6.134136127943218
SIM,1917,27,50-100,1944,2
SIM,1919,48,40-44,1967,2
STAT,1870,20,30-34,1890,35.529411746959404
SIM,1838,47,35-39,1885,1
STAT,1929,34,25-29,1963,23.677803663426435
SIM,1820,35,50-100,1855,6
STAT,1880,40,45-49,1920,3.2163410965225374
SIM,1870,32,40-44,1902,10
STAT,1838,60,na,1898,2581.114233896449
SIM,1873,26,20-24,1899,27
SIM,1888,55,na,1943,4844
SIM,1896,39,20-24,1935,1
STAT,1869,48,na,1917,4347.480995085922
STAT,1843,28,35-39,1871,16.51489692562383
STAT,1912,36,20-24,1948,0.5222628086603459
SIM,1892,24,40-44,1916,8
SIM,1844,31,35-39,1875,21
SIM,1849,53,na,1902,3471
STAT,1840,103,na,1943,0.207155371483135
STAT,1907,42,25-29,1949,0.1322043326472807
SIM,1851,28,35-39,1879,20
SIM,1889,42,20-24,1931,3
STAT,1842,44,30-34,1886,1.7260803621801346
STAT,1951,20,25-29,1971,223.01666084476832
SIM,1861,71,na,1932,2437
STAT,1870,23,35-39,1893,11.53499528649133
SIM,1928,38,40-44,1966,10
STAT,1831,28,30-34,1859,43.414042154312476
STAT,1911,32,35-39,1943,17.977068000484007
STAT,1914,33,15-19,1947,0.2601855297798209
SIM,1916,22,35-39,1938,23
SIM,1924,39,50-100,1963,4
STAT,1873,24,15-19,1897,6.727402438911838
SIM,1898,64,na,1962,5146
STAT,1860,18,na,1878,4316.349730726712
STAT,1801,82,na,1883,366.2136354114174
SIM,1840,43,50-100,1883,6
STAT,1828,32,40-44,1860,9.72133345165215
STAT,1871,37,15-19,1908,0.11267497152760046
STAT,1849,22,30-34,1871,34.06495125602921
STAT,1833,49,45-49,1882,0.3228935410874655
STAT,1881,21,45-49,1902,1.3653380528843024
STAT,1759,98,na,1857,0.4588464825044639
STAT,1857,41,20-24,1898,0.2511341920221786
STAT,1863,38,na,1901,4144.474551827138
SIM,1841,49,45-49,1890,3
STAT,1946,26,15-19,1972,1.5887932687835753
SIM,1939,17,35-39,1956,12
STAT,1889,26,20-24,1915,29.31430033249986
STAT,1958,5,na,1963,10427.547191843143
SIM,1897,26,20-24,1923,36
STAT,1923,48,40-44,1971,0.3713397196096937
STAT,1929,9,na,1938,10259.499422094223
STAT,1793,109,na,1902,2.5823991191916345E-4
SIM,1876,49,na,1925,4782
STAT,1927,42,40-44,1969,0.633443868812525
STAT,1889,4,na,1893,6551.025046458632
SIM,1848,26,25-29,1874,84
SIM,1869,51,na,1920,4149
STAT,1838,36,15-19,1874,0.09266272904046617
SIM,1817,38,na,1855,3250
SIM,1895,30,50-100,1925,3
SIM,1922,47,na,1969,8897
STAT,1860,93,na,1953,47.93206649911437
STAT,1782,112,na,1894,2.341037656100912E-4
STAT,1932,33,35-39,1965,24.521292647765186
SIM,1940,17,30-34,1957,32
STAT,1861,22,50-100,1883,0.7042399076654744
STAT,1813,44,15-19,1857,0.09066605857541402
STAT,1898,24,20-24,1922,187.16482615556015
SIM,1875,91,na,1966,270
STAT,1936,35,45-49,1971,1.354259303096605
SIM,1866,15,35-39,1881,1
SIM,1862,22,40-44,1884,5
SIM,1839,53,na,1892,2890
SIM,1926,20,50-100,1946,6
STAT,1887,40,na,1927,5273.28929348005
SIM,1876,20,15-19,1896,6
STAT,1863,20,40-44,1883,3.811927289210509
STAT,1920,30,35-39,1950,20.373484269673707
SIM,1859,30,40-44,1889,11
STAT,1932,17,30-34,1949,32.598706746272406
SIM,1886,79,na,1965,1901
SIM,1906,41,50-100,1947,1
STAT,1859,21,na,1880,3947.045238055385
SIM,1826,74,na,1900,1200
SIM,1854,23,45-49,1877,1
STAT,1883,52,30-34,1935,0.011748606866473438
STAT,1856,88,na,1944,213.9202573614519
STAT,1846,23,45-49,1869,1.3084178430784081
STAT,1854,40,40-44,1894,3.482903938452512
STAT,1906,27,30-34,1933,74.10892592729417
SIM,1914,28,na,1942,7697
SIM,1861,39,20-24,1900,1
STAT,1905,35,15-19,1940,0.035737440728662
STAT,1875,53,35-39,1928,0.017613836840417382
SIM,1839,33,20-24,1872,7
SIM,1845,25,45-49,1870,6
STAT,1868,20,15-19,1888,6.431181964780361
SIM,1903,40,na,1943,6909
STAT,1850,16,50-100,1866,0.09233657528243629
SIM,1833,30,20-24,1863,6
SIM,1871,20,40-44,1891,7
STAT,1839,17,na,1856,4688.613261794695
SIM,1889,27,25-29,1916,117
STAT,1857,23,20-24,1880,124.33684833239685
STAT,1844,49,20-24,1893,0.018974350955564816
STAT,1846,41,45-49,1887,2.3500862194459047
STAT,1854,22,40-44,1876,3.753369346640839
STAT,1950,15,25-29,1965,103.5327434668826
SIM,1822,40,50-100,1862,6
STAT,1837,25,45-49,1862,2.015521559327265
STAT,1847,36,na,1883,3765.041518612417
SIM,1912,19,20-24,1931,62
SIM,1793,98,na,1891,1
SIM,1922,15,15-19,1937,103
SIM,1899,18,na,1917,7068
SIM,1830,95,na,1925,11
STAT,1843,22,na,1865,3759.4977153031746
STAT,1851,41,na,1892,3599.0552326892366
STAT,1916,21,30-34,1937,61.00794080042662
STAT,1940,23,15-19,1963,10.948951034619201
STAT,1906,64,na,1970,5776.112402433917
SIM,1845,30,40-44,1875,17
SIM,1864,20,na,1884,4593
SIM,1953,15,na,1968,9270
STAT,1839,72,na,1911,1971.9199032059103
SIM,1793,82,na,1875,230
SIM,1906,32,20-24,1938,6
SIM,1905,38,45-49,1943,4
SIM,1865,23,20-24,1888,127
STAT,1880,35,15-19,1915,0.12060757916147102
STAT,1904,19,20-24,1923,51.11480189271729
STAT,1914,15,15-19,1929,19.05127764835512
STAT,1937,28,15-19,1965,1.38942652859567
SIM,1907,24,35-39,1931,20
STAT,1850,46,40-44,1896,0.26324105789190544
STAT,1899,16,35-39,1915,1.522083389479209
STAT,1900,48,45-49,1948,0.3682762060899627
STAT,1927,10,na,1937,9978.470426059817
SIM,1854,41,45-49,1895,4
STAT,1945,23,50-100,1968,1.455861698899582
SIM,1930,19,40-44,1949,5
SIM,1905,45,35-39,1950,1
STAT,1833,54,40-44,1887,0.013732722184741076
STAT,1874,17,50-100,1891,0.10131103160992565
SIM,1880,54,50-100,1934,2
STAT,1887,24,45-49,1911,1.5652444294691785
SIM,1857,22,30-34,1879,50
STAT,1822,44,na,1866,3033.5396887998004
SIM,1843,58,na,1901,2939
SIM,1895,24,45-49,1919,4
STAT,1922,37,40-44,1959,3.439247016038818
SIM,1893,17,na,1910,6691
STAT,1766,115,na,1881,2.229277827157032E-4
STAT,1901,17,na,1918,7140.820470727555
SIM,1874,31,20-24,1905,5
SIM,1940,24,20-24,1964,234
STAT,1914,42,30-34,1956,0.25588982690460227
SIM,1873,18,30-34,1891,3
SIM,1948,22,50-100,1970,3
SIM,1924,21,30-34,1945,90
STAT,1866,0,na,1866,7072.758168071315
SIM,1858,20,na,1878,4253
STAT,1922,19,40-44,1941,3.2508493441202857
STAT,1913,46,na,1959,7261.743965785279
STAT,1865,18,30-34,1883,2.995841929865641
STAT,1915,49,45-49,1964,0.4397477439633863
SIM,1880,54,na,1934,4582
STAT,1837,30,40-44,1867,7.739204905879936
SIM,1855,87,na,1942,237
SIM,1899,21,25-29,1920,180
SIM,1856,0,na,1856,6582
SIM,1789,77,na,1866,642
SIM,1884,68,na,1952,3160
STAT,1872,29,30-34,1901,50.74740981662582
SIM,1819,92,na,1911,20
STAT,1894,48,20-24,1942,0.0173408105223664
STAT,1942,27,na,1969,7940.875838579876
STAT,1798,61,na,1859,1801.410298772484
STAT,1868,85,na,1953,526.7565422724248
STAT,1932,24,20-24,1956,293.6655833174995
SIM,1925,1,na,1926,10037
STAT,1923,3,na,1926,9615.938341950352
SIM,1905,30,50-100,1935,2
SIM,1898,23,30-34,1921,66
SIM,1877,33,40-44,1910,12
STAT,1860,52,35-39,1912,0.01404440447232339
STAT,1945,15,15-19,1960,100.16916874267758
SIM,1880,29,30-34,1909,78
SIM,1886,41,40-44,1927,11
STAT,1924,25,25-29,1949,155.78480152053618
SIM,1821,75,na,1896,1219
STAT,1880,15,45-49,1895,0.1396241126570839
SIM,1927,43,45-49,1970,1
STAT,1866,48,45-49,1914,0.43425534800792626
STAT,1839,28,30-34,1867,49.178378527609986
STAT,1889,19,30-34,1908,3.9478205524836083
STAT,1891,7,na,1898,6503.964523128095
SIM,1866,105,na,1971,2
STAT,1866,50,na,1916,4070.0439800960926
STAT,1898,5,na,1903,7162.4349795764665
STAT,1904,24,45-49,1928,2.0086997108412676
SIM,1900,9,na,1909,7602
STAT,1863,15,45-49,1878,0.13334392990740404
SIM,1846,94,na,1940,12
SIM,1842,80,na,1922,828
SIM,1880,31,50-100,1911,4
STAT,1842,51,30-34,1893,0.008904643871530137
SIM,1829,39,na,1868,3350
STAT,1895,41,40-44,1936,0.41290565200270124
STAT,1841,27,na,1868,3898.483481961815
STAT,1865,25,20-24,1890,21.671031327431237
SIM,1832,74,na,1906,1357
SIM,1847,28,30-34,1875,59
SIM,1873,72,na,1945,2430
SIM,1912,24,45-49,1936,5
SIM,1904,17,20-24,1921,53
STAT,1854,105,na,1959,0.09968849123641772
STAT,1869,33,40-44,1902,8.450878130363508
SIM,1874,48,45-49,1922,1
SIM,1953,15,15-19,1968,114
STAT,1922,41,25-29,1963,0.16572889919748712
STAT,1936,21,50-100,1957,1.2711678239313597
SIM,1852,33,35-39,1885,21
STAT,1878,41,40-44,1919,4.765866342893431
STAT,1914,38,45-49,1952,1.3680796836018811
SIM,1830,48,50-100,1878,2
SIM,1799,83,na,1882,229
STAT,1816,44,na,1860,3000.2841868580404
STAT,1869,18,15-19,1887,11.705024919274988
SIM,1929,38,30-34,1967,11
SIM,1877,86,na,1963,669
STAT,1887,42,45-49,1929,3.376437797461212
SIM,1874,29,50-100,1903,1
SIM,1915,42,50-100,1957,1
STAT,1872,19,na,1891,5098.833642866276
STAT,1874,18,25-29,1892,11.68760971134517
STAT,1821,39,25-29,1860,9.993477411369748
SIM,1936,15,15-19,1951,71
STAT,1788,95,na,1883,5.401095265951434
SIM,1846,23,na,1869,4061
STAT,1778,102,na,1880,0.1781894675226149
SIM,1935,22,50-100,1957,2
STAT,1848,25,20-24,1873,23.297676145215842
SIM,1878,24,45-49,1902,2
SIM,1952,9,na,1961,9773
SIM,1869,67,na,1936,2893
STAT,1877,20,40-44,1897,4.396151166616716
SIM,1873,25,na,1898,5036
SIM,1896,69,na,1965,4454
STAT,1919,43,45-49,1962,0.36360050612518957
STAT,1928,15,15-19,1943,116.00959654581426
STAT,1844,33,35-39,1877,19.355035278913405
STAT,1881,55,na,1936,4036.344936037632
SIM,1820,89,na,1909,87
STAT,1830,36,15-19,1866,0.10672668043460876
STAT,1840,20,45-49,1860,1.29860305750313
STAT,1940,28,45-49,1968,3.5564953391558647
SIM,1823,38,na,1861,3266
STAT,1874,23,20-24,1897,142.06482586368142
STAT,1905,9,na,1914,7578.354168931649
SIM,1869,34,45-49,1903,6
SIM,1911,30,35-39,1941,20
STAT,1891,47,40-44,1938,0.23995433916815667
SIM,1921,22,45-49,1943,6
STAT,1858,15,35-39,1873,1.021140945615447
SIM,1877,18,15-19,1895,12
SIM,1878,42,45-49,1920,10
STAT,1881,30,50-100,1911,1.8029626948641952
STAT,1765,98,na,1863,1.0216981586213818
STAT,1874,47,40-44,1921,0.352376523255604
SIM,1941,14,na,1955,8311
STAT,1919,25,15-19,1944,1.5506438055720544
SIM,1831,42,50-100,1873,2
STAT,1846,54,50-100,1900,0.02249687652244689
SIM,1907,7,na,1914,7859
STAT,1875,15,35-39,1890,1.1462602839833032
SIM,1922,38,45-49,1960,3
SIM,1939,32,30-34,1971,39
STAT,1923,35,35-39,1958,5.668112667414979
SIM,1856,25,20-24,1881,22
SIM,1931,35,35-39,1966,3
STAT,1913,43,25-29,1956,0.14045374163952676
STAT,1828,50,40-44,1878,0.01905472537093069
STAT,1903,49,25-29,1952,0.09147970625256248
SIM,1867,72,na,1939,2319
STAT,1913,22,45-49,1935,2.2025428819091424
STAT,1954,12,na,1966,9806.34225466874
SIM,1919,9,na,1928,9041
STAT,1850,44,50-100,1894,1.5979611313652062
SIM,1884,4,na,1888,5776
STAT,1890,32,na,1922,5882.628848492653
SIM,1883,15,35-39,1898,4
STAT,1923,40,30-34,1963,0.3025231241212652
STAT,1839,35,20-24,1874,1.4685304126257426
STAT,1786,76,na,1862,659.0639955643808
SIM,1885,35,50-100,1920,4
SIM,1897,19,30-34,1916,6
STAT,1859,32,40-44,1891,6.971224870539846
STAT,1870,24,na,1894,4660.125847575761
STAT,1895,46,15-19,1941,5.954688764806014E-4
SIM,1905,51,na,1956,6567
SIM,1932,25,25-29,1957,193
SIM,1837,58,na,1895,2613
STAT,1920,49,25-29,1969,0.1177029611122834
SIM,1909,13,na,1922,7871
SIM,1838,75,na,1913,1316
STAT,1875,55,na,1930,4299.503460145584
SIM,1931,28,45-49,1959,3
SIM,1882,47,40-44,1929,1
STAT,1831,30,45-49,1861,3.00571354807201
STAT,1923,28,45-49,1951,3.9905091926601024
SIM,1836,32,40-44,1868,12
STAT,1834,52,35-39,1886,0.011750384079909092
SIM,1867,32,40-44,1899,3
STAT,1859,92,na,1951,66.95098228800622
STAT,1794,95,na,1889,5.494118604280652
STAT,1908,22,35-39,1930,17.494125914976763
STAT,1930,22,45-49,1952,2.9110907191952355
SIM,1852,35,na,1887,3912
STAT,1895,23,40-44,1918,5.466870008953247
STAT,1866,19,na,1885,4774.014875584156
STAT,1850,63,na,1913,2735.8197548085586
STAT,1864,26,15-19,1890,0.8218843461143572
SIM,1781,97,na,1878,5
SIM,1901,27,20-24,1928,38
STAT,1900,38,45-49,1938,1.1994943014824553
SIM,1917,32,na,1949,8271
SIM,1857,66,na,1923,2952
SIM,1836,46,50-100,1882,1
SIM,1889,71,na,1960,3650
SIM,1927,25,15-19,1952,2
SIM,1884,48,50-100,1932,2
STAT,1807,71,na,1878,1402.937347510619
STAT,1870,23,50-100,1893,0.8060794295307812
SIM,1845,40,40-44,1885,8
STAT,1864,108,na,1972,0.0640782051239942
SIM,1853,52,na,1905,3528
STAT,1882,48,30-34,1930,0.1880510629924882
STAT,1856,29,na,1885,3798.3563718429905
STAT,1914,29,30-34,1943,79.21830911086245
SIM,1847,35,20-24,1882,2
STAT,1910,27,20-24,1937,35.61271929013229
STAT,1889,29,25-29,1918,104.58750050638854
STAT,1875,50,30-34,1925,0.012555312226741592
STAT,1853,23,35-39,1876,10.830738964973744
SIM,1840,23,15-19,1863,10
SIM,1923,33,35-39,1956,31
STAT,1917,46,15-19,1963,7.789460443269417E-4
STAT,1837,52,50-100,1889,0.021131078040659328
STAT,1929,26,15-19,1955,1.7850004692378625
SIM,1914,32,50-100,1946,4
STAT,1904,32,45-49,1936,2.902516081682428
STAT,1845,47,15-19,1892,6.135001871143689E-4
STAT,1949,23,35-39,1972,22.181149443015723
SIM,1888,29,30-34,1917,71
STAT,1931,27,40-44,1958,12.153728034064729
SIM,1818,55,na,1873,2521
SIM,1912,32,45-49,1944,7
STAT,1849,25,35-39,1874,18.35508197283305
STAT,1883,31,20-24,1914,5.385526586772827
SIM,1902,32,35-39,1934,6
STAT,1797,102,na,1899,0.14186035974697225
SIM,1902,1,na,1903,7860
STAT,1921,44,15-19,1965,0.003480816006501659
SIM,1895,16,45-49,1911,1
STAT,1885,23,50-100,1908,0.8172463829045603
SIM,1869,26,50-100,1895,5
STAT,1816,40,20-24,1856,0.9455597399708005
SIM,1904,27,15-19,1931,3
SIM,1861,23,35-39,1884,13
STAT,1828,35,45-49,1863,4.182367537261212
STAT,1905,19,40-44,1924,0.5313548049508037
SIM,1853,80,na,1933,814
STAT,1907,31,30-34,1938,29.880545918255795
STAT,1906,40,30-34,1946,0.23732163371501602
STAT,1892,67,na,1959,4219.1361387095685
SIM,1914,48,40-44,1962,1
STAT,1840,49,50-100,1889,0.3484501186969883
SIM,1903,34,45-49,1937,8
STAT,1824,52,50-100,1876,0.03522732617522146
SIM,1924,24,35-39,1948,31
STAT,1868,14,na,1882,5085.587411131901
STAT,1845,72,na,1917,1946.0398193619556
STAT,1855,36,15-19,1891,0.08508495113782473
STAT,1854,43,45-49,1897,2.2777566248888403
STAT,1881,19,30-34,1900,3.09467709859896
STAT,1836,47,20-24,1883,0.016701076025259273
STAT,1915,33,35-39,1948,18.71895279682985
STAT,1833,56,na,1889,2694.7610508060347
STAT,1873,84,na,1957,798.0159471189488
SIM,1913,19,40-44,1932,1
STAT,1870,4,na,1874,5863.074687548926
STAT,1887,16,45-49,1903,0.14791238091749037
SIM,1881,7,na,1888,4548
STAT,1833,46,40-44,1879,0.2674876078419047
STAT,1878,23,40-44,1901,4.381797678682018
STAT,1930,40,20-24,1970,0.04705876188173396
SIM,1920,31,40-44,1951,16
SIM,1915,31,30-34,1946,40
SIM,1886,23,40-44,1909,2
STAT,1830,36,50-100,1866,2.3334330363948355
STAT,1913,25,25-29,1938,133.38645998899457
SIM,1919,28,20-24,1947,38
SIM,1893,5,na,1898,6967
SIM,1944,24,50-100,1968,5
STAT,1824,79,na,1903,747.4385719537071
STAT,1860,28,50-100,1888,1.0527762007643735
SIM,1950,8,na,1958,9186
STAT,1892,38,45-49,1930,5.015125246266687
SIM,1817,42,na,1859,3065
STAT,1842,44,40-44,1886,3.3770010732814373
SIM,1841,95,na,1936,14
SIM,1894,34,na,1928,6380
SIM,1921,25,25-29,1946,158
STAT,1955,16,15-19,1971,121.69339417528134
STAT,1910,53,na,1963,6777.7978038902165
SIM,1850,44,40-44,1894,8
STAT,1868,69,na,1937,2819.923345744534
STAT,1864,55,na,1919,3732.8629272253775
SIM,1892,9,na,1901,7439
STAT,1825,47,45-49,1872,0.5117764858662944
STAT,1877,48,20-24,1925,0.024849689000939607
SIM,1856,28,25-29,1884,87
SIM,1931,32,30-34,1963,52
STAT,1854,18,na,1872,4184.631104689712
SIM,1834,38,na,1872,3446
STAT,1902,42,35-39,1944,0.3581057234515461
STAT,1874,15,20-24,1889,36.96887965332142
SIM,1941,30,na,1971,8122
STAT,1916,24,35-39,1940,19.80190007114219
STAT,1933,21,30-34,1954,77.23622531591835
STAT,1852,51,50-100,1903,0.024186086888234967
SIM,1856,18,30-34,1874,4
STAT,1773,97,na,1870,1.7131998941724758
SIM,1896,27,15-19,1923,2
SIM,1849,30,25-29,1879,25
SIM,1904,22,45-49,1926,5
STAT,1827,33,35-39,1860,23.786213653024852
STAT,1830,29,25-29,1859,88.08290357897388
SIM,1900,48,na,1948,6419
SIM,1930,14,na,1944,10895
SIM,1879,38,50-100,1917,6
SIM,1871,77,na,1948,1492
SIM,1891,31,20-24,1922,9
SIM,1941,21,30-34,1962,90
SIM,1888,36,20-24,1924,2
SIM,1907,21,30-34,1928,62
SIM,1913,27,40-44,1940,8
STAT,1848,18,30-34,1866,3.2207121941215857
STAT,1815,90,na,1905,73.28228402159492
SIM,1830,24,na,1854,3410
SIM,1882,49,na,1931,4531
SIM,1888,23,50-100,1911,1
STAT,1894,24,35-39,1918,15.044774678331079
STAT,1939,33,20-24,1972,5.023723340034611
STAT,1827,91,na,1918,70.072492813195
STAT,1918,45,na,1963,7931.468660270961
SIM,1884,25,50-100,1909,3
SIM,1882,15,20-24,1897,41
SIM,1936,33,45-49,1969,4
SIM,1805,57,na,1862,2151
STAT,1905,45,40-44,1950,0.28487492258288616
SIM,1910,42,35-39,1952,1
STAT,1816,54,40-44,1870,0.047678360332806737
SIM,1885,20,40-44,1905,7
STAT,1880,38,na,1918,4987.651380636815
STAT,1822,38,30-34,1860,20.374110159452297
STAT,1829,46,15-19,1875,6.394544914717595E-4
SIM,1829,38,50-100,1867,4
SIM,1905,47,50-100,1952,3
SIM,1835,23,na,1858,3757
SIM,1835,33,35-39,1868,31
STAT,1925,15,50-100,1940,0.9181037967649106
SIM,1899,46,50-100,1945,1
STAT,1835,105,na,1940,0.037974428258500864
SIM,1849,15,35-39,1864,1
STAT,1841,47,30-34,1888,0.14108672753092977
STAT,1941,23,35-39,1964,19.646460399235504
SIM,1862,25,45-49,1887,3
SIM,1875,20,na,1895,5293
STAT,1870,39,20-24,1909,1.513076908013586
SIM,1921,18,35-39,1939,12
SIM,1857,25,35-39,1882,27
SIM,1787,82,na,1869,231
STAT,1897,66,na,1963,4820.90880985634
SIM,1840,20,50-100,1860,6
STAT,1885,85,na,1970,1184.426926337859
STAT,1928,33,45-49,1961,3.9707156717103005
SIM,1918,27,15-19,1945,4
STAT,1845,41,na,1886,3673.4760951821854
STAT,1883,45,40-44,1928,0.3430943403252796
STAT,1854,25,45-49,1879,1.989271446145548
STAT,1819,104,na,1923,0.06979336771084473
STAT,1911,48,20-24,1959,0.021076891889174634
STAT,1832,23,15-19,1855,6.485549456969803
SIM,1868,32,35-39,1900,27
STAT,1888,27,15-19,1915,1.083017511167188
STAT,1893,52,na,1945,5482.654574794227
SIM,1906,35,25-29,1941,3
STAT,1886,48,15-19,1934,8.420611455214893E-4
SIM,1905,35,40-44,1940,5
SIM,1837,39,30-34,1876,11
SIM,1864,52,na,1916,4071
STAT,1821,36,20-24,1857,3.215607155336388
STAT,1900,22,35-39,1922,16.34882403838272
STAT,1835,48,50-100,1883,0.3311698564577255
STAT,1875,23,na,1898,4902.571642423445
STAT,1896,37,15-19,1933,0.14973211312945567
SIM,1921,29,40-44,1950,16
SIM,1933,38,20-24,1971,1
STAT,1825,54,35-39,1879,0.017295455594110255
STAT,1921,24,45-49,1945,2.549975960118688
STAT,1875,28,50-100,1903,1.3254632640540003
SIM,1840,15,15-19,1855,11
SIM,1891,45,40-44,1936,1
STAT,1844,21,40-44,1865,4.232022628679252
SIM,1860,4,na,1864,5131
STAT,1904,53,na,1957,6217.3137465498785
STAT,1922,17,15-19,1939,106.04715589231843
STAT,1914,25,15-19,1939,1.4473043399254613
SIM,1851,41,na,1892,3697
STAT,1886,22,35-39,1908,12.440908363284393
SIM,1865,27,50-100,1892,1
SIM,1913,37,40-44,1950,7
SIM,1944,17,15-19,1961,90
STAT,1911,38,20-24,1949,0.5118187270403576
STAT,1892,45,35-39,1937,0.20165428371020677
SIM,1842,64,na,1906,2416
SIM,1830,38,30-34,1868,15
STAT,1906,34,20-24,1940,4.528626063824462
SIM,1928,32,na,1960,9696
SIM,1898,35,50-100,1933,6
STAT,1937,18,20-24,1955,265.7280450128511
SIM,1945,18,20-24,1963,341
STAT,1931,35,40-44,1966,4.011109159646745
SIM,1852,21,40-44,1873,6
STAT,1905,27,40-44,1932,8.74938511319287
SIM,1848,18,25-29,1866,16
STAT,1870,24,50-100,1894,0.8035160969448731
STAT,1804,59,na,1863,2029.833889845923
SIM,1827,31,35-39,1858,21
SIM,1922,25,15-19,1947,2
STAT,1874,38,na,1912,4847.795160836003
SIM,1832,24,20-24,1856,129
STAT,1878,31,40-44,1909,9.184821287656677
SIM,1894,22,35-39,1916,15
SIM,1835,35,50-100,1870,2
STAT,1829,39,30-34,1868,8.980952357806459
STAT,1955,8,na,1963,10535.476252736455
SIM,1852,67,na,1919,2499
SIM,1908,23,40-44,1931,9
STAT,1848,28,25-29,1876,82.21051506707916
STAT,1857,42,na,1899,3633.8671435803017
SIM,1833,60,na,1893,2431
SIM,1849,23,35-39,1872,11
STAT,1797,76,na,1873,747.1661415765416
STAT,1876,49,na,1925,4601.477698189395
STAT,1913,29,40-44,1942,9.315020257021798
STAT,1850,108,na,1958,0.005405115139909794
SIM,1877,36,45-49,1913,7
STAT,1924,22,20-24,1946,264.9183165091021
STAT,1903,46,20-24,1949,0.01951994455224666
STAT,1913,47,40-44,1960,0.3108687078030507
SIM,1916,47,na,1963,7717
SIM,1863,35,na,1898,4451
STAT,1927,26,na,1953,9227.98973575283
STAT,1879,85,na,1964,1037.411503746941
SIM,1898,26,35-39,1924,35
STAT,1898,42,20-24,1940,0.030104210025596434
SIM,1912,33,na,1945,7710
STAT,1869,36,45-49,1905,3.9199093131180485
SIM,1861,87,na,1948,238
STAT,1904,21,40-44,1925,6.058655990685637
SIM,1841,17,25-29,1858,10
STAT,1909,43,35-39,1952,0.37830805006273155
SIM,1912,21,40-44,1933,9
STAT,1785,82,na,1867,348.4992634650667
STAT,1925,38,20-24,1963,0.6382106482860695
STAT,1888,35,15-19,1923,0.13531763393821486
SIM,1914,27,30-34,1941,82
STAT,1912,31,40-44,1943,7.810802136653067
STAT,1945,22,50-100,1967,1.456342291855894
SIM,1778,77,na,1855,567
STAT,1868,34,35-39,1902,19.292820774556866
STAT,1923,32,30-34,1955,36.46611677756529
SIM,1932,22,20-24,1954,274
STAT,1905,37,40-44,1942,2.759686535609655
SIM,1934,32,na,1966,10270
STAT,1949,21,50-100,1970,1.5510691019768794
STAT,1840,25,15-19,1865,0.8284086513726534
SIM,1853,21,35-39,1874,14
STAT,1886,23,na,1909,5026.567561979288
SIM,1889,19,25-29,1908,14
STAT,1919,40,40-44,1959,0.5488331767187925
STAT,1868,15,45-49,1883,0.12931033206741535
STAT,1851,44,35-39,1895,2.769201581817258
STAT,1931,17,40-44,1948,3.6976131505201146
SIM,1836,35,45-49,1871,5
STAT,1837,49,30-34,1886,0.13654005845149617
SIM,1904,66,na,1970,5398
STAT,1810,59,na,1869,2137.5614582169624
SIM,1830,79,na,1909,754
STAT,1923,25,40-44,1948,10.877602965904767
SIM,1921,47,40-44,1968,1
STAT,1834,73,na,1907,1578.4494860506409
STAT,1866,26,50-100,1892,1.1961446085583325
SIM,1876,34,35-39,1910,23
SIM,1901,17,na,1918,7212
STAT,1876,40,na,1916,4876.57047565211
STAT,1936,17,15-19,1953,87.7696215512276
STAT,1847,34,15-19,1881,0.2271711562737543
STAT,1885,22,40-44,1907,4.189072948223105
STAT,1851,37,45-49,1888,3.123361632659054
STAT,1923,43,35-39,1966,0.47442686914492727
STAT,1860,42,35-39,1902,2.966228182125978
SIM,1845,49,30-34,1894,1
STAT,1867,20,25-29,1887,110.30003071905243
SIM,1850,30,20-24,1880,6
STAT,1922,35,15-19,1957,0.04419505037272288
SIM,1894,20,50-100,1914,1
SIM,1937,26,15-19,1963,5
SIM,1931,25,40-44,1956,20
STAT,1903,28,20-24,1931,33.6157746406159
STAT,1934,5,na,1939,10985.300334698582
STAT,1895,26,45-49,1921,2.9319348324701378
STAT,1928,36,25-29,1964,2.515002411525735
SIM,1911,28,20-24,1939,38
STAT,1939,11,na,1950,8005.5355309845845
SIM,1927,40,40-44,1967,1
SIM,1882,33,na,1915,4932
STAT,1897,70,na,1967,4411.23507672784
STAT,1905,35,50-100,1940,0.7813503099026459
SIM,1874,16,25-29,1890,18
STAT,1899,34,50-100,1933,2.5136715966624887
SIM,1869,16,15-19,1885,16
SIM,1889,12,na,1901,6594
SIM,1914,34,20-24,1948,7
SIM,1886,31,40-44,1917,14
SIM,1819,40,40-44,1859,7
SIM,1871,61,na,1932,3603
SIM,1826,31,40-44,1857,7
SIM,1847,24,15-19,1871,8
SIM,1871,30,40-44,1901,11
STAT,1852,50,35-39,1902,0.013918386137576618
STAT,1920,22,35-39,1942,21.136228138145732
SIM,1888,34,na,1922,5651
SIM,1875,20,25-29,1895,142
STAT,1842,30,20-24,1872,4.963534829221331
STAT,1828,53,45-49,1881,0.0225227210197235
STAT,1895,44,45-49,1939,0.26981294237808634
STAT,1908,6,na,1914,7831.559183641481
SIM,1865,37,na,1902,4384
SIM,1930,17,15-19,1947,114
STAT,1840,73,na,1913,1714.4501113862293
STAT,1840,18,30-34,1858,2.9611777040862206
STAT,1911,11,na,1922,7995.791349414331
SIM,1897,29,25-29,1926,143
STAT,1866,16,25-29,1882,10.903030297521246
STAT,1915,25,na,1940,7769.936380459908
SIM,1843,48,50-100,1891,2
SIM,1931,6,na,1937,10609
STAT,1901,19,20-24,1920,49.85628941763338
STAT,1811,45,na,1856,2871.0664747092605
STAT,1833,40,20-24,1873,0.2600078161505785
SIM,1875,36,na,1911,5271
STAT,1894,20,40-44,1914,5.438483639417193
STAT,1909,25,35-39,1934,29.43834659854535
STAT,1924,31,30-34,1955,37.13438358518221
STAT,1813,42,45-49,1855,11.121154195133345
SIM,1915,39,45-49,1954,2
SIM,1869,26,45-49,1895,4
STAT,1828,47,15-19,1875,7.204817320023983E-4
STAT,1865,48,30-34,1913,0.1753780556022282
STAT,1942,22,35-39,1964,19.93909898756648
STAT,1858,50,30-34,1908,0.009506479745459288
STAT,1828,46,50-100,1874,0.44823436607656353
STAT,1859,22,40-44,1881,3.4754274860964567
SIM,1858,15,25-29,1873,14
STAT,1814,89,na,1903,90.4121670753999
SIM,1930,33,25-29,1963,30
STAT,1822,45,50-100,1867,0.7858164650231467
SIM,1904,25,25-29,1929,134
STAT,1886,54,na,1940,4464.318408908516
STAT,1882,40,na,1922,4593.007560846505
SIM,1858,24,40-44,1882,5
STAT,1865,33,20-24,1898,4.938673037075357
SIM,1884,13,na,1897,5612
STAT,1795,81,na,1876,443.73137519463364
STAT,1928,30,40-44,1958,9.892085457977947
SIM,1853,21,na,1874,4183
STAT,1931,29,30-34,1960,102.06794196087634
STAT,1878,52,45-49,1930,0.030448086513012083
SIM,1864,35,20-24,1899,3
STAT,1869,26,15-19,1895,0.8909153679670969
STAT,1910,41,35-39,1951,0.38670634873508897
STAT,1935,33,35-39,1968,25.522703861502805
STAT,1825,44,40-44,1869,4.970975205342183
SIM,1913,48,45-49,1961,1
STAT,1821,37,50-100,1858,4.807013006531632
SIM,1836,40,na,1876,3258
SIM,1875,23,50-100,1898,2
SIM,1880,25,15-19,1905,5
STAT,1848,36,25-29,1884,4.915906365677358
SIM,1857,35,na,1892,4184
STAT,1922,33,25-29,1955,20.99627784821194
STAT,1910,22,na,1932,7240.430548789866
STAT,1892,35,40-44,1927,11.17273295820256
SIM,1839,85,na,1924,364
STAT,1856,35,20-24,1891,1.2125722317828371
SIM,1852,63,na,1915,2862
SIM,1784,78,na,1862,477
SIM,1821,42,45-49,1863,7
SIM,1917,25,35-39,1942,42
STAT,1841,17,30-34,1858,2.9826373808950524
STAT,1916,41,50-100,1957,0.24349203083451273
SIM,1920,34,45-49,1954,5
STAT,1842,37,na,1879,3740.6454781824473
SIM,1900,43,40-44,1943,2
STAT,1829,55,na,1884,2534.5169928676787
STAT,1905,48,45-49,1953,0.3839393944461885
SIM,1788,67,na,1855,1389
SIM,1773,90,na,1863,30
STAT,1851,41,30-34,1892,1.7902597296274754
STAT,1895,38,15-19,1933,0.14704508106645583
STAT,1826,101,na,1927,0.683096383103396
SIM,1844,23,35-39,1867,13
SIM,1853,35,45-49,1888,7
STAT,1852,48,20-24,1900,0.01888540814008195
SIM,1892,40,30-34,1932,7
SIM,1943,15,35-39,1958,9
STAT,1836,23,35-39,1859,10.16843877832604
SIM,1869,20,na,1889,4675
SIM,1936,30,40-44,1966,11
STAT,1861,48,50-100,1909,0.4076681152855271
SIM,1845,15,15-19,1860,11
STAT,1855,62,na,1917,2756.0986200356356
STAT,1915,35,25-29,1950,2.028066373598689
STAT,1861,49,20-24,1910,0.019750923408447866
SIM,1948,22,30-34,1970,92
STAT,1918,20,50-100,1938,1.4415575371841636
STAT,1845,35,45-49,1880,3.6211840447715864
STAT,1845,21,35-39,1866,11.243842006022403
STAT,1893,36,50-100,1929,3.1579985646395827
SIM,1900,20,30-34,1920,63
SIM,1840,78,na,1918,1276
STAT,1853,76,na,1929,1498.9834423607801
STAT,1915,19,50-100,1934,0.1575288451946969
SIM,1833,39,45-49,1872,4
STAT,1762,118,na,1880,1.0518277417693938E-4
STAT,1807,50,20-24,1857,0.005005046143986288
STAT,1831,23,50-100,1854,1.5121615909308548
STAT,1857,15,20-24,1872,33.191599002965795
STAT,1909,24,45-49,1933,2.0999244893497506
SIM,1886,1,na,1887,6652
SIM,1870,92,na,1962,195
SIM,1922,19,30-34,1941,30
STAT,1768,108,na,1876,0.008749812730974908
SIM,1856,36,25-29,1892,6
SIM,1935,27,15-19,1962,2
SIM,1866,87,na,1953,254
SIM,1910,29,50-100,1939,2
SIM,1809,78,na,1887,610
STAT,1900,27,40-44,1927,8.392445270573237
STAT,1859,40,40-44,1899,3.652170169627659
STAT,1940,27,30-34,1967,80.70077115521015
SIM,1868,43,40-44,1911,7
SIM,1796,63,na,1859,1784
STAT,1891,17,na,1908,6304.877923093008
STAT,1916,48,20-24,1964,0.022828421730888077
STAT,1924,46,na,1970,8852.768073173866
STAT,1871,25,45-49,1896,2.2429542865387755
STAT,1884,75,na,1959,2313.7315544988955
STAT,1924,36,40-44,1960,3.5673403103576247
STAT,1854,22,na,1876,3851.2089574835727
STAT,1844,23,50-100,1867,0.8163344927876656
SIM,1801,82,na,1883,294
STAT,1814,40,50-100,1854,6.570995883076781
STAT,1943,16,45-49,1959,1.0701123274938644
STAT,1870,53,35-39,1923,0.01679619555130043
STAT,1869,54,45-49,1923,0.02761893780578765
STAT,1885,20,15-19,1905,6.671585785003998
STAT,1914,19,30-34,1933,5.065712979145209
SIM,1885,53,na,1938,4499
STAT,1912,34,45-49,1946,3.1012112768070916
SIM,1879,39,30-34,1918,16
STAT,1820,96,na,1916,9.612826551150622
STAT,1844,47,50-100,1891,0.3947738078204039
SIM,1928,24,20-24,1952,285
STAT,1943,12,na,1955,8412.486762619874
SIM,1892,39,na,1931,6667
STAT,1878,68,na,1946,3223.4281255770857
STAT,1887,12,na,1899,5833.352690161164
STAT,1820,48,20-24,1868,0.04401121096878176
STAT,1902,35,15-19,1937,0.03488786950438639
SIM,1814,43,50-100,1857,4
STAT,1825,39,45-49,1864,4.8618634467296955
STAT,1861,53,40-44,1914,0.017412921783268916
SIM,1833,44,40-44,1877,10
STAT,1909,18,45-49,1927,0.1974337377778611
SIM,1913,18,na,1931,8168
SIM,1932,31,30-34,1963,53
STAT,1907,39,45-49,1946,1.2643622287554084
SIM,1874,14,na,1888,5064
SIM,1882,23,20-24,1905,132
SIM,1917,24,45-49,1941,4
SIM,1932,36,40-44,1968,6
STAT,1888,41,50-100,1929,2.5332300952508464
STAT,1891,38,30-34,1929,13.238671426669109
SIM,1867,22,40-44,1889,5
STAT,1874,41,20-24,1915,0.3298978065098256
SIM,1858,88,na,1946,182
SIM,1930,15,25-29,1945,165
SIM,1885,24,35-39,1909,14
STAT,1799,95,na,1894,9.041787336123686
STAT,1924,45,na,1969,8872.376024187315
SIM,1893,20,15-19,1913,8
STAT,1880,33,45-49,1913,3.6944523782472065
STAT,1858,102,na,1960,1.087076687490782
STAT,1877,24,35-39,1901,12.16131336210446
STAT,1839,52,50-100,1891,0.023456322827544025
STAT,1857,27,50-100,1884,1.0372275353231466
STAT,1825,51,30-34,1876,0.012692924656198111
STAT,1874,69,na,1943,3034.754704132582
STAT,1895,16,na,1911,6662.786073883139
STAT,1837,51,45-49,1888,0.020711255313546426
STAT,1870,55,na,1925,4099.918804992566
SIM,1909,19,15-19,1928,15
STAT,1845,88,na,1933,211.54518256731706
STAT,1791,82,na,1873,336.3220170702051
SIM,1900,39,20-24,1939,1
SIM,1910,29,15-19,1939,2
SIM,1903,28,na,1931,6956
SIM,1824,55,na,1879,2751
STAT,1922,15,25-29,1937,101.73179316661026
STAT,1846,15,45-49,1861,0.1271831900006657
SIM,1808,93,na,1901,15
STAT,1902,29,15-19,1931,1.284416945714445
SIM,1894,33,40-44,1927,18
STAT,1841,24,20-24,1865,124.85150577352647
SIM,1862,43,45-49,1905,7
STAT,1861,21,40-44,1882,3.62469094735601
SIM,1851,42,35-39,1893,5
STAT,1808,89,na,1897,82.55115448858194
STAT,1941,25,25-29,1966,137.6393966621217
STAT,1856,28,30-34,1884,40.36900213333668
STAT,1888,34,na,1922,5647.510620089404
STAT,1885,17,na,1902,5077.216357267024
STAT,1897,40,50-100,1937,0.20005004661618925
STAT,1889,37,25-29,1926,7.169871401962572
STAT,1941,20,30-34,1961,60.03028050101535
SIM,1840,49,30-34,1889,1
SIM,1844,39,20-24,1883,1
SIM,1859,34,35-39,1893,26
STAT,1832,49,30-34,1881,0.13233755815859025
SIM,1928,18,20-24,1946,316
STAT,1830,39,50-100,1869,2.23729810557561
STAT,1911,40,35-39,1951,0.39267076360614106
STAT,1836,39,20-24,1875,1.2324424140368115
STAT,1916,16,50-100,1932,0.1609302146492975
SIM,1803,93,na,1896,27
STAT,1790,102,na,1892,0.11467884833945928
STAT,1811,47,20-24,1858,0.08146104934191868
STAT,1896,53,na,1949,5649.239897985152
STAT,1902,0,na,1902,8372.511819442307
SIM,1866,21,50-100,1887,1
STAT,1814,96,na,1910,7.389931359609803
STAT,1843,42,35-39,1885,2.611737090376589
SIM,1885,21,30-34,1906,53
STAT,1877,35,50-100,1912,2.5992237189886556
STAT,1886,33,40-44,1919,9.206613949331746
SIM,1864,28,30-34,1892,58
SIM,1923,29,50-100,1952,5
STAT,1916,10,na,1926,8487.9457492951
STAT,1800,60,na,1860,2092.8892088593225
SIM,1865,15,20-24,1880,37
STAT,1869,48,15-19,1917,7.72939558265383E-4
SIM,1876,30,40-44,1906,12
SIM,1891,54,na,1945,5521
STAT,1851,29,45-49,1880,1.986418813127115
STAT,1887,3,na,1890,5971.438250188661
SIM,1939,16,50-100,1955,1
STAT,1946,18,15-19,1964,101.62025909528369
STAT,1801,53,35-39,1854,0.052855433360788184
SIM,1830,40,45-49,1870,7
SIM,1880,31,45-49,1911,6
STAT,1908,28,na,1936,7131.71477020065
STAT,1934,16,50-100,1950,1.0261246241980515
STAT,1872,31,50-100,1903,1.8673407925312355
SIM,1865,41,20-24,1906,1
STAT,1850,37,30-34,1887,8.30108357400444
STAT,1826,81,na,1907,647.3519195690786
SIM,1913,39,30-34,1952,4
STAT,1905,39,30-34,1944,3.3260823709476233
STAT,1917,26,45-49,1943,3.671346476041975
STAT,1932,38,40-44,1970,4.058376314267012
SIM,1809,71,na,1880,1206
STAT,1886,34,50-100,1920,1.9366588125819697
STAT,1831,24,15-19,1855,6.475974988858849
SIM,1827,42,40-44,1869,7
STAT,1906,23,15-19,1929,9.678843321561093
SIM,1923,32,na,1955,9105
STAT,1872,31,45-49,1903,3.553971207723815
STAT,1877,22,30-34,1899,37.355175693714685
SIM,1830,26,15-19,1856,1
SIM,1819,77,na,1896,781
STAT,1878,34,45-49,1912,3.6467536693925484
STAT,1819,42,40-44,1861,10.41382970402477
STAT,1900,48,50-100,1948,0.38325693248791504
SIM,1897,37,25-29,1934,12
STAT,1935,15,35-39,1950,11.6413065684659
SIM,1904,18,35-39,1922,2
STAT,1907,42,50-100,1949,0.21749744911706986
STAT,1836,36,na,1872,3531.8048735628054
SIM,1923,38,40-44,1961,9
STAT,1950,21,30-34,1971,68.879262101026
STAT,1820,52,40-44,1872,0.03767693877818387
STAT,1851,34,40-44,1885,6.853314431101965
SIM,1904,43,25-29,1947,3
STAT,1904,17,30-34,1921,4.620212658595741
STAT,1916,32,35-39,1948,19.054388870770122
STAT,1897,36,20-24,1933,2.091032017477253
STAT,1833,25,25-29,1858,74.715526083831
STAT,1912,16,15-19,1928,18.584607011397335
STAT,1873,91,na,1964,296.3859062061362
STAT,1853,22,45-49,1875,1.3035991917514096
SIM,1914,23,15-19,1937,14
STAT,1884,43,35-39,1927,3.585165569041563
STAT,1870,47,50-100,1917,0.484712035107169
STAT,1893,8,na,1901,6654.521352620388
SIM,1886,34,45-49,1920,5
SIM,1839,18,30-34,1857,7
STAT,1835,21,50-100,1856,0.7074519824421494
STAT,1876,48,50-100,1924,0.5065777857554102
STAT,1915,30,30-34,1945,32.66996612953362
STAT,1936,30,na,1966,7429.070551956232
SIM,1912,17,30-34,1929,5
STAT,1932,35,25-29,1967,2.676626684643057
STAT,1815,42,50-100,1857,6.377087012886781
STAT,1922,43,15-19,1965,0.0035533072263127115
SIM,1819,43,45-49,1862,4
SIM,1849,17,25-29,1866,12
STAT,1806,82,na,1888,345.84297511736037
SIM,1919,27,na,1946,8187
STAT,1852,9,na,1861,4696.382934834665
SIM,1925,26,45-49,1951,5
STAT,1847,38,30-34,1885,8.342040777173816
STAT,1880,27,15-19,1907,0.9652852803426655
SIM,1905,15,15-19,1920,17
SIM,1920,16,15-19,1936,104
STAT,1871,34,50-100,1905,1.8227202977766106
STAT,1822,40,45-49,1862,5.312563681685875
STAT,1857,73,na,1930,1869.7565921847283
STAT,1869,54,na,1923,4097.7472391832025
SIM,1915,13,na,1928,8410
STAT,1823,42,50-100,1865,3.5182739231356117
SIM,1931,31,na,1962,10045
SIM,1892,43,35-39,1935,1
STAT,1915,38,40-44,1953,3.039293524965564
SIM,1869,36,na,1905,4604
SIM,1889,16,20-24,1905,46
STAT,1867,24,40-44,1891,3.91669365167011
SIM,1918,42,na,1960,8240
STAT,1868,1,na,1869,6824.560725557851
SIM,1838,38,30-34,1876,14
STAT,1898,16,20-24,1914,48.572634640734854
SIM,1853,32,40-44,1885,11
SIM,1964,2,na,1966,10492
STAT,1865,61,na,1926,3428.593546776122
STAT,1817,52,35-39,1869,0.03985064497528675
STAT,1897,29,30-34,1926,67.49623141110159
SIM,1924,32,35-39,1956,39
STAT,1825,102,na,1927,0.33921393292524105
STAT,1931,38,45-49,1969,1.8216329641316333
STAT,1906,48,40-44,1954,0.2806322100507754
STAT,1874,39,50-100,1913,2.5133148737651627
STAT,1936,31,na,1967,7424.984563152662
SIM,1903,16,15-19,1919,18
STAT,1796,59,na,1855,2009.7995
SIM,1947,4,na,1951,9402
SIM,1861,22,45-49,1883,2
SIM,1895,31,50-100,1926,8
STAT,1936,32,40-44,1968,7.678248903677786
SIM,1886,16,15-19,1902,14
SIM,1900,28,45-49,1928,3
SIM,1952,0,na,1952,10110
SIM,1848,58,na,1906,3002
SIM,1923,30,30-34,1953,52
SIM,1863,1,na,1864,6382
STAT,1812,49,25-29,1861,0.38673718847857275
STAT,1901,37,20-24,1938,0.470420368385027
SIM,1841,25,25-29,1866,87
SIM,1839,25,20-24,1864,20
STAT,1845,50,40-44,1895,0.016455553887863388
SIM,1861,102,na,1963,3
STAT,1887,36,15-19,1923,0.12745200784166977
STAT,1900,21,20-24,1921,193.64981850445463
SIM,1932,39,45-49,1971,2
STAT,1835,58,na,1893,2561.2692703026455
STAT,1837,22,na,1859,3900.9920171361123
STAT,1868,30,40-44,1898,8.400097967103573
STAT,1914,45,35-39,1959,0.25950290099964723
STAT,1930,23,50-100,1953,1.6971319061117347
SIM,1913,43,na,1956,7407
STAT,1827,32,45-49,1859,4.304343994446397
SIM,1844,20,30-34,1864,46
SIM,1894,18,15-19,1912,18
STAT,1856,24,15-19,1880,5.884967057378063
STAT,1877,50,na,1927,4580.4234009033835
STAT,1945,19,30-34,1964,26.87062277239066
SIM,1890,25,20-24,1915,34
SIM,1854,20,40-44,1874,6
SIM,1862,25,na,1887,4455
STAT,1908,16,50-100,1924,0.14723297203662764
STAT,1848,53,25-29,1901,0.005714612698126017
STAT,1863,23,45-49,1886,1.2483356843514781
STAT,1919,22,50-100,1941,1.454861779151664
STAT,1830,42,45-49,1872,2.6827266406515733
STAT,1858,53,35-39,1911,0.013336632346474793
SIM,1919,34,20-24,1953,6
STAT,1870,3,na,1873,6214.834309464623
SIM,1903,20,35-39,1923,16
SIM,1889,33,50-100,1922,1
STAT,1850,49,45-49,1899,0.3542964779497089
STAT,1937,26,25-29,1963,129.66516568403512
SIM,1919,29,35-39,1948,36
SIM,1875,24,40-44,1899,4
STAT,1862,51,35-39,1913,0.014932072735128879
STAT,1833,43,25-29,1876,1.0116500260909325
SIM,1899,49,na,1948,6097
SIM,1940,30,30-34,1970,38
STAT,1859,25,45-49,1884,1.8419633116754381
STAT,1796,66,na,1862,1575.4022395113527
SIM,1832,59,na,1891,2545
SIM,1855,38,30-34,1893,13
SIM,1864,9,na,1873,5319
SIM,1928,28,15-19,1956,1
STAT,1845,32,40-44,1877,7.945641971261302
STAT,1960,12,na,1972,10330.627488559243
STAT,1815,52,20-24,1867,0.0037987507772587518
SIM,1915,36,40-44,1951,4
STAT,1901,21,35-39,1922,16.548867519383393
SIM,1843,31,40-44,1874,13
STAT,1924,39,45-49,1963,1.6196102698111317
SIM,1884,72,na,1956,2607
STAT,1882,49,45-49,1931,0.454611268559166
STAT,1862,29,20-24,1891,20.106109184858095
STAT,1874,26,25-29,1900,87.77592842706986
SIM,1890,68,na,1958,4153
STAT,1836,20,30-34,1856,38.02723147696587
STAT,1846,20,40-44,1866,3.9953946236117055
SIM,1887,17,na,1904,6237
SIM,1922,45,35-39,1967,1
STAT,1861,105,na,1966,0.3331142524458539
STAT,1882,25,20-24,1907,23.237003416835584
SIM,1821,46,50-100,1867,1
STAT,1886,18,15-19,1904,12.61897286003922
SIM,1881,39,na,1920,3966
SIM,1835,32,45-49,1867,5
SIM,1900,46,45-49,1946,3
STAT,1885,45,50-100,1930,0.49865100484302977
SIM,1859,32,30-34,1891,42
SIM,1823,34,20-24,1857,9
STAT,1846,35,15-19,1881,0.09170602499181355
SIM,1892,32,na,1924,6823
STAT,1894,23,45-49,1917,1.8035386583011725
STAT,1909,49,20-24,1958,0.020399626258987665
STAT,1878,16,15-19,1894,12.548495804650129
SIM,1870,29,20-24,1899,21
STAT,1880,30,40-44,1910,9.300846368519421
STAT,1932,30,30-34,1962,42.350365930626985
STAT,1825,37,na,1862,3305.6361937664565
STAT,1839,88,na,1927,214.3584893697553
SIM,1845,88,na,1933,156
SIM,1864,24,15-19,1888,6
STAT,1813,46,50-100,1859,1.5420244289130904
STAT,1808,56,na,1864,2269.857779646092
STAT,1903,47,na,1950,6440.5933677189605
SIM,1866,17,25-29,1883,13
SIM,1844,44,na,1888,3232
STAT,1887,21,40-44,1908,4.721102655766827
STAT,1871,22,40-44,1893,4.181193728333549
SIM,1849,43,na,1892,3747
STAT,1835,31,40-44,1866,7.228703351470341
STAT,1915,32,20-24,1947,5.017530175997435
SIM,1906,49,45-49,1955,1
STAT,1864,76,na,1940,1710.356810404792
STAT,1860,62,na,1922,2997.6304666270225
SIM,1796,59,na,1855,2095
SIM,1849,47,na,1896,3668
SIM,1918,42,40-44,1960,1
STAT,1859,30,15-19,1889,0.23225348105350302
STAT,1837,33,45-49,1870,3.016537511485691
STAT,1830,24,45-49,1854,3.7237843892631926
SIM,1931,27,30-34,1958,111
STAT,1870,50,30-34,1920,0.011972489655637571
SIM,1788,92,na,1880,14
STAT,1869,9,na,1878,5311.819229970945
SIM,1879,13,na,1892,5382
STAT,1858,17,25-29,1875,10.421849094751916
SIM,1814,93,na,1907,14
SIM,1905,47,na,1952,6759
STAT,1846,51,na,1897,3313.80641551246
SIM,1820,36,50-100,1856,4
STAT,1923,27,30-34,1950,90.8252618289139
SIM,1882,26,25-29,1908,98
STAT,1907,36,40-44,1943,2.818142811964266
SIM,1910,15,45-49,1925,1
SIM,1931,23,15-19,1954,11
STAT,1902,15,45-49,1917,0.18712245152582782
STAT,1923,23,15-19,1946,12.466367780202505
SIM,1867,18,50-100,1885,1
STAT,1918,15,35-39,1933,1.8589055998172885
SIM,1937,28,40-44,1965,8
SIM,1893,24,na,1917,6171
SIM,1927,28,30-34,1955,118
STAT,1793,105,na,1898,0.010642580068712982
SIM,1917,21,40-44,1938,6
SIM,1897,38,na,1935,6475
STAT,1848,51,20-24,1899,0.001215761017155429
SIM,1870,21,na,1891,4613
SIM,1919,0,na,1919,9535
STAT,1909,21,40-44,1930,6.333808890756459
SIM,1926,33,35-39,1959,8
STAT,1818,55,na,1873,2510.4835221040867
SIM,1899,43,40-44,1942,3
SIM,1874,10,na,1884,5156
STAT,1887,49,na,1936,4976.7423029366655
SIM,1856,33,20-24,1889,7
SIM,1868,46,45-49,1914,2
STAT,1890,48,40-44,1938,0.2350714487086747
STAT,1807,53,25-29,1860,0.022608684204436527
STAT,1926,16,na,1942,9134.95157117218
STAT,1857,69,na,1926,2310.202297708043
STAT,1929,28,40-44,1957,11.774479679817905
STAT,1841,42,50-100,1883,1.5928101070635325
STAT,1839,46,25-29,1885,0.09281702866057358
SIM,1926,15,35-39,1941,11
SIM,1822,60,na,1882,2186
SIM,1923,32,20-24,1955,7
STAT,1847,43,na,1890,3497.6692309235086
STAT,1919,28,30-34,1947,85.18467455158239
SIM,1945,24,20-24,1969,234
STAT,1857,18,25-29,1875,10.422961725391657
STAT,1848,33,20-24,1881,4.6549859713340505
STAT,1778,96,na,1874,3.2306333549843043
STAT,1815,108,na,1923,0.0017025865516961721
STAT,1859,18,50-100,1877,0.09087834935032975
STAT,1918,33,35-39,1951,19.52595437354423
STAT,1841,42,20-24,1883,0.23944204680271094
SIM,1867,25,45-49,1892,4
STAT,1853,47,20-24,1900,0.01889790254276109
STAT,1779,101,na,1880,0.23221099539234602
STAT,1947,3,na,1950,9092.176592819611
SIM,1898,17,25-29,1915,16
STAT,1869,51,40-44,1920,0.020700546128691304
SIM,1876,76,na,1952,2008
STAT,1830,44,15-19,1874,0.02406971277997567
SIM,1872,87,na,1959,627
SIM,1778,78,na,1856,508
SIM,1865,18,25-29,1883,14
STAT,1774,82,na,1856,227.92833851999995
STAT,1904,46,50-100,1950,0.40272825874525514
SIM,1874,45,40-44,1919,1
STAT,1883,48,45-49,1931,0.4624044547974399
STAT,1849,16,25-29,1865,11.098877797402064
STAT,1871,45,15-19,1916,8.106069624623085E-4
STAT,1905,17,15-19,1922,17.333521141687633
STAT,1882,18,30-34,1900,3.127557721117596
STAT,1892,42,30-34,1934,2.9031228528028143
SIM,1827,96,na,1923,12
STAT,1870,17,na,1887,5055.545377661822
STAT,1931,25,15-19,1956,1.8423835806039546
STAT,1890,31,50-100,1921,2.2679185905781534
STAT,1879,37,15-19,1916,0.11862522655857002
STAT,1849,108,na,1957,0.004446476626956788
SIM,1854,39,30-34,1893,16
STAT,1941,22,20-24,1963,232.08604888424716
SIM,1843,22,na,1865,3932
SIM,1900,25,40-44,1925,16
STAT,1917,23,40-44,1940,7.194326482124527
STAT,1866,87,na,1953,328.3093177504172
STAT,1925,4,na,1929,9845.051559873988
STAT,1886,36,45-49,1922,4.270454644541858
STAT,1879,29,50-100,1908,1.3416772825734202
STAT,1921,21,40-44,1942,7.691257704421658
STAT,1937,24,20-24,1961,218.58314259613346
STAT,1900,45,40-44,1945,0.2732531676003914
STAT,1804,54,15-19,1858,1.3815175434647665E-4
STAT,1889,34,20-24,1923,6.673615449683456
SIM,1876,33,45-49,1909,3
SIM,1864,21,na,1885,4594
SIM,1897,34,20-24,1931,8
SIM,1890,18,30-34,1908,4
STAT,1900,24,25-29,1924,159.37669799863775
SIM,1911,47,na,1958,7239
STAT,1846,39,30-34,1885,8.349630453067858
SIM,1859,31,30-34,1890,39
SIM,1894,36,45-49,1930,7
SIM,1930,37,40-44,1967,6
SIM,1904,29,40-44,1933,14
SIM,1858,20,25-29,1878,110
SIM,1862,40,40-44,1902,7
STAT,1824,47,30-34,1871,0.23443553463478156
STAT,1848,21,na,1869,4299.668172184135
STAT,1931,31,na,1962,10014.865443145973
SIM,1858,51,na,1909,3705
STAT,1833,42,25-29,1875,1.0247095372744135
SIM,1895,21,40-44,1916,11
STAT,1868,33,45-49,1901,3.336659985817559
STAT,1884,68,na,1952,3047.639241325971
STAT,1888,28,50-100,1916,1.5216123976658598
STAT,1872,25,15-19,1897,0.9271461016012446
STAT,1927,27,15-19,1954,1.7330449728130362
SIM,1913,17,15-19,1930,17
STAT,1945,26,20-24,1971,40.460616077977775
STAT,1845,53,45-49,1898,0.02200363951779547
STAT,1863,69,na,1932,2594.470934730295
STAT,1860,25,na,1885,4013.4604840001703
SIM,1818,82,na,1900,369
SIM,1919,36,25-29,1955,4
SIM,1945,19,35-39,1964,16
SIM,1867,65,na,1932,3296
SIM,1922,35,40-44,1957,4
SIM,1857,16,25-29,1873,13
STAT,1817,70,na,1887,1592.0164283643746
STAT,1836,21,30-34,1857,31.488809627037668
SIM,1931,34,20-24,1965,11
STAT,1884,40,30-34,1924,2.3158840779334815
SIM,1953,18,30-34,1971,32
STAT,1945,18,30-34,1963,26.880030783164763
STAT,1784,96,na,1880,2.581789336296048
STAT,1898,19,25-29,1917,15.404608820622292
STAT,1923,34,20-24,1957,5.63828950599882
STAT,1856,53,20-24,1909,0.0011313905672001893
STAT,1866,45,40-44,1911,0.3222082975449937
STAT,1780,82,na,1862,295.2221338738823
STAT,1800,97,na,1897,4.5885470737363505
SIM,1828,30,40-44,1858,14
SIM,1816,39,45-49,1855,6
STAT,1937,19,35-39,1956,8.221570753243162
STAT,1889,15,50-100,1904,0.12256802119251563
SIM,1844,21,30-34,1865,43
SIM,1887,37,15-19,1924,2
STAT,1842,54,35-39,1896,0.012464824249835622
SIM,1918,31,35-39,1949,33
STAT,1914,35,40-44,1949,3.0478179945365333
STAT,1938,16,15-19,1954,90.651203704977
STAT,1856,40,50-100,1896,1.6628123217007191
STAT,1913,35,50-100,1948,0.8449638242375008
STAT,1854,37,15-19,1891,0.08608422888818192
SIM,1921,35,50-100,1956,5
SIM,1884,32,40-44,1916,11
STAT,1920,28,20-24,1948,40.28940838731502
SIM,1911,22,35-39,1933,25
STAT,1914,17,40-44,1931,0.5844456106480683
STAT,1868,40,35-39,1908,3.514636145617349
STAT,1901,47,15-19,1948,6.349739463694183E-4
STAT,1940,25,40-44,1965,9.608281115551495
SIM,1914,43,35-39,1957,2
STAT,1783,96,na,1879,2.7249334991745604
STAT,1848,54,25-29,1902,0.005648151752446811
SIM,1836,21,35-39,1857,9
SIM,1843,59,na,1902,2886
STAT,1842,92,na,1934,62.008247144233586
SIM,1908,28,na,1936,7130
STAT,1843,77,na,1920,1210.855834834039
SIM,1905,19,30-34,1924,5
STAT,1874,43,25-29,1917,1.3183333997960924
SIM,1922,17,40-44,1939,3
SIM,1869,31,40-44,1900,18
STAT,1882,43,20-24,1925,0.3101911747331819
STAT,1812,46,20-24,1858,0.08477450491971658
STAT,1925,31,na,1956,9073.866425811248
STAT,1890,16,15-19,1906,14.665523589990467
STAT,1940,32,30-34,1972,32.934130064312555
STAT,1833,22,20-24,1855,126.00227524503157
SIM,1850,47,45-49,1897,1
SIM,1841,22,20-24,1863,112
STAT,1866,52,30-34,1918,0.011033404437341897
SIM,1839,28,25-29,1867,85
SIM,1817,41,40-44,1858,5
SIM,1926,13,na,1939,10053
SIM,1948,5,na,1953,9375
STAT,1903,22,35-39,1925,16.780287030300286
SIM,1857,73,na,1930,2031
STAT,1919,29,30-34,1948,84.87460233621464
SIM,1896,53,na,1949,5883
SIM,1882,43,25-29,1925,3
SIM,1927,36,20-24,1963,1
STAT,1865,65,na,1930,3100.762213662601
STAT,1826,74,na,1900,1328.533505117527
SIM,1925,23,40-44,1948,10
STAT,1876,32,40-44,1908,9.058792466851227
STAT,1897,25,15-19,1922,1.2331440767460866
STAT,1831,37,na,1868,3477.9034511352143
SIM,1864,2,na,1866,6198
STAT,1819,45,45-49,1864,1.0206400530766495
SIM,1879,50,na,1929,4491
STAT,1807,52,25-29,1859,0.02307100588375032
STAT,1825,96,na,1921,9.935069428994801
STAT,1953,17,15-19,1970,110.86703355891069
STAT,1920,46,20-24,1966,0.024727352915390972
SIM,1905,37,30-34,1942,8
STAT,1919,36,20-24,1955,0.5723533289632184
SIM,1927,29,30-34,1956,124
SIM,1946,16,15-19,1962,103
STAT,1842,47,45-49,1889,0.3514189084930209
STAT,1895,31,na,1926,6305.552662494483
STAT,1927,45,45-49,1972,0.5534917006111862
STAT,1900,31,50-100,1931,2.5774662941233193
SIM,1945,26,25-29,1971,164
SIM,1878,72,na,1950,2506
STAT,1845,17,15-19,1862,11.558179641540908
SIM,1839,27,50-100,1866,1
STAT,1938,34,15-19,1972,0.2606648201278663
SIM,1853,17,15-19,1870,11
STAT,1878,35,na,1913,5016.659850756665
SIM,1903,31,40-44,1934,20
STAT,1906,17,na,1923,7432.717926300173
STAT,1832,43,50-100,1875,1.6633439618957107
STAT,1906,43,35-39,1949,0.3673920288544798
SIM,1828,49,30-34,1877,1
SIM,1904,47,40-44,1951,1
SIM,1828,85,na,1913,355
SIM,1831,25,15-19,1856,1
SIM,1920,4,na,1924,9375
SIM,1887,18,25-29,1905,14
SIM,1877,30,50-100,1907,3
SIM,1918,17,na,1935,8260
STAT,1930,15,20-24,1945,355.63540195559125
SIM,1853,89,na,1942,158
SIM,1832,81,na,1913,735
SIM,1851,88,na,1939,151
SIM,1936,34,20-24,1970,5
STAT,1812,45,45-49,1857,1.69585355755342
STAT,1934,31,40-44,1965,10.798705273166318
SIM,1834,34,35-39,1868,20
SIM,1877,93,na,1970,169
SIM,1916,36,45-49,1952,2
STAT,1877,21,30-34,1898,37.467954235964925
STAT,1858,52,na,1910,3371.940029350577
SIM,1922,47,25-29,1969,1
SIM,1839,54,na,1893,2851
STAT,1855,48,20-24,1903,0.01786784625067965
SIM,1881,39,25-29,1920,8
STAT,1882,46,40-44,1928,0.3377746004070722
STAT,1911,48,na,1959,7006.717403672074
STAT,1950,18,40-44,1968,3.338851356833077
STAT,1952,17,50-100,1969,0.9066850746529785
STAT,1881,88,na,1969,705.3094744365984
SIM,1912,18,30-34,1930,8
STAT,1910,45,15-19,1955,6.976465690744447E-4
SIM,1823,37,25-29,1860,8
SIM,1889,40,45-49,1929,5
SIM,1885,22,30-34,1907,45
STAT,1880,17,20-24,1897,37.71874500401133
STAT,1867,23,50-100,1890,0.7689214788397815
STAT,1824,42,na,1866,2937.7524082867358
STAT,1826,41,40-44,1867,4.849446126717675
SIM,1912,26,na,1938,7666
SIM,1938,31,na,1969,7732
SIM,1879,19,na,1898,5224
STAT,1882,28,25-29,1910,82.93072747611602
STAT,1896,28,50-100,1924,1.699689850866559
STAT,1900,41,25-29,1941,0.12549729450426805
STAT,1918,30,30-34,1948,34.07841640257473
SIM,1860,31,40-44,1891,14
SIM,1875,28,45-49,1903,3
SIM,1892,25,40-44,1917,12
STAT,1819,111,na,1930,1.1231020063970747E-4
STAT,1829,42,20-24,1871,0.2613977186893219
SIM,1928,26,25-29,1954,190
STAT,1873,39,25-29,1912,5.8488100419724915
SIM,1848,47,40-44,1895,1
SIM,1904,7,na,1911,7672
SIM,1858,21,50-100,1879,1
SIM,1909,22,40-44,1931,9
STAT,1893,25,35-39,1918,24.867653580292487
STAT,1844,32,45-49,1876,3.3676125638675054
SIM,1890,28,25-29,1918,112
SIM,1903,18,20-24,1921,61
SIM,1852,32,45-49,1884,4
STAT,1858,38,45-49,1896,3.1230146313111806
STAT,1883,53,na,1936,4203.989388663168
STAT,1832,52,20-24,1884,0.0010006752886022917
STAT,1871,20,50-100,1891,0.8231196511403477
SIM,1822,97,na,1919,5
STAT,1846,67,na,1913,2428.0926258644577
SIM,1854,21,na,1875,4260
STAT,1787,108,na,1895,0.0013472541206369692
SIM,1832,39,50-100,1871,3
STAT,1920,44,45-49,1964,0.3699078235753346
STAT,1923,45,25-29,1968,0.12587468183836378
STAT,1854,51,45-49,1905,0.022353791217041293
STAT,1885,54,na,1939,4209.589123669642
SIM,1823,45,na,1868,3032
SIM,1949,19,na,1968,8967
STAT,1826,34,35-39,1860,26.7068699341069
STAT,1854,86,na,1940,340.13336738077
SIM,1928,11,na,1939,10268
STAT,1861,45,40-44,1906,0.29065776607958527
STAT,1896,16,na,1912,6750.887354430198
STAT,1935,37,15-19,1972,0.05424167639096401
SIM,1831,64,na,1895,2295
STAT,1842,19,40-44,1861,0.34557306412181066
STAT,1835,32,35-39,1867,16.706036150965463
SIM,1851,31,30-34,1882,38
STAT,1914,47,25-29,1961,0.10626675513781317
SIM,1926,30,30-34,1956,53
SIM,1865,43,25-29,1908,7
STAT,1855,32,20-24,1887,4.1502447570093866
SIM,1804,62,na,1866,1860
SIM,1863,32,20-24,1895,7
STAT,1867,27,45-49,1894,2.100054637617868
STAT,1871,49,30-34,1920,0.19017526606001206
SIM,1827,69,na,1896,1700
SIM,1866,35,40-44,1901,11
SIM,1843,32,35-39,1875,35
STAT,1873,69,na,1942,3011.4813891552985
STAT,1920,20,45-49,1940,2.54078283789412
SIM,1910,20,40-44,1930,9
SIM,1907,43,40-44,1950,2
STAT,1808,93,na,1901,22.96534135767622
STAT,1857,43,25-29,1900,1.0035792498177238
STAT,1867,35,35-39,1902,13.504949168602327
SIM,1890,75,na,1965,3242
STAT,1922,37,50-100,1959,0.9645934719291962
STAT,1851,26,40-44,1877,5.476414290826415
STAT,1855,34,na,1889,3588.608565189488
STAT,1873,46,15-19,1919,8.231522232894827E-4
SIM,1904,49,30-34,1953,1
STAT,1884,25,40-44,1909,6.014493969108419
STAT,1911,19,15-19,1930,18.24839011897371
SIM,1842,36,na,1878,3669
STAT,1902,29,50-100,1931,1.8109480812739562
STAT,1852,31,40-44,1883,7.231148130216056
STAT,1899,39,45-49,1938,1.1786517821071278
SIM,1797,75,na,1872,771
SIM,1835,30,na,1865,3678
STAT,1853,50,30-34,1903,0.009553475002315575
STAT,1912,24,15-19,1936,10.672539934524137
SIM,1825,41,30-34,1866,3
SIM,1868,29,50-100,1897,5
SIM,1909,15,35-39,1924,2
STAT,1870,43,40-44,1913,4.427707923842382
SIM,1942,26,45-49,1968,10
STAT,1837,19,30-34,1856,3.149365644876013
SIM,1845,19,30-34,1864,3
STAT,1919,20,35-39,1939,20.94328804879683
SIM,1943,27,50-100,1970,2
STAT,1909,47,15-19,1956,6.839961254192654E-4
STAT,1821,52,45-49,1873,0.0408583173849171
STAT,1861,22,35-39,1883,10.077671899168758
SIM,1804,72,na,1876,1066
STAT,1904,25,20-24,1929,34.237134515623644
SIM,1920,24,15-19,1944,12
STAT,1873,59,na,1932,3988.097503935658
SIM,1837,42,20-24,1879,1
STAT,1803,52,40-44,1855,0.0773418088116557
STAT,1863,16,20-24,1879,35.97639340460956
SIM,1825,34,40-44,1859,9
SIM,1875,35,35-39,1910,5
STAT,1870,38,45-49,1908,3.9331341746809176
SIM,1924,26,40-44,1950,14
STAT,1849,45,40-44,1894,0.2735036586275035
STAT,1841,43,15-19,1884,0.02055599672302218
STAT,1930,15,na,1945,9655.200182558672
SIM,1898,32,50-100,1930,5
SIM,1856,22,na,1878,4201
STAT,1928,34,20-24,1962,6.150791405924262
STAT,1796,91,na,1887,38.81091170503558
SIM,1826,42,45-49,1868,7
SIM,1872,56,na,1928,4246
STAT,1830,48,30-34,1878,0.16494615366183502
SIM,1896,28,50-100,1924,2
STAT,1896,33,20-24,1929,7.177096650658791
SIM,1811,47,45-49,1858,2
SIM,1848,21,15-19,1869,7
STAT,1847,15,50-100,1862,0.0943162308433099
STAT,1881,38,20-24,1919,1.4972960714789947
STAT,1846,19,25-29,1865,10.77549066066078
SIM,1929,18,40-44,1947,3
STAT,1889,78,na,1967,2737.883724344004
SIM,1875,49,50-100,1924,1
STAT,1847,15,na,1862,4419.048047571688
STAT,1895,17,50-100,1912,0.12892852467037913
SIM,1871,16,20-24,1887,40
SIM,1889,48,40-44,1937,1
STAT,1885,33,45-49,1918,3.4908054646227726
SIM,1852,23,50-100,1875,1
SIM,1892,32,30-34,1924,68
STAT,1895,5,na,1900,6896.552379561201
STAT,1818,42,45-49,1860,7.37634491217112
STAT,1884,32,30-34,1916,34.81939884348722
SIM,1880,75,na,1955,2203
SIM,1925,34,45-49,1959,6
STAT,1893,73,na,1966,3681.8886857162015
STAT,1904,18,30-34,1922,4.608107701430219
SIM,1905,39,35-39,1944,7
SIM,1854,19,25-29,1873,14
STAT,1864,46,20-24,1910,0.021725222035120454
SIM,1951,13,na,1964,9797
STAT,1882,50,50-100,1932,0.030140088899628832
STAT,1917,34,45-49,1951,3.2991195588042412
SIM,1858,42,40-44,1900,8
SIM,1893,33,45-49,1926,7
STAT,1820,44,40-44,1864,8.597852173098401
STAT,1817,41,30-34,1858,6.481997658542071
STAT,1900,49,20-24,1949,0.018568237336941965
SIM,1822,43,50-100,1865,4
STAT,1916,26,40-44,1942,9.766605912465591
SIM,1909,34,na,1943,7305
STAT,1933,26,40-44,1959,12.506193292670444
STAT,1839,16,15-19,1855,12.193585796510785
STAT,1859,19,35-39,1878,1.011842637244103
SIM,1894,34,50-100,1928,4
STAT,1903,26,15-19,1929,1.3091271760150818
STAT,1813,50,45-49,1863,0.0888365514947736
STAT,1790,72,na,1862,994.8553588021281
SIM,1888,37,50-100,1925,5
SIM,1884,33,35-39,1917,23
STAT,1894,47,45-49,1941,0.34376542480373773
STAT,1910,22,40-44,1932,6.379434710076415
STAT,1913,23,20-24,1936,226.1281347461543
STAT,1882,44,15-19,1926,0.026802676796233015
STAT,1860,24,40-44,1884,3.4726672791519606
SIM,1889,22,15-19,1911,4
STAT,1830,50,45-49,1880,0.025189324619462963
SIM,1811,44,na,1855,2717
STAT,1905,15,25-29,1920,16.628170485079096
SIM,1817,42,35-39,1859,8
SIM,1904,23,20-24,1927,199
STAT,1876,30,15-19,1906,0.2998607589071131
SIM,1893,30,40-44,1923,12
STAT,1804,50,35-39,1854,0.05241559987430313
STAT,1840,21,20-24,1861,127.41243170499165
STAT,1825,36,40-44,1861,11.957629129987106
SIM,1915,28,40-44,1943,15
STAT,1770,102,na,1872,0.13866770992991684
STAT,1938,15,20-24,1953,271.3977743216069
SIM,1841,88,na,1929,156
STAT,1805,75,na,1880,948.7292353765033
SIM,1916,41,40-44,1957,1
STAT,1838,17,25-29,1855,10.13039491681199
SIM,1880,85,na,1965,953
STAT,1814,47,20-24,1861,0.06216756593700044
SIM,1929,15,20-24,1944,345
SIM,1837,19,25-29,1856,14
SIM,1935,29,20-24,1964,48
STAT,1871,44,50-100,1915,2.0911734390418295
STAT,1934,26,45-49,1960,4.696517419826425
SIM,1949,18,40-44,1967,1
STAT,1920,26,15-19,1946,1.5690240665070605
STAT,1913,49,30-34,1962,0.1747412902697058
STAT,1818,111,na,1929,1.1011699529800196E-4
STAT,1932,32,50-100,1964,2.219938512066102
STAT,1926,35,50-100,1961,1.0379214765418987
SIM,1867,19,35-39,1886,2
STAT,1875,27,40-44,1902,6.2288305146372664
STAT,1902,20,40-44,1922,5.977111669929756
SIM,1941,26,40-44,1967,11
STAT,1876,40,40-44,1916,4.745830501049348
STAT,1815,53,15-19,1868,1.2411851588418993E-4
STAT,1915,29,50-100,1944,2.035899906327121
SIM,1867,93,na,1960,100
STAT,1880,41,45-49,1921,3.1986190570806983
STAT,1918,45,15-19,1963,7.952871070951447E-4
STAT,1924,28,40-44,1952,10.918949522357321
SIM,1822,81,na,1903,484
SIM,1846,17,25-29,1863,15
SIM,1912,25,20-24,1937,38
SIM,1913,15,25-29,1928,25
SIM,1847,16,15-19,1863,15
SIM,1814,62,na,1876,2060
SIM,1833,36,40-44,1869,12
STAT,1927,29,20-24,1956,44.6310808142935
SIM,1898,20,15-19,1918,8
STAT,1810,66,na,1876,1675.5497791536702
STAT,1929,42,25-29,1971,0.18675085102810657
STAT,1828,37,20-24,1865,1.5523828365002532
STAT,1760,105,na,1865,0.0050870891111990495
STAT,1804,52,45-49,1856,0.08486462874008474
SIM,1852,36,na,1888,3870
STAT,1838,32,na,1870,3644.661629556988
SIM,1817,69,na,1886,1659
SIM,1927,20,35-39,1947,33
STAT,1875,54,na,1929,4354.072786909125
STAT,1911,4,na,1915,8132.822767413229
STAT,1925,24,na,1949,8771.048111667846
STAT,1824,53,25-29,1877,0.008099131754939034
STAT,1810,48,15-19,1858,0.002559382372145419
STAT,1895,28,20-24,1923,30.764173194437323
SIM,1921,23,20-24,1944,250
STAT,1821,50,35-39,1871,0.02522258984561726
SIM,1867,33,35-39,1900,33
STAT,1871,43,45-49,1914,2.981337768495562
SIM,1932,28,40-44,1960,15
SIM,1918,11,na,1929,8978
SIM,1833,69,na,1902,1849
STAT,1865,51,20-24,1916,0.0013604208837319886
STAT,1891,44,25-29,1935,1.5814308950239848
STAT,1778,78,na,1856,615.5242831656001
SIM,1901,22,40-44,1923,5
SIM,1883,27,40-44,1910,10
SIM,1861,19,na,1880,4976
SIM,1909,44,na,1953,7017
STAT,1874,17,na,1891,5222.738324378133
SIM,1828,29,25-29,1857,76
STAT,1869,22,35-39,1891,11.419681653619005
STAT,1870,22,45-49,1892,1.3826682167666198
STAT,1885,49,45-49,1934,0.4645241642888295
SIM,1884,40,40-44,1924,8
SIM,1810,96,na,1906,17
STAT,1951,18,50-100,1969,0.900679027574087
SIM,1844,37,na,1881,3470
SIM,1906,38,40-44,1944,4
STAT,1834,34,40-44,1868,7.242503301710295
STAT,1908,41,40-44,1949,0.47037211370138415
STAT,1788,108,na,1896,0.0011394318514098324
STAT,1807,51,50-100,1858,0.10038382744863186
SIM,1911,44,45-49,1955,2
STAT,1907,28,40-44,1935,8.860619631263212
SIM,1888,27,na,1915,5593
STAT,1843,31,30-34,1874,29.709973995547923
STAT,1786,97,na,1883,1.7519490063874583
STAT,1848,86,na,1934,363.81198563050515
STAT,1865,18,50-100,1883,0.09208528649939395
STAT,1881,22,20-24,1903,134.52278902020157
SIM,1893,23,35-39,1916,20
STAT,1823,45,20-24,1868,0.038149210194080185
STAT,1871,41,35-39,1912,3.64986543247255
STAT,1881,54,25-29,1935,0.006724158428308913
STAT,1943,24,45-49,1967,2.415978631971586
SIM,1931,29,35-39,1960,44
SIM,1862,49,30-34,1911,2
SIM,1869,29,na,1898,4568
SIM,1911,26,15-19,1937,3
STAT,1858,21,50-100,1879,0.7419693069717583
SIM,1902,30,45-49,1932,6
STAT,1908,36,45-49,1944,1.2961302508347359
STAT,1846,57,na,1903,3078.170149159446
SIM,1859,74,na,1933,1770
STAT,1890,36,20-24,1926,1.909408776804038
SIM,1826,32,35-39,1858,29
SIM,1862,27,20-24,1889,20
SIM,1831,29,30-34,1860,62
SIM,1930,39,30-34,1969,5
STAT,1899,43,30-34,1942,0.21931955901275635
STAT,1866,71,na,1937,2487.3738764367586
STAT,1922,39,30-34,1961,4.178344063286673
STAT,1923,29,35-39,1952,34.55271071714936
STAT,1850,43,25-29,1893,0.9774874339887794
STAT,1909,7,na,1916,7895.233642665224
SIM,1877,22,35-39,1899,14
SIM,1950,16,40-44,1966,5
STAT,1953,19,20-24,1972,330.97585469856614
STAT,1841,58,na,1899,2869.3552668820353
STAT,1866,37,40-44,1903,8.157387720254237
STAT,1942,16,40-44,1958,2.9529839397593225
STAT,1854,27,20-24,1881,18.85326850780099
SIM,1851,24,40-44,1875,6
SIM,1857,46,50-100,1903,1
SIM,1924,11,na,1935,9932
SIM,1853,73,na,1926,1797
SIM,1863,17,25-29,1880,16
SIM,1878,43,20-24,1921,1
STAT,1855,17,25-29,1872,10.163490143298313
STAT,1862,53,45-49,1915,0.024649120866212113
STAT,1865,44,15-19,1909,0.024996409308497617
SIM,1874,41,na,1915,4506
SIM,1946,15,20-24,1961,281
STAT,1840,45,20-24,1885,0.017920484867954195
STAT,1843,24,40-44,1867,3.611562039574834
SIM,1898,46,40-44,1944,1
STAT,1940,21,25-29,1961,190.11479531248514
SIM,1864,38,25-29,1902,7
STAT,1823,94,na,1917,23.983322113966175
SIM,1914,46,50-100,1960,1
STAT,1876,33,35-39,1909,21.06475043112502
SIM,1867,40,40-44,1907,14
STAT,1860,31,30-34,1891,28.752405080461994
STAT,1853,39,na,1892,3690.113565313397
STAT,1927,35,15-19,1962,0.04829563544131006
SIM,1858,27,45-49,1885,1
SIM,1892,28,45-49,1920,6
STAT,1872,48,20-24,1920,0.024050841907206726
SIM,1933,36,45-49,1969,5
STAT,1815,75,na,1890,956.8846994724673
SIM,1882,70,na,1952,2722
STAT,1935,24,na,1959,10038.275264344698
STAT,1944,26,50-100,1970,2.173505716187313
STAT,1850,40,20-24,1890,0.24596025550087594
SIM,1838,37,na,1875,3492
SIM,1877,38,20-24,1915,2
STAT,1911,30,45-49,1941,3.120429578610234
STAT,1914,31,25-29,1945,18.869827466359517
SIM,1835,31,30-34,1866,50
STAT,1856,38,25-29,1894,4.464216324695833
SIM,1881,36,20-24,1917,1
SIM,1851,34,35-39,1885,22
STAT,1891,19,50-100,1910,0.12164656584863717
STAT,1851,49,15-19,1900,6.071258857285722E-4
SIM,1865,37,50-100,1902,2
STAT,1894,22,30-34,1916,46.21213060199905
STAT,1934,34,45-49,1968,4.334115407952645
SIM,1868,21,30-34,1889,46
SIM,1887,15,20-24,1902,47
STAT,1924,34,35-39,1958,21.49860425234637
STAT,1932,10,na,1942,10629.092286338217
SIM,1862,56,na,1918,3695
SIM,1930,30,20-24,1960,9
SIM,1907,49,na,1956,6570
STAT,1846,42,20-24,1888,0.2462002406800509
STAT,1898,40,45-49,1938,0.2869153225778746
STAT,1932,7,na,1939,10690.766818679751
SIM,1916,33,40-44,1949,15
STAT,1936,19,20-24,1955,260.79174309336884
STAT,1840,46,35-39,1886,0.2064108252362331
SIM,1869,23,40-44,1892,6
SIM,1834,31,30-34,1865,47
SIM,1848,21,na,1869,4014
STAT,1812,61,na,1873,2211.3253104534756
STAT,1869,38,20-24,1907,1.5010224801588563
STAT,1831,108,na,1939,0.002365026449889651
SIM,1865,21,15-19,1886,6
STAT,1884,28,45-49,1912,2.206450589174412
STAT,1912,51,na,1963,7041.683137087407
STAT,1916,43,40-44,1959,0.5168507898354715
STAT,1834,41,30-34,1875,1.8687113210069033
SIM,1934,24,45-49,1958,4
STAT,1881,24,na,1905,4587.865336078185
SIM,1792,66,na,1858,1515
SIM,1885,21,50-100,1906,2
STAT,1908,12,na,1920,7742.077646985549
STAT,1893,22,30-34,1915,45.59727260669756
STAT,1877,54,35-39,1931,0.017558070635478058
STAT,1831,53,30-34,1884,0.007857053815919415
STAT,1881,46,20-24,1927,0.02349148405803682
STAT,1925,36,45-49,1961,1.6536453989904638
SIM,1811,44,40-44,1855,11
SIM,1944,19,20-24,1963,301
STAT,1921,18,30-34,1939,27.979513212267342
SIM,1893,40,35-39,1933,9
STAT,1898,44,25-29,1942,0.12023067224664309
STAT,1903,44,45-49,1947,0.2948225199740859
STAT,1812,42,40-44,1854,18.41620063887985
SIM,1909,25,45-49,1934,2
STAT,1811,54,40-44,1865,0.06548842528079753
STAT,1800,76,na,1876,816.2617106110566
STAT,1840,102,na,1942,0.4231806085208674
STAT,1899,36,40-44,1935,12.171458568962185
STAT,1920,41,40-44,1961,0.5585886141306003
SIM,1857,22,50-100,1879,1
STAT,1855,53,50-100,1908,0.022408294910684003
STAT,1922,30,20-24,1952,5.609200511716424
SIM,1908,34,45-49,1942,3
SIM,1870,36,45-49,1906,8
STAT,1865,34,na,1899,4340.943961474236
SIM,1842,34,40-44,1876,10
STAT,1922,47,30-34,1969,0.20677640268020608
SIM,1825,37,45-49,1862,3
SIM,1820,42,40-44,1862,8
STAT,1866,9,na,1875,5120.855210316376
STAT,1827,60,na,1887,2413.0119505292214
STAT,1873,36,20-24,1909,1.5894385890849716
SIM,1866,24,50-100,1890,1
STAT,1857,21,15-19,1878,6.038740007788829
SIM,1842,41,30-34,1883,5
SIM,1847,89,na,1936,170
SIM,1889,19,na,1908,6402
STAT,1884,35,35-39,1919,14.239278349382587
SIM,1866,38,45-49,1904,6
SIM,1825,44,35-39,1869,5
SIM,1922,16,na,1938,9070
STAT,1912,42,45-49,1954,0.3242687747825515
STAT,1926,24,45-49,1950,2.742970881916797
STAT,1864,49,25-29,1913,0.10181468111884427
SIM,1802,67,na,1869,1628
SIM,1875,40,30-34,1915,6
STAT,1881,47,35-39,1928,0.272017280557716
STAT,1824,50,20-24,1874,0.0017910316789242133
SIM,1875,32,30-34,1907,51
STAT,1826,31,30-34,1857,56.3063556493865
STAT,1885,30,40-44,1915,8.788161817976475
SIM,1932,34,35-39,1966,35
STAT,1844,53,40-44,1897,0.016728275546662588
SIM,1837,89,na,1926,104
SIM,1850,32,25-29,1882,27
STAT,1817,44,35-39,1861,9.09623535314367
STAT,1846,16,20-24,1862,34.31421648585361
SIM,1827,90,na,1917,51
STAT,1879,78,na,1957,1811.1131752615029
SIM,1845,54,na,1899,3395
STAT,1938,18,40-44,1956,2.786136367283237
STAT,1928,18,30-34,1946,30.93188196883162
SIM,1789,84,na,1873,175
STAT,1830,42,na,1872,3541.5297353100123
SIM,1861,21,30-34,1882,47
STAT,1858,35,40-44,1893,6.957474995499599
STAT,1865,54,25-29,1919,0.006320208898040136
STAT,1867,40,30-34,1907,2.1964523752865106
SIM,1816,44,40-44,1860,6
SIM,1883,31,25-29,1914,27
SIM,1907,38,50-100,1945,1
STAT,1870,35,40-44,1905,8.762265280453883
SIM,1892,35,35-39,1927,26
SIM,1922,31,25-29,1953,28
STAT,1885,40,35-39,1925,3.6770036849516132
STAT,1875,35,40-44,1910,9.18881365312631
STAT,1891,41,20-24,1932,0.3982518877945639
STAT,1906,45,25-29,1951,0.09657306692813838
SIM,1901,25,45-49,1926,6
STAT,1876,17,45-49,1893,0.1364495501959964
SIM,1920,42,45-49,1962,1
STAT,1892,27,40-44,1919,7.573671924260644
STAT,1891,54,na,1945,5227.460022090471
STAT,1858,112,na,1970,6.530079255380755E-4
STAT,1918,37,15-19,1955,0.04087158076702725
STAT,1853,21,30-34,1874,33.53976798435731
STAT,1928,37,25-29,1965,2.512713759331247
SIM,1772,83,na,1855,190
SIM,1870,85,na,1955,522
STAT,1842,32,25-29,1874,18.42157663540187
STAT,1875,31,25-29,1906,21.385012441825545
SIM,1827,47,50-100,1874,1
SIM,1861,43,40-44,1904,8
STAT,1831,47,20-24,1878,0.018363582928085362
STAT,1857,112,na,1969,5.572424345371601E-4
STAT,1863,41,45-49,1904,2.657883294435001
SIM,1918,29,20-24,1947,44
STAT,1840,53,25-29,1893,0.005030594687492073
SIM,1871,41,45-49,1912,7
SIM,1885,84,na,1969,1363
STAT,1921,25,20-24,1946,41.35596339139362
STAT,1941,28,40-44,1969,9.733744973446125
SIM,1882,18,na,1900,5264
SIM,1883,35,40-44,1918,14
SIM,1875,25,40-44,1900,9
SIM,1925,36,50-100,1961,2
STAT,1882,36,na,1918,4657.450840860427
STAT,1920,25,na,1945,8353.868912658583
STAT,1933,18,40-44,1951,3.771988328949944
SIM,1888,17,15-19,1905,12
STAT,1862,20,na,1882,4239.927557180731
SIM,1897,48,na,1945,6073
STAT,1819,47,50-100,1866,1.030658408784953
STAT,1935,30,30-34,1965,44.079888593156234
SIM,1914,45,25-29,1959,1
STAT,1934,35,na,1969,10505.002883097497
SIM,1941,18,40-44,1959,6
STAT,1871,51,45-49,1922,0.02925870187192714
STAT,1875,42,30-34,1917,2.3876212746097085
SIM,1871,19,25-29,1890,19
STAT,1853,22,50-100,1875,0.7623387376738427
STAT,1872,54,30-34,1926,0.011749880211354138
STAT,1841,45,50-100,1886,0.3672546332435755
STAT,1913,26,25-29,1939,132.94228307723122
SIM,1813,41,50-100,1854,3
SIM,1905,9,na,1914,7832
SIM,1875,42,40-44,1917,13
STAT,1859,16,30-34,1875,2.9917148453067632
SIM,1824,42,25-29,1866,3
SIM,1866,22,na,1888,4597
STAT,1873,53,20-24,1926,0.0014899390534900813
STAT,1861,72,na,1933,2122.9369366875485
STAT,1883,33,25-29,1916,20.238359230751495
STAT,1873,53,na,1926,4347.478456015002
STAT,1886,30,25-29,1916,22.012170222160062
SIM,1891,33,25-29,1924,6
STAT,1948,24,50-100,1972,1.5246907906560574
SIM,1867,16,30-34,1883,4
SIM,1829,54,na,1883,2737
SIM,1870,43,35-39,1913,5
SIM,1936,18,30-34,1954,23
STAT,1862,43,35-39,1905,3.1032487020753563
STAT,1877,47,45-49,1924,0.4926219500888148
SIM,1779,84,na,1863,177
SIM,1782,83,na,1865,218
STAT,1906,27,na,1933,7023.404739299517
STAT,1843,27,45-49,1870,1.9141141139598257
STAT,1864,86,na,1950,400.55518060112126
SIM,1854,16,20-24,1870,31
STAT,1903,13,na,1916,7414.655560144023
SIM,1851,27,45-49,1878,2
SIM,1939,15,30-34,1954,30
STAT,1908,44,45-49,1952,0.30736436615679924
SIM,1944,7,na,1951,8759
STAT,1802,61,na,1863,2066.2832808621847
STAT,1863,19,25-29,1882,10.28068331686689
STAT,1870,46,45-49,1916,0.46927582024111136
STAT,1939,25,50-100,1964,2.02287425045534
SIM,1842,30,25-29,1872,21
SIM,1883,42,30-34,1925,5
STAT,1817,60,na,1877,2311.4320200327325
STAT,1896,26,na,1922,6385.330955606163
SIM,1942,23,40-44,1965,8
STAT,1808,51,30-34,1859,0.036057769498780645
STAT,1927,15,45-49,1942,1.2600604362288526
SIM,1815,39,40-44,1854,11
SIM,1868,7,na,1875,5425
STAT,1871,5,na,1876,5580.29474441077
SIM,1922,37,30-34,1959,1
SIM,1921,38,50-100,1959,5
STAT,1825,58,na,1883,2451.279767865095
STAT,1873,28,50-100,1901,1.3080640320312424
STAT,1934,23,40-44,1957,9.124196215565359
SIM,1883,28,50-100,1911,2
STAT,1936,29,30-34,1965,75.67279837702979
STAT,1946,16,25-29,1962,97.09245119461893
SIM,1812,91,na,1903,52
SIM,1876,32,30-34,1908,53
SIM,1848,37,na,1885,3711
SIM,1881,28,50-100,1909,1
STAT,1899,46,35-39,1945,0.21914596608470616
STAT,1921,26,50-100,1947,2.2475479700035503
STAT,1867,42,40-44,1909,4.249097869904979
STAT,1868,32,30-34,1900,33.5493077568793
SIM,1899,28,45-49,1927,5
STAT,1914,37,30-34,1951,3.6757868117784502
STAT,1841,27,25-29,1868,76.23244222342886
STAT,1834,30,25-29,1864,17.831030515428306
STAT,1925,19,45-49,1944,1.2119427297465095
SIM,1927,36,50-100,1963,1
SIM,1954,16,25-29,1970,136
STAT,1831,58,na,1889,2559.491677810378
STAT,1833,29,40-44,1862,5.129238858765525
SIM,1906,34,25-29,1940,19
STAT,1841,17,50-100,1858,0.09167940905207933
STAT,1888,52,na,1940,5112.530084202317
SIM,1836,32,50-100,1868,2
SIM,1895,17,20-24,1912,52
STAT,1918,12,na,1930,8708.51052263227
STAT,1885,46,40-44,1931,0.34513984765352973
STAT,1817,37,45-49,1854,14.926142708946644
STAT,1821,75,na,1896,1141.1032493096145
STAT,1858,86,na,1944,349.3259293691477
STAT,1886,20,50-100,1906,0.8745729820065463
STAT,1801,105,na,1906,0.023241522927163
STAT,1900,70,na,1970,4687.702815867408
SIM,1924,43,40-44,1967,2
STAT,1849,52,30-34,1901,0.009365607601426053
STAT,1821,35,45-49,1856,8.888688072360736
STAT,1890,46,15-19,1936,5.57800043270619E-4
STAT,1936,36,20-24,1972,0.5232406375738956
SIM,1851,19,na,1870,4438
SIM,1918,39,30-34,1957,7
STAT,1926,10,na,1936,9839.214239283654
STAT,1894,21,na,1915,6154.399310347322
SIM,1859,17,35-39,1876,2
STAT,1859,43,45-49,1902,2.3884537001577226
SIM,1892,60,na,1952,5463
SIM,1852,48,45-49,1900,1
SIM,1935,31,35-39,1966,44
SIM,1929,16,15-19,1945,117
STAT,1816,42,25-29,1858,3.5370580345757907
STAT,1856,57,na,1913,3131.4797322973154
STAT,1887,17,20-24,1904,40.04507685314253
STAT,1944,27,15-19,1971,1.5408676498926095
SIM,1941,29,45-49,1970,4
STAT,1827,31,30-34,1858,45.38107698040161
SIM,1867,43,45-49,1910,9
SIM,1935,15,45-49,1950,1
STAT,1908,33,40-44,1941,7.433670438596273
SIM,1820,96,na,1916,9
SIM,1913,35,50-100,1948,2
SIM,1839,24,50-100,1863,1
SIM,1928,19,35-39,1947,16
SIM,1921,26,25-29,1947,160
STAT,1893,30,30-34,1923,45.05401005849483
SIM,1895,29,50-100,1924,2
SIM,1841,29,40-44,1870,6
STAT,1893,32,40-44,1925,11.101465375825523
STAT,1914,44,20-24,1958,0.03523053326861273
STAT,1890,39,25-29,1929,7.026235115149101
STAT,1926,41,45-49,1967,0.41489951420497084
STAT,1871,40,40-44,1911,4.558745628171388
STAT,1764,102,na,1866,0.12193221690772889
STAT,1901,15,40-44,1916,0.5195371184900636
SIM,1936,30,na,1966,6638
SIM,1801,98,na,1899,5
SIM,1887,26,50-100,1913,2
SIM,1904,35,na,1939,7044
STAT,1933,29,45-49,1962,4.62873774190098
SIM,1849,74,na,1923,1659
STAT,1885,20,30-34,1905,36.021615455230474
SIM,1828,26,20-24,1854,21
SIM,1834,41,40-44,1875,6
SIM,1867,35,na,1902,4821
SIM,1923,4,na,1927,9984
SIM,1919,34,na,1953,8225
STAT,1927,31,35-39,1958,22.712823034485368
STAT,1859,50,35-39,1909,0.014037841348299007
SIM,1893,20,30-34,1913,59
STAT,1876,71,na,1947,2788.2112539391264
SIM,1854,37,na,1891,3930
SIM,1859,32,50-100,1891,2
STAT,1821,42,35-39,1863,5.75734931577208
SIM,1929,18,25-29,1947,156
SIM,1866,18,na,1884,5087
SIM,1868,40,25-29,1908,5
STAT,1926,41,na,1967,9258.59863321892
STAT,1823,48,25-29,1871,0.17546146479823163
SIM,1850,62,na,1912,2899
STAT,1843,34,35-39,1877,16.703978387889762
STAT,1897,39,25-29,1936,1.6608056849828687
SIM,1852,31,30-34,1883,43
SIM,1873,35,na,1908,5016
SIM,1899,40,na,1939,6512
SIM,1840,19,30-34,1859,4
STAT,1869,52,35-39,1921,0.01675772088472661
STAT,1921,32,45-49,1953,3.5357886260041256
STAT,1840,35,na,1875,3733.300857964505
STAT,1763,102,na,1865,0.07587697792446903
STAT,1903,41,40-44,1944,0.45117881952599165
STAT,1906,42,20-24,1948,0.032415721392821624
STAT,1941,14,na,1955,8168.821373086141
STAT,1838,93,na,1931,39.55268645885098
STAT,1783,86,na,1869,120.68211817911263
SIM,1920,20,35-39,1940,29
SIM,1837,20,40-44,1857,2
SIM,1921,45,30-34,1966,2
SIM,1883,55,na,1938,4261
STAT,1876,50,35-39,1926,0.018241542027172635
SIM,1919,31,50-100,1950,2
SIM,1913,30,50-100,1943,2
STAT,1949,20,30-34,1969,67.7750900590209
STAT,1931,31,25-29,1962,24.474457710546258
SIM,1908,31,40-44,1939,11
STAT,1839,38,25-29,1877,5.316873405790436
STAT,1883,37,40-44,1920,8.686162274475073
STAT,1808,47,45-49,1855,1.4996033163754725
STAT,1802,95,na,1897,10.204096063248645
SIM,1838,26,15-19,1864,1
STAT,1874,21,15-19,1895,6.842697170068992
SIM,1891,37,40-44,1928,17
SIM,1847,38,25-29,1885,9
STAT,1860,20,25-29,1880,107.90064469746358
STAT,1860,34,35-39,1894,16.46702554986241
SIM,1870,33,40-44,1903,9
STAT,1879,26,50-100,1905,1.3559729580971824
SIM,1891,16,25-29,1907,18
STAT,1913,45,30-34,1958,0.17659884006759075
STAT,1839,24,15-19,1863,6.523964899006826
SIM,1845,29,50-100,1874,3
STAT,1897,17,15-19,1914,16.021162077436703
SIM,1906,64,na,1970,5677
STAT,1816,46,40-44,1862,0.8541681940916185
STAT,1814,53,30-34,1867,0.02897441772815741
STAT,1892,23,25-29,1915,144.28661751769312
STAT,1844,31,30-34,1875,34.06957571721569
STAT,1869,85,na,1954,536.4645044342227
STAT,1913,45,15-19,1958,7.297466581040328E-4
SIM,1889,1,na,1890,6821
STAT,1840,48,25-29,1888,0.0827749246909719
STAT,1945,14,na,1959,8662.331223246356
STAT,1872,32,20-24,1904,5.486507831776847
STAT,1922,45,40-44,1967,0.36742492889903805
STAT,1824,39,50-100,1863,3.4107747940265662
STAT,1891,42,50-100,1933,2.6340606187033484
SIM,1887,55,na,1942,4994
SIM,1941,24,35-39,1965,27
STAT,1841,102,na,1943,0.42537635035130744
STAT,1936,25,15-19,1961,1.3659364394908025
STAT,1924,24,25-29,1948,218.6899950538077
STAT,1933,3,na,1936,10966.938783071078
SIM,1932,24,25-29,1956,271
STAT,1825,32,25-29,1857,36.35125466454204
STAT,1834,44,35-39,1878,2.8323785532676276
SIM,1875,43,35-39,1918,9
STAT,1830,26,20-24,1856,29.239498810292353
SIM,1871,39,30-34,1910,15
STAT,1846,26,na,1872,4037.5065325462497
SIM,1902,64,na,1966,5524
STAT,1861,50,50-100,1911,0.025752682750880145
STAT,1856,20,na,1876,3925.637052394369
SIM,1782,76,na,1858,665
STAT,1853,43,40-44,1896,3.533099479277034
SIM,1833,32,25-29,1865,23
SIM,1906,30,na,1936,7081
STAT,1932,32,20-24,1964,6.549144152711766
SIM,1798,61,na,1859,1807
SIM,1927,25,na,1952,9459
STAT,1827,53,na,1880,2771.7340881619675
SIM,1906,5,na,1911,7681
STAT,1867,43,35-39,1910,3.400276164488976
SIM,1851,44,45-49,1895,5
STAT,1798,102,na,1900,0.15871040455297808
STAT,1864,48,na,1912,4010.624020375811
SIM,1851,23,na,1874,4047
SIM,1930,37,50-100,1967,2
STAT,1858,52,40-44,1910,0.01648668744648393
SIM,1769,94,na,1863,5
STAT,1851,75,na,1926,1595.8542217903898
STAT,1912,28,30-34,1940,77.72958613993825
SIM,1857,41,25-29,1898,2
SIM,1884,43,45-49,1927,4
STAT,1814,80,na,1894,532.382258169356
STAT,1926,40,30-34,1966,0.31913618847211495
STAT,1848,90,na,1938,129.27544883676794
SIM,1930,38,35-39,1968,6
STAT,1840,50,20-24,1890,0.0010804491631748257
SIM,1862,94,na,1956,38
SIM,1883,38,45-49,1921,6
SIM,1913,49,na,1962,7310
STAT,1848,31,15-19,1879,0.27515289492176204
STAT,1926,21,40-44,1947,8.27337051740868
STAT,1922,38,35-39,1960,5.551328307542221
SIM,1813,83,na,1896,338
SIM,1912,47,30-34,1959,1
STAT,1773,105,na,1878,0.03798743527195886
SIM,1937,18,15-19,1955,83
STAT,1919,47,25-29,1966,0.11617448006154334
SIM,1794,61,na,1855,1812
STAT,1851,22,25-29,1873,105.97424440693115
STAT,1876,43,45-49,1919,3.1036879154259993
STAT,1912,20,35-39,1932,18.338353639401497
SIM,1880,32,20-24,1912,7
STAT,1827,53,40-44,1880,0.017990853088296933
STAT,1904,33,20-24,1937,4.480137238050012
SIM,1882,18,25-29,1900,13
SIM,1920,27,50-100,1947,4
STAT,1904,47,30-34,1951,0.15754273009997138
STAT,1843,44,45-49,1887,2.1039961781652634
STAT,1875,38,45-49,1913,4.124599729308082
STAT,1894,44,40-44,1938,0.39976022383224635
SIM,1912,33,20-24,1945,4
SIM,1837,80,na,1917,767
SIM,1909,41,35-39,1950,1
STAT,1837,52,20-24,1889,0.0010324631373270685
STAT,1870,21,30-34,1891,35.425310570540816
STAT,1880,36,50-100,1916,2.6246846117716
STAT,1840,43,30-34,1883,1.7090403755901002
STAT,1882,27,50-100,1909,1.2585286791357828
SIM,1861,39,50-100,1900,4
SIM,1807,76,na,1883,730
SIM,1895,74,na,1969,3902
STAT,1834,25,50-100,1859,1.1327858206629096
STAT,1846,51,50-100,1897,0.023243702002357806
SIM,1915,34,35-39,1949,27
STAT,1840,32,na,1872,3810.2474581028628
STAT,1852,20,na,1872,4107.036547172597
STAT,1882,67,na,1949,3118.752293714389
STAT,1916,47,na,1963,7610.145162703959
SIM,1919,18,30-34,1937,41
SIM,1934,21,40-44,1955,12
STAT,1891,15,20-24,1906,44.462813726042896
STAT,1842,36,40-44,1878,7.725071984920151
STAT,1837,53,na,1890,2952.805233859501
STAT,1853,39,20-24,1892,1.2073631160317726
SIM,1889,30,15-19,1919,4
SIM,1920,28,30-34,1948,101
STAT,1895,37,na,1932,6200.061491357793
SIM,1921,37,na,1958,8499
STAT,1795,71,na,1866,1286.7241366422545
STAT,1907,34,35-39,1941,17.11313233459247
STAT,1833,60,na,1893,2507.2314245209955
STAT,1874,48,na,1922,4594.020499961542
SIM,1894,38,20-24,1932,4
SIM,1816,47,45-49,1863,1
SIM,1779,94,na,1873,2
SIM,1782,73,na,1855,926
SIM,1850,36,40-44,1886,14
STAT,1935,27,50-100,1962,2.7407143763943176
STAT,1886,38,20-24,1924,1.6352542648129094
STAT,1905,41,25-29,1946,0.13083483119415384
STAT,1865,28,25-29,1893,77.34191715268568
STAT,1863,35,15-19,1898,0.10021852059122313
SIM,1868,88,na,1956,215
SIM,1889,44,25-29,1933,4
STAT,1819,47,20-24,1866,0.05035790470316365
STAT,1839,15,50-100,1854,0.10125890805374665
STAT,1862,40,30-34,1902,2.004583643517845
STAT,1918,39,20-24,1957,0.5598608523445617
SIM,1849,16,na,1865,4718
SIM,1868,82,na,1950,747
STAT,1930,23,20-24,1953,286.7982904178413
STAT,1873,16,15-19,1889,12.250184835945406
SIM,1878,17,20-24,1895,44
STAT,1887,43,20-24,1930,0.35613435836605045
STAT,1808,54,35-39,1862,0.04904182576997815
SIM,1834,42,35-39,1876,8
STAT,1937,18,50-100,1955,0.7343256952417118
SIM,1850,15,25-29,1865,16
SIM,1858,40,30-34,1898,3
STAT,1954,0,na,1954,10604.353028054846
SIM,1887,48,na,1935,5408
SIM,1910,40,45-49,1950,1
STAT,1884,45,45-49,1929,0.4753399881409904
STAT,1879,15,20-24,1894,37.62512019916296
STAT,1893,33,35-39,1926,25.814654482621634
SIM,1889,40,na,1929,5887
STAT,1929,18,15-19,1947,116.6553327858141
SIM,1946,18,40-44,1964,7
STAT,1850,35,na,1885,3746.556165383156
STAT,1845,37,20-24,1882,1.2480405895758897
STAT,1895,40,50-100,1935,2.8082441923881496
STAT,1898,22,15-19,1920,9.016522099146671
STAT,1910,25,45-49,1935,3.4221759043829434
SIM,1843,42,45-49,1885,5
SIM,1890,37,na,1927,6183
SIM,1848,68,na,1916,2227
SIM,1837,90,na,1927,64
SIM,1821,40,35-39,1861,6
SIM,1881,16,15-19,1897,1
SIM,1843,80,na,1923,840
STAT,1840,42,na,1882,3480.0769855719227
STAT,1846,20,na,1866,4099.543141659145
STAT,1833,54,50-100,1887,0.019700680876806334
STAT,1815,68,na,1883,1656.0204197677901
STAT,1912,35,20-24,1947,0.5246974046177726
SIM,1909,45,50-100,1954,1
SIM,1820,50,45-49,1870,1
SIM,1879,29,na,1908,4867
STAT,1878,46,15-19,1924,8.461150387845416E-4
SIM,1899,43,na,1942,6412
SIM,1944,21,50-100,1965,3
STAT,1880,31,35-39,1911,21.634123240639294
SIM,1857,48,45-49,1905,3
STAT,1862,47,15-19,1909,6.872608620676457E-4
STAT,1920,22,na,1942,8197.314410413988
STAT,1927,22,50-100,1949,1.6370274642558065
SIM,1866,0,na,1866,7038
STAT,1890,30,15-19,1920,0.3538789693032244
SIM,1839,31,15-19,1870,2
SIM,1907,46,45-49,1953,1
STAT,1842,53,50-100,1895,0.022124167109656964
STAT,1820,80,na,1900,692.5231179633212
SIM,1914,29,35-39,1943,42
SIM,1907,32,35-39,1939,24
STAT,1820,105,na,1925,0.03282470785977545
STAT,1863,39,30-34,1902,9.327334240629565
SIM,1905,17,25-29,1922,21
STAT,1858,45,35-39,1903,0.22261604417104255
STAT,1906,29,35-39,1935,28.193304677149474
SIM,1919,37,na,1956,8216
SIM,1865,47,40-44,1912,3
STAT,1822,48,50-100,1870,0.7526538056481086
SIM,1885,44,40-44,1929,11
SIM,1874,30,20-24,1904,5
STAT,1812,50,45-49,1862,0.10014864372067538
STAT,1871,27,20-24,1898,23.539333202916122
SIM,1920,35,20-24,1955,1
SIM,1868,41,na,1909,4489
STAT,1842,15,25-29,1857,10.962599495077498
STAT,1877,44,40-44,1921,4.653415458272694
SIM,1903,28,30-34,1931,97
STAT,1832,51,25-29,1883,0.004899319594359315
SIM,1877,55,na,1932,4155
STAT,1915,19,35-39,1934,1.7643233930677278
STAT,1909,40,30-34,1949,0.24437297882690504
STAT,1877,51,30-34,1928,0.012543166509721532
STAT,1844,93,na,1937,47.19649816945491
STAT,1900,45,50-100,1945,0.3920033756638097
SIM,1831,95,na,1926,11
SIM,1862,41,35-39,1903,6
SIM,1856,56,na,1912,3384
SIM,1853,37,20-24,1890,1
STAT,1852,33,30-34,1885,28.514400624705146
STAT,1878,53,20-24,1931,0.0015315026848770597
STAT,1906,46,50-100,1952,0.40886968552631864
STAT,1925,16,40-44,1941,3.420116198841785
STAT,1865,92,na,1957,98.29707927114907
STAT,1827,49,20-24,1876,0.021100845144830703
STAT,1889,32,15-19,1921,0.3546282680090424
STAT,1921,47,30-34,1968,0.2029130435298995
STAT,1864,40,15-19,1904,0.025182579420242608
STAT,1857,47,40-44,1904,0.26824608017739227
SIM,1933,16,40-44,1949,4
STAT,1837,22,40-44,1859,3.8028982183053968
STAT,1847,26,15-19,1873,0.8372768581972927
SIM,1845,22,40-44,1867,5
STAT,1806,61,na,1867,1905.6310587512642
SIM,1900,23,35-39,1923,14
STAT,1853,51,45-49,1904,0.023071424984451975
SIM,1939,10,na,1949,8268
STAT,1852,42,45-49,1894,2.3824236613749865
SIM,1860,33,30-34,1893,36
SIM,1934,35,50-100,1969,3
STAT,1763,112,na,1875,7.087597909263381E-4
STAT,1932,19,35-39,1951,11.162321402948363
STAT,1902,40,45-49,1942,0.2993299100550318
STAT,1838,16,50-100,1854,0.08810156553117042
STAT,1826,42,35-39,1868,3.8248837845725303
SIM,1940,19,35-39,1959,11
SIM,1844,75,na,1919,1404
STAT,1837,45,15-19,1882,5.938825860200794E-4
STAT,1841,53,25-29,1894,0.005056696751161583
SIM,1923,19,35-39,1942,9
SIM,1843,90,na,1933,86
SIM,1864,16,15-19,1880,11
STAT,1870,51,45-49,1921,0.028913290389122125
STAT,1862,37,20-24,1899,1.330640305282568
SIM,1924,46,45-49,1970,1
SIM,1899,33,na,1932,6573
STAT,1868,54,40-44,1922,0.019672867885166784
STAT,1817,54,45-49,1871,0.06454499730915572
STAT,1876,33,na,1909,4963.633761089894
STAT,1909,62,na,1971,6209.450202171151
STAT,1930,37,30-34,1967,4.801192314106814
SIM,1874,37,40-44,1911,18
STAT,1950,2,na,1952,9549.840922655676
STAT,1861,32,45-49,1893,2.9313797435358038
SIM,1921,21,50-100,1942,2
SIM,1869,27,20-24,1896,26
SIM,1876,70,na,1946,3125
SIM,1825,95,na,1920,4
STAT,1916,46,45-49,1962,0.4513298269105374
STAT,1905,43,15-19,1948,0.002780745061541799
STAT,1831,31,20-24,1862,4.609359144352486
STAT,1856,16,15-19,1872,10.99926989716073
STAT,1907,33,na,1940,7113.543127537283
STAT,1820,40,50-100,1860,4.517117368067606
STAT,1931,33,15-19,1964,0.3398715124515181
STAT,1826,43,30-34,1869,2.379464270215105
STAT,1854,49,30-34,1903,0.14529483265385837
SIM,1949,1,na,1950,9810
STAT,1826,46,50-100,1872,0.4964482391611574
STAT,1912,18,20-24,1930,55.23744998215337
SIM,1885,40,25-29,1925,2
SIM,1834,46,50-100,1880,2
SIM,1838,68,na,1906,2057
STAT,1821,46,15-19,1867,0.0011878320309727805
SIM,1873,28,25-29,1901,90
SIM,1927,2,na,1929,10459
STAT,1923,42,20-24,1965,0.04167430360131493
SIM,1966,0,na,1966,9457
STAT,1925,22,35-39,1947,22.758031429310744
SIM,1825,61,na,1886,2085
SIM,1851,20,25-29,1871,118
SIM,1920,18,20-24,1938,315
STAT,1922,48,45-49,1970,0.5027228215337799
STAT,1920,15,na,1935,8819.01810219837
SIM,1878,21,40-44,1899,5
STAT,1853,46,45-49,1899,0.37445969441732224
STAT,1893,34,30-34,1927,44.3120887433478
STAT,1868,43,50-100,1911,2.0153359141038885
SIM,1903,12,na,1915,7645
SIM,1933,22,35-39,1955,37
STAT,1917,31,40-44,1948,8.309259769464271
STAT,1923,29,na,1952,8621.516945001005
STAT,1800,66,na,1866,1673.3473127162908
STAT,1877,40,25-29,1917,1.3602936297061103
STAT,1790,65,na,1855,1448.9536
STAT,1867,40,15-19,1907,0.026383814185815525
STAT,1943,18,50-100,1961,0.802102766984575
STAT,1903,30,35-39,1933,29.35508898682918
SIM,1822,91,na,1913,35
STAT,1919,44,20-24,1963,0.03851523347507957
STAT,1892,20,20-24,1912,175.27073812794643
SIM,1922,2,na,1924,9995
SIM,1951,18,50-100,1969,1
SIM,1876,43,50-100,1919,6
SIM,1925,31,40-44,1956,2
STAT,1904,1,na,1905,7889.982467743863
STAT,1823,39,na,1862,3373.0564771521167
SIM,1865,26,25-29,1891,86
STAT,1833,87,na,1920,231.61215673378965
SIM,1813,76,na,1889,773
SIM,1912,36,25-29,1948,3
STAT,1860,89,na,1949,172.296477761816
SIM,1938,23,15-19,1961,12
STAT,1821,105,na,1926,0.03250038416260291
SIM,1903,24,15-19,1927,9
STAT,1816,49,45-49,1865,1.1245726970394108
STAT,1843,41,40-44,1884,3.285961297506543
STAT,1901,18,45-49,1919,0.1842069352967655
STAT,1836,32,50-100,1868,1.5402043606824865
SIM,1829,61,na,1890,2382
SIM,1824,49,45-49,1873,1
STAT,1904,36,25-29,1940,1.8100904357597627
STAT,1913,48,35-39,1961,0.25350834749671136
SIM,1852,94,na,1946,17
STAT,1852,23,50-100,1875,0.7665552645135194
STAT,1815,65,na,1880,1852.020380999443
STAT,1853,53,35-39,1906,0.013402561952333348
STAT,1905,48,na,1953,6489.929349934966
SIM,1909,39,20-24,1948,1
STAT,1943,21,40-44,1964,7.226975374678076
SIM,1814,40,50-100,1854,6
STAT,1806,54,na,1860,2227.278102887918
STAT,1895,47,na,1942,5894.242567894019
STAT,1926,0,na,1926,11153.516528383327
STAT,1772,84,na,1856,164.39658899
STAT,1830,40,35-39,1870,3.338333248542621
STAT,1835,42,45-49,1877,2.323624480814321
STAT,1854,45,15-19,1899,6.193076807467047E-4
SIM,1839,16,na,1855,4129
SIM,1937,25,na,1962,7461
STAT,1884,21,25-29,1905,114.50790165793876
STAT,1861,48,45-49,1909,0.39173320588515004
SIM,1860,32,35-39,1892,21
SIM,1817,76,na,1893,899
SIM,1839,36,25-29,1875,6
SIM,1873,25,20-24,1898,28
STAT,1882,51,20-24,1933,0.00145872636359489
STAT,1820,47,45-49,1867,0.87819535812068
SIM,1918,48,na,1966,8114
STAT,1896,7,na,1903,6946.99547462792
STAT,1842,39,45-49,1881,3.103144908291103
STAT,1816,54,na,1870,2603.842181017362
STAT,1872,74,na,1946,2252.58282504729
SIM,1850,39,45-49,1889,4
STAT,1828,38,na,1866,3374.495670790095
SIM,1903,49,na,1952,6471
SIM,1867,42,30-34,1909,4
SIM,1893,55,na,1948,5410
STAT,1777,83,na,1860,226.1622224944688
STAT,1898,35,50-100,1933,3.387396547392235
SIM,1832,27,25-29,1859,84
SIM,1848,23,20-24,1871,141
STAT,1813,48,30-34,1861,0.5869335812680806
STAT,1873,52,25-29,1925,0.007229715756154019
STAT,1893,30,15-19,1923,0.3674765532776557
SIM,1858,43,35-39,1901,5
SIM,1825,30,25-29,1855,23
SIM,1883,45,35-39,1928,1
SIM,1907,26,40-44,1933,13
STAT,1852,32,35-39,1884,16.71168620466406
STAT,1926,43,35-39,1969,0.5004800316255502
STAT,1849,48,45-49,1897,0.3686138046837305
STAT,1822,34,15-19,1856,0.6781852714529153
SIM,1834,43,30-34,1877,7
STAT,1875,45,35-39,1920,0.2940114549325745
SIM,1900,38,na,1938,6876
SIM,1902,19,15-19,1921,13
STAT,1787,83,na,1870,255.1596926294818
SIM,1820,62,na,1882,1973
STAT,1801,55,na,1856,2312.5619123525994
STAT,1880,39,30-34,1919,11.224943215643014
SIM,1832,43,na,1875,3318
SIM,1938,16,25-29,1954,107
SIM,1830,34,15-19,1864,1
STAT,1951,14,na,1965,9442.863800707328
STAT,1938,28,na,1966,7493.10458405217
STAT,1865,102,na,1967,3.3259632139521886
STAT,1898,27,25-29,1925,115.6134944074232
STAT,1918,41,35-39,1959,0.4329425291943735
SIM,1823,76,na,1899,930
SIM,1791,87,na,1878,77
STAT,1858,42,30-34,1900,1.807830253600594
SIM,1853,42,na,1895,3792
STAT,1860,27,45-49,1887,1.8405004125228217
STAT,1883,16,25-29,1899,11.271954663807582
SIM,1943,25,na,1968,8211
STAT,1886,33,na,1919,5066.008953218568
STAT,1938,18,25-29,1956,86.32047138157866
SIM,1922,26,na,1948,8960
SIM,1884,30,30-34,1914,49
SIM,1870,82,na,1952,764
SIM,1802,77,na,1879,750
SIM,1848,40,20-24,1888,2
SIM,1913,41,25-29,1954,1
SIM,1874,33,25-29,1907,22
STAT,1887,18,na,1905,5689.873993548845
STAT,1931,37,30-34,1968,4.8750513760118155
STAT,1855,54,30-34,1909,0.008729218456900254
SIM,1870,40,30-34,1910,7
STAT,1859,42,30-34,1901,1.8458039624567624
STAT,1849,46,50-100,1895,0.3895926441026777
SIM,1892,42,40-44,1934,9
STAT,1774,105,na,1879,0.02996819191940483
SIM,1892,21,25-29,1913,173
STAT,1817,39,na,1856,3088.3764930965376
STAT,1889,47,na,1936,5577.544496425565
STAT,1948,15,30-34,1963,28.18465031925382
SIM,1808,53,30-34,1861,1
SIM,1861,46,45-49,1907,1
SIM,1912,23,na,1935,8041
STAT,1884,42,40-44,1926,4.480141801941147
SIM,1892,34,50-100,1926,3
STAT,1831,47,50-100,1878,0.3758413157142727
SIM,1899,43,50-100,1942,2
SIM,1770,88,na,1858,51
SIM,1820,58,na,1878,2274
STAT,1891,18,25-29,1909,14.109256077186616
STAT,1930,26,25-29,1956,169.10298061321654
SIM,1866,42,30-34,1908,8
SIM,1955,10,na,1965,10118
SIM,1946,18,25-29,1964,123
STAT,1893,33,50-100,1926,2.3355789671455587
SIM,1926,41,35-39,1967,1
STAT,1809,52,45-49,1861,0.10697544650980373
STAT,1876,30,30-34,1906,36.76405889695284
STAT,1879,18,25-29,1897,11.939470567378384
STAT,1812,52,35-39,1864,0.057073354222341326
SIM,1888,39,25-29,1927,9
SIM,1855,16,na,1871,4865
STAT,1870,31,25-29,1901,20.39231168621312
SIM,1898,49,45-49,1947,1
STAT,1922,35,30-34,1957,4.1945115616547985
SIM,1792,76,na,1868,759
STAT,1845,31,50-100,1876,1.696248332879232
SIM,1851,57,na,1908,3111
STAT,1834,79,na,1913,929.0674424380497
STAT,1859,17,45-49,1876,0.12188905902476224
SIM,1876,15,na,1891,5461
SIM,1871,71,na,1942,2471
STAT,1838,38,na,1876,3461.5321927389646
STAT,1933,29,na,1962,10036.947707388357
STAT,1898,48,40-44,1946,0.26062079226738016
SIM,1833,28,na,1861,3653
STAT,1907,17,35-39,1924,1.6287675776573705
STAT,1852,28,50-100,1880,1.178983540252851
SIM,1915,17,35-39,1932,3
SIM,1924,29,45-49,1953,7
STAT,1884,34,50-100,1918,1.811597338883064
STAT,1916,29,45-49,1945,3.581819319329079
SIM,1819,42,50-100,1861,5
STAT,1841,50,20-24,1891,0.001086055250446969
STAT,1866,23,30-34,1889,33.223580838348006
SIM,1892,70,na,1962,4391
SIM,1930,35,30-34,1965,6
STAT,1935,14,na,1949,10906.217153197209
SIM,1875,44,30-34,1919,5
STAT,1924,44,50-100,1968,0.28120255713842524
SIM,1842,44,35-39,1886,10
STAT,1875,92,na,1967,280.65941467779317
STAT,1867,44,30-34,1911,2.145158963648695
STAT,1850,17,25-29,1867,10.617359262998251
STAT,1885,32,30-34,1917,35.099203200151614
STAT,1856,19,na,1875,4179.7058302925925
SIM,1918,15,45-49,1933,1
SIM,1819,61,na,1880,2071
STAT,1830,80,na,1910,854.2091812169532
SIM,1923,16,30-34,1939,37
STAT,1881,44,30-34,1925,2.2139527258281007
SIM,1884,41,na,1925,5012
STAT,1845,54,20-24,1899,0.0011058171872306579
SIM,1844,32,50-100,1876,3
STAT,1871,34,na,1905,4747.174571165833
SIM,1886,26,45-49,1912,3
STAT,1915,16,30-34,1931,5.165226462643969
STAT,1899,32,25-29,1931,28.342706452795493
STAT,1905,47,30-34,1952,0.1587406269225127
SIM,1776,80,na,1856,318
SIM,1886,70,na,1956,2938
SIM,1937,16,25-29,1953,104
STAT,1796,97,na,1893,2.3934219778968377
STAT,1881,49,25-29,1930,0.11009222158976993
STAT,1910,2,na,1912,8160.731074904496
SIM,1945,6,na,1951,9092
SIM,1830,31,50-100,1861,3
STAT,1825,68,na,1893,1768.1791399734786
STAT,1902,23,45-49,1925,1.9821613295974925
STAT,1902,34,na,1936,6803.326785457579
STAT,1857,26,25-29,1883,69.08556156033302
SIM,1819,35,45-49,1854,7
STAT,1914,15,na,1929,8107.7785740700265
SIM,1851,41,40-44,1892,4
STAT,1907,24,25-29,1931,168.86195538648278
STAT,1854,93,na,1947,44.802156759966856
SIM,1881,23,na,1904,4052
STAT,1904,63,na,1967,5707.136450118763
SIM,1828,41,50-100,1869,4
STAT,1835,45,50-100,1880,0.3781824193216487
STAT,1864,45,50-100,1909,0.4478043588208325
STAT,1775,98,na,1873,0.8498791567870025
STAT,1928,19,50-100,1947,0.9481602363302122
STAT,1942,19,45-49,1961,1.0536352757957375
SIM,1826,41,30-34,1867,4
STAT,1862,50,40-44,1912,0.01843399299349409
SIM,1889,24,20-24,1913,158
SIM,1950,19,45-49,1969,1
STAT,1933,24,35-39,1957,25.2100364100688
STAT,1894,20,50-100,1914,1.064282590036695
STAT,1817,51,40-44,1868,0.04971523169212163
SIM,1841,57,na,1898,2843
STAT,1881,51,20-24,1932,0.001447370759252999
STAT,1913,40,20-24,1953,0.035185212471849546
STAT,1929,16,25-29,1945,111.95766193280474
STAT,1798,105,na,1903,0.01587275768104718
SIM,1843,45,50-100,1888,1
STAT,1917,33,na,1950,7964.086257374928
STAT,1781,98,na,1879,1.1339460202317635
SIM,1893,32,30-34,1925,68
STAT,1845,51,35-39,1896,0.013329479274356317
SIM,1820,45,45-49,1865,1
SIM,1934,11,na,1945,10750
SIM,1949,10,na,1959,9615
SIM,1915,24,25-29,1939,213
STAT,1818,41,30-34,1859,5.8821731263815185
SIM,1897,15,15-19,1912,16
STAT,1927,39,30-34,1966,4.566026736636629
STAT,1760,99,na,1859,0.08597965243340164
STAT,1833,94,na,1927,26.27425346042284
SIM,1842,37,45-49,1879,3
SIM,1913,12,na,1925,8382
STAT,1863,60,na,1923,3371.7042211478524
STAT,1925,33,40-44,1958,9.377556016827496
STAT,1793,79,na,1872,552.0051389624081
SIM,1933,33,40-44,1966,16
STAT,1834,37,45-49,1871,3.3007323379555245
SIM,1863,42,na,1905,4315
STAT,1843,20,25-29,1863,102.1168323593371
SIM,1956,15,30-34,1971,42
STAT,1866,29,50-100,1895,1.183533962378895
STAT,1928,42,50-100,1970,0.3024235207890211
SIM,1911,41,40-44,1952,2
STAT,1878,26,45-49,1904,2.350000132054443
STAT,1910,43,50-100,1953,0.22297078086412947
STAT,1877,18,na,1895,5282.718534795477
STAT,1889,15,15-19,1904,14.847075971512902
STAT,1946,20,15-19,1966,11.970907620411618
STAT,1824,49,35-39,1873,0.3296657745687897
STAT,1917,26,na,1943,7960.94197823448
SIM,1855,53,na,1908,3740
STAT,1903,2,na,1905,7665.271472181215
SIM,1860,44,40-44,1904,8
STAT,1777,102,na,1879,0.14929869981887145
STAT,1882,45,35-39,1927,0.278181509153471
SIM,1903,17,15-19,1920,16
STAT,1845,51,40-44,1896,0.016300048903623077
SIM,1844,28,20-24,1872,21
STAT,1863,31,35-39,1894,17.976812407140127
SIM,1859,43,na,1902,4061
STAT,1780,97,na,1877,1.7505688545383586
STAT,1889,48,25-29,1937,0.07989400014987744
STAT,1913,12,na,1925,8157.0502222218865
STAT,1784,87,na,1871,92.53741410843715
SIM,1857,15,25-29,1872,17
SIM,1896,75,na,1971,3564
STAT,1829,47,15-19,1876,6.311407404901764E-4
STAT,1771,101,na,1872,0.2001477253042789
STAT,1849,28,30-34,1877,46.8788862446083
STAT,1841,46,30-34,1887,0.142905919891144
SIM,1837,40,na,1877,3410
STAT,1937,35,20-24,1972,0.5333953918102537
STAT,1840,28,40-44,1868,5.352584786988437
STAT,1851,39,50-100,1890,1.8840703786872364
STAT,1850,20,15-19,1870,6.159360549720756
STAT,1955,15,15-19,1970,121.72382513156427
STAT,1839,94,na,1933,31.206828290937892
SIM,1890,45,35-39,1935,1
STAT,1840,17,30-34,1857,2.9787223788979302
STAT,1878,45,15-19,1923,8.521310842392709E-4
STAT,1815,54,35-39,1869,0.04258164254567306
STAT,1836,28,20-24,1864,20.04285225747937
STAT,1798,95,na,1893,7.197545316565406
STAT,1828,54,45-49,1882,0.022080609094681666
STAT,1804,53,20-24,1857,0.004228993553744094
SIM,1851,43,30-34,1894,1
STAT,1809,72,na,1881,1267.7116484913845
SIM,1842,27,na,1869,3856
STAT,1882,8,na,1890,5114.338626685213
STAT,1850,31,25-29,1881,16.60014412950963
SIM,1855,18,25-29,1873,12
STAT,1911,21,40-44,1932,6.461585273269631
SIM,1847,58,na,1905,2960
SIM,1900,27,45-49,1927,4
STAT,1824,41,25-29,1865,1.7102475983296594
STAT,1857,34,15-19,1891,0.22225840330725177
STAT,1939,32,20-24,1971,5.026839980822719
SIM,1880,21,35-39,1901,16
STAT,1893,48,45-49,1941,0.3364984030082252
STAT,1792,82,na,1874,335.31539745167186
STAT,1866,15,50-100,1881,0.09482098636167434
STAT,1905,17,na,1922,7376.741545620099
STAT,1871,55,na,1926,4148.898323226353
SIM,1832,49,35-39,1881,1
STAT,1929,11,na,1940,10226.797676014374
SIM,1806,76,na,1882,730
SIM,1857,26,35-39,1883,20
STAT,1915,0,na,1915,9492.423784817687
STAT,1884,42,35-39,1926,3.6068064074864807
SIM,1848,22,20-24,1870,138
STAT,1843,54,40-44,1897,0.014341776437670843
STAT,1849,15,25-29,1864,11.164637512349806
SIM,1878,39,30-34,1917,16
STAT,1842,25,40-44,1867,5.595317715133897
SIM,1874,23,30-34,1897,42
SIM,1850,25,40-44,1875,9
SIM,1892,42,35-39,1934,8
STAT,1876,48,15-19,1924,8.250445606017004E-4
STAT,1875,18,30-34,1893,3.305531696803357
STAT,1953,18,15-19,1971,110.83155610817175
SIM,1825,55,na,1880,2390
STAT,1843,43,30-34,1886,1.6370582681520751
STAT,1892,19,45-49,1911,0.16426893095925704
SIM,1873,31,45-49,1904,1
SIM,1850,22,na,1872,4104
STAT,1817,51,35-39,1868,0.040654979281237666
STAT,1824,30,15-19,1854,0.9138701228378501
STAT,1910,33,50-100,1943,1.6038465498140886
SIM,1837,49,40-44,1886,1
STAT,1921,43,15-19,1964,0.0034869181131997585
STAT,1860,50,25-29,1910,0.005892675102612342
STAT,1909,48,20-24,1957,0.02046285648552795
STAT,1834,63,na,1897,2371.229483371748
SIM,1821,65,na,1886,1819
STAT,1847,18,25-29,1865,10.717613019840497
STAT,1853,17,40-44,1870,0.3481167156418854
SIM,1884,31,20-24,1915,6
STAT,1885,63,na,1948,3586.980013466882
SIM,1867,45,35-39,1912,1
STAT,1897,42,45-49,1939,0.2802277176571345
SIM,1814,71,na,1885,1311
STAT,1882,47,30-34,1929,0.18955613873403643
SIM,1772,90,na,1862,29
SIM,1872,15,20-24,1887,39
STAT,1829,38,30-34,1867,9.146253347773776
SIM,1925,15,50-100,1940,1
STAT,1801,92,na,1893,33.01410822632343
STAT,1850,33,20-24,1883,4.290794921081404
SIM,1872,49,na,1921,4638
STAT,1833,36,25-29,1869,4.790889120127583
STAT,1855,37,15-19,1892,0.08467739422187458
STAT,1948,17,50-100,1965,0.8658721936573336
STAT,1939,30,25-29,1969,19.0695684216236
SIM,1861,17,40-44,1878,1
STAT,1831,39,25-29,1870,4.609332709058787
STAT,1851,18,45-49,1869,0.12239067510504043
SIM,1867,34,25-29,1901,29
STAT,1880,49,50-100,1929,0.5116218634214225
SIM,1897,17,na,1914,6971
SIM,1857,28,30-34,1885,50
STAT,1896,29,30-34,1925,66.66582721469439
SIM,1910,39,50-100,1949,2
STAT,1761,110,na,1871,3.009837199019262E-4
STAT,1843,41,35-39,1884,2.6454132004179085
STAT,1895,45,45-49,1940,0.35382493688387917
SIM,1893,37,50-100,1930,6
STAT,1927,28,15-19,1955,1.7269446545087346
STAT,1877,21,50-100,1898,0.8577829281013859
STAT,1932,35,50-100,1967,1.1413629704263695
STAT,1895,30,50-100,1925,2.43060151534368
STAT,1949,17,40-44,1966,3.2851962980620795
STAT,1864,15,20-24,1879,36.81589277491676
STAT,1817,53,30-34,1870,0.02700873859947478
STAT,1829,49,40-44,1878,0.2631505630107283
SIM,1868,20,na,1888,4612
STAT,1862,18,20-24,1880,34.84320867111148
SIM,1797,82,na,1879,260
SIM,1923,16,50-100,1939,1
STAT,1884,44,30-34,1928,2.261801596268289
STAT,1832,51,30-34,1883,0.008233578842096785
SIM,1818,61,na,1879,2133
SIM,1827,33,50-100,1860,4
STAT,1830,43,20-24,1873,0.28070702791899516
STAT,1853,15,45-49,1868,0.12580498651215732
STAT,1855,41,na,1896,3500.967588205925
STAT,1900,46,35-39,1946,0.22187710350932918
STAT,1839,54,20-24,1893,0.0011205232796943768
SIM,1862,41,40-44,1903,7
SIM,1939,24,40-44,1963,9
STAT,1805,82,na,1887,386.8494673533517
SIM,1839,46,40-44,1885,1
SIM,1956,8,na,1964,10702
STAT,1901,27,na,1928,6747.581817834408
STAT,1826,68,na,1894,1829.4129990713784
SIM,1843,68,na,1911,2265
SIM,1851,63,na,1914,2728
SIM,1836,18,15-19,1854,12
STAT,1889,53,na,1942,5275.9426336525885
STAT,1898,37,40-44,1935,11.964099231974128
SIM,1869,42,35-39,1911,11
SIM,1870,18,20-24,1888,41
SIM,1837,38,30-34,1875,13
SIM,1906,45,40-44,1951,1
STAT,1837,44,15-19,1881,0.020150068348267446
STAT,1861,23,25-29,1884,98.15136458196743
SIM,1869,30,40-44,1899,11
STAT,1933,25,35-39,1958,40.300281164674246
STAT,1950,22,30-34,1972,68.8565319445327
SIM,1833,23,15-19,1856,5
STAT,1856,66,na,1922,2553.964907721495
STAT,1893,26,50-100,1919,1.6431540913555691
STAT,1917,42,40-44,1959,0.527129874466898
SIM,1831,26,15-19,1857,2
SIM,1936,1,na,1937,7133
SIM,1941,22,30-34,1963,84
SIM,1937,25,15-19,1962,2
STAT,1841,30,45-49,1871,3.1342632457768422
SIM,1922,28,35-39,1950,45
SIM,1904,28,na,1932,6962
SIM,1826,32,40-44,1858,14
STAT,1824,43,20-24,1867,0.40283356476680726
SIM,1898,29,30-34,1927,90
SIM,1919,32,45-49,1951,4
STAT,1851,35,na,1886,3768.7661764516733
SIM,1922,17,25-29,1939,125
STAT,1868,91,na,1959,178.20373319837032
STAT,1918,22,35-39,1940,20.506333478726038
SIM,1863,88,na,1951,252
SIM,1866,31,50-100,1897,4
STAT,1805,49,25-29,1854,0.4591451415176459
STAT,1846,88,na,1934,210.2785286199029
STAT,1842,74,na,1916,1652.2692117754675
STAT,1885,23,40-44,1908,4.176128712813097
STAT,1914,17,25-29,1931,18.107376652647226
SIM,1867,19,na,1886,5171
STAT,1864,61,na,1925,3373.4655348384604
SIM,1771,89,na,1860,53
STAT,1839,52,25-29,1891,0.005501157106413558
STAT,1891,21,45-49,1912,1.7460366590729346
STAT,1834,54,45-49,1888,0.019038545871143054
SIM,1921,48,40-44,1969,1
STAT,1855,25,na,1880,3790.6825951334454
STAT,1857,36,40-44,1893,6.9242185093718405
SIM,1872,29,40-44,1901,7
SIM,1873,47,30-34,1920,1
SIM,1904,48,40-44,1952,1
STAT,1854,44,15-19,1898,0.020884533904732487
STAT,1859,36,45-49,1895,3.2199317930855917
SIM,1926,31,na,1957,9469
STAT,1874,34,20-24,1908,5.541838473470966
SIM,1808,83,na,1891,250
SIM,1874,29,45-49,1903,3
SIM,1800,63,na,1863,1769
STAT,1843,56,na,1899,2857.155469444436
SIM,1888,40,na,1928,5515
STAT,1935,22,35-39,1957,25.9006322771187
STAT,1933,22,30-34,1955,77.00374427771743
SIM,1848,83,na,1931,485
SIM,1887,26,20-24,1913,30
STAT,1824,30,45-49,1854,11.190597794462692
SIM,1843,33,25-29,1876,27
STAT,1840,26,15-19,1866,0.822460677255798
STAT,1902,52,na,1954,6106.910483415404
SIM,1842,15,35-39,1857,1
STAT,1808,48,50-100,1856,1.5234438053995207
STAT,1833,38,na,1871,3483.3449319575284
STAT,1929,25,15-19,1954,1.7909643806253455
SIM,1859,39,20-24,1898,4
STAT,1928,32,45-49,1960,3.973179042716784
SIM,1880,20,na,1900,5245
SIM,1943,22,35-39,1965,22
STAT,1903,27,20-24,1930,33.734520151549354
SIM,1890,27,50-100,1917,3
STAT,1859,45,35-39,1904,0.22729212304029842
SIM,1884,34,na,1918,5086
STAT,1873,38,na,1911,4810.617769342101
STAT,1860,71,na,1931,2189.1835741605164
STAT,1869,52,40-44,1921,0.020492298634636672
SIM,1916,13,na,1929,8603
STAT,1868,28,40-44,1896,5.735793776270335
SIM,1882,34,20-24,1916,7
SIM,1917,54,na,1971,7693
SIM,1863,29,na,1892,4436
SIM,1906,48,45-49,1954,1
STAT,1811,46,45-49,1857,1.6299199850521864
STAT,1879,26,20-24,1905,24.867469108216316
STAT,1827,109,na,1936,8.603216128349494E-4
STAT,1839,41,15-19,1880,0.025296215207279458
SIM,1888,42,45-49,1930,3
SIM,1926,22,35-39,1948,37
SIM,1834,91,na,1925,40
SIM,1825,34,50-100,1859,1
SIM,1911,27,20-24,1938,37
STAT,1819,74,na,1893,1161.2568875275263
SIM,1934,32,40-44,1966,18
SIM,1881,30,50-100,1911,2
STAT,1891,21,15-19,1912,8.26048858710836
STAT,1930,36,50-100,1966,1.1070291791331577
STAT,1864,16,50-100,1880,0.10113957205534836
SIM,1793,92,na,1885,8
STAT,1810,50,40-44,1860,0.06775958526951625
STAT,1905,38,35-39,1943,4.436829057533037
SIM,1936,32,45-49,1968,4
SIM,1832,41,25-29,1873,4
SIM,1900,14,na,1914,7555
STAT,1849,26,35-39,1875,18.223292484268114
STAT,1890,17,15-19,1907,14.629593057194999
SIM,1893,23,40-44,1916,7
STAT,1820,49,20-24,1869,0.04337784335601533
STAT,1850,39,35-39,1889,10.790004572754958
STAT,1891,32,25-29,1923,25.569454052261694
SIM,1852,22,40-44,1874,4
STAT,1913,49,25-29,1962,0.10397828742282118
SIM,1821,40,40-44,1861,5
STAT,1892,17,na,1909,6385.479621001845
STAT,1905,27,25-29,1932,123.5531720526021
STAT,1867,10,na,1877,5136.049666485511
STAT,1907,21,20-24,1928,205.17483059649788
SIM,1833,28,45-49,1861,3
SIM,1872,65,na,1937,3430
STAT,1868,20,30-34,1888,34.72361311438835
SIM,1854,12,na,1866,4824
STAT,1791,107,na,1898,0.0018610751540771532
STAT,1863,34,15-19,1897,0.24960713092196168
STAT,1818,44,35-39,1862,8.285807718798265
STAT,1868,26,45-49,1894,2.1407982811344315
STAT,1871,44,20-24,1915,0.31435941186155963
SIM,1810,81,na,1891,406
SIM,1835,22,40-44,1857,7
SIM,1842,17,30-34,1859,5
SIM,1822,39,25-29,1861,6
SIM,1884,34,25-29,1918,30
STAT,1871,47,50-100,1918,0.4905026283093456
STAT,1924,38,45-49,1962,1.6214262672304296
STAT,1815,40,45-49,1855,9.689154415516091
SIM,1898,16,25-29,1914,18
STAT,1818,92,na,1910,42.72992167833023
STAT,1926,32,40-44,1958,9.555002783628444
STAT,1838,53,na,1891,2867.238506426864
STAT,1880,31,40-44,1911,9.264387050754827
STAT,1876,34,25-29,1910,21.212185173177932
STAT,1835,33,25-29,1868,16.72209082407355
STAT,1924,32,30-34,1956,37.1128456427028
STAT,1907,38,45-49,1945,1.270881852659552
SIM,1936,21,50-100,1957,3
SIM,1874,52,50-100,1926,1
STAT,1833,33,20-24,1866,4.537344950238893
STAT,1851,51,40-44,1902,0.01639786324729349
SIM,1939,26,50-100,1965,3
STAT,1792,109,na,1901,2.665783541914129E-4
SIM,1898,27,35-39,1925,42
STAT,1790,99,na,1889,0.678354332117918
SIM,1884,35,50-100,1919,4
STAT,1862,1,na,1863,6276.069571043179
SIM,1836,40,50-100,1876,4
SIM,1841,33,20-24,1874,2
STAT,1924,21,20-24,1945,265.7181280746068
SIM,1915,38,45-49,1953,4
STAT,1896,38,15-19,1934,0.14898944184833365
SIM,1932,32,30-34,1964,13
STAT,1913,48,40-44,1961,0.310004492795358
STAT,1926,38,50-100,1964,1.0350801589711334
STAT,1844,22,40-44,1866,4.201636706205335
STAT,1848,47,25-29,1895,0.09400681898546386
STAT,1885,24,25-29,1909,114.36020963602691
SIM,1932,21,20-24,1953,296
STAT,1860,41,40-44,1901,3.7056905394545177
STAT,1809,56,na,1865,2408.165412284199
STAT,1882,31,45-49,1913,3.4448103631835334
STAT,1881,29,40-44,1910,5.805790421932378
STAT,1879,38,15-19,1917,0.1180368454348395
SIM,1822,38,40-44,1860,14
SIM,1876,20,30-34,1896,48
SIM,1826,44,35-39,1870,4
SIM,1826,33,25-29,1859,18
STAT,1813,61,na,1874,2085.9546419024055
STAT,1922,29,na,1951,8497.670621390555
SIM,1930,38,40-44,1968,6
SIM,1893,35,35-39,1928,4
SIM,1915,21,20-24,1936,243
STAT,1922,38,40-44,1960,3.4357733765526186
SIM,1846,25,20-24,1871,22
STAT,1885,35,35-39,1920,14.353703418460396
SIM,1832,30,45-49,1862,4
STAT,1830,40,40-44,1870,4.146661796031493
SIM,1909,35,50-100,1944,1
STAT,1887,70,na,1957,3289.187264463693
STAT,1918,9,na,1927,8749.393910790266
SIM,1932,38,45-49,1970,6
STAT,1812,46,50-100,1858,1.7350514653283045
STAT,1820,36,15-19,1856,0.2977099645996711
STAT,1869,50,45-49,1919,0.028808035531725028
STAT,1874,20,na,1894,4919.899857282129
STAT,1907,32,30-34,1939,29.758932096368497
STAT,1937,22,45-49,1959,2.2133350933745
SIM,1915,32,30-34,1947,32
SIM,1945,22,45-49,1967,2
STAT,1889,13,na,1902,6421.080939475498
SIM,1917,32,35-39,1949,3
STAT,1883,4,na,1887,5567.183976514605
STAT,1854,44,45-49,1898,2.2633612030195445
STAT,1859,38,40-44,1897,7.0018859568267455
STAT,1880,91,na,1971,448.71262226695114
SIM,1930,7,na,1937,11010
STAT,1838,25,20-24,1863,20.489994807006987
STAT,1909,32,35-39,1941,17.621575560138506
SIM,1893,24,25-29,1917,172
STAT,1891,34,20-24,1925,6.690094903212464
STAT,1935,25,45-49,1960,4.761152302393434
STAT,1834,51,35-39,1885,0.011985418129427158
STAT,1855,25,20-24,1880,20.5569340551222
STAT,1828,51,40-44,1879,0.018680651748727933
SIM,1890,31,45-49,1921,7
SIM,1815,96,na,1911,4
STAT,1846,31,35-39,1877,18.522319570261313
STAT,1865,45,35-39,1910,0.2594344929694866
SIM,1859,83,na,1942,526
STAT,1936,18,15-19,1954,87.53966514276341
SIM,1906,30,50-100,1936,3
STAT,1807,49,35-39,1856,0.9264934423946533
STAT,1948,24,40-44,1972,7.791169373415323
SIM,1860,24,na,1884,4193
STAT,1918,38,20-24,1956,0.5604885995760871
STAT,1795,107,na,1902,0.002015418765569139
SIM,1841,31,25-29,1872,29
SIM,1899,5,na,1904,7358
SIM,1856,47,25-29,1903,1
SIM,1937,15,na,1952,7437
SIM,1841,20,15-19,1861,9
STAT,1844,34,35-39,1878,19.155097764482225
STAT,1940,18,35-39,1958,8.602469368666286
SIM,1852,34,35-39,1886,19
SIM,1934,26,na,1960,10011
STAT,1862,35,na,1897,4105.514464615928
SIM,1847,41,45-49,1888,10
SIM,1874,15,25-29,1889,13
SIM,1930,36,na,1966,10483
SIM,1812,50,40-44,1862,1
STAT,1889,45,20-24,1934,0.030180714020308988
STAT,1866,25,na,1891,4477.409181841231
SIM,1819,86,na,1905,153
STAT,1822,38,na,1860,3198.8213048144116
SIM,1806,54,35-39,1860,1
SIM,1867,33,40-44,1900,12
STAT,1844,23,25-29,1867,114.59702412687808
SIM,1823,40,45-49,1863,6
SIM,1943,25,45-49,1968,3
SIM,1877,40,na,1917,4784
STAT,1798,79,na,1877,548.7791072308044
SIM,1863,25,20-24,1888,24
STAT,1861,20,20-24,1881,120.73704912407776
STAT,1867,42,35-39,1909,3.4208009703108413
STAT,1900,49,15-19,1949,6.189407001234034E-4
STAT,1839,41,45-49,1880,2.7414771306155568
SIM,1873,50,na,1923,4596
SIM,1847,98,na,1945,8
STAT,1793,64,na,1857,1620.2354096124482
STAT,1799,104,na,1903,0.04536014791943308
STAT,1902,46,15-19,1948,6.451847498799173E-4
SIM,1854,31,35-39,1885,25
STAT,1867,66,na,1933,3100.0641061953106
STAT,1822,49,30-34,1871,0.29241818568278943
STAT,1942,15,35-39,1957,8.86116659800473
STAT,1821,53,20-24,1874,0.0020365879253166582
STAT,1873,18,50-100,1891,0.10027068531277643
SIM,1878,2,na,1880,6741
STAT,1847,51,45-49,1898,0.02222772464340139
SIM,1845,42,50-100,1887,5
SIM,1891,44,na,1935,5910
STAT,1915,42,50-100,1957,0.23889109288675436
STAT,1872,35,25-29,1907,5.899524541467104
SIM,1852,23,25-29,1875,126
SIM,1862,44,45-49,1906,6
STAT,1881,18,30-34,1899,3.103210928652755
STAT,1887,41,50-100,1928,2.397103251834609
STAT,1804,50,40-44,1854,0.064096790555619
STAT,1895,45,15-19,1940,5.997027780939444E-4
SIM,1876,23,35-39,1899,15
SIM,1871,31,40-44,1902,13
SIM,1873,45,35-39,1918,1
STAT,1889,37,na,1926,5866.931747428639
STAT,1882,42,30-34,1924,2.25906874822337
SIM,1827,81,na,1908,522
SIM,1890,22,na,1912,6221
SIM,1890,42,30-34,1932,5
SIM,1957,4,na,1961,10327
SIM,1942,21,na,1963,7783
STAT,1830,33,na,1863,3831.4929220852623
STAT,1805,66,na,1871,1769.0295076237705
STAT,1861,22,40-44,1883,3.5986656663539938
SIM,1898,24,30-34,1922,59
STAT,1933,28,45-49,1961,4.631099602698358
STAT,1844,41,na,1885,3871.9449962233357
SIM,1865,55,na,1920,3832
STAT,1815,51,30-34,1866,0.03126205372145986
SIM,1941,28,45-49,1969,4
STAT,1846,47,15-19,1893,6.098267759578646E-4
STAT,1868,23,35-39,1891,11.17838069582921
STAT,1923,14,na,1937,9363.165547591208
STAT,1871,41,40-44,1912,4.53362693976016
SIM,1786,82,na,1868,328
SIM,1939,27,45-49,1966,3
STAT,1885,23,na,1908,4739.756934916298
STAT,1863,47,20-24,1910,0.021115904312285244
SIM,1883,49,na,1932,4553
SIM,1950,15,35-39,1965,10
STAT,1938,17,35-39,1955,8.361084164840543
SIM,1864,41,45-49,1905,4
STAT,1881,33,na,1914,4638.615209237458
STAT,1893,32,35-39,1925,25.924053990461385
STAT,1866,26,35-39,1892,18.04228710626458
STAT,1875,52,40-44,1927,0.021774149213769366
STAT,1849,22,50-100,1871,0.7798753422726121
SIM,1815,41,25-29,1856,1
STAT,1838,37,15-19,1875,0.0917055230494782
SIM,1814,55,na,1869,2410
STAT,1874,32,25-29,1906,21.18083319631674
SIM,1875,33,50-100,1908,4
SIM,1935,5,na,1940,11393
STAT,1801,76,na,1877,816.9038047337614
SIM,1858,41,20-24,1899,1
STAT,1888,12,na,1900,6164.617473035039
SIM,1878,23,45-49,1901,1
STAT,1881,27,15-19,1908,0.8856642328111368
SIM,1858,35,50-100,1893,4
STAT,1847,15,15-19,1862,11.424841741369965
SIM,1839,23,na,1862,3697
STAT,1891,35,35-39,1926,17.82440247363996
STAT,1908,16,40-44,1924,0.549669895936048
STAT,1865,44,20-24,1909,0.2874586915218289
STAT,1867,33,50-100,1900,1.7256960781244173
STAT,1917,36,50-100,1953,0.8848994662459847
SIM,1882,32,25-29,1914,26
STAT,1866,15,25-29,1881,10.967629636077746
STAT,1926,19,na,1945,9063.702089949582
SIM,1834,41,35-39,1875,6
SIM,1916,16,40-44,1932,2
SIM,1928,35,20-24,1963,1
STAT,1872,21,35-39,1893,11.880269900038456
SIM,1946,11,na,1957,8638
STAT,1777,93,na,1870,11.798431003929126
STAT,1914,28,35-39,1942,30.464908596454787
SIM,1915,47,na,1962,7547
STAT,1823,79,na,1902,838.9273103861508
SIM,1944,18,15-19,1962,89
STAT,1873,3,na,1876,6371.129004629945
STAT,1824,44,35-39,1868,4.483123658819731
SIM,1858,44,25-29,1902,2
STAT,1842,98,na,1940,4.836474903829803
SIM,1894,7,na,1901,7068
STAT,1895,42,40-44,1937,0.4105397026167258
SIM,1882,21,15-19,1903,7
SIM,1921,16,na,1937,8513
STAT,1826,41,35-39,1867,3.9041204800766205
STAT,1893,48,15-19,1941,5.703357962427513E-4
STAT,1944,28,15-19,1972,1.5401280334206608
STAT,1909,47,na,1956,6821.5538566006635
STAT,1931,25,30-34,1956,102.25800946504053
SIM,1825,71,na,1896,1415
SIM,1876,55,na,1931,4583
STAT,1832,54,35-39,1886,0.011221145469965664
SIM,1832,44,35-39,1876,7
STAT,1850,20,45-49,1870,1.3019168542940562
STAT,1881,15,20-24,1896,34.76832585560107
STAT,1866,24,15-19,1890,6.109178929509302
STAT,1848,31,na,1879,4187.45567746226
STAT,1885,38,15-19,1923,0.1123273800390096
SIM,1918,37,50-100,1955,4
SIM,1865,36,40-44,1901,11
STAT,1821,48,50-100,1869,0.7085409677635368
SIM,1855,15,15-19,1870,15
SIM,1894,12,na,1906,7014
STAT,1861,5,na,1866,4858.424535590802
SIM,1871,24,na,1895,4567
SIM,1895,32,35-39,1927,36
STAT,1850,10,na,1860,4528.843569548123
SIM,1805,94,na,1899,4
STAT,1768,97,na,1865,1.6034303880685001
STAT,1906,42,na,1948,6816.937077165712
STAT,1927,16,20-24,1943,341.23495372498286
SIM,1839,32,20-24,1871,6
STAT,1948,20,25-29,1968,214.32955157357972
STAT,1921,47,na,1968,8362.264566514235
SIM,1905,0,na,1905,8236
SIM,1924,25,35-39,1949,48
SIM,1945,26,na,1971,8610
SIM,1801,53,45-49,1854,1
STAT,1803,59,na,1862,2089.307656494596
SIM,1901,39,na,1940,6690
SIM,1866,77,na,1943,1647
STAT,1813,43,15-19,1856,0.0962888453295572
STAT,1898,23,20-24,1921,187.76190902626362
STAT,1806,54,50-100,1860,0.08466345201638484
STAT,1928,26,na,1954,9351.572044530663
SIM,1904,44,na,1948,6680
SIM,1824,35,40-44,1859,13
STAT,1855,28,30-34,1883,39.29597165225376
SIM,1888,80,na,1968,2139
SIM,1863,28,30-34,1891,59
STAT,1865,31,45-49,1896,3.2126600817867574
SIM,1827,38,na,1865,3311
SIM,1844,93,na,1937,21
SIM,1880,24,45-49,1904,4
STAT,1916,25,35-39,1941,31.5640538284618
STAT,1900,30,25-29,1930,28.926593393058006
SIM,1927,32,na,1959,9620
STAT,1834,105,na,1939,0.03896535005492695
STAT,1844,27,40-44,1871,5.922012316547057
STAT,1852,107,na,1959,0.018198335329572417
SIM,1872,27,15-19,1899,1
SIM,1889,65,na,1954,4137
STAT,1887,46,25-29,1933,0.13047585327156916
SIM,1963,0,na,1963,10489
SIM,1891,26,40-44,1917,7
SIM,1900,21,30-34,1921,82
STAT,1864,27,15-19,1891,0.8190735016506463
STAT,1868,51,na,1919,4157.164279971081
STAT,1905,35,30-34,1940,3.391807613208302
SIM,1828,41,35-39,1869,6
SIM,1885,29,20-24,1914,26
STAT,1902,39,50-100,1941,0.7479948015795163
STAT,1876,31,20-24,1907,5.669384961555703
SIM,1843,38,50-100,1881,1
STAT,1924,5,na,1929,9667.445444200739
SIM,1917,35,45-49,1952,2
STAT,1887,35,15-19,1922,0.12804614194027267
STAT,1920,39,15-19,1959,0.04236320360625647
SIM,1831,31,50-100,1862,2
SIM,1898,25,50-100,1923,3
STAT,1859,55,na,1914,3323.8271947591593
SIM,1893,27,na,1920,6243
STAT,1918,38,15-19,1956,0.040830300470452566
SIM,1875,14,na,1889,5793
STAT,1863,20,na,1883,4326.401326902981
SIM,1929,19,30-34,1948,45
SIM,1918,28,15-19,1946,2
STAT,1860,44,45-49,1904,2.421481186182263
STAT,1848,44,20-24,1892,0.2568918746939771
SIM,1832,68,na,1900,1949
SIM,1900,54,na,1954,6022
SIM,1862,63,na,1925,3241
STAT,1852,47,15-19,1899,6.345513889565851E-4
STAT,1865,31,15-19,1896,0.2623590015031621
SIM,1880,24,15-19,1904,7
STAT,1901,31,50-100,1932,2.6011509544105365
STAT,1889,45,15-19,1934,0.001006022915744932
SIM,1841,36,25-29,1877,6
SIM,1876,46,50-100,1922,1
STAT,1917,45,45-49,1962,0.46059647117366737
SIM,1818,38,20-24,1856,2
SIM,1848,39,45-49,1887,3
STAT,1880,34,15-19,1914,0.3003887068412246
STAT,1900,49,45-49,1949,0.36517532043468526
STAT,1854,41,35-39,1895,2.788515027253109
STAT,1870,24,35-39,1894,11.498314001480281
SIM,1838,27,50-100,1865,1
STAT,1897,48,na,1945,5998.562504207857
STAT,1852,76,na,1928,1509.9816393583262
SIM,1880,35,25-29,1915,9
STAT,1968,0,na,1968,9989.899174766422
SIM,1932,35,40-44,1967,6
STAT,1909,35,45-49,1944,1.3162872870364817
STAT,1835,30,20-24,1865,4.552651940028577
STAT,1931,22,50-100,1953,1.7236181084077198
STAT,1880,34,45-49,1914,3.678344565878048
STAT,1939,15,50-100,1954,0.7593535599853045
STAT,1929,39,35-39,1968,6.257493521591006
STAT,1834,23,na,1857,3772.3677096128185
SIM,1843,12,na,1855,4564
STAT,1873,51,50-100,1924,0.031139973028628292
SIM,1882,37,25-29,1919,9
STAT,1937,30,15-19,1967,0.2571088133037511
SIM,1913,24,20-24,1937,238
STAT,1866,29,45-49,1895,2.054239626757035
STAT,1818,37,40-44,1855,30.29075325481294
STAT,1813,43,45-49,1856,10.435302879950052
STAT,1877,29,20-24,1906,24.426869151053513
SIM,1876,23,40-44,1899,9
STAT,1842,42,50-100,1884,1.6272951228347063
SIM,1822,66,na,1888,1760
SIM,1913,35,30-34,1948,6
STAT,1848,44,15-19,1892,0.022338425092950472
STAT,1944,28,20-24,1972,39.823310259144556
STAT,1856,52,30-34,1908,0.009226099855083365
STAT,1895,42,35-39,1937,0.33051124169418705
STAT,1849,23,30-34,1872,33.82036490601091
STAT,1852,47,45-49,1899,0.3743856345984278
STAT,1901,70,na,1971,4764.938199019544
STAT,1831,34,25-29,1865,16.910552807879924
SIM,1926,33,50-100,1959,2
STAT,1802,53,40-44,1855,0.06613281572290045
STAT,1854,41,40-44,1895,3.463713137751639
STAT,1894,16,45-49,1910,0.16988872606925684
SIM,1775,79,na,1854,430
STAT,1868,23,40-44,1891,3.9917210262454517
STAT,1905,24,20-24,1929,200.0182425651907
SIM,1829,28,25-29,1857,70
STAT,1874,37,25-29,1911,5.953934487957361
STAT,1887,32,35-39,1919,22.874942509613323
STAT,1794,89,na,1883,78.95739381777925
STAT,1828,51,35-39,1879,0.0152762339418988
STAT,1876,27,na,1903,4985.112295986139
SIM,1846,17,na,1863,4460
STAT,1822,46,20-24,1868,0.03784684468603383
STAT,1884,78,na,1962,2005.0685920073954
STAT,1855,39,40-44,1894,6.534550985984658
STAT,1875,52,35-39,1927,0.017805963183163707
STAT,1806,101,na,1907,0.38854650953737163
STAT,1831,23,15-19,1854,12.233385862284958
STAT,1790,75,na,1865,748.631896446699
STAT,1885,28,40-44,1913,6.000773331193286
STAT,1834,51,40-44,1885,0.014656454135900034
STAT,1924,35,40-44,1959,3.5702679300602735
SIM,1843,30,20-24,1873,7
STAT,1883,26,40-44,1909,5.96441599031228
SIM,1845,91,na,1936,59
SIM,1856,6,na,1862,5055
SIM,1875,42,35-39,1917,9
STAT,1822,34,50-100,1856,4.363418221888817
STAT,1840,43,50-100,1883,1.5704695308797993
STAT,1939,29,na,1968,7599.243731858439
SIM,1937,20,15-19,1957,11
SIM,1935,16,20-24,1951,378
STAT,1889,28,50-100,1917,1.5873757018836854
SIM,1895,34,na,1929,6528
SIM,1939,22,15-19,1961,13
SIM,1826,40,na,1866,3199
SIM,1874,27,25-29,1901,97
STAT,1850,34,35-39,1884,15.909492282037943
STAT,1859,34,25-29,1893,16.323909988982763
SIM,1857,23,30-34,1880,1
SIM,1932,18,50-100,1950,1
SIM,1821,43,45-49,1864,6
STAT,1858,54,30-34,1912,0.009114084594649833
SIM,1908,18,na,1926,7644
STAT,1857,22,20-24,1879,125.23604312201296
STAT,1881,73,na,1954,2318.5897245302262
STAT,1867,100,na,1967,10.92953672716148
SIM,1937,28,25-29,1965,134
SIM,1904,21,45-49,1925,1
STAT,1929,28,25-29,1957,166.2716059345484
SIM,1896,19,25-29,1915,19
STAT,1888,19,25-29,1907,13.454308141575673
SIM,1829,45,na,1874,3149
STAT,1929,20,15-19,1949,13.675041550040882
STAT,1843,40,20-24,1883,0.23500111451958566
SIM,1865,22,20-24,1887,120
SIM,1826,37,40-44,1863,10
SIM,1850,23,20-24,1873,129
STAT,1874,37,30-34,1911,11.021112836079523
STAT,1877,16,45-49,1893,0.13732808091786902
STAT,1894,25,35-39,1919,25.202982312783032
STAT,1919,19,20-24,1938,300.8975510471331
SIM,1937,31,na,1968,7768
STAT,1851,108,na,1959,0.006769416328445393
STAT,1940,15,30-34,1955,25.00937773901172
SIM,1893,28,40-44,1921,10
STAT,1856,27,50-100,1883,1.032904548451512
STAT,1857,51,na,1908,3405.727494696605
SIM,1835,34,35-39,1869,27
SIM,1915,23,40-44,1938,11
SIM,1882,48,40-44,1930,1
SIM,1854,49,40-44,1903,2
STAT,1871,31,50-100,1902,1.8459735747911645
SIM,1941,25,40-44,1966,12
STAT,1918,27,na,1945,8050.293924297547
SIM,1882,6,na,1888,5492
SIM,1862,44,15-19,1906,1
SIM,1934,32,35-39,1966,27
STAT,1821,53,na,1874,2613.5245839021172
SIM,1899,64,na,1963,5249
STAT,1871,44,45-49,1915,2.9624957137986696
STAT,1907,23,40-44,1930,6.166386566058716
STAT,1915,16,50-100,1931,0.15876717456456477
SIM,1852,88,na,1940,187
SIM,1763,94,na,1857,18
SIM,1895,35,45-49,1930,7
SIM,1875,44,25-29,1919,7
STAT,1892,18,30-34,1910,4.019215573132534
STAT,1884,40,15-19,1924,0.02781842933431026
STAT,1910,47,na,1957,6925.097501733144
STAT,1804,53,45-49,1857,0.08317020340063447
STAT,1874,48,40-44,1922,0.34957865366095436
STAT,1930,21,45-49,1951,2.919879556660783
STAT,1867,44,25-29,1911,1.1981969035170028
SIM,1869,33,45-49,1902,3
STAT,1795,104,na,1899,0.02850505349722611
STAT,1907,35,40-44,1942,2.831279950936611
SIM,1886,40,45-49,1926,5
SIM,1927,19,20-24,1946,355
SIM,1937,25,20-24,1962,42
STAT,1842,23,20-24,1865,128.47705922132423
STAT,1925,1,na,1926,10186.277680721143
SIM,1840,33,50-100,1873,4
STAT,1766,93,na,1859,7.663491287417274
SIM,1835,23,25-29,1858,104
SIM,1893,38,45-49,1931,2
SIM,1865,39,45-49,1904,9
STAT,1874,34,15-19,1908,0.2919656584355631
STAT,1808,71,na,1879,1313.7014690121516
SIM,1835,22,35-39,1857,11
STAT,1887,35,45-49,1922,4.545637498292213
STAT,1844,37,15-19,1881,0.09582889131528054
SIM,1826,56,na,1882,2450
SIM,1895,50,na,1945,6023
STAT,1882,44,20-24,1926,0.30823076650886816
STAT,1874,22,20-24,1896,142.50516682918374
STAT,1926,32,35-39,1958,22.312766797542974
STAT,1845,66,na,1911,2525.60921222892
SIM,1837,96,na,1933,5
STAT,1856,52,25-29,1908,0.005489910604659301
SIM,1880,28,30-34,1908,65
SIM,1925,46,na,1971,8980
SIM,1863,28,25-29,1891,89
STAT,1846,45,25-29,1891,0.08910602490660971
STAT,1855,28,25-29,1883,66.01072406329915
STAT,1827,34,35-39,1861,22.681706699962756
STAT,1941,21,20-24,1962,232.16266256289296
SIM,1854,52,na,1906,3549
STAT,1924,47,35-39,1971,0.30991274618133663
STAT,1943,29,50-100,1972,2.1387267540813886
STAT,1922,32,na,1954,8628.016217983004
SIM,1929,15,15-19,1944,112
STAT,1870,33,na,1903,4711.6750492951105
SIM,1864,73,na,1937,2117
STAT,1909,20,40-44,1929,6.3524214857095895
SIM,1915,35,40-44,1950,9
STAT,1881,18,25-29,1899,11.032932281215812
SIM,1927,42,45-49,1969,1
SIM,1869,45,45-49,1914,1
SIM,1933,15,35-39,1948,10
SIM,1882,35,35-39,1917,4
SIM,1824,30,na,1854,3671
STAT,1846,34,15-19,1880,0.2524738144933636
SIM,1883,65,na,1948,3437
SIM,1884,10,na,1894,5652
SIM,1895,53,na,1948,5824
STAT,1860,54,40-44,1914,0.01679140763756717
SIM,1828,32,45-49,1860,6
SIM,1861,24,35-39,1885,12
SIM,1925,45,45-49,1970,1
STAT,1941,24,na,1965,7616.867352940775
STAT,1953,12,na,1965,9596.084290964276
STAT,1860,43,30-34,1903,1.871930333171494
STAT,1884,51,25-29,1935,0.007097528982126458
SIM,1894,19,15-19,1913,13
SIM,1850,78,na,1928,1078
STAT,1829,33,na,1862,3331.6781601392586
STAT,1919,42,45-49,1961,0.36417590405359423
STAT,1856,54,20-24,1910,0.0011182324949036509
SIM,1899,67,na,1966,4929
STAT,1880,46,15-19,1926,8.534447174599647E-4
STAT,1839,54,na,1893,3269.563816401436
STAT,1914,25,30-34,1939,80.32988485621243
STAT,1944,15,45-49,1959,1.0862202731417911
STAT,1876,33,40-44,1909,9.020564362641112
SIM,1854,34,15-19,1888,2
SIM,1878,38,50-100,1916,5
STAT,1853,24,35-39,1877,10.752974259205232
STAT,1888,68,na,1956,3704.4781438341374
SIM,1815,44,35-39,1859,4
STAT,1882,31,15-19,1913,0.281317345826992
SIM,1915,27,50-100,1942,4
SIM,1828,44,45-49,1872,6
STAT,1898,35,20-24,1933,2.126806149482627
SIM,1852,27,40-44,1879,8
STAT,1885,37,50-100,1922,2.4681265883287127
STAT,1925,15,35-39,1940,10.282764428918453
SIM,1900,36,35-39,1936,7
STAT,1874,35,35-39,1909,14.765105850384364
SIM,1884,33,40-44,1917,10
STAT,1920,46,na,1966,8220.262025825474
STAT,1781,82,na,1863,312.37981379510023
SIM,1890,42,25-29,1932,1
STAT,1831,23,45-49,1854,2.585796221965524
STAT,1899,15,na,1914,7021.172902813387
SIM,1837,99,na,1936,1
SIM,1833,27,30-34,1860,54
SIM,1862,87,na,1949,298
SIM,1882,37,30-34,1919,21
SIM,1874,91,na,1965,211
SIM,1831,27,na,1858,3964
SIM,1876,39,20-24,1915,4
STAT,1818,47,15-19,1865,0.001763384903670156
STAT,1819,58,na,1877,2319.5522428399486
STAT,1815,44,na,1859,2889.682982398551
STAT,1877,12,na,1889,5432.197682238096
STAT,1809,54,40-44,1863,0.0745385323507016
STAT,1833,33,15-19,1866,0.23904502310693646
SIM,1817,42,40-44,1859,7
SIM,1887,79,na,1966,2317
STAT,1880,33,50-100,1913,1.9411529325200887
STAT,1938,19,30-34,1957,24.270689660002922
SIM,1946,19,30-34,1965,34
SIM,1884,45,40-44,1929,1
STAT,1859,48,45-49,1907,0.374600682498285
STAT,1870,28,20-24,1898,23.17956103868666
STAT,1917,15,50-100,1932,0.1635701761091481
STAT,1844,25,na,1869,4338.708811090085
STAT,1766,90,na,1856,33.403290989999995
SIM,1908,22,50-100,1930,4
STAT,1896,63,na,1959,4951.050310223492
STAT,1876,45,40-44,1921,0.36117803191472103
SIM,1927,16,na,1943,9532
STAT,1841,43,20-24,1884,0.23639394954691254
STAT,1883,29,45-49,1912,2.1873986330654134
SIM,1876,24,25-29,1900,139
SIM,1910,46,45-49,1956,1
STAT,1846,34,45-49,1880,3.0916131745892774
STAT,1869,76,na,1945,1854.011667579314
STAT,1946,24,30-34,1970,64.54552012928056
STAT,1822,49,25-29,1871,0.17400090220036676
SIM,1856,38,50-100,1894,5
STAT,1862,54,20-24,1916,0.0012387687719542357
SIM,1948,15,na,1963,8697
SIM,1848,38,30-34,1886,15
STAT,1868,35,na,1903,4570.066460441871
STAT,1911,21,35-39,1932,18.09496695993057
SIM,1915,21,15-19,1936,11
STAT,1852,32,40-44,1884,7.156450370030927
STAT,1854,40,na,1894,3578.852323536316
STAT,1928,42,na,1970,9560.609344878485
SIM,1874,72,na,1946,2271
STAT,1858,16,35-39,1874,1.015126425445772
SIM,1905,29,na,1934,7033
STAT,1815,40,15-19,1855,0.08940396858843165
STAT,1867,50,na,1917,4131.078656404369
SIM,1866,16,35-39,1882,1
SIM,1871,31,35-39,1902,24
STAT,1835,32,40-44,1867,7.154030845849654
STAT,1820,90,na,1910,88.26259735409
SIM,1904,47,50-100,1951,1
STAT,1906,40,50-100,1946,0.21807933861092077
SIM,1876,35,35-39,1911,26
STAT,1821,111,na,1932,1.1897226741127356E-4
STAT,1840,22,50-100,1862,0.7485509429673403
SIM,1885,35,na,1920,5028
SIM,1923,42,na,1965,9145
STAT,1807,49,na,1856,2758.7509416046505
STAT,1907,43,na,1950,6834.559991419265
STAT,1815,51,25-29,1866,0.018602213605384877
STAT,1869,17,na,1886,5010.8992776376035
STAT,1846,47,20-24,1893,0.01829481937146825
STAT,1882,42,25-29,1924,1.2618221888550707
SIM,1883,49,50-100,1932,3
STAT,1794,105,na,1899,0.011484892405004492
SIM,1885,75,na,1960,2418
SIM,1848,36,40-44,1884,13
STAT,1858,31,50-100,1889,1.457610908497355
SIM,1843,32,40-44,1875,13
STAT,1777,77,na,1854,567.0
SIM,1859,26,45-49,1885,3
STAT,1907,21,15-19,1928,9.822263828366589
STAT,1835,44,40-44,1879,3.4037930144902773
SIM,1932,30,50-100,1962,5
SIM,1840,63,na,1903,2766
SIM,1935,19,25-29,1954,138
STAT,1861,34,40-44,1895,7.227642282911458
STAT,1831,27,30-34,1858,43.89377534121944
STAT,1852,33,25-29,1885,16.727746307532044
STAT,1799,80,na,1879,534.0856367201928
STAT,1847,51,50-100,1898,0.02313190323497316
STAT,1809,96,na,1905,7.631941056708284
SIM,1813,86,na,1899,171
STAT,1847,15,20-24,1862,34.12990693009034
STAT,1898,38,25-29,1936,1.6900513348617965
SIM,1818,45,na,1863,2992
STAT,1887,23,45-49,1910,1.5702377856274738
SIM,1860,33,25-29,1893,24
STAT,1863,22,45-49,1885,1.2573635546740383
STAT,1937,35,15-19,1972,0.0388566228352178
SIM,1897,60,na,1957,5316
SIM,1909,23,40-44,1932,8
STAT,1927,19,25-29,1946,108.22124467689756
SIM,1836,58,na,1894,2505
STAT,1844,22,na,1866,4311.161365856954
STAT,1955,15,20-24,1970,363.6306670114733
STAT,1826,42,40-44,1868,4.751023424839716
STAT,1962,3,na,1965,10177.23075573754
STAT,1862,101,na,1963,3.444511702803549
STAT,1929,25,20-24,1954,46.30922147057586
SIM,1895,23,45-49,1918,3
SIM,1939,24,35-39,1963,32
STAT,1933,13,na,1946,10696.729907099038
STAT,1862,18,15-19,1880,11.66361647702051
STAT,1878,40,45-49,1918,3.188718045766266
SIM,1851,43,25-29,1894,5
SIM,1824,33,20-24,1857,5
STAT,1883,24,20-24,1907,135.88520293415
SIM,1880,39,40-44,1919,20
STAT,1815,53,20-24,1868,0.0037235587518919676
STAT,1831,38,40-44,1869,7.083017492070922
STAT,1900,46,40-44,1946,0.2713240002371326
STAT,1911,47,25-29,1958,0.1014511104357933
STAT,1841,30,15-19,1871,0.2559567942689846
SIM,1950,13,na,1963,9175
STAT,1946,25,20-24,1971,41.09891573661989
SIM,1834,43,25-29,1877,2
STAT,1870,17,40-44,1887,0.3661199186689287
SIM,1817,60,na,1877,2267
SIM,1843,44,40-44,1887,4
STAT,1851,51,na,1902,3353.773258506071
SIM,1842,67,na,1909,2195
STAT,1832,53,20-24,1885,9.810514792747919E-4
STAT,1850,31,50-100,1881,1.484955168749742
STAT,1872,28,30-34,1900,50.93280522765448
STAT,1855,65,na,1920,2548.3525749003284
SIM,1820,46,50-100,1866,2
SIM,1845,32,45-49,1877,6
SIM,1910,34,45-49,1944,1
STAT,1891,32,na,1923,5957.1441823325695
STAT,1818,89,na,1907,107.77891801819163
STAT,1833,78,na,1911,1027.1616978890722
STAT,1928,21,50-100,1949,1.663959243237165
SIM,1867,30,30-34,1897,49
SIM,1923,31,20-24,1954,6
STAT,1902,34,45-49,1936,2.8306168997533905
STAT,1857,37,25-29,1894,4.53242336711815
STAT,1873,30,50-100,1903,1.8953005088078243
STAT,1796,69,na,1865,1408.676872427729
SIM,1851,47,na,1898,3540
STAT,1896,43,50-100,1939,0.19420193139007458
SIM,1870,18,15-19,1888,14
STAT,1890,53,na,1943,5222.813309847899
SIM,1889,39,30-34,1928,21
STAT,1868,35,35-39,1903,13.719878787300175
SIM,1848,43,na,1891,3485
SIM,1857,17,na,1874,4770
STAT,1872,39,40-44,1911,8.795769254647617
SIM,1894,49,na,1943,5967
STAT,1846,22,45-49,1868,1.3178802230801228
STAT,1859,48,15-19,1907,6.349158766156615E-4
STAT,1843,43,25-29,1886,0.9143929102766272
STAT,1899,48,50-100,1947,0.3785393328122009
SIM,1855,15,20-24,1870,47
STAT,1899,17,35-39,1916,1.5183542851749852
STAT,1902,46,45-49,1948,0.380659322823651
SIM,1812,45,na,1857,2892
SIM,1885,25,35-39,1910,30
SIM,1918,19,25-29,1937,114
SIM,1854,22,45-49,1876,1
STAT,1907,64,na,1971,5857.3168820194805
STAT,1826,43,25-29,1869,1.3290701383508257
STAT,1903,50,na,1953,6280.715598657009
STAT,1866,26,40-44,1892,5.601329127920507
SIM,1896,16,na,1912,7038
STAT,1776,92,na,1868,21.114187860545243
STAT,1911,36,15-19,1947,0.037651015494292076
STAT,1929,36,30-34,1965,4.729500839505967
STAT,1837,32,45-49,1869,3.0480235952243597
SIM,1887,39,na,1926,5704
SIM,1861,22,na,1883,4562
STAT,1842,15,na,1857,4440.660046259959
STAT,1859,30,30-34,1889,28.47515189247645
STAT,1915,31,20-24,1946,5.038034978359358
STAT,1893,34,25-29,1927,25.99533437898569
STAT,1872,24,15-19,1896,6.6542435697880675
STAT,1841,41,25-29,1882,0.9806625326553864
SIM,1860,32,40-44,1892,11
SIM,1907,22,30-34,1929,71
SIM,1794,77,na,1871,660
SIM,1872,25,na,1897,5109
STAT,1816,38,45-49,1854,14.841576477281198
STAT,1881,40,50-100,1921,2.083089097485792
SIM,1824,38,45-49,1862,9
STAT,1853,36,50-100,1889,1.9628122392408676
STAT,1926,22,50-100,1948,1.6141816579762422
STAT,1827,69,na,1896,1774.603929630121
SIM,1931,21,na,1952,9658
STAT,1841,49,35-39,1890,0.19888897957967328
SIM,1891,24,20-24,1915,191
STAT,1915,42,30-34,1957,0.2599697193001809
STAT,1897,17,50-100,1914,0.13226052973687946
SIM,1854,34,45-49,1888,2
SIM,1891,29,45-49,1920,3
STAT,1851,17,30-34,1868,3.004026797552684
SIM,1861,28,20-24,1889,25
STAT,1833,21,20-24,1854,150.7588129110866
STAT,1930,34,20-24,1964,6.3491514415856765
STAT,1859,45,40-44,1904,0.27794579553401855
STAT,1913,21,45-49,1934,2.209192551489125
SIM,1878,20,35-39,1898,21
SIM,1928,23,20-24,1951,276
SIM,1920,17,15-19,1937,100
STAT,1908,19,15-19,1927,17.69571879136646
SIM,1938,16,na,1954,7378
STAT,1891,37,30-34,1928,13.304662552931648
STAT,1861,10,na,1871,4670.231098633863
STAT,1831,74,na,1905,1432.9014100953866
STAT,1822,110,na,1932,3.12008729074081E-4
SIM,1863,24,15-19,1887,7
SIM,1913,9,na,1922,8428
STAT,1857,91,na,1948,91.22127546337288
SIM,1832,46,30-34,1878,1
STAT,1897,42,15-19,1939,0.0025857230664944335
SIM,1840,60,na,1900,2984
STAT,1878,50,na,1928,4606.943902195171
SIM,1916,32,na,1948,8009
STAT,1876,48,45-49,1924,0.4867767004667009
STAT,1865,24,na,1889,4329.321963106973
SIM,1878,65,na,1943,3568
STAT,1915,45,35-39,1960,0.2636404000367377
STAT,1879,75,na,1954,2174.715076393285
STAT,1875,61,na,1936,3885.5503195507804
SIM,1874,51,na,1925,4155
STAT,1838,28,25-29,1866,72.30304929582992
STAT,1840,19,20-24,1859,32.74303476718726
STAT,1917,42,na,1959,7826.987545293289
STAT,1909,23,45-49,1932,2.1066235522458925
STAT,1855,24,15-19,1879,5.728541366897076
SIM,1876,28,40-44,1904,7
SIM,1863,35,25-29,1898,8
STAT,1868,24,25-29,1892,109.31034093115053
STAT,1888,16,20-24,1904,42.42309566665256
STAT,1876,86,na,1962,789.1743926809935
SIM,1828,48,30-34,1876,1
STAT,1892,16,40-44,1908,0.46356879574473614
STAT,1904,36,50-100,1940,0.771855936560923
STAT,1912,17,15-19,1929,18.539074724219418
SIM,1835,22,50-100,1857,1
SIM,1900,24,40-44,1924,8
STAT,1905,57,na,1962,6154.855338391574
STAT,1824,43,15-19,1867,0.0350290075238433
STAT,1887,27,na,1914,5390.661209239295
SIM,1835,49,50-100,1884,3
STAT,1831,36,20-24,1867,1.274122523069749
SIM,1921,21,45-49,1942,8
STAT,1891,48,40-44,1939,0.23804910171516142
SIM,1854,38,30-34,1892,17
SIM,1833,23,50-100,1856,4
STAT,1833,40,50-100,1873,1.7296171788131791
SIM,1889,37,40-44,1926,18
STAT,1885,23,35-39,1908,11.69479437056669
SIM,1913,27,25-29,1940,142
STAT,1845,54,45-49,1899,0.02174773719020351
SIM,1841,21,20-24,1862,125
SIM,1896,16,20-24,1912,53
STAT,1787,92,na,1879,21.743884231955718
STAT,1850,33,15-19,1883,0.22605580627124808
SIM,1912,36,50-100,1948,1
STAT,1824,46,30-34,1870,0.23775405616841677
STAT,1853,28,20-24,1881,19.426954564115057
SIM,1886,42,35-39,1928,7
SIM,1829,25,20-24,1854,24
SIM,1873,87,na,1960,433
STAT,1856,8,na,1864,4524.561501518069
SIM,1913,38,35-39,1951,5
SIM,1928,34,30-34,1962,50
SIM,1841,40,50-100,1881,4
SIM,1906,31,20-24,1937,7
SIM,1861,25,na,1886,4602
SIM,1863,39,40-44,1902,13
STAT,1804,53,15-19,1857,1.409663277926849E-4
STAT,1889,33,20-24,1922,6.702839831348134
SIM,1826,44,40-44,1870,6
STAT,1851,15,40-44,1866,0.34882141527123367
STAT,1940,24,50-100,1964,1.3529196738928815
STAT,1896,36,25-29,1932,7.714123509600936
STAT,1846,38,30-34,1884,8.436782415419144
STAT,1911,49,15-19,1960,7.003915270196515E-4
STAT,1864,21,na,1885,4369.678408363685
STAT,1845,18,15-19,1863,11.490101963452235
STAT,1878,53,na,1931,4468.75656573725
STAT,1765,110,na,1875,0.003576596365483185
STAT,1862,45,50-100,1907,0.42818167356190295
SIM,1893,35,40-44,1928,1
STAT,1885,35,40-44,1920,8.883652583306247
SIM,1815,93,na,1908,22
STAT,1834,53,30-34,1887,0.007965228823935213
STAT,1783,112,na,1895,1.2840939565783883E-4
STAT,1820,36,45-49,1856,10.568702486411134
SIM,1946,15,15-19,1961,88
STAT,1803,56,na,1859,2217.204633051702
STAT,1877,48,50-100,1925,0.5085902814161439
SIM,1906,33,40-44,1939,9
SIM,1895,20,40-44,1915,9
STAT,1784,111,na,1895,1.9414347199034273E-4
STAT,1865,47,30-34,1912,0.17678170231863813
SIM,1889,23,50-100,1912,1
STAT,1922,24,15-19,1946,12.248217377230626
SIM,1884,48,45-49,1932,2
STAT,1899,12,na,1911,7146.160847898354
STAT,1839,29,50-100,1868,1.2403019185055852
STAT,1848,45,35-39,1893,0.23184761924010863
STAT,1872,24,45-49,1896,1.406521307877925
SIM,1850,28,45-49,1878,2
SIM,1895,39,30-34,1934,18
SIM,1853,18,15-19,1871,12
STAT,1823,52,50-100,1875,0.04491844899832342
STAT,1842,28,45-49,1870,2.0295477632843855
STAT,1860,51,50-100,1911,0.024888274094022028
STAT,1870,34,50-100,1904,1.8012023055037565
STAT,1877,28,na,1905,4987.299483171438
SIM,1886,17,na,1903,5333
STAT,1891,34,15-19,1925,0.3524602842113249
STAT,1895,40,45-49,1935,3.978345950617006
SIM,1852,22,35-39,1874,13
STAT,1810,53,45-49,1863,0.08791199236226874
STAT,1856,41,15-19,1897,0.02161634440060401
SIM,1930,26,50-100,1956,4
STAT,1890,21,50-100,1911,1.0083019352050215
SIM,1838,19,30-34,1857,4
SIM,1839,49,45-49,1888,1
SIM,1858,98,na,1956,1
SIM,1884,50,na,1934,4718
SIM,1839,47,na,1886,3139
SIM,1916,19,15-19,1935,85
SIM,1835,33,na,1868,3606
STAT,1887,39,30-34,1926,11.917249995851714
STAT,1887,48,20-24,1935,0.026764931400930145
STAT,1920,27,20-24,1947,40.431728070121885
STAT,1941,24,25-29,1965,192.6628131377905
STAT,1829,45,25-29,1874,0.09329453108363674
SIM,1906,14,na,1920,7572
SIM,1830,30,35-39,1860,19
SIM,1883,18,30-34,1901,3
STAT,1830,89,na,1919,145.0666359076149
STAT,1866,28,30-34,1894,46.76078013289467
SIM,1873,42,25-29,1915,4
SIM,1897,33,20-24,1930,10
SIM,1872,18,25-29,1890,15
SIM,1878,35,45-49,1913,6
STAT,1842,26,25-29,1868,78.44615035634108
STAT,1938,15,15-19,1953,90.84925508105368
SIM,1862,66,na,1928,2964
SIM,1850,26,25-29,1876,85
STAT,1863,76,na,1939,1674.9155554680735
STAT,1831,36,50-100,1867,2.029314348489665
STAT,1871,44,15-19,1915,0.027335602507859526
SIM,1864,14,na,1878,5157
STAT,1896,25,15-19,1921,1.217972740588551
SIM,1911,54,na,1965,7020
STAT,1892,57,na,1949,5080.941813854358
STAT,1867,41,20-24,1908,0.30174203645364456
SIM,1870,45,50-100,1915,2
STAT,1865,42,25-29,1907,1.1767863391763418
SIM,1905,18,30-34,1923,6
STAT,1864,18,25-29,1882,10.520580270232195
SIM,1837,45,25-29,1882,1
STAT,1829,34,15-19,1863,0.2587932752857253
STAT,1844,22,35-39,1866,11.76622673246031
STAT,1897,46,30-34,1943,0.14782777618378992
SIM,1887,29,25-29,1916,111
STAT,1857,39,45-49,1896,3.1065566690698434
STAT,1852,35,45-49,1887,3.2615142259260383
SIM,1915,1,na,1916,8746
STAT,1948,22,15-19,1970,12.343138985270267
STAT,1840,24,25-29,1864,103.57801625332036
STAT,1842,16,50-100,1858,0.09421925865580376
STAT,1830,43,15-19,1873,0.024409308093932665
SIM,1827,41,na,1868,3284
STAT,1875,16,35-39,1891,1.1437614365642192
SIM,1856,32,20-24,1888,8
SIM,1829,85,na,1914,303
SIM,1871,42,50-100,1913,6
STAT,1932,31,na,1963,10160.696207018353
SIM,1874,26,40-44,1900,11
SIM,1879,16,15-19,1895,11
SIM,1913,23,30-34,1936,76
SIM,1826,96,na,1922,4
SIM,1796,81,na,1877,417
SIM,1804,93,na,1897,12
SIM,1888,24,na,1912,5473
SIM,1902,21,35-39,1923,22
SIM,1880,37,20-24,1917,3
STAT,1850,47,40-44,1897,0.261272014778874
SIM,1883,16,35-39,1899,1
STAT,1826,40,20-24,1866,0.3495477012524197
STAT,1887,20,40-44,1907,4.734976135844852
SIM,1918,16,20-24,1934,66
SIM,1849,84,na,1933,427
STAT,1849,24,15-19,1873,6.2189160667965915
SIM,1866,40,na,1906,4535
SIM,1860,30,20-24,1890,7
SIM,1891,27,25-29,1918,113
STAT,1835,47,15-19,1882,5.463187719433237E-4
STAT,1832,37,na,1869,3503.3657485035187
STAT,1863,42,50-100,1905,1.865402552177663
SIM,1907,25,35-39,1932,33
STAT,1886,19,15-19,1905,12.584270684674113
STAT,1868,39,20-24,1907,1.466298795947647
STAT,1790,96,na,1886,2.9567812241486173
STAT,1931,17,25-29,1948,114.55997412318078
SIM,1878,46,25-29,1924,1
SIM,1860,35,45-49,1895,6
SIM,1835,27,40-44,1862,7
SIM,1840,19,25-29,1859,12
SIM,1854,44,50-100,1898,6
SIM,1838,22,na,1860,3829
STAT,1861,37,45-49,1898,3.351067886549697
STAT,1935,4,na,1939,11145.763785906474
STAT,1894,18,40-44,1912,0.47327986117251714
SIM,1900,33,30-34,1933,66
STAT,1931,28,35-39,1959,39.12924784320475
STAT,1848,32,20-24,1880,5.168762575715822
SIM,1859,23,40-44,1882,1
STAT,1879,29,25-29,1908,88.72210519944491
SIM,1797,66,na,1863,1617
SIM,1922,25,30-34,1947,118
STAT,1766,109,na,1875,0.003680702945925053
STAT,1910,40,35-39,1950,0.38884890620829665
SIM,1904,34,15-19,1938,4
STAT,1879,52,50-100,1931,0.031734370172587234
STAT,1819,55,na,1874,2461.543642671998
STAT,1815,41,na,1856,2999.315644059527
STAT,1833,34,35-39,1867,16.82259869352253
SIM,1876,39,na,1915,5053
STAT,1849,19,40-44,1868,0.3519418908521164
SIM,1841,34,35-39,1875,26
STAT,1875,22,50-100,1897,0.8479396290984279
STAT,1846,44,50-100,1890,1.5963346496715247
SIM,1857,24,15-19,1881,8
STAT,1846,49,40-44,1895,0.2567534696040218
STAT,1878,42,35-39,1920,3.814848247046849
SIM,1930,4,na,1934,11099
STAT,1914,19,50-100,1933,0.15570835909530312
SIM,1916,19,45-49,1935,1
STAT,1862,50,35-39,1912,0.015074527015424641
STAT,1827,27,40-44,1854,17.83785975356378
SIM,1865,37,25-29,1902,7
STAT,1875,54,30-34,1929,0.012037071640679728
STAT,1905,23,30-34,1928,51.86501248226323
STAT,1841,34,30-34,1875,30.1045473898162
STAT,1930,24,na,1954,9388.928443849536
SIM,1875,54,na,1929,4729
SIM,1923,34,25-29,1957,35
SIM,1871,40,na,1911,4557
SIM,1910,31,40-44,1941,13
SIM,1858,43,40-44,1901,5
SIM,1928,38,25-29,1966,6
STAT,1830,43,45-49,1873,2.64535857895488
STAT,1894,29,20-24,1923,30.21850778221234
STAT,1873,52,30-34,1925,0.012149939096191534
STAT,1866,65,na,1931,3149.2108759196467
SIM,1921,46,20-24,1967,1
STAT,1857,34,20-24,1891,4.218715917139946
STAT,1921,29,50-100,1950,2.2238526475331444
STAT,1852,30,20-24,1882,4.554191666610017
STAT,1911,44,20-24,1955,0.03363400638996373
STAT,1908,19,45-49,1927,0.19477947397395753
SIM,1917,23,45-49,1940,5
STAT,1827,38,20-24,1865,1.5596741171595407
STAT,1851,54,45-49,1905,0.021878242359369186
SIM,1939,21,30-34,1960,75
SIM,1873,10,na,1883,5573
SIM,1815,56,na,1871,2226
SIM,1848,22,15-19,1870,6
SIM,1849,33,50-100,1882,4
STAT,1837,41,35-39,1878,3.0172600472483078
STAT,1877,68,na,1945,3204.872021664553
STAT,1883,27,25-29,1910,83.93758310347037
STAT,1899,21,50-100,1920,1.1318193836178079
SIM,1889,23,15-19,1912,11
STAT,1826,45,45-49,1871,0.4835722114682376
STAT,1845,47,50-100,1892,0.3766894313226823
STAT,1933,25,40-44,1958,12.51144810087281
SIM,1843,47,45-49,1890,2
STAT,1822,78,na,1900,882.1897373997092
STAT,1856,10,na,1866,4453.625140797438
SIM,1929,17,35-39,1946,11
STAT,1904,44,20-24,1948,0.031536668741074976
STAT,1893,31,20-24,1924,6.947778203689606
STAT,1913,45,50-100,1958,0.4480648244685724
STAT,1856,41,45-49,1897,2.342671159941436
STAT,1858,52,35-39,1910,0.013482104251346824
SIM,1822,34,25-29,1856,23
STAT,1893,36,45-49,1929,5.12764427733793
SIM,1906,54,na,1960,6351
STAT,1902,31,40-44,1933,12.416013135775668
SIM,1865,34,20-24,1899,4
SIM,1902,40,na,1942,6824
STAT,1850,36,30-34,1886,8.387728812639
STAT,1915,34,25-29,1949,18.849969016847506
SIM,1923,45,35-39,1968,2
SIM,1846,28,25-29,1874,93
SIM,1926,25,45-49,1951,6
SIM,1833,25,40-44,1858,10
SIM,1824,36,25-29,1860,8
STAT,1908,46,na,1954,6765.181871159736
SIM,1948,23,30-34,1971,86
STAT,1904,32,na,1936,6976.134921490723
SIM,1899,27,na,1926,6652
SIM,1921,45,50-100,1966,1
SIM,1948,17,45-49,1965,1
STAT,1859,33,35-39,1892,16.210451076623098
STAT,1880,32,na,1912,5077.050997112342
STAT,1788,77,na,1865,692.5998054228182
SIM,1845,41,35-39,1886,8
STAT,1911,32,na,1943,7440.080892915205
STAT,1924,23,40-44,1947,7.985973184692816
SIM,1932,23,40-44,1955,9
STAT,1872,37,20-24,1909,1.5646232132586086
STAT,1856,110,na,1966,0.003205591305123448
SIM,1898,25,15-19,1923,1
STAT,1835,47,45-49,1882,0.3223283467448669
STAT,1841,45,40-44,1886,0.2560016012101698
SIM,1930,34,25-29,1964,31
SIM,1838,81,na,1919,648
STAT,1889,46,35-39,1935,0.3496224326446012
STAT,1817,48,na,1865,2886.25370108677
STAT,1922,34,25-29,1956,20.982210342053627
STAT,1918,25,45-49,1943,3.737740078157888
STAT,1861,37,15-19,1898,0.09439628972038372
STAT,1913,46,20-24,1959,0.02184403675443079
STAT,1940,7,na,1947,8163.910775314825
SIM,1836,55,na,1891,2586
SIM,1873,4,na,1877,5859
STAT,1859,22,25-29,1881,95.47563503522971
STAT,1881,25,25-29,1906,83.13603303608569
STAT,1852,36,na,1888,3814.7617248435777
STAT,1941,21,50-100,1962,1.3738250024757714
SIM,1867,22,25-29,1889,114
SIM,1915,28,na,1943,7745
STAT,1849,27,25-29,1876,79.31826985174219
STAT,1842,24,35-39,1866,10.801267643285685
SIM,1899,33,25-29,1932,39
SIM,1862,49,50-100,1911,2
SIM,1874,26,50-100,1900,1
STAT,1864,42,50-100,1906,1.9048745167167112
SIM,1885,32,50-100,1917,1
SIM,1893,8,na,1901,6906
SIM,1799,86,na,1885,111
SIM,1945,23,20-24,1968,7
STAT,1924,26,45-49,1950,4.075332775380182
SIM,1957,14,na,1971,10314
STAT,1817,52,40-44,1869,0.04873164574311274
STAT,1898,49,40-44,1947,0.2584263651964888
STAT,1854,62,na,1916,2801.888586980866
STAT,1880,38,30-34,1918,11.282824103292908
STAT,1896,26,15-19,1922,1.2139168913623906
STAT,1943,20,40-44,1963,7.22957802276627
SIM,1846,35,25-29,1881,3
SIM,1860,37,40-44,1897,2
SIM,1874,24,20-24,1898,7
SIM,1914,15,30-34,1929,7
STAT,1930,37,25-29,1967,2.5937475577507185
STAT,1828,108,na,1936,0.0022494585316936446
SIM,1919,6,na,1925,9084
STAT,1833,106,na,1939,0.015961803085645574
STAT,1833,24,25-29,1857,100.4688748477001
SIM,1872,5,na,1877,5903
SIM,1897,36,25-29,1933,10
STAT,1878,90,na,1968,491.76352619307914
STAT,1850,72,na,1922,1936.358574918628
SIM,1781,88,na,1869,75
SIM,1928,37,35-39,1965,4
SIM,1874,35,na,1909,4626
SIM,1879,1,na,1880,6793
STAT,1889,49,30-34,1938,0.1331357847956778
STAT,1897,30,45-49,1927,4.745536625564184
SIM,1932,26,45-49,1958,4
STAT,1911,33,40-44,1944,7.665838261713931
STAT,1925,19,15-19,1944,110.10501927786639
STAT,1815,44,30-34,1859,6.436437882681744
SIM,1885,13,na,1898,5417
STAT,1866,24,20-24,1890,127.61312196948086
STAT,1906,15,30-34,1921,4.712462377757429
STAT,1848,68,na,1916,2505.796586130632
SIM,1844,90,na,1934,74
STAT,1845,50,35-39,1895,0.013456644565500294
SIM,1851,42,40-44,1893,4
SIM,1838,29,40-44,1867,6
STAT,1887,67,na,1954,3580.6784251035274
SIM,1835,43,50-100,1878,7
STAT,1820,37,20-24,1857,3.833089197685145
SIM,1939,29,35-39,1968,3
STAT,1882,35,30-34,1917,10.584974669817727
SIM,1910,31,35-39,1941,27
STAT,1829,73,na,1902,1405.7160787478424
SIM,1824,76,na,1900,1120
STAT,1836,27,15-19,1863,0.7807436784359378
STAT,1865,49,45-49,1914,0.4239744198518767
STAT,1908,27,50-100,1935,1.9177272582658285
SIM,1834,45,45-49,1879,1
SIM,1897,49,30-34,1946,1
STAT,1829,35,15-19,1864,0.10171608553412849
STAT,1891,72,na,1963,3628.8651590198187
STAT,1844,21,35-39,1865,11.851319204347528
STAT,1939,31,30-34,1970,32.48843192625141
SIM,1929,17,50-100,1946,1
SIM,1879,24,50-100,1903,1
STAT,1919,33,50-100,1952,1.7935513327913213
SIM,1902,18,na,1920,7395
STAT,1809,45,50-100,1854,1.9739742969622314
SIM,1862,40,35-39,1902,7
STAT,1866,101,na,1967,6.155748620755365
STAT,1849,16,na,1865,4495.862793799588
STAT,1944,15,50-100,1959,0.8146652048563431
SIM,1852,21,35-39,1873,21
STAT,1909,36,20-24,1945,0.5066251868229474
SIM,1829,29,30-34,1858,58
SIM,1894,15,35-39,1909,2
STAT,1900,30,30-34,1930,49.30876267212453
STAT,1855,24,45-49,1879,1.210853707276827
SIM,1795,96,na,1891,3
STAT,1813,47,30-34,1860,0.5972537886574819
SIM,1905,15,20-24,1920,50
SIM,1836,95,na,1931,7
SIM,1877,18,na,1895,5234
STAT,1932,34,25-29,1966,24.784436032448756
SIM,1907,25,40-44,1932,8
STAT,1838,35,25-29,1873,4.800661080145036
SIM,1882,30,na,1912,4994
STAT,1835,21,25-29,1856,99.31209892121763
STAT,1931,16,35-39,1947,11.120083012679238
STAT,1871,58,na,1929,3968.079045849258
SIM,1928,20,40-44,1948,10
STAT,1822,75,na,1897,1162.3484762425526
STAT,1900,23,25-29,1923,159.88513272068957
SIM,1922,29,25-29,1951,162
STAT,1813,80,na,1893,549.685184437285
STAT,1902,31,35-39,1933,28.99377550454156
SIM,1833,53,na,1886,2820
SIM,1907,18,35-39,1925,1
STAT,1875,17,25-29,1892,11.783120721894615
STAT,1840,29,30-34,1869,44.672882384510075
SIM,1831,40,na,1871,3581
STAT,1950,16,45-49,1966,1.193162413722285
SIM,1839,44,na,1883,3252
STAT,1879,36,25-29,1915,6.11151228618561
SIM,1889,22,45-49,1911,4
STAT,1898,30,20-24,1928,7.447080047082499
STAT,1886,15,35-39,1901,1.1752515172236184
SIM,1909,26,45-49,1935,3
STAT,1901,26,35-39,1927,27.37470261375121
STAT,1942,16,50-100,1958,0.7909776486609331
STAT,1862,91,na,1953,100.02959318331293
STAT,1856,17,15-19,1873,10.934484197466455
STAT,1873,35,na,1908,4880.512129378404
STAT,1831,29,20-24,1860,20.02500730485959
STAT,1833,37,30-34,1870,8.776283124241576
SIM,1864,17,15-19,1881,10
SIM,1952,19,25-29,1971,121
STAT,1913,47,35-39,1960,0.2542150653784633
STAT,1889,36,25-29,1925,7.204380384001942
STAT,1880,30,35-39,1910,21.71926275062174
SIM,1808,86,na,1894,160
STAT,1854,48,30-34,1902,0.14652860349528873
STAT,1857,22,15-19,1879,5.995381854532906
SIM,1841,24,25-29,1865,127
SIM,1844,13,na,1857,4270
STAT,1852,37,40-44,1889,7.014765839759745
SIM,1917,36,20-24,1953,2
SIM,1874,38,40-44,1912,9
SIM,1824,37,50-100,1861,4
SIM,1827,59,na,1886,2492
SIM,1848,80,na,1928,803
STAT,1792,106,na,1898,0.004549395295835411
STAT,1847,19,30-34,1866,2.9967661740244904
SIM,1890,35,30-34,1925,20
SIM,1865,22,15-19,1887,2
STAT,1811,49,50-100,1860,1.6110139359464815
STAT,1844,78,na,1922,1261.7851442216324
STAT,1857,11,na,1868,4437.068051283713
SIM,1887,36,25-29,1923,10
SIM,1800,82,na,1882,270
STAT,1898,21,50-100,1919,1.1178918181745479
STAT,1820,74,na,1894,1242.4165085078287
STAT,1876,49,20-24,1925,0.024542952150840985
STAT,1947,19,35-39,1966,9.539318879174067
SIM,1852,47,50-100,1899,1
STAT,1869,30,na,1899,4707.4034898285245
SIM,1823,44,30-34,1867,2
STAT,1855,25,15-19,1880,0.7950195554676034
STAT,1907,27,50-100,1934,1.898838820595556
SIM,1825,58,na,1883,2222
SIM,1884,41,25-29,1925,2
STAT,1863,0,na,1863,6788.287759056677
STAT,1915,44,35-39,1959,0.40810941656802335
SIM,1807,47,40-44,1854,1
SIM,1806,73,na,1879,978
STAT,1874,25,50-100,1899,1.3318038738858111
SIM,1855,19,30-34,1874,2
SIM,1924,15,30-34,1939,37
STAT,1913,15,na,1928,8014.381596797616
SIM,1855,56,na,1911,3586
STAT,1851,53,30-34,1904,0.009079380750585333
STAT,1929,26,20-24,1955,46.15501176307883
SIM,1933,19,15-19,1952,109
STAT,1940,29,na,1969,7707.965883497512
SIM,1824,34,35-39,1858,28
SIM,1841,37,30-34,1878,16
STAT,1842,77,na,1919,1286.9194765698487
STAT,1884,43,40-44,1927,4.453260951129503
STAT,1875,38,50-100,1913,2.5402464212338165
SIM,1921,47,35-39,1968,1
SIM,1894,71,na,1965,4035
STAT,1885,22,35-39,1907,11.731043294346216
STAT,1890,41,15-19,1931,0.03419742163776154
SIM,1848,32,25-29,1880,24
SIM,1875,46,45-49,1921,2
STAT,1819,71,na,1890,1396.704240204199
SIM,1907,55,na,1962,6393
STAT,1877,28,15-19,1905,0.9481367727054645
SIM,1962,1,na,1963,10325
SIM,1885,28,15-19,1913,1
STAT,1867,46,45-49,1913,0.447643550330505
STAT,1920,26,45-49,1946,3.8397235343787046
STAT,1967,1,na,1968,9931.780367349224
SIM,1900,17,na,1917,7411
SIM,1886,20,na,1906,5018
SIM,1919,33,20-24,1952,8
SIM,1858,48,40-44,1906,1
STAT,1919,12,na,1931,8841.321490785558
SIM,1903,29,15-19,1932,1
STAT,1920,15,20-24,1935,61.905234357746636
SIM,1867,41,na,1908,4718
STAT,1922,31,20-24,1953,5.587212445710498
SIM,1911,15,20-24,1926,53
STAT,1881,46,50-100,1927,0.4807923546853262
STAT,1891,33,15-19,1924,0.35400374051999206
STAT,1924,20,30-34,1944,68.88380959431929
STAT,1825,89,na,1914,121.55067664490524
SIM,1821,43,50-100,1864,4
STAT,1859,32,35-39,1891,16.279149085765024
STAT,1876,41,25-29,1917,1.3474453780716389
STAT,1794,86,na,1880,148.95812045435162
STAT,1862,97,na,1959,16.57317310962031
STAT,1807,92,na,1899,33.24487170179531
SIM,1890,81,na,1971,2217
SIM,1920,37,na,1957,8488
SIM,1929,26,30-34,1955,138
STAT,1794,108,na,1902,7.174852327261718E-4
SIM,1882,44,25-29,1926,2
SIM,1923,44,35-39,1967,1
STAT,1920,37,25-29,1957,2.176710649642581
STAT,1875,49,50-100,1924,0.5000259545855393
SIM,1913,26,35-39,1939,39
SIM,1925,30,40-44,1955,12
STAT,1944,19,25-29,1963,94.11660276071552
SIM,1856,35,25-29,1891,10
SIM,1867,32,35-39,1899,5
SIM,1914,40,50-100,1954,1
STAT,1908,18,45-49,1926,0.19531659460913264
SIM,1895,30,45-49,1925,8
STAT,1896,25,45-49,1921,2.980628975743339
STAT,1887,30,45-49,1917,3.9705944937230147
STAT,1897,18,15-19,1915,15.979186632793823
STAT,1866,28,na,1894,4431.583384718283
STAT,1916,15,30-34,1931,5.247035919345241
SIM,1849,68,na,1917,2389
SIM,1852,26,na,1878,4110
STAT,1798,76,na,1874,729.2714059052711
STAT,1829,34,45-49,1863,3.168996757045822
STAT,1874,44,25-29,1918,1.3100015327093812
STAT,1946,4,na,1950,8924.200352549646
STAT,1832,53,na,1885,2846.52619891404
STAT,1907,20,30-34,1927,53.188783417846615
STAT,1905,26,35-39,1931,28.279118190641046
SIM,1884,22,25-29,1906,133
STAT,1781,113,na,1894,1.441658535539226E-4
STAT,1864,25,25-29,1889,77.18340542389862
STAT,1895,49,30-34,1944,0.14069535627292032
STAT,1902,9,na,1911,7398.1971264009035
STAT,1903,37,na,1940,6828.217175187665
STAT,1850,38,45-49,1888,3.0728809194047813
SIM,1932,20,30-34,1952,88
STAT,1914,29,25-29,1943,133.07363894075803
STAT,1938,26,30-34,1964,78.44650964022615
SIM,1856,32,na,1888,4050
SIM,1861,62,na,1923,3482
SIM,1930,31,20-24,1961,8
STAT,1918,26,45-49,1944,3.7252934036976195
SIM,1819,46,na,1865,2872
SIM,1888,18,15-19,1906,13
STAT,1915,22,na,1937,7624.324983485284
STAT,1807,100,na,1907,0.8474129613466134
STAT,1903,15,20-24,1918,51.21635637256229
STAT,1927,16,45-49,1943,1.2573135044778732
STAT,1948,24,35-39,1972,21.818322660599243
SIM,1822,39,30-34,1861,12
STAT,1921,10,na,1931,9146.928952850563
STAT,1848,48,30-34,1896,0.15672929298232652
STAT,1824,42,15-19,1866,0.03589250662645354
STAT,1925,18,45-49,1943,1.2152847628443315
SIM,1837,34,45-49,1871,7
SIM,1887,25,45-49,1912,6
STAT,1887,15,50-100,1902,0.11117665078683303
SIM,1836,18,na,1854,3997
SIM,1879,40,45-49,1919,5
STAT,1917,30,40-44,1947,8.341960253658614
STAT,1933,34,30-34,1967,42.82995845405591
SIM,1936,12,na,1948,6868
SIM,1869,82,na,1951,832
SIM,1903,34,50-100,1937,4
STAT,1926,44,40-44,1970,0.620576036028094
SIM,1838,27,15-19,1865,4
SIM,1878,30,45-49,1908,2
STAT,1856,45,30-34,1901,0.15234104517924277
STAT,1933,15,30-34,1948,33.109649643738805
SIM,1935,16,45-49,1951,2
STAT,1770,98,na,1868,0.9421916694329039
STAT,1879,25,45-49,1904,2.361402508417782
SIM,1889,33,25-29,1922,31
SIM,1899,32,50-100,1931,3
STAT,1837,74,na,1911,1546.7739511281818
SIM,1851,8,na,1859,4851
STAT,1906,41,20-24,1947,0.03260253391213816
SIM,1933,18,45-49,1951,2
STAT,1820,68,na,1888,1692.3661133027092
STAT,1894,37,na,1931,6112.339660642164
SIM,1898,28,25-29,1926,117
SIM,1874,29,na,1903,4598
SIM,1906,36,45-49,1942,3
SIM,1843,21,25-29,1864,116
STAT,1874,2,na,1876,6782.092460356237
SIM,1895,37,na,1932,6546
STAT,1899,52,na,1951,5926.557889640109
STAT,1843,42,40-44,1885,3.244131010189284
SIM,1920,15,na,1935,8574
STAT,1814,40,na,1854,2843.4581664895077
SIM,1887,33,20-24,1920,8
SIM,1840,23,na,1863,4265
SIM,1865,35,35-39,1900,21
STAT,1841,48,45-49,1889,0.3395930127332898
SIM,1802,83,na,1885,287
STAT,1833,28,50-100,1861,1.1036618068231305
SIM,1956,5,na,1961,10711
STAT,1862,75,na,1937,1777.058713643627
SIM,1857,97,na,1954,13
SIM,1946,19,25-29,1965,121
SIM,1902,36,45-49,1938,2
STAT,1938,19,25-29,1957,86.29025921659515
STAT,1940,23,na,1963,7511.172392828288
SIM,1902,25,20-24,1927,31
SIM,1804,56,na,1860,2198
STAT,1892,29,50-100,1921,1.6057722705842732
STAT,1869,51,35-39,1920,0.016928016733061213
STAT,1782,83,na,1865,257.2630407712201
SIM,1841,43,25-29,1884,3
SIM,1823,42,50-100,1865,6
SIM,1862,10,na,1872,5139
SIM,1870,45,na,1915,4450
STAT,1855,35,25-29,1890,4.3828734921524495
STAT,1907,44,30-34,1951,0.2337813751526295
STAT,1944,16,45-49,1960,1.0859487180735063
SIM,1846,73,na,1919,1713
SIM,1915,26,45-49,1941,4
SIM,1876,21,20-24,1897,142
STAT,1923,41,20-24,1964,0.04173440113895501
STAT,1886,44,50-100,1930,2.2218929993251506
SIM,1915,20,30-34,1935,70
STAT,1829,95,na,1924,15.735390612272054
STAT,1854,45,20-24,1899,0.018579246765325255
SIM,1872,25,25-29,1897,101
STAT,1856,104,na,1960,0.2636577316385072
STAT,1937,23,20-24,1960,218.65967348185214
STAT,1879,38,na,1917,4952.262187818998
SIM,1832,48,45-49,1880,1
STAT,1883,43,na,1926,4553.002328094061
STAT,1838,24,45-49,1862,1.206910821799582
STAT,1918,29,25-29,1947,140.43356320676637
SIM,1857,27,25-29,1884,81
STAT,1860,53,40-44,1913,0.016988989586457684
STAT,1899,18,25-29,1917,15.639540149964565
STAT,1848,35,25-29,1883,4.967217724774278
SIM,1879,28,15-19,1907,4
STAT,1891,39,45-49,1930,4.926418215041766
SIM,1844,47,na,1891,3151
SIM,1940,31,20-24,1971,7
SIM,1911,37,25-29,1948,2
SIM,1865,15,na,1880,4963
STAT,1878,13,na,1891,5438.84495801152
STAT,1850,32,15-19,1882,0.22841533669935235
STAT,1903,37,25-29,1940,1.7870165696177822
STAT,1868,21,20-24,1889,133.3748068020665
SIM,1833,21,25-29,1854,102
SIM,1869,40,45-49,1909,4
SIM,1824,70,na,1894,1676
SIM,1887,26,15-19,1913,5
STAT,1824,48,45-49,1872,0.5635831019002825
SIM,1926,29,25-29,1955,162
SIM,1787,67,na,1854,1304
SIM,1846,24,45-49,1870,1
SIM,1951,20,40-44,1971,10
STAT,1904,47,25-29,1951,0.09374443353615705
STAT,1881,17,na,1898,4930.188437028372
STAT,1913,24,50-100,1937,1.3338604128491345
STAT,1917,42,35-39,1959,0.42437393566002285
STAT,1876,9,na,1885,5537.761915244216
STAT,1851,18,50-100,1869,0.09179300632878032
SIM,1837,37,na,1874,3444
STAT,1821,53,45-49,1874,0.040052894344542275
STAT,1877,25,35-39,1902,20.372612559414613
STAT,1895,46,20-24,1941,0.01786408200825942
STAT,1924,45,45-49,1969,0.5248831681133006
STAT,1933,35,na,1968,10368.318936865746
STAT,1871,40,35-39,1911,3.6700876152324806
STAT,1941,31,30-34,1972,33.428651102345846
STAT,1858,92,na,1950,65.57360031204858
STAT,1834,52,40-44,1886,0.014369041070295034
SIM,1926,22,40-44,1948,9
STAT,1923,15,30-34,1938,29.030922465732456
SIM,1856,48,30-34,1904,1
STAT,1851,27,40-44,1878,5.437093636218283
STAT,1854,46,na,1900,3458.769575527035
SIM,1919,30,40-44,1949,14
STAT,1910,16,35-39,1926,1.683960287164058
STAT,1926,42,45-49,1968,0.4143020589045157
STAT,1905,39,25-29,1944,1.796849087085162
SIM,1923,42,50-100,1965,2
SIM,1909,29,25-29,1938,132
SIM,1913,39,25-29,1952,2
STAT,1850,56,na,1906,3127.309168936282
STAT,1936,24,na,1960,7047.707445098917
STAT,1932,31,20-24,1963,6.55294486073099
SIM,1833,23,20-24,1856,112
STAT,1869,14,na,1883,5157.650291948036
STAT,1832,99,na,1931,2.469068284143046
STAT,1924,2,na,1926,9833.527923247826
SIM,1930,36,20-24,1966,1
SIM,1906,30,30-34,1936,40
STAT,1900,33,35-39,1933,28.25250559703478
SIM,1870,61,na,1931,3555
STAT,1909,39,25-29,1948,1.8642774250951784
STAT,1874,60,na,1934,3943.8850939125346
STAT,1912,29,15-19,1941,1.3953570766892522
STAT,1837,42,50-100,1879,1.737899327157789
SIM,1902,24,na,1926,7322
STAT,1835,40,25-29,1875,1.0228640300410001
STAT,1874,25,25-29,1899,88.06919885927121
SIM,1911,26,45-49,1937,3
SIM,1834,42,40-44,1876,9
STAT,1918,22,40-44,1940,7.3226672758401445
STAT,1947,16,30-34,1963,27.735791270248075
STAT,1922,36,20-24,1958,0.6061799578369992
SIM,1920,29,15-19,1949,2
SIM,1908,6,na,1914,7896
SIM,1846,21,35-39,1867,11
STAT,1893,33,40-44,1926,11.054617191939537
SIM,1955,16,30-34,1971,35
STAT,1857,32,25-29,1889,16.22342150825242
STAT,1862,41,na,1903,4007.7172305624044
STAT,1832,44,30-34,1876,1.7868988769632703
STAT,1911,36,45-49,1947,1.336610891091646
SIM,1889,49,40-44,1938,1
STAT,1828,50,35-39,1878,0.015582135269171902
STAT,1801,79,na,1880,614.7227726538242
STAT,1895,41,35-39,1936,0.3324159852898979
STAT,1879,33,20-24,1912,5.686052900896823
STAT,1893,49,20-24,1942,0.016966021989029505
SIM,1840,44,30-34,1884,5
SIM,1902,47,25-29,1949,1
STAT,1857,29,na,1886,3814.2535278327537
SIM,1917,22,30-34,1939,86
SIM,1865,32,25-29,1897,27
STAT,1909,22,30-34,1931,53.97808484866842
SIM,1843,40,25-29,1883,3
STAT,1925,25,50-100,1950,2.3899311880346064
STAT,1903,26,45-49,1929,3.2037025655254485
STAT,1813,64,na,1877,1865.197336454598
STAT,1893,21,na,1914,6072.514282045227
STAT,1920,23,40-44,1943,7.524276144374904
STAT,1913,44,30-34,1957,0.2510174535322213
SIM,1844,24,35-39,1868,13
SIM,1831,24,na,1855,3898
SIM,1892,46,45-49,1938,1
STAT,1838,21,35-39,1859,10.320651625585713
STAT,1884,46,45-49,1930,0.4719840878247152
SIM,1891,47,na,1938,5785
SIM,1871,30,35-39,1901,26
SIM,1929,19,25-29,1948,135
STAT,1915,41,30-34,1956,0.26034461554656796
STAT,1828,91,na,1919,71.16314424947124
SIM,1806,57,na,1863,2300
STAT,1877,65,na,1942,3544.1187517834205
SIM,1839,31,45-49,1870,6
STAT,1875,64,na,1939,3614.6583039904176
STAT,1918,48,25-29,1966,0.1136680827461158
STAT,1900,20,20-24,1920,194.21887982233403
SIM,1891,24,50-100,1915,3
STAT,1838,32,20-24,1870,4.545857607211072
SIM,1889,35,20-24,1924,2
STAT,1896,20,45-49,1916,1.8704519698545075
STAT,1836,43,na,1879,3283.0645253718735
SIM,1886,14,na,1900,5443
STAT,1865,43,15-19,1908,0.025155391382032054
STAT,1873,54,20-24,1927,0.001472611062297992
SIM,1875,43,40-44,1918,9
SIM,1778,84,na,1862,190
STAT,1873,19,40-44,1892,0.3733145369125796
SIM,1849,22,na,1871,4263
STAT,1880,69,na,1949,3122.305705538659
STAT,1867,43,40-44,1910,4.2236032826855485
SIM,1846,32,20-24,1878,7
SIM,1868,57,na,1925,3921
SIM,1910,3,na,1913,8454
STAT,1930,21,na,1951,9476.599600445474
STAT,1924,30,50-100,1954,1.9563955618287356
STAT,1806,54,30-34,1860,0.03336898280275603
STAT,1857,35,35-39,1892,11.23991386025715
SIM,1820,80,na,1900,594
STAT,1893,47,50-100,1940,0.35298920737046646
STAT,1873,45,30-34,1918,0.2006193787029241
STAT,1880,22,50-100,1902,0.8676038696187185
STAT,1933,37,35-39,1970,6.654345934574373
SIM,1928,23,45-49,1951,8
STAT,1809,50,25-29,1859,0.0271825207944736
STAT,1937,20,40-44,1957,6.618684196577687
STAT,1836,24,35-39,1860,10.09542938789766
STAT,1859,49,20-24,1908,0.018887113161770375
STAT,1895,68,na,1963,4433.488421712947
STAT,1913,34,15-19,1947,0.2560669999511308
STAT,1945,20,na,1965,8088.106559708626
STAT,1866,19,40-44,1885,0.345731628816179
STAT,1835,67,na,1902,2053.081963478895
STAT,1854,40,35-39,1894,2.803964873707236
STAT,1898,33,25-29,1931,27.8758018187823
SIM,1893,22,35-39,1915,16
SIM,1948,19,35-39,1967,13
STAT,1901,23,30-34,1924,50.206278823443945
STAT,1888,15,50-100,1903,0.11749015710810562
STAT,1838,105,na,1943,0.03968163167511961
STAT,1924,39,na,1963,8938.143693109008
STAT,1895,46,50-100,1941,0.36561819729326167
STAT,1906,18,35-39,1924,1.610589563913406
SIM,1914,18,35-39,1932,1
SIM,1945,20,40-44,1965,6
SIM,1931,15,30-34,1946,38
SIM,1940,8,na,1948,8356
STAT,1931,29,25-29,1960,171.45723770649693
SIM,1850,25,na,1875,4091
STAT,1865,46,40-44,1911,0.31501152776561653
SIM,1937,26,20-24,1963,37
STAT,1945,8,na,1953,8698.73055029226
STAT,1863,46,15-19,1909,7.091674303131651E-4
SIM,1924,27,na,1951,9103
STAT,1813,44,20-24,1857,1.0426596173023095
STAT,1903,53,na,1956,6130.938258930981
SIM,1769,88,na,1857,75
STAT,1824,58,na,1882,2280.2212365066857
STAT,1908,15,40-44,1923,0.5508707942675514
STAT,1864,22,20-24,1886,126.40896904316755
SIM,1908,33,45-49,1941,2
STAT,1889,50,na,1939,5439.090580765914
SIM,1944,18,20-24,1962,295
SIM,1891,25,35-39,1916,30
STAT,1878,21,45-49,1899,1.47530152573398
STAT,1879,22,40-44,1901,4.401998479203893
STAT,1878,30,35-39,1908,21.532730203437026
STAT,1911,37,15-19,1948,0.03747066713007443
SIM,1826,31,35-39,1857,27
STAT,1870,92,na,1962,183.2897560322418
SIM,1861,49,50-100,1910,2
STAT,1927,41,na,1968,9419.13419530009
SIM,1929,29,35-39,1958,50
STAT,1867,48,40-44,1915,0.31974318341894786
STAT,1900,48,na,1948,6225.166245921485
STAT,1924,18,50-100,1942,0.8984527304483968
STAT,1865,86,na,1951,407.1009154099778
STAT,1930,15,50-100,1945,0.9827800215102449
SIM,1887,22,40-44,1909,8
STAT,1906,44,25-29,1950,0.12946242306657635
SIM,1829,39,40-44,1868,11
SIM,1933,27,35-39,1960,49
STAT,1772,100,na,1872,0.34146124146828694
STAT,1857,44,25-29,1901,0.997236628958876
STAT,1853,49,50-100,1902,0.3804752419830245
STAT,1889,40,20-24,1929,0.39947197984178273
SIM,1905,25,30-34,1930,89
STAT,1907,27,na,1934,7084.06580155164
STAT,1942,15,40-44,1957,2.953722370351911
SIM,1845,78,na,1923,1114
SIM,1774,94,na,1868,3
SIM,1831,24,25-29,1855,118
STAT,1875,53,40-44,1928,0.0215392061437528
STAT,1850,35,40-44,1885,6.961255977581383
SIM,1939,23,20-24,1962,6
STAT,1862,54,45-49,1916,0.02436245159053806
STAT,1936,18,20-24,1954,261.51089806304225
SIM,1848,34,20-24,1882,5
SIM,1886,30,35-39,1916,21
STAT,1883,25,35-39,1908,19.27600530428572
STAT,1886,85,na,1971,1281.2712674140355
SIM,1859,46,na,1905,3997
SIM,1915,23,35-39,1938,23
STAT,1866,38,40-44,1904,8.116927077161776
SIM,1870,17,15-19,1887,12
SIM,1950,15,40-44,1965,1
STAT,1877,71,na,1948,2799.288058346164
STAT,1822,45,15-19,1867,0.00127983030114873
SIM,1922,26,20-24,1948,48
SIM,1864,11,na,1875,5242
SIM,1882,86,na,1968,845
SIM,1850,42,50-100,1892,5
STAT,1914,26,20-24,1940,37.29853566975478
STAT,1885,39,20-24,1924,1.5340381913111447
STAT,1890,15,25-29,1905,14.034272984345476
SIM,1893,39,20-24,1932,2
STAT,1807,47,30-34,1854,0.6664726548213028
STAT,1907,23,35-39,1930,17.26829507869842
SIM,1874,28,30-34,1902,56
STAT,1862,17,15-19,1879,11.732722210842368
SIM,1858,32,25-29,1890,18
STAT,1841,73,na,1914,1723.3458163168762
STAT,1843,50,25-29,1893,0.005033016335832325
STAT,1898,22,45-49,1920,1.9058410354831514
STAT,1818,48,20-24,1866,0.0520915023161926
SIM,1857,63,na,1920,3222
SIM,1907,33,na,1940,7157
STAT,1874,38,30-34,1912,10.966448116412566
SIM,1834,47,40-44,1881,1
STAT,1857,21,45-49,1878,1.2764210393880135
STAT,1810,52,30-34,1862,0.03679496015619722
STAT,1882,18,na,1900,4955.850668945023
STAT,1804,81,na,1885,429.92887033794943
SIM,1891,15,25-29,1906,20
STAT,1891,36,40-44,1927,10.980516315420173
SIM,1926,37,45-49,1963,2
STAT,1898,36,35-39,1934,19.42395564254428
STAT,1844,38,20-24,1882,1.301880364299918
STAT,1876,22,25-29,1898,119.57805299089829
STAT,1893,38,40-44,1931,11.1502922310942
STAT,1900,26,na,1926,6709.0871000582165
STAT,1904,31,45-49,1935,5.075544108225208
SIM,1882,64,na,1946,3503
SIM,1907,37,35-39,1944,1
STAT,1868,46,50-100,1914,0.4732667688806508
SIM,1832,45,40-44,1877,2
SIM,1882,38,30-34,1920,16
SIM,1918,28,20-24,1946,44
STAT,1935,26,20-24,1961,50.28515729117467
SIM,1846,21,40-44,1867,4
STAT,1769,107,na,1876,0.0105204704321532
STAT,1842,21,na,1863,4044.0846865784024
SIM,1857,101,na,1958,2
SIM,1815,47,30-34,1862,1
STAT,1915,56,na,1971,7198.49131195751
STAT,1810,50,na,1860,2554.254593030317
STAT,1881,15,15-19,1896,11.638549771796052
STAT,1939,9,na,1948,8031.134452412499
STAT,1955,16,20-24,1971,363.5397593447203
SIM,1819,40,na,1859,3115
STAT,1933,18,35-39,1951,11.315964331668956
SIM,1906,45,35-39,1951,1
SIM,1889,30,20-24,1919,8
STAT,1807,86,na,1893,177.10321911139437
SIM,1941,18,35-39,1959,8
SIM,1837,43,na,1880,3272
SIM,1848,33,50-100,1881,1
STAT,1824,45,40-44,1869,0.4264457072870504
STAT,1855,40,50-100,1895,1.6091346723286584
STAT,1861,30,25-29,1891,17.35630381320326
STAT,1845,26,na,1871,4086.7593030018093
SIM,1850,24,35-39,1874,11
STAT,1826,84,na,1910,398.23278710675993
SIM,1904,22,20-24,1926,180
SIM,1943,26,20-24,1969,44
STAT,1826,47,40-44,1873,0.34138656186248106
SIM,1916,15,40-44,1931,2
STAT,1774,88,na,1862,64.04062578926491
STAT,1918,33,50-100,1951,1.7666092869456962
STAT,1918,37,45-49,1955,1.4509409446771053
SIM,1859,35,35-39,1894,18
STAT,1900,34,50-100,1934,2.544998582477064
SIM,1855,29,40-44,1884,8
STAT,1879,22,35-39,1901,12.327318091486429
SIM,1924,25,40-44,1949,20
SIM,1865,92,na,1957,73
SIM,1865,21,45-49,1886,1
SIM,1872,22,20-24,1894,146
STAT,1838,21,40-44,1859,3.685432015549079
SIM,1887,22,35-39,1909,20
STAT,1898,23,15-19,1921,8.98866104586031
STAT,1926,23,45-49,1949,2.751721355828331
STAT,1907,47,35-39,1954,0.23332364041553755
SIM,1841,47,40-44,1888,2
SIM,1833,37,40-44,1870,16
STAT,1948,21,30-34,1969,66.66579631017602
STAT,1870,70,na,1940,2782.0537682300965
SIM,1824,92,na,1916,68
STAT,1843,45,45-49,1888,0.33759212800643035
SIM,1835,20,20-24,1855,127
STAT,1833,47,40-44,1880,0.26408206908682175
STAT,1848,39,40-44,1887,7.244857454628916
STAT,1892,28,40-44,1920,7.547012599087249
STAT,1890,47,na,1937,5521.378008621947
STAT,1916,25,40-44,1941,9.799237372917414
SIM,1921,34,20-24,1955,7
SIM,1848,29,40-44,1877,8
STAT,1911,31,45-49,1942,3.108197494662081
STAT,1880,35,20-24,1915,1.6556129238234254
SIM,1912,31,45-49,1943,6
STAT,1920,34,20-24,1954,5.348425143405364
STAT,1847,29,40-44,1876,5.409884802939237
STAT,1882,12,na,1894,5080.81986780456
SIM,1885,69,na,1954,2985
SIM,1915,47,35-39,1962,1
STAT,1912,41,45-49,1953,0.32613754290338776
STAT,1825,37,40-44,1862,11.514127736548629
SIM,1897,63,na,1960,5100
SIM,1934,23,45-49,1957,4
SIM,1791,66,na,1857,1387
STAT,1863,100,na,1963,6.275369909779763
STAT,1907,45,45-49,1952,0.3990988141229064
SIM,1847,104,na,1951,1
STAT,1854,49,50-100,1903,0.3686406075165895
STAT,1865,32,15-19,1897,0.2612912003670442
SIM,1878,19,na,1897,5483
STAT,1877,32,50-100,1909,1.921511878087398
SIM,1817,53,35-39,1870,1
STAT,1855,9,na,1864,4369.634335056023
STAT,1892,17,25-29,1909,14.327166292593217
SIM,1897,32,45-49,1929,10
SIM,1878,81,na,1959,1254
SIM,1869,0,na,1869,6933
SIM,1943,22,40-44,1965,7
STAT,1899,15,20-24,1914,49.28523209478113
STAT,1837,48,30-34,1885,0.13830062541300364
SIM,1946,22,15-19,1968,10
STAT,1829,31,35-39,1860,19.979784196857814
STAT,1859,52,na,1911,3442.7680668280946
STAT,1876,44,35-39,1920,3.7314788543006014
STAT,1913,34,20-24,1947,4.860441326282408
SIM,1930,39,25-29,1969,4
SIM,1810,59,na,1869,2228
SIM,1891,22,25-29,1913,157
STAT,1926,22,30-34,1948,70.50744717367391
SIM,1833,26,25-29,1859,86
SIM,1871,46,na,1917,4386
STAT,1837,19,50-100,1856,0.0968042521898886
SIM,1884,44,35-39,1928,8
STAT,1922,39,25-29,1961,2.2572663206489745
STAT,1928,19,30-34,1947,30.84681929341731
SIM,1924,28,45-49,1952,3
STAT,1785,75,na,1860,854.677252158359
SIM,1956,13,na,1969,10692
STAT,1864,29,40-44,1893,5.369268527022019
SIM,1934,22,30-34,1956,1
STAT,1923,18,35-39,1941,9.921967966211891
SIM,1930,34,30-34,1964,52
SIM,1952,15,50-100,1967,1
STAT,1901,18,15-19,1919,16.73520345817765
SIM,1852,20,20-24,1872,141
STAT,1879,91,na,1970,428.15674068167027
STAT,1922,34,30-34,1956,35.76663231769319
STAT,1896,22,35-39,1918,15.559889246204223
SIM,1894,4,na,1898,7097
STAT,1880,88,na,1968,742.3090827956734
STAT,1821,50,40-44,1871,0.03084362408294016
SIM,1833,21,30-34,1854,42
SIM,1896,28,15-19,1924,2
SIM,1921,22,20-24,1943,242
STAT,1853,61,na,1914,2956.5579236655394
STAT,1859,21,35-39,1880,10.77246367116808
STAT,1881,26,15-19,1907,0.8887035991201276
SIM,1829,32,20-24,1861,6
STAT,1916,28,45-49,1944,3.5949047727017143
SIM,1909,38,20-24,1947,1
SIM,1867,21,35-39,1888,14
STAT,1883,22,25-29,1905,113.59094292307485
SIM,1909,5,na,1914,7979
SIM,1927,33,50-100,1960,4
SIM,1909,26,20-24,1935,35
STAT,1922,47,50-100,1969,0.5246310368498978
SIM,1822,69,na,1891,1555
SIM,1910,22,45-49,1932,5
STAT,1789,65,na,1854,1625.9999999999998
STAT,1809,53,35-39,1862,0.06219459050371611
SIM,1893,73,na,1966,3638
SIM,1824,43,25-29,1867,2
STAT,1860,49,na,1909,3612.8824096490366
SIM,1830,61,na,1891,2226
SIM,1931,18,35-39,1949,13
SIM,1932,35,35-39,1967,10
STAT,1848,15,na,1863,4721.3068331039585
STAT,1857,25,25-29,1882,69.58518317553336
SIM,1809,87,na,1896,161
SIM,1875,32,25-29,1907,25
STAT,1888,28,15-19,1916,1.0792052895278794
STAT,1913,44,25-29,1957,0.1402079475916576
SIM,1822,44,na,1866,2971
STAT,1822,94,na,1916,22.56594731701826
SIM,1948,18,na,1966,8754
STAT,1883,34,25-29,1917,20.150119984505423
SIM,1902,28,25-29,1930,122
STAT,1805,49,30-34,1854,0.7716189258205727
STAT,1870,27,15-19,1897,0.8996137596149784
SIM,1882,36,40-44,1918,15
STAT,1861,2,na,1863,5786.391919700432
STAT,1833,51,50-100,1884,0.02090666397757516
STAT,1842,12,na,1854,4564.0
SIM,1824,31,25-29,1855,7
STAT,1848,49,45-49,1897,0.37889125203149115
SIM,1874,25,35-39,1899,30
SIM,1889,59,na,1948,4870
STAT,1844,20,20-24,1864,140.9670317922609
SIM,1820,39,20-24,1859,1
SIM,1882,22,15-19,1904,8
SIM,1916,27,50-100,1943,1
SIM,1911,38,na,1949,7454
STAT,1892,73,na,1965,3596.893044798167
SIM,1891,34,25-29,1925,35
STAT,1863,103,na,1966,1.4803902943371905
STAT,1912,11,na,1923,8079.596102245023
SIM,1817,41,35-39,1858,5
STAT,1866,25,35-39,1891,18.102568659902047
STAT,1816,43,25-29,1859,3.401102343515699
SIM,1884,32,35-39,1916,28
STAT,1902,22,45-49,1924,1.9883051926427595
STAT,1904,44,15-19,1948,0.0027423191690780753
SIM,1936,19,30-34,1955,23
SIM,1919,33,45-49,1952,5
STAT,1874,36,40-44,1910,9.095872129728834
SIM,1840,18,40-44,1858,1
STAT,1942,29,50-100,1971,2.107797490796558
SIM,1948,16,30-34,1964,43
STAT,1873,15,25-29,1888,11.766647700886248
STAT,1884,3,na,1887,5900.058384030811
STAT,1912,17,20-24,1929,55.382552269098404
STAT,1924,35,35-39,1959,5.768637000598819
STAT,1903,27,15-19,1930,1.3046499610731106
STAT,1855,21,35-39,1876,10.354368406208783
STAT,1937,23,45-49,1960,2.212604692793686
SIM,1863,29,30-34,1892,48
SIM,1867,38,40-44,1905,14
STAT,1918,45,20-24,1963,0.02385863419970344
SIM,1929,16,20-24,1945,362
STAT,1889,20,45-49,1909,1.7468539963180743
SIM,1889,38,25-29,1927,11
SIM,1796,87,na,1883,138
SIM,1841,21,15-19,1862,5
SIM,1855,37,na,1892,4096
STAT,1876,32,35-39,1908,21.1540203972012
STAT,1922,27,25-29,1949,150.3797402854823
STAT,1848,42,25-29,1890,1.0516531860102634
SIM,1817,45,50-100,1862,1
SIM,1932,23,35-39,1955,30
STAT,1955,13,na,1968,10528.419361874281
SIM,1857,5,na,1862,5259
SIM,1942,15,na,1957,7862
SIM,1905,16,35-39,1921,2
STAT,1857,50,50-100,1907,0.024116354414106964
STAT,1909,32,40-44,1941,7.546092560228049
SIM,1917,32,40-44,1949,4
SIM,1897,54,na,1951,5695
SIM,1963,3,na,1966,10477
STAT,1919,46,50-100,1965,0.4965866130016371
SIM,1897,20,45-49,1917,2
SIM,1930,27,25-29,1957,177
SIM,1815,45,40-44,1860,2
STAT,1836,27,na,1863,3721.6460324050413
STAT,1930,34,15-19,1964,0.33449805331273685
STAT,1833,21,15-19,1854,7.21722460088791
STAT,1912,33,na,1945,7486.334966225764
STAT,1855,29,30-34,1884,39.01382657579061
STAT,1892,70,na,1962,3935.773433807255
SIM,1929,36,na,1965,9988
SIM,1920,17,20-24,1937,313
STAT,1822,39,20-24,1861,2.804627086261223
STAT,1885,31,50-100,1916,1.8494522061704108
STAT,1942,18,45-49,1960,1.0540041772577786
SIM,1915,45,45-49,1960,2
STAT,1888,23,20-24,1911,163.9903103484194
SIM,1863,21,35-39,1884,10
STAT,1823,54,30-34,1877,0.01701338855538997
STAT,1883,15,25-29,1898,11.29658121084723
SIM,1856,42,25-29,1898,1
SIM,1855,27,15-19,1882,1
SIM,1885,23,45-49,1908,7
SIM,1891,60,na,1951,5088
STAT,1823,57,na,1880,2620.7621336428942
STAT,1909,44,40-44,1953,0.46693997874675447
SIM,1950,10,na,1960,9180
SIM,1939,20,25-29,1959,233
STAT,1877,23,45-49,1900,1.4578748604231728
STAT,1830,36,na,1866,3758.9267920984116
STAT,1835,43,35-39,1878,2.7756089207684207
STAT,1889,32,45-49,1921,4.342523313392373
SIM,1870,51,40-44,1921,1
STAT,1862,51,40-44,1913,0.018259791759705574
STAT,1882,43,15-19,1925,0.02697314708581536
SIM,1830,39,20-24,1869,2
SIM,1896,23,20-24,1919,209
STAT,1859,77,na,1936,1389.5010268796248
STAT,1903,39,15-19,1942,0.0345023827281462
STAT,1815,52,15-19,1867,1.2662491452503587E-4
STAT,1955,17,35-39,1972,11.248632589486999
SIM,1858,42,na,1900,3960
STAT,1884,44,na,1928,4547.021158794724
SIM,1843,43,35-39,1886,5
STAT,1942,24,30-34,1966,60.820944287452704
SIM,1883,38,50-100,1921,5
SIM,1843,31,35-39,1874,30
STAT,1868,38,15-19,1906,0.10736727614478718
SIM,1869,41,50-100,1910,3
STAT,1898,26,25-29,1924,116.01024946057838
STAT,1929,24,30-34,1953,72.9376745266182
STAT,1930,30,na,1960,9868.563764193776
STAT,1898,45,25-29,1943,0.08968660158414564
SIM,1841,38,45-49,1879,3
STAT,1847,27,15-19,1874,0.8312652103554361
STAT,1893,22,25-29,1915,146.54178466332772
SIM,1866,93,na,1959,69
STAT,1861,27,40-44,1888,5.072152543956185
STAT,1919,43,20-24,1962,0.03858275329334293
STAT,1904,38,na,1942,6849.112354799454
SIM,1924,22,30-34,1946,89
STAT,1929,29,25-29,1958,166.18680741552177
SIM,1929,33,na,1962,9887
STAT,1773,87,na,1860,100.30566429440036
SIM,1845,94,na,1939,20
STAT,1901,17,45-49,1918,0.18469082525894395
STAT,1847,25,25-29,1872,78.62892084976872
STAT,1847,25,50-100,1872,1.1890456907018734
STAT,1948,23,20-24,1971,257.7476810938252
STAT,1936,3,na,1939,7844.279820794809
STAT,1791,97,na,1888,1.9942774630513749
STAT,1833,38,45-49,1871,3.248655098819374
SIM,1848,32,30-34,1880,48
SIM,1918,16,45-49,1934,1
SIM,1924,29,15-19,1953,1
SIM,1777,83,na,1860,216
SIM,1855,31,na,1886,4275
STAT,1846,46,15-19,1892,6.144226574354818E-4
STAT,1841,42,15-19,1883,0.020821048672624694
SIM,1860,40,25-29,1900,2
STAT,1900,23,na,1923,6605.503889922292
SIM,1796,101,na,1897,1
SIM,1846,54,na,1900,3259
SIM,1889,26,25-29,1915,115
SIM,1937,29,25-29,1966,135
STAT,1920,18,25-29,1938,97.91301390377018
STAT,1838,25,15-19,1863,0.7924307447462577
STAT,1916,34,30-34,1950,32.5697427918679
SIM,1848,37,25-29,1885,6
SIM,1903,29,20-24,1932,41
STAT,1857,38,30-34,1895,8.348191569398587
STAT,1883,19,40-44,1902,0.36098335119229374
STAT,1889,43,25-29,1932,1.5875688522553646
STAT,1811,54,na,1865,2493.2928982978974
STAT,1835,31,35-39,1866,16.88041079447236
STAT,1851,16,25-29,1867,10.743579861675684
STAT,1945,5,na,1950,8769.31058228038
STAT,1910,19,45-49,1929,0.19890781742688785
STAT,1859,31,20-24,1890,4.362894678213052
STAT,1878,49,30-34,1927,0.19991717708783568
SIM,1881,15,25-29,1896,15
SIM,1933,24,30-34,1957,108
STAT,1916,22,30-34,1938,60.824306898617344
STAT,1872,37,na,1909,4782.022298996492
SIM,1903,17,20-24,1920,45
STAT,1852,31,35-39,1883,16.886119822429755
SIM,1898,46,50-100,1944,2
STAT,1861,96,na,1957,19.292694934839602
SIM,1839,23,25-29,1862,102
STAT,1836,104,na,1940,0.0886832519221134
STAT,1842,21,25-29,1863,108.27514785930326
SIM,1867,31,20-24,1898,8
STAT,1838,102,na,1940,0.39677338639148224
STAT,1891,16,50-100,1907,0.12260282573264598
STAT,1924,36,na,1960,8965.370910700407
SIM,1904,44,30-34,1948,1
STAT,1832,40,15-19,1872,0.022601466727410084
SIM,1908,34,na,1942,7166
SIM,1877,34,na,1911,4860
SIM,1907,21,25-29,1928,181
SIM,1878,20,40-44,1898,2
SIM,1849,16,35-39,1865,1
SIM,1905,28,35-39,1933,4
STAT,1888,16,15-19,1904,14.200951533893331
SIM,1860,31,35-39,1891,27
SIM,1841,20,45-49,1861,1
STAT,1893,36,na,1929,6060.041841494809
STAT,1800,91,na,1891,49.49447010467353
SIM,1891,19,40-44,1910,1
SIM,1839,35,25-29,1874,7
SIM,1917,39,25-29,1956,4
STAT,1842,33,25-29,1875,18.231281748758175
SIM,1830,37,30-34,1867,13
STAT,1893,58,na,1951,5062.4083840888925
SIM,1899,43,35-39,1942,2
STAT,1884,22,na,1906,4716.546598190281
SIM,1865,25,25-29,1890,79
STAT,1936,31,50-100,1967,1.623173701943311
SIM,1900,34,45-49,1934,7
SIM,1896,16,15-19,1912,14
STAT,1797,60,na,1857,1915.7286622693375
STAT,1872,59,na,1931,3944.727911289367
STAT,1916,16,45-49,1932,0.21457361953239676
STAT,1898,39,30-34,1937,3.1123442579723193
STAT,1952,15,35-39,1967,10.160258943591876
SIM,1848,25,25-29,1873,16
SIM,1834,54,na,1888,2734
SIM,1879,44,na,1923,4656
SIM,1892,23,na,1915,6754
STAT,1888,15,45-49,1903,0.1566535428108075
SIM,1850,21,25-29,1871,120
STAT,1904,16,na,1920,7339.05547861675
SIM,1924,16,45-49,1940,2
STAT,1836,22,45-49,1858,1.2238840411229173
SIM,1900,60,na,1960,5759
STAT,1807,48,45-49,1855,1.5929840583006596
STAT,1817,54,na,1871,2602.8197896183533
SIM,1907,34,30-34,1941,39
STAT,1930,41,20-24,1971,0.04699617372843125
SIM,1850,9,na,1859,4728
STAT,1827,43,50-100,1870,1.9707426922027311
SIM,1809,62,na,1871,1902
SIM,1829,25,15-19,1854,1
STAT,1949,10,na,1959,9228.627179482859
SIM,1869,30,35-39,1899,31
SIM,1924,34,30-34,1958,48
STAT,1861,33,35-39,1894,16.95184303119635
STAT,1901,24,45-49,1925,1.959242928242421
SIM,1840,16,15-19,1856,13
SIM,1889,33,30-34,1922,55
STAT,1874,39,45-49,1913,4.0808709585594904
SIM,1844,22,45-49,1866,7
SIM,1855,25,25-29,1880,96
STAT,1891,29,50-100,1920,1.585503163305576
STAT,1897,11,na,1908,6982.253461937195
STAT,1943,28,na,1971,8053.530600732839
SIM,1937,24,30-34,1961,78
STAT,1861,21,35-39,1882,10.150552868766496
STAT,1822,37,30-34,1859,21.34731540442906
STAT,1802,77,na,1879,760.8561120202498
STAT,1847,67,na,1914,2416.413859605975
STAT,1898,73,na,1971,4115.080274075069
STAT,1937,2,na,1939,8037.164320613622
SIM,1879,19,25-29,1898,12
STAT,1859,71,na,1930,2145.677551274754
STAT,1860,31,na,1891,3929.7418412898046
SIM,1921,24,50-100,1945,5
SIM,1850,33,25-29,1883,22
STAT,1826,31,25-29,1857,33.03167565053286
STAT,1935,34,40-44,1969,10.922272261632017
SIM,1859,20,30-34,1879,45
SIM,1882,21,45-49,1903,2
SIM,1895,6,na,1901,7315
STAT,1877,74,na,1951,2327.4022118331823
STAT,1831,39,30-34,1870,8.532169104030084
SIM,1919,18,50-100,1937,1
SIM,1834,69,na,1903,1841
SIM,1810,44,45-49,1854,6
SIM,1841,28,50-100,1869,3
STAT,1873,81,na,1954,1109.67911335785
STAT,1841,76,na,1917,1374.6162664994479
SIM,1868,22,30-34,1890,44
STAT,1935,22,40-44,1957,9.24893338909111
SIM,1860,83,na,1943,686
SIM,1910,53,na,1963,6995
SIM,1935,14,na,1949,11210
SIM,1834,31,25-29,1865,19
STAT,1852,44,40-44,1896,3.5365291763419395
SIM,1821,81,na,1902,609
SIM,1908,32,30-34,1940,33
STAT,1833,31,25-29,1864,17.55612515391241
STAT,1907,26,45-49,1933,3.307092272890018
STAT,1937,25,na,1962,7382.975950135793
STAT,1851,57,na,1908,3115.2950525585034
STAT,1902,41,45-49,1943,0.2976806022506286
SIM,1870,24,50-100,1894,1
STAT,1914,1,na,1915,8697.41016191973
SIM,1879,66,na,1945,3307
STAT,1890,19,40-44,1909,0.44846655805668756
SIM,1907,28,45-49,1935,10
STAT,1926,20,40-44,1946,8.297682727801137
SIM,1929,22,15-19,1951,15
SIM,1896,26,25-29,1922,125
STAT,1860,34,na,1894,3880.239845768807
STAT,1863,23,na,1886,4233.878150035636
STAT,1879,26,15-19,1905,0.9617253323382792
STAT,1862,24,50-100,1886,0.71029284826899
SIM,1865,48,40-44,1913,1
SIM,1839,39,40-44,1878,15
STAT,1848,32,15-19,1880,0.2723105655172202
STAT,1926,25,35-39,1951,36.589004813597974
SIM,1955,9,na,1964,10121
STAT,1761,99,na,1860,0.0526350236266798
STAT,1779,97,na,1876,1.6151262082806808
STAT,1842,27,30-34,1869,46.36344395504459
SIM,1849,42,25-29,1891,2
STAT,1893,45,40-44,1938,0.24967470880268924
STAT,1922,37,35-39,1959,5.556940817768168
SIM,1879,41,na,1920,4759
STAT,1892,15,35-39,1907,1.3937446700947733
SIM,1919,19,30-34,1938,35
SIM,1939,26,30-34,1965,88
SIM,1913,49,50-100,1962,2
STAT,1808,108,na,1916,0.0014393700979131176
STAT,1873,41,15-19,1914,0.028466770582905924
SIM,1843,37,40-44,1880,18
SIM,1856,19,na,1875,4573
SIM,1857,24,20-24,1881,125
SIM,1828,28,50-100,1856,1
SIM,1926,26,20-24,1952,48
STAT,1809,47,40-44,1856,1.327019096044045
SIM,1891,24,15-19,1915,9
STAT,1853,106,na,1959,0.0443925072111374
STAT,1863,38,30-34,1901,9.375430197542956
STAT,1826,54,40-44,1880,0.019459244559153713
STAT,1866,22,30-34,1888,33.46385129061461
STAT,1888,26,25-29,1914,101.32277047724686
STAT,1911,24,45-49,1935,2.142287743345544
SIM,1904,34,20-24,1938,5
SIM,1905,23,na,1928,7063
SIM,1950,19,15-19,1969,102
STAT,1826,36,50-100,1862,3.0111598462500395
STAT,1928,29,na,1957,9310.365555802462
STAT,1938,16,20-24,1954,270.80612717358593
SIM,1883,17,25-29,1900,11
STAT,1871,45,20-24,1916,0.02431823026499436
SIM,1934,20,40-44,1954,12
STAT,1827,37,15-19,1864,0.11669825800240258
STAT,1935,29,25-29,1964,181.05790533656716
SIM,1899,30,20-24,1929,10
STAT,1943,23,45-49,1966,2.41682452055378
SIM,1921,37,25-29,1958,3
SIM,1882,39,45-49,1921,6
STAT,1889,47,40-44,1936,0.2393632688711558
STAT,1802,55,na,1857,2368.039027734509
STAT,1864,19,30-34,1883,2.941673582221806
STAT,1900,45,35-39,1945,0.22345469364647338
SIM,1936,32,50-100,1968,2
STAT,1913,37,25-29,1950,1.9628949414040515
STAT,1928,33,20-24,1961,6.154915199107663
SIM,1872,19,30-34,1891,4
STAT,1847,52,na,1899,3264.6909499605013
SIM,1831,28,40-44,1859,4
SIM,1880,38,na,1918,5203
STAT,1804,54,20-24,1858,0.004144556276084008
SIM,1930,24,20-24,1954,282
STAT,1905,49,50-100,1954,0.39619299527033613
STAT,1942,19,15-19,1961,95.7227841761092
STAT,1835,37,40-44,1872,7.0123941023641265
SIM,1918,7,na,1925,9036
STAT,1934,11,na,1945,10841.621996583404
STAT,1861,38,20-24,1899,1.2893762652878507
SIM,1897,47,40-44,1944,1
SIM,1930,37,35-39,1967,11
STAT,1866,27,25-29,1893,78.8278399642779
SIM,1876,52,na,1928,4693
SIM,1833,24,35-39,1857,15
STAT,1867,51,25-29,1918,0.006731504629267658
STAT,1887,47,15-19,1934,8.993040695658611E-4
SIM,1850,27,30-34,1877,54
STAT,1918,34,40-44,1952,8.325148668773885
STAT,1871,74,na,1945,2226.8074401294225
SIM,1924,18,35-39,1942,11
STAT,1811,51,na,1862,2645.9195183677743
STAT,1848,46,40-44,1894,0.2815148899812545
SIM,1922,16,35-39,1938,9
STAT,1792,79,na,1871,562.8572802960808
SIM,1936,33,20-24,1969,4
SIM,1839,20,20-24,1859,121
STAT,1896,47,na,1943,5972.181482985702
SIM,1926,34,40-44,1960,11
SIM,1846,25,15-19,1871,1
SIM,1946,15,50-100,1961,1
SIM,1880,23,na,1903,5257
STAT,1894,28,15-19,1922,1.1729410866134704
STAT,1874,22,15-19,1896,6.822100651587084
STAT,1879,29,na,1908,5005.443353647082
STAT,1913,41,20-24,1954,0.03499134195112964
SIM,1859,33,45-49,1892,4
STAT,1776,98,na,1874,1.1113457768979549
SIM,1946,16,20-24,1962,298
STAT,1802,104,na,1906,0.05119112954181648
SIM,1941,16,45-49,1957,2
SIM,1852,34,50-100,1886,3
STAT,1916,29,15-19,1945,1.463636812283313
STAT,1933,16,45-49,1949,1.3539944217483277
STAT,1865,89,na,1954,192.75338238150664
SIM,1874,34,25-29,1908,22
STAT,1942,27,35-39,1969,31.824885045356638
SIM,1864,67,na,1931,2979
STAT,1852,21,25-29,1873,109.17108554872041
SIM,1826,43,35-39,1869,4
SIM,1860,21,25-29,1881,126
STAT,1806,50,15-19,1856,1.4940525464812897E-4
STAT,1868,33,50-100,1901,1.7531603207090518
SIM,1850,18,40-44,1868,1
SIM,1846,29,30-34,1875,59
STAT,1922,26,na,1948,8588.213961051344
SIM,1800,66,na,1866,1572
SIM,1893,34,35-39,1927,35
STAT,1842,18,40-44,1860,0.3476205491563416
SIM,1907,15,30-34,1922,6
SIM,1874,22,30-34,1896,42
SIM,1934,25,35-39,1959,46
STAT,1866,34,25-29,1900,18.923471163585585
STAT,1883,28,30-34,1911,49.79188659953925
SIM,1888,30,45-49,1918,6
SIM,1823,91,na,1914,42
STAT,1883,24,15-19,1907,6.505185405588132
SIM,1932,22,na,1954,9763
SIM,1871,38,30-34,1909,14
SIM,1856,16,na,1872,4659
STAT,1902,18,50-100,1920,0.1393268103468049
STAT,1935,24,50-100,1959,1.8087369579404773
STAT,1838,56,na,1894,2760.3735842729875
STAT,1871,71,na,1942,2678.2974784924995
SIM,1868,41,50-100,1909,2
SIM,1899,49,40-44,1948,1
SIM,1877,19,15-19,1896,13
STAT,1838,29,30-34,1867,42.73273269087915
STAT,1885,34,35-39,1919,20.184101608815606
STAT,1882,53,50-100,1935,0.029236023494434722
STAT,1914,16,35-39,1930,1.7576429556694844
SIM,1941,25,35-39,1966,46
STAT,1921,19,20-24,1940,310.3589081600307
STAT,1934,14,na,1948,10790.421820867288
SIM,1790,65,na,1855,1626
STAT,1844,34,50-100,1878,1.7330560624957916
SIM,1889,23,20-24,1912,158
STAT,1805,69,na,1874,1581.812499393657
SIM,1793,76,na,1869,680
STAT,1807,95,na,1902,10.61259753421376
SIM,1829,35,25-29,1864,5
SIM,1908,45,45-49,1953,1
SIM,1900,24,35-39,1924,25
SIM,1827,44,50-100,1871,6
STAT,1857,48,40-44,1905,0.2661162063007839
SIM,1943,24,50-100,1967,2
SIM,1839,60,na,1899,2547
SIM,1842,16,25-29,1858,15
SIM,1852,26,50-100,1878,1
SIM,1908,30,40-44,1938,11
STAT,1869,19,15-19,1888,11.636082322500455
STAT,1842,23,15-19,1865,6.150537899291751
SIM,1893,70,na,1963,4022
STAT,1836,19,50-100,1855,0.1248063190822625
SIM,1902,27,na,1929,6978
SIM,1848,35,35-39,1883,20
STAT,1849,93,na,1942,46.228676616867205
STAT,1835,48,20-24,1883,0.01618093825258664
SIM,1878,32,35-39,1910,29
SIM,1768,91,na,1859,17
SIM,1872,71,na,1943,2760
SIM,1915,22,20-24,1937,231
STAT,1925,15,40-44,1940,3.427588341426095
STAT,1816,47,40-44,1863,0.8411763894702288
STAT,1903,18,25-29,1921,16.252338231524742
SIM,1849,49,50-100,1898,2
STAT,1848,31,45-49,1879,3.3693249205804614
STAT,1847,22,20-24,1869,128.77639596890643
STAT,1929,16,50-100,1945,0.9679334812961381
STAT,1796,106,na,1902,0.0054093218160184454
SIM,1897,33,15-19,1930,1
SIM,1925,33,45-49,1958,3
SIM,1891,28,30-34,1919,73
SIM,1846,79,na,1925,922
SIM,1911,18,25-29,1929,20
STAT,1919,46,25-29,1965,0.11646330906803204
SIM,1911,34,20-24,1945,5
STAT,1822,91,na,1913,65.42791429631004
STAT,1931,26,20-24,1957,47.61876677383743
SIM,1908,35,35-39,1943,6
SIM,1917,47,45-49,1964,1
STAT,1924,23,35-39,1947,22.36384955216825
STAT,1826,50,25-29,1876,0.007088192090002734
SIM,1956,10,na,1966,10696
STAT,1929,27,35-39,1956,37.94466590450134
SIM,1852,42,na,1894,3758
SIM,1853,27,na,1880,4116
SIM,1898,25,20-24,1923,39
SIM,1893,21,20-24,1914,7
STAT,1835,42,na,1877,3262.5464490886634
STAT,1899,4,na,1903,7279.477768494899
SIM,1923,26,na,1949,9421
SIM,1948,22,25-29,1970,233
STAT,1830,44,20-24,1874,0.27680168201942096
SIM,1904,47,35-39,1951,1
STAT,1907,22,20-24,1929,204.5572543564025
SIM,1938,19,40-44,1957,2
SIM,1824,37,30-34,1861,11
STAT,1893,41,25-29,1934,1.6512816984400955
STAT,1828,94,na,1922,24.544015827469313
STAT,1818,43,35-39,1861,8.59804584670308
STAT,1903,34,20-24,1937,4.424938392020538
SIM,1920,12,na,1932,9215
STAT,1890,45,30-34,1935,0.2410061043710181
STAT,1923,47,50-100,1970,0.5342014062501208
STAT,1953,18,20-24,1971,331.0917368064484
SIM,1937,16,50-100,1953,2
STAT,1857,29,40-44,1886,4.787650916516022
SIM,1850,23,15-19,1873,6
STAT,1916,18,35-39,1934,1.793292044741546
STAT,1916,37,35-39,1953,5.002434169573411
STAT,1883,38,40-44,1921,8.643078909593681
STAT,1889,33,15-19,1922,0.3531317367180441
SIM,1869,21,45-49,1890,3
SIM,1933,15,40-44,1948,5
SIM,1881,85,na,1966,743
SIM,1914,12,na,1926,8476
SIM,1917,48,na,1965,7889
STAT,1911,40,50-100,1951,0.22908913875777137
SIM,1872,15,15-19,1887,12
STAT,1917,33,45-49,1950,3.3135667096583514
STAT,1814,65,na,1879,1735.0074422076375
STAT,1829,79,na,1908,827.3974261564691
STAT,1779,94,na,1873,7.039941548489338
STAT,1887,33,na,1920,5367.435352323355
STAT,1838,39,40-44,1877,7.0019288746228945
STAT,1872,36,15-19,1908,0.11452777686736546
STAT,1858,53,40-44,1911,0.01630879608893637
SIM,1826,30,20-24,1856,7
SIM,1831,43,na,1874,3418
STAT,1855,19,na,1874,4068.6069296298924
STAT,1857,45,na,1902,3577.0016016517534
SIM,1944,25,na,1969,8280
STAT,1909,44,na,1953,6933.269342297285
SIM,1848,20,50-100,1868,3
STAT,1909,47,45-49,1956,0.4035580536653398
SIM,1790,87,na,1877,91
SIM,1855,22,20-24,1877,131
STAT,1922,24,20-24,1946,255.84997200184986
STAT,1938,29,35-39,1967,30.015023354777714
STAT,1920,16,50-100,1936,0.8508182227985875
SIM,1952,16,20-24,1968,376
SIM,1824,47,40-44,1871,1
STAT,1926,36,15-19,1962,0.047433578511788387
STAT,1874,21,45-49,1895,1.4463551374577264
SIM,1840,57,na,1897,3100
SIM,1846,39,40-44,1885,15
SIM,1860,86,na,1946,348
STAT,1938,15,50-100,1953,0.7499936986558153
STAT,1944,16,20-24,1960,294.7265413437216
SIM,1935,11,na,1946,11271
STAT,1864,15,15-19,1879,12.32396412279218
STAT,1907,35,35-39,1942,4.574622018283881
STAT,1898,35,15-19,1933,0.15493291779968404
SIM,1865,29,40-44,1894,3
SIM,1924,37,35-39,1961,8
SIM,1865,38,30-34,1903,14
STAT,1790,108,na,1898,7.1650025021486E-4
STAT,1799,101,na,1900,0.3880592897704409
STAT,1872,34,na,1906,4802.123306130091
STAT,1785,72,na,1857,1135.7788098420401
STAT,1895,62,na,1957,4906.103176899461
STAT,1918,26,20-24,1944,39.361411532679185
STAT,1875,48,na,1923,4619.428087536545
STAT,1789,107,na,1896,0.0024135734659496604
SIM,1817,47,40-44,1864,3
STAT,1920,27,15-19,1947,1.5636580041996067
STAT,1873,17,15-19,1890,12.17803124726169
STAT,1860,25,50-100,1885,1.0757825781737547
STAT,1903,23,40-44,1926,5.973606670623717
STAT,1880,47,20-24,1927,0.025411850882311137
SIM,1867,56,na,1923,4076
SIM,1781,73,na,1854,869
SIM,1881,17,15-19,1898,7
SIM,1892,48,na,1940,6360
STAT,1837,90,na,1927,109.88447554531292
STAT,1926,35,45-49,1961,1.6852737613969124
SIM,1891,38,40-44,1929,20
STAT,1842,37,40-44,1879,7.6452719913159255
STAT,1853,2,na,1855,5700.022800000001
STAT,1921,31,45-49,1952,3.5502380950509838
STAT,1835,64,na,1899,2251.420739622121
STAT,1897,38,50-100,1935,3.2980260871028237
SIM,1759,95,na,1854,1
SIM,1884,38,40-44,1922,16
STAT,1772,106,na,1878,0.020681157529474414
STAT,1933,35,45-49,1968,1.8787610053496382
STAT,1802,52,50-100,1854,0.09681577632042325
STAT,1876,38,40-44,1914,9.098635166325035
STAT,1894,30,50-100,1924,2.3962120475999598
STAT,1946,7,na,1953,8838.266953907623
STAT,1913,22,20-24,1935,217.66531950175977
SIM,1868,25,35-39,1893,27
STAT,1885,21,20-24,1906,138.95277112804328
SIM,1846,57,na,1903,3159
SIM,1818,45,50-100,1863,1
SIM,1856,31,45-49,1887,4
STAT,1822,33,15-19,1855,0.7860155267906891
SIM,1850,37,40-44,1887,11
STAT,1862,4,na,1866,5269.572267861459
SIM,1905,18,25-29,1923,23
SIM,1937,27,35-39,1964,40
SIM,1838,18,25-29,1856,15
SIM,1911,23,40-44,1934,7
STAT,1880,85,na,1965,1087.2178153147065
SIM,1858,42,35-39,1900,7
STAT,1905,63,na,1968,5783.564093640217
STAT,1853,27,15-19,1880,0.8315957999095216
STAT,1905,36,20-24,1941,0.4883012539781661
STAT,1909,48,15-19,1957,6.820946161905999E-4
SIM,1915,35,35-39,1950,10
SIM,1833,50,na,1883,3011
SIM,1934,35,45-49,1969,2
SIM,1812,51,na,1863,2662
STAT,1833,35,40-44,1868,7.3603221823151985
STAT,1852,40,25-29,1892,1.0338036981622605
SIM,1837,31,35-39,1868,27
STAT,1935,37,45-49,1972,1.9255792828807532
SIM,1879,16,20-24,1895,31
STAT,1814,43,na,1857,2739.7912968791807
SIM,1832,28,na,1860,3683
SIM,1902,21,40-44,1923,8
STAT,1923,44,25-29,1967,0.16794846899237043
SIM,1906,33,35-39,1939,27
SIM,1895,20,35-39,1915,23
STAT,1811,43,40-44,1854,17.29646233231141
SIM,1859,23,35-39,1882,18
STAT,1859,44,35-39,1903,2.8715723743736246
SIM,1861,27,15-19,1888,4
STAT,1887,20,35-39,1907,13.259785812718635
STAT,1927,28,20-24,1955,44.65385427997626
STAT,1849,24,20-24,1873,129.90539378649714
SIM,1935,28,20-24,1963,56
SIM,1889,36,35-39,1925,26
STAT,1820,65,na,1885,1892.6678056233902
STAT,1831,35,15-19,1866,0.09380861861103325
SIM,1841,35,40-44,1876,14
STAT,1884,24,50-100,1908,0.8081533198837014
STAT,1867,32,25-29,1899,19.373113783498955
SIM,1867,44,35-39,1911,8
SIM,1913,36,20-24,1949,1
STAT,1901,21,40-44,1922,5.909484050969949
STAT,1840,94,na,1934,28.84871100384823
STAT,1899,37,50-100,1936,0.7332847985983438
STAT,1890,42,20-24,1932,0.39101688861627526
STAT,1858,28,40-44,1886,4.793359914713575
STAT,1802,110,na,1912,2.1208470925308104E-4
STAT,1878,45,50-100,1923,0.523208925239713
STAT,1898,24,50-100,1922,1.1075498313036565
SIM,1885,21,25-29,1906,126
SIM,1867,31,50-100,1898,4
STAT,1887,18,50-100,1905,0.11037256094685884
SIM,1910,21,30-34,1931,65
STAT,1819,80,na,1899,647.2847350304476
STAT,1873,45,25-29,1918,0.11937681923467446
STAT,1879,18,30-34,1897,3.358191150153021
STAT,1837,93,na,1930,40.73305378280176
SIM,1858,36,na,1894,4066
STAT,1808,51,25-29,1859,0.021455862635461124
SIM,1908,35,50-100,1943,4
SIM,1832,38,40-44,1870,14
STAT,1854,43,50-100,1897,1.6078282011964495
STAT,1844,15,35-39,1859,1.1397953039551214
SIM,1920,17,50-100,1937,2
SIM,1888,31,20-24,1919,8
STAT,1941,28,35-39,1969,31.353098062865186
STAT,1898,48,35-39,1946,0.21312448014939386
SIM,1840,26,na,1866,4257
SIM,1919,41,50-100,1960,1
SIM,1852,15,35-39,1867,3
SIM,1856,25,50-100,1881,2
SIM,1928,27,30-34,1955,12
SIM,1897,37,30-34,1934,18
SIM,1911,39,50-100,1950,2
STAT,1869,39,na,1908,4564.102185150814
STAT,1902,21,30-34,1923,50.94232159549065
STAT,1782,86,na,1868,136.36597429515444
SIM,1867,41,30-34,1908,1
SIM,1909,32,45-49,1941,4
SIM,1941,7,na,1948,8402
STAT,1843,37,50-100,1880,2.0077653567859235
SIM,1868,23,45-49,1891,1
STAT,1805,60,na,1865,2212.5608584206875
SIM,1922,45,50-100,1967,1
STAT,1824,38,40-44,1862,12.714537768882343
STAT,1900,42,30-34,1942,0.22339321917873314
STAT,1809,48,50-100,1857,1.869548316980741
STAT,1868,31,25-29,1899,19.76186531809457
STAT,1902,38,25-29,1940,1.7631784510750943
STAT,1904,17,25-29,1921,16.426370800786405
SIM,1881,45,25-29,1926,1
SIM,1883,24,25-29,1907,120
STAT,1869,18,45-49,1887,0.12883899340335267
SIM,1921,40,45-49,1961,1
SIM,1846,18,15-19,1864,12
STAT,1875,42,25-29,1917,1.333626302986272
SIM,1907,37,40-44,1944,2
STAT,1930,38,30-34,1968,4.796343109869563
STAT,1823,51,20-24,1874,0.0022388145572341486
STAT,1833,25,30-34,1858,44.47791228828267
SIM,1827,44,na,1871,3137
STAT,1873,44,na,1917,4678.774890132735
SIM,1836,30,45-49,1866,5
SIM,1899,34,30-34,1933,49
SIM,1910,38,25-29,1948,4
SIM,1912,17,25-29,1929,24
SIM,1931,23,50-100,1954,2
STAT,1918,48,30-34,1966,0.19102552978941
STAT,1900,24,30-34,1924,49.59092563595488
STAT,1794,71,na,1865,1244.1759200409365
STAT,1838,18,15-19,1856,10.546692086542345
STAT,1903,28,na,1931,6838.440137923172
STAT,1934,30,35-39,1964,25.230928007856683
STAT,1943,25,35-39,1968,32.31998727758493
STAT,1806,54,25-29,1860,0.019855923459858184
STAT,1836,39,15-19,1875,0.08978058450379202
STAT,1919,15,na,1934,8686.684808448099
SIM,1845,69,na,1914,2334
STAT,1867,39,50-100,1906,2.298811126640661
STAT,1891,29,40-44,1920,7.424624905292571
STAT,1913,40,45-49,1953,0.3315823773803666
STAT,1832,62,na,1894,2382.84574637601
STAT,1861,30,30-34,1891,29.585850430487056
SIM,1804,87,na,1891,73
STAT,1883,19,35-39,1902,1.0829499908753648
STAT,1927,38,50-100,1965,1.0530274943835687
STAT,1947,17,50-100,1964,0.8522956847735899
SIM,1870,36,na,1906,4621
SIM,1887,19,15-19,1906,14
SIM,1905,21,20-24,1926,211
STAT,1924,40,20-24,1964,0.04253112975980597
SIM,1897,24,25-29,1921,163
SIM,1863,82,na,1945,760
STAT,1899,40,15-19,1939,0.002680414829442832
SIM,1848,44,25-29,1892,2
STAT,1831,80,na,1911,798.6994260444043
SIM,1924,32,40-44,1956,15
SIM,1871,18,na,1889,4914
STAT,1809,50,na,1859,2711.568331919704
STAT,1946,17,30-34,1963,27.301354202099223
STAT,1811,54,35-39,1865,0.053553618927891296
STAT,1872,47,50-100,1919,0.49618021579179333
STAT,1827,75,na,1902,1244.8609454226162
STAT,1857,7,na,1864,4579.538995670862
SIM,1841,25,30-34,1866,55
STAT,1934,32,30-34,1966,43.45061241807802
STAT,1823,85,na,1908,328.9617118810944
STAT,1876,80,na,1956,1369.9090005559167
STAT,1917,35,35-39,1952,5.1215946393105565
SIM,1883,42,25-29,1925,3
STAT,1872,90,na,1962,326.9732823352865
STAT,1907,43,25-29,1950,0.13141110665139705
SIM,1891,19,35-39,1910,3
STAT,1852,15,50-100,1867,0.09556174763915208
SIM,1923,38,35-39,1961,10
STAT,1909,40,25-29,1949,0.13649661936269242
STAT,1930,25,25-29,1955,169.1740337073737
STAT,1872,48,15-19,1920,8.01694025042844E-4
STAT,1856,72,na,1928,1967.8885330374778
STAT,1916,32,40-44,1948,8.159666631777636
STAT,1833,109,na,1942,9.353047866370223E-4
SIM,1893,31,50-100,1924,4
STAT,1830,49,20-24,1879,0.020185038876594927
SIM,1800,97,na,1897,1
STAT,1786,109,na,1895,6.612089655183493E-4
SIM,1902,37,50-100,1939,5
STAT,1902,26,50-100,1928,1.8302438735606206
SIM,1877,31,45-49,1908,6
SIM,1925,17,35-39,1942,15
STAT,1932,35,30-34,1967,4.954606868983714
STAT,1940,1,na,1941,8528.997016424588
STAT,1910,16,40-44,1926,0.5613201282211187
STAT,1872,18,50-100,1890,0.09918026594061018
SIM,1877,15,na,1892,5265
STAT,1833,43,30-34,1876,1.8111798780104298
STAT,1835,22,30-34,1857,30.679626477164174
STAT,1904,49,50-100,1953,0.3932032229647302
STAT,1900,40,35-39,1940,0.35584960641009517
STAT,1849,35,50-100,1884,2.028922939031599
STAT,1822,104,na,1926,0.07530990482274359
STAT,1869,31,45-49,1900,3.426500447273672
STAT,1885,16,35-39,1901,1.1057770485053626
STAT,1913,22,15-19,1935,10.420216691376593
SIM,1913,3,na,1916,8543
SIM,1893,16,35-39,1909,2
STAT,1877,34,na,1911,4961.625508242169
SIM,1843,22,30-34,1865,40
STAT,1816,46,35-39,1862,0.6985020294894858
STAT,1864,52,20-24,1916,0.0013250810317825374
SIM,1845,19,50-100,1864,4
SIM,1954,17,30-34,1971,45
STAT,1915,38,35-39,1953,4.910718586742251
STAT,1917,17,35-39,1934,1.823513999860954
STAT,1881,79,na,1960,1701.8331462243195
STAT,1907,25,25-29,1932,126.41782689616267
STAT,1835,40,30-34,1875,1.8312565624195365
STAT,1912,27,30-34,1939,78.00416078590463
STAT,1944,22,45-49,1966,2.4534002730645894
STAT,1825,80,na,1905,715.7380008407632
STAT,1892,11,na,1903,6539.090472859589
SIM,1906,17,na,1923,7407
STAT,1917,49,25-29,1966,0.11123431237418417
STAT,1851,23,25-29,1874,105.21334933208942
STAT,1927,22,45-49,1949,2.7993168572154428
SIM,1864,36,na,1900,4487
SIM,1872,31,na,1903,5082
STAT,1820,53,50-100,1873,0.052984927075690864
SIM,1821,59,na,1880,2293
SIM,1872,2,na,1874,6749
STAT,1871,20,45-49,1891,1.4075345498188985
SIM,1795,65,na,1860,1636
SIM,1867,26,35-39,1893,25
SIM,1842,23,25-29,1865,112
STAT,1922,30,15-19,1952,0.29551455325522386
STAT,1807,109,na,1916,5.678924718325335E-4
STAT,1839,17,20-24,1856,36.21185661110292
STAT,1860,47,40-44,1907,0.27947315997876576
STAT,1871,49,na,1920,4420.083341600761
STAT,1839,33,25-29,1872,19.47803770856422
STAT,1852,39,50-100,1891,1.937094769080577
STAT,1834,23,25-29,1857,101.18130522049022
STAT,1944,10,na,1954,8551.345866683523
SIM,1862,20,45-49,1882,3
STAT,1814,49,35-39,1863,0.7030553083614791
STAT,1927,35,20-24,1962,0.6629672758280605
STAT,1860,31,25-29,1891,16.867369728285748
STAT,1866,37,35-39,1903,13.180245727522927
STAT,1877,2,na,1879,6814.792619179336
SIM,1929,25,25-29,1954,182
SIM,1895,28,na,1923,6579
STAT,1818,39,na,1857,3049.791386154413
SIM,1843,40,30-34,1883,4
STAT,1920,6,na,1926,9079.75363600908
SIM,1873,23,25-29,1896,140
SIM,1856,49,50-100,1905,1
SIM,1915,25,25-29,1940,145
STAT,1899,29,40-44,1928,8.229896648661853
SIM,1920,27,30-34,1947,109
SIM,1882,61,na,1943,3801
STAT,1889,24,25-29,1913,141.6624843067919
SIM,1906,38,35-39,1944,9
STAT,1869,30,30-34,1899,34.44225536512759
STAT,1910,32,45-49,1942,3.0654182269551904
SIM,1826,40,30-34,1866,3
SIM,1916,0,na,1916,9094
STAT,1904,48,30-34,1952,0.1562918408229776
STAT,1822,60,na,1882,2325.1574141808783
SIM,1802,92,na,1894,29
SIM,1874,37,35-39,1911,26
SIM,1884,23,30-34,1907,50
STAT,1830,47,25-29,1877,0.09942782190652306
STAT,1854,20,45-49,1874,1.2742524978251348
STAT,1784,81,na,1865,329.3518573362989
STAT,1891,40,15-19,1931,0.03482247263329592
SIM,1856,36,30-34,1892,16
SIM,1925,32,30-34,1957,42
SIM,1911,19,30-34,1930,6
SIM,1922,21,50-100,1943,5
SIM,1893,31,30-34,1924,63
SIM,1907,58,na,1965,6241
STAT,1855,111,na,1966,0.0010310004572408945
SIM,1802,52,na,1854,2452
SIM,1935,22,45-49,1957,3
STAT,1922,43,20-24,1965,0.04086303089554837
SIM,1878,56,na,1934,4428
STAT,1885,69,na,1954,2950.196863625105
STAT,1885,31,30-34,1916,35.24264074799594
SIM,1847,33,25-29,1880,4
SIM,1886,23,na,1909,4952
SIM,1946,25,25-29,1971,142
STAT,1848,77,na,1925,1417.3500634538511
STAT,1818,40,30-34,1858,6.1042889748409745
STAT,1892,26,50-100,1918,1.622881898691934
STAT,1848,36,30-34,1884,9.099656514077477
STAT,1856,113,na,1969,1.6239167165621682E-4
STAT,1903,19,30-34,1922,4.558691890950446
SIM,1856,41,na,1897,3899
SIM,1858,36,35-39,1894,20
STAT,1865,23,25-29,1888,105.54836165343931
STAT,1917,32,30-34,1949,33.31711046009959
SIM,1806,48,40-44,1854,1
STAT,1834,41,25-29,1875,1.0437847060943157
STAT,1848,23,25-29,1871,113.47090499716215
STAT,1883,74,na,1957,2335.727668416153
STAT,1908,24,30-34,1932,53.064972457888466
SIM,1831,39,35-39,1870,22
SIM,1859,42,50-100,1901,3
SIM,1870,76,na,1946,1723
STAT,1809,50,30-34,1859,0.045681736775431005
STAT,1851,41,25-29,1892,0.9999648981175083
STAT,1825,33,25-29,1858,33.21929888354174
STAT,1865,39,40-44,1904,7.951053939773397
STAT,1925,15,na,1940,9019.796650434826
STAT,1854,77,na,1931,1325.1021650768946
STAT,1855,47,30-34,1902,0.14528753746867754
STAT,1932,25,na,1957,9918.9988453119
SIM,1944,25,20-24,1969,43
STAT,1810,75,na,1885,898.5961251415199
SIM,1912,35,25-29,1947,3
SIM,1961,2,na,1963,10518
SIM,1816,72,na,1888,1167
STAT,1828,57,na,1885,2566.377026796395
STAT,1928,33,15-19,1961,0.32426493073101254
STAT,1936,25,20-24,1961,35.319213366500726
STAT,1828,30,45-49,1858,4.156096912499087
STAT,1855,18,15-19,1873,10.581147324087567
STAT,1933,15,25-29,1948,117.7156599318704
STAT,1878,16,50-100,1894,0.10359240450238134
SIM,1815,59,na,1874,2092
STAT,1938,25,25-29,1963,131.83251331334122
SIM,1833,33,25-29,1866,23
SIM,1847,17,20-24,1864,35
SIM,1938,10,na,1948,7986
STAT,1895,21,45-49,1916,1.84063305899235
SIM,1926,37,na,1963,9525
STAT,1894,46,na,1940,5854.640338810637
SIM,1873,39,40-44,1912,14
STAT,1904,35,25-29,1939,1.818528407570891
STAT,1908,40,35-39,1948,0.3807783242830076
SIM,1874,38,na,1912,4542
STAT,1771,107,na,1878,0.01212227372683584
STAT,1865,49,na,1914,4041.842953802007
SIM,1910,35,20-24,1945,1
SIM,1866,28,40-44,1894,9
SIM,1842,41,25-29,1883,3
STAT,1857,14,na,1871,4376.909134434741
STAT,1859,41,30-34,1900,1.8564413715155468
SIM,1833,44,na,1877,3252
STAT,1923,46,45-49,1969,0.5145967703572617
STAT,1876,41,30-34,1917,2.4123618766774464
SIM,1955,15,25-29,1970,132
STAT,1790,81,na,1871,377.18855455012863
SIM,1916,24,30-34,1940,81
STAT,1840,39,35-39,1879,11.82696757224213
STAT,1942,22,40-44,1964,7.1201118336178135
STAT,1838,29,50-100,1867,1.0855338210136443
SIM,1847,15,25-29,1862,12
SIM,1853,30,45-49,1883,6
STAT,1941,19,50-100,1960,0.7788856353148877
SIM,1844,16,na,1860,4134
STAT,1900,27,35-39,1927,27.032674502294245
STAT,1870,95,na,1965,88.42766950790593
STAT,1889,37,30-34,1926,13.271889689253008
STAT,1871,48,25-29,1919,0.11412305683569188
SIM,1925,30,35-39,1955,35
STAT,1892,24,25-29,1916,143.8277860739869
STAT,1840,51,20-24,1891,0.0010702389185828244
STAT,1803,65,na,1868,1699.9434656897874
STAT,1879,69,na,1948,3100.1518158184485
SIM,1912,17,na,1929,8075
SIM,1841,79,na,1920,823
SIM,1856,23,25-29,1879,135
STAT,1818,102,na,1920,0.3007808074502425
STAT,1845,30,45-49,1875,3.262040499575365
STAT,1908,42,30-34,1950,0.23904282630295884
STAT,1839,15,25-29,1854,11.712282728752799
SIM,1778,93,na,1871,17
STAT,1933,33,25-29,1966,25.142700043466952
SIM,1901,32,45-49,1933,5
STAT,1858,37,50-100,1895,1.9329807039385423
SIM,1909,48,30-34,1957,1
SIM,1861,33,50-100,1894,4
SIM,1818,42,50-100,1860,4
STAT,1902,35,20-24,1937,0.47891523930512125
SIM,1888,18,20-24,1906,41
STAT,1919,43,na,1962,8113.846928693411
STAT,1947,15,25-29,1962,98.63449014418366
SIM,1884,41,30-34,1925,3
STAT,1930,40,45-49,1970,0.4434776727241884
STAT,1943,22,30-34,1965,61.7554012889564
SIM,1898,48,na,1946,6225
STAT,1882,80,na,1962,1659.3326006814302
SIM,1932,25,na,1957,9954
SIM,1814,77,na,1891,801
SIM,1846,17,30-34,1863,3
STAT,1842,52,na,1894,3188.6016582970306
SIM,1882,29,40-44,1911,9
STAT,1884,18,40-44,1902,0.3638025018785309
SIM,1902,43,45-49,1945,2
SIM,1863,18,15-19,1881,11
SIM,1810,87,na,1897,131
STAT,1874,29,40-44,1903,6.150297200041735
STAT,1775,104,na,1879,0.049121437869205566
STAT,1859,49,na,1908,3541.082974164034
STAT,1853,39,15-19,1892,0.0879536155450866
SIM,1857,94,na,1951,34
SIM,1850,16,na,1866,4577
SIM,1876,21,na,1897,5107
SIM,1931,12,na,1943,10495
SIM,1944,10,na,1954,8703
STAT,1920,15,15-19,1935,20.7225149177341
STAT,1819,40,na,1859,3047.064800343119
SIM,1899,37,35-39,1936,5
STAT,1840,36,30-34,1876,9.193823413414346
SIM,1771,83,na,1854,220
STAT,1791,101,na,1892,0.22518740487902894
STAT,1842,33,30-34,1875,31.077352688681653
SIM,1854,8,na,1862,4967
STAT,1894,21,25-29,1915,148.9662207378669
STAT,1820,37,na,1857,3142.1452668257175
STAT,1807,55,na,1862,2472.528835687497
STAT,1879,19,15-19,1898,12.469371459817683
STAT,1857,103,na,1960,0.5512118664038526
SIM,1850,15,30-34,1865,4
STAT,1901,33,na,1934,6718.509619870818
STAT,1924,43,25-29,1967,0.17122669232111265
STAT,1930,22,20-24,1952,287.6872440018069
SIM,1910,24,35-39,1934,20
SIM,1950,19,na,1969,8546
STAT,1833,28,35-39,1861,16.647304217607537
STAT,1843,35,40-44,1878,7.3088861308837165
STAT,1883,24,50-100,1907,0.8041021204555535
SIM,1851,35,40-44,1886,11
STAT,1902,24,35-39,1926,16.53481085234137
SIM,1835,30,25-29,1865,28
STAT,1825,36,35-39,1861,19.320460870150256
SIM,1926,39,50-100,1965,3
STAT,1829,70,na,1899,1660.5510886069271
STAT,1854,48,25-29,1902,0.08719057314033749
STAT,1921,35,25-29,1956,2.223663093916726
STAT,1939,24,30-34,1963,58.26197265514032
SIM,1789,93,na,1882,7
STAT,1903,68,na,1971,5152.796175932094
STAT,1962,9,na,1971,10166.65092596636
SIM,1856,20,15-19,1876,6
STAT,1813,49,20-24,1862,0.07150479210165213
SIM,1879,23,20-24,1902,128
STAT,1901,22,25-29,1923,161.8544675158244
STAT,1929,42,50-100,1971,0.3072352691149911
SIM,1831,49,na,1880,3168
STAT,1835,25,35-39,1860,16.530980909141302
STAT,1925,24,30-34,1949,69.03198918662515
SIM,1924,35,45-49,1959,2
STAT,1909,34,50-100,1943,1.5806609015345168
SIM,1876,31,25-29,1907,28
STAT,1918,32,45-49,1950,3.376505257775054
SIM,1912,33,50-100,1945,2
STAT,1848,20,15-19,1868,6.682150389073454
STAT,1922,49,35-39,1971,0.2973038865252048
STAT,1938,22,20-24,1960,222.2945455397614
SIM,1833,36,35-39,1869,17
SIM,1850,33,30-34,1883,38
STAT,1883,34,na,1917,4694.5535009724645
STAT,1893,20,50-100,1913,1.0501221812604784
STAT,1961,4,na,1965,10259.234729819489
STAT,1914,31,na,1945,7721.46967446547
SIM,1901,31,30-34,1932,58
STAT,1843,93,na,1936,40.939449316202065
STAT,1898,48,50-100,1946,0.3738812297553881
SIM,1812,44,50-100,1856,2
SIM,1907,32,40-44,1939,11
SIM,1919,43,na,1962,8184
STAT,1890,56,na,1946,5028.015896984945
SIM,1856,39,35-39,1895,19
SIM,1913,16,30-34,1929,4
STAT,1896,19,15-19,1915,15.739193021922567
STAT,1905,43,20-24,1948,0.031978566480540524
SIM,1843,25,35-39,1868,27
STAT,1843,17,40-44,1860,0.32742366485765856
SIM,1856,72,na,1928,2014
SIM,1883,21,20-24,1904,136
SIM,1889,28,na,1917,6008
STAT,1908,43,45-49,1951,0.30931926390467684
SIM,1918,38,25-29,1956,1
STAT,1795,65,na,1860,1704.5749818364852
SIM,1838,40,20-24,1878,1
STAT,1905,16,30-34,1921,4.666776654656673
SIM,1839,69,na,1908,1969
SIM,1841,28,40-44,1869,10
STAT,1830,67,na,1897,2189.000560099893
STAT,1921,17,25-29,1938,99.73765559072302
STAT,1869,15,35-39,1884,1.1015985665680295
SIM,1897,21,20-24,1918,7
STAT,1841,38,40-44,1879,7.405954274040463
SIM,1915,53,na,1968,7375
SIM,1838,22,20-24,1860,140
STAT,1829,28,15-19,1857,1.111831395197104
SIM,1935,35,20-24,1970,1
STAT,1867,44,na,1911,4312.528213253492
SIM,1926,32,45-49,1958,7
STAT,1827,49,15-19,1876,7.033608861274893E-4
STAT,1881,37,30-34,1918,10.403768998726163
STAT,1897,31,20-24,1928,7.327112056879525
SIM,1918,22,45-49,1940,2
STAT,1889,21,20-24,1910,172.1262563435395
SIM,1869,20,25-29,1889,131
SIM,1822,46,30-34,1868,1
STAT,1859,26,35-39,1885,15.892382805834671
SIM,1897,23,na,1920,6471
SIM,1891,78,na,1969,2931
STAT,1899,47,40-44,1946,0.2659796874511689
STAT,1951,17,40-44,1968,3.363612209868371
SIM,1891,16,30-34,1907,6
STAT,1838,17,30-34,1855,2.8493560384615173
STAT,1816,60,na,1876,2312.344122224609
SIM,1868,44,50-100,1912,7
SIM,1837,28,15-19,1865,1
SIM,1862,41,na,1903,4226
STAT,1814,46,30-34,1860,0.5093550245729529
SIM,1937,3,na,1940,8142
STAT,1876,23,30-34,1899,37.092390230369354
SIM,1868,66,na,1934,3252
STAT,1906,45,30-34,1951,0.16229640570731083
SIM,1916,25,45-49,1941,2
STAT,1856,30,20-24,1886,4.3530422349072495
SIM,1842,20,20-24,1862,137
SIM,1904,22,15-19,1926,7
SIM,1943,26,15-19,1969,4
STAT,1947,19,40-44,1966,3.1797731438297605
SIM,1825,49,na,1874,2690
SIM,1903,68,na,1971,5317
STAT,1904,13,na,1917,7474.41842833671
SIM,1824,43,30-34,1867,6
SIM,1911,21,45-49,1932,3
STAT,1853,52,45-49,1905,0.02283932644910838
SIM,1859,35,40-44,1894,9
SIM,1925,35,35-39,1960,10
STAT,1833,46,35-39,1879,0.218739866730296
STAT,1853,20,25-29,1873,108.57057723099993
STAT,1788,71,na,1859,1223.1102303667342
STAT,1883,34,30-34,1917,34.348236953794114
SIM,1878,29,15-19,1907,1
SIM,1922,36,25-29,1958,7
STAT,1871,18,na,1889,5070.354158742177
STAT,1964,1,na,1965,10013.899858289182
STAT,1841,111,na,1952,1.5573189648832554E-4
SIM,1886,51,na,1937,4454
SIM,1912,49,50-100,1961,1
SIM,1892,36,40-44,1928,19
STAT,1848,39,35-39,1887,11.70583093357113
SIM,1841,46,35-39,1887,1
SIM,1925,46,20-24,1971,1
STAT,1816,43,30-34,1859,6.089070299767933
SIM,1832,90,na,1922,104
SIM,1877,15,35-39,1892,1
STAT,1942,25,45-49,1967,3.665280678733432
SIM,1891,34,30-34,1925,56
STAT,1834,35,50-100,1869,2.075503815275001
STAT,1853,24,na,1877,3939.904291190433
STAT,1869,43,50-100,1912,2.052477939361004
STAT,1935,30,25-29,1965,25.859116007921276
STAT,1840,54,30-34,1894,0.008355871655872425
SIM,1933,19,na,1952,10393
SIM,1864,30,20-24,1894,5
SIM,1887,18,30-34,1905,5
STAT,1908,25,45-49,1933,3.3511484421524664
SIM,1879,69,na,1948,2878
STAT,1920,33,15-19,1953,0.2830098128723878
SIM,1825,45,40-44,1870,1
STAT,1876,26,35-39,1902,20.224425621351397
SIM,1946,22,20-24,1968,261
SIM,1838,28,na,1866,3777
STAT,1917,46,20-24,1963,0.023368401885432686
STAT,1862,72,na,1934,2180.0107513632042
STAT,1849,52,25-29,1901,0.00557292347771604
SIM,1862,46,50-100,1908,1
STAT,1936,15,na,1951,7151.523256237937
STAT,1923,43,40-44,1966,0.5893023933883589
STAT,1884,16,na,1900,5049.112051974707
STAT,1919,30,50-100,1949,1.8156301123631673
STAT,1916,35,45-49,1951,1.4233148305750585
SIM,1927,30,50-100,1957,2
SIM,1910,50,na,1960,7096
SIM,1869,23,35-39,1892,17
STAT,1789,96,na,1885,3.3180677907599296
STAT,1808,49,40-44,1857,1.0368782576021907
SIM,1837,34,na,1871,3540
STAT,1853,52,na,1905,3388.6092057467085
STAT,1812,70,na,1882,1580.9291766996396
STAT,1894,74,na,1968,3632.581379414193
STAT,1921,16,50-100,1937,0.8644028197110065
SIM,1874,66,na,1940,3059
SIM,1898,32,20-24,1930,8
STAT,1817,45,40-44,1862,0.8530724564535815
SIM,1819,49,na,1868,2743
SIM,1842,39,40-44,1881,11
STAT,1861,59,na,1920,3266.9795481938513
SIM,1841,28,35-39,1869,23
STAT,1892,27,35-39,1919,24.39534620899806
STAT,1936,28,25-29,1964,127.1826312676086
SIM,1886,20,30-34,1906,44
STAT,1831,47,15-19,1878,6.121188924955447E-4
STAT,1871,50,45-49,1921,0.029537834407074
STAT,1925,27,40-44,1952,11.116200080233813
SIM,1907,19,40-44,1926,1
SIM,1830,64,na,1894,2157
STAT,1869,15,40-44,1884,0.36719954344975864
STAT,1838,87,na,1925,238.43727732602576
STAT,1922,46,25-29,1968,0.12334640196519928
STAT,1851,53,25-29,1904,0.005402606675551482
SIM,1858,33,30-34,1891,37
STAT,1850,87,na,1937,270.1326689424443
STAT,1933,19,40-44,1952,3.761615361045331
STAT,1889,21,15-19,1910,8.240140843202244
SIM,1942,15,45-49,1957,2
SIM,1905,24,25-29,1929,199
STAT,1863,45,50-100,1908,0.4385251555889719
STAT,1827,30,25-29,1857,28.10061401737926
SIM,1885,38,na,1923,4959
STAT,1909,36,15-19,1945,0.036906475206677246
STAT,1785,110,na,1895,4.3184800987518387E-4
SIM,1912,32,20-24,1944,5
STAT,1832,44,25-29,1876,0.9980876650901824
SIM,1861,20,25-29,1881,131
SIM,1868,97,na,1965,19
SIM,1763,91,na,1854,24
SIM,1840,44,25-29,1884,2
STAT,1846,18,50-100,1864,0.09371180535077062
SIM,1906,35,30-34,1941,6
STAT,1896,48,30-34,1944,0.1437662673196362
SIM,1856,20,20-24,1876,117
STAT,1890,16,na,1906,6241.304133778632
SIM,1941,19,40-44,1960,4
SIM,1892,18,40-44,1910,1
STAT,1834,39,40-44,1873,7.099114965198924
STAT,1855,6,na,1861,4474.446805070349
SIM,1865,44,30-34,1909,3
STAT,1834,20,20-24,1854,232.04779498849481
STAT,1918,21,na,1939,7977.0317086720715
STAT,1907,58,na,1965,6274.256862824502
SIM,1882,25,50-100,1907,5
STAT,1813,55,na,1868,2390.58315375215
STAT,1812,51,45-49,1863,0.09815924046025745
STAT,1851,26,35-39,1877,17.639927362137108
STAT,1874,15,15-19,1889,12.375175832154879
STAT,1920,33,45-49,1953,3.465535100224497
STAT,1904,32,20-24,1936,4.499123539386224
SIM,1891,38,na,1929,6028
STAT,1884,36,40-44,1920,8.771942199264943
STAT,1912,42,20-24,1954,0.03440914390218726
SIM,1866,31,na,1897,4657
STAT,1848,20,20-24,1868,139.58178054014485
STAT,1913,32,50-100,1945,1.6617525930073298
SIM,1853,44,50-100,1897,6
STAT,1912,24,20-24,1936,222.9360370850977
STAT,1914,36,25-29,1950,1.9953274946214683
SIM,1795,93,na,1888,7
STAT,1857,44,30-34,1901,1.7853752477666827
SIM,1856,39,40-44,1895,15
STAT,1923,44,50-100,1967,0.2763023182183827
SIM,1816,44,na,1860,2958
SIM,1933,27,40-44,1960,16
STAT,1903,36,50-100,1939,0.7656844430804997
SIM,1808,77,na,1885,676
SIM,1877,15,40-44,1892,2
STAT,1770,117,na,1887,1.251869078998373E-4
STAT,1844,87,na,1931,284.5168187135703
STAT,1934,33,45-49,1967,4.337021212164796
STAT,1836,52,na,1888,2896.5799461106303
STAT,1897,26,na,1923,6464.868041434378
STAT,1903,21,45-49,1924,2.01124553928666
SIM,1833,36,50-100,1869,5
STAT,1962,0,na,1962,10247.673720142933
SIM,1920,24,20-24,1944,255
SIM,1882,15,15-19,1897,11
STAT,1912,36,na,1948,7453.667307768947
SIM,1879,26,25-29,1905,85
SIM,1817,82,na,1899,402
STAT,1840,54,25-29,1894,0.004972088871276539
SIM,1932,25,30-34,1957,117
SIM,1814,49,na,1863,2642
SIM,1835,70,na,1905,1804
STAT,1855,87,na,1942,265.6690606686426
SIM,1854,77,na,1931,1400
SIM,1838,43,25-29,1881,5
STAT,1903,15,15-19,1918,17.144458299423203
STAT,1815,59,na,1874,2276.2170860994283
STAT,1951,17,35-39,1968,10.090836045357708
SIM,1901,16,35-39,1917,2
STAT,1821,39,30-34,1860,18.498564671527614
SIM,1842,27,40-44,1869,8
SIM,1875,39,50-100,1914,2
STAT,1933,37,40-44,1970,4.1184421698352045
STAT,1834,27,40-44,1861,5.228730329477307
SIM,1898,20,20-24,1918,208
SIM,1917,17,na,1934,8622
STAT,1860,35,40-44,1895,7.247651488313586
STAT,1859,31,50-100,1890,1.4788738336509264
STAT,1920,31,na,1951,8398.820985623359
STAT,1897,34,25-29,1931,27.414624123972718
STAT,1900,25,45-49,1925,3.131756137661467
SIM,1852,30,25-29,1882,24
SIM,1838,27,20-24,1865,22
STAT,1923,23,50-100,1946,1.5409603480061518
STAT,1868,16,35-39,1884,1.0798092314398666
STAT,1830,27,na,1857,3919.9478360624807
SIM,1908,30,35-39,1938,23
STAT,1909,42,45-49,1951,0.31455950123360177
STAT,1941,9,na,1950,8233.82714229605
STAT,1847,52,20-24,1899,0.0011188532831466662
STAT,1914,45,50-100,1959,0.45524223065707164
STAT,1906,41,15-19,1947,0.0028350031020025527
STAT,1818,40,25-29,1858,3.4096028647624466
SIM,1911,15,15-19,1926,20
SIM,1951,18,20-24,1969,339
STAT,1924,21,na,1945,8726.576741668376
SIM,1827,75,na,1902,1129
STAT,1805,52,15-19,1857,1.9313349889712677E-4
STAT,1912,27,25-29,1939,131.03407084558629
STAT,1883,16,30-34,1899,3.170440279014512
SIM,1904,20,50-100,1924,5
STAT,1920,37,30-34,1957,4.029230373583958
SIM,1810,46,40-44,1856,1
SIM,1930,28,30-34,1958,127
SIM,1929,29,40-44,1958,17
SIM,1908,40,na,1948,7023
STAT,1922,28,30-34,1950,89.20546313482457
SIM,1866,62,na,1928,3535
SIM,1881,79,na,1960,1303
STAT,1826,50,30-34,1876,0.011912100710506149
STAT,1774,114,na,1888,4.466945798763558E-4
STAT,1836,52,45-49,1888,0.01952790437186795
SIM,1904,38,30-34,1942,5
SIM,1912,32,15-19,1944,1
SIM,1906,17,30-34,1923,3
SIM,1786,88,na,1874,93
STAT,1868,54,50-100,1922,0.028222291758576802
STAT,1935,32,45-49,1967,4.3975884872558275
STAT,1895,49,25-29,1944,0.08371955003320786
SIM,1906,23,30-34,1929,63
STAT,1893,41,30-34,1934,2.9563268996276
SIM,1890,28,na,1918,6268
STAT,1828,85,na,1913,336.65233801530934
SIM,1853,36,na,1889,3914
SIM,1841,48,na,1889,3170
STAT,1828,88,na,1916,168.59188978751433
SIM,1877,3,na,1880,5970
SIM,1916,40,40-44,1956,2
SIM,1902,47,30-34,1949,1
STAT,1844,47,na,1891,3616.360793848919
SIM,1887,20,45-49,1907,2
SIM,1833,33,30-34,1866,38
SIM,1904,50,na,1954,6434
STAT,1764,111,na,1875,0.00181747569394478
STAT,1898,64,na,1962,5087.461847065265
STAT,1904,32,15-19,1936,0.23703137015776496
STAT,1899,43,25-29,1942,0.12250281724708355
STAT,1911,25,20-24,1936,36.206727087305524
STAT,1930,40,15-19,1970,0.004092066471601614
SIM,1898,39,40-44,1937,1
STAT,1872,43,15-19,1915,0.027827885432885283
SIM,1913,19,35-39,1932,2
STAT,1849,31,20-24,1880,5.002793288139811
STAT,1858,36,na,1894,3727.1466578371146
SIM,1917,8,na,1925,8881
STAT,1876,24,na,1900,4909.327945146653
SIM,1879,28,20-24,1907,27
STAT,1892,24,30-34,1916,44.7527971977439
STAT,1909,53,na,1962,6676.456575061302
SIM,1893,31,25-29,1924,32
SIM,1790,93,na,1883,14
STAT,1841,22,25-29,1863,105.21968147478816
STAT,1857,32,30-34,1889,27.65472000143086
STAT,1848,25,15-19,1873,0.9010151067630875
SIM,1865,26,30-34,1891,54
SIM,1908,43,na,1951,6897
STAT,1893,39,50-100,1932,3.1112401452853167
STAT,1861,42,30-34,1903,1.9302226008411267
STAT,1885,31,25-29,1916,20.674814855802836
SIM,1857,35,50-100,1892,3
SIM,1876,16,35-39,1892,1
STAT,1832,93,na,1925,38.10166798209215
STAT,1841,67,na,1908,2300.0399112868695
STAT,1845,17,45-49,1862,0.12722264504871228
STAT,1867,72,na,1939,2388.6704894882155
STAT,1825,40,na,1865,3244.0010283191164
STAT,1831,42,15-19,1873,0.021867120733091452
STAT,1873,13,na,1886,5358.796465309835
SIM,1907,33,25-29,1940,24
STAT,1874,54,na,1928,4330.124695598902
STAT,1908,40,40-44,1948,0.4729782237140485
STAT,1924,25,30-34,1949,92.73819112380464
STAT,1860,17,40-44,1877,0.34596866854455716
SIM,1901,34,35-39,1935,27
STAT,1847,109,na,1956,0.0012384403751358702
STAT,1840,26,na,1866,3921.5228770335125
STAT,1922,46,30-34,1968,0.20729048307824013
SIM,1823,85,na,1908,296
SIM,1929,22,20-24,1951,275
STAT,1825,33,30-34,1858,56.62618140081535
STAT,1899,25,25-29,1924,117.84802928504534
SIM,1857,31,20-24,1888,5
STAT,1925,27,35-39,1952,35.80608616239596
STAT,1903,33,15-19,1936,0.23414387463974695
STAT,1858,46,40-44,1904,0.27030569211051675
SIM,1939,32,25-29,1971,22
STAT,1928,20,na,1948,9261.913551981956
STAT,1935,26,15-19,1961,1.944729855583056
SIM,1854,74,na,1928,1803
SIM,1856,25,15-19,1881,1
STAT,1857,26,30-34,1883,41.126412521268705
STAT,1907,28,35-39,1935,28.540698051429324
STAT,1842,101,na,1943,0.8495526218415365
SIM,1915,28,35-39,1943,38
SIM,1900,51,na,1951,6250
STAT,1932,31,15-19,1963,0.345234685224769
STAT,1795,96,na,1891,3.6696099219899874
SIM,1837,74,na,1911,1484
SIM,1828,69,na,1897,1839
SIM,1902,29,30-34,1931,82
SIM,1939,26,25-29,1965,135
SIM,1832,26,50-100,1858,5
STAT,1860,29,40-44,1889,4.894563654230664
SIM,1925,43,na,1968,9059
STAT,1916,33,25-29,1949,19.190450897427848
SIM,1860,39,50-100,1899,7
STAT,1877,50,40-44,1927,0.022395418757728963
SIM,1863,40,50-100,1903,3
STAT,1859,41,25-29,1900,1.0369312207647956
SIM,1842,89,na,1931,116
STAT,1826,32,30-34,1858,52.49119247478458
STAT,1845,20,50-100,1865,0.7914156503259444
SIM,1847,95,na,1942,18
STAT,1827,47,na,1874,3055.038110422196
STAT,1912,29,20-24,1941,36.07994697938965
STAT,1804,75,na,1879,853.3092047879486
STAT,1813,43,50-100,1856,7.366096129444483
STAT,1912,45,25-29,1957,0.10347061118943511
SIM,1922,33,20-24,1955,8
STAT,1852,11,na,1863,4622.752746840564
STAT,1875,21,20-24,1896,143.72591774698896
STAT,1843,62,na,1905,2560.3181652818503
STAT,1920,19,30-34,1939,27.464064317578504
SIM,1887,64,na,1951,4122
STAT,1930,22,15-19,1952,13.772352107840144
STAT,1771,86,na,1857,100.71223226783
STAT,1797,91,na,1888,37.734294553158094
SIM,1903,45,25-29,1948,1
STAT,1833,28,40-44,1861,5.16824887367312
STAT,1893,23,30-34,1916,45.45637703434287
STAT,1796,103,na,1899,0.06393829363349818
SIM,1920,29,20-24,1949,45
SIM,1933,10,na,1943,11272
STAT,1906,18,40-44,1924,0.5368632190548756
SIM,1869,20,30-34,1889,47
SIM,1851,31,25-29,1882,21
SIM,1916,22,40-44,1938,10
STAT,1813,47,25-29,1860,0.3553906807346199
SIM,1839,24,30-34,1863,34
SIM,1850,56,na,1906,3266
SIM,1876,61,na,1937,4112
SIM,1865,32,30-34,1897,45
SIM,1903,39,25-29,1942,5
SIM,1902,55,na,1957,6124
SIM,1924,21,25-29,1945,244
STAT,1898,27,30-34,1925,68.82434124636445
STAT,1848,46,na,1894,3699.5541978161455
SIM,1830,37,25-29,1867,7
STAT,1898,15,30-34,1913,4.376424495959135
STAT,1905,43,50-100,1948,0.21272698166323617
SIM,1918,31,50-100,1949,5
STAT,1901,26,40-44,1927,8.49862981425043
SIM,1860,25,35-39,1885,26
STAT,1925,40,40-44,1965,0.6131608762737958
STAT,1926,20,35-39,1946,23.236758234032017
STAT,1914,33,20-24,1947,4.938615681379755
SIM,1895,68,na,1963,4528
STAT,1852,43,35-39,1895,2.8652450370232447
SIM,1810,56,na,1866,2386
SIM,1834,32,30-34,1866,32
SIM,1897,26,15-19,1923,1
SIM,1913,31,20-24,1944,4
SIM,1878,87,na,1965,689
SIM,1924,33,25-29,1957,29
STAT,1880,38,25-29,1918,6.095318734986183
SIM,1934,6,na,1940,10847
STAT,1897,16,25-29,1913,15.335710183778875
STAT,1921,47,25-29,1968,0.12074164457310912
SIM,1868,21,25-29,1889,131
SIM,1864,17,20-24,1881,37
STAT,1856,17,20-24,1873,32.665041357791615
STAT,1925,22,40-44,1947,8.126732757118335
STAT,1817,45,na,1862,2999.306720005584
STAT,1831,49,35-39,1880,0.20881804981958038
STAT,1849,38,40-44,1887,7.012224631449176
SIM,1856,9,na,1865,4924
STAT,1843,31,25-29,1874,17.429119915300298
STAT,1786,100,na,1886,0.40193781955403785
STAT,1820,41,30-34,1861,4.785583805697627
STAT,1879,60,na,1939,4028.8734106326956
STAT,1905,31,20-24,1936,4.5518592829163635
STAT,1905,19,35-39,1924,1.5940643225579827
SIM,1838,25,25-29,1863,93
SIM,1848,26,30-34,1874,54
STAT,1861,28,na,1889,4011.8981884114646
STAT,1834,26,na,1860,3796.660175177815
SIM,1857,38,40-44,1895,10
SIM,1907,15,25-29,1922,21
SIM,1841,70,na,1911,1891
STAT,1889,26,15-19,1915,1.133702231893905
SIM,1933,22,40-44,1955,10
SIM,1859,38,45-49,1897,6
SIM,1867,41,25-29,1908,1
SIM,1911,32,na,1943,7558
STAT,1880,57,na,1937,4275.636683399711
STAT,1832,22,na,1854,3543.431452598803
STAT,1856,15,25-29,1871,10.565108655918927
STAT,1906,17,50-100,1923,0.14418036554965993
SIM,1893,64,na,1957,4559
SIM,1839,42,30-34,1881,3
SIM,1871,38,25-29,1909,8
STAT,1846,11,na,1857,4614.318402387419
STAT,1852,25,35-39,1877,18.1720570871004
SIM,1920,27,25-29,1947,165
SIM,1903,27,25-29,1930,131
SIM,1822,41,na,1863,3047
SIM,1934,20,35-39,1954,29
SIM,1924,15,25-29,1939,134
STAT,1861,87,na,1948,296.16137637524275
STAT,1878,23,35-39,1901,12.270747946150797
STAT,1942,23,25-29,1965,195.5364824843989
SIM,1838,100,na,1938,1
SIM,1886,23,35-39,1909,16
STAT,1898,33,30-34,1931,47.51756549761507
STAT,1931,21,20-24,1952,292.1535755318174
SIM,1868,28,45-49,1896,4
STAT,1884,32,25-29,1916,20.426523359217615
STAT,1916,21,25-29,1937,196.06901931708907
SIM,1913,58,na,1971,6927
SIM,1947,24,30-34,1971,78
SIM,1889,68,na,1957,3841
STAT,1867,51,30-34,1918,0.01131266761099356
STAT,1817,41,25-29,1858,3.620575283548775
STAT,1934,30,40-44,1964,10.804647829472533
SIM,1938,16,30-34,1954,27
STAT,1842,15,30-34,1857,3.083428565721134
SIM,1864,15,25-29,1879,17
STAT,1865,40,na,1905,4283.4787667207665
STAT,1839,32,na,1871,4164.414306473846
STAT,1867,33,30-34,1900,32.88437880073583
SIM,1826,34,na,1860,3341
SIM,1923,18,45-49,1941,1
STAT,1898,45,30-34,1943,0.15072331800378322
STAT,1847,27,20-24,1874,21.494143123993044
STAT,1856,50,50-100,1906,0.023871839151041123
SIM,1828,29,na,1857,3557
SIM,1938,19,na,1957,7338
STAT,1864,39,na,1903,4210.460695723829
STAT,1919,43,15-19,1962,0.0033550222067157357
SIM,1944,19,na,1963,8105
STAT,1837,20,45-49,1857,1.3336351124409014
SIM,1840,29,35-39,1869,30
STAT,1858,34,50-100,1892,1.4302032181487974
SIM,1848,44,30-34,1892,6
SIM,1769,85,na,1854,116
STAT,1886,15,40-44,1901,0.39175052842309444
STAT,1933,32,50-100,1965,2.250519311173709
SIM,1847,33,na,1880,3860
STAT,1950,15,30-34,1965,29.120448926060767
SIM,1839,36,30-34,1875,16
SIM,1889,27,30-34,1916,76
SIM,1900,17,35-39,1917,2
SIM,1849,99,na,1948,2
STAT,1886,79,na,1965,2110.797454748615
STAT,1851,23,30-34,1874,32.73770537448319
STAT,1863,14,na,1877,4772.242859092046
STAT,1910,45,20-24,1955,0.020929415482444116
SIM,1933,23,25-29,1956,295
STAT,1832,29,35-39,1861,16.593511693471033
STAT,1783,71,na,1854,1008.0
STAT,1925,23,25-29,1948,222.56468520269948
STAT,1897,18,20-24,1915,47.735291651436164
SIM,1828,30,50-100,1858,4
STAT,1916,15,25-29,1931,18.65493300527134
STAT,1856,33,25-29,1889,15.9889155973321
STAT,1848,25,50-100,1873,1.2703753124993598
STAT,1915,36,45-49,1951,1.397668843779763
SIM,1858,18,40-44,1876,1
SIM,1875,33,30-34,1908,50
SIM,1942,24,na,1966,7897
SIM,1864,76,na,1940,1655
STAT,1868,30,50-100,1898,1.774741883258925
STAT,1926,39,25-29,1965,2.4246626708572427
SIM,1846,29,50-100,1875,1
STAT,1863,38,25-29,1901,5.064887550179976
SIM,1864,33,25-29,1897,20
STAT,1876,53,30-34,1929,0.012234399078567623
SIM,1849,46,35-39,1895,2
STAT,1832,41,20-24,1873,0.25658372312217276
STAT,1931,33,20-24,1964,6.451145774585271
SIM,1915,25,30-34,1940,93
STAT,1915,18,45-49,1933,0.21061765882135464
STAT,1923,41,15-19,1964,0.0036290785559188084
STAT,1883,7,na,1890,5169.738900421471
STAT,1916,37,40-44,1953,3.0960572291187116
SIM,1849,43,30-34,1892,2
SIM,1919,20,50-100,1939,1
STAT,1941,26,45-49,1967,3.611161604196282
STAT,1805,54,50-100,1859,0.11388875258599271
STAT,1823,54,25-29,1877,0.010123669125471493
STAT,1830,47,30-34,1877,0.1670939800922234
STAT,1838,47,na,1885,3132.538788832674
SIM,1855,27,20-24,1882,22
SIM,1875,76,na,1951,1960
STAT,1924,28,35-39,1952,35.170727818723726
SIM,1835,48,na,1883,3173
STAT,1834,88,na,1922,182.44136188018246
STAT,1842,21,30-34,1863,33.690400624052465
STAT,1915,53,na,1968,7318.072326920204
SIM,1784,93,na,1877,12
SIM,1919,18,25-29,1937,122
STAT,1853,40,45-49,1893,2.3918801061700647
SIM,1831,89,na,1920,79
STAT,1873,42,20-24,1915,0.32549202627575025
SIM,1857,34,25-29,1891,24
SIM,1892,32,25-29,1924,41
STAT,1893,44,35-39,1937,0.3175510302644821
STAT,1799,55,na,1854,2208.9650133090004
STAT,1867,36,35-39,1903,13.442286204460009
STAT,1917,30,35-39,1947,19.48007949230285
SIM,1875,36,35-39,1911,20
SIM,1832,34,na,1866,3533
STAT,1934,17,35-39,1951,11.464441055418186
STAT,1860,3,na,1863,5344.220363126627
SIM,1911,37,30-34,1948,3
SIM,1881,42,20-24,1923,1
SIM,1932,28,35-39,1960,53
STAT,1926,36,20-24,1962,0.6511335867389457
SIM,1940,20,na,1960,7727
SIM,1858,32,50-100,1890,1
STAT,1892,42,na,1934,5836.303705883977
SIM,1843,74,na,1917,1582
SIM,1942,17,35-39,1959,10
SIM,1886,21,45-49,1907,2
SIM,1924,37,40-44,1961,5
SIM,1793,67,na,1860,1501
STAT,1863,53,20-24,1916,0.0012836219352774616
SIM,1871,21,na,1892,4609
STAT,1852,14,na,1866,4560.076268838367
STAT,1899,40,20-24,1939,0.03082476887372002
STAT,1806,51,20-24,1857,0.004393168225603938
SIM,1825,41,25-29,1866,6
STAT,1843,47,40-44,1890,0.2387019401385693
STAT,1951,15,45-49,1966,1.2019267198559407
SIM,1929,42,na,1971,9946
STAT,1863,54,na,1917,3701.9079832682273
STAT,1876,38,50-100,1914,2.5518620918979327
STAT,1926,40,25-29,1966,0.17825625014619154
STAT,1843,29,40-44,1872,5.09032940633558
SIM,1880,47,30-34,1927,1
STAT,1857,47,35-39,1904,0.21936011280046608
STAT,1846,73,na,1919,1819.2915904977403
STAT,1921,29,25-29,1950,147.0583806592124
STAT,1887,44,50-100,1931,2.3540951355959927
STAT,1939,18,30-34,1957,24.63566405453797
SIM,1947,18,30-34,1965,27
SIM,1850,21,30-34,1871,41
SIM,1902,31,45-49,1933,9
STAT,1867,13,na,1880,5049.465673759109
STAT,1843,100,na,1943,1.4871711817539057
STAT,1849,34,25-29,1883,16.721686420587172
SIM,1923,17,na,1940,9184
STAT,1862,42,45-49,1904,2.5803214173390674
STAT,1896,17,50-100,1913,0.13063333223834644
SIM,1816,41,na,1857,3023
STAT,1827,49,50-100,1876,0.43186394686557805
STAT,1865,25,15-19,1890,0.8381061906537535
SIM,1938,19,35-39,1957,9
STAT,1879,20,45-49,1899,1.4818650725851883
SIM,1914,43,na,1957,7550
SIM,1851,29,40-44,1880,7
STAT,1821,59,na,1880,2320.8490159590624
STAT,1841,53,30-34,1894,0.008498059899827406
STAT,1857,29,35-39,1886,15.421370611803605
STAT,1911,28,25-29,1939,129.21847808930352
STAT,1913,40,15-19,1953,0.0030595838584550807
STAT,1851,29,na,1880,3870.259443511355
STAT,1944,6,na,1950,8624.076953281774
SIM,1812,42,na,1854,2955
STAT,1857,24,50-100,1881,0.6647384537752759
STAT,1917,23,50-100,1940,1.4078917819058854
SIM,1847,17,15-19,1864,11
SIM,1896,13,na,1909,7186
STAT,1852,22,30-34,1874,33.72527781734062
STAT,1932,22,50-100,1954,1.7437658528708957
STAT,1849,87,na,1936,278.6824555742537
STAT,1861,45,35-39,1906,0.2376874260805057
SIM,1901,33,na,1934,6713
STAT,1901,29,45-49,1930,3.116799912818794
STAT,1848,24,30-34,1872,35.053583794461154
STAT,1799,58,na,1857,2081.5433300276545
STAT,1827,50,45-49,1877,0.026321349232659476
STAT,1851,50,20-24,1901,0.0011603482737490018
STAT,1961,1,na,1962,10272.06972472807
STAT,1871,48,30-34,1919,0.19179013903065006
STAT,1919,49,50-100,1968,0.4924515990915436
STAT,1835,52,30-34,1887,0.007860357551328733
SIM,1860,22,30-34,1882,42
SIM,1898,35,25-29,1933,10
STAT,1929,17,30-34,1946,31.412958226728097
SIM,1810,49,45-49,1859,1
SIM,1934,3,na,1937,10954
SIM,1908,28,20-24,1936,38
SIM,1937,17,30-34,1954,30
STAT,1868,54,na,1922,4023.5936375603765
SIM,1896,5,na,1901,7305
STAT,1847,28,50-100,1875,1.163617100880569
SIM,1952,16,15-19,1968,122
SIM,1888,16,25-29,1904,21
STAT,1903,37,30-34,1940,3.3078817534080973
STAT,1878,20,30-34,1898,37.79563366900694
STAT,1908,22,40-44,1930,6.247029167350975
STAT,1826,53,35-39,1879,0.016232033991280745
SIM,1940,22,50-100,1962,6
SIM,1951,20,35-39,1971,34
STAT,1872,47,30-34,1919,0.195562886859608
STAT,1944,16,15-19,1960,98.65846100109584
STAT,1858,42,25-29,1900,1.0097790647012066
SIM,1896,22,45-49,1918,2
STAT,1913,38,30-34,1951,3.6154219661663136
STAT,1939,3,na,1942,8182.829810284172
SIM,1865,29,35-39,1894,27
STAT,1907,25,30-34,1932,75.25612561509675
SIM,1811,97,na,1908,1
STAT,1893,26,35-39,1919,24.784844293870115
SIM,1872,62,na,1934,3747
SIM,1887,61,na,1948,4465
STAT,1817,85,na,1902,276.49895981058086
STAT,1922,26,50-100,1948,2.2818830968905863
STAT,1858,39,na,1897,3671.961234900773
STAT,1873,17,20-24,1890,36.37994140047794
SIM,1824,31,30-34,1855,11
SIM,1834,35,35-39,1869,14
SIM,1829,31,45-49,1860,4
SIM,1881,17,20-24,1898,21
SIM,1824,46,35-39,1870,1
STAT,1934,35,35-39,1969,6.7537480932262275
STAT,1943,20,35-39,1963,20.245647147514934
SIM,1891,22,30-34,1913,52
STAT,1899,22,20-24,1921,190.69042629298298
STAT,1888,40,45-49,1928,3.6086261754494284
STAT,1837,22,35-39,1859,10.649602953764736
SIM,1845,22,35-39,1867,14
SIM,1855,51,50-100,1906,1
STAT,1902,43,na,1945,6565.133880798394
STAT,1761,104,na,1865,0.004969464330658611
STAT,1883,37,35-39,1920,14.034609746752697
STAT,1814,42,15-19,1856,0.07974975113861121
STAT,1888,22,45-49,1910,1.6645520090015584
SIM,1921,38,30-34,1959,8
STAT,1826,35,35-39,1861,17.93900109720219
SIM,1888,34,25-29,1922,8
SIM,1820,49,na,1869,2730
SIM,1907,30,20-24,1937,2
STAT,1853,55,na,1908,3271.5394159122534
STAT,1912,38,50-100,1950,0.8237254871704274
STAT,1918,44,45-49,1962,0.3561234854162703
SIM,1891,37,35-39,1928,29
STAT,1905,54,na,1959,6269.51164909643
SIM,1921,22,15-19,1943,11
STAT,1839,17,15-19,1856,12.121765576169334
SIM,1864,100,na,1964,7
SIM,1920,38,50-100,1958,3
STAT,1881,33,15-19,1914,0.2768182301807766
STAT,1883,22,30-34,1905,35.34443914419879
STAT,1866,34,30-34,1900,32.25727052816264
SIM,1829,70,na,1899,1745
SIM,1837,31,40-44,1868,13
STAT,1871,80,na,1951,1241.2227469469672
SIM,1848,36,50-100,1884,6
STAT,1875,24,25-29,1899,118.28858071876778
SIM,1806,82,na,1888,271
SIM,1933,25,45-49,1958,6
SIM,1807,67,na,1874,1430
STAT,1884,48,40-44,1932,0.33712916147845723
SIM,1823,82,na,1905,493
STAT,1923,45,30-34,1968,0.21153939790603646
STAT,1945,23,na,1968,8079.859493229557
STAT,1901,36,na,1937,6746.092483290015
STAT,1822,52,20-24,1874,0.002207294086414693
SIM,1847,36,na,1883,3699
STAT,1852,40,30-34,1892,1.8508420972016584
SIM,1805,97,na,1902,3
STAT,1832,107,na,1939,0.006148273190949285
STAT,1870,20,25-29,1890,114.18541302562173
STAT,1914,42,50-100,1956,0.23514200258553078
STAT,1931,36,25-29,1967,2.6360472330371443
STAT,1908,24,50-100,1932,1.2148575598198714
STAT,1920,21,45-49,1941,2.53333834417909
STAT,1934,20,na,1954,9945.313275608301
STAT,1877,53,45-49,1930,0.029946164349933423
SIM,1938,29,45-49,1967,6
SIM,1865,21,na,1886,4516
STAT,1850,28,40-44,1878,5.3662436015028465
STAT,1820,44,35-39,1864,6.921831870392264
STAT,1875,79,na,1954,1453.6856051837804
STAT,1875,46,40-44,1921,0.35699569682815907
STAT,1917,7,na,1924,8658.327514355982
STAT,1908,45,35-39,1953,0.23910860730816633
STAT,1880,54,na,1934,4455.046407655765
STAT,1844,49,15-19,1893,6.324778088364633E-4
STAT,1918,26,15-19,1944,1.5222645466185476
STAT,1875,39,na,1914,4849.599538745291
SIM,1847,30,20-24,1877,6
SIM,1883,28,40-44,1911,9
SIM,1907,25,50-100,1932,3
SIM,1839,39,35-39,1878,19
SIM,1863,51,na,1914,4026
SIM,1871,35,20-24,1906,1
STAT,1831,46,30-34,1877,0.15004433620551247
SIM,1870,42,45-49,1912,5
STAT,1939,20,15-19,1959,10.805532142907625
SIM,1881,17,na,1898,4375
STAT,1908,27,35-39,1935,28.92642372634524
STAT,1799,110,na,1909,1.8792696838836656E-4
SIM,1873,25,15-19,1898,1
SIM,1874,34,30-34,1908,42
STAT,1861,38,50-100,1899,2.053609216048223
STAT,1942,27,40-44,1969,9.88021388570978
SIM,1916,24,50-100,1940,7
STAT,1829,31,40-44,1860,8.55594894839731
STAT,1896,22,40-44,1918,5.5563268741865395
SIM,1878,8,na,1886,5782
SIM,1883,46,40-44,1929,1
STAT,1927,38,25-29,1965,2.469469891840776
SIM,1847,49,40-44,1896,1
SIM,1832,22,25-29,1854,113
STAT,1839,30,20-24,1869,5.3029688150110585
STAT,1868,51,45-49,1919,0.028019410421187777
SIM,1862,43,50-100,1905,6
SIM,1916,27,35-39,1943,35
STAT,1820,34,na,1854,3056.543485299495
STAT,1905,46,25-29,1951,0.09516909648024016
SIM,1881,76,na,1957,1556
SIM,1916,45,35-39,1961,1
STAT,1887,64,na,1951,3926.5912474996135
STAT,1900,42,25-29,1942,0.12477819500675864
SIM,1851,47,40-44,1898,1
STAT,1834,45,40-44,1879,0.27247948904301744
STAT,1941,16,35-39,1957,8.731813338681759
STAT,1856,19,40-44,1875,0.33304299519882785
SIM,1920,43,na,1963,8455
SIM,1855,21,45-49,1876,2
SIM,1933,20,20-24,1953,302
STAT,1839,49,40-44,1888,0.2654708025481526
SIM,1911,2,na,1913,8356
STAT,1909,13,na,1922,7813.867954776469
SIM,1922,19,50-100,1941,2
SIM,1868,25,40-44,1893,6
SIM,1863,21,40-44,1884,5
SIM,1852,11,na,1863,4762
STAT,1809,59,na,1868,2269.25307614289
SIM,1934,36,20-24,1970,1
STAT,1925,43,45-49,1968,0.40621743437997054
SIM,1874,22,25-29,1896,124
STAT,1776,106,na,1882,0.02522556517312547
STAT,1822,34,20-24,1856,12.872723626530867
STAT,1822,63,na,1885,2079.0851961251524
SIM,1897,25,50-100,1922,5
STAT,1921,19,15-19,1940,103.89132956077883
SIM,1911,33,45-49,1944,5
SIM,1906,28,50-100,1934,1
SIM,1903,24,20-24,1927,201
SIM,1947,20,15-19,1967,15
STAT,1842,36,35-39,1878,12.48173441250596
STAT,1865,20,20-24,1885,129.8361747714153
SIM,1825,89,na,1914,75
SIM,1850,36,35-39,1886,16
SIM,1902,58,na,1960,5990
STAT,1881,17,50-100,1898,0.09563612908868914
STAT,1938,29,40-44,1967,9.318332182728387
STAT,1821,41,45-49,1862,4.895627651023315
SIM,1825,39,40-44,1864,13
SIM,1878,28,na,1906,5169
STAT,1847,21,45-49,1868,1.3125047477836027
STAT,1940,20,na,1960,7518.8390036290475
STAT,1918,44,15-19,1962,0.0032860300846039455
SIM,1860,77,na,1937,1599
STAT,1803,93,na,1896,20.625172100902155
SIM,1812,82,na,1894,414
SIM,1830,34,20-24,1864,5
SIM,1799,55,na,1854,2063
STAT,1875,28,40-44,1903,6.2069050312257446
STAT,1811,60,na,1871,2214.269461771837
STAT,1866,22,25-29,1888,107.54705730172475
STAT,1869,79,na,1948,1368.106705333893
STAT,1921,32,20-24,1953,5.4807447710430175
STAT,1827,44,na,1871,3160.830185546436
SIM,1821,56,na,1877,2436
STAT,1815,50,50-100,1865,0.0809194893959079
STAT,1855,21,40-44,1876,3.697472040469742
STAT,1925,20,20-24,1945,270.35824477559504
SIM,1839,20,15-19,1859,6
SIM,1842,45,40-44,1887,1
STAT,1925,25,45-49,1950,4.148162627978299
STAT,1817,39,40-44,1856,27.305099684055914
SIM,1859,21,na,1880,4360
SIM,1934,18,20-24,1952,322
STAT,1950,18,35-39,1968,10.016553490552697
STAT,1903,39,50-100,1942,0.7543474543042931
STAT,1886,18,45-49,1904,0.1388989576941783
SIM,1884,28,na,1912,5106
STAT,1898,67,na,1965,4826.966963376927
STAT,1903,33,45-49,1936,2.867157883435272
SIM,1820,100,na,1920,1
SIM,1873,20,20-24,1893,138
SIM,1957,7,na,1964,10325
STAT,1862,69,na,1931,2533.2752127948143
STAT,1916,2,na,1918,8734.798983947687
SIM,1924,19,40-44,1943,5
STAT,1844,30,25-29,1874,20.195262649861835
STAT,1889,25,50-100,1914,1.603790321796572
STAT,1916,19,40-44,1935,0.5961201983874841
SIM,1850,18,35-39,1868,1
SIM,1830,52,20-24,1882,1
STAT,1919,47,30-34,1966,0.19523766976287726
STAT,1926,18,20-24,1944,334.76903590869875
SIM,1882,25,25-29,1907,95
SIM,1800,57,na,1857,2125
STAT,1842,18,35-39,1860,1.0428615870885793
STAT,1890,45,25-29,1935,0.14340858964853714
STAT,1922,35,na,1957,8658.421921311363
STAT,1867,54,35-39,1921,0.015835603939050272
STAT,1886,33,35-39,1919,21.499211951923325
STAT,1889,43,30-34,1932,2.842260352892607
STAT,1857,40,15-19,1897,0.021958749718440307
STAT,1872,44,50-100,1916,2.1153788549884345
SIM,1855,7,na,1862,5199
STAT,1849,38,50-100,1887,1.9666938930683215
SIM,1834,94,na,1928,8
STAT,1883,50,50-100,1933,0.03039863623530411
STAT,1884,21,50-100,1905,0.8156996268648211
STAT,1913,29,35-39,1942,30.004355402027873
SIM,1939,18,40-44,1957,4
SIM,1838,84,na,1922,392
SIM,1893,34,50-100,1927,4
STAT,1941,23,40-44,1964,7.015612654540169
SIM,1836,42,45-49,1878,6
SIM,1876,24,na,1900,5048
STAT,1878,46,20-24,1924,0.025383473491684766
STAT,1850,53,40-44,1903,0.015882553940594377
SIM,1940,16,25-29,1956,106
STAT,1852,50,40-44,1902,0.01702019786612888
STAT,1915,26,35-39,1941,31.036110324827046
SIM,1834,29,40-44,1863,5
STAT,1870,24,40-44,1894,4.105966956663626
STAT,1855,43,15-19,1898,0.020673886607159953
SIM,1797,97,na,1894,2
SIM,1919,15,20-24,1934,70
SIM,1827,42,35-39,1869,6
SIM,1949,21,25-29,1970,248
STAT,1798,70,na,1868,1287.871163538854
SIM,1848,16,20-24,1864,35
STAT,1850,21,20-24,1871,127.7375648585512
STAT,1904,29,25-29,1933,121.7444147686574
SIM,1881,33,25-29,1914,22
SIM,1878,25,na,1903,5231
STAT,1819,42,35-39,1861,8.383812246004213
SIM,1860,43,35-39,1903,4
STAT,1932,23,30-34,1955,75.93232604864822
SIM,1869,49,25-29,1918,1
SIM,1814,42,25-29,1856,2
SIM,1899,22,30-34,1921,64
STAT,1860,40,20-24,1900,0.26309472865737843
SIM,1865,86,na,1951,322
SIM,1894,33,35-39,1927,40
SIM,1917,18,20-24,1935,2
SIM,1878,32,40-44,1910,12
SIM,1879,22,45-49,1901,4
STAT,1853,27,45-49,1880,2.0350853961797437
SIM,1921,29,35-39,1950,40
STAT,1923,45,na,1968,8717.7658999075
STAT,1929,39,40-44,1968,3.8728261876032724
STAT,1832,33,50-100,1865,1.5403923158901935
STAT,1828,42,45-49,1870,2.818030671068495
STAT,1874,17,35-39,1891,1.1346837642610563
SIM,1882,17,35-39,1899,1
SIM,1903,65,na,1968,5671
SIM,1872,34,na,1906,5018
SIM,1864,39,na,1903,4452
STAT,1921,37,15-19,1958,0.04329432442248647
SIM,1783,77,na,1860,696
SIM,1778,90,na,1868,37
STAT,1895,33,45-49,1928,4.569729769842573
SIM,1829,48,na,1877,3031
SIM,1895,39,25-29,1934,9
SIM,1900,39,45-49,1939,5
SIM,1913,0,na,1913,8895
STAT,1929,36,na,1965,9762.760966019025
STAT,1810,44,40-44,1854,15.807010549822067
STAT,1901,20,35-39,1921,16.5974981890774
SIM,1872,27,20-24,1899,28
SIM,1873,81,na,1954,942
STAT,1918,0,na,1918,9901.656130469326
SIM,1832,24,15-19,1856,7
SIM,1888,43,20-24,1931,1
STAT,1841,36,na,1877,3699.5919347643517
STAT,1821,81,na,1902,599.4083200430631
STAT,1864,27,20-24,1891,21.17890037286824
STAT,1931,40,na,1971,10048.568229100953
SIM,1890,17,30-34,1907,5
STAT,1872,21,40-44,1893,4.242360718234299
SIM,1874,49,35-39,1923,1
STAT,1899,17,40-44,1916,0.506118124361964
SIM,1935,34,45-49,1969,6
SIM,1828,48,25-29,1876,1
STAT,1920,3,na,1923,9188.488239023485
SIM,1853,32,35-39,1885,21
STAT,1930,19,25-29,1949,112.54240840461837
SIM,1879,72,na,1951,2402
STAT,1949,16,35-39,1965,9.858348661184529
SIM,1935,16,15-19,1951,116
STAT,1892,20,15-19,1912,8.390675534032225
SIM,1855,37,30-34,1892,16
SIM,1924,33,na,1957,9212
STAT,1886,40,40-44,1926,4.843713490153758
STAT,1866,49,35-39,1915,0.2554400364445727
SIM,1838,21,45-49,1859,2
SIM,1915,31,25-29,1946,27
STAT,1929,31,45-49,1960,4.038737286542175
STAT,1950,18,50-100,1968,0.8943349673860529
SIM,1861,27,45-49,1888,3
STAT,1839,42,20-24,1881,0.26135495352492305
STAT,1851,48,45-49,1899,0.36124626764817336
STAT,1932,16,25-29,1948,116.18374057621976
STAT,1838,53,25-29,1891,0.0047168111602262
STAT,1937,31,na,1968,7562.877756408649
STAT,1760,111,na,1871,3.081078567593523E-4
SIM,1899,15,25-29,1914,23
SIM,1915,50,na,1965,7471
STAT,1883,46,30-34,1929,0.19262300693725767
STAT,1915,16,na,1931,8184.69019686053
SIM,1911,60,na,1971,6699
STAT,1869,43,45-49,1912,2.907677089093745
SIM,1857,57,na,1914,3577
STAT,1875,54,25-29,1929,0.00716255495682734
SIM,1894,40,40-44,1934,9
STAT,1833,31,30-34,1864,29.926469283594656
STAT,1849,16,30-34,1865,3.1217592928870985
STAT,1813,100,na,1913,0.9433786752680364
STAT,1848,27,35-39,1875,18.88778290487142
STAT,1843,53,35-39,1896,0.011866090872266465
SIM,1830,39,na,1869,3091
SIM,1889,17,20-24,1906,46
STAT,1927,16,15-19,1943,114.22695499630865
SIM,1785,78,na,1863,446
STAT,1864,40,20-24,1904,0.2895996476912614
SIM,1937,31,45-49,1968,1
STAT,1909,16,na,1925,7672.357518182383
SIM,1929,37,25-29,1966,4
STAT,1913,21,na,1934,7492.737883104317
SIM,1841,31,30-34,1872,43
STAT,1843,37,na,1880,3502.5602617277536
SIM,1827,41,50-100,1868,3
STAT,1927,35,50-100,1962,1.0559180777807657
STAT,1949,23,40-44,1972,7.920732262322586
SIM,1923,26,35-39,1949,7
SIM,1940,23,30-34,1963,84
STAT,1766,100,na,1866,0.24693384977344632
STAT,1868,35,40-44,1903,8.491372092493819
STAT,1923,11,na,1934,9407.593442001107
STAT,1940,18,40-44,1958,2.8674899555796753
SIM,1910,13,na,1923,8263
STAT,1852,73,na,1925,1893.0523407308408
SIM,1849,21,20-24,1870,133
SIM,1876,35,40-44,1911,15
STAT,1822,69,na,1891,1656.9787823485399
SIM,1877,71,na,1948,2548
STAT,1831,27,25-29,1858,73.73427275921557
STAT,1852,19,40-44,1871,0.34843255624641556
STAT,1935,30,na,1965,10581.462942340846
SIM,1840,16,20-24,1856,38
STAT,1845,32,35-39,1877,18.554600179216145
SIM,1860,19,40-44,1879,1
SIM,1865,52,na,1917,3999
STAT,1847,37,30-34,1884,8.429113519833706
STAT,1812,79,na,1891,662.6863077904533
STAT,1898,27,50-100,1925,1.7483354194163025
STAT,1809,81,na,1890,480.63903968569855
SIM,1932,21,15-19,1953,12
STAT,1881,51,45-49,1932,0.028464957185055813
STAT,1878,19,50-100,1897,0.10278441936727793
STAT,1878,1,na,1879,7243.718488452728
STAT,1879,38,20-24,1917,1.6203237652886893
STAT,1889,18,25-29,1907,14.074501289217729
STAT,1890,49,40-44,1939,0.2330921471105477
SIM,1931,18,40-44,1949,4
STAT,1847,21,na,1868,4024.402758209401
SIM,1853,47,50-100,1900,2
STAT,1923,18,40-44,1941,3.307322846894012
STAT,1830,64,na,1894,2400.469804772115
STAT,1870,46,20-24,1916,0.02386148329069126
SIM,1922,20,45-49,1942,5
STAT,1792,85,na,1877,177.73874837438163
STAT,1864,51,45-49,1915,0.026324752984431727
STAT,1905,26,na,1931,6994.431885327531
STAT,1861,56,na,1917,3428.641901955306
SIM,1880,28,25-29,1908,101
STAT,1827,78,na,1905,944.8143762287378
STAT,1882,5,na,1887,5237.013986417729
STAT,1892,48,na,1940,5617.834290311702
SIM,1905,33,20-24,1938,1
STAT,1854,38,15-19,1892,0.08565725111289656
STAT,1942,18,na,1960,7766.19978678323
STAT,1956,16,50-100,1972,1.001367718482054
SIM,1850,45,30-34,1895,1
STAT,1776,103,na,1879,0.10250007695314652
SIM,1930,24,15-19,1954,12
STAT,1823,32,15-19,1855,0.8156110488707079
SIM,1882,22,20-24,1904,149
SIM,1905,60,na,1965,6093
STAT,1889,22,na,1911,5889.521738381261
SIM,1888,49,na,1937,5173
SIM,1880,69,na,1949,3266
STAT,1839,35,15-19,1874,0.1069790501409958
STAT,1894,41,45-49,1935,3.900447615212395
STAT,1879,51,20-24,1930,0.0015662962610227282
STAT,1910,44,45-49,1954,0.31387894206564043
STAT,1885,32,na,1917,4797.191992307321
STAT,1909,20,35-39,1929,17.78926564274895
STAT,1818,44,40-44,1862,10.292094814621363
STAT,1878,84,na,1962,1101.2142329306869
STAT,1950,21,25-29,1971,221.36609094235277
STAT,1919,46,na,1965,8065.95774110816
SIM,1908,38,50-100,1946,1
STAT,1963,2,na,1965,10094.967155305985
SIM,1874,69,na,1943,2681
SIM,1835,34,40-44,1869,13
SIM,1901,70,na,1971,4787
SIM,1823,51,na,1874,2740
STAT,1867,36,50-100,1903,2.333359657019648
STAT,1848,42,30-34,1890,1.8827984382181404
STAT,1927,34,45-49,1961,3.9037077048307527
STAT,1872,28,25-29,1900,85.55867714393644
SIM,1859,52,na,1911,3768
STAT,1890,23,15-19,1913,8.107478899204006
STAT,1915,31,15-19,1946,0.26542332598099216
STAT,1840,32,15-19,1872,0.2503669768035978
STAT,1858,21,20-24,1879,125.3853798963349
STAT,1818,47,50-100,1865,1.0827192403817227
SIM,1779,78,na,1857,599
SIM,1858,24,35-39,1882,14
STAT,1851,51,35-39,1902,0.013409467639691806
SIM,1813,92,na,1905,25
SIM,1877,40,40-44,1917,10
SIM,1873,1,na,1874,7076
SIM,1897,18,25-29,1915,20
STAT,1929,30,na,1959,9712.359926535197
SIM,1896,28,20-24,1924,33
STAT,1907,31,25-29,1938,17.52918457693564
SIM,1913,46,50-100,1959,1
SIM,1868,43,35-39,1911,5
STAT,1837,45,20-24,1882,0.017816493252583113
STAT,1881,70,na,1951,2738.914884242524
SIM,1866,21,20-24,1887,123
STAT,1815,81,na,1896,502.64044952349275
SIM,1886,54,na,1940,4294
SIM,1840,94,na,1934,22
STAT,1820,48,15-19,1868,0.0014670390751685026
SIM,1931,20,50-100,1951,3
SIM,1932,31,25-29,1963,29
SIM,1800,94,na,1894,12
STAT,1901,29,50-100,1930,1.7957196924411787
STAT,1839,45,25-29,1884,0.09401382464834708
STAT,1914,28,40-44,1942,9.458001576834878
STAT,1811,52,45-49,1863,0.09397422291258344
STAT,1921,37,50-100,1958,0.9465712461442399
SIM,1799,92,na,1891,11
SIM,1856,17,25-29,1873,6
SIM,1875,2,na,1877,6995
SIM,1856,42,30-34,1898,4
STAT,1823,103,na,1926,0.1722182319083725
SIM,1862,32,45-49,1894,2
SIM,1877,19,20-24,1896,37
STAT,1888,28,20-24,1916,27.90516511976254
STAT,1809,87,na,1896,156.59193953700736
STAT,1824,31,20-24,1855,14.362255214718761
SIM,1917,20,35-39,1937,1
STAT,1835,36,na,1871,3465.047244272476
STAT,1890,41,45-49,1931,3.7061453097917227
STAT,1812,49,50-100,1861,1.649004412506989
STAT,1840,88,na,1928,198.16067347175087
STAT,1870,39,15-19,1909,0.11022415948482
STAT,1890,30,20-24,1920,6.717023151096669
STAT,1911,26,na,1937,7405.758749352838
STAT,1827,34,40-44,1861,9.71299402812982
STAT,1891,15,15-19,1906,14.883738512283935
STAT,1879,44,15-19,1923,0.028779168937402677
SIM,1811,66,na,1877,1638
STAT,1869,19,20-24,1888,34.76095474125919
STAT,1853,21,na,1874,4026.0032408191905
SIM,1898,17,30-34,1915,5
STAT,1903,39,20-24,1942,0.4736235578606922
SIM,1791,72,na,1863,914
SIM,1905,28,40-44,1933,1
SIM,1871,28,15-19,1899,1
STAT,1824,64,na,1888,1887.9969987429733
STAT,1803,96,na,1899,6.059842725725582
STAT,1863,35,20-24,1898,1.3757267913913853
STAT,1928,15,20-24,1943,346.5603132837091
STAT,1863,28,15-19,1891,0.7992776283694859
STAT,1863,19,50-100,1882,0.08888197039136583
STAT,1894,25,40-44,1919,7.824407078082703
SIM,1912,48,na,1960,7307
SIM,1916,9,na,1925,8646
SIM,1919,44,50-100,1963,2
SIM,1877,33,35-39,1910,26
STAT,1925,46,na,1971,9011.353406318129
SIM,1922,28,40-44,1950,19
STAT,1891,22,20-24,1913,172.03191591548622
STAT,1924,31,25-29,1955,21.784590743293368
STAT,1889,49,50-100,1938,0.3377907919561051
SIM,1859,45,50-100,1904,2
STAT,1848,17,25-29,1865,11.518531957573563
STAT,1845,42,45-49,1887,2.3484729276089262
STAT,1840,50,45-49,1890,0.021248832736039037
STAT,1854,32,45-49,1886,2.7375768065967523
SIM,1776,95,na,1871,5
SIM,1920,20,40-44,1940,11
SIM,1785,72,na,1857,865
SIM,1911,39,20-24,1950,1
SIM,1912,29,25-29,1941,144
STAT,1838,37,20-24,1875,1.25886656711211
STAT,1933,21,25-29,1954,248.2239320777066
STAT,1916,29,50-100,1945,2.063636956620843
SIM,1854,43,na,1897,3832
STAT,1858,16,40-44,1874,0.3383754947401281
STAT,1830,29,30-34,1859,52.435469102996684
STAT,1834,53,25-29,1887,0.004739640246248421
STAT,1839,52,30-34,1891,0.00924500022626921
STAT,1902,47,20-24,1949,0.01921077993696619
SIM,1852,34,40-44,1886,10
STAT,1896,44,15-19,1940,0.0025225436507846097
STAT,1923,23,20-24,1946,260.40686161064343
SIM,1866,16,40-44,1882,3
STAT,1900,15,35-39,1915,1.5444194020941053
SIM,1931,23,20-24,1954,264
STAT,1884,51,30-34,1935,0.011927791876587528
STAT,1844,34,40-44,1878,8.202793231382545
STAT,1810,44,na,1854,2698.47471994669
STAT,1936,18,na,1954,7099.7995611096685
SIM,1871,86,na,1957,377
STAT,1892,49,45-49,1941,0.32954853831535913
SIM,1899,25,35-39,1924,3
SIM,1941,21,25-29,1962,215
SIM,1892,54,na,1946,5946
SIM,1832,31,20-24,1863,7
SIM,1856,22,50-100,1878,2
SIM,1909,32,50-100,1941,1
STAT,1912,20,40-44,1932,6.548496942534453
STAT,1869,33,35-39,1902,19.734423655044875
STAT,1914,20,45-49,1934,2.241505368386902
SIM,1884,36,45-49,1920,4
SIM,1819,42,45-49,1861,6
STAT,1883,30,15-19,1913,0.28484713957067337
STAT,1859,18,na,1877,4257.971174975113
SIM,1909,41,40-44,1950,2
STAT,1915,23,30-34,1938,59.82135511821635
SIM,1874,16,30-34,1890,3
STAT,1878,49,25-29,1927,0.11895898026112826
SIM,1853,42,45-49,1895,7
STAT,1938,13,na,1951,7882.839979752422
SIM,1900,36,40-44,1936,1
STAT,1836,110,na,1946,3.6741446941808935E-4
STAT,1878,33,45-49,1911,3.6627231422929447
STAT,1941,30,na,1971,8029.028643809565
SIM,1921,26,30-34,1947,111
SIM,1883,71,na,1954,2636
SIM,1886,33,45-49,1919,5
STAT,1843,16,50-100,1859,0.08822237583916018
STAT,1892,30,25-29,1922,26.104492931717733
SIM,1915,41,35-39,1956,1
STAT,1884,44,25-29,1928,1.2633486445260471
STAT,1898,33,na,1931,6494.47462950137
STAT,1857,17,35-39,1874,1.0152347997614903
STAT,1836,42,35-39,1878,2.864831128981716
STAT,1897,57,na,1954,5425.284099819458
STAT,1920,42,50-100,1962,0.26198308341299825
STAT,1939,19,45-49,1958,1.0093047772618444
SIM,1841,42,na,1883,3434
STAT,1831,24,20-24,1855,135.27503379098607
STAT,1866,16,30-34,1882,3.066673655951374
SIM,1817,45,45-49,1862,1
STAT,1836,89,na,1925,139.67739449131764
STAT,1913,26,30-34,1939,79.14011338792878
SIM,1845,32,na,1877,4124
SIM,1900,23,na,1923,6909
SIM,1849,16,40-44,1865,1
STAT,1823,50,45-49,1873,0.04491478609979523
STAT,1849,26,40-44,1875,5.65752326174345
STAT,1858,19,45-49,1877,0.11872552379860048
STAT,1897,36,15-19,1933,0.15232685487538217
STAT,1900,22,40-44,1922,5.838049932647992
SIM,1810,50,na,1860,2677
SIM,1870,30,45-49,1900,8
SIM,1863,57,na,1920,3694
STAT,1864,43,25-29,1907,1.1509177201386405
SIM,1928,41,45-49,1969,1
STAT,1876,36,45-49,1912,4.184156215393997
STAT,1894,43,na,1937,5973.516168508384
SIM,1912,19,15-19,1931,16
STAT,1929,29,30-34,1958,98.93047176571922
SIM,1881,30,20-24,1911,2
STAT,1836,27,45-49,1863,1.9106398304530914
STAT,1852,53,45-49,1905,0.02275865649493964
SIM,1867,16,na,1883,5269
SIM,1860,36,50-100,1896,4
STAT,1921,16,na,1937,8492.218075264303
STAT,1940,23,20-24,1963,228.70991993206536
STAT,1938,18,50-100,1956,0.7462863454726485
STAT,1852,36,50-100,1888,1.987942058255895
STAT,1932,26,35-39,1958,39.73597152406047
SIM,1828,60,na,1888,2388
SIM,1904,44,50-100,1948,1
SIM,1807,92,na,1899,25
SIM,1860,40,30-34,1900,3
SIM,1871,45,50-100,1916,1
STAT,1766,99,na,1865,0.40336804497606316
SIM,1844,42,35-39,1886,5
STAT,1818,95,na,1913,13.640463573096163
STAT,1811,91,na,1902,53.866226635716664
SIM,1848,39,50-100,1887,7
SIM,1940,26,35-39,1966,43
STAT,1791,66,na,1857,1537.97180161888
STAT,1904,19,15-19,1923,17.11046336756673
SIM,1937,29,30-34,1966,88
STAT,1817,103,na,1920,0.14475290060593524
STAT,1873,30,20-24,1903,5.591414436671925
STAT,1817,53,25-29,1870,0.01607131537537296
STAT,1860,50,30-34,1910,0.009902967976222454
STAT,1886,43,45-49,1929,3.167701632380695
SIM,1882,24,na,1906,4918
SIM,1916,15,35-39,1931,1
STAT,1872,99,na,1971,28.477072231307627
STAT,1853,92,na,1945,65.89776322746717
STAT,1883,49,35-39,1932,0.27199805673650546
SIM,1829,37,20-24,1866,2
SIM,1949,16,45-49,1965,2
SIM,1872,43,25-29,1915,1
STAT,1887,32,40-44,1919,9.795743456556195
STAT,1822,37,25-29,1859,11.532457683914458
STAT,1862,17,45-49,1879,0.12914386171334355
STAT,1920,39,20-24,1959,0.5815311763382706
SIM,1895,36,20-24,1931,2
STAT,1844,19,na,1863,4656.8131969450715
STAT,1866,40,25-29,1906,1.2087212063532127
STAT,1859,46,na,1905,3626.8628967608183
SIM,1836,32,35-39,1868,30
SIM,1858,46,45-49,1904,1
STAT,1809,45,45-49,1854,1.8968156956359163
STAT,1810,47,45-49,1857,1.5394188136305358
STAT,1802,52,35-39,1854,0.05518814627856522
SIM,1865,17,35-39,1882,1
SIM,1878,39,25-29,1917,9
SIM,1838,59,na,1897,2690
STAT,1858,54,25-29,1912,0.005423256896613978
STAT,1923,33,30-34,1956,36.44350778516319
STAT,1895,23,35-39,1918,15.30937502217444
STAT,1862,32,35-39,1894,17.481353905686213
SIM,1904,13,na,1917,7591
STAT,1831,77,na,1908,1116.058278828925
SIM,1822,32,50-100,1854,4
STAT,1829,53,50-100,1882,0.020537015280545336
SIM,1907,27,na,1934,7128
STAT,1843,50,30-34,1893,0.008458263645904405
STAT,1861,50,na,1911,3671.5066002767985
SIM,1868,40,30-34,1908,3
STAT,1912,35,50-100,1947,0.8356935479334935
STAT,1857,21,50-100,1878,0.7464450807153858
STAT,1887,36,20-24,1923,1.7495682511578188
STAT,1906,36,35-39,1942,4.514404911202622
STAT,1908,15,35-39,1923,1.6526122871183682
SIM,1898,23,25-29,1921,180
SIM,1923,23,30-34,1946,90
SIM,1895,32,40-44,1927,17
SIM,1899,2,na,1901,7441
SIM,1817,51,na,1868,2709
STAT,1870,27,45-49,1897,2.201539286987728
SIM,1863,26,na,1889,4467
SIM,1860,15,na,1875,4702
STAT,1873,27,30-34,1900,51.6746715231184
SIM,1881,27,30-34,1908,50
SIM,1915,22,na,1937,7652
STAT,1850,24,25-29,1874,103.84232835076041
STAT,1923,48,35-39,1971,0.30366565925961675
SIM,1935,31,40-44,1966,8
STAT,1903,49,30-34,1952,0.15373673004502653
STAT,1933,31,35-39,1964,24.888943896386735
SIM,1908,20,25-29,1928,188
SIM,1911,49,30-34,1960,1
STAT,1837,38,15-19,1875,0.09432822848785663
STAT,1885,60,na,1945,3833.9960124995464
SIM,1874,40,25-29,1914,1
STAT,1838,50,20-24,1888,0.001033525100946769
SIM,1807,98,na,1905,5
STAT,1819,52,45-49,1871,0.05847194167954695
STAT,1903,45,15-19,1948,6.552905976814121E-4
SIM,1844,84,na,1928,349
STAT,1924,21,15-19,1945,12.720632205912688
SIM,1828,41,40-44,1869,7
SIM,1834,33,50-100,1867,2
STAT,1847,92,na,1939,63.48794392298328
STAT,1914,18,30-34,1932,5.079682104933778
SIM,1829,47,30-34,1876,1
SIM,1887,40,35-39,1927,8
SIM,1909,26,15-19,1935,4
SIM,1875,21,30-34,1896,57
SIM,1852,37,45-49,1889,4
STAT,1856,35,15-19,1891,0.08833308760118587
STAT,1901,41,30-34,1942,0.22674525774918333
SIM,1854,31,40-44,1885,13
STAT,1806,110,na,1916,1.8816291618333454E-4
STAT,1867,75,na,1942,1947.149895803981
STAT,1845,63,na,1908,2749.4980787214204
SIM,1885,41,45-49,1926,7
SIM,1877,9,na,1886,5481
STAT,1835,35,45-49,1870,3.260411487013199
STAT,1858,24,25-29,1882,92.75644067965644
STAT,1830,31,45-49,1861,3.512083845322846
SIM,1847,67,na,1914,2369
SIM,1818,37,45-49,1855,3
STAT,1888,38,30-34,1926,12.65894790703496
STAT,1950,13,na,1963,9378.227298703789
SIM,1877,43,50-100,1920,5
SIM,1924,30,20-24,1954,8
STAT,1877,28,45-49,1905,2.3202850470430705
SIM,1885,28,45-49,1913,1
SIM,1837,38,25-29,1875,6
STAT,1898,18,35-39,1916,1.4957410914760614
STAT,1927,31,40-44,1958,9.726318985347248
SIM,1862,22,35-39,1884,18
STAT,1850,19,na,1869,4250.297964847144
SIM,1813,61,na,1874,2133
SIM,1896,38,30-34,1934,20
SIM,1832,34,25-29,1866,23
STAT,1912,47,15-19,1959,7.151792731865038E-4
SIM,1876,30,50-100,1906,2
STAT,1849,22,na,1871,4089.0445103581187
STAT,1882,23,25-29,1905,112.2768153288408
SIM,1890,53,na,1943,5588
SIM,1931,33,30-34,1964,50
STAT,1867,21,30-34,1888,34.074033069874964
SIM,1914,2,na,1916,8638
STAT,1905,34,25-29,1939,17.03092710165438
SIM,1886,42,50-100,1928,7
STAT,1879,40,35-39,1919,3.8639013522191954
SIM,1922,18,30-34,1940,39
SIM,1948,16,25-29,1964,120
SIM,1815,41,30-34,1856,3
SIM,1854,15,na,1869,4805
STAT,1842,48,35-39,1890,0.2058150359238177
STAT,1899,15,15-19,1914,16.498022629330137
STAT,1910,48,25-29,1958,0.09971260345304532
STAT,1844,37,45-49,1881,3.401925237120351
STAT,1824,34,25-29,1858,36.253413444833576
STAT,1854,22,35-39,1876,10.510902734169967
SIM,1923,33,40-44,1956,12
STAT,1854,46,50-100,1900,0.3775706334463743
SIM,1913,34,25-29,1947,25
STAT,1849,22,25-29,1871,109.47888911220853
STAT,1878,42,50-100,1920,2.225631191336009
STAT,1874,32,30-34,1906,36.105208210437965
STAT,1925,45,35-39,1970,0.3169491671577874
STAT,1818,47,45-49,1865,1.0403979688507272
STAT,1907,47,40-44,1954,0.2853214796215875
SIM,1822,75,na,1897,1074
STAT,1837,37,na,1874,3634.440179575929
STAT,1891,25,25-29,1916,106.316938185568
STAT,1839,63,na,1902,2786.06323021428
STAT,1874,23,na,1897,4875.606720362279
SIM,1849,30,50-100,1879,2
STAT,1816,69,na,1885,1653.1499332611254
STAT,1916,30,20-24,1946,5.12676998142736
SIM,1850,84,na,1934,497
SIM,1801,76,na,1877,683
SIM,1879,44,25-29,1923,2
SIM,1839,27,35-39,1866,20
STAT,1841,46,25-29,1887,0.08503492671897762
STAT,1879,54,25-29,1933,0.00727665951343413
STAT,1870,49,25-29,1919,0.1118262132528255
STAT,1918,6,na,1924,8809.161916105817
STAT,1932,28,na,1960,9905.614212835584
STAT,1840,17,25-29,1857,10.59033467157539
STAT,1882,58,na,1940,3890.71871151269
STAT,1888,74,na,1962,3108.522346310443
SIM,1869,42,na,1911,4441
SIM,1919,12,na,1931,8991
STAT,1851,45,40-44,1896,0.26803710173599654
STAT,1823,31,50-100,1854,5.9893194252779836
STAT,1865,29,50-100,1894,1.1653260241136327
SIM,1882,32,30-34,1914,45
STAT,1910,34,35-39,1944,17.649683072304573
STAT,1909,18,20-24,1927,53.58352720657068
STAT,1931,24,25-29,1955,240.44676383564772
STAT,1878,39,15-19,1917,0.1172547404677754
STAT,1885,38,45-49,1923,3.987621517159122
STAT,1915,33,40-44,1948,8.01602274174327
SIM,1845,48,25-29,1893,1
STAT,1865,35,25-29,1900,5.332954570566562
SIM,1857,22,25-29,1879,122
STAT,1939,32,15-19,1971,0.26483352986141634
STAT,1832,26,30-34,1858,44.72304174746889
STAT,1873,75,na,1948,2112.513956851121
STAT,1823,42,25-29,1865,2.1385586726036174
STAT,1944,13,na,1957,8535.530281294783
STAT,1928,37,30-34,1965,4.65119358003886
STAT,1910,30,50-100,1940,1.623590046302312
SIM,1895,65,na,1960,4824
STAT,1839,19,40-44,1858,0.369205263063152
SIM,1914,26,25-29,1940,139
SIM,1815,40,50-100,1855,4
SIM,1836,18,20-24,1854,34
STAT,1889,28,na,1917,5922.079221237588
SIM,1843,32,50-100,1875,2
SIM,1873,35,25-29,1908,4
STAT,1876,89,na,1965,520.1215855654111
STAT,1771,83,na,1854,190.0
SIM,1916,38,na,1954,7843
STAT,1866,46,30-34,1912,0.18089698324492687
STAT,1826,29,40-44,1855,12.818577709373963
SIM,1947,19,45-49,1966,2
SIM,1853,67,na,1920,2484
STAT,1912,23,45-49,1935,2.1716471304662375
SIM,1832,99,na,1931,3
SIM,1866,24,25-29,1890,131
SIM,1795,62,na,1857,1827
STAT,1907,41,35-39,1948,0.3749504675761039
SIM,1897,28,50-100,1925,3
SIM,1840,26,30-34,1866,72
SIM,1816,75,na,1891,893
STAT,1828,54,na,1882,2723.3880247646157
STAT,1847,47,40-44,1894,0.2597506789333281
SIM,1830,27,15-19,1857,1
SIM,1937,19,50-100,1956,1
STAT,1890,33,25-29,1923,25.143063454178694
SIM,1814,46,na,1860,2759
STAT,1892,46,40-44,1938,0.24485342432667434
SIM,1808,46,na,1854,2871
SIM,1870,39,na,1909,4561
STAT,1834,54,na,1888,2819.987971221279
SIM,1830,33,na,1863,3290
SIM,1900,20,25-29,1920,191
STAT,1898,41,15-19,1939,0.0026328437294874385
STAT,1871,32,45-49,1903,3.4990054176690686
SIM,1843,35,45-49,1878,5
STAT,1837,48,25-29,1885,0.08229458622947038
STAT,1846,31,40-44,1877,7.931818436456352
STAT,1882,47,25-29,1929,0.1127937343579567
SIM,1874,97,na,1971,38
SIM,1920,23,45-49,1943,3
SIM,1851,32,na,1883,3932
STAT,1829,38,25-29,1867,4.9410793676509615
STAT,1942,20,20-24,1962,235.62785048447674
SIM,1890,23,25-29,1913,170
STAT,1902,43,40-44,1945,0.44214688964526233
STAT,1844,19,15-19,1863,12.039550876450942
STAT,1894,33,50-100,1927,2.3670731622917063
STAT,1943,7,na,1950,8486.910725947115
SIM,1849,31,30-34,1880,30
SIM,1834,60,na,1894,2503
STAT,1835,32,50-100,1867,1.5114773929992082
SIM,1894,30,30-34,1924,73
SIM,1777,77,na,1854,628
STAT,1886,30,30-34,1916,37.522319432310915
SIM,1823,32,25-29,1855,23
STAT,1865,54,30-34,1919,0.010621462278241125
STAT,1896,29,25-29,1925,111.98754833355487
STAT,1921,44,20-24,1965,0.04002938191274738
SIM,1911,36,50-100,1947,2
STAT,1862,104,na,1966,0.720866139370699
STAT,1928,18,25-29,1946,109.97298183686148
SIM,1831,42,25-29,1873,3
STAT,1845,44,50-100,1889,1.6158080309371015
SIM,1880,25,20-24,1905,28
SIM,1950,20,20-24,1970,267
STAT,1906,26,25-29,1932,124.91794078065462
SIM,1847,19,40-44,1866,2
STAT,1865,32,20-24,1897,4.959602559878042
STAT,1874,28,50-100,1902,1.3181730057534624
SIM,1856,78,na,1934,1199
STAT,1860,41,35-39,1901,2.983322620742835
SIM,1886,30,40-44,1916,14
STAT,1816,110,na,1926,2.7143377979237294E-4
STAT,1872,25,20-24,1897,23.97334900632778
SIM,1857,38,50-100,1895,3
SIM,1851,37,50-100,1888,1
STAT,1836,80,na,1916,822.475216554482
STAT,1823,36,30-34,1859,21.43713191261265
STAT,1914,37,na,1951,7587.656546263927
SIM,1880,44,50-100,1924,4
SIM,1831,29,25-29,1860,75
STAT,1888,34,15-19,1922,0.3370259925132453
STAT,1920,49,30-34,1969,0.1978063671090166
SIM,1892,21,50-100,1913,6
STAT,1836,40,45-49,1876,2.4292418557792783
STAT,1836,24,40-44,1860,3.6050067405275468
STAT,1832,36,40-44,1868,7.288317555241888
SIM,1936,18,25-29,1954,93
SIM,1873,47,25-29,1920,1
SIM,1913,27,na,1940,7698
SIM,1838,53,na,1891,2904
SIM,1882,47,35-39,1929,1
SIM,1873,42,30-34,1915,7
STAT,1919,18,15-19,1937,101.00193567674867
SIM,1892,41,20-24,1933,3
SIM,1914,8,na,1922,8539
STAT,1884,41,20-24,1925,0.3181492053862845
SIM,1818,39,na,1857,3179
STAT,1819,49,na,1868,2748.908740702589
STAT,1919,8,na,1927,8899.648715711175
STAT,1882,89,na,1971,630.0087837196269
STAT,1905,38,40-44,1943,2.745998490393033
SIM,1862,72,na,1934,2195
SIM,1877,30,30-34,1907,50
SIM,1829,76,na,1905,1121
STAT,1863,82,na,1945,824.8713911047912
STAT,1934,15,45-49,1949,1.371155284116777
STAT,1874,54,40-44,1928,0.021171613919358415
SIM,1904,26,30-34,1930,86
SIM,1935,35,50-100,1970,1
STAT,1878,42,40-44,1920,4.73855792874865
STAT,1865,42,30-34,1907,2.1068271470020887
SIM,1939,32,na,1971,7971
STAT,1896,72,na,1968,4081.0447414167625
STAT,1832,90,na,1922,102.78585607498874
STAT,1862,38,na,1900,4046.718932811632
STAT,1880,53,20-24,1933,0.0015447697018382794
SIM,1927,18,15-19,1945,1
SIM,1794,83,na,1877,263
STAT,1875,19,45-49,1894,0.13510003337855817
SIM,1868,29,20-24,1897,22
STAT,1810,52,25-29,1862,0.021894521534820126
STAT,1874,47,35-39,1921,0.28815837248569764
SIM,1844,40,45-49,1884,3
SIM,1831,36,30-34,1867,18
STAT,1852,42,na,1894,3679.142371158402
STAT,1929,19,50-100,1948,0.9603839329637779
SIM,1940,29,na,1969,7897
STAT,1825,43,na,1868,3122.221519234995
STAT,1888,43,na,1931,5477.225682032709
STAT,1911,37,20-24,1948,0.5143700022515251
STAT,1924,41,35-39,1965,0.48430235059946014
STAT,1846,28,15-19,1874,0.8346697280234052
STAT,1940,26,25-29,1966,135.62496087800542
STAT,1947,24,20-24,1971,253.61750952687123
STAT,1919,25,20-24,1944,40.09521807973615
SIM,1921,22,na,1943,8365
STAT,1869,70,na,1939,2745.731382590752
STAT,1900,37,45-49,1937,1.2054734497934314
STAT,1881,27,20-24,1908,22.90074640764085
SIM,1849,90,na,1939,82
SIM,1831,80,na,1911,656
STAT,1832,48,40-44,1880,0.2605183020871483
SIM,1876,92,na,1968,260
SIM,1949,18,35-39,1967,12
STAT,1915,41,25-29,1956,0.14541771378314897
SIM,1874,19,35-39,1893,2
SIM,1889,44,50-100,1933,6
STAT,1866,19,35-39,1885,1.0371948263961899
STAT,1806,50,45-49,1856,0.08814917443606202
STAT,1813,58,na,1871,2252.685030585941
SIM,1829,25,50-100,1854,2
SIM,1913,30,45-49,1943,9
STAT,1873,41,45-49,1914,3.085086045325015
STAT,1890,27,30-34,1917,62.07730957476654
STAT,1959,12,na,1971,10375.421135188917
STAT,1865,47,25-29,1912,0.10519241689478175
SIM,1842,58,na,1900,2793
SIM,1840,36,40-44,1876,10
SIM,1853,9,na,1862,4901
SIM,1884,26,35-39,1910,21
SIM,1878,36,20-24,1914,1
STAT,1883,40,25-29,1923,1.2870723941335547
STAT,1759,110,na,1869,0.0016062558670504243
SIM,1854,28,15-19,1882,1
STAT,1859,23,30-34,1882,29.494460920361178
SIM,1881,41,45-49,1922,4
STAT,1861,25,45-49,1886,1.9072790771575696
STAT,1888,48,40-44,1936,0.22762489382870718
SIM,1829,79,na,1908,923
STAT,1931,28,40-44,1959,12.147894244608374
STAT,1858,51,20-24,1909,0.0011673525446738065
SIM,1887,30,na,1917,5880
STAT,1847,40,20-24,1887,0.24975376967371765
STAT,1907,52,na,1959,6502.751237284996
STAT,1847,45,15-19,1892,6.1581502947415E-4
STAT,1860,53,35-39,1913,0.013892865348067022
STAT,1891,44,30-34,1935,2.8312714295071966
STAT,1819,41,50-100,1860,5.047243944221105
SIM,1886,42,40-44,1928,9
SIM,1794,86,na,1880,153
SIM,1845,41,40-44,1886,10
SIM,1927,25,20-24,1952,51
STAT,1910,31,30-34,1941,30.817395388137623
SIM,1849,18,30-34,1867,4
STAT,1824,53,30-34,1877,0.01361104099712046
SIM,1807,61,na,1868,1834
STAT,1865,52,50-100,1917,0.027563176258034047
SIM,1848,29,35-39,1877,19
SIM,1918,31,40-44,1949,15
SIM,1850,53,na,1903,3405
STAT,1817,50,20-24,1867,0.0035550472259916486
STAT,1852,45,na,1897,3621.5683277215626
STAT,1836,45,50-100,1881,0.35068700371901707
STAT,1888,41,20-24,1929,0.3808123745192278
SIM,1832,41,30-34,1873,2
SIM,1845,38,na,1883,3984
SIM,1958,6,na,1964,10844
STAT,1878,30,40-44,1908,9.220967480178981
STAT,1897,46,25-29,1943,0.08796363456736692
SIM,1874,3,na,1877,5778
SIM,1900,30,35-39,1930,41
STAT,1891,32,30-34,1923,43.5861259010658
STAT,1847,33,15-19,1880,0.25224431997447366
STAT,1941,6,na,1947,8290.07325824714
STAT,1890,42,50-100,1932,2.6011122964284947
SIM,1817,48,50-100,1865,1
STAT,1849,56,na,1905,3226.289518964969
SIM,1887,33,na,1920,5833
SIM,1914,43,40-44,1957,3
STAT,1877,41,45-49,1918,3.1528930618941553
STAT,1824,95,na,1919,14.214738306602145
SIM,1890,25,15-19,1915,2
SIM,1925,12,na,1937,9685
SIM,1913,24,15-19,1937,10
STAT,1923,36,35-39,1959,5.663464815027697
STAT,1942,30,30-34,1972,33.934046575237446
SIM,1875,24,35-39,1899,13
SIM,1849,93,na,1942,23
STAT,1841,53,50-100,1894,0.02156119324386413
SIM,1848,17,35-39,1865,1
SIM,1834,23,35-39,1857,11
STAT,1870,30,na,1900,4769.6761964747975
SIM,1931,36,35-39,1967,8
STAT,1885,34,50-100,1919,1.826155109688342
SIM,1867,36,45-49,1903,5
STAT,1840,57,na,1897,2900.78247085633
STAT,1865,18,na,1883,4747.137081413421
STAT,1905,24,15-19,1929,9.575404269860098
SIM,1896,48,40-44,1944,1
SIM,1898,27,40-44,1925,6
STAT,1840,26,20-24,1866,21.266483055670623
STAT,1882,20,20-24,1902,136.38714827401049
STAT,1915,48,45-49,1963,0.44111077626203604
SIM,1885,25,40-44,1910,11
STAT,1850,52,50-100,1902,0.023033314775783582
SIM,1872,37,30-34,1909,13
SIM,1914,36,35-39,1950,1
STAT,1827,46,50-100,1873,0.4495126278034156
SIM,1805,66,na,1871,1580
STAT,1926,25,na,1951,9129.608602447255
STAT,1937,23,15-19,1960,10.467819056164025
STAT,1863,34,45-49,1897,3.0565098245071725
STAT,1882,25,15-19,1907,0.898668647635645
STAT,1801,54,40-44,1855,0.06334614527507287
STAT,1856,49,40-44,1905,0.2612000790409724
STAT,1839,23,50-100,1862,0.8122554365643309
SIM,1830,30,40-44,1860,14
SIM,1826,65,na,1891,1852
SIM,1880,21,40-44,1901,5
STAT,1850,43,30-34,1893,1.7500178182068191
STAT,1837,106,na,1943,0.016922547284008785
STAT,1906,48,35-39,1954,0.22948895734645072
SIM,1823,34,15-19,1857,2
STAT,1856,53,50-100,1909,0.02315579269189878
SIM,1881,37,40-44,1918,10
STAT,1841,41,30-34,1882,1.7557022690221638
STAT,1863,85,na,1948,484.64244273420246
STAT,1903,15,50-100,1918,0.14153374928570378
SIM,1929,34,20-24,1963,8
STAT,1921,19,na,1940,8425.981694307322
STAT,1870,64,na,1934,3446.8644324921756
STAT,1883,52,25-29,1935,0.006990906497796928
STAT,1815,41,20-24,1856,0.9905129826212811
SIM,1869,11,na,1880,5225
SIM,1859,41,35-39,1900,4
SIM,1944,24,45-49,1968,3
STAT,1873,49,40-44,1922,0.3439768810349118
STAT,1947,24,na,1971,8329.174512683763
STAT,1864,37,30-34,1901,9.621537359709805
SIM,1891,40,25-29,1931,5
SIM,1923,48,45-49,1971,1
STAT,1896,26,20-24,1922,31.388422224983234
SIM,1838,50,na,1888,3064
STAT,1906,46,45-49,1952,0.3928878092128883
STAT,1929,35,25-29,1964,2.5571145147822265
STAT,1836,83,na,1919,527.8272271669146
STAT,1877,25,40-44,1902,6.324791722290352
STAT,1931,20,45-49,1951,2.964972641581098
SIM,1864,49,40-44,1913,1
STAT,1811,46,15-19,1857,0.0027625739206375657
STAT,1876,55,na,1931,4319.163606419117
STAT,1828,32,35-39,1860,22.701180855700162
STAT,1819,43,na,1862,2934.3309506471746
STAT,1828,40,50-100,1868,2.054575212862314
SIM,1840,22,15-19,1862,6
STAT,1905,30,45-49,1935,5.134262984812794
STAT,1855,56,na,1911,3075.6342525485347
SIM,1881,49,40-44,1930,1
STAT,1830,95,na,1925,18.359584593671958
STAT,1914,21,50-100,1935,1.3069811946286871
SIM,1903,20,40-44,1923,7
STAT,1841,31,20-24,1872,4.808162747456837
STAT,1894,77,na,1971,3186.9257738264882
STAT,1925,42,30-34,1967,0.3125362653332123
STAT,1900,20,15-19,1920,9.29777337950609
STAT,1832,34,15-19,1866,0.23684078045721244
STAT,1901,64,na,1965,5383.659200434072
STAT,1829,47,20-24,1876,0.018934238869892293
SIM,1857,26,na,1883,4401
SIM,1837,35,20-24,1872,2
STAT,1849,53,na,1902,3351.191882719231
SIM,1889,20,50-100,1909,1
STAT,1896,38,20-24,1934,2.0452184444154735
SIM,1875,36,50-100,1911,4
SIM,1832,65,na,1897,2180
STAT,1879,50,45-49,1929,0.031097698549055024
STAT,1882,39,40-44,1921,8.525605670279775
STAT,1923,20,50-100,1943,1.5549594196288161
SIM,1930,19,35-39,1949,11
SIM,1885,31,35-39,1916,29
STAT,1832,22,15-19,1854,10.387597327858087
STAT,1859,8,na,1867,4582.135613256298
STAT,1850,31,30-34,1881,28.29688778359529
SIM,1940,26,na,1966,7900
STAT,1837,44,45-49,1881,2.1837635039260332
STAT,1799,86,na,1885,150.06110526979484
STAT,1829,35,20-24,1864,1.396284271202994
SIM,1840,48,40-44,1888,1
SIM,1890,32,20-24,1922,10
SIM,1857,26,40-44,1883,7
STAT,1867,18,40-44,1885,0.35157890239085
SIM,1869,42,40-44,1911,12
STAT,1855,37,20-24,1892,1.1623895380715203
STAT,1932,36,45-49,1968,1.8517121307275113
STAT,1922,19,35-39,1941,9.752547467699959
STAT,1916,40,30-34,1956,0.2653295106210899
SIM,1930,30,45-49,1960,7
SIM,1818,36,na,1854,3274
STAT,1832,40,45-49,1872,2.449433784613464
STAT,1914,21,20-24,1935,220.86672867200042
SIM,1902,49,20-24,1951,1
STAT,1826,28,na,1854,3044.557047059993
STAT,1826,90,na,1916,94.3804408832573
SIM,1826,47,50-100,1873,2
STAT,1874,40,15-19,1914,0.028845707179418843
SIM,1879,41,20-24,1920,1
SIM,1913,38,40-44,1951,5
SIM,1839,17,25-29,1856,12
STAT,1832,54,50-100,1886,0.019685095136110282
STAT,1821,50,na,1871,2773.5114474968113
SIM,1922,21,20-24,1943,285
STAT,1882,32,20-24,1914,5.3179887882933174
STAT,1845,23,50-100,1868,0.7744906624069186
STAT,1862,30,45-49,1892,3.0343843501058205
STAT,1876,35,50-100,1911,2.5889385707133563
SIM,1881,48,na,1929,3813
SIM,1904,19,25-29,1923,19
STAT,1936,24,45-49,1960,2.1715022009902154
STAT,1768,94,na,1862,6.988962318362772
SIM,1906,48,na,1954,6526
SIM,1897,49,50-100,1946,1
STAT,1877,31,35-39,1908,21.32485170892104
SIM,1909,22,35-39,1931,20
STAT,1873,37,40-44,1910,8.98288144406923
STAT,1901,42,45-49,1943,0.29348601886834336
SIM,1844,24,40-44,1868,4
STAT,1911,49,20-24,1960,0.02101176429323708
STAT,1945,15,20-24,1960,299.2395416798267
SIM,1928,23,15-19,1951,12
SIM,1898,6,na,1904,7359
SIM,1849,34,35-39,1883,22
SIM,1890,20,20-24,1910,177
SIM,1828,91,na,1919,90
STAT,1841,24,15-19,1865,5.97697303081065
STAT,1877,21,25-29,1898,120.41555486842206
STAT,1815,48,40-44,1863,0.9055944854945722
SIM,1880,18,15-19,1898,15
STAT,1941,31,25-29,1972,19.610652259636087
SIM,1863,20,na,1883,4494
SIM,1890,39,40-44,1929,18
STAT,1831,43,na,1874,3266.873709174964
STAT,1846,42,na,1888,3583.004359173711
STAT,1872,18,15-19,1890,12.014038645383717
STAT,1769,113,na,1882,6.371894665290885E-4
STAT,1922,30,45-49,1952,3.6186591784183983
SIM,1850,87,na,1937,222
SIM,1894,18,na,1912,6799
STAT,1846,35,20-24,1881,1.258873457410574
SIM,1840,40,45-49,1880,6
STAT,1884,84,na,1968,1276.2638024592288
STAT,1842,51,25-29,1893,0.005298631012983549
STAT,1888,46,15-19,1934,9.575361736523738E-4
STAT,1886,48,na,1934,4736.2627358218715
SIM,1924,40,30-34,1964,1
SIM,1801,73,na,1874,946
SIM,1953,15,20-24,1968,356
SIM,1823,48,40-44,1871,1
SIM,1848,19,25-29,1867,12
STAT,1789,93,na,1882,14.46264891320225
STAT,1863,16,15-19,1879,12.042945265419222
SIM,1935,2,na,1937,11537
SIM,1924,29,50-100,1953,5
SIM,1818,40,35-39,1858,7
STAT,1848,22,50-100,1870,0.8141582136760291
STAT,1818,64,na,1882,1958.7468318314686
STAT,1937,27,30-34,1964,77.15452078236655
SIM,1918,33,na,1951,8238
SIM,1827,28,20-24,1855,22
SIM,1840,38,30-34,1878,15
STAT,1852,52,30-34,1904,0.009436728875683158
SIM,1835,79,na,1914,779
SIM,1871,16,15-19,1887,13
SIM,1839,38,na,1877,3541
STAT,1854,22,50-100,1876,0.7345146026835029
STAT,1830,98,na,1928,4.485855718466853
STAT,1861,15,35-39,1876,1.072774581742855
SIM,1936,15,20-24,1951,232
STAT,1825,51,25-29,1876,0.007552814598663792
STAT,1880,23,na,1903,5016.265288334389
SIM,1953,18,25-29,1971,131
SIM,1814,40,na,1854,2981
STAT,1900,34,40-44,1934,12.045829098083042
SIM,1836,24,na,1860,3620
STAT,1834,57,na,1891,2670.6747369660793
STAT,1945,18,25-29,1963,95.56732241736653
STAT,1849,19,35-39,1868,1.0558256114253026
STAT,1913,52,na,1965,7121.848349006309
STAT,1872,96,na,1968,80.23845377427617
SIM,1857,19,35-39,1876,1
STAT,1886,31,45-49,1917,3.732921754239558
STAT,1810,50,35-39,1860,0.05541087593229479
STAT,1815,50,na,1865,2720.0278206177936
SIM,1855,93,na,1948,21
STAT,1906,23,20-24,1929,202.1789552359827
STAT,1856,45,25-29,1901,0.0906492160924969
SIM,1862,22,50-100,1884,1
STAT,1941,0,na,1941,9318.191160669385
STAT,1925,28,50-100,1953,2.365470501661593
STAT,1819,40,45-49,1859,7.361438905631081
SIM,1864,45,25-29,1909,1
STAT,1895,30,40-44,1925,11.504372010641578
STAT,1870,15,45-49,1885,0.1323111168191051
STAT,1846,15,50-100,1861,0.09538739250049925
SIM,1831,26,20-24,1857,25
STAT,1847,43,25-29,1890,0.9717957158261727
SIM,1921,19,25-29,1940,123
STAT,1892,42,25-29,1934,1.6215641226145716
SIM,1908,17,35-39,1925,3
STAT,1899,19,30-34,1918,4.386805384196628
STAT,1875,16,40-44,1891,0.38125383426221543
STAT,1834,50,20-24,1884,0.0010478703286507021
SIM,1844,30,35-39,1874,31
STAT,1823,39,35-39,1862,25.248856499470538
SIM,1849,28,40-44,1877,7
STAT,1845,97,na,1942,8.278279816347307
STAT,1848,54,30-34,1902,0.00949203289767818
SIM,1914,23,20-24,1937,230
SIM,1882,44,30-34,1926,4
STAT,1923,26,25-29,1949,153.09498196833425
SIM,1845,44,45-49,1889,6
SIM,1861,24,40-44,1885,4
STAT,1832,38,30-34,1870,8.686266854169563
SIM,1824,39,na,1863,3428
STAT,1844,25,45-49,1869,2.226851437951784
STAT,1867,41,na,1908,4391.315901938373
STAT,1883,42,15-19,1925,0.027368740242070543
SIM,1835,19,15-19,1854,9
SIM,1883,16,40-44,1899,1
SIM,1888,18,na,1906,5905
SIM,1918,16,15-19,1934,22
STAT,1869,40,40-44,1909,4.44611152688315
STAT,1874,51,50-100,1925,0.03138062880796977
SIM,1855,43,25-29,1898,2
STAT,1838,43,15-19,1881,0.01963743690886147
STAT,1874,44,30-34,1918,2.3453253150934894
STAT,1816,51,15-19,1867,1.1827393394341879E-4
SIM,1893,33,na,1926,6234
STAT,1941,25,30-34,1966,81.93628999254045
STAT,1853,24,40-44,1877,3.8398113835182466
STAT,1803,103,na,1906,0.10128253641539091
SIM,1914,46,45-49,1960,1
STAT,1888,44,25-29,1932,1.5121797855301262
SIM,1855,47,40-44,1902,1
STAT,1858,18,30-34,1876,2.91406722561486
STAT,1913,19,25-29,1932,17.802802476574332
SIM,1890,59,na,1949,5053
STAT,1836,30,35-39,1866,17.38078143728743
STAT,1875,51,20-24,1926,0.0015417353289014825
STAT,1850,36,25-29,1886,4.531301747471251
SIM,1923,35,30-34,1958,4
SIM,1873,32,20-24,1905,6
STAT,1908,37,na,1945,7118.691761460431
STAT,1895,22,na,1917,6223.934162632151
STAT,1868,38,45-49,1906,3.8115378498548806
STAT,1905,23,na,1928,6886.443168389718
SIM,1894,31,45-49,1925,3
STAT,1842,45,30-34,1887,0.14788243721839675
SIM,1873,29,50-100,1902,1
SIM,1903,34,na,1937,7024
STAT,1915,35,30-34,1950,3.7540803291838007
STAT,1818,61,na,1879,2190.5762818302933
STAT,1842,41,15-19,1883,0.021546115272873423
STAT,1932,38,35-39,1970,6.55729492224392
STAT,1840,29,25-29,1869,75.0430435539818
STAT,1938,10,na,1948,7918.974600050127
STAT,1837,26,15-19,1863,0.8176879819276727
SIM,1876,38,45-49,1914,4
SIM,1854,46,na,1900,3774
SIM,1900,20,na,1920,6923
STAT,1890,17,20-24,1907,43.70359439283479
STAT,1780,111,na,1891,0.0014571224765774983
STAT,1883,27,50-100,1910,1.2693245741958492
SIM,1891,27,50-100,1918,5
STAT,1864,33,15-19,1897,0.25600500586462466
STAT,1891,47,35-39,1938,0.19622434323021404
STAT,1837,68,na,1905,2129.933766757782
STAT,1911,47,30-34,1958,0.1704942289033514
SIM,1887,38,20-24,1925,3
SIM,1855,90,na,1945,98
SIM,1937,32,20-24,1969,7
STAT,1946,25,15-19,1971,1.5894608423373568
STAT,1811,51,30-34,1862,0.03932694574863957
STAT,1861,49,15-19,1910,6.58363534495932E-4
STAT,1872,20,50-100,1892,0.8326472939258285
SIM,1845,26,15-19,1871,1
STAT,1799,89,na,1888,79.54204678052038
SIM,1827,40,45-49,1867,5
SIM,1896,44,25-29,1940,1
STAT,1834,38,50-100,1872,2.0118460883928986
STAT,1897,43,20-24,1940,0.02955739877667708
SIM,1847,64,na,1911,2628
SIM,1881,39,30-34,1920,13
STAT,1842,83,na,1925,591.0399556520757
STAT,1857,82,na,1939,734.4926310542825
SIM,1933,28,50-100,1961,4
STAT,1942,8,na,1950,8357.059591688725
STAT,1901,44,35-39,1945,0.35073308975075784
STAT,1929,32,20-24,1961,6.256722937264484
STAT,1806,48,30-34,1854,0.5816041210213797
SIM,1874,60,na,1934,3620
SIM,1913,28,30-34,1941,89
STAT,1875,70,na,1945,2917.484558047984
STAT,1905,28,30-34,1933,73.29190696702555
STAT,1911,43,15-19,1954,0.002943298009206501
STAT,1866,52,25-29,1918,0.006565331502745906
SIM,1859,31,25-29,1890,25
SIM,1881,23,15-19,1904,6
STAT,1868,29,na,1897,4552.992049205444
SIM,1918,34,45-49,1952,7
STAT,1873,39,30-34,1912,10.826520775422317
SIM,1841,43,30-34,1884,4
SIM,1904,29,35-39,1933,42
STAT,1907,40,20-24,1947,0.03306631701211363
SIM,1869,45,na,1914,4392
STAT,1867,24,35-39,1891,10.968274691402192
STAT,1878,45,45-49,1923,0.5027577628638568
STAT,1806,76,na,1882,771.4634707591429
SIM,1835,37,45-49,1872,5
STAT,1835,19,40-44,1854,0.6116195577911385
STAT,1850,46,35-39,1896,0.21526722073513857
SIM,1906,45,na,1951,6638
SIM,1830,33,45-49,1863,2
SIM,1898,3,na,1901,7428
STAT,1890,19,50-100,1909,0.1201249416966527
STAT,1832,32,25-29,1864,17.406999579586607
STAT,1836,20,25-29,1856,122.21297564235283
STAT,1931,18,30-34,1949,32.13763438284267
STAT,1859,33,40-44,1892,6.941806301586168
STAT,1894,28,45-49,1922,2.8704272871579986
SIM,1925,15,na,1940,8993
STAT,1805,91,na,1896,43.34551008228008
STAT,1902,12,na,1914,7363.627490164158
SIM,1858,21,30-34,1879,45
SIM,1866,37,50-100,1903,4
SIM,1854,38,25-29,1892,8
STAT,1824,41,30-34,1865,3.0618948812560207
STAT,1793,61,na,1854,1812.0000000000002
STAT,1824,46,25-29,1870,0.14147348660448236
STAT,1938,34,20-24,1972,4.947713154366794
STAT,1920,45,15-19,1965,8.26069986817131E-4
SIM,1884,59,na,1943,4144
STAT,1941,21,15-19,1962,11.114242990522573
SIM,1895,29,15-19,1924,1
SIM,1909,59,na,1968,6457
STAT,1861,111,na,1972,0.0029321876067577267
STAT,1906,43,40-44,1949,0.4563506327244132
STAT,1933,30,20-24,1963,6.646870838285399
STAT,1887,29,15-19,1916,1.017495392804683
STAT,1857,50,25-29,1907,0.005655952786860725
SIM,1881,45,na,1926,3917
STAT,1871,22,35-39,1893,11.708978395789307
STAT,1841,34,25-29,1875,17.660593258397792
STAT,1879,0,na,1879,7666.384672395702
SIM,1877,43,45-49,1920,6
SIM,1826,35,45-49,1861,3
SIM,1849,24,25-29,1873,107
STAT,1841,44,35-39,1885,2.661092377832992
STAT,1781,76,na,1857,696.8180147758785
STAT,1891,37,25-29,1928,7.1875762822435
SIM,1875,45,na,1920,5075
SIM,1914,33,30-34,1947,48
STAT,1847,100,na,1947,1.6183099472354898
STAT,1943,26,50-100,1969,2.1418094814795756
SIM,1941,30,20-24,1971,6
STAT,1922,16,30-34,1938,28.55152091520304
STAT,1838,47,30-34,1885,0.1347821634678207
STAT,1845,18,20-24,1863,34.32486151732455
STAT,1880,22,45-49,1902,1.483602560518504
SIM,1908,27,45-49,1935,1
SIM,1870,20,35-39,1890,12
SIM,1896,44,na,1940,6425
STAT,1858,30,na,1888,3835.892051714432
SIM,1840,32,25-29,1872,27
STAT,1844,16,na,1860,4740.078014246168
SIM,1880,60,na,1940,4179
STAT,1856,42,20-24,1898,0.2471635382431509
SIM,1913,22,50-100,1935,2
STAT,1858,67,na,1925,2495.7960020018113
STAT,1796,75,na,1871,844.8870726354827
STAT,1917,11,na,1928,8595.207210647955
SIM,1820,40,na,1860,3034
SIM,1946,14,na,1960,8629
SIM,1860,46,na,1906,3949
SIM,1910,16,na,1926,8068
STAT,1909,37,50-100,1946,0.8030445541658612
STAT,1915,45,40-44,1960,0.32239454558716046
STAT,1803,62,na,1865,1901.1419831681665
SIM,1886,27,15-19,1913,1
STAT,1812,76,na,1888,895.218773406154
STAT,1837,41,40-44,1878,3.747845417193974
SIM,1852,25,45-49,1877,4
STAT,1881,6,na,1887,5186.425011457234
STAT,1878,27,15-19,1905,0.9569950761967135
STAT,1887,39,25-29,1926,6.43805456011931
STAT,1936,21,40-44,1957,6.49566710770482
SIM,1930,16,30-34,1946,49
SIM,1853,18,20-24,1871,37
STAT,1906,33,30-34,1939,29.37959816694716
SIM,1944,21,40-44,1965,10
STAT,1895,20,30-34,1915,47.15503346485571
STAT,1865,15,na,1880,4826.005506652735
SIM,1917,37,50-100,1954,3
SIM,1927,28,25-29,1955,175
STAT,1877,37,na,1914,4940.856847510758
STAT,1822,33,45-49,1855,9.624982150858656
STAT,1905,22,50-100,1927,1.1910663406695865
SIM,1868,41,45-49,1909,5
SIM,1905,36,25-29,1941,2
STAT,1862,20,35-39,1882,10.461523999690817
SIM,1867,23,30-34,1890,53
SIM,1823,44,25-29,1867,2
STAT,1807,53,30-34,1860,0.03799515020975871
STAT,1879,48,30-34,1927,0.2019183886692836
SIM,1952,14,na,1966,9759
STAT,1882,35,25-29,1917,5.718319617821951
SIM,1823,54,na,1877,2584
SIM,1942,27,50-100,1969,1
STAT,1919,28,25-29,1947,143.09614471446565
STAT,1914,24,25-29,1938,189.42942394062655
SIM,1928,39,30-34,1967,10
SIM,1824,100,na,1924,1
STAT,1858,6,na,1864,4588.188577689193
STAT,1934,27,50-100,1961,2.7046438396759345
SIM,1926,36,50-100,1962,3
SIM,1934,29,na,1963,9976
SIM,1936,4,na,1940,6999
SIM,1904,23,50-100,1927,1
SIM,1833,39,50-100,1872,4
SIM,1925,15,45-49,1940,1
STAT,1924,47,40-44,1971,0.3789790144563511
SIM,1893,26,45-49,1919,5
SIM,1882,51,50-100,1933,1
STAT,1898,36,na,1934,6470.083999085417
SIM,1825,80,na,1905,589
STAT,1900,37,50-100,1937,0.7424234635354162
SIM,1931,26,25-29,1957,191
SIM,1931,15,na,1946,9816
STAT,1918,36,50-100,1954,0.8979022181789909
SIM,1844,53,na,1897,3044
SIM,1844,20,25-29,1864,118
STAT,1827,37,45-49,1864,4.142787666406523
SIM,1871,34,45-49,1905,5
STAT,1866,96,na,1962,40.62910987083855
SIM,1903,23,45-49,1926,3
SIM,1949,15,30-34,1964,41
STAT,1846,38,25-29,1884,4.557801969517355
SIM,1919,37,30-34,1956,9
STAT,1864,30,na,1894,4342.658548995925
STAT,1873,33,25-29,1906,20.92970127055466
SIM,1773,84,na,1857,206
SIM,1883,74,na,1957,2538
STAT,1850,29,50-100,1879,1.1377150312975315
STAT,1885,26,45-49,1911,2.239697892564269
SIM,1788,83,na,1871,199
STAT,1843,31,na,1874,3687.861403231024
STAT,1859,15,na,1874,4334.104611504249
STAT,1833,53,40-44,1886,0.014007408749394587
STAT,1863,31,40-44,1894,7.698215741218839
SIM,1878,59,na,1937,4204
STAT,1837,103,na,1940,0.20002485229620168
STAT,1901,67,na,1968,5107.998031978583
SIM,1894,19,20-24,1913,43
STAT,1860,43,25-29,1903,1.0455827128963082
STAT,1838,16,na,1854,4127.749704526865
STAT,1849,29,45-49,1878,2.052111116147054
STAT,1825,39,50-100,1864,2.9943102438098737
STAT,1917,15,45-49,1932,0.21809356814553077
SIM,1871,21,50-100,1892,1
SIM,1899,58,na,1957,5637
SIM,1857,29,45-49,1886,2
STAT,1883,37,na,1920,4674.902765787955
SIM,1922,24,25-29,1946,230
SIM,1904,16,20-24,1920,52
STAT,1863,21,50-100,1884,0.7406179895528191
STAT,1910,41,40-44,1951,0.48034163254452333
SIM,1890,35,25-29,1925,13
SIM,1934,17,45-49,1951,2
STAT,1896,40,35-39,1936,0.33867759852617396
SIM,1808,49,50-100,1857,1
STAT,1851,97,na,1948,8.32795663092275
STAT,1815,44,25-29,1859,3.5951274807118607
STAT,1886,19,20-24,1905,37.59351743978645
SIM,1882,28,50-100,1910,3
SIM,1900,32,25-29,1932,35
STAT,1932,33,40-44,1965,10.500760467472135
SIM,1870,46,na,1916,4420
STAT,1953,16,20-24,1969,331.29048141166834
STAT,1928,42,15-19,1970,0.003953248926642813
SIM,1952,18,20-24,1970,355
SIM,1882,79,na,1961,1761
STAT,1950,15,40-44,1965,3.341690993583314
STAT,1837,23,35-39,1860,10.57313880455671
SIM,1838,33,45-49,1871,3
STAT,1900,33,30-34,1933,48.70914863478003
SIM,1905,23,30-34,1928,70
SIM,1823,68,na,1891,1610
SIM,1873,40,50-100,1913,4
SIM,1903,15,20-24,1918,62
STAT,1932,39,35-39,1971,6.549950751931006
SIM,1937,29,35-39,1966,29
SIM,1848,23,50-100,1871,5
STAT,1920,32,45-49,1952,3.480221635526419
SIM,1914,29,40-44,1943,5
STAT,1803,71,na,1874,1283.2279668176893
STAT,1839,31,45-49,1870,3.385760196617752
STAT,1906,29,40-44,1935,8.752769411679653
STAT,1897,24,45-49,1921,1.8707336595940165
STAT,1883,76,na,1959,2148.6791646111515
SIM,1901,43,40-44,1944,1
STAT,1824,65,na,1889,1818.8963085889814
SIM,1855,30,40-44,1885,14
STAT,1932,19,na,1951,9791.323130795523
SIM,1903,37,50-100,1940,2
STAT,1894,28,na,1922,6169.793898369474
STAT,1921,25,15-19,1946,1.5994019119387004
STAT,1807,85,na,1892,218.81613985123533
STAT,1890,14,na,1904,6345.677597010708
STAT,1898,17,15-19,1915,16.219647915816093
STAT,1902,41,40-44,1943,0.4473792675544577
SIM,1834,35,50-100,1869,3
SIM,1885,12,na,1897,5417
SIM,1885,47,50-100,1932,1
SIM,1919,38,30-34,1957,2
STAT,1915,27,40-44,1942,9.602381510514052
STAT,1918,28,20-24,1946,39.08871718505899
STAT,1932,31,25-29,1963,24.830840817593817
SIM,1917,25,50-100,1942,3
SIM,1845,23,35-39,1868,14
STAT,1942,19,50-100,1961,0.7902264568468036
STAT,1888,31,40-44,1919,10.394329645880681
SIM,1922,35,25-29,1957,2
STAT,1906,21,30-34,1927,52.578817666690775
STAT,1930,23,15-19,1953,13.729795539826917
STAT,1940,30,20-24,1970,5.104525314583869
SIM,1876,22,25-29,1898,131
SIM,1941,18,45-49,1959,1
STAT,1831,48,40-44,1879,0.25864961407810216
SIM,1862,20,30-34,1882,47
SIM,1924,43,35-39,1967,1
STAT,1854,63,na,1917,2735.315714154201
STAT,1933,18,45-49,1951,1.3471383613202572
STAT,1858,77,na,1935,1360.914834346024
STAT,1877,20,25-29,1897,120.76940923748793
STAT,1925,41,35-39,1966,0.49297797035788343
STAT,1941,17,40-44,1958,2.9097896454556587
SIM,1888,34,50-100,1922,2
STAT,1923,33,25-29,1956,21.379293950811665
SIM,1907,31,40-44,1938,12
STAT,1854,20,30-34,1874,32.54932467214737
SIM,1861,85,na,1946,393
SIM,1843,15,25-29,1858,12
SIM,1829,40,40-44,1869,5
STAT,1816,46,na,1862,2962.228871248106
SIM,1931,33,25-29,1964,26
STAT,1845,27,na,1872,4057.4163712062564
STAT,1781,104,na,1885,0.06553997534240899
SIM,1849,33,20-24,1882,7
SIM,1787,68,na,1855,1254
SIM,1809,96,na,1905,15
SIM,1896,31,40-44,1927,17
STAT,1914,35,25-29,1949,2.00462897305645
STAT,1865,21,45-49,1886,1.3043716861070134
STAT,1922,17,30-34,1939,28.481569688960803
SIM,1783,86,na,1869,110
SIM,1914,21,30-34,1935,83
STAT,1919,44,15-19,1963,0.0033491509178539837
STAT,1847,30,40-44,1877,7.924608544770558
STAT,1947,25,35-39,1972,34.331474771900616
STAT,1824,110,na,1934,2.954429889897136E-4
STAT,1860,16,na,1876,4367.649114374194
STAT,1896,19,na,1915,6698.232754343069
STAT,1912,27,15-19,1939,1.405401746059546
STAT,1931,32,20-24,1963,6.455147966324394
SIM,1936,21,na,1957,6298
SIM,1915,45,35-39,1960,1
STAT,1909,17,15-19,1926,17.98397672576869
SIM,1856,37,50-100,1893,5
SIM,1865,16,15-19,1881,9
STAT,1796,84,na,1880,225.64071407971133
STAT,1846,21,35-39,1867,11.108333568088595
SIM,1928,34,na,1962,9658
STAT,1929,34,30-34,1963,40.36158650182584
SIM,1924,20,na,1944,9042
SIM,1920,27,15-19,1947,2
STAT,1924,25,40-44,1949,11.031859406290156
STAT,1841,45,na,1886,3364.2689325165156
SIM,1899,32,20-24,1931,10
SIM,1836,86,na,1922,223
SIM,1887,20,35-39,1907,19
SIM,1854,21,35-39,1875,17
SIM,1842,49,50-100,1891,1
STAT,1786,74,na,1860,796.6275679297248
SIM,1907,26,45-49,1933,4
STAT,1858,20,15-19,1878,6.045940857729881
SIM,1930,17,30-34,1947,42
STAT,1944,18,20-24,1962,294.5497318264134
SIM,1832,72,na,1904,1580
SIM,1840,91,na,1931,67
STAT,1903,40,45-49,1943,0.30187209211926935
STAT,1870,26,na,1896,4748.302508164271
SIM,1833,24,50-100,1857,1
SIM,1884,36,50-100,1920,5
SIM,1910,36,45-49,1946,3
STAT,1873,66,na,1939,3363.3408016421504
SIM,1907,40,na,1947,6996
SIM,1953,17,25-29,1970,138
SIM,1802,74,na,1876,1048
STAT,1915,47,35-39,1962,0.26240537152087
STAT,1835,20,20-24,1855,146.19874849283812
STAT,1914,40,20-24,1954,0.0355952494098051
SIM,1910,41,40-44,1951,1
STAT,1857,16,15-19,1873,11.045304837595715
STAT,1875,57,na,1932,4178.72938380837
STAT,1930,36,20-24,1966,0.6950578218099835
STAT,1794,93,na,1887,14.660195317660774
SIM,1937,34,30-34,1971,29
STAT,1850,52,35-39,1902,0.013129739732903729
SIM,1808,79,na,1887,557
STAT,1860,39,20-24,1899,1.2515318531567599
SIM,1898,24,50-100,1922,5
STAT,1913,39,25-29,1952,1.9431392769144908
SIM,1848,24,15-19,1872,5
SIM,1925,39,50-100,1964,3
SIM,1804,65,na,1869,1665
SIM,1899,27,25-29,1926,120
STAT,1929,29,35-39,1958,37.90710997411007
STAT,1945,17,25-29,1962,95.59791374976648
STAT,1946,26,30-34,1972,88.18295974175203
SIM,1917,17,15-19,1934,17
STAT,1900,20,25-29,1920,161.33763175952095
STAT,1902,36,45-49,1938,1.2327724909341566
SIM,1884,16,25-29,1900,13
STAT,1887,58,na,1945,4466.982702197221
STAT,1883,44,na,1927,4524.227353380503
STAT,1872,49,40-44,1921,0.3402362159194016
SIM,1856,31,na,1887,4098
SIM,1835,46,50-100,1881,1
STAT,1873,20,40-44,1893,4.301606286995531
SIM,1888,32,45-49,1920,5
SIM,1906,47,35-39,1953,1
SIM,1849,34,50-100,1883,2
STAT,1855,49,40-44,1904,0.25276821569972924
STAT,1891,63,na,1954,4454.305175534557
SIM,1823,36,na,1859,3299
SIM,1870,78,na,1948,1393
STAT,1879,39,na,1918,4926.857082795484
STAT,1895,77,na,1972,3263.842036726355
STAT,1933,23,40-44,1956,9.005478385707075
STAT,1931,23,50-100,1954,1.7182921284527402
STAT,1800,104,na,1904,0.0569699320683574
STAT,1916,23,40-44,1939,7.093676959474106
STAT,1938,32,30-34,1970,31.999755506891717
SIM,1875,23,20-24,1898,186
STAT,1920,29,15-19,1949,1.5524822477268134
STAT,1903,29,15-19,1932,1.295325383570848
SIM,1935,26,20-24,1961,57
STAT,1919,27,25-29,1946,143.6016224254031
STAT,1859,24,25-29,1883,94.10952691425139
SIM,1871,95,na,1966,71
STAT,1910,30,35-39,1940,17.945193314504518
SIM,1811,67,na,1878,1586
STAT,1914,18,35-39,1932,1.7487429881943721
STAT,1832,52,na,1884,2903.463110464923
SIM,1930,21,15-19,1951,11
STAT,1865,47,na,1912,4108.788033833273
SIM,1862,59,na,1921,3573
SIM,1919,41,na,1960,8208
SIM,1887,18,50-100,1905,1
STAT,1922,34,20-24,1956,5.5372779535647085
STAT,1887,22,35-39,1909,13.181139627020103
STAT,1903,38,na,1941,6794.349217998741
SIM,1915,25,40-44,1940,17
SIM,1843,20,20-24,1863,145
SIM,1924,23,40-44,1947,13
SIM,1905,18,35-39,1923,2
STAT,1803,54,15-19,1857,1.735698411856518E-4
STAT,1910,38,45-49,1948,1.3107280118697524
SIM,1929,32,30-34,1961,47
SIM,1936,17,25-29,1953,85
SIM,1959,5,na,1964,10853
SIM,1890,66,na,1956,4250
STAT,1904,46,20-24,1950,0.019677277264999394
STAT,1918,48,15-19,1966,7.893610282095896E-4
SIM,1922,18,35-39,1940,10
STAT,1765,103,na,1868,0.09423182420676587
SIM,1836,30,30-34,1866,45
SIM,1886,21,30-34,1907,57
SIM,1930,34,20-24,1964,6
SIM,1932,25,40-44,1957,12
SIM,1895,22,35-39,1917,17
STAT,1858,33,20-24,1891,4.2377859720342315
STAT,1875,25,na,1900,4996.087549637115
SIM,1848,12,na,1860,4550
SIM,1830,42,50-100,1872,3
STAT,1927,26,20-24,1953,44.965372655060214
STAT,1925,24,45-49,1949,2.7024887777830373
STAT,1870,45,15-19,1915,8.010374007605696E-4
SIM,1867,24,25-29,1891,112
SIM,1828,31,35-39,1859,22
SIM,1855,26,50-100,1881,4
SIM,1941,23,40-44,1964,8
STAT,1782,92,na,1874,21.923124761767262
STAT,1890,20,50-100,1910,1.0112649414835688
STAT,1932,19,40-44,1951,3.720774016411165
SIM,1863,49,40-44,1912,1
STAT,1907,45,35-39,1952,0.23675353413178024
SIM,1940,19,40-44,1959,5
SIM,1879,34,45-49,1913,6
SIM,1904,0,na,1904,7974
SIM,1943,23,na,1966,7982
STAT,1906,7,na,1913,7667.41787751525
SIM,1926,28,20-24,1954,46
STAT,1896,20,35-39,1916,15.652728406833168
SIM,1912,46,20-24,1958,2
STAT,1860,54,45-49,1914,0.023147033914018646
STAT,1837,83,na,1920,553.3028158868949
SIM,1900,31,30-34,1931,69
STAT,1880,52,20-24,1932,0.0015616195770749171
SIM,1921,19,30-34,1940,37
SIM,1906,35,40-44,1941,8
STAT,1779,110,na,1889,0.0034612496245490674
STAT,1825,82,na,1907,539.8525356390029
STAT,1868,22,25-29,1890,109.99895349786526
STAT,1907,25,40-44,1932,8.952244886246804
STAT,1829,96,na,1925,10.162387319123654
STAT,1915,39,na,1954,7599.109459537706
SIM,1911,29,15-19,1940,2
STAT,1778,87,na,1865,115.7935128168148
STAT,1864,30,40-44,1894,7.892047002595511
STAT,1911,25,na,1936,7430.502322085383
STAT,1828,107,na,1935,0.005791453700197329
SIM,1824,85,na,1909,284
SIM,1902,19,20-24,1921,41
STAT,1852,29,na,1881,3973.8743623356963
STAT,1908,24,45-49,1932,2.0774063481368517
STAT,1895,21,30-34,1916,47.01686921680368
SIM,1795,87,na,1882,105
SIM,1844,30,50-100,1874,2
SIM,1791,73,na,1864,832
SIM,1939,18,na,1957,7609
SIM,1927,27,25-29,1954,175
SIM,1921,23,15-19,1944,11
SIM,1901,30,35-39,1931,39
SIM,1928,31,50-100,1959,2
SIM,1878,22,35-39,1900,16
STAT,1834,49,20-24,1883,0.016511887584539878
STAT,1867,23,20-24,1890,129.94002693759322
STAT,1828,30,30-34,1858,41.61219985227926
STAT,1933,35,35-39,1968,6.665872920652729
SIM,1925,3,na,1928,9896
STAT,1927,38,15-19,1965,0.04816342578896928
SIM,1847,31,45-49,1878,4
STAT,1817,49,20-24,1866,0.05617487744619982
STAT,1913,19,30-34,1932,5.0073588596216565
STAT,1878,0,na,1878,7678.310884516353
STAT,1889,22,45-49,1911,1.7364930896093944
SIM,1799,69,na,1868,1332
STAT,1898,10,na,1908,7079.588222491666
STAT,1820,51,na,1871,2725.316847095684
SIM,1882,47,na,1929,4625
SIM,1884,21,20-24,1905,142
SIM,1914,43,50-100,1957,1
STAT,1911,57,na,1968,6717.754173111095
STAT,1938,27,35-39,1965,30.044760312529803
SIM,1840,32,50-100,1872,4
STAT,1924,45,35-39,1969,0.3113713713487502
SIM,1815,49,na,1864,2581
STAT,1914,23,30-34,1937,59.13002810883586
SIM,1897,22,45-49,1919,2
STAT,1824,33,na,1857,3077.646213242319
SIM,1845,20,30-34,1865,43
SIM,1916,24,45-49,1940,1
SIM,1869,81,na,1950,832
SIM,1908,5,na,1913,7927
STAT,1937,28,30-34,1965,77.11748661239098
SIM,1781,101,na,1882,1
SIM,1874,28,na,1902,4626
SIM,1909,28,20-24,1937,35
STAT,1923,46,30-34,1969,0.2110718958366642
SIM,1901,38,45-49,1939,1
STAT,1849,22,15-19,1871,6.309190792651651
STAT,1923,5,na,1928,9532.26735074243
SIM,1857,22,15-19,1879,6
STAT,1828,47,na,1875,3061.790211096992
STAT,1904,33,15-19,1937,0.2360310977756992
STAT,1806,68,na,1874,1467.8622999326979
STAT,1802,54,na,1856,2415.041877638176
SIM,1931,30,20-24,1961,12
SIM,1812,52,na,1864,2618
SIM,1868,20,25-29,1888,136
SIM,1889,17,15-19,1906,13
STAT,1836,34,na,1870,3567.3532396149394
STAT,1852,15,25-29,1867,11.053311041132261
STAT,1925,17,na,1942,8978.083166677223
STAT,1938,24,30-34,1962,57.418925174243846
STAT,1928,38,30-34,1966,4.646495874523023
SIM,1888,24,45-49,1912,5
SIM,1920,15,20-24,1935,305
STAT,1887,26,na,1913,5409.160538280216
STAT,1877,16,40-44,1893,0.38451872007536925
SIM,1856,26,15-19,1882,1
STAT,1787,91,na,1878,35.51877590244
STAT,1891,31,50-100,1922,2.296646343977384
STAT,1891,31,na,1922,5981.488841919183
STAT,1950,18,45-49,1968,1.1924466231814044
STAT,1832,39,45-49,1871,3.214574817522955
STAT,1895,45,na,1940,5980.888848183598
SIM,1923,39,35-39,1962,10
STAT,1808,109,na,1917,5.59065739730434E-4
STAT,1915,39,35-39,1954,4.885526600392262
SIM,1938,16,50-100,1954,1
SIM,1844,30,na,1874,3670
STAT,1935,21,50-100,1956,1.8105650132618332
SIM,1848,44,na,1892,3489
STAT,1915,31,25-29,1946,19.090446698365177
SIM,1878,42,na,1920,5069
STAT,1956,15,35-39,1971,11.218125056194943
STAT,1814,48,40-44,1862,0.8732249080344683
STAT,1899,34,20-24,1933,7.415699826657899
STAT,1901,24,35-39,1925,16.395768473634
STAT,1912,15,20-24,1927,55.639867683941745
STAT,1795,67,na,1862,1582.0834736287234
STAT,1816,50,50-100,1866,0.0740846835461198
STAT,1854,23,35-39,1877,10.435434452538626
SIM,1852,39,50-100,1891,4
SIM,1907,34,45-49,1941,5
STAT,1803,102,na,1905,0.20690173315776852
STAT,1923,30,20-24,1953,5.690949839587665
STAT,1831,67,na,1898,2046.7509942609868
STAT,1914,0,na,1914,9382.724348321104
SIM,1932,39,na,1971,10262
STAT,1901,15,45-49,1916,0.1855489257684393
SIM,1948,22,na,1970,8639
STAT,1847,33,45-49,1880,3.088802949380298
STAT,1922,29,25-29,1951,149.30494813057467
STAT,1930,19,30-34,1949,31.654579471381236
STAT,1913,23,15-19,1936,10.825354123777545
STAT,1944,20,na,1964,7968.117291314205
STAT,1868,12,na,1880,5132.0809255365675
STAT,1930,28,20-24,1958,46.85371821353126
STAT,1906,46,30-34,1952,0.16115059308301724
SIM,1903,27,15-19,1930,2
STAT,1852,49,15-19,1901,6.242125510394537E-4
SIM,1862,23,35-39,1885,13
STAT,1903,37,15-19,1940,0.03485316432438364
STAT,1910,43,40-44,1953,0.47472373934010287
SIM,1841,97,na,1938,2
SIM,1817,83,na,1900,329
SIM,1855,33,45-49,1888,5
SIM,1930,29,25-29,1959,196
STAT,1861,65,na,1926,2840.8411734974607
SIM,1899,15,30-34,1914,3
STAT,1865,79,na,1944,1282.726171347248
SIM,1852,17,na,1869,4551
STAT,1902,44,45-49,1946,0.29233970509328766
SIM,1935,34,50-100,1969,6
SIM,1946,24,30-34,1970,81
SIM,1902,34,45-49,1936,3
STAT,1848,26,15-19,1874,0.8945458182965285
SIM,1816,66,na,1882,1772
STAT,1893,6,na,1899,6687.316108637807
STAT,1928,17,25-29,1945,110.26186793084025
SIM,1817,37,50-100,1854,3
SIM,1865,24,na,1889,4426
STAT,1908,49,45-49,1957,0.39490113527114556
STAT,1874,51,na,1925,4473.871204170352
STAT,1907,20,na,1927,7062.208542378173
SIM,1912,16,25-29,1928,23
STAT,1844,85,na,1929,442.70353628826393
STAT,1888,34,45-49,1922,4.126978477842756
STAT,1848,99,na,1947,3.105387480631108
SIM,1866,32,50-100,1898,3
STAT,1840,71,na,1911,1926.7050642078445
SIM,1906,27,40-44,1933,11
STAT,1905,25,30-34,1930,74.04979862060624
STAT,1907,33,40-44,1940,7.360453342611651
SIM,1866,33,20-24,1899,9
SIM,1822,48,40-44,1870,2
SIM,1866,8,na,1874,5376
STAT,1816,78,na,1894,767.4660116947862
STAT,1913,44,20-24,1957,0.03467508425602597
STAT,1923,16,35-39,1939,9.972464347203577
SIM,1846,40,40-44,1886,8
SIM,1873,11,na,1884,5551
SIM,1899,24,20-24,1923,150
SIM,1931,16,35-39,1947,14
SIM,1842,82,na,1924,615
STAT,1881,39,40-44,1920,8.459237222308431
STAT,1931,40,20-24,1971,0.0477826895604448
STAT,1889,81,na,1970,2259.523419305788
STAT,1900,41,na,1941,6526.988546908438
STAT,1922,21,15-19,1943,12.362587764663255
STAT,1847,61,na,1908,2848.4393774459877
STAT,1871,49,25-29,1920,0.11316214069713534
STAT,1925,46,40-44,1971,0.38672699243759684
SIM,1898,23,15-19,1921,5
SIM,1849,36,25-29,1885,10
SIM,1849,61,na,1910,3013
STAT,1840,111,na,1951,1.5492802706970187E-4
SIM,1829,43,45-49,1872,10
SIM,1838,30,40-44,1868,3
SIM,1860,15,25-29,1875,15
STAT,1924,28,45-49,1952,4.047099026405129
SIM,1878,30,35-39,1908,30
SIM,1913,25,30-34,1938,99
SIM,1792,90,na,1882,31
SIM,1840,39,45-49,1879,5
SIM,1896,34,45-49,1930,10
SIM,1889,45,50-100,1934,2
STAT,1874,16,15-19,1890,12.302286046503484
STAT,1936,33,na,1969,7416.077251701321
STAT,1935,16,50-100,1951,1.0371362828563948
SIM,1920,38,na,1958,8485
STAT,1897,21,40-44,1918,5.642521693264789
STAT,1908,41,35-39,1949,0.3786802357162083
SIM,1882,16,15-19,1898,10
SIM,1916,49,45-49,1965,2
STAT,1941,21,25-29,1962,192.85753370190446
SIM,1915,33,40-44,1948,14
SIM,1907,23,40-44,1930,7
SIM,1852,49,na,1901,3573
SIM,1871,63,na,1934,3405
SIM,1846,96,na,1942,6
SIM,1839,39,50-100,1878,6
STAT,1846,44,na,1890,3492.3617044362627
STAT,1904,16,25-29,1920,16.466714250700615
STAT,1842,30,na,1872,3979.6522023365433
SIM,1875,77,na,1952,1765
STAT,1936,36,15-19,1972,0.03811687243353668
SIM,1878,10,na,1888,5674
STAT,1869,17,45-49,1886,0.12960235125222833
STAT,1916,18,45-49,1934,0.21348710862943132
STAT,1838,40,40-44,1878,3.6524976815098715
SIM,1905,15,30-34,1920,10
STAT,1904,55,na,1959,6153.068813002884
STAT,1941,29,35-39,1970,31.337107982853116
SIM,1834,20,na,1854,3816
SIM,1902,26,50-100,1928,2
SIM,1916,41,35-39,1957,1
STAT,1919,49,20-24,1968,0.02406115400271944
STAT,1852,26,50-100,1878,1.1960978435720753
SIM,1841,43,50-100,1884,5
SIM,1900,22,40-44,1922,9
SIM,1932,28,45-49,1960,8
SIM,1911,40,45-49,1951,1
STAT,1841,30,50-100,1871,1.6468162715136085
SIM,1801,89,na,1890,63
STAT,1924,42,30-34,1966,0.30703612950203063
STAT,1931,15,30-34,1946,32.37176454224425
SIM,1849,20,15-19,1869,8
STAT,1940,25,25-29,1965,135.6819472958697
STAT,1916,26,45-49,1942,3.61998388202903
STAT,1839,23,45-49,1862,1.3889567436017771
SIM,1863,33,na,1896,4416
SIM,1939,27,50-100,1966,2
SIM,1904,39,25-29,1943,2
STAT,1852,52,45-49,1904,0.02300690095625766
STAT,1873,23,45-49,1896,1.4265213882704997
STAT,1920,24,45-49,1944,2.5099015934407145
SIM,1896,39,na,1935,6618
SIM,1892,25,na,1917,6889
STAT,1920,18,na,1938,8316.432643534927
STAT,1882,27,na,1909,4695.237889301989
SIM,1887,41,40-44,1928,11
STAT,1899,3,na,1902,7315.322850462163
SIM,1838,28,50-100,1866,1
STAT,1900,28,35-39,1928,26.937519488046156
STAT,1892,80,na,1972,2554.13016039624
STAT,1879,41,40-44,1920,4.773043343785956
SIM,1918,29,25-29,1947,158
STAT,1912,48,20-24,1960,0.021395751064626455
SIM,1914,37,40-44,1951,7
STAT,1876,21,20-24,1897,144.3831267927302
STAT,1901,32,35-39,1933,28.632952465520553
SIM,1841,15,15-19,1856,9
STAT,1956,6,na,1962,10504.170890075462
STAT,1853,37,50-100,1890,1.9425363888095097
SIM,1938,25,35-39,1963,39
STAT,1807,53,na,1860,2572.053664928928
STAT,1913,27,30-34,1940,78.86945420014212
STAT,1775,90,na,1865,43.08480007540747
STAT,1887,5,na,1892,5919.479082028183
SIM,1825,32,20-24,1857,4
SIM,1859,26,40-44,1885,9
SIM,1913,17,30-34,1930,11
SIM,1925,19,15-19,1944,102
STAT,1857,105,na,1962,0.17095436793760652
SIM,1883,64,na,1947,3543
STAT,1906,37,40-44,1943,2.7806276602403135
STAT,1880,7,na,1887,5643.300187204683
STAT,1884,23,20-24,1907,137.00549251916587
STAT,1849,30,15-19,1879,0.2663177183634119
SIM,1921,27,30-34,1948,104
STAT,1862,21,50-100,1883,0.7258149177521303
SIM,1897,30,45-49,1927,9
SIM,1789,91,na,1880,16
STAT,1889,30,45-49,1919,4.377429132908957
STAT,1901,1,na,1902,7695.720903653485
SIM,1887,78,na,1965,2469
STAT,1858,16,30-34,1874,2.9487006223290346
STAT,1917,19,15-19,1936,97.77443811010008
SIM,1866,16,30-34,1882,2
STAT,1905,17,30-34,1922,4.655343051852762
SIM,1848,16,15-19,1864,12
SIM,1889,20,45-49,1909,3
STAT,1866,51,50-100,1917,0.028278324185219295
SIM,1847,23,45-49,1870,1
SIM,1924,26,45-49,1950,7
STAT,1836,98,na,1934,4.319205687091673
SIM,1857,48,na,1905,3955
STAT,1928,34,15-19,1962,0.32404767322742295
SIM,1892,23,20-24,1915,191
STAT,1911,43,50-100,1954,0.22516228125089463
STAT,1832,84,na,1916,433.6989481806749
SIM,1895,4,na,1899,7351
STAT,1936,32,50-100,1968,1.6222322611961837
STAT,1923,49,35-39,1972,0.3027273323725045
SIM,1906,55,na,1961,6311
SIM,1902,41,na,1943,6787
STAT,1943,17,15-19,1960,97.19250310290353
SIM,1928,36,30-34,1964,9
STAT,1830,48,25-29,1878,0.0981497764396013
STAT,1821,38,30-34,1859,19.621173750249106
STAT,1912,42,na,1954,7236.1483496799365
STAT,1916,43,35-39,1959,0.41609860198740106
SIM,1906,38,45-49,1944,1
SIM,1870,39,30-34,1909,14
STAT,1935,3,na,1938,11200.64695599083
SIM,1835,21,25-29,1856,121
SIM,1879,31,40-44,1910,10
SIM,1933,21,40-44,1954,8
STAT,1878,20,40-44,1898,4.421604737714565
STAT,1899,17,30-34,1916,4.410457765046732
SIM,1937,1,na,1938,8269
SIM,1865,99,na,1964,2
STAT,1908,16,45-49,1924,0.19631062938217028
STAT,1811,48,15-19,1859,0.0026691148086085002
SIM,1923,31,25-29,1954,27
STAT,1889,27,15-19,1916,1.1298249702608272
SIM,1832,29,na,1861,3651
STAT,1877,80,na,1957,1450.50095191743
STAT,1942,16,45-49,1958,1.054636864881244
STAT,1916,56,na,1972,7326.565636903845
SIM,1862,34,50-100,1896,2
SIM,1882,5,na,1887,5537
STAT,1873,17,50-100,1890,0.10053408461446636
STAT,1890,20,40-44,1910,5.167563475021186
SIM,1918,36,50-100,1954,3
STAT,1862,50,na,1912,3770.212729348918
SIM,1898,30,na,1928,6805
STAT,1904,38,20-24,1942,0.4799029132303093
STAT,1853,46,na,1899,3569.8080037288096
STAT,1866,64,na,1930,3239.3956508390047
STAT,1862,39,30-34,1901,9.107330637988253
SIM,1912,38,20-24,1950,1
STAT,1856,11,na,1867,4418.575110939361
STAT,1868,30,25-29,1898,19.839636693934782
STAT,1925,21,40-44,1946,8.151268074021141
STAT,1919,21,na,1940,8098.68710559269
STAT,1843,22,20-24,1865,121.16972895361711
SIM,1950,16,45-49,1966,2
STAT,1861,33,na,1894,3994.480763371134
SIM,1851,22,20-24,1873,134
SIM,1853,98,na,1951,4
STAT,1895,24,35-39,1919,15.260691209603928
SIM,1890,28,50-100,1918,2
SIM,1879,19,20-24,1898,38
SIM,1859,19,50-100,1878,4
STAT,1934,31,35-39,1965,25.21705099745235
SIM,1932,17,40-44,1949,6
STAT,1867,26,25-29,1893,80.28452106244775
SIM,1840,16,na,1856,4718
SIM,1935,34,20-24,1969,8
STAT,1806,49,45-49,1855,1.3944490184400844
STAT,1924,17,40-44,1941,3.3630354956694726
SIM,1927,24,20-24,1951,271
STAT,1837,41,50-100,1878,1.7603080486166787
STAT,1923,41,25-29,1964,0.16875214157966825
STAT,1924,43,na,1967,8905.328709432135
SIM,1905,26,35-39,1931,37
STAT,1890,78,na,1968,2746.167256254275
STAT,1932,27,40-44,1959,12.330703696210842
SIM,1861,2,na,1863,6318
STAT,1927,34,20-24,1961,6.051047688082732
STAT,1824,97,na,1921,5.7436574732319
STAT,1879,20,35-39,1899,12.400869891651004
STAT,1922,37,25-29,1959,2.2620819964342243
SIM,1827,32,50-100,1859,2
SIM,1845,41,50-100,1886,3
SIM,1927,20,50-100,1947,2
SIM,1944,19,25-29,1963,118
STAT,1910,35,40-44,1945,2.920049517877536
STAT,1932,34,50-100,1966,2.2170757135479957
STAT,1820,83,na,1903,444.4298742943974
STAT,1936,19,25-29,1955,83.3591883959642
SIM,1814,49,45-49,1863,2
SIM,1903,26,na,1929,7053
SIM,1829,84,na,1913,388
SIM,1930,37,25-29,1967,4
SIM,1836,33,35-39,1869,24
STAT,1914,27,25-29,1941,134.03158778940215
SIM,1858,31,20-24,1889,9
STAT,1905,42,20-24,1947,0.03217159605688181
SIM,1922,27,25-29,1949,176
STAT,1828,33,35-39,1861,22.02364410272844
SIM,1790,88,na,1878,74
SIM,1828,67,na,1895,1920
SIM,1940,27,40-44,1967,15
STAT,1919,24,20-24,1943,244.31795803883634
SIM,1914,42,na,1956,7576
SIM,1824,53,na,1877,2881
SIM,1868,0,na,1868,7093
STAT,1840,38,40-44,1878,7.3962332379000415
STAT,1866,2,na,1868,6294.779948602549
STAT,1896,40,50-100,1936,0.19758883663855756
STAT,1919,16,20-24,1935,60.843390374806965
SIM,1849,24,30-34,1873,50
STAT,1860,48,na,1908,3643.561194910179
SIM,1777,90,na,1867,42
SIM,1921,47,25-29,1968,1
SIM,1849,29,na,1878,4210
SIM,1938,2,na,1940,8132
STAT,1914,26,35-39,1940,30.67744072780329
SIM,1914,30,20-24,1944,4
STAT,1882,52,50-100,1934,0.029554921093028496
STAT,1940,17,25-29,1957,88.86941798566063
STAT,1851,52,50-100,1903,0.023287385628361617
STAT,1926,42,40-44,1968,0.6226477313525207
STAT,1894,60,na,1954,4947.980867374129
SIM,1906,39,35-39,1945,8
STAT,1871,46,50-100,1917,0.4941992386141797
STAT,1874,53,35-39,1927,0.017516957942516106
STAT,1834,22,50-100,1856,0.7259798511149939
SIM,1826,33,na,1859,3413
SIM,1955,0,na,1955,10141
STAT,1898,74,na,1972,3965.2913520987363
SIM,1834,52,na,1886,2840
STAT,1870,49,30-34,1919,0.18793016575001997
SIM,1809,64,na,1873,1739
SIM,1805,50,na,1855,2425
SIM,1834,39,20-24,1873,6
SIM,1888,21,40-44,1909,3
STAT,1829,32,na,1861,3364.9111973979866
SIM,1867,15,35-39,1882,2
SIM,1915,17,40-44,1932,1
SIM,1946,6,na,1952,8694
SIM,1921,28,20-24,1949,44
SIM,1925,44,40-44,1969,2
STAT,1827,30,na,1857,3578.6436188340776
STAT,1830,28,30-34,1858,54.841406661421615
SIM,1845,15,na,1860,4790
SIM,1918,37,25-29,1955,3
SIM,1873,26,15-19,1899,3
SIM,1877,25,na,1902,4955
STAT,1906,43,50-100,1949,0.21434120203856902
SIM,1942,17,na,1959,7898
STAT,1887,30,35-39,1917,23.058814548303435
STAT,1905,61,na,1966,5930.191535470348
SIM,1922,26,35-39,1948,45
STAT,1854,54,20-24,1908,0.0011001131997955048
STAT,1888,16,50-100,1904,0.11723402856560995
STAT,1914,30,50-100,1944,1.694631179565538
STAT,1759,112,na,1871,6.308012368760274E-4
STAT,1826,35,50-100,1861,3.1139153571625835
STAT,1851,109,na,1960,0.0030025069183186696
STAT,1920,37,15-19,1957,0.04245358171181102
STAT,1855,40,40-44,1895,3.425984453160982
STAT,1876,24,25-29,1900,118.82947359650966
SIM,1930,25,30-34,1955,133
SIM,1831,38,40-44,1869,12
STAT,1926,34,na,1960,9222.566635174606
SIM,1872,80,na,1952,1160
STAT,1901,41,25-29,1942,0.12665050484656257
STAT,1901,21,30-34,1922,50.513944057049684
STAT,1913,47,25-29,1960,0.10459134012884755
SIM,1823,39,45-49,1862,4
STAT,1902,28,45-49,1930,3.1547147280920154
SIM,1889,3,na,1892,6735
SIM,1904,35,30-34,1939,7
STAT,1842,41,50-100,1883,1.6482776979293476
SIM,1907,18,45-49,1925,2
SIM,1834,63,na,1897,2348
SIM,1879,27,na,1906,4932
SIM,1910,28,45-49,1938,4
SIM,1927,16,20-24,1943,343
STAT,1825,109,na,1934,8.23184356102711E-4
STAT,1936,28,15-19,1964,1.3640932537506165
STAT,1823,38,40-44,1861,16.318717661373466
STAT,1856,43,na,1899,3575.4412924731596
STAT,1859,15,35-39,1874,1.0360368573922412
STAT,1924,21,25-29,1945,220.7320603349514
SIM,1875,26,25-29,1901,86
SIM,1808,49,20-24,1857,1
SIM,1884,24,25-29,1908,4
SIM,1918,18,20-24,1936,329
STAT,1881,10,na,1891,5056.526890537645
SIM,1798,84,na,1882,175
STAT,1759,101,na,1860,0.10776173758087965
STAT,1815,39,45-49,1854,13.93143015982317
SIM,1794,70,na,1864,1211
STAT,1851,53,40-44,1904,0.01605774774400847
STAT,1929,43,20-24,1972,0.04611272153239813
STAT,1921,16,25-29,1937,99.9826129925548
SIM,1876,94,na,1970,209
SIM,1932,21,25-29,1953,288
STAT,1851,98,na,1949,5.035832095152678
SIM,1870,14,na,1884,5136
STAT,1907,41,40-44,1948,0.46573923678252693
SIM,1932,29,35-39,1961,51
SIM,1862,49,25-29,1911,1
STAT,1919,48,30-34,1967,0.19469490904093645
STAT,1785,89,na,1874,79.24441201279654
STAT,1922,25,30-34,1947,90.1279125396968
STAT,1848,24,na,1872,4207.716702889758
STAT,1907,17,50-100,1924,0.14542564963263513
SIM,1917,39,na,1956,8003
SIM,1920,22,45-49,1942,5
SIM,1780,89,na,1869,63
STAT,1900,24,40-44,1924,5.801502725416536
STAT,1940,16,35-39,1956,8.607633177328747
SIM,1913,25,na,1938,7711
STAT,1781,75,na,1856,766.0960836174
STAT,1859,62,na,1921,2938.0580391597905
SIM,1839,62,na,1901,2423
SIM,1872,39,40-44,1911,14
STAT,1834,49,50-100,1883,0.3379432858501904
SIM,1925,31,35-39,1956,8
SIM,1827,49,30-34,1876,1
STAT,1830,29,na,1859,3881.9348025483123
STAT,1929,30,15-19,1959,0.3300013555873238
SIM,1876,83,na,1959,1143
STAT,1909,54,na,1963,6643.5416441462485
STAT,1939,28,40-44,1967,9.459972225295825
SIM,1847,81,na,1928,787
STAT,1907,36,45-49,1943,1.2833641625654453
STAT,1905,40,na,1945,6842.289497409912
SIM,1902,31,40-44,1933,20
STAT,1841,29,45-49,1870,1.9722750179768367
STAT,1929,38,25-29,1967,2.5501143952495675
STAT,1822,51,20-24,1873,0.002251668232629085
STAT,1921,46,20-24,1967,0.02521704874032841
SIM,1901,22,35-39,1923,27
SIM,1913,21,15-19,1934,11
STAT,1819,49,30-34,1868,0.3941794317919694
STAT,1854,49,25-29,1903,0.08645642851449585
SIM,1860,29,20-24,1889,25
SIM,1898,19,na,1917,7119
STAT,1865,26,15-19,1891,0.8353152970388762
SIM,1925,27,15-19,1952,4
STAT,1876,36,50-100,1912,2.576925895745247
STAT,1910,46,45-49,1956,0.41070216007355265
STAT,1912,22,45-49,1934,2.1783783194734085
SIM,1895,30,35-39,1925,44
SIM,1892,14,na,1906,7383
STAT,1810,52,40-44,1862,0.06507538395732189
STAT,1905,29,25-29,1934,122.6701144027884
SIM,1903,30,45-49,1933,6
STAT,1926,37,50-100,1963,1.036126646884487
STAT,1899,37,25-29,1936,1.7196367064880642
STAT,1876,31,na,1907,5005.039575615017
SIM,1929,19,35-39,1948,15
STAT,1852,29,20-24,1881,19.534405846969598
SIM,1809,53,na,1862,2415
SIM,1915,36,45-49,1951,3
STAT,1811,51,45-49,1862,0.09587974367712958
STAT,1938,16,30-34,1954,24.346608393092257
STAT,1940,22,20-24,1962,228.78541912037502
SIM,1843,23,25-29,1866,106
SIM,1923,35,na,1958,9209
SIM,1946,16,30-34,1962,43
STAT,1917,27,15-19,1944,1.4950894907026027
STAT,1906,30,20-24,1936,4.604449260165801
STAT,1884,61,na,1945,3726.5647424981203
STAT,1864,39,40-44,1903,7.823209740532869
SIM,1872,30,40-44,1902,11
SIM,1913,29,25-29,1942,135
STAT,1918,36,20-24,1954,0.5637556549814966
STAT,1905,21,15-19,1926,9.664816684943762
STAT,1888,75,na,1963,2986.1087363127376
STAT,1903,24,50-100,1927,1.1652859167576612
SIM,1877,57,na,1934,4003
SIM,1873,43,na,1916,4831
SIM,1931,36,50-100,1967,6
SIM,1952,16,na,1968,9054
SIM,1933,30,30-34,1963,53
STAT,1902,33,40-44,1935,12.313297636872102
SIM,1853,39,30-34,1892,5
STAT,1838,52,50-100,1890,0.020331333932084725
STAT,1856,19,50-100,1875,0.08920792344940204
SIM,1939,29,45-49,1968,1
STAT,1835,23,25-29,1858,97.89109695775743
STAT,1926,38,20-24,1964,0.6498840087092864
SIM,1903,23,20-24,1926,208
STAT,1846,33,na,1879,3882.4160417820167
STAT,1866,32,na,1898,4446.842252827217
STAT,1884,23,50-100,1907,0.8107314458816052
STAT,1836,40,30-34,1876,1.866061216681702
STAT,1873,54,30-34,1927,0.01187906212956724
STAT,1845,59,na,1904,2994.753249593151
STAT,1876,42,na,1918,4821.911788051806
STAT,1830,101,na,1931,0.7879644912059021
STAT,1858,13,na,1871,4370.506765882426
SIM,1847,20,40-44,1867,5
STAT,1901,16,35-39,1917,1.555213492670254
SIM,1897,56,na,1953,5608
SIM,1893,42,na,1935,6112
STAT,1856,20,40-44,1876,3.825906602617102
SIM,1885,76,na,1961,2418
SIM,1881,62,na,1943,3082
STAT,1898,25,15-19,1923,1.2484214726511085
STAT,1921,17,15-19,1938,104.451481443205
SIM,1927,17,na,1944,9488
STAT,1889,27,50-100,1916,1.5929830020509048
STAT,1929,37,35-39,1966,6.270843324293784
STAT,1946,18,30-34,1964,27.292617768754546
STAT,1915,35,40-44,1950,3.0834519857029288
SIM,1913,36,na,1949,7691
STAT,1893,16,25-29,1909,14.541761082105904
STAT,1935,36,20-24,1971,0.7452683855528943
SIM,1876,30,25-29,1906,28
STAT,1925,30,30-34,1955,37.82039692056724
STAT,1841,51,30-34,1892,0.008678055374027983
SIM,1908,57,na,1965,6305
STAT,1875,39,50-100,1914,2.527214957092888
SIM,1910,33,40-44,1943,11
STAT,1920,40,45-49,1960,0.3721729087369511
STAT,1941,28,45-49,1969,3.6078040039152866
STAT,1895,13,na,1908,6785.675780731885
STAT,1922,39,50-100,1961,0.9625399789821223
SIM,1864,20,40-44,1884,8
SIM,1904,43,na,1947,6731
STAT,1936,27,25-29,1963,127.24370824756747
STAT,1911,31,40-44,1942,7.729785420694978
STAT,1941,23,na,1964,7619.534189907241
SIM,1825,70,na,1895,1497
SIM,1944,27,25-29,1971,149
STAT,1843,25,25-29,1868,73.98440494935363
STAT,1847,50,na,1897,3329.329662288747
STAT,1881,8,na,1889,5105.111912864189
STAT,1949,17,45-49,1966,1.1732841068516078
STAT,1839,20,40-44,1859,4.241328819514739
SIM,1844,40,30-34,1884,2
SIM,1851,25,25-29,1876,89
STAT,1802,86,na,1888,160.86744320659938
SIM,1885,16,40-44,1901,3
STAT,1880,79,na,1959,1791.1090771241425
SIM,1845,47,na,1892,3683
STAT,1926,23,na,1949,8930.834644084434
SIM,1841,33,na,1874,3815
SIM,1897,45,na,1942,6208
SIM,1899,35,25-29,1934,13
STAT,1836,49,30-34,1885,0.13131381804566292
SIM,1893,31,na,1924,6286
STAT,1888,42,45-49,1930,3.568179149865577
STAT,1937,32,15-19,1969,0.25681836236242916
SIM,1864,37,40-44,1901,17
STAT,1950,19,35-39,1969,10.013047696831004
STAT,1827,62,na,1889,2239.611850038933
SIM,1940,23,25-29,1963,212
SIM,1910,16,15-19,1926,21
STAT,1905,46,50-100,1951,0.40579045591038226
STAT,1902,20,35-39,1922,16.738251312818537
STAT,1882,52,30-34,1934,0.011648682284998461
SIM,1825,35,25-29,1860,7
STAT,1949,19,na,1968,8639.29667936843
STAT,1949,22,40-44,1971,7.923346966821637
STAT,1863,52,20-24,1915,0.0012976232905828509
SIM,1870,7,na,1877,5353
STAT,1822,85,na,1907,309.52061705004985
SIM,1875,17,35-39,1892,1
STAT,1808,70,na,1878,1444.3104642986816
STAT,1826,99,na,1925,2.2671577795516638
SIM,1810,100,na,1910,7
SIM,1913,57,na,1970,6998
SIM,1928,28,30-34,1956,123
STAT,1862,30,30-34,1892,30.381247276860698
STAT,1921,20,45-49,1941,2.581350270243247
SIM,1880,13,na,1893,5779
SIM,1881,49,35-39,1930,1
SIM,1940,20,50-100,1960,3
STAT,1894,20,25-29,1914,149.4039743828085
SIM,1765,89,na,1854,72
STAT,1826,39,20-24,1865,1.707939261072584
STAT,1919,6,na,1925,8943.507889467912
STAT,1931,19,25-29,1950,113.94561246675286
STAT,1939,32,25-29,1971,19.04802589249949
STAT,1822,42,50-100,1864,3.555339798434763
STAT,1919,34,50-100,1953,1.785731448980351
STAT,1847,41,45-49,1888,2.3236957061571983
STAT,1884,26,25-29,1910,84.64997744774004
STAT,1910,32,50-100,1942,1.6106434652373902
SIM,1862,70,na,1932,2491
SIM,1862,3,na,1865,5651
SIM,1907,40,30-34,1947,1
STAT,1867,17,35-39,1884,1.0609858527774123
STAT,1813,49,na,1862,2667.741137233404
STAT,1944,26,20-24,1970,39.86037179507371
SIM,1892,26,25-29,1918,121
SIM,1920,19,15-19,1939,97
SIM,1919,17,25-29,1936,128
STAT,1914,54,na,1968,7167.712640303989
STAT,1927,37,25-29,1964,2.471966578084642
SIM,1923,35,40-44,1958,4
STAT,1912,19,15-19,1931,18.43965346698375
SIM,1890,27,40-44,1917,10
SIM,1910,20,35-39,1930,22
STAT,1901,40,35-39,1941,0.35911955296977666
STAT,1932,23,25-29,1955,244.0334242967893
STAT,1802,53,45-49,1855,0.09116439558901149
STAT,1902,16,15-19,1918,16.963017990795528
STAT,1910,40,na,1950,7171.777741627127
STAT,1863,32,50-100,1895,1.619831126704533
STAT,1845,39,30-34,1884,8.451485999004118
STAT,1929,18,30-34,1947,31.330656276174086
SIM,1913,45,25-29,1958,1
SIM,1839,21,45-49,1860,1
SIM,1919,49,35-39,1968,1
SIM,1866,84,na,1950,562
SIM,1834,25,25-29,1859,79
SIM,1938,17,35-39,1955,9
SIM,1900,25,45-49,1925,4
STAT,1898,42,na,1940,6330.832592475239
SIM,1827,82,na,1909,431
SIM,1938,22,30-34,1960,78
SIM,1858,65,na,1923,2860
SIM,1922,23,30-34,1945,87
STAT,1879,82,na,1961,1383.129526915898
SIM,1855,41,45-49,1896,4
SIM,1854,51,na,1905,3591
SIM,1779,92,na,1871,9
STAT,1862,48,20-24,1910,0.02045413831682601
STAT,1846,29,50-100,1875,1.1683827941025975
STAT,1899,59,na,1958,5512.682231655351
SIM,1937,18,30-34,1955,29
STAT,1920,21,40-44,1941,7.570385081980376
STAT,1879,37,50-100,1916,2.5935784892249734
STAT,1901,48,45-49,1949,0.3716603422290052
STAT,1859,43,50-100,1902,1.685967312927036
SIM,1912,37,30-34,1949,5
STAT,1923,17,25-29,1940,102.73711592416673
SIM,1864,16,20-24,1880,35
SIM,1914,33,25-29,1947,25
STAT,1880,25,50-100,1905,1.3702256819734353
SIM,1789,70,na,1859,1257
SIM,1858,34,25-29,1892,20
STAT,1821,47,20-24,1868,0.035123351346675796
SIM,1911,32,45-49,1943,2
STAT,1905,26,20-24,1931,34.38258451549668
SIM,1885,41,30-34,1926,7
SIM,1867,58,na,1925,3945
SIM,1863,44,na,1907,4239
STAT,1768,101,na,1869,0.23052945617920217
SIM,1867,43,50-100,1910,5
STAT,1882,27,40-44,1909,5.893462461251232
STAT,1872,28,na,1900,4826.971935508501
SIM,1823,36,40-44,1859,11
STAT,1837,20,30-34,1857,34.06618573877942
SIM,1930,28,35-39,1958,53
STAT,1934,27,15-19,1961,1.918271658764596
STAT,1919,19,25-29,1938,96.17856511907341
STAT,1873,98,na,1971,45.16831689052876
SIM,1801,68,na,1869,1478
STAT,1905,45,25-29,1950,0.09584576759949258
SIM,1892,46,na,1938,6500
SIM,1820,71,na,1891,1263
STAT,1900,36,35-39,1936,4.297623944839047
STAT,1856,16,20-24,1872,32.85857838447617
SIM,1924,27,35-39,1951,53
STAT,1906,33,25-29,1939,17.235307563439537
STAT,1948,18,40-44,1966,3.2315558801735915
STAT,1911,27,20-24,1938,35.96274402339831
SIM,1935,18,20-24,1953,394
STAT,1951,20,30-34,1971,69.39284589536675
SIM,1952,7,na,1959,9773
STAT,1849,84,na,1933,526.2060557018943
STAT,1845,16,45-49,1861,0.12797642619902458
SIM,1912,20,45-49,1932,2
STAT,1861,42,45-49,1903,2.512767261340179
STAT,1950,16,na,1966,8791.556886573413
SIM,1924,28,50-100,1952,2
STAT,1879,16,15-19,1895,12.56739280240672
SIM,1942,27,15-19,1969,1
STAT,1845,70,na,1915,2162.047104178084
STAT,1922,28,35-39,1950,34.18078617224345
SIM,1949,22,50-100,1971,2
SIM,1886,20,40-44,1906,5
STAT,1825,38,50-100,1863,3.1085317889348287
STAT,1843,39,20-24,1882,1.123561964910288
STAT,1881,30,40-44,1911,8.533670958439155
STAT,1910,22,35-39,1932,17.86491324031623
STAT,1904,21,50-100,1925,1.1856470511694421
SIM,1886,61,na,1947,3788
SIM,1865,24,15-19,1889,6
STAT,1853,15,40-44,1868,0.352254047893415
SIM,1931,17,25-29,1948,162
SIM,1933,24,45-49,1957,3
STAT,1947,22,30-34,1969,65.59885012240733
SIM,1898,27,30-34,1925,74
SIM,1912,21,50-100,1933,1
STAT,1924,15,50-100,1939,0.9049981680648933
STAT,1857,24,15-19,1881,5.377733471940478
SIM,1893,10,na,1903,6879
SIM,1896,42,45-49,1938,1
STAT,1957,7,na,1964,10464.639292654838
STAT,1897,27,50-100,1924,1.7269403914050705
STAT,1902,21,na,1923,6763.931709322323
SIM,1897,24,na,1921,6436
SIM,1892,57,na,1949,5672
SIM,1918,34,20-24,1952,10
STAT,1872,43,50-100,1915,2.1288330800543775
STAT,1903,32,45-49,1935,5.014469515989294
STAT,1915,40,15-19,1955,0.003131427669666334
STAT,1906,35,na,1941,7054.58781222995
SIM,1851,39,20-24,1890,4
SIM,1923,38,45-49,1961,3
STAT,1871,54,20-24,1925,0.0014399295325640445
STAT,1873,49,35-39,1922,0.2812895061678895
SIM,1904,19,30-34,1923,5
STAT,1876,20,30-34,1896,37.42936128102787
STAT,1897,17,20-24,1914,47.860686650460366
STAT,1919,53,na,1972,7874.8133816541085
SIM,1923,19,40-44,1942,5
STAT,1931,35,25-29,1966,2.6382105657010197
STAT,1865,52,30-34,1917,0.010863662331718671
STAT,1921,49,25-29,1970,0.12003392831434019
SIM,1835,26,na,1861,3768
STAT,1885,20,50-100,1905,0.8246707729366903
STAT,1900,27,45-49,1927,3.1106524500502024
STAT,1806,100,na,1906,0.7228906761751317
STAT,1912,35,15-19,1947,0.03822299454942257
STAT,1928,39,20-24,1967,0.671297946056907
STAT,1832,100,na,1932,1.3840856080420683
SIM,1838,66,na,1904,2237
STAT,1889,60,na,1949,4749.321478874906
SIM,1857,80,na,1937,941
STAT,1843,28,50-100,1871,1.0948836365442016
STAT,1820,41,45-49,1861,6.229881625112367
SIM,1933,24,na,1957,10204
STAT,1827,108,na,1935,0.0022149831694213574
STAT,1848,21,45-49,1869,1.4022788545142166
SIM,1914,24,35-39,1938,25
SIM,1880,43,50-100,1923,6
STAT,1832,48,35-39,1880,0.2130406680859268
STAT,1902,49,15-19,1951,6.299253095644997E-4
SIM,1904,38,35-39,1942,7
SIM,1879,48,40-44,1927,1
STAT,1908,37,15-19,1945,0.03633582930525307
STAT,1836,66,na,1902,2179.2003034419154
STAT,1901,58,na,1959,5766.882920253692
STAT,1916,27,35-39,1943,31.351355935503108
STAT,1838,25,na,1863,3778.226607010569
STAT,1838,49,40-44,1887,0.2323446657285462
STAT,1851,15,50-100,1866,0.09343428494105074
STAT,1847,26,50-100,1873,1.1805083426426337
SIM,1854,29,na,1883,4161
SIM,1850,15,na,1865,4529
SIM,1846,49,40-44,1895,1
SIM,1946,19,35-39,1965,11
STAT,1915,19,40-44,1934,0.5881078317399846
STAT,1916,28,50-100,1944,2.0711760373969677
STAT,1925,38,na,1963,9108.459889767179
SIM,1913,26,20-24,1939,35
STAT,1926,45,45-49,1971,0.5440582325850898
SIM,1859,22,25-29,1881,101
STAT,1921,41,15-19,1962,0.0034974725227690366
STAT,1936,31,45-49,1967,3.0892660969620573
STAT,1817,52,na,1869,2707.9855271003066
SIM,1840,30,45-49,1870,5
SIM,1905,47,40-44,1952,1
STAT,1842,51,na,1893,3221.004968277905
STAT,1930,27,30-34,1957,100.62116038069394
STAT,1927,18,20-24,1945,339.5070828967654
SIM,1788,85,na,1873,124
STAT,1921,24,na,1945,8276.060945624033
SIM,1838,77,na,1915,1063
SIM,1867,47,na,1914,4528
STAT,1855,80,na,1935,932.802612997693
STAT,1906,24,35-39,1930,17.065983208653634
STAT,1941,25,40-44,1966,9.746897373316393
STAT,1859,94,na,1953,32.127403791103866
STAT,1811,90,na,1901,73.28738317784583
STAT,1817,63,na,1880,2066.8123652147137
SIM,1871,84,na,1955,495
SIM,1784,71,na,1855,1008
SIM,1842,15,30-34,1857,5
STAT,1822,54,25-29,1876,0.010181529681744723
SIM,1851,28,50-100,1879,4
STAT,1866,30,15-19,1896,0.26750692481436267
STAT,1931,39,40-44,1970,3.995648575061448
STAT,1832,30,45-49,1862,3.028222083037353
SIM,1837,21,35-39,1858,13
STAT,1854,48,50-100,1902,0.37177091865163614
STAT,1891,16,15-19,1907,14.851291962327158
STAT,1877,41,30-34,1918,2.4219455338085853
SIM,1849,27,35-39,1876,22
STAT,1841,26,40-44,1867,5.437420861356436
STAT,1880,30,50-100,1910,1.965048701171246
STAT,1772,115,na,1887,3.0826554364140533E-4
STAT,1955,15,na,1970,9872.264862291531
STAT,1850,15,15-19,1865,11.251309629622542
SIM,1883,16,30-34,1899,3
STAT,1936,24,20-24,1960,214.59773803251088
SIM,1912,17,15-19,1929,19
STAT,1859,40,25-29,1899,1.0426763675499962
STAT,1830,24,50-100,1854,2.1776517726023616
SIM,1819,63,na,1882,1941
STAT,1920,17,50-100,1937,0.8487337181527305
SIM,1788,74,na,1862,789
STAT,1850,81,na,1931,829.1378660492738
SIM,1858,38,40-44,1896,9
SIM,1830,37,50-100,1867,4
SIM,1897,15,20-24,1912,49
STAT,1789,109,na,1898,3.6411731211355187E-4
STAT,1841,54,35-39,1895,0.012147643030783296
STAT,1942,17,35-39,1959,8.856470799989447
SIM,1886,24,35-39,1910,16
STAT,1859,21,20-24,1880,127.21444136434798
STAT,1896,41,40-44,1937,0.41836545759801336
STAT,1925,33,35-39,1958,21.898394513592258
SIM,1931,37,40-44,1968,6
STAT,1867,25,50-100,1892,1.218138481473015
SIM,1933,33,35-39,1966,37
STAT,1875,16,30-34,1891,3.3223547089830237
SIM,1855,14,na,1869,4983
STAT,1904,17,15-19,1921,17.202718017738672
SIM,1859,28,na,1887,4319
SIM,1881,31,45-49,1912,6
STAT,1905,49,40-44,1954,0.2761736190546306
STAT,1923,37,40-44,1960,3.5019860880535814
STAT,1941,30,15-19,1971,0.2728060282514495
SIM,1838,47,40-44,1885,1
STAT,1932,20,20-24,1952,296.4371827424928
SIM,1903,26,25-29,1929,133
SIM,1939,30,25-29,1969,23
STAT,1854,95,na,1949,20.381891159745425
SIM,1944,24,20-24,1968,246
STAT,1820,38,15-19,1858,0.26271945646310324
SIM,1821,34,na,1855,3250
SIM,1774,93,na,1867,6
SIM,1953,8,na,1961,9959
STAT,1822,37,50-100,1859,4.917652593822342
STAT,1878,24,35-39,1902,12.23172696768204
STAT,1889,15,20-24,1904,44.35329018666597
SIM,1825,48,na,1873,2730
STAT,1907,42,30-34,1949,0.23668840102914165
SIM,1863,45,50-100,1908,1
SIM,1905,27,25-29,1932,143
STAT,1829,50,40-44,1879,0.01669537925513124
STAT,1833,52,35-39,1885,0.011683776640870551
SIM,1929,16,30-34,1945,44
STAT,1924,29,35-39,1953,35.04270636946356
SIM,1914,10,na,1924,8509
SIM,1918,24,na,1942,8068
STAT,1901,45,40-44,1946,0.2757641251488092
SIM,1868,43,na,1911,4418
SIM,1867,21,20-24,1888,134
SIM,1805,71,na,1876,1190
SIM,1839,51,na,1890,2927
STAT,1855,45,50-100,1900,0.37404090028418235
STAT,1915,44,30-34,1959,0.25910473895118513
SIM,1809,85,na,1894,260
STAT,1938,19,35-39,1957,8.355483174891527
SIM,1904,15,15-19,1919,16
SIM,1925,39,45-49,1964,4
STAT,1917,39,45-49,1956,1.42124346953837
STAT,1890,46,na,1936,5562.989167595563
STAT,1795,99,na,1894,0.8093665324857124
STAT,1915,38,45-49,1953,1.3840747789283683
SIM,1813,90,na,1903,50
SIM,1869,40,35-39,1909,6
SIM,1940,20,20-24,1960,228
SIM,1868,27,45-49,1895,1
SIM,1838,26,20-24,1864,24
STAT,1935,16,na,1951,10189.216516820396
STAT,1917,31,35-39,1948,19.403717580693012
STAT,1897,38,40-44,1935,11.759074375862204
SIM,1914,21,na,1935,7641
STAT,1854,107,na,1961,0.02557296442508045
STAT,1868,26,40-44,1894,5.77580835476108
SIM,1903,58,na,1961,6108
SIM,1918,35,na,1953,8287
STAT,1813,48,25-29,1861,0.3492497309422606
STAT,1911,34,45-49,1945,3.0690442920668066
STAT,1924,41,40-44,1965,0.6015690781726915
SIM,1889,16,25-29,1905,14
SIM,1960,0,na,1960,10849
STAT,1933,32,30-34,1965,42.885262628308325
STAT,1931,16,20-24,1947,359.28459253396124
STAT,1874,83,na,1957,949.1595524166681
SIM,1887,46,na,1933,5501
SIM,1916,21,40-44,1937,11
STAT,1823,48,na,1871,3085.6907128517246
STAT,1903,25,20-24,1928,33.963386213067345
SIM,1906,31,25-29,1937,22
STAT,1829,41,50-100,1870,1.766036614746744
STAT,1880,39,25-29,1919,6.064049749875705
SIM,1814,86,na,1900,184
SIM,1900,34,35-39,1934,45
SIM,1870,30,30-34,1900,50
STAT,1914,32,20-24,1946,4.959544961115664
STAT,1830,53,20-24,1883,0.0010982835987302032
SIM,1840,48,na,1888,3546
SIM,1899,39,40-44,1938,4
STAT,1858,36,25-29,1894,4.5548786628818245
STAT,1918,43,45-49,1961,0.35674779405586793
STAT,1943,29,45-49,1972,3.7121513946322415
SIM,1793,85,na,1878,115
STAT,1849,26,30-34,1875,47.559387244889905
STAT,1873,31,45-49,1904,3.5930446969534553
STAT,1907,17,40-44,1924,0.5429225573203587
SIM,1853,66,na,1919,2596
SIM,1927,19,25-29,1946,145
SIM,1857,102,na,1959,2
STAT,1937,19,50-100,1956,0.7340686812483773
SIM,1911,25,20-24,1936,43
STAT,1839,95,na,1934,20.76003045226353
STAT,1835,81,na,1916,700.366744378841
STAT,1890,29,40-44,1919,7.3317534913196045
SIM,1913,49,40-44,1962,1
SIM,1948,16,40-44,1964,6
SIM,1922,32,20-24,1954,7
STAT,1892,37,50-100,1929,3.104096993871113
SIM,1856,95,na,1951,8
SIM,1852,81,na,1933,803
SIM,1907,43,35-39,1950,2
SIM,1908,19,15-19,1927,18
STAT,1913,28,20-24,1941,36.61345167719649
STAT,1804,101,na,1905,0.3838692704389993
STAT,1837,51,na,1888,3072.11208258572
STAT,1908,21,40-44,1929,6.265889494730113
SIM,1858,30,30-34,1888,39
SIM,1879,27,20-24,1906,25
STAT,1851,66,na,1917,2540.7650445164686
STAT,1871,29,30-34,1900,50.16672794021984
STAT,1904,37,30-34,1941,3.334543612428031
STAT,1943,21,35-39,1964,20.23835871454182
SIM,1834,22,20-24,1856,121
SIM,1864,23,45-49,1887,1
STAT,1965,0,na,1965,9985.07262669831
SIM,1868,40,50-100,1908,5
STAT,1868,48,15-19,1916,7.589522992333788E-4
SIM,1814,40,45-49,1854,4
STAT,1839,36,15-19,1875,0.10587395655303936
SIM,1813,44,50-100,1857,3
SIM,1941,26,45-49,1967,6
STAT,1923,42,15-19,1965,0.003623852682798285
STAT,1772,93,na,1865,10.597110324824712
STAT,1861,17,40-44,1878,0.35339152511861155
STAT,1861,39,15-19,1900,0.09344623305181778
STAT,1869,30,40-44,1899,8.554909206596184
STAT,1889,38,na,1927,5837.831765961393
SIM,1857,26,30-34,1883,54
SIM,1883,32,na,1915,4970
STAT,1893,75,na,1968,3408.152898175172
SIM,1945,19,50-100,1964,1
STAT,1916,24,na,1940,7679.818733305549
SIM,1859,39,na,1898,4140
SIM,1888,40,45-49,1928,7
STAT,1878,21,30-34,1899,37.68489246235675
SIM,1876,22,50-100,1898,1
STAT,1869,61,na,1930,3656.8068275104247
STAT,1857,28,na,1885,3841.8379241279936
STAT,1856,23,45-49,1879,1.25291365094008
STAT,1912,10,na,1922,8091.976826790012
STAT,1933,26,45-49,1959,4.635409532314951
SIM,1929,35,35-39,1964,12
STAT,1868,22,50-100,1890,0.7835800326842232
STAT,1878,15,45-49,1893,0.13842497244310106
STAT,1885,24,na,1909,4724.684507863263
SIM,1950,17,35-39,1967,13
STAT,1852,31,25-29,1883,17.078771264971312
STAT,1853,14,na,1867,4502.431786266692
STAT,1900,21,15-19,1921,9.27053090350414
STAT,1835,27,40-44,1862,5.058702756733917
SIM,1855,39,40-44,1894,16
SIM,1894,22,40-44,1916,10
SIM,1909,42,na,1951,7098
SIM,1933,22,30-34,1955,93
STAT,1864,94,na,1958,53.75292545624303
STAT,1850,23,15-19,1873,6.027638233072081
STAT,1875,36,25-29,1911,6.015678284563751
SIM,1802,85,na,1887,185
SIM,1833,42,20-24,1875,3
SIM,1897,23,20-24,1920,192
STAT,1822,38,25-29,1860,11.00670312916939
STAT,1805,83,na,1888,313.0772739290675
SIM,1872,48,30-34,1920,1
SIM,1847,59,na,1906,2900
SIM,1866,30,na,1896,4662
SIM,1830,38,25-29,1868,8
STAT,1858,27,35-39,1885,15.551418896463638
STAT,1822,53,na,1875,2670.743097111534
STAT,1905,18,na,1923,7357.414482770574
STAT,1913,37,na,1950,7500.251077610805
STAT,1854,29,30-34,1883,39.890036714733
STAT,1856,37,40-44,1893,6.821183261349552
STAT,1898,21,20-24,1919,188.91251833164495
SIM,1934,37,50-100,1971,2
SIM,1920,49,50-100,1969,1
STAT,1814,42,45-49,1856,8.642878672848619
SIM,1855,78,na,1933,1164
SIM,1858,11,na,1869,4825
SIM,1866,27,35-39,1893,27
SIM,1890,39,35-39,1929,30
STAT,1849,21,25-29,1870,110.27063225177623
SIM,1935,30,40-44,1965,16
SIM,1816,45,25-29,1861,1
SIM,1823,48,35-39,1871,1
SIM,1909,35,45-49,1944,1
STAT,1889,23,20-24,1912,171.0778871089416
SIM,1885,44,35-39,1929,9
STAT,1856,75,na,1931,1604.1450542970242
SIM,1857,21,25-29,1878,128
STAT,1881,64,na,1945,3393.4169087339396
STAT,1864,48,30-34,1912,0.17255816942705446
SIM,1848,23,25-29,1871,133
STAT,1861,37,50-100,1898,2.063845891670912
STAT,1877,44,35-39,1921,3.7463030041420704
SIM,1848,36,30-34,1884,16
SIM,1929,33,20-24,1962,8
STAT,1942,29,15-19,1971,1.494957720383114
STAT,1873,16,20-24,1889,36.595488829684776
SIM,1787,89,na,1876,63
SIM,1922,30,50-100,1952,1
STAT,1817,43,25-29,1860,3.3530319424604182
STAT,1945,21,45-49,1966,2.4911673093963977
SIM,1846,15,15-19,1861,11
STAT,1867,25,35-39,1892,18.37403609954364
STAT,1883,65,na,1948,3353.3476209375613
SIM,1918,33,45-49,1951,7
SIM,1845,22,45-49,1867,1
SIM,1883,36,25-29,1919,7
STAT,1882,26,15-19,1908,0.8956760810390182
SIM,1826,48,50-100,1874,2
SIM,1839,30,20-24,1869,5
SIM,1872,48,na,1920,4686
SIM,1822,42,45-49,1864,4
SIM,1865,48,50-100,1913,2
STAT,1892,33,20-24,1925,6.805292297878452
SIM,1830,92,na,1922,29
SIM,1920,39,30-34,1959,8
STAT,1871,38,20-24,1909,1.53904813854459
STAT,1869,52,50-100,1921,0.029397830262798914
SIM,1901,31,25-29,1932,33
SIM,1863,97,na,1960,26
STAT,1894,38,15-19,1932,0.14496460755391766
STAT,1871,32,na,1903,4788.168962384719
STAT,1818,49,15-19,1867,0.0017098047316149402
STAT,1845,48,na,1893,3423.29870849415
STAT,1864,19,50-100,1883,0.09042027615213405
STAT,1884,34,25-29,1918,20.251639620484124
SIM,1926,22,na,1948,9115
STAT,1848,42,15-19,1890,0.022616199059090146
STAT,1856,65,na,1921,2633.3607338469806
STAT,1827,47,15-19,1874,7.223941369222322E-4
SIM,1832,83,na,1915,532
STAT,1825,42,20-24,1867,0.3666555570308394
SIM,1938,31,20-24,1969,6
SIM,1910,39,na,1949,7431
STAT,1865,17,25-29,1882,10.71430755966938
STAT,1875,24,30-34,1899,36.806134671313096
STAT,1890,25,na,1915,5923.065159970381
SIM,1879,80,na,1959,1362
SIM,1889,24,25-29,1913,142
SIM,1909,52,na,1961,6807
STAT,1880,19,30-34,1899,3.372887986239971
SIM,1838,98,na,1936,4
STAT,1944,27,50-100,1971,2.172527638615028
SIM,1887,16,15-19,1903,12
SIM,1832,26,40-44,1858,6
SIM,1925,23,35-39,1948,29
SIM,1927,31,45-49,1958,5
STAT,1916,24,30-34,1940,60.443536166167455
STAT,1918,32,40-44,1950,8.39704077983213
STAT,1870,15,na,1885,5115.630027436551
STAT,1930,39,50-100,1969,1.103667207315092
STAT,1790,90,na,1880,56.175166655570244
STAT,1837,22,45-49,1859,1.2725941641165752
STAT,1912,39,30-34,1951,3.5574127789654226
SIM,1879,36,50-100,1915,3
STAT,1855,106,na,1961,0.060825684400303254
SIM,1811,49,50-100,1860,1
STAT,1861,19,20-24,1880,33.85141358681475
STAT,1950,16,30-34,1966,29.113168813829258
SIM,1902,23,40-44,1925,8
SIM,1905,24,20-24,1929,199
STAT,1815,48,35-39,1863,0.7405562398458921
STAT,1778,111,na,1889,0.002656025079773541
STAT,1823,111,na,1934,1.2879912649124198E-4
STAT,1830,37,20-24,1867,1.4446505921361743
SIM,1942,20,30-34,1962,93
STAT,1889,43,15-19,1932,0.034141267920114654
STAT,1788,86,na,1874,146.43604500714284
STAT,1858,46,50-100,1904,0.38777498793142334
STAT,1900,62,na,1962,5444.004034074487
SIM,1942,15,35-39,1957,12
STAT,1835,28,na,1863,3625.0540469963653
SIM,1825,37,50-100,1862,4
SIM,1855,26,20-24,1881,25
STAT,1899,28,35-39,1927,26.605939228358743
STAT,1837,29,na,1866,3814.4027051652433
STAT,1856,97,na,1953,8.371222295547199
STAT,1925,42,25-29,1967,0.17456980657604576
SIM,1865,20,20-24,1885,128
STAT,1939,24,25-29,1963,187.24395041198537
STAT,1863,39,25-29,1902,5.038904677047554
STAT,1849,34,30-34,1883,28.504070838438075
STAT,1853,37,15-19,1890,0.0888478294287727
STAT,1866,43,20-24,1909,0.29380702469093384
STAT,1876,23,35-39,1899,12.151833782893593
SIM,1926,32,40-44,1958,14
STAT,1919,31,45-49,1950,3.442008334055144
STAT,1934,15,35-39,1949,11.517706520537754
SIM,1907,32,30-34,1939,42
STAT,1891,17,40-44,1908,0.45659591992188525
STAT,1841,25,15-19,1866,0.8294974475449762
SIM,1888,25,20-24,1913,31
STAT,1886,22,40-44,1908,4.442560765339133
STAT,1847,39,40-44,1886,6.78104057235463
SIM,1906,20,20-24,1926,193
STAT,1850,49,40-44,1899,0.2570150719053852
STAT,1870,15,40-44,1885,0.3704712171828289
STAT,1915,15,25-29,1930,18.404194708821908
SIM,1849,50,na,1899,3583
STAT,1836,26,45-49,1862,1.9244574348352081
STAT,1935,27,45-49,1962,4.757010999748138
STAT,1777,111,na,1888,0.002225390179395294
SIM,1785,88,na,1873,72
STAT,1853,23,40-44,1876,3.8675806123146663
SIM,1876,26,40-44,1902,11
SIM,1929,20,15-19,1949,10
SIM,1843,27,40-44,1870,10
STAT,1843,47,na,1890,3136.9238221299966
STAT,1917,23,35-39,1940,20.146929041009738
STAT,1882,39,35-39,1921,13.775191466165598
STAT,1859,30,na,1889,3891.848195509257
STAT,1847,26,20-24,1873,21.649587159800404
STAT,1765,91,na,1856,31.707985535999995
STAT,1873,45,na,1918,4662.827044644508
SIM,1860,47,na,1907,3924
SIM,1947,24,25-29,1971,249
STAT,1843,33,25-29,1876,17.07089414006433
SIM,1877,25,45-49,1902,3
STAT,1848,78,na,1926,1281.1568958565708
SIM,1861,23,40-44,1884,2
STAT,1934,20,30-34,1954,78.27397019816866
SIM,1827,31,40-44,1858,11
SIM,1851,33,25-29,1884,19
SIM,1889,37,30-34,1926,17
SIM,1923,15,25-29,1938,114
SIM,1830,70,na,1900,1703
SIM,1804,86,na,1890,92
STAT,1798,86,na,1884,140.24614708620575
SIM,1924,24,30-34,1948,89
STAT,1805,51,na,1856,2643.794613415381
STAT,1900,23,50-100,1923,1.138945358470439
STAT,1944,25,45-49,1969,3.7741017662021124
STAT,1871,64,na,1935,3488.042262432383
STAT,1927,25,45-49,1952,4.26988944140346
SIM,1838,21,15-19,1859,6
SIM,1868,11,na,1879,5239
STAT,1938,20,15-19,1958,10.649176698049201
SIM,1849,32,30-34,1881,36
STAT,1813,70,na,1883,1491.2986972411104
STAT,1880,21,35-39,1901,12.452893129422621
SIM,1925,36,40-44,1961,5
SIM,1933,7,na,1940,11305
STAT,1868,21,35-39,1889,11.294120742230303
SIM,1881,4,na,1885,4651
STAT,1886,17,45-49,1903,0.1392638289259643
SIM,1911,21,40-44,1932,10
SIM,1933,26,50-100,1959,2
SIM,1866,32,30-34,1898,42
SIM,1890,77,na,1967,2927
SIM,1843,77,na,1920,1220
SIM,1916,30,30-34,1946,37
STAT,1767,102,na,1869,0.13695812678730485
SIM,1822,49,30-34,1871,2
STAT,1924,30,15-19,1954,0.30407322601173004
SIM,1867,23,35-39,1890,14
SIM,1882,24,15-19,1906,6
SIM,1842,48,45-49,1890,1
STAT,1896,44,45-49,1940,0.2733806489603006
SIM,1819,39,30-34,1858,12
STAT,1850,19,45-49,1869,0.12095277223810129
SIM,1943,27,45-49,1970,1
STAT,1839,27,25-29,1866,83.20897127483978
STAT,1865,22,20-24,1887,127.97842066811411
SIM,1847,27,25-29,1874,100
STAT,1930,39,na,1969,9889.649724664581
STAT,1820,72,na,1892,1413.8201777404952
STAT,1829,53,45-49,1882,0.01973426553000269
STAT,1835,29,20-24,1864,19.52780140245339
STAT,1909,37,45-49,1946,1.3039039531944547
STAT,1947,23,20-24,1970,253.70630673422812
STAT,1808,48,na,1856,2616.6565439739998
STAT,1868,76,na,1944,1820.4611251527015
STAT,1873,77,na,1950,1773.7811957260255
STAT,1844,39,15-19,1883,0.09385929221628733
STAT,1915,18,na,1933,8143.246355088818
SIM,1832,33,15-19,1865,5
SIM,1946,20,15-19,1966,14
SIM,1893,26,40-44,1919,13
SIM,1935,25,45-49,1960,1
SIM,1856,22,20-24,1878,140
STAT,1796,73,na,1869,1021.2366907897967
STAT,1851,35,25-29,1886,4.605741125430284
STAT,1847,29,na,1876,3906.7916378663317
STAT,1917,36,40-44,1953,3.155098948258525
SIM,1826,29,20-24,1855,18
STAT,1903,21,40-44,1924,6.010213069959727
SIM,1817,37,40-44,1854,12
SIM,1859,54,35-39,1913,1
SIM,1897,27,50-100,1924,3
SIM,1839,25,50-100,1864,1
STAT,1860,27,na,1887,3956.0340949701813
SIM,1932,26,30-34,1958,120
SIM,1857,43,20-24,1900,1
STAT,1859,39,45-49,1898,3.1722563689232572
SIM,1870,67,na,1937,3108
SIM,1855,46,na,1901,3993
SIM,1882,15,25-29,1897,19
SIM,1772,91,na,1863,29
SIM,1837,53,45-49,1890,1
SIM,1826,35,40-44,1861,6
STAT,1876,28,40-44,1904,6.235287066954049
SIM,1878,25,50-100,1903,3
SIM,1904,21,50-100,1925,6
STAT,1828,39,30-34,1867,10.306766107784464
SIM,1889,80,na,1969,2311
STAT,1839,44,15-19,1883,0.02215158465175901
STAT,1858,32,30-34,1890,27.488899001510617
SIM,1843,29,20-24,1872,23
SIM,1898,22,25-29,1920,169
SIM,1903,22,45-49,1925,7
SIM,1857,34,30-34,1891,36
STAT,1834,48,45-49,1882,0.3289209404103023
STAT,1924,26,30-34,1950,92.42937294736235
SIM,1927,34,50-100,1961,3
STAT,1848,22,20-24,1870,137.58458194737145
SIM,1919,52,na,1971,7948
STAT,1857,20,20-24,1877,127.05398845823862
STAT,1899,45,25-29,1944,0.09080398699894053
STAT,1796,110,na,1906,1.2311314634603815E-4
STAT,1891,24,15-19,1915,8.18406807563657
SIM,1884,28,40-44,1912,13
SIM,1833,25,30-34,1858,61
STAT,1929,22,15-19,1951,13.593932407527578
SIM,1858,4,na,1862,5065
STAT,1771,116,na,1887,1.806900457697903E-4
STAT,1865,58,na,1923,3628.5180825995044
STAT,1874,15,25-29,1889,11.816692381651205
STAT,1876,95,na,1971,144.2069141112894
SIM,1836,39,30-34,1875,17
SIM,1890,26,15-19,1916,1
STAT,1812,53,na,1865,2636.275084020049
STAT,1885,26,40-44,1911,6.042636484722201
STAT,1824,33,15-19,1857,0.5621584605267881
SIM,1862,48,na,1910,4065
SIM,1937,22,15-19,1959,10
STAT,1923,37,na,1960,8801.123938849994
SIM,1850,47,na,1897,3623
SIM,1858,42,25-29,1900,3
SIM,1883,10,na,1893,5384
SIM,1877,42,35-39,1919,7
SIM,1886,31,50-100,1917,3
SIM,1946,20,na,1966,8033
STAT,1894,16,40-44,1910,0.47568854866947724
STAT,1845,81,na,1926,833.2833205443327
SIM,1858,33,35-39,1891,22
STAT,1828,30,50-100,1858,2.1837119235958
SIM,1869,60,na,1929,3641
STAT,1899,25,30-34,1924,70.1545526696297
SIM,1864,49,35-39,1913,1
STAT,1860,70,na,1930,2301.1579184734337
STAT,1814,42,50-100,1856,6.1008555162927145
STAT,1904,20,45-49,1924,2.0334142841002674
STAT,1954,16,15-19,1970,113.3279517088149
STAT,1868,98,na,1966,27.157710686084524
STAT,1877,27,45-49,1904,2.328481301223377
SIM,1886,44,50-100,1930,6
STAT,1880,25,na,1905,5111.949886842593
STAT,1938,33,20-24,1971,4.951030344697742
SIM,1916,22,na,1938,7818
STAT,1855,15,15-19,1870,10.77034050438394
STAT,1915,1,na,1916,8799.097151574604
STAT,1886,4,na,1890,5608.475184295565
SIM,1873,17,25-29,1890,14
SIM,1917,37,45-49,1954,7
SIM,1852,25,40-44,1877,6
STAT,1805,73,na,1878,1146.7533782582161
STAT,1903,59,na,1962,5890.491318919676
STAT,1800,54,50-100,1854,0.09071873621935214
STAT,1835,49,15-19,1884,5.324980285509646E-4
STAT,1855,26,na,1881,3778.1933089923727
STAT,1875,49,45-49,1924,0.4804809669217947
SIM,1862,29,30-34,1891,58
SIM,1883,49,45-49,1932,2
STAT,1840,32,45-49,1872,3.0658143519609906
SIM,1836,43,50-100,1879,4
STAT,1850,41,50-100,1891,1.6271550653924927
STAT,1953,15,45-49,1968,1.2209773696240735
STAT,1881,33,45-49,1914,3.3897174212332875
STAT,1929,20,na,1949,9381.318286717442
SIM,1835,25,40-44,1860,7
STAT,1844,25,40-44,1869,6.007977142675019
STAT,1932,20,50-100,1952,1.7541701530270446
SIM,1818,36,45-49,1854,5
STAT,1917,40,25-29,1957,0.15091068357125798
STAT,1908,30,30-34,1938,30.29654097441349
SIM,1868,32,40-44,1900,12
SIM,1842,28,na,1870,3852
SIM,1901,39,20-24,1940,1
STAT,1895,15,45-49,1910,0.17270339386527514
SIM,1910,1,na,1911,8494
SIM,1911,28,25-29,1939,124
STAT,1890,38,30-34,1928,13.07307462545673
STAT,1856,49,35-39,1905,0.21359819597001264
SIM,1863,15,15-19,1878,14
SIM,1879,22,15-19,1901,6
STAT,1949,21,15-19,1970,12.548147590410945
STAT,1930,17,na,1947,9610.548174137604
SIM,1856,10,na,1866,4888
SIM,1817,39,20-24,1856,2
SIM,1876,21,35-39,1897,14
SIM,1916,25,35-39,1941,46
SIM,1845,29,30-34,1874,64
STAT,1834,35,25-29,1869,4.867293788205056
STAT,1927,30,40-44,1957,9.731671404619787
SIM,1831,47,30-34,1878,1
STAT,1884,31,20-24,1915,5.412659760126789
STAT,1948,22,25-29,1970,214.18168964534468
STAT,1869,42,35-39,1911,3.5392902600058784
SIM,1873,27,40-44,1900,7
STAT,1869,6,na,1875,5439.231468861574
STAT,1823,47,30-34,1870,0.29909883374524593
STAT,1880,48,15-19,1928,8.403352870226357E-4
STAT,1903,28,25-29,1931,121.21220088823
SIM,1842,18,na,1860,4278
STAT,1845,24,45-49,1869,1.3148699411606224
STAT,1855,16,na,1871,4141.3544928965175
STAT,1867,22,30-34,1889,33.829381512433265
SIM,1862,38,20-24,1900,4
SIM,1898,35,30-34,1933,21
STAT,1943,26,40-44,1969,10.029706901013723
SIM,1854,29,50-100,1883,2
STAT,1910,31,25-29,1941,18.078779866234864
STAT,1837,29,30-34,1866,44.41364803696433
SIM,1842,35,25-29,1877,8
STAT,1908,25,35-39,1933,29.122670082964756
STAT,1839,32,20-24,1871,5.193975353261917
SIM,1892,31,20-24,1923,9
SIM,1904,34,50-100,1938,2
SIM,1870,33,35-39,1903,30
SIM,1875,22,30-34,1897,52
SIM,1847,32,20-24,1879,8
SIM,1918,30,40-44,1948,14
STAT,1849,46,25-29,1895,0.0913702611645159
STAT,1927,33,45-49,1960,3.9063249425422555
STAT,1902,25,40-44,1927,8.59933723395385
SIM,1882,26,na,1908,4981
SIM,1855,48,30-34,1903,1
STAT,1860,38,45-49,1898,3.2532666887467916
SIM,1837,20,45-49,1857,2
STAT,1892,36,25-29,1928,7.314498864934697
STAT,1817,40,20-24,1857,0.9286724981981149
SIM,1933,29,15-19,1962,1
STAT,1880,47,na,1927,4764.384674916229
SIM,1827,34,45-49,1861,5
SIM,1906,36,30-34,1942,5
STAT,1886,25,45-49,1911,2.3831616899984716
STAT,1839,37,40-44,1876,8.168098008206409
SIM,1833,45,25-29,1878,1
STAT,1852,27,40-44,1879,5.560894165161555
STAT,1849,17,40-44,1866,0.356124684927379
SIM,1916,22,30-34,1938,85
SIM,1922,18,na,1940,9042
SIM,1870,99,na,1969,20
SIM,1846,32,na,1878,3958
SIM,1908,25,na,1933,7220
STAT,1870,18,45-49,1888,0.12998692280041255
STAT,1966,1,na,1967,9930.728695390335
SIM,1933,25,35-39,1958,46
STAT,1874,50,30-34,1924,0.012486256016992789
STAT,1920,16,45-49,1936,1.1344242970647833
STAT,1942,22,30-34,1964,60.862323637928114
SIM,1884,15,35-39,1899,1
STAT,1815,51,na,1866,2666.6881332165676
STAT,1825,45,25-29,1870,0.12839542746603377
STAT,1835,31,25-29,1866,17.072997103491055
STAT,1917,41,na,1958,7838.274660804848
STAT,1898,33,15-19,1931,0.38757018890300754
STAT,1877,38,15-19,1915,0.1171808854948736
STAT,1897,45,15-19,1942,6.152013863353086E-4
STAT,1845,48,20-24,1893,0.018258885929984477
STAT,1893,43,na,1936,5894.037812318698
STAT,1868,34,40-44,1902,8.26177039708204
SIM,1929,36,25-29,1965,3
SIM,1881,29,40-44,1910,7
STAT,1925,25,35-39,1950,36.04900640793514
STAT,1929,2,na,1931,10540.3483276549
STAT,1873,29,40-44,1902,6.103131014337967
STAT,1878,76,na,1954,1998.359173869398
SIM,1917,42,40-44,1959,1
STAT,1825,71,na,1896,1544.4119821588988
SIM,1851,30,20-24,1881,7
STAT,1895,32,35-39,1927,26.650696287779905
SIM,1871,19,30-34,1890,4
STAT,1768,88,na,1856,75.97611283999998
STAT,1844,39,50-100,1883,2.052105174997091
STAT,1932,15,25-29,1947,116.43757448860498
SIM,1885,27,45-49,1912,2
SIM,1892,0,na,1892,7829
SIM,1948,20,25-29,1968,249
STAT,1925,29,15-19,1954,1.6716057167952885
STAT,1812,49,20-24,1861,0.08057025135808091
STAT,1832,31,na,1863,3688.243959506791
SIM,1814,64,na,1878,1903
STAT,1863,77,na,1940,1528.159454497961
SIM,1909,32,40-44,1941,11
SIM,1840,15,20-24,1855,32
SIM,1843,31,25-29,1874,27
STAT,1908,22,30-34,1930,53.399261113249004
STAT,1886,31,50-100,1917,1.9613656553743488
SIM,1876,34,40-44,1910,15
SIM,1961,1,na,1962,10520
STAT,1885,2,na,1887,6274.506182486048
SIM,1865,23,25-29,1888,119
STAT,1838,46,na,1884,3172.930190153325
SIM,1822,73,na,1895,1280
STAT,1856,36,15-19,1892,0.08792322207471634
SIM,1842,71,na,1913,1830
SIM,1792,68,na,1860,1398
SIM,1827,29,na,1856,3540
STAT,1889,39,30-34,1928,13.138314022867213
SIM,1842,23,30-34,1865,38
STAT,1797,110,na,1907,1.3371338577955626E-4
STAT,1900,30,na,1930,6739.286931740847
STAT,1940,21,50-100,1961,1.3542870435363061
STAT,1909,42,40-44,1951,0.47274628645671873
STAT,1884,17,35-39,1901,1.0942744414810806
STAT,1834,23,30-34,1857,31.483112939013647
STAT,1868,44,na,1912,4381.1615737294605
SIM,1872,43,50-100,1915,5
STAT,1855,43,45-49,1898,2.2405323037478904
SIM,1822,36,25-29,1858,9
SIM,1892,17,35-39,1909,2
SIM,1836,41,35-39,1877,11
STAT,1865,27,40-44,1892,5.496294308425416
SIM,1848,76,na,1924,1278
SIM,1860,27,40-44,1887,9
STAT,1856,6,na,1862,4596.62772097472
SIM,1872,33,45-49,1905,4
STAT,1843,30,20-24,1873,4.64761495093076
STAT,1935,24,40-44,1959,9.24264518263833
SIM,1940,15,25-29,1955,110
STAT,1935,32,40-44,1967,10.936375643241357
SIM,1775,88,na,1863,46
SIM,1875,25,50-100,1900,2
STAT,1863,19,30-34,1882,2.8916273579632357
SIM,1929,19,na,1948,9670
SIM,1850,21,15-19,1871,7
STAT,1844,19,20-24,1863,35.96625320466679
SIM,1883,24,30-34,1907,44
STAT,1828,41,35-39,1869,3.4651314998155587
SIM,1866,49,45-49,1915,3
STAT,1826,37,40-44,1863,10.373344889686988
SIM,1840,70,na,1910,2103
SIM,1942,23,35-39,1965,20
STAT,1863,13,na,1876,4794.007653840482
STAT,1857,15,25-29,1872,10.609326513305076
STAT,1793,87,na,1880,114.1684306615464
SIM,1930,39,50-100,1969,3
SIM,1916,28,50-100,1944,4
STAT,1892,16,30-34,1908,4.039670773306507
STAT,1857,16,50-100,1873,0.09118301543076676
SIM,1834,49,50-100,1883,2
SIM,1839,33,25-29,1872,26
STAT,1840,26,25-29,1866,76.68296339705768
STAT,1934,21,na,1955,9916.173507710768
SIM,1883,20,15-19,1903,7
STAT,1780,90,na,1870,54.32819023024587
SIM,1926,39,25-29,1965,5
STAT,1881,27,25-29,1908,82.57581161611796
STAT,1918,39,25-29,1957,2.091135905209067
SIM,1865,46,na,1911,4221
SIM,1876,62,na,1938,4012
STAT,1842,21,15-19,1863,6.2398200373293085
STAT,1898,38,50-100,1936,0.7206690506368278
SIM,1873,22,20-24,1895,126
STAT,1876,15,35-39,1891,1.1515017368765377
SIM,1873,97,na,1970,72
SIM,1874,27,50-100,1901,3
SIM,1923,20,20-24,1943,267
STAT,1839,26,50-100,1865,1.2674063059508958
SIM,1879,7,na,1886,5554
STAT,1910,62,na,1972,6303.702790616124
STAT,1934,23,35-39,1957,25.551319385905934
SIM,1862,31,35-39,1893,27
STAT,1882,17,25-29,1899,11.148702711960276
STAT,1893,28,40-44,1921,7.641285936886438
SIM,1869,27,na,1896,4622
STAT,1868,41,50-100,1909,2.0391854522630855
SIM,1833,99,na,1932,1
SIM,1876,41,50-100,1917,7
STAT,1909,39,50-100,1948,0.7949622679223995
SIM,1888,28,25-29,1916,111
SIM,1832,29,45-49,1861,1
STAT,1946,22,15-19,1968,11.962649116297356
SIM,1917,39,50-100,1956,2
STAT,1764,104,na,1868,0.04788464578913623
STAT,1822,111,na,1933,1.2118731045966379E-4
STAT,1848,38,30-34,1886,8.912628624833635
SIM,1863,65,na,1928,3018
SIM,1864,29,na,1893,4492
STAT,1838,78,na,1916,1057.4299815348077
STAT,1860,25,25-29,1885,71.13908561482918
STAT,1858,24,30-34,1882,28.861670556382187
SIM,1817,41,25-29,1858,1
SIM,1943,16,50-100,1959,1
STAT,1837,49,25-29,1886,0.08124697614676925
STAT,1836,37,15-19,1873,0.09166459357918821
STAT,1951,19,15-19,1970,109.06408915472636
SIM,1936,26,15-19,1962,1
STAT,1826,49,50-100,1875,0.47661468623456543
STAT,1908,28,50-100,1936,1.894892169637283
STAT,1884,82,na,1966,1531.2513933297892
SIM,1860,26,50-100,1886,2
STAT,1930,26,50-100,1956,2.5572164568703863
STAT,1951,15,35-39,1966,10.096186317372872
SIM,1908,31,35-39,1939,27
SIM,1848,98,na,1946,3
SIM,1856,38,30-34,1894,16
STAT,1866,46,25-29,1912,0.10764117907525358
SIM,1884,32,25-29,1916,24
STAT,1876,32,25-29,1908,21.3953637364603
SIM,1866,36,25-29,1902,10
SIM,1878,48,25-29,1926,1
SIM,1844,26,45-49,1870,2
SIM,1852,19,20-24,1871,31
STAT,1898,24,25-29,1922,155.47782907739773
STAT,1929,35,20-24,1964,0.6846175364415149
SIM,1866,24,30-34,1890,44
SIM,1903,39,30-34,1942,6
SIM,1848,20,20-24,1868,121
SIM,1902,26,45-49,1928,3
STAT,1780,105,na,1885,0.03881603149584849
STAT,1928,26,15-19,1954,1.762281113490833
SIM,1865,15,25-29,1880,15
STAT,1833,47,na,1880,3152.2112547725137
SIM,1931,22,20-24,1953,294
STAT,1899,42,20-24,1941,0.030479271680429725
SIM,1861,37,50-100,1898,6
SIM,1919,33,50-100,1952,4
STAT,1854,31,35-39,1885,16.064135089621537
SIM,1888,38,40-44,1926,18
STAT,1833,27,30-34,1860,43.781062150696464
STAT,1883,22,15-19,1905,6.5461655395895315
STAT,1807,64,na,1871,1929.1335636633728
STAT,1833,43,50-100,1876,1.6643274518168436
STAT,1858,44,25-29,1902,0.9973768774462212
STAT,1886,49,20-24,1935,0.02504915175435393
SIM,1939,26,40-44,1965,9
STAT,1841,38,35-39,1879,11.96612206335213
STAT,1859,36,40-44,1895,7.0706568738525375
SIM,1847,24,20-24,1871,147
STAT,1915,20,20-24,1935,224.10565254173008
SIM,1934,21,35-39,1955,29
STAT,1843,16,35-39,1859,0.9880907924682946
STAT,1810,52,na,1862,2455.0592674042086
STAT,1830,40,na,1870,3633.4096566721164
SIM,1871,39,25-29,1910,8
SIM,1867,9,na,1876,5568
STAT,1896,38,25-29,1934,7.639094080614319
STAT,1927,22,40-44,1949,8.365209733746424
SIM,1804,54,na,1858,2300
SIM,1899,26,35-39,1925,30
SIM,1935,22,40-44,1957,14
STAT,1910,18,15-19,1928,18.120610548970447
SIM,1857,59,na,1916,3444
STAT,1831,49,30-34,1880,0.14438276580982198
SIM,1909,43,45-49,1952,1
STAT,1845,21,40-44,1866,4.015096799124722
STAT,1897,37,15-19,1934,0.1515972092405292
STAT,1818,38,45-49,1856,12.368198537170434
STAT,1829,47,25-29,1876,0.09088434233598078
STAT,1932,32,15-19,1964,0.34503444910733855
STAT,1872,3,na,1875,6322.57364879655
STAT,1888,27,20-24,1915,28.003738278502862
STAT,1923,22,20-24,1945,261.21401291053695
SIM,1859,92,na,1951,42
SIM,1922,39,40-44,1961,4
STAT,1850,16,40-44,1866,0.34472329821584674
SIM,1853,21,40-44,1874,4
SIM,1943,24,40-44,1967,9
SIM,1826,38,45-49,1864,5
STAT,1869,93,na,1962,131.79219970573877
STAT,1876,10,na,1886,5494.179728971243
STAT,1846,65,na,1911,2588.5310127649195
SIM,1868,35,45-49,1903,5
SIM,1852,71,na,1923,2129
STAT,1879,24,15-19,1903,6.925484899836615
SIM,1858,33,na,1891,4029
STAT,1906,42,15-19,1948,0.002818758534228078
SIM,1867,20,30-34,1887,47
STAT,1827,33,40-44,1860,10.185977370213928
SIM,1822,83,na,1905,345
STAT,1862,33,35-39,1895,17.407582592204214
STAT,1869,25,45-49,1894,2.1875370378259467
STAT,1939,20,na,1959,7412.784518352656
STAT,1851,15,30-34,1866,3.0397293547569726
SIM,1897,39,30-34,1936,7
STAT,1866,48,40-44,1914,0.31501913352183514
STAT,1847,34,20-24,1881,4.311965525831273
SIM,1900,39,na,1939,6856
SIM,1924,32,30-34,1956,57
SIM,1850,69,na,1919,2267
SIM,1909,20,na,1929,7242
SIM,1930,27,na,1957,10173
SIM,1899,57,na,1956,5637
SIM,1797,89,na,1886,51
SIM,1866,44,25-29,1910,2
SIM,1874,48,40-44,1922,1
SIM,1859,50,na,1909,3847
SIM,1928,24,15-19,1952,16
SIM,1916,33,35-39,1949,30
STAT,1839,24,20-24,1863,136.27748310990137
STAT,1866,26,30-34,1892,47.086997040248846
STAT,1894,24,40-44,1918,5.3723830895315965
STAT,1908,33,35-39,1941,17.359048312406795
STAT,1898,16,25-29,1914,15.525703973134364
STAT,1800,74,na,1874,986.6364809708723
SIM,1890,9,na,1899,6889
SIM,1908,23,35-39,1931,24
SIM,1915,38,na,1953,7686
STAT,1844,28,45-49,1872,2.1792286323258425
SIM,1858,25,35-39,1883,24
SIM,1899,21,50-100,1920,2
SIM,1905,32,20-24,1937,7
STAT,1838,23,15-19,1861,5.751181080355711
SIM,1849,48,40-44,1897,1
STAT,1950,20,15-19,1970,12.76176517594774
SIM,1892,34,25-29,1926,41
SIM,1891,51,na,1942,5649
SIM,1835,33,40-44,1868,12
SIM,1797,67,na,1864,1547
SIM,1844,43,35-39,1887,8
STAT,1865,54,50-100,1919,0.026948668685922248
STAT,1861,21,25-29,1882,99.57614462961021
STAT,1916,32,30-34,1948,32.85099993922842
SIM,1852,28,na,1880,4251
SIM,1825,43,25-29,1868,1
SIM,1851,16,35-39,1867,1
STAT,1857,23,25-29,1880,103.28662521760069
STAT,1919,23,45-49,1942,2.4801262036945766
STAT,1879,1,na,1880,7232.4672999381055
SIM,1889,21,20-24,1910,187
STAT,1922,4,na,1926,9431.366102758646
SIM,1846,10,na,1856,4700
SIM,1879,23,50-100,1902,1
SIM,1917,34,40-44,1951,11
STAT,1893,65,na,1958,4480.534415887058
SIM,1839,25,25-29,1864,76
SIM,1893,29,45-49,1922,4
SIM,1924,2,na,1926,10174
STAT,1850,17,na,1867,4300.812329881715
STAT,1907,21,25-29,1928,170.43874053532284
STAT,1881,42,na,1923,4506.173185659708
SIM,1847,37,40-44,1884,14
SIM,1932,22,15-19,1954,14
STAT,1908,20,15-19,1928,9.949120367808987
SIM,1921,15,15-19,1936,104
SIM,1837,82,na,1919,552
STAT,1873,24,20-24,1897,140.52703937476508
STAT,1917,44,40-44,1961,0.525375989499026
STAT,1878,23,45-49,1901,1.4663159080589634
STAT,1836,43,35-39,1879,2.828361828709778
SIM,1915,21,25-29,1936,221
SIM,1859,37,45-49,1896,8
SIM,1891,22,15-19,1913,9
STAT,1885,29,45-49,1914,2.216085331449272
SIM,1910,25,40-44,1935,16
STAT,1863,99,na,1962,9.437356056515172
SIM,1898,31,15-19,1929,2
SIM,1834,21,30-34,1855,38
SIM,1899,43,25-29,1942,1
STAT,1887,42,50-100,1929,2.3833678502015965
SIM,1949,15,45-49,1964,1
STAT,1913,15,15-19,1928,18.831817813669407
STAT,1862,16,45-49,1878,0.12990902587575173
SIM,1941,21,na,1962,7687
STAT,1851,32,20-24,1883,4.361283297860401
SIM,1808,90,na,1898,54
SIM,1945,5,na,1950,9124
STAT,1855,48,na,1903,3349.9839600331916
SIM,1896,27,20-24,1923,37
SIM,1811,89,na,1900,64
SIM,1916,20,15-19,1936,16
STAT,1926,21,35-39,1947,23.168674532406307
STAT,1815,53,50-100,1868,0.0762088327714151
SIM,1841,27,30-34,1868,50
STAT,1909,34,40-44,1943,7.481485928127524
SIM,1935,33,45-49,1968,7
STAT,1835,71,na,1906,1728.756143496567
SIM,1927,23,45-49,1950,5
STAT,1919,20,50-100,1939,1.463542313072593
SIM,1829,36,20-24,1865,2
STAT,1775,113,na,1888,7.321856490681159E-4
STAT,1858,35,35-39,1893,11.24149460937026
SIM,1886,23,45-49,1909,1
STAT,1920,40,na,1960,8305.142489153975
SIM,1840,28,40-44,1868,11
SIM,1846,23,15-19,1869,6
SIM,1880,77,na,1957,2014
STAT,1832,28,40-44,1860,5.202401799444091
STAT,1858,41,20-24,1899,0.25116951081165034
SIM,1849,20,50-100,1869,1
SIM,1889,33,15-19,1922,2
SIM,1824,49,40-44,1873,1
SIM,1892,36,50-100,1928,6
SIM,1853,34,na,1887,3974
STAT,1843,79,na,1922,979.3190232825887
STAT,1886,41,na,1927,4949.725886799661
STAT,1866,17,40-44,1883,0.3498406145499939
SIM,1845,27,15-19,1872,1
SIM,1824,32,na,1856,3599
STAT,1945,26,15-19,1971,1.5647752199819966
STAT,1883,26,30-34,1909,50.13924939399363
STAT,1912,49,50-100,1961,0.4365465777498375
SIM,1927,40,35-39,1967,2
SIM,1824,35,30-34,1859,17
SIM,1919,21,45-49,1940,3
SIM,1868,41,30-34,1909,2
STAT,1888,49,30-34,1937,0.12762010939041155
STAT,1942,25,35-39,1967,31.852590779194866
SIM,1887,56,na,1943,4924
SIM,1925,32,25-29,1957,29
STAT,1878,22,na,1900,4988.598635311818
STAT,1900,42,50-100,1942,0.2052802550110715
SIM,1826,31,25-29,1857,26
SIM,1924,15,40-44,1939,1
SIM,1880,26,20-24,1906,2
STAT,1842,110,na,1952,4.1141612356068746E-4
STAT,1926,30,25-29,1956,22.59285283333842
SIM,1872,16,na,1888,5452
STAT,1825,47,40-44,1872,0.3712548063576346
SIM,1881,23,45-49,1904,1
STAT,1874,24,15-19,1898,6.779393115827057
SIM,1882,28,30-34,1910,63
SIM,1947,15,35-39,1962,8
SIM,1847,49,35-39,1896,1
SIM,1929,8,na,1937,10621
SIM,1832,51,na,1883,3013
SIM,1842,26,35-39,1868,25
STAT,1843,38,45-49,1881,2.9359639400908044
STAT,1812,47,50-100,1859,1.7058250498778977
SIM,1847,35,25-29,1882,8
SIM,1886,32,35-39,1918,2
STAT,1922,26,20-24,1948,41.847927041344995
STAT,1882,21,45-49,1903,1.3760500550595318
SIM,1908,47,45-49,1955,1
SIM,1944,18,na,1962,8138
STAT,1899,49,40-44,1948,0.26164604178327644
SIM,1851,38,45-49,1889,8
STAT,1911,39,15-19,1950,0.03709354153236298
SIM,1913,28,35-39,1941,40
SIM,1958,4,na,1962,10847
STAT,1816,49,40-44,1865,0.8157917184642306
STAT,1909,45,45-49,1954,0.4074378772661535
STAT,1783,87,na,1870,97.66803824235586
STAT,1878,32,35-39,1910,21.361027230902327
SIM,1874,1,na,1875,6538
STAT,1916,15,40-44,1931,0.6021188999937586
STAT,1849,48,50-100,1897,0.383608263905259
STAT,1903,60,na,1963,5833.294648212965
SIM,1834,30,20-24,1864,5
SIM,1941,27,35-39,1968,45
STAT,1839,49,35-39,1888,0.217090610061041
SIM,1911,3,na,1914,8315
SIM,1854,39,25-29,1893,7
SIM,1890,21,45-49,1911,2
SIM,1893,22,25-29,1915,167
STAT,1854,31,na,1885,3785.303962383372
STAT,1889,28,40-44,1917,7.433393665194735
STAT,1839,35,25-29,1874,5.4851069884115
STAT,1811,69,na,1880,1583.034020658064
STAT,1905,28,35-39,1933,28.08320154573443
SIM,1904,53,na,1957,6324
STAT,1857,39,35-39,1896,11.022110804866347
STAT,1933,27,35-39,1960,40.265227536814145
STAT,1823,39,30-34,1862,19.02548264354188
SIM,1796,72,na,1868,1056
STAT,1854,38,20-24,1892,1.1758402991559582
STAT,1893,21,20-24,1914,176.94017042649673
SIM,1858,22,30-34,1880,41
SIM,1835,36,45-49,1871,8
STAT,1863,48,15-19,1911,6.982741868424234E-4
SIM,1854,25,15-19,1879,2
STAT,1935,35,45-49,1970,1.9289148662430806
STAT,1943,25,na,1968,8064.41266669175
STAT,1890,16,20-24,1906,43.81093117421159
SIM,1897,28,40-44,1925,11
SIM,1920,18,25-29,1938,107
STAT,1867,81,na,1948,1022.8152874177048
STAT,1846,25,15-19,1871,0.8529098124412992
STAT,1855,37,25-29,1892,4.34164040711454
STAT,1885,22,25-29,1907,115.08063440843796
SIM,1888,16,30-34,1904,6
STAT,1837,27,15-19,1864,0.8118169822174324
STAT,1846,39,25-29,1885,4.510719875172238
SIM,1894,28,15-19,1922,1
STAT,1912,18,25-29,1930,17.65603828157416
STAT,1897,28,25-29,1925,113.79670987351366
STAT,1940,29,40-44,1969,9.59042215251775
SIM,1885,66,na,1951,3420
SIM,1846,43,45-49,1889,7
STAT,1914,39,40-44,1953,2.9887584608302915
STAT,1933,20,15-19,1953,14.347006018795076
SIM,1868,64,na,1932,3357
STAT,1911,26,45-49,1937,3.4153127056056443
SIM,1850,25,30-34,1875,60
STAT,1875,27,35-39,1902,20.063514554280307
STAT,1809,45,40-44,1854,1.375995113545353
SIM,1894,31,30-34,1925,7
STAT,1860,51,40-44,1911,0.01734882951143459
STAT,1900,19,45-49,1919,0.1820276909955696
STAT,1853,29,15-19,1882,0.7459242226239982
SIM,1915,37,35-39,1952,4
STAT,1886,63,na,1949,3804.0341791237997
STAT,1919,36,15-19,1955,0.04169461861402155
SIM,1919,20,40-44,1939,9
STAT,1904,49,25-29,1953,0.09221704186886069
STAT,1861,28,45-49,1889,1.8664905543051236
SIM,1900,23,30-34,1923,63
STAT,1858,18,45-49,1876,0.11942896037521052
STAT,1952,20,25-29,1972,224.43197378588636
SIM,1921,23,na,1944,8325
SIM,1847,15,30-34,1862,4
SIM,1877,52,50-100,1929,1
SIM,1909,39,25-29,1948,2
STAT,1886,28,15-19,1914,0.9638629753420784
SIM,1849,82,na,1931,626
STAT,1869,34,35-39,1903,19.64838156790888
SIM,1877,22,40-44,1899,1
SIM,1879,38,25-29,1917,7
SIM,1916,46,40-44,1962,1
STAT,1800,84,na,1884,239.66912898497822
SIM,1877,34,35-39,1911,28
STAT,1843,37,40-44,1880,7.1586644666189105
STAT,1857,48,50-100,1905,0.3817648377321303
SIM,1861,31,na,1892,4573
SIM,1871,17,15-19,1888,15
SIM,1884,37,45-49,1921,8
SIM,1838,37,25-29,1875,6
STAT,1838,43,45-49,1881,2.12820707558091
SIM,1942,19,15-19,1961,87
STAT,1827,36,45-49,1863,4.253903886699323
STAT,1874,28,30-34,1902,51.89072289115473
STAT,1878,44,na,1922,4809.294910009113
SIM,1864,38,30-34,1902,18
STAT,1859,20,30-34,1879,33.119785890705536
STAT,1894,27,45-49,1921,2.880566882584696
STAT,1892,38,40-44,1930,11.012726999961135
SIM,1831,25,20-24,1856,23
SIM,1827,40,30-34,1867,4
SIM,1831,39,30-34,1870,17
STAT,1863,17,15-19,1880,11.972012317805902
SIM,1929,24,30-34,1953,91
SIM,1865,37,35-39,1902,15
SIM,1883,27,35-39,1910,27
SIM,1911,23,na,1934,7417
STAT,1917,32,25-29,1949,19.54521782911688
STAT,1919,40,35-39,1959,0.4418465097628856
STAT,1839,48,30-34,1887,0.15203809526982462
STAT,1865,25,25-29,1890,78.14168885883494
SIM,1941,20,15-19,1961,11
STAT,1882,48,25-29,1930,0.11189815210715455
STAT,1857,35,50-100,1892,1.9510640638791221
STAT,1846,12,na,1858,4593.3693968405805
SIM,1910,26,50-100,1936,2
STAT,1842,39,40-44,1881,6.814204239818115
STAT,1890,17,25-29,1907,13.969369257479965
STAT,1842,25,30-34,1867,47.036462717121864
STAT,1899,49,50-100,1948,0.3753520316299222
STAT,1932,40,na,1972,10194.889753737767
STAT,1862,48,50-100,1910,0.4186280143097937
SIM,1882,29,35-39,1911,27
SIM,1932,34,30-34,1966,50
STAT,1907,41,na,1948,6915.440353931516
SIM,1831,26,25-29,1857,94
SIM,1902,27,20-24,1929,36
SIM,1930,26,20-24,1956,50
SIM,1874,81,na,1955,859
SIM,1878,21,45-49,1899,1
SIM,1845,31,35-39,1876,25
SIM,1851,37,40-44,1888,6
STAT,1875,15,40-44,1890,0.38208678345013675
SIM,1807,47,50-100,1854,1
STAT,1876,36,40-44,1912,9.187999872909717
SIM,1879,42,45-49,1921,7
STAT,1908,46,40-44,1954,0.29033135427721757
STAT,1923,25,25-29,1948,153.60649158531342
SIM,1850,39,40-44,1889,17
STAT,1939,15,35-39,1954,8.504761447565237
STAT,1785,101,na,1886,0.29710397524384385
STAT,1871,23,35-39,1894,11.672797652546318
STAT,1874,29,35-39,1903,19.810553055860886
SIM,1919,19,na,1938,8254
SIM,1860,20,20-24,1880,130
STAT,1871,11,na,1882,5321.923537481498
SIM,1833,47,40-44,1880,2
STAT,1907,37,35-39,1944,4.5315850063705945
STAT,1924,34,30-34,1958,37.06498548849979
SIM,1884,36,40-44,1920,11
STAT,1848,37,50-100,1885,2.074579026561908
SIM,1836,32,na,1868,3502
SIM,1867,39,45-49,1906,7
STAT,1848,34,15-19,1882,0.24270945254573034
STAT,1849,43,20-24,1892,0.2493954897986771
STAT,1841,16,25-29,1857,10.667082905575581
SIM,1873,25,25-29,1898,111
SIM,1902,63,na,1965,5623
STAT,1833,69,na,1902,1929.2733380235925
SIM,1892,39,45-49,1931,13
STAT,1841,98,na,1939,4.713405458551991
SIM,1870,27,15-19,1897,1
STAT,1852,23,25-29,1875,107.60901679171147
STAT,1827,39,15-19,1866,0.11065872561895237
STAT,1891,26,30-34,1917,63.07937510117207
STAT,1832,22,45-49,1854,2.195648059175798
STAT,1907,30,15-19,1937,0.2446755032708077
STAT,1944,8,na,1952,8581.784276374663
STAT,1905,34,20-24,1939,4.494520626349246
SIM,1822,51,na,1873,2690
SIM,1862,20,50-100,1882,1
SIM,1914,25,25-29,1939,150
SIM,1839,49,35-39,1888,1
SIM,1912,29,30-34,1941,106
STAT,1819,40,30-34,1859,5.654807736862114
SIM,1875,25,35-39,1900,25
STAT,1846,107,na,1953,0.007223469433687886
SIM,1838,45,na,1883,3245
STAT,1931,18,35-39,1949,11.063775571617812
STAT,1861,24,50-100,1885,0.6941633278488141
STAT,1925,26,50-100,1951,2.3819727171784515
SIM,1901,18,15-19,1919,15
STAT,1833,79,na,1912,919.0632008032264
SIM,1843,35,40-44,1878,16
SIM,1854,38,20-24,1892,6
STAT,1941,26,30-34,1967,81.90187675074361
SIM,1787,90,na,1877,43
STAT,1921,29,30-34,1950,87.54338086140874
STAT,1906,25,25-29,1931,125.33530735414399
SIM,1854,61,na,1915,3060
STAT,1838,39,25-29,1877,4.605350291425137
SIM,1834,37,40-44,1871,9
STAT,1809,108,na,1917,0.001628061501944015
STAT,1885,14,na,1899,5174.801018076124
STAT,1839,15,30-34,1854,3.2942904784448985
STAT,1835,35,40-44,1870,7.159546342485167
STAT,1936,20,40-44,1956,6.498006390005223
SIM,1838,41,45-49,1879,8
SIM,1875,39,45-49,1914,9
STAT,1845,27,15-19,1872,0.8509616088470784
STAT,1873,36,15-19,1909,0.11578693165348083
SIM,1932,18,na,1950,9921
SIM,1848,27,40-44,1875,9
STAT,1873,38,30-34,1911,10.882347216643701
SIM,1860,23,25-29,1883,3
STAT,1886,31,30-34,1917,37.375231940136246
STAT,1862,27,15-19,1889,0.78606906253521
STAT,1910,30,na,1940,7426.88907308578
STAT,1856,15,30-34,1871,2.9716271076249643
STAT,1926,37,45-49,1963,1.6823594953409764
STAT,1937,18,na,1955,7214.2915317508705
SIM,1808,48,45-49,1856,1
SIM,1887,44,45-49,1931,11
SIM,1913,34,20-24,1947,6
STAT,1869,22,40-44,1891,4.077887898985979
SIM,1807,84,na,1891,224
STAT,1915,23,25-29,1938,192.25553720321582
SIM,1907,35,35-39,1942,7
STAT,1930,39,25-29,1969,2.5882258094999475
SIM,1859,21,35-39,1880,17
SIM,1840,22,45-49,1862,2
STAT,1842,26,35-39,1868,17.89351931629716
STAT,1875,20,15-19,1895,6.900760466978158
STAT,1900,19,na,1919,7037.853993440247
STAT,1911,19,20-24,1930,54.51417800644921
STAT,1887,37,20-24,1924,1.7411878192347732
STAT,1841,20,45-49,1861,1.3003098407870002
STAT,1856,29,40-44,1885,4.767696806782882
STAT,1934,36,40-44,1970,4.176535603898438
STAT,1955,16,30-34,1971,32.68375146627119
SIM,1855,17,30-34,1872,1
STAT,1899,19,45-49,1918,0.17978706935713712
STAT,1847,17,30-34,1864,3.03238243944634
SIM,1928,39,35-39,1967,12
SIM,1865,36,30-34,1901,12
SIM,1872,26,na,1898,5073
STAT,1817,37,50-100,1854,9.192669128547786
STAT,1858,49,45-49,1907,0.3638047782190567
STAT,1817,47,40-44,1864,0.8268335757999087
STAT,1870,35,50-100,1905,2.457521617209209
STAT,1904,29,30-34,1933,72.4740584118096
SIM,1907,49,50-100,1956,1
STAT,1893,48,50-100,1941,0.35018647306394507
SIM,1853,12,na,1865,4807
STAT,1826,30,20-24,1856,9.41319056291338
STAT,1879,44,45-49,1923,3.1189422146166277
SIM,1895,37,20-24,1932,5
STAT,1950,9,na,1959,9383.387107953458
SIM,1850,26,35-39,1876,28
SIM,1794,91,na,1885,46
SIM,1864,29,40-44,1893,10
STAT,1884,38,40-44,1922,8.686624170133657
STAT,1917,51,na,1968,7650.512820962337
SIM,1864,15,30-34,1879,5
SIM,1935,36,na,1971,10973
STAT,1814,87,na,1901,151.62639177218216
STAT,1878,31,50-100,1909,1.9405353477172722
STAT,1878,28,15-19,1906,0.953626453528501
SIM,1803,91,na,1894,49
SIM,1934,37,45-49,1971,1
STAT,1920,17,20-24,1937,307.1285032276813
SIM,1822,42,50-100,1864,4
STAT,1845,30,30-34,1875,32.660615007877034
STAT,1840,17,na,1857,4289.865380351009
STAT,1851,37,40-44,1888,6.858598199164081
SIM,1836,30,50-100,1866,2
STAT,1830,72,na,1902,1743.9102682485195
SIM,1923,23,25-29,1946,243
STAT,1931,24,20-24,1955,289.4507661961448
STAT,1864,43,50-100,1907,1.8934452696164106
SIM,1825,47,40-44,1872,1
SIM,1875,38,40-44,1913,16
STAT,1866,22,15-19,1888,6.197860694488491
SIM,1892,38,40-44,1930,19
STAT,1817,48,45-49,1865,1.1221419976221791
SIM,1881,38,30-34,1919,13
STAT,1916,35,35-39,1951,5.049942893044055
SIM,1854,83,na,1937,590
STAT,1832,37,30-34,1869,8.779388948232711
STAT,1883,27,35-39,1910,19.146111795195804
SIM,1944,20,40-44,1964,12
STAT,1841,47,25-29,1888,0.08395243210184504
STAT,1889,35,15-19,1924,0.14116599239031882
SIM,1900,26,35-39,1926,47
STAT,1914,24,20-24,1938,228.035890460921
SIM,1899,47,40-44,1946,1
SIM,1891,27,35-39,1918,26
STAT,1822,47,15-19,1869,0.0012435585142103879
SIM,1922,24,20-24,1946,238
SIM,1875,31,20-24,1906,7
SIM,1927,20,40-44,1947,10
STAT,1860,5,na,1865,4756.375148607191
SIM,1874,22,15-19,1896,7
SIM,1912,41,na,1953,7472
SIM,1829,27,30-34,1856,52
STAT,1900,40,40-44,1940,0.44201338158129233
SIM,1840,37,30-34,1877,21
SIM,1917,30,25-29,1947,23
STAT,1872,15,15-19,1887,12.228852229384136
SIM,1908,20,30-34,1928,69
STAT,1947,17,35-39,1964,9.545713438057655
SIM,1828,43,50-100,1871,6
STAT,1867,38,40-44,1905,8.238649107487532
STAT,1828,43,50-100,1871,1.9573774675114337
SIM,1824,36,35-39,1860,17
SIM,1849,44,25-29,1893,3
STAT,1847,37,25-29,1884,4.553659002959459
STAT,1840,49,na,1889,3192.008494244031
STAT,1951,0,na,1951,10555.919855479016
SIM,1874,26,30-34,1900,56
STAT,1915,36,30-34,1951,3.7366613964563857
SIM,1821,99,na,1920,1
SIM,1910,21,25-29,1931,191
SIM,1924,35,35-39,1959,5
SIM,1893,63,na,1956,4629
SIM,1905,35,25-29,1940,1
SIM,1865,32,15-19,1897,1
STAT,1884,39,45-49,1923,3.935539512933979
SIM,1831,32,45-49,1863,5
SIM,1903,18,25-29,1921,20
STAT,1873,5,na,1878,5670.327495339908
SIM,1891,26,30-34,1917,85
SIM,1853,30,30-34,1883,50
STAT,1897,32,45-49,1929,4.707695500115464
STAT,1858,104,na,1962,0.3678956781575349
SIM,1819,41,35-39,1860,10
STAT,1836,30,50-100,1866,1.5725249231908327
STAT,1831,25,20-24,1856,21.021163014866083
STAT,1890,23,45-49,1913,1.7136946829952422
SIM,1823,37,30-34,1860,10
STAT,1855,32,50-100,1887,1.406792697755885
STAT,1867,39,45-49,1906,3.732581087966716
SIM,1896,18,30-34,1914,5
SIM,1905,38,na,1943,7119
SIM,1880,15,15-19,1895,11
STAT,1846,38,20-24,1884,1.2202625803111506
SIM,1859,34,40-44,1893,9
STAT,1834,97,na,1931,7.139376209803441
SIM,1809,46,45-49,1855,2
STAT,1856,27,25-29,1883,68.30365781622702
STAT,1783,103,na,1886,0.0941866108834599
STAT,1877,20,50-100,1897,0.8603036177012509
SIM,1934,30,25-29,1964,24
SIM,1885,20,25-29,1905,126
STAT,1868,37,45-49,1905,3.830537314936968
SIM,1904,23,15-19,1927,12
STAT,1774,113,na,1887,7.128067082776512E-4
SIM,1808,47,40-44,1855,2
STAT,1871,17,15-19,1888,11.984669989910504
STAT,1888,18,30-34,1906,3.7947019333826972
SIM,1922,43,50-100,1965,1
STAT,1909,38,20-24,1947,0.5016976278552623
STAT,1882,28,30-34,1910,49.36839524555526
STAT,1919,20,40-44,1939,7.478700675697101
SIM,1876,37,45-49,1913,4
SIM,1885,44,na,1929,4818
SIM,1890,28,30-34,1918,73
STAT,1823,32,45-49,1855,9.987387678556813
SIM,1917,38,20-24,1955,3
SIM,1923,36,30-34,1959,6
STAT,1902,21,25-29,1923,163.71985197202022
SIM,1825,48,45-49,1873,1
STAT,1857,32,15-19,1889,0.22556174633046563
SIM,1889,37,na,1926,5934
SIM,1839,22,20-24,1861,106
STAT,1878,44,50-100,1922,2.198295810993527
STAT,1918,36,na,1954,8045.8478479141695
SIM,1857,27,na,1884,4362
SIM,1864,27,25-29,1891,74
STAT,1928,0,na,1928,11462.85751038997
STAT,1816,38,35-39,1854,52.658141433638065
STAT,1849,30,na,1879,4052.9962153833144
SIM,1884,39,45-49,1923,5
SIM,1939,22,25-29,1961,206
SIM,1872,27,25-29,1899,104
STAT,1856,31,45-49,1887,2.779265284650595
STAT,1857,36,30-34,1893,8.430185591191355
SIM,1799,90,na,1889,21
SIM,1883,33,20-24,1916,6
STAT,1872,29,25-29,1901,85.24724355913254
SIM,1908,44,40-44,1952,3
STAT,1909,30,25-29,1939,17.96587845109558
SIM,1869,32,35-39,1901,30
STAT,1889,26,25-29,1915,105.70188843745113
STAT,1933,15,40-44,1948,3.79946814336931
STAT,1907,34,30-34,1941,29.504147999525085
STAT,1833,23,15-19,1856,5.868542422225895
SIM,1797,57,na,1854,2092
STAT,1808,47,40-44,1855,1.0878478285141333
STAT,1923,29,40-44,1952,10.727082650257737
SIM,1867,36,40-44,1903,9
STAT,1829,25,15-19,1854,2.583401598658823
STAT,1917,47,45-49,1964,0.4584387981610021
STAT,1917,20,30-34,1937,62.05538186678713
STAT,1819,64,na,1883,1920.5626203264749
STAT,1859,32,25-29,1891,16.4648756817919
STAT,1864,27,25-29,1891,76.36715661123556
STAT,1927,18,na,1945,9217.329969793447
STAT,1854,27,15-19,1881,0.7291319370871138
SIM,1869,59,na,1928,3729
SIM,1838,39,40-44,1877,20
STAT,1878,26,15-19,1904,0.9602792311673054
SIM,1910,29,20-24,1939,38
SIM,1930,37,na,1967,10475
STAT,1846,36,20-24,1882,1.2458692945955234
STAT,1936,16,20-24,1952,262.8418189032461
STAT,1871,96,na,1967,73.14791435574745
STAT,1875,33,20-24,1908,5.596890484557048
SIM,1841,23,15-19,1864,5
SIM,1929,40,na,1969,9983
SIM,1808,47,na,1855,2832
SIM,1860,79,na,1939,1259
STAT,1902,29,20-24,1931,33.21135218718436
SIM,1817,48,45-49,1865,1
STAT,1924,37,35-39,1961,5.758661563144715
STAT,1831,27,20-24,1858,20.448722803482866
STAT,1832,32,50-100,1864,1.5571319017755598
STAT,1840,39,30-34,1879,8.911839879803807
STAT,1871,20,30-34,1891,35.95386246251422
SIM,1806,48,35-39,1854,1
STAT,1928,20,40-44,1948,8.527817619955155
SIM,1915,34,30-34,1949,40
STAT,1903,38,50-100,1941,0.7582372111977373
STAT,1932,36,30-34,1968,4.950544091351148
SIM,1834,33,25-29,1867,26
SIM,1842,37,40-44,1879,12
STAT,1893,15,35-39,1908,1.4111546002313098
STAT,1840,50,na,1890,3152.6319474068728
SIM,1864,31,45-49,1895,6
SIM,1944,16,20-24,1960,291
SIM,1859,82,na,1941,635
SIM,1933,20,15-19,1953,15
SIM,1941,24,30-34,1965,73
STAT,1876,39,45-49,1915,4.12220415083203
SIM,1934,17,15-19,1951,115
STAT,1865,39,35-39,1904,12.846863274476846
STAT,1888,47,15-19,1935,9.503738030734539E-4
SIM,1932,5,na,1937,10921
STAT,1953,19,25-29,1972,105.7927613009408
STAT,1941,22,15-19,1963,11.110575290335694
SIM,1863,12,na,1875,5022
SIM,1834,24,35-39,1858,9
SIM,1880,29,25-29,1909,116
SIM,1814,54,na,1868,2456
SIM,1879,35,20-24,1914,3
STAT,1937,5,na,1942,7901.421361901868
SIM,1824,38,35-39,1862,17
SIM,1908,27,15-19,1935,2
STAT,1863,67,na,1930,2802.507666682943
SIM,1881,20,40-44,1901,7
SIM,1925,20,30-34,1945,73
STAT,1841,18,40-44,1859,0.3402539074502208
STAT,1861,25,40-44,1886,5.145780677136082
STAT,1880,15,na,1895,5398.377101141861
SIM,1891,29,35-39,1920,28
SIM,1846,64,na,1910,2683
STAT,1833,49,40-44,1882,0.23423463637185613
SIM,1937,26,30-34,1963,89
STAT,1850,27,na,1877,3903.301499495814
SIM,1883,6,na,1889,5465
SIM,1782,91,na,1873,14
STAT,1910,19,na,1929,7690.501206425663
SIM,1873,39,35-39,1912,20
STAT,1883,29,35-39,1912,19.009270950043415
STAT,1934,32,25-29,1966,25.489956145414386
SIM,1832,37,30-34,1869,13
SIM,1874,27,35-39,1901,26
STAT,1851,39,40-44,1890,6.71763143383873
STAT,1904,25,15-19,1929,1.3240880858064235
SIM,1890,45,na,1935,6007
STAT,1928,32,50-100,1960,2.087602534981431
SIM,1929,27,35-39,1956,50
STAT,1895,19,50-100,1914,0.12823710742291944
STAT,1849,37,35-39,1886,11.448216046466143
SIM,1876,30,na,1906,5178
STAT,1897,25,20-24,1922,31.885582300203993
SIM,1936,20,40-44,1956,10
SIM,1861,53,na,1914,4017
SIM,1827,43,35-39,1870,6
STAT,1925,20,15-19,1945,12.942766910734983
STAT,1933,24,30-34,1957,76.95139062554105
STAT,1875,18,45-49,1893,0.1354725829817581
SIM,1883,38,40-44,1921,13
STAT,1842,28,35-39,1870,17.637490832780333
STAT,1926,17,15-19,1943,112.35689145808603
SIM,1873,38,30-34,1911,12
STAT,1898,20,45-49,1918,1.917212368480886
SIM,1831,87,na,1918,149
SIM,1943,28,20-24,1971,43
STAT,1880,28,20-24,1908,24.87166168403727
SIM,1895,39,20-24,1934,2
STAT,1848,24,50-100,1872,0.802508873537536
STAT,1904,23,na,1927,6834.476330725328
SIM,1810,46,35-39,1856,1
SIM,1924,41,na,1965,9304
SIM,1947,21,20-24,1968,263
STAT,1900,16,40-44,1916,0.5136842190075505
SIM,1856,25,25-29,1881,94
SIM,1858,49,45-49,1907,1
STAT,1809,48,45-49,1857,1.796471512752747
SIM,1850,28,35-39,1878,29
STAT,1918,35,45-49,1953,1.4647207066442234
STAT,1836,23,40-44,1859,3.6310778797038203
SIM,1932,37,35-39,1969,8
STAT,1943,16,50-100,1959,0.8025842456203987
SIM,1872,26,20-24,1898,26
SIM,1821,37,20-24,1858,2
SIM,1936,30,35-39,1966,20
STAT,1867,38,50-100,1905,2.310664837255781
STAT,1929,26,30-34,1955,99.07306860528551
STAT,1913,36,20-24,1949,0.5280562248612494
SIM,1841,87,na,1928,205
STAT,1894,7,na,1901,6759.327776282568
STAT,1864,26,20-24,1890,21.25158077913287
STAT,1876,63,na,1939,3727.1612928837526
STAT,1844,31,na,1875,4229.013237467144
SIM,1911,17,20-24,1928,58
SIM,1883,25,50-100,1908,1
STAT,1896,16,15-19,1912,15.862918330471464
STAT,1801,69,na,1870,1497.4333812719224
STAT,1826,33,25-29,1859,28.805997207041862
STAT,1935,28,20-24,1963,50.23840295648785
SIM,1786,72,na,1858,1081
SIM,1816,47,40-44,1863,1
STAT,1903,17,20-24,1920,50.97949818911671
STAT,1908,42,25-29,1950,0.13351941703983858
STAT,1875,25,50-100,1900,1.3391695187623986
SIM,1827,72,na,1899,1437
SIM,1906,23,25-29,1929,176
STAT,1804,99,na,1903,1.2740401271819761
STAT,1887,39,20-24,1926,1.7236635383145167
SIM,1889,28,40-44,1917,8
SIM,1839,47,35-39,1886,1
SIM,1857,37,35-39,1894,14
STAT,1814,49,30-34,1863,0.48611252727535675
STAT,1869,31,30-34,1900,34.3072417240963
STAT,1893,24,25-29,1917,145.624407622373
STAT,1875,38,40-44,1913,9.057219625132378
STAT,1865,38,30-34,1903,9.730266514273572
SIM,1833,46,na,1879,3192
SIM,1867,32,25-29,1899,6
STAT,1858,15,40-44,1873,0.34038033491276426
STAT,1909,22,na,1931,7167.0090463391525
STAT,1865,48,25-29,1913,0.10435718910463719
STAT,1939,21,20-24,1960,225.6328212406551
SIM,1854,36,20-24,1890,3
SIM,1868,44,35-39,1912,6
SIM,1832,38,35-39,1870,21
STAT,1898,38,35-39,1936,4.151713006699656
STAT,1928,21,45-49,1949,2.8453701975188004
STAT,1952,17,na,1969,8907.614834151784
SIM,1899,25,na,1924,6955
STAT,1846,97,na,1943,8.228712552843973
STAT,1810,84,na,1894,300.8448764587866
STAT,1831,35,na,1866,3550.8657535824686
STAT,1832,35,15-19,1867,0.09449515969585685
STAT,1921,28,50-100,1949,2.231977043973207
SIM,1781,95,na,1876,9
SIM,1878,74,na,1952,2175
SIM,1875,38,50-100,1913,2
STAT,1844,26,50-100,1870,1.2737710790839016
SIM,1837,25,15-19,1862,1
SIM,1926,35,45-49,1961,4
STAT,1911,23,40-44,1934,6.4222297016611565
SIM,1899,23,30-34,1922,59
SIM,1844,20,na,1864,3775
SIM,1936,21,45-49,1957,1
SIM,1951,16,50-100,1967,1
SIM,1931,25,25-29,1956,187
STAT,1859,23,35-39,1882,9.662677017962316
STAT,1786,101,na,1887,0.2518823733799289
SIM,1918,26,20-24,1944,50
SIM,1848,37,50-100,1885,5
SIM,1931,29,40-44,1960,13
STAT,1837,31,35-39,1868,17.88584074501566
STAT,1870,29,15-19,1899,0.8931840516673148
SIM,1884,81,na,1965,1762
SIM,1838,34,20-24,1872,5
SIM,1877,31,30-34,1908,39
SIM,1866,20,15-19,1886,5
SIM,1935,29,25-29,1964,183
STAT,1874,26,30-34,1900,52.25272778272875
SIM,1913,32,50-100,1945,2
STAT,1824,38,35-39,1862,20.543431040999653
STAT,1830,49,15-19,1879,6.728340373720862E-4
STAT,1899,16,40-44,1915,0.507361159202009
STAT,1905,32,50-100,1937,1.5366467371540964
SIM,1902,31,na,1933,6991
STAT,1893,11,na,1904,6620.773374133915
SIM,1929,29,na,1958,9634
STAT,1917,39,50-100,1956,0.8753112723988901
SIM,1921,39,25-29,1960,4
STAT,1850,27,30-34,1877,45.43701249812674
STAT,1764,95,na,1859,3.6111454022028697
STAT,1874,17,40-44,1891,0.3782279433192988
SIM,1878,26,15-19,1904,1
SIM,1914,22,20-24,1936,228
SIM,1911,24,45-49,1935,4
STAT,1829,64,na,1893,2057.3629996003688
SIM,1861,26,45-49,1887,4
STAT,1863,45,na,1908,4017.148930280401
STAT,1900,25,30-34,1925,71.02886364932468
STAT,1944,22,40-44,1966,7.331505825114433
SIM,1887,1,na,1888,6854
STAT,1837,25,15-19,1862,0.823601440268803
SIM,1844,23,40-44,1867,3
STAT,1869,49,20-24,1918,0.022992962440919053
SIM,1850,79,na,1929,954
SIM,1894,26,na,1920,6415
SIM,1880,45,na,1925,5033
STAT,1834,32,20-24,1866,4.608953667892485
STAT,1825,49,40-44,1874,0.36117544446328925
STAT,1905,37,25-29,1942,1.8151174367215275
STAT,1852,20,20-24,1872,132.37100881796152
SIM,1928,21,45-49,1949,3
STAT,1843,90,na,1933,110.44126328490933
SIM,1847,49,na,1896,3363
SIM,1852,8,na,1860,4867
STAT,1934,19,15-19,1953,123.32844025038139
SIM,1860,90,na,1950,101
SIM,1865,39,35-39,1904,18
STAT,1926,34,40-44,1960,9.542680799185723
SIM,1864,24,20-24,1888,127
SIM,1833,49,40-44,1882,1
STAT,1877,26,na,1903,5022.092346096848
SIM,1839,46,30-34,1885,1
STAT,1882,19,40-44,1901,0.35791310544339033
STAT,1848,25,25-29,1873,84.00706606745284
SIM,1890,17,25-29,1907,17
STAT,1891,29,35-39,1920,23.915254957950076
SIM,1841,65,na,1906,2334
SIM,1853,33,35-39,1886,23
STAT,1819,43,35-39,1862,8.115234691310423
STAT,1881,41,50-100,1922,2.071611276558646
STAT,1927,29,25-29,1956,160.93133629544857
SIM,1857,48,50-100,1905,2
STAT,1831,28,25-29,1859,72.92840046000988
SIM,1865,78,na,1943,1343
SIM,1871,15,15-19,1886,14
STAT,1898,37,30-34,1935,14.566203654673764
STAT,1906,22,20-24,1928,202.80562461604634
SIM,1871,31,na,1902,4673
SIM,1879,59,na,1938,4015
STAT,1819,37,15-19,1856,0.32658143258834627
SIM,1905,39,40-44,1944,6
STAT,1907,28,45-49,1935,3.284180864615779
STAT,1865,34,15-19,1899,0.2590541294169488
SIM,1901,35,40-44,1936,6
SIM,1868,28,20-24,1896,29
SIM,1949,17,na,1966,8993
STAT,1822,101,na,1923,0.6442815889864637
SIM,1887,38,25-29,1925,7
SIM,1846,36,20-24,1882,3
SIM,1836,21,40-44,1857,9
SIM,1867,37,45-49,1904,8
STAT,1880,17,15-19,1897,12.626190081227323
SIM,1876,3,na,1879,6321
SIM,1882,26,30-34,1908,67
STAT,1864,0,na,1864,6905.774602783576
STAT,1863,9,na,1872,4914.89146299647
STAT,1867,36,40-44,1903,8.31956722835798
STAT,1914,15,30-34,1929,5.116688773401339
STAT,1780,80,na,1860,450.7438752689199
SIM,1913,37,25-29,1950,3
STAT,1830,50,na,1880,3210.3024444586927
STAT,1860,16,35-39,1876,1.044055432034837
SIM,1871,21,35-39,1892,13
SIM,1875,36,40-44,1911,18
SIM,1922,15,30-34,1937,34
SIM,1917,21,35-39,1938,27
SIM,1915,28,45-49,1943,2
STAT,1815,83,na,1898,368.99929587461395
STAT,1860,22,20-24,1882,116.50973965006946
STAT,1853,26,45-49,1879,2.0498029815875434
STAT,1936,23,45-49,1959,2.1722624928627177
STAT,1909,21,35-39,1930,17.737143094415696
SIM,1844,83,na,1927,437
SIM,1812,73,na,1885,1046
SIM,1849,35,35-39,1884,20
STAT,1879,38,25-29,1917,6.0520702411488
STAT,1838,36,20-24,1874,1.2720063931533843
STAT,1847,48,30-34,1895,0.1457022399132217
SIM,1875,34,25-29,1909,23
SIM,1833,21,15-19,1854,5
SIM,1892,48,35-39,1940,1
STAT,1848,27,40-44,1875,5.863818036138052
STAT,1925,16,45-49,1941,1.2214697739839513
STAT,1841,13,na,1854,4447.0
STAT,1862,29,15-19,1891,0.7775843393507421
STAT,1811,47,na,1858,2798.4926511790786
SIM,1898,62,na,1960,5305
STAT,1913,59,na,1972,6811.611004807793
STAT,1824,37,30-34,1861,16.1892461378972
STAT,1906,49,35-39,1955,0.22755666032559366
STAT,1931,27,25-29,1958,171.62710652764366
SIM,1944,23,45-49,1967,3
STAT,1877,24,40-44,1901,4.3427193593777575
STAT,1898,25,50-100,1923,1.7601967009717139
SIM,1826,98,na,1924,2
STAT,1863,21,35-39,1884,10.598242190047385
STAT,1886,34,35-39,1920,21.405475387812945
SIM,1945,24,15-19,1969,12
SIM,1885,24,40-44,1909,12
STAT,1906,16,35-39,1922,1.6187864200731468
SIM,1894,34,35-39,1928,34
STAT,1850,49,na,1899,3377.587552235343
STAT,1928,36,na,1964,9609.86202030096
SIM,1923,27,40-44,1950,17
STAT,1867,31,20-24,1898,5.133525248533473
SIM,1859,30,25-29,1889,26
STAT,1856,18,35-39,1874,1.005048664381313
STAT,1857,8,na,1865,4543.498023774932
STAT,1809,98,na,1907,2.887348746472509
STAT,1841,110,na,1951,4.009471859332291E-4
STAT,1845,33,35-39,1878,18.362931159364848
STAT,1838,37,25-29,1875,4.701991695492375
STAT,1824,87,na,1911,188.36121338002118
SIM,1931,22,50-100,1953,2
SIM,1864,18,35-39,1882,1
STAT,1891,28,30-34,1919,62.64236361271916
SIM,1859,60,na,1919,3358
SIM,1880,67,na,1947,3406
STAT,1846,53,50-100,1899,0.022761593859027374
SIM,1934,34,40-44,1968,17
SIM,1870,29,15-19,1899,1
SIM,1917,20,30-34,1937,3
STAT,1899,21,15-19,1920,9.156417759352605
SIM,1910,60,na,1970,6584
STAT,1921,38,20-24,1959,0.5937126680631973
SIM,1911,45,na,1956,7256
SIM,1868,96,na,1964,26
SIM,1842,32,20-24,1874,6
STAT,1857,37,35-39,1894,11.134171286384419
STAT,1865,26,na,1891,4393.846614892688
SIM,1898,38,35-39,1936,4
SIM,1865,35,50-100,1900,4
SIM,1935,20,50-100,1955,3
STAT,1930,15,15-19,1945,119.04744402888905
STAT,1873,54,50-100,1927,0.030139438548399667
STAT,1823,53,50-100,1876,0.0440336094736518
SIM,1909,43,50-100,1952,1
STAT,1864,33,45-49,1897,3.134853610383752
STAT,1946,22,50-100,1968,1.478695981888127
SIM,1827,50,na,1877,2943
STAT,1834,26,35-39,1860,16.963920318344133
STAT,1915,32,15-19,1947,0.26434305304424954
STAT,1856,24,20-24,1880,122.92961583626175
SIM,1829,94,na,1923,25
SIM,1914,49,35-39,1963,1
STAT,1879,37,20-24,1916,1.6284006324255196
SIM,1895,44,na,1939,6319
SIM,1869,20,40-44,1889,3
SIM,1879,37,na,1916,4828
STAT,1908,29,15-19,1937,1.3390623900198009
SIM,1856,27,40-44,1883,7
STAT,1862,82,na,1944,805.4151699512367
SIM,1847,27,na,1874,3880
STAT,1937,24,15-19,1961,10.464155319494369
STAT,1782,103,na,1885,0.10642710910674588
STAT,1821,39,20-24,1860,2.6755586604765518
STAT,1761,106,na,1867,0.0019515846202928422
SIM,1846,37,25-29,1883,7
STAT,1872,28,20-24,1900,23.727984380647122
STAT,1828,48,20-24,1876,0.021331990684141374
STAT,1829,42,na,1871,3086.2502145276285
SIM,1904,27,30-34,1931,85
STAT,1844,21,25-29,1865,116.26053185487164
STAT,1867,34,25-29,1901,19.207248917031645
STAT,1909,20,30-34,1929,54.30014884349609
SIM,1933,16,45-49,1949,2
STAT,1835,38,45-49,1873,3.160411485839482
STAT,1960,5,na,1965,10340.240089898036
SIM,1843,38,45-49,1881,6
SIM,1907,19,na,1926,7567
STAT,1903,24,45-49,1927,1.9926388417303567
SIM,1852,21,25-29,1873,145
STAT,1882,59,na,1941,3823.5649065519806
STAT,1895,39,20-24,1934,2.008172630057325
STAT,1925,22,30-34,1947,69.46686382752641
STAT,1847,46,15-19,1893,6.114673753660626E-4
SIM,1897,26,25-29,1923,133
STAT,1850,28,35-39,1878,17.28505958663668
SIM,1880,28,20-24,1908,28
STAT,1872,26,20-24,1898,23.8935177541367
STAT,1824,32,25-29,1856,46.08171787074099
STAT,1833,91,na,1924,76.17981108693031
STAT,1893,26,40-44,1919,7.694593787171558
STAT,1939,23,20-24,1962,225.48392815005045
STAT,1834,54,30-34,1888,0.007809030686697844
STAT,1884,20,30-34,1904,35.73445779865956
SIM,1783,76,na,1859,769
SIM,1855,27,25-29,1882,84
SIM,1821,67,na,1888,1684
STAT,1919,25,45-49,1944,3.7947432679910262
STAT,1835,46,45-49,1881,0.3264844943580449
STAT,1838,47,25-29,1885,0.08020095600127514
STAT,1829,86,na,1915,262.5924824176472
STAT,1852,43,40-44,1895,3.5590221966246083
STAT,1855,44,20-24,1899,0.2362471051438197
SIM,1801,101,na,1902,1
STAT,1870,48,50-100,1918,0.48086342154841816
STAT,1878,49,20-24,1927,0.024783122043798813
SIM,1834,35,40-44,1869,11
SIM,1902,19,na,1921,7383
STAT,1868,50,40-44,1918,0.02051985782480219
STAT,1931,8,na,1939,10543.67906607037
STAT,1936,22,40-44,1958,6.493523537559275
STAT,1875,48,40-44,1923,0.3515120255858983
SIM,1872,34,20-24,1906,6
SIM,1883,22,30-34,1905,45
STAT,1876,29,45-49,1905,2.3026912439141327
STAT,1916,30,15-19,1946,0.2700982319207902
STAT,1881,54,50-100,1935,0.028671064611857998
STAT,1841,31,15-19,1872,0.25331276058418606
SIM,1944,22,40-44,1966,11
STAT,1827,33,50-100,1860,2.152055932161889
STAT,1889,42,25-29,1931,1.597151762832358
SIM,1823,34,25-29,1857,24
SIM,1853,17,20-24,1870,31
STAT,1885,77,na,1962,2179.1719968787743
STAT,1898,35,30-34,1933,14.704540655819336
STAT,1845,17,20-24,1862,34.52823280856701
STAT,1891,23,25-29,1914,142.46533751247648
SIM,1837,36,20-24,1873,1
STAT,1826,35,40-44,1861,11.102629669367056
SIM,1861,95,na,1956,15
SIM,1903,48,35-39,1951,1
SIM,1950,20,15-19,1970,12
SIM,1813,48,na,1861,2868
SIM,1857,35,35-39,1892,13
STAT,1868,52,35-39,1920,0.016454470028570773
SIM,1840,31,20-24,1871,7
SIM,1852,26,45-49,1878,5
SIM,1892,28,40-44,1920,9
STAT,1858,33,35-39,1891,15.876953607698212
SIM,1890,25,25-29,1915,130
STAT,1850,37,25-29,1887,4.484493400419874
STAT,1893,39,45-49,1932,5.051722602102261
STAT,1806,49,30-34,1855,0.5719604453898626
SIM,1883,11,na,1894,5375
SIM,1909,41,na,1950,7142
SIM,1843,46,45-49,1889,1
SIM,1859,53,45-49,1912,1
SIM,1927,25,45-49,1952,6
STAT,1870,31,40-44,1901,8.634100441580609
STAT,1842,16,40-44,1858,0.3517519845189528
SIM,1947,23,20-24,1970,275
STAT,1849,35,35-39,1884,11.688452207188933
STAT,1866,32,30-34,1898,32.535829310415345
STAT,1884,28,40-44,1912,5.952936275980135
STAT,1829,49,25-29,1878,0.08853663733305071
STAT,1873,34,15-19,1907,0.28972659485587116
STAT,1855,31,50-100,1886,1.4214765505227849
STAT,1912,45,30-34,1957,0.17388811214704256
SIM,1851,45,40-44,1896,1
STAT,1919,48,50-100,1967,0.49397799108399315
SIM,1839,44,30-34,1883,3
SIM,1832,32,25-29,1864,22
STAT,1843,52,30-34,1895,0.00829404702392284
STAT,1874,5,na,1879,5694.443941803722
STAT,1846,46,20-24,1892,0.018432695937077578
STAT,1844,44,45-49,1888,2.412733754377422
STAT,1911,35,na,1946,7410.7407720921
SIM,1928,24,na,1952,9204
STAT,1867,44,50-100,1911,1.971227151459627
STAT,1943,6,na,1949,8509.71676688236
STAT,1815,41,15-19,1856,0.08613156835823896
STAT,1819,50,45-49,1869,0.06085184850547315
STAT,1960,4,na,1964,10342.411996417284
SIM,1834,48,45-49,1882,2
SIM,1853,76,na,1929,1382
STAT,1886,41,45-49,1927,3.205188296727669
SIM,1880,78,na,1958,1887
STAT,1847,27,25-29,1874,77.50386305594525
SIM,1885,43,45-49,1928,2
STAT,1824,55,na,1879,2419.8049886285767
SIM,1800,73,na,1873,1024
SIM,1953,15,45-49,1968,1
STAT,1824,47,25-29,1871,0.13949882918201192
SIM,1938,25,20-24,1963,39
SIM,1866,38,40-44,1904,13
SIM,1846,29,25-29,1875,88
STAT,1798,85,na,1883,173.2931509776421
STAT,1877,43,45-49,1920,3.116018022741604
STAT,1895,8,na,1903,6841.045292317568
SIM,1892,46,40-44,1938,1
STAT,1817,37,40-44,1854,32.7763568693432
SIM,1860,25,40-44,1885,11
STAT,1885,27,45-49,1912,2.2320381257716995
STAT,1910,45,50-100,1955,0.42835535324764695
STAT,1883,66,na,1949,3252.2441901662937
SIM,1823,46,na,1869,2989
SIM,1870,68,na,1938,2967
STAT,1832,31,20-24,1863,4.64363948095647
STAT,1829,54,20-24,1883,9.837442069909029E-4
STAT,1942,20,15-19,1962,11.280130735533561
SIM,1865,34,30-34,1899,38
STAT,1835,28,45-49,1863,1.8615411959034935
STAT,1876,51,30-34,1927,0.012493533103234911
SIM,1860,42,30-34,1902,2
STAT,1861,36,45-49,1897,3.3671967590254286
STAT,1833,30,25-29,1863,17.74039253504475
STAT,1851,29,40-44,1880,5.359297266828161
STAT,1849,40,30-34,1889,1.8503263316122383
STAT,1901,20,50-100,1921,1.1598532586795036
SIM,1881,17,25-29,1898,14
SIM,1947,18,25-29,1965,118
STAT,1878,50,50-100,1928,0.03231402736832602
SIM,1837,29,30-34,1866,53
STAT,1886,18,20-24,1904,37.69718469770513
STAT,1835,47,50-100,1882,0.33544000775646526
SIM,1920,22,50-100,1942,1
STAT,1880,53,45-49,1933,0.030380469649872083
SIM,1889,36,40-44,1925,15
STAT,1859,54,35-39,1913,0.013458407002421817
STAT,1886,19,na,1905,5355.57153230128
SIM,1843,28,45-49,1871,5
SIM,1866,33,35-39,1899,31
SIM,1869,39,20-24,1908,2
SIM,1893,27,45-49,1920,1
SIM,1825,37,40-44,1862,12
STAT,1873,17,25-29,1890,11.628444800688511
SIM,1868,10,na,1878,5267
STAT,1877,50,35-39,1927,0.018314010708601357
SIM,1892,20,30-34,1912,72
STAT,1786,84,na,1870,193.51305066609967
STAT,1849,48,40-44,1897,0.26740120044194876
STAT,1832,39,30-34,1871,8.594151382937753
STAT,1852,25,40-44,1877,5.641616945607044
STAT,1898,28,40-44,1926,8.158320217223157
STAT,1807,63,na,1870,2002.422216798186
STAT,1865,29,40-44,1894,5.457011264096808
SIM,1909,21,na,1930,7223
STAT,1875,47,na,1922,4656.399902764498
STAT,1870,33,35-39,1903,19.995483914221577
SIM,1802,84,na,1886,241
STAT,1882,25,25-29,1907,83.78829154806462
STAT,1818,36,45-49,1854,15.292384567876125
STAT,1882,30,20-24,1912,5.360735537922249
SIM,1840,39,30-34,1879,17
SIM,1875,49,45-49,1924,1
STAT,1892,15,40-44,1907,0.4645815835969775
STAT,1855,39,25-29,1894,4.297943727578587
STAT,1827,51,35-39,1878,0.015307636084938145
STAT,1816,68,na,1884,1715.9538439496835
STAT,1867,49,45-49,1916,0.43705621075045237
STAT,1835,51,40-44,1886,0.014179856345476022
STAT,1856,42,50-100,1898,1.6441748100142675
STAT,1858,99,na,1957,4.117816042877037
STAT,1884,46,40-44,1930,0.3423884566182052
STAT,1829,36,20-24,1865,1.3719835999367187
STAT,1767,93,na,1860,10.823208851033439
STAT,1884,36,50-100,1920,2.4602356684739206
STAT,1863,46,50-100,1909,0.43542916799051384
STAT,1796,74,na,1870,928.8862568416753
SIM,1862,49,na,1911,4023
STAT,1894,42,35-39,1936,0.3258349894934755
STAT,1894,38,na,1932,6082.022455925379
STAT,1896,27,20-24,1923,31.28107382097379
SIM,1853,40,45-49,1893,2
SIM,1910,38,na,1948,7495
SIM,1919,30,35-39,1949,26
SIM,1839,37,40-44,1876,20
SIM,1890,30,20-24,1920,8
STAT,1925,39,50-100,1964,1.0153493536711897
SIM,1826,36,45-49,1862,9
SIM,1873,33,25-29,1906,28
STAT,1812,54,na,1866,2584.57782705765
STAT,1815,82,na,1897,433.68823265786034
STAT,1890,24,na,1914,5793.715454906101
STAT,1771,115,na,1886,2.8833364573027317E-4
STAT,1849,28,45-49,1877,2.066951830288526
SIM,1884,47,45-49,1931,2
SIM,1910,2,na,1912,8494
STAT,1885,42,40-44,1927,4.516143664014988
STAT,1918,37,50-100,1955,0.8936012665539134
SIM,1820,93,na,1913,18
STAT,1834,24,35-39,1858,10.240123275856766
STAT,1843,27,40-44,1870,5.16422139759791
SIM,1814,85,na,1899,224
STAT,1891,30,15-19,1921,0.3583615586719744
STAT,1923,36,na,1959,8809.140256483395
STAT,1838,52,20-24,1890,9.933876907356075E-4
STAT,1866,27,50-100,1893,1.1920537939970626
STAT,1956,15,20-24,1971,362.4522843232737
STAT,1810,50,25-29,1860,0.022797617296378372
STAT,1850,52,20-24,1902,0.0011254063039608856
STAT,1929,43,50-100,1972,0.3067498373897894
STAT,1801,90,na,1891,62.494301206861486
STAT,1834,21,30-34,1855,31.94012656632528
SIM,1888,26,25-29,1914,6
STAT,1840,32,50-100,1872,1.61085159871373
STAT,1860,27,40-44,1887,4.965613880237879
SIM,1822,35,20-24,1857,2
STAT,1874,30,15-19,1904,0.29685406589789004
SIM,1847,39,40-44,1886,16
STAT,1848,41,25-29,1889,1.065213351980981
STAT,1852,82,na,1934,743.6438519744454
SIM,1873,96,na,1969,99
STAT,1942,19,na,1961,7763.481616857852
SIM,1849,46,40-44,1895,1
SIM,1842,21,30-34,1863,37
SIM,1951,20,na,1971,9116
SIM,1878,37,20-24,1915,4
STAT,1871,30,45-49,1901,3.5271309204660355
SIM,1872,19,25-29,1891,12
STAT,1864,19,25-29,1883,10.458614052440527
SIM,1873,30,20-24,1903,7
STAT,1888,43,20-24,1931,0.3763585376955532
SIM,1833,24,40-44,1857,4
STAT,1817,38,50-100,1855,8.433175422164142
STAT,1820,73,na,1893,1329.6978771649353
STAT,1844,51,35-39,1895,0.013969410479406611
SIM,1906,17,25-29,1923,22
STAT,1930,38,na,1968,9900.738551842647
STAT,1821,90,na,1911,87.3905209895961
SIM,1945,20,35-39,1965,25
SIM,1847,43,25-29,1890,1
STAT,1874,52,50-100,1926,0.03106493968216158
STAT,1885,47,50-100,1932,0.49142695239379697
SIM,1968,0,na,1968,10511
STAT,1834,47,40-44,1881,0.2416836882106099
STAT,1915,17,na,1932,8164.637705878221
SIM,1829,31,na,1860,3567
SIM,1870,32,45-49,1902,9
STAT,1881,29,25-29,1910,81.98562683230558
SIM,1847,7,na,1854,4763
SIM,1856,19,40-44,1875,1
SIM,1857,28,45-49,1885,2
SIM,1898,36,35-39,1934,28
STAT,1820,35,45-49,1855,11.416171202294858
STAT,1856,44,na,1900,3552.844503504727
STAT,1859,47,45-49,1906,0.37759881710610743
STAT,1903,37,50-100,1940,0.7620168145981443
SIM,1893,42,40-44,1935,1
STAT,1813,71,na,1884,1356.4405560495964
STAT,1835,53,35-39,1888,0.011145353636916553
STAT,1896,45,20-24,1941,0.01822899347530545
SIM,1865,27,40-44,1892,6
STAT,1818,51,40-44,1869,0.045404192433374325
SIM,1894,18,20-24,1912,48
SIM,1851,85,na,1936,319
STAT,1870,16,45-49,1886,0.1315318043410405
STAT,1879,45,20-24,1924,0.02560245221789818
STAT,1899,31,30-34,1930,48.51089842786478
STAT,1825,39,40-44,1864,10.676179002664327
STAT,1922,19,na,1941,8554.702929396879
STAT,1835,27,na,1862,3651.270166793951
STAT,1840,35,15-19,1875,0.09788090806342742
STAT,1915,2,na,1917,8617.395795394588
STAT,1900,63,na,1963,5373.123101550839
SIM,1875,12,na,1887,5852
STAT,1860,41,25-29,1901,1.0579561661927557
STAT,1767,101,na,1868,0.21854903982527463
SIM,1832,47,25-29,1879,1
STAT,1857,34,30-34,1891,27.249717700013047
STAT,1894,40,40-44,1934,5.894396516651061
SIM,1907,20,15-19,1927,10
SIM,1933,6,na,1939,11334
SIM,1806,66,na,1872,1655
SIM,1827,27,20-24,1854,2
STAT,1903,47,30-34,1950,0.15628307284316242
STAT,1848,37,40-44,1885,7.396887843714833
SIM,1857,40,30-34,1897,2
SIM,1811,57,na,1868,2201
STAT,1820,34,35-39,1854,65.14078688809266
STAT,1928,30,35-39,1958,23.099919588030847
STAT,1837,17,50-100,1854,0.13370561950689724
STAT,1840,15,20-24,1855,33.52595511696924
SIM,1791,63,na,1854,1562
SIM,1833,39,40-44,1872,13
STAT,1882,32,15-19,1914,0.28017238422947605
SIM,1896,25,20-24,1921,33
SIM,1947,15,na,1962,8770
SIM,1852,44,45-49,1896,4
STAT,1837,48,20-24,1885,0.017144706264225887
STAT,1839,39,40-44,1878,8.000216712110412
STAT,1844,63,na,1907,2881.497955279586
STAT,1848,19,40-44,1867,0.3674130539105593
STAT,1948,16,25-29,1964,100.18062118724792
STAT,1843,46,na,1889,3177.3717646945606
STAT,1855,29,25-29,1884,65.53676706452471
SIM,1863,66,na,1929,2923
STAT,1880,20,45-49,1900,1.4924545783089962
STAT,1850,22,25-29,1872,105.34971928888005
STAT,1834,37,40-44,1871,7.248087007379726
STAT,1891,38,25-29,1929,7.151925903883573
STAT,1887,36,na,1923,5347.277427405864
STAT,1937,20,35-39,1957,18.53490541256689
SIM,1830,48,na,1878,2818
SIM,1855,47,na,1902,3959
STAT,1847,28,na,1875,3935.0452628536227
STAT,1838,79,na,1917,946.1460502780851
STAT,1888,25,20-24,1913,28.193724834078246
STAT,1838,29,25-29,1867,71.7839134018859
STAT,1853,41,35-39,1894,2.878035973613355
STAT,1839,46,30-34,1885,0.15598417466903916
STAT,1859,52,40-44,1911,0.0168329924537425
SIM,1911,47,30-34,1958,1
STAT,1855,27,na,1882,3751.0658810338073
STAT,1851,13,na,1864,4478.890814648056
SIM,1944,4,na,1948,8828
SIM,1816,39,40-44,1855,16
SIM,1831,33,20-24,1864,8
SIM,1936,23,45-49,1959,2
SIM,1856,102,na,1958,2
SIM,1819,84,na,1903,231
SIM,1888,62,na,1950,4390
STAT,1857,27,40-44,1884,4.857149181058582
STAT,1928,23,45-49,1951,2.8280399038176065
SIM,1842,49,na,1891,3154
SIM,1863,32,50-100,1895,1
STAT,1876,52,40-44,1928,0.021873714887455296
STAT,1864,83,na,1947,716.6843903502448
SIM,1856,41,25-29,1897,2
SIM,1893,37,45-49,1930,11
STAT,1864,63,na,1927,3221.2213941879336
SIM,1842,29,na,1871,3808
STAT,1843,45,40-44,1888,0.24489734009317715
SIM,1879,8,na,1887,5507
SIM,1826,46,45-49,1872,1
SIM,1843,66,na,1909,2463
STAT,1805,52,na,1857,2591.9499842769437
SIM,1850,48,na,1898,3583
STAT,1847,42,20-24,1889,0.24343551202048633
SIM,1891,26,50-100,1917,3
STAT,1797,68,na,1865,1421.6318109361168
STAT,1876,47,45-49,1923,0.49067264123813165
STAT,1840,33,20-24,1873,4.7031577126074335
STAT,1844,26,45-49,1870,2.210862644627289
STAT,1949,4,na,1953,9298.03095539243
SIM,1863,29,25-29,1892,77
SIM,1875,3,na,1878,6562
STAT,1948,23,15-19,1971,12.33906574940513
SIM,1817,38,45-49,1855,3
SIM,1799,79,na,1878,496
STAT,1818,53,35-39,1871,0.03567574736952877
STAT,1852,50,na,1902,3481.056256968518
STAT,1811,44,35-39,1855,13.080216439020468
SIM,1892,45,30-34,1937,1
STAT,1823,33,20-24,1856,13.468058227482883
STAT,1914,43,50-100,1957,0.23477047822144562
STAT,1861,40,30-34,1901,1.952102601715436
STAT,1896,47,15-19,1943,5.988296919638374E-4
SIM,1924,42,na,1966,9282
STAT,1929,21,na,1950,9353.831024137358
SIM,1884,29,45-49,1913,2
SIM,1916,23,na,1939,7801
SIM,1851,27,40-44,1878,8
SIM,1792,69,na,1861,1344
STAT,1760,106,na,1866,0.0031879261333151096
STAT,1845,36,50-100,1881,2.008521280591932
STAT,1890,24,20-24,1914,168.81656466824248
SIM,1893,44,35-39,1937,1
STAT,1892,59,na,1951,4913.652436702364
SIM,1919,51,na,1970,7983
STAT,1948,12,na,1960,9078.39711158291
STAT,1885,44,35-39,1929,3.5911351882211155
SIM,1883,48,40-44,1931,1
STAT,1850,18,40-44,1868,0.34067441693799805
STAT,1856,64,na,1920,2708.7729734271943
SIM,1939,21,20-24,1960,222
SIM,1898,29,45-49,1927,4
STAT,1857,49,50-100,1906,0.37855037779842576
STAT,1840,28,25-29,1868,75.58574923347811
SIM,1847,46,30-34,1893,1
SIM,1858,5,na,1863,5065
STAT,1826,38,45-49,1864,4.565841783244791
STAT,1829,39,25-29,1868,4.851778833331243
STAT,1891,22,15-19,1913,8.235624516461161
SIM,1908,30,30-34,1938,34
STAT,1818,46,45-49,1864,1.0565854927034748
SIM,1910,48,25-29,1958,1
STAT,1819,39,15-19,1858,0.2865886869724024
SIM,1883,25,35-39,1908,27
STAT,1885,50,40-44,1935,0.021467824750669235
SIM,1877,51,50-100,1928,1
SIM,1938,28,25-29,1966,143
STAT,1860,19,40-44,1879,0.3419051600087483
STAT,1876,26,40-44,1902,6.278786257037411
SIM,1870,17,20-24,1887,39
SIM,1857,70,na,1927,2465
SIM,1929,41,na,1970,9965
STAT,1820,42,35-39,1862,7.3257435379349785
SIM,1841,37,25-29,1878,10
STAT,1936,25,45-49,1961,3.34272647892153
STAT,1939,26,25-29,1965,133.7119480565306
STAT,1868,53,45-49,1921,0.02743824714805677
SIM,1861,34,45-49,1895,4
SIM,1835,26,45-49,1861,2
STAT,1835,43,40-44,1878,3.447682006432158
SIM,1843,43,40-44,1886,6
SIM,1866,48,40-44,1914,1
SIM,1878,29,20-24,1907,28
SIM,1912,3,na,1915,8356
STAT,1872,51,45-49,1923,0.029597372512843594
STAT,1839,25,25-29,1864,84.41684528211626
SIM,1855,24,20-24,1879,143
SIM,1898,26,40-44,1924,14
STAT,1774,95,na,1869,3.606370426819009
STAT,1858,48,40-44,1906,0.26615363211759374
STAT,1917,26,50-100,1943,2.1152173220002233
STAT,1856,38,50-100,1894,1.9036241528243643
STAT,1862,17,20-24,1879,35.049651116185814
SIM,1848,38,45-49,1886,6
SIM,1860,78,na,1938,1436
STAT,1882,49,na,1931,4333.910883554748
STAT,1830,39,20-24,1869,1.404706919485758
SIM,1918,34,na,1952,8210
STAT,1850,25,30-34,1875,46.09658304110947
STAT,1840,25,20-24,1865,21.4202806708876
STAT,1891,19,40-44,1910,0.454147289605508
SIM,1823,31,20-24,1854,7
STAT,1846,49,25-29,1895,0.08638434424100772
STAT,1914,44,50-100,1958,0.23435962988455805
SIM,1938,20,15-19,1958,13
STAT,1878,39,20-24,1917,1.6095875984552246
SIM,1799,91,na,1890,17
STAT,1844,43,35-39,1887,2.9568537928419922
STAT,1898,36,40-44,1934,12.021683093994357
SIM,1877,78,na,1955,1344
STAT,1885,37,45-49,1922,4.007498710764512
SIM,1831,33,na,1864,3793
STAT,1882,22,20-24,1904,135.5782114524396
SIM,1925,26,50-100,1951,3
STAT,1847,83,na,1930,605.1438847061654
STAT,1865,33,25-29,1898,18.713938029394782
STAT,1847,44,15-19,1891,0.020766753363352583
SIM,1855,37,25-29,1892,10
SIM,1875,23,35-39,1898,16
SIM,1835,47,na,1882,3219
SIM,1882,23,25-29,1905,116
STAT,1849,34,50-100,1883,1.495827655876913
STAT,1902,48,25-29,1950,0.09147957818521184
SIM,1834,38,45-49,1872,5
STAT,1873,35,25-29,1908,5.964385789675879
STAT,1873,41,50-100,1914,2.1777077904595075
SIM,1894,40,35-39,1934,5
STAT,1886,40,35-39,1926,3.8995053336806795
STAT,1783,102,na,1885,0.1502969838726282
SIM,1826,28,45-49,1854,3
STAT,1823,41,20-24,1864,0.5424094545868249
STAT,1876,54,35-39,1930,0.017488593214740944
SIM,1863,39,25-29,1902,10
SIM,1904,22,na,1926,6986
SIM,1871,85,na,1956,436
SIM,1895,12,na,1907,7223
STAT,1866,54,25-29,1920,0.00641896063880436
STAT,1894,17,45-49,1911,0.1694724986903872
SIM,1911,55,na,1966,6975
STAT,1919,22,40-44,1941,7.43434315058833
STAT,1893,29,45-49,1922,2.821926565717536
SIM,1890,22,20-24,1912,180
STAT,1935,37,na,1972,10626.69497944651
SIM,1927,22,40-44,1949,12
STAT,1849,31,na,1880,4011.128764478406
STAT,1890,32,20-24,1922,6.663461302193568
STAT,1875,25,35-39,1900,20.199632024919243
SIM,1939,23,15-19,1962,1
STAT,1859,37,45-49,1896,3.204508319796713
STAT,1894,35,45-49,1929,5.221013676930077
STAT,1859,30,50-100,1889,1.4943100565349323
SIM,1863,11,na,1874,5044
SIM,1901,57,na,1958,5893
STAT,1856,105,na,1961,0.14357218118643272
SIM,1843,25,40-44,1868,8
STAT,1880,15,15-19,1895,12.684853201750474
STAT,1880,50,40-44,1930,0.022720216583158953
SIM,1835,44,45-49,1879,7
STAT,1836,27,20-24,1863,20.18780066626314
STAT,1852,28,45-49,1880,2.0463415370131606
SIM,1852,43,35-39,1895,5
SIM,1859,61,na,1920,3273
SIM,1847,18,35-39,1865,1
SIM,1885,40,40-44,1925,7
STAT,1846,98,na,1944,4.975820193579222
STAT,1842,84,na,1926,495.27375163776986
STAT,1810,83,na,1893,359.01628514002505
STAT,1815,42,25-29,1857,3.87626860082641
STAT,1885,19,45-49,1904,0.1306133529130663
SIM,1867,25,na,1892,4876
SIM,1867,48,na,1915,4502
STAT,1857,81,na,1938,851.2698257507734
SIM,1867,30,50-100,1897,3
SIM,1881,41,50-100,1922,5
STAT,1817,53,na,1870,2654.881978541293
SIM,1849,33,35-39,1882,35
SIM,1860,28,45-49,1888,3
STAT,1827,44,45-49,1871,2.7420644037247213
STAT,1910,47,20-24,1957,0.020831371233771826
STAT,1913,33,50-100,1946,1.6547399970648395
SIM,1878,64,na,1942,3690
SIM,1829,29,25-29,1858,90
SIM,1898,33,30-34,1931,59
STAT,1807,47,25-29,1854,0.39657876598885394
SIM,1919,23,45-49,1942,2
STAT,1928,15,45-49,1943,1.2769353117291404
STAT,1840,18,25-29,1858,10.527957600359809
SIM,1930,38,na,1968,10468
STAT,1791,75,na,1866,824.8131560792613
STAT,1831,49,50-100,1880,0.366326520571169
STAT,1877,40,40-44,1917,4.764684393893654
STAT,1852,109,na,1961,0.0037830395061361744
STAT,1874,38,25-29,1912,5.924402972897092
STAT,1821,35,na,1856,3215.113787328454
SIM,1844,52,na,1896,3044
SIM,1876,27,45-49,1903,2
STAT,1832,41,15-19,1873,0.02231162930265067
SIM,1832,24,25-29,1856,110
SIM,1879,43,20-24,1922,1
SIM,1944,25,45-49,1969,5
SIM,1947,15,20-24,1962,296
SIM,1842,24,35-39,1866,14
SIM,1837,39,25-29,1876,8
STAT,1842,24,40-44,1866,3.857056610882388
SIM,1827,39,15-19,1866,1
SIM,1888,19,35-39,1907,1
STAT,1831,45,na,1876,3195.7908062918013
STAT,1861,11,na,1872,4633.476379887615
SIM,1894,58,na,1952,5289
STAT,1910,18,na,1928,7711.708404538143
STAT,1933,26,na,1959,10051.41480732653
SIM,1868,43,45-49,1911,6
SIM,1924,20,15-19,1944,13
SIM,1844,27,20-24,1871,2
STAT,1888,38,25-29,1926,6.838741935225685
SIM,1842,29,40-44,1871,9
SIM,1822,38,25-29,1860,8
SIM,1832,28,40-44,1860,6
STAT,1824,31,15-19,1855,0.7566596032090092
STAT,1814,45,15-19,1859,0.0021378660459619564
STAT,1918,21,35-39,1939,20.568243892843494
SIM,1882,38,25-29,1920,8
STAT,1849,43,35-39,1892,2.8436507027177353
STAT,1849,105,na,1954,0.04637938614478702
STAT,1839,43,25-29,1882,1.0433302110995812
STAT,1832,34,25-29,1866,17.034660682540807
SIM,1852,36,45-49,1888,3
SIM,1847,25,25-29,1872,109
SIM,1861,41,35-39,1902,4
SIM,1921,33,50-100,1954,2
STAT,1881,36,15-19,1917,0.1101458672932713
STAT,1947,25,20-24,1972,41.7412178459358
STAT,1861,33,40-44,1894,7.259292799517352
STAT,1856,40,20-24,1896,0.24996525573962042
STAT,1879,53,20-24,1932,0.0015338090013671682
SIM,1813,91,na,1904,33
SIM,1782,90,na,1872,29
SIM,1896,38,25-29,1934,12
STAT,1834,29,40-44,1863,5.153915315543449
STAT,1881,26,20-24,1907,22.97933573585748
STAT,1916,20,15-19,1936,11.332522922732988
SIM,1871,28,20-24,1899,22
STAT,1866,28,45-49,1894,2.0617443762867182
STAT,1844,36,45-49,1880,3.7773999041219626
SIM,1812,74,na,1886,951
SIM,1840,34,25-29,1874,26
SIM,1890,44,na,1934,6007
STAT,1824,35,30-34,1859,17.563748859724395
STAT,1852,46,45-49,1898,0.37720714403581573
STAT,1863,28,20-24,1891,20.667035653559513
STAT,1865,57,na,1922,3687.29354165346
STAT,1896,48,25-29,1944,0.08554686898554306
SIM,1865,77,na,1942,1496
STAT,1845,17,na,1862,4470.622205074814
STAT,1888,45,15-19,1933,9.643444454371604E-4
SIM,1850,24,40-44,1874,4
SIM,1873,29,40-44,1902,9
STAT,1851,65,na,1916,2619.750522778232
STAT,1855,36,20-24,1891,1.1679841823047603
STAT,1837,30,na,1867,3866.6505021819535
STAT,1834,65,na,1899,2245.8551823498947
STAT,1881,31,na,1912,4677.309772585922
SIM,1830,27,20-24,1857,18
SIM,1898,72,na,1970,4198
STAT,1859,104,na,1963,0.4376659215703452
STAT,1839,50,50-100,1889,0.024168638422731807
STAT,1874,93,na,1967,209.735851328438
STAT,1916,34,na,1950,7818.430068519514
SIM,1894,33,45-49,1927,4
STAT,1866,36,25-29,1902,5.391149157957614
STAT,1893,76,na,1969,3263.7494598794906
SIM,1849,49,45-49,1898,1
STAT,1930,25,50-100,1955,2.5582909390647934
STAT,1829,28,20-24,1857,28.74878298815979
STAT,1842,49,40-44,1891,0.24956322051457336
STAT,1871,19,15-19,1890,11.843906350799118
STAT,1892,44,25-29,1936,0.11122171894240629
STAT,1845,40,45-49,1885,2.4094264710139766
STAT,1857,17,40-44,1874,0.33841161951412574
STAT,1910,46,50-100,1956,0.4274086879169695
SIM,1832,35,30-34,1867,14
STAT,1864,42,20-24,1906,0.2863536909781684
STAT,1875,22,30-34,1897,37.03799898214557
STAT,1829,29,30-34,1858,54.72335412804971
STAT,1857,38,na,1895,3690.3765250385723
SIM,1871,46,50-100,1917,1
STAT,1955,14,na,1969,10526.313678001907
SIM,1827,42,45-49,1869,8
STAT,1870,48,na,1918,4404.992404346298
SIM,1857,25,40-44,1882,7
STAT,1898,43,30-34,1941,0.21662072953929984
SIM,1850,23,30-34,1873,42
SIM,1872,79,na,1951,1337
SIM,1863,36,20-24,1899,2
STAT,1844,18,45-49,1862,0.1333063459813221
STAT,1891,15,25-29,1906,14.212045297296514
SIM,1917,40,na,1957,8032
STAT,1912,20,na,1932,7432.3101444227395
STAT,1911,49,30-34,1960,0.1694948923592139
STAT,1808,49,na,1857,2583.4112328203664
SIM,1837,28,20-24,1865,22
STAT,1926,20,30-34,1946,70.9281347576354
STAT,1870,26,45-49,1896,2.2090943898008466
STAT,1854,25,15-19,1879,0.8128748712953113
SIM,1874,36,25-29,1910,8
SIM,1840,16,25-29,1856,8
STAT,1863,38,20-24,1901,1.3560248541519937
STAT,1881,16,20-24,1897,34.69253090523586
STAT,1853,42,45-49,1895,2.36507089093299
SIM,1888,36,25-29,1924,11
SIM,1836,64,na,1900,2184
STAT,1825,53,25-29,1878,0.007258617370840771
STAT,1835,25,40-44,1860,5.132135650769039
STAT,1883,24,30-34,1907,35.12317681229257
SIM,1939,24,25-29,1963,220
SIM,1860,38,45-49,1898,6
STAT,1863,46,na,1909,3988.7878588326216
STAT,1832,26,25-29,1858,75.12730297621374
STAT,1876,44,40-44,1920,4.635001857463637
SIM,1820,40,35-39,1860,8
STAT,1815,39,30-34,1854,37.24561616102131
STAT,1855,26,20-24,1881,18.572494934837913
STAT,1888,46,25-29,1934,0.1378853238625023
STAT,1852,38,45-49,1890,3.161480402674029
SIM,1884,44,40-44,1928,8
SIM,1841,30,25-29,1871,26
STAT,1850,48,na,1898,3406.268331587307
STAT,1868,45,45-49,1913,0.45800123152546346
SIM,1876,45,45-49,1921,1
STAT,1860,37,40-44,1897,7.179467218181708
STAT,1896,19,20-24,1915,47.01834871355788
STAT,1849,25,40-44,1874,5.698438046920342
STAT,1880,38,50-100,1918,2.599156295113707
SIM,1962,2,na,1964,10323
STAT,1893,46,35-39,1939,0.20273178055044283
STAT,1777,112,na,1889,0.001394585263721649
STAT,1965,1,na,1966,9926.060847474522
SIM,1856,48,25-29,1904,1
SIM,1816,39,50-100,1855,3
SIM,1834,48,50-100,1882,2
STAT,1831,50,45-49,1881,0.020328271698979397
STAT,1861,43,35-39,1904,3.022004037935983
STAT,1839,18,35-39,1857,1.1141782348631675
STAT,1850,21,15-19,1871,6.115136340973762
SIM,1823,39,30-34,1862,15
SIM,1840,26,25-29,1866,90
SIM,1824,33,30-34,1857,29
SIM,1907,18,na,1925,7578
STAT,1840,36,25-29,1876,4.966778138603081
STAT,1900,43,45-49,1943,0.28906881325978767
SIM,1897,6,na,1903,7223
STAT,1809,53,40-44,1862,0.07605509906915245
STAT,1921,25,na,1946,8487.251036826512
SIM,1800,54,25-29,1854,1
SIM,1863,26,20-24,1889,23
SIM,1939,31,15-19,1970,1
STAT,1888,28,25-29,1916,100.62081021417488
SIM,1848,65,na,1913,2483
STAT,1862,29,na,1891,4090.175684991449
STAT,1804,102,na,1906,0.19722435376614908
STAT,1832,33,15-19,1865,0.23941582671480965
STAT,1887,19,50-100,1906,0.1100690364042549
SIM,1818,99,na,1917,1
STAT,1843,53,40-44,1896,0.014510533947480038
STAT,1860,22,35-39,1882,9.865994176895136
STAT,1881,19,25-29,1900,11.002591717442469
SIM,1859,81,na,1940,754
SIM,1891,24,30-34,1915,68
SIM,1886,39,20-24,1925,1
STAT,1855,46,15-19,1901,6.048857647180943E-4
STAT,1829,46,20-24,1875,0.019183651618731517
STAT,1822,37,20-24,1859,3.087590611619492
SIM,1805,72,na,1877,1094
STAT,1845,29,15-19,1874,0.8387856692572785
STAT,1857,35,40-44,1892,6.956496653845683
STAT,1865,15,25-29,1880,11.913896803478789
STAT,1813,44,50-100,1857,6.935952974184609
SIM,1899,26,na,1925,6666
STAT,1894,43,45-49,1937,0.2676872661395412
STAT,1904,48,50-100,1952,0.39654210750996416
SIM,1871,38,20-24,1909,2
SIM,1934,20,30-34,1954,102
STAT,1903,39,30-34,1942,3.2745893949058473
STAT,1873,27,25-29,1900,86.80488965027415
STAT,1897,41,20-24,1938,0.029907181810402465
STAT,1827,107,na,1934,0.005702693466752546
SIM,1881,27,25-29,1908,76
STAT,1842,23,30-34,1865,33.2083432921002
SIM,1801,67,na,1868,1540
STAT,1826,48,45-49,1874,0.4642506075217975
SIM,1839,27,40-44,1866,4
SIM,1789,69,na,1858,1391
STAT,1837,38,20-24,1875,1.2948691554183385
STAT,1839,96,na,1935,13.407450466985354
SIM,1853,29,15-19,1882,1
SIM,1829,37,25-29,1866,9
SIM,1892,37,50-100,1929,5
STAT,1835,82,na,1917,604.2904343849516
STAT,1811,68,na,1879,1643.1741962404642
SIM,1834,22,35-39,1856,11
STAT,1865,36,30-34,1901,9.825834959006597
SIM,1810,44,40-44,1854,5
STAT,1847,45,25-29,1892,0.08867743811135244
SIM,1911,39,30-34,1950,8
STAT,1884,37,50-100,1921,2.4484511396219313
SIM,1896,28,25-29,1924,122
SIM,1898,44,35-39,1942,2
STAT,1896,37,20-24,1933,2.0554132943554766
SIM,1884,26,40-44,1910,8
SIM,1873,36,30-34,1909,14
STAT,1886,15,45-49,1901,0.13991086898541558
STAT,1819,42,45-49,1861,6.929232807267339
STAT,1893,12,na,1905,6610.908421806455
STAT,1857,42,30-34,1899,1.807576041312162
STAT,1849,32,30-34,1881,29.102217179789722
SIM,1887,25,na,1912,5895
SIM,1845,38,20-24,1883,3
SIM,1862,25,15-19,1887,1
STAT,1827,52,45-49,1879,0.02529740924844497
STAT,1921,38,35-39,1959,5.447608662866574
SIM,1815,40,25-29,1855,2
STAT,1938,22,15-19,1960,10.641830031249738
SIM,1874,29,35-39,1903,31
SIM,1863,19,30-34,1882,5
STAT,1880,14,na,1894,5476.689011157304
SIM,1857,32,30-34,1889,37
SIM,1948,17,30-34,1965,31
STAT,1852,45,35-39,1897,0.22535797748474914
STAT,1898,18,40-44,1916,0.4985803926925639
STAT,1839,42,15-19,1881,0.02272651892529835
STAT,1874,31,25-29,1905,21.267391479638867
SIM,1859,38,20-24,1897,2
SIM,1882,31,25-29,1913,25
STAT,1850,28,na,1878,3875.275794729434
SIM,1949,21,30-34,1970,75
STAT,1883,17,40-44,1900,0.36292966860443737
STAT,1886,33,45-49,1919,3.7020399473212096
STAT,1855,19,30-34,1874,2.8250887703231675
STAT,1896,61,na,1957,5076.571499166247
STAT,1876,22,50-100,1898,0.8518169645381425
STAT,1835,50,30-34,1885,0.008177951979351544
SIM,1874,2,na,1876,6135
STAT,1848,14,na,1862,4808.481635723179
STAT,1885,34,40-44,1919,8.643443854686353
STAT,1949,23,30-34,1972,67.70598294857234
STAT,1862,31,35-39,1893,17.552793776355983
STAT,1883,28,25-29,1911,83.64212281094616
SIM,1872,42,50-100,1914,4
SIM,1839,84,na,1923,364
STAT,1841,28,40-44,1869,5.359619809882576
SIM,1844,34,45-49,1878,7
STAT,1781,85,na,1866,165.58141243533487
STAT,1888,42,na,1930,5510.287406471542
SIM,1898,37,50-100,1935,1
STAT,1919,49,35-39,1968,0.28071345310324564
SIM,1891,61,na,1952,4940
STAT,1860,47,35-39,1907,0.2285411360236963
SIM,1815,43,30-34,1858,6
STAT,1858,105,na,1963,0.20033391258390404
SIM,1943,21,35-39,1964,24
STAT,1848,47,35-39,1895,0.22848879845091236
STAT,1868,27,45-49,1895,2.1334767510129513
SIM,1847,28,na,1875,3888
SIM,1843,14,na,1857,4527
SIM,1851,33,na,1884,3908
STAT,1844,40,30-34,1884,1.9508360388025892
STAT,1947,20,15-19,1967,12.157991368904893
SIM,1888,18,25-29,1906,15
STAT,1874,34,30-34,1908,35.79608983093932
SIM,1880,39,25-29,1919,9
SIM,1833,34,35-39,1867,9
SIM,1882,34,30-34,1916,47
SIM,1919,29,50-100,1948,1
STAT,1924,22,15-19,1946,12.682343102972888
SIM,1942,16,na,1958,7906
SIM,1877,40,35-39,1917,6
STAT,1911,43,20-24,1954,0.03384792527771891
SIM,1864,32,20-24,1896,5
SIM,1838,24,20-24,1862,123
SIM,1870,40,45-49,1910,7
STAT,1905,62,na,1967,5859.85946385967
STAT,1848,33,25-29,1881,17.638972724307987
SIM,1798,74,na,1872,873
SIM,1925,30,30-34,1955,50
STAT,1888,35,20-24,1923,1.8575418321710675
STAT,1840,41,20-24,1881,0.2422111031436006
SIM,1891,0,na,1891,7030
STAT,1818,48,50-100,1866,1.0661393718601613
SIM,1849,38,40-44,1887,13
STAT,1854,48,20-24,1902,0.018164703584903238
STAT,1829,54,50-100,1883,0.020133963972590825
SIM,1858,36,40-44,1894,14
SIM,1931,5,na,1936,10645
SIM,1828,45,na,1873,3154
SIM,1824,31,na,1855,3727
SIM,1856,15,25-29,1871,15
STAT,1935,21,35-39,1956,25.909182307280087
SIM,1852,25,50-100,1877,2
STAT,1852,17,40-44,1869,0.35257364223185284
STAT,1902,45,20-24,1947,0.01949318138275444
SIM,1896,35,20-24,1931,4
STAT,1836,34,45-49,1870,2.871107676888734
STAT,1865,41,25-29,1906,1.1835681848756796
STAT,1892,26,25-29,1918,107.31753485893984
STAT,1856,32,20-24,1888,4.263572890682605
SIM,1891,28,25-29,1919,109
STAT,1857,38,45-49,1895,3.1225754812888553
SIM,1829,44,20-24,1873,1
SIM,1849,30,30-34,1879,43
STAT,1870,79,na,1949,1386.2049430792126
STAT,1928,35,na,1963,9617.748574131747
STAT,1802,52,40-44,1854,0.06748721872215506
SIM,1874,28,45-49,1902,2
SIM,1818,90,na,1908,95
STAT,1895,26,15-19,1921,1.1980748802323216
SIM,1923,1,na,1924,10154
STAT,1845,32,45-49,1877,3.1949948316076027
SIM,1833,35,25-29,1868,8
STAT,1947,18,na,1965,8370.593585361956
SIM,1824,37,25-29,1861,8
SIM,1873,41,25-29,1914,3
STAT,1830,29,20-24,1859,24.428027993091288
STAT,1828,35,15-19,1863,0.11781318407456322
SIM,1807,52,na,1859,2293
STAT,1928,1,na,1929,10625.610397831086
SIM,1863,31,50-100,1894,2
STAT,1883,20,15-19,1903,6.585223691252272
SIM,1836,29,15-19,1865,1
SIM,1853,32,45-49,1885,4
STAT,1825,35,25-29,1860,8.148267275038844
STAT,1853,27,20-24,1880,21.50269122525156
SIM,1897,16,25-29,1913,16
SIM,1829,26,20-24,1855,21
SIM,1917,31,35-39,1948,30
SIM,1815,71,na,1886,1220
SIM,1852,33,40-44,1885,9
STAT,1877,35,45-49,1912,4.220361205171823
SIM,1954,9,na,1963,9927
STAT,1872,46,15-19,1918,8.142006425985085E-4
STAT,1843,15,50-100,1858,0.08874508438619486
STAT,1836,41,35-39,1877,2.9017706696057974
STAT,1951,16,50-100,1967,0.9012196786319825
STAT,1839,54,30-34,1893,0.009038887455011146
SIM,1891,20,15-19,1911,8
STAT,1850,26,40-44,1876,5.444140804937316
STAT,1848,48,25-29,1896,0.0932604048427193
STAT,1869,36,15-19,1905,0.11041999378284878
STAT,1843,69,na,1912,2055.7607783525264
SIM,1855,34,20-24,1889,7
SIM,1932,15,25-29,1947,140
SIM,1834,62,na,1896,2409
SIM,1889,32,25-29,1921,33
STAT,1841,29,30-34,1870,44.73159696126673
SIM,1835,19,20-24,1854,26
STAT,1859,44,40-44,1903,3.5668816061287005
SIM,1911,37,50-100,1948,1
STAT,1825,34,35-39,1859,30.24352747193114
STAT,1902,47,15-19,1949,6.403587679508156E-4
SIM,1849,48,50-100,1897,1
SIM,1861,27,20-24,1888,23
SIM,1879,25,20-24,1904,24
SIM,1847,80,na,1927,909
SIM,1875,20,30-34,1895,53
STAT,1869,40,35-39,1909,3.5794098161387398
SIM,1818,44,45-49,1862,8
SIM,1946,5,na,1951,8720
STAT,1909,31,35-39,1940,17.693588465191834
STAT,1871,22,45-49,1893,1.3991862080624298
SIM,1847,29,40-44,1876,8
SIM,1927,39,na,1966,9660
SIM,1927,38,na,1965,9677
STAT,1759,111,na,1870,0.0010065923642044894
STAT,1860,58,na,1918,3243.4236816117946
SIM,1812,47,50-100,1859,2
SIM,1923,25,na,1948,9100
STAT,1851,88,na,1939,212.8146360095616
STAT,1924,15,25-29,1939,104.67814256651148
STAT,1849,54,25-29,1903,0.005448677866695142
STAT,1851,25,25-29,1876,77.893666122958
SIM,1856,33,25-29,1889,23
STAT,1844,33,40-44,1877,8.288412532846854
SIM,1833,28,35-39,1861,28
STAT,1839,47,40-44,1886,0.2723609761139887
STAT,1831,45,15-19,1876,6.280178286313894E-4
STAT,1851,43,25-29,1894,0.9882696886557871
SIM,1885,35,45-49,1920,4
SIM,1877,58,na,1935,3922
STAT,1889,16,25-29,1905,14.146131371252705
SIM,1844,41,35-39,1885,7
SIM,1865,38,25-29,1903,4
STAT,1857,50,na,1907,3438.218661043466
SIM,1870,6,na,1876,5398
STAT,1862,35,50-100,1897,2.1394586251183507
SIM,1838,44,na,1882,3271
STAT,1862,40,45-49,1902,2.6095706007455695
STAT,1892,25,35-39,1917,24.560852247949814
STAT,1810,53,30-34,1863,0.03605881724014701
STAT,1872,39,25-29,1911,5.7852056519756205
STAT,1912,37,30-34,1949,3.5935805689674423
SIM,1889,47,25-29,1936,1
SIM,1833,27,45-49,1860,4
STAT,1773,115,na,1888,3.548370983881638E-4
SIM,1896,17,20-24,1913,47
STAT,1882,29,40-44,1911,5.851340781784495
STAT,1892,19,35-39,1911,1.3798592757128332
STAT,1888,17,20-24,1905,42.31915908226925
SIM,1798,85,na,1883,139
STAT,1841,99,na,1940,2.747868248281225
STAT,1848,40,15-19,1888,0.02320319218760327
SIM,1794,92,na,1886,24
SIM,1853,8,na,1861,4942
STAT,1895,24,na,1919,6184.971253054314
SIM,1912,34,50-100,1946,4
STAT,1860,40,15-19,1900,0.022877803727595927
STAT,1915,17,25-29,1932,18.319081584123996
SIM,1899,37,40-44,1936,7
SIM,1917,49,na,1966,7871
STAT,1841,21,20-24,1862,127.57989273731776
STAT,1852,2,na,1854,5773.0
SIM,1913,35,na,1948,7720
STAT,1827,37,20-24,1864,1.6019486128462113
SIM,1938,29,50-100,1967,2
STAT,1831,38,25-29,1869,4.6586843790290535
STAT,1850,18,50-100,1868,0.09125205377531252
STAT,1892,18,45-49,1910,0.16472191622888643
STAT,1950,19,50-100,1969,0.8940219501474679
STAT,1852,35,40-44,1887,7.161967849826058
SIM,1921,13,na,1934,9161
SIM,1850,27,45-49,1877,4
STAT,1857,53,20-24,1910,0.001142979211896511
STAT,1932,17,25-29,1949,115.89909041180805
SIM,1901,28,50-100,1929,2
SIM,1948,18,40-44,1966,4
STAT,1826,77,na,1903,1034.768202921457
STAT,1834,96,na,1930,11.411134355955317
STAT,1814,97,na,1911,4.623510555139873
STAT,1858,8,na,1866,4516.254667653482
SIM,1825,38,50-100,1863,3
SIM,1903,37,30-34,1940,2
STAT,1889,34,25-29,1923,25.288093587047115
STAT,1853,16,45-49,1869,0.12506399514160066
SIM,1893,47,50-100,1940,1
STAT,1839,29,40-44,1868,5.808109833738571
STAT,1872,43,45-49,1915,3.0158468720526654
STAT,1841,35,30-34,1876,9.301996688654535
STAT,1893,18,40-44,1911,0.46698281529157026
SIM,1880,43,45-49,1923,7
SIM,1890,13,na,1903,6844
STAT,1877,28,20-24,1905,24.51610778338504
SIM,1838,17,30-34,1855,4
STAT,1803,51,45-49,1854,0.10878540706124452
SIM,1920,37,30-34,1957,8
STAT,1856,39,40-44,1895,6.752531085886383
STAT,1891,10,na,1901,6466.443456853504
STAT,1898,31,15-19,1929,0.3908032355236069
STAT,1844,32,na,1876,4185.3275307241065
STAT,1821,49,20-24,1870,0.03412259648991741
SIM,1844,51,na,1895,3083
SIM,1894,27,na,1921,6419
STAT,1810,46,40-44,1856,1.1384941787400702
STAT,1762,94,na,1856,8.9943444576
SIM,1856,44,30-34,1900,3
SIM,1880,14,na,1894,5767
SIM,1928,20,35-39,1948,33
STAT,1811,50,40-44,1861,0.07096379607481766
STAT,1870,23,40-44,1893,4.119065585224641
STAT,1899,37,na,1936,6570.757705305671
SIM,1919,16,20-24,1935,312
SIM,1923,17,25-29,1940,120
STAT,1873,40,20-24,1913,0.32918163482990903
SIM,1835,37,20-24,1872,1
STAT,1889,48,35-39,1937,0.19418680787938622
STAT,1861,15,40-44,1876,0.3575915479517424
STAT,1862,24,45-49,1886,1.2146007242602075
STAT,1902,11,na,1913,7374.615667508746
STAT,1842,27,25-29,1869,77.88290699678255
STAT,1917,15,35-39,1932,1.8319863118459088
SIM,1912,35,30-34,1947,6
STAT,1851,18,35-39,1869,1.0280818613614338
STAT,1893,7,na,1900,6669.394101466657
STAT,1894,28,20-24,1922,30.32890499639924
SIM,1866,94,na,1960,50
STAT,1861,98,na,1959,9.964613362485576
SIM,1826,66,na,1892,1852
SIM,1841,29,45-49,1870,1
STAT,1895,23,na,1918,6204.7022060696145
STAT,1898,46,35-39,1944,0.21644927275320022
SIM,1840,42,25-29,1882,4
STAT,1884,83,na,1967,1404.5250280178163
SIM,1834,27,40-44,1861,8
SIM,1860,45,35-39,1905,1
SIM,1862,80,na,1942,1119
SIM,1792,89,na,1881,47
STAT,1883,46,25-29,1929,0.11461864765137614
STAT,1889,49,25-29,1938,0.07922129266861547
SIM,1865,35,20-24,1900,3
STAT,1851,24,35-39,1875,10.648189060998533
STAT,1939,33,15-19,1972,0.26466933307290225
SIM,1897,34,25-29,1931,30
SIM,1820,41,45-49,1861,4
STAT,1833,29,45-49,1862,1.9011478667434765
STAT,1842,27,45-49,1869,2.044225300945173
STAT,1904,35,30-34,1939,3.36621217717341
STAT,1874,15,50-100,1889,0.10216158498595634
SIM,1841,36,35-39,1877,16
SIM,1868,25,45-49,1893,4
SIM,1881,24,20-24,1905,117
STAT,1876,64,na,1940,3631.1868895919947
STAT,1872,50,na,1922,4433.175766466612
SIM,1929,38,25-29,1967,6
STAT,1805,101,na,1906,0.4268317951381675
STAT,1897,33,20-24,1930,7.266496144008416
STAT,1906,24,na,1930,6916.633991270554
SIM,1849,39,na,1888,3845
STAT,1930,25,30-34,1955,100.70875796616929
STAT,1909,21,na,1930,7188.646873428168
SIM,1839,48,45-49,1887,2
SIM,1889,39,45-49,1928,9
STAT,1847,49,40-44,1896,0.25551852340566883
STAT,1902,10,na,1912,7385.916119171078
STAT,1877,51,45-49,1928,0.03058044724699374
STAT,1833,22,25-29,1855,104.67009542502258
STAT,1879,61,na,1940,3947.44987900381
SIM,1811,51,45-49,1862,1
SIM,1861,42,45-49,1903,5
STAT,1919,7,na,1926,8919.539288324138
STAT,1870,42,45-49,1912,2.9639253538300534
SIM,1848,45,35-39,1893,1
SIM,1916,54,na,1970,7513
STAT,1832,42,25-29,1874,1.0241859522453132
STAT,1897,47,30-34,1944,0.14672202441793517
SIM,1912,40,na,1952,7525
SIM,1815,39,45-49,1854,8
SIM,1885,28,20-24,1913,21
STAT,1936,5,na,1941,7776.024529987163
SIM,1850,27,25-29,1877,87
SIM,1870,24,45-49,1894,3
SIM,1925,15,35-39,1940,11
STAT,1832,23,20-24,1855,135.47503247836033
STAT,1802,54,35-39,1856,0.05299524393208369
SIM,1874,32,30-34,1906,44
STAT,1889,41,15-19,1930,0.034545296581721785
STAT,1910,39,20-24,1949,0.5042371298221913
SIM,1873,32,na,1905,5033
STAT,1851,17,45-49,1868,0.12311582732800239
STAT,1852,42,30-34,1894,1.8300970673710577
STAT,1883,26,50-100,1909,1.2736805617169207
STAT,1868,38,20-24,1906,1.4738596961890977
STAT,1922,10,na,1932,9286.663886393422
STAT,1833,36,35-39,1869,11.769107992992458
SIM,1810,47,45-49,1857,1
SIM,1905,21,15-19,1926,9
STAT,1926,24,na,1950,8902.434589916242
SIM,1840,23,20-24,1863,126
SIM,1848,31,25-29,1879,26
STAT,1949,16,40-44,1965,3.2861164106570633
STAT,1859,61,na,1920,3003.8114722881796
SIM,1859,42,40-44,1901,8
SIM,1767,90,na,1857,41
STAT,1867,28,na,1895,4498.039732301291
STAT,1942,6,na,1948,8398.2447822997
SIM,1818,37,20-24,1855,2
SIM,1846,63,na,1909,2774
STAT,1833,37,25-29,1870,4.741210397414636
SIM,1841,22,25-29,1863,108
SIM,1862,81,na,1943,950
SIM,1848,39,35-39,1887,22
SIM,1908,35,na,1943,7203
SIM,1858,44,na,1902,3908
SIM,1904,21,na,1925,6980
STAT,1842,45,25-29,1887,0.08799616014136492
SIM,1860,35,40-44,1895,12
STAT,1867,80,na,1947,1170.0282406571926
STAT,1831,42,45-49,1873,2.3698490430666572
STAT,1897,15,20-24,1912,48.08305438064932
SIM,1893,32,na,1925,6239
STAT,1790,89,na,1879,69.4120433159153
STAT,1853,34,45-49,1887,2.782881273912128
SIM,1838,49,40-44,1887,1
SIM,1940,17,25-29,1957,133
STAT,1865,19,40-44,1884,0.3417602586453542
STAT,1898,39,45-49,1937,1.1641479221558697
SIM,1888,15,20-24,1903,40
STAT,1892,48,40-44,1940,0.2410923266622519
STAT,1907,10,na,1917,7689.026259724423
STAT,1895,49,20-24,1944,0.017441573737185908
STAT,1848,44,30-34,1892,1.8596737571760702
STAT,1858,30,30-34,1888,28.065742374470716
STAT,1879,27,20-24,1906,24.78242236386621
STAT,1850,19,30-34,1869,2.9512482426286764
STAT,1866,21,25-29,1887,108.32482957809545
SIM,1939,20,30-34,1959,80
STAT,1860,44,30-34,1904,1.8600997334658504
STAT,1855,47,na,1902,3376.7957180343847
SIM,1831,34,na,1865,3832
SIM,1864,35,25-29,1899,7
STAT,1890,79,na,1969,2591.420731364346
SIM,1838,27,25-29,1865,75
STAT,1920,39,na,1959,8299.537791403336
STAT,1878,75,na,1953,2171.445059567525
STAT,1885,3,na,1888,5919.369132557337
SIM,1824,34,20-24,1858,4
STAT,1889,38,40-44,1927,10.846932351475159
SIM,1853,22,50-100,1875,1
SIM,1844,31,40-44,1875,11
STAT,1828,32,45-49,1860,3.9090120403993307
STAT,1856,35,25-29,1891,4.52907775373448
SIM,1790,78,na,1868,656
STAT,1820,40,40-44,1860,9.617326717413656
SIM,1895,18,15-19,1913,20
STAT,1823,43,15-19,1866,0.044832721321928795
SIM,1903,36,na,1939,7023
STAT,1812,85,na,1897,259.8537674862041
SIM,1869,91,na,1960,169
SIM,1819,85,na,1904,183
SIM,1891,25,20-24,1916,28
STAT,1897,18,25-29,1915,15.258056573070792
STAT,1887,18,15-19,1905,13.369798921486677
STAT,1847,53,25-29,1900,0.0053125478620476615
SIM,1833,31,30-34,1864,40
SIM,1883,19,35-39,1902,2
SIM,1886,39,na,1925,4867
SIM,1882,25,na,1907,4997
SIM,1882,37,35-39,1919,27
STAT,1839,51,25-29,1890,0.005557061141497016
STAT,1840,18,na,1858,4264.598073260742
SIM,1872,37,25-29,1909,8
SIM,1919,20,na,1939,8177
SIM,1887,27,20-24,1914,34
SIM,1902,20,35-39,1922,21
STAT,1834,43,25-29,1877,1.0173790958157523
SIM,1825,32,35-39,1857,19
STAT,1883,25,20-24,1908,23.436334790492356
STAT,1892,22,30-34,1914,45.03472238692076
SIM,1907,24,30-34,1931,75
STAT,1860,33,25-29,1893,16.7278289370603
STAT,1895,23,45-49,1918,1.8294223168765147
STAT,1855,58,na,1913,2982.08722943081
STAT,1936,23,na,1959,7050.175006351137
STAT,1861,29,20-24,1890,19.57972079491662
STAT,1919,46,30-34,1965,0.19572306295901562
STAT,1911,46,25-29,1957,0.10170333470586389
STAT,1884,23,35-39,1907,11.601565632679998
STAT,1836,31,40-44,1867,7.3660912664543945
SIM,1892,23,35-39,1915,20
SIM,1903,9,na,1912,7682
STAT,1899,39,40-44,1938,2.5882046144363096
SIM,1818,41,40-44,1859,2
SIM,1874,21,25-29,1895,127
STAT,1870,30,30-34,1900,34.89788073678376
STAT,1822,53,20-24,1875,0.002163794459375461
STAT,1866,10,na,1876,5080.554079811185
STAT,1864,37,25-29,1901,5.197841993379359
STAT,1933,30,15-19,1963,0.35018307194014375
SIM,1890,36,30-34,1926,21
SIM,1903,25,na,1928,7067
SIM,1833,38,50-100,1871,4
SIM,1880,36,20-24,1916,5
STAT,1884,50,25-29,1934,0.0071652405048977415
STAT,1819,96,na,1915,8.9848782310033
STAT,1893,36,40-44,1929,11.259807842540317
SIM,1870,35,50-100,1905,3
STAT,1874,37,35-39,1911,14.62619906555183
SIM,1939,28,40-44,1967,12
STAT,1836,44,na,1880,3241.271113963886
STAT,1832,30,na,1862,3726.7082418063746
STAT,1806,78,na,1884,638.2452954670256
STAT,1825,31,30-34,1856,68.66130054004387
STAT,1925,32,30-34,1957,37.77767193675362
SIM,1846,26,20-24,1872,25
SIM,1875,42,25-29,1917,4
SIM,1864,17,25-29,1881,14
SIM,1885,42,35-39,1927,7
SIM,1877,79,na,1956,1268
SIM,1842,43,25-29,1885,2
STAT,1872,18,20-24,1890,35.89003945119741
STAT,1872,36,20-24,1908,1.5721538301048101
STAT,1850,59,na,1909,2979.8548194745613
STAT,1855,52,20-24,1907,0.0011068103566087384
STAT,1882,36,30-34,1918,10.535860387349775
STAT,1884,49,45-49,1933,0.4608210635602258
SIM,1860,14,na,1874,4791
STAT,1839,39,50-100,1878,2.243792544860192
STAT,1883,43,20-24,1926,0.31285205280969725
STAT,1895,43,50-100,1938,0.1916675328818623
STAT,1846,43,na,1889,3537.3927136814295
STAT,1886,36,15-19,1922,0.1202945113353057
SIM,1880,18,20-24,1898,47
STAT,1893,43,30-34,1936,0.2028923712472434
STAT,1850,29,45-49,1879,1.9747124928725106
SIM,1885,32,40-44,1917,16
STAT,1802,64,na,1866,1847.607802396852
SIM,1875,46,40-44,1921,1
STAT,1826,45,40-44,1871,0.3507947564739752
STAT,1880,6,na,1886,5688.065260807237
SIM,1917,0,na,1917,9311
SIM,1896,38,na,1934,6559
SIM,1888,33,20-24,1921,8
SIM,1856,37,40-44,1893,13
STAT,1899,36,50-100,1935,3.4136860262511273
STAT,1917,20,na,1937,7884.616195399531
SIM,1854,17,15-19,1871,11
SIM,1892,49,45-49,1941,1
SIM,1939,19,na,1958,7612
STAT,1866,29,35-39,1895,17.85207189538038
STAT,1849,62,na,1911,2891.1019194453024
SIM,1778,85,na,1863,145
SIM,1882,27,50-100,1909,2
STAT,1867,46,40-44,1913,0.3247312531639328
STAT,1877,32,40-44,1909,9.094780583668937
STAT,1836,50,45-49,1886,0.020316921102845942
SIM,1803,90,na,1893,66
SIM,1889,31,50-100,1920,3
SIM,1889,43,30-34,1932,2
SIM,1886,83,na,1969,1320
STAT,1856,17,25-29,1873,10.441018201758203
STAT,1864,44,15-19,1908,0.024594494549002924
STAT,1816,52,20-24,1868,0.003478083804712124
SIM,1866,30,30-34,1896,50
SIM,1773,86,na,1859,127
SIM,1832,29,30-34,1861,53
SIM,1920,28,na,1948,8424
STAT,1846,17,15-19,1863,11.418882872007448
STAT,1858,38,40-44,1896,6.857836217972171
STAT,1826,52,30-34,1878,0.011448351600730352
STAT,1873,76,na,1949,1944.1254693505182
SIM,1846,44,20-24,1890,1
STAT,1819,45,15-19,1864,0.0017298969390190124
SIM,1852,59,na,1911,3111
SIM,1842,25,25-29,1867,89
SIM,1933,32,30-34,1965,59
STAT,1826,108,na,1934,0.0021927655713301296
STAT,1851,47,40-44,1898,0.2641539969944533
STAT,1907,40,50-100,1947,0.2199628872353304
STAT,1865,16,50-100,1881,0.09317971089387547
SIM,1806,67,na,1873,1603
STAT,1906,57,na,1963,6235.974988935845
STAT,1844,15,40-44,1859,0.3799317899826378
STAT,1853,24,50-100,1877,0.7514308537923863
STAT,1873,43,25-29,1916,1.3082231960235273
SIM,1802,53,na,1855,2406
SIM,1875,28,40-44,1903,10
SIM,1881,43,25-29,1924,3
SIM,1929,18,50-100,1947,1
SIM,1852,15,40-44,1867,1
STAT,1861,41,40-44,1902,3.7981599310624694
SIM,1849,51,na,1900,3541
SIM,1873,65,na,1938,3411
STAT,1806,52,25-29,1858,0.02066852034171163
STAT,1823,70,na,1893,1683.6910709223764
STAT,1859,51,30-34,1910,0.009614441329668497
STAT,1838,44,20-24,1882,0.22295568983360362
SIM,1847,39,50-100,1886,4
STAT,1834,25,25-29,1859,74.90858200753235
STAT,1850,30,25-29,1880,18.43232273018182
STAT,1931,24,na,1955,9505.991715537604
STAT,1851,51,25-29,1902,0.005517038058943454
STAT,1854,22,45-49,1876,1.2560199227308346
SIM,1926,37,50-100,1963,3
STAT,1802,102,na,1904,0.2250067409187846
SIM,1890,29,40-44,1919,9
STAT,1824,40,25-29,1864,1.7523656855366152
STAT,1828,44,50-100,1872,1.926145659895747
STAT,1851,21,30-34,1872,33.212930855268226
STAT,1846,28,20-24,1874,21.582174222987547
SIM,1836,44,50-100,1880,4
STAT,1850,109,na,1959,0.00239738476915559
STAT,1860,26,50-100,1886,1.0680584592624667
SIM,1908,27,50-100,1935,2
SIM,1887,24,na,1911,5804
STAT,1848,23,50-100,1871,0.8083125577018354
SIM,1843,39,20-24,1882,2
SIM,1893,41,30-34,1934,5
STAT,1881,42,20-24,1923,0.30963426544958456
STAT,1808,50,50-100,1858,0.09337865288281964
SIM,1863,43,45-49,1906,4
STAT,1867,53,30-34,1920,0.011078026451960583
STAT,1899,34,35-39,1933,27.78307420276487
STAT,1863,54,20-24,1917,0.001268693412170185
STAT,1829,107,na,1936,0.0055813741899947795
SIM,1823,38,40-44,1861,12
STAT,1891,31,25-29,1922,25.673947016619334
STAT,1846,53,45-49,1899,0.02187188990045866
STAT,1883,18,30-34,1901,3.1543864978560605
SIM,1874,25,40-44,1899,4
SIM,1909,10,na,1919,7907
STAT,1854,19,15-19,1873,10.755066267451214
STAT,1900,40,na,1940,6563.151511738117
SIM,1856,47,35-39,1903,1
SIM,1862,19,15-19,1881,10
STAT,1885,41,30-34,1926,2.3216311709967465
SIM,1857,58,na,1915,3507
STAT,1866,25,40-44,1891,5.620043874020995
STAT,1831,35,20-24,1866,1.2877363298248217
SIM,1867,44,40-44,1911,10
SIM,1864,42,50-100,1906,4
SIM,1838,99,na,1937,2
STAT,1877,42,35-39,1919,3.792887552492792
SIM,1834,85,na,1919,271
SIM,1891,18,30-34,1909,7
STAT,1875,24,na,1899,4886.981464600534
STAT,1883,40,30-34,1923,2.3042747607144025
STAT,1871,65,na,1936,3390.935165846265
STAT,1904,38,35-39,1942,4.403347626010331
STAT,1943,20,30-34,1963,61.79803459121786
STAT,1879,48,25-29,1927,0.12014978383530645
STAT,1894,46,50-100,1940,0.36044523285505115
SIM,1854,28,20-24,1882,27
STAT,1930,7,na,1937,10437.111763154628
SIM,1846,19,30-34,1865,5
SIM,1859,101,na,1960,2
STAT,1838,26,20-24,1864,20.342876644292673
STAT,1847,50,20-24,1897,0.0011410058349855192
STAT,1889,45,30-34,1934,0.24345775075360881
SIM,1839,29,na,1868,3802
STAT,1907,15,25-29,1922,16.899055906765582
STAT,1861,18,45-49,1879,0.12546784414494475
SIM,1870,31,35-39,1901,33
STAT,1811,53,45-49,1864,0.09210659309786355
STAT,1893,32,25-29,1925,26.219817993696385
STAT,1902,27,50-100,1929,1.8239844395130427
STAT,1941,31,50-100,1972,1.7542582286218178
STAT,1810,49,45-49,1859,1.4812755471583865
STAT,1869,33,45-49,1902,3.398153610081555
STAT,1898,36,20-24,1934,2.116937768949028
SIM,1808,78,na,1886,609
SIM,1922,39,na,1961,9038
STAT,1939,28,50-100,1967,2.020144597109231
STAT,1871,10,na,1881,5364.1393138817475
STAT,1871,25,15-19,1896,0.9165371475693895
STAT,1874,27,40-44,1901,6.194570958304417
SIM,1867,80,na,1947,1153
SIM,1879,28,25-29,1907,99
SIM,1948,21,15-19,1969,11
STAT,1841,24,25-29,1865,103.71415117591754
SIM,1848,42,30-34,1890,6
SIM,1882,27,40-44,1909,8
SIM,1836,33,na,1869,3474
SIM,1877,33,45-49,1910,4
STAT,1815,45,30-34,1860,0.5368538327365214
SIM,1824,52,na,1876,2936
STAT,1930,28,35-39,1958,38.536423416170365
SIM,1815,53,50-100,1868,1
STAT,1945,15,45-49,1960,1.1025773084519443
SIM,1951,20,30-34,1971,81
STAT,1854,21,50-100,1875,0.7398265573653859
SIM,1831,36,25-29,1867,11
SIM,1883,26,25-29,1909,95
STAT,1848,15,25-29,1863,11.655428554654437
STAT,1939,22,30-34,1961,58.301611016795675
SIM,1850,17,30-34,1867,5
SIM,1937,32,15-19,1969,2
STAT,1838,19,30-34,1857,2.8158894744730625
SIM,1852,70,na,1922,2257
SIM,1859,6,na,1865,5149
STAT,1926,9,na,1935,9855.574492941938
SIM,1874,35,35-39,1909,12
STAT,1885,16,40-44,1901,0.3685923708428461
STAT,1773,89,na,1862,65.69684887002173
SIM,1941,30,15-19,1971,4
STAT,1807,53,50-100,1860,0.09640091805176511
SIM,1885,33,50-100,1918,3
SIM,1912,38,35-39,1950,9
STAT,1856,42,15-19,1898,0.021492482747188554
SIM,1864,39,40-44,1903,4
STAT,1828,29,15-19,1857,1.1548147938100102
STAT,1843,22,35-39,1865,10.260600048226399
STAT,1866,35,35-39,1901,13.30542011829305
STAT,1819,45,50-100,1864,1.0621576128133159
STAT,1897,43,15-19,1940,0.002570208728095467
STAT,1877,33,50-100,1910,1.9134030979618697
STAT,1920,39,30-34,1959,4.02065267075362
SIM,1947,22,30-34,1969,84
SIM,1936,20,na,1956,6269
STAT,1929,32,15-19,1961,0.32962855932594265
STAT,1833,26,40-44,1859,5.2488771763305815
STAT,1850,70,na,1920,2151.2912571983447
STAT,1864,34,20-24,1898,4.838078214699201
SIM,1841,26,40-44,1867,10
SIM,1841,33,30-34,1874,12
STAT,1879,2,na,1881,6823.1096507616085
STAT,1818,50,30-34,1868,0.026190340654148585
STAT,1791,74,na,1865,906.81657934987
STAT,1890,27,25-29,1917,104.27959866203973
SIM,1909,7,na,1916,7944
STAT,1795,88,na,1883,100.89901358558565
SIM,1852,40,30-34,1892,3
SIM,1915,15,25-29,1930,31
SIM,1910,27,50-100,1937,1
STAT,1887,47,20-24,1934,0.026979145818730867
STAT,1907,40,15-19,1947,0.0028753320693960123
SIM,1864,46,30-34,1910,1
STAT,1949,19,45-49,1968,1.1724981379078374
STAT,1875,26,25-29,1901,88.26138002409836
STAT,1845,35,15-19,1880,0.10200519649067406
STAT,1814,51,20-24,1865,0.0037383234352623656
STAT,1844,25,50-100,1869,1.2829828962791863
STAT,1890,34,15-19,1924,0.34805151132628864
SIM,1893,34,40-44,1927,17
STAT,1842,42,20-24,1884,0.2446260688802055
SIM,1848,35,40-44,1883,15
SIM,1868,65,na,1933,3357
STAT,1842,29,na,1871,3925.8983719058733
STAT,1852,108,na,1960,0.008529195802263998
SIM,1879,18,30-34,1897,7
STAT,1787,70,na,1857,1242.0016467724558
STAT,1910,49,15-19,1959,6.903083937903751E-4
STAT,1823,36,25-29,1859,11.580979245540398
SIM,1836,32,45-49,1868,7
SIM,1915,22,15-19,1937,8
STAT,1835,39,20-24,1874,1.2094556375392767
SIM,1864,51,na,1915,4123
STAT,1808,53,25-29,1861,0.02059470878440406
STAT,1889,82,na,1971,2090.895186522998
STAT,1917,30,30-34,1947,33.58491812873036
STAT,1919,18,20-24,1937,301.7273011252276
SIM,1859,45,45-49,1904,1
STAT,1833,33,30-34,1866,29.30782053829583
SIM,1821,47,20-24,1868,1
SIM,1860,31,25-29,1891,25
STAT,1866,43,na,1909,4275.835991531477
STAT,1766,102,na,1868,0.09697469815296819
STAT,1901,25,na,1926,6793.359628471119
STAT,1844,52,45-49,1896,0.02331153752147423
STAT,1856,46,30-34,1902,0.1512655174002774
STAT,1813,47,20-24,1860,0.07403972860679331
SIM,1858,39,45-49,1897,7
SIM,1851,22,35-39,1873,16
STAT,1875,44,25-29,1919,1.3172465980428905
STAT,1818,70,na,1888,1566.0952015339349
STAT,1842,24,20-24,1866,127.55459393611504
STAT,1862,21,40-44,1883,3.7089139598758227
SIM,1895,29,20-24,1924,32
SIM,1797,88,na,1885,64
SIM,1850,24,20-24,1874,125
SIM,1892,79,na,1971,2901
SIM,1883,44,25-29,1927,4
SIM,1826,43,40-44,1869,7
STAT,1887,29,20-24,1916,26.309523517285204
STAT,1907,22,15-19,1929,9.792698814243213
STAT,1832,85,na,1917,357.393955237767
SIM,1915,8,na,1923,8476
SIM,1872,16,20-24,1888,39
SIM,1927,18,20-24,1945,2
STAT,1874,23,25-29,1897,118.01325690963743
SIM,1870,21,40-44,1891,5
STAT,1857,50,30-34,1907,0.009505142969527916
STAT,1880,38,20-24,1918,1.631902705979297
STAT,1818,43,40-44,1861,10.679936836328606
STAT,1843,48,45-49,1891,0.32643906939347406
SIM,1869,28,15-19,1897,1
STAT,1864,16,20-24,1880,36.59904716647248
STAT,1895,30,35-39,1925,26.86491837191786
STAT,1897,36,25-29,1933,7.810212327539795
STAT,1910,21,30-34,1931,54.69569042514358
SIM,1859,24,40-44,1883,2
STAT,1818,48,na,1866,2839.5825597088733
STAT,1824,66,na,1890,1752.3247036946238
STAT,1860,80,na,1940,1014.5491571832897
SIM,1890,37,40-44,1927,15
STAT,1934,33,35-39,1967,25.18679960430695
STAT,1879,52,45-49,1931,0.03049393881527093
STAT,1909,49,25-29,1958,0.09791820147552864
STAT,1824,44,40-44,1868,5.56864645284539
STAT,1916,42,30-34,1958,0.26459505603574823
SIM,1893,38,20-24,1931,3
STAT,1807,47,45-49,1854,1.6248713470024065
STAT,1834,40,20-24,1874,0.26146880484156493
STAT,1858,76,na,1934,1491.609673980167
STAT,1826,67,na,1893,1897.672270646534
STAT,1862,81,na,1943,933.4683595086307
SIM,1892,16,25-29,1908,23
SIM,1920,33,15-19,1953,2
STAT,1891,37,35-39,1928,17.65671451635314
SIM,1851,64,na,1915,2652
STAT,1915,38,na,1953,7638.2939072820645
STAT,1921,31,15-19,1952,0.2899270069051424
SIM,1857,79,na,1936,1097
STAT,1885,78,na,1963,2067.7727243983313
STAT,1857,35,20-24,1892,1.2249924067163547
STAT,1841,43,30-34,1884,1.7112866058970917
SIM,1832,44,40-44,1876,11
STAT,1906,48,45-49,1954,0.38685281327328014
STAT,1885,38,20-24,1923,1.5419483865340649
SIM,1850,41,50-100,1891,4
STAT,1923,45,40-44,1968,0.3741275294876887
STAT,1858,33,50-100,1891,1.4364662108280077
STAT,1807,84,na,1891,265.5342327636765
STAT,1913,47,50-100,1960,0.44596585619550483
STAT,1850,41,30-34,1891,1.7707275750481037
STAT,1922,25,50-100,1947,2.2895071557191304
STAT,1873,46,30-34,1919,0.1992030058892814
STAT,1824,46,35-39,1870,0.34385917230023316
SIM,1839,38,30-34,1877,4
SIM,1855,49,40-44,1904,1
STAT,1874,38,45-49,1912,4.1019137762315605
STAT,1912,33,15-19,1945,0.2543666735914115
SIM,1857,29,35-39,1886,14
STAT,1884,16,25-29,1900,11.328744635039417
STAT,1933,31,50-100,1964,2.2518253698882447
SIM,1791,94,na,1885,2
SIM,1809,95,na,1904,25
SIM,1839,30,na,1869,3666
SIM,1783,75,na,1858,851
SIM,1841,19,30-34,1860,7
STAT,1842,17,30-34,1859,3.0472127478290845
STAT,1847,39,na,1886,3649.5640220510104
STAT,1882,37,40-44,1919,8.612284482855578
STAT,1836,45,15-19,1881,5.711509920645852E-4
SIM,1823,46,40-44,1869,2
STAT,1900,0,na,1900,8226.512331913975
STAT,1846,20,45-49,1866,1.3370107716468675
STAT,1815,46,40-44,1861,0.934609264940272
STAT,1891,35,40-44,1926,11.031703419285662
STAT,1892,18,50-100,1910,0.12354143717166481
SIM,1891,29,na,1920,6115
SIM,1881,39,40-44,1920,12
STAT,1869,15,45-49,1884,0.1311426621985762
STAT,1914,21,15-19,1935,10.573476647294369
STAT,1827,84,na,1911,402.2677720255172
STAT,1841,34,na,1875,3736.839298387779
SIM,1781,102,na,1883,1
SIM,1922,21,15-19,1943,13
STAT,1907,19,na,1926,7456.709807521824
SIM,1888,31,na,1919,5600
SIM,1854,20,45-49,1874,3
STAT,1923,4,na,1927,9568.820244074795
SIM,1900,33,45-49,1933,10
STAT,1770,116,na,1886,1.9976527981208176E-4
STAT,1859,48,20-24,1907,0.019047493053278988
SIM,1836,97,na,1933,5
SIM,1841,44,35-39,1885,7
STAT,1848,52,30-34,1900,0.009708478695366318
SIM,1853,99,na,1952,2
SIM,1926,23,50-100,1949,6
STAT,1914,47,40-44,1961,0.31584841356290944
SIM,1891,40,30-34,1931,5
STAT,1833,37,45-49,1870,3.2826997647084615
STAT,1823,40,45-49,1863,5.239781543543975
STAT,1826,41,25-29,1867,1.3844926816624457
SIM,1923,46,45-49,1969,1
STAT,1847,39,50-100,1886,1.9018545159672446
STAT,1879,19,20-24,1898,37.25027418622876
STAT,1882,44,30-34,1926,2.2313226851321897
STAT,1832,45,30-34,1877,0.15307876933033956
SIM,1874,43,35-39,1917,5
STAT,1860,30,20-24,1890,4.468875260271622
STAT,1911,58,na,1969,6665.288513019099
STAT,1850,34,40-44,1884,6.812926627177736
STAT,1784,72,na,1856,868.683464145
STAT,1792,91,na,1883,37.77538998230973
SIM,1900,15,30-34,1915,3
STAT,1932,38,45-49,1970,1.8481585453451341
STAT,1937,16,15-19,1953,89.40404182427504
STAT,1958,8,na,1966,10423.063986771684
SIM,1945,16,15-19,1961,100
STAT,1769,95,na,1864,3.223792960539863
STAT,1856,47,40-44,1903,0.2655263382240816
SIM,1828,30,45-49,1858,4
STAT,1866,43,35-39,1909,3.350038739273996
STAT,1832,51,na,1883,2961.5388880126047
SIM,1922,47,40-44,1969,1
STAT,1833,44,35-39,1877,2.816387055850097
STAT,1851,17,25-29,1868,10.680300176290414
SIM,1774,92,na,1866,10
SIM,1852,37,20-24,1889,2
STAT,1809,49,20-24,1858,0.08970755626560437
STAT,1892,26,na,1918,6054.543457709009
STAT,1911,19,50-100,1930,0.15064710863763084
SIM,1871,32,50-100,1903,3
STAT,1841,14,na,1855,4426.81062
SIM,1867,89,na,1956,175
SIM,1890,44,30-34,1934,5
SIM,1907,27,35-39,1934,38
STAT,1948,20,30-34,1968,66.68980463984636
SIM,1834,41,25-29,1875,2
STAT,1917,29,na,1946,7877.011806393857
STAT,1904,22,50-100,1926,1.182078253545422
SIM,1895,21,45-49,1916,3
STAT,1915,46,45-49,1961,0.4434402145362819
SIM,1867,40,25-29,1907,1
STAT,1865,47,35-39,1912,0.25567601586596256
STAT,1898,29,30-34,1927,68.33244079555998
STAT,1933,19,35-39,1952,11.284845429756865
STAT,1880,49,25-29,1929,0.119989491552031
STAT,1902,37,20-24,1939,0.4744097127770166
SIM,1781,74,na,1855,796
STAT,1815,53,30-34,1868,0.030036706153622396
SIM,1829,40,50-100,1869,5
STAT,1926,46,20-24,1972,0.02760284158437
STAT,1886,32,50-100,1918,1.953382897156975
STAT,1877,59,na,1936,4075.751783121325
SIM,1919,19,25-29,1938,128
STAT,1900,34,35-39,1934,28.129324672631697
SIM,1848,38,25-29,1886,6
SIM,1841,37,45-49,1878,4
STAT,1816,47,na,1863,2924.531570768934
STAT,1794,72,na,1866,1131.6650915916346
STAT,1872,40,40-44,1912,4.611513290606509
STAT,1887,21,45-49,1908,1.5798602389630527
SIM,1800,72,na,1872,1126
SIM,1873,47,35-39,1920,1
SIM,1941,19,35-39,1960,12
STAT,1822,43,50-100,1865,3.460768144704828
STAT,1888,11,na,1899,6173.816459559784
SIM,1920,26,25-29,1946,174
STAT,1809,65,na,1874,1846.3541866580706
STAT,1928,18,15-19,1946,115.17055222075315
STAT,1860,15,25-29,1875,10.846242730177336
STAT,1875,78,na,1953,1624.6653909246952
STAT,1881,45,25-29,1926,0.11356085787527648
SIM,1863,40,40-44,1903,5
STAT,1848,38,50-100,1886,2.0531486252175233
STAT,1923,36,50-100,1959,0.9830842847216945
SIM,1882,46,na,1928,4664
STAT,1912,26,25-29,1938,131.48374525435617
STAT,1891,42,30-34,1933,2.8664777384085496
STAT,1843,15,25-29,1858,10.264850165739869
SIM,1880,40,40-44,1920,7
STAT,1830,24,15-19,1854,17.617200812205834
SIM,1875,13,na,1888,5824
STAT,1844,37,20-24,1881,1.3154691607302618
STAT,1907,26,30-34,1933,75.0055227167985
STAT,1889,49,45-49,1938,0.3245872436179375
STAT,1874,42,30-34,1916,2.374488978688864
STAT,1864,62,na,1926,3299.6203742808466
SIM,1840,38,40-44,1878,15
SIM,1842,81,na,1923,714
STAT,1854,47,50-100,1901,0.3747464051081954
STAT,1814,54,25-29,1868,0.016899883262557328
STAT,1840,47,30-34,1887,0.14090153746270725
SIM,1799,70,na,1869,1203
SIM,1829,30,na,1859,3599
SIM,1879,17,20-24,1896,41
SIM,1882,42,30-34,1924,5
SIM,1888,41,na,1929,5480
STAT,1877,46,15-19,1923,8.412442620927752E-4
STAT,1945,18,15-19,1963,100.08404894753538
STAT,1854,35,50-100,1889,1.9109124826225123
STAT,1915,40,50-100,1955,0.23955419922440369
SIM,1856,45,40-44,1901,1
SIM,1858,45,50-100,1903,1
STAT,1794,62,na,1856,1843.28516616
SIM,1836,87,na,1923,167
SIM,1851,15,25-29,1866,13
STAT,1875,41,20-24,1916,0.33172233197935075
SIM,1791,74,na,1865,740
SIM,1877,30,40-44,1907,16
SIM,1916,43,35-39,1959,2
STAT,1867,42,25-29,1909,1.2130962486911274
STAT,1865,45,40-44,1910,0.3172513220996399
STAT,1906,8,na,1914,7650.319535648392
SIM,1936,18,15-19,1954,70
STAT,1837,84,na,1921,463.6511606287413
SIM,1842,17,25-29,1859,15
STAT,1929,40,15-19,1969,0.004027295497618819
SIM,1878,36,45-49,1914,6
STAT,1841,39,45-49,1880,3.3377848719866643
STAT,1846,16,50-100,1862,0.09482556075867127
SIM,1953,18,15-19,1971,107
STAT,1856,54,30-34,1910,0.009020408458383183
SIM,1898,37,25-29,1935,3
STAT,1843,15,na,1858,4158.020187849953
STAT,1851,34,na,1885,3771.088095825354
STAT,1828,48,na,1876,3022.8142077112943
STAT,1824,32,na,1856,3085.4437473883827
STAT,1865,53,50-100,1918,0.02726576958620987
SIM,1901,8,na,1909,7409
SIM,1849,30,na,1879,4213
SIM,1889,39,25-29,1928,11
STAT,1857,28,30-34,1885,40.537957402732154
STAT,1868,16,40-44,1884,0.3599364313198455
SIM,1865,28,30-34,1893,56
SIM,1874,27,na,1901,4615
SIM,1819,95,na,1914,8
STAT,1915,17,50-100,1932,0.1583781949868816
STAT,1816,67,na,1883,1781.1437034976996
STAT,1872,81,na,1953,1097.6116222629273
STAT,1850,36,35-39,1886,11.131415960093117
STAT,1920,28,25-29,1948,145.27607694069468
SIM,1897,49,45-49,1946,2
SIM,1837,17,15-19,1854,8
STAT,1849,29,35-39,1878,17.833574382264334
STAT,1853,108,na,1961,0.010277688740574047
SIM,1888,2,na,1890,6202
STAT,1797,69,na,1866,1369.6000866558552
STAT,1898,11,na,1909,7068.756452511253
STAT,1852,51,na,1903,3448.1602753401653
SIM,1861,36,50-100,1897,3
STAT,1765,102,na,1867,0.15036913240902844
STAT,1899,27,25-29,1926,117.05389721143763
SIM,1869,31,45-49,1900,4
SIM,1902,38,25-29,1940,3
STAT,1903,33,20-24,1936,4.444315608071729
SIM,1833,27,25-29,1860,81
SIM,1915,19,40-44,1934,2
SIM,1883,18,25-29,1901,16
SIM,1906,21,30-34,1927,70
STAT,1927,44,15-19,1971,0.0038762013577312337
STAT,1849,95,na,1944,21.03085930242508
STAT,1920,35,15-19,1955,0.04252712189895784
SIM,1897,14,na,1911,7122
SIM,1851,54,na,1905,3253
STAT,1818,47,20-24,1865,0.05290159364410803
SIM,1841,41,30-34,1882,3
SIM,1911,33,20-24,1944,8
STAT,1908,43,35-39,1951,0.37425133557776114
STAT,1859,26,40-44,1885,4.933879291360799
STAT,1808,50,20-24,1858,0.004562475077195022
STAT,1821,34,15-19,1855,0.7158968218638713
SIM,1842,40,20-24,1882,2
SIM,1828,78,na,1906,934
STAT,1907,44,45-49,1951,0.3043370156056759
STAT,1874,20,20-24,1894,143.35543381144623
SIM,1882,15,50-100,1897,4
STAT,1807,51,30-34,1858,0.03956496140932167
STAT,1882,15,50-100,1897,0.09683428487127951
STAT,1860,48,45-49,1908,0.3821961321762242
STAT,1824,51,30-34,1875,0.014163220508046576
SIM,1896,60,na,1956,5266
STAT,1924,44,30-34,1968,0.306014548145687
STAT,1838,51,45-49,1889,0.01992740016018784
SIM,1882,35,40-44,1917,5
SIM,1860,1,na,1861,6228
STAT,1851,44,na,1895,3534.482050170615
SIM,1943,15,50-100,1958,1
STAT,1849,36,25-29,1885,4.708905585073779
STAT,1800,105,na,1905,0.025043412437929232
STAT,1918,47,25-29,1965,0.11398496093752208
SIM,1823,69,na,1892,1542
SIM,1893,30,25-29,1923,31
STAT,1909,38,50-100,1947,0.7990614531771986
STAT,1824,39,45-49,1863,5.538077201714874
SIM,1866,9,na,1875,5331
SIM,1815,44,40-44,1859,7
STAT,1924,44,45-49,1968,0.39837029042101696
STAT,1864,52,na,1916,3866.4408618960047
STAT,1842,18,50-100,1860,0.0931126244527816
STAT,1919,28,15-19,1947,1.5347731344856832
STAT,1895,20,40-44,1915,5.516534560611672
SIM,1867,26,40-44,1893,6
SIM,1857,36,25-29,1893,1
SIM,1915,26,30-34,1941,103
STAT,1892,18,25-29,1910,14.28962911690662
STAT,1900,35,45-49,1935,5.638042665864268
STAT,1904,34,50-100,1938,1.5119939369027762
STAT,1885,30,25-29,1915,20.756179077787767
STAT,1917,48,20-24,1965,0.023245645202625266
SIM,1832,39,45-49,1871,6
SIM,1900,30,40-44,1930,18
SIM,1876,38,20-24,1914,5
STAT,1857,38,25-29,1895,4.509942547217243
STAT,1848,30,20-24,1878,5.2772269575756425
SIM,1832,43,30-34,1875,5
STAT,1844,47,15-19,1891,6.42953544290442E-4
STAT,1831,99,na,1930,2.4452628155139537
STAT,1849,85,na,1934,433.62536226170306
SIM,1901,32,35-39,1933,41
SIM,1823,90,na,1913,62
STAT,1858,45,50-100,1903,0.3905321448742354
SIM,1873,37,40-44,1910,15
SIM,1900,32,35-39,1932,34
STAT,1891,34,30-34,1925,43.21295889068235
SIM,1877,89,na,1966,425
STAT,1869,51,50-100,1920,0.029696577835827347
STAT,1904,31,15-19,1935,0.414489753170099
SIM,1886,60,na,1946,3873
SIM,1884,27,na,1911,5344
STAT,1841,46,35-39,1887,0.20668211563870634
SIM,1904,11,na,1915,7617
STAT,1824,47,45-49,1871,0.5715577078693245
STAT,1934,30,30-34,1964,43.49975326284377
SIM,1863,25,45-49,1888,3
STAT,1819,65,na,1884,1850.2700284225266
SIM,1840,46,40-44,1886,1
SIM,1860,37,na,1897,4135
STAT,1873,97,na,1970,63.751135326994344
SIM,1871,20,45-49,1891,4
STAT,1851,40,20-24,1891,0.24867334011000575
SIM,1891,28,45-49,1919,4
STAT,1905,31,15-19,1936,0.23980969474383373
STAT,1857,59,na,1916,3059.3953030073812
STAT,1911,42,50-100,1953,0.22652140970914955
SIM,1874,28,25-29,1902,87
SIM,1808,48,na,1856,2800
STAT,1810,54,40-44,1864,0.0624975674450416
STAT,1844,96,na,1940,13.866713679416133
SIM,1811,88,na,1899,84
SIM,1848,35,20-24,1883,1
STAT,1848,48,45-49,1896,0.38210860649820605
STAT,1857,53,35-39,1910,0.013334756984658044
STAT,1897,40,45-49,1937,0.28340423351839944
SIM,1831,88,na,1919,110
STAT,1874,62,na,1936,3779.59229399832
SIM,1861,54,na,1915,3978
SIM,1844,44,50-100,1888,4
STAT,1927,34,50-100,1961,2.051100645809011
STAT,1881,48,30-34,1929,0.1865871602889324
SIM,1902,10,na,1912,7629
STAT,1871,48,20-24,1919,0.023775637949836562
SIM,1818,78,na,1896,670
STAT,1887,25,na,1912,5427.233224919199
STAT,1834,32,na,1866,3689.060181675463
SIM,1832,47,45-49,1879,2
SIM,1824,37,45-49,1861,3
STAT,1900,42,35-39,1942,0.35186109182457426
STAT,1816,44,35-39,1860,9.233897797433062
STAT,1869,28,50-100,1897,1.2474328512022181
STAT,1909,46,20-24,1955,0.0205709176884342
SIM,1932,36,45-49,1968,5
STAT,1908,40,30-34,1948,0.24175249162665094
SIM,1857,28,25-29,1885,81
STAT,1761,105,na,1866,0.0031142142120938326
STAT,1918,40,40-44,1958,0.5384894184709696
SIM,1893,33,50-100,1926,4
STAT,1832,53,30-34,1885,0.00791381497326471
STAT,1836,44,50-100,1880,1.629096611528817
SIM,1919,10,na,1929,9023
SIM,1869,21,30-34,1890,42
SIM,1844,62,na,1906,2568
STAT,1863,49,25-29,1912,0.09970492247206249
SIM,1912,48,50-100,1960,1
STAT,1907,19,40-44,1926,0.5400109749445738
STAT,1824,43,30-34,1867,2.916164669664744
SIM,1857,34,50-100,1891,2
STAT,1853,15,na,1868,4420.8054784196665
SIM,1889,29,30-34,1918,85
STAT,1883,35,35-39,1918,14.16789813613968
STAT,1924,36,45-49,1960,1.6245438983970557
STAT,1817,84,na,1901,335.5325580790002
STAT,1850,37,45-49,1887,3.1049551056461056
SIM,1881,84,na,1965,832
STAT,1920,33,20-24,1953,5.371846393681818
SIM,1833,45,na,1878,3243
SIM,1934,31,35-39,1965,32
STAT,1924,43,35-39,1967,0.48284085938535803
STAT,1950,15,na,1965,8793.755325404767
SIM,1842,40,na,1882,3545
SIM,1837,35,45-49,1872,3
SIM,1954,0,na,1954,10181
SIM,1906,46,45-49,1952,1
STAT,1884,22,50-100,1906,0.8132443709879581
STAT,1920,49,na,1969,8151.812943769189
STAT,1822,48,25-29,1870,0.1765181551282317
STAT,1865,44,30-34,1909,2.080950927436437
STAT,1831,34,na,1865,3549.2407959706416
STAT,1896,26,45-49,1922,2.970703481254113
STAT,1933,16,30-34,1949,33.037470607515466
SIM,1875,23,na,1898,5174
STAT,1927,19,na,1946,9191.982312376515
STAT,1928,44,15-19,1972,0.003940095538450375
SIM,1926,40,40-44,1966,3
STAT,1883,28,45-49,1911,2.1953898521271547
SIM,1900,18,35-39,1918,2
STAT,1871,32,50-100,1903,1.8384604623417649
SIM,1892,22,50-100,1914,1
SIM,1938,32,30-34,1970,42
STAT,1837,30,45-49,1867,3.1119851315315996
STAT,1897,35,na,1932,6420.699229462807
SIM,1820,72,na,1892,1203
STAT,1938,30,15-19,1968,0.26129658530620725
SIM,1941,16,30-34,1957,40
SIM,1873,44,30-34,1917,5
STAT,1805,52,45-49,1857,0.11394886025812898
STAT,1912,41,15-19,1953,0.003009343167712296
SIM,1856,30,20-24,1886,7
STAT,1865,37,40-44,1902,8.031891353662736
STAT,1887,59,na,1946,4389.882580757297
STAT,1900,31,30-34,1931,49.115472322449826
SIM,1830,48,25-29,1878,1
SIM,1903,59,na,1962,6056
STAT,1891,38,45-49,1929,4.951821057064503
SIM,1867,79,na,1946,1323
SIM,1898,29,25-29,1927,126
STAT,1832,38,40-44,1870,7.1345534541765865
STAT,1944,7,na,1951,8600.964427046978
SIM,1819,64,na,1883,1888
STAT,1829,35,45-49,1864,3.610920607034793
STAT,1926,31,35-39,1957,22.325715712656308
SIM,1845,30,45-49,1875,4
SIM,1937,18,50-100,1955,1
STAT,1846,50,40-44,1896,0.016357024145725138
SIM,1810,72,na,1882,1140
STAT,1898,39,25-29,1937,1.6813813715139556
STAT,1814,66,na,1880,1671.506169822838
STAT,1931,21,15-19,1952,13.986167255171688
SIM,1848,28,30-34,1876,55
STAT,1842,34,35-39,1876,17.839425036329004
STAT,1915,43,40-44,1958,0.5078158177507703
SIM,1784,92,na,1876,12
SIM,1839,15,25-29,1854,19
STAT,1878,21,na,1899,5003.6596508609055
SIM,1891,43,35-39,1934,4
STAT,1883,43,35-39,1926,3.567193458619237
STAT,1873,47,40-44,1920,0.3496741731100843
STAT,1890,45,na,1935,5601.501652787352
STAT,1957,6,na,1963,10466.10454729146
SIM,1883,5,na,1888,5511
SIM,1881,47,40-44,1928,1
STAT,1840,44,25-29,1884,0.9424470856555482
SIM,1892,56,na,1948,5775
STAT,1850,44,35-39,1894,2.7389889414599016
STAT,1804,66,na,1870,1591.1064043449655
STAT,1929,18,50-100,1947,0.9630322717109833
SIM,1928,16,15-19,1944,112
STAT,1816,52,35-39,1868,0.04057764290494408
STAT,1849,51,20-24,1900,0.0011728243920669942
SIM,1850,34,35-39,1884,20
STAT,1861,51,35-39,1912,0.014541143308989448
STAT,1948,23,35-39,1971,21.825961747210783
STAT,1950,8,na,1958,9384.513249543405
SIM,1865,13,na,1878,5078
STAT,1925,17,35-39,1942,10.235210149857373
STAT,1857,45,35-39,1902,0.2225847404942081
STAT,1891,45,35-39,1936,0.1991088715215632
SIM,1871,30,na,1901,4689
SIM,1897,31,20-24,1928,10
STAT,1875,19,35-39,1894,1.1348404906388152
SIM,1914,11,na,1925,8489
STAT,1824,36,40-44,1860,13.879702871228027
SIM,1873,48,45-49,1921,3
SIM,1855,16,20-24,1871,32
STAT,1861,44,45-49,1905,2.481905252815018
STAT,1910,31,50-100,1941,1.6172255733208065
SIM,1899,25,25-29,1924,13
SIM,1900,40,35-39,1940,1
SIM,1895,43,na,1938,6366
SIM,1845,19,15-19,1864,8
STAT,1820,50,35-39,1870,0.03206237185814642
SIM,1833,90,na,1923,72
STAT,1888,21,na,1909,5662.569386813816
STAT,1824,54,35-39,1878,0.019297839582051998
STAT,1764,96,na,1860,2.2106709923205528
STAT,1821,99,na,1920,2.0992495655504286
SIM,1860,39,20-24,1899,2
SIM,1859,29,na,1888,4308
SIM,1910,37,20-24,1947,1
STAT,1875,18,25-29,1893,11.752248945603256
SIM,1832,36,40-44,1868,14
SIM,1808,68,na,1876,1590
STAT,1830,47,20-24,1877,0.02071413053011558
SIM,1908,41,35-39,1949,1
SIM,1786,73,na,1859,977
SIM,1841,64,na,1905,2407
SIM,1933,17,35-39,1950,14
STAT,1917,19,na,1936,7929.878548766856
STAT,1847,16,20-24,1863,33.928881778272114
STAT,1866,40,30-34,1906,2.1640008605848187
SIM,1872,70,na,1942,2760
SIM,1826,97,na,1923,3
STAT,1889,31,20-24,1920,6.7587538161840035
SIM,1945,13,na,1958,9031
STAT,1789,108,na,1897,9.374560699095077E-4
STAT,1907,29,35-39,1936,28.197457334138576
STAT,1882,71,na,1953,2626.082291749762
SIM,1833,24,20-24,1857,124
STAT,1922,49,40-44,1971,0.36356018039812454
STAT,1846,54,20-24,1900,0.001099195964812236
SIM,1915,41,40-44,1956,1
SIM,1898,61,na,1959,5392
STAT,1890,31,45-49,1921,4.316361215164483
SIM,1907,19,35-39,1926,2
STAT,1901,31,30-34,1932,49.5668005432905
STAT,1839,17,25-29,1856,11.574718361891744
STAT,1837,39,na,1876,3559.740472579565
STAT,1919,42,15-19,1961,0.003360331530533979
SIM,1891,35,35-39,1926,23
STAT,1787,69,na,1856,1289.1858488399998
STAT,1883,12,na,1895,5124.4040935923995
SIM,1793,75,na,1868,753
STAT,1881,15,45-49,1896,0.1281072913227
STAT,1849,28,25-29,1877,78.74876467420667
SIM,1843,45,na,1888,3448
SIM,1850,42,35-39,1892,11
STAT,1873,39,40-44,1912,8.892472737920345
STAT,1867,28,40-44,1895,5.64593934035473
STAT,1814,53,15-19,1867,1.197288979901598E-4
STAT,1826,49,20-24,1875,0.023287363441611798
STAT,1859,95,na,1954,21.37243409799394
SIM,1847,17,25-29,1864,15
SIM,1851,41,25-29,1892,2
STAT,1806,48,40-44,1854,1.02862216254506
STAT,1881,44,15-19,1925,0.026594028621635336
SIM,1911,24,na,1935,7324
STAT,1920,25,20-24,1945,40.70603018920357
SIM,1813,79,na,1892,569
SIM,1922,40,na,1962,9040
SIM,1872,41,45-49,1913,11
SIM,1874,40,30-34,1914,3
SIM,1871,49,25-29,1920,1
STAT,1859,18,40-44,1877,0.33927925341212684
SIM,1824,44,35-39,1868,6
STAT,1900,32,40-44,1932,12.149851274474456
SIM,1878,18,15-19,1896,10
STAT,1911,20,35-39,1931,18.148141013098947
STAT,1843,41,25-29,1884,0.93812556109435
STAT,1870,27,20-24,1897,23.26144131210526
STAT,1824,86,na,1910,237.2158093067454
STAT,1836,67,na,1903,2107.6789494829527
SIM,1840,46,50-100,1886,2
STAT,1842,42,35-39,1884,2.789268936803216
STAT,1885,33,50-100,1918,1.8341520124626798
STAT,1896,30,na,1926,6414.073453239793
STAT,1832,46,40-44,1878,0.2672852438390825
STAT,1853,31,40-44,1884,7.1397383011274735
STAT,1851,54,30-34,1905,0.008973787552456028
STAT,1877,17,45-49,1894,0.13699162711962024
SIM,1915,29,35-39,1944,37
SIM,1888,48,40-44,1936,1
STAT,1855,25,45-49,1880,1.9455758280470683
STAT,1881,35,50-100,1916,2.419414970546811
STAT,1852,39,20-24,1891,1.2162216644469397
STAT,1854,108,na,1962,0.011985536966746707
STAT,1850,33,30-34,1883,27.71529361175503
STAT,1904,22,na,1926,6855.6603211175825
STAT,1892,15,20-24,1907,45.03122731371873
STAT,1919,52,na,1971,7910.569154231233
STAT,1862,35,15-19,1897,0.09785466881829011
STAT,1864,41,45-49,1905,2.714124171249707
STAT,1924,40,15-19,1964,0.0036983593092999333
SIM,1898,41,na,1939,6574
STAT,1823,49,na,1872,3046.4139523547933
STAT,1948,2,na,1950,9294.380317814428
STAT,1885,48,15-19,1933,7.940140274444963E-4
STAT,1840,43,15-19,1883,0.020529014975680406
SIM,1889,36,20-24,1925,1
STAT,1891,27,40-44,1918,7.478072086389087
STAT,1863,20,45-49,1883,1.2756156341327674
STAT,1850,80,na,1930,948.4749891890385
SIM,1914,48,45-49,1962,2
STAT,1832,46,50-100,1878,0.3834419149470629
STAT,1795,98,na,1893,1.3883025995055018
SIM,1865,38,45-49,1903,6
STAT,1930,21,15-19,1951,13.813932043290448
STAT,1839,85,na,1924,428.04127002022796
STAT,1865,48,45-49,1913,0.4275745979667568
STAT,1837,19,15-19,1856,11.726224121472024
SIM,1856,63,na,1919,2955
STAT,1820,43,45-49,1863,5.885023081001301
SIM,1893,62,na,1955,4689
STAT,1837,50,na,1887,3133.5612180721128
STAT,1846,13,na,1859,4572.515499778924
STAT,1911,45,15-19,1956,7.078368888883183E-4
STAT,1843,19,40-44,1862,0.323577973100159
SIM,1835,33,50-100,1868,4
SIM,1854,0,na,1854,6420
STAT,1916,34,45-49,1950,3.252964465678378
STAT,1877,47,50-100,1924,0.5126608082335181
SIM,1915,22,35-39,1937,18
SIM,1846,25,45-49,1871,4
STAT,1865,30,20-24,1895,4.999468550072082
STAT,1816,41,30-34,1857,6.59432802593321
STAT,1881,37,25-29,1918,5.62042689949376
SIM,1845,16,na,1861,4741
SIM,1855,27,50-100,1882,3
STAT,1830,28,na,1858,3902.438145575063
STAT,1856,33,na,1889,3725.0805331147994
SIM,1879,26,na,1905,4963
STAT,1829,31,na,1860,3398.37880672053
SIM,1883,42,na,1925,4758
STAT,1799,71,na,1870,1253.388624547138
STAT,1910,32,35-39,1942,17.802097524713837
STAT,1851,29,50-100,1880,1.1444595354027705
SIM,1821,98,na,1919,1
STAT,1879,92,na,1971,349.8169018391451
SIM,1822,46,25-29,1868,1
SIM,1832,50,na,1882,3058
STAT,1858,52,25-29,1910,0.0055469228360085195
STAT,1831,43,20-24,1874,0.24824835043677992
STAT,1933,31,40-44,1964,10.658199871372963
STAT,1814,46,25-29,1860,0.3030872844280839
SIM,1850,31,30-34,1881,42
STAT,1951,21,na,1972,8813.723664148925
SIM,1866,33,50-100,1899,1
STAT,1863,46,20-24,1909,0.02127504162363
STAT,1834,32,35-39,1866,17.267541128329647
SIM,1842,32,35-39,1874,25
SIM,1853,45,na,1898,3734
SIM,1868,75,na,1943,1923
STAT,1823,44,25-29,1867,2.032051325390622
SIM,1853,35,na,1888,3958
STAT,1886,30,na,1916,5128.37198289168
SIM,1938,3,na,1941,8090
SIM,1851,10,na,1861,4752
SIM,1891,25,40-44,1916,7
SIM,1960,1,na,1961,10842
SIM,1851,19,40-44,1870,1
SIM,1950,19,50-100,1969,1
SIM,1875,44,50-100,1919,5
SIM,1930,25,50-100,1955,4
STAT,1826,98,na,1924,3.888845056607599
SIM,1917,18,na,1935,8707
STAT,1831,35,50-100,1866,2.050997265858611
STAT,1920,41,50-100,1961,0.26236088308463995
SIM,1867,29,45-49,1896,2
STAT,1833,52,20-24,1885,0.0010014666058272789
SIM,1895,5,na,1900,7335
STAT,1922,45,25-29,1967,0.123619601284037
STAT,1860,45,40-44,1905,0.2835814587930759
SIM,1861,31,40-44,1892,10
SIM,1864,38,50-100,1902,5
STAT,1855,51,45-49,1906,0.021988473564624623
STAT,1785,102,na,1887,0.18618614816605963
STAT,1913,33,15-19,1946,0.25718834111840705
SIM,1813,70,na,1883,1391
STAT,1893,21,50-100,1914,1.0470453232693853
SIM,1779,91,na,1870,21
SIM,1898,26,20-24,1924,34
STAT,1838,25,45-49,1863,1.9392404775161287
STAT,1859,44,50-100,1903,1.6753119995093368
SIM,1921,33,15-19,1954,2
STAT,1881,49,40-44,1930,0.3272185500502966
STAT,1859,29,45-49,1888,1.789629148852869
STAT,1922,31,15-19,1953,0.2943561362064632
SIM,1858,17,35-39,1875,1
SIM,1868,40,40-44,1908,2
SIM,1857,25,20-24,1882,21
STAT,1839,41,na,1880,3851.183591624324
STAT,1872,44,20-24,1916,0.3179981345895633
STAT,1883,25,40-44,1908,5.984343855350599
STAT,1945,25,50-100,1970,2.2071628352431136
SIM,1855,39,50-100,1894,2
SIM,1826,43,na,1869,3070
STAT,1939,33,35-39,1972,18.82148436329666
STAT,1822,45,20-24,1867,0.038394942807932084
STAT,1842,31,30-34,1873,31.729498303776115
STAT,1942,24,45-49,1966,2.3810398820559313
SIM,1864,43,25-29,1907,1
STAT,1912,22,50-100,1934,1.2739054985238945
STAT,1866,51,20-24,1917,0.0013816771321579228
STAT,1918,23,50-100,1941,1.428579406078948
SIM,1892,42,25-29,1934,6
STAT,1920,43,15-19,1963,0.003419204826862571
SIM,1835,41,40-44,1876,5
SIM,1925,37,na,1962,9132
SIM,1831,44,25-29,1875,3
STAT,1863,50,40-44,1913,0.018879298542489643
SIM,1892,15,na,1907,7286
SIM,1855,13,na,1868,5009
SIM,1887,26,45-49,1913,3
STAT,1890,34,50-100,1924,2.239350175540503
SIM,1875,16,25-29,1891,17
STAT,1839,40,20-24,1879,0.2946574484908922
SIM,1921,44,na,1965,8440
STAT,1843,52,50-100,1895,0.02104357379972439
STAT,1879,26,45-49,1905,2.3535390380647514
SIM,1817,73,na,1890,1134
STAT,1890,35,25-29,1925,7.165077438826157
STAT,1811,52,35-39,1863,0.055747420449588525
STAT,1924,33,40-44,1957,9.212526106451895
SIM,1885,77,na,1962,2277
STAT,1873,12,na,1885,5383.2363583768665
STAT,1888,65,na,1953,4034.0505861043935
SIM,1890,8,na,1898,6904
SIM,1882,20,20-24,1902,130
SIM,1816,42,35-39,1858,6
SIM,1932,33,40-44,1965,19
STAT,1907,22,35-39,1929,17.321819500956373
STAT,1867,50,25-29,1917,0.006795724223176676
STAT,1894,32,50-100,1926,2.3771045434651294
SIM,1792,80,na,1872,452
STAT,1840,48,40-44,1888,0.24602547252456541
SIM,1900,41,30-34,1941,1
SIM,1912,22,50-100,1934,6
STAT,1855,47,25-29,1902,0.08645208757790114
SIM,1839,61,na,1900,2485
STAT,1875,33,35-39,1908,20.968867035072158
STAT,1867,16,25-29,1883,11.022125587795445
STAT,1892,30,30-34,1922,44.49816226735939
SIM,1917,9,na,1926,8865
STAT,1805,53,20-24,1858,0.005678144777676185
STAT,1890,49,35-39,1939,0.19061273756268635
STAT,1855,18,20-24,1873,31.609503357670093
STAT,1817,51,25-29,1868,0.016726619878348926
SIM,1898,19,30-34,1917,4
STAT,1811,45,45-49,1856,1.658349346641608
STAT,1949,23,50-100,1972,1.5500455652810003
STAT,1924,40,30-34,1964,0.3078883906763584
SIM,1863,18,20-24,1881,30
STAT,1894,32,40-44,1926,11.251163468620796
STAT,1894,46,15-19,1940,5.87043860042963E-4
SIM,1858,24,25-29,1882,127
STAT,1870,37,15-19,1907,0.11134479532358696
SIM,1888,10,na,1898,6078
STAT,1882,40,15-19,1922,0.027443562043993907
STAT,1884,42,25-29,1926,1.279058138912826
STAT,1800,73,na,1873,1084.7284771604955
STAT,1827,41,40-44,1868,4.351134173307401
SIM,1863,47,25-29,1910,1
STAT,1899,22,50-100,1921,1.1284126072731189
STAT,1920,36,25-29,1956,2.178693260509645
STAT,1935,17,na,1952,10164.252936354187
SIM,1883,33,35-39,1916,28
SIM,1838,19,25-29,1857,12
SIM,1839,16,20-24,1855,30
STAT,1839,31,na,1870,4207.88172468989
STAT,1939,15,20-24,1954,274.78479682237594
SIM,1890,33,25-29,1923,35
STAT,1790,68,na,1858,1295.6103364268388
SIM,1859,16,40-44,1875,2
STAT,1868,42,40-44,1910,4.316721744203726
SIM,1804,96,na,1900,2
SIM,1842,50,na,1892,3155
SIM,1879,24,45-49,1903,1
SIM,1924,41,35-39,1965,1
SIM,1807,83,na,1890,283
SIM,1894,30,40-44,1924,22
STAT,1835,54,45-49,1889,0.01841945145642732
STAT,1806,51,15-19,1857,1.4643881204089583E-4
SIM,1923,40,50-100,1963,1
SIM,1865,42,30-34,1907,3
SIM,1954,17,na,1971,9244
STAT,1869,16,40-44,1885,0.36503673813883963
SIM,1855,19,25-29,1874,14
SIM,1866,53,na,1919,4117
STAT,1828,40,45-49,1868,2.9106482265624454
SIM,1830,43,50-100,1873,6
SIM,1862,35,50-100,1897,3
STAT,1808,80,na,1888,559.7857454555358
STAT,1864,45,25-29,1909,0.10502251989461224
SIM,1858,75,na,1933,1660
STAT,1921,3,na,1924,9335.196320276222
STAT,1858,19,35-39,1877,0.9972945846831885
STAT,1797,90,na,1887,61.63921486026675
STAT,1949,18,35-39,1967,9.852434535295856
STAT,1927,41,45-49,1968,0.4220934891636779
STAT,1820,36,20-24,1856,4.086745363509362
STAT,1912,23,20-24,1935,214.61206062344095
STAT,1921,35,30-34,1956,4.11614234537702
SIM,1834,31,na,1865,3655
STAT,1901,20,40-44,1921,5.92684972065146
SIM,1920,23,20-24,1943,265
STAT,1874,53,20-24,1927,0.001501453592817373
STAT,1835,33,50-100,1868,1.4958638315295265
STAT,1901,49,20-24,1950,0.01873886319321818
STAT,1893,47,45-49,1940,0.3391915841866673
SIM,1823,42,25-29,1865,2
SIM,1837,28,na,1865,3677
SIM,1876,42,40-44,1918,7
SIM,1897,55,na,1952,5695
SIM,1899,48,50-100,1947,2
SIM,1924,16,30-34,1940,30
STAT,1789,71,na,1860,1227.4106263874553
SIM,1889,26,na,1915,6061
STAT,1849,25,20-24,1874,22.316649089456476
STAT,1890,42,15-19,1932,0.03400147041177714
STAT,1842,50,20-24,1892,0.0011144127126659364
STAT,1882,33,25-29,1915,20.066227368747995
SIM,1827,83,na,1910,368
SIM,1803,70,na,1873,1392
SIM,1819,40,45-49,1859,6
STAT,1886,30,40-44,1916,9.319948202036983
STAT,1866,25,20-24,1891,22.009635968870153
SIM,1862,47,50-100,1909,1
STAT,1822,52,45-49,1874,0.04341011538539622
SIM,1822,50,na,1872,2739
SIM,1884,22,50-100,1906,1
STAT,1878,31,45-49,1909,3.6932769749055576
STAT,1932,35,40-44,1967,4.069516645603249
SIM,1840,41,15-19,1881,1
STAT,1910,5,na,1915,8022.901146689975
SIM,1825,29,40-44,1854,6
STAT,1866,33,na,1899,4428.076578520285
SIM,1839,41,25-29,1880,1
STAT,1762,105,na,1867,0.0457550317526305
STAT,1932,21,30-34,1953,76.39764109249235
SIM,1821,88,na,1909,125
SIM,1849,19,35-39,1868,1
SIM,1834,21,na,1855,3777
STAT,1898,32,25-29,1930,27.993936229671508
SIM,1874,25,20-24,1899,26
STAT,1934,19,50-100,1953,1.018121204959951
SIM,1857,18,30-34,1875,5
SIM,1886,31,45-49,1917,6
STAT,1884,62,na,1946,3644.990240284837
STAT,1882,47,35-39,1929,0.27415144044205997
SIM,1889,36,na,1925,5969
STAT,1916,16,30-34,1932,5.23559738104107
STAT,1873,22,na,1895,4853.212470557999
STAT,1857,31,25-29,1888,16.392758705682112
SIM,1923,21,30-34,1944,95
STAT,1901,16,50-100,1917,0.13885832183269803
SIM,1891,32,30-34,1923,55
SIM,1908,15,35-39,1923,3
SIM,1834,34,50-100,1868,1
STAT,1866,18,30-34,1884,3.030654629633407
SIM,1814,44,25-29,1858,1
SIM,1904,42,na,1946,6778
SIM,1843,17,40-44,1860,2
STAT,1849,18,30-34,1867,3.0850932688024537
STAT,1883,51,20-24,1934,0.0014712395919414519
SIM,1869,24,35-39,1893,10
STAT,1810,102,na,1912,0.26513361088781745
STAT,1834,86,na,1920,294.859662757865
SIM,1824,34,40-44,1858,13
SIM,1930,31,15-19,1961,1
SIM,1923,17,50-100,1940,1
STAT,1938,17,50-100,1955,0.7465252335473835
SIM,1866,63,na,1929,3430
SIM,1874,82,na,1956,794
SIM,1881,35,25-29,1916,8
SIM,1929,9,na,1938,10606
STAT,1934,22,na,1956,9912.901170453228
STAT,1876,48,20-24,1924,0.02475135859017022
STAT,1830,102,na,1932,0.4048403962917684
SIM,1865,35,40-44,1900,14
SIM,1857,43,35-39,1900,4
STAT,1880,24,50-100,1904,0.8621725186053527
STAT,1917,40,na,1957,7848.713449692937
STAT,1922,41,na,1963,8619.393997509267
STAT,1915,21,30-34,1936,60.18794176093052
STAT,1852,50,30-34,1902,0.009623569839334664
STAT,1887,80,na,1967,2134.5264245130174
SIM,1873,42,na,1915,4845
SIM,1838,23,45-49,1861,1
STAT,1886,40,na,1926,4977.1499832071295
SIM,1865,31,25-29,1896,27
SIM,1924,34,45-49,1958,6
STAT,1793,86,na,1879,141.07059268694724
STAT,1883,32,30-34,1915,34.64485234938448
STAT,1830,73,na,1903,1640.1476072877329
SIM,1826,34,50-100,1860,2
SIM,1903,19,15-19,1922,12
STAT,1840,28,na,1868,3865.411972435278
STAT,1916,41,35-39,1957,0.41735807379717926
STAT,1873,42,15-19,1915,0.02830365598746586
STAT,1893,40,25-29,1933,1.6604306714397283
SIM,1939,16,25-29,1955,109
SIM,1907,16,30-34,1923,7
STAT,1821,102,na,1923,0.3249686804412682
SIM,1780,88,na,1868,72
STAT,1821,68,na,1889,1688.4915701130542
STAT,1911,38,25-29,1949,1.91169379425335
STAT,1869,41,45-49,1910,2.942086616163478
SIM,1901,24,na,1925,6705
STAT,1906,45,40-44,1951,0.2870366178265232
SIM,1854,82,na,1936,702
STAT,1812,44,15-19,1856,0.10148861934268288
STAT,1906,31,30-34,1937,29.62467793130434
SIM,1881,30,na,1911,4119
STAT,1914,22,na,1936,7536.214278220223
SIM,1883,15,20-24,1898,39
SIM,1912,30,na,1942,7850
STAT,1892,41,20-24,1933,0.4033431486791037
SIM,1849,26,25-29,1875,82
STAT,1868,45,na,1913,4366.228158577533
SIM,1853,36,50-100,1889,1
STAT,1847,19,25-29,1866,10.654486279153637
STAT,1856,7,na,1863,4560.452260810649
SIM,1919,18,15-19,1937,102
STAT,1825,50,20-24,1875,0.0016050740508905498
STAT,1925,43,35-39,1968,0.4914902985108808
STAT,1841,32,25-29,1873,18.031193629954714
STAT,1875,15,20-24,1890,37.035124521932666
STAT,1832,49,45-49,1881,0.3226411538847205
SIM,1824,41,30-34,1865,2
SIM,1860,43,40-44,1903,5
STAT,1931,36,50-100,1967,1.1240591440508307
SIM,1840,49,45-49,1889,1
SIM,1822,43,20-24,1865,1
SIM,1877,41,45-49,1918,4
SIM,1932,22,35-39,1954,30
STAT,1864,49,40-44,1913,0.30261586012573777
STAT,1922,42,20-24,1964,0.040927696656265285
SIM,1833,35,na,1868,3572
SIM,1850,20,25-29,1870,146
STAT,1845,108,na,1953,0.0028225682526276693
STAT,1895,44,na,1939,6020.951227945786
STAT,1817,94,na,1911,20.158466404475377
STAT,1874,35,40-44,1909,9.138273719788655
STAT,1881,34,20-24,1915,5.231414301239907
SIM,1878,41,na,1919,5113
STAT,1930,33,15-19,1963,0.33472231726530455
SIM,1823,49,45-49,1872,1
STAT,1901,30,35-39,1931,28.863108206517044
STAT,1810,73,na,1883,1086.1562011281744
STAT,1831,46,25-29,1877,0.08928257936096934
STAT,1879,51,na,1930,4570.280398102528
SIM,1899,36,na,1935,6648
SIM,1866,26,25-29,1892,78
STAT,1912,48,35-39,1960,0.2496170866289255
STAT,1922,5,na,1927,9395.338284246107
SIM,1924,31,40-44,1955,14
STAT,1853,49,30-34,1902,0.14995929771619662
SIM,1861,49,30-34,1910,1
STAT,1847,60,na,1907,2907.1937634043907
STAT,1908,59,na,1967,6314.021222442174
SIM,1782,80,na,1862,402
STAT,1865,1,na,1866,6595.794683465552
SIM,1844,31,na,1875,3656
STAT,1820,46,15-19,1866,0.0015102109001025861
SIM,1849,23,20-24,1872,128
STAT,1830,46,25-29,1876,0.10072253319573772
STAT,1861,34,na,1895,3977.0648272428393
SIM,1943,22,na,1965,8043
STAT,1880,48,na,1928,4726.555460597393
STAT,1787,90,na,1877,58.020150776634324
SIM,1911,36,25-29,1947,4
STAT,1815,49,45-49,1864,1.2288533156298362
STAT,1870,21,50-100,1891,0.8110191028505964
STAT,1918,44,20-24,1962,0.03778934393191007
SIM,1900,44,35-39,1944,1
STAT,1844,41,40-44,1885,3.768138849465691
STAT,1890,46,30-34,1936,0.13498772421538122
STAT,1847,50,50-100,1897,0.02335258516478034
STAT,1903,23,50-100,1926,1.1690033474024004
STAT,1880,46,20-24,1926,0.02560336404537051
SIM,1911,23,50-100,1934,1
STAT,1882,81,na,1963,1546.979190289291
STAT,1834,108,na,1942,0.002434246858092798
SIM,1818,68,na,1886,1625
SIM,1797,68,na,1865,1492
SIM,1884,40,25-29,1924,2
STAT,1900,43,30-34,1943,0.22205285986366063
STAT,1875,52,25-29,1927,0.007325881921433076
STAT,1891,41,na,1932,5795.844252936604
STAT,1876,40,25-29,1916,1.354910937336362
SIM,1803,69,na,1872,1519
STAT,1939,30,30-34,1969,32.50631039696975
STAT,1776,112,na,1888,0.0015278275357757793
STAT,1833,41,30-34,1874,1.8582429179690816
STAT,1835,47,20-24,1882,0.0163895775751179
STAT,1897,44,25-29,1941,0.1187593649837695
STAT,1902,30,35-39,1932,29.107878387821827
SIM,1940,9,na,1949,8341
SIM,1950,21,40-44,1971,10
STAT,1911,42,45-49,1953,0.32090533134089066
SIM,1940,21,30-34,1961,91
STAT,1912,30,45-49,1942,3.1531351380893673
SIM,1899,29,40-44,1928,11
STAT,1858,26,25-29,1884,68.6713162923501
STAT,1923,48,45-49,1971,0.511893539181156
STAT,1814,43,20-24,1857,0.8848551316569196
STAT,1891,20,20-24,1911,173.05835629833666
STAT,1924,22,35-39,1946,22.43316804141623
STAT,1933,34,45-49,1967,4.27772284871442
STAT,1863,53,45-49,1916,0.025244563769085092
STAT,1903,36,25-29,1939,1.7956175778155183
SIM,1906,32,35-39,1938,24
STAT,1820,52,50-100,1872,0.05405056166567789
STAT,1914,43,25-29,1957,0.14270362491397715
SIM,1852,41,40-44,1893,7
STAT,1875,88,na,1963,568.2744102079804
STAT,1897,48,40-44,1945,0.2574314791133106
STAT,1904,43,15-19,1947,0.0027597608576987315
STAT,1904,56,na,1960,6115.719685307956
SIM,1846,18,20-24,1864,40
SIM,1920,30,45-49,1950,7
SIM,1910,30,35-39,1940,28
STAT,1931,24,50-100,1955,1.7128279594842608
SIM,1846,97,na,1943,6
STAT,1871,47,25-29,1918,0.11503644621866807
STAT,1825,42,35-39,1867,4.180670361151177
STAT,1838,45,na,1883,3213.8424039556826
STAT,1825,72,na,1897,1461.214508679999
SIM,1884,37,na,1921,5051
STAT,1861,47,15-19,1908,6.692680154493639E-4
SIM,1871,64,na,1935,3299
STAT,1840,40,45-49,1880,2.5406681262156576
STAT,1882,26,na,1908,4711.35070872583
STAT,1868,11,na,1879,5155.486835770967
STAT,1920,47,30-34,1967,0.1989726272161129
STAT,1824,50,50-100,1874,0.03665644691065757
STAT,1900,9,na,1909,7269.187695016183
STAT,1926,23,50-100,1949,1.609193836653095
SIM,1841,34,40-44,1875,9
STAT,1916,19,35-39,1935,1.7883604916185072
STAT,1875,30,30-34,1905,36.59671474392085
STAT,1833,34,40-44,1867,7.203946458230014
STAT,1848,45,na,1893,3725.858760666451
SIM,1804,55,na,1859,2239
SIM,1875,54,40-44,1929,1
STAT,1838,18,20-24,1856,31.506573787414908
SIM,1836,40,45-49,1876,4
SIM,1863,44,20-24,1907,1
STAT,1815,72,na,1887,1271.6020724528746
SIM,1934,23,50-100,1957,3
STAT,1865,40,15-19,1905,0.025594104460164725
STAT,1867,54,40-44,1921,0.019364681343667152
SIM,1898,15,15-19,1913,16
SIM,1927,18,na,1945,10086
SIM,1865,23,na,1888,4427
SIM,1904,1,na,1905,7825
STAT,1838,28,50-100,1866,1.093384320434363
SIM,1831,98,na,1929,1
SIM,1913,56,na,1969,7060
SIM,1837,40,50-100,1877,4
STAT,1823,48,40-44,1871,0.5215104688768819
STAT,1842,20,25-29,1862,109.05818563214203
STAT,1829,40,50-100,1869,1.7936142064766536
SIM,1922,19,na,1941,9022
SIM,1908,46,50-100,1954,1
SIM,1893,45,45-49,1938,1
STAT,1862,32,45-49,1894,3.0101880309301485
SIM,1875,67,na,1942,3458
STAT,1895,31,45-49,1926,4.607849702212135
SIM,1858,28,40-44,1886,8
STAT,1863,12,na,1875,4815.871711410285
STAT,1878,11,na,1889,5472.131732873718
STAT,1885,45,45-49,1930,0.47915976114099196
STAT,1892,41,50-100,1933,2.6831087205007615
SIM,1903,45,30-34,1948,1
SIM,1827,28,na,1855,3574
STAT,1865,78,na,1943,1433.5980277920876
STAT,1890,39,40-44,1929,10.68261813314262
SIM,1848,34,na,1882,3794
STAT,1933,36,na,1969,10359.816915337517
STAT,1782,91,na,1873,35.81156647026571
SIM,1860,68,na,1928,2619
SIM,1928,30,50-100,1958,6
STAT,1901,23,45-49,1924,1.965493196607633
SIM,1912,19,na,1931,8043
STAT,1820,39,25-29,1859,12.700859098841763
STAT,1940,23,30-34,1963,59.11621562203512
STAT,1818,54,45-49,1872,0.05894995641306034
SIM,1849,16,30-34,1865,4
STAT,1843,29,50-100,1872,1.087022372033814
STAT,1949,15,30-34,1964,28.643316980540497
STAT,1869,92,na,1961,164.45656206261543
SIM,1856,48,45-49,1904,2
SIM,1813,69,na,1882,1528
SIM,1851,29,50-100,1880,2
STAT,1897,25,na,1922,6486.467979807135
SIM,1914,41,25-29,1955,1
STAT,1908,15,na,1923,7606.666984340084
STAT,1867,59,na,1926,3675.915898240713
STAT,1841,36,40-44,1877,7.561365214405555
SIM,1922,30,na,1952,9099
SIM,1844,42,45-49,1886,8
STAT,1908,17,35-39,1925,1.6449695188312357
STAT,1860,52,30-34,1912,0.009710702516462943
STAT,1885,21,50-100,1906,0.8222544875719858
SIM,1840,17,na,1857,4738
STAT,1874,45,35-39,1919,0.292394345271444
STAT,1868,19,45-49,1887,0.1262905913900975
SIM,1832,27,50-100,1859,5
STAT,1814,50,45-49,1864,0.07500422547305872
STAT,1909,55,na,1964,6607.467213018534
SIM,1843,35,na,1878,3722
SIM,1838,16,20-24,1854,32
STAT,1842,20,na,1862,4073.331204627629
SIM,1897,46,40-44,1943,1
STAT,1936,26,50-100,1962,1.9250766300607367
STAT,1911,35,20-24,1946,0.519255036490895
STAT,1917,41,35-39,1958,0.42498591537816743
STAT,1939,18,25-29,1957,87.58786285098006
SIM,1883,30,30-34,1913,44
STAT,1889,46,40-44,1935,0.42753828807658845
SIM,1924,19,35-39,1943,12
STAT,1787,79,na,1866,529.233493373745
SIM,1914,52,na,1966,7326
SIM,1916,17,35-39,1933,4
STAT,1864,15,45-49,1879,0.13565175155713602
STAT,1861,37,20-24,1898,1.2958034504018432
SIM,1812,84,na,1896,274
STAT,1834,51,25-29,1885,0.004931143409203994
STAT,1869,19,45-49,1888,0.12808013173220692
STAT,1872,4,na,1876,5964.7159802746655
STAT,1856,43,25-29,1899,0.9934039787107006
SIM,1833,42,35-39,1875,5
SIM,1961,10,na,1971,10503
SIM,1891,21,25-29,1912,169
SIM,1915,37,na,1952,7748
SIM,1862,30,45-49,1892,4
STAT,1842,61,na,1903,2782.0515514930225
STAT,1857,60,na,1917,3002.276392700234
STAT,1892,33,35-39,1925,25.4961696539802
STAT,1870,41,35-39,1911,3.606777210835528
STAT,1866,74,na,1940,2068.0685020659275
SIM,1860,46,45-49,1906,1
SIM,1835,57,na,1892,2712
STAT,1842,53,25-29,1895,0.00518872970898286
SIM,1861,3,na,1864,5960
STAT,1872,47,25-29,1919,0.11636799767095608
STAT,1784,102,na,1886,0.14240169543856931
STAT,1775,112,na,1887,0.0011683751401345458
STAT,1942,21,40-44,1963,7.122462246159044
SIM,1809,54,na,1863,2366
SIM,1925,41,35-39,1966,2
SIM,1839,19,25-29,1858,13
STAT,1763,105,na,1868,0.018673543558883537
STAT,1818,79,na,1897,717.2420901428918
SIM,1828,68,na,1896,1839
STAT,1844,86,na,1930,358.3109611656322
SIM,1847,18,20-24,1865,24
SIM,1861,64,na,1925,3296
STAT,1876,18,40-44,1894,0.38105783931228804
STAT,1883,21,25-29,1904,113.93388391365494
SIM,1882,38,45-49,1920,7
SIM,1940,31,25-29,1971,22
STAT,1854,30,45-49,1884,2.7950237432226186
STAT,1924,22,na,1946,8700.30974567596
SIM,1867,44,50-100,1911,5
STAT,1881,41,na,1922,4532.142361390471
SIM,1918,49,50-100,1967,4
STAT,1840,46,50-100,1886,0.3621035608863482
SIM,1881,32,20-24,1913,5
SIM,1811,43,45-49,1854,2
SIM,1852,50,na,1902,3541
SIM,1888,41,20-24,1929,1
SIM,1822,84,na,1906,287
SIM,1785,87,na,1872,93
SIM,1939,27,30-34,1966,83
STAT,1839,18,20-24,1857,35.998568775663536
STAT,1866,28,25-29,1894,78.55036596760362
STAT,1870,34,45-49,1904,3.4280947316364214
STAT,1843,49,20-24,1892,0.016458837188813136
STAT,1903,43,15-19,1946,0.0027376947630636337
SIM,1889,4,na,1893,6704
SIM,1815,47,45-49,1862,1
STAT,1836,42,45-49,1878,2.3677870238186673
STAT,1853,45,15-19,1898,6.391895924906871E-4
SIM,1906,23,na,1929,6919
STAT,1881,41,45-49,1922,2.934782650201412
SIM,1824,30,25-29,1854,28
STAT,1956,7,na,1963,10502.700306150851
SIM,1864,82,na,1946,723
SIM,1876,63,na,1939,3923
STAT,1925,40,30-34,1965,0.313403793610568
SIM,1891,30,na,1921,6185
SIM,1887,19,20-24,1906,38
STAT,1874,52,na,1926,4428.864059856395
STAT,1828,79,na,1907,858.5401591309745
STAT,1912,41,na,1953,7277.850432659071
STAT,1858,45,na,1903,3577.5046608548487
SIM,1839,20,na,1859,3766
STAT,1873,32,20-24,1905,5.546828242985403
STAT,1906,41,25-29,1947,0.1318276354386628
SIM,1879,81,na,1960,1259
STAT,1905,6,na,1911,7630.122681913244
SIM,1949,16,35-39,1965,8
STAT,1927,40,na,1967,9431.678327475638
STAT,1896,16,50-100,1912,0.13095416995473552
SIM,1826,87,na,1913,147
STAT,1847,27,50-100,1874,1.1720322927424596
STAT,1916,31,40-44,1947,8.193012191396623
STAT,1807,54,35-39,1861,0.053850494843120184
STAT,1896,40,na,1936,6246.437688053141
SIM,1878,39,50-100,1917,5
STAT,1893,44,40-44,1937,0.39444136563149224
STAT,1848,45,40-44,1893,0.2835165165883684
STAT,1852,53,35-39,1905,0.013500897939548395
SIM,1944,26,50-100,1970,3
STAT,1812,48,30-34,1860,0.661025173673661
STAT,1851,32,35-39,1883,16.339638916903592
SIM,1882,15,na,1897,5279
STAT,1831,68,na,1899,1973.1293609974196
SIM,1882,45,35-39,1927,1
SIM,1848,75,na,1923,1420
STAT,1826,53,40-44,1879,0.019849458663562455
STAT,1867,19,35-39,1886,1.048524247258997
STAT,1929,16,30-34,1945,31.490108993762817
SIM,1839,24,20-24,1863,113
SIM,1896,51,na,1947,6045
STAT,1839,19,na,1858,4633.5440554108945
SIM,1938,32,na,1970,7715
STAT,1954,10,na,1964,9808.990505543406
STAT,1831,90,na,1921,101.79484845967815
STAT,1908,42,45-49,1950,0.31118638219786415
STAT,1898,15,20-24,1913,48.67875432516368
STAT,1950,17,35-39,1967,10.01975981369308
STAT,1909,35,15-19,1944,0.03707851953733045
SIM,1935,19,30-34,1954,44
SIM,1781,75,na,1856,716
STAT,1843,24,na,1867,3705.705139241442
STAT,1901,25,45-49,1926,3.1605342366775604
STAT,1905,44,15-19,1949,0.002763170752752855
SIM,1924,30,30-34,1954,51
STAT,1903,22,45-49,1925,2.0051916902134073
SIM,1855,77,na,1932,1300
SIM,1868,29,45-49,1897,2
STAT,1904,15,15-19,1919,17.282644354496483
STAT,1913,36,na,1949,7536.350195045067
SIM,1797,98,na,1895,1
STAT,1835,80,na,1915,801.1699471262683
SIM,1931,28,30-34,1959,132
STAT,1860,49,20-24,1909,0.019270070599608
STAT,1923,31,30-34,1954,36.615140398989176
STAT,1932,37,40-44,1969,4.062479418479677
SIM,1889,18,25-29,1907,15
STAT,1927,19,30-34,1946,30.439174340399735
SIM,1907,33,35-39,1940,26
STAT,1864,54,30-34,1918,0.0104506808510227
SIM,1876,32,25-29,1908,29
SIM,1851,27,50-100,1878,2
SIM,1945,22,15-19,1967,12
SIM,1903,28,25-29,1931,142
STAT,1868,32,25-29,1900,19.68143452624992
SIM,1875,19,35-39,1894,1
SIM,1909,43,na,1952,7057
SIM,1838,97,na,1935,6
STAT,1853,48,20-24,1901,0.018747853196571563
SIM,1920,25,20-24,1945,46
STAT,1911,41,35-39,1952,0.3905071476986712
STAT,1855,105,na,1960,0.11712788970037794
SIM,1883,22,15-19,1905,6
STAT,1903,47,15-19,1950,6.457972775012393E-4
SIM,1851,87,na,1938,200
STAT,1943,27,45-49,1970,3.7158291558615653
STAT,1900,61,na,1961,5509.344864163467
STAT,1835,29,na,1864,3599.026158938933
STAT,1801,102,na,1903,0.23239008496940652
SIM,1937,16,30-34,1953,24
SIM,1804,85,na,1889,120
SIM,1859,36,40-44,1895,12
STAT,1873,46,na,1919,4629.907485709319
STAT,1866,32,15-19,1898,0.26537381239757707
STAT,1844,65,na,1909,2729.1441681103347
SIM,1862,33,50-100,1895,2
SIM,1910,18,15-19,1928,18
SIM,1928,29,40-44,1957,14
SIM,1880,76,na,1956,2108
STAT,1848,79,na,1927,1146.327944136625
SIM,1900,16,35-39,1916,1
STAT,1902,18,15-19,1920,16.87712437519468
SIM,1943,25,15-19,1968,1
STAT,1935,22,50-100,1957,1.8099675268074564
SIM,1947,17,na,1964,8704
SIM,1848,17,25-29,1865,12
STAT,1830,25,50-100,1855,1.7764225331584105
STAT,1906,47,40-44,1953,0.282878263462669
SIM,1817,43,50-100,1860,4
SIM,1905,38,30-34,1943,8
STAT,1886,16,40-44,1902,0.3908965122711321
STAT,1787,109,na,1896,5.232869729966051E-4
STAT,1832,109,na,1941,9.275428073814251E-4
STAT,1912,25,20-24,1937,36.58621370492246
STAT,1934,32,45-49,1966,4.339711833501566
STAT,1896,39,na,1935,6218.818235340172
SIM,1925,37,45-49,1962,1
STAT,1841,31,50-100,1872,1.629804659428873
STAT,1900,1,na,1901,7625.647871190979
STAT,1838,51,50-100,1889,0.020738006234340134
STAT,1766,101,na,1867,0.15474603563752562
STAT,1927,39,25-29,1966,2.466704085561916
STAT,1929,36,25-29,1965,2.5550176808801064
SIM,1867,22,30-34,1889,42
STAT,1930,41,45-49,1971,0.4428878474194652
SIM,1840,31,50-100,1871,4
STAT,1937,22,15-19,1959,10.471274576774364
SIM,1941,9,na,1950,8373
SIM,1884,58,na,1942,4226
STAT,1826,44,na,1870,3162.7008895691447
STAT,1913,24,25-29,1937,187.24730519615423
SIM,1813,46,na,1859,2941
STAT,1885,79,na,1964,1951.253731378485
STAT,1922,45,50-100,1967,0.5271002480823643
SIM,1921,24,25-29,1945,240
STAT,1829,105,na,1934,0.03470128095343536
STAT,1936,33,50-100,1969,1.6212264771942428
STAT,1849,20,20-24,1869,133.70421994794535
STAT,1930,21,20-24,1951,288.5557969506282
SIM,1880,68,na,1948,3266
STAT,1923,40,15-19,1963,0.003633911658424513
STAT,1942,17,na,1959,7768.685766228422
SIM,1955,12,na,1967,10118
STAT,1951,9,na,1960,9449.949162162815
SIM,1911,22,45-49,1933,5
SIM,1906,34,30-34,1940,40
SIM,1850,46,na,1896,3654
STAT,1928,37,20-24,1965,0.6727301001779963
STAT,1900,40,20-24,1940,0.03120892689122984
STAT,1818,49,na,1867,2803.44540448419
STAT,1813,46,25-29,1859,0.36164742051628485
SIM,1923,21,25-29,1944,249
STAT,1933,36,45-49,1969,1.877220421325251
SIM,1845,21,40-44,1866,6
STAT,1805,50,na,1855,2696.676247597215
SIM,1900,32,40-44,1932,22
SIM,1835,31,25-29,1866,26
STAT,1914,22,20-24,1936,229.4724277408868
SIM,1868,21,35-39,1889,11
STAT,1822,54,na,1876,2618.369841796888
SIM,1880,44,na,1924,5047
SIM,1904,26,20-24,1930,36
SIM,1909,18,20-24,1927,47
SIM,1888,19,20-24,1907,38
SIM,1939,19,45-49,1958,4
STAT,1917,10,na,1927,8608.378029032376
STAT,1916,38,40-44,1954,3.0807007852622834
STAT,1838,20,45-49,1858,1.242204540333875
SIM,1909,29,30-34,1938,92
STAT,1887,15,45-49,1902,0.148235534382444
STAT,1894,22,25-29,1916,148.517832413446
STAT,1845,19,50-100,1864,0.09429628193307206
SIM,1905,36,35-39,1941,4
STAT,1948,16,40-44,1964,3.233495687865097
SIM,1922,22,20-24,1944,273
STAT,1852,52,na,1904,3413.471782970243
STAT,1827,85,na,1912,331.49278021534747
STAT,1880,37,25-29,1917,6.125702217987401
SIM,1905,25,25-29,1930,121
STAT,1917,37,45-49,1954,1.42992949733784
STAT,1837,21,40-44,1858,3.8304004938512506
STAT,1872,80,na,1952,1255.5899497391013
STAT,1934,34,40-44,1968,10.778524257077205
STAT,1770,115,na,1885,3.1877268707945446E-4
SIM,1891,38,50-100,1929,6
STAT,1915,21,25-29,1936,193.43368356561865
STAT,1916,30,30-34,1946,33.115060945252644
SIM,1924,38,40-44,1962,9
SIM,1830,26,na,1856,3444
STAT,1844,31,25-29,1875,19.986645586688766
STAT,1917,18,na,1935,8371.305346732668
STAT,1924,44,25-29,1968,0.17092704560955063
SIM,1901,55,na,1956,5965
STAT,1812,47,20-24,1859,0.08334650410827239
STAT,1856,25,50-100,1881,1.0478983470402639
SIM,1916,44,40-44,1960,1
STAT,1838,69,na,1907,1986.124944489706
SIM,1876,15,35-39,1891,1
SIM,1942,29,15-19,1971,2
STAT,1913,26,20-24,1939,36.868877847156696
STAT,1814,67,na,1881,1610.3290440073215
STAT,1946,19,40-44,1965,3.130843689855365
SIM,1921,37,30-34,1958,8
STAT,1845,18,45-49,1863,0.12647330366937545
STAT,1921,23,na,1944,8302.462777255701
STAT,1935,33,45-49,1968,4.394861982393729
STAT,1906,66,na,1972,5587.069355897181
STAT,1913,37,30-34,1950,3.6334438476506596
STAT,1896,30,35-39,1926,27.220150204984748
STAT,1918,46,20-24,1964,0.0238059066181221
SIM,1867,8,na,1875,5608
STAT,1867,31,50-100,1898,1.7400915503080574
STAT,1907,15,40-44,1922,0.5454450547015898
STAT,1929,43,na,1972,9697.378544622921
STAT,1942,28,40-44,1970,9.875471383044637
STAT,1851,11,na,1862,4519.837780607574
STAT,1942,20,30-34,1962,60.90434039736664
SIM,1867,0,na,1867,6961
SIM,1889,81,na,1970,2120
STAT,1864,85,na,1949,494.89748891251367
STAT,1922,47,25-29,1969,0.12304050288832559
SIM,1904,37,30-34,1941,5
SIM,1905,61,na,1966,6020
STAT,1946,23,na,1969,8203.878877700969
STAT,1889,40,45-49,1929,3.764589140359894
STAT,1940,26,35-39,1966,30.935971315595218
STAT,1868,75,na,1943,1978.1385488842664
SIM,1850,38,na,1888,3810
SIM,1915,27,35-39,1942,41
STAT,1875,77,na,1952,1797.3751711173627
STAT,1859,39,na,1898,3749.0912566976435
STAT,1924,43,40-44,1967,0.5997537082465767
STAT,1917,29,15-19,1946,1.4844038062317986
STAT,1955,6,na,1961,10538.32140771909
SIM,1843,76,na,1919,1337
STAT,1809,88,na,1897,122.0195711260269
STAT,1948,19,45-49,1967,1.1537228750203583
SIM,1849,26,30-34,1875,59
SIM,1906,21,25-29,1927,194
STAT,1784,71,na,1855,955.0484999999999
SIM,1884,6,na,1890,5700
SIM,1833,66,na,1899,2091
SIM,1857,20,20-24,1877,133
STAT,1859,25,35-39,1884,16.007315329903374
STAT,1904,31,20-24,1935,7.867484392807434
STAT,1859,31,na,1890,3851.645403649651
STAT,1863,44,na,1907,4030.8884213294805
SIM,1866,26,30-34,1892,51
SIM,1855,69,na,1924,2431
STAT,1930,41,15-19,1971,0.004086624023194383
SIM,1861,21,25-29,1882,124
SIM,1950,20,30-34,1970,90
SIM,1860,48,na,1908,3887
STAT,1928,35,25-29,1963,2.5170664059786376
STAT,1902,23,40-44,1925,5.92330061009902
SIM,1921,26,20-24,1947,45
SIM,1926,33,45-49,1959,1
SIM,1858,16,25-29,1874,14
STAT,1869,32,50-100,1901,1.793037146627419
SIM,1912,31,20-24,1943,4
STAT,1794,73,na,1867,1029.328617359003
STAT,1918,33,45-49,1951,3.3622564055872424
STAT,1819,98,na,1917,3.399197753852244
STAT,1759,96,na,1855,1.22436
STAT,1890,44,30-34,1934,2.7958562827013083
STAT,1909,43,45-49,1952,0.31267214422620015
STAT,1870,21,25-29,1891,113.85084976545667
STAT,1888,17,50-100,1905,0.11694680519562424
STAT,1899,23,50-100,1922,1.1249258123166446
SIM,1818,77,na,1895,758
STAT,1859,42,50-100,1901,1.6961441779950057
SIM,1776,96,na,1872,3
SIM,1907,36,50-100,1943,2
STAT,1853,21,25-29,1874,107.79104048648131
SIM,1838,29,50-100,1867,7
STAT,1851,21,15-19,1872,6.151387564717158
STAT,1920,18,50-100,1938,0.8465100358111705
STAT,1898,3,na,1901,7225.304390615047
STAT,1801,60,na,1861,2094.5355336140046
STAT,1892,49,na,1941,5570.532125587274
SIM,1930,24,50-100,1954,2
STAT,1840,53,30-34,1893,0.008454193931293368
STAT,1885,35,50-100,1920,2.4915666856094827
SIM,1912,15,15-19,1927,16
SIM,1896,4,na,1900,7332
STAT,1852,60,na,1912,3039.68247871304
SIM,1931,15,25-29,1946,139
STAT,1908,44,40-44,1952,0.461932836617266
SIM,1951,19,15-19,1970,115
STAT,1903,25,50-100,1928,1.851954980618182
SIM,1873,74,na,1947,2076
STAT,1808,47,na,1855,2650.327645025519
STAT,1907,27,35-39,1934,28.641516188412535
STAT,1858,26,30-34,1884,40.87981364602946
SIM,1889,46,50-100,1935,1
STAT,1907,43,40-44,1950,0.4602921276500285
STAT,1817,83,na,1900,400.41118187882637
STAT,1940,15,25-29,1955,88.916537526392
STAT,1919,45,25-29,1964,0.11672126305939333
STAT,1895,48,25-29,1943,0.084430454459759
STAT,1900,29,45-49,1929,3.0884200346755533
SIM,1800,95,na,1895,7
SIM,1932,27,35-39,1959,47
STAT,1923,28,30-34,1951,90.5055569072761
STAT,1920,47,15-19,1967,8.222002461033427E-4
STAT,1869,16,35-39,1885,1.0951101510109438
SIM,1931,26,35-39,1957,49
STAT,1823,53,30-34,1876,0.017355266319464484
STAT,1922,27,30-34,1949,89.52057556079859
STAT,1913,41,15-19,1954,0.0030427255513949926
STAT,1923,15,25-29,1938,103.21444754794936
STAT,1848,55,na,1903,3390.44491099153
STAT,1922,16,20-24,1938,317.57716225293666
STAT,1944,19,30-34,1963,26.471989749450135
SIM,1930,16,20-24,1946,368
STAT,1826,34,50-100,1860,2.4163020945480245
STAT,1879,18,15-19,1897,12.503756790992915
SIM,1875,16,30-34,1891,6
SIM,1862,44,20-24,1906,1
SIM,1831,67,na,1898,2075
SIM,1897,25,na,1922,6582
STAT,1871,31,na,1902,4807.7364497351455
SIM,1893,11,na,1904,6867
SIM,1931,31,30-34,1962,49
SIM,1898,21,20-24,1919,181
STAT,1834,21,15-19,1855,5.91565069134573
STAT,1924,27,35-39,1951,35.29496609939359
SIM,1857,49,50-100,1906,4
STAT,1923,26,35-39,1949,34.92087253019828
SIM,1842,21,15-19,1863,8
SIM,1878,40,35-39,1918,7
STAT,1812,52,na,1864,2689.0064000648117
STAT,1868,15,35-39,1883,1.0862069906145857
STAT,1771,117,na,1888,1.1323303098255451E-4
SIM,1930,27,30-34,1957,112
STAT,1923,38,na,1961,8792.234803671756
STAT,1934,29,15-19,1963,1.9163730394153207
SIM,1941,30,30-34,1971,42
STAT,1852,39,15-19,1891,0.08859894034526435
SIM,1856,94,na,1950,16
SIM,1852,80,na,1932,914
SIM,1899,17,25-29,1916,16
STAT,1933,17,35-39,1950,11.345690039572641
SIM,1924,33,35-39,1957,32
STAT,1922,44,15-19,1966,0.003547088938666663
SIM,1863,13,na,1876,4992
STAT,1909,23,na,1932,7144.862988385957
SIM,1919,37,20-24,1956,1
STAT,1772,94,na,1866,6.487338998651192
STAT,1917,34,40-44,1951,8.204590059212812
STAT,1867,16,30-34,1883,3.1001713514787177
STAT,1842,82,na,1924,694.6546420620513
STAT,1910,17,40-44,1927,0.559944893906977
SIM,1858,21,20-24,1879,144
SIM,1905,22,20-24,1927,209
STAT,1877,26,40-44,1903,6.303730165855129
SIM,1901,23,na,1924,6703
STAT,1872,29,na,1901,4809.401757663254
SIM,1914,31,30-34,1945,47
STAT,1894,49,20-24,1943,0.017194800897768068
STAT,1848,36,50-100,1884,2.096233114636099
STAT,1916,33,35-39,1949,18.973979349735473
STAT,1876,62,na,1938,3817.8739786156593
STAT,1946,16,30-34,1962,27.30900072230146
SIM,1914,28,30-34,1942,100
STAT,1880,34,20-24,1914,5.7017174605015795
STAT,1907,48,40-44,1955,0.283056027073392
STAT,1936,29,25-29,1965,127.11776812566215
SIM,1858,32,30-34,1890,32
STAT,1914,53,na,1967,7203.224537272744
STAT,1934,3,na,1937,11081.725553788705
SIM,1801,69,na,1870,1422
SIM,1925,34,40-44,1959,14
STAT,1931,22,20-24,1953,291.27419326946665
STAT,1887,40,35-39,1927,4.131525028449379
STAT,1933,30,30-34,1963,42.933764085854605
SIM,1911,19,15-19,1930,16
SIM,1820,48,50-100,1868,1
SIM,1954,16,30-34,1970,39
STAT,1797,78,na,1875,618.1436877681558
STAT,1863,36,na,1899,4185.180629771937
SIM,1862,79,na,1941,1302
STAT,1906,19,40-44,1925,0.5353868452024745
SIM,1928,8,na,1936,10315
STAT,1920,38,na,1958,8308.843696343236
SIM,1915,48,40-44,1963,1
STAT,1921,15,15-19,1936,104.93677825921247
STAT,1813,43,20-24,1856,1.1073216614825037
STAT,1907,40,30-34,1947,0.23937137781078316
SIM,1835,49,na,1884,3122
SIM,1888,3,na,1891,6172
SIM,1931,34,35-39,1965,31
STAT,1843,15,30-34,1858,2.887173999022927
STAT,1919,47,20-24,1966,0.024203017808491708
SIM,1869,69,na,1938,2761
SIM,1941,17,35-39,1958,14
STAT,1942,26,45-49,1968,3.6637412608483646
STAT,1906,58,na,1964,6187.272024272256
SIM,1856,36,50-100,1892,3
SIM,1916,45,na,1961,7761
STAT,1842,50,na,1892,3251.7338531905566
STAT,1927,28,na,1955,9164.05857721834
SIM,1907,30,30-34,1937,34
SIM,1895,10,na,1905,7250
STAT,1842,53,40-44,1895,0.015422057866202939
SIM,1851,15,30-34,1866,4
STAT,1789,94,na,1883,8.853744411684152
STAT,1901,42,35-39,1943,0.35509438742465843
SIM,1879,29,20-24,1908,28
SIM,1894,36,na,1930,6403
STAT,1923,34,35-39,1957,21.123969333105297
STAT,1879,23,40-44,1902,4.388396303903151
STAT,1902,44,na,1946,6523.642234671754
STAT,1868,67,na,1935,3046.0378993333375
SIM,1849,35,50-100,1884,4
STAT,1903,19,15-19,1922,16.97365401219602
SIM,1913,32,20-24,1945,5
STAT,1851,67,na,1918,2457.377135755437
STAT,1846,40,50-100,1886,1.680274276989438
STAT,1943,24,40-44,1967,7.219678585723124
STAT,1896,41,50-100,1937,0.19650012214867907
SIM,1907,38,40-44,1945,5
SIM,1844,25,40-44,1869,9
SIM,1818,69,na,1887,1572
STAT,1838,22,40-44,1860,3.658970613677438
STAT,1933,38,40-44,1971,4.114282543243671
SIM,1904,24,25-29,1928,183
SIM,1902,41,35-39,1943,1
STAT,1855,57,na,1912,3030.391672693546
SIM,1924,40,na,1964,9311
SIM,1888,28,50-100,1916,1
STAT,1837,40,50-100,1877,1.7830057113218063
SIM,1885,26,40-44,1911,8
SIM,1904,21,15-19,1925,9
STAT,1939,26,40-44,1965,9.468776141852102
STAT,1860,4,na,1864,5041.73749057366
STAT,1870,48,20-24,1918,0.023494956380475208
STAT,1871,95,na,1966,97.71947679613578
SIM,1854,28,na,1882,4177
STAT,1905,32,20-24,1937,4.533333215634891
STAT,1860,79,na,1939,1146.5905216573503
SIM,1869,25,45-49,1894,4
SIM,1845,40,50-100,1885,4
SIM,1916,23,35-39,1939,27
SIM,1933,20,30-34,1953,107
SIM,1870,38,20-24,1908,4
STAT,1877,0,na,1877,7657.039730469543
STAT,1916,36,45-49,1952,1.4167106497611899
STAT,1817,110,na,1927,2.787216239842747E-4
STAT,1906,42,50-100,1948,0.21563501211123653
STAT,1897,24,na,1921,6344.814511976442
SIM,1875,1,na,1876,6995
SIM,1869,22,35-39,1891,18
SIM,1941,30,50-100,1971,2
STAT,1884,38,na,1922,4675.15135857538
STAT,1902,21,45-49,1923,1.9943080599030676
STAT,1913,41,45-49,1954,0.32975535848100085
STAT,1830,49,35-39,1879,0.2354921116182462
SIM,1933,25,na,1958,10505
STAT,1937,27,20-24,1964,35.94385300078266
SIM,1905,33,30-34,1938,9
STAT,1942,18,50-100,1960,0.7905031329433337
STAT,1899,27,30-34,1926,69.68180840124825
SIM,1846,22,40-44,1868,2
STAT,1880,24,na,1904,5000.313564717487
SIM,1838,28,20-24,1866,24
STAT,1849,23,25-29,1872,108.69283068838288
STAT,1908,8,na,1916,7793.153032580106
SIM,1901,33,40-44,1934,16
STAT,1880,16,na,1896,5386.608639061371
SIM,1915,15,40-44,1930,1
SIM,1910,21,45-49,1931,4
SIM,1903,8,na,1911,7692
STAT,1850,26,na,1876,3931.5298840633895
STAT,1827,31,25-29,1858,26.6224478249432
STAT,1919,35,50-100,1954,0.9158453870757791
SIM,1928,26,30-34,1954,118
STAT,1885,47,na,1932,4501.76057395906
SIM,1863,3,na,1866,5638
SIM,1886,22,40-44,1908,5
SIM,1926,30,40-44,1956,13
SIM,1924,36,45-49,1960,3
STAT,1930,6,na,1936,10465.158387633486
STAT,1804,100,na,1904,0.7141886740944005
STAT,1924,12,na,1936,9526.78742630045
STAT,1798,63,na,1861,1671.9601620821618
SIM,1859,59,na,1918,3439
SIM,1934,10,na,1944,10768
SIM,1907,5,na,1912,7898
SIM,1941,12,na,1953,8339
SIM,1908,58,na,1966,6253
STAT,1904,34,25-29,1938,16.902407428678906
STAT,1923,23,30-34,1946,67.3091407010456
STAT,1921,18,25-29,1939,99.4763429330754
SIM,1814,87,na,1901,140
STAT,1911,29,20-24,1940,35.705711559637415
STAT,1924,41,20-24,1965,0.042474563357225395
STAT,1857,9,na,1866,4507.740694327824
SIM,1852,9,na,1861,4826
STAT,1843,110,na,1953,3.8709928851653533E-4
STAT,1862,38,20-24,1900,1.3240403293683662
STAT,1875,50,50-100,1925,0.03185521358390561
STAT,1878,22,40-44,1900,4.395379401031204
SIM,1870,22,50-100,1892,1
SIM,1857,23,25-29,1880,4
STAT,1827,93,na,1920,35.34035107511279
STAT,1830,100,na,1930,1.4660077233174607
SIM,1801,80,na,1881,454
SIM,1912,34,25-29,1946,24
STAT,1791,73,na,1864,996.9728326020758
STAT,1862,22,50-100,1884,0.7206035666426696
STAT,1897,19,20-24,1916,47.604019599394704
SIM,1868,95,na,1963,39
STAT,1809,107,na,1916,0.004191605524945331
STAT,1936,26,15-19,1962,1.3653627461862166
STAT,1891,27,50-100,1918,1.5969166253698865
STAT,1932,34,30-34,1966,42.2479708440107
SIM,1794,93,na,1887,16
SIM,1876,31,na,1907,5149
STAT,1905,18,40-44,1923,0.5328200601161232
STAT,1908,23,35-39,1931,17.440069065899486
SIM,1914,47,40-44,1961,1
STAT,1918,30,40-44,1948,8.46453738693848
STAT,1940,24,15-19,1964,10.945118901757084
STAT,1842,39,na,1881,3667.4127469366063
STAT,1886,30,50-100,1916,1.9690844664829612
STAT,1855,48,30-34,1903,0.1441339544211762
SIM,1905,44,35-39,1949,1
STAT,1876,22,30-34,1898,37.20736097578451
STAT,1901,35,na,1936,6777.540270143475
SIM,1849,29,35-39,1878,16
STAT,1822,62,na,1884,2158.0705793285783
STAT,1830,49,na,1879,3250.186154223382
SIM,1802,54,na,1856,2354
STAT,1853,38,50-100,1891,1.9329014083210145
STAT,1898,37,50-100,1935,3.355528684871031
SIM,1883,33,na,1916,4902
SIM,1918,39,25-29,1957,3
STAT,1836,25,40-44,1861,5.229676438126297
STAT,1893,74,na,1967,3547.867937556133
STAT,1832,46,35-39,1878,0.2185743821481671
SIM,1840,46,35-39,1886,1
SIM,1904,29,25-29,1933,142
SIM,1931,23,30-34,1954,86
SIM,1873,66,na,1939,3310
SIM,1825,79,na,1904,688
SIM,1820,48,na,1868,2775
SIM,1900,37,40-44,1937,7
SIM,1938,15,50-100,1953,1
SIM,1915,40,30-34,1955,1
SIM,1928,32,50-100,1960,2
STAT,1893,34,na,1927,6056.365327435174
STAT,1918,49,25-29,1967,0.1133168483704303
STAT,1829,30,45-49,1859,3.541706852512613
STAT,1877,46,50-100,1923,0.5165244108265001
STAT,1884,16,30-34,1900,3.1864134813212597
SIM,1865,79,na,1944,1181
SIM,1902,27,50-100,1929,2
STAT,1935,25,15-19,1960,1.9455469853168883
SIM,1821,57,na,1878,2389
STAT,1827,45,50-100,1872,0.4555556809225994
SIM,1828,36,na,1864,3448
SIM,1911,19,20-24,1930,47
SIM,1939,28,50-100,1967,2
SIM,1874,49,45-49,1923,1
SIM,1882,17,25-29,1899,15
SIM,1885,46,50-100,1931,1
STAT,1856,18,20-24,1874,32.472644264194216
SIM,1936,16,15-19,1952,85
SIM,1868,44,na,1912,4385
SIM,1887,23,40-44,1910,5
STAT,1882,82,na,1964,1431.5281333180005
SIM,1847,26,na,1873,3924
SIM,1932,24,30-34,1956,99
SIM,1935,33,50-100,1968,1
STAT,1870,46,na,1916,4473.711334032502
STAT,1919,42,20-24,1961,0.03864381051395498
SIM,1910,26,45-49,1936,2
STAT,1924,24,30-34,1948,68.04658032338835
STAT,1895,45,20-24,1940,0.017991099168388244
STAT,1902,26,45-49,1928,3.1767229426525527
STAT,1873,47,35-39,1920,0.28594850670739624
SIM,1898,24,25-29,1922,173
STAT,1926,40,40-44,1966,0.6243760572260117
STAT,1911,39,50-100,1950,0.8109996009997886
STAT,1928,16,15-19,1944,115.75669562534438
STAT,1854,47,25-29,1901,0.08788840709265316
STAT,1828,54,20-24,1882,0.001122742877931204
SIM,1930,19,25-29,1949,138
STAT,1804,57,na,1861,2111.8484711187484
STAT,1826,49,15-19,1875,7.762447652423824E-4
STAT,1927,33,50-100,1960,2.0524758045980915
STAT,1914,34,15-19,1948,0.2590511208699808
STAT,1922,19,25-29,1941,100.71827462220972
SIM,1909,51,na,1960,6807
SIM,1891,20,na,1911,6154
STAT,1870,36,50-100,1906,2.446118716905358
STAT,1909,24,50-100,1933,1.2280260639549039
SIM,1805,59,na,1864,2069
SIM,1864,18,20-24,1882,35
STAT,1903,19,20-24,1922,50.70610559112562
STAT,1862,15,40-44,1877,0.36590051493886905
SIM,1870,49,50-100,1919,2
SIM,1839,39,na,1878,3458
SIM,1894,30,50-100,1924,6
STAT,1866,49,45-49,1915,0.43059891797769956
SIM,1925,14,na,1939,9651
SIM,1917,24,50-100,1941,6
SIM,1892,16,30-34,1908,8
STAT,1918,49,50-100,1967,0.48317045409916176
SIM,1846,41,na,1887,3614
STAT,1856,42,na,1898,3597.0234330715857
STAT,1874,17,25-29,1891,11.718311687967647
STAT,1885,87,na,1972,928.641507477127
STAT,1780,81,na,1861,364.7870182551369
STAT,1920,31,35-39,1951,20.293620211336588
SIM,1938,32,25-29,1970,21
STAT,1935,15,na,1950,10211.477537852912
STAT,1877,36,na,1913,4964.637460948703
STAT,1942,23,35-39,1965,19.932519084900576
STAT,1903,61,na,1964,5770.528397798192
SIM,1911,14,na,1925,8112
SIM,1896,29,20-24,1925,40
SIM,1871,34,20-24,1905,8
SIM,1929,37,35-39,1966,11
STAT,1924,20,na,1944,8752.220748461372
STAT,1910,33,40-44,1943,7.591226797386537
STAT,1867,21,20-24,1888,131.8262560140748
STAT,1821,77,na,1898,958.1321247336531
SIM,1866,61,na,1927,3615
SIM,1856,54,na,1910,3489
SIM,1946,23,20-24,1969,254
STAT,1894,44,50-100,1938,0.18776151660373763
SIM,1944,26,20-24,1970,43
STAT,1814,43,50-100,1857,5.886210111423991
STAT,1825,108,na,1933,0.002119369625145365
SIM,1938,1,na,1939,8212
STAT,1842,111,na,1953,1.597981365522066E-4
STAT,1914,13,na,1927,8239.319042700592
SIM,1911,18,30-34,1929,6
STAT,1843,18,35-39,1861,0.9764853618775996
STAT,1912,40,45-49,1952,0.32794451719312206
STAT,1925,26,45-49,1951,4.134349246427132
SIM,1821,97,na,1918,4
STAT,1860,39,50-100,1899,1.9933338444436564
STAT,1938,23,20-24,1961,222.22118833973323
STAT,1938,29,50-100,1967,1.989897852202114
SIM,1877,24,na,1901,4849
SIM,1853,49,50-100,1902,2
STAT,1867,32,30-34,1899,33.02373897922816
SIM,1843,41,25-29,1884,4
STAT,1883,46,40-44,1929,0.340672094282583
SIM,1847,18,15-19,1865,9
SIM,1829,38,20-24,1867,4
STAT,1829,32,40-44,1861,8.318588597184783
SIM,1841,39,50-100,1880,5
STAT,1873,14,na,1887,5334.467529357328
SIM,1844,28,45-49,1872,1
SIM,1828,47,na,1875,3063
SIM,1863,22,40-44,1885,3
STAT,1785,88,na,1873,97.91722724922346
SIM,1940,27,na,1967,7929
STAT,1897,48,35-39,1945,0.21051639695664015
STAT,1860,47,na,1907,3672.722612453054
SIM,1822,42,na,1864,3043
SIM,1926,3,na,1929,10250
SIM,1929,26,25-29,1955,211
STAT,1763,103,na,1866,0.047549825755927005
STAT,1781,74,na,1855,842.26182
STAT,1854,24,45-49,1878,1.238048227481885
STAT,1854,33,50-100,1887,1.4235292587333217
STAT,1871,21,40-44,1892,4.193817117858302
SIM,1837,30,45-49,1867,6
STAT,1836,20,35-39,1856,12.458097018330307
STAT,1836,106,na,1942,0.01614338650202217
SIM,1845,47,25-29,1892,1
STAT,1816,111,na,1927,1.054275944091555E-4
SIM,1921,21,15-19,1942,14
STAT,1839,18,15-19,1857,12.0503683769257
STAT,1931,37,25-29,1968,2.633648430055081
STAT,1890,47,40-44,1937,0.23695285437239155
STAT,1882,50,na,1932,4297.0100007982555
STAT,1824,96,na,1920,9.18030444055286
SIM,1858,66,na,1924,2754
STAT,1933,33,35-39,1966,24.85908611377529
STAT,1798,110,na,1908,1.495957404103139E-4
STAT,1907,24,30-34,1931,52.54231501511328
STAT,1928,39,40-44,1967,3.8121721325572744
SIM,1849,92,na,1941,38
STAT,1886,64,na,1950,3706.080299011361
SIM,1779,93,na,1872,5
STAT,1896,21,45-49,1917,1.8649715455828342
STAT,1785,100,na,1885,0.47409956634886585
STAT,1854,44,20-24,1898,0.24017212693251835
SIM,1862,24,45-49,1886,2
SIM,1889,31,20-24,1920,9
STAT,1840,45,50-100,1885,0.3667725757759765
STAT,1855,22,40-44,1877,3.670924191219169
STAT,1837,47,25-29,1884,0.08335570434579231
SIM,1844,20,35-39,1864,13
STAT,1855,17,15-19,1872,10.643839538972108
STAT,1926,24,40-44,1950,8.196830830939929
STAT,1937,19,na,1956,7211.766529714758
SIM,1859,33,30-34,1892,39
SIM,1842,59,na,1901,2753
STAT,1856,44,30-34,1900,1.76727336176506
STAT,1902,39,20-24,1941,0.46963499003535625
SIM,1828,44,na,1872,3163
STAT,1816,41,15-19,1857,0.07921115307307436
STAT,1907,43,35-39,1950,0.37056518938851135
STAT,1937,25,25-29,1962,129.7196479361682
STAT,1900,18,na,1918,7057.261462462018
SIM,1915,24,30-34,1939,78
SIM,1810,49,na,1859,2729
SIM,1875,46,na,1921,5073
STAT,1842,45,40-44,1887,0.2615441446784896
STAT,1864,1,na,1865,6514.907760266025
SIM,1913,33,50-100,1946,1
STAT,1947,16,25-29,1963,98.6098315216476
STAT,1859,102,na,1961,1.2932373183371875
SIM,1824,39,50-100,1863,4
SIM,1847,18,na,1865,4384
STAT,1835,41,25-29,1876,1.0098429709385783
SIM,1879,28,na,1907,4875
STAT,1856,21,45-49,1877,1.2711011349234316
SIM,1864,21,45-49,1885,6
SIM,1843,36,na,1879,3664
SIM,1955,16,25-29,1971,141
STAT,1841,19,50-100,1860,0.09060260616467264
SIM,1818,37,na,1855,3248
SIM,1862,2,na,1864,6000
SIM,1864,44,30-34,1908,3
SIM,1909,25,15-19,1934,2
STAT,1866,23,25-29,1889,106.77486943029838
SIM,1850,45,40-44,1895,1
SIM,1902,44,45-49,1946,1
STAT,1841,89,na,1930,152.42529328928504
SIM,1837,32,40-44,1869,8
SIM,1902,7,na,1909,7669
STAT,1800,83,na,1883,296.14374025080707
STAT,1896,23,40-44,1919,5.539157824145303
STAT,1938,34,30-34,1972,31.958489114986257
STAT,1877,29,45-49,1906,2.3118392094718336
STAT,1901,33,50-100,1934,2.579632088806575
SIM,1818,38,45-49,1856,4
STAT,1896,15,50-100,1911,0.1312402737515138
SIM,1830,33,20-24,1863,6
STAT,1841,36,35-39,1877,12.217226271341582
SIM,1933,26,45-49,1959,7
STAT,1957,15,na,1972,9804.612344771762
STAT,1802,85,na,1887,198.7735613574687
SIM,1875,21,20-24,1896,149
SIM,1885,21,35-39,1906,13
SIM,1863,20,45-49,1883,3
STAT,1905,47,25-29,1952,0.09445723163856798
STAT,1851,99,na,1950,2.93583975315306
STAT,1888,29,20-24,1917,27.8035903187266
STAT,1910,31,45-49,1941,3.0779454649977325
STAT,1828,34,45-49,1862,3.681477351277458
STAT,1883,13,na,1896,5116.461267247331
STAT,1864,44,50-100,1908,1.881478695512435
STAT,1774,115,na,1889,2.799300923711159E-4
STAT,1832,31,50-100,1863,1.574036832836775
STAT,1883,38,50-100,1921,2.4240938364366906
SIM,1844,31,50-100,1875,2
SIM,1899,56,na,1955,5681
STAT,1922,32,20-24,1954,5.564472491056455
SIM,1904,28,40-44,1932,7
STAT,1834,95,na,1929,17.668944390869605
STAT,1762,104,na,1866,0.07301296017462221
SIM,1845,48,na,1893,3642
SIM,1849,17,40-44,1866,1
SIM,1857,25,na,1882,4441
STAT,1822,33,20-24,1855,14.919463852203533
STAT,1920,19,15-19,1939,102.25861642912754
SIM,1853,11,na,1864,4828
SIM,1930,32,20-24,1962,5
STAT,1845,31,40-44,1876,8.028577173463175
SIM,1900,30,na,1930,7015
SIM,1934,24,40-44,1958,13
STAT,1906,44,30-34,1950,0.23177949841280393
STAT,1936,26,20-24,1962,35.30437929688681
STAT,1939,29,45-49,1968,3.504542147376621
SIM,1885,29,45-49,1914,5
SIM,1884,22,30-34,1906,44
STAT,1921,34,25-29,1955,20.59018391511167
SIM,1911,22,na,1933,7364
STAT,1867,45,45-49,1912,0.45082638460582214
STAT,1862,18,45-49,1880,0.12838320436785194
STAT,1895,25,45-49,1920,2.9417307960208876
SIM,1823,43,30-34,1866,2
STAT,1906,26,35-39,1932,28.493706525523955
STAT,1861,31,25-29,1892,17.288267102255492
STAT,1909,31,na,1940,7322.758609103247
STAT,1921,15,20-24,1936,313.48202072346544
STAT,1886,61,na,1947,3983.8237197157255
SIM,1859,20,25-29,1879,130
SIM,1890,34,30-34,1924,63
SIM,1898,30,50-100,1928,3
STAT,1952,17,45-49,1969,1.2089134328706386
SIM,1859,31,35-39,1890,30
STAT,1906,31,25-29,1937,17.379081657702795
STAT,1900,43,25-29,1943,0.12402952583671804
SIM,1881,21,na,1902,4053
STAT,1892,6,na,1898,6604.812245323875
SIM,1864,25,50-100,1889,2
SIM,1874,23,25-29,1897,125
STAT,1858,14,na,1872,4350.66466516532
STAT,1895,18,50-100,1913,0.12859073193574272
STAT,1908,29,50-100,1937,1.8879947621398032
STAT,1928,13,na,1941,10065.961298971686
SIM,1928,29,35-39,1957,55
STAT,1855,20,45-49,1875,1.2462627276940215
SIM,1836,34,45-49,1870,4
SIM,1849,31,20-24,1880,6
SIM,1881,61,na,1942,3152
STAT,1911,32,45-49,1943,3.0955471308588063
STAT,1835,21,30-34,1856,30.90149924171973
STAT,1848,47,na,1895,3671.8815324164816
STAT,1867,90,na,1957,188.7251128046349
SIM,1865,22,50-100,1887,2
SIM,1875,45,45-49,1920,1
SIM,1916,53,na,1969,7553
STAT,1953,1,na,1954,9816.076667331527
SIM,1928,25,25-29,1953,189
SIM,1843,21,30-34,1864,43
SIM,1853,43,na,1896,3786
SIM,1939,16,40-44,1955,3
SIM,1842,51,na,1893,3121
SIM,1945,25,25-29,1970,152
SIM,1932,16,na,1948,9951
STAT,1883,32,15-19,1915,0.2825757554907073
STAT,1835,40,na,1875,3347.2243537209206
STAT,1822,36,25-29,1858,12.03271508477822
STAT,1886,72,na,1958,2882.798180507099
SIM,1849,42,30-34,1891,3
STAT,1925,44,40-44,1969,0.6094291118978102
SIM,1921,24,na,1945,8256
STAT,1905,44,20-24,1949,0.031776461940383506
SIM,1943,18,20-24,1961,308
STAT,1914,21,na,1935,7580.0557954503
SIM,1901,15,na,1916,7231
SIM,1914,15,25-29,1929,22
STAT,1925,39,15-19,1964,0.04644010104792886
STAT,1935,18,20-24,1953,373.40473711600157
STAT,1879,30,35-39,1909,21.565156715800093
SIM,1887,30,35-39,1917,37
STAT,1922,24,50-100,1946,1.5139949057211037
SIM,1859,15,35-39,1874,2
SIM,1914,26,35-39,1940,34
SIM,1853,14,na,1867,4750
STAT,1857,83,na,1940,624.935710206226
SIM,1835,92,na,1927,47
SIM,1887,24,50-100,1911,1
SIM,1914,31,25-29,1945,25
STAT,1906,15,25-29,1921,16.7543487977297
SIM,1857,28,na,1885,4330
STAT,1853,77,na,1930,1367.6425131411283
STAT,1920,34,45-49,1954,3.450425367187518
SIM,1862,28,na,1890,4360
STAT,1783,78,na,1861,519.1745872881636
STAT,1937,27,na,1964,7376.554156441626
STAT,1836,28,45-49,1864,1.8969214364704379
STAT,1898,43,15-19,1941,0.0026020509897079704
STAT,1926,43,45-49,1969,0.41364746165144656
SIM,1807,85,na,1892,178
SIM,1918,23,45-49,1941,2
SIM,1845,21,35-39,1866,17
STAT,1845,49,50-100,1894,0.3705519757228364
STAT,1836,22,30-34,1858,31.262719973915537
STAT,1901,34,35-39,1935,28.387808556785377
STAT,1914,41,30-34,1955,0.25625883963367474
SIM,1840,17,20-24,1857,25
STAT,1935,29,30-34,1964,107.78318851190916
STAT,1951,16,45-49,1967,1.2016262381759764
SIM,1834,44,45-49,1878,5
STAT,1932,16,35-39,1948,11.250068065549053
STAT,1801,68,na,1869,1554.3215500019955
STAT,1847,23,15-19,1870,6.120604192224127
STAT,1844,54,na,1898,3381.5605293682656
STAT,1911,18,50-100,1929,0.15106253059677197
STAT,1901,23,25-29,1924,161.35433721120046
STAT,1872,22,40-44,1894,4.229591212472416
STAT,1895,46,na,1941,5938.663772915421
SIM,1891,46,40-44,1937,1
SIM,1937,19,35-39,1956,9
STAT,1914,38,30-34,1952,3.657554909192028
STAT,1884,19,35-39,1903,1.0884060719776776
STAT,1894,6,na,1900,6777.49145337762
SIM,1940,16,35-39,1956,8
STAT,1941,27,40-44,1968,9.738419414765215
SIM,1874,46,40-44,1920,2
SIM,1922,38,30-34,1960,8
STAT,1837,21,35-39,1858,10.72662008598209
SIM,1894,28,na,1922,6413
SIM,1908,34,40-44,1942,10
STAT,1783,89,na,1872,63.969292192781595
STAT,1948,19,50-100,1967,0.8652921562652686
SIM,1890,35,na,1925,6230
STAT,1869,35,45-49,1904,3.938182479824433
SIM,1899,33,30-34,1932,71
SIM,1890,46,na,1936,5962
STAT,1875,24,50-100,1899,0.8426313796483641
SIM,1848,30,20-24,1878,6
SIM,1899,20,25-29,1919,180
STAT,1828,70,na,1898,1723.0532157687653
STAT,1861,36,50-100,1897,2.073779294491526
STAT,1921,27,50-100,1948,2.239861355946138
SIM,1807,74,na,1881,804
STAT,1815,43,30-34,1858,6.693312088079706
STAT,1866,46,40-44,1912,0.3199335069643262
SIM,1844,22,30-34,1866,40
SIM,1892,19,35-39,1911,6
STAT,1878,48,25-29,1926,0.11996912025366409
SIM,1877,35,45-49,1912,5
STAT,1946,19,35-39,1965,9.392530525749748
SIM,1821,100,na,1921,1
STAT,1898,30,45-49,1928,4.80432897852413
SIM,1952,19,30-34,1971,45
STAT,1912,37,15-19,1949,0.037863401239809184
STAT,1832,29,na,1861,3675.2795418662668
SIM,1907,33,40-44,1940,10
STAT,1901,22,35-39,1923,16.499055428150054
SIM,1899,22,20-24,1921,185
STAT,1903,69,na,1972,5034.6425596179715
STAT,1852,21,30-34,1873,33.96917650464395
SIM,1860,21,30-34,1881,44
SIM,1919,35,25-29,1954,3
SIM,1935,35,na,1970,10975
STAT,1840,59,na,1899,2805.2745688607247
STAT,1842,31,15-19,1873,0.25879708951018077
SIM,1821,89,na,1910,100
STAT,1882,34,30-34,1916,34.05609736303071
STAT,1831,47,30-34,1878,0.1481328968042506
STAT,1925,42,45-49,1967,0.4068602736122781
SIM,1854,9,na,1863,4929
STAT,1925,23,40-44,1948,8.101621152898842
STAT,1838,77,na,1915,1169.8398972627892
SIM,1941,20,na,1961,7738
SIM,1792,67,na,1859,1459
STAT,1932,30,15-19,1962,0.3454246687926049
STAT,1863,37,25-29,1900,5.0901346178846865
SIM,1852,18,na,1870,4522
STAT,1898,18,25-29,1916,15.447088313484375
SIM,1929,34,30-34,1963,58
SIM,1920,28,25-29,1948,167
STAT,1854,21,40-44,1875,3.780513433090427
STAT,1821,37,na,1858,3159.745882190994
STAT,1929,19,35-39,1948,10.756302042081012
STAT,1894,9,na,1903,6731.507834383064
STAT,1837,44,20-24,1881,0.23172577348936532
STAT,1931,34,20-24,1965,6.4468235069163
SIM,1923,37,40-44,1960,4
STAT,1825,31,15-19,1856,0.5600260228392087
SIM,1889,34,25-29,1923,39
STAT,1872,72,na,1944,2563.348948017843
SIM,1929,23,20-24,1952,292
SIM,1931,13,na,1944,10495
SIM,1934,27,45-49,1961,5
STAT,1804,97,na,1901,3.6140088755973876
STAT,1942,24,25-29,1966,195.46804471552946
SIM,1935,27,na,1962,10554
STAT,1795,66,na,1861,1642.1875375012696
STAT,1892,22,15-19,1914,8.34090892124481
STAT,1951,1,na,1952,9784.91546923483
SIM,1855,23,15-19,1878,7
STAT,1802,53,na,1855,2463.3479611022976
STAT,1857,29,50-100,1886,1.0223864194846988
STAT,1774,96,na,1870,2.2077478478900607
STAT,1823,54,50-100,1877,0.04316620060340598
STAT,1840,70,na,1910,2025.2539199527453
STAT,1912,28,25-29,1940,130.57283091620982
SIM,1920,50,na,1970,8319
SIM,1827,28,45-49,1855,3
STAT,1927,36,20-24,1963,0.6624236426618815
STAT,1920,22,45-49,1942,2.525712995763111
SIM,1864,47,35-39,1911,1
STAT,1813,93,na,1906,25.96970942953128
SIM,1875,24,25-29,1899,133
STAT,1841,33,30-34,1874,30.41877331819313
STAT,1940,28,30-34,1968,80.66203478505562
STAT,1885,32,25-29,1917,20.590668359339727
SIM,1854,92,na,1946,69
SIM,1880,36,na,1916,5265
SIM,1846,33,na,1879,3898
STAT,1826,44,45-49,1870,3.0356635368252687
STAT,1867,24,25-29,1891,107.59793295289548
SIM,1871,37,25-29,1908,9
STAT,1886,19,45-49,1905,0.13851698556051936
STAT,1900,36,50-100,1936,0.7459967881506578
STAT,1881,54,30-34,1935,0.011300321912041127
SIM,1844,85,na,1929,280
SIM,1833,31,15-19,1864,1
SIM,1848,99,na,1947,2
STAT,1845,22,50-100,1867,0.7800917209634359
SIM,1826,41,25-29,1867,3
SIM,1893,32,25-29,1925,38
STAT,1856,47,35-39,1903,0.21713602474940544
STAT,1883,49,45-49,1932,0.4585110092880455
STAT,1865,41,50-100,1906,1.947160549975181
STAT,1877,21,35-39,1898,12.274872264439022
STAT,1893,35,45-49,1928,5.151547457540915
SIM,1890,43,na,1933,6039
STAT,1835,34,50-100,1869,1.4804115581498267
STAT,1925,40,25-29,1965,0.1750543719221369
STAT,1940,31,30-34,1971,32.95324294522075
STAT,1827,29,na,1856,3433.63169399009
STAT,1866,20,20-24,1886,131.3449151779945
SIM,1925,4,na,1929,9856
SIM,1873,41,50-100,1914,3
STAT,1937,29,40-44,1966,9.168988284572633
SIM,1882,29,50-100,1911,1
SIM,1859,39,45-49,1898,7
SIM,1901,31,45-49,1932,5
SIM,1924,34,25-29,1958,29
STAT,1818,41,25-29,1859,3.2855381561063135
STAT,1922,35,25-29,1957,2.266000486386109
SIM,1896,24,15-19,1920,8
SIM,1920,39,na,1959,8473
STAT,1827,47,50-100,1874,0.44355037267062386
SIM,1817,52,na,1869,2650
STAT,1874,29,50-100,1903,1.3133748560125194
STAT,1918,29,30-34,1947,83.59964834662762
STAT,1842,48,45-49,1890,0.3469453457879046
STAT,1793,88,na,1881,92.3965109343895
STAT,1923,44,30-34,1967,0.300681935191586
STAT,1926,27,45-49,1953,4.181928718782009
STAT,1828,31,40-44,1859,10.02353857569832
SIM,1833,22,25-29,1855,117
STAT,1896,31,na,1927,6388.9302853030895
STAT,1908,39,15-19,1947,0.03597012534547258
STAT,1909,26,50-100,1935,1.9451670218889283
SIM,1885,23,30-34,1908,52
STAT,1932,21,25-29,1953,245.52886674449397
SIM,1917,26,50-100,1943,3
STAT,1857,42,15-19,1899,0.021712626659838776
STAT,1874,27,50-100,1901,1.3228293651186795
STAT,1918,18,20-24,1936,297.19486838624357
SIM,1930,35,25-29,1965,5
SIM,1835,47,50-100,1882,1
SIM,1830,36,25-29,1866,5
SIM,1862,21,40-44,1883,5
STAT,1897,56,na,1953,5506.281500694678
STAT,1918,25,15-19,1943,1.5273506241971246
SIM,1926,29,30-34,1955,106
STAT,1872,2,na,1874,6701.901260119302
STAT,1893,42,na,1935,5909.207762096892
SIM,1852,31,25-29,1883,24
STAT,1916,45,35-39,1961,0.26833104489550136
STAT,1863,34,20-24,1897,4.737825704598483
STAT,1912,43,na,1955,7192.731459581857
SIM,1874,20,20-24,1894,135
SIM,1868,26,40-44,1894,11
STAT,1877,23,30-34,1900,37.239748200821104
STAT,1911,45,20-24,1956,0.0212351253457729
SIM,1849,22,15-19,1871,7
SIM,1933,23,40-44,1956,14
SIM,1838,54,30-34,1892,1
SIM,1926,18,20-24,1944,328
STAT,1852,34,45-49,1886,2.8185104091679616
SIM,1850,48,45-49,1898,1
STAT,1928,32,15-19,1960,0.3244660997128345
STAT,1800,103,na,1903,0.12257924965220203
SIM,1854,84,na,1938,493
SIM,1904,49,50-100,1953,1
SIM,1926,25,15-19,1951,2
STAT,1897,45,30-34,1942,0.14887886094204078
SIM,1822,74,na,1896,1177
SIM,1864,34,20-24,1898,6
STAT,1839,62,na,1901,2853.871210167868
STAT,1906,40,15-19,1946,0.0028507105169509523
STAT,1921,31,20-24,1952,5.503142561267375
STAT,1916,34,25-29,1950,19.106780531515053
STAT,1915,37,40-44,1952,3.054443565048204
STAT,1825,59,na,1884,2403.2101716172624
SIM,1874,32,15-19,1906,1
SIM,1910,51,na,1961,7062
STAT,1888,24,15-19,1912,7.825686437719659
SIM,1903,25,20-24,1928,36
SIM,1860,34,45-49,1894,4
SIM,1839,27,25-29,1866,72
STAT,1839,21,45-49,1860,1.4091190496863766
STAT,1856,34,20-24,1890,4.1759424359343384
STAT,1938,26,25-29,1964,131.77714365774972
SIM,1907,17,na,1924,7697
STAT,1907,18,45-49,1925,0.1933928459074635
STAT,1946,18,50-100,1964,0.8389122608571431
SIM,1860,99,na,1959,4
SIM,1853,15,40-44,1868,1
STAT,1882,37,35-39,1919,13.915242189301189
SIM,1907,36,45-49,1943,2
SIM,1952,15,15-19,1967,107
SIM,1853,34,45-49,1887,4
SIM,1822,82,na,1904,406
SIM,1823,46,35-39,1869,1
SIM,1849,34,25-29,1883,22
SIM,1902,32,45-49,1934,1
SIM,1811,90,na,1901,50
SIM,1859,51,na,1910,3813
SIM,1905,29,40-44,1934,13
SIM,1807,82,na,1889,361
SIM,1914,23,30-34,1937,78
STAT,1815,46,35-39,1861,0.764283279166953
SIM,1879,90,na,1969,376
STAT,1836,31,50-100,1867,1.5562807407342718
STAT,1900,26,40-44,1926,8.421245931659511
SIM,1845,70,na,1915,2203
STAT,1906,23,30-34,1929,52.258575909249195
STAT,1893,49,50-100,1942,0.3472379029607467
SIM,1875,37,50-100,1912,4
STAT,1779,81,na,1860,336.56321035130395
SIM,1927,26,15-19,1953,5
STAT,1850,18,na,1868,4275.480545258713
SIM,1929,20,na,1949,9595
SIM,1940,21,25-29,1961,225
STAT,1907,7,na,1914,7733.641273495617
STAT,1911,16,45-49,1927,0.20244178785294084
STAT,1845,34,45-49,1879,3.129327172770578
SIM,1888,64,na,1952,4155
SIM,1924,3,na,1927,10128
SIM,1930,18,40-44,1948,7
STAT,1895,22,40-44,1917,5.483814997294888
STAT,1922,18,40-44,1940,3.259813832158722
SIM,1883,24,50-100,1907,1
STAT,1935,30,40-44,1965,10.948744231573627
STAT,1923,35,na,1958,8816.369679620682
SIM,1855,28,20-24,1883,20
STAT,1904,19,30-34,1923,4.595435405251285
STAT,1897,35,20-24,1932,2.1007796349835757
STAT,1881,42,50-100,1923,2.059740943943965
STAT,1913,28,na,1941,7513.972114932075
STAT,1852,24,35-39,1876,10.890644226614643
SIM,1836,31,40-44,1867,13
STAT,1839,104,na,1943,0.10414733471604926
STAT,1775,114,na,1889,4.5883878070151617E-4
SIM,1934,24,50-100,1958,2
STAT,1843,49,15-19,1892,5.486274237023965E-4
STAT,1919,26,15-19,1945,1.545480161699499
SIM,1887,18,15-19,1905,12
STAT,1902,65,na,1967,5380.4103827551035
STAT,1847,28,20-24,1875,21.339815176362773
STAT,1830,46,30-34,1876,0.16926981436312402
STAT,1878,45,20-24,1923,0.025563955014084202
SIM,1856,62,na,1918,3047
STAT,1816,39,50-100,1855,8.165700695837035
SIM,1858,23,40-44,1881,4
STAT,1815,40,50-100,1855,6.839403097235697
SIM,1930,23,15-19,1953,9
SIM,1867,42,25-29,1909,3
STAT,1913,21,15-19,1934,10.451676236849513
STAT,1834,55,na,1889,2764.7639017068036
SIM,1879,68,na,1947,3028
SIM,1953,16,15-19,1969,112
SIM,1846,17,15-19,1863,13
SIM,1848,33,25-29,1881,22
SIM,1931,19,40-44,1950,4
STAT,1869,32,40-44,1901,8.486691970478924
STAT,1943,8,na,1951,8467.984915028253
SIM,1806,89,na,1895,42
SIM,1865,17,25-29,1882,17
SIM,1823,40,50-100,1863,5
SIM,1891,49,45-49,1940,2
SIM,1888,19,15-19,1907,9
STAT,1757,112,na,1869,0.002524791510330539
STAT,1858,26,50-100,1884,1.0384643694685074
SIM,1955,15,50-100,1970,1
STAT,1860,45,35-39,1905,0.23190072618333307
SIM,1928,19,20-24,1947,333
STAT,1815,52,na,1867,2614.394435922374
SIM,1891,39,na,1930,6013
SIM,1933,27,50-100,1960,6
STAT,1862,51,na,1913,3734.584219056571
SIM,1832,52,na,1884,2940
SIM,1881,18,20-24,1899,23
STAT,1811,67,na,1878,1705.5991241856595
STAT,1871,98,na,1969,37.78065673505097
STAT,1857,17,25-29,1874,10.484716706794677
STAT,1874,39,na,1913,4822.925971660915
STAT,1873,18,20-24,1891,36.284625954008675
STAT,1896,71,na,1967,4204.012095201403
SIM,1958,5,na,1963,10844
SIM,1860,24,35-39,1884,12
SIM,1912,19,30-34,1931,7
SIM,1888,22,45-49,1910,2
SIM,1921,29,25-29,1950,167
SIM,1911,25,na,1936,7491
SIM,1851,48,50-100,1899,1
STAT,1871,24,45-49,1895,1.3904270592213959
STAT,1922,23,15-19,1945,12.287290962491348
STAT,1838,17,15-19,1855,10.609180157671027
STAT,1938,12,na,1950,7895.077349644371
SIM,1922,17,na,1939,9011
STAT,1903,18,30-34,1921,4.571262863825968
STAT,1923,19,40-44,1942,3.298227709065054
SIM,1890,37,35-39,1927,25
STAT,1845,15,40-44,1860,0.3604571732455716
STAT,1879,16,na,1895,5348.38870001312
STAT,1857,80,na,1937,973.7923834345024
STAT,1879,21,45-49,1900,1.4775232079225133
STAT,1923,24,15-19,1947,12.426724730661464
SIM,1902,29,15-19,1931,3
SIM,1919,39,40-44,1958,4
STAT,1841,23,20-24,1864,125.75442252727231
STAT,1871,47,30-34,1918,0.19332514064739031
STAT,1913,29,25-29,1942,131.5407066439318
SIM,1887,21,45-49,1908,1
STAT,1859,42,25-29,1901,1.0309896048698137
STAT,1872,25,45-49,1897,2.2689165718477207
SIM,1899,24,40-44,1923,6
STAT,1909,40,40-44,1949,0.4781050928226231
SIM,1878,33,40-44,1911,17
STAT,1914,44,35-39,1958,0.4017046610076368
STAT,1945,16,15-19,1961,100.14412645049192
SIM,1866,26,50-100,1892,3
STAT,1863,47,na,1910,3958.951725648554
SIM,1843,44,na,1887,3481
STAT,1849,32,na,1881,3977.5524936324746
SIM,1895,13,na,1908,7206
SIM,1877,32,40-44,1909,12
SIM,1928,22,20-24,1950,279
STAT,1910,15,45-49,1925,0.20090940812474836
SIM,1899,34,50-100,1933,2
STAT,1858,29,35-39,1887,15.328902234077933
SIM,1832,41,na,1873,3355
STAT,1925,27,50-100,1952,2.373826370485701
SIM,1866,29,35-39,1895,33
SIM,1931,24,15-19,1955,14
SIM,1825,36,50-100,1861,3
STAT,1872,48,30-34,1920,0.19401011753794276
STAT,1871,87,na,1958,470.9569786349076
STAT,1901,27,40-44,1928,8.46956450028569
STAT,1930,38,50-100,1968,1.1049047005797417
STAT,1794,70,na,1864,1367.8726431620837
STAT,1944,15,15-19,1959,98.68313178404185
STAT,1843,48,50-100,1891,0.33971794623460005
STAT,1811,78,na,1889,714.4731494441771
STAT,1800,75,na,1875,897.4149439966764
STAT,1908,23,40-44,1931,6.22772584722386
SIM,1762,93,na,1855,1
SIM,1903,29,30-34,1932,93
SIM,1879,82,na,1961,1163
STAT,1790,80,na,1870,466.0676566787701
SIM,1876,33,30-34,1909,44
STAT,1820,52,na,1872,2671.8734064584446
STAT,1887,35,20-24,1922,1.757724090939779
STAT,1856,17,30-34,1873,2.9367244322819226
STAT,1930,17,15-19,1947,118.49689019543392
STAT,1937,34,15-19,1971,0.2564871733573294
STAT,1823,101,na,1924,0.6847491338910942
SIM,1840,25,na,1865,4288
STAT,1850,54,50-100,1904,0.022519798256205106
STAT,1881,50,20-24,1931,0.0014611788998566443
SIM,1874,20,15-19,1894,7
SIM,1935,32,35-39,1967,39
STAT,1864,53,25-29,1917,0.006291760062264964
STAT,1840,16,25-29,1856,10.653081320553452
STAT,1866,95,na,1961,54.27708218667898
STAT,1784,74,na,1858,718.6771055990071
SIM,1836,31,35-39,1867,30
SIM,1866,39,45-49,1905,4
STAT,1911,24,na,1935,7265.822311529839
SIM,1834,20,50-100,1854,1
STAT,1828,56,na,1884,2617.7103262950413
SIM,1843,34,45-49,1877,7
SIM,1937,15,25-29,1952,104
STAT,1868,33,30-34,1901,33.40772967814526
SIM,1872,28,20-24,1900,26
SIM,1888,45,30-34,1933,1
STAT,1906,35,40-44,1941,2.80703561806786
SIM,1853,65,na,1918,2684
STAT,1804,52,15-19,1856,1.438382327304495E-4
SIM,1905,17,30-34,1922,7
STAT,1824,33,30-34,1857,68.92274543542122
SIM,1950,21,20-24,1971,238
STAT,1871,28,20-24,1899,23.45647475004186
STAT,1886,10,na,1896,5522.42627253086
SIM,1832,26,25-29,1858,78
STAT,1905,45,50-100,1950,0.40867570639754913
SIM,1896,32,45-49,1928,3
STAT,1808,100,na,1908,0.8342416524093484
STAT,1921,39,25-29,1960,2.2150921151713536
STAT,1836,43,50-100,1879,1.650102415275271
SIM,1871,44,50-100,1915,2
STAT,1890,15,na,1905,6254.939902766663
SIM,1848,38,50-100,1886,4
SIM,1923,28,45-49,1951,9
STAT,1888,32,45-49,1920,4.162617144113896
STAT,1916,31,20-24,1947,5.106673043100167
SIM,1828,76,na,1904,1052
STAT,1825,37,50-100,1862,3.2293267677020903
STAT,1855,38,20-24,1893,1.156624085962685
SIM,1881,28,30-34,1909,50
STAT,1863,32,40-44,1895,7.666884003152075
SIM,1878,19,25-29,1897,17
SIM,1914,35,40-44,1949,7
SIM,1933,35,35-39,1968,8
STAT,1849,49,45-49,1898,0.3655100764482933
STAT,1923,47,35-39,1970,0.3045122031844697
STAT,1942,21,20-24,1963,235.5430244583023
SIM,1895,28,15-19,1923,1
SIM,1931,27,25-29,1958,175
STAT,1843,20,20-24,1863,122.92864705859385
SIM,1870,69,na,1939,2854
SIM,1869,43,40-44,1912,4
STAT,1844,38,45-49,1882,3.3667833494208987
SIM,1869,26,20-24,1895,27
SIM,1940,25,40-44,1965,14
STAT,1891,24,30-34,1915,44.18789813699923
STAT,1915,28,45-49,1943,3.5465861698769023
STAT,1813,47,15-19,1860,0.002467988782632755
STAT,1846,35,45-49,1881,3.2555635000432637
STAT,1923,27,25-29,1950,152.57139713000257
STAT,1843,13,na,1856,4254.1080455988
SIM,1919,50,na,1969,8020
STAT,1833,39,40-44,1872,7.059742949019842
STAT,1876,16,45-49,1892,0.13678467264397404
STAT,1931,21,45-49,1952,2.956285271741265
SIM,1834,23,25-29,1857,101
STAT,1899,50,na,1949,6043.899799302278
SIM,1915,29,50-100,1944,1
STAT,1828,31,35-39,1859,23.406887867049054
SIM,1867,30,25-29,1897,27
SIM,1852,38,45-49,1890,12
STAT,1925,35,35-39,1960,5.8719743085421285
STAT,1767,94,na,1861,6.625751994425649
STAT,1871,3,na,1874,6269.969014967502
STAT,1876,49,50-100,1925,0.5023124007993498
SIM,1851,20,20-24,1871,133
STAT,1895,22,35-39,1917,15.356827619518755
SIM,1837,37,25-29,1874,7
STAT,1952,0,na,1952,10573.818462090476
SIM,1910,37,na,1947,7551
STAT,1873,28,30-34,1901,51.492776679357
SIM,1930,18,35-39,1948,9
STAT,1839,25,50-100,1864,1.27657209358282
STAT,1887,28,15-19,1915,1.0212126066930465
STAT,1932,25,40-44,1957,12.341438415100114
SIM,1916,23,40-44,1939,11
SIM,1897,39,50-100,1936,3
STAT,1922,18,35-39,1940,9.779440930258167
STAT,1900,47,40-44,1947,0.2692944967153589
STAT,1958,11,na,1969,10419.416339620813
STAT,1866,97,na,1963,29.618214804742593
STAT,1903,34,45-49,1937,2.8546570750634945
SIM,1845,56,na,1901,3334
SIM,1854,35,45-49,1889,6
STAT,1943,20,25-29,1963,198.60824474736086
STAT,1882,46,25-29,1928,0.11364378990645702
SIM,1839,23,30-34,1862,46
SIM,1934,28,20-24,1962,54
STAT,1884,21,20-24,1905,137.8450653345384
STAT,1856,37,25-29,1893,4.486469211987289
SIM,1918,21,50-100,1939,2
STAT,1831,23,20-24,1854,255.5401601682808
STAT,1952,2,na,1954,9599.105646991948
STAT,1896,39,20-24,1935,2.0347264737956223
STAT,1850,51,30-34,1901,0.009170532742021256
SIM,1909,20,30-34,1929,78
STAT,1851,28,35-39,1879,17.387527385808173
SIM,1919,39,35-39,1958,10
STAT,1883,67,na,1950,3145.5055358450363
STAT,1898,47,30-34,1945,0.148539760477564
SIM,1924,31,20-24,1955,7
STAT,1850,19,50-100,1869,0.09071457917857595
STAT,1896,28,25-29,1924,112.39667222043727
STAT,1835,34,45-49,1869,2.8175574990326933
SIM,1828,98,na,1926,2
STAT,1859,30,25-29,1889,16.704721350975714
SIM,1915,20,15-19,1935,11
STAT,1929,28,30-34,1957,98.98095205126538
SIM,1825,30,20-24,1855,7
SIM,1937,28,30-34,1965,90
STAT,1870,50,45-49,1920,0.02918912764537088
SIM,1858,26,45-49,1884,2
STAT,1912,44,25-29,1956,0.13805580662587316
STAT,1807,108,na,1915,0.0014620953936112183
STAT,1881,86,na,1967,919.6829190111713
STAT,1890,43,25-29,1933,1.5715818589405168
SIM,1886,30,na,1916,5041
SIM,1880,22,40-44,1902,6
SIM,1905,37,25-29,1942,2
SIM,1904,33,50-100,1937,5
SIM,1861,94,na,1955,18
STAT,1903,15,na,1918,7296.280818000782
STAT,1880,38,15-19,1918,0.11888034453167144
STAT,1869,20,40-44,1889,4.119779415379928
STAT,1881,47,20-24,1928,0.023315767757282706
STAT,1919,38,15-19,1957,0.041614603267806596
SIM,1841,39,40-44,1880,14
SIM,1938,24,30-34,1962,84
STAT,1917,16,45-49,1933,0.21761812416697357
STAT,1837,42,40-44,1879,3.7001353450330954
STAT,1905,33,50-100,1938,1.5301620879233058
SIM,1951,20,25-29,1971,233
SIM,1925,16,45-49,1941,1
STAT,1921,34,na,1955,8425.43372352701
STAT,1927,32,35-39,1959,22.699649597125365
STAT,1829,48,20-24,1877,0.01868808035125394
STAT,1928,36,30-34,1964,4.6554300213582955
SIM,1873,27,25-29,1900,91
SIM,1787,69,na,1856,1202
SIM,1911,34,45-49,1945,9
STAT,1841,45,25-29,1886,0.08613137917588665
STAT,1939,31,15-19,1970,0.26498722245043754
SIM,1863,75,na,1938,1898
SIM,1892,21,20-24,1913,192
STAT,1926,28,20-24,1954,44.03068006525408
STAT,1854,106,na,1960,0.05176923038398407
STAT,1866,36,30-34,1902,9.979361262063568
STAT,1887,43,50-100,1930,2.369067643100387
STAT,1874,92,na,1966,261.7183500067858
STAT,1900,45,45-49,1945,0.3766807687646418
SIM,1922,34,20-24,1956,5
STAT,1824,111,na,1935,1.1475301135349465E-4
STAT,1912,46,20-24,1958,0.021508738740553392
SIM,1892,29,45-49,1921,4
SIM,1855,31,45-49,1886,6
SIM,1933,5,na,1938,11357
SIM,1848,13,na,1861,4531
STAT,1885,39,45-49,1924,3.9671650187760963
STAT,1814,56,na,1870,2262.937925221536
STAT,1803,80,na,1883,546.800579080259
STAT,1833,26,35-39,1859,16.90701382441951
STAT,1929,15,25-29,1944,112.20226286585225
STAT,1884,29,45-49,1913,2.1984191090298166
SIM,1841,26,35-39,1867,20
STAT,1823,92,na,1915,49.97935670433229
STAT,1849,27,40-44,1876,5.616902244724134
STAT,1905,31,45-49,1936,2.9365374510304214
STAT,1870,47,45-49,1917,0.4657656371057079
STAT,1928,16,20-24,1944,345.80481180075066
SIM,1889,17,35-39,1906,1
STAT,1852,54,45-49,1906,0.022493973319903496
SIM,1936,16,20-24,1952,248
STAT,1850,23,30-34,1873,32.54477623940757
STAT,1818,48,45-49,1866,1.024466173339675
STAT,1914,34,20-24,1948,4.917083317008939
SIM,1857,27,40-44,1884,6
STAT,1845,38,20-24,1883,1.2351483302855712
STAT,1858,34,25-29,1892,15.988078330841304
SIM,1896,62,na,1958,5113
STAT,1781,105,na,1886,0.04107193634782745
SIM,1831,33,50-100,1864,1
SIM,1874,36,30-34,1910,16
STAT,1845,28,na,1873,4028.284121660997
SIM,1925,2,na,1927,9954
STAT,1839,47,35-39,1886,0.22272509780310643
STAT,1907,16,50-100,1923,0.14578281753559735
SIM,1840,92,na,1932,47
STAT,1865,24,15-19,1889,6.039003657863029
STAT,1834,38,45-49,1872,3.2666357729044426
SIM,1842,16,40-44,1858,2
STAT,1918,22,50-100,1940,1.4330073989416778
SIM,1959,6,na,1965,10852
STAT,1840,49,25-29,1889,0.0817211998996558
STAT,1864,31,45-49,1895,3.161004042386306
SIM,1840,27,30-34,1867,63
STAT,1844,109,na,1953,0.0011489463514102235
STAT,1923,42,50-100,1965,0.27722470997628074
STAT,1937,30,50-100,1967,1.6542283181325128
SIM,1875,4,na,1879,6196
SIM,1873,34,30-34,1907,44
SIM,1893,36,40-44,1929,15
STAT,1840,27,20-24,1867,21.113789707330913
STAT,1911,56,na,1967,6764.428731357464
SIM,1901,24,35-39,1925,22
STAT,1819,48,20-24,1867,0.04960585529781657
STAT,1890,18,20-24,1908,43.58909097552556
STAT,1943,15,50-100,1958,0.8027849418558627
SIM,1842,35,40-44,1877,13
SIM,1886,52,na,1938,4394
STAT,1858,68,na,1926,2406.0222198098054
STAT,1835,26,na,1861,3677.6758796095455
SIM,1846,95,na,1941,9
STAT,1879,24,50-100,1903,0.8560550923510636
STAT,1900,64,na,1964,5296.394903660694
STAT,1778,88,na,1866,93.71168992264822
STAT,1900,17,45-49,1917,0.18300913145066758
STAT,1879,30,na,1909,5081.547976926256
STAT,1844,32,30-34,1876,33.71763700005687
SIM,1873,12,na,1885,5531
SIM,1815,58,na,1873,2143
STAT,1879,49,30-34,1928,0.20021823583668835
SIM,1919,42,na,1961,8198
STAT,1927,1,na,1928,10485.191497256421
SIM,1856,101,na,1957,2
SIM,1941,17,40-44,1958,4
STAT,1947,24,30-34,1971,65.55425048099126
SIM,1913,31,45-49,1944,2
STAT,1881,34,15-19,1915,0.2756113026971885
STAT,1910,24,35-39,1934,17.75307577850993
SIM,1811,68,na,1879,1531
STAT,1823,49,25-29,1872,0.17298280159325113
SIM,1868,22,25-29,1890,125
STAT,1889,26,50-100,1915,1.5984497000249898
SIM,1795,64,na,1859,1699
SIM,1924,17,40-44,1941,4
STAT,1887,36,45-49,1923,4.5245457403001375
STAT,1833,70,na,1903,1844.520360284216
STAT,1886,18,na,1904,5370.339967211107
STAT,1922,48,30-34,1970,0.20620156428075515
STAT,1814,43,15-19,1857,0.07694392864771432
STAT,1937,29,35-39,1966,29.53397583434838
SIM,1816,38,35-39,1854,12
STAT,1823,52,25-29,1875,0.010534619886201267
STAT,1886,39,20-24,1925,1.6268654104344185
SIM,1943,24,na,1967,8000
STAT,1933,17,40-44,1950,3.781896898824866
SIM,1847,47,35-39,1894,1
STAT,1857,22,50-100,1879,0.7410856050358494
STAT,1897,38,25-29,1935,7.734248315494846
STAT,1918,45,45-49,1963,0.46921978812047754
SIM,1842,28,35-39,1870,21
STAT,1849,41,20-24,1890,0.25234684257766543
STAT,1885,36,40-44,1921,8.842432435319704
SIM,1835,32,30-34,1867,51
STAT,1840,52,25-29,1892,0.00508546687507412
SIM,1858,45,45-49,1903,2
SIM,1866,31,20-24,1897,8
STAT,1829,37,25-29,1866,5.032451230175156
STAT,1891,62,na,1953,4562.715290845035
SIM,1877,20,40-44,1897,5
STAT,1883,21,na,1904,4707.071261593387
STAT,1891,64,na,1955,4339.606817264543
STAT,1916,17,40-44,1933,0.5993343054038324
SIM,1895,36,45-49,1931,10
SIM,1936,22,na,1958,6266
STAT,1894,23,30-34,1917,46.069335118438865
STAT,1928,19,25-29,1947,109.6705561368101
STAT,1964,0,na,1964,10073.43385235661
SIM,1818,40,50-100,1858,2
STAT,1860,40,35-39,1900,2.9998518041838875
STAT,1907,20,15-19,1927,9.851127632329321
STAT,1824,34,na,1858,3063.3629230486004
STAT,1889,38,35-39,1927,17.5258598322215
SIM,1887,39,20-24,1926,3
SIM,1897,38,35-39,1935,1
SIM,1904,25,30-34,1929,90
SIM,1906,16,35-39,1922,3
SIM,1828,45,45-49,1873,1
STAT,1870,22,30-34,1892,35.31868038572348
SIM,1837,42,50-100,1879,8
STAT,1850,16,25-29,1866,10.680266029914446
SIM,1906,33,25-29,1939,24
STAT,1827,32,30-34,1859,43.09649806076338
SIM,1826,45,40-44,1871,1
STAT,1825,45,40-44,1870,0.38161974571714496
STAT,1943,28,20-24,1971,39.2425669100877
SIM,1912,18,na,1930,8058
SIM,1869,80,na,1949,988
STAT,1820,50,na,1870,2779.829276003223
STAT,1865,46,25-29,1911,0.10598518608671034
SIM,1926,45,45-49,1971,2
SIM,1851,28,45-49,1879,2
SIM,1898,28,40-44,1926,13
STAT,1834,28,35-39,1862,16.721192953378544
STAT,1870,28,45-49,1898,2.193789868697532
SIM,1817,44,45-49,1861,5
SIM,1896,39,30-34,1935,9
STAT,1893,22,50-100,1915,1.0438937168463445
STAT,1873,21,45-49,1894,1.43526314421121
SIM,1867,46,40-44,1913,1
SIM,1884,35,45-49,1919,7
STAT,1871,42,na,1913,4631.827722955736
SIM,1843,34,50-100,1877,2
STAT,1871,21,35-39,1892,11.744328825554225
STAT,1876,35,45-49,1911,4.203661203377669
STAT,1913,25,30-34,1938,79.40453047440857
STAT,1830,42,15-19,1872,0.02475411145559567
SIM,1831,56,na,1887,2761
SIM,1857,41,20-24,1898,1
SIM,1899,27,45-49,1926,3
STAT,1848,37,35-39,1885,11.95147303799484
SIM,1867,35,45-49,1902,9
STAT,1881,28,20-24,1909,22.820135780285945
STAT,1903,35,15-19,1938,0.03518416904925043
STAT,1873,99,na,1972,31.036957268157934
STAT,1924,20,15-19,1944,12.7580131845434
SIM,1921,25,30-34,1946,101
SIM,1795,86,na,1881,139
SIM,1883,29,35-39,1912,23
SIM,1832,33,30-34,1865,34
SIM,1827,48,20-24,1875,1
STAT,1875,36,40-44,1911,9.146177557775806
STAT,1923,27,na,1950,8683.580117668173
STAT,1831,24,45-49,1855,1.368840307029005
STAT,1871,43,15-19,1914,0.027509462309656552
STAT,1865,48,na,1913,4076.1642568446405
SIM,1852,32,30-34,1884,40
SIM,1882,48,na,1930,4583
SIM,1888,38,25-29,1926,14
STAT,1853,22,30-34,1875,33.29895245022965
SIM,1873,24,15-19,1897,7
SIM,1883,36,40-44,1919,12
STAT,1830,27,20-24,1857,27.069693390243454
STAT,1892,29,35-39,1921,24.220988102833534
STAT,1895,49,15-19,1944,5.813852798332288E-4
SIM,1861,22,30-34,1883,53
STAT,1841,26,25-29,1867,76.78374954516312
STAT,1870,19,15-19,1889,11.73975746472071
SIM,1848,11,na,1859,4568
SIM,1898,20,45-49,1918,1
SIM,1824,86,na,1910,284
SIM,1878,38,25-29,1916,11
STAT,1875,29,35-39,1904,19.92011685987095
STAT,1952,18,20-24,1970,327.994179914733
SIM,1869,46,45-49,1915,1
STAT,1869,39,20-24,1908,1.4933222348356414
SIM,1922,17,30-34,1939,39
STAT,1934,38,50-100,1972,1.1691302304109021
SIM,1870,77,na,1947,1556
SIM,1816,45,40-44,1861,1
STAT,1842,85,na,1927,408.13528777462074
STAT,1934,25,50-100,1959,2.706998416675742
STAT,1914,17,30-34,1931,5.093025832615231
STAT,1891,17,25-29,1908,14.146319434103965
STAT,1860,20,20-24,1880,129.89122324843083
STAT,1940,27,25-29,1967,135.5639296456103
SIM,1831,27,20-24,1858,21
SIM,1856,37,35-39,1893,17
STAT,1854,21,35-39,1875,10.586916796770778
STAT,1929,21,45-49,1950,2.8820527547195507
STAT,1776,113,na,1889,9.574436818446073E-4
SIM,1951,11,na,1962,9798
STAT,1838,48,30-34,1886,0.13306638652687533
SIM,1928,25,na,1953,9442
STAT,1899,32,20-24,1931,7.479738360589714
STAT,1825,38,35-39,1863,17.90798681926992
SIM,1877,39,20-24,1916,1
SIM,1833,38,35-39,1871,22
STAT,1859,46,40-44,1905,0.2759834982175484
STAT,1904,27,15-19,1931,1.3151655707368037
SIM,1873,63,na,1936,3626
SIM,1882,24,30-34,1906,46
SIM,1862,21,35-39,1883,17
SIM,1912,27,15-19,1939,3
STAT,1844,62,na,1906,2951.628652052351
SIM,1804,88,na,1892,54
STAT,1781,103,na,1884,0.10458451073517
STAT,1860,28,45-49,1888,1.8272856195609077
STAT,1782,93,na,1875,13.42089851665868
STAT,1906,55,na,1961,6317.650311325751
SIM,1937,21,45-49,1958,3
SIM,1834,20,20-24,1854,122
SIM,1912,39,25-29,1951,4
STAT,1803,101,na,1904,0.40270491875465875
SIM,1891,17,35-39,1908,1
STAT,1844,35,40-44,1879,8.381382275257632
STAT,1905,18,35-39,1923,1.5984600877994315
SIM,1874,39,35-39,1913,18
STAT,1896,45,15-19,1941,6.07632581349193E-4
SIM,1773,85,na,1858,163
STAT,1866,12,na,1878,5017.68593086189
STAT,1843,23,25-29,1866,99.93299109552184
SIM,1857,20,15-19,1877,6
SIM,1879,32,45-49,1911,6
SIM,1848,46,30-34,1894,2
STAT,1876,25,35-39,1901,20.29199797460684
STAT,1942,7,na,1949,8375.737486283137
SIM,1886,84,na,1970,1162
STAT,1839,17,30-34,1856,3.2555980224635244
STAT,1908,26,45-49,1934,3.3399891178400973
STAT,1818,39,15-19,1857,0.3168535793005575
STAT,1887,16,20-24,1903,40.14342825236082
STAT,1870,44,40-44,1914,4.399724809763697
SIM,1940,28,45-49,1968,4
STAT,1860,18,35-39,1878,1.03179267952092
SIM,1820,70,na,1890,1339
SIM,1903,35,na,1938,7067
STAT,1864,50,20-24,1914,0.0013513167560632831
STAT,1836,65,na,1901,2246.9457168035437
SIM,1954,15,25-29,1969,136
SIM,1884,25,35-39,1909,23
SIM,1924,0,na,1924,10482
STAT,1917,38,20-24,1955,0.5501879452524946
SIM,1925,38,20-24,1963,1
STAT,1883,17,35-39,1900,1.088788942773727
STAT,1845,31,35-39,1876,18.748269806315385
STAT,1910,36,45-49,1946,1.3236016816072302
STAT,1946,15,25-29,1961,97.11673037721322
SIM,1829,36,50-100,1865,5
SIM,1914,27,25-29,1941,124
SIM,1851,23,25-29,1874,127
STAT,1909,19,15-19,1928,17.887532345303615
SIM,1939,17,na,1956,7650
SIM,1895,16,20-24,1911,47
SIM,1847,17,30-34,1864,4
SIM,1833,77,na,1910,1082
STAT,1914,37,25-29,1951,1.9857698759222309
STAT,1832,75,na,1907,1342.1281052232587
SIM,1862,26,na,1888,4427
STAT,1904,39,25-29,1943,1.7832896105117433
STAT,1906,47,35-39,1953,0.2313256832716275
STAT,1824,36,35-39,1860,22.42603891605747
STAT,1932,28,45-49,1960,4.568170692959933
STAT,1940,19,40-44,1959,2.8664863340952227
STAT,1866,39,35-39,1905,13.047592416848703
STAT,1888,39,30-34,1927,12.594007504271874
STAT,1844,94,na,1938,32.275797238163435
SIM,1928,34,15-19,1962,1
STAT,1929,0,na,1929,11610.63684914722
SIM,1852,35,40-44,1887,13
STAT,1803,53,40-44,1856,0.07579949731658824
SIM,1906,24,na,1930,6900
SIM,1868,33,na,1901,4660
SIM,1917,19,15-19,1936,86
STAT,1864,47,20-24,1911,0.02156271737429774
SIM,1853,31,35-39,1884,23
STAT,1849,49,50-100,1898,0.3803782823231766
STAT,1857,30,15-19,1887,0.23029506789990667
STAT,1866,27,40-44,1893,5.582172582303017
STAT,1933,37,na,1970,10350.389481944547
STAT,1810,74,na,1884,987.9350958601536
SIM,1833,45,40-44,1878,1
SIM,1920,24,45-49,1944,3
STAT,1843,28,45-49,1871,1.9003707746215934
STAT,1911,29,15-19,1940,1.380883883544114
STAT,1879,39,20-24,1918,1.612011504372758
STAT,1921,36,20-24,1957,0.5948542414762982
SIM,1842,73,na,1915,1591
STAT,1851,25,30-34,1876,46.36984882824048
STAT,1859,93,na,1952,46.97950427149397
STAT,1912,24,45-49,1936,2.255876970786081
STAT,1949,20,na,1969,8611.349356791656
SIM,1832,23,20-24,1855,103
SIM,1949,20,25-29,1969,253
SIM,1848,37,40-44,1885,10
STAT,1900,32,na,1932,6685.547550435664
SIM,1899,59,na,1958,5637
STAT,1839,34,15-19,1873,0.2680146935312062
SIM,1832,36,35-39,1868,20
STAT,1934,16,45-49,1950,1.368166165597403
STAT,1849,20,15-19,1869,6.400775960075731
SIM,1846,41,45-49,1887,9
SIM,1822,37,20-24,1859,1
SIM,1881,17,30-34,1898,3
STAT,1812,48,50-100,1860,1.6771465106907653
STAT,1808,58,na,1866,2181.7068361042366
SIM,1942,16,45-49,1958,2
STAT,1873,17,30-34,1890,3.270709551092735
STAT,1790,88,na,1878,85.76800113173766
SIM,1829,48,30-34,1877,1
STAT,1772,116,na,1888,1.931807682337595E-4
STAT,1918,20,30-34,1938,62.967226395233844
SIM,1886,38,na,1924,4887
SIM,1914,38,45-49,1952,4
SIM,1880,25,45-49,1905,1
STAT,1898,17,35-39,1915,1.4996702274720388
STAT,1912,41,20-24,1953,0.03460744455951326
STAT,1848,45,20-24,1893,0.01987265380419209
STAT,1840,33,15-19,1873,0.24778068593321673
STAT,1852,51,40-44,1903,0.016859356996293956
STAT,1858,31,20-24,1889,4.300165930915697
STAT,1858,46,na,1904,3552.247477949214
STAT,1855,28,50-100,1883,0.9982302458091944
SIM,1828,90,na,1918,131
SIM,1837,59,na,1896,2564
SIM,1854,40,50-100,1894,3
STAT,1819,41,35-39,1860,8.651240056296821
STAT,1892,36,40-44,1928,11.1208914772765
STAT,1915,25,40-44,1940,9.667527219646175
SIM,1788,84,na,1872,156
STAT,1838,41,45-49,1879,2.3993884879290586
STAT,1818,45,40-44,1863,0.7784038850858739
STAT,1890,69,na,1959,3841.1194907754075
STAT,1849,40,na,1889,3719.810346936324
SIM,1926,20,30-34,1946,95
SIM,1932,23,25-29,1955,280
STAT,1964,8,na,1972,9994.988076815089
STAT,1912,49,25-29,1961,0.10238225855456841
STAT,1875,51,35-39,1926,0.017986911512984333
STAT,1891,27,35-39,1918,24.087412202122202
STAT,1779,111,na,1890,0.0021690613022161643
STAT,1885,20,25-29,1905,115.76727101195573
SIM,1922,37,25-29,1959,1
STAT,1861,74,na,1935,1865.5639084716572
STAT,1893,45,na,1938,5817.817430997266
STAT,1872,24,20-24,1896,138.9988419203503
STAT,1928,39,35-39,1967,6.159492129810642
STAT,1906,27,25-29,1933,124.4907214231848
STAT,1850,26,35-39,1876,17.535972124900884
SIM,1893,20,25-29,1913,165
SIM,1898,21,15-19,1919,7
SIM,1909,23,35-39,1932,21
STAT,1834,30,20-24,1864,4.705670687350332
SIM,1880,24,20-24,1904,135
STAT,1899,68,na,1967,4822.301975247142
SIM,1839,26,35-39,1865,23
SIM,1917,28,20-24,1945,39
SIM,1916,26,45-49,1942,4
STAT,1868,78,na,1946,1501.351412806684
STAT,1877,22,25-29,1899,120.05310404826815
STAT,1884,24,25-29,1908,113.44855119458755
STAT,1778,86,na,1864,143.078602269634
SIM,1936,19,25-29,1955,97
STAT,1924,23,25-29,1947,219.38764777372808
STAT,1855,51,50-100,1906,0.022882919909333038
SIM,1886,22,35-39,1908,16
STAT,1851,50,35-39,1901,0.013537396032196058
SIM,1906,46,na,1952,6596
SIM,1923,25,40-44,1948,15
STAT,1832,27,30-34,1859,44.200720318152435
STAT,1899,18,40-44,1917,0.5047920948761359
STAT,1854,42,40-44,1896,3.4438660614723213
STAT,1846,48,20-24,1894,0.018149558505658782
STAT,1868,24,40-44,1892,3.9790273533819915
STAT,1949,21,30-34,1970,67.75069102659964
STAT,1822,37,15-19,1859,0.22492384768846402
SIM,1805,81,na,1886,362
SIM,1934,20,25-29,1954,254
SIM,1941,23,na,1964,7736
STAT,1870,25,35-39,1895,19.261957098202263
STAT,1878,38,15-19,1916,0.11785935897933944
SIM,1825,33,25-29,1858,24
STAT,1909,28,20-24,1937,35.12750332801511
STAT,1838,38,20-24,1876,1.2458624754738425
STAT,1880,54,20-24,1934,0.0015268040302058997
SIM,1827,41,35-39,1868,5
SIM,1901,26,na,1927,6799
SIM,1836,42,50-100,1878,8
STAT,1908,38,na,1946,7083.383050323583
STAT,1846,32,40-44,1878,7.84988275200776
SIM,1888,18,30-34,1906,7
STAT,1842,49,35-39,1891,0.20408207332133918
STAT,1823,47,na,1870,3125.4738455947922
STAT,1828,42,50-100,1870,1.9891981150539302
SIM,1893,39,45-49,1932,12
SIM,1854,32,40-44,1886,15
SIM,1906,28,45-49,1934,7
SIM,1842,30,20-24,1872,6
SIM,1888,19,na,1907,5892
STAT,1819,52,50-100,1871,0.060850461241150997
STAT,1886,32,35-39,1918,21.59032311547062
SIM,1846,38,20-24,1884,2
SIM,1852,29,15-19,1881,1
STAT,1878,22,35-39,1900,12.30878208278661
STAT,1894,59,na,1953,5042.117195412478
SIM,1888,0,na,1888,7076
SIM,1894,32,35-39,1926,43
STAT,1784,101,na,1885,0.22723553934059282
SIM,1879,20,35-39,1899,19
SIM,1801,58,na,1859,2142
STAT,1844,29,15-19,1873,0.8841032011189631
STAT,1918,46,15-19,1964,7.935295225884644E-4
STAT,1881,7,na,1888,5145.607846617066
STAT,1890,40,20-24,1930,0.39544925297729044
STAT,1837,45,45-49,1882,0.3503910206700297
STAT,1876,73,na,1949,2481.048700024905
SIM,1959,4,na,1963,10856
STAT,1926,20,25-29,1946,227.95081495067723
SIM,1947,6,na,1953,9350
STAT,1830,47,15-19,1877,6.904704103092205E-4
STAT,1906,38,45-49,1944,1.2599992542564724
STAT,1900,10,na,1910,7257.120843442456
STAT,1849,5,na,1854,4896.0
STAT,1865,37,35-39,1902,12.977475795982173
STAT,1912,36,50-100,1948,0.8318159298710821
STAT,1896,18,15-19,1914,15.782595158608736
SIM,1920,36,50-100,1956,1
SIM,1863,27,25-29,1890,84
STAT,1792,69,na,1861,1371.0916821393196
STAT,1931,38,50-100,1969,1.1219019836170128
STAT,1858,17,40-44,1875,0.3363824630761089
STAT,1890,21,45-49,1911,1.7241962435037734
SIM,1865,16,35-39,1881,1
STAT,1864,31,na,1895,4325.635327483861
STAT,1902,27,20-24,1929,33.45042866275735
STAT,1817,86,na,1903,223.7899631018899
SIM,1855,15,na,1870,4862
STAT,1892,26,30-34,1918,63.88578321853793
SIM,1826,48,45-49,1874,1
STAT,1944,11,na,1955,8538.262307507497
STAT,1887,33,40-44,1920,9.754405419169524
STAT,1817,38,45-49,1855,13.692952294986881
STAT,1863,27,15-19,1890,0.802101023973874
SIM,1875,44,na,1919,5076
SIM,1901,21,30-34,1922,65
SIM,1895,33,40-44,1928,16
STAT,1900,42,40-44,1942,0.43705910655140595
STAT,1871,48,15-19,1919,7.925205678664574E-4
STAT,1890,37,20-24,1927,1.9002627087631465
STAT,1934,30,25-29,1964,25.518784231103375
SIM,1833,35,30-34,1868,11
STAT,1864,28,20-24,1892,21.104350643555744
STAT,1930,29,25-29,1959,168.8595890342927
SIM,1892,24,25-29,1916,194
STAT,1829,108,na,1937,0.0021678615491358714
STAT,1862,49,50-100,1911,0.4151031664293053
SIM,1847,44,30-34,1891,3
STAT,1840,19,35-39,1859,1.013417419684502
SIM,1825,38,45-49,1863,4
STAT,1851,35,40-44,1886,7.002523094765267
SIM,1832,23,15-19,1855,4
STAT,1818,36,50-100,1854,9.418229093758683
STAT,1878,43,50-100,1921,2.2122774041879936
STAT,1829,27,15-19,1856,1.3147353263599062
STAT,1869,53,50-100,1922,0.029080627674263324
STAT,1924,18,45-49,1942,1.1979369739311956
SIM,1831,30,45-49,1861,9
STAT,1825,35,30-34,1860,15.082962911059225
STAT,1897,22,45-49,1919,1.8825185529170012
STAT,1828,78,na,1906,959.5200490980534
STAT,1855,27,25-29,1882,66.48810868364778
SIM,1909,31,50-100,1940,6
SIM,1828,42,40-44,1870,7
STAT,1924,23,na,1947,8673.425788561815
STAT,1846,15,20-24,1861,34.51752470637414
STAT,1886,32,na,1918,5087.478110846337
STAT,1806,77,na,1883,701.7000290983932
SIM,1910,27,20-24,1937,40
STAT,1846,34,20-24,1880,4.792238601623385
SIM,1855,27,30-34,1882,59
SIM,1952,15,na,1967,9120
STAT,1807,49,40-44,1856,1.1329691212298476
STAT,1849,39,35-39,1888,11.212917529487433
STAT,1905,23,15-19,1928,9.605951194659111
STAT,1921,19,30-34,1940,27.902569550933613
SIM,1886,43,50-100,1929,5
STAT,1927,15,15-19,1942,114.47651379638475
SIM,1883,31,20-24,1914,6
STAT,1833,25,na,1858,3801.305444536445
SIM,1899,36,35-39,1935,5
SIM,1847,34,20-24,1881,6
STAT,1839,44,30-34,1883,1.8441192915493676
SIM,1838,31,45-49,1869,4
STAT,1939,17,35-39,1956,8.483844925710617
STAT,1914,29,40-44,1943,9.423574451095202
SIM,1947,17,35-39,1964,12
SIM,1801,91,na,1892,51
SIM,1922,29,40-44,1951,14
SIM,1808,70,na,1878,1393
STAT,1875,31,20-24,1906,5.643578822269963
SIM,1815,49,40-44,1864,1
SIM,1826,36,50-100,1862,2
STAT,1820,103,na,1923,0.16066612605117941
STAT,1867,20,30-34,1887,34.32045392908578
SIM,1913,23,15-19,1936,9
SIM,1915,9,na,1924,8462
SIM,1857,39,35-39,1896,19
SIM,1854,34,20-24,1888,8
STAT,1884,60,na,1944,3803.4321053471867
STAT,1834,50,35-39,1884,0.012225153387353157
STAT,1861,24,45-49,1885,1.1870192453926407
SIM,1861,38,50-100,1899,2
SIM,1810,44,35-39,1854,4
SIM,1935,15,15-19,1950,112
STAT,1812,55,na,1867,2534.262696054899
STAT,1895,43,40-44,1938,0.4080764644010255
SIM,1891,31,na,1922,6184
STAT,1901,20,20-24,1921,196.00358141103948
STAT,1940,24,20-24,1964,228.6298714600891
SIM,1887,42,45-49,1929,8
STAT,1850,54,35-39,1904,0.012837018588932714
STAT,1861,25,50-100,1886,1.0988638005753195
SIM,1852,35,35-39,1887,21
SIM,1868,42,35-39,1910,8
STAT,1870,25,40-44,1895,5.979982511056119
STAT,1899,35,25-29,1934,8.042802703475063
SIM,1883,73,na,1956,2538
STAT,1877,89,na,1966,550.7204162242
SIM,1860,25,50-100,1885,1
STAT,1858,22,15-19,1880,5.95943282977435
SIM,1901,15,45-49,1916,1
SIM,1863,17,15-19,1880,11
STAT,1863,38,15-19,1901,0.09878327994949951
SIM,1884,29,na,1913,5086
STAT,1892,24,50-100,1916,1.024560486522641
SIM,1840,47,na,1887,3590
SIM,1859,19,15-19,1878,8
STAT,1852,25,50-100,1877,1.204747933736302
SIM,1846,30,na,1876,4038
SIM,1902,17,20-24,1919,55
SIM,1867,49,45-49,1916,2
STAT,1838,53,50-100,1891,0.020111958838957538
STAT,1859,49,45-49,1908,0.3714465447516494
STAT,1908,40,25-29,1948,0.13503292380340864
STAT,1847,27,30-34,1874,46.13780031659856
STAT,1848,44,na,1892,3738.601978301832
STAT,1862,59,na,1921,3354.81022373606
STAT,1828,52,40-44,1880,0.018313921808137793
STAT,1837,37,15-19,1874,0.09531280981322723
STAT,1861,110,na,1971,0.007437570025258029
STAT,1869,38,na,1907,4587.636761738538
SIM,1812,83,na,1895,345
STAT,1865,34,30-34,1899,31.761012364854746
SIM,1918,20,40-44,1938,12
STAT,1863,35,45-49,1898,3.5577570578840993
SIM,1865,68,na,1933,2744
SIM,1908,30,25-29,1938,21
STAT,1870,15,50-100,1885,0.09923333761432881
SIM,1895,35,20-24,1930,5
SIM,1819,62,na,1881,2011
STAT,1844,35,35-39,1879,13.542163461216212
SIM,1920,21,35-39,1941,29
SIM,1921,28,35-39,1949,44
SIM,1913,18,35-39,1931,2
SIM,1873,37,35-39,1910,23
STAT,1889,46,20-24,1935,0.029967638179325615
STAT,1855,44,15-19,1899,0.020543227643802703
SIM,1892,16,na,1908,7270
STAT,1908,36,na,1944,7152.954413099179
STAT,1879,42,45-49,1921,3.15772565371359
STAT,1835,24,35-39,1859,9.907135495750488
STAT,1913,28,35-39,1941,30.113970253751518
SIM,1843,24,35-39,1867,14
SIM,1848,49,50-100,1897,1
SIM,1860,45,na,1905,3986
SIM,1888,35,20-24,1923,2
STAT,1881,17,25-29,1898,11.061914497198467
SIM,1811,48,50-100,1859,1
STAT,1804,68,na,1872,1476.7687980419175
STAT,1865,43,20-24,1908,0.2892869852687272
STAT,1791,84,na,1875,220.27965103019238
SIM,1848,96,na,1944,10
STAT,1857,16,35-39,1873,1.021249962037893
STAT,1865,16,na,1881,4803.556329518609
STAT,1912,21,35-39,1933,18.284622263238052
STAT,1876,24,50-100,1900,0.8464844422943456
STAT,1819,95,na,1914,13.912141323573236
STAT,1827,35,40-44,1862,9.585434659531066
SIM,1873,24,20-24,1897,146
SIM,1927,29,25-29,1956,190
STAT,1924,48,40-44,1972,0.37792545279616246
SIM,1876,25,45-49,1901,3
STAT,1844,54,40-44,1898,0.0165337257020549
SIM,1815,45,25-29,1860,1
STAT,1915,30,15-19,1945,0.26646788007086997
STAT,1814,47,30-34,1861,0.5014850133321604
SIM,1865,8,na,1873,5206
STAT,1860,23,25-29,1883,96.08973194492236
STAT,1885,36,35-39,1921,14.28710223459874
SIM,1960,2,na,1962,10836
STAT,1826,97,na,1923,6.431138362810033
SIM,1843,42,30-34,1885,4
STAT,1835,39,15-19,1874,0.08810605090587165
STAT,1889,39,50-100,1928,3.0265943426123
SIM,1780,87,na,1867,89
STAT,1842,46,30-34,1888,0.14599989379260656
STAT,1839,22,20-24,1861,138.25570765833152
SIM,1898,37,30-34,1935,3
SIM,1913,15,30-34,1928,9
STAT,1848,27,25-29,1875,82.805055364597
STAT,1879,45,15-19,1924,8.534143232376229E-4
STAT,1843,27,50-100,1870,1.1028017531316867
STAT,1920,30,na,1950,8431.873931434588
SIM,1893,22,40-44,1915,8
STAT,1887,30,50-100,1917,2.0862445516202057
SIM,1856,27,25-29,1883,83
SIM,1902,39,50-100,1941,2
SIM,1919,46,50-100,1965,3
STAT,1822,34,45-49,1856,8.30457021550387
STAT,1931,25,25-29,1956,171.7765196339631
SIM,1864,34,15-19,1898,1
SIM,1862,71,na,1933,2335
SIM,1827,31,50-100,1858,1
SIM,1861,44,40-44,1905,7
SIM,1903,24,45-49,1927,4
SIM,1839,38,50-100,1877,1
STAT,1845,79,na,1924,1077.2762256454987
SIM,1884,49,50-100,1933,1
SIM,1946,7,na,1953,8677
STAT,1887,19,25-29,1906,12.731321113632312
SIM,1833,48,45-49,1881,2
SIM,1862,4,na,1866,5320
SIM,1826,45,35-39,1871,1
SIM,1838,23,15-19,1861,6
SIM,1858,23,35-39,1881,14
STAT,1888,41,na,1929,5542.043314664568
SIM,1906,25,40-44,1931,9
STAT,1905,27,30-34,1932,73.5508058034537
SIM,1840,79,na,1919,1130
STAT,1865,24,20-24,1889,126.14724814205363
STAT,1894,48,45-49,1942,0.341035927330796
STAT,1891,33,20-24,1924,6.719391449934176
SIM,1901,36,45-49,1937,2
SIM,1866,22,15-19,1888,4
STAT,1822,84,na,1906,375.6044669684852
STAT,1859,35,45-49,1894,3.2349419236111476
STAT,1932,33,50-100,1965,2.2185621501886215
SIM,1893,36,35-39,1929,23
STAT,1833,34,20-24,1867,4.49019216898163
SIM,1847,25,50-100,1872,4
STAT,1907,51,na,1958,6529.784545302548
STAT,1818,45,35-39,1863,0.636545234598918
SIM,1875,46,35-39,1921,1
STAT,1843,25,40-44,1868,5.239186016177031
SIM,1925,36,na,1961,9116
STAT,1874,24,30-34,1898,36.60369508956448
STAT,1900,26,35-39,1926,27.12544351912966
STAT,1931,17,30-34,1948,32.22205617000808
STAT,1881,38,30-34,1919,10.35216630449248
SIM,1855,24,na,1879,4328
SIM,1911,31,35-39,1942,29
STAT,1874,36,25-29,1910,5.982591099323116
SIM,1813,43,50-100,1856,3
STAT,1918,14,na,1932,8680.317760482256
SIM,1843,39,15-19,1882,3
SIM,1882,36,25-29,1918,10
SIM,1841,34,20-24,1875,6
STAT,1835,42,30-34,1877,1.7849295307769193
STAT,1821,37,20-24,1858,3.0181245921163296
STAT,1867,46,35-39,1913,0.2655512590408414
SIM,1906,37,40-44,1943,3
SIM,1832,42,20-24,1874,1
STAT,1908,32,30-34,1940,30.05495497516125
SIM,1899,24,35-39,1923,13
SIM,1932,27,40-44,1959,17
SIM,1935,23,45-49,1958,3
STAT,1906,24,20-24,1930,201.53602615833236
SIM,1851,31,na,1882,3997
SIM,1879,24,15-19,1903,6
SIM,1915,23,25-29,1938,215
SIM,1826,35,na,1861,3368
SIM,1839,82,na,1921,521
STAT,1855,89,na,1944,158.4138171409325
SIM,1938,4,na,1942,8066
STAT,1888,44,na,1932,5442.609615722265
STAT,1825,48,45-49,1873,0.504780783665298
STAT,1898,51,na,1949,5913.114764949289
STAT,1927,36,15-19,1963,0.048256033020248175
STAT,1876,43,30-34,1919,2.3841478088653387
SIM,1946,4,na,1950,8747
SIM,1820,43,40-44,1863,8
STAT,1840,37,30-34,1877,9.098851217553776
STAT,1861,29,15-19,1890,0.7572267771455797
STAT,1897,35,15-19,1932,0.15303694630624312
STAT,1823,33,15-19,1856,0.7095498194433517
STAT,1824,42,20-24,1866,0.4127638039104841
STAT,1837,52,na,1889,3011.8679646462137
STAT,1836,21,25-29,1857,101.19961339512408
STAT,1904,36,20-24,1940,0.4846164095125529
SIM,1883,41,na,1924,4798
STAT,1933,34,25-29,1967,25.125854434437848
SIM,1841,35,25-29,1876,8
SIM,1916,32,30-34,1948,38
STAT,1859,34,40-44,1893,6.9115400261112505
STAT,1890,24,15-19,1914,8.08169711630453
STAT,1809,52,30-34,1861,0.04387806454191694
STAT,1839,34,20-24,1873,5.0872220658601
STAT,1924,27,40-44,1951,10.95751999273173
STAT,1929,24,15-19,1953,13.508832028031005
SIM,1851,25,40-44,1876,8
STAT,1927,35,45-49,1962,1.71449485427114
SIM,1841,24,na,1865,3836
SIM,1877,27,na,1904,4905
STAT,1884,51,na,1935,4314.543899718184
SIM,1798,75,na,1873,790
SIM,1884,43,30-34,1927,4
SIM,1881,63,na,1944,2995
SIM,1857,36,30-34,1893,5
SIM,1836,42,na,1878,3165
SIM,1844,21,25-29,1865,112
STAT,1859,46,35-39,1905,0.22568744065163396
STAT,1889,28,25-29,1917,104.96958981330901
SIM,1873,34,na,1907,4991
STAT,1892,39,45-49,1931,4.989397653753342
STAT,1899,23,15-19,1922,9.100648773946496
SIM,1835,35,40-44,1870,15
STAT,1860,15,30-34,1875,3.050701129781404
STAT,1851,64,na,1915,2694.7730031869564
STAT,1874,53,50-100,1927,0.030729748982991065
STAT,1919,29,25-29,1948,142.57527474770504
SIM,1833,37,50-100,1870,6
SIM,1796,94,na,1890,9
STAT,1868,20,25-29,1888,111.59571493743205
STAT,1812,43,40-44,1855,17.461339457431784
SIM,1835,24,45-49,1859,5
STAT,1856,34,na,1890,3686.6004512077234
SIM,1847,22,20-24,1869,144
STAT,1907,23,25-29,1930,169.40064945173927
STAT,1823,33,50-100,1856,4.565216529790105
SIM,1854,1,na,1855,6043
SIM,1895,19,25-29,1914,22
SIM,1827,29,20-24,1856,20
SIM,1928,38,30-34,1966,8
SIM,1835,23,40-44,1858,5
STAT,1921,4,na,1925,9289.453858306868
STAT,1894,26,40-44,1920,7.798351802512688
STAT,1925,47,45-49,1972,0.5317828663795016
SIM,1826,32,na,1858,3426
SIM,1851,34,na,1885,3863
STAT,1927,23,45-49,1950,2.790666968126646
SIM,1897,26,50-100,1923,2
STAT,1905,20,50-100,1925,1.1981729207725356
SIM,1836,22,45-49,1858,3
SIM,1913,35,25-29,1948,4
SIM,1876,93,na,1969,260
STAT,1823,46,20-24,1869,0.03760990158248322
SIM,1882,35,20-24,1917,1
SIM,1858,35,35-39,1893,19
STAT,1855,24,20-24,1879,119.66207842266797
SIM,1859,37,na,1896,4205
STAT,1823,41,50-100,1864,3.608201955208692
SIM,1863,24,20-24,1887,130
SIM,1879,49,50-100,1928,1
STAT,1929,19,40-44,1948,3.5854342216193693
SIM,1937,24,15-19,1961,8
STAT,1965,2,na,1967,9920.204471574512
SIM,1819,44,50-100,1863,4
SIM,1903,0,na,1903,8101
SIM,1916,20,30-34,1936,85
STAT,1944,20,40-44,1964,7.336567184887824
SIM,1900,30,20-24,1930,8
STAT,1874,35,20-24,1909,1.6091887158528684
STAT,1905,35,25-29,1940,1.8323558269621127
SIM,1880,27,25-29,1907,102
STAT,1894,15,45-49,1909,0.17025989263520155
SIM,1828,28,25-29,1856,74
SIM,1914,24,20-24,1938,239
STAT,1924,46,50-100,1970,0.5450271690293357
SIM,1920,25,15-19,1945,1
STAT,1907,44,25-29,1951,0.1305805884573602
STAT,1884,26,40-44,1910,5.994465704191288
SIM,1876,20,25-29,1896,126
STAT,1891,19,na,1910,6271.066155291434
STAT,1821,69,na,1890,1626.6927786469164
SIM,1871,32,40-44,1903,14
STAT,1789,72,na,1861,1116.4158834432376
SIM,1834,45,35-39,1879,1
STAT,1922,11,na,1933,9272.45529064724
STAT,1952,15,50-100,1967,0.9071658090301585
STAT,1840,27,na,1867,3893.3663427764122
STAT,1930,26,20-24,1956,46.89732259372175
STAT,1867,29,na,1896,4481.666867675714
STAT,1896,49,30-34,1945,0.14255575534880488
STAT,1908,20,30-34,1928,53.71787151602996
SIM,1935,35,45-49,1970,5
STAT,1941,15,40-44,1956,2.9113324478597526
STAT,1851,38,45-49,1889,3.0910973069936842
SIM,1868,42,na,1910,4439
SIM,1871,35,45-49,1906,1
SIM,1891,47,30-34,1938,2
STAT,1849,36,30-34,1885,8.716484854261106
STAT,1878,25,45-49,1903,2.3578517784767703
STAT,1881,18,50-100,1899,0.09538556243047683
STAT,1925,20,30-34,1945,69.8813426986306
SIM,1918,35,45-49,1953,4
STAT,1836,48,20-24,1884,0.016488471327457718
SIM,1858,74,na,1932,1783
SIM,1847,82,na,1929,676
SIM,1905,16,na,1921,7658
STAT,1839,30,na,1869,4251.80284811088
SIM,1817,50,na,1867,2768
STAT,1915,37,35-39,1952,4.935197164679057
SIM,1913,48,30-34,1961,1
SIM,1874,24,30-34,1898,3
STAT,1944,28,50-100,1972,2.1714848253484917
STAT,1850,32,20-24,1882,4.335581477746525
SIM,1938,22,15-19,1960,11
SIM,1876,36,40-44,1912,10
STAT,1841,49,40-44,1890,0.2432128087536952
SIM,1908,29,15-19,1937,4
STAT,1893,36,35-39,1929,18.192960700015096
SIM,1809,45,40-44,1854,1
SIM,1816,57,na,1873,2380
SIM,1848,67,na,1915,2319
SIM,1839,26,50-100,1865,1
STAT,1921,15,50-100,1936,0.8662913348209165
SIM,1870,19,20-24,1889,35
STAT,1880,56,na,1936,4339.470291386
SIM,1849,60,na,1909,3085
STAT,1771,99,na,1870,0.5217141513822112
STAT,1805,102,na,1907,0.21929763970608773
STAT,1899,39,na,1938,6504.625951674796
SIM,1881,24,15-19,1905,3
SIM,1885,22,na,1907,4930
STAT,1945,19,25-29,1964,95.53387385452046
SIM,1816,43,25-29,1859,2
SIM,1866,64,na,1930,3341
STAT,1872,19,50-100,1891,0.0989075202092735
STAT,1881,21,50-100,1902,0.7984433362032695
SIM,1826,64,na,1890,1907
SIM,1892,26,40-44,1918,12
STAT,1868,36,40-44,1904,8.451972125984652
SIM,1867,46,35-39,1913,1
SIM,1897,28,25-29,1925,132
SIM,1932,15,40-44,1947,8
SIM,1844,29,20-24,1873,23
STAT,1904,15,20-24,1919,51.62916534667783
STAT,1934,22,30-34,1956,78.01887273842439
STAT,1836,29,20-24,1865,19.898944578270665
SIM,1876,24,40-44,1900,5
SIM,1923,37,35-39,1960,9
STAT,1893,28,50-100,1921,1.6317703829077745
SIM,1869,48,25-29,1917,1
SIM,1912,15,20-24,1927,50
STAT,1813,79,na,1892,621.2255147114566
STAT,1924,15,40-44,1939,3.378660649048038
STAT,1905,48,30-34,1953,0.15748022634474793
SIM,1877,32,50-100,1909,5
SIM,1886,25,45-49,1911,3
SIM,1825,35,40-44,1860,11
SIM,1888,11,na,1899,6071
STAT,1829,42,50-100,1871,1.7388630520468285
STAT,1853,79,na,1932,1106.1253467492177
STAT,1931,25,na,1956,9776.637027874429
STAT,1946,24,15-19,1970,11.954515896584248
STAT,1888,76,na,1964,2859.587309155166
SIM,1942,22,30-34,1964,86
STAT,1843,45,35-39,1888,0.20026651689317404
SIM,1866,34,25-29,1900,23
SIM,1904,41,45-49,1945,1
SIM,1869,22,40-44,1891,5
STAT,1915,16,35-39,1931,1.7781926845798968
SIM,1909,45,45-49,1954,1
STAT,1921,27,15-19,1948,1.5886241639817282
STAT,1941,27,35-39,1968,31.368154777158214
STAT,1821,46,50-100,1867,0.7293294796837465
SIM,1838,35,na,1873,3591
SIM,1908,56,na,1964,6362
STAT,1819,42,na,1861,2971.3900725589915
STAT,1931,41,30-34,1972,0.34544506261313196
STAT,1918,38,50-100,1956,0.8926987292746941
SIM,1917,19,na,1936,8154
SIM,1913,27,30-34,1940,87
SIM,1859,32,25-29,1891,25
SIM,1830,34,45-49,1864,5
STAT,1846,18,25-29,1864,10.839334339922924
SIM,1889,30,45-49,1919,2
STAT,1867,23,35-39,1890,11.00326507433859
SIM,1854,18,25-29,1872,13
STAT,1878,46,45-49,1924,0.49920829305803804
SIM,1899,21,30-34,1920,68
STAT,1858,12,na,1870,4390.439360579457
STAT,1862,19,20-24,1881,31.52056360000285
SIM,1907,20,20-24,1927,209
STAT,1856,34,15-19,1890,0.22000492954334494
STAT,1931,38,30-34,1969,4.870127574122042
SIM,1856,46,25-29,1902,1
STAT,1884,46,35-39,1930,0.2799905609643161
SIM,1815,72,na,1887,1097
STAT,1900,23,30-34,1923,49.7491278625578
STAT,1839,53,20-24,1892,0.0011337083073083736
STAT,1831,26,25-29,1857,74.66655961503525
SIM,1942,25,50-100,1967,2
SIM,1837,27,na,1864,3707
SIM,1877,56,na,1933,4082
STAT,1873,11,na,1884,5407.787714601156
STAT,1866,24,30-34,1890,32.98503552792866
SIM,1911,25,50-100,1936,2
STAT,1880,70,na,1950,2985.142815894345
STAT,1912,25,15-19,1937,1.4149364529718187
STAT,1883,47,30-34,1930,0.19118218684536709
STAT,1826,45,35-39,1871,0.2868648716098873
STAT,1835,107,na,1942,0.006107829104240099
SIM,1913,26,na,1939,7681
STAT,1861,32,30-34,1893,29.349931510039568
SIM,1871,31,50-100,1902,3
STAT,1950,17,40-44,1967,3.339920131275085
SIM,1841,16,25-29,1857,14
SIM,1853,19,20-24,1872,28
SIM,1867,42,50-100,1909,8
STAT,1834,87,na,1921,234.1333152128827
SIM,1866,36,40-44,1902,16
SIM,1867,49,na,1916,4463
SIM,1784,94,na,1878,5
SIM,1860,13,na,1873,4815
SIM,1895,38,25-29,1933,8
SIM,1787,80,na,1867,358
STAT,1905,15,30-34,1920,4.676972454607716
STAT,1926,19,15-19,1945,111.75434448235903
SIM,1934,19,15-19,1953,119
SIM,1909,33,45-49,1942,5
STAT,1802,87,na,1889,130.1900217871009
STAT,1932,37,35-39,1969,6.563924485974758
SIM,1923,16,35-39,1939,11
STAT,1853,28,45-49,1881,1.8386308537626057
SIM,1861,28,45-49,1889,2
STAT,1845,19,20-24,1864,34.122688082987516
STAT,1941,20,15-19,1961,11.118245558923789
STAT,1880,78,na,1958,1898.0650422552244
STAT,1877,49,20-24,1926,0.0246404546195517
STAT,1827,54,40-44,1881,0.016050096203094524
SIM,1893,25,45-49,1918,2
SIM,1918,19,30-34,1937,36
SIM,1868,49,20-24,1917,1
STAT,1853,90,na,1943,124.74166001285919
STAT,1865,27,25-29,1892,77.61512238347554
STAT,1881,53,25-29,1934,0.006803280581471427
SIM,1893,33,30-34,1926,56
SIM,1814,95,na,1909,3
STAT,1904,45,na,1949,6587.946030612651
SIM,1922,25,25-29,1947,175
SIM,1903,21,40-44,1924,7
SIM,1912,2,na,1914,8405
STAT,1849,32,15-19,1881,0.23736804888359772
SIM,1928,22,15-19,1950,14
STAT,1850,39,40-44,1889,6.678043234010356
STAT,1808,46,50-100,1854,1.598999803972475
STAT,1831,98,na,1929,4.194347785577717
SIM,1826,34,45-49,1860,4
STAT,1897,58,na,1955,5338.805071268334
STAT,1922,15,30-34,1937,28.61389921549282
STAT,1827,38,45-49,1865,4.033461900317725
STAT,1927,20,40-44,1947,8.41512133902058
SIM,1930,15,30-34,1945,42
STAT,1835,45,35-39,1880,0.2155762983135018
SIM,1904,12,na,1916,7604
STAT,1757,114,na,1871,9.915242273917254E-4
STAT,1859,16,45-49,1875,0.12261123922379032
STAT,1891,30,na,1921,6005.028553850274
STAT,1912,29,30-34,1941,77.44665044638892
STAT,1901,41,45-49,1942,0.29517738528603227
STAT,1885,33,30-34,1918,34.951084562646955
SIM,1848,45,na,1893,3495
STAT,1894,45,40-44,1939,0.25304145602584094
SIM,1920,29,30-34,1949,101
STAT,1887,38,25-29,1925,6.47125208330667
SIM,1882,33,20-24,1915,5
STAT,1934,37,45-49,1971,1.900236737584704
SIM,1797,90,na,1887,33
SIM,1841,23,30-34,1864,42
SIM,1905,34,20-24,1939,7
STAT,1837,24,45-49,1861,1.254385317203248
STAT,1930,9,na,1939,10394.15485198538
SIM,1887,15,na,1902,6279
STAT,1919,44,na,1963,8099.647696568197
SIM,1830,31,40-44,1861,9
STAT,1920,19,20-24,1939,305.4814360262143
STAT,1860,25,40-44,1885,5.037695482067802
SIM,1937,2,na,1939,8194
STAT,1943,19,15-19,1962,97.12739501138493
STAT,1875,39,45-49,1914,4.103440532696733
STAT,1895,46,45-49,1941,0.35132693282947897
SIM,1815,40,na,1855,2876
STAT,1901,29,20-24,1930,32.93207560824844
STAT,1879,62,na,1941,3861.0402011524166
STAT,1874,33,20-24,1907,5.566106698677201
STAT,1894,29,45-49,1923,2.8599789318327433
STAT,1850,42,50-100,1892,1.617831466867794
SIM,1889,35,30-34,1924,20
SIM,1784,91,na,1875,17
SIM,1935,20,40-44,1955,8
STAT,1844,23,40-44,1867,4.171468954654778
STAT,1890,40,50-100,1930,2.6305971544418827
STAT,1853,47,45-49,1900,0.37165873590308074
SIM,1852,23,40-44,1875,7
SIM,1875,78,na,1953,1603
SIM,1927,26,20-24,1953,51
SIM,1927,40,na,1967,9681
SIM,1932,20,15-19,1952,14
SIM,1911,38,50-100,1949,2
SIM,1871,33,45-49,1904,3
SIM,1867,25,35-39,1892,20
STAT,1914,25,25-29,1939,134.94090209055577
SIM,1883,39,45-49,1922,3
SIM,1878,35,20-24,1913,3
STAT,1853,50,45-49,1903,0.023291529942407723
STAT,1885,25,45-49,1910,2.247181005311958
SIM,1897,47,na,1944,6124
SIM,1897,22,na,1919,6457
STAT,1888,20,35-39,1908,14.012783325729123
STAT,1899,36,na,1935,6550.693336103193
SIM,1880,17,15-19,1897,13
STAT,1808,48,45-49,1856,1.4638955157359943
STAT,1948,24,25-29,1972,214.03607083437086
SIM,1915,27,40-44,1942,12
STAT,1833,23,30-34,1856,31.68577684952924
STAT,1891,35,20-24,1926,1.9426089875715122
STAT,1804,65,na,1869,1651.5532534201423
STAT,1914,55,na,1969,7128.791960667138
SIM,1917,30,na,1947,8250
STAT,1822,32,45-49,1854,11.187044641213054
SIM,1900,33,25-29,1933,39
SIM,1893,24,40-44,1917,7
STAT,1867,43,30-34,1910,2.1588025960557684
SIM,1820,46,45-49,1866,2
STAT,1890,28,30-34,1918,61.85879744506335
STAT,1905,39,40-44,1944,2.7319115181373177
SIM,1837,18,25-29,1855,9
SIM,1919,36,30-34,1955,5
STAT,1923,24,20-24,1947,259.5787677907217
STAT,1908,35,35-39,1943,4.620127440819063
SIM,1875,43,30-34,1918,7
STAT,1868,18,50-100,1886,0.09527913766341063
STAT,1853,44,40-44,1897,3.510770290568002
SIM,1826,33,40-44,1859,11
STAT,1889,29,na,1918,5900.5228528722855
STAT,1870,49,na,1919,4367.902368301706
STAT,1919,26,20-24,1945,39.96170100353064
STAT,1832,52,50-100,1884,0.0204804867625175
SIM,1831,37,30-34,1868,13
STAT,1812,46,45-49,1858,1.6672318668158395
SIM,1931,24,20-24,1955,291
STAT,1944,23,45-49,1967,2.4525906509744773
STAT,1823,37,30-34,1860,20.68040263489771
STAT,1918,42,35-39,1960,0.4323190919523336
SIM,1835,38,45-49,1873,5
STAT,1922,31,45-49,1953,3.6044740344389985
STAT,1824,44,20-24,1868,0.3931814901354873
SIM,1845,24,45-49,1869,1
SIM,1879,28,30-34,1907,78
SIM,1926,42,35-39,1968,1
SIM,1854,37,25-29,1891,10
SIM,1883,34,25-29,1917,26
SIM,1897,35,30-34,1932,21
STAT,1872,17,15-19,1889,12.085220594686415
SIM,1841,32,20-24,1873,7
STAT,1824,49,40-44,1873,0.40313414625730387
STAT,1818,42,30-34,1860,5.666258025615293
STAT,1866,41,na,1907,4326.436347000177
STAT,1933,31,20-24,1964,6.643215059324342
STAT,1818,49,50-100,1867,1.0498209871039472
SIM,1826,49,50-100,1875,3
SIM,1896,20,35-39,1916,14
SIM,1830,32,45-49,1862,5
SIM,1869,29,25-29,1898,99
STAT,1848,24,20-24,1872,135.61596016600964
STAT,1824,45,25-29,1869,0.14347705927868615
SIM,1884,26,na,1910,5176
SIM,1856,104,na,1960,1
SIM,1866,7,na,1873,5421
SIM,1871,53,na,1924,4087
STAT,1867,26,na,1893,4529.419375807181
SIM,1852,24,45-49,1876,1
SIM,1906,30,15-19,1936,1
STAT,1875,34,25-29,1909,21.115630677611673
SIM,1847,37,25-29,1884,11
STAT,1846,37,25-29,1883,4.605375498415989
SIM,1931,19,50-100,1950,1
STAT,1814,54,50-100,1868,0.07205922497508685
SIM,1817,84,na,1901,275
STAT,1891,36,25-29,1927,7.22217047883713
STAT,1923,19,50-100,1942,0.8834536358085441
SIM,1878,16,20-24,1894,30
SIM,1846,86,na,1932,253
SIM,1858,20,30-34,1878,37
STAT,1914,31,50-100,1945,1.6879882253416405
SIM,1884,46,35-39,1930,1
SIM,1826,42,30-34,1868,4
STAT,1869,23,45-49,1892,1.3603994904652439
STAT,1885,24,40-44,1909,4.162848623506349
STAT,1876,46,35-39,1922,0.29327065547372483
SIM,1937,19,40-44,1956,4
SIM,1938,27,35-39,1965,39
STAT,1875,26,na,1901,4979.450578096825
SIM,1848,34,30-34,1882,38
STAT,1890,1,na,1891,6709.825308563011
SIM,1913,39,40-44,1952,3
SIM,1947,14,na,1961,9310
SIM,1856,24,20-24,1880,123
STAT,1806,91,na,1897,39.4575728388161
SIM,1881,21,45-49,1902,1
SIM,1916,35,35-39,1951,9
SIM,1922,31,50-100,1953,3
STAT,1907,27,40-44,1934,8.89191918680075
STAT,1847,31,45-49,1878,3.1536202238601434
STAT,1834,35,40-44,1869,7.400185167317504
STAT,1893,5,na,1898,6708.515016088647
STAT,1839,37,25-29,1876,5.372369987764037
STAT,1833,32,20-24,1865,4.584987550155117
SIM,1888,23,20-24,1911,151
STAT,1889,35,30-34,1924,13.397934433832496
STAT,1932,21,50-100,1953,1.749030434478675
STAT,1934,25,35-39,1959,40.83155354329015
SIM,1853,97,na,1950,9
SIM,1940,21,50-100,1961,3
STAT,1775,91,na,1866,26.37565291016294
SIM,1916,47,45-49,1963,1
STAT,1878,44,45-49,1922,3.1142524078317857
STAT,1915,34,30-34,1949,32.131977519748105
SIM,1902,29,20-24,1931,35
STAT,1917,30,25-29,1947,19.702325067632202
SIM,1860,16,na,1876,4664
SIM,1909,30,40-44,1939,13
STAT,1941,18,45-49,1959,1.0388777876455264
SIM,1876,39,45-49,1915,6
STAT,1916,33,na,1949,7852.66769969017
SIM,1845,42,40-44,1887,8
SIM,1848,16,35-39,1864,2
STAT,1841,23,15-19,1864,6.02019805282997
STAT,1843,16,na,1859,4133.529448943518
STAT,1854,45,45-49,1899,0.3653918391846732
STAT,1880,8,na,1888,5598.887414731383
SIM,1930,31,45-49,1961,8
SIM,1832,49,40-44,1881,1
STAT,1840,46,20-24,1886,0.017692357095585132
STAT,1855,71,na,1926,2012.7917349791205
STAT,1872,42,50-100,1914,2.141683179129153
STAT,1945,16,20-24,1961,299.1647317944069
STAT,1836,68,na,1904,2031.865737670052
SIM,1866,47,50-100,1913,3
STAT,1931,29,40-44,1960,12.141698818543622
SIM,1945,26,30-34,1971,104
SIM,1834,42,30-34,1876,5
STAT,1905,41,na,1946,6804.588482279181
SIM,1904,28,35-39,1932,39
STAT,1904,18,25-29,1922,16.383333709288344
STAT,1906,26,na,1932,7047.507213971293
SIM,1918,15,15-19,1933,17
STAT,1868,39,45-49,1907,3.7919846606851237
STAT,1838,44,15-19,1882,0.019387452337011658
STAT,1875,17,40-44,1892,0.3803197623682729
STAT,1919,22,na,1941,8074.3100574048585
STAT,1844,24,45-49,1868,1.3859091382242537
SIM,1870,23,na,1893,4576
STAT,1829,34,20-24,1863,4.912189116140593
STAT,1849,36,50-100,1885,2.0079641650714026
STAT,1869,52,na,1921,4191.187725480539
SIM,1884,37,50-100,1921,6
STAT,1891,44,50-100,1935,2.6017088754595847
STAT,1850,100,na,1950,1.627788239812212
STAT,1853,23,na,1876,3968.3973844104994
SIM,1897,25,20-24,1922,37
SIM,1883,26,30-34,1909,50
STAT,1872,27,25-29,1899,85.86090753847186
SIM,1842,33,25-29,1875,20
STAT,1854,53,na,1907,3247.781140408731
SIM,1903,67,na,1970,5439
STAT,1846,75,na,1921,1576.836461731262
STAT,1861,35,35-39,1896,12.002557717475874
SIM,1923,34,30-34,1957,64
SIM,1953,16,20-24,1969,338
STAT,1859,22,30-34,1881,29.707762656232937
STAT,1868,22,na,1890,4544.5033121801025
STAT,1939,22,25-29,1961,187.37134128266777
STAT,1925,23,35-39,1948,22.687709112194177
STAT,1908,47,45-49,1955,0.3972294599203715
SIM,1867,43,30-34,1910,3
SIM,1886,44,45-49,1930,8
STAT,1849,44,25-29,1893,1.0020519810314918
STAT,1869,32,35-39,1901,19.818055850734986
SIM,1885,22,25-29,1907,141
STAT,1866,63,na,1929,3325.014781461643
SIM,1912,18,25-29,1930,25
STAT,1950,14,na,1964,9376.351653244048
STAT,1826,46,na,1872,3097.7093746190276
STAT,1907,41,20-24,1948,0.03288412160537687
SIM,1877,32,35-39,1909,29
STAT,1876,37,50-100,1913,2.5645824207046273
STAT,1850,35,25-29,1885,4.5785986717504334
STAT,1877,81,na,1958,1352.2875324631007
SIM,1924,27,50-100,1951,3
SIM,1834,61,na,1895,2454
SIM,1895,66,na,1961,4742
SIM,1838,27,30-34,1865,58
SIM,1947,22,25-29,1969,255
STAT,1923,22,50-100,1945,1.5457366743298302
SIM,1896,29,na,1925,6517
STAT,1937,26,30-34,1963,77.18925594754295
SIM,1809,48,45-49,1857,1
STAT,1864,34,15-19,1898,0.25488882403905494
STAT,1866,34,50-100,1900,1.6927868876210304
STAT,1840,72,na,1912,1822.913462398968
STAT,1916,27,50-100,1943,2.078492330399977
STAT,1935,29,50-100,1964,2.738001740088566
STAT,1897,18,30-34,1915,4.291603238440024
STAT,1786,83,na,1869,239.1116405116764
SIM,1925,30,25-29,1955,31
SIM,1824,54,na,1878,2811
STAT,1875,26,30-34,1901,52.54171555654987
SIM,1914,41,na,1955,7590
SIM,1835,21,40-44,1856,4
SIM,1856,24,50-100,1880,1
STAT,1834,33,25-29,1867,17.284135413514388
STAT,1863,31,50-100,1894,1.6264507813847702
STAT,1875,22,15-19,1897,6.859830809681096
STAT,1809,49,15-19,1858,0.0029902492451950257
SIM,1893,15,35-39,1908,1
STAT,1807,54,na,1861,2521.6158540917872
SIM,1933,23,35-39,1956,31
STAT,1929,33,20-24,1962,6.252843769043378
STAT,1859,43,30-34,1902,1.8347291386820217
STAT,1889,25,20-24,1914,29.412243102029628
STAT,1817,61,na,1878,2226.833608099534
STAT,1911,17,20-24,1928,54.808102625166946
STAT,1941,24,30-34,1965,59.94808123839851
STAT,1857,104,na,1961,0.31394271851031424
STAT,1868,19,15-19,1887,11.473502549520852
SIM,1837,34,20-24,1871,8
SIM,1842,25,30-34,1867,66
SIM,1864,38,na,1902,4433
STAT,1811,101,na,1912,0.5304313680609222
STAT,1818,46,na,1864,2913.2601449629683
STAT,1849,46,40-44,1895,0.27157272279759337
SIM,1835,46,na,1881,3257
SIM,1861,25,40-44,1886,8
STAT,1903,31,35-39,1934,29.24001703800081
SIM,1845,43,45-49,1888,5
SIM,1949,21,50-100,1970,5
STAT,1874,27,35-39,1901,19.953162040194076
STAT,1904,20,50-100,1924,1.1891312056018555
SIM,1926,23,35-39,1949,28
STAT,1831,76,na,1907,1223.2384300718174
STAT,1896,25,20-24,1921,31.49329489699021
STAT,1853,25,40-44,1878,5.5703005748876695
STAT,1853,45,na,1898,3595.1900454496817
SIM,1948,21,20-24,1969,251
SIM,1882,27,35-39,1909,26
STAT,1882,15,25-29,1897,11.200501210688799
STAT,1907,9,na,1916,7701.811266426691
STAT,1918,23,35-39,1941,20.442968908276782
STAT,1834,25,30-34,1859,44.592837858524746
SIM,1912,20,50-100,1932,6
SIM,1857,49,45-49,1906,2
SIM,1856,34,30-34,1890,38
STAT,1885,15,35-39,1900,1.1081929090470848
STAT,1946,21,na,1967,8209.29611914726
STAT,1866,20,15-19,1886,6.287829777375794
STAT,1850,34,20-24,1884,4.246471009546631
STAT,1921,48,50-100,1969,0.5133977358435842
SIM,1837,72,na,1909,1591
SIM,1942,25,35-39,1967,42
SIM,1864,17,30-34,1881,3
STAT,1902,39,15-19,1941,0.03421182477053846
SIM,1937,33,20-24,1970,6
STAT,1934,17,50-100,1951,1.0236106188687666
SIM,1902,9,na,1911,7642
STAT,1842,53,na,1895,3154.1966464040083
STAT,1847,107,na,1954,0.007188725614530122
STAT,1848,34,30-34,1882,29.75709339481282
SIM,1829,41,45-49,1870,3
SIM,1890,24,15-19,1914,8
SIM,1833,23,30-34,1856,33
STAT,1767,91,na,1858,28.8800383006584
STAT,1878,66,na,1944,3457.1652147822583
SIM,1839,31,na,1870,3631
SIM,1872,89,na,1961,472
STAT,1846,27,15-19,1873,0.8407059970824573
STAT,1826,42,30-34,1868,2.4283818855600967
STAT,1839,64,na,1903,2714.322102036261
STAT,1882,24,15-19,1906,6.449857319759887
SIM,1816,46,50-100,1862,2
STAT,1787,68,na,1855,1338.1625999999999
STAT,1858,47,50-100,1905,0.3848744310216963
SIM,1835,54,40-44,1889,1
SIM,1872,38,30-34,1910,17
SIM,1939,15,50-100,1954,1
STAT,1864,38,30-34,1902,9.573814534405647
SIM,1880,42,50-100,1922,5
STAT,1931,34,15-19,1965,0.3396437985381756
STAT,1852,38,50-100,1890,1.9470833064426278
STAT,1893,33,30-34,1926,44.506135494102104
SIM,1926,44,na,1970,9449
SIM,1907,23,25-29,1930,191
SIM,1876,19,15-19,1895,13
STAT,1878,43,40-44,1921,4.710126581176157
SIM,1860,38,50-100,1898,3
STAT,1888,73,na,1961,3225.9468102017877
SIM,1897,5,na,1902,7247
STAT,1854,48,15-19,1902,6.054895868875038E-4
STAT,1931,22,na,1953,9565.875760346571
SIM,1886,43,40-44,1929,8
SIM,1918,32,40-44,1950,13
STAT,1845,25,na,1870,4116.314440685936
STAT,1892,27,na,1919,6033.836919083644
SIM,1868,33,45-49,1901,1
STAT,1796,82,na,1878,344.5072649132193
SIM,1809,94,na,1903,25
SIM,1866,39,50-100,1905,5
SIM,1835,39,20-24,1874,4
SIM,1825,31,25-29,1856,20
STAT,1870,44,45-49,1914,2.927522185520284
SIM,1872,47,na,1919,4732
STAT,1826,40,35-39,1866,3.985603617379792
STAT,1889,31,15-19,1920,0.3560775034480759
STAT,1898,37,25-29,1935,7.869098482891796
STAT,1896,17,na,1913,6734.3476804118445
SIM,1874,44,25-29,1918,1
STAT,1884,22,25-29,1906,114.16323287394833
SIM,1909,21,35-39,1930,24
STAT,1805,50,45-49,1855,0.11864671788454931
SIM,1832,27,30-34,1859,57
SIM,1832,29,25-29,1861,74
SIM,1898,40,na,1938,6626
STAT,1828,109,na,1937,8.737121882951284E-4
STAT,1876,19,45-49,1895,0.135717799230453
SIM,1853,19,15-19,1872,9
SIM,1891,41,20-24,1932,1
STAT,1866,44,25-29,1910,1.1804941275007776
STAT,1850,35,30-34,1885,8.47527843891297
STAT,1877,45,40-44,1922,0.36261289392884744
SIM,1826,33,50-100,1859,1
STAT,1887,34,15-19,1921,0.3189154053241612
SIM,1866,36,45-49,1902,7
STAT,1813,45,50-100,1858,1.5692021538056768
STAT,1830,37,50-100,1867,2.300917001382875
STAT,1871,25,20-24,1896,23.699031768560715
STAT,1833,38,35-39,1871,11.526278217452383
STAT,1850,9,na,1859,4564.768296037942
SIM,1918,48,50-100,1966,1
STAT,1871,27,15-19,1898,0.9103609598982549
STAT,1845,19,15-19,1864,11.422425262887495
STAT,1859,19,50-100,1878,0.09034307587265632
STAT,1881,63,na,1944,3483.1069117104844
SIM,1858,12,na,1870,4807
SIM,1841,38,35-39,1879,11
STAT,1854,28,25-29,1882,67.49325655958813
SIM,1834,40,35-39,1874,5
SIM,1869,29,20-24,1898,29
SIM,1948,15,35-39,1963,9
STAT,1809,74,na,1883,1048.8001393794896
STAT,1820,41,na,1861,3084.1110361563465
STAT,1864,47,25-29,1911,0.1035010385685932
STAT,1854,61,na,1915,2864.594561941772
STAT,1815,52,25-29,1867,0.018234002880276417
STAT,1820,52,35-39,1872,0.030810580847604956
STAT,1872,27,na,1899,4844.022896102783
STAT,1872,41,45-49,1913,3.051536483176028
STAT,1822,76,na,1898,1069.6976792012595
STAT,1837,43,45-49,1880,2.4306824876564495
STAT,1908,17,40-44,1925,0.5483232046910047
STAT,1893,31,35-39,1924,26.029996074484533
STAT,1879,28,30-34,1907,53.00893629922761
SIM,1957,13,na,1970,10315
STAT,1778,110,na,1888,0.0042383153490250704
STAT,1910,37,20-24,1947,0.5093636483781667
STAT,1801,104,na,1905,0.052870909090659474
SIM,1841,36,40-44,1877,10
STAT,1816,39,45-49,1855,13.258653411782591
STAT,1788,87,na,1875,118.5106912242807
STAT,1792,92,na,1884,23.125338239370368
STAT,1905,19,na,1924,7337.181592942956
SIM,1928,18,15-19,1946,105
SIM,1862,28,25-29,1890,81
SIM,1885,32,35-39,1917,27
SIM,1894,38,45-49,1932,4
STAT,1816,50,20-24,1866,0.0036197729550159433
STAT,1877,58,na,1935,4147.334781449138
STAT,1841,43,50-100,1884,1.5725336344006136
STAT,1886,38,45-49,1924,4.228919170927203
SIM,1864,25,25-29,1889,88
STAT,1849,46,45-49,1895,0.3743642677493262
STAT,1841,44,20-24,1885,0.23338465456918023
STAT,1765,90,na,1855,51.79520000000001
STAT,1886,3,na,1889,5944.959915513637
STAT,1915,49,na,1964,7433.2872099053775
SIM,1844,44,40-44,1888,5
STAT,1845,37,15-19,1882,0.0909168755800657
STAT,1856,25,25-29,1881,69.29516403982426
STAT,1873,22,20-24,1895,141.4123049814072
SIM,1816,44,35-39,1860,7
SIM,1892,22,25-29,1914,176
STAT,1948,21,20-24,1969,257.9178788065806
STAT,1888,10,na,1898,6183.276873175742
SIM,1887,28,30-34,1915,67
STAT,1833,36,40-44,1869,7.284020268294781
STAT,1883,41,20-24,1924,0.31655435222263945
SIM,1857,43,40-44,1900,7
STAT,1891,18,30-34,1909,3.968482406842153
STAT,1877,32,35-39,1909,21.23805956246573
SIM,1821,43,na,1864,3048
STAT,1845,35,20-24,1880,1.400252975652613
SIM,1860,48,45-49,1908,2
STAT,1831,40,45-49,1871,2.4317986367904045
SIM,1837,18,20-24,1855,21
STAT,1863,15,15-19,1878,12.114298483486962
STAT,1846,66,na,1912,2510.486802730057
SIM,1823,36,20-24,1859,5
SIM,1880,41,45-49,1921,2
SIM,1874,26,25-29,1900,88
SIM,1859,42,35-39,1901,7
STAT,1882,43,25-29,1925,1.2542512557219403
SIM,1843,33,40-44,1876,14
SIM,1888,39,30-34,1927,20
SIM,1855,55,na,1910,3650
STAT,1906,19,50-100,1925,0.1434071558061921
SIM,1845,53,50-100,1898,1
STAT,1913,14,na,1927,8130.642746894945
SIM,1851,21,25-29,1872,119
STAT,1890,32,50-100,1922,2.258688161914501
SIM,1889,38,35-39,1927,27
SIM,1821,39,20-24,1860,2
SIM,1891,23,20-24,1914,176
SIM,1888,42,na,1930,5462
STAT,1882,27,20-24,1909,23.080418280709065
STAT,1821,33,40-44,1854,28.49879045002027
STAT,1847,32,20-24,1879,4.8378576051076365
SIM,1894,23,45-49,1917,3
STAT,1931,35,50-100,1966,1.1249816289866004
SIM,1818,41,35-39,1859,3
STAT,1871,42,40-44,1913,4.507649257395335
STAT,1850,71,na,1921,2046.6094246230734
SIM,1848,37,35-39,1885,14
STAT,1876,21,50-100,1897,0.8543886744482317
SIM,1858,29,45-49,1887,3
STAT,1814,53,20-24,1867,0.003591870099233338
SIM,1862,45,45-49,1907,1
SIM,1824,39,45-49,1863,4
SIM,1885,14,na,1899,5409
SIM,1913,20,50-100,1933,2
STAT,1841,42,25-29,1883,0.9681786986146834
STAT,1881,44,20-24,1925,0.30583131263059155
SIM,1939,22,30-34,1961,74
STAT,1843,21,25-29,1864,101.3836335029971
STAT,1850,17,30-34,1867,2.986323532001043
STAT,1895,29,25-29,1924,110.52607432346983
SIM,1917,33,35-39,1950,28
STAT,1827,39,20-24,1866,1.519042315104316
STAT,1867,41,35-39,1908,3.44051512195967
STAT,1892,34,25-29,1926,25.67462043641708
SIM,1892,26,45-49,1918,4
STAT,1887,49,15-19,1936,4.990171629481441E-4
SIM,1836,38,25-29,1874,9
STAT,1858,43,na,1901,3612.5719309882975
STAT,1920,29,30-34,1949,86.1675853246122
STAT,1835,33,40-44,1868,7.080129707212028
SIM,1838,17,25-29,1855,11
STAT,1857,36,25-29,1893,4.554238167942596
SIM,1880,23,45-49,1903,2
STAT,1927,42,na,1969,9405.570642058856
STAT,1871,33,na,1904,4767.962889363458
SIM,1872,29,25-29,1901,97
SIM,1857,45,35-39,1902,1
STAT,1820,50,40-44,1870,0.0392077003532587
STAT,1803,53,45-49,1856,0.10448996134947255
STAT,1825,43,25-29,1868,1.4504435687099575
SIM,1874,42,30-34,1916,2
SIM,1890,27,20-24,1917,28
STAT,1867,26,40-44,1893,5.685327067965035
STAT,1863,33,45-49,1896,3.0698945648097435
STAT,1824,31,na,1855,3081.0681858114085
STAT,1866,42,30-34,1908,2.1397458133962157
SIM,1831,65,na,1896,2236
SIM,1869,83,na,1952,689
STAT,1935,5,na,1940,11103.18696824431
SIM,1894,50,na,1944,5901
STAT,1828,38,25-29,1866,5.681354425487803
STAT,1841,35,na,1876,3738.207619473513
STAT,1877,34,50-100,1911,1.9050606604547555
STAT,1884,26,45-49,1910,2.2218434351745127
SIM,1926,21,na,1947,9830
STAT,1802,54,40-44,1856,0.06480561243035597
STAT,1851,16,35-39,1867,1.0403005111736956
SIM,1853,35,20-24,1888,2
STAT,1852,48,45-49,1900,0.3714130126597161
STAT,1910,39,15-19,1949,0.03673251076751616
SIM,1833,43,25-29,1876,1
SIM,1836,96,na,1932,5
SIM,1842,32,40-44,1874,13
SIM,1861,63,na,1924,3402
STAT,1840,46,25-29,1886,0.08492331009737208
STAT,1856,53,25-29,1909,0.005430674469235029
STAT,1876,34,40-44,1910,8.981234702019998
SIM,1875,41,35-39,1916,6
SIM,1783,84,na,1867,173
SIM,1916,8,na,1924,8656
STAT,1882,45,20-24,1927,0.02384413022766233
SIM,1810,71,na,1881,1246
SIM,1921,34,50-100,1955,3
STAT,1864,17,30-34,1881,2.9766350777155157
STAT,1829,94,na,1923,23.65370484678019
STAT,1906,30,50-100,1936,1.5607526725860723
SIM,1883,17,35-39,1900,1
STAT,1949,22,50-100,1971,1.5505572491732278
STAT,1823,46,25-29,1869,0.18052751917481233
STAT,1842,40,20-24,1882,0.25097522689356944
STAT,1819,45,20-24,1864,0.05189695382085906
SIM,1821,44,45-49,1865,4
SIM,1772,92,na,1864,16
SIM,1872,17,30-34,1889,6
SIM,1838,35,25-29,1873,7
STAT,1824,100,na,1924,1.1350429001317335
STAT,1834,41,na,1875,3411.6858014734626
STAT,1901,49,na,1950,6229.4725214389
STAT,1815,54,20-24,1869,0.003649855208768204
SIM,1934,30,30-34,1964,47
STAT,1888,40,50-100,1928,2.5472655283118444
STAT,1856,96,na,1952,13.380040430827457
STAT,1880,48,20-24,1928,0.025210080786305596
STAT,1886,23,45-49,1909,1.4820557973236774
STAT,1886,38,15-19,1924,0.11912449785490462
STAT,1897,26,25-29,1923,114.59058907434208
SIM,1842,35,45-49,1877,6
SIM,1922,48,45-49,1970,1
STAT,1917,22,30-34,1939,61.68732018352772
SIM,1833,26,35-39,1859,24
SIM,1882,36,30-34,1918,14
STAT,1834,35,45-49,1869,3.36999686451805
SIM,1925,22,30-34,1947,95
SIM,1842,34,35-39,1876,27
SIM,1817,43,40-44,1860,9
STAT,1840,45,15-19,1885,5.973489701499658E-4
SIM,1831,46,25-29,1877,1
STAT,1854,20,50-100,1874,0.7451769277063176
STAT,1870,29,20-24,1899,23.095187436505842
STAT,1804,51,40-44,1855,0.0628170292715236
STAT,1830,44,45-49,1874,2.6085549393886964
STAT,1947,22,15-19,1969,12.149603799229727
SIM,1836,88,na,1924,120
STAT,1819,47,15-19,1866,0.0016785953468891285
STAT,1862,34,40-44,1896,7.421952867021645
STAT,1851,34,35-39,1885,16.00380556177558
STAT,1899,33,25-29,1932,28.223100231564697
SIM,1864,37,20-24,1901,2
STAT,1865,46,30-34,1911,0.17811399500124753
STAT,1900,48,15-19,1948,6.241964340985127E-4
STAT,1886,36,20-24,1922,1.6513153569322214
SIM,1876,22,40-44,1898,5
SIM,1815,45,30-34,1860,1
STAT,1813,44,45-49,1857,9.825933408252341
STAT,1831,37,15-19,1868,0.09183393951342957
STAT,1855,107,na,1962,0.030046671580061794
STAT,1892,17,35-39,1909,1.3872990762625181
STAT,1848,47,40-44,1895,0.2794091586041947
SIM,1880,22,na,1902,5278
SIM,1882,57,na,1939,4142
STAT,1834,34,35-39,1868,16.912636328937865
SIM,1827,32,45-49,1859,6
STAT,1899,35,50-100,1934,3.4295993673154714
STAT,1825,42,40-44,1867,5.192958514838162
SIM,1768,87,na,1855,89
SIM,1873,28,30-34,1901,64
STAT,1868,22,40-44,1890,4.004093675703373
STAT,1902,42,na,1944,6604.7624555315815
STAT,1890,37,25-29,1927,7.097670006723149
STAT,1917,25,50-100,1942,2.122284529483403
STAT,1949,20,25-29,1969,217.8174720807278
STAT,1926,30,30-34,1956,38.51216087936131
STAT,1865,45,20-24,1910,0.022237243067436286
SIM,1892,55,na,1947,5864
SIM,1910,28,50-100,1938,2
STAT,1881,28,15-19,1909,0.8825466947116417
SIM,1884,34,40-44,1918,16
STAT,1878,12,na,1890,5447.288254806471
SIM,1892,38,50-100,1930,5
SIM,1890,43,25-29,1933,2
STAT,1850,19,25-29,1869,10.49265510936942
SIM,1900,16,na,1916,7421
STAT,1819,47,45-49,1866,0.9903720882439855
STAT,1909,16,45-49,1925,0.1984385474363273
STAT,1874,20,15-19,1894,6.8628051892735655
STAT,1871,40,45-49,1911,3.03333266094252
STAT,1880,35,45-49,1915,4.281568551049012
STAT,1894,31,50-100,1925,2.3868188963733683
STAT,1880,18,25-29,1898,12.02479081296048
STAT,1833,48,na,1881,3112.2151305003763
STAT,1889,44,20-24,1933,0.3901431726569129
SIM,1816,88,na,1904,90
STAT,1869,38,15-19,1907,0.10934602224584627
STAT,1925,47,na,1972,8989.005249870454
SIM,1833,44,35-39,1877,9
SIM,1851,25,45-49,1876,2
STAT,1838,27,30-34,1865,43.353047499323544
SIM,1816,42,40-44,1858,9
SIM,1894,36,20-24,1930,2
STAT,1892,35,35-39,1927,18.05227002652687
STAT,1824,45,30-34,1869,0.241121171389461
SIM,1831,28,25-29,1859,73
STAT,1875,35,35-39,1910,14.846765416324697
SIM,1827,29,15-19,1856,1
SIM,1902,39,30-34,1941,6
SIM,1785,79,na,1864,394
SIM,1902,22,35-39,1924,18
STAT,1881,46,15-19,1927,7.830487798048403E-4
STAT,1800,106,na,1906,0.010370477090546497
STAT,1861,53,35-39,1914,0.014239538874296237
STAT,1895,55,na,1950,5441.458187642553
SIM,1898,36,50-100,1934,5
STAT,1802,56,na,1858,2321.6017824006353
STAT,1839,51,50-100,1890,0.02369469142326203
STAT,1875,33,40-44,1908,8.979504187338707
STAT,1851,33,na,1884,3810.4500447880123
SIM,1873,43,25-29,1916,2
SIM,1841,18,40-44,1859,1
STAT,1828,37,15-19,1865,0.11308750562887109
STAT,1865,43,25-29,1908,1.1697256211412834
STAT,1891,36,30-34,1927,13.368698619318181
SIM,1862,57,na,1919,3695
SIM,1883,35,35-39,1918,23
STAT,1865,15,50-100,1880,0.10300196886672575
STAT,1929,29,na,1958,9458.499324500153
STAT,1928,31,50-100,1959,2.088814047128766
SIM,1898,47,45-49,1945,1
STAT,1963,9,na,1972,10080.6407437039
SIM,1926,38,50-100,1964,1
STAT,1895,28,15-19,1923,1.1897746634681472
STAT,1860,111,na,1971,0.0024807978761285827
SIM,1861,29,20-24,1890,25
SIM,1863,41,45-49,1904,6
SIM,1883,33,40-44,1916,15
STAT,1890,19,25-29,1909,13.894454393872802
STAT,1918,20,25-29,1938,202.36582593104487
STAT,1861,51,40-44,1912,0.017781740919700362
STAT,1798,77,na,1875,663.3233926692575
SIM,1882,18,30-34,1900,6
STAT,1809,66,na,1875,1778.777623426385
STAT,1871,73,na,1944,2383.2435465232047
SIM,1916,26,50-100,1942,2
STAT,1848,30,15-19,1878,0.2780248920567078
STAT,1830,24,20-24,1854,368.00133404988304
SIM,1852,51,40-44,1903,1
STAT,1933,34,na,1967,10281.414782748674
SIM,1832,45,30-34,1877,1
STAT,1861,26,45-49,1887,1.893584813383578
STAT,1853,29,20-24,1882,19.28746903034471
STAT,1847,20,na,1867,4053.506938024413
STAT,1865,30,15-19,1895,0.2633914961681413
SIM,1920,36,na,1956,8495
SIM,1880,23,15-19,1903,9
STAT,1805,84,na,1889,253.37343779079444
STAT,1869,36,20-24,1905,1.5157651784937538
STAT,1874,36,30-34,1910,11.074158053154129
SIM,1897,48,40-44,1945,1
SIM,1926,20,25-29,1946,274
SIM,1846,27,30-34,1873,66
SIM,1851,65,na,1916,2569
SIM,1871,47,50-100,1918,3
STAT,1952,20,30-34,1972,69.83322820781235
STAT,1848,43,20-24,1891,0.25852575748125867
STAT,1873,40,50-100,1913,2.1897734421256185
SIM,1932,29,50-100,1961,2
STAT,1830,26,45-49,1856,2.7673223038501207
SIM,1837,50,na,1887,2988
STAT,1841,29,25-29,1870,75.1416743184549
SIM,1863,98,na,1961,26
SIM,1779,79,na,1858,543
STAT,1855,54,20-24,1909,0.0010821345594995574
SIM,1867,34,40-44,1901,15
STAT,1824,51,50-100,1875,0.03593478251849625
STAT,1872,38,15-19,1910,0.11341385203964258
SIM,1879,36,25-29,1915,8
STAT,1889,48,40-44,1937,0.23746272451631878
SIM,1857,44,25-29,1901,2
SIM,1837,19,30-34,1856,6
STAT,1938,26,na,1964,7500.078036609363
STAT,1825,44,35-39,1869,4.00195931617973
STAT,1876,96,na,1972,107.94608555800568
STAT,1860,25,45-49,1885,1.86721739477375
STAT,1848,49,35-39,1897,0.22476599728117821
STAT,1873,68,na,1941,3135.9471307757904
SIM,1933,17,40-44,1950,5
STAT,1856,22,20-24,1878,124.71408072530184
STAT,1893,30,25-29,1923,26.430576616873626
STAT,1912,40,na,1952,7318.173569024399
STAT,1862,52,40-44,1914,0.018076098254602924
STAT,1885,25,na,1910,4830.16717306671
SIM,1831,49,30-34,1880,1
SIM,1810,63,na,1873,1902
STAT,1957,15,35-39,1972,11.177471396020167
STAT,1889,83,na,1972,1917.8527008863541
STAT,1851,15,25-29,1866,10.807234472720001
SIM,1862,25,20-24,1887,23
STAT,1858,32,25-29,1890,16.126143937679046
SIM,1852,39,20-24,1891,5
STAT,1883,42,30-34,1925,2.2784474636580008
STAT,1898,34,20-24,1932,7.324446181298674
SIM,1814,53,na,1867,2500
STAT,1871,28,25-29,1899,84.57966415851952
STAT,1847,17,25-29,1864,10.781113780004725
SIM,1859,40,40-44,1899,7
STAT,1907,20,20-24,1927,205.77775943163257
SIM,1843,98,na,1941,1
SIM,1867,19,45-49,1886,1
STAT,1901,57,na,1958,5812.2768020779195
STAT,1859,19,45-49,1878,0.1204574344968751
SIM,1850,91,na,1941,71
SIM,1807,52,40-44,1859,1
STAT,1812,86,na,1898,210.3178437903089
STAT,1820,53,45-49,1873,0.05091385509120326
SIM,1823,52,50-100,1875,1
STAT,1876,16,40-44,1892,0.382997176538462
SIM,1891,42,30-34,1933,6
SIM,1889,37,25-29,1926,9
STAT,1844,54,45-49,1898,0.02279181816146981
SIM,1818,39,20-24,1857,2
STAT,1850,36,40-44,1886,6.889346203332967
STAT,1861,35,na,1896,3998.0299618192394
STAT,1789,80,na,1869,523.0160646687925
STAT,1872,40,35-39,1912,3.712569025730832
STAT,1841,27,30-34,1868,45.38092758566561
SIM,1816,96,na,1912,3
STAT,1853,107,na,1960,0.02192901071215765
SIM,1861,44,45-49,1905,7
STAT,1855,30,50-100,1885,1.4363136707415456
STAT,1914,2,na,1916,8517.808642076086
SIM,1863,27,30-34,1890,54
STAT,1833,39,45-49,1872,3.214961661712635
SIM,1918,17,45-49,1935,1
STAT,1816,51,30-34,1867,0.028622316132156832
SIM,1816,45,45-49,1861,1
STAT,1860,22,40-44,1882,3.5230770424039606
SIM,1854,33,45-49,1887,3
SIM,1943,20,25-29,1963,212
SIM,1866,32,25-29,1898,21
SIM,1833,29,45-49,1862,1
SIM,1840,61,na,1901,2917
STAT,1799,79,na,1878,587.1847540268401
STAT,1875,36,45-49,1911,4.165110601307117
SIM,1929,17,20-24,1946,337
STAT,1849,86,na,1935,350.96335945375466
SIM,1880,40,35-39,1920,4
STAT,1825,110,na,1935,3.19733035753854E-4
STAT,1909,15,35-39,1924,1.6705258536600707
SIM,1835,41,35-39,1876,2
STAT,1861,63,na,1924,2999.4304179155606
STAT,1874,19,40-44,1893,0.3761995843960056
STAT,1822,47,20-24,1869,0.037306788242604826
STAT,1835,36,45-49,1871,3.226731436352354
SIM,1915,20,20-24,1935,236
SIM,1841,35,30-34,1876,13
SIM,1890,15,25-29,1905,22
STAT,1848,46,25-29,1894,0.09471528934980039
SIM,1829,63,na,1892,2249
SIM,1883,36,45-49,1919,4
STAT,1833,35,30-34,1868,8.961138635919326
STAT,1823,49,30-34,1872,0.29070721103489666
STAT,1832,86,na,1918,289.2639455507915
STAT,1782,90,na,1872,58.498426067930524
STAT,1844,39,20-24,1883,1.2884319401367
STAT,1855,27,30-34,1882,39.580157180811995
STAT,1901,49,15-19,1950,6.246282236630049E-4
STAT,1846,51,45-49,1897,0.022335153426569585
STAT,1854,25,20-24,1879,21.01862150353683
SIM,1845,45,na,1890,3719
STAT,1867,29,45-49,1896,2.0850451539925854
SIM,1898,44,40-44,1942,1
STAT,1873,29,50-100,1902,1.3033026789546498
SIM,1820,43,45-49,1863,5
STAT,1839,33,na,1872,4121.395906687975
STAT,1853,48,na,1901,3514.9735794924213
STAT,1885,48,50-100,1933,0.48752502239179
STAT,1938,32,15-19,1970,0.26100140351842205
SIM,1819,53,na,1872,2505
STAT,1893,49,45-49,1942,0.33366508645489595
STAT,1935,20,25-29,1955,254.258623116058
SIM,1810,50,50-100,1860,2
STAT,1862,35,20-24,1897,1.3432775575001121
STAT,1857,52,30-34,1909,0.00932060125561911
STAT,1872,30,50-100,1902,1.8746895756678532
STAT,1845,22,45-49,1867,1.3339567920199025
SIM,1872,41,50-100,1913,5
SIM,1883,32,30-34,1915,39
SIM,1870,34,40-44,1904,12
STAT,1815,39,25-29,1854,20.121194827110703
SIM,1908,36,na,1944,7144
SIM,1869,26,15-19,1895,1
SIM,1891,27,40-44,1918,12
STAT,1842,22,20-24,1864,129.40619570649685
SIM,1843,36,45-49,1879,8
STAT,1826,109,na,1935,8.516920755603356E-4
STAT,1948,22,30-34,1970,66.64379659739366
STAT,1882,25,na,1907,4727.091924835533
SIM,1816,41,30-34,1857,2
SIM,1855,17,25-29,1872,18
STAT,1895,26,20-24,1921,30.978793083332995
SIM,1850,22,20-24,1872,133
STAT,1838,24,20-24,1862,119.27242452116505
STAT,1861,50,30-34,1911,0.010150080198391198
SIM,1874,50,na,1924,4188
SIM,1834,21,25-29,1855,117
STAT,1795,89,na,1884,81.65757169481448
STAT,1868,53,na,1921,4070.9386541076487
SIM,1853,22,45-49,1875,2
STAT,1818,49,20-24,1867,0.05129418706852318
SIM,1846,39,25-29,1885,9
STAT,1846,33,45-49,1879,3.123882884789149
SIM,1841,17,30-34,1858,5
SIM,1833,25,25-29,1858,90
STAT,1865,25,na,1890,4408.527009835436
STAT,1812,43,45-49,1855,11.618558173704908
SIM,1823,39,25-29,1862,5
SIM,1856,29,40-44,1885,8
STAT,1828,35,20-24,1863,1.6172535051839112
STAT,1872,23,15-19,1895,6.675471569378691
SIM,1856,96,na,1952,6
STAT,1897,39,30-34,1936,3.07425734865251
STAT,1925,17,40-44,1942,3.4117369141546225
STAT,1868,42,35-39,1910,3.47524260048739
STAT,1883,27,40-44,1910,5.944017687625414
STAT,1847,35,25-29,1882,4.649215686347647
STAT,1851,28,50-100,1879,1.1527361811836685
STAT,1881,47,25-29,1928,0.11191568001440133
SIM,1909,29,na,1938,7258
STAT,1821,51,40-44,1872,0.030235615539896368
STAT,1866,66,na,1932,3054.262168010669
STAT,1891,37,40-44,1928,10.92791964226931
STAT,1832,52,25-29,1884,0.0048032411612331394
STAT,1849,94,na,1943,31.613942791210807
STAT,1864,32,20-24,1896,4.87985760749542
SIM,1916,31,na,1947,8066
STAT,1848,29,40-44,1877,5.779915903032033
SIM,1864,22,20-24,1886,150
STAT,1836,76,na,1912,1259.6519539944543
STAT,1889,47,30-34,1936,0.13534091395830114
SIM,1903,24,50-100,1927,3
STAT,1894,30,na,1924,6240.802230250836
SIM,1832,46,40-44,1878,1
STAT,1914,48,45-49,1962,0.4341881065506408
STAT,1824,42,25-29,1866,1.669001446661432
SIM,1890,0,na,1890,7200
STAT,1873,37,25-29,1910,5.908274193732041
SIM,1884,19,45-49,1903,1
SIM,1914,44,na,1958,7536
STAT,1861,43,na,1904,3857.147525034425
SIM,1930,5,na,1935,11068
SIM,1824,36,40-44,1860,15
SIM,1881,37,25-29,1918,7
STAT,1889,15,na,1904,6318.568584811712
STAT,1891,33,25-29,1924,25.461550956161147
SIM,1878,19,20-24,1897,33
SIM,1833,68,na,1901,1930
STAT,1856,37,20-24,1893,1.2011646257825195
SIM,1876,42,35-39,1918,6
SIM,1880,30,50-100,1910,1
STAT,1834,32,40-44,1866,7.3944842898540415
SIM,1879,22,50-100,1901,1
STAT,1807,49,45-49,1856,1.5618032292879753
STAT,1824,46,40-44,1870,0.4204906440145851
SIM,1882,39,35-39,1921,23
SIM,1865,22,na,1887,4485
SIM,1898,32,na,1930,6749
STAT,1858,36,40-44,1894,6.925192311520482
SIM,1865,37,40-44,1902,14
STAT,1874,53,na,1927,4381.076616650547
STAT,1909,33,35-39,1942,17.54721251127472
STAT,1917,25,35-39,1942,32.01190435349932
STAT,1885,45,na,1930,4567.937152882452
SIM,1769,92,na,1861,15
SIM,1854,30,na,1884,4177
STAT,1902,45,15-19,1947,6.497721411967666E-4
SIM,1851,42,30-34,1893,3
STAT,1840,43,20-24,1883,0.23608365946924112
SIM,1945,21,45-49,1966,5
STAT,1866,27,35-39,1893,17.980582484361154
STAT,1910,19,20-24,1929,53.98359250375483
STAT,1883,23,20-24,1906,136.3186963886659
STAT,1859,84,na,1943,534.7524837540634
SIM,1869,44,45-49,1913,2
SIM,1919,28,15-19,1947,1
STAT,1876,37,45-49,1913,4.164114107122261
SIM,1831,41,50-100,1872,3
SIM,1859,43,50-100,1902,5
SIM,1838,32,20-24,1870,3
SIM,1857,50,na,1907,3897
SIM,1861,31,35-39,1892,22
SIM,1908,22,30-34,1930,59
STAT,1853,32,45-49,1885,2.8412789063710613
STAT,1845,37,45-49,1882,3.22754869925786
STAT,1912,29,na,1941,7404.483955830078
STAT,1863,48,20-24,1911,0.020948244032045697
STAT,1881,17,30-34,1898,3.1113626989239345
STAT,1833,35,25-29,1868,4.841074868692349
SIM,1849,83,na,1932,518
SIM,1896,6,na,1902,7288
STAT,1841,43,na,1884,3440.291322905715
SIM,1795,89,na,1884,87
SIM,1897,29,30-34,1926,98
STAT,1880,32,40-44,1912,9.226680995458253
STAT,1883,25,50-100,1908,1.2779360888929343
SIM,1850,71,na,1921,2038
STAT,1809,46,45-49,1855,1.8627476434076131
SIM,1813,68,na,1881,1599
SIM,1939,25,35-39,1964,41
SIM,1821,35,na,1856,3301
STAT,1868,25,45-49,1893,2.1479509578239853
SIM,1953,9,na,1962,9959
SIM,1875,26,45-49,1901,2
SIM,1907,62,na,1969,5988
SIM,1925,25,35-39,1950,43
SIM,1935,32,40-44,1967,17
STAT,1937,21,45-49,1958,2.2140657350670723
STAT,1869,39,25-29,1908,5.57770690741204
SIM,1859,5,na,1864,5200
STAT,1816,99,na,1915,1.8602556425639314
STAT,1889,29,30-34,1918,62.26060255206528
STAT,1845,50,45-49,1895,0.022684057950219688
SIM,1922,31,na,1953,9060
SIM,1824,32,20-24,1856,8
STAT,1880,50,35-39,1930,0.018579616407579515
STAT,1821,110,na,1931,3.063058814429946E-4
SIM,1817,46,45-49,1863,1
STAT,1900,32,35-39,1932,28.37223643478958
STAT,1897,38,20-24,1935,2.070694134881933
SIM,1891,25,50-100,1916,3
SIM,1924,15,50-100,1939,1
STAT,1838,42,20-24,1880,0.25136525559149814
STAT,1850,32,25-29,1882,16.428664640651796
STAT,1887,16,15-19,1903,13.43784252558019
STAT,1856,50,20-24,1906,0.0011663765519310926
STAT,1892,16,25-29,1908,14.362354060040314
STAT,1916,15,50-100,1931,0.16128180899290206
SIM,1846,24,20-24,1870,128
STAT,1840,33,50-100,1873,1.594211501699017
STAT,1861,54,45-49,1915,0.02372462994390004
STAT,1853,31,35-39,1884,16.672660313767807
STAT,1884,43,30-34,1927,2.276187098732278
SIM,1920,16,50-100,1936,1
SIM,1832,27,na,1859,3701
STAT,1897,23,20-24,1920,185.46419700919506
STAT,1759,103,na,1862,0.04231968190644114
STAT,1818,71,na,1889,1424.4732124592201
STAT,1889,47,50-100,1936,0.34338562378401044
STAT,1875,32,30-34,1907,36.304890871742636
STAT,1836,44,40-44,1880,3.4684851179783776
STAT,1851,19,45-49,1870,0.12166979402867176
SIM,1895,16,15-19,1911,14
SIM,1858,26,40-44,1884,7
STAT,1834,36,50-100,1870,2.054063860863211
STAT,1782,104,na,1886,0.06669467646392443
STAT,1864,29,25-29,1893,75.82134624700333
SIM,1917,15,35-39,1932,2
STAT,1817,52,30-34,1869,0.027553874513282946
STAT,1927,32,40-44,1959,9.720677720335747
SIM,1882,20,15-19,1902,7
SIM,1877,39,25-29,1916,8
STAT,1817,39,50-100,1856,7.658164936332974
STAT,1837,18,50-100,1855,0.1060078615657183
STAT,1846,15,15-19,1861,11.554595149700525
STAT,1925,39,na,1964,9098.258414690632
SIM,1842,36,50-100,1878,7
SIM,1871,22,na,1893,4620
SIM,1895,34,45-49,1929,8
SIM,1850,41,30-34,1891,3
SIM,1871,18,20-24,1889,30
SIM,1848,36,25-29,1884,8
SIM,1867,88,na,1955,211
SIM,1841,39,45-49,1880,5
SIM,1825,39,50-100,1864,3
STAT,1839,53,25-29,1892,0.005441799621235355
STAT,1846,48,15-19,1894,6.049847513567586E-4
STAT,1849,43,40-44,1892,3.5321991102492523
STAT,1865,47,40-44,1912,0.3126552415379297
SIM,1932,6,na,1938,10881
SIM,1828,43,45-49,1871,8
SIM,1949,18,na,1967,8972
STAT,1912,16,50-100,1928,0.153422701574242
SIM,1887,25,20-24,1912,31
STAT,1807,48,35-39,1855,0.944990544377117
STAT,1834,31,30-34,1865,30.0810964825716
STAT,1935,23,35-39,1958,25.89208506846725
STAT,1772,92,na,1864,17.310448438081472
SIM,1809,86,na,1895,203
SIM,1951,15,35-39,1966,10
STAT,1852,100,na,1952,1.692060726622606
STAT,1894,32,35-39,1926,26.27362779072243
SIM,1815,94,na,1909,16
STAT,1889,47,25-29,1936,0.08053343562876988
SIM,1885,45,40-44,1930,1
SIM,1919,31,45-49,1950,4
STAT,1848,46,30-34,1894,0.15917430724695802
STAT,1899,5,na,1904,7251.670163419247
STAT,1882,40,20-24,1922,0.3156009464600485
SIM,1892,47,na,1939,6426
STAT,1851,33,25-29,1884,16.355341478489382
STAT,1920,16,na,1936,8358.757891176292
STAT,1943,15,35-39,1958,8.991193014639677
STAT,1795,80,na,1875,548.2903437472305
STAT,1863,18,20-24,1881,32.35399384289574
SIM,1864,83,na,1947,577
STAT,1843,42,30-34,1885,1.6581667306330339
STAT,1811,47,45-49,1858,1.6020672429254952
SIM,1879,33,20-24,1912,1
STAT,1880,15,20-24,1895,37.89399179420833
STAT,1825,29,45-49,1854,7.485160622589756
STAT,1857,51,20-24,1908,0.0011671883946596136
SIM,1928,16,20-24,1944,353
STAT,1827,41,35-39,1868,3.502946850771282
SIM,1873,47,40-44,1920,1
STAT,1852,30,35-39,1882,17.062374147372108
SIM,1856,28,30-34,1884,55
STAT,1842,41,30-34,1883,1.7937139693298274
STAT,1854,43,15-19,1897,0.02101736364295597
STAT,1874,39,35-39,1913,14.4789928776904
STAT,1875,50,25-29,1925,0.00747092951746233
STAT,1871,27,45-49,1898,2.227839889213826
STAT,1841,26,20-24,1867,21.294434073940916
STAT,1920,29,50-100,1949,2.1889034998435806
SIM,1891,62,na,1953,4825
SIM,1945,18,15-19,1963,96
SIM,1899,27,40-44,1926,14
SIM,1875,40,25-29,1915,3
STAT,1923,21,15-19,1944,12.542761969240074
SIM,1802,76,na,1878,856
SIM,1878,40,na,1918,5115
STAT,1873,25,25-29,1898,87.39380252425345
SIM,1875,75,na,1950,2142
STAT,1837,61,na,1898,2604.421143889188
SIM,1860,30,35-39,1890,29
SIM,1933,23,na,1956,10180
STAT,1856,38,30-34,1894,8.263549412351768
SIM,1909,24,40-44,1933,10
STAT,1861,23,40-44,1884,3.5728272468695725
STAT,1899,37,40-44,1936,2.614518581016375
SIM,1874,28,50-100,1902,3
SIM,1922,47,35-39,1969,1
SIM,1885,30,40-44,1915,13
SIM,1858,47,45-49,1905,1
STAT,1819,56,na,1875,2413.2727718392002
STAT,1877,30,40-44,1907,9.16788572247555
SIM,1931,21,15-19,1952,10
SIM,1880,90,na,1970,435
STAT,1887,34,45-49,1921,3.905209222026361
SIM,1809,55,na,1864,2317
STAT,1830,51,na,1881,3147.3574513907124
STAT,1846,33,15-19,1879,0.2551090914076041
SIM,1804,63,na,1867,1783
STAT,1867,40,25-29,1907,1.2268472777021946
SIM,1878,12,na,1890,5621
SIM,1873,88,na,1961,374
STAT,1937,18,15-19,1955,88.95133721677047
STAT,1879,25,20-24,1904,24.950554454549966
SIM,1842,31,30-34,1873,43
STAT,1914,47,35-39,1961,0.2582872546774585
SIM,1943,23,35-39,1966,29
STAT,1848,28,30-34,1876,48.93965511566403
STAT,1858,53,30-34,1911,0.009221328646812263
SIM,1920,21,40-44,1941,8
STAT,1869,18,20-24,1887,34.96690984021807
SIM,1803,61,na,1864,2028
SIM,1929,18,30-34,1947,45
STAT,1785,99,na,1884,0.7744447161763957
STAT,1832,24,25-29,1856,104.5915078925033
SIM,1895,75,na,1970,3902
SIM,1861,43,35-39,1904,7
STAT,1863,36,20-24,1899,1.36934341907933
STAT,1876,30,25-29,1906,21.567342710706296
SIM,1889,2,na,1891,6782
STAT,1818,51,35-39,1869,0.03712959670170222
STAT,1945,16,na,1961,8122.069279810241
STAT,1837,28,20-24,1865,20.84055021398658
STAT,1820,37,45-49,1857,9.912724119278943
STAT,1922,25,15-19,1947,1.6238355028220564
STAT,1846,37,30-34,1883,8.524844054502143
STAT,1869,53,40-44,1922,0.020271186732368936
STAT,1888,48,25-29,1936,0.07658407583214942
STAT,1954,18,15-19,1972,113.259965091974
SIM,1860,70,na,1930,2473
SIM,1861,41,40-44,1902,5
SIM,1896,48,25-29,1944,2
STAT,1856,40,15-19,1896,0.02173611036873575
SIM,1921,46,na,1967,8394
STAT,1843,24,35-39,1867,10.113786790091789
SIM,1809,63,na,1872,1824
SIM,1929,7,na,1936,10645
SIM,1939,21,15-19,1960,10
STAT,1820,51,50-100,1871,0.05513762919089735
STAT,1860,21,30-34,1881,30.33285836110723
STAT,1841,66,na,1907,2378.088785217714
SIM,1837,33,45-49,1870,5
SIM,1884,30,25-29,1914,30
STAT,1912,21,40-44,1933,6.529309846492827
SIM,1951,8,na,1959,9802
STAT,1849,33,50-100,1882,1.5114408397515462
SIM,1828,29,30-34,1857,55
STAT,1877,48,15-19,1925,8.283222380775238E-4
STAT,1848,13,na,1861,4830.411704863259
STAT,1896,24,45-49,1920,1.8477180771117088
SIM,1868,73,na,1941,2280
STAT,1885,42,35-39,1927,3.635790254996199
SIM,1854,19,30-34,1873,4
STAT,1869,83,na,1952,776.8795456001061
SIM,1796,74,na,1870,873
SIM,1896,36,25-29,1932,12
STAT,1891,30,20-24,1921,6.802107768094505
SIM,1872,31,45-49,1903,8
STAT,1854,33,na,1887,3707.503508142524
STAT,1936,20,50-100,1956,1.271625609150654
SIM,1870,91,na,1961,195
STAT,1871,24,40-44,1895,4.15501872890271
STAT,1864,17,25-29,1881,10.582913631521858
SIM,1876,17,na,1893,5433
STAT,1872,58,na,1930,4014.009719039997
SIM,1917,16,na,1933,8629
STAT,1953,11,na,1964,9597.523919552208
SIM,1872,17,25-29,1889,18
STAT,1833,51,30-34,1884,0.008240085823522666
SIM,1833,26,40-44,1859,7
STAT,1784,104,na,1888,0.05592332296400757
SIM,1887,57,na,1944,4849
STAT,1893,16,45-49,1909,0.16762833599040725
SIM,1839,29,40-44,1868,2
SIM,1889,34,20-24,1923,10
STAT,1883,10,na,1893,5139.914919184295
SIM,1873,30,15-19,1903,1
STAT,1908,48,20-24,1956,0.020141958155331586
SIM,1930,39,40-44,1969,8
SIM,1892,43,30-34,1935,1
STAT,1821,34,20-24,1855,13.588531513258081
SIM,1930,25,15-19,1955,6
STAT,1844,51,40-44,1895,0.01708259334685138
SIM,1858,43,na,1901,3946
STAT,1838,27,50-100,1865,1.1012915940798567
STAT,1875,17,35-39,1892,1.140959221044637
SIM,1884,49,45-49,1933,2
SIM,1902,62,na,1964,5710
SIM,1837,19,na,1856,4043
STAT,1851,30,20-24,1881,4.452803055266255
SIM,1889,35,na,1924,5987
STAT,1869,94,na,1963,103.42524664107555
STAT,1855,7,na,1862,4439.232908714445
STAT,1893,19,45-49,1912,0.16632089260830826
STAT,1922,39,40-44,1961,3.4319253103708802
SIM,1837,81,na,1918,659
STAT,1872,27,30-34,1899,51.112722009126585
SIM,1887,24,15-19,1911,8
STAT,1838,91,na,1929,78.4246690628425
SIM,1857,42,30-34,1899,3
STAT,1869,51,45-49,1920,0.028535799595950227
SIM,1880,38,20-24,1918,3
STAT,1837,53,50-100,1890,0.020716697600281993
STAT,1894,50,na,1944,5666.602323985035
SIM,1932,20,20-24,1952,283
STAT,1837,46,20-24,1883,0.01758968929347772
STAT,1825,45,45-49,1870,0.5260646032207069
STAT,1895,44,15-19,1939,0.0024896236338739254
STAT,1876,49,45-49,1925,0.48267804064877134
SIM,1820,40,40-44,1860,7
SIM,1905,31,50-100,1936,3
SIM,1925,25,50-100,1950,5
STAT,1813,41,40-44,1854,17.379902046968922
STAT,1821,54,45-49,1875,0.039263348915209426
STAT,1879,39,15-19,1918,0.11743131641775874
STAT,1913,20,45-49,1933,2.215684507094912
STAT,1849,42,30-34,1891,1.816304275699251
SIM,1956,11,na,1967,10695
STAT,1867,22,25-29,1889,108.72180850923051
STAT,1899,36,35-39,1935,19.665954384265344
STAT,1841,48,35-39,1889,0.20145348241076233
STAT,1826,28,45-49,1854,8.533344952769998
SIM,1834,30,na,1864,3676
SIM,1851,24,35-39,1875,18
SIM,1834,28,45-49,1862,2
STAT,1820,111,na,1931,1.2015950032011474E-4
STAT,1831,101,na,1932,0.7367595674550383
STAT,1923,38,45-49,1961,1.5931712748807325
STAT,1935,35,50-100,1970,1.1879744478043381
STAT,1956,8,na,1964,10501.334955111051
SIM,1894,5,na,1899,7097
SIM,1898,25,30-34,1923,82
SIM,1770,89,na,1859,37
SIM,1834,25,45-49,1859,3
SIM,1874,27,40-44,1901,8
SIM,1923,24,na,1947,8844
STAT,1857,19,40-44,1876,0.33443687084599477
STAT,1872,38,20-24,1910,1.5568626821208456
SIM,1875,22,25-29,1897,140
SIM,1931,38,45-49,1969,2
STAT,1866,28,50-100,1894,1.1878577646421924
SIM,1881,19,25-29,1900,10
STAT,1872,5,na,1877,5627.113055791119
SIM,1877,47,na,1924,4593
STAT,1821,36,15-19,1857,0.23424955734447298
STAT,1799,70,na,1869,1378.00128032712
STAT,1838,27,25-29,1865,72.82593954173961
STAT,1890,18,15-19,1908,14.591263523385141
SIM,1863,23,45-49,1886,2
STAT,1845,34,40-44,1879,7.7823328788495925
SIM,1833,45,45-49,1878,1
SIM,1856,65,na,1921,2781
SIM,1877,18,20-24,1895,35
STAT,1840,49,30-34,1889,0.13733701782166705
STAT,1894,61,na,1955,4847.982174044495
SIM,1870,37,45-49,1907,6
SIM,1847,29,na,1876,3862
STAT,1909,30,30-34,1939,30.624941717260977
STAT,1837,25,20-24,1862,21.29597992762754
SIM,1823,78,na,1901,758
STAT,1880,30,45-49,1910,3.739931422089827
STAT,1948,4,na,1952,9172.442453580972
STAT,1934,38,20-24,1972,0.7340485026762436
STAT,1855,41,45-49,1896,2.2670468218990285
STAT,1892,36,45-49,1928,5.064382655529215
STAT,1912,48,40-44,1960,0.3052460366594394
SIM,1821,41,40-44,1862,10
STAT,1847,47,25-29,1894,0.08739275111030712
SIM,1790,86,na,1876,118
SIM,1929,36,30-34,1965,5
SIM,1881,32,na,1913,4092
STAT,1821,66,na,1887,1819.2216374367808
STAT,1775,89,na,1864,53.237118590643114
STAT,1897,41,15-19,1938,0.0026006246457143767
STAT,1775,111,na,1886,0.0018644184979886473
STAT,1924,20,20-24,1944,266.4989700568733
STAT,1846,46,50-100,1892,0.3772558285756425
SIM,1833,22,20-24,1855,112
SIM,1845,25,20-24,1870,23
SIM,1850,60,na,1910,3047
STAT,1914,24,na,1938,7489.036267044525
STAT,1857,37,40-44,1894,6.8910515027119486
STAT,1874,52,30-34,1926,0.012243836193002027
SIM,1885,42,na,1927,4879
SIM,1845,28,20-24,1873,24
SIM,1843,48,45-49,1891,1
STAT,1826,46,45-49,1872,0.4770430970458142
STAT,1884,20,na,1904,4744.688201277215
STAT,1830,82,na,1912,644.2958064325054
STAT,1836,47,15-19,1883,5.567020444812227E-4
STAT,1855,23,45-49,1878,1.2196105107439688
STAT,1887,49,20-24,1936,0.014970528057019298
SIM,1878,38,30-34,1916,17
STAT,1793,85,na,1878,174.31186542314003
STAT,1939,31,20-24,1970,5.029757240021934
SIM,1855,35,25-29,1890,8
STAT,1932,15,30-34,1947,32.7501650920167
SIM,1834,43,40-44,1877,9
SIM,1862,17,na,1879,4867
SIM,1862,40,45-49,1902,7
SIM,1881,25,25-29,1906,81
SIM,1883,87,na,1970,812
SIM,1896,18,25-29,1914,24
STAT,1898,38,40-44,1936,2.5695372756329116
SIM,1780,79,na,1859,438
SIM,1846,27,25-29,1873,100
SIM,1857,24,30-34,1881,43
STAT,1893,34,40-44,1927,11.006419060982678
STAT,1907,42,na,1949,6875.814880703486
SIM,1895,38,30-34,1933,13
STAT,1812,42,35-39,1854,14.826242874073431
STAT,1851,35,45-49,1886,3.1889041070614734
STAT,1926,46,15-19,1972,9.200939101330469E-4
SIM,1803,78,na,1881,747
SIM,1925,39,na,1964,9091
SIM,1861,32,na,1893,4547
STAT,1836,45,20-24,1881,0.017134544834053744
STAT,1858,39,45-49,1897,3.106993566252555
SIM,1828,47,30-34,1875,1
STAT,1888,18,25-29,1906,13.49140951774949
STAT,1878,43,na,1921,4839.882970381928
STAT,1826,43,40-44,1869,4.6553182403408
SIM,1914,30,50-100,1944,1
SIM,1904,20,45-49,1924,2
STAT,1827,51,na,1878,2883.7248264898494
SIM,1864,80,na,1944,1023
STAT,1873,37,20-24,1910,1.5818251782432542
SIM,1875,26,40-44,1901,12
SIM,1878,16,15-19,1894,11
SIM,1893,32,50-100,1925,5
STAT,1851,16,40-44,1867,0.34676685713528604
STAT,1835,48,45-49,1883,0.31822510689080463
SIM,1849,36,45-49,1885,3
SIM,1884,80,na,1964,1901
STAT,1840,16,30-34,1856,2.996371004112152
SIM,1881,37,20-24,1918,3
SIM,1940,15,30-34,1955,24
STAT,1904,14,na,1918,7461.786661192821
SIM,1863,10,na,1873,5044
SIM,1890,27,25-29,1917,113
SIM,1865,52,30-34,1917,1
STAT,1884,38,50-100,1922,2.436306821969405
SIM,1886,26,20-24,1912,29
STAT,1841,46,40-44,1887,0.25274270082676437
SIM,1948,23,50-100,1971,3
SIM,1886,29,20-24,1915,26
SIM,1849,39,45-49,1888,5
SIM,1874,73,na,1947,2133
STAT,1764,97,na,1861,1.3533285680787959
STAT,1821,36,45-49,1857,8.31585829676987
STAT,1936,22,35-39,1958,18.184406596279473
SIM,1829,39,25-29,1868,6
SIM,1892,24,na,1916,6729
STAT,1825,73,na,1898,1374.2722454135383
STAT,1859,52,35-39,1911,0.013765297599057159
STAT,1911,39,30-34,1950,3.5205138925749107
STAT,1880,51,45-49,1931,0.031023951468725344
SIM,1944,22,35-39,1966,23
STAT,1878,29,20-24,1907,24.568299922441835
SIM,1872,24,na,1896,5033
SIM,1829,27,25-29,1856,85
SIM,1814,46,20-24,1860,1
SIM,1937,17,50-100,1954,1
STAT,1860,51,25-29,1911,0.005836989322892654
STAT,1890,36,15-19,1926,0.13909602110871264
STAT,1857,33,20-24,1890,4.237190065826949
STAT,1858,51,35-39,1909,0.013619112523331537
SIM,1903,48,40-44,1951,1
SIM,1905,48,45-49,1953,2
STAT,1887,38,30-34,1925,11.978700730599684
STAT,1849,24,30-34,1873,33.577534685985746
STAT,1945,7,na,1952,8718.172074017319
STAT,1823,45,15-19,1868,0.0012716392212254863
STAT,1836,96,na,1932,11.416675334406712
STAT,1872,23,45-49,1895,1.4110083143174539
SIM,1859,43,45-49,1902,6
SIM,1865,33,20-24,1898,9
STAT,1878,26,20-24,1904,24.830077063952373
STAT,1928,9,na,1937,10128.917261935727
SIM,1889,27,na,1916,6025
STAT,1888,36,25-29,1924,6.90591048911075
SIM,1947,15,15-19,1962,91
STAT,1826,47,50-100,1873,0.4897461421272939
STAT,1907,65,na,1972,5765.474153309415
SIM,1943,20,30-34,1963,82
STAT,1846,19,30-34,1865,3.0308008358475433
STAT,1882,27,25-29,1909,83.22367481145234
SIM,1792,81,na,1873,361
SIM,1841,19,25-29,1860,7
STAT,1840,41,na,1881,3524.9495939023
STAT,1870,31,35-39,1901,20.16228294455747
STAT,1832,39,25-29,1871,4.642817388284863
STAT,1831,37,20-24,1868,1.2606293747136543
STAT,1873,4,na,1877,6010.52310296789
STAT,1910,17,na,1927,7731.966155866515
STAT,1892,17,40-44,1909,0.4624330521951615
STAT,1813,42,15-19,1855,0.10261734695202987
STAT,1879,28,25-29,1907,89.0462334893461
STAT,1842,26,40-44,1868,5.555143333939236
SIM,1871,18,25-29,1889,12
SIM,1862,42,40-44,1904,5
SIM,1905,39,na,1944,7095
SIM,1899,34,na,1933,6593
STAT,1829,66,na,1895,1939.7834203786963
SIM,1866,95,na,1961,40
SIM,1868,42,50-100,1910,4
STAT,1863,18,25-29,1881,10.341595313262
STAT,1915,43,35-39,1958,0.4088248600731512
STAT,1836,29,15-19,1865,0.769572448424006
STAT,1852,36,45-49,1888,3.227822783972223
SIM,1840,39,25-29,1879,8
SIM,1844,29,15-19,1873,1
STAT,1832,36,25-29,1868,4.793715557249201
STAT,1879,93,na,1972,280.3362687958541
SIM,1840,36,25-29,1876,8
SIM,1899,23,25-29,1922,176
SIM,1909,20,25-29,1929,175
SIM,1936,31,50-100,1967,2
SIM,1819,38,20-24,1857,3
SIM,1919,28,na,1947,8174
STAT,1865,0,na,1865,6991.514398415891
SIM,1860,36,45-49,1896,4
SIM,1837,37,30-34,1874,14
STAT,1842,29,40-44,1871,5.436342633224436
STAT,1884,35,50-100,1919,2.47170437678219
STAT,1864,46,15-19,1910,7.241734308297243E-4
SIM,1887,28,25-29,1915,115
SIM,1830,29,20-24,1859,23
SIM,1868,30,40-44,1898,13
STAT,1914,44,30-34,1958,0.25503842131638116
SIM,1820,42,35-39,1862,6
SIM,1888,21,50-100,1909,2
STAT,1922,42,na,1964,8606.982070152857
SIM,1845,14,na,1859,4869
SIM,1850,29,40-44,1879,4
STAT,1813,48,na,1861,2702.112696237579
SIM,1850,26,40-44,1876,6
STAT,1762,93,na,1855,14.69232
STAT,1797,92,na,1889,23.100180439552314
STAT,1939,15,15-19,1954,91.98304651286182
SIM,1831,96,na,1927,8
STAT,1896,28,30-34,1924,66.909377348242
SIM,1875,44,40-44,1919,11
SIM,1849,32,25-29,1881,20
STAT,1839,50,20-24,1889,0.001180878145584598
STAT,1909,20,na,1929,7209.771503934696
SIM,1840,24,25-29,1864,127
STAT,1919,47,50-100,1966,0.4953550782013932
STAT,1939,26,50-100,1965,2.0220246432701496
STAT,1876,65,na,1941,3530.094646585754
STAT,1878,47,20-24,1925,0.025193605109966963
STAT,1935,20,30-34,1955,79.11395222503907
SIM,1844,43,50-100,1887,5
SIM,1914,25,30-34,1939,91
STAT,1884,25,35-39,1909,19.37312100598474
SIM,1874,43,40-44,1917,10
STAT,1863,47,50-100,1910,0.43217215781394464
SIM,1858,40,25-29,1898,1
SIM,1954,16,na,1970,9271
STAT,1852,15,45-49,1867,0.12741566351886946
SIM,1938,23,20-24,1961,217
SIM,1817,81,na,1898,485
STAT,1877,48,45-49,1925,0.48871053180510965
STAT,1880,33,15-19,1913,0.30170413687801295
SIM,1925,28,na,1953,8853
SIM,1825,34,35-39,1859,23
STAT,1847,51,na,1898,3297.867496980121
SIM,1845,25,na,1870,4335
SIM,1854,37,30-34,1891,15
SIM,1848,33,20-24,1881,4
STAT,1785,103,na,1888,0.11667727347122459
STAT,1861,38,45-49,1899,3.3344465898324107
STAT,1906,25,30-34,1931,74.61170521462691
STAT,1867,44,40-44,1911,4.196910109938978
SIM,1834,22,na,1856,3768
SIM,1889,38,40-44,1927,19
STAT,1853,99,na,1952,2.9964791675656555
SIM,1859,22,40-44,1881,1
SIM,1840,18,25-29,1858,11
STAT,1866,43,40-44,1909,4.161201600061177
SIM,1892,25,35-39,1917,35
STAT,1877,46,20-24,1923,0.02523735006239674
SIM,1839,32,50-100,1871,2
SIM,1879,37,50-100,1916,3
SIM,1904,17,15-19,1921,16
STAT,1852,18,45-49,1870,0.12517746365964535
SIM,1881,40,50-100,1921,2
STAT,1857,54,25-29,1911,0.005422494292634043
SIM,1861,55,na,1916,3978
STAT,1843,21,30-34,1864,31.54606848356844
SIM,1865,14,na,1879,5064
STAT,1875,53,30-34,1928,0.012178710038426632
STAT,1894,44,35-39,1938,0.3218330580857174
SIM,1946,18,30-34,1964,38
STAT,1874,61,na,1935,3864.179176164562
SIM,1830,35,20-24,1865,6
SIM,1809,45,35-39,1854,1
SIM,1885,33,45-49,1918,6
STAT,1830,74,na,1904,1532.4883183453653
STAT,1902,49,30-34,1951,0.15244205336593641
STAT,1868,13,na,1881,5108.781278134632
STAT,1949,3,na,1952,9343.81565208766
STAT,1850,38,35-39,1888,10.902628727510134
SIM,1895,35,na,1930,6606
STAT,1837,28,25-29,1865,75.14712917270745
STAT,1913,17,15-19,1930,18.74472707793106
SIM,1902,11,na,1913,7615
SIM,1854,81,na,1935,809
STAT,1833,54,35-39,1887,0.011230029849868239
STAT,1829,37,30-34,1866,9.315388498481035
STAT,1854,28,20-24,1882,18.717902039914986
STAT,1870,41,40-44,1911,4.48010553574839
STAT,1873,19,25-29,1892,11.5660838350536
STAT,1843,40,35-39,1883,2.679523535018698
SIM,1810,94,na,1904,25
STAT,1834,33,na,1867,3650.9521899987503
SIM,1879,48,25-29,1927,1
SIM,1818,42,45-49,1860,5
SIM,1871,62,na,1933,3509
STAT,1868,36,35-39,1904,13.656218549727104
STAT,1793,77,na,1870,667.2227800272495
STAT,1878,20,na,1898,5018.363455786362
STAT,1894,46,20-24,1940,0.017611331292802325
STAT,1883,44,25-29,1927,1.2570155921455994
SIM,1865,36,25-29,1901,6
SIM,1901,37,20-24,1938,2
STAT,1877,33,45-49,1910,3.64163817666522
SIM,1875,47,45-49,1922,2
SIM,1862,28,20-24,1890,23
STAT,1840,81,na,1921,780.5613060429622
STAT,1865,28,30-34,1893,46.04139444143218
STAT,1854,40,45-49,1894,2.3174809768166678
STAT,1910,44,50-100,1954,0.2215616055290682
SIM,1879,9,na,1888,5462
SIM,1918,32,35-39,1950,27
STAT,1815,74,na,1889,1052.0187555355467
SIM,1844,47,45-49,1891,2
STAT,1898,20,na,1918,6502.452551539671
STAT,1822,35,20-24,1857,3.352069405105096
STAT,1938,18,30-34,1956,24.279187375584378
SIM,1881,83,na,1964,934
SIM,1858,44,40-44,1902,6
STAT,1893,20,na,1913,6090.359034014891
STAT,1832,36,20-24,1868,1.2834238420819437
SIM,1845,28,25-29,1873,91
STAT,1867,68,na,1935,2890.4704317497685
SIM,1891,8,na,1899,6713
SIM,1868,45,40-44,1913,1
STAT,1925,16,na,1941,9000.133493736881
STAT,1776,110,na,1886,0.0038904203094695944
STAT,1776,85,na,1861,162.2812727939175
STAT,1846,52,50-100,1898,0.023009870360214072
STAT,1839,40,15-19,1879,0.02562238820918235
SIM,1851,21,30-34,1872,37
STAT,1872,54,20-24,1926,0.001456596774323524
STAT,1867,47,45-49,1914,0.4442951765740327
STAT,1888,13,na,1901,6155.0623159518345
SIM,1840,21,20-24,1861,139
STAT,1949,18,40-44,1967,3.284145035246699
STAT,1887,71,na,1958,3201.267288884578
SIM,1921,17,15-19,1938,97
SIM,1883,4,na,1887,5565
SIM,1846,45,25-29,1891,1
SIM,1918,9,na,1927,9002
STAT,1842,47,40-44,1889,0.2549276147420986
STAT,1896,39,15-19,1935,0.1482251260116516
SIM,1940,7,na,1947,8374
SIM,1928,19,25-29,1947,133
SIM,1835,53,35-39,1888,1
STAT,1911,35,15-19,1946,0.037826530596258734
SIM,1812,75,na,1887,841
SIM,1833,42,40-44,1875,7
STAT,1889,20,50-100,1909,1.02155208355451
SIM,1865,29,50-100,1894,2
STAT,1911,22,35-39,1933,18.040501109381182
SIM,1790,89,na,1879,65
STAT,1852,33,40-44,1885,7.082524237708505
STAT,1827,53,35-39,1880,0.01471214625099316
STAT,1835,46,50-100,1881,0.3397652189942622
STAT,1872,83,na,1955,805.7805855910976
SIM,1860,33,40-44,1893,14
SIM,1915,46,na,1961,7561
STAT,1899,33,30-34,1932,48.109576273982626
SIM,1840,36,20-24,1876,1
STAT,1828,38,20-24,1866,1.5210718362215414
STAT,1895,41,50-100,1936,0.19393573150193083
SIM,1825,93,na,1918,13
STAT,1901,28,15-19,1929,1.2782690934564713
STAT,1836,47,45-49,1883,0.328454482698492
STAT,1956,16,25-29,1972,115.82488948115804
STAT,1892,33,40-44,1925,10.918232338737582
SIM,1891,26,25-29,1917,102
STAT,1847,29,25-29,1876,76.3949030926117
STAT,1833,50,50-100,1883,0.02132484615822955
STAT,1845,42,50-100,1887,1.6577455912087593
SIM,1823,36,25-29,1859,8
STAT,1871,45,45-49,1916,0.47825851039484346
SIM,1911,31,40-44,1942,14
STAT,1838,45,25-29,1883,0.08228253522464206
STAT,1877,15,45-49,1892,0.1376281101981009
STAT,1868,54,35-39,1922,0.016087625644128817
STAT,1817,50,35-39,1867,0.041475549453714504
STAT,1845,52,40-44,1897,0.01613607041165263
SIM,1850,43,25-29,1893,1
STAT,1862,37,15-19,1899,0.09693407417006089
STAT,1865,3,na,1868,5870.280749313415
STAT,1830,26,15-19,1856,1.1308093553212477
STAT,1878,29,25-29,1907,88.58869794073391
SIM,1866,35,35-39,1901,20
SIM,1878,43,na,1921,5046
STAT,1857,58,na,1915,3113.1278903956104
STAT,1948,21,15-19,1969,12.347213565746966
STAT,1816,53,25-29,1869,0.016364797573497195
STAT,1895,29,20-24,1924,30.652191604009573
STAT,1927,21,50-100,1948,1.6419697933337412
STAT,1867,26,45-49,1893,2.1072614718516003
SIM,1841,63,na,1904,2478
STAT,1861,32,na,1893,4011.408908966974
STAT,1898,12,na,1910,7058.224005397011
SIM,1853,42,50-100,1895,4
STAT,1882,47,40-44,1929,0.33524804639602723
SIM,1841,55,na,1896,2926
SIM,1870,35,20-24,1905,2
SIM,1834,46,45-49,1880,1
SIM,1898,28,35-39,1926,35
SIM,1844,32,45-49,1876,4
STAT,1856,106,na,1962,0.07455846941192637
SIM,1855,29,25-29,1884,86
SIM,1871,36,20-24,1907,2
STAT,1920,40,50-100,1960,0.2627102877673707
SIM,1882,17,na,1899,5266
STAT,1830,71,na,1901,1843.2036488099088
STAT,1883,26,25-29,1909,84.2256347743988
STAT,1919,32,50-100,1951,1.801152195054451
SIM,1822,40,45-49,1862,5
STAT,1892,31,20-24,1923,6.862060924299699
SIM,1935,21,50-100,1956,2
STAT,1893,16,40-44,1909,0.46935945490962094
SIM,1908,25,35-39,1933,30
SIM,1860,3,na,1863,5449
STAT,1879,15,45-49,1894,0.13863342901307038
STAT,1905,8,na,1913,7592.704380210246
SIM,1881,22,20-24,1903,121
STAT,1860,24,35-39,1884,9.724827116193131
SIM,1824,35,25-29,1859,8
SIM,1905,36,na,1941,7181
STAT,1881,31,45-49,1912,3.4179938851288325
STAT,1903,31,40-44,1934,12.52146122112505
SIM,1834,25,40-44,1859,7
SIM,1912,32,na,1944,7715
STAT,1816,39,40-44,1855,29.114712642472742
SIM,1824,39,40-44,1863,14
STAT,1893,37,45-49,1930,5.10308286124948
STAT,1913,49,40-44,1962,0.3090465789126205
STAT,1840,27,15-19,1867,0.8165554095931012
STAT,1804,54,45-49,1858,0.081509603669673
SIM,1864,91,na,1955,63
STAT,1853,45,20-24,1898,0.019175704642308937
SIM,1876,36,35-39,1912,15
SIM,1927,32,50-100,1959,3
STAT,1862,19,15-19,1881,10.55137511703334
STAT,1836,32,45-49,1868,2.9313567045553954
STAT,1922,50,na,1972,8444.672815315043
SIM,1878,32,na,1910,5210
STAT,1814,40,45-49,1854,9.308910861034652
SIM,1870,19,15-19,1889,10
SIM,1917,30,30-34,1947,42
STAT,1831,53,20-24,1884,9.740149719054544E-4
STAT,1806,49,25-29,1855,0.34034009645596774
STAT,1892,35,na,1927,6013.178036196418
STAT,1906,45,50-100,1951,0.4117768299457354
STAT,1926,24,50-100,1950,1.6040766002525384
SIM,1835,20,35-39,1855,11
STAT,1882,28,na,1910,4678.710651931638
STAT,1926,33,35-39,1959,22.298932882128504
SIM,1853,34,40-44,1887,10
SIM,1896,15,20-24,1911,53
STAT,1855,38,15-19,1893,0.08425739434653409
STAT,1938,16,50-100,1954,0.748358712392746
STAT,1825,40,20-24,1865,0.38312794154472557
STAT,1863,98,na,1961,13.734255110334388
SIM,1847,40,na,1887,3647
STAT,1824,109,na,1933,7.606472258430875E-4
SIM,1776,82,na,1858,196
STAT,1832,54,20-24,1886,9.618125040143996E-4
STAT,1847,47,20-24,1894,0.018206823997278385
STAT,1883,48,40-44,1931,0.3354391635132318
SIM,1906,30,20-24,1936,4
STAT,1862,73,na,1935,2050.300111657094
SIM,1892,41,35-39,1933,11
STAT,1876,50,40-44,1926,0.02230679991321478
STAT,1886,86,na,1972,1140.6901839533675
SIM,1827,37,na,1864,3366
SIM,1832,48,35-39,1880,1
STAT,1829,33,15-19,1862,0.26578126728610596
STAT,1849,27,35-39,1876,18.09244924423107
SIM,1886,29,25-29,1915,116
SIM,1891,48,40-44,1939,1
STAT,1840,30,45-49,1870,3.130149220067476
STAT,1851,32,40-44,1883,6.997128448977899
SIM,1846,55,na,1901,3214
SIM,1857,27,35-39,1884,21
SIM,1906,21,na,1927,6898
STAT,1884,41,35-39,1925,3.627592512583585
SIM,1855,32,20-24,1887,7
STAT,1938,34,na,1972,7671.697435186661
STAT,1956,5,na,1961,10505.851826367681
SIM,1892,22,30-34,1914,67
SIM,1914,21,15-19,1935,12
SIM,1850,25,25-29,1875,93
STAT,1864,35,25-29,1899,5.247206528630923
SIM,1775,89,na,1864,30
SIM,1863,23,15-19,1886,6
STAT,1888,15,20-24,1903,42.515780067199046
SIM,1875,29,45-49,1904,4
STAT,1881,32,na,1913,4658.273121811501
SIM,1825,31,30-34,1856,39
STAT,1822,103,na,1925,0.16204041832933905
SIM,1864,37,25-29,1901,8
STAT,1928,28,15-19,1956,1.7554111101088943
STAT,1842,43,25-29,1885,0.9765484244434149
STAT,1823,110,na,1933,3.3160610306439575E-4
STAT,1928,31,45-49,1959,3.9754848239146554
SIM,1903,21,35-39,1924,23
SIM,1934,33,35-39,1967,33
SIM,1939,3,na,1942,8412
SIM,1870,22,45-49,1892,4
STAT,1863,50,35-39,1913,0.015438678750256105
STAT,1928,27,na,1955,9319.589668138364
SIM,1894,20,40-44,1914,11
SIM,1819,38,25-29,1857,8
SIM,1901,19,20-24,1920,54
STAT,1853,25,35-39,1878,17.94234188799131
STAT,1824,48,35-39,1872,0.33432895922049005
STAT,1839,38,30-34,1877,9.841872103041934
STAT,1833,31,15-19,1864,0.24409094262257539
STAT,1904,54,na,1958,6186.662389779386
SIM,1910,30,50-100,1940,1
SIM,1861,25,35-39,1886,22
STAT,1862,37,45-49,1899,3.441159223799173
STAT,1940,16,na,1956,7550.411315725108
STAT,1850,40,na,1890,3579.51180392378
STAT,1854,41,50-100,1895,1.6268552823740896
STAT,1886,20,40-44,1906,4.46906761291183
STAT,1830,41,40-44,1871,4.088831656919853
STAT,1891,39,35-39,1930,17.479007538452674
SIM,1830,71,na,1901,1611
STAT,1897,27,na,1924,6442.758192732668
SIM,1847,38,30-34,1885,16
SIM,1940,13,na,1953,8300
SIM,1906,32,na,1938,7016
SIM,1884,50,40-44,1934,1
SIM,1835,32,50-100,1867,4
STAT,1829,48,15-19,1877,6.229354637532059E-4
STAT,1862,22,45-49,1884,1.2322320520073962
STAT,1823,78,na,1901,937.600373716025
STAT,1855,23,15-19,1878,5.769969749699924
STAT,1809,63,na,1872,1989.3066368791256
STAT,1849,45,35-39,1894,0.2236595344401449
SIM,1835,35,35-39,1870,14
STAT,1844,41,35-39,1885,3.0335975840458738
SIM,1874,46,45-49,1920,1
STAT,1888,4,na,1892,6279.622975381434
SIM,1871,15,20-24,1886,44
STAT,1842,25,25-29,1867,79.01346704975833
STAT,1918,24,40-44,1942,7.276826106013814
SIM,1934,15,35-39,1949,15
STAT,1854,84,na,1938,509.9684421205857
STAT,1894,26,35-39,1920,25.119056381681464
SIM,1878,34,45-49,1912,1
STAT,1829,33,45-49,1862,3.254566692984149
SIM,1896,33,20-24,1929,1
SIM,1873,49,35-39,1922,1
SIM,1855,0,na,1855,6389
STAT,1888,33,20-24,1921,6.425148233556115
SIM,1833,37,na,1870,3466
STAT,1906,21,15-19,1927,9.738155496479155
STAT,1852,15,40-44,1867,0.35676394460890315
STAT,1874,32,15-19,1906,0.29448693803987497
STAT,1922,3,na,1925,9477.807358816848
STAT,1819,44,40-44,1863,9.753679667997178
SIM,1859,25,45-49,1884,1
SIM,1944,20,50-100,1964,1
STAT,1880,18,20-24,1898,37.61992189210083
STAT,1902,30,50-100,1932,2.6335331579430563
STAT,1891,20,15-19,1911,8.28476294252997
SIM,1894,35,40-44,1929,18
SIM,1936,31,45-49,1967,5
SIM,1782,82,na,1864,262
SIM,1947,19,30-34,1966,44
STAT,1853,43,35-39,1896,2.844375558519644
STAT,1886,35,40-44,1921,9.42121727344005
SIM,1824,63,na,1887,2189
STAT,1896,42,45-49,1938,0.2767800840955691
STAT,1896,24,15-19,1920,8.741542744170705
STAT,1828,92,na,1920,51.14779829786497
STAT,1865,49,35-39,1914,0.25151024941530103
SIM,1851,40,35-39,1891,6
SIM,1852,41,35-39,1893,7
STAT,1866,46,45-49,1912,0.44102983476894064
STAT,1827,35,35-39,1862,15.48760320709592
SIM,1938,26,25-29,1964,136
STAT,1863,15,20-24,1878,36.189549853245175
SIM,1850,29,45-49,1879,5
STAT,1834,52,30-34,1886,0.008124551274426725
STAT,1866,41,20-24,1907,0.29728394474072223
STAT,1905,39,na,1944,6865.787372234274
STAT,1888,48,20-24,1936,0.015955016542621634
SIM,1926,24,40-44,1950,6
SIM,1872,58,na,1930,4097
SIM,1898,49,na,1947,6175
STAT,1939,19,30-34,1958,24.62704157211888
SIM,1849,36,40-44,1885,12
STAT,1884,22,30-34,1906,35.52251027223918
STAT,1826,66,na,1892,1962.0673200919514
SIM,1937,16,na,1953,7421
STAT,1905,10,na,1915,7565.774101011222
STAT,1829,51,45-49,1880,0.022562946102006938
STAT,1810,82,na,1892,421.95510923325753
STAT,1842,29,45-49,1871,2.0149756103440035
STAT,1895,41,45-49,1936,0.27474228708171144
STAT,1947,15,50-100,1962,0.8527475812993477
SIM,1793,74,na,1867,826
SIM,1827,44,40-44,1871,14
STAT,1926,15,35-39,1941,10.436795758786127
SIM,1789,92,na,1881,13
SIM,1962,3,na,1965,10321
STAT,1836,99,na,1935,2.518053723517574
STAT,1916,39,15-19,1955,0.039316465006010826
STAT,1918,42,40-44,1960,0.5369988340967392
STAT,1844,40,na,1884,3921.8704064980557
STAT,1865,40,20-24,1905,0.2943321853947574
SIM,1884,83,na,1967,1471
STAT,1828,50,45-49,1878,0.026267027988556846
SIM,1839,46,25-29,1885,1
STAT,1799,62,na,1861,1856.9340732662688
STAT,1827,32,50-100,1859,2.2616044576974574
SIM,1926,42,40-44,1968,3
SIM,1922,41,25-29,1963,1
SIM,1897,25,15-19,1922,1
STAT,1786,75,na,1861,724.58853696184
STAT,1898,34,25-29,1932,27.754263322852417
STAT,1871,56,na,1927,4092.556283996938
STAT,1904,38,40-44,1942,2.7252764929427484
STAT,1877,42,40-44,1919,4.711279773351378
STAT,1910,49,20-24,1959,0.020709270030274753
STAT,1822,36,30-34,1858,22.273323789834542
STAT,1842,29,50-100,1871,1.1609123089364555
STAT,1875,46,na,1921,4691.4922649059945
SIM,1892,47,45-49,1939,2
STAT,1958,6,na,1964,10425.878784292448
SIM,1907,30,35-39,1937,18
SIM,1856,40,20-24,1896,2
STAT,1894,49,25-29,1943,0.08253504045925636
STAT,1900,72,na,1972,4428.950304400994
SIM,1806,75,na,1881,814
SIM,1931,25,30-34,1956,127
STAT,1837,92,na,1929,58.049100445777064
SIM,1912,47,50-100,1959,1
STAT,1894,41,30-34,1935,2.9961915916814372
STAT,1853,35,50-100,1888,1.9832997254042932
STAT,1896,46,25-29,1942,0.08688142049779801
STAT,1856,99,na,1955,2.951092121024357
STAT,1861,41,35-39,1902,3.057766513122185
STAT,1819,46,50-100,1865,1.0462875748548013
STAT,1858,16,25-29,1874,10.483597483932275
STAT,1844,45,50-100,1889,0.40287760199021355
STAT,1861,35,40-44,1896,7.428504669812511
STAT,1957,15,30-34,1972,32.46789368825304
SIM,1894,35,45-49,1929,12
STAT,1914,41,25-29,1955,0.1431355686693126
STAT,1847,37,na,1884,3726.148639725152
STAT,1835,52,45-49,1887,0.01916368161537335
SIM,1920,28,20-24,1948,45
STAT,1921,37,30-34,1958,4.109024490584935
SIM,1821,66,na,1887,1751
SIM,1889,19,30-34,1908,4
STAT,1884,47,45-49,1931,0.46845364684778634
STAT,1935,2,na,1937,11293.934857917226
SIM,1801,100,na,1901,1
SIM,1898,63,na,1961,5224
STAT,1846,17,45-49,1863,0.12568938427440363
STAT,1811,48,20-24,1859,0.0800735146935849
SIM,1948,18,35-39,1966,14
STAT,1846,52,20-24,1898,0.00112426081129813
STAT,1905,41,15-19,1946,0.0028136524716624238
SIM,1827,44,45-49,1871,9
STAT,1837,40,45-49,1877,2.5259247649442544
SIM,1814,41,50-100,1855,5
STAT,1856,19,25-29,1875,10.318385228189051
SIM,1830,94,na,1924,18
SIM,1864,19,25-29,1883,15
SIM,1926,24,na,1950,9160
STAT,1941,23,25-29,1964,192.73026873184668
SIM,1885,26,35-39,1911,29
STAT,1886,35,45-49,1921,4.290361923868606
SIM,1789,78,na,1867,580
SIM,1860,41,25-29,1901,1
STAT,1894,39,na,1933,6050.821680726482
STAT,1903,16,45-49,1919,0.18830027428301463
STAT,1771,114,na,1885,4.601044341204672E-4
STAT,1889,41,20-24,1930,0.3972708892328546
SIM,1830,36,30-34,1866,9
STAT,1873,40,15-19,1913,0.028624491531243055
STAT,1906,17,40-44,1923,0.5382734956133823
SIM,1834,84,na,1918,343
SIM,1905,35,30-34,1940,5
STAT,1831,29,35-39,1860,16.47024376795586
STAT,1826,69,na,1895,1756.803597138235
STAT,1914,16,20-24,1930,56.788607821350034
SIM,1872,35,25-29,1907,9
STAT,1858,54,na,1912,3296.7642708913577
STAT,1879,18,50-100,1897,0.10322306764544115
STAT,1878,48,30-34,1926,0.2016147734805418
SIM,1847,57,na,1904,3026
STAT,1849,23,20-24,1872,130.84485988043878
STAT,1868,51,30-34,1919,0.01149270733611442
SIM,1828,27,45-49,1855,3
SIM,1844,29,na,1873,3641
SIM,1906,40,30-34,1946,1
SIM,1875,23,40-44,1898,8
STAT,1905,16,na,1921,7394.858950047716
STAT,1842,17,50-100,1859,0.0936643072223211
STAT,1863,30,45-49,1893,3.1076852453250092
SIM,1912,30,45-49,1942,2
SIM,1890,24,20-24,1914,170
STAT,1767,100,na,1867,0.34874661277111496
STAT,1812,100,na,1912,1.0063400751528955
STAT,1867,37,na,1904,4456.153172013626
STAT,1854,64,na,1918,2664.88133451473
STAT,1880,36,20-24,1916,1.6479308798568846
STAT,1805,81,na,1886,478.0050257671465
STAT,1882,24,20-24,1906,134.7294682852542
STAT,1912,28,20-24,1940,36.21175777770047
SIM,1910,42,45-49,1952,2
STAT,1850,53,25-29,1903,0.005343662966450473
STAT,1901,46,45-49,1947,0.3774583320052379
STAT,1925,30,na,1955,9078.85979870053
SIM,1865,33,25-29,1898,22
SIM,1922,16,20-24,1938,340
STAT,1813,45,20-24,1858,0.07667111804240212
SIM,1822,41,20-24,1863,2
SIM,1912,35,50-100,1947,4
SIM,1841,66,na,1907,2260
SIM,1867,71,na,1938,2483
STAT,1920,31,40-44,1951,8.690343038523215
SIM,1838,29,25-29,1867,83
STAT,1834,53,40-44,1887,0.014087264174906546
SIM,1916,14,na,1930,8592
STAT,1827,50,30-34,1877,0.010796214441181375
STAT,1852,83,na,1935,632.721935013937
STAT,1877,9,na,1886,5543.88979060299
SIM,1829,32,na,1861,3508
STAT,1807,62,na,1869,2078.4951388812387
STAT,1940,22,50-100,1962,1.353840128811939
STAT,1881,32,20-24,1913,5.276590361500202
SIM,1914,17,40-44,1931,1
STAT,1843,51,25-29,1894,0.004985454331458712
SIM,1905,19,25-29,1924,24
STAT,1857,33,25-29,1890,16.05583356407217
SIM,1880,20,45-49,1900,2
STAT,1895,40,35-39,1935,4.813477397475085
SIM,1894,45,50-100,1939,1
SIM,1904,43,30-34,1947,1
SIM,1866,16,25-29,1882,14
SIM,1938,23,na,1961,7331
SIM,1939,25,30-34,1964,105
STAT,1889,25,15-19,1914,1.1374900738397913
STAT,1903,1,na,1904,7826.896893022123
STAT,1870,32,45-49,1902,3.4576981629948773
STAT,1893,34,50-100,1927,2.3253958428488035
SIM,1843,45,40-44,1888,1
SIM,1845,24,40-44,1869,5
SIM,1823,67,na,1890,1683
STAT,1960,3,na,1963,10345.308682848481
SIM,1912,38,40-44,1950,3
STAT,1862,38,25-29,1900,4.945422172477646
STAT,1932,30,20-24,1962,6.55655096376106
STAT,1829,97,na,1926,6.358097626209719
STAT,1902,42,45-49,1944,0.2959748923997325
SIM,1906,31,30-34,1937,41
STAT,1867,23,40-44,1890,3.9291884710079144
SIM,1870,38,25-29,1908,9
SIM,1840,39,na,1879,3883
STAT,1782,101,na,1883,0.27100322323800885
STAT,1835,45,40-44,1880,0.26361901561543216
STAT,1837,24,40-44,1861,3.748484648420642
SIM,1823,33,20-24,1856,6
SIM,1881,18,15-19,1899,7
STAT,1862,28,na,1890,4105.118315660455
STAT,1873,18,15-19,1891,12.146124805393859
SIM,1886,48,30-34,1934,1
STAT,1887,18,45-49,1905,0.14716341459581173
STAT,1930,42,20-24,1972,0.04692849923826232
STAT,1876,53,45-49,1929,0.029827667146954912
SIM,1850,49,na,1899,3548
STAT,1859,53,45-49,1912,0.022953983746281076
SIM,1851,96,na,1947,6
STAT,1848,24,15-19,1872,6.492296039505237
SIM,1854,39,na,1893,3885
STAT,1884,29,na,1913,4725.356697114069
STAT,1814,41,20-24,1855,0.9524462440495092
STAT,1843,46,45-49,1889,0.3332945802169085
SIM,1927,35,50-100,1962,2
SIM,1917,22,45-49,1939,3
SIM,1941,28,50-100,1969,4
STAT,1788,84,na,1872,223.57791924155214
SIM,1924,43,na,1967,9261
STAT,1886,6,na,1892,5569.395728534826
SIM,1845,47,30-34,1892,1
STAT,1852,49,20-24,1901,0.018726393003542462
SIM,1872,44,50-100,1916,7
STAT,1915,33,25-29,1948,18.93251478129395
STAT,1859,45,50-100,1904,0.3987353232085361
STAT,1904,45,15-19,1949,6.605723056851731E-4
STAT,1947,25,15-19,1972,1.6143012556039933
STAT,1810,51,30-34,1861,0.037546139571574225
SIM,1883,39,50-100,1922,4
SIM,1917,41,na,1958,8012
STAT,1913,42,20-24,1955,0.03479084156174968
SIM,1851,46,45-49,1897,1
SIM,1910,29,na,1939,7485
SIM,1800,64,na,1864,1695
SIM,1857,21,50-100,1878,1
STAT,1904,30,45-49,1934,5.095518540905557
STAT,1819,87,na,1906,184.35146422677886
STAT,1899,15,30-34,1914,4.43094939504507
SIM,1923,33,25-29,1956,29
SIM,1865,76,na,1941,1663
STAT,1890,25,25-29,1915,104.98706569981707
STAT,1862,31,40-44,1893,7.51663811643503
SIM,1793,77,na,1870,612
SIM,1882,88,na,1970,635
SIM,1856,24,15-19,1880,6
SIM,1834,39,na,1873,3392
STAT,1838,20,40-44,1858,3.7120847843003575
STAT,1834,30,na,1864,3766.4736102065044
STAT,1899,2,na,1901,7376.2506810879495
STAT,1909,22,45-49,1931,2.113153195620359
SIM,1823,47,na,1870,2944
STAT,1879,41,50-100,1920,2.2418284852189316
STAT,1918,27,45-49,1945,3.7125529002569744
STAT,1760,107,na,1867,0.00199777766996458
SIM,1877,16,na,1893,5267
STAT,1913,43,30-34,1956,0.2514575041645091
STAT,1892,58,na,1950,4999.951601341521
STAT,1930,35,15-19,1965,0.050674911055220526
STAT,1823,34,25-29,1857,45.67078221087425
STAT,1946,20,50-100,1966,1.4797168106971508
SIM,1831,34,25-29,1865,9
SIM,1908,4,na,1912,7950
STAT,1820,40,35-39,1860,7.742575382821369
STAT,1831,43,15-19,1874,0.021586814247381656
SIM,1819,93,na,1912,15
SIM,1846,20,40-44,1866,6
SIM,1921,43,30-34,1964,1
STAT,1890,23,na,1913,5812.198245326239
STAT,1819,44,45-49,1863,6.489977181107709
SIM,1857,23,20-24,1880,4
SIM,1858,6,na,1864,5024
STAT,1777,92,na,1869,19.272813557988055
SIM,1926,27,45-49,1953,6
STAT,1895,47,20-24,1942,0.01773045867483762
SIM,1898,24,20-24,1922,184
STAT,1907,24,35-39,1931,17.213381900348164
SIM,1832,28,50-100,1860,2
STAT,1805,53,na,1858,2541.122024590322
STAT,1869,31,25-29,1900,20.126070459101413
STAT,1910,42,35-39,1952,0.384490521356837
SIM,1799,68,na,1867,1332
SIM,1869,29,50-100,1898,2
SIM,1924,29,na,1953,9056
SIM,1929,28,40-44,1957,17
SIM,1953,6,na,1959,9960
SIM,1877,87,na,1964,583
SIM,1892,35,50-100,1927,3
STAT,1853,23,50-100,1876,0.7568651455373442
SIM,1909,12,na,1921,7889
SIM,1843,67,na,1910,2361
STAT,1924,24,35-39,1948,22.29273251059236
SIM,1883,7,na,1890,5409
STAT,1805,53,15-19,1858,1.8927132609969886E-4
SIM,1858,22,25-29,1880,118
STAT,1828,106,na,1934,0.01491067094100906
STAT,1899,30,25-29,1929,28.570529155094345
SIM,1901,29,50-100,1930,5
STAT,1881,66,na,1947,3199.481014907644
STAT,1840,34,25-29,1874,17.637412010043608
STAT,1879,21,40-44,1900,4.415288497581613
SIM,1884,46,40-44,1930,1
STAT,1885,43,45-49,1928,2.9869559286118545
STAT,1876,46,40-44,1922,0.3586281150094031
STAT,1923,25,30-34,1948,91.44145022785183
SIM,1829,52,na,1881,2830
STAT,1848,40,20-24,1888,0.26683669574535585
SIM,1882,17,20-24,1899,34
STAT,1883,75,na,1958,2243.746712833926
STAT,1930,37,na,1967,9910.748407734454
STAT,1837,47,30-34,1884,0.14008389337567603
STAT,1874,17,20-24,1891,36.66109267643058
STAT,1913,35,15-19,1948,0.038646998924610015
SIM,1915,24,35-39,1939,23
SIM,1877,31,25-29,1908,25
STAT,1812,63,na,1875,2052.4185006611515
SIM,1874,59,na,1933,3686
SIM,1930,33,30-34,1963,58
STAT,1887,57,na,1944,4539.339778262729
STAT,1860,42,30-34,1902,1.8832297114401348
STAT,1872,44,15-19,1916,0.02765201319694946
STAT,1865,9,na,1874,5062.032673017725
SIM,1887,21,40-44,1908,8
SIM,1814,84,na,1898,271
STAT,1825,81,na,1906,625.6838455749785
STAT,1868,35,50-100,1903,2.3815451608867075
STAT,1818,52,45-49,1870,0.06135226727069344
SIM,1863,67,na,1930,2815
STAT,1801,91,na,1892,45.9333113870432
STAT,1778,113,na,1891,6.464895048628378E-4
SIM,1906,18,30-34,1924,5
STAT,1846,89,na,1935,160.91143845580828
STAT,1861,66,na,1927,2755.189812116513
STAT,1879,46,25-29,1925,0.12202414905306344
STAT,1898,29,na,1927,6475.959306201246
STAT,1875,54,40-44,1929,0.021288705176300955
STAT,1909,32,50-100,1941,1.5943107537593513
SIM,1932,24,35-39,1956,35
STAT,1816,45,na,1861,3000.4120554335605
STAT,1780,107,na,1887,0.015243649022843642
STAT,1853,40,30-34,1893,1.8373611875893903
STAT,1922,33,30-34,1955,35.790612027751806
STAT,1923,49,50-100,1972,0.5310702328923521
STAT,1952,18,na,1970,8904.764397404851
SIM,1771,96,na,1867,3
STAT,1862,15,35-39,1877,1.0977014812609975
STAT,1813,62,na,1875,2009.608702008777
SIM,1864,18,15-19,1882,11
STAT,1840,19,na,1859,4239.479590609239
STAT,1931,26,35-39,1957,39.16566345043032
SIM,1938,29,30-34,1967,87
SIM,1880,42,20-24,1922,1
STAT,1797,67,na,1864,1475.6402438614455
STAT,1882,30,15-19,1912,0.2824244496696972
STAT,1919,30,na,1949,8305.349908362714
STAT,1921,38,40-44,1959,3.3715802368102024
SIM,1836,30,25-29,1866,23
STAT,1919,41,45-49,1960,0.36470107359957765
STAT,1927,17,na,1944,9241.542811960784
SIM,1917,1,na,1918,9106
STAT,1822,39,35-39,1861,25.73384674621861
STAT,1835,51,35-39,1886,0.011595676944770419
STAT,1854,24,40-44,1878,3.6996644580209828
SIM,1869,58,na,1927,3798
STAT,1820,34,40-44,1854,27.895258606476936
STAT,1827,51,40-44,1878,0.018719052083556065
STAT,1877,49,25-29,1926,0.11827417665668633
STAT,1944,17,45-49,1961,1.085644652432445
STAT,1815,52,50-100,1867,0.07774776282965845
STAT,1894,42,40-44,1936,0.404731164371551
SIM,1882,30,20-24,1912,9
SIM,1932,38,na,1970,10267
SIM,1778,86,na,1864,118
STAT,1900,20,30-34,1920,50.20108083137635
STAT,1941,20,20-24,1961,232.24627122053238
STAT,1832,33,20-24,1865,4.544383222175481
STAT,1850,50,20-24,1900,0.0011476886012591965
STAT,1836,45,na,1881,3211.698252688347
STAT,1908,26,50-100,1934,1.924308392969785
SIM,1952,17,45-49,1969,5
STAT,1856,18,15-19,1874,10.870080085543378
SIM,1844,60,na,1904,2701
SIM,1818,47,50-100,1865,2
STAT,1887,15,40-44,1902,0.41505959720295665
STAT,1907,11,na,1918,7677.262049547044
SIM,1803,100,na,1903,2
SIM,1867,31,35-39,1898,33
SIM,1868,42,40-44,1910,7
SIM,1909,37,50-100,1946,2
STAT,1831,34,50-100,1865,1.512722576536963
STAT,1874,30,20-24,1904,5.634625976953007
STAT,1929,27,20-24,1956,46.134242007785446
SIM,1892,44,40-44,1936,1
STAT,1940,25,30-34,1965,80.77102668270005
SIM,1901,46,na,1947,6438
STAT,1926,36,50-100,1962,1.0370703809311344
STAT,1900,22,25-29,1922,160.38070911184516
SIM,1922,19,25-29,1941,122
STAT,1885,4,na,1889,5584.332839654592
SIM,1867,57,na,1924,4016
STAT,1878,74,na,1952,2340.877794320438
SIM,1871,30,45-49,1901,5
STAT,1859,31,35-39,1890,16.345675987032248
STAT,1864,28,15-19,1892,0.8161903629248359
STAT,1937,22,20-24,1959,218.73185499400017
STAT,1927,39,20-24,1966,0.6604119074156671
STAT,1895,21,25-29,1916,151.10412378701474
SIM,1934,36,50-100,1970,2
STAT,1914,19,25-29,1933,18.010270503671297
SIM,1948,19,45-49,1967,2
STAT,1805,51,20-24,1856,0.005912240436276445
STAT,1884,44,40-44,1928,4.425116341918362
STAT,1872,42,20-24,1914,0.3219523794704091
STAT,1828,30,25-29,1858,24.411466037415536
SIM,1849,52,na,1901,3510
SIM,1845,27,45-49,1872,2
SIM,1906,15,25-29,1921,19
SIM,1923,40,30-34,1963,1
SIM,1895,15,40-44,1910,1
STAT,1875,27,50-100,1902,1.330145375776734
STAT,1895,48,30-34,1943,0.1418900706679444
SIM,1827,51,na,1878,2866
STAT,1849,63,na,1912,2822.4093378392813
STAT,1836,44,45-49,1880,2.307886872946038
SIM,1823,92,na,1915,26
SIM,1867,36,50-100,1903,3
SIM,1921,28,40-44,1949,14
SIM,1840,33,20-24,1873,7
STAT,1860,43,40-44,1903,3.662350191067463
STAT,1913,28,40-44,1941,9.349050801940857
STAT,1857,52,50-100,1909,0.02364813700895282
STAT,1809,97,na,1906,4.774923922129537
STAT,1936,22,na,1958,7052.502332120741
SIM,1862,24,40-44,1886,3
STAT,1852,45,40-44,1897,0.2755806118315441
SIM,1844,44,45-49,1888,8
SIM,1895,21,na,1916,6582
SIM,1931,31,25-29,1962,30
SIM,1869,48,30-34,1917,1
SIM,1859,36,35-39,1895,16
STAT,1837,27,45-49,1864,1.9866825747089616
SIM,1865,52,50-100,1917,1
STAT,1933,30,50-100,1963,2.2530645553937108
SIM,1881,29,50-100,1910,1
SIM,1824,32,25-29,1856,26
SIM,1863,30,50-100,1893,5
STAT,1837,21,na,1858,3929.2036996999545
SIM,1830,39,35-39,1869,23
STAT,1864,18,50-100,1882,0.09095600703356176
STAT,1915,40,na,1955,7573.1018200382705
STAT,1883,23,25-29,1906,113.23994690944257
SIM,1830,49,na,1879,2785
SIM,1857,81,na,1938,813
STAT,1931,41,25-29,1972,0.19295129702382122
SIM,1921,45,25-29,1966,1
SIM,1874,23,20-24,1897,149
STAT,1947,18,40-44,1965,3.1808864540886908
STAT,1802,103,na,1905,0.11014529981456338
SIM,1893,18,40-44,1911,1
STAT,1878,40,35-39,1918,3.858091385400098
STAT,1955,17,20-24,1972,363.4379682121039
STAT,1853,41,40-44,1894,3.5749102713447787
SIM,1950,18,50-100,1968,1
STAT,1855,18,na,1873,4092.7130092544007
STAT,1918,34,na,1952,8045.877249928961
STAT,1885,18,40-44,1903,0.3667259735171014
STAT,1923,35,40-44,1958,3.5080524009986074
SIM,1931,35,40-44,1966,5
SIM,1824,94,na,1918,32
SIM,1862,20,25-29,1882,119
SIM,1865,90,na,1955,90
STAT,1848,27,20-24,1875,22.964322566890246
STAT,1923,31,25-29,1954,21.479980858454113
SIM,1903,28,20-24,1931,34
SIM,1891,23,25-29,1914,160
SIM,1795,78,na,1873,669
STAT,1876,52,35-39,1928,0.01788738371089839
SIM,1856,27,20-24,1883,23
STAT,1839,87,na,1926,275.09366978485576
STAT,1836,48,25-29,1884,0.07914465867991857
STAT,1901,43,40-44,1944,0.4384288455851673
STAT,1864,41,50-100,1905,1.9158523506861427
SIM,1851,43,40-44,1894,10
STAT,1866,23,20-24,1889,128.5360105250507
SIM,1834,22,40-44,1856,5
STAT,1853,37,na,1890,3727.630508329685
STAT,1831,26,30-34,1857,44.44876270695308
STAT,1913,45,25-29,1958,0.10508360630016592
SIM,1953,0,na,1953,10297
STAT,1842,28,na,1870,3954.290175364996
SIM,1836,34,40-44,1870,11
STAT,1769,100,na,1869,0.27718059826446445
STAT,1838,23,45-49,1861,1.2156391106137892
SIM,1881,86,na,1967,655
SIM,1923,30,20-24,1953,11
STAT,1899,18,35-39,1917,1.5143761969478269
SIM,1853,31,40-44,1884,10
SIM,1892,78,na,1970,3102
STAT,1895,25,40-44,1920,7.936699809059898
STAT,1932,33,25-29,1965,24.801052737783063
SIM,1933,34,na,1967,10741
SIM,1886,41,45-49,1927,7
STAT,1838,38,15-19,1876,0.09075820499637709
STAT,1831,36,na,1867,3514.1948902270547
SIM,1810,45,45-49,1855,2
STAT,1847,44,20-24,1891,0.23881765077980596
STAT,1907,49,15-19,1956,6.593017446257085E-4
SIM,1831,42,na,1873,3482
STAT,1951,17,50-100,1968,0.9009673371219658
STAT,1783,111,na,1894,3.306027024480287E-4
SIM,1914,24,15-19,1938,11
STAT,1824,88,na,1912,146.7748246899802
STAT,1886,45,50-100,1931,0.528825211948683
STAT,1831,41,20-24,1872,0.25473746218715887
STAT,1911,48,25-29,1959,0.10116907634878179
STAT,1859,50,40-44,1909,0.01716627452347539
STAT,1867,51,na,1918,4092.039963101345
SIM,1927,23,15-19,1950,14
STAT,1854,20,25-29,1874,104.60792618420646
SIM,1852,20,35-39,1872,15
STAT,1925,20,35-39,1945,22.89381880555957
STAT,1816,90,na,1906,77.44134496694384
SIM,1865,48,na,1913,4157
STAT,1877,27,na,1904,5004.916790273197
STAT,1878,41,45-49,1919,3.171148209334095
STAT,1915,18,50-100,1933,0.15796324411601592
STAT,1850,31,15-19,1881,0.23079949548774067
STAT,1900,29,40-44,1929,8.332462893158699
SIM,1886,40,35-39,1926,5
SIM,1879,29,15-19,1908,1
STAT,1924,40,50-100,1964,0.2829244664871555
STAT,1876,93,na,1969,239.53809796772393
SIM,1856,85,na,1941,363
SIM,1857,103,na,1960,1
SIM,1897,28,20-24,1925,35
STAT,1888,19,na,1907,5996.455174609453
STAT,1899,17,25-29,1916,15.680623383228625
STAT,1915,30,20-24,1945,5.0578617966020385
STAT,1915,40,30-34,1955,0.2606913350221475
SIM,1777,81,na,1858,326
SIM,1919,32,20-24,1951,7
STAT,1828,34,40-44,1862,9.15547676921896
SIM,1923,31,30-34,1954,43
STAT,1932,32,na,1964,10154.80300321829
SIM,1855,44,20-24,1899,1
STAT,1844,20,35-39,1864,11.937027058628475
SIM,1850,22,25-29,1872,114
STAT,1773,88,na,1861,81.1773741134582
STAT,1911,47,15-19,1958,7.045210133918526E-4
STAT,1849,18,na,1867,4443.057501010262
STAT,1919,23,15-19,1942,11.733461662302732
STAT,1773,114,na,1887,5.662264004789822E-4
STAT,1841,49,45-49,1890,0.33526999368119487
STAT,1804,88,na,1892,92.35326473000185
STAT,1858,32,50-100,1890,1.4425537878125767
STAT,1880,23,50-100,1903,0.864922973661597
STAT,1854,46,20-24,1900,0.018448077283162063
STAT,1877,26,35-39,1903,20.304771759591763
SIM,1947,16,25-29,1963,138
STAT,1862,34,45-49,1896,2.9844160026763875
SIM,1903,47,30-34,1950,1
STAT,1882,16,50-100,1898,0.0966231861302601
STAT,1930,20,45-49,1950,2.928459944297576
STAT,1857,27,na,1884,3869.621808714561
STAT,1868,52,40-44,1920,0.020121466159964133
STAT,1913,9,na,1922,8195.344698595622
STAT,1915,31,30-34,1946,32.54189986230583
STAT,1923,40,20-24,1963,0.04178998181476867
STAT,1871,33,50-100,1904,1.8307021591906825
SIM,1859,90,na,1949,76
SIM,1945,22,20-24,1967,256
STAT,1810,54,35-39,1864,0.051107823963104794
STAT,1827,82,na,1909,564.2075201147694
STAT,1854,47,30-34,1901,0.1477013522320109
SIM,1830,44,50-100,1874,5
STAT,1824,41,15-19,1865,0.036779520700065585
STAT,1882,51,50-100,1933,0.029855265059527344
STAT,1842,22,25-29,1864,107.49773229767347
SIM,1827,41,40-44,1868,7
SIM,1866,17,35-39,1883,1
STAT,1813,46,30-34,1859,0.607768587558565
STAT,1885,21,35-39,1906,11.766460339969527
STAT,1869,35,40-44,1904,8.647865486235183
STAT,1822,44,50-100,1866,3.3687953117791873
STAT,1889,28,20-24,1917,29.111211985465435
SIM,1907,31,na,1938,7225
SIM,1884,42,25-29,1926,4
STAT,1814,64,na,1878,1800.9211565368873
SIM,1838,43,na,1881,3334
STAT,1787,100,na,1887,0.42891400131799207
SIM,1933,20,35-39,1953,36
STAT,1941,21,30-34,1962,60.00866960003497
STAT,1901,26,na,1927,6770.737740908315
SIM,1852,58,na,1910,3180
SIM,1893,40,40-44,1933,10
STAT,1844,17,40-44,1861,0.3754693741282938
STAT,1933,39,15-19,1972,0.05271886349322648
STAT,1803,72,na,1875,1167.1856617783656
SIM,1841,86,na,1927,269
SIM,1894,32,40-44,1926,15
STAT,1836,25,35-39,1861,16.845166854990932
STAT,1870,47,15-19,1917,7.894326187774004E-4
STAT,1886,32,40-44,1918,9.245630510084302
STAT,1821,37,25-29,1858,11.272995199679865
SIM,1845,40,45-49,1885,6
STAT,1846,35,na,1881,3847.5467409271846
STAT,1819,41,40-44,1860,10.746011245403487
SIM,1937,27,20-24,1964,36
STAT,1845,50,na,1895,3365.572437746168
SIM,1888,17,20-24,1905,33
SIM,1921,46,35-39,1967,1
STAT,1890,40,15-19,1930,0.03438689342050852
SIM,1894,25,na,1919,6708
SIM,1786,95,na,1881,2
STAT,1880,37,30-34,1917,11.339065870008145
STAT,1885,76,na,1961,2284.9898781352153
STAT,1906,24,15-19,1930,9.648064599798529
STAT,1798,94,na,1892,10.819471644166624
STAT,1885,56,na,1941,4100.268471703879
STAT,1904,23,50-100,1927,1.1784256317419664
STAT,1876,42,25-29,1918,1.3397245160552884
SIM,1878,31,45-49,1909,4
SIM,1880,27,30-34,1907,64
SIM,1821,46,30-34,1867,2
SIM,1857,33,50-100,1890,4
STAT,1941,30,30-34,1971,33.44704697818385
SIM,1889,25,50-100,1914,3
STAT,1858,17,35-39,1875,1.0091473307998966
STAT,1888,45,20-24,1933,0.028930358811221756
SIM,1841,16,20-24,1857,30
STAT,1863,17,45-49,1880,0.13177776439404557
SIM,1877,35,40-44,1912,16
SIM,1844,25,35-39,1869,26
STAT,1931,31,15-19,1962,0.34027972575783805
STAT,1829,63,na,1892,2111.740312651135
STAT,1874,84,na,1958,862.4823020899779
STAT,1891,32,15-19,1923,0.355503967261837
STAT,1879,24,45-49,1903,1.4638541521432846
STAT,1913,46,35-39,1959,0.2548470861521207
SIM,1810,74,na,1884,933
STAT,1809,51,25-29,1860,0.02664048593125883
STAT,1833,39,50-100,1872,1.980021187883717
SIM,1849,33,40-44,1882,15
STAT,1843,78,na,1921,1094.5046976648362
SIM,1913,36,35-39,1949,4
SIM,1836,34,na,1870,3427
STAT,1844,53,35-39,1897,0.01367966461409806
STAT,1915,41,50-100,1956,0.23923559213943527
SIM,1796,71,na,1867,1158
STAT,1905,36,35-39,1941,4.480406574341308
SIM,1934,19,na,1953,9855
STAT,1777,103,na,1880,0.09356101621549218
SIM,1848,18,30-34,1866,1
STAT,1870,57,na,1927,3984.7511091596657
STAT,1882,49,35-39,1931,0.2696846512161485
STAT,1931,40,15-19,1971,0.004155016707932989
STAT,1912,18,na,1930,7869.125710707021
STAT,1897,19,15-19,1916,15.93524386955364
SIM,1887,24,45-49,1911,1
SIM,1839,43,25-29,1882,2
SIM,1890,49,35-39,1939,1
STAT,1910,18,45-49,1928,0.1994563223132493
STAT,1885,40,40-44,1925,4.567336322972614
STAT,1882,28,50-100,1910,1.254098658185225
SIM,1864,60,na,1924,3590
STAT,1879,43,20-24,1922,0.33306539822143005
SIM,1882,33,25-29,1915,28
STAT,1816,54,35-39,1870,0.03898931344618101
STAT,1904,47,50-100,1951,0.39971585136984067
STAT,1845,15,35-39,1860,1.0813714571265938
STAT,1865,70,na,1935,2574.3763188990856
STAT,1883,45,35-39,1928,0.28056780231489037
STAT,1875,15,na,1890,5276.02289151537
STAT,1872,45,25-29,1917,0.11807862529219726
SIM,1913,17,25-29,1930,25
STAT,1916,17,35-39,1933,1.7980028121092728
STAT,1827,54,45-49,1881,0.02212513263659396
STAT,1929,42,15-19,1971,0.004016147602166754
SIM,1847,16,20-24,1863,36
SIM,1886,21,25-29,1907,129
STAT,1931,23,30-34,1954,75.05499203089354
STAT,1865,27,20-24,1892,21.524998668678453
SIM,1867,16,40-44,1883,4
SIM,1925,37,50-100,1962,1
STAT,1859,28,40-44,1887,4.863283138055637
SIM,1841,41,50-100,1882,5
SIM,1870,46,50-100,1916,1
SIM,1842,15,25-29,1857,19
SIM,1946,17,20-24,1963,4
SIM,1850,29,50-100,1879,2
STAT,1827,31,na,1858,3547.20495229744
STAT,1905,17,25-29,1922,16.55127086679174
STAT,1894,33,45-49,1927,4.505074756042298
SIM,1915,15,na,1930,8245
STAT,1851,107,na,1958,0.014443578408392494
STAT,1926,32,na,1958,9234.475272274802
SIM,1871,33,15-19,1904,4
SIM,1925,43,35-39,1968,1
SIM,1858,16,30-34,1874,3
STAT,1830,27,25-29,1857,97.60825529918127
STAT,1942,23,40-44,1965,7.117762196712717
STAT,1870,40,30-34,1910,2.3025954227914047
STAT,1805,54,25-29,1859,0.026710065564637734
SIM,1909,6,na,1915,7963
STAT,1820,49,50-100,1869,0.8877998255361285
SIM,1833,29,40-44,1862,10
SIM,1891,45,35-39,1936,1
STAT,1874,33,25-29,1907,21.091450080228284
STAT,1859,53,na,1912,3405.6205993870176
SIM,1805,73,na,1878,991
SIM,1823,98,na,1921,1
STAT,1869,60,na,1929,3732.2353029837254
SIM,1895,52,na,1947,5887
STAT,1843,22,40-44,1865,3.663988020168443
STAT,1880,17,45-49,1897,0.1389783987478674
STAT,1865,42,15-19,1907,0.025307234790776723
STAT,1920,35,20-24,1955,0.5837813271640668
SIM,1887,43,20-24,1930,2
SIM,1861,35,50-100,1896,4
SIM,1938,18,40-44,1956,4
STAT,1858,40,15-19,1898,0.02196183793375708
SIM,1826,30,35-39,1856,36
SIM,1835,42,45-49,1877,7
SIM,1879,15,20-24,1894,40
SIM,1827,46,50-100,1873,1
STAT,1900,23,35-39,1923,16.298306172104112
SIM,1885,45,na,1930,4823
STAT,1894,45,45-49,1939,0.34881882988646296
STAT,1916,25,na,1941,7875.79380276935
STAT,1854,27,45-49,1881,1.7843353191727005
STAT,1907,21,30-34,1928,53.03294028243231
STAT,1895,15,na,1910,6677.342680927562
SIM,1853,15,35-39,1868,2
SIM,1881,52,na,1933,3673
SIM,1815,80,na,1895,643
SIM,1815,42,25-29,1857,2
STAT,1896,62,na,1958,5016.363361186136
STAT,1918,37,na,1955,8007.308236722655
STAT,1825,29,40-44,1854,20.194734665880343
STAT,1874,18,30-34,1892,3.287350747889989
STAT,1811,44,40-44,1855,16.247399451564
STAT,1853,44,45-49,1897,2.3360229010448794
SIM,1915,21,30-34,1936,76
SIM,1894,39,25-29,1933,12
SIM,1904,21,20-24,1925,186
STAT,1860,46,45-49,1906,0.3881584827826499
STAT,1939,16,25-29,1955,87.64043926195383
STAT,1826,100,na,1926,1.2709006364832767
STAT,1928,44,na,1972,9528.79895084488
STAT,1827,42,45-49,1869,2.842940116159254
SIM,1845,20,25-29,1865,130
SIM,1859,100,na,1959,3
STAT,1949,21,35-39,1970,22.195796251419452
SIM,1867,28,40-44,1895,2
SIM,1851,22,40-44,1873,4
SIM,1900,61,na,1961,5759
STAT,1890,22,20-24,1912,169.8800432642281
STAT,1938,17,20-24,1955,270.1426521620107
STAT,1893,46,40-44,1939,0.24791200535854233
STAT,1839,37,20-24,1876,1.4383472795658427
STAT,1901,71,na,1972,4637.571400959752
STAT,1924,46,45-49,1970,0.5237231763117702
STAT,1904,35,50-100,1939,0.7754540433219366
SIM,1841,32,25-29,1873,25
SIM,1861,32,45-49,1893,3
STAT,1874,30,na,1904,4974.353690863074
STAT,1903,38,25-29,1941,1.7781529674324783
SIM,1893,40,na,1933,6145
STAT,1886,39,25-29,1925,6.07650393567501
SIM,1927,22,35-39,1949,29
STAT,1866,26,25-29,1892,79.09835634297087
SIM,1963,2,na,1965,10480
SIM,1911,38,25-29,1949,5
STAT,1823,31,20-24,1854,17.669370606249625
STAT,1917,43,35-39,1960,0.42370342484168005
SIM,1902,42,na,1944,6757
STAT,1859,16,40-44,1875,0.3433115533113963
STAT,1936,29,20-24,1965,35.253565357423184
SIM,1878,18,na,1896,5506
STAT,1804,103,na,1907,0.09654526565560533
STAT,1839,16,20-24,1855,36.42640815513667
STAT,1805,110,na,1915,2.0670347904705688E-4
STAT,1833,53,25-29,1886,0.004712773000490943
SIM,1887,23,na,1910,5843
SIM,1870,34,50-100,1904,2
SIM,1839,93,na,1932,47
STAT,1922,44,20-24,1966,0.04079152059148116
SIM,1829,86,na,1915,243
STAT,1925,29,45-49,1954,4.0907618614605665
SIM,1899,17,30-34,1916,5
SIM,1831,31,20-24,1862,6
STAT,1898,40,na,1938,6402.59562260353
SIM,1935,17,45-49,1952,3
STAT,1828,37,45-49,1865,4.014605972390093
SIM,1855,38,na,1893,4116
STAT,1835,49,20-24,1884,0.015974954908631215
STAT,1837,20,25-29,1857,109.4828565272535
SIM,1858,41,35-39,1899,7
SIM,1872,27,na,1899,5056
STAT,1871,46,20-24,1917,0.024146543559323486
SIM,1908,33,na,1941,7197
SIM,1870,34,45-49,1904,7
STAT,1843,43,40-44,1886,3.202833222429574
STAT,1943,22,45-49,1965,2.4176223359246345
STAT,1823,43,20-24,1866,0.515576267355459
SIM,1854,53,na,1907,3502
SIM,1885,34,50-100,1919,3
SIM,1821,45,50-100,1866,1
SIM,1807,51,na,1858,2347
STAT,1869,63,na,1932,3491.7755244691252
STAT,1912,12,na,1924,8067.557504052678
SIM,1933,29,45-49,1962,9
STAT,1927,17,45-49,1944,1.254233086391903
SIM,1870,15,na,1885,5104
STAT,1913,0,na,1913,9274.640724094357
SIM,1929,39,30-34,1968,7
STAT,1867,82,na,1949,882.5054862897441
SIM,1815,49,45-49,1864,2
STAT,1933,28,50-100,1961,2.6681715178504763
STAT,1902,28,50-100,1930,1.817564014285957
SIM,1868,26,35-39,1894,27
STAT,1822,32,15-19,1854,0.913579957767463
STAT,1895,28,45-49,1923,2.911622500537083
STAT,1910,31,na,1941,7397.775667919284
STAT,1921,18,20-24,1939,311.21474871900807
STAT,1904,18,20-24,1922,51.25575521957109
SIM,1819,37,45-49,1856,6
STAT,1911,41,40-44,1952,0.4850627393613946
STAT,1858,36,45-49,1894,3.1536881643285004
SIM,1913,45,30-34,1958,1
SIM,1821,49,35-39,1870,1
STAT,1861,97,na,1958,14.064181680548723
SIM,1825,32,40-44,1857,11
STAT,1851,19,40-44,1870,0.3406755061240437
STAT,1873,34,20-24,1907,5.499338513862797
SIM,1767,91,na,1858,26
STAT,1769,109,na,1878,0.004131549585126952
STAT,1857,30,20-24,1887,4.371260902315954
SIM,1840,43,30-34,1883,5
STAT,1878,28,45-49,1906,2.333719421379575
SIM,1892,23,40-44,1915,9
SIM,1896,40,50-100,1936,1
STAT,1884,23,40-44,1907,4.142837387047865
SIM,1805,70,na,1875,1323
STAT,1880,44,50-100,1924,2.217339086658803
STAT,1915,18,30-34,1933,5.139071920067027
STAT,1899,41,15-19,1940,0.0026656457437326015
SIM,1903,22,15-19,1925,9
STAT,1936,4,na,1940,7805.842849672914
STAT,1921,33,15-19,1954,0.2875284916302133
STAT,1863,51,45-49,1914,0.02577926313343006
SIM,1909,27,45-49,1936,6
SIM,1869,38,na,1907,4548
SIM,1908,33,50-100,1941,4
STAT,1915,34,35-39,1949,18.637338162635672
SIM,1876,35,50-100,1911,4
SIM,1881,34,20-24,1915,3
STAT,1926,22,45-49,1948,2.7602505299659263
SIM,1853,38,25-29,1891,7
STAT,1939,29,50-100,1968,2.0191143233647053
STAT,1849,21,50-100,1870,0.7855153424312685
STAT,1919,22,35-39,1941,20.819069622927266
SIM,1836,37,45-49,1873,5
SIM,1836,31,na,1867,3538
STAT,1831,44,25-29,1875,0.990920766142268
SIM,1839,24,15-19,1863,4
SIM,1887,41,50-100,1928,5
SIM,1912,18,20-24,1930,60
STAT,1806,53,30-34,1859,0.03404494297338857
STAT,1813,49,35-39,1862,0.8342225440232763
SIM,1849,38,na,1887,3897
SIM,1924,33,40-44,1957,17
STAT,1848,106,na,1954,0.01990881682553545
STAT,1821,33,45-49,1854,11.45955084865583
SIM,1913,33,30-34,1946,42
SIM,1940,18,30-34,1958,32
STAT,1852,51,35-39,1903,0.013786857388576518
SIM,1807,54,na,1861,2198
SIM,1923,34,35-39,1957,33
STAT,1932,18,30-34,1950,32.51329813459718
SIM,1928,28,25-29,1956,200
STAT,1814,98,na,1912,2.795790597587531
SIM,1854,50,na,1904,3630
STAT,1821,46,na,1867,2916.682601754478
STAT,1901,3,na,1904,7474.5502637476775
STAT,1863,75,na,1938,1819.9866949201594
STAT,1905,45,30-34,1950,0.1610741387682233
SIM,1847,71,na,1918,2020
STAT,1898,15,15-19,1913,16.29500676550926
STAT,1860,49,15-19,1909,6.42335121633741E-4
STAT,1898,43,na,1941,6292.847596920394
SIM,1904,20,na,1924,7005
STAT,1895,44,50-100,1939,0.19045619407404893
SIM,1872,32,20-24,1904,8
STAT,1914,44,na,1958,7408.884274909587
STAT,1916,33,40-44,1949,8.125232838591536
SIM,1930,29,na,1959,10126
SIM,1931,22,na,1953,9572
STAT,1913,34,50-100,1947,1.647525330677636
SIM,1886,28,45-49,1914,3
SIM,1865,30,20-24,1895,6
STAT,1859,70,na,1929,2255.426610123356
SIM,1816,68,na,1884,1649
STAT,1872,20,45-49,1892,1.4238268183612885
SIM,1931,4,na,1935,10686
STAT,1770,91,na,1861,29.24053407987907
STAT,1899,28,na,1927,6580.595208923674
STAT,1841,45,30-34,1886,0.14474856917676418
STAT,1941,24,35-39,1965,19.639584138095778
STAT,1906,43,25-29,1949,0.1302858295090736
STAT,1817,53,40-44,1870,0.04776752107089134
STAT,1848,16,na,1864,4693.498335856974
SIM,1922,35,30-34,1957,6
STAT,1905,33,30-34,1938,29.158338112747945
STAT,1858,103,na,1961,0.6459409677070229
STAT,1868,43,45-49,1911,2.855059219828715
SIM,1788,76,na,1864,643
SIM,1858,97,na,1955,4
STAT,1912,43,15-19,1955,0.0029741470335731372
SIM,1918,39,20-24,1957,2
STAT,1830,45,20-24,1875,0.021257110951815376
STAT,1930,24,25-29,1954,237.4857382337212
STAT,1873,44,30-34,1917,2.327339184383141
STAT,1874,54,25-29,1928,0.007123159767882336
SIM,1876,43,45-49,1919,6
STAT,1917,32,45-49,1949,3.3276092205691534
SIM,1896,37,na,1933,6580
SIM,1925,32,45-49,1957,6
STAT,1951,19,45-49,1970,1.2004850532192477
SIM,1787,91,na,1878,43
STAT,1812,83,na,1895,376.3064939777581
STAT,1842,44,35-39,1886,2.7187061587922963
SIM,1923,18,30-34,1941,33
SIM,1850,44,35-39,1894,6
STAT,1860,27,50-100,1887,1.0603897995249625
STAT,1869,38,45-49,1907,3.881783328088572
SIM,1890,15,na,1905,6709
SIM,1830,40,na,1870,3093
STAT,1931,35,30-34,1966,4.883496180338951
SIM,1803,92,na,1895,39
STAT,1902,2,na,1904,7600.719245715738
STAT,1853,68,na,1921,2417.916384132396
STAT,1832,43,30-34,1875,1.810109609564497
STAT,1841,97,na,1938,7.794746826559048
STAT,1882,46,30-34,1928,0.1909847043223677
STAT,1899,37,45-49,1936,1.1906349937245204
STAT,1914,35,30-34,1949,3.7106962045376757
STAT,1926,37,15-19,1963,0.047390413955342645
STAT,1956,15,15-19,1971,121.32936651932644
SIM,1877,38,45-49,1915,9
STAT,1906,28,30-34,1934,73.84806250803011
STAT,1921,45,15-19,1966,8.424293207512818E-4
SIM,1831,25,na,1856,4014
STAT,1877,45,45-49,1922,0.4998635691895784
SIM,1838,46,na,1884,3205
SIM,1908,32,45-49,1940,6
SIM,1834,53,na,1887,2789
STAT,1870,43,35-39,1913,3.5645937151529363
SIM,1818,46,na,1864,2955
STAT,1902,32,35-39,1934,28.87577083823807
STAT,1854,30,na,1884,3824.8142940408125
SIM,1939,28,na,1967,7771
STAT,1858,23,na,1881,3859.8588981869434
SIM,1889,58,na,1947,4960
SIM,1849,47,50-100,1896,2
STAT,1844,23,na,1867,4280.207227250101
STAT,1898,31,20-24,1929,7.417887493297935
SIM,1848,22,50-100,1870,1
STAT,1900,41,30-34,1941,0.2246806392415873
SIM,1841,32,na,1873,3766
STAT,1803,52,35-39,1855,0.06324680641706816
SIM,1798,83,na,1881,218
SIM,1924,17,35-39,1941,12
SIM,1794,90,na,1884,46
SIM,1910,32,35-39,1942,28
STAT,1924,29,50-100,1953,2.323216787663942
SIM,1859,8,na,1867,5075
STAT,1811,50,35-39,1861,0.05803114178379418
STAT,1911,26,15-19,1937,1.3955973084425926
SIM,1894,59,na,1953,5182
SIM,1856,43,25-29,1899,1
STAT,1946,18,25-29,1964,97.0342044233858
STAT,1855,45,25-29,1900,0.08772294667906819
STAT,1850,57,na,1907,3081.30645106123
STAT,1863,78,na,1941,1381.3186125152517
SIM,1852,42,45-49,1894,4
SIM,1847,19,25-29,1866,15
STAT,1815,51,15-19,1866,1.291819313194388E-4
STAT,1936,27,30-34,1963,75.74777012640084
STAT,1887,19,20-24,1906,39.83032331521989
STAT,1896,43,20-24,1939,0.0291937549484826
STAT,1898,19,30-34,1917,4.332823697754793
SIM,1806,58,na,1864,2254
SIM,1944,27,30-34,1971,108
SIM,1878,66,na,1944,3439
STAT,1816,76,na,1892,930.5896189583466
STAT,1849,60,na,1909,3016.7734713577315
STAT,1901,22,40-44,1923,5.891696503976531
STAT,1908,29,45-49,1937,3.2769601707937146
SIM,1857,100,na,1957,3
STAT,1847,54,30-34,1901,0.008824198898655496
STAT,1866,45,35-39,1911,0.2634880943944277
STAT,1936,25,na,1961,7248.36288850938
SIM,1828,28,20-24,1856,22
STAT,1838,23,na,1861,3727.279214560694
STAT,1876,31,35-39,1907,21.240469106464513
SIM,1865,45,na,1910,4257
STAT,1785,90,na,1875,64.13250264195625
STAT,1791,76,na,1867,750.2253023750135
STAT,1839,19,25-29,1858,11.438769730875544
STAT,1894,48,15-19,1942,5.780265089604011E-4
STAT,1824,30,50-100,1854,5.879805584523513
SIM,1921,46,50-100,1967,1
STAT,1868,40,40-44,1908,4.365653859855138
SIM,1946,21,na,1967,8023
STAT,1806,69,na,1875,1414.1385397551612
STAT,1837,43,15-19,1880,0.02242844436733162
STAT,1913,46,50-100,1959,0.44707460120649695
SIM,1883,16,25-29,1899,16
STAT,1843,25,45-49,1868,1.941899683830368
STAT,1844,50,30-34,1894,0.009750996443489247
STAT,1920,38,25-29,1958,2.1745121718864415
SIM,1854,30,45-49,1884,6
STAT,1882,42,15-19,1924,0.027135962862993336
STAT,1858,54,40-44,1912,0.016119124790422035
SIM,1852,24,50-100,1876,5
STAT,1891,17,20-24,1908,44.257188374379425
SIM,1948,15,30-34,1963,36
STAT,1894,30,40-44,1924,11.341601919503969
SIM,1872,44,20-24,1916,4
SIM,1867,26,na,1893,4873
SIM,1832,30,50-100,1862,3
STAT,1851,52,30-34,1903,0.009178415857689805
STAT,1881,48,50-100,1929,0.47340709141097387
STAT,1893,42,25-29,1935,1.641819854308034
STAT,1848,43,25-29,1891,1.0453432668942015
STAT,1875,16,25-29,1891,11.812060269555024
STAT,1931,38,35-39,1969,6.4631817524409625
STAT,1757,103,na,1860,0.16938516818138477
STAT,1934,19,45-49,1953,1.3574949399466005
STAT,1884,30,15-19,1914,0.28628224655470247
SIM,1832,26,20-24,1858,19
STAT,1870,71,na,1941,2646.6790318680205
SIM,1839,28,30-34,1867,54
STAT,1864,44,20-24,1908,0.2828366720372793
SIM,1888,73,na,1961,3160
SIM,1881,44,30-34,1925,4
STAT,1826,51,25-29,1877,0.006948847457936897
STAT,1865,56,na,1921,3742.343413262553
STAT,1844,24,50-100,1868,0.8104732111294503
SIM,1846,72,na,1918,1841
SIM,1919,16,15-19,1935,101
SIM,1856,39,50-100,1895,2
STAT,1868,18,40-44,1886,0.3557088671095666
SIM,1879,18,25-29,1897,11
STAT,1917,40,30-34,1957,0.27017880335278477
STAT,1851,51,50-100,1902,0.023524037445058918
STAT,1828,45,50-100,1873,0.45417037572168867
STAT,1846,30,45-49,1876,3.2227270680688114
STAT,1878,44,15-19,1922,0.02873589505399686
SIM,1836,65,na,1901,2108
STAT,1924,4,na,1928,9704.51669798705
SIM,1887,26,na,1913,5882
SIM,1881,6,na,1887,4586
STAT,1923,47,40-44,1970,0.37237492189255506
SIM,1878,42,50-100,1920,8
STAT,1890,77,na,1967,2894.1143835408852
SIM,1854,18,20-24,1872,38
SIM,1870,31,40-44,1901,13
SIM,1921,21,20-24,1942,283
SIM,1910,20,na,1930,7614
SIM,1884,31,35-39,1915,25
STAT,1933,33,40-44,1966,10.645413864215989
STAT,1861,39,20-24,1900,1.2827617650469243
STAT,1845,38,25-29,1883,4.613401724558483
SIM,1916,20,35-39,1936,26
STAT,1881,35,25-29,1916,5.673804774804766
SIM,1852,27,na,1879,4085
SIM,1878,63,na,1941,3786
SIM,1905,16,20-24,1921,44
STAT,1852,41,25-29,1893,1.0281074397853862
SIM,1906,34,35-39,1940,24
STAT,1878,21,25-29,1899,121.11275698249074
SIM,1873,27,20-24,1900,26
STAT,1833,50,20-24,1883,0.0010419306353030625
STAT,1923,43,25-29,1966,0.16824289405697024
STAT,1847,82,na,1929,711.231118313861
SIM,1850,40,50-100,1890,7
SIM,1895,19,20-24,1914,47
STAT,1855,42,20-24,1897,0.23918479189262823
STAT,1913,21,20-24,1934,218.32247013687174
SIM,1840,17,15-19,1857,8
SIM,1920,6,na,1926,9304
SIM,1876,18,40-44,1894,1
STAT,1842,40,50-100,1882,1.6695308253358727
SIM,1925,40,30-34,1965,1
STAT,1835,49,na,1884,2993.588646621809
STAT,1901,47,20-24,1948,0.019049235147424102
STAT,1921,30,45-49,1951,3.5642097974570146
SIM,1817,40,35-39,1857,3
STAT,1814,44,25-29,1858,3.453086370680969
SIM,1900,35,45-49,1935,3
SIM,1880,49,40-44,1929,2
STAT,1911,44,45-49,1955,0.31696394638893555
STAT,1852,38,na,1890,3736.355816635729
STAT,1885,22,na,1907,4754.4481797918515
SIM,1908,7,na,1915,7878
STAT,1822,50,45-49,1872,0.045173043060751185
SIM,1794,79,na,1873,534
STAT,1849,26,25-29,1875,79.89189364813578
SIM,1822,44,25-29,1866,1
SIM,1918,37,30-34,1955,6
STAT,1903,35,20-24,1938,0.4829826234546961
STAT,1844,42,45-49,1886,2.475355158223882
STAT,1939,32,30-34,1971,32.4695886357342
STAT,1832,83,na,1915,517.5590393220223
STAT,1905,48,35-39,1953,0.22776065803983447
SIM,1852,72,na,1924,2008
STAT,1784,94,na,1878,6.889100630201904
STAT,1890,34,20-24,1924,6.606411406577937
SIM,1882,37,40-44,1919,17
STAT,1821,91,na,1912,64.2320329273531
STAT,1876,11,na,1887,5450.94053450424
SIM,1870,5,na,1875,5433
STAT,1825,50,na,1875,2871.9871319069775
SIM,1901,40,50-100,1941,1
SIM,1863,64,na,1927,3109
STAT,1789,100,na,1889,0.46601704629357993
SIM,1868,23,30-34,1891,37
STAT,1888,29,15-19,1917,1.0752769822739976
STAT,1867,52,25-29,1919,0.006663785692697224
STAT,1928,32,20-24,1960,6.158733613948309
SIM,1939,28,35-39,1967,39
SIM,1886,25,40-44,1911,10
SIM,1871,37,30-34,1908,13
STAT,1861,20,35-39,1881,10.22396090808656
SIM,1914,19,na,1933,8218
SIM,1869,41,45-49,1910,5
STAT,1819,48,25-29,1867,0.23810809432243815
STAT,1800,54,40-44,1854,0.06323716470722958
SIM,1944,23,15-19,1967,13
SIM,1857,26,25-29,1883,74
SIM,1892,40,25-29,1932,3
SIM,1928,33,na,1961,9649
SIM,1890,12,na,1902,6860
STAT,1833,32,25-29,1865,17.373730197365216
SIM,1930,36,35-39,1966,10
SIM,1825,35,45-49,1860,5
STAT,1878,25,40-44,1903,6.36141205896233
STAT,1936,23,15-19,1959,10.276960358909895
STAT,1824,49,45-49,1873,0.5557223049269465
STAT,1825,41,30-34,1866,2.713317382913654
SIM,1845,79,na,1924,971
SIM,1876,85,na,1961,904
STAT,1883,20,20-24,1903,137.55710281276538
STAT,1850,16,20-24,1866,33.413535427093144
STAT,1900,44,35-39,1944,0.3475395057458974
STAT,1836,42,na,1878,3325.396826979319
STAT,1940,31,25-29,1971,19.331757845912044
SIM,1940,30,20-24,1970,5
STAT,1874,37,40-44,1911,9.052302902227437
STAT,1897,28,50-100,1925,1.7208615612273246
STAT,1921,16,30-34,1937,28.121910785404005
SIM,1918,26,na,1944,8231
STAT,1869,50,35-39,1919,0.01708951262739004
SIM,1913,48,35-39,1961,1
SIM,1919,16,50-100,1935,1
SIM,1938,18,50-100,1956,1
STAT,1940,21,15-19,1961,10.956180920898891
STAT,1834,64,na,1898,2310.1703241749256
SIM,1954,8,na,1962,9927
STAT,1836,41,40-44,1877,3.604391976670408
STAT,1775,80,na,1855,357.46101
STAT,1914,45,40-44,1959,0.3173349753477577
SIM,1913,34,na,1947,7656
STAT,1803,58,na,1861,2131.098498041182
SIM,1929,18,na,1947,9652
STAT,1888,29,50-100,1917,1.5160737285383559
SIM,1891,20,20-24,1911,167
STAT,1907,46,45-49,1953,0.39628117649519856
STAT,1840,21,50-100,1861,0.7539644074125624
SIM,1866,20,50-100,1886,1
STAT,1863,33,15-19,1896,0.25070018372299396
STAT,1858,50,25-29,1908,0.0056567482237709
STAT,1932,40,30-34,1972,0.35094198961820894
SIM,1870,12,na,1882,5181
STAT,1905,30,na,1935,7025.916148760432
STAT,1908,20,35-39,1928,17.598505833123024
SIM,1827,48,25-29,1875,1
STAT,1851,31,30-34,1882,28.46463495276496
SIM,1829,83,na,1912,476
SIM,1847,37,20-24,1884,2
SIM,1903,27,na,1930,7022
STAT,1858,33,40-44,1891,6.798992580956003
STAT,1812,46,15-19,1858,0.0028258143449746377
SIM,1896,29,50-100,1925,3
STAT,1780,104,na,1884,0.06194014632238416
STAT,1858,20,50-100,1878,0.7473351735176152
STAT,1846,18,20-24,1864,33.911185447880015
SIM,1841,35,na,1876,3707
SIM,1866,33,40-44,1899,14
SIM,1929,42,50-100,1971,2
STAT,1890,47,50-100,1937,0.33992769270653295
STAT,1768,87,na,1855,93.8788
STAT,1878,77,na,1955,1823.262943054961
STAT,1848,39,50-100,1887,2.0319395999190273
SIM,1876,40,40-44,1916,10
SIM,1862,27,45-49,1889,1
SIM,1898,18,na,1916,7131
SIM,1844,41,40-44,1885,11
STAT,1836,90,na,1926,104.82509101784402
STAT,1871,45,50-100,1916,0.4977130930511206
STAT,1840,31,20-24,1871,4.801851565655338
STAT,1861,12,na,1873,4612.440397122925
SIM,1895,31,45-49,1926,7
SIM,1855,28,15-19,1883,1
STAT,1841,41,15-19,1882,0.021089518239817563
SIM,1833,41,30-34,1874,4
SIM,1894,33,50-100,1927,5
SIM,1790,80,na,1870,474
STAT,1889,69,na,1958,3829.533147736562
STAT,1857,18,30-34,1875,2.9316457230715858
STAT,1855,49,na,1904,3321.777095089712
STAT,1906,40,20-24,1946,0.032783169174288494
STAT,1922,36,35-39,1958,5.562002239806391
SIM,1898,27,25-29,1925,128
STAT,1892,32,30-34,1924,44.14333189232326
STAT,1924,21,30-34,1945,68.68198003220797
STAT,1838,54,20-24,1892,9.712405966458343E-4
STAT,1890,47,35-39,1937,0.19376985799437196
SIM,1843,30,35-39,1873,27
SIM,1872,78,na,1950,1499
SIM,1871,93,na,1964,104
STAT,1799,93,na,1892,19.875072948253163
STAT,1884,40,25-29,1924,1.293556877651824
SIM,1922,48,na,1970,8901
SIM,1801,66,na,1867,1615
SIM,1941,0,na,1941,8797
STAT,1806,109,na,1915,4.844440570102069E-4
STAT,1810,51,na,1861,2504.1658112597684
STAT,1853,47,15-19,1900,6.299295306512246E-4
STAT,1889,44,25-29,1933,1.5775354171091103
SIM,1885,11,na,1896,5417
STAT,1847,28,15-19,1875,0.8252967261450843
SIM,1849,17,35-39,1866,1
STAT,1886,33,50-100,1919,1.9451396213309726
SIM,1800,81,na,1881,357
SIM,1932,21,30-34,1953,93
STAT,1932,18,na,1950,9818.323520476832
SIM,1915,46,45-49,1961,1
STAT,1931,33,na,1964,10002.851205959823
SIM,1865,18,30-34,1883,5
STAT,1930,28,40-44,1958,11.963848579481054
SIM,1885,42,40-44,1927,8
STAT,1862,34,50-100,1896,1.5680829747773544
STAT,1921,26,na,1947,8458.988490873882
STAT,1887,31,45-49,1918,3.95502976330762
STAT,1818,57,na,1875,2412.987770077607
STAT,1914,31,15-19,1945,0.2623559545747836
STAT,1886,16,35-39,1902,1.1726894689160707
SIM,1903,36,50-100,1939,1
STAT,1919,49,40-44,1968,0.34327245043177174
STAT,1850,39,45-49,1889,3.0411380595073294
STAT,1899,34,40-44,1933,11.897554156054133
SIM,1843,13,na,1856,4541
SIM,1936,32,20-24,1968,7
STAT,1863,37,30-34,1900,9.422164131635872
SIM,1888,38,20-24,1926,3
SIM,1903,26,30-34,1929,83
STAT,1874,51,20-24,1925,0.0015332555399223604
STAT,1829,52,20-24,1881,0.0010235245572295295
SIM,1868,49,25-29,1917,1
SIM,1887,77,na,1964,2638
STAT,1901,0,na,1901,8302.106783090408
SIM,1856,47,40-44,1903,1
STAT,1826,35,na,1861,3465.566970026606
STAT,1860,50,50-100,1910,0.02512571207311294
STAT,1835,30,35-39,1865,17.056605529593053
SIM,1911,56,na,1967,6928
SIM,1818,91,na,1909,69
STAT,1912,47,30-34,1959,0.17307352994703792
SIM,1918,0,na,1918,9502
SIM,1858,19,35-39,1877,3
SIM,1861,86,na,1947,308
SIM,1875,31,50-100,1906,5
STAT,1823,72,na,1895,1515.475708733327
SIM,1883,19,na,1902,5215
STAT,1947,17,na,1964,8373.27303273243
SIM,1816,65,na,1881,1849
STAT,1869,15,50-100,1884,0.09835699664893213
STAT,1820,38,20-24,1858,3.6064211758851967
STAT,1851,16,50-100,1867,0.09288395700274793
SIM,1828,40,45-49,1868,4
STAT,1838,17,50-100,1855,0.08758264731019186
STAT,1887,66,na,1953,3702.1841075120724
SIM,1865,32,20-24,1897,7
STAT,1906,18,30-34,1924,4.678379293832904
STAT,1846,68,na,1914,2340.7541341121123
STAT,1860,52,50-100,1912,0.02463789805663616
STAT,1898,20,15-19,1918,9.070319804916423
SIM,1859,21,40-44,1880,4
SIM,1862,31,40-44,1893,10
STAT,1842,38,45-49,1880,3.4456428234083143
SIM,1876,30,30-34,1906,51
STAT,1827,48,20-24,1875,0.02138442274937345
SIM,1845,34,45-49,1879,5
STAT,1824,47,40-44,1871,0.41462152329655183
STAT,1850,73,na,1923,1821.1452397109697
STAT,1891,71,na,1962,3738.207735276662
SIM,1954,15,20-24,1969,349
STAT,1845,48,50-100,1893,0.37369851723798014
STAT,1849,23,50-100,1872,0.7742758373150949
STAT,1838,27,15-19,1865,0.7810922909584266
STAT,1951,19,20-24,1970,325.8117089523497
SIM,1846,27,15-19,1873,2
STAT,1902,30,30-34,1932,50.183866700457216
STAT,1822,35,50-100,1857,5.338891996449391
STAT,1824,41,na,1865,2975.3687182454655
STAT,1857,5,na,1862,4652.480884550388
STAT,1948,23,30-34,1971,66.62180414451653
STAT,1900,22,20-24,1922,193.06693255075626
STAT,1887,40,50-100,1927,2.4103844702657735
SIM,1827,58,na,1885,2538
STAT,1821,47,50-100,1868,0.7188578957671663
SIM,1874,36,na,1910,4575
STAT,1803,95,na,1898,9.38303071354006
STAT,1930,34,25-29,1964,24.058613665066563
STAT,1911,49,na,1960,6985.066646894728
STAT,1857,32,20-24,1889,4.281417104516607
STAT,1828,55,na,1883,2670.0704069758362
STAT,1920,21,35-39,1941,21.2000402593263
SIM,1914,18,30-34,1932,4
STAT,1878,28,50-100,1906,1.3445540422303572
STAT,1915,43,50-100,1958,0.2385136449599934
STAT,1847,25,15-19,1872,0.8433319818268094
STAT,1926,45,15-19,1971,9.221318214584703E-4
STAT,1836,23,50-100,1859,0.7105828070212356
STAT,1846,32,45-49,1878,3.1564894205029432
STAT,1854,31,40-44,1885,6.879149362813199
SIM,1832,47,40-44,1879,1
STAT,1923,44,35-39,1967,0.4735966221239235
SIM,1939,26,35-39,1965,44
STAT,1889,35,20-24,1924,1.9378238335492066
STAT,1898,28,25-29,1926,115.2065349071091
SIM,1840,24,na,1864,4228
STAT,1844,24,35-39,1868,11.59787029380918
SIM,1907,20,30-34,1927,75
STAT,1861,21,30-34,1882,30.98365849871162
STAT,1830,45,15-19,1875,7.085697417784247E-4
STAT,1940,19,45-49,1959,1.0237448703705132
SIM,1921,31,45-49,1952,7
STAT,1873,54,25-29,1927,0.0070685327693029406
STAT,1914,24,15-19,1938,10.91668345445634
STAT,1941,26,25-29,1967,137.5815881155237
SIM,1922,24,15-19,1946,12
STAT,1862,46,50-100,1908,0.42515871094655594
STAT,1891,38,40-44,1929,10.873717160843658
SIM,1962,0,na,1962,10334
STAT,1837,34,45-49,1871,2.9853766789920444
STAT,1918,39,30-34,1957,3.870826058550254
SIM,1886,21,na,1907,4981
SIM,1926,39,30-34,1965,6
STAT,1876,34,50-100,1910,1.8975223207485303
SIM,1852,24,35-39,1876,13
STAT,1832,60,na,1892,2486.4242196566966
SIM,1830,39,30-34,1869,15
SIM,1897,35,20-24,1932,5
STAT,1967,0,na,1967,9990.826149895103
STAT,1832,53,50-100,1885,0.02007885281418307
STAT,1822,39,30-34,1861,19.390931808417346
STAT,1919,13,na,1932,8827.61744247484
STAT,1831,37,30-34,1868,8.715874691685649
STAT,1900,44,40-44,1944,0.43169111164001295
SIM,1907,28,40-44,1935,12
STAT,1829,72,na,1901,1494.6476116404494
SIM,1915,34,25-29,1949,25
SIM,1824,77,na,1901,1008
STAT,1922,28,40-44,1950,10.611616591298581
SIM,1912,19,35-39,1931,4
SIM,1943,15,45-49,1958,1
STAT,1879,16,20-24,1895,37.54309743712878
SIM,1899,43,30-34,1942,1
SIM,1932,31,20-24,1963,9
SIM,1909,23,45-49,1932,2
STAT,1850,37,40-44,1887,6.818179257052538
SIM,1854,32,45-49,1886,5
STAT,1813,53,15-19,1866,1.417608360569476E-4
SIM,1903,66,na,1969,5556
SIM,1912,33,45-49,1945,3
SIM,1871,24,45-49,1895,1
STAT,1837,91,na,1928,80.76508952580497
STAT,1833,45,40-44,1878,0.2709370638303995
SIM,1841,45,40-44,1886,1
STAT,1807,107,na,1914,0.003764309347368035
STAT,1843,49,50-100,1892,0.33685752112730477
STAT,1909,42,35-39,1951,0.3805915996606956
SIM,1849,69,na,1918,2294
STAT,1883,39,45-49,1922,3.9158110096512764
STAT,1782,84,na,1866,208.2029788961485
STAT,1907,28,na,1935,7059.129889930177
STAT,1903,14,na,1917,7402.12479224738
SIM,1795,63,na,1858,1772
STAT,1917,19,45-49,1936,1.0762181433667526
STAT,1863,24,45-49,1887,1.239372634137835
STAT,1879,28,15-19,1907,0.9550625361660924
STAT,1816,48,45-49,1864,1.141932307402592
STAT,1853,22,na,1875,3997.0965375501078
SIM,1920,30,na,1950,8590
STAT,1808,94,na,1902,15.705078340860458
STAT,1882,19,na,1901,4942.222079605422
STAT,1918,48,50-100,1966,0.484668078461608
STAT,1858,53,na,1911,3335.5567964338825
SIM,1879,83,na,1962,1047
STAT,1851,50,30-34,1901,0.009360142395162342
STAT,1929,23,20-24,1952,283.0828419145042
STAT,1935,15,45-49,1950,1.385869572810587
STAT,1833,23,20-24,1856,122.58652571021328
STAT,1875,40,15-19,1915,0.029005240605821728
STAT,1889,34,50-100,1923,2.262130074711713
STAT,1900,31,35-39,1931,28.488183340987412
SIM,1865,27,25-29,1892,87
SIM,1925,19,45-49,1944,1
SIM,1866,33,na,1899,4609
SIM,1924,44,na,1968,9237
SIM,1824,48,45-49,1872,1
STAT,1894,39,20-24,1933,1.9797599151597078
SIM,1930,28,40-44,1958,17
STAT,1946,15,20-24,1961,303.8326294432632
SIM,1836,19,na,1855,4033
SIM,1882,87,na,1969,731
STAT,1778,79,na,1857,559.8624222389349
SIM,1881,15,15-19,1896,11
SIM,1910,30,30-34,1940,35
STAT,1849,17,na,1866,4469.382161944109
SIM,1936,19,20-24,1955,228
STAT,1847,52,50-100,1899,0.022899196288429336
STAT,1928,19,20-24,1947,343.10765317291134
SIM,1848,35,25-29,1883,8
STAT,1873,15,15-19,1888,12.322765927256956
SIM,1907,15,35-39,1922,2
SIM,1795,95,na,1890,5
STAT,1835,31,30-34,1866,29.102920998638652
STAT,1908,61,na,1969,6185.432894430496
SIM,1841,23,20-24,1864,132
SIM,1926,20,40-44,1946,13
STAT,1811,98,na,1909,3.019728188549191
SIM,1899,30,25-29,1929,37
SIM,1873,48,40-44,1921,1
STAT,1915,36,25-29,1951,2.0186561456251897
STAT,1913,42,25-29,1955,0.14067600973490788
STAT,1859,35,35-39,1894,11.477623661063147
STAT,1879,31,na,1910,5061.628308856704
STAT,1910,41,45-49,1951,0.319613350085559
SIM,1929,29,30-34,1958,116
SIM,1874,68,na,1942,2816
STAT,1779,80,na,1859,415.86952965686885
STAT,1858,25,50-100,1883,1.0459744661353594
SIM,1843,31,30-34,1874,53
SIM,1893,22,30-34,1915,56
STAT,1847,19,50-100,1866,0.09211369563784498
STAT,1914,29,45-49,1943,3.492839572908832
STAT,1776,104,na,1880,0.06423372322422832
STAT,1869,42,40-44,1911,4.396277607287945
STAT,1856,103,na,1959,0.46292288936617887
SIM,1856,39,na,1895,3922
STAT,1861,57,na,1918,3378.2065795775425
SIM,1856,100,na,1956,2
STAT,1872,38,30-34,1910,10.764004331256482
SIM,1852,25,na,1877,4118
STAT,1839,39,na,1878,3914.311289726203
STAT,1885,22,30-34,1907,35.80796474485959
SIM,1837,20,na,1857,3795
SIM,1856,48,40-44,1904,1
SIM,1895,33,45-49,1928,9
SIM,1778,83,na,1861,242
SIM,1920,18,30-34,1938,36
STAT,1938,29,30-34,1967,78.33360080932813
SIM,1923,36,25-29,1959,6
SIM,1917,25,45-49,1942,5
STAT,1887,33,45-49,1920,3.922310495787995
STAT,1912,18,30-34,1930,4.966078786269367
SIM,1922,29,45-49,1951,4
STAT,1781,112,na,1893,3.711692632885935E-4
STAT,1830,49,50-100,1879,0.4131204459844567
SIM,1920,14,na,1934,9172
STAT,1918,23,45-49,1941,2.442870691314634
STAT,1900,65,na,1965,5213.347431571294
STAT,1904,33,45-49,1937,2.8902674638177275
SIM,1804,89,na,1893,41
SIM,1924,28,na,1952,9085
STAT,1866,88,na,1954,255.82518657748003
SIM,1845,55,na,1900,3396
STAT,1920,4,na,1924,9143.46464665227
SIM,1827,42,na,1869,3248
STAT,1904,19,35-39,1923,1.5820351109822284
SIM,1799,93,na,1892,11
STAT,1865,48,40-44,1913,0.31017275892011864
SIM,1878,33,45-49,1911,5
STAT,1860,43,35-39,1903,2.948430813033222
STAT,1917,41,30-34,1958,0.26981946554432557
SIM,1906,36,25-29,1942,3
STAT,1857,49,45-49,1906,0.36375362095745595
STAT,1858,69,na,1927,2310.5271979055547
SIM,1863,38,30-34,1901,10
STAT,1839,28,50-100,1867,1.2492716892342874
STAT,1862,74,na,1936,1915.7184123279228
STAT,1894,20,30-34,1914,46.48785849106557
STAT,1907,34,25-29,1941,17.3083737319847
STAT,1909,25,45-49,1934,3.387473369104503
SIM,1813,47,30-34,1860,1
STAT,1820,36,50-100,1856,6.509021585155016
SIM,1826,31,30-34,1857,40
SIM,1894,72,na,1966,3904
STAT,1835,25,na,1860,3704.2725565656833
STAT,1917,47,15-19,1964,7.77014258137011E-4
STAT,1839,19,30-34,1858,3.217360021291059
STAT,1887,50,na,1937,4933.586005651286
SIM,1905,29,45-49,1934,6
SIM,1847,19,30-34,1866,6
SIM,1889,36,25-29,1925,9
STAT,1878,14,na,1892,5429.653310032481
SIM,1828,42,45-49,1870,2
SIM,1886,32,40-44,1918,2
STAT,1851,3,na,1854,5325.0
STAT,1881,17,15-19,1898,11.584725447846973
STAT,1844,61,na,1905,3017.6857940848677
STAT,1878,32,40-44,1910,9.147439065015918
STAT,1848,75,na,1923,1688.016423899758
SIM,1872,17,15-19,1889,13
STAT,1919,45,na,1964,8083.822989915878
SIM,1861,61,na,1922,3568
STAT,1895,32,40-44,1927,11.412635623629356
SIM,1813,93,na,1906,16
SIM,1931,19,45-49,1950,5
STAT,1810,52,35-39,1862,0.05321585148969066
SIM,1932,34,25-29,1966,29
SIM,1817,41,30-34,1858,3
SIM,1869,89,na,1958,249
SIM,1936,13,na,1949,6862
SIM,1927,16,15-19,1943,98
STAT,1878,73,na,1951,2505.327490817714
STAT,1871,46,15-19,1917,8.048840773073243E-4
STAT,1913,31,45-49,1944,3.1756151923053144
STAT,1876,32,30-34,1908,36.47090061486746
SIM,1884,32,30-34,1916,42
STAT,1859,23,40-44,1882,3.450473916746283
STAT,1938,16,25-29,1954,86.56017520371559
STAT,1923,19,45-49,1942,1.177938181078059
SIM,1946,16,25-29,1962,116
SIM,1836,41,40-44,1877,8
STAT,1924,34,25-29,1958,21.74387890190459
SIM,1861,38,20-24,1899,2
SIM,1857,56,na,1913,3631
STAT,1848,34,20-24,1882,4.606899966250171
STAT,1853,38,20-24,1891,1.2135888267128092
SIM,1819,43,50-100,1862,3
STAT,1901,32,50-100,1933,2.590564270026087
STAT,1919,16,15-19,1935,20.367067143324377
STAT,1924,45,50-100,1969,0.5462343469360643
STAT,1904,37,50-100,1941,0.7681587466247964
SIM,1815,47,40-44,1862,1
SIM,1902,31,35-39,1933,44
SIM,1869,43,45-49,1912,7
STAT,1895,31,50-100,1926,2.4210735574035316
STAT,1874,38,40-44,1912,9.007403479832389
SIM,1900,20,20-24,1920,210
STAT,1833,107,na,1940,0.006199723936495595
STAT,1831,42,50-100,1873,1.6728346138415662
STAT,1898,36,50-100,1934,3.3716790274123354
STAT,1865,52,25-29,1917,0.006464327936736949
SIM,1856,34,20-24,1890,4
STAT,1828,41,40-44,1869,4.304162388456361
STAT,1933,24,25-29,1957,247.30852241665193
SIM,1909,39,30-34,1948,2
SIM,1802,82,na,1884,363
SIM,1886,53,na,1939,4354
SIM,1901,18,20-24,1919,54
STAT,1899,51,na,1950,5986.784946198872
STAT,1858,19,40-44,1877,0.33243154747511966
STAT,1892,15,25-29,1907,14.393732396665042
SIM,1867,23,40-44,1890,5
STAT,1904,44,25-29,1948,0.12751783284551613
SIM,1833,24,25-29,1857,109
STAT,1864,17,15-19,1881,11.08308592427717
STAT,1833,41,50-100,1874,1.7075745695217845
STAT,1952,15,na,1967,8912.337749295266
STAT,1767,95,na,1862,4.056152855947493
SIM,1817,44,50-100,1861,4
SIM,1941,24,25-29,1965,197
STAT,1836,46,50-100,1882,0.3462227581616741
STAT,1922,46,50-100,1968,0.5259353565341023
STAT,1930,31,45-49,1961,4.103692278760809
STAT,1770,99,na,1869,0.576790896193435
SIM,1882,38,40-44,1920,14
STAT,1841,37,na,1878,3661.3751500782337
SIM,1870,23,50-100,1893,1
STAT,1815,80,na,1895,574.9850711792687
STAT,1894,36,na,1930,6141.75868474208
SIM,1877,17,na,1894,5249
SIM,1854,48,30-34,1902,1
SIM,1865,75,na,1940,1854
STAT,1803,79,na,1882,601.1638236532197
STAT,1807,47,40-44,1854,1.1787202303097781
STAT,1824,51,25-29,1875,0.008427701378108539
SIM,1850,35,40-44,1885,15
STAT,1883,36,na,1919,4697.403327727774
STAT,1921,27,na,1948,8430.058750235092
STAT,1841,47,40-44,1888,0.24952528624523967
STAT,1887,25,45-49,1912,2.5249592772775715
STAT,1915,42,35-39,1957,0.40947182555753203
STAT,1855,27,15-19,1882,0.7131160883058447
SIM,1857,16,35-39,1873,1
SIM,1891,22,20-24,1913,174
STAT,1839,44,20-24,1883,0.2547432097363266
SIM,1903,29,35-39,1932,34
SIM,1863,68,na,1931,2689
SIM,1878,49,30-34,1927,1
STAT,1868,33,35-39,1901,19.377305827966797
STAT,1825,38,45-49,1863,5.047325042173937
STAT,1844,48,20-24,1892,0.019135471626661304
STAT,1939,16,50-100,1955,0.7576981692245364
STAT,1888,18,15-19,1906,14.129043865524395
SIM,1876,33,35-39,1909,32
STAT,1865,23,na,1888,4360.631295810898
SIM,1862,34,45-49,1896,4
SIM,1915,22,30-34,1937,97
STAT,1784,110,na,1894,4.998415900474827E-4
STAT,1926,16,50-100,1942,0.929825144156931
STAT,1854,34,45-49,1888,2.6813105935821615
STAT,1890,54,na,1944,5162.0719910543685
STAT,1791,77,na,1868,682.3824282812411
SIM,1890,31,50-100,1921,5
SIM,1804,57,na,1861,2145
STAT,1892,29,45-49,1921,2.7871114261491816
STAT,1847,85,na,1932,417.8745805046578
STAT,1877,39,20-24,1916,1.6003217877810945
STAT,1849,16,35-39,1865,1.0747039994814995
SIM,1904,31,45-49,1935,5
SIM,1824,31,20-24,1855,1
SIM,1920,40,40-44,1960,1
STAT,1853,105,na,1958,0.08548363638508293
STAT,1904,41,45-49,1945,0.30262848977223467
SIM,1947,16,50-100,1963,1
SIM,1844,54,na,1898,3003
STAT,1937,26,na,1963,7379.875100236732
STAT,1842,35,40-44,1877,7.805704916709764
STAT,1883,22,20-24,1905,136.74122677941435
STAT,1902,33,35-39,1935,28.753915085300715
STAT,1880,49,20-24,1929,0.0249978119060849
STAT,1875,19,40-44,1894,0.3782801854482433
SIM,1918,32,na,1950,8304
SIM,1879,67,na,1946,3163
SIM,1902,23,35-39,1925,26
SIM,1844,38,20-24,1882,2
STAT,1912,40,40-44,1952,0.49286240618672805
STAT,1931,18,40-44,1949,3.687925404065753
STAT,1894,15,35-39,1909,1.4301833631146228
STAT,1919,29,20-24,1948,39.540395027247925
SIM,1875,53,na,1928,4805
STAT,1895,21,na,1916,6242.724764172305
STAT,1899,35,na,1934,6581.2302444373845
SIM,1921,34,25-29,1955,31
STAT,1933,12,na,1945,10713.335577243766
STAT,1779,102,na,1881,0.1455196644825215
STAT,1840,95,na,1935,19.191316508199996
SIM,1874,21,50-100,1895,1
STAT,1778,95,na,1873,5.27726053609119
SIM,1833,38,45-49,1871,7
SIM,1934,16,50-100,1950,1
STAT,1920,24,15-19,1944,11.874328846216999
STAT,1882,31,50-100,1913,1.8099850949064984
SIM,1865,16,na,1881,4933
SIM,1908,32,40-44,1940,9
STAT,1894,38,50-100,1932,3.169453064565034
SIM,1856,37,25-29,1893,7
SIM,1927,29,20-24,1956,46
SIM,1910,52,na,1962,7030
STAT,1910,18,20-24,1928,54.13245675984438
STAT,1913,34,25-29,1947,18.41749739104474
STAT,1930,31,20-24,1961,6.361039184688431
SIM,1837,36,na,1873,3519
STAT,1883,36,40-44,1919,8.727969247169014
SIM,1854,24,45-49,1878,1
SIM,1846,15,20-24,1861,33
STAT,1836,38,20-24,1874,1.2453064294530616
STAT,1812,50,50-100,1862,0.10422248668390761
SIM,1861,21,50-100,1882,1
STAT,1917,16,40-44,1933,0.6093308958415604
STAT,1842,54,na,1896,3117.5133394063287
STAT,1856,54,50-100,1910,0.022886490822891997
SIM,1913,36,40-44,1949,4
STAT,1848,37,25-29,1885,4.86512505291991
SIM,1835,77,na,1912,1016
SIM,1910,33,35-39,1943,25
SIM,1819,41,40-44,1860,14
SIM,1906,15,na,1921,7456
STAT,1922,32,25-29,1954,21.08525763543346
SIM,1822,37,30-34,1859,10
STAT,1908,45,na,1953,6813.283653755248
SIM,1784,95,na,1879,1
STAT,1905,28,40-44,1933,8.718587277594434
SIM,1854,91,na,1945,97
STAT,1923,41,30-34,1964,0.3021207683661838
STAT,1799,57,na,1856,2123.178867621715
SIM,1835,24,35-39,1859,13
SIM,1948,21,30-34,1969,83
STAT,1852,80,na,1932,985.9250977115538
SIM,1885,20,30-34,1905,44
STAT,1840,44,50-100,1884,1.5504774537516992
STAT,1854,46,15-19,1900,6.149353685206331E-4
STAT,1856,19,30-34,1875,2.9022316996073187
SIM,1885,39,20-24,1924,3
SIM,1930,32,25-29,1962,35
STAT,1905,36,40-44,1941,2.7729690573945773
SIM,1841,37,40-44,1878,12
SIM,1925,16,40-44,1941,4
STAT,1825,50,50-100,1875,0.03285051427425541
STAT,1869,53,na,1922,4145.964809922603
STAT,1833,37,40-44,1870,7.208489231347206
STAT,1928,42,45-49,1970,0.42843332234551057
SIM,1926,23,45-49,1949,4
STAT,1881,28,30-34,1909,48.98408193128769
SIM,1870,22,na,1892,4584
SIM,1896,18,15-19,1914,18
SIM,1907,39,20-24,1946,3
STAT,1881,20,50-100,1901,0.8007896498774102
SIM,1891,36,40-44,1927,18
STAT,1792,78,na,1870,618.8168918236977
STAT,1864,22,na,1886,4338.304117391632
STAT,1846,24,45-49,1870,1.2990234029651049
SIM,1851,9,na,1860,4805
SIM,1807,48,45-49,1855,1
STAT,1891,42,25-29,1933,1.6010956802565508
STAT,1913,39,50-100,1952,0.828590415606288
SIM,1874,39,45-49,1913,7
STAT,1907,22,30-34,1929,52.87331113218221
SIM,1859,54,50-100,1913,1
SIM,1840,56,na,1896,3161
STAT,1803,63,na,1866,1831.5601865842107
STAT,1874,24,20-24,1898,141.61305971743502
STAT,1896,28,15-19,1924,1.2055069217534407
STAT,1816,45,40-44,1861,0.8673615312854059
STAT,1924,17,50-100,1941,0.9008128601419686
SIM,1935,12,na,1947,11254
STAT,1856,9,na,1865,4488.953202501122
STAT,1911,39,20-24,1950,0.5091930969706405
SIM,1829,27,15-19,1856,1
STAT,1853,21,50-100,1874,0.7678519144193734
STAT,1921,33,45-49,1954,3.520867598002388
STAT,1921,19,35-39,1940,9.605802459057047
SIM,1826,46,50-100,1872,1
STAT,1827,44,50-100,1871,1.9355748676708109
STAT,1829,37,15-19,1866,0.09815065660933185
SIM,1816,42,na,1858,2994
STAT,1866,39,45-49,1905,3.677434019259793
STAT,1850,89,na,1939,161.07538873340604
STAT,1888,26,15-19,1914,1.0867341419325973
STAT,1917,44,35-39,1961,0.42296194384820707
SIM,1905,26,40-44,1931,15
SIM,1841,26,25-29,1867,86
SIM,1878,30,40-44,1908,13
STAT,1863,1,na,1864,6404.070671894069
STAT,1850,49,35-39,1899,0.21017587704283183
STAT,1835,41,na,1876,3304.614187698055
STAT,1918,20,40-44,1938,7.366358479080551
STAT,1829,48,30-34,1877,0.15075050925426772
STAT,1887,34,na,1921,5344.033334187227
STAT,1868,16,45-49,1884,0.12854869421153833
STAT,1898,66,na,1964,4920.95724679063
SIM,1811,43,na,1854,2756
SIM,1899,28,na,1927,6606
SIM,1906,33,20-24,1939,3
STAT,1896,42,50-100,1938,0.1953741764487672
STAT,1822,47,30-34,1869,0.3009414140193609
SIM,1897,49,40-44,1946,1
STAT,1904,16,30-34,1920,4.631559980548081
SIM,1815,57,na,1872,2175
SIM,1961,4,na,1965,10517
STAT,1903,37,20-24,1940,0.4784388318941142
SIM,1881,22,na,1903,4058
STAT,1889,49,40-44,1938,0.23546328837589145
STAT,1932,33,20-24,1965,6.5450836833370865
SIM,1923,27,na,1950,9024
STAT,1900,39,45-49,1939,1.1933408957158507
SIM,1915,51,na,1966,7443
SIM,1885,36,na,1921,4987
STAT,1883,20,na,1903,4720.903508874387
STAT,1857,46,40-44,1903,0.27026768244205884
SIM,1852,41,na,1893,3783
STAT,1925,18,40-44,1943,3.4027981634395372
SIM,1918,18,15-19,1936,97
STAT,1952,20,40-44,1972,8.169592694162617
SIM,1801,65,na,1866,1659
STAT,1839,55,na,1894,3228.586573942862
STAT,1935,35,15-19,1970,0.054335636496851594
SIM,1921,39,50-100,1960,3
STAT,1885,49,20-24,1934,0.023619873656829795
SIM,1770,87,na,1857,60
SIM,1859,15,30-34,1874,4
STAT,1772,107,na,1879,0.01296026098899573
SIM,1960,11,na,1971,10817
STAT,1880,44,15-19,1924,0.028984826780230025
SIM,1866,92,na,1958,91
STAT,1896,39,30-34,1935,14.067910309869102
STAT,1926,22,40-44,1948,8.248467672151277
SIM,1912,16,30-34,1928,4
STAT,1833,26,25-29,1859,74.12125726095617
STAT,1851,28,45-49,1879,2.000784445445413
STAT,1869,45,45-49,1914,0.46644205431339686
SIM,1896,26,15-19,1922,2
SIM,1898,17,35-39,1915,1
SIM,1933,29,20-24,1962,55
SIM,1936,20,50-100,1956,1
STAT,1893,19,na,1912,6430.571919216503
STAT,1906,41,50-100,1947,0.21687772145517464
SIM,1869,35,45-49,1904,6
STAT,1852,49,45-49,1901,0.3682857150931215
STAT,1945,19,20-24,1964,298.88061491957404
SIM,1892,49,na,1941,6281
SIM,1796,80,na,1876,417
SIM,1839,42,20-24,1881,4
SIM,1806,96,na,1902,1
SIM,1924,15,35-39,1939,13
STAT,1871,48,50-100,1919,0.48660803744056935
STAT,1837,104,na,1941,0.09296355035318268
STAT,1849,33,na,1882,3936.464376373251
SIM,1895,14,na,1909,7195
STAT,1840,16,15-19,1856,11.156569896056807
STAT,1853,22,35-39,1875,10.90906605927937
SIM,1925,44,35-39,1969,2
SIM,1848,27,25-29,1875,93
SIM,1917,34,35-39,1951,26
STAT,1904,30,40-44,1934,12.672059930559488
STAT,1898,33,20-24,1931,7.356520611163347
STAT,1913,38,40-44,1951,2.96956353173009
STAT,1823,46,50-100,1869,0.7697492885784349
STAT,1857,68,na,1925,2405.6838913559604
SIM,1876,25,35-39,1901,28
STAT,1891,28,50-100,1919,1.591295478848585
SIM,1841,48,45-49,1889,2
SIM,1861,22,35-39,1883,15
STAT,1868,30,30-34,1898,33.81898186037955
STAT,1924,31,20-24,1955,5.749028919441375
STAT,1928,20,50-100,1948,1.6688489707213787
STAT,1853,54,na,1907,3313.061816129295
SIM,1947,13,na,1960,9313
SIM,1921,38,40-44,1959,8
SIM,1913,28,40-44,1941,13
STAT,1850,41,25-29,1891,0.9890550459654741
STAT,1852,37,na,1889,3775.355236225941
STAT,1817,49,50-100,1866,1.149712446212098
STAT,1916,15,35-39,1931,1.8063565953953775
STAT,1873,42,na,1915,4736.954544808438
STAT,1946,23,20-24,1969,249.8023455090526
STAT,1828,44,45-49,1872,2.7287063593384335
SIM,1902,17,na,1919,7412
STAT,1904,41,20-24,1945,0.03211282757785517
SIM,1930,26,15-19,1956,2
STAT,1925,29,20-24,1954,43.22294747343017
SIM,1897,38,25-29,1935,3
STAT,1833,48,45-49,1881,0.32705745089855487
STAT,1902,43,50-100,1945,0.2076699121427781
STAT,1879,15,na,1894,5360.073660593212
STAT,1806,53,50-100,1859,0.08637849145314616
STAT,1914,38,35-39,1952,4.853967742703816
STAT,1906,43,20-24,1949,0.03222122706446468
SIM,1874,25,25-29,1899,100
SIM,1888,16,15-19,1904,14
STAT,1878,40,40-44,1918,4.792271760292643
SIM,1925,45,na,1970,9010
STAT,1911,47,20-24,1958,0.02113564899337621
STAT,1880,32,50-100,1912,1.9493793132218848
STAT,1889,30,15-19,1919,0.35747882042413864
SIM,1807,81,na,1888,432
SIM,1835,32,35-39,1867,33
STAT,1921,35,50-100,1956,0.9482109435215259
SIM,1905,15,25-29,1920,16
STAT,1902,36,15-19,1938,0.03472598978988604
SIM,1865,46,40-44,1911,2
SIM,1933,18,40-44,1951,2
SIM,1849,85,na,1934,332
STAT,1929,35,15-19,1964,0.049872806942709964
SIM,1845,71,na,1916,2091
STAT,1832,53,25-29,1885,0.004709046880855037
SIM,1846,56,na,1902,3214
SIM,1912,30,40-44,1942,3
SIM,1931,14,na,1945,10495
SIM,1860,76,na,1936,1599
STAT,1841,69,na,1910,2129.302541968225
STAT,1820,75,na,1895,1152.4904016220341
SIM,1935,28,na,1963,10554
STAT,1893,27,50-100,1920,1.6375345043631326
STAT,1933,28,40-44,1961,12.494565234246014
SIM,1887,16,20-24,1903,39
SIM,1836,44,45-49,1880,6
SIM,1895,25,45-49,1920,4
STAT,1849,92,na,1941,65.88096995420722
STAT,1909,45,15-19,1954,6.905720920891499E-4
STAT,1840,27,30-34,1867,45.32136069923579
STAT,1869,69,na,1938,2871.8936715834107
STAT,1935,32,35-39,1967,25.538537754910863
STAT,1821,92,na,1913,46.16613134620578
STAT,1914,16,15-19,1930,19.00974586308171
SIM,1889,20,15-19,1909,7
STAT,1931,26,40-44,1957,12.159199673917986
STAT,1922,26,15-19,1948,1.6184281305976589
SIM,1923,42,35-39,1965,1
STAT,1894,23,35-39,1917,15.092769685932344
STAT,1889,38,25-29,1927,7.1343088398088375
STAT,1871,35,na,1906,4772.199346487677
STAT,1860,51,35-39,1911,0.014187126969637955
SIM,1840,40,na,1880,3884
SIM,1863,52,50-100,1915,1
STAT,1872,22,45-49,1894,1.4153818442160817
STAT,1950,21,20-24,1971,266.4813766298236
SIM,1860,41,35-39,1901,7
STAT,1864,17,50-100,1881,0.09149491206562828
STAT,1827,32,35-39,1859,24.997030061102713
STAT,1875,49,na,1924,4580.532503039489
STAT,1895,35,45-49,1930,5.295943557034856
SIM,1889,28,25-29,1917,112
SIM,1922,16,15-19,1938,95
STAT,1796,76,na,1872,768.4839346570559
SIM,1931,16,40-44,1947,4
STAT,1866,25,25-29,1891,79.36263391390415
SIM,1922,38,35-39,1960,10
STAT,1923,16,40-44,1939,3.3241549748657993
SIM,1828,34,45-49,1862,5
SIM,1928,25,20-24,1953,49
STAT,1848,48,40-44,1896,0.27719064988487757
STAT,1792,62,na,1854,1780.0000000000002
STAT,1842,21,20-24,1863,130.34205163725233
STAT,1923,34,na,1957,8742.473500880795
SIM,1850,21,20-24,1871,130
SIM,1894,56,na,1950,5464
STAT,1831,49,25-29,1880,0.08591371105881221
SIM,1886,40,40-44,1926,2
SIM,1897,21,na,1918,6944
SIM,1890,42,na,1932,6090
STAT,1867,32,50-100,1899,1.7330093776983035
STAT,1943,27,na,1970,8057.398151845724
STAT,1804,104,na,1908,0.044870377666099116
STAT,1814,49,25-29,1863,0.28925703823553484
SIM,1884,34,50-100,1918,3
STAT,1891,39,na,1930,5822.22535283872
STAT,1902,29,na,1931,6756.168681507533
SIM,1824,34,25-29,1858,26
SIM,1805,74,na,1879,886
SIM,1922,18,40-44,1940,2
SIM,1925,19,20-24,1944,300
SIM,1809,88,na,1897,119
STAT,1870,38,20-24,1908,1.5208790173727083
STAT,1875,29,45-49,1904,2.2922097593482667
SIM,1934,30,40-44,1964,14
SIM,1895,22,40-44,1917,8
STAT,1890,18,30-34,1908,3.91884238096185
SIM,1818,38,na,1856,3217
SIM,1847,15,15-19,1862,8
STAT,1914,15,25-29,1929,18.19150616535841
SIM,1876,47,50-100,1923,4
STAT,1883,25,25-29,1908,84.50704322834922
STAT,1944,22,35-39,1966,20.5310848749126
SIM,1828,31,40-44,1859,9
STAT,1783,85,na,1868,149.11913774757522
STAT,1913,31,20-24,1944,4.9224482006837595
STAT,1839,47,25-29,1886,0.09163546788572449
STAT,1847,69,na,1916,2237.0377785433634
STAT,1880,87,na,1967,852.4253953695061
STAT,1917,19,20-24,1936,292.085662837326
STAT,1931,22,25-29,1953,241.96148478329724
SIM,1816,38,45-49,1854,6
STAT,1872,57,na,1929,4079.029448448263
STAT,1869,50,40-44,1919,0.020898032536157986
SIM,1914,46,25-29,1960,1
SIM,1918,43,50-100,1961,1
STAT,1926,31,30-34,1957,38.49097919087767
STAT,1937,32,45-49,1969,3.144813390447663
SIM,1884,35,35-39,1919,17
SIM,1904,46,40-44,1950,1
SIM,1883,29,45-49,1912,4
STAT,1863,48,30-34,1911,0.16898249560456685
SIM,1836,41,50-100,1877,5
SIM,1882,27,25-29,1909,90
SIM,1846,22,45-49,1868,3
SIM,1937,30,na,1967,7698
STAT,1867,52,35-39,1919,0.016196701499858305
SIM,1891,28,40-44,1919,10
STAT,1921,41,45-49,1962,0.3790385580435929
STAT,1838,92,na,1930,56.36694664222742
SIM,1831,24,15-19,1855,8
SIM,1932,32,35-39,1964,7
STAT,1878,46,na,1924,4759.064290909549
SIM,1817,44,35-39,1861,5
STAT,1768,109,na,1877,0.005483245144120046
SIM,1867,26,45-49,1893,3
STAT,1902,31,45-49,1933,4.99256044275026
SIM,1904,51,na,1955,6376
STAT,1865,44,25-29,1909,1.1623329552156711
STAT,1882,41,20-24,1923,0.31386198524505377
SIM,1891,25,25-29,1916,125
SIM,1908,16,40-44,1924,1
STAT,1920,29,20-24,1949,40.14275494078521
SIM,1940,1,na,1941,8557
STAT,1839,15,15-19,1854,12.265831544306753
STAT,1866,16,35-39,1882,1.0557400920259512
STAT,1874,42,25-29,1916,1.3262911466761491
STAT,1781,99,na,1880,0.6941790746654809
SIM,1868,39,20-24,1907,2
STAT,1838,22,45-49,1860,1.2244305217600262
STAT,1876,35,35-39,1911,14.914654553402833
SIM,1853,10,na,1863,4850
STAT,1838,17,na,1855,4103.4372587672
STAT,1919,27,30-34,1946,85.48558380658154
SIM,1930,36,40-44,1966,5
STAT,1808,47,50-100,1855,1.5606041266819495
SIM,1882,42,25-29,1924,2
STAT,1913,36,15-19,1949,0.03846767684959985
SIM,1831,27,30-34,1858,49
SIM,1873,28,50-100,1901,2
STAT,1919,41,40-44,1960,0.5481032285937564
SIM,1918,29,30-34,1947,108
STAT,1807,51,25-29,1858,0.02354278672740513
SIM,1857,24,na,1881,4349
SIM,1927,27,30-34,1954,114
STAT,1907,38,40-44,1945,2.790732874111798
STAT,1883,28,40-44,1911,5.923094745364974
SIM,1873,44,25-29,1917,3
SIM,1885,68,na,1953,3139
SIM,1874,16,35-39,1890,1
SIM,1863,15,20-24,1878,46
SIM,1882,49,45-49,1931,2
SIM,1832,33,20-24,1865,3
SIM,1838,17,15-19,1855,11
SIM,1915,38,40-44,1953,8
SIM,1898,5,na,1903,7370
STAT,1822,48,20-24,1870,0.0367746173671486
STAT,1846,37,15-19,1883,0.08982116436453295
STAT,1846,109,na,1955,0.0010897494157253431
STAT,1906,41,30-34,1947,0.23601399151324629
SIM,1904,24,20-24,1928,181
STAT,1891,24,20-24,1915,170.95496622270832
STAT,1851,17,50-100,1868,0.09233687049600178
STAT,1924,32,35-39,1956,21.526364320267778
STAT,1822,93,na,1915,32.99790500543716
STAT,1929,27,15-19,1956,1.7841972190267053
SIM,1876,16,na,1892,5455
SIM,1827,74,na,1901,1230
SIM,1934,31,30-34,1965,51
STAT,1819,38,20-24,1857,4.190079029806733
STAT,1918,48,20-24,1966,0.023680851676753368
STAT,1901,50,na,1951,6175.453054144462
STAT,1836,105,na,1941,0.03898427071244184
STAT,1930,20,40-44,1950,8.751128536157431
SIM,1874,17,25-29,1891,14
STAT,1866,17,25-29,1883,10.838811449068848
SIM,1857,6,na,1863,5201
STAT,1879,23,45-49,1902,1.4685240586497907
SIM,1887,23,45-49,1910,1
STAT,1914,14,na,1928,8225.394593518427
STAT,1833,41,25-29,1874,1.0379374899591762
SIM,1848,26,35-39,1874,25
STAT,1886,29,20-24,1915,24.832023665788114
STAT,1937,28,25-29,1965,129.54460508762466
STAT,1830,26,na,1856,3932.4687263395604
SIM,1830,48,20-24,1878,1
SIM,1848,48,50-100,1896,1
STAT,1872,6,na,1878,5582.827676042043
STAT,1874,27,25-29,1901,87.47573475184926
STAT,1879,36,15-19,1915,0.11919617624277284
SIM,1909,36,50-100,1945,2
STAT,1905,64,na,1969,5700.974798383035
STAT,1918,28,na,1946,8021.956889684022
STAT,1824,33,20-24,1857,10.670403503712517
SIM,1872,28,30-34,1900,61
STAT,1896,20,40-44,1916,5.589479084656505
STAT,1768,96,na,1864,2.619213937189226
STAT,1874,49,45-49,1923,0.47783824535240266
SIM,1830,41,na,1871,3048
SIM,1865,35,25-29,1900,5
STAT,1879,90,na,1969,514.8032808879153
STAT,1890,15,15-19,1905,14.69756428012113
STAT,1797,98,na,1895,1.5718913226635922
SIM,1835,21,30-34,1856,44
STAT,1851,74,na,1925,1720.374961504053
STAT,1856,51,20-24,1907,0.0011553542935153443
SIM,1780,86,na,1866,113
STAT,1940,28,35-39,1968,30.907207544441516
STAT,1793,84,na,1877,215.38596987908073
STAT,1910,40,30-34,1950,0.24687642638052498
STAT,1855,88,na,1943,207.01464545421965
STAT,1829,40,na,1869,3166.2743253097724
SIM,1856,55,na,1911,3435
SIM,1869,32,40-44,1901,12
STAT,1848,91,na,1939,95.01745489502443
STAT,1907,25,35-39,1932,28.835829638744624
STAT,1951,19,50-100,1970,0.9003637899144359
SIM,1894,29,20-24,1923,35
SIM,1913,28,na,1941,7662
STAT,1855,15,20-24,1870,32.17468804744494
STAT,1913,23,45-49,1936,2.2881776239071785
SIM,1834,55,na,1889,2675
SIM,1902,20,30-34,1922,66
STAT,1905,32,25-29,1937,17.177998265345362
SIM,1827,38,20-24,1865,3
SIM,1830,35,50-100,1865,1
SIM,1841,41,25-29,1882,1
SIM,1937,27,15-19,1964,1
SIM,1859,30,30-34,1889,38
STAT,1811,48,45-49,1859,1.5747790625438578
STAT,1899,40,25-29,1939,0.12463928124472895
SIM,1915,25,35-39,1940,42
STAT,1851,95,na,1946,20.610512498177904
STAT,1855,38,30-34,1893,7.996791761992747
STAT,1914,18,40-44,1932,0.5829143631481707
SIM,1913,32,25-29,1945,24
SIM,1835,93,na,1928,47
STAT,1926,30,40-44,1956,9.565809096414295
SIM,1874,48,50-100,1922,2
SIM,1921,23,45-49,1944,3
STAT,1891,46,40-44,1937,0.24176272434626667
STAT,1905,21,45-49,1926,2.042872410896802
SIM,1890,48,40-44,1938,1
SIM,1855,16,25-29,1871,12
SIM,1875,32,50-100,1907,1
SIM,1777,82,na,1859,260
STAT,1826,51,35-39,1877,0.01688955996402972
SIM,1903,18,30-34,1921,9
STAT,1872,36,na,1908,4805.038433090994
SIM,1844,46,50-100,1890,2
STAT,1862,28,20-24,1890,20.179562793426154
STAT,1938,27,40-44,1965,9.327564187886681
SIM,1934,25,45-49,1959,7
SIM,1843,34,35-39,1877,23
STAT,1950,22,35-39,1972,22.558080669910293
SIM,1870,28,20-24,1898,24
STAT,1955,17,15-19,1972,121.65932002491229
SIM,1898,45,50-100,1943,1
SIM,1853,28,20-24,1881,21
STAT,1845,28,20-24,1873,21.845451041085077
STAT,1817,55,na,1872,2552.0357934901476
SIM,1937,26,25-29,1963,140
STAT,1805,59,na,1864,2256.8170405865903
STAT,1926,25,45-49,1951,4.210300296356459
STAT,1946,26,25-29,1972,148.13276724928505
STAT,1813,41,na,1854,2895.7282539784965
STAT,1836,51,40-44,1887,0.014449357084869628
STAT,1841,40,20-24,1881,0.24565665588813188
STAT,1835,34,35-39,1869,16.362672126827544
SIM,1845,43,50-100,1888,7
SIM,1909,20,40-44,1929,3
STAT,1930,31,na,1961,9863.136054123468
STAT,1922,49,na,1971,8471.529875331678
STAT,1892,40,15-19,1932,0.035267643888610395
STAT,1811,53,40-44,1864,0.06681630815242741
SIM,1815,89,na,1904,78
STAT,1850,23,20-24,1873,125.90983860522104
STAT,1928,42,20-24,1970,0.04546236020093077
SIM,1839,45,25-29,1884,2
SIM,1861,48,50-100,1909,1
STAT,1866,22,20-24,1888,129.4655733416437
SIM,1851,40,na,1891,3709
STAT,1937,3,na,1940,7970.777343325353
STAT,1842,24,25-29,1866,105.95960662797336
STAT,1900,40,25-29,1940,0.12619261581742203
SIM,1913,21,45-49,1934,2
SIM,1919,19,20-24,1938,288
STAT,1846,21,40-44,1867,3.9667076902141734
SIM,1854,21,40-44,1875,6
SIM,1895,7,na,1902,7292
SIM,1916,39,50-100,1955,3
STAT,1929,26,25-29,1955,166.42634648869208
SIM,1874,22,20-24,1896,133
SIM,1794,78,na,1872,596
SIM,1820,63,na,1883,1907
STAT,1823,56,na,1879,2673.1832573189145
STAT,1841,48,30-34,1889,0.13929069348946105
STAT,1936,16,15-19,1952,87.98518525510264
SIM,1848,23,30-34,1871,43
STAT,1861,4,na,1865,5149.909408088618
SIM,1906,47,na,1953,6593
SIM,1914,19,45-49,1933,1
STAT,1862,23,50-100,1885,0.7154296330341752
STAT,1841,96,na,1937,12.458637939037878
STAT,1911,20,30-34,1931,55.39558394563099
STAT,1865,28,50-100,1893,1.1695833073523954
SIM,1944,16,15-19,1960,95
STAT,1871,94,na,1965,127.38154286849309
STAT,1777,78,na,1855,515.72619
STAT,1815,50,20-24,1865,0.003953721136794247
SIM,1910,41,35-39,1951,3
STAT,1858,54,35-39,1912,0.013181527312285297
SIM,1790,64,na,1854,1679
SIM,1855,17,15-19,1872,14
SIM,1953,17,30-34,1970,35
SIM,1862,41,50-100,1903,5
SIM,1907,23,35-39,1930,23
SIM,1928,43,25-29,1971,2
STAT,1850,45,40-44,1895,0.26511275393468425
STAT,1906,46,25-29,1952,0.09589126107562575
STAT,1949,11,na,1960,9227.519744221321
SIM,1938,19,30-34,1957,38
SIM,1928,39,40-44,1967,4
SIM,1865,38,40-44,1903,13
STAT,1955,12,na,1967,10530.209497488855
SIM,1917,31,30-34,1948,48
SIM,1824,37,40-44,1861,9
STAT,1901,27,45-49,1928,3.1392366246401946
STAT,1866,21,50-100,1887,0.7716543730842335
SIM,1836,62,na,1898,2309
STAT,1847,17,15-19,1864,11.290653457408798
STAT,1945,17,30-34,1962,26.88863514641162
SIM,1834,37,50-100,1871,3
STAT,1922,39,45-49,1961,1.5628767758797062
SIM,1855,92,na,1947,37
SIM,1850,24,25-29,1874,114
SIM,1910,31,45-49,1941,7
STAT,1929,29,40-44,1958,11.768474695181197
STAT,1882,49,30-34,1931,0.1864676730420914
STAT,1819,53,50-100,1872,0.059648668699318036
STAT,1837,31,40-44,1868,7.659258919202199
STAT,1832,92,na,1924,54.299085053572966
STAT,1833,77,na,1910,1136.3539488323754
SIM,1930,39,45-49,1969,3
STAT,1950,22,50-100,1972,1.5763859755543654
SIM,1889,24,30-34,1913,56
STAT,1906,19,45-49,1925,0.19120954107492277
STAT,1848,52,25-29,1900,0.00577694594487118
STAT,1861,24,35-39,1885,9.933476058869505
SIM,1955,8,na,1963,10122
SIM,1911,21,na,1932,7440
STAT,1884,21,na,1905,4730.786264847474
STAT,1863,49,20-24,1912,0.02077185981729587
SIM,1930,21,45-49,1951,2
STAT,1949,19,40-44,1968,3.282995584484363
STAT,1888,35,na,1923,5677.2815253461595
STAT,1905,34,15-19,1939,0.23678887075219843
STAT,1808,78,na,1886,676.627398803808
SIM,1950,12,na,1962,9176
SIM,1917,7,na,1924,8890
STAT,1893,42,35-39,1935,4.629755435112659
SIM,1865,42,25-29,1907,2
SIM,1908,35,45-49,1943,1
SIM,1937,29,40-44,1966,17
STAT,1955,16,25-29,1971,116.20145227447038
SIM,1888,17,na,1905,5937
SIM,1876,91,na,1967,332
STAT,1878,8,na,1886,5603.389316274896
SIM,1858,34,50-100,1892,1
STAT,1872,27,15-19,1899,0.9208984243115288
STAT,1932,34,35-39,1966,24.504863381691187
SIM,1857,40,na,1897,4124
STAT,1857,84,na,1941,523.6773770815109
STAT,1892,72,na,1964,3718.5260312813807
STAT,1804,64,na,1868,1714.2965055222567
STAT,1902,41,35-39,1943,0.3601694946559246
STAT,1922,21,45-49,1943,2.6131058968831207
SIM,1868,40,na,1908,4518
STAT,1847,16,25-29,1863,10.844990775673438
STAT,1887,22,40-44,1909,4.706892136772971
STAT,1883,16,35-39,1899,1.0914630271903434
SIM,1919,38,25-29,1957,2
STAT,1882,48,40-44,1930,0.33258617690764286
STAT,1822,43,15-19,1865,0.04523880258294607
SIM,1875,0,na,1875,7404
STAT,1903,21,35-39,1924,16.830948184335135
STAT,1864,28,30-34,1892,45.30109947564933
SIM,1930,17,25-29,1947,135
SIM,1890,44,25-29,1934,3
STAT,1922,28,na,1950,8528.715144516602
SIM,1928,9,na,1937,10296
STAT,1911,38,30-34,1949,3.53866725559612
STAT,1820,47,20-24,1867,0.044654002955005496
SIM,1888,4,na,1892,6154
STAT,1919,44,45-49,1963,0.3629642052394705
SIM,1845,31,40-44,1876,7
STAT,1894,20,na,1914,6172.48469049046
STAT,1838,50,50-100,1888,0.021152812895215315
STAT,1869,32,na,1901,4669.866439743033
SIM,1914,44,35-39,1958,1
STAT,1927,26,15-19,1953,1.7389923265699057
STAT,1898,34,na,1932,6466.158720116741
STAT,1920,15,50-100,1935,0.1710719102180386
SIM,1934,27,na,1961,9987
STAT,1857,102,na,1959,0.9276537637224042
STAT,1844,21,30-34,1865,36.17509624688537
SIM,1864,69,na,1933,2707
SIM,1913,37,30-34,1950,7
SIM,1900,34,50-100,1934,7
STAT,1900,47,45-49,1947,0.37122372244618534
SIM,1841,41,na,1882,3489
SIM,1848,32,20-24,1880,6
SIM,1849,21,na,1870,4294
STAT,1780,113,na,1893,2.198248891433191E-4
STAT,1861,39,45-49,1900,3.3173408788265717
SIM,1863,22,45-49,1885,2
STAT,1849,39,45-49,1888,3.160335107099453
STAT,1909,46,50-100,1955,0.42101809868741163
STAT,1821,40,40-44,1861,7.571063847332869
SIM,1853,1,na,1854,6142
SIM,1896,17,25-29,1913,15
STAT,1884,25,50-100,1909,1.284374542194861
STAT,1906,44,35-39,1950,0.3650701112321196
STAT,1922,17,25-29,1939,101.26131831375612
STAT,1898,39,40-44,1937,2.5563555494089143
SIM,1932,3,na,1935,10998
STAT,1864,25,15-19,1889,0.8278281522474943
STAT,1947,19,30-34,1966,27.709450577314627
SIM,1919,45,50-100,1964,2
STAT,1917,40,40-44,1957,0.5285930648952197
STAT,1854,39,na,1893,3575.333047775633
SIM,1862,41,45-49,1903,7
SIM,1949,17,40-44,1966,3
STAT,1865,37,25-29,1902,5.282783337081224
SIM,1878,26,20-24,1904,30
SIM,1911,21,35-39,1932,18
STAT,1814,63,na,1877,1869.3389625668344
STAT,1906,16,40-44,1922,0.5395955045996514
STAT,1779,96,na,1875,2.638319135353459
SIM,1930,13,na,1943,10926
STAT,1802,78,na,1880,692.0518938102589
STAT,1900,25,25-29,1925,119.31672692501954
SIM,1917,46,50-100,1963,2
SIM,1939,20,15-19,1959,13
SIM,1860,44,na,1904,3954
SIM,1882,24,20-24,1906,134
STAT,1859,91,na,1950,93.1504887553305
SIM,1876,54,na,1930,4640
STAT,1937,22,50-100,1959,1.2943480571397095
STAT,1909,46,na,1955,6838.513369757664
STAT,1950,20,30-34,1970,68.90406756534956
STAT,1886,49,na,1935,4696.383403586254
STAT,1882,35,na,1917,4679.162153251518
STAT,1847,41,15-19,1888,0.02144125369595383
STAT,1811,93,na,1904,27.166885092453157
SIM,1871,87,na,1958,324
STAT,1923,28,35-39,1951,34.678942066270565
STAT,1952,15,45-49,1967,1.2095544120402109
SIM,1931,28,35-39,1959,46
SIM,1945,22,50-100,1967,3
SIM,1839,48,40-44,1887,1
SIM,1887,20,40-44,1907,9
STAT,1857,35,25-29,1892,4.575468341045044
STAT,1937,25,20-24,1962,35.975144577262526
SIM,1917,10,na,1927,8849
STAT,1927,29,30-34,1956,95.80190671687052
STAT,1885,16,45-49,1901,0.13164010043228574
STAT,1888,17,25-29,1905,13.526849864394197
SIM,1872,25,15-19,1897,3
STAT,1838,38,30-34,1876,8.61377771858586
STAT,1852,41,35-39,1893,2.8991524220739
STAT,1912,50,na,1962,7068.259793912519
SIM,1946,12,na,1958,8635
STAT,1852,54,40-44,1906,0.016317661986675027
SIM,1898,16,20-24,1914,44
STAT,1797,77,na,1874,679.5999073937749
STAT,1913,20,40-44,1933,6.621138853176648
STAT,1916,38,45-49,1954,1.4029313797043201
SIM,1877,31,50-100,1908,5
STAT,1831,29,30-34,1860,42.98425775990652
STAT,1792,99,na,1891,0.7096170164170154
STAT,1865,34,20-24,1899,4.917140422633707
STAT,1793,63,na,1856,1681.78888272
STAT,1856,54,25-29,1910,0.005367515725157824
SIM,1797,59,na,1856,2013
STAT,1830,96,na,1926,11.857170518131161
STAT,1877,72,na,1949,2648.4904106430554
STAT,1891,27,25-29,1918,105.60050965389766
STAT,1908,29,20-24,1937,34.624327235750734
STAT,1843,92,na,1935,58.34323687644587
STAT,1861,48,20-24,1909,0.01991863834329843
STAT,1865,41,20-24,1906,0.2927104150532323
SIM,1904,27,25-29,1931,131
STAT,1875,54,35-39,1929,0.017408987917963324
STAT,1869,31,50-100,1900,1.8003646306742631
SIM,1871,21,40-44,1892,7
STAT,1855,15,50-100,1870,0.08891308468582067
STAT,1820,49,25-29,1869,0.20821363839628565
SIM,1924,38,45-49,1962,2
SIM,1829,26,25-29,1855,76
STAT,1860,18,45-49,1878,0.12283243908979762
SIM,1850,18,na,1868,4460
STAT,1896,23,45-49,1919,1.853612565068627
SIM,1859,33,35-39,1892,23
STAT,1891,49,45-49,1940,0.3253887612417261
SIM,1916,29,20-24,1945,3
SIM,1852,21,30-34,1873,48
STAT,1827,92,na,1919,50.36390348455577
STAT,1941,23,20-24,1964,232.00946048811537
SIM,1849,16,25-29,1865,13
STAT,1829,32,45-49,1861,3.3449591197797575
STAT,1953,16,15-19,1969,110.89808502271698
SIM,1892,25,50-100,1917,2
SIM,1935,29,30-34,1964,139
SIM,1879,25,50-100,1904,2
STAT,1880,48,30-34,1928,0.2033613108165919
SIM,1908,19,45-49,1927,2
STAT,1842,27,40-44,1869,5.515257404801553
STAT,1863,21,40-44,1884,3.7845576512739783
STAT,1898,36,25-29,1934,7.906972883001374
SIM,1883,72,na,1955,2636
SIM,1893,25,35-39,1918,35
STAT,1867,31,15-19,1898,0.270454125730757
STAT,1910,29,50-100,1939,1.9280107384458518
STAT,1877,52,40-44,1929,0.021960613203040717
SIM,1857,39,45-49,1896,7
STAT,1931,24,15-19,1955,13.856776596992194
STAT,1941,31,na,1972,8024.612678055469
SIM,1915,31,20-24,1946,7
SIM,1830,78,na,1908,873
STAT,1931,28,30-34,1959,102.12002317269445
STAT,1897,49,na,1946,5948.054607922427
SIM,1837,32,45-49,1869,3
STAT,1905,37,30-34,1942,3.359898252375035
SIM,1832,36,25-29,1868,9
STAT,1849,17,25-29,1866,11.033505407175367
SIM,1934,34,35-39,1968,35
STAT,1813,78,na,1891,694.2928994495245
SIM,1857,17,25-29,1874,17
STAT,1824,36,25-29,1860,9.129040698281424
STAT,1926,34,35-39,1960,22.28399259709747
STAT,1789,95,na,1884,5.420085253944805
STAT,1893,35,na,1928,6088.291514120331
STAT,1868,68,na,1936,2936.471916094317
SIM,1859,24,45-49,1883,1
SIM,1937,23,20-24,1960,221
STAT,1885,25,35-39,1910,19.528800995866998
STAT,1911,34,15-19,1945,0.2506307469627506
STAT,1932,31,30-34,1963,42.32707322936515
STAT,1862,41,40-44,1903,3.900271054698677
STAT,1934,26,50-100,1960,2.705861477340738
SIM,1850,27,40-44,1877,7
SIM,1867,32,30-34,1899,11
SIM,1923,33,20-24,1956,8
STAT,1926,39,50-100,1965,1.033920869193086
STAT,1930,38,40-44,1968,3.9395251005338254
STAT,1917,42,45-49,1959,0.3507456645306069
SIM,1932,30,30-34,1962,59
STAT,1899,15,35-39,1914,1.5254087806209629
STAT,1953,19,30-34,1972,29.756119649204802
STAT,1932,36,25-29,1968,2.6744318507616494
STAT,1879,39,50-100,1918,2.5674752753546364
STAT,1932,27,na,1959,9910.371191007269
SIM,1869,20,35-39,1889,12
STAT,1942,28,45-49,1970,3.6603347728438878
SIM,1858,41,40-44,1899,9
SIM,1837,25,20-24,1862,21
SIM,1886,35,45-49,1921,10
STAT,1769,108,na,1877,0.006592863205717446
STAT,1861,73,na,1934,1996.6221889546391
STAT,1907,31,20-24,1938,4.626012499135594
STAT,1863,30,50-100,1893,1.6328515594980018
STAT,1865,87,na,1952,323.25848188129277
STAT,1833,49,35-39,1882,0.1915470161663781
SIM,1826,34,35-39,1860,26
SIM,1892,41,30-34,1933,6
STAT,1890,41,50-100,1931,2.6161025641209092
STAT,1862,58,na,1920,3413.731224673932
SIM,1941,21,20-24,1962,247
SIM,1963,1,na,1964,10488
STAT,1888,42,15-19,1930,0.0329243773968161
SIM,1816,74,na,1890,954
SIM,1929,27,40-44,1956,14
STAT,1850,26,25-29,1876,76.87864425315577
SIM,1833,21,20-24,1854,115
STAT,1901,9,na,1910,7335.985170317041
STAT,1918,32,35-39,1950,19.608703100628883
SIM,1902,39,20-24,1941,2
SIM,1903,15,15-19,1918,17
SIM,1940,31,30-34,1971,41
STAT,1887,38,15-19,1925,0.12621237882099665
SIM,1898,18,25-29,1916,16
SIM,1921,20,40-44,1941,2
STAT,1930,23,45-49,1953,2.9020954488729216
STAT,1781,78,na,1859,576.4897970991924
STAT,1931,27,30-34,1958,102.16906432356973
SIM,1819,44,45-49,1863,6
STAT,1851,36,na,1887,3729.834821848929
STAT,1801,106,na,1907,0.009624314644138196
STAT,1844,18,na,1862,4684.404338498828
STAT,1863,44,15-19,1907,0.024084858345581342
SIM,1945,25,20-24,1970,45
STAT,1874,46,40-44,1920,0.35503216384113573
SIM,1846,38,30-34,1884,18
STAT,1844,15,45-49,1859,0.13568989199740314
STAT,1869,52,45-49,1921,0.028248729452014964
STAT,1922,36,40-44,1958,3.4423795814579448
SIM,1846,40,na,1886,3672
STAT,1859,32,30-34,1891,28.066306888883332
SIM,1824,93,na,1917,53
STAT,1842,59,na,1901,2893.457414387386
STAT,1829,25,20-24,1854,66.79938365829393
SIM,1926,32,35-39,1958,32
SIM,1849,15,25-29,1864,18
SIM,1865,91,na,1956,73
SIM,1905,16,15-19,1921,14
SIM,1876,15,30-34,1891,5
STAT,1877,23,35-39,1900,12.200109710985394
STAT,1885,86,na,1971,1054.4716039800685
STAT,1841,43,25-29,1884,0.9558537837813187
STAT,1851,50,50-100,1901,0.02374846039579922
STAT,1896,16,20-24,1912,47.387958495580484
STAT,1915,33,20-24,1948,4.996356198654726
STAT,1834,53,35-39,1887,0.011519959048102074
STAT,1840,74,na,1914,1601.9136060748372
SIM,1925,42,45-49,1967,1
SIM,1866,17,na,1883,5057
SIM,1868,16,35-39,1884,1
STAT,1881,72,na,1953,2465.273497639794
STAT,1844,88,na,1932,221.70119547798822
STAT,1840,39,25-29,1879,4.814442207488785
STAT,1871,20,25-29,1891,115.5495245569306
SIM,1887,39,50-100,1926,3
STAT,1859,26,45-49,1885,1.8287380150976094
STAT,1897,71,na,1968,4293.322763126906
SIM,1913,38,30-34,1951,6
SIM,1885,23,35-39,1908,13
SIM,1846,18,na,1864,4430
SIM,1910,4,na,1914,8425
STAT,1880,31,45-49,1911,3.7252708909152332
STAT,1895,40,40-44,1935,5.978990515367115
STAT,1850,48,45-49,1898,0.3573049859312501
STAT,1849,15,20-24,1864,34.92890626550635
SIM,1925,13,na,1938,9668
SIM,1842,28,45-49,1870,4
STAT,1859,54,na,1913,3366.013231816147
STAT,1952,16,50-100,1968,0.9069390175779005
STAT,1815,53,25-29,1868,0.017873081175351836
STAT,1863,21,na,1884,4295.337765375812
STAT,1877,20,30-34,1897,37.57805794574596
STAT,1855,22,45-49,1877,1.2284306427589786
STAT,1878,35,45-49,1913,4.24479695815734
STAT,1911,23,35-39,1934,17.984755960953187
STAT,1842,22,na,1864,4015.048158528771
SIM,1889,27,35-39,1916,30
SIM,1889,38,50-100,1927,6
STAT,1933,21,20-24,1954,298.812952114517
STAT,1905,48,50-100,1953,0.39955726746236936
STAT,1868,15,30-34,1883,3.1551727439238806
STAT,1904,48,40-44,1952,0.2764169741664708
STAT,1924,38,40-44,1962,3.5604942957042165
STAT,1845,110,na,1955,4.258192178125592E-4
SIM,1922,15,25-29,1937,135
STAT,1857,38,40-44,1895,6.856871887258498
STAT,1924,30,30-34,1954,37.28052323626838
SIM,1897,53,na,1950,5779
SIM,1932,38,40-44,1970,10
SIM,1905,38,35-39,1943,14
STAT,1832,30,15-19,1862,0.2472970379093594
STAT,1834,52,50-100,1886,0.02061353086616334
STAT,1836,22,35-39,1858,10.241976167206584
STAT,1905,38,30-34,1943,3.343233157043256
STAT,1858,51,30-34,1909,0.009416643511864699
STAT,1831,26,15-19,1857,0.8008338028274302
SIM,1889,33,20-24,1922,10
STAT,1842,81,na,1923,805.0979834288164
STAT,1909,22,40-44,1931,6.3147441259952855
SIM,1844,22,35-39,1866,15
STAT,1882,44,25-29,1926,1.246324387785778
SIM,1870,41,40-44,1911,2
STAT,1935,23,50-100,1958,1.8093702375236107
STAT,1854,18,50-100,1872,0.08931304412516844
SIM,1907,32,na,1939,7194
STAT,1860,52,25-29,1912,0.005778269210304354
STAT,1879,16,45-49,1895,0.13833120813782193
STAT,1944,12,na,1956,8536.98156816137
SIM,1868,27,15-19,1895,1
STAT,1787,99,na,1886,0.7006338026691367
STAT,1879,39,30-34,1918,11.14529817842777
SIM,1900,23,25-29,1923,175
SIM,1916,18,40-44,1934,1
STAT,1912,27,20-24,1939,36.339673428167615
SIM,1867,35,35-39,1902,23
STAT,1933,15,35-39,1948,11.398403770153912
SIM,1831,63,na,1894,2370
STAT,1838,35,15-19,1873,0.09362992617788375
STAT,1934,19,20-24,1953,368.4242007779443
SIM,1935,36,50-100,1971,1
STAT,1812,56,na,1868,2484.565804585263
SIM,1783,78,na,1861,631
SIM,1942,19,20-24,1961,271
STAT,1861,20,40-44,1881,3.650904441244143
SIM,1921,31,20-24,1952,7
SIM,1913,48,50-100,1961,1
SIM,1917,22,40-44,1939,6
STAT,1807,93,na,1900,23.327926473149777
SIM,1857,15,20-24,1872,41
SIM,1887,39,30-34,1926,18
SIM,1910,36,na,1946,7587
SIM,1821,40,45-49,1861,2
SIM,1825,78,na,1903,779
STAT,1834,28,45-49,1862,1.9241092783392464
STAT,1925,42,40-44,1967,0.6114635949722278
STAT,1908,18,40-44,1926,0.5468865978947144
SIM,1920,27,20-24,1947,47
STAT,1809,73,na,1882,1153.0724841183082
SIM,1914,28,35-39,1942,46
STAT,1843,40,30-34,1883,1.7012036916302202
STAT,1889,30,na,1919,5990.236597917626
STAT,1843,22,50-100,1865,0.7170231480895252
SIM,1842,26,na,1868,3878
STAT,1822,77,na,1899,975.9707685496446
STAT,1852,46,40-44,1898,0.2736350127120134
SIM,1850,45,na,1895,3681
SIM,1947,22,15-19,1969,12
SIM,1853,30,25-29,1883,25
STAT,1910,17,45-49,1927,0.19998027062227963
STAT,1938,19,40-44,1957,2.785161219554688
STAT,1828,51,45-49,1879,0.025751365751872486
STAT,1928,43,20-24,1971,0.0453905296718133
STAT,1889,45,25-29,1934,0.14486742053982035
SIM,1835,40,na,1875,3520
SIM,1837,41,na,1878,3347
STAT,1829,44,15-19,1873,0.022038538018250994
STAT,1868,29,15-19,1897,0.8655704760168507
STAT,1921,49,50-100,1970,0.5118113368398276
STAT,1827,48,50-100,1875,0.43766783494209516
STAT,1941,25,35-39,1966,31.395462896135374
STAT,1861,31,35-39,1892,17.09325251106389
SIM,1857,36,40-44,1893,5
SIM,1860,37,50-100,1897,1
STAT,1909,38,15-19,1947,0.0365475139122127
STAT,1887,37,15-19,1924,0.1268415127241082
STAT,1835,30,40-44,1865,7.304155275465902
STAT,1894,5,na,1899,6798.976218227218
SIM,1791,70,na,1861,1103
STAT,1839,93,na,1932,45.63335813022825
SIM,1857,18,25-29,1875,10
SIM,1871,17,na,1888,4921
SIM,1900,22,35-39,1922,22
STAT,1759,97,na,1856,0.7495287047999999
STAT,1895,42,45-49,1937,0.2731680137767333
STAT,1834,62,na,1896,2428.9411244896205
SIM,1863,95,na,1958,44
SIM,1834,43,35-39,1877,5
SIM,1858,35,na,1893,4072
SIM,1851,40,30-34,1891,3
STAT,1842,28,40-44,1870,5.475657856635077
STAT,1870,34,40-44,1904,8.52533879294094
STAT,1901,19,45-49,1920,0.18370036622469937
STAT,1841,41,20-24,1882,0.24252944665867587
STAT,1780,98,na,1878,1.0716632413712923
STAT,1873,31,15-19,1904,0.29342276962107516
SIM,1810,80,na,1890,463
SIM,1898,65,na,1963,5052
SIM,1943,28,15-19,1971,2
STAT,1893,34,35-39,1927,25.702102589077395
STAT,1843,23,na,1866,3732.5045217072984
STAT,1913,49,45-49,1962,0.4260221535624813
STAT,1849,18,25-29,1867,10.968518060327106
STAT,1903,17,50-100,1920,0.14087920395826586
STAT,1894,34,50-100,1928,2.3567527233041137
STAT,1827,86,na,1913,268.300311522896
SIM,1851,62,na,1913,2806
STAT,1921,48,40-44,1969,0.35787334055623526
SIM,1850,28,40-44,1878,7
STAT,1880,47,30-34,1927,0.20498892286413306
STAT,1900,21,30-34,1921,50.05399166454044
SIM,1884,67,na,1951,3293
STAT,1947,17,40-44,1964,3.181904663581037
SIM,1913,2,na,1915,8594
STAT,1944,26,15-19,1970,1.541561352501235
STAT,1834,51,30-34,1885,0.008287060531448428
STAT,1835,41,35-39,1876,2.8476485840059933
STAT,1942,26,na,1968,7944.45084145853
SIM,1946,19,40-44,1965,8
SIM,1905,52,na,1957,6534
STAT,1935,28,15-19,1963,1.9429216768790123
STAT,1826,43,35-39,1869,3.7478348678327094
STAT,1877,35,na,1912,4987.780763692233
SIM,1808,76,na,1884,749
SIM,1805,51,50-100,1856,1
SIM,1899,20,20-24,1919,191
SIM,1874,32,25-29,1906,28
STAT,1844,47,45-49,1891,0.37934291041785856
STAT,1855,29,50-100,1884,0.9910629526442849
STAT,1921,17,20-24,1938,312.0322732749883
STAT,1917,43,45-49,1960,0.3501914863806484
STAT,1856,73,na,1929,1850.799165321748
STAT,1831,38,na,1869,3441.9870174103967
SIM,1922,27,30-34,1949,115
STAT,1854,60,na,1914,2923.6821787748104
STAT,1855,34,15-19,1889,0.2141570764156215
STAT,1857,42,25-29,1899,1.009637072251231
STAT,1913,27,25-29,1940,132.4876204691072
STAT,1934,35,45-49,1969,1.9035284213407149
STAT,1923,48,50-100,1971,0.5327163263407454
SIM,1880,22,50-100,1902,3
SIM,1939,16,30-34,1955,33
STAT,1833,33,25-29,1866,17.193199788549283
SIM,1843,30,40-44,1873,15
SIM,1904,32,20-24,1936,8
STAT,1817,50,30-34,1867,0.028677379895000975
STAT,1845,21,50-100,1866,0.7857332859566044
STAT,1822,55,na,1877,2567.1899043799554
STAT,1850,30,20-24,1880,4.864353784608751
SIM,1811,43,40-44,1854,12
SIM,1921,27,25-29,1948,160
STAT,1879,20,40-44,1899,4.428263309077209
STAT,1864,60,na,1924,3443.049566579022
SIM,1884,57,na,1941,4294
STAT,1831,25,15-19,1856,0.8129731617894956
SIM,1925,43,45-49,1968,1
SIM,1816,47,50-100,1863,2
STAT,1806,108,na,1914,0.0012472491877402922
STAT,1914,27,30-34,1941,79.78857297835967
STAT,1826,30,15-19,1856,0.4959235809265834
SIM,1867,1,na,1868,6556
STAT,1938,19,50-100,1957,0.7460251452517331
STAT,1881,34,50-100,1915,1.7732726306058095
STAT,1917,49,na,1966,7703.810497495729
STAT,1930,24,20-24,1954,285.8862718543127
STAT,1864,29,30-34,1893,45.136203473557956
STAT,1914,23,50-100,1937,1.353709581539641
SIM,1896,52,na,1948,5975
SIM,1866,38,na,1904,4540
STAT,1932,18,35-39,1950,11.193102434643636
STAT,1878,20,35-39,1898,12.382223286566983
STAT,1862,52,35-39,1914,0.014781856083413482
STAT,1881,40,na,1921,4557.252824453206
STAT,1845,30,25-29,1875,19.1600899941901
STAT,1954,11,na,1965,9807.813426682742
SIM,1821,58,na,1879,2348
SIM,1885,19,15-19,1904,14
SIM,1907,6,na,1913,7871
STAT,1800,107,na,1907,0.004027997006739165
STAT,1943,9,na,1952,8451.980423538851
SIM,1920,15,15-19,1935,91
STAT,1839,51,20-24,1890,0.0011577211251496842
SIM,1839,49,40-44,1888,1
STAT,1820,35,40-44,1855,25.06880100936283
STAT,1884,41,30-34,1925,2.3031235566640693
SIM,1910,48,30-34,1958,1
STAT,1815,51,20-24,1866,0.003875461348568015
STAT,1879,36,na,1915,5000.902170547709
STAT,1900,35,50-100,1935,3.4723412317945943
SIM,1940,18,35-39,1958,10
STAT,1902,48,30-34,1950,0.1537365148207269
SIM,1906,48,40-44,1954,1
SIM,1907,38,45-49,1945,5
SIM,1923,35,35-39,1958,7
STAT,1890,49,na,1939,5431.417395023379
STAT,1833,46,30-34,1879,0.15124299349926495
STAT,1935,30,45-49,1965,4.402561977873553
SIM,1876,38,na,1914,5104
SIM,1900,26,40-44,1926,7
STAT,1939,22,15-19,1961,10.798077609426242
STAT,1932,32,30-34,1964,42.30252352689211
STAT,1919,19,30-34,1938,27.051953802689262
STAT,1849,36,40-44,1885,7.1593733152919485
STAT,1815,41,50-100,1856,6.589064497919078
STAT,1816,43,na,1859,3037.843931359601
STAT,1831,47,35-39,1878,0.21424179299579882
STAT,1912,15,15-19,1927,18.62520996913005
STAT,1915,35,35-39,1950,4.982067330166879
STAT,1845,52,45-49,1897,0.022243648484948055
STAT,1838,54,50-100,1892,0.019878056757660457
STAT,1927,38,20-24,1965,0.6611523981015409
SIM,1875,44,35-39,1919,8
SIM,1876,18,35-39,1894,1
STAT,1829,28,25-29,1857,103.66273858352793
SIM,1831,23,15-19,1854,2
SIM,1833,43,na,1876,3253
SIM,1858,44,35-39,1902,7
SIM,1932,33,35-39,1965,36
STAT,1874,31,20-24,1905,5.61253824312335
STAT,1841,51,50-100,1892,0.022017875974747025
STAT,1882,42,20-24,1924,0.3120635560695995
SIM,1910,24,45-49,1934,3
STAT,1809,51,35-39,1860,0.064751181736327
STAT,1918,50,na,1968,7823.161303700841
STAT,1809,89,na,1898,93.37303641276955
SIM,1817,40,40-44,1857,4
STAT,1857,39,40-44,1896,6.821696134476858
STAT,1784,70,na,1854,1050.0
SIM,1915,33,35-39,1948,30
STAT,1839,61,na,1900,2917.740550825437
SIM,1929,17,15-19,1946,108
STAT,1835,54,40-44,1889,0.01336190714603549
STAT,1807,88,na,1895,109.58078221292843
STAT,1834,25,40-44,1859,5.304631369464605
STAT,1908,39,50-100,1947,0.78643764110901
SIM,1814,88,na,1902,108
SIM,1832,40,20-24,1872,1
STAT,1844,33,50-100,1877,1.7511453944201523
SIM,1840,29,50-100,1869,3
SIM,1930,22,20-24,1952,306
STAT,1867,44,35-39,1911,3.3787864191294066
STAT,1876,42,35-39,1918,3.7778790672347022
SIM,1838,18,15-19,1856,14
STAT,1872,48,35-39,1920,0.28059314532666196
SIM,1898,37,40-44,1935,5
SIM,1889,82,na,1971,1934
STAT,1907,37,40-44,1944,2.804643907894956
STAT,1848,44,25-29,1892,1.0387366974474304
STAT,1896,19,25-29,1915,15.028893714159432
STAT,1840,23,15-19,1863,6.0122959566680745
STAT,1854,104,na,1958,0.1830691799251069
STAT,1884,15,na,1899,5060.143164072386
STAT,1920,17,15-19,1937,102.80996519643315
SIM,1868,41,25-29,1909,1
SIM,1830,25,na,1855,3484
SIM,1837,28,25-29,1865,88
SIM,1882,31,20-24,1913,5
STAT,1807,102,na,1909,0.23401445547504351
SIM,1929,39,35-39,1968,11
SIM,1846,93,na,1939,22
STAT,1896,48,20-24,1944,0.01782226520334727
STAT,1891,43,15-19,1934,0.0342255744616517
STAT,1907,33,35-39,1940,17.18807232995106
STAT,1850,47,45-49,1897,0.36016469359842146
SIM,1843,41,35-39,1884,14
STAT,1928,38,25-29,1966,2.510175918434323
STAT,1892,18,na,1910,6368.74966439482
SIM,1867,42,35-39,1909,12
SIM,1906,35,35-39,1941,7
STAT,1885,32,50-100,1917,1.8419249356912972
STAT,1898,4,na,1902,7189.900399101033
SIM,1826,95,na,1921,10
STAT,1772,85,na,1857,133.046159469607
STAT,1904,34,20-24,1938,4.460603839692115
SIM,1884,31,40-44,1915,15
SIM,1852,47,45-49,1899,2
SIM,1912,34,20-24,1946,3
STAT,1897,65,na,1962,4905.878627687895
SIM,1815,40,20-24,1855,1
SIM,1900,37,na,1937,6926
STAT,1879,68,na,1947,3228.282341971289
STAT,1876,31,40-44,1907,9.095812423414523
SIM,1946,17,15-19,1963,1
STAT,1846,32,50-100,1878,1.6584944310433698
STAT,1938,17,15-19,1955,90.42910825589979
STAT,1859,42,35-39,1901,2.907279817676715
STAT,1885,45,40-44,1930,0.34759386030729916
STAT,1935,6,na,1941,11068.100897424658
SIM,1919,17,30-34,1936,34
STAT,1820,46,20-24,1866,0.0453063668560665
STAT,1897,39,50-100,1936,0.7081981662922241
SIM,1920,19,20-24,1939,282
STAT,1830,45,50-100,1875,0.43506218692190407
SIM,1922,36,50-100,1958,2
STAT,1818,54,40-44,1872,0.042763697155557535
STAT,1899,20,50-100,1919,1.1351453595212053
STAT,1874,26,50-100,1900,1.327368966985771
STAT,1913,32,20-24,1945,4.902413836506977
STAT,1912,19,20-24,1931,55.08554699470245
STAT,1860,15,40-44,1875,0.35008047147177024
STAT,1925,19,50-100,1944,0.9089570473098824
SIM,1834,92,na,1926,28
STAT,1886,31,25-29,1917,21.925882514889196
SIM,1936,17,30-34,1953,27
SIM,1905,30,na,1935,7274
SIM,1957,12,na,1969,10315
STAT,1854,41,45-49,1895,2.304711656634409
STAT,1951,8,na,1959,9451.083292157873
SIM,1901,31,40-44,1932,20
STAT,1936,28,20-24,1964,35.27155384988664
STAT,1784,80,na,1864,406.95892417681813
SIM,1898,19,25-29,1917,18
STAT,1846,45,50-100,1891,0.3799381922126638
STAT,1906,65,na,1971,5685.5429599637555
SIM,1884,42,35-39,1926,9
STAT,1839,71,na,1910,2084.1955156330637
STAT,1875,52,30-34,1927,0.012311551681065323
STAT,1818,41,35-39,1859,9.26486428799717
STAT,1909,40,45-49,1949,0.31812518436207327
STAT,1929,17,50-100,1946,0.9655620442669626
STAT,1929,28,na,1957,9463.325620566646
SIM,1867,7,na,1874,5652
SIM,1842,25,40-44,1867,9
STAT,1827,76,na,1903,1145.633079462979
SIM,1837,21,40-44,1858,5
SIM,1905,62,na,1967,5939
STAT,1856,52,20-24,1908,0.00114373142932258
SIM,1873,73,na,1946,2264
SIM,1841,30,20-24,1871,6
SIM,1941,23,35-39,1964,28
STAT,1857,28,50-100,1885,1.0297802416195265
SIM,1920,37,50-100,1957,1
STAT,1885,32,35-39,1917,20.358402120698905
STAT,1877,29,na,1906,4969.145713052691
SIM,1842,20,na,1862,3957
SIM,1884,5,na,1889,5736
STAT,1882,7,na,1889,5154.907750683089
STAT,1918,36,15-19,1954,0.04106829791403551
STAT,1896,35,15-19,1931,0.1511541371514027
STAT,1830,41,45-49,1871,2.720657747031554
STAT,1879,35,15-19,1914,0.11975182470942462
STAT,1823,32,50-100,1855,5.247610442780573
STAT,1854,17,na,1871,4209.424615676041
STAT,1919,48,25-29,1967,0.11585151500697224
SIM,1855,60,na,1915,3318
STAT,1868,18,35-39,1886,1.0671265395433425
STAT,1928,17,30-34,1945,31.013136386163335
SIM,1919,43,20-24,1962,1
SIM,1852,46,50-100,1898,2
SIM,1894,31,25-29,1925,3
STAT,1840,36,20-24,1876,1.3297579727639217
SIM,1915,37,40-44,1952,3
STAT,1819,40,25-29,1859,3.158541271350644
STAT,1900,24,35-39,1924,16.246477558476812
STAT,1826,37,50-100,1863,2.9093754289817557
SIM,1893,32,35-39,1925,38
STAT,1922,22,20-24,1944,257.461727160724
STAT,1834,40,na,1874,3455.676564134899
STAT,1861,47,20-24,1908,0.02007805812480942
SIM,1860,23,na,1883,4523
SIM,1896,27,50-100,1923,2
STAT,1842,75,na,1917,1532.6779662271595
SIM,1935,26,15-19,1961,3
SIM,1826,41,35-39,1867,8
SIM,1917,40,45-49,1957,1
STAT,1819,73,na,1892,1242.8366877087274
STAT,1891,48,45-49,1939,0.3281517993926119
STAT,1908,45,45-49,1953,0.40306879461470824
STAT,1911,41,50-100,1952,0.22782685760321597
STAT,1913,44,15-19,1957,0.0030152248807702076
STAT,1824,40,20-24,1864,0.433380766476367
SIM,1869,68,na,1937,2893
SIM,1846,39,30-34,1885,15
STAT,1838,39,30-34,1877,8.524797394752865
SIM,1878,29,25-29,1907,106
STAT,1929,40,50-100,1969,0.30808808305475605
SIM,1900,15,na,1915,7445
SIM,1775,86,na,1861,86
STAT,1860,88,na,1948,225.15645983797808
STAT,1891,31,20-24,1922,6.775443505643575
SIM,1825,56,na,1881,2341
STAT,1924,33,35-39,1957,21.513017974389214
SIM,1827,40,25-29,1867,2
SIM,1898,15,20-24,1913,48
STAT,1847,90,na,1937,120.17997467409097
SIM,1786,81,na,1867,415
STAT,1908,42,40-44,1950,0.4676768814898753
STAT,1943,28,50-100,1971,2.1398180612926483
STAT,1811,61,na,1872,2133.227199470989
STAT,1831,44,30-34,1875,1.774067815996117
STAT,1881,37,20-24,1918,1.504759679489261
STAT,1913,46,40-44,1959,0.31164157891876926
STAT,1903,40,50-100,1943,0.2130861820617995
SIM,1826,73,na,1899,1292
SIM,1934,33,45-49,1967,7
SIM,1788,82,na,1870,255
SIM,1850,23,25-29,1873,124
STAT,1860,41,30-34,1901,1.894082805918046
STAT,1861,40,25-29,1901,1.090363619833803
STAT,1930,36,15-19,1966,0.05063335762815522
STAT,1875,26,40-44,1901,6.250206219909357
SIM,1867,20,25-29,1887,131
STAT,1823,40,15-19,1863,0.04834862202000497
STAT,1903,29,20-24,1932,33.493413220924054
SIM,1829,39,30-34,1868,13
STAT,1846,41,na,1887,3629.204127719581
SIM,1932,25,35-39,1957,53
SIM,1806,59,na,1865,2222
SIM,1929,19,40-44,1948,1
STAT,1893,31,30-34,1924,44.87739833906552
STAT,1843,43,35-39,1886,2.5784896772160946
STAT,1922,6,na,1928,9365.649015267889
STAT,1925,45,45-49,1970,0.5342857381782838
STAT,1900,37,40-44,1937,2.647102386557319
SIM,1886,16,na,1902,5330
STAT,1826,40,30-34,1866,2.5304213598608847
STAT,1926,33,45-49,1959,3.8397472659405585
STAT,1872,73,na,1945,2410.829685610782
STAT,1811,45,40-44,1856,1.2030059656191159
STAT,1941,22,30-34,1963,59.98886673906694
SIM,1929,16,50-100,1945,1
STAT,1951,18,45-49,1969,1.2009053700987828
STAT,1852,59,na,1911,3097.5130473062463
STAT,1837,46,15-19,1883,5.863224607000437E-4
STAT,1891,45,40-44,1936,0.24348170518487192
STAT,1882,45,15-19,1927,7.948036417857136E-4
SIM,1831,32,50-100,1863,4
STAT,1877,15,35-39,1892,1.1560763398574707
STAT,1963,0,na,1963,10160.97808252794
STAT,1820,43,40-44,1863,8.844504128296396
STAT,1839,54,25-29,1893,0.005378511491640388
STAT,1874,47,30-34,1921,0.1992409317426769
STAT,1931,15,25-29,1946,115.09223647040373
SIM,1896,36,na,1932,6569
STAT,1879,52,na,1931,4524.303377297621
SIM,1845,41,45-49,1886,6
STAT,1814,46,20-24,1860,0.06314318720130492
STAT,1815,54,15-19,1869,1.2166173327446757E-4
STAT,1824,54,40-44,1878,0.02359850092020273
SIM,1908,8,na,1916,7862
STAT,1836,40,25-29,1876,1.0423044676363449
STAT,1761,103,na,1864,0.0079299540917207
STAT,1853,51,40-44,1904,0.01673655912599934
STAT,1901,16,40-44,1917,0.5184045275717551
STAT,1859,20,25-29,1879,106.44129033670299
STAT,1924,25,35-39,1949,35.534418738597886
STAT,1892,56,na,1948,5156.798317098882
STAT,1911,49,25-29,1960,0.10085646390286405
STAT,1929,38,30-34,1967,4.720424544778336
STAT,1938,27,na,1965,7496.70300149289
SIM,1878,22,40-44,1900,5
STAT,1852,30,40-44,1882,7.30662557237873
SIM,1864,90,na,1954,97
SIM,1920,5,na,1925,9336
STAT,1858,39,50-100,1897,1.9135261129432186
SIM,1843,75,na,1918,1455
SIM,1900,29,45-49,1929,3
STAT,1880,49,na,1929,4686.757863619167
SIM,1855,17,na,1872,4822
SIM,1903,19,20-24,1922,47
SIM,1923,32,30-34,1955,51
STAT,1848,70,na,1918,2300.6309366698893
SIM,1852,44,40-44,1896,8
STAT,1850,33,25-29,1883,16.258956534913867
SIM,1920,51,na,1971,8272
STAT,1883,32,25-29,1915,20.324127046889377
STAT,1878,47,15-19,1925,8.397860982944333E-4
SIM,1941,27,40-44,1968,16
SIM,1876,22,30-34,1898,47
SIM,1901,34,45-49,1935,6
STAT,1932,35,35-39,1967,6.575294839562189
STAT,1855,18,25-29,1873,10.10362718635429
STAT,1877,31,50-100,1908,1.9293643911594172
STAT,1904,46,15-19,1950,6.55908665207036E-4
STAT,1851,18,40-44,1869,0.34269397362871684
SIM,1860,30,40-44,1890,12
STAT,1933,27,40-44,1960,12.500565505688748
STAT,1871,42,45-49,1913,2.9993337711222963
SIM,1839,44,25-29,1883,3
SIM,1921,24,20-24,1945,263
SIM,1938,17,40-44,1955,1
STAT,1834,56,na,1890,2710.5468815943327
STAT,1811,49,20-24,1860,0.07871403907479177
SIM,1884,34,35-39,1918,27
SIM,1840,18,30-34,1858,5
SIM,1857,18,na,1875,4758
SIM,1863,18,25-29,1881,13
STAT,1809,100,na,1909,0.9436049279994171
STAT,1923,46,25-29,1969,0.12559649879150106
STAT,1848,16,50-100,1864,0.10017385367661497
STAT,1858,41,15-19,1899,0.021840828206742074
STAT,1915,32,30-34,1947,32.40945432986626
STAT,1844,44,40-44,1888,3.626057766869519
STAT,1855,47,20-24,1902,0.018010852418885615
SIM,1824,41,25-29,1865,2
SIM,1841,62,na,1903,2548
STAT,1897,55,na,1952,5582.086231721455
SIM,1859,25,35-39,1884,19
SIM,1928,36,25-29,1964,6
STAT,1876,34,35-39,1910,20.972908119245314
STAT,1864,41,15-19,1905,0.025043823407637073
STAT,1878,42,45-49,1920,3.1529775300946103
STAT,1899,33,50-100,1932,2.524679197965618
STAT,1817,53,35-39,1870,0.03906222526487631
STAT,1926,26,na,1952,9099.207005801094
STAT,1804,51,45-49,1855,0.08659356846729058
SIM,1891,32,25-29,1923,28
STAT,1826,40,40-44,1866,4.95065921340498
SIM,1859,29,15-19,1888,1
SIM,1843,39,50-100,1882,3
STAT,1862,30,25-29,1892,17.822917046112018
STAT,1829,93,na,1922,34.58851935597956
SIM,1776,97,na,1873,1
STAT,1868,22,30-34,1890,34.22677211565846
STAT,1926,38,15-19,1964,0.047342549637247745
SIM,1945,7,na,1952,9071
STAT,1885,48,45-49,1933,0.46846867049439206
SIM,1834,40,30-34,1874,3
STAT,1918,34,50-100,1952,1.7589068704546131
STAT,1816,41,25-29,1857,3.6833183718978364
STAT,1914,20,na,1934,7602.330624179147
SIM,1818,44,na,1862,2986
SIM,1883,22,25-29,1905,131
STAT,1835,39,50-100,1874,1.9263184149722559
STAT,1861,44,40-44,1905,3.730014471044021
STAT,1843,101,na,1944,0.7993396384809068
STAT,1870,72,na,1942,2504.1024324212904
SIM,1883,26,40-44,1909,8
SIM,1817,43,35-39,1860,6
SIM,1904,46,50-100,1950,4
SIM,1835,44,50-100,1879,5
STAT,1905,44,50-100,1949,0.21138254713912455
SIM,1885,31,50-100,1916,5
STAT,1842,23,25-29,1865,106.72589857977617
SIM,1893,34,na,1927,6198
SIM,1926,34,50-100,1960,4
STAT,1913,24,20-24,1937,225.40904727766147
SIM,1856,61,na,1917,3127
SIM,1886,42,45-49,1928,7
SIM,1911,29,20-24,1940,41
STAT,1931,21,50-100,1952,1.728821862212981
SIM,1879,19,15-19,1898,11
SIM,1830,30,45-49,1860,4
STAT,1818,56,na,1874,2461.2529402356267
STAT,1860,72,na,1932,2071.2522550204894
STAT,1859,38,na,1897,3768.423268062806
STAT,1928,35,20-24,1963,0.6738954364222319
STAT,1936,19,30-34,1955,23.44627319741636
SIM,1835,56,na,1891,2757
SIM,1866,15,25-29,1881,10
SIM,1874,29,40-44,1903,6
STAT,1861,23,35-39,1884,10.005314214932723
SIM,1915,30,30-34,1945,40
STAT,1910,43,35-39,1953,0.38218357822869586
STAT,1812,50,40-44,1862,0.07265020249721436
STAT,1843,35,50-100,1878,2.0498974967620356
STAT,1925,28,45-49,1953,4.1057066336068955
STAT,1832,51,20-24,1883,0.0010206916297706185
SIM,1933,28,45-49,1961,7
STAT,1877,67,na,1944,3324.4525810032396
SIM,1950,17,50-100,1967,1
STAT,1850,44,40-44,1894,3.402195034981243
STAT,1902,13,na,1915,7352.213867554404
STAT,1884,44,35-39,1928,3.5625073226452195
SIM,1913,25,25-29,1938,136
SIM,1800,80,na,1880,440
STAT,1824,62,na,1886,2034.1736093470402
SIM,1944,19,30-34,1963,33
STAT,1824,43,25-29,1867,1.6288487410717607
SIM,1803,94,na,1897,27
STAT,1898,13,na,1911,7047.283758188645
SIM,1878,40,45-49,1918,8
STAT,1843,30,15-19,1873,0.24485447668661214
SIM,1943,26,na,1969,8193
SIM,1891,24,25-29,1915,182
SIM,1868,20,30-34,1888,42
SIM,1847,41,na,1888,3588
STAT,1824,53,50-100,1877,0.034533798143154056
STAT,1891,34,25-29,1925,25.350538593992294
STAT,1842,31,25-29,1873,18.613857786334712
SIM,1825,49,50-100,1874,2
SIM,1923,48,40-44,1971,1
STAT,1863,36,15-19,1899,0.09975350665567988
SIM,1908,43,45-49,1951,2
STAT,1867,41,30-34,1908,2.1843499226986816
STAT,1895,48,na,1943,5847.44228190494
SIM,1831,46,50-100,1877,1
SIM,1901,32,na,1933,6734
SIM,1867,18,na,1885,5204
SIM,1869,40,50-100,1909,9
STAT,1842,91,na,1933,86.27354418041796
STAT,1947,4,na,1951,9047.624927514795
SIM,1851,35,50-100,1886,4
STAT,1889,52,na,1941,5333.491001559412
STAT,1939,22,na,1961,7407.670577673793
STAT,1901,66,na,1967,5207.460528064618
STAT,1907,30,30-34,1937,29.99813862165268
STAT,1901,46,50-100,1947,0.39281256859421987
STAT,1850,30,50-100,1880,1.6488515218123825
SIM,1832,42,na,1874,3349
STAT,1919,45,50-100,1964,0.4976865001670063
STAT,1915,48,40-44,1963,0.31999222384400955
STAT,1922,38,30-34,1960,4.183029055829198
SIM,1850,31,25-29,1881,28
SIM,1930,38,30-34,1968,6
SIM,1875,41,30-34,1916,5
SIM,1881,19,30-34,1900,4
STAT,1830,49,30-34,1879,0.16282597424511291
STAT,1959,10,na,1969,10378.223068609426
SIM,1811,46,45-49,1857,1
STAT,1821,51,35-39,1872,0.02472538659665446
STAT,1835,33,35-39,1868,16.533462797525992
SIM,1939,24,30-34,1963,84
STAT,1883,24,25-29,1907,112.87984387827056
STAT,1859,16,na,1875,4308.576735342486
SIM,1903,27,20-24,1930,35
SIM,1874,90,na,1964,266
STAT,1934,32,40-44,1966,10.792442024107883
STAT,1902,35,na,1937,6835.0164001865005
SIM,1877,2,na,1879,6332
SIM,1921,35,25-29,1956,2
SIM,1844,18,15-19,1862,11
STAT,1836,18,15-19,1854,19.506714858665504
STAT,1841,44,15-19,1885,0.0202943188847381
STAT,1892,19,40-44,1911,0.45995311853501447
STAT,1913,35,25-29,1948,1.9815367925133165
STAT,1913,51,na,1964,7151.455374255726
SIM,1820,57,na,1877,2334
STAT,1855,52,50-100,1907,0.02265271773504514
SIM,1871,31,45-49,1902,2
STAT,1870,37,45-49,1907,3.952739763909912
STAT,1931,32,na,1963,10009.05682118894
SIM,1824,33,25-29,1857,18
SIM,1851,43,35-39,1894,7
SIM,1900,21,na,1921,6880
STAT,1897,40,15-19,1937,0.002615033480190226
SIM,1817,53,na,1870,2599
SIM,1955,11,na,1966,10118
STAT,1944,5,na,1949,8651.415426028023
STAT,1860,94,na,1954,32.77882299608435
STAT,1938,11,na,1949,7906.85856891205
SIM,1832,43,25-29,1875,1
STAT,1899,42,15-19,1941,0.002650371593621015
STAT,1910,46,15-19,1956,6.961047701567899E-4
STAT,1892,34,na,1926,5981.645734546696
STAT,1906,28,35-39,1934,28.296303220873458
STAT,1888,3,na,1891,6310.544644137709
STAT,1890,31,15-19,1921,0.3524917637435556
STAT,1875,37,50-100,1912,2.552908849125479
STAT,1857,0,na,1857,6225.944399116263
SIM,1796,58,na,1854,2150
STAT,1905,25,25-29,1930,124.39139734078466
STAT,1893,47,40-44,1940,0.2460576235584603
STAT,1950,15,35-39,1965,10.025072400310172
SIM,1843,33,35-39,1876,29
STAT,1881,5,na,1886,5227.565955527234
STAT,1872,45,30-34,1917,0.19843769163967875
STAT,1926,1,na,1927,10338.86368115021
STAT,1940,17,30-34,1957,24.996124519466484
SIM,1858,47,50-100,1905,1
STAT,1876,51,25-29,1927,0.007434168386473805
STAT,1857,90,na,1947,124.11057886173181
SIM,1776,81,na,1857,243
STAT,1857,51,50-100,1908,0.023888454864893657
STAT,1911,22,45-49,1933,2.1557833216139892
SIM,1910,15,na,1925,8118
STAT,1942,17,50-100,1959,0.790756174919308
SIM,1883,3,na,1886,5896
STAT,1882,51,na,1933,4256.403256290712
STAT,1812,77,na,1889,814.2641397270352
STAT,1833,45,na,1878,3234.025454924796
STAT,1898,43,25-29,1941,0.12099536294042658
STAT,1907,15,50-100,1922,0.1461013184097305
SIM,1850,23,na,1873,4064
STAT,1858,15,25-29,1873,10.545711725998407
STAT,1805,54,30-34,1859,0.04488774950652672
SIM,1833,28,40-44,1861,4
SIM,1941,20,30-34,1961,83
SIM,1851,22,50-100,1873,1
SIM,1820,79,na,1899,675
STAT,1896,30,45-49,1926,4.687152424762351
SIM,1833,35,40-44,1868,11
SIM,1823,41,50-100,1864,5
SIM,1835,31,35-39,1866,33
STAT,1825,42,na,1867,3162.3006574448827
SIM,1932,22,30-34,1954,86
STAT,1953,10,na,1963,9598.675760643486
SIM,1861,39,na,1900,4457
SIM,1826,57,na,1883,2394
STAT,1907,15,30-34,1922,4.753163858630145
SIM,1953,18,20-24,1971,333
STAT,1869,45,50-100,1914,0.4854159675899469
SIM,1863,29,50-100,1892,1
STAT,1933,20,30-34,1953,77.463192469855
STAT,1894,22,35-39,1916,15.13955089820781
SIM,1895,51,na,1946,5964
STAT,1912,43,45-49,1955,0.32232316213385603
SIM,1850,20,20-24,1870,142
STAT,1915,44,25-29,1959,0.1447251700964079
SIM,1817,40,30-34,1857,2
SIM,1923,44,25-29,1967,4
STAT,1890,17,50-100,1907,0.12077262050201783
SIM,1882,7,na,1889,5442
SIM,1877,17,15-19,1894,13
STAT,1840,40,15-19,1880,0.023443306155392245
STAT,1869,17,15-19,1886,11.774375993878932
STAT,1919,9,na,1928,8882.828379638482
SIM,1927,15,15-19,1942,109
SIM,1929,17,25-29,1946,149
SIM,1938,29,35-39,1967,45
STAT,1890,70,na,1960,3745.9749609889004
STAT,1913,48,30-34,1961,0.1752829144754349
STAT,1882,88,na,1970,733.0883344228197
SIM,1852,89,na,1941,125
SIM,1917,33,45-49,1950,5
STAT,1831,46,20-24,1877,0.018600538234532008
SIM,1868,99,na,1967,7
STAT,1909,51,na,1960,6734.65264273945
STAT,1830,41,35-39,1871,3.291776214074804
STAT,1802,94,na,1896,15.338969489580672
SIM,1845,39,na,1884,3982
STAT,1835,50,25-29,1885,0.004866219312714218
SIM,1950,17,40-44,1967,3
STAT,1872,34,15-19,1906,0.28657588843876486
STAT,1896,18,50-100,1914,0.13029107290788197
STAT,1862,52,45-49,1914,0.024917985934444768
STAT,1910,48,na,1958,6905.845730678325
SIM,1915,29,na,1944,7707
STAT,1899,29,na,1928,6556.641842363189
STAT,1857,89,na,1946,165.3749318592525
STAT,1828,87,na,1915,216.35980825378505
SIM,1868,19,15-19,1887,10
STAT,1827,31,35-39,1858,26.322142088781618
SIM,1900,30,50-100,1930,5
SIM,1883,66,na,1949,3320
SIM,1921,20,na,1941,8964
STAT,1825,35,40-44,1860,12.388544692782524
STAT,1834,21,25-29,1855,102.6500683445344
SIM,1889,25,20-24,1914,32
SIM,1928,33,20-24,1961,9
STAT,1941,25,na,1966,7833.727361391585
SIM,1895,32,45-49,1927,10
STAT,1942,17,40-44,1959,2.952157104256191
STAT,1892,26,40-44,1918,7.5996627709372495
SIM,1920,43,45-49,1963,3
STAT,1916,27,40-44,1943,9.733204120244963
SIM,1854,54,na,1908,3502
SIM,1842,21,25-29,1863,103
SIM,1906,53,na,1959,6391
STAT,1870,56,na,1926,4044.241907620768
STAT,1873,52,20-24,1925,0.001506190852791704
STAT,1833,61,na,1894,2456.5602774314234
SIM,1915,15,30-34,1930,4
SIM,1898,23,20-24,1921,200
STAT,1844,24,na,1868,4249.47533935845
SIM,1870,16,na,1886,5008
SIM,1843,30,30-34,1873,49
SIM,1894,19,na,1913,6797
STAT,1922,34,15-19,1956,0.29172539246541385
STAT,1887,32,45-49,1919,3.938932792170958
STAT,1804,51,35-39,1855,0.051369066111531345
SIM,1843,91,na,1934,62
SIM,1874,4,na,1878,5423
SIM,1927,14,na,1941,10195
STAT,1941,7,na,1948,8267.855861915037
SIM,1895,73,na,1968,3902
SIM,1858,30,25-29,1888,25
STAT,1824,94,na,1918,21.36783462600286
SIM,1835,72,na,1907,1606
STAT,1866,36,40-44,1902,8.196649672184
STAT,1872,47,20-24,1919,0.024243333978999988
STAT,1938,28,30-34,1966,78.3735713307068
STAT,1896,15,45-49,1911,0.17498703166868504
STAT,1899,16,25-29,1915,15.719135264626958
SIM,1869,42,45-49,1911,10
SIM,1885,15,35-39,1900,2
STAT,1774,116,na,1890,1.7542379098620724E-4
STAT,1902,19,na,1921,7162.757845143636
STAT,1900,30,50-100,1930,2.587609724242347
STAT,1946,19,50-100,1965,0.8386186415658432
SIM,1861,21,35-39,1882,19
STAT,1882,51,25-29,1933,0.007001886218636927
STAT,1884,31,15-19,1915,0.285160020148208
STAT,1831,33,15-19,1864,0.23766558342002217
SIM,1887,22,na,1909,5820
STAT,1843,76,na,1919,1327.1398264254358
STAT,1869,30,35-39,1899,19.977356200041555
STAT,1902,21,40-44,1923,5.959598732736864
STAT,1901,39,15-19,1940,0.03392413514780888
SIM,1914,9,na,1923,8523
STAT,1870,30,25-29,1900,20.47256413763265
STAT,1880,43,15-19,1923,0.02916917597237544
SIM,1927,28,20-24,1955,48
SIM,1828,41,45-49,1869,5
SIM,1954,10,na,1964,9926
STAT,1868,25,35-39,1893,18.666456642820982
STAT,1919,28,20-24,1947,39.684847873507486
SIM,1899,66,na,1965,5060
STAT,1820,110,na,1930,3.093625301102307E-4
STAT,1902,44,15-19,1946,0.0026974830506836865
STAT,1941,20,50-100,1961,1.3743197575885038
STAT,1851,106,na,1957,0.02923919674560203
STAT,1895,47,15-19,1942,5.910147692845261E-4
STAT,1853,40,25-29,1893,1.026273820690365
STAT,1896,70,na,1966,4319.47157027485
STAT,1842,20,20-24,1862,131.2846756081186
STAT,1917,48,15-19,1965,7.7485415849939E-4
SIM,1857,22,20-24,1879,128
STAT,1891,47,30-34,1938,0.1356751172576919
STAT,1853,21,35-39,1874,10.987959609273952
STAT,1920,25,15-19,1945,1.574266373530918
STAT,1898,32,20-24,1930,7.38769669120021
STAT,1817,40,15-19,1857,0.0807541346396977
STAT,1873,19,50-100,1892,0.09999494092816628
SIM,1839,41,20-24,1880,1
STAT,1924,22,30-34,1946,68.475247272311
STAT,1863,16,na,1879,4658.12612261026
STAT,1873,19,30-34,1892,3.253169406265681
STAT,1821,76,na,1897,1050.145909307145
SIM,1851,24,na,1875,4021
STAT,1867,53,25-29,1920,0.006591883445073022
STAT,1939,26,30-34,1965,79.59829247378879
SIM,1901,16,na,1917,7221
STAT,1843,40,40-44,1883,3.3283309505064915
SIM,1884,31,30-34,1915,48
STAT,1810,50,30-34,1860,0.038312662770109994
SIM,1846,18,25-29,1864,19
STAT,1838,18,25-29,1856,10.070726890751965
STAT,1846,17,50-100,1863,0.09426703820580272
STAT,1919,15,15-19,1934,20.411564353615248
STAT,1909,33,45-49,1942,3.021528501888282
STAT,1833,42,15-19,1875,0.022036765714243855
STAT,1943,25,45-49,1968,3.719064038672107
STAT,1876,31,30-34,1907,36.61994378607678
STAT,1813,57,na,1870,2297.7437862339916
SIM,1775,80,na,1855,348
STAT,1922,33,na,1955,8591.605989543117
SIM,1897,34,50-100,1931,7
SIM,1906,31,na,1937,7050
STAT,1808,72,na,1880,1194.9034451693833
SIM,1864,74,na,1938,1957
STAT,1920,39,25-29,1959,2.172076718253928
STAT,1888,30,45-49,1918,4.196076852275044
STAT,1822,35,15-19,1857,0.24419051718762486
SIM,1834,40,40-44,1874,3
STAT,1852,42,25-29,1894,1.0222163841554162
SIM,1812,44,na,1856,2893
STAT,1863,40,35-39,1903,3.233641559696072
STAT,1873,53,25-29,1926,0.007151707123145116
STAT,1921,37,25-29,1958,2.219817816061651
SIM,1868,23,35-39,1891,14
SIM,1901,43,35-39,1944,1
SIM,1911,0,na,1911,8629
STAT,1832,29,50-100,1861,1.1000955384588333
STAT,1882,56,na,1938,4012.769183295807
STAT,1915,15,30-34,1930,5.176511257184629
STAT,1850,46,30-34,1896,0.14884190684084428
STAT,1876,20,50-100,1896,0.8568993896599353
STAT,1930,42,25-29,1972,0.1897543640607007
STAT,1909,46,15-19,1955,6.856966531190009E-4
STAT,1866,32,25-29,1898,19.08688545738707
SIM,1916,25,40-44,1941,15
SIM,1865,24,20-24,1889,117
SIM,1838,16,25-29,1854,13
STAT,1809,95,na,1904,11.81726004785823
STAT,1887,45,15-19,1932,9.125239789231052E-4
STAT,1900,30,20-24,1930,7.633828145649676
STAT,1893,31,40-44,1924,11.146832986078863
STAT,1883,14,na,1897,5107.814447705683
STAT,1857,24,20-24,1881,112.33413939788174
STAT,1846,31,45-49,1877,3.1894362974556594
SIM,1848,39,40-44,1887,14
SIM,1864,19,30-34,1883,3
STAT,1829,35,na,1864,3307.4014033962426
STAT,1820,39,20-24,1859,3.4004073015401732
SIM,1848,24,20-24,1872,122
SIM,1879,30,45-49,1909,4
SIM,1948,17,35-39,1965,16
STAT,1874,37,na,1911,4871.960082846924
STAT,1877,41,25-29,1918,1.3527984118064302
STAT,1876,66,na,1942,3423.6622929911937
STAT,1849,22,20-24,1871,131.7911201229213
STAT,1947,25,na,1972,8566.314634929888
SIM,1899,33,50-100,1932,7
SIM,1958,7,na,1965,10841
SIM,1910,21,40-44,1931,6
STAT,1847,29,30-34,1876,45.47764001838922
SIM,1825,94,na,1919,8
SIM,1896,30,45-49,1926,11
STAT,1920,28,50-100,1948,2.1969002166321214
SIM,1923,15,30-34,1938,40
STAT,1935,23,45-49,1958,3.0940229882742405
STAT,1845,89,na,1934,161.88072005598804
STAT,1861,20,30-34,1881,31.207730000112438
STAT,1921,44,25-29,1965,0.16185793349221864
SIM,1885,41,25-29,1926,2
SIM,1887,19,25-29,1906,18
STAT,1821,51,45-49,1872,0.041679937347683285
STAT,1810,101,na,1911,0.5160450209969587
STAT,1835,30,30-34,1865,29.406692128324234
STAT,1898,21,15-19,1919,9.043743767888015
STAT,1769,114,na,1883,3.9930752298978386E-4
STAT,1817,50,40-44,1867,0.050718671786436374
STAT,1845,52,35-39,1897,0.013195384712856289
STAT,1905,22,20-24,1927,201.2782795775108
STAT,1884,85,na,1969,1148.50979583306
SIM,1838,39,50-100,1877,6
STAT,1863,31,45-49,1894,3.0955031191633355
STAT,1914,36,50-100,1950,0.8508444338917096
SIM,1882,26,50-100,1908,3
SIM,1907,16,na,1923,7621
SIM,1924,27,40-44,1951,18
STAT,1867,89,na,1956,223.15054781624744
SIM,1913,22,20-24,1935,249
STAT,1926,40,45-49,1966,0.41545206545202196
SIM,1824,30,20-24,1854,5
STAT,1917,35,45-49,1952,1.4435097110435462
SIM,1855,29,30-34,1884,50
STAT,1935,36,15-19,1971,0.054291081274924165
SIM,1811,96,na,1907,4
SIM,1939,27,35-39,1966,42
SIM,1889,47,40-44,1936,1
SIM,1943,23,45-49,1966,2
SIM,1854,7,na,1861,5004
SIM,1907,27,40-44,1934,11
STAT,1867,41,40-44,1908,4.273585514905387
STAT,1826,52,25-29,1878,0.006812242209159347
STAT,1900,48,20-24,1948,0.018725909494888924
STAT,1939,33,30-34,1972,32.44945749078004
STAT,1883,21,20-24,1904,137.15406050152387
SIM,1886,20,35-39,1906,12
STAT,1930,27,25-29,1957,169.02688427194065
STAT,1912,37,50-100,1949,0.8278315315669996
SIM,1829,87,na,1916,194
STAT,1908,29,na,1937,7105.755328437125
SIM,1954,16,20-24,1970,329
SIM,1857,29,40-44,1886,5
SIM,1925,29,na,1954,8837
STAT,1911,31,35-39,1942,18.050533672531206
STAT,1843,52,25-29,1895,0.004935300660884237
STAT,1874,43,15-19,1917,0.0283512578031067
SIM,1844,40,25-29,1884,1
STAT,1832,39,na,1871,3431.381369599353
SIM,1865,28,50-100,1893,1
SIM,1937,16,20-24,1953,240
STAT,1857,20,15-19,1877,6.082411723966908
STAT,1868,32,35-39,1900,19.45942459977786
SIM,1860,30,30-34,1890,47
STAT,1826,91,na,1917,69.36962404919409
SIM,1848,42,na,1890,3513
SIM,1844,76,na,1920,1280
SIM,1912,37,50-100,1949,2
STAT,1907,44,na,1951,6791.365572273501
STAT,1857,74,na,1931,1747.025769473723
SIM,1889,0,na,1889,7253
STAT,1877,19,15-19,1896,12.378948148292894
STAT,1837,41,45-49,1878,2.4937697426865135
STAT,1849,29,40-44,1878,5.536533093281176
STAT,1870,51,50-100,1921,0.03008942418604241
STAT,1807,52,15-19,1859,1.6021518518001882E-4
STAT,1841,50,25-29,1891,0.005213064958970448
SIM,1894,29,na,1923,6363
STAT,1860,78,na,1938,1281.4503572548504
STAT,1842,15,50-100,1857,0.09477749811972895
SIM,1860,46,40-44,1906,1
SIM,1915,45,na,1960,7586
SIM,1925,35,45-49,1960,4
STAT,1876,20,25-29,1896,120.29152375496732
SIM,1862,89,na,1951,156
SIM,1876,32,35-39,1908,28
STAT,1946,16,20-24,1962,303.7566712859023
STAT,1857,52,na,1909,3371.4658760999555
STAT,1898,47,40-44,1945,0.2627066833330445
SIM,1875,37,na,1912,5225
STAT,1859,7,na,1866,4618.483075056996
SIM,1886,28,50-100,1914,3
SIM,1871,40,35-39,1911,4
SIM,1875,41,40-44,1916,5
SIM,1883,88,na,1971,690
STAT,1851,25,40-44,1876,5.516019309468399
STAT,1929,16,20-24,1945,350.2629328565756
STAT,1870,54,45-49,1924,0.02798429973313844
STAT,1893,43,25-29,1936,0.11332727089006615
SIM,1839,34,20-24,1873,7
STAT,1880,36,15-19,1916,0.12004795999416182
STAT,1928,43,na,1971,9545.503582113583
SIM,1942,15,40-44,1957,2
SIM,1924,23,35-39,1947,27
STAT,1894,41,25-29,1935,1.6735484634621718
SIM,1824,38,50-100,1862,4
SIM,1854,31,45-49,1885,6
STAT,1916,23,35-39,1939,19.865070996912365
STAT,1897,20,45-49,1917,1.8937507307015486
STAT,1813,45,15-19,1858,0.0025557016866644524
STAT,1852,30,30-34,1882,29.416637598818944
SIM,1865,20,15-19,1885,5
SIM,1888,27,50-100,1915,2
STAT,1945,18,20-24,1963,298.98525976049007
STAT,1888,27,50-100,1915,1.5269873932902411
SIM,1844,86,na,1930,231
STAT,1844,46,50-100,1890,0.3977489701168781
SIM,1891,21,20-24,1912,185
STAT,1934,15,40-44,1949,3.8392357291330863
STAT,1866,29,40-44,1895,5.542275749874589
SIM,1838,29,30-34,1867,46
STAT,1898,25,20-24,1923,32.28061210543791
STAT,1827,50,25-29,1877,0.00642419365515115
STAT,1911,27,15-19,1938,1.3908243656477188
STAT,1809,57,na,1866,2360.9412885493057
SIM,1938,26,30-34,1964,84
SIM,1805,58,na,1863,2103
SIM,1908,19,20-24,1927,55
STAT,1806,102,na,1908,0.1996274256701108
STAT,1867,67,na,1934,2998.320002229982
STAT,1916,20,30-34,1936,61.187219353131304
STAT,1785,109,na,1894,0.001111835457056162
STAT,1891,55,na,1946,5161.803124213015
SIM,1885,15,na,1900,5322
STAT,1879,30,45-49,1909,3.7133952542382436
STAT,1912,37,25-29,1949,1.941359607061218
SIM,1856,44,25-29,1900,4
STAT,1816,38,50-100,1854,9.140586725055645
SIM,1826,50,25-29,1876,1
STAT,1924,29,na,1953,8743.77959044106
STAT,1932,11,na,1943,10612.829775140119
SIM,1864,15,15-19,1879,17
STAT,1859,48,na,1907,3571.1520746324404
STAT,1872,22,50-100,1894,0.8277087123661886
SIM,1874,52,na,1926,4110
SIM,1913,47,35-39,1960,1
SIM,1848,42,25-29,1890,2
SIM,1848,20,na,1868,4070
STAT,1850,42,15-19,1892,0.021148125295273858
SIM,1852,31,35-39,1883,28
SIM,1907,26,na,1933,7145
STAT,1791,100,na,1891,0.4189611060280729
STAT,1812,62,na,1874,2130.390804090878
STAT,1851,90,na,1941,122.21727696427614
STAT,1794,79,na,1873,582.8688064241159
SIM,1924,20,30-34,1944,92
STAT,1907,28,50-100,1935,1.89215490794706
STAT,1903,25,15-19,1928,1.3135011347939451
STAT,1878,51,35-39,1929,0.018245978774284265
STAT,1833,30,20-24,1863,4.6817510105216416
STAT,1933,23,35-39,1956,25.218863012123034
SIM,1892,41,40-44,1933,15
STAT,1808,50,15-19,1858,1.5208236879633405E-4
STAT,1893,40,20-24,1933,0.4106441497963138
SIM,1836,35,na,1871,3447
SIM,1825,72,na,1897,1326
STAT,1905,47,35-39,1952,0.22958355143825426
SIM,1917,30,40-44,1947,10
SIM,1894,43,50-100,1937,2
STAT,1818,50,25-29,1868,0.015584334784500409
SIM,1795,79,na,1874,615
SIM,1890,1,na,1891,7065
SIM,1920,37,25-29,1957,3
STAT,1889,14,na,1903,6410.229312687784
SIM,1857,25,25-29,1882,78
SIM,1930,6,na,1936,11042
STAT,1853,38,na,1891,3709.1414610083716
STAT,1880,92,na,1972,366.6116737707672
STAT,1884,41,40-44,1925,4.5059609582318165
STAT,1875,41,15-19,1916,0.028845421730083656
STAT,1846,44,15-19,1890,0.020867121128383424
STAT,1885,41,25-29,1926,1.2967669656822767
STAT,1948,16,30-34,1964,28.177604156674008
STAT,1851,42,40-44,1893,3.4824955125956305
SIM,1871,43,50-100,1914,4
SIM,1905,27,30-34,1932,90
STAT,1838,49,na,1887,3053.291988264086
STAT,1863,43,50-100,1906,1.8542101368645971
SIM,1806,80,na,1886,445
STAT,1777,94,na,1871,7.222763491985331
STAT,1920,36,20-24,1956,0.5833026264757923
STAT,1868,15,na,1883,4999.608751593154
SIM,1839,30,15-19,1869,1
SIM,1904,35,25-29,1939,2
STAT,1799,78,na,1877,645.563017719186
SIM,1871,60,na,1931,3678
STAT,1932,33,na,1965,10148.507025356295
SIM,1884,20,25-29,1904,126
STAT,1901,34,na,1935,6689.216917928183
STAT,1881,24,15-19,1905,6.399647746797661
SIM,1874,74,na,1948,1974
STAT,1895,20,35-39,1915,15.448455198838923
STAT,1787,94,na,1881,8.148832692849457
STAT,1865,51,25-29,1916,0.006530019937306251
SIM,1943,20,40-44,1963,5
STAT,1891,33,na,1924,5932.005033883129
STAT,1914,30,na,1944,7751.85695372407
STAT,1918,21,50-100,1939,1.4373337736002139
STAT,1886,43,50-100,1929,2.236024675272875
STAT,1909,30,40-44,1939,7.60674912461549
SIM,1816,95,na,1911,5
SIM,1820,73,na,1893,1110
STAT,1856,15,15-19,1871,11.064439445494695
SIM,1880,38,30-34,1918,14
STAT,1934,4,na,1938,11027.42509857514
STAT,1790,98,na,1888,1.1080962006565358
SIM,1856,71,na,1927,2149
SIM,1868,67,na,1935,3146
SIM,1898,26,25-29,1924,135
STAT,1902,24,45-49,1926,1.9758580565693729
STAT,1831,109,na,1940,9.185999234016399E-4
STAT,1915,41,20-24,1956,0.03596352107253427
SIM,1922,15,na,1937,9087
STAT,1871,19,na,1890,5040.489772747183
SIM,1785,80,na,1865,303
SIM,1874,89,na,1963,310
STAT,1889,42,20-24,1931,0.3949945270375503
STAT,1867,50,20-24,1917,0.001415775945870487
SIM,1937,14,na,1951,7934
STAT,1844,31,35-39,1875,19.76119282758192
STAT,1844,40,25-29,1884,1.0896561702759846
STAT,1772,95,na,1867,3.9714191881942864
STAT,1938,17,25-29,1955,86.34810277446651
STAT,1834,40,15-19,1874,0.022736419040323676
STAT,1828,49,na,1877,2984.334360335468
STAT,1800,77,na,1877,742.4471641204985
STAT,1874,22,na,1896,4890.719042202686
STAT,1889,36,na,1925,5895.169609859871
SIM,1891,17,25-29,1908,27
SIM,1927,19,30-34,1946,41
SIM,1872,23,na,1895,5029
STAT,1916,0,na,1916,9621.748333195803
SIM,1957,5,na,1962,10326
SIM,1851,40,40-44,1891,7
STAT,1879,19,25-29,1898,11.906637023318096
SIM,1836,57,na,1893,2553
SIM,1873,2,na,1875,6649
SIM,1852,40,25-29,1892,1
STAT,1918,7,na,1925,8785.553362170653
STAT,1937,33,20-24,1970,4.871680718920817
SIM,1919,11,na,1930,9013
SIM,1946,17,25-29,1963,1
STAT,1853,16,na,1869,4394.766934151778
STAT,1861,89,na,1950,176.59585200939506
SIM,1800,59,na,1859,2042
SIM,1892,8,na,1900,7453
STAT,1878,2,na,1880,6833.724022006303
SIM,1849,32,50-100,1881,2
STAT,1861,47,45-49,1908,0.3948684614692156
STAT,1818,72,na,1890,1295.6580998565337
SIM,1833,31,25-29,1864,23
SIM,1930,25,25-29,1955,194
STAT,1857,27,25-29,1884,68.58952722832984
SIM,1870,38,na,1908,4583
STAT,1919,51,na,1970,7943.455058172066
STAT,1825,52,40-44,1877,0.022007091139471843
STAT,1848,41,20-24,1889,0.2634398646085174
SIM,1893,66,na,1959,4469
STAT,1931,37,35-39,1968,6.469716165768387
STAT,1904,37,25-29,1941,1.801420102572473
SIM,1891,37,na,1928,6078
STAT,1899,14,na,1913,7123.026006119506
STAT,1892,22,25-29,1914,144.7338450990492
STAT,1939,29,35-39,1968,30.455715857319444
STAT,1873,50,20-24,1923,0.0015360124312312252
SIM,1916,28,45-49,1944,6
STAT,1883,17,25-29,1900,11.244338374881254
SIM,1931,17,30-34,1948,38
SIM,1880,21,45-49,1901,1
STAT,1846,48,30-34,1894,0.14640643319390487
STAT,1783,110,na,1893,8.511693891713106E-4
SIM,1891,39,45-49,1930,4
SIM,1939,31,30-34,1970,39
SIM,1801,81,na,1882,368
SIM,1889,66,na,1955,4019
SIM,1853,68,na,1921,2371
SIM,1865,23,50-100,1888,1
STAT,1921,30,40-44,1951,8.863843747379605
SIM,1912,37,25-29,1949,2
STAT,1852,106,na,1958,0.036840226992130076
STAT,1849,23,na,1872,4059.685170773748
STAT,1857,23,50-100,1880,0.7357646103916919
SIM,1890,52,na,1942,5663
STAT,1943,22,40-44,1965,7.2245904728044295
SIM,1883,15,25-29,1898,13
SIM,1874,36,40-44,1910,13
SIM,1821,47,50-100,1868,3
STAT,1825,31,25-29,1856,40.27960579272893
SIM,1907,16,35-39,1923,2
STAT,1855,23,na,1878,3739.570399015756
STAT,1875,15,25-29,1890,11.837866819220928
SIM,1896,3,na,1899,7332
SIM,1902,22,45-49,1924,2
STAT,1923,17,30-34,1940,28.896664348873017
STAT,1868,49,20-24,1917,0.022576877485588228
SIM,1833,52,40-44,1885,1
STAT,1849,25,25-29,1874,80.46966584893111
STAT,1926,42,35-39,1968,0.501272041451043
STAT,1904,52,na,1956,6245.5436036383235
STAT,1834,24,na,1858,3745.2821094577967
SIM,1887,28,15-19,1915,3
STAT,1887,29,na,1916,5352.1331444450825
STAT,1931,34,50-100,1965,2.185255271495382
STAT,1915,18,35-39,1933,1.7691886618879193
SIM,1867,22,50-100,1889,1
STAT,1935,20,40-44,1955,9.255318459296193
STAT,1819,57,na,1876,2365.948492783433
STAT,1870,28,50-100,1898,1.2639347338582705
SIM,1841,33,25-29,1874,8
STAT,1957,5,na,1962,10467.77939199418
STAT,1814,50,15-19,1864,1.2712569888690425E-4
STAT,1852,53,na,1905,3376.640422431995
STAT,1948,18,50-100,1966,0.8655951145553632
SIM,1870,30,25-29,1900,29
STAT,1795,97,na,1892,2.2958914476930357
STAT,1871,42,35-39,1913,3.628951703544483
STAT,1899,30,20-24,1929,7.539861560490754
STAT,1881,41,15-19,1922,0.027079887946909725
STAT,1888,51,na,1939,5164.484801303429
STAT,1870,21,35-39,1891,11.605682003424471
STAT,1873,2,na,1875,6753.369731428815
STAT,1946,19,25-29,1965,97.0002424518376
SIM,1845,49,na,1894,3606
SIM,1900,31,na,1931,6970
SIM,1893,36,50-100,1929,6
SIM,1850,61,na,1911,2967
SIM,1923,18,35-39,1941,12
STAT,1921,46,15-19,1967,8.405675519524216E-4
STAT,1908,28,45-49,1936,3.288931882847279
SIM,1879,17,25-29,1896,14
STAT,1885,36,50-100,1921,2.4800058161882546
SIM,1820,37,20-24,1857,2
SIM,1889,43,25-29,1932,4
SIM,1837,24,45-49,1861,2
SIM,1794,94,na,1888,8
STAT,1852,33,35-39,1885,16.539054486169885
STAT,1859,22,50-100,1881,0.6801228451951061
STAT,1917,44,na,1961,7800.945318388027
STAT,1923,43,20-24,1966,0.041608458201624864
SIM,1859,22,30-34,1881,44
STAT,1939,28,na,1967,7603.121323733547
STAT,1802,84,na,1886,245.6117155041007
STAT,1884,51,35-39,1935,0.0172509386723038
SIM,1822,34,50-100,1856,2
STAT,1921,41,20-24,1962,0.04022093183947646
SIM,1838,25,15-19,1863,1
SIM,1855,9,na,1864,5110
SIM,1938,28,50-100,1966,3
STAT,1792,83,na,1875,271.37075115763804
STAT,1843,38,na,1881,3469.8320241721544
SIM,1906,32,30-34,1938,43
STAT,1882,41,na,1923,4567.700089186242
STAT,1870,51,40-44,1921,0.0209743869072171
SIM,1804,95,na,1899,6
STAT,1771,84,na,1855,153.767
SIM,1915,30,na,1945,7899
SIM,1860,38,na,1898,4070
STAT,1813,47,50-100,1860,1.5153463854891742
STAT,1822,54,30-34,1876,0.017110626435619638
STAT,1867,52,na,1919,4050.874041072546
STAT,1913,49,35-39,1962,0.2527250067029464
STAT,1915,15,na,1930,8202.571803391922
SIM,1857,34,na,1891,4152
SIM,1921,49,35-39,1970,1
SIM,1899,31,25-29,1930,36
STAT,1822,39,na,1861,3169.214724842874
STAT,1804,58,na,1862,2070.4351226001113
SIM,1819,87,na,1906,122
STAT,1919,45,20-24,1964,0.024316930938357514
SIM,1915,28,50-100,1943,1
STAT,1859,51,25-29,1910,0.0057209898269787165
STAT,1851,51,30-34,1902,0.009271689049528062
SIM,1882,23,na,1905,4956
STAT,1934,18,45-49,1952,1.3612383453964414
STAT,1932,18,50-100,1950,0.9993839607882342
STAT,1941,31,20-24,1972,5.175319027026717
STAT,1956,16,30-34,1972,32.577836398024075
SIM,1839,37,25-29,1876,9
SIM,1884,52,na,1936,4630
STAT,1851,21,25-29,1872,106.74064221805685
SIM,1878,25,45-49,1903,3
SIM,1858,19,na,1877,4515
STAT,1922,25,25-29,1947,151.39996582112417
STAT,1860,30,15-19,1890,0.2354377728758316
SIM,1875,15,na,1890,5685
STAT,1873,74,na,1947,2277.3484366994253
SIM,1838,42,na,1880,3364
STAT,1842,16,25-29,1858,10.898029784051495
STAT,1900,33,25-29,1933,28.574834587703936
STAT,1819,35,na,1854,3096.1194406572367
SIM,1845,50,35-39,1895,1
SIM,1912,17,20-24,1929,58
STAT,1841,54,40-44,1895,0.0148548320148152
SIM,1815,43,25-29,1858,2
SIM,1860,42,25-29,1902,4
STAT,1858,37,na,1895,3709.293625346075
STAT,1892,43,40-44,1935,5.645754455798204
STAT,1904,17,20-24,1921,51.390398062494846
STAT,1900,71,na,1971,4562.400519599272
SIM,1860,33,35-39,1893,19
STAT,1813,49,30-34,1862,0.5768053016061284
STAT,1920,48,na,1968,8177.080121344146
SIM,1835,48,50-100,1883,1
SIM,1882,34,25-29,1916,29
STAT,1837,38,na,1875,3596.8964125209054
STAT,1874,34,25-29,1908,20.99949135787849
SIM,1850,38,45-49,1888,6
STAT,1918,16,45-49,1934,0.2208158145178035
SIM,1807,91,na,1898,38
SIM,1900,53,na,1953,6109
STAT,1897,16,15-19,1913,16.060510327739667
STAT,1917,32,40-44,1949,8.275441082202548
SIM,1929,15,25-29,1944,138
SIM,1925,32,40-44,1957,16
SIM,1820,47,na,1867,2818
STAT,1837,50,35-39,1887,0.01253209224389764
SIM,1926,16,45-49,1942,1
STAT,1820,46,45-49,1866,0.8910251810213176
STAT,1887,49,30-34,1936,0.1207622551906211
STAT,1852,75,na,1927,1640.7671922527968
SIM,1817,43,na,1860,3025
SIM,1887,30,45-49,1917,8
STAT,1902,45,na,1947,6480.235034921488
SIM,1865,85,na,1950,421
STAT,1865,40,45-49,1905,2.773760876130424
STAT,1868,41,25-29,1909,1.2395048905395478
STAT,1893,28,35-39,1921,24.613135844340196
SIM,1825,57,na,1882,2267
SIM,1837,47,30-34,1884,1
STAT,1921,45,25-29,1966,0.1213099232376665
STAT,1923,44,na,1967,8734.831598674247
SIM,1830,35,25-29,1865,7
SIM,1930,20,45-49,1950,7
SIM,1933,21,25-29,1954,277
SIM,1867,43,25-29,1910,5
SIM,1881,42,50-100,1923,3
STAT,1889,67,na,1956,4003.559936705876
SIM,1853,42,40-44,1895,11
SIM,1898,18,35-39,1916,1
SIM,1827,34,40-44,1861,13
STAT,1896,29,15-19,1925,1.201118876558258
SIM,1806,74,na,1880,898
SIM,1802,60,na,1862,2059
STAT,1840,89,na,1929,151.63849216078796
STAT,1941,15,30-34,1956,25.37018174854464
STAT,1866,21,20-24,1887,130.40185868701644
SIM,1812,44,20-24,1856,1
STAT,1829,38,15-19,1867,0.09636858105764208
SIM,1848,24,30-34,1872,48
SIM,1870,36,50-100,1906,3
STAT,1869,54,20-24,1923,0.0014043528230813973
STAT,1882,49,40-44,1931,0.3297858012980804
SIM,1887,40,45-49,1927,6
STAT,1871,100,na,1971,17.262501281810295
SIM,1842,37,50-100,1879,5
SIM,1877,45,50-100,1922,1
STAT,1848,69,na,1917,2406.341519627108
SIM,1874,21,20-24,1895,134
SIM,1791,71,na,1862,1015
SIM,1915,30,20-24,1945,7
SIM,1860,40,35-39,1900,5
STAT,1849,24,25-29,1873,107.91241616404028
SIM,1834,93,na,1927,11
STAT,1871,57,na,1928,4032.3547810593436
SIM,1873,40,45-49,1913,5
STAT,1845,48,25-29,1893,0.0876426483756394
STAT,1897,50,na,1947,5896.475483004159
SIM,1881,25,30-34,1906,53
STAT,1925,21,25-29,1946,223.92856672250042
SIM,1842,25,na,1867,3937
STAT,1882,17,20-24,1899,34.8790537603489
STAT,1813,42,20-24,1855,1.1800994262101485
STAT,1850,48,35-39,1898,0.2119605851699629
STAT,1826,37,35-39,1863,16.760663995772116
STAT,1843,34,30-34,1877,28.79874010796658
STAT,1777,104,na,1881,0.058631882031762485
STAT,1923,31,15-19,1954,0.2986461265962505
SIM,1812,45,50-100,1857,1
SIM,1855,8,na,1863,5160
STAT,1847,38,35-39,1885,11.070783035671905
SIM,1899,18,50-100,1917,3
STAT,1858,75,na,1933,1620.8039574266445
SIM,1843,35,35-39,1878,18
STAT,1852,74,na,1926,1768.7923850852683
STAT,1873,19,20-24,1892,36.18484323263517
SIM,1855,38,35-39,1893,19
SIM,1910,14,na,1924,8241
STAT,1894,14,na,1908,6678.362822087533
SIM,1919,23,15-19,1942,12
SIM,1900,36,45-49,1936,1
STAT,1871,35,20-24,1906,1.561409255113483
SIM,1877,70,na,1947,2705
STAT,1852,32,30-34,1884,28.812028883067224
STAT,1840,26,30-34,1866,45.64912139082188
SIM,1853,43,50-100,1896,4
STAT,1898,28,na,1926,6499.61791541335
SIM,1851,34,30-34,1885,36
SIM,1897,24,50-100,1921,1
SIM,1860,32,30-34,1892,44
SIM,1834,37,35-39,1871,13
STAT,1835,35,35-39,1870,11.567990063441714
STAT,1893,20,25-29,1913,147.4161364064502
STAT,1845,42,40-44,1887,3.52948123015609
STAT,1855,21,45-49,1876,1.2373145613091785
STAT,1781,106,na,1887,0.02573855035109303
SIM,1856,33,na,1889,4018
SIM,1839,26,30-34,1865,58
SIM,1874,58,na,1932,3757
STAT,1880,33,20-24,1913,5.726685810635952
SIM,1870,44,na,1914,4447
SIM,1866,22,25-29,1888,126
STAT,1864,35,30-34,1899,9.712914265889834
STAT,1887,56,na,1943,4607.110371832382
SIM,1835,40,25-29,1875,2
SIM,1914,31,50-100,1945,2
STAT,1879,21,na,1900,5011.194748825557
STAT,1867,38,35-39,1905,13.311543281179086
STAT,1898,17,30-34,1915,4.35618502502608
SIM,1925,20,35-39,1945,24
STAT,1817,53,45-49,1870,0.06584775106899371
STAT,1886,43,40-44,1929,4.760686539233655
STAT,1861,32,25-29,1893,17.21790385514932
STAT,1932,17,na,1949,9844.115102044187
SIM,1912,27,50-100,1939,3
SIM,1863,28,15-19,1891,2
SIM,1825,44,30-34,1869,3
SIM,1907,31,25-29,1938,21
STAT,1894,31,25-29,1925,26.681975674857828
STAT,1847,29,20-24,1876,21.18659530339649
STAT,1883,42,na,1925,4580.485239531246
STAT,1891,61,na,1952,4664.828384174618
STAT,1871,17,45-49,1888,0.13191708932022334
STAT,1912,47,25-29,1959,0.10298590112468246
SIM,1837,42,na,1879,3293
STAT,1880,28,25-29,1908,89.68256375764372
STAT,1884,44,45-49,1928,2.944417395316628
STAT,1803,73,na,1876,1061.6370623837483
STAT,1861,25,35-39,1886,16.574932528063243
STAT,1879,40,45-49,1919,3.193519991648488
STAT,1851,45,45-49,1896,0.36949039758987606
STAT,1819,52,40-44,1871,0.04241693392546066
SIM,1839,33,50-100,1872,2
STAT,1858,22,25-29,1880,103.40978857421977
SIM,1797,96,na,1893,5
SIM,1889,25,30-34,1914,85
SIM,1936,33,50-100,1969,2
STAT,1876,40,20-24,1916,0.3350855049128819
SIM,1949,20,20-24,1969,272
STAT,1933,16,35-39,1949,11.373555249934974
SIM,1890,49,40-44,1939,1
SIM,1894,43,40-44,1937,1
STAT,1922,20,45-49,1942,2.620784796336387
STAT,1824,63,na,1887,1959.7228552449378
SIM,1855,29,20-24,1884,23
SIM,1858,43,30-34,1901,3
SIM,1888,28,20-24,1916,31
STAT,1807,87,na,1894,140.62881113540266
STAT,1798,93,na,1891,15.821179253307143
STAT,1829,47,30-34,1876,0.15273618789779483
SIM,1846,19,na,1865,4409
STAT,1843,50,35-39,1893,0.01223302593970298
SIM,1907,24,50-100,1931,5
SIM,1919,41,45-49,1960,2
STAT,1866,98,na,1964,20.984801371308173
SIM,1875,38,35-39,1913,26
STAT,1827,40,25-29,1867,1.2651213858874608
STAT,1859,43,25-29,1902,1.024803667240595
STAT,1817,44,30-34,1861,5.7751122393471945
SIM,1916,25,50-100,1941,5
SIM,1941,16,35-39,1957,10
SIM,1884,40,20-24,1924,1
SIM,1924,34,na,1958,9218
SIM,1903,37,25-29,1940,2
SIM,1890,18,35-39,1908,2
STAT,1853,26,40-44,1879,5.530305816759975
STAT,1862,39,15-19,1901,0.09595847582981541
STAT,1866,94,na,1960,70.7525121707628
SIM,1816,80,na,1896,517
STAT,1780,83,na,1863,238.92327294413295
STAT,1830,34,20-24,1864,5.177986849140738
STAT,1886,25,40-44,1911,6.429697426954984
SIM,1892,35,30-34,1927,24
STAT,1840,19,40-44,1859,0.3378058261200553
SIM,1877,28,45-49,1905,4
STAT,1896,38,30-34,1934,14.140450822588983
STAT,1836,29,45-49,1865,1.8833015405565805
STAT,1859,49,50-100,1908,0.3865562340727942
STAT,1858,40,25-29,1898,1.021225395714476
SIM,1920,29,25-29,1949,160
STAT,1911,59,na,1970,6607.100544300442
SIM,1861,26,40-44,1887,7
STAT,1884,35,30-34,1919,10.729560885199728
STAT,1917,20,35-39,1937,20.329956659460002
SIM,1916,49,50-100,1965,1
STAT,1855,28,15-19,1883,0.7079959147918088
SIM,1821,37,25-29,1858,6
STAT,1912,29,25-29,1941,130.09754581167485
SIM,1894,25,40-44,1919,2
SIM,1817,45,35-39,1862,1
STAT,1886,49,25-29,1935,0.12023592281222699
STAT,1896,22,45-49,1918,1.8593579812306302
STAT,1830,31,40-44,1861,8.734211564888469
SIM,1840,24,30-34,1864,43
SIM,1861,30,25-29,1891,27
STAT,1928,41,45-49,1969,0.42905115601016514
STAT,1833,71,na,1904,1754.7659995527856
SIM,1911,29,30-34,1940,98
STAT,1831,40,15-19,1871,0.022438743322001208
STAT,1818,42,25-29,1860,3.1649369281578617
STAT,1912,15,50-100,1927,0.15375789378268834
STAT,1844,50,25-29,1894,0.005802245761692227
STAT,1807,101,na,1908,0.4554759925941912
STAT,1876,36,35-39,1912,14.845450556275042
STAT,1843,43,45-49,1886,2.1311254045653802
SIM,1865,16,30-34,1881,6
STAT,1869,49,25-29,1918,0.11036621456813404
STAT,1892,19,na,1911,6351.235602817736
STAT,1838,55,na,1893,2798.375523887379
SIM,1827,29,45-49,1856,3
SIM,1906,28,35-39,1934,38
SIM,1936,23,na,1959,6299
STAT,1907,23,30-34,1930,52.70993260078374
STAT,1878,83,na,1961,1211.883427533
SIM,1875,30,25-29,1905,30
SIM,1826,42,25-29,1868,2
STAT,1873,36,na,1909,4857.866553098092
STAT,1778,89,na,1867,75.84087065439921
STAT,1911,27,na,1938,7380.431054430047
STAT,1947,18,30-34,1965,27.719152280612832
STAT,1881,31,15-19,1912,0.2791274022203996
STAT,1879,46,30-34,1925,0.20506836357948424
STAT,1899,20,20-24,1919,191.8281939748021
SIM,1851,43,45-49,1894,4
SIM,1817,58,na,1875,2402
SIM,1822,36,30-34,1858,13
SIM,1876,69,na,1945,3287
SIM,1887,40,50-100,1927,6
STAT,1770,109,na,1879,0.005263173365475474
STAT,1835,42,25-29,1877,0.99698766991853
SIM,1837,31,45-49,1868,2
STAT,1839,32,15-19,1871,0.2736388729430814
STAT,1814,40,15-19,1854,0.08589537729728945
SIM,1884,36,35-39,1920,20
STAT,1829,31,45-49,1860,3.4404032762236985
SIM,1905,31,na,1936,7254
STAT,1853,30,25-29,1883,17.03888814032033
STAT,1874,54,30-34,1928,0.011970865836397959
STAT,1933,20,20-24,1953,299.691046881881
STAT,1857,16,30-34,1873,2.966488038465024
STAT,1903,36,na,1939,6861.081756802756
STAT,1903,29,30-34,1932,71.89458087228174
SIM,1959,7,na,1966,10852
STAT,1862,33,50-100,1895,1.57494975571226
STAT,1828,27,45-49,1855,3.7814015740508284
STAT,1848,26,30-34,1874,49.650070548442706
STAT,1895,44,20-24,1939,0.028630670243182763
STAT,1905,15,na,1920,7411.014962666326
SIM,1932,23,30-34,1955,95
STAT,1849,17,35-39,1866,1.0683739929245533
SIM,1842,45,45-49,1887,1
STAT,1854,17,45-49,1871,0.11978961969355294
SIM,1867,36,35-39,1903,20
STAT,1885,21,na,1906,4768.802274638512
STAT,1781,102,na,1883,0.1668892889960745
STAT,1828,53,20-24,1881,0.0011452231461593452
STAT,1913,46,30-34,1959,0.1762085566310414
STAT,1819,72,na,1891,1321.4637827843987
SIM,1865,53,na,1918,3951
SIM,1872,40,50-100,1912,3
SIM,1837,29,50-100,1866,2
STAT,1933,29,50-100,1962,2.6668107503763734
STAT,1841,90,na,1931,114.39213410774262
STAT,1860,21,25-29,1881,97.48458502151036
SIM,1887,22,45-49,1909,3
SIM,1852,32,25-29,1884,21
SIM,1857,17,35-39,1874,2
SIM,1898,25,25-29,1923,127
STAT,1782,94,na,1876,8.21600565392811
STAT,1847,91,na,1938,88.33228138545688
STAT,1924,23,30-34,1947,68.26365875823959
STAT,1834,45,45-49,1879,0.37561424925700876
STAT,1879,22,45-49,1901,1.4730758630666672
SIM,1941,20,20-24,1961,224
SIM,1893,26,35-39,1919,30
STAT,1840,17,15-19,1857,11.09085769936903
SIM,1793,78,na,1871,529
SIM,1859,85,na,1944,352
SIM,1896,36,30-34,1932,23
SIM,1923,33,50-100,1956,3
STAT,1891,49,35-39,1940,0.19302723151418943
SIM,1932,18,35-39,1950,17
STAT,1833,53,30-34,1886,0.007920076924379835
STAT,1890,17,30-34,1907,3.9291367191660647
STAT,1869,44,50-100,1913,2.039506278784242
STAT,1963,1,na,1964,10100.9267020602
SIM,1866,39,na,1905,4522
STAT,1865,8,na,1873,5102.186883793177
SIM,1863,90,na,1953,147
SIM,1912,49,na,1961,7273
SIM,1859,53,na,1912,3721
SIM,1848,35,50-100,1883,4
STAT,1891,30,45-49,1921,4.3882385121002185
STAT,1913,39,40-44,1952,2.954329670812316
SIM,1836,48,25-29,1884,1
STAT,1879,37,na,1916,4976.947849150786
SIM,1826,94,na,1920,12
SIM,1846,21,45-49,1867,2
SIM,1947,19,35-39,1966,12
STAT,1862,37,na,1899,4066.8907107368855
STAT,1903,36,20-24,1939,0.4807415840818662
SIM,1853,27,45-49,1880,3
STAT,1805,50,15-19,1855,2.0109596274850498E-4
SIM,1868,35,40-44,1903,17
STAT,1882,6,na,1888,5195.798686344621
STAT,1895,18,45-49,1913,0.17145430924765698
SIM,1831,26,30-34,1857,61
STAT,1839,92,na,1931,65.03257536016568
STAT,1895,39,25-29,1934,7.500724283516313
SIM,1831,57,na,1888,2721
SIM,1903,25,50-100,1928,2
STAT,1907,47,45-49,1954,0.3933169932950147
SIM,1907,23,50-100,1930,2
STAT,1875,46,45-49,1921,0.492120236730633
SIM,1927,31,50-100,1958,4
STAT,1939,19,35-39,1958,8.47816169980102
STAT,1819,88,na,1907,143.65034795479065
STAT,1851,27,50-100,1878,1.1610726830479539
STAT,1885,26,35-39,1911,19.463770088550767
SIM,1921,39,40-44,1960,7
SIM,1818,39,45-49,1857,6
SIM,1883,46,45-49,1929,1
SIM,1906,15,30-34,1921,7
STAT,1845,27,45-49,1872,2.082477500563048
STAT,1924,18,35-39,1942,10.062672445395688
SIM,1915,23,30-34,1938,78
SIM,1840,93,na,1933,37
STAT,1838,21,45-49,1859,1.2332855117342785
STAT,1860,34,30-34,1894,28.39021807556606
SIM,1857,42,25-29,1899,1
STAT,1809,45,35-39,1854,1.1252296515221831
STAT,1872,41,15-19,1913,0.02815720136025836
SIM,1898,30,20-24,1928,11
SIM,1843,42,25-29,1885,4
SIM,1893,33,25-29,1926,29
STAT,1892,46,45-49,1938,0.33753158991703713
STAT,1907,30,20-24,1937,4.644217833041115
SIM,1913,50,na,1963,7287
STAT,1871,41,na,1912,4658.5210485640055
STAT,1823,102,na,1925,0.3518104100105665
STAT,1899,46,30-34,1945,0.15152378219561555
SIM,1857,24,25-29,1881,119
STAT,1867,36,na,1903,4477.600880229932
STAT,1924,30,20-24,1954,5.771653802346573
STAT,1849,42,25-29,1891,1.0145123022891915
STAT,1881,27,30-34,1908,49.157114976003214
STAT,1862,50,45-49,1912,0.025411345504861505
SIM,1826,35,35-39,1861,14
STAT,1934,12,na,1946,10825.467979808494
STAT,1937,31,45-49,1968,3.146638440743296
STAT,1811,92,na,1903,38.715811732155004
STAT,1838,45,30-34,1883,0.13828037302969418
SIM,1887,29,15-19,1916,1
SIM,1882,16,30-34,1898,4
STAT,1791,67,na,1858,1481.6820336796293
STAT,1885,33,25-29,1918,20.5037757388633
SIM,1902,38,50-100,1940,2
STAT,1899,15,25-29,1914,15.753477846331965
STAT,1874,16,30-34,1890,3.3040812308328915
STAT,1823,52,30-34,1875,0.017704014146050318
STAT,1839,50,45-49,1889,0.023223935981808833
SIM,1898,15,30-34,1913,6
SIM,1950,21,25-29,1971,229
STAT,1821,44,20-24,1865,0.47730918638906084
STAT,1841,16,20-24,1857,33.3722916237176
SIM,1857,21,20-24,1878,137
STAT,1879,29,15-19,1908,0.9515861085344478
STAT,1866,24,25-29,1890,106.00822586778881
STAT,1901,44,45-49,1945,0.28988140010572083
SIM,1864,19,20-24,1883,29
SIM,1830,32,20-24,1862,1
SIM,1840,19,35-39,1859,2
STAT,1888,14,na,1902,6144.6602606378765
SIM,1877,25,40-44,1902,8
SIM,1929,20,20-24,1949,291
STAT,1846,38,15-19,1884,0.08889331173664736
SIM,1848,27,35-39,1875,33
SIM,1865,24,30-34,1889,35
SIM,1836,25,na,1861,3706
SIM,1860,54,na,1914,3638
STAT,1869,31,na,1900,4688.950468148402
STAT,1893,41,35-39,1934,4.656436818080261
STAT,1926,26,50-100,1952,2.4176536304067726
SIM,1864,68,na,1932,2853
SIM,1842,31,25-29,1873,28
STAT,1856,19,20-24,1875,32.28138038947812
STAT,1870,22,25-29,1892,113.50815870766264
STAT,1835,32,30-34,1867,28.802287824722725
STAT,1922,27,na,1949,8558.842269304552
SIM,1844,34,40-44,1878,15
SIM,1881,28,35-39,1909,18
STAT,1942,21,25-29,1963,195.66560047272705
STAT,1918,47,20-24,1965,0.023746867969709155
STAT,1845,19,45-49,1864,0.12572837591076277
STAT,1836,34,40-44,1870,7.140166060931968
STAT,1822,32,20-24,1854,17.340781055129092
STAT,1941,18,35-39,1959,8.726575033049027
SIM,1883,37,50-100,1920,4
STAT,1924,3,na,1927,9752.3029826018
SIM,1880,26,25-29,1906,9
SIM,1879,38,20-24,1917,1
STAT,1890,43,30-34,1933,2.8136384778815193
STAT,1867,44,45-49,1911,2.792571805903611
STAT,1871,32,40-44,1903,8.701686784987125
STAT,1867,30,25-29,1897,19.528837625237585
STAT,1896,40,45-49,1936,0.27991751937342946
STAT,1868,51,25-29,1919,0.0068386357043401175
STAT,1903,39,25-29,1942,1.7690310427095493
SIM,1852,19,na,1871,4506
SIM,1875,44,45-49,1919,7
STAT,1880,5,na,1885,5733.185430142458
STAT,1863,22,na,1885,4264.497240220417
SIM,1929,28,30-34,1957,120
STAT,1844,32,25-29,1876,19.780183537778274
STAT,1924,32,50-100,1956,1.9475962298614558
STAT,1933,37,45-49,1970,1.8755121507418455
STAT,1862,16,40-44,1878,0.3637453609058793
SIM,1884,43,25-29,1927,2
STAT,1876,43,25-29,1919,1.3316861689589565
SIM,1890,20,na,1910,6293
SIM,1957,6,na,1963,10326
STAT,1865,22,15-19,1887,6.126666747989298
SIM,1918,20,45-49,1938,3
STAT,1809,52,25-29,1861,0.02610926129396618
STAT,1875,22,25-29,1897,119.03375269872804
SIM,1841,31,na,1872,3819
SIM,1874,24,25-29,1898,8
SIM,1816,64,na,1880,1915
STAT,1853,49,15-19,1902,6.19665997342556E-4
STAT,1887,44,15-19,1931,0.030772487681281487
SIM,1850,28,50-100,1878,1
SIM,1911,39,25-29,1950,2
STAT,1853,31,50-100,1884,1.5084577165816064
STAT,1903,20,na,1923,6841.4225423836915
STAT,1861,22,30-34,1883,30.761195830690863
STAT,1880,25,20-24,1905,25.128852765304877
STAT,1854,43,20-24,1897,0.2416996688395845
SIM,1848,10,na,1858,4587
SIM,1846,28,15-19,1874,1
STAT,1897,28,20-24,1925,31.559236825333787
SIM,1924,31,25-29,1955,25
STAT,1864,29,20-24,1893,21.027530807213193
SIM,1812,50,na,1862,2708
SIM,1877,44,50-100,1921,5
SIM,1839,34,30-34,1873,34
SIM,1874,17,35-39,1891,2
STAT,1874,49,35-39,1923,0.2834633662821925
SIM,1858,30,50-100,1888,6
STAT,1803,57,na,1860,2173.7252501975568
STAT,1887,28,na,1915,5371.6860817827765
STAT,1877,35,40-44,1912,9.267502507217083
STAT,1891,65,na,1956,4271.561782369833
SIM,1833,40,50-100,1873,8
STAT,1812,48,15-19,1860,0.0027315066804876366
STAT,1890,25,30-34,1915,62.49846242615388
SIM,1781,81,na,1862,297
STAT,1840,29,35-39,1869,17.117272718767143
STAT,1928,28,na,1956,9315.116265097666
SIM,1928,17,30-34,1945,43
SIM,1952,19,15-19,1971,109
SIM,1934,28,na,1962,10011
STAT,1787,93,na,1880,13.31117104911865
STAT,1873,28,35-39,1901,19.73044617718129
SIM,1854,32,50-100,1886,3
STAT,1823,34,30-34,1857,77.8511914792818
STAT,1858,18,40-44,1876,0.3344011703685907
STAT,1872,21,45-49,1893,1.4196550057834902
SIM,1811,65,na,1876,1719
SIM,1831,34,30-34,1865,14
STAT,1916,16,35-39,1932,1.8024187380174157
STAT,1895,47,25-29,1942,0.0851061976692529
SIM,1821,34,20-24,1855,6
SIM,1930,34,na,1964,10392
STAT,1908,25,40-44,1933,9.04129610939899
STAT,1826,50,35-39,1876,0.017228244837051855
SIM,1882,49,35-39,1931,2
SIM,1860,35,35-39,1895,17
STAT,1808,107,na,1915,0.0037058008236479935
SIM,1800,65,na,1865,1632
STAT,1780,112,na,1892,5.659609411274661E-4
STAT,1944,19,15-19,1963,98.5647650181258
SIM,1836,24,40-44,1860,5
SIM,1849,22,25-29,1871,131
STAT,1825,40,50-100,1865,2.5486336495181328
STAT,1832,54,na,1886,2790.7058201977766
STAT,1857,54,30-34,1911,0.009112802996282315
SIM,1804,79,na,1883,526
SIM,1895,36,na,1931,6567
STAT,1836,26,40-44,1862,5.1921273613005505
STAT,1809,58,na,1867,2314.643229880854
STAT,1849,53,40-44,1902,0.016385241926804656
STAT,1916,31,25-29,1947,19.350534475056236
STAT,1866,17,35-39,1883,1.049521782883919
STAT,1939,27,na,1966,7606.772574569344
SIM,1862,45,50-100,1907,2
STAT,1836,52,40-44,1888,0.014166005192435336
STAT,1911,55,na,1966,6805.739570550703
SIM,1839,37,na,1876,3528
STAT,1814,73,na,1887,1083.5349770951639
STAT,1852,35,35-39,1887,11.571902598051869
STAT,1950,20,20-24,1970,266.57734447383433
SIM,1913,44,50-100,1957,1
STAT,1834,31,25-29,1865,17.64683597020393
SIM,1852,25,35-39,1877,30
SIM,1853,96,na,1949,16
STAT,1890,76,na,1966,3034.6489776980843
STAT,1908,21,25-29,1929,172.13415643491538
STAT,1834,89,na,1923,139.60960335157202
SIM,1856,26,50-100,1882,1
SIM,1916,21,25-29,1937,220
STAT,1768,115,na,1883,3.3210169362312303E-4
STAT,1898,44,na,1942,6253.076800107851
STAT,1843,36,50-100,1879,2.028722055620482
STAT,1844,25,35-39,1869,19.35212983570213
SIM,1871,33,20-24,1904,5
STAT,1901,26,45-49,1927,3.150009657669424
STAT,1881,71,na,1952,2605.6392859752823
SIM,1838,37,20-24,1875,5
SIM,1834,43,45-49,1877,6
SIM,1878,32,45-49,1910,1
STAT,1856,40,na,1896,3637.797422468571
STAT,1838,39,20-24,1877,1.232992716102197
SIM,1844,26,40-44,1870,3
STAT,1870,15,35-39,1885,1.111413587198962
SIM,1874,47,35-39,1921,1
SIM,1848,19,35-39,1867,2
SIM,1884,33,30-34,1917,32
SIM,1858,99,na,1957,1
SIM,1868,43,50-100,1911,3
SIM,1888,22,50-100,1910,1
SIM,1895,37,25-29,1932,10
STAT,1781,77,na,1858,633.8047616996959
STAT,1906,18,50-100,1924,0.1438026129919199
STAT,1934,28,na,1962,10174.452208538147
SIM,1864,27,20-24,1891,21
STAT,1900,3,na,1903,7406.491090366588
STAT,1931,34,30-34,1965,41.6416094555081
STAT,1808,52,40-44,1860,0.06247868849542947
SIM,1818,75,na,1893,948
SIM,1906,25,30-34,1931,84
STAT,1873,25,30-34,1898,52.02524946223241
STAT,1899,19,40-44,1918,0.5034039166152265
STAT,1853,29,45-49,1882,1.82542948423259
SIM,1854,85,na,1939,378
SIM,1840,27,35-39,1867,24
SIM,1897,18,20-24,1915,37
STAT,1874,19,35-39,1893,1.1285986878434953
STAT,1889,18,20-24,1907,44.032503135103255
SIM,1890,15,30-34,1905,6
STAT,1858,101,na,1959,1.757914402708295
STAT,1869,46,20-24,1915,0.023549948694232808
SIM,1858,16,40-44,1874,1
SIM,1872,18,15-19,1890,11
SIM,1898,22,20-24,1920,195
STAT,1856,27,20-24,1883,18.94265058677756
SIM,1924,16,35-39,1940,12
STAT,1849,32,25-29,1881,17.072584213761882
STAT,1855,37,30-34,1892,8.036653563668546
SIM,1940,25,30-34,1965,98
SIM,1914,17,30-34,1931,3
STAT,1924,26,35-39,1950,35.41608912419834
SIM,1857,32,25-29,1889,23
STAT,1813,52,15-19,1865,1.4463849699079346E-4
SIM,1861,29,45-49,1890,4
STAT,1858,45,30-34,1903,0.15392309332850942
STAT,1871,29,15-19,1900,0.9038544396982906
STAT,1876,33,30-34,1909,36.316993414272716
SIM,1846,39,20-24,1885,4
SIM,1938,20,45-49,1958,2
STAT,1882,29,na,1911,4661.680145158611
SIM,1903,29,25-29,1932,129
STAT,1831,25,25-29,1856,75.79838517787891
STAT,1872,33,15-19,1905,0.2878308308613203
SIM,1849,48,35-39,1897,1
STAT,1895,15,40-44,1910,0.48356962041480783
STAT,1906,17,30-34,1923,4.690668846209973
STAT,1880,9,na,1889,5554.824170777447
SIM,1897,48,50-100,1945,1
STAT,1864,18,15-19,1882,11.017806548183183
SIM,1903,49,50-100,1952,1
SIM,1946,15,25-29,1961,108
STAT,1793,62,na,1855,1745.6808000000003
STAT,1852,27,35-39,1879,17.91204316048541
SIM,1847,56,na,1903,3077
STAT,1792,84,na,1876,219.62034891187642
STAT,1858,7,na,1865,4552.079533582779
STAT,1803,104,na,1907,0.04707207162441705
STAT,1875,71,na,1946,2775.519759453369
STAT,1918,29,15-19,1947,1.5062157014776212
SIM,1775,81,na,1856,274
SIM,1838,29,20-24,1867,18
SIM,1883,43,40-44,1926,9
SIM,1926,29,15-19,1955,4
SIM,1849,40,25-29,1889,2
STAT,1875,43,40-44,1918,4.643249401888791
SIM,1817,42,30-34,1859,4
SIM,1873,22,15-19,1895,4
STAT,1869,47,na,1916,4382.276268659076
STAT,1916,23,25-29,1939,194.87482191759662
SIM,1853,7,na,1860,4984
STAT,1938,15,25-29,1953,86.74928865297906
STAT,1888,20,45-49,1908,1.674483674252752
STAT,1832,27,35-39,1859,16.93635475632775
STAT,1923,12,na,1935,9393.576127772525
SIM,1945,21,15-19,1966,11
SIM,1908,34,50-100,1942,2
SIM,1937,19,25-29,1956,99
SIM,1904,30,45-49,1934,8
SIM,1936,3,na,1939,7033
SIM,1818,36,40-44,1854,8
STAT,1846,74,na,1920,1699.8732904974686
STAT,1905,44,30-34,1949,0.23003394886206913
SIM,1875,16,na,1891,5654
STAT,1910,33,na,1943,7336.5751673884415
STAT,1780,99,na,1879,0.6560508031026777
SIM,1896,20,45-49,1916,1
SIM,1924,23,25-29,1947,242
STAT,1799,94,na,1893,13.591767386392409
STAT,1898,25,30-34,1923,69.29126817601579
STAT,1851,37,na,1888,3691.305628139232
SIM,1896,39,35-39,1935,9
STAT,1877,27,40-44,1904,6.282171408687903
STAT,1867,51,35-39,1918,0.016361296139016806
STAT,1813,45,25-29,1858,0.36802134943635617
STAT,1848,29,35-39,1877,18.61752805289688
STAT,1880,36,25-29,1916,6.155185556804496
SIM,1906,18,35-39,1924,2
SIM,1829,48,35-39,1877,2
SIM,1947,16,30-34,1963,44
STAT,1834,42,40-44,1876,3.6095107877156756
STAT,1875,32,25-29,1907,21.297975441187322
SIM,1819,88,na,1907,92
SIM,1852,32,50-100,1884,1
SIM,1862,38,25-29,1900,8
SIM,1856,17,20-24,1873,30
STAT,1857,24,30-34,1881,29.035772511893942
SIM,1860,27,35-39,1887,21
STAT,1823,77,na,1900,1037.2718232080906
SIM,1876,41,25-29,1917,2
SIM,1946,13,na,1959,8631
SIM,1925,27,50-100,1952,4
STAT,1929,19,25-29,1948,111.08443066611903
STAT,1836,91,na,1927,77.04644189811536
STAT,1881,54,20-24,1935,0.0014008664045775476
SIM,1843,32,30-34,1875,50
STAT,1866,47,35-39,1913,0.2596708919920121
SIM,1872,35,30-34,1907,19
STAT,1921,6,na,1927,9224.725605231299
STAT,1939,16,30-34,1955,24.65045211712773
STAT,1899,13,na,1912,7135.084298584112
SIM,1842,42,40-44,1884,8
SIM,1865,31,20-24,1896,8
SIM,1913,44,30-34,1957,1
SIM,1883,32,25-29,1915,22
STAT,1848,17,20-24,1865,36.03607574516305
STAT,1859,36,35-39,1895,11.424367487275815
STAT,1864,53,30-34,1917,0.010573652428769289
STAT,1880,22,na,1902,5031.813592334701
STAT,1932,25,30-34,1957,103.74703232980235
SIM,1932,15,30-34,1947,47
SIM,1866,70,na,1936,2632
STAT,1882,41,50-100,1923,2.0878644707429332
SIM,1884,20,na,1904,5168
STAT,1828,45,20-24,1873,0.022190735848704343
STAT,1909,45,na,1954,6887.136553827689
SIM,1822,39,35-39,1861,16
STAT,1841,48,40-44,1889,0.2463488293513378
STAT,1905,31,na,1936,7057.904550359729
STAT,1834,93,na,1927,38.83873239134521
STAT,1849,21,20-24,1870,132.74422364871907
STAT,1850,53,30-34,1903,0.008980322571835874
SIM,1816,41,25-29,1857,2
SIM,1881,16,na,1897,4428
STAT,1861,50,25-29,1911,0.006039717084634426
SIM,1898,33,25-29,1931,32
SIM,1870,24,40-44,1894,3
STAT,1917,12,na,1929,8582.40035190409
SIM,1905,19,50-100,1924,3
STAT,1815,42,na,1857,2962.1744252120693
STAT,1862,24,40-44,1886,3.6295961905876455
STAT,1818,46,40-44,1864,0.766472187228227
STAT,1857,31,20-24,1888,4.326105777195032
STAT,1924,15,30-34,1939,29.442613053696086
SIM,1876,53,na,1929,4640
STAT,1895,36,20-24,1931,2.0383531926584704
STAT,1896,19,50-100,1915,0.12993277245738533
STAT,1831,32,15-19,1863,0.2402406887086405
SIM,1918,30,50-100,1948,3
STAT,1830,28,15-19,1858,0.9880781730331869
STAT,1918,22,45-49,1940,2.450442558821392
STAT,1901,8,na,1909,7349.87643678256
SIM,1885,27,40-44,1912,9
STAT,1888,39,35-39,1927,16.71359902854051
STAT,1921,27,25-29,1948,148.11700058993122
STAT,1937,21,15-19,1958,10.474731238082928
SIM,1840,16,30-34,1856,8
STAT,1852,43,na,1895,3657.0675169314513
SIM,1940,28,na,1968,7911
STAT,1867,83,na,1950,750.8709679547659
STAT,1908,22,50-100,1930,1.2225106892066633
SIM,1865,27,35-39,1892,23
STAT,1900,17,35-39,1917,1.5372769890064364
SIM,1861,34,40-44,1895,10
STAT,1924,33,25-29,1957,21.758457068140252
STAT,1863,44,50-100,1907,1.8424915287996129
STAT,1814,44,30-34,1858,6.182138477053999
SIM,1923,21,15-19,1944,15
STAT,1840,52,30-34,1892,0.008546409691868628
STAT,1843,35,45-49,1878,3.328419868867425
SIM,1921,21,na,1942,8289
STAT,1825,46,35-39,1871,0.30780459080673805
STAT,1916,37,45-49,1953,1.4099246057488337
SIM,1880,23,20-24,1903,140
SIM,1887,32,na,1919,5863
STAT,1860,32,40-44,1892,7.112574286522358
STAT,1907,50,na,1957,6554.42919909113
SIM,1891,39,35-39,1930,19
SIM,1884,41,35-39,1925,5
SIM,1833,23,25-29,1856,104
STAT,1874,50,50-100,1924,0.03168000485383853
STAT,1863,33,20-24,1896,4.758573083241418
STAT,1903,18,15-19,1921,17.02046027796041
STAT,1951,15,40-44,1966,3.3653956339766835
STAT,1907,29,50-100,1936,1.8693991713263702
STAT,1851,31,25-29,1882,16.698551671951385
STAT,1860,37,35-39,1897,11.600177087743125
STAT,1872,28,15-19,1900,0.9176568618579524
STAT,1879,42,15-19,1921,0.029137032299062334
STAT,1919,38,25-29,1957,2.133693941976267
STAT,1834,37,50-100,1871,2.0328453811804947
SIM,1822,44,30-34,1866,4
SIM,1847,36,30-34,1883,15
STAT,1946,21,45-49,1967,2.5294047362459016
SIM,1868,98,na,1966,10
STAT,1858,38,50-100,1896,1.9233931196470073
SIM,1851,35,45-49,1886,7
STAT,1852,37,50-100,1889,1.9674066167941113
STAT,1883,39,35-39,1922,13.893357642246045
STAT,1892,37,35-39,1929,17.882438342709417
SIM,1880,28,15-19,1908,1
SIM,1794,84,na,1878,204
SIM,1952,13,na,1965,9762
SIM,1911,18,15-19,1929,18
SIM,1866,40,25-29,1906,2
SIM,1835,71,na,1906,1708
STAT,1853,34,40-44,1887,6.920755561882237
STAT,1825,41,na,1866,3202.8905902703327
STAT,1922,32,50-100,1954,1.8861680998598538
SIM,1833,46,35-39,1879,1
STAT,1915,21,15-19,1936,11.14744609885524
STAT,1916,27,na,1943,7822.721888865958
SIM,1932,33,25-29,1965,34
STAT,1951,20,35-39,1971,22.733782422898066
SIM,1838,52,na,1890,2943
SIM,1875,47,na,1922,5033
SIM,1835,19,na,1854,4122
SIM,1946,19,50-100,1965,1
SIM,1820,42,na,1862,2991
SIM,1856,40,45-49,1896,5
STAT,1881,35,30-34,1916,10.502574853567637
SIM,1929,23,25-29,1952,270
STAT,1918,35,50-100,1953,0.9020879060631243
SIM,1824,48,35-39,1872,1
SIM,1900,52,na,1952,6173
SIM,1852,22,30-34,1874,49
STAT,1809,50,35-39,1859,0.06606862759771283
STAT,1913,42,15-19,1955,0.0030252907339855003
STAT,1912,13,na,1925,8055.052789921397
SIM,1837,73,na,1910,1484
STAT,1857,27,35-39,1884,15.645229559140535
STAT,1937,17,30-34,1954,23.95282387417618
STAT,1825,41,25-29,1866,1.5155466525129826
STAT,1898,49,50-100,1947,0.37073314980084776
STAT,1913,1,na,1914,8597.220965606506
STAT,1851,96,na,1947,13.310887286698232
STAT,1892,71,na,1963,3830.570209921587
SIM,1856,29,35-39,1885,22
STAT,1922,48,25-29,1970,0.12269845029029604
STAT,1911,26,50-100,1937,1.9677054841014983
STAT,1876,41,35-39,1917,3.7996510678535023
STAT,1840,58,na,1898,2854.54399827088
SIM,1856,22,15-19,1878,7
SIM,1896,28,30-34,1924,79
STAT,1837,43,20-24,1880,0.2579270962934471
SIM,1893,72,na,1965,3765
STAT,1813,56,na,1869,2343.70381810707
STAT,1849,50,25-29,1899,0.0056832636609140215
STAT,1849,55,na,1904,3270.7057024036103
STAT,1840,25,na,1865,3949.8830372409006
SIM,1878,17,na,1895,5499
STAT,1861,95,na,1956,25.773421862052775
SIM,1945,17,30-34,1962,36
STAT,1851,36,35-39,1887,11.197404259952664
STAT,1840,53,20-24,1893,0.0010480406087823634
STAT,1844,22,30-34,1866,35.91535905583273
SIM,1805,64,na,1869,1698
STAT,1881,47,50-100,1928,0.47719602787227977
SIM,1826,67,na,1893,1790
STAT,1923,43,50-100,1966,0.27678669493451824
STAT,1840,34,30-34,1874,30.0650322399329
SIM,1835,44,40-44,1879,6
SIM,1889,35,25-29,1924,9
STAT,1899,47,45-49,1946,0.36665424238156924
SIM,1870,42,40-44,1912,7
STAT,1942,27,45-49,1969,3.6620925772809834
SIM,1818,41,50-100,1859,1
SIM,1932,26,35-39,1958,46
STAT,1869,20,30-34,1889,35.21564744416716
SIM,1862,73,na,1935,2034
SIM,1956,12,na,1968,10692
STAT,1859,47,40-44,1906,0.2739191416508812
STAT,1909,20,25-29,1929,174.51133070273693
STAT,1848,22,15-19,1870,6.586539190376078
SIM,1845,43,20-24,1888,1
STAT,1920,32,na,1952,8364.637784211873
SIM,1889,67,na,1956,3940
SIM,1900,22,25-29,1922,168
STAT,1922,47,35-39,1969,0.2990567808713606
SIM,1879,36,30-34,1915,17
SIM,1912,24,20-24,1936,231
STAT,1862,42,40-44,1904,3.877922501555253
STAT,1852,105,na,1957,0.07094072325225798
STAT,1890,21,15-19,1911,8.157161716730645
SIM,1927,38,25-29,1965,5
STAT,1836,30,25-29,1866,17.57907640686033
SIM,1909,4,na,1913,8011
SIM,1872,94,na,1966,140
STAT,1880,86,na,1966,967.9282766183771
SIM,1939,31,20-24,1970,4
SIM,1851,30,na,1881,4005
STAT,1888,28,30-34,1916,59.89924458352329
STAT,1928,33,50-100,1961,2.0863082214097424
SIM,1893,65,na,1958,4559
STAT,1897,29,50-100,1926,1.714597625144457
SIM,1920,19,30-34,1939,36
SIM,1843,11,na,1854,4588
STAT,1841,19,25-29,1860,10.479703561480614
SIM,1847,25,na,1872,3935
STAT,1858,43,40-44,1901,3.515719529312525
STAT,1827,44,40-44,1871,4.121003368209645
STAT,1838,70,na,1908,1898.8744756782735
STAT,1837,105,na,1942,0.040865847099755576
STAT,1845,16,40-44,1861,0.3583340804951552
STAT,1908,49,50-100,1957,0.4109649095902842
SIM,1866,43,40-44,1909,10
STAT,1904,42,20-24,1946,0.031928821075834064
STAT,1925,30,35-39,1955,21.93676148380556
SIM,1919,31,15-19,1950,3
STAT,1826,43,45-49,1869,3.097590876368224
STAT,1912,19,30-34,1931,4.952422069607125
STAT,1910,34,45-49,1944,3.039173339810957
SIM,1889,21,15-19,1910,11
STAT,1947,19,na,1966,8367.663877607078
SIM,1820,41,na,1861,3042
SIM,1877,20,30-34,1897,46
SIM,1929,30,45-49,1959,4
STAT,1857,49,35-39,1906,0.21578604663151976
SIM,1885,46,na,1931,4779
STAT,1839,36,30-34,1875,10.04839978899431
SIM,1801,75,na,1876,772
SIM,1892,30,25-29,1922,42
SIM,1843,40,35-39,1883,6
STAT,1894,35,40-44,1929,11.464837957914613
STAT,1889,41,45-49,1930,3.74384625419651
STAT,1918,38,na,1956,7999.220855403567
SIM,1829,37,30-34,1866,15
STAT,1821,47,25-29,1868,0.16859207859969158
STAT,1904,49,40-44,1953,0.27408954324398915
STAT,1931,41,15-19,1972,0.004149490535711437
STAT,1842,16,35-39,1858,1.0552558924587974
STAT,1893,34,45-49,1927,4.425753405645189
STAT,1815,54,25-29,1869,0.017519304184860494
SIM,1830,39,40-44,1869,15
SIM,1920,15,50-100,1935,1
STAT,1837,69,na,1906,2045.3966955551657
SIM,1844,30,25-29,1874,27
STAT,1921,34,20-24,1955,5.433820822226661
SIM,1940,28,35-39,1968,47
STAT,1908,39,na,1947,7047.045295275424
STAT,1834,25,na,1859,3824.1173376622314
STAT,1835,40,35-39,1875,2.8843665704477934
STAT,1896,46,30-34,1942,0.14600905529934702
STAT,1849,112,na,1961,1.2055008486585173E-4
SIM,1871,54,na,1925,4032
SIM,1892,36,45-49,1928,11
STAT,1855,55,na,1910,3117.976371675893
SIM,1831,26,na,1857,3945
SIM,1903,26,20-24,1929,34
STAT,1932,28,35-39,1960,39.69902565351292
SIM,1784,85,na,1869,116
SIM,1855,39,na,1894,4091
STAT,1877,53,40-44,1930,0.0217236581865799
SIM,1891,20,45-49,1911,3
STAT,1842,38,35-39,1880,12.225193691692844
STAT,1882,45,25-29,1927,0.11445181975391966
STAT,1863,20,50-100,1883,0.7459740834721493
STAT,1912,26,20-24,1938,36.464381613285056
STAT,1892,25,50-100,1917,1.6283041515164849
SIM,1920,26,20-24,1946,46
SIM,1923,28,35-39,1951,39
SIM,1864,25,30-34,1889,60
STAT,1915,28,35-39,1943,30.821093344283284
STAT,1898,26,50-100,1924,1.7543352459574777
STAT,1883,20,45-49,1903,1.391932432552035
STAT,1921,49,40-44,1970,0.35676751193391654
SIM,1850,55,na,1905,3311
STAT,1856,25,30-34,1881,41.25118820293567
STAT,1916,20,20-24,1936,236.72225787579302
SIM,1848,20,15-19,1868,6
STAT,1797,99,na,1896,0.9163969221996476
SIM,1862,18,na,1880,4910
SIM,1919,27,30-34,1946,102
SIM,1868,27,40-44,1895,8
STAT,1868,45,40-44,1913,0.33224496087138905
SIM,1848,34,25-29,1882,23
STAT,1896,64,na,1960,4880.3493117934995
STAT,1892,50,na,1942,5522.226723013438
STAT,1925,25,40-44,1950,11.191616031608834
STAT,1869,25,40-44,1894,5.901908092307089
SIM,1850,38,35-39,1888,21
STAT,1848,17,na,1865,4665.853630658778
SIM,1828,43,20-24,1871,2
SIM,1895,34,20-24,1929,8
STAT,1888,45,na,1933,5424.0582001824205
SIM,1897,23,15-19,1920,7
STAT,1904,24,20-24,1928,198.50885444027102
STAT,1879,40,50-100,1919,2.2542493994096793
STAT,1878,49,15-19,1927,8.261033414579807E-4
SIM,1867,24,na,1891,4772
STAT,1890,47,25-29,1937,0.07972245505605977
STAT,1910,16,45-49,1926,0.20047142561503642
SIM,1841,18,35-39,1859,1
STAT,1865,26,30-34,1891,46.36259270335749
SIM,1790,85,na,1875,151
SIM,1883,35,na,1918,4902
STAT,1833,40,na,1873,3435.547870333272
STAT,1887,34,20-24,1921,6.053375155414332
STAT,1888,19,15-19,1907,14.0901889948942
SIM,1810,79,na,1889,593
SIM,1935,34,na,1969,10851
STAT,1858,48,35-39,1906,0.21764899872892787
STAT,1852,40,35-39,1892,2.9152152581462865
SIM,1885,35,40-44,1920,10
SIM,1931,20,na,1951,9595
STAT,1773,86,na,1859,123.94126318349237
STAT,1904,24,50-100,1928,1.1746782382330274
SIM,1903,29,na,1932,6940
STAT,1812,53,45-49,1865,0.09429824179735814
STAT,1889,23,15-19,1912,8.189952624784684
STAT,1898,35,25-29,1933,7.9438322647096244
SIM,1928,31,45-49,1959,5
STAT,1832,82,na,1914,608.2918519604417
SIM,1862,40,na,1902,4256
STAT,1831,27,15-19,1858,0.7908345899010351
STAT,1858,46,45-49,1904,0.37261766002489394
STAT,1859,40,20-24,1899,0.25786620172103897
SIM,1933,25,40-44,1958,24
STAT,1880,40,35-39,1920,3.8915130465917303
SIM,1889,28,35-39,1917,29
STAT,1950,16,35-39,1966,10.022566132210098
STAT,1832,54,25-29,1886,0.004616699803912892
STAT,1865,72,na,1937,2317.1737641232357
SIM,1818,44,40-44,1862,9
SIM,1873,26,30-34,1899,63
SIM,1852,74,na,1926,1720
STAT,1898,28,35-39,1926,26.27854073603225
SIM,1869,39,25-29,1908,9
STAT,1849,37,50-100,1886,1.9872218952462142
STAT,1929,22,20-24,1951,283.96027917716157
STAT,1905,40,15-19,1945,0.002829241592838966
STAT,1903,51,na,1954,6221.362836249702
STAT,1817,45,45-49,1862,1.175964368613659
SIM,1941,29,50-100,1970,3
SIM,1924,20,20-24,1944,279
STAT,1861,30,35-39,1891,17.160521756348782
STAT,1922,40,15-19,1962,0.003568809102474639
STAT,1886,71,na,1957,2969.660757668914
SIM,1886,44,20-24,1930,1
SIM,1896,19,15-19,1915,18
STAT,1874,30,45-49,1904,3.6350618890991315
STAT,1841,44,25-29,1885,0.9436857651137823
SIM,1871,5,na,1876,5393
SIM,1869,21,35-39,1890,11
STAT,1916,31,na,1947,7918.173359041913
STAT,1821,41,40-44,1862,7.357558054421517
SIM,1937,22,20-24,1959,213
STAT,1857,34,25-29,1891,15.985830129732822
STAT,1930,39,40-44,1969,3.935112832421228
SIM,1915,14,na,1929,8398
STAT,1844,55,na,1899,3339.1796389861424
STAT,1940,31,15-19,1971,0.2687783866765423
SIM,1882,19,35-39,1901,2
STAT,1929,15,30-34,1944,31.5589074119208
SIM,1869,44,20-24,1913,1
STAT,1816,48,35-39,1864,0.6774174714374458
STAT,1853,54,45-49,1907,0.022330134804665027
SIM,1895,20,na,1915,6562
STAT,1822,46,30-34,1868,0.3052978691684589
SIM,1870,20,25-29,1890,125
STAT,1928,12,na,1940,10081.587759999686
STAT,1852,33,45-49,1885,2.847929521121143
STAT,1930,32,20-24,1962,6.35734978196131
STAT,1854,50,35-39,1904,0.013387232973415023
SIM,1860,33,45-49,1893,6
STAT,1820,97,na,1917,6.014264931727385
STAT,1869,16,na,1885,5040.588342977739
SIM,1855,91,na,1946,66
STAT,1837,48,15-19,1885,5.714897061057121E-4
SIM,1839,37,35-39,1876,17
SIM,1882,30,45-49,1912,4
STAT,1884,36,45-49,1920,3.9946862191790475
STAT,1878,44,20-24,1922,0.3304627752723823
SIM,1859,45,40-44,1904,2
SIM,1838,35,30-34,1873,11
STAT,1872,51,na,1923,4391.282255473506
SIM,1841,19,na,1860,4228
STAT,1853,91,na,1944,91.68512010945149
STAT,1856,36,na,1892,3688.8384004823038
SIM,1913,21,50-100,1934,1
STAT,1859,33,30-34,1892,27.947867073812247
STAT,1846,10,na,1856,4650.921151852499
SIM,1859,37,40-44,1896,10
SIM,1835,78,na,1913,902
STAT,1875,16,na,1891,5264.521161611868
SIM,1876,45,40-44,1921,1
SIM,1921,14,na,1935,9136
SIM,1865,34,25-29,1899,22
SIM,1841,48,35-39,1889,1
STAT,1853,37,45-49,1890,3.154097569622093
STAT,1822,39,40-44,1861,15.926938676427874
SIM,1860,24,30-34,1884,39
STAT,1837,17,45-49,1854,0.17827415934252977
STAT,1862,20,25-29,1882,102.62674755822844
SIM,1937,15,30-34,1952,30
STAT,1897,26,30-34,1923,68.2154089926726
STAT,1852,24,30-34,1876,33.24272144689576
SIM,1849,91,na,1940,56
STAT,1849,54,na,1903,3312.2175211232075
STAT,1833,48,35-39,1881,0.19401713215945082
SIM,1924,37,45-49,1961,3
STAT,1887,39,15-19,1926,0.12556490931764494
SIM,1904,20,15-19,1924,7
STAT,1808,46,35-39,1854,0.9114819757161271
STAT,1860,35,45-49,1895,3.3005340053659813
STAT,1863,36,25-29,1899,5.114633713371737
SIM,1844,55,na,1899,2956
SIM,1859,41,50-100,1900,2
SIM,1895,29,25-29,1924,120
STAT,1839,39,35-39,1878,12.926297701559346
STAT,1835,46,40-44,1881,0.23683959908101915
STAT,1919,35,20-24,1954,0.5750214283909526
STAT,1889,27,30-34,1916,62.70879404217094
STAT,1904,45,25-29,1949,0.09512249125437959
STAT,1907,33,25-29,1940,17.384168707549623
STAT,1807,56,na,1863,2424.042545219666
SIM,1910,32,45-49,1942,7
SIM,1894,6,na,1900,7078
STAT,1843,70,na,1913,1965.4512073594994
STAT,1895,20,na,1915,6261.0696983885855
STAT,1831,44,na,1875,3225.2875799607805
SIM,1851,37,35-39,1888,9
SIM,1899,45,45-49,1944,1
SIM,1891,36,30-34,1927,19
STAT,1801,78,na,1879,675.8388828279564
SIM,1861,37,45-49,1898,9
STAT,1908,35,na,1943,7186.298839715456
STAT,1792,77,na,1869,680.3400418040368
STAT,1878,21,35-39,1899,12.345943372337342
SIM,1913,20,45-49,1933,2
STAT,1879,38,30-34,1917,11.202768380218297
STAT,1779,112,na,1891,8.424851003937806E-4
SIM,1887,38,30-34,1925,16
STAT,1920,18,15-19,1938,102.54060308761848
SIM,1888,26,30-34,1914,3
SIM,1850,92,na,1942,50
SIM,1811,64,na,1875,1785
STAT,1847,84,na,1931,507.0924210672254
STAT,1845,45,20-24,1890,0.018675578479301347
SIM,1828,38,25-29,1866,3
STAT,1871,38,25-29,1909,5.74849770059482
SIM,1838,38,35-39,1876,21
STAT,1771,108,na,1879,0.007596665276396216
STAT,1888,82,na,1970,1976.2375432976437
SIM,1828,92,na,1920,63
STAT,1800,54,30-34,1854,0.03575559319510705
STAT,1930,42,15-19,1972,0.004080739284600986
SIM,1834,34,30-34,1868,36
SIM,1843,46,40-44,1889,1
STAT,1778,85,na,1863,176.7930338188978
SIM,1859,84,na,1943,427
SIM,1856,40,na,1896,3934
SIM,1812,47,25-29,1859,1
SIM,1927,35,20-24,1962,2
STAT,1906,43,30-34,1949,0.23325366155382407
STAT,1934,20,35-39,1954,25.64332655479669
STAT,1826,34,30-34,1860,46.04437269191028
SIM,1824,45,30-34,1869,1
STAT,1836,49,15-19,1885,5.426186256094748E-4
SIM,1907,37,45-49,1944,3
SIM,1859,41,25-29,1900,1
SIM,1897,27,30-34,1924,87
STAT,1902,32,45-49,1934,4.972240721748267
STAT,1893,25,30-34,1918,64.89992779943042
STAT,1853,34,50-100,1887,1.4621918467582706
STAT,1819,41,na,1860,3008.9488905064263
STAT,1875,37,35-39,1912,14.707090396718192
STAT,1809,49,50-100,1858,1.8360145788767475
SIM,1840,18,20-24,1858,37
STAT,1897,29,35-39,1926,25.862477164747506
STAT,1901,46,15-19,1947,6.397593462795899E-4
STAT,1887,29,25-29,1916,94.86722480575142
SIM,1896,46,na,1942,6338
STAT,1838,104,na,1942,0.09026964142751112
STAT,1896,42,15-19,1938,0.002553910989875136
SIM,1885,31,25-29,1916,17
STAT,1905,20,45-49,1925,2.048875616453009
STAT,1913,20,15-19,1933,10.48238963849029
SIM,1909,22,45-49,1931,3
STAT,1843,32,40-44,1875,7.303255587419667
SIM,1935,13,na,1948,11237
STAT,1851,40,50-100,1891,1.654218274415368
SIM,1939,27,na,1966,7787
SIM,1851,32,40-44,1883,12
SIM,1959,3,na,1962,10857
STAT,1883,36,30-34,1919,10.626238973865142
STAT,1835,33,45-49,1868,2.8469666646788254
STAT,1922,44,30-34,1966,0.29529513321373774
SIM,1817,49,50-100,1866,2
SIM,1937,4,na,1941,8100
STAT,1882,15,30-34,1897,3.1503427083092435
STAT,1912,44,20-24,1956,0.03414283433295627
SIM,1921,32,20-24,1953,7
SIM,1942,20,35-39,1962,26
STAT,1817,111,na,1928,1.0825826597173217E-4
STAT,1921,17,na,1938,8471.412140979905
SIM,1843,33,45-49,1876,8
STAT,1830,37,25-29,1867,5.3959134864429945
STAT,1869,16,50-100,1885,0.09777767393866994
SIM,1917,36,50-100,1953,1
SIM,1826,63,na,1889,1989
STAT,1835,26,50-100,1861,1.0880810313759617
SIM,1857,37,50-100,1894,3
SIM,1907,35,40-44,1942,3
SIM,1886,18,45-49,1904,2
STAT,1816,45,30-34,1861,0.4904240442990721
STAT,1867,35,30-34,1902,10.176230199357608
SIM,1869,19,20-24,1888,32
SIM,1863,58,na,1921,3619
STAT,1850,53,50-100,1903,0.022784785309352882
SIM,1866,38,50-100,1904,3
SIM,1865,46,30-34,1911,2
SIM,1866,46,45-49,1912,2
STAT,1883,51,50-100,1934,0.030111369122880483
STAT,1933,23,25-29,1956,247.39511070539876
SIM,1846,37,30-34,1883,9
SIM,1941,23,25-29,1964,199
STAT,1837,46,25-29,1883,0.08443050467024454
SIM,1930,35,na,1965,10498
STAT,1899,6,na,1905,7228.754885702841
STAT,1817,47,35-39,1864,0.6761489537320995
SIM,1889,32,20-24,1921,9
SIM,1900,15,35-39,1915,1
SIM,1861,34,50-100,1895,2
STAT,1827,47,45-49,1874,0.42621289952029046
SIM,1856,26,30-34,1882,65
STAT,1850,18,35-39,1868,1.0220231916400668
STAT,1945,25,20-24,1970,40.47761667698211
SIM,1827,52,na,1879,2806
STAT,1909,36,50-100,1945,0.8069096513960479
SIM,1923,28,na,1951,8991
SIM,1845,77,na,1922,1263
STAT,1857,46,30-34,1903,0.15281490484151708
STAT,1894,38,45-49,1932,5.146242956149935
STAT,1884,38,35-39,1922,14.03535605163477
SIM,1847,39,35-39,1886,22
SIM,1867,40,20-24,1907,1
SIM,1890,42,20-24,1932,1
STAT,1910,31,40-44,1941,7.654551559832693
STAT,1859,17,na,1876,4283.199218371324
STAT,1813,63,na,1876,1936.0570235152563
STAT,1882,57,na,1939,3953.741348609525
SIM,1864,28,35-39,1892,27
SIM,1854,28,25-29,1882,94
SIM,1892,38,35-39,1930,32
STAT,1817,77,na,1894,871.8479075204021
STAT,1883,35,na,1918,4719.300883828734
STAT,1936,2,na,1938,7909.613226041915
SIM,1906,21,15-19,1927,7
SIM,1942,26,50-100,1968,1
STAT,1861,36,40-44,1897,7.39403640814458
SIM,1842,36,35-39,1878,19
STAT,1840,96,na,1936,12.394327940490808
SIM,1855,18,15-19,1873,11
STAT,1847,18,15-19,1865,11.224151508544663
SIM,1916,46,na,1962,7751
SIM,1881,19,20-24,1900,28
SIM,1844,29,45-49,1873,4
STAT,1901,65,na,1966,5299.243424171266
SIM,1825,47,35-39,1872,2
STAT,1863,47,30-34,1910,0.17033495514844552
STAT,1899,44,40-44,1943,0.42637732426750197
SIM,1832,26,na,1858,3740
SIM,1861,88,na,1949,181
STAT,1840,30,15-19,1870,0.2556208260526811
STAT,1914,41,15-19,1955,0.003078184478042981
STAT,1856,28,35-39,1884,15.468158355065473
SIM,1798,81,na,1879,339
STAT,1864,32,na,1896,4308.029991701001
STAT,1834,36,35-39,1870,11.833286916097956
STAT,1846,28,25-29,1874,77.82128674675144
STAT,1863,43,15-19,1906,0.024238042775925187
SIM,1865,39,40-44,1904,5
STAT,1782,105,na,1887,0.04179555289964753
STAT,1936,33,15-19,1969,0.2519794946556115
SIM,1937,18,35-39,1955,12
SIM,1898,16,na,1914,7175
STAT,1812,78,na,1890,740.6302335715192
STAT,1896,49,na,1945,5874.875862922667
SIM,1867,33,30-34,1900,38
STAT,1870,40,25-29,1910,1.2861343855601135
SIM,1839,92,na,1931,72
STAT,1885,30,20-24,1915,5.477627520362865
STAT,1955,15,25-29,1970,116.23050990194587
SIM,1876,32,na,1908,5147
STAT,1884,30,25-29,1914,20.590714656827753
STAT,1923,21,50-100,1944,1.5504033885293043
STAT,1821,38,15-19,1859,0.20673652927591413
STAT,1842,35,30-34,1877,9.503388870364782
STAT,1882,18,35-39,1900,1.0767001796559996
STAT,1842,44,na,1886,3470.032005266198
SIM,1938,18,30-34,1956,28
SIM,1824,38,40-44,1862,11
SIM,1847,27,20-24,1874,29
STAT,1803,105,na,1908,0.0206924119653775
STAT,1893,21,15-19,1914,8.470595690087848
STAT,1935,29,15-19,1964,1.9419307868238047
SIM,1863,45,30-34,1908,1
STAT,1911,28,na,1939,7354.451937118457
STAT,1855,41,15-19,1896,0.02091854192446254
STAT,1866,42,25-29,1908,1.195173342102346
STAT,1881,19,50-100,1900,0.095123252133793
SIM,1891,29,40-44,1920,10
SIM,1813,60,na,1873,2245
SIM,1897,31,na,1928,6542
SIM,1798,77,na,1875,631
STAT,1883,29,40-44,1912,5.901534680491845
STAT,1921,40,45-49,1961,0.3795433507000238
SIM,1825,41,na,1866,2952
STAT,1876,34,45-49,1910,3.611413471459708
SIM,1871,36,25-29,1907,6
SIM,1884,34,45-49,1918,6
STAT,1816,38,40-44,1854,32.59065765406635
STAT,1839,27,20-24,1866,23.07634054951068
SIM,1876,34,50-100,1910,1
SIM,1936,2,na,1938,7068
STAT,1930,17,25-29,1947,113.14920439218685
STAT,1929,18,35-39,1947,10.785963441545258
SIM,1828,37,na,1865,3392
SIM,1898,71,na,1969,4355
STAT,1868,34,50-100,1902,1.7455165417107605
SIM,1849,36,na,1885,3992
SIM,1944,27,na,1971,8285
STAT,1860,73,na,1933,1948.01274584677
SIM,1893,30,20-24,1923,9
STAT,1855,45,30-34,1900,0.1474232868120562
SIM,1881,87,na,1968,562
STAT,1798,62,na,1860,1735.478681837411
STAT,1890,44,20-24,1934,0.38621438790893914
SIM,1831,41,na,1872,3525
SIM,1875,43,na,1918,5114
STAT,1908,30,35-39,1938,17.57273977150219
SIM,1833,41,25-29,1874,2
STAT,1864,54,50-100,1918,0.026515363743603103
SIM,1831,29,35-39,1860,21
STAT,1964,2,na,1966,10007.991657372791
STAT,1864,54,20-24,1918,0.0012955389964209641
STAT,1876,47,40-44,1923,0.35594557670913285
SIM,1817,43,45-49,1860,6
STAT,1928,31,15-19,1959,0.324654399264408
SIM,1796,70,na,1866,1282
SIM,1908,32,na,1940,7231
STAT,1886,17,40-44,1903,0.3899388158160677
STAT,1940,0,na,1940,9201.041055088232
SIM,1843,26,50-100,1869,2
SIM,1876,48,45-49,1924,2
SIM,1923,25,30-34,1948,117
STAT,1869,28,45-49,1897,2.1651478336180974
SIM,1848,31,20-24,1879,7
STAT,1838,37,30-34,1875,8.703686803263574
SIM,1848,14,na,1862,4509
STAT,1886,46,20-24,1932,0.02565594756068796
STAT,1877,31,25-29,1908,21.568144039362252
SIM,1917,20,25-29,1937,9
STAT,1907,26,35-39,1933,28.73980632604762
STAT,1868,48,45-49,1916,0.4477822334384093
STAT,1899,49,35-39,1948,0.21396288512927994
SIM,1857,47,35-39,1904,1
STAT,1899,23,25-29,1922,157.91706903720114
SIM,1875,35,30-34,1910,3
SIM,1884,47,40-44,1931,1
SIM,1916,30,35-39,1946,22
STAT,1878,15,50-100,1893,0.10381872933232579
SIM,1954,6,na,1960,9928
STAT,1865,17,na,1882,4775.263382737748
STAT,1892,32,25-29,1924,25.89633451471534
STAT,1878,47,25-29,1925,0.12092929888682546
STAT,1915,25,30-34,1940,81.2690729614389
STAT,1872,18,25-29,1890,11.47185307580785
SIM,1866,91,na,1957,114
STAT,1823,53,20-24,1876,0.0021514793754262695
STAT,1889,20,na,1909,5924.661979166113
SIM,1818,40,25-29,1858,2
STAT,1865,29,35-39,1894,17.577428806706557
SIM,1879,39,35-39,1918,20
SIM,1873,17,20-24,1890,40
STAT,1829,62,na,1891,2163.136434330835
STAT,1947,20,45-49,1967,2.5698599310372505
SIM,1912,27,25-29,1939,122
STAT,1909,39,15-19,1948,0.036360025165843045
STAT,1929,25,25-29,1954,166.9823978736112
STAT,1959,6,na,1965,10383.413804743077
SIM,1845,92,na,1937,59
SIM,1867,17,na,1884,5256
STAT,1930,35,25-29,1965,2.5982405751385924
STAT,1904,27,25-29,1931,122.62080864264176
SIM,1849,18,40-44,1867,1
SIM,1860,20,15-19,1880,5
SIM,1874,42,25-29,1916,1
STAT,1839,24,50-100,1863,0.8064234425297991
STAT,1822,42,15-19,1864,0.04647503344099334
SIM,1825,42,40-44,1867,8
SIM,1880,18,25-29,1898,21
STAT,1848,40,45-49,1888,2.5146457767835027
SIM,1904,14,na,1918,7575
STAT,1913,50,na,1963,7178.446332465798
STAT,1927,36,50-100,1963,1.0550522249569851
SIM,1915,26,35-39,1941,42
STAT,1902,14,na,1916,7339.7886261182375
STAT,1862,19,45-49,1881,0.1161405941871298
SIM,1807,60,na,1867,1891
SIM,1883,37,35-39,1920,18
SIM,1844,92,na,1936,31
STAT,1899,41,25-29,1940,0.12395251880507052
SIM,1928,31,na,1959,9663
SIM,1841,15,30-34,1856,3
SIM,1953,1,na,1954,10057
SIM,1816,46,35-39,1862,1
STAT,1841,17,35-39,1858,1.0268095716266572
SIM,1820,78,na,1898,754
STAT,1865,51,50-100,1916,0.027843279651326394
STAT,1948,24,30-34,1972,66.59848651306594
SIM,1872,27,30-34,1899,65
STAT,1881,53,30-34,1934,0.011433291087387446
SIM,1823,93,na,1916,20
STAT,1865,17,20-24,1882,33.520035382925066
SIM,1829,39,20-24,1868,2
STAT,1914,22,50-100,1936,1.3579055095641939
STAT,1830,59,na,1889,2686.2699891590073
STAT,1909,24,na,1933,7122.142324082891
SIM,1892,33,40-44,1925,17
SIM,1826,32,30-34,1858,39
SIM,1814,78,na,1892,715
SIM,1820,36,45-49,1856,5
STAT,1873,43,na,1916,4708.532817539581
STAT,1843,37,35-39,1880,11.56656517829257
STAT,1817,42,40-44,1859,12.208376729840987
SIM,1915,33,25-29,1948,24
STAT,1864,27,30-34,1891,45.46112262729743
STAT,1867,37,50-100,1904,2.322182864262525
STAT,1852,20,15-19,1872,6.336951603942261
STAT,1885,23,30-34,1908,35.697318133798
STAT,1927,37,20-24,1964,0.6618208371470587
SIM,1847,24,50-100,1871,1
SIM,1890,21,na,1911,6253
SIM,1893,23,30-34,1916,69
SIM,1938,15,15-19,1953,83
SIM,1937,25,25-29,1962,150
STAT,1884,33,40-44,1917,8.612088625201325
STAT,1937,32,50-100,1969,1.6523595678318554
STAT,1821,82,na,1903,517.1814866995558
STAT,1822,35,25-29,1857,12.52031225332762
SIM,1850,35,30-34,1885,14
SIM,1858,44,45-49,1902,5
STAT,1923,13,na,1936,9379.016084774477
STAT,1880,45,50-100,1925,0.5277413506503631
STAT,1959,11,na,1970,10376.977681841194
STAT,1864,37,20-24,1901,1.3916208131268173
SIM,1961,9,na,1970,10505
STAT,1788,88,na,1876,95.91070240781039
STAT,1872,26,na,1898,4860.646306470912
SIM,1800,96,na,1896,4
SIM,1834,32,40-44,1866,8
STAT,1873,21,15-19,1894,6.790221018926906
SIM,1920,45,na,1965,8418
SIM,1905,22,25-29,1927,203
SIM,1859,26,35-39,1885,23
STAT,1815,46,25-29,1861,0.31444797454129925
STAT,1832,43,20-24,1875,0.2500451755090185
STAT,1901,28,na,1929,6723.83032983563
SIM,1902,21,45-49,1923,3
STAT,1893,23,40-44,1916,5.317813528794077
SIM,1843,69,na,1912,2141
STAT,1914,45,30-34,1959,0.1794277200384438
SIM,1909,24,35-39,1933,23
STAT,1875,34,30-34,1909,35.99406288901119
STAT,1866,50,25-29,1916,0.006695320705659807
STAT,1927,33,na,1960,9388.767910137936
STAT,1882,37,25-29,1919,5.664522956910389
SIM,1869,74,na,1943,1949
STAT,1900,32,25-29,1932,28.695931418289106
STAT,1857,6,na,1863,4615.865859988976
SIM,1837,33,20-24,1870,6
SIM,1926,35,50-100,1961,3
STAT,1838,33,15-19,1871,0.23701953518043511
STAT,1807,60,na,1867,2239.420910882455
SIM,1852,23,45-49,1875,1
STAT,1932,36,35-39,1968,6.569903097793747
SIM,1926,21,30-34,1947,3
STAT,1826,32,40-44,1858,13.037978523973573
STAT,1850,34,25-29,1884,16.0910015139082
STAT,1870,20,35-39,1890,11.6397865780983
STAT,1937,32,20-24,1969,4.874703034802394
STAT,1876,26,45-49,1902,2.3272265977447244
SIM,1919,35,30-34,1954,5
STAT,1803,94,na,1897,14.104730192922949
STAT,1820,76,na,1896,1060.625391708741
SIM,1812,81,na,1893,482
SIM,1857,55,na,1912,3705
SIM,1941,8,na,1949,8386
STAT,1811,99,na,1910,1.7604713366422928
STAT,1857,52,25-29,1909,0.005546142842452662
STAT,1828,41,50-100,1869,2.021601974348659
SIM,1845,20,35-39,1865,15
STAT,1851,17,40-44,1868,0.3447244003467592
STAT,1846,49,20-24,1895,0.017996739223041125
SIM,1931,36,25-29,1967,1
STAT,1946,25,25-29,1971,148.1950091531294
SIM,1846,26,25-29,1872,100
SIM,1890,37,25-29,1927,8
STAT,1824,44,25-29,1868,1.5898207876263781
STAT,1952,10,na,1962,9508.874533525868
SIM,1912,16,na,1928,8112
STAT,1835,49,45-49,1884,0.3141741012800847
SIM,1918,22,35-39,1940,33
SIM,1928,35,25-29,1963,2
STAT,1914,38,25-29,1952,1.9759204573376568
STAT,1883,28,50-100,1911,1.26485655169468
STAT,1923,36,25-29,1959,2.3054450669241064
SIM,1799,60,na,1859,1846
SIM,1894,51,na,1945,5857
SIM,1858,8,na,1866,4931
SIM,1922,38,25-29,1960,5
STAT,1837,20,35-39,1857,11.160419270470545
SIM,1888,49,50-100,1937,1
SIM,1866,29,45-49,1895,6
SIM,1908,20,50-100,1928,1
STAT,1820,42,na,1862,3045.3995733165893
SIM,1895,29,na,1924,6583
SIM,1842,33,30-34,1875,40
STAT,1884,15,50-100,1899,0.0981569996821786
SIM,1924,35,40-44,1959,4
SIM,1867,25,30-34,1892,62
STAT,1786,77,na,1863,599.4648384454937
SIM,1894,20,30-34,1914,59
SIM,1887,38,50-100,1925,3
SIM,1920,35,na,1955,8497
STAT,1866,48,50-100,1914,0.45191997159146874
SIM,1882,56,na,1938,4211
STAT,1841,36,25-29,1877,4.97330608711874
STAT,1931,35,20-24,1966,0.706329422348153
STAT,1833,108,na,1941,0.002408034774174254
STAT,1943,27,50-100,1970,2.1408456672129095
SIM,1843,25,45-49,1868,3
SIM,1817,90,na,1907,50
SIM,1866,32,na,1898,4650
SIM,1835,29,15-19,1864,1
SIM,1860,22,40-44,1882,6
STAT,1929,33,25-29,1962,23.69367842797317
STAT,1861,58,na,1919,3324.357966699077
SIM,1893,24,45-49,1917,3
STAT,1821,43,45-49,1864,4.6259358982841805
SIM,1862,42,45-49,1904,9
STAT,1837,43,50-100,1880,1.7157758687230698
STAT,1918,21,30-34,1939,62.782732421895794
SIM,1936,25,20-24,1961,31
STAT,1845,34,na,1879,3889.1822976804356
STAT,1907,29,na,1936,7035.7679952316885
SIM,1919,28,25-29,1947,157
SIM,1869,36,20-24,1905,2
STAT,1904,16,20-24,1920,51.516613766222086
STAT,1942,16,na,1958,7770.861607478514
SIM,1846,33,15-19,1879,1
STAT,1834,33,30-34,1867,29.462830949958125
SIM,1787,75,na,1862,673
SIM,1889,39,40-44,1928,16
STAT,1885,24,45-49,1909,1.393047239306752
SIM,1912,16,20-24,1928,46
STAT,1827,29,15-19,1856,1.4596815450356064
STAT,1890,17,na,1907,6226.012938650874
STAT,1929,17,20-24,1946,349.4047886710769
SIM,1874,37,na,1911,4535
SIM,1858,33,50-100,1891,3
SIM,1870,37,na,1907,4625
STAT,1852,22,40-44,1874,3.945425270119866
STAT,1884,39,50-100,1923,2.4238085679727033
SIM,1838,25,50-100,1863,1
SIM,1905,48,35-39,1953,1
STAT,1886,20,30-34,1906,38.20134371100421
SIM,1836,20,25-29,1856,114
SIM,1889,31,45-49,1920,7
STAT,1883,73,na,1956,2423.9598053301715
SIM,1916,7,na,1923,8676
SIM,1941,13,na,1954,8326
SIM,1872,37,20-24,1909,1
STAT,1801,93,na,1894,23.165999742411145
STAT,1877,16,35-39,1893,1.1535560934365816
STAT,1917,25,45-49,1942,3.6836129070223618
SIM,1887,27,25-29,1914,124
STAT,1776,105,na,1881,0.04025334733292717
STAT,1905,17,35-39,1922,1.6026590545222792
STAT,1820,53,40-44,1873,0.03693411857484913
STAT,1916,35,40-44,1951,3.1254608597835856
SIM,1937,17,20-24,1954,253
STAT,1835,25,45-49,1860,1.902221560148973
SIM,1878,9,na,1887,5727
SIM,1857,89,na,1946,173
STAT,1807,51,15-19,1858,1.6349143830965703E-4
SIM,1936,27,30-34,1963,80
STAT,1892,40,25-29,1932,1.6399453312923142
STAT,1928,25,20-24,1953,45.719801078206295
STAT,1845,24,na,1869,4031.654915404449
STAT,1940,15,na,1955,7552.299390572752
STAT,1915,48,na,1963,7456.327261142305
STAT,1829,33,20-24,1862,5.044829109239522
STAT,1881,29,20-24,1910,22.7370704860457
STAT,1943,5,na,1948,8536.692715864492
STAT,1832,61,na,1893,2436.173586177435
STAT,1874,42,15-19,1916,0.028522392156042943
SIM,1897,3,na,1900,7305
STAT,1879,27,25-29,1906,89.36078344707985
SIM,1925,25,45-49,1950,2
STAT,1896,24,20-24,1920,182.59991617284115
STAT,1910,36,15-19,1946,0.03728455884551662
STAT,1903,29,na,1932,6813.548215821136
STAT,1924,37,40-44,1961,3.5640940306752005
SIM,1861,19,15-19,1880,12
SIM,1872,16,25-29,1888,16
STAT,1892,18,40-44,1910,0.4612214775984102
SIM,1880,6,na,1886,5966
STAT,1895,19,20-24,1914,46.40474393637933
STAT,1942,10,na,1952,8327.418249576995
STAT,1786,108,na,1894,0.0017023479455172356
STAT,1954,18,25-29,1972,108.148618233844
SIM,1880,21,na,1901,5291
SIM,1902,28,15-19,1930,1
SIM,1799,94,na,1893,6
STAT,1918,17,45-49,1935,0.22027481577223484
SIM,1833,27,40-44,1860,7
SIM,1942,17,45-49,1959,1
SIM,1821,41,45-49,1862,6
SIM,1836,28,20-24,1864,20
SIM,1884,21,15-19,1905,8
STAT,1870,52,40-44,1922,0.02076338457493049
SIM,1955,16,50-100,1971,1
STAT,1863,25,20-24,1888,21.041106161415698
SIM,1802,81,na,1883,461
STAT,1865,42,20-24,1907,0.2910331843749771
STAT,1934,17,45-49,1951,1.3648141584916889
STAT,1937,18,25-29,1955,84.93702255898125
STAT,1818,46,50-100,1864,1.0995652397533573
SIM,1876,2,na,1878,6709
SIM,1797,65,na,1862,1617
SIM,1899,29,na,1928,6589
STAT,1852,81,na,1933,861.8760019174858
SIM,1822,38,20-24,1860,4
SIM,1863,89,na,1952,194
STAT,1856,102,na,1958,0.7790691507340605
STAT,1864,16,25-29,1880,11.698479528818853
SIM,1886,19,20-24,1905,34
SIM,1817,59,na,1876,2363
SIM,1878,34,20-24,1912,11
SIM,1834,27,50-100,1861,1
STAT,1881,16,25-29,1897,11.089082749935809
SIM,1849,43,40-44,1892,8
SIM,1868,31,25-29,1899,26
STAT,1862,44,45-49,1906,2.548629703265595
SIM,1857,44,30-34,1901,2
SIM,1853,69,na,1922,2282
SIM,1914,35,na,1949,7810
STAT,1853,19,15-19,1872,11.162478747151853
STAT,1885,15,30-34,1900,3.219036603379532
SIM,1852,30,35-39,1882,26
STAT,1890,21,na,1911,5847.815530112463
SIM,1821,64,na,1885,1900
STAT,1868,90,na,1958,214.2670143904223
SIM,1926,17,45-49,1943,1
STAT,1887,35,na,1922,5372.204456082085
STAT,1918,30,45-49,1948,3.403646086878081
SIM,1917,19,45-49,1936,1
STAT,1802,57,na,1859,2276.0751714477606
STAT,1810,76,na,1886,817.3360775449726
SIM,1871,20,50-100,1891,2
STAT,1879,48,20-24,1927,0.02503120613332504
STAT,1885,6,na,1891,5251.611900591203
STAT,1874,21,na,1895,4905.484550700292
STAT,1905,24,25-29,1929,166.15516263758386
SIM,1863,99,na,1962,15
STAT,1907,13,na,1920,7653.9409035531235
STAT,1927,43,na,1970,9390.709840444402
STAT,1880,32,45-49,1912,3.7101090383892084
STAT,1853,48,50-100,1901,0.3837060468979048
STAT,1859,28,35-39,1887,15.664987479218244
SIM,1883,18,40-44,1901,1
STAT,1828,28,20-24,1856,33.48440117718018
STAT,1909,19,45-49,1928,0.19689079499897197
STAT,1933,35,40-44,1968,4.1255763383955655
SIM,1859,30,20-24,1889,6
STAT,1820,38,45-49,1858,9.326539595286517
SIM,1926,30,45-49,1956,8
SIM,1906,27,50-100,1933,2
STAT,1884,16,40-44,1900,0.36565402062996644
SIM,1926,20,na,1946,9161
STAT,1918,8,na,1926,8765.961578173012
SIM,1873,42,20-24,1915,2
STAT,1813,41,45-49,1854,11.564370733314938
SIM,1832,44,25-29,1876,3
SIM,1932,37,40-44,1969,7
SIM,1912,10,na,1922,8272
SIM,1925,40,40-44,1965,2
SIM,1937,33,25-29,1970,29
SIM,1945,18,25-29,1963,121
STAT,1925,27,45-49,1952,4.120209772004351
STAT,1844,30,35-39,1874,19.967456654826282
SIM,1853,48,50-100,1901,1
STAT,1932,40,20-24,1972,0.048478473858100654
STAT,1923,38,35-39,1961,5.652596167873357
STAT,1914,3,na,1917,8447.451542692537
STAT,1790,82,na,1872,305.25869719741905
STAT,1843,15,40-44,1858,0.33131506227599766
SIM,1812,43,45-49,1855,1
STAT,1908,27,45-49,1935,3.328566355057083
SIM,1845,18,20-24,1863,41
STAT,1833,41,15-19,1874,0.02232123783399066
SIM,1863,26,25-29,1889,91
SIM,1916,1,na,1917,8887
SIM,1914,43,30-34,1957,3
STAT,1891,35,25-29,1926,7.255837565139377
STAT,1858,29,45-49,1887,1.7638982516127928
STAT,1863,43,na,1906,4056.525663522945
STAT,1838,26,25-29,1864,73.35261129080759
STAT,1902,51,na,1953,6168.970324883735
SIM,1805,95,na,1900,4
STAT,1862,36,na,1898,4086.4648775001137
STAT,1845,22,35-39,1867,11.163111220419163
SIM,1856,18,na,1874,4615
STAT,1925,14,na,1939,9633.460053422095
SIM,1931,38,35-39,1969,10
STAT,1868,23,30-34,1891,34.12101138982107
SIM,1831,36,20-24,1867,3
SIM,1926,30,na,1956,9465
STAT,1861,54,40-44,1915,0.017210409502929503
SIM,1894,41,na,1935,6293
SIM,1951,15,45-49,1966,1
SIM,1873,37,25-29,1910,9
STAT,1854,18,20-24,1872,32.31942006566383
STAT,1798,78,na,1876,603.3390582701765
STAT,1833,39,na,1872,3447.363582268081
STAT,1886,16,na,1902,5397.671514134317
STAT,1861,23,45-49,1884,1.195603679813703
STAT,1860,33,40-44,1893,7.082559223033238
STAT,1837,18,20-24,1855,38.36071921816521
STAT,1905,21,50-100,1926,1.1946622741146717
SIM,1874,28,40-44,1902,8
SIM,1932,30,na,1962,10216
STAT,1856,47,25-29,1903,0.08933596356683478
SIM,1925,22,25-29,1947,252
SIM,1870,44,45-49,1914,7
SIM,1906,16,na,1922,7441
SIM,1916,27,45-49,1943,5
STAT,1844,23,45-49,1867,1.3959319294779056
SIM,1872,23,15-19,1895,8
STAT,1937,25,30-34,1962,77.22168905694681
SIM,1876,23,30-34,1899,46
SIM,1876,48,50-100,1924,2
SIM,1884,26,45-49,1910,1
SIM,1793,99,na,1892,1
STAT,1899,20,na,1919,6583.465161150809
STAT,1960,1,na,1961,10355.351051698923
SIM,1863,39,20-24,1902,3
STAT,1874,90,na,1964,385.1542465321445
STAT,1802,105,na,1907,0.022503108635287112
STAT,1913,13,na,1926,8144.406794377443
STAT,1942,25,40-44,1967,9.888815286022531
STAT,1943,15,45-49,1958,1.070379922474483
SIM,1878,41,50-100,1919,4
STAT,1823,36,20-24,1859,3.1005813133626523
STAT,1890,27,20-24,1917,28.919856768126586
STAT,1868,30,20-24,1898,5.235748812024645
STAT,1913,16,30-34,1929,5.046721552426736
SIM,1921,16,30-34,1937,39
SIM,1865,54,na,1919,3890
STAT,1871,50,35-39,1921,0.017522444164217558
STAT,1850,41,15-19,1891,0.021270002409077865
STAT,1877,54,50-100,1931,0.030801872392711035
STAT,1902,41,na,1943,6642.825847638553
SIM,1886,22,na,1908,4941
STAT,1829,52,50-100,1881,0.020948135108572873
STAT,1855,26,25-29,1881,66.96894571387334
SIM,1911,17,15-19,1928,19
SIM,1816,43,30-34,1859,4
STAT,1917,22,25-29,1939,198.2524277003458
STAT,1919,14,na,1933,8812.69876899706
SIM,1945,25,30-34,1970,101
STAT,1869,53,45-49,1922,0.02794392566122773
STAT,1948,20,15-19,1968,12.351660163405793
STAT,1864,23,15-19,1887,6.008082925749484
STAT,1903,17,15-19,1920,17.06517102604866
STAT,1833,49,na,1882,3072.5966337939167
SIM,1883,34,30-34,1917,46
STAT,1848,76,na,1924,1553.4646347507082
STAT,1914,46,50-100,1960,0.45423614532731954
STAT,1855,48,35-39,1903,0.20845819863749165
SIM,1922,22,25-29,1944,243
STAT,1838,47,20-24,1885,0.0167085332796723
SIM,1867,41,35-39,1908,5
SIM,1842,43,40-44,1885,6
STAT,1871,72,na,1943,2534.017593326109
SIM,1807,59,na,1866,1972
STAT,1827,39,na,1866,3331.7586602529477
STAT,1892,34,30-34,1926,43.76539430667928
SIM,1908,25,45-49,1933,3
STAT,1879,24,20-24,1903,144.66473472428385
STAT,1899,27,40-44,1926,8.289140688892505
SIM,1844,22,25-29,1866,118
SIM,1911,35,45-49,1946,2
STAT,1904,46,na,1950,6541.435131636529
STAT,1914,48,35-39,1962,0.2575692161094553
STAT,1840,54,20-24,1894,0.001035851896502224
STAT,1835,20,15-19,1855,6.998922211359095
STAT,1856,21,15-19,1877,6.013571572815922
STAT,1806,52,50-100,1858,0.08812827485650843
STAT,1845,20,25-29,1865,111.09891738750927
STAT,1944,21,50-100,1965,1.4352106759828192
SIM,1846,87,na,1933,201
SIM,1912,22,15-19,1934,9
STAT,1825,43,30-34,1868,2.5967618623883504
STAT,1814,47,35-39,1861,0.7252882427512294
STAT,1846,33,20-24,1879,4.842259138524341
SIM,1909,21,30-34,1930,64
STAT,1905,48,25-29,1953,0.09370724121935775
STAT,1873,73,na,1946,2437.3351135530474
STAT,1906,36,25-29,1942,1.8376935096363183
STAT,1899,43,50-100,1942,0.20153689162352353
SIM,1854,33,20-24,1887,5
SIM,1850,17,na,1867,4477
STAT,1881,38,35-39,1919,13.738435254335563
STAT,1876,87,na,1963,695.0022124023703
SIM,1853,22,35-39,1875,14
SIM,1904,31,20-24,1935,5
STAT,1840,34,50-100,1874,1.5777432968864662
SIM,1833,43,30-34,1876,4
STAT,1911,21,45-49,1932,2.162291819992166
STAT,1839,24,na,1863,4228.241581649979
STAT,1871,18,20-24,1889,35.59142966216007
STAT,1909,31,30-34,1940,30.504891945729316
STAT,1904,22,15-19,1926,9.563011970258609
STAT,1824,41,20-24,1865,0.4229644652060763
STAT,1944,20,45-49,1964,2.4550939962568408
STAT,1851,58,na,1909,3065.6372494207208
STAT,1917,43,na,1960,7814.620904971724
STAT,1877,20,20-24,1897,145.3826929471201
SIM,1887,24,20-24,1911,165
STAT,1785,108,na,1893,0.002862530462800036
STAT,1836,22,25-29,1858,100.47300017094703
SIM,1917,24,40-44,1941,10
STAT,1831,75,na,1906,1329.188006032683
STAT,1932,33,30-34,1965,42.27629596230544
STAT,1861,88,na,1949,230.77486769911667
STAT,1883,50,25-29,1933,0.007129321802936379
SIM,1903,19,30-34,1922,5
SIM,1892,22,na,1914,6764
SIM,1861,31,50-100,1892,2
STAT,1838,48,na,1886,3092.661570050834
STAT,1818,93,na,1911,29.983586041684333
STAT,1937,19,20-24,1956,265.6350401970967
SIM,1933,27,45-49,1960,5
STAT,1897,15,50-100,1912,0.1328750314469357
STAT,1839,65,na,1904,2638.755374715572
STAT,1929,30,20-24,1959,6.263799032018774
STAT,1931,31,50-100,1962,2.189346803020573
SIM,1864,21,15-19,1885,4
SIM,1913,24,25-29,1937,219
SIM,1904,16,30-34,1920,4
STAT,1877,73,na,1950,2490.9052312097942
STAT,1786,102,na,1888,0.15784712692600006
STAT,1952,16,na,1968,8910.10966485794
STAT,1872,39,20-24,1911,1.548875976561566
SIM,1930,21,20-24,1951,269
SIM,1881,27,20-24,1908,20
SIM,1852,20,40-44,1872,3
STAT,1858,90,na,1948,124.12803341609074
SIM,1880,39,20-24,1919,2
STAT,1812,51,40-44,1863,0.07120704216724434
STAT,1872,15,20-24,1887,36.531761043077815
SIM,1812,77,na,1889,705
SIM,1873,3,na,1876,6245
STAT,1888,72,na,1960,3335.0358322755205
STAT,1903,35,45-49,1938,1.2490378527072443
STAT,1834,43,40-44,1877,3.5635617153880546
SIM,1843,20,15-19,1863,3
SIM,1945,19,20-24,1964,336
STAT,1914,22,25-29,1936,190.62275552041913
SIM,1853,20,25-29,1873,2
STAT,1928,28,25-29,1956,163.66755229247622
STAT,1840,37,35-39,1877,12.075151679793576
SIM,1908,11,na,1919,7829
STAT,1875,44,40-44,1919,4.613904065668852
STAT,1943,16,40-44,1959,2.9963152456117514
STAT,1828,52,45-49,1880,0.025245826814616592
STAT,1918,28,15-19,1946,1.5117183562945333
STAT,1900,19,40-44,1919,0.5096776587284543
STAT,1898,31,45-49,1929,4.785496008928315
STAT,1895,54,na,1949,5510.672230862182
STAT,1864,31,15-19,1895,0.25814055741829245
STAT,1775,115,na,1890,2.8754049870221914E-4
STAT,1906,38,35-39,1944,4.47049671835604
SIM,1877,21,25-29,1898,139
SIM,1900,30,25-29,1930,35
STAT,1891,32,20-24,1923,6.7478674505756056
SIM,1894,23,35-39,1917,23
STAT,1779,95,na,1874,4.309711417154203
STAT,1872,20,na,1892,4829.077091412614
STAT,1813,108,na,1921,0.0016276711337393354
STAT,1834,50,30-34,1884,0.008452820338282143
SIM,1868,30,30-34,1898,43
SIM,1880,15,20-24,1895,39
STAT,1897,59,na,1956,5292.197302996164
SIM,1826,30,40-44,1856,14
STAT,1848,26,50-100,1874,1.2612540177556144
SIM,1869,16,50-100,1885,1
SIM,1914,38,35-39,1952,8
STAT,1816,92,na,1908,40.91024132693282
STAT,1926,19,45-49,1945,1.2300971036677208
STAT,1865,88,na,1953,251.88947425154097
SIM,1832,36,na,1868,3504
SIM,1866,26,40-44,1892,7
SIM,1846,23,20-24,1869,125
STAT,1909,24,40-44,1933,6.275212730264022
STAT,1861,53,45-49,1914,0.024003794068921596
STAT,1886,23,35-39,1909,12.402465956441842
SIM,1893,31,35-39,1924,39
SIM,1816,53,40-44,1869,1
SIM,1824,62,na,1886,2281
STAT,1875,40,25-29,1915,1.3487435980913165
STAT,1891,42,15-19,1933,0.034432167466450406
SIM,1879,18,15-19,1897,13
STAT,1889,48,50-100,1937,0.3406591419311655
STAT,1848,49,40-44,1897,0.2748567046128469
STAT,1895,43,45-49,1938,0.27152900569407284
STAT,1842,41,25-29,1883,1.0018942932744643
STAT,1808,53,40-44,1861,0.06121205158573171
SIM,1839,22,15-19,1861,5
STAT,1847,54,20-24,1901,0.0010939089948636578
SIM,1936,28,25-29,1964,101
SIM,1877,29,20-24,1906,28
SIM,1883,44,40-44,1927,9
SIM,1926,28,15-19,1954,4
SIM,1951,16,40-44,1967,4
SIM,1812,43,na,1855,2931
STAT,1921,16,20-24,1937,312.7986299182881
STAT,1832,23,na,1855,3699.31872417683
STAT,1907,49,20-24,1956,0.01977906973709961
STAT,1865,45,25-29,1910,0.1067387617446274
STAT,1903,16,50-100,1919,0.14122520571226096
STAT,1885,31,35-39,1916,20.441599430380563
STAT,1869,21,25-29,1890,112.36441750531425
STAT,1853,1,na,1854,6042.000000000001
STAT,1935,21,30-34,1956,79.08547120223804
SIM,1847,35,na,1882,3727
SIM,1943,21,30-34,1964,86
SIM,1844,15,35-39,1859,2
SIM,1946,23,25-29,1969,225
SIM,1827,32,35-39,1859,23
SIM,1880,37,na,1917,5243
STAT,1874,86,na,1960,690.9888844398085
SIM,1914,36,25-29,1950,1
SIM,1931,28,25-29,1959,188
STAT,1851,33,30-34,1884,27.87959302452556
STAT,1886,21,25-29,1907,122.41281884021969
STAT,1931,38,25-29,1969,2.630988445140725
STAT,1885,21,40-44,1906,4.201720125801767
STAT,1924,41,25-29,1965,0.1717449713805229
SIM,1830,31,na,1861,3378
STAT,1938,23,25-29,1961,184.59915064032913
STAT,1868,21,na,1889,4577.3688203099355
STAT,1879,54,50-100,1933,0.03102686786644174
SIM,1852,56,na,1908,3307
STAT,1814,42,na,1856,2773.992023928671
STAT,1866,28,40-44,1894,5.56252333481331
SIM,1875,84,na,1959,950
STAT,1896,49,35-39,1945,0.20617567931691194
STAT,1818,40,35-39,1858,9.614713425038149
STAT,1855,24,na,1879,3712.7202835508256
SIM,1859,20,na,1879,4387
STAT,1880,55,na,1935,4399.211584706312
SIM,1884,51,na,1935,4675
SIM,1919,29,20-24,1948,35
STAT,1816,51,25-29,1867,0.017031460674822595
SIM,1895,67,na,1962,4645
SIM,1909,32,35-39,1941,24
STAT,1897,48,25-29,1945,0.08661245958815143
SIM,1838,21,na,1859,3867
SIM,1894,21,25-29,1915,188
STAT,1839,52,20-24,1891,0.0011460744506306788
STAT,1944,18,15-19,1962,98.59927476429333
STAT,1928,27,30-34,1955,97.4775565235424
STAT,1900,22,30-34,1922,49.90332914963017
STAT,1853,52,40-44,1905,0.01656818934119179
STAT,1879,8,na,1887,5594.685942500954
STAT,1838,41,15-19,1879,0.02213968771750946
STAT,1879,34,15-19,1913,0.2982573401807621
STAT,1883,69,na,1952,2912.0072657793953
SIM,1899,37,45-49,1936,1
STAT,1824,43,50-100,1867,2.679718879757496
STAT,1917,26,40-44,1943,9.90518062183287
SIM,1936,30,50-100,1966,2
STAT,1913,29,na,1942,7486.62125643372
SIM,1917,25,na,1942,8154
SIM,1827,30,25-29,1857,17
STAT,1909,33,50-100,1942,1.5875827623784868
STAT,1771,85,na,1856,124.4436331
STAT,1831,38,20-24,1869,1.2472718778107048
STAT,1951,17,45-49,1968,1.2012897828292879
STAT,1891,34,na,1925,5906.141491935399
SIM,1832,97,na,1929,8
SIM,1854,25,20-24,1879,26
STAT,1863,28,25-29,1891,74.52146809601444
SIM,1886,21,35-39,1907,13
STAT,1922,2,na,1924,9556.746081449623
STAT,1846,25,20-24,1871,22.053810687725786
STAT,1936,27,20-24,1963,35.28849232620321
STAT,1946,18,35-39,1964,9.395819062421598
SIM,1952,18,15-19,1970,108
SIM,1876,30,20-24,1906,9
STAT,1828,93,na,1921,35.89041006561183
STAT,1882,20,na,1902,4680.7511476055615
SIM,1882,22,na,1904,4908
SIM,1917,33,50-100,1950,4
SIM,1871,28,25-29,1899,85
STAT,1859,25,30-34,1884,41.77610106313963
SIM,1859,33,25-29,1892,21
STAT,1861,15,45-49,1876,0.12771123606943616
SIM,1826,40,35-39,1866,8
SIM,1875,33,40-44,1908,14
STAT,1832,108,na,1940,0.002388050790096612
STAT,1954,15,20-24,1969,338.6339821499608
STAT,1838,23,20-24,1861,120.13499377648019
STAT,1843,18,45-49,1861,0.1162482358283463
SIM,1806,81,na,1887,345
SIM,1868,33,35-39,1901,4
SIM,1911,1,na,1912,8430
STAT,1822,92,na,1914,47.02565912132989
STAT,1858,26,40-44,1884,4.862941051937107
STAT,1847,59,na,1906,2962.5037076257636
STAT,1911,28,15-19,1939,1.3859286638806387
SIM,1852,17,35-39,1869,3
STAT,1844,32,50-100,1876,1.769423539584055
STAT,1895,45,50-100,1940,0.36821781506763906
SIM,1850,41,25-29,1891,1
STAT,1807,48,40-44,1855,1.155588434459098
STAT,1914,28,30-34,1942,79.50771720147583
STAT,1844,17,35-39,1861,1.1264080571671942
SIM,1864,37,na,1901,4456
SIM,1867,34,45-49,1901,3
SIM,1867,55,na,1922,4147
STAT,1854,42,45-49,1896,2.2915056588418925
SIM,1898,21,45-49,1919,2
STAT,1829,41,na,1870,3126.0061781863483
STAT,1933,39,20-24,1972,0.7236861259922514
STAT,1807,94,na,1901,15.953035797928205
SIM,1844,21,na,1865,3752
SIM,1869,84,na,1953,558
STAT,1922,21,20-24,1943,258.23902663088313
STAT,1867,33,40-44,1900,8.167957410839236
STAT,1916,1,na,1917,8918.975834939181
STAT,1875,51,30-34,1926,0.012436664526198885
STAT,1908,60,na,1968,6252.712076372261
SIM,1859,44,50-100,1903,5
STAT,1871,88,na,1959,410.11875613485023
SIM,1836,56,na,1892,2586
SIM,1922,28,30-34,1950,120
STAT,1910,28,15-19,1938,1.3724394454109659
STAT,1922,34,na,1956,8585.84961353012
SIM,1800,58,na,1858,2082
SIM,1849,54,na,1903,3425
STAT,1947,15,15-19,1962,103.2961779173147
STAT,1878,3,na,1881,6446.935242360746
SIM,1927,33,15-19,1960,1
STAT,1878,18,50-100,1896,0.10306785597119873
STAT,1933,38,45-49,1971,1.8736178834695958
STAT,1926,39,15-19,1965,0.047289525981654035
STAT,1867,73,na,1940,2246.544595363667
STAT,1926,32,45-49,1958,3.8421293861599763
STAT,1909,16,40-44,1925,0.555628067936566
SIM,1929,10,na,1939,10578
SIM,1899,50,na,1949,6028
STAT,1813,94,na,1907,17.759645490479276
STAT,1843,60,na,1903,2671.611079259191
STAT,1847,108,na,1955,0.002792172915939645
STAT,1872,45,50-100,1917,0.5034741419504858
STAT,1844,20,40-44,1864,4.262628299872333
SIM,1955,15,15-19,1970,106
STAT,1788,78,na,1866,629.9680050184328
STAT,1928,17,20-24,1945,344.9575900118388
STAT,1820,52,45-49,1872,0.05193783621355649
SIM,1921,19,35-39,1940,9
SIM,1879,36,na,1915,4857
STAT,1860,19,50-100,1879,0.09158171701766907
SIM,1835,22,30-34,1857,52
SIM,1858,72,na,1930,2076
STAT,1871,31,40-44,1902,8.737247381831171
STAT,1918,46,45-49,1964,0.46818281238873133
STAT,1954,17,30-34,1971,30.42848396001469
STAT,1925,47,15-19,1972,9.013261335370793E-4
SIM,1937,30,20-24,1967,4
STAT,1878,19,20-24,1897,37.19426270009185
STAT,1885,18,35-39,1903,1.100177856852315
STAT,1914,35,20-24,1949,0.5367003085233628
SIM,1914,46,35-39,1960,2
SIM,1954,11,na,1965,9923
STAT,1884,19,45-49,1903,0.12957212741927904
SIM,1936,17,20-24,1953,223
SIM,1916,24,40-44,1940,11
STAT,1913,19,35-39,1932,1.7238448222244607
STAT,1833,45,30-34,1878,0.15319338684216796
SIM,1930,32,50-100,1962,3
SIM,1855,54,na,1909,3692
SIM,1847,27,50-100,1874,4
SIM,1848,38,40-44,1886,11
SIM,1870,33,50-100,1903,3
SIM,1910,5,na,1915,8392
STAT,1915,14,na,1929,8321.56294701295
SIM,1944,27,20-24,1971,43
STAT,1909,14,na,1923,7800.662517932897
STAT,1838,76,na,1914,1282.184941869385
STAT,1857,30,45-49,1887,2.8200281577359316
STAT,1883,40,15-19,1923,0.027678978066539243
SIM,1859,48,45-49,1907,1
SIM,1860,17,na,1877,4654
STAT,1908,24,40-44,1932,6.207921679029689
SIM,1828,35,20-24,1863,1
SIM,1904,24,30-34,1928,54
SIM,1934,32,45-49,1966,5
STAT,1859,41,35-39,1900,2.924034535565507
STAT,1843,39,na,1882,3433.988659362454
STAT,1883,42,25-29,1925,1.2726463362592424
STAT,1894,20,20-24,1914,179.85309582878148
SIM,1831,39,25-29,1870,9
STAT,1823,39,25-29,1862,10.278134245263137
STAT,1897,22,15-19,1919,8.906183579013307
STAT,1849,54,40-44,1903,0.016194681563195923
SIM,1895,26,20-24,1921,32
STAT,1873,44,20-24,1917,0.3214943071696694
STAT,1885,37,40-44,1922,8.80007718395452
SIM,1918,8,na,1926,9017
SIM,1928,28,35-39,1956,52
STAT,1887,26,20-24,1913,26.58985353127076
SIM,1893,37,40-44,1930,21
STAT,1906,46,35-39,1952,0.23306903968849746
SIM,1830,72,na,1902,1518
STAT,1904,40,45-49,1944,0.30430521148753104
STAT,1927,22,35-39,1949,23.425860271660117
SIM,1830,49,35-39,1879,1
SIM,1926,22,45-49,1948,3
SIM,1935,22,35-39,1957,37
SIM,1891,42,25-29,1933,5
SIM,1921,17,25-29,1938,113
STAT,1833,38,40-44,1871,7.133730458070206
STAT,1872,23,20-24,1895,139.44226833365124
SIM,1865,30,45-49,1895,6
STAT,1806,53,20-24,1859,0.004220447632235991
STAT,1822,49,35-39,1871,0.42291886378246807
STAT,1850,31,20-24,1881,4.380835508549844
SIM,1841,38,40-44,1879,4
SIM,1899,32,15-19,1931,1
STAT,1836,54,45-49,1890,0.0187695294590381
STAT,1913,17,25-29,1930,17.898790018189928
STAT,1825,75,na,1900,1191.1243894226384
SIM,1858,36,45-49,1894,7
STAT,1901,24,40-44,1925,5.854813459884785
SIM,1832,43,50-100,1875,4
SIM,1844,82,na,1926,522
SIM,1873,34,20-24,1907,8
SIM,1925,26,40-44,1951,19
SIM,1861,22,25-29,1883,138
SIM,1906,36,35-39,1942,8
SIM,1889,33,na,1922,5993
STAT,1907,48,45-49,1955,0.3901940563682522
SIM,1830,62,na,1892,2226
SIM,1943,24,35-39,1967,28
STAT,1846,36,25-29,1882,4.65344559137489
SIM,1892,18,na,1910,7258
SIM,1946,20,20-24,1966,242
SIM,1849,21,30-34,1870,45
SIM,1880,37,30-34,1917,16
STAT,1871,20,35-39,1891,11.778840829183732
SIM,1821,33,45-49,1854,5
SIM,1822,43,na,1865,2997
STAT,1842,43,30-34,1885,1.7483366882211906
STAT,1945,23,15-19,1968,11.77791978818664
SIM,1792,83,na,1875,248
STAT,1940,18,30-34,1958,24.988125759620253
SIM,1911,4,na,1915,8277
STAT,1797,83,na,1880,271.07552991748025
STAT,1864,38,na,1902,4232.171736733268
STAT,1924,45,40-44,1969,0.3807627046569606
SIM,1904,52,na,1956,6353
SIM,1950,11,na,1961,9177
STAT,1889,24,50-100,1913,1.0091359104193525
STAT,1842,23,na,1865,3986.2201127505336
STAT,1845,43,50-100,1888,1.6366424898326715
STAT,1909,52,na,1961,6706.77118079851
STAT,1888,38,20-24,1926,1.8309397678469699
SIM,1790,95,na,1885,6
SIM,1825,88,na,1913,112
STAT,1881,23,15-19,1904,6.420063548883109
STAT,1851,43,40-44,1894,3.4616005395200555
SIM,1897,52,na,1949,5844
SIM,1928,19,50-100,1947,1
SIM,1944,17,na,1961,8159
STAT,1841,65,na,1906,2452.0171008070474
STAT,1884,52,na,1936,4271.256641425958
STAT,1929,41,50-100,1970,0.30767832590429317
STAT,1897,18,na,1915,6800.368426923727
STAT,1873,15,na,1888,5244.281218426329
SIM,1877,48,na,1925,4538
STAT,1815,58,na,1873,2321.7465356637963
SIM,1904,18,20-24,1922,49
STAT,1894,16,35-39,1910,1.427065563383033
SIM,1882,39,40-44,1921,17
SIM,1913,39,45-49,1952,2
STAT,1823,40,na,1863,3391.938628977066
STAT,1864,38,35-39,1902,12.705478954764244
SIM,1825,35,50-100,1860,6
SIM,1862,35,20-24,1897,2
STAT,1934,37,15-19,1971,0.05352780179068519
STAT,1872,37,30-34,1909,10.81765992448191
STAT,1836,32,35-39,1868,17.023549176861383
STAT,1884,4,na,1888,5566.115079494666
SIM,1854,36,25-29,1890,8
SIM,1886,43,45-49,1929,9
SIM,1858,33,40-44,1891,8
STAT,1777,79,na,1856,469.0890706383
STAT,1935,24,35-39,1959,25.88302283869328
SIM,1866,60,na,1926,3691
SIM,1810,48,na,1858,2766
STAT,1836,37,45-49,1873,3.2540926850699794
SIM,1858,68,na,1926,2559
SIM,1943,22,50-100,1965,1
STAT,1930,19,35-39,1949,10.897477982146503
SIM,1810,58,na,1868,2276
SIM,1841,45,30-34,1886,1
STAT,1933,31,25-29,1964,25.17289846945602
STAT,1901,41,40-44,1942,0.4436172240632661
STAT,1837,38,25-29,1875,4.836464939642836
STAT,1930,30,45-49,1960,4.1059505515641685
SIM,1845,38,25-29,1883,10
STAT,1868,24,45-49,1892,1.3315336614584874
STAT,1870,38,50-100,1908,2.4223271752824544
STAT,1890,19,20-24,1909,43.46922097534287
SIM,1908,22,25-29,1930,184
STAT,1774,112,na,1886,0.001137451462935279
STAT,1850,42,na,1892,3539.3911046682038
SIM,1841,31,20-24,1872,5
SIM,1850,43,30-34,1893,4
STAT,1941,30,20-24,1971,5.178167018887104
SIM,1835,25,35-39,1860,20
SIM,1835,39,45-49,1874,5
SIM,1844,37,45-49,1881,5
STAT,1808,73,na,1881,1086.8483266227158
STAT,1815,51,50-100,1866,0.0793177724602939
STAT,1876,21,15-19,1897,6.912003580554719
STAT,1848,38,na,1886,3939.889876753549
SIM,1939,25,50-100,1964,6
STAT,1905,39,45-49,1944,1.2440949843962872
SIM,1877,31,35-39,1908,25
STAT,1854,35,20-24,1889,1.1997828899877176
SIM,1914,35,30-34,1949,7
STAT,1871,25,50-100,1896,1.2922604255145833
STAT,1823,37,35-39,1860,27.445112865877757
SIM,1849,26,40-44,1875,6
STAT,1874,39,40-44,1913,8.961195499980846
SIM,1867,31,40-44,1898,11
STAT,1879,38,50-100,1917,2.5807143399184187
STAT,1797,93,na,1890,14.141468461485134
SIM,1877,45,45-49,1922,1
STAT,1892,44,40-44,1936,0.38957499831959175
SIM,1920,25,45-49,1945,6
STAT,1904,27,50-100,1931,1.854301731871487
STAT,1898,72,na,1970,4254.2363449173135
SIM,1852,36,40-44,1888,15
STAT,1827,39,45-49,1866,3.9283842922918466
STAT,1848,45,25-29,1893,0.09538873381050256
SIM,1854,47,30-34,1901,1
STAT,1921,19,25-29,1940,99.20278299000942
SIM,1844,32,35-39,1876,23
STAT,1837,60,na,1897,2658.142197704803
SIM,1935,20,45-49,1955,8
STAT,1919,33,15-19,1952,0.27876312460538966
STAT,1868,31,35-39,1899,19.538948118620652
STAT,1922,24,25-29,1946,212.5345826640455
SIM,1861,30,na,1891,4554
STAT,1859,31,40-44,1890,6.9997137053205005
STAT,1825,53,40-44,1878,0.02157422402017473
STAT,1890,28,35-39,1918,23.70238608756693
STAT,1902,38,15-19,1940,0.034388236423390464
STAT,1909,34,35-39,1943,17.470706664725558
SIM,1896,38,20-24,1934,2
SIM,1818,47,45-49,1865,2
STAT,1829,34,na,1863,3298.6821120300024
STAT,1860,40,30-34,1900,1.9045770253276002
STAT,1844,36,40-44,1880,8.294802596354218
STAT,1830,25,na,1855,3935.8339119329457
STAT,1841,68,na,1909,2217.3074756778806
SIM,1930,24,25-29,1954,270
SIM,1928,27,20-24,1955,5
STAT,1930,37,50-100,1967,1.1060217825801473
SIM,1831,28,20-24,1859,21
SIM,1892,39,50-100,1931,5
STAT,1910,49,na,1959,6884.506667370525
STAT,1861,17,35-39,1878,1.060174513972991
STAT,1875,23,50-100,1898,0.8453194956445135
STAT,1802,54,50-100,1856,0.09296879907284822
STAT,1900,49,na,1949,6172.750346130827
STAT,1912,25,45-49,1937,3.4626395567156645
STAT,1855,8,na,1863,4404.296145722862
STAT,1887,37,25-29,1924,6.503509490378949
SIM,1826,36,na,1862,3312
STAT,1938,20,20-24,1958,222.4480082386227
SIM,1915,48,45-49,1963,1
SIM,1917,27,45-49,1944,3
SIM,1835,20,40-44,1855,6
STAT,1905,46,35-39,1951,0.23131377850144505
SIM,1858,38,35-39,1896,15
STAT,1861,50,40-44,1911,0.017951381474635663
STAT,1810,80,na,1890,559.4292633444443
STAT,1898,65,na,1963,5007.690445303284
STAT,1836,19,15-19,1855,15.118208510756173
SIM,1885,38,45-49,1923,8
STAT,1870,49,15-19,1919,7.76570278494044E-4
SIM,1938,0,na,1938,8405
STAT,1906,35,30-34,1941,3.41754541532274
STAT,1943,19,45-49,1962,1.0690960413548412
STAT,1874,32,20-24,1906,5.589695212473838
SIM,1882,32,20-24,1914,7
SIM,1855,23,na,1878,4359
STAT,1875,18,40-44,1893,0.37932332459086815
STAT,1940,25,20-24,1965,37.628668811183736
STAT,1876,25,30-34,1901,52.95832191026855
STAT,1830,30,40-44,1860,8.88005728512638
SIM,1899,34,40-44,1933,17
SIM,1867,49,50-100,1916,1
STAT,1877,38,45-49,1915,4.159920940351678
STAT,1897,28,na,1925,6420.07968389425
STAT,1900,36,40-44,1936,2.6598430346934996
SIM,1845,42,45-49,1887,5
STAT,1909,27,45-49,1936,3.3363262790587838
STAT,1908,25,50-100,1933,1.9307377496762075
SIM,1844,19,15-19,1863,12
STAT,1874,46,30-34,1920,0.20074248553447493
STAT,1927,20,45-49,1947,2.8160191758017876
SIM,1910,26,15-19,1936,3
STAT,1928,30,50-100,1958,2.0899635270686536
SIM,1885,67,na,1952,3283
STAT,1853,22,25-29,1875,107.01710081578841
SIM,1831,37,35-39,1868,24
STAT,1872,67,na,1939,3217.5808498324045
STAT,1880,24,45-49,1904,1.474314950639533
SIM,1884,25,30-34,1909,62
SIM,1951,19,45-49,1970,2
STAT,1912,44,na,1956,7180.144179527587
SIM,1909,30,45-49,1939,5
STAT,1935,17,45-49,1952,1.3794603986178626
SIM,1928,15,20-24,1943,347
STAT,1923,28,25-29,1951,152.03434581210496
SIM,1881,47,25-29,1928,2
SIM,1890,17,20-24,1907,47
SIM,1815,88,na,1903,107
STAT,1931,29,45-49,1960,4.50030997641461
STAT,1910,15,na,1925,7767.889998257968
SIM,1899,20,30-34,1919,63
STAT,1940,23,50-100,1963,1.3533933615694311
STAT,1831,36,30-34,1867,8.809165069196297
SIM,1885,30,30-34,1915,44
STAT,1863,15,na,1878,4685.725043114202
SIM,1871,32,45-49,1903,2
SIM,1896,15,na,1911,7058
STAT,1905,47,50-100,1952,0.4027551433001727
SIM,1875,19,45-49,1894,2
SIM,1917,6,na,1923,8913
SIM,1830,27,25-29,1857,82
STAT,1819,51,40-44,1870,0.043271544720488
STAT,1843,51,35-39,1894,0.012117423844572784
STAT,1907,41,25-29,1948,0.13296622914025438
SIM,1840,26,20-24,1866,25
STAT,1864,40,50-100,1904,1.926467184874803
SIM,1848,16,30-34,1864,2
SIM,1934,19,45-49,1953,1
SIM,1934,5,na,1939,10880
STAT,1941,23,30-34,1964,59.96907041304306
STAT,1909,15,45-49,1924,0.19887208858945227
STAT,1947,16,50-100,1963,0.852534394404023
STAT,1823,46,na,1869,3165.7698772231483
SIM,1848,41,na,1889,3554
SIM,1876,60,na,1936,4191
SIM,1875,36,45-49,1911,5
STAT,1835,24,30-34,1859,30.2406486493281
STAT,1846,43,15-19,1889,0.0211361847603831
STAT,1873,47,25-29,1920,0.11764738442957384
SIM,1872,29,20-24,1901,26
SIM,1943,17,45-49,1960,4
SIM,1876,33,25-29,1909,24
SIM,1881,21,15-19,1902,6
SIM,1927,15,na,1942,9514
STAT,1838,28,15-19,1866,0.7754840483093453
STAT,1892,40,na,1932,5902.461013404792
STAT,1889,46,25-29,1935,0.14384465655080925
STAT,1846,108,na,1954,0.002805667762738712
STAT,1870,26,40-44,1896,5.960069169294301
STAT,1917,29,45-49,1946,3.632640410671429
STAT,1904,26,30-34,1930,73.24627512621815
STAT,1939,30,15-19,1969,0.26513304562553175
STAT,1915,26,25-29,1941,136.06397567637325
STAT,1866,44,30-34,1910,2.113465284136419
STAT,1941,16,25-29,1957,90.17676424625839
STAT,1862,27,45-49,1889,1.9236721370263756
SIM,1827,73,na,1900,1332
SIM,1843,24,30-34,1867,41
STAT,1912,49,30-34,1961,0.17205907506248583
SIM,1874,44,30-34,1918,4
STAT,1802,88,na,1890,105.36278463230074
SIM,1949,21,35-39,1970,32
STAT,1876,23,40-44,1899,4.339334268398517
SIM,1934,15,45-49,1949,2
SIM,1925,17,45-49,1942,2
STAT,1873,27,20-24,1900,24.073596443297433
STAT,1917,17,45-49,1934,0.21708495976276454
STAT,1868,33,25-29,1901,19.598378872549137
STAT,1897,45,20-24,1942,0.01845605782462228
STAT,1878,9,na,1887,5559.290642355812
SIM,1954,15,30-34,1969,44
SIM,1830,29,15-19,1859,1
SIM,1864,75,na,1939,1800
STAT,1841,75,na,1916,1493.6772827037655
STAT,1877,30,30-34,1907,36.91011249638327
SIM,1912,26,30-34,1938,83
STAT,1946,15,30-34,1961,27.315829679721393
STAT,1822,36,50-100,1858,5.130971573381039
STAT,1886,42,40-44,1928,4.789423077699856
STAT,1926,15,45-49,1941,1.2424754553686113
STAT,1912,34,na,1946,7453.69454577302
SIM,1872,38,35-39,1910,23
SIM,1876,26,35-39,1902,27
SIM,1928,25,30-34,1953,123
STAT,1877,23,25-29,1900,119.68213995675902
SIM,1923,26,25-29,1949,22
STAT,1847,35,30-34,1882,8.60599504111898
SIM,1925,29,45-49,1954,8
SIM,1835,32,25-29,1867,28
STAT,1854,42,50-100,1896,1.6175334016060865
STAT,1854,38,na,1892,3593.769083172308
SIM,1913,16,20-24,1929,55
STAT,1946,22,20-24,1968,249.88480749552616
SIM,1840,62,na,1902,2845
STAT,1901,20,25-29,1921,162.8201834454465
SIM,1817,80,na,1897,569
SIM,1940,26,25-29,1966,159
STAT,1915,47,40-44,1962,0.32088428214838216
STAT,1904,15,na,1919,7355.089573887825
STAT,1894,23,25-29,1917,148.05891231128837
STAT,1905,16,20-24,1921,51.90832709948404
SIM,1904,27,35-39,1931,36
SIM,1886,39,25-29,1925,9
STAT,1929,39,30-34,1968,4.715137669288186
STAT,1845,41,40-44,1886,3.574990863852938
STAT,1857,53,na,1910,3335.0877592968377
STAT,1832,26,20-24,1858,20.835051815736012
STAT,1878,43,45-49,1921,3.1340596649140418
STAT,1791,98,na,1889,1.2208567773307906
STAT,1872,26,25-29,1898,86.15555955214019
SIM,1809,61,na,1870,1981
STAT,1846,19,na,1865,4364.867190225246
STAT,1829,29,50-100,1858,1.390129953425229
SIM,1819,48,25-29,1867,1
SIM,1944,11,na,1955,8688
STAT,1840,80,na,1920,892.9068453212863
STAT,1868,48,50-100,1916,0.46599710318583504
STAT,1827,32,25-29,1859,25.282217774512716
STAT,1903,30,na,1933,6917.1439382223725
STAT,1898,23,50-100,1921,1.1110830754836944
STAT,1848,48,na,1896,3642.726793049095
STAT,1853,60,na,1913,3017.542456715765
SIM,1870,27,45-49,1897,2
STAT,1915,40,20-24,1955,0.03601141625615497
SIM,1830,31,45-49,1861,3
STAT,1915,33,50-100,1948,1.6935958786005931
STAT,1919,31,50-100,1950,1.8085128423227042
SIM,1911,31,na,1942,7565
STAT,1860,42,50-100,1902,1.7305354067150696
SIM,1905,38,25-29,1943,6
STAT,1833,34,25-29,1867,17.01452543215077
SIM,1843,38,na,1881,3588
STAT,1901,28,20-24,1929,33.05238629435992
SIM,1855,35,30-34,1890,17
SIM,1904,34,25-29,1938,24
STAT,1785,98,na,1883,1.265060466164193
STAT,1867,36,45-49,1903,3.7886775587098764
STAT,1862,22,35-39,1884,10.311835831725094
SIM,1905,24,15-19,1929,10
SIM,1883,23,50-100,1906,1
SIM,1809,49,45-49,1858,2
SIM,1899,36,30-34,1935,3
STAT,1915,33,30-34,1948,32.27268643259422
STAT,1931,36,35-39,1967,6.475608969931024
SIM,1923,33,30-34,1956,52
STAT,1811,53,50-100,1864,0.09585330181221784
STAT,1861,3,na,1864,5458.882137045387
SIM,1853,41,40-44,1894,7
STAT,1883,44,30-34,1927,2.2504633896335564
SIM,1870,22,35-39,1892,12
STAT,1853,20,35-39,1873,11.06742371152269
SIM,1940,6,na,1946,8393
STAT,1878,50,35-39,1928,0.018420048230058324
SIM,1885,23,25-29,1908,143
STAT,1878,52,na,1930,4517.500394999295
STAT,1867,19,45-49,1886,0.12482429202290665
STAT,1932,26,25-29,1958,174.2046347412883
SIM,1922,46,50-100,1968,1
SIM,1932,30,20-24,1962,5
STAT,1945,6,na,1951,8741.599560840372
STAT,1816,53,30-34,1869,0.02750195174274262
STAT,1828,86,na,1914,272.4763028194509
STAT,1878,39,25-29,1917,6.011969591396718
STAT,1783,79,na,1862,472.22562935969495
SIM,1908,29,45-49,1937,3
SIM,1841,34,25-29,1875,21
STAT,1949,21,na,1970,8608.249271023207
STAT,1854,20,35-39,1874,10.663480587388229
SIM,1817,37,35-39,1854,18
STAT,1916,49,15-19,1965,7.585953963049634E-4
STAT,1832,46,25-29,1878,0.08992774489063932
STAT,1927,36,45-49,1963,1.7130889684906372
STAT,1882,34,20-24,1916,5.272458291229071
SIM,1827,37,45-49,1864,6
SIM,1863,37,30-34,1900,3
SIM,1840,20,15-19,1860,6
SIM,1923,36,35-39,1959,10
SIM,1926,24,35-39,1950,28
SIM,1876,21,40-44,1897,5
STAT,1893,26,45-49,1919,2.851994412180587
STAT,1933,15,50-100,1948,1.017714433776879
SIM,1866,21,30-34,1887,45
STAT,1876,28,35-39,1904,20.084311577264618
SIM,1868,34,na,1902,4564
STAT,1924,48,45-49,1972,0.5209720031614372
STAT,1866,67,na,1933,2954.0212836565597
STAT,1886,28,45-49,1914,2.3587702887032838
STAT,1863,53,na,1916,3745.4677734737274
SIM,1961,0,na,1961,10526
SIM,1940,21,15-19,1961,8
STAT,1775,105,na,1880,0.030782931469495053
SIM,1849,20,na,1869,4332
STAT,1961,3,na,1964,10262.108120093115
STAT,1815,43,20-24,1858,0.9246016854212452
STAT,1935,22,45-49,1957,3.0950443529107
STAT,1944,4,na,1948,8684.590561974766
SIM,1896,37,50-100,1933,4
SIM,1898,29,40-44,1927,13
STAT,1896,33,na,1929,6336.075785671153
STAT,1896,27,25-29,1923,112.79370606578881
SIM,1861,20,35-39,1881,12
STAT,1890,55,na,1945,5097.236366846726
SIM,1884,28,35-39,1912,30
SIM,1886,15,na,1901,5371
STAT,1868,37,40-44,1905,8.411487179501187
SIM,1894,28,45-49,1922,4
SIM,1906,33,30-34,1939,35
STAT,1907,45,40-44,1952,0.2895157496420634
SIM,1804,58,na,1862,2103
SIM,1859,23,30-34,1882,48
SIM,1876,22,na,1898,5076
STAT,1818,49,45-49,1867,1.0087856407305889
STAT,1829,36,25-29,1865,5.1244950511738185
STAT,1828,48,25-29,1876,0.10239355050750384
STAT,1874,52,25-29,1926,0.0072855884082630926
SIM,1858,35,30-34,1893,14
SIM,1889,29,na,1918,5956
STAT,1838,48,35-39,1886,0.19245138555996794
STAT,1830,33,45-49,1863,3.3966427211787615
SIM,1943,22,45-49,1965,4
SIM,1927,37,30-34,1964,5
STAT,1878,36,20-24,1914,1.6337778789869435
STAT,1932,21,15-19,1953,14.149654585979977
SIM,1862,20,35-39,1882,11
STAT,1805,49,35-39,1854,1.1159777857834234
STAT,1840,28,20-24,1868,20.962192697232275
STAT,1819,37,45-49,1856,11.593639478119023
STAT,1880,21,40-44,1901,4.44684044092814
SIM,1819,54,na,1873,2461
SIM,1890,34,20-24,1924,10
STAT,1846,47,30-34,1893,0.14757820413473471
STAT,1913,30,45-49,1943,3.1881125936725097
SIM,1856,49,na,1905,3708
STAT,1888,36,30-34,1924,12.783281188313232
SIM,1919,38,35-39,1957,2
STAT,1940,16,40-44,1956,2.8692112252334896
STAT,1891,46,30-34,1937,0.13669761542104125
STAT,1930,16,30-34,1946,31.903415139552237
STAT,1915,36,35-39,1951,4.958950537754903
SIM,1900,19,15-19,1919,13
SIM,1905,45,30-34,1950,1
STAT,1855,33,15-19,1888,0.2163924100110355
STAT,1910,42,45-49,1952,0.31778196558956884
STAT,1913,26,50-100,1939,2.010385582005802
SIM,1876,37,40-44,1913,14
SIM,1915,45,40-44,1960,1
SIM,1834,35,45-49,1869,6
SIM,1922,36,35-39,1958,12
STAT,1866,40,15-19,1906,0.02599400617378157
SIM,1809,46,40-44,1855,2
SIM,1835,23,45-49,1858,2
SIM,1850,25,50-100,1875,5
STAT,1843,102,na,1945,0.41068471945872026
SIM,1861,23,na,1884,4572
SIM,1845,61,na,1906,3099
STAT,1888,37,50-100,1925,2.9307019366641254
STAT,1921,42,20-24,1963,0.040163013697627606
SIM,1908,20,35-39,1928,28
STAT,1833,46,na,1879,3192.856313277928
SIM,1914,45,na,1959,7522
SIM,1873,89,na,1962,327
STAT,1881,34,na,1915,4618.390846925181
SIM,1775,87,na,1862,61
STAT,1826,35,45-49,1861,5.056066345328349
STAT,1914,36,35-39,1950,4.9016422999499065
SIM,1786,80,na,1866,495
STAT,1866,20,45-49,1886,1.3290716622310288
STAT,1831,29,40-44,1860,5.1132794649615025
SIM,1816,43,na,1859,2955
STAT,1856,33,15-19,1889,0.22230130199293205
SIM,1921,26,50-100,1947,4
STAT,1868,26,35-39,1894,18.604297342200386
SIM,1880,22,45-49,1902,1
SIM,1919,25,20-24,1944,42
STAT,1844,39,45-49,1883,3.33200447742138
STAT,1856,26,50-100,1882,1.0403744369085155
STAT,1919,37,30-34,1956,3.953596834311867
SIM,1875,74,na,1949,2339
STAT,1929,37,40-44,1966,3.8810885158547133
SIM,1807,69,na,1876,1307
STAT,1859,34,45-49,1893,2.7791756464417112
STAT,1874,35,25-29,1909,6.0104797252482705
STAT,1945,17,20-24,1962,299.0809656695044
SIM,1815,44,25-29,1859,4
STAT,1808,79,na,1887,615.4399831299795
STAT,1933,33,na,1966,10288.307949074548
STAT,1848,42,20-24,1890,0.26008627513205096
STAT,1887,48,30-34,1935,0.21590377197704141
SIM,1936,29,na,1965,6448
SIM,1867,21,15-19,1888,6
SIM,1878,88,na,1966,585
SIM,1931,35,30-34,1966,2
STAT,1871,34,45-49,1905,3.469048330085949
SIM,1893,15,30-34,1908,5
STAT,1850,79,na,1929,1071.9169445199566
SIM,1923,23,20-24,1946,260
SIM,1961,3,na,1964,10518
STAT,1842,25,50-100,1867,1.1948608919920836
STAT,1966,0,na,1966,9989.768225603651
SIM,1885,74,na,1959,2524
SIM,1849,29,45-49,1878,6
SIM,1889,17,30-34,1906,7
STAT,1894,21,35-39,1915,15.185258526372186
STAT,1852,25,45-49,1877,2.0910603534860597
STAT,1893,66,na,1959,4402.931559803893
SIM,1860,25,45-49,1885,1
SIM,1839,29,35-39,1868,3
STAT,1805,58,na,1863,2301.9584457069036
STAT,1840,15,25-29,1855,10.716199737004406
STAT,1795,64,na,1859,1769.3325532867814
SIM,1774,95,na,1869,1
STAT,1851,53,35-39,1904,0.01313133580225191
SIM,1928,32,20-24,1960,9
STAT,1827,30,35-39,1857,27.783634315340926
STAT,1861,39,50-100,1900,2.0430742007698957
SIM,1882,35,25-29,1917,1
STAT,1877,1,na,1878,7223.651281724968
SIM,1876,24,45-49,1900,4
STAT,1922,17,35-39,1939,9.805130371832366
STAT,1832,24,30-34,1856,32.544216031466846
SIM,1852,39,45-49,1891,8
STAT,1839,34,na,1873,4078.821886971885
SIM,1877,42,40-44,1919,9
STAT,1906,31,15-19,1937,0.24162942486189976
STAT,1851,68,na,1919,2368.9852801823145
STAT,1918,24,35-39,1942,20.37796026714846
STAT,1868,21,40-44,1889,4.033050981752355
STAT,1858,21,30-34,1879,32.40921581365702
SIM,1858,41,na,1899,3997
STAT,1854,38,25-29,1892,4.391880336086656
STAT,1870,93,na,1963,146.88474468911787
STAT,1837,42,45-49,1879,2.462024053862114
SIM,1835,30,35-39,1865,38
STAT,1772,91,na,1863,28.27672978222332
SIM,1870,75,na,1945,1884
STAT,1829,43,15-19,1872,0.022381194754389155
SIM,1930,17,35-39,1947,15
SIM,1850,46,35-39,1896,2
STAT,1941,26,35-39,1967,31.382276801718998
STAT,1859,21,15-19,1880,6.090093030544585
SIM,1837,36,25-29,1873,6
SIM,1843,42,na,1885,3519
STAT,1903,67,na,1970,5263.43354913491
SIM,1827,80,na,1907,600
SIM,1838,49,50-100,1887,2
STAT,1824,35,na,1859,3120.579417645342
STAT,1865,49,40-44,1914,0.3075611042900112
SIM,1936,23,15-19,1959,9
SIM,1912,19,25-29,1931,25
STAT,1904,19,25-29,1923,16.33827954158779
SIM,1834,24,na,1858,3713
STAT,1841,33,20-24,1874,4.709339178852184
SIM,1789,94,na,1883,5
STAT,1913,18,20-24,1931,55.85019424101429
SIM,1926,29,na,1955,9229
STAT,1923,18,30-34,1941,28.820955088278964
SIM,1921,18,20-24,1939,310
SIM,1948,16,35-39,1964,10
STAT,1842,46,35-39,1888,0.2111568712833453
SIM,1871,25,20-24,1896,24
STAT,1887,17,50-100,1904,0.11066249668818183
STAT,1928,23,15-19,1951,13.379439216228125
SIM,1931,18,30-34,1949,45
SIM,1837,35,na,1872,3544
SIM,1848,30,45-49,1878,6
STAT,1877,33,35-39,1910,21.148434951112126
SIM,1925,24,50-100,1949,2
SIM,1891,47,35-39,1938,1
SIM,1862,42,50-100,1904,4
SIM,1904,17,25-29,1921,18
SIM,1821,37,50-100,1858,3
STAT,1945,27,30-34,1972,86.81080100783637
STAT,1900,25,35-39,1925,27.216073042360726
SIM,1830,24,20-24,1854,111
STAT,1896,34,15-19,1930,0.376468843071812
STAT,1869,29,20-24,1898,22.79365756887306
SIM,1945,15,20-24,1960,303
SIM,1865,19,35-39,1884,2
SIM,1849,46,45-49,1895,1
STAT,1879,49,35-39,1928,0.2895718288206522
STAT,1849,28,40-44,1877,5.576572886607016
SIM,1895,30,40-44,1925,19
STAT,1940,28,25-29,1968,135.49885895938044
STAT,1904,29,35-39,1933,27.769827167027767
STAT,1927,18,15-19,1945,113.6485575573015
STAT,1822,61,na,1883,2240.056652821857
STAT,1917,24,50-100,1941,1.4034146860394248
SIM,1936,29,20-24,1965,33
STAT,1833,51,25-29,1884,0.00490319151715393
STAT,1853,15,35-39,1868,1.056762082494977
SIM,1931,25,20-24,1956,51
STAT,1877,66,na,1943,3437.2635714171497
STAT,1915,23,20-24,1938,231.43797679456242
SIM,1905,28,30-34,1933,10
STAT,1859,85,na,1944,440.6681317623736
SIM,1877,1,na,1878,6731
STAT,1819,54,45-49,1873,0.056185116258386285
STAT,1801,62,na,1863,1944.021288572868
SIM,1885,33,35-39,1918,29
STAT,1868,52,na,1920,4115.343207314571
SIM,1861,15,35-39,1876,1
STAT,1855,39,20-24,1894,1.150690604401697
STAT,1916,39,20-24,1955,0.539707769906034
SIM,1839,36,50-100,1875,1
SIM,1909,46,45-49,1955,1
STAT,1845,24,40-44,1869,3.9292310915273068
STAT,1897,34,15-19,1931,0.38115822172598557
SIM,1896,7,na,1903,7264
SIM,1860,75,na,1935,1759
STAT,1921,48,na,1969,8339.017471019322
STAT,1923,25,20-24,1948,42.599681934897994
SIM,1857,28,40-44,1885,8
SIM,1899,23,35-39,1922,27
STAT,1892,30,15-19,1922,0.3629428607124823
STAT,1816,98,na,1914,3.1908877383212944
STAT,1928,29,20-24,1957,45.366766626267946
SIM,1912,29,35-39,1941,35
STAT,1883,47,35-39,1930,0.27650316291819077
SIM,1859,40,30-34,1899,4
STAT,1870,29,45-49,1899,2.1858044735754736
STAT,1855,23,20-24,1878,120.52746562586165
SIM,1841,26,50-100,1867,1
SIM,1868,38,45-49,1906,6
SIM,1925,44,na,1969,9029
STAT,1823,87,na,1910,211.41719473872726
SIM,1871,23,na,1894,4603
STAT,1867,16,40-44,1883,0.35575738238465576
STAT,1850,38,40-44,1888,6.747747465327184
SIM,1953,17,20-24,1970,330
SIM,1902,16,na,1918,7429
SIM,1908,26,40-44,1934,12
STAT,1914,26,40-44,1940,9.52398336788664
STAT,1937,15,20-24,1952,267.6639357755373
STAT,1833,26,50-100,1859,1.1208797040968679
STAT,1831,39,35-39,1870,11.323103722154341
STAT,1905,26,15-19,1931,1.3297132239681622
SIM,1954,17,20-24,1971,341
STAT,1956,15,50-100,1971,1.0016181230128072
STAT,1835,22,40-44,1857,3.5891230974116537
SIM,1853,24,40-44,1877,7
STAT,1866,54,40-44,1920,0.019078577602749218
SIM,1853,44,45-49,1897,5
STAT,1931,16,15-19,1947,120.26899511390589
STAT,1827,36,40-44,1863,9.341158971686049
STAT,1869,31,35-39,1900,19.899044963737396
SIM,1904,45,na,1949,6654
STAT,1856,44,20-24,1900,0.24412785589336558
STAT,1902,49,20-24,1951,0.018897775910047963
STAT,1847,53,na,1900,3229.464934610428
SIM,1900,34,40-44,1934,17
STAT,1847,37,20-24,1884,1.2191533818212001
SIM,1795,94,na,1889,7
SIM,1876,31,35-39,1907,30
STAT,1801,99,na,1900,1.5012055446322377
STAT,1842,102,na,1944,0.4364831460497445
SIM,1917,32,45-49,1949,1
SIM,1856,45,25-29,1901,1
STAT,1835,72,na,1907,1635.6280500464063
STAT,1890,48,na,1938,5477.538267233489
SIM,1843,22,40-44,1865,3
SIM,1899,39,35-39,1938,4
SIM,1818,42,35-39,1860,6
SIM,1850,24,na,1874,4032
STAT,1946,17,20-24,1963,303.67161941794234
STAT,1887,30,40-44,1917,9.874483034550126
STAT,1804,80,na,1884,531.2354755195224
STAT,1888,32,15-19,1920,0.3399363922006597
SIM,1840,29,25-29,1869,102
SIM,1922,26,40-44,1948,14
STAT,1856,67,na,1923,2470.1437794500757
SIM,1878,37,25-29,1915,9
STAT,1926,16,40-44,1942,3.471348048997569
SIM,1896,32,15-19,1928,1
SIM,1935,18,15-19,1953,119
STAT,1832,29,25-29,1861,72.74684706994249
STAT,1923,35,30-34,1958,4.271028241528674
STAT,1905,19,25-29,1924,16.462509794143664
STAT,1909,32,45-49,1941,3.0343333887889723
STAT,1847,31,15-19,1878,0.2575375645069705
SIM,1863,23,20-24,1886,140
SIM,1913,21,20-24,1934,223
SIM,1921,30,45-49,1951,3
STAT,1837,35,20-24,1872,1.3358406927139796
STAT,1900,15,25-29,1915,15.949807779676286
STAT,1845,44,45-49,1889,2.289061383720494
STAT,1894,27,40-44,1921,7.771681439348096
SIM,1886,36,20-24,1922,4
STAT,1828,30,35-39,1858,24.136100551591156
STAT,1840,22,15-19,1862,6.055776431445852
SIM,1885,20,20-24,1905,132
SIM,1916,30,na,1946,8092
SIM,1858,22,35-39,1880,10
SIM,1928,21,15-19,1949,14
SIM,1796,79,na,1875,526
STAT,1937,28,35-39,1965,29.549045847730717
SIM,1843,27,35-39,1870,22
SIM,1854,75,na,1929,1669
SIM,1846,48,35-39,1894,1
SIM,1917,15,na,1932,8660
SIM,1869,40,40-44,1909,11
STAT,1836,20,na,1856,3750.756325421276
STAT,1824,48,40-44,1872,0.40883655490394666
SIM,1907,63,na,1970,5897
STAT,1833,31,20-24,1864,4.63312221067303
SIM,1919,44,na,1963,8163
SIM,1821,95,na,1916,9
SIM,1833,76,na,1909,1203
STAT,1869,37,na,1906,4610.50486587327
STAT,1881,18,15-19,1899,11.554373467173619
STAT,1891,39,40-44,1930,10.817934991808526
STAT,1863,32,45-49,1895,3.08290442146834
STAT,1886,45,45-49,1931,0.5081545204595157
STAT,1905,21,20-24,1926,201.8859563059919
SIM,1835,36,40-44,1871,13
SIM,1904,38,40-44,1942,7
SIM,1927,27,20-24,1954,49
SIM,1913,19,25-29,1932,28
SIM,1855,31,15-19,1886,1
STAT,1835,27,35-39,1862,16.29444823502626
SIM,1815,95,na,1910,9
SIM,1836,30,35-39,1866,25
SIM,1859,43,35-39,1902,7
SIM,1914,34,35-39,1948,26
SIM,1845,35,20-24,1880,2
STAT,1817,87,na,1904,177.70042020105564
STAT,1808,101,na,1909,0.44839654575350074
SIM,1923,43,25-29,1966,1
SIM,1935,36,45-49,1971,1
STAT,1908,47,15-19,1955,6.732697043713021E-4
STAT,1901,38,15-19,1939,0.034099063342757224
STAT,1762,102,na,1864,0.1859183032550943
STAT,1838,86,na,1924,300.27992862669316
STAT,1889,43,20-24,1932,0.39262455987532513
STAT,1938,3,na,1941,8081.967502733326
STAT,1938,25,15-19,1963,1.4139654152722148
SIM,1905,35,20-24,1940,1
STAT,1895,21,35-39,1916,15.403191225106326
SIM,1878,44,15-19,1922,4
SIM,1933,3,na,1936,11440
SIM,1851,61,na,1912,2882
STAT,1889,51,na,1940,5387.691174777677
SIM,1901,31,na,1932,6776
STAT,1939,21,na,1960,7410.115915926049
STAT,1920,37,20-24,1957,0.5827718210856996
STAT,1829,49,20-24,1878,0.018445133638133125
STAT,1850,45,30-34,1895,0.14990020226886244
SIM,1853,90,na,1943,118
SIM,1884,23,40-44,1907,5
STAT,1917,49,15-19,1966,7.724598591496266E-4
SIM,1946,25,15-19,1971,2
STAT,1857,19,35-39,1876,1.0033105544474967
STAT,1859,32,50-100,1891,1.4728548171479674
STAT,1915,43,25-29,1958,0.14497888314190627
STAT,1853,53,na,1906,3352.0461124167014
STAT,1937,35,25-29,1972,1.9922847807923068
SIM,1836,94,na,1930,10
SIM,1867,32,50-100,1899,2
STAT,1942,29,20-24,1971,38.65533503139571
STAT,1919,27,20-24,1946,39.825031986098566
SIM,1871,16,na,1887,4954
STAT,1859,50,30-34,1909,0.009706164584996716
SIM,1863,96,na,1959,44
STAT,1906,50,na,1956,6463.560116401328
STAT,1880,31,50-100,1911,1.9573457102626546
SIM,1910,29,25-29,1939,141
STAT,1847,38,na,1885,3687.6575242767913
STAT,1904,26,25-29,1930,123.04161095209797
SIM,1881,36,25-29,1917,11
SIM,1848,91,na,1939,61
STAT,1906,34,35-39,1940,16.96659208285594
STAT,1851,43,na,1894,3556.962050328691
SIM,1822,98,na,1920,1
STAT,1862,46,20-24,1908,0.020773227741679244
STAT,1923,20,20-24,1943,262.77256447343126
STAT,1930,18,20-24,1948,353.0632538343465
SIM,1909,41,45-49,1950,1
SIM,1816,42,25-29,1858,2
SIM,1826,88,na,1914,98
STAT,1921,23,20-24,1944,252.80415595814858
SIM,1871,91,na,1962,160
SIM,1793,84,na,1877,142
SIM,1931,39,40-44,1970,7
STAT,1877,30,25-29,1907,21.653023893022908
SIM,1834,26,40-44,1860,10
SIM,1838,20,40-44,1858,6
SIM,1912,26,25-29,1938,127
SIM,1850,39,50-100,1889,5
SIM,1935,33,40-44,1968,20
STAT,1932,26,30-34,1958,103.70345857622384
STAT,1869,27,45-49,1896,2.1727960758049316
STAT,1927,33,40-44,1960,9.714650900149142
STAT,1875,21,30-34,1896,37.14981994016545
STAT,1893,17,40-44,1910,0.4682095242450923
SIM,1914,14,na,1928,8436
STAT,1858,49,50-100,1907,0.3786036160332924
SIM,1831,42,20-24,1873,1
SIM,1903,39,35-39,1942,8
SIM,1918,28,na,1946,8191
STAT,1852,27,50-100,1879,1.1875098610552282
STAT,1914,42,15-19,1956,0.003073751892394599
SIM,1884,42,na,1926,4970
SIM,1919,29,15-19,1948,4
SIM,1839,55,na,1894,2808
SIM,1876,43,35-39,1919,9
SIM,1893,40,30-34,1933,5
SIM,1899,25,30-34,1924,13
STAT,1859,23,na,1882,3916.1646587826203
SIM,1834,83,na,1917,430
STAT,1943,16,35-39,1959,8.988945216386018
STAT,1811,109,na,1920,6.613476574911606E-4
STAT,1924,16,50-100,1940,0.9030252720585119
STAT,1836,48,15-19,1884,5.496152274549767E-4
STAT,1843,48,na,1891,3112.0166469822866
STAT,1838,61,na,1899,2528.9499152294
STAT,1902,29,25-29,1931,119.75392910383314
SIM,1883,33,25-29,1916,32
STAT,1875,33,25-29,1908,21.20809798482551
STAT,1934,21,35-39,1955,25.568191607991146
SIM,1841,16,30-34,1857,3
SIM,1928,0,na,1928,10803
SIM,1941,28,na,1969,7927
SIM,1785,89,na,1874,58
STAT,1892,30,20-24,1922,6.889066063267708
SIM,1928,18,30-34,1946,33
STAT,1912,45,15-19,1957,7.185453124989755E-4
SIM,1920,36,30-34,1956,7
STAT,1810,47,40-44,1857,1.1167309349711245
STAT,1910,23,45-49,1933,2.1282045863012318
STAT,1864,93,na,1957,68.4960057294498
SIM,1800,71,na,1871,1272
STAT,1892,38,50-100,1930,3.0887006727815134
SIM,1942,21,35-39,1963,29
SIM,1951,16,35-39,1967,14
SIM,1874,46,35-39,1920,2
STAT,1911,16,15-19,1927,18.391840148136332
SIM,1832,29,40-44,1861,11
SIM,1905,49,40-44,1954,1
STAT,1930,29,30-34,1959,100.52157006397712
STAT,1904,39,30-34,1943,3.3009829141739413
SIM,1872,49,35-39,1921,1
STAT,1796,80,na,1876,525.9921998653996
SIM,1942,29,45-49,1971,7
STAT,1892,25,na,1917,6074.772449967402
STAT,1913,20,50-100,1933,1.2957219833443483
SIM,1858,34,na,1892,4037
SIM,1854,20,na,1874,4271
SIM,1942,23,30-34,1965,77
STAT,1911,16,50-100,1927,0.15183134088970562
SIM,1857,31,30-34,1888,45
STAT,1939,27,25-29,1966,133.65177767990505
STAT,1932,24,35-39,1956,24.867474115613437
STAT,1916,41,40-44,1957,0.5184152243145834
SIM,1891,43,30-34,1934,2
SIM,1935,31,45-49,1966,7
STAT,1876,17,35-39,1893,1.1461764340055758
STAT,1937,19,15-19,1956,88.9202042487446
STAT,1896,15,na,1911,6765.636441873481
STAT,1866,46,35-39,1912,0.2616278684480032
SIM,1858,10,na,1868,4848
STAT,1894,37,50-100,1931,3.185251914058766
STAT,1914,44,40-44,1958,0.49897156666888764
SIM,1888,22,20-24,1910,147
STAT,1778,112,na,1890,0.0016644512367416848
STAT,1849,31,30-34,1880,32.31426516762247
STAT,1866,40,20-24,1906,0.298931054852962
STAT,1881,65,na,1946,3298.944181994787
STAT,1856,98,na,1954,5.061994409894435
SIM,1911,27,50-100,1938,2
STAT,1870,40,40-44,1910,4.504927687305444
STAT,1818,43,50-100,1861,5.016209762936974
STAT,1843,25,50-100,1868,1.118810190111239
SIM,1877,24,40-44,1901,7
SIM,1829,37,na,1866,3396
SIM,1940,24,35-39,1964,26
STAT,1883,43,30-34,1926,2.264776778876052
SIM,1907,46,40-44,1953,2
SIM,1825,47,na,1872,2766
SIM,1925,26,35-39,1951,47
SIM,1821,33,na,1854,3285
SIM,1953,7,na,1960,9959
STAT,1914,33,30-34,1947,31.89972631238248
STAT,1852,84,na,1936,530.2019998836288
SIM,1945,19,15-19,1964,108
SIM,1905,47,45-49,1952,3
STAT,1863,33,50-100,1896,1.6129954393498405
STAT,1940,32,15-19,1972,0.26862249521227
STAT,1794,97,na,1891,2.1043046576729907
STAT,1870,22,na,1892,4689.482825092958
SIM,1813,45,50-100,1858,1
SIM,1922,33,30-34,1955,37
STAT,1809,64,na,1873,1916.498013969349
STAT,1866,50,50-100,1916,0.02854810376580617
STAT,1864,49,35-39,1913,0.24746624132771405
STAT,1840,20,50-100,1860,0.7594170216278502
STAT,1865,27,30-34,1892,46.20403263631203
STAT,1868,99,na,1967,18.661149320836124
SIM,1909,43,40-44,1952,1
STAT,1934,23,30-34,1957,77.99312651042071
STAT,1863,19,20-24,1882,32.16342881916106
STAT,1915,29,35-39,1944,30.708904564510092
SIM,1885,30,25-29,1915,26
SIM,1838,73,na,1911,1552
SIM,1940,26,30-34,1966,98
STAT,1917,26,35-39,1943,31.90530471200215
STAT,1958,7,na,1965,10424.419161262647
SIM,1929,34,25-29,1963,32
SIM,1781,99,na,1880,2
STAT,1864,43,20-24,1907,0.28463556883229935
STAT,1881,46,30-34,1927,0.1894979643882974
SIM,1879,21,40-44,1900,4
SIM,1888,32,na,1920,5586
STAT,1930,16,25-29,1946,113.42710078912015
SIM,1906,23,20-24,1929,190
SIM,1860,16,40-44,1876,3
STAT,1866,17,na,1883,4830.753563577396
SIM,1871,19,20-24,1890,29
STAT,1835,19,45-49,1854,0.21843550323591396
SIM,1923,29,35-39,1952,45
SIM,1924,41,40-44,1965,1
STAT,1818,104,na,1922,0.06843043552830773
STAT,1844,89,na,1933,169.6524058156209
SIM,1934,34,na,1968,10252
SIM,1872,43,20-24,1915,1
SIM,1804,61,na,1865,1933
SIM,1892,77,na,1969,3283
STAT,1876,94,na,1970,187.97991776115103
SIM,1916,33,30-34,1949,49
STAT,1830,27,15-19,1857,1.0468942279061915
STAT,1890,9,na,1899,6396.1751699789265
SIM,1896,24,50-100,1920,1
STAT,1938,34,25-29,1972,18.74819342421449
SIM,1847,24,25-29,1871,141
STAT,1849,40,15-19,1889,0.022226143696837935
SIM,1873,16,20-24,1889,43
SIM,1859,75,na,1934,1620
STAT,1896,41,45-49,1937,0.27837517384168187
SIM,1856,16,20-24,1872,40
STAT,1831,82,na,1913,602.4270191843794
STAT,1869,7,na,1876,5396.424717201633
STAT,1777,110,na,1887,0.0035511356525688063
STAT,1869,21,30-34,1890,34.96279909551804
STAT,1852,16,40-44,1868,0.3546626049751567
SIM,1863,80,na,1943,1051
STAT,1910,25,40-44,1935,9.232926032397097
STAT,1894,33,35-39,1927,26.16275308144559
STAT,1865,16,20-24,1881,33.71863816169747
SIM,1905,30,20-24,1935,6
STAT,1909,39,na,1948,7123.432065362579
STAT,1908,33,30-34,1941,29.928123065166073
STAT,1861,29,50-100,1890,1.067642702579167
SIM,1850,42,30-34,1892,5
STAT,1899,38,40-44,1937,2.6015505688545333
STAT,1894,44,45-49,1938,0.2659954826175392
SIM,1852,42,35-39,1894,6
SIM,1926,39,na,1965,9493
STAT,1877,49,15-19,1926,8.213477648329107E-4
STAT,1830,38,25-29,1868,5.3206289637286215
STAT,1879,54,20-24,1933,0.0015159708026812678
STAT,1839,37,30-34,1876,9.944599819173998
SIM,1912,39,30-34,1951,6
SIM,1905,21,na,1926,7101
STAT,1934,29,45-49,1963,4.689757676230487
STAT,1851,32,25-29,1883,16.526055633180135
SIM,1846,25,na,1871,4132
STAT,1945,24,15-19,1969,11.773797516260775
SIM,1836,21,45-49,1857,1
STAT,1867,58,na,1925,3740.476523028179
STAT,1944,24,50-100,1968,1.4337616009734826
SIM,1851,95,na,1946,9
STAT,1805,74,na,1879,1043.0524702623252
SIM,1881,5,na,1886,4620
STAT,1907,16,25-29,1923,16.86221596488883
STAT,1928,24,15-19,1952,13.33689259952052
STAT,1792,90,na,1882,61.706344510290656
STAT,1848,27,30-34,1875,49.29358304190489
STAT,1904,28,20-24,1932,33.886721159000516
SIM,1877,21,30-34,1898,43
STAT,1871,63,na,1934,3580.2332691120173
STAT,1886,5,na,1891,5587.0508090915555
SIM,1851,55,na,1906,3212
STAT,1844,42,35-39,1886,2.994979886800969
STAT,1788,85,na,1873,180.94161004218813
SIM,1842,19,na,1861,4246
STAT,1912,36,30-34,1948,3.6108766682081592
STAT,1784,79,na,1863,447.4190267673935
SIM,1897,15,25-29,1912,19
SIM,1856,27,30-34,1883,56
STAT,1862,27,na,1889,4134.806224351296
SIM,1896,67,na,1963,4651
SIM,1915,16,25-29,1931,22
STAT,1889,15,25-29,1904,14.177037312594157
SIM,1858,27,35-39,1885,20
STAT,1848,16,20-24,1864,36.24958580555778
STAT,1780,106,na,1886,0.024324842457503375
STAT,1844,53,45-49,1897,0.02306000603161753
SIM,1913,31,50-100,1944,3
SIM,1901,25,40-44,1926,10
SIM,1912,28,20-24,1940,39
STAT,1798,87,na,1885,113.50120683686632
STAT,1936,34,20-24,1970,4.779651338499319
STAT,1899,31,15-19,1930,0.39567216608531447
STAT,1927,31,45-49,1958,3.9110167562481286
SIM,1861,32,35-39,1893,25
SIM,1925,38,50-100,1963,3
STAT,1823,42,20-24,1865,0.528890861272387
STAT,1930,16,na,1946,9634.151846160697
SIM,1847,37,30-34,1884,19
SIM,1901,36,20-24,1937,3
SIM,1898,34,na,1932,6673
STAT,1899,22,30-34,1921,49.289057340154756
SIM,1821,73,na,1894,1442
STAT,1885,40,30-34,1925,2.334494234227339
STAT,1889,17,20-24,1906,44.14817134402461
SIM,1916,20,25-29,1936,246
STAT,1823,48,35-39,1871,0.4264688423547681
STAT,1852,68,na,1920,2435.6568874393583
STAT,1840,48,35-39,1888,0.2011890550985396
STAT,1840,42,20-24,1882,0.2391277558005825
STAT,1914,47,45-49,1961,0.4353985144207303
SIM,1814,63,na,1877,1990
SIM,1772,82,na,1854,231
STAT,1834,20,30-34,1854,59.97897899326933
SIM,1922,33,50-100,1955,2
STAT,1821,48,25-29,1869,0.16617247335206617
SIM,1901,23,45-49,1924,2
SIM,1830,36,50-100,1866,2
SIM,1902,25,50-100,1927,2
SIM,1854,42,50-100,1896,2
SIM,1916,31,35-39,1947,18
STAT,1829,39,50-100,1868,2.068887952449451
STAT,1889,45,na,1934,5658.4832022795135
STAT,1839,26,20-24,1865,23.24322691878757
SIM,1876,47,na,1923,4844
STAT,1890,33,20-24,1923,6.63534149549831
STAT,1890,39,35-39,1929,17.260370211227826
STAT,1923,39,40-44,1962,3.4945308191326903
STAT,1858,30,15-19,1888,0.22891419120204512
STAT,1856,74,na,1930,1729.312708110028
SIM,1936,24,15-19,1960,5
STAT,1881,30,45-49,1911,3.431445150117294
SIM,1850,30,na,1880,4021
SIM,1898,23,50-100,1921,2
STAT,1853,32,35-39,1885,16.500431732726582
SIM,1894,20,na,1914,6395
STAT,1821,37,15-19,1858,0.21986340854492792
STAT,1927,12,na,1939,9948.358193292146
STAT,1810,45,45-49,1855,1.600024307817776
SIM,1868,32,50-100,1900,2
STAT,1924,16,25-29,1940,104.44994421571651
STAT,1825,42,25-29,1867,1.4825637551388522
STAT,1839,24,25-29,1863,113.20571103701349
SIM,1897,17,20-24,1914,48
SIM,1807,48,50-100,1855,1
STAT,1908,20,25-29,1928,172.63999161033368
STAT,1834,32,25-29,1866,17.46454415463174
SIM,1866,30,15-19,1896,1
SIM,1893,19,na,1912,6727
STAT,1858,37,40-44,1895,6.892020640348298
STAT,1822,46,na,1868,2980.431117938396
SIM,1875,22,na,1897,5281
SIM,1868,12,na,1880,5213
SIM,1880,52,na,1932,4721
SIM,1797,74,na,1871,865
SIM,1906,17,40-44,1923,1
SIM,1931,37,45-49,1968,3
SIM,1959,10,na,1969,10851
STAT,1889,28,30-34,1917,62.488059087142496
SIM,1899,28,35-39,1927,38
STAT,1901,19,na,1920,7102.525714411241
STAT,1947,24,25-29,1971,210.68007599077805
STAT,1871,39,25-29,1910,5.71900790739077
SIM,1897,28,30-34,1925,91
SIM,1809,47,50-100,1856,1
STAT,1845,21,45-49,1866,1.3436038677906397
STAT,1908,31,35-39,1939,17.503854631597907
STAT,1913,44,na,1957,7292.0748748505
SIM,1817,68,na,1885,1732
SIM,1847,26,20-24,1873,25
STAT,1919,34,15-19,1953,0.2775477173821103
STAT,1911,3,na,1914,8172.869829578161
SIM,1842,32,25-29,1874,25
SIM,1932,16,25-29,1948,135
STAT,1835,96,na,1931,11.120939561366711
SIM,1931,20,20-24,1951,299
STAT,1906,34,na,1940,7021.880184807899
SIM,1819,94,na,1913,8
SIM,1898,32,30-34,1930,64
STAT,1908,39,45-49,1947,1.2769392979049652
STAT,1923,37,45-49,1960,1.5947820047054846
SIM,1836,23,40-44,1859,5
SIM,1853,21,45-49,1874,3
STAT,1900,18,35-39,1918,1.5332493232952402
STAT,1849,47,50-100,1896,0.3866784911247896
STAT,1893,50,na,1943,5591.207493672985
STAT,1815,39,40-44,1854,30.592064910715287
SIM,1853,38,15-19,1891,1
STAT,1895,17,45-49,1912,0.17190469956050555
STAT,1906,20,20-24,1926,204.01567847068904
SIM,1898,41,15-19,1939,1
SIM,1936,24,45-49,1960,3
STAT,1921,26,25-29,1947,148.6252991128973
SIM,1932,4,na,1936,10952
STAT,1851,46,45-49,1897,0.3668817953828916
STAT,1905,7,na,1912,7609.673953125716
SIM,1883,47,50-100,1930,2
SIM,1837,19,15-19,1856,12
SIM,1883,30,20-24,1913,6
STAT,1846,96,na,1942,13.152261732348713
SIM,1899,41,50-100,1940,1
SIM,1819,39,20-24,1858,3
SIM,1905,37,na,1942,7170
SIM,1867,27,na,1894,4852
STAT,1920,14,na,1934,8946.951764316535
SIM,1927,34,15-19,1961,1
STAT,1851,100,na,1951,1.645743690425011
STAT,1887,15,15-19,1902,13.4672010238121
STAT,1918,24,50-100,1942,1.424036523567617
STAT,1853,43,45-49,1896,2.3508804655873914
STAT,1874,17,30-34,1891,3.295986231817351
STAT,1865,2,na,1867,6222.472704381402
STAT,1875,24,35-39,1899,12.05805363145345
STAT,1850,16,30-34,1866,3.0040171932693998
STAT,1932,6,na,1938,10719.49506545517
SIM,1895,15,15-19,1910,19
STAT,1875,47,50-100,1922,0.5083078888244615
STAT,1845,38,15-19,1883,0.08997770425532363
STAT,1875,30,20-24,1905,5.665788714028956
SIM,1836,26,45-49,1862,3
SIM,1910,26,20-24,1936,40
STAT,1917,23,30-34,1940,61.4967063641606
STAT,1910,20,40-44,1930,6.417498050656759
SIM,1907,41,40-44,1948,1
SIM,1836,66,na,1902,2042
SIM,1914,20,20-24,1934,202
STAT,1916,44,45-49,1960,0.34330425376284307
SIM,1859,7,na,1866,5117
SIM,1882,17,30-34,1899,5
SIM,1862,39,25-29,1901,8
STAT,1902,26,20-24,1928,33.5652217210433
STAT,1923,23,25-29,1946,216.3199910566018
STAT,1847,46,25-29,1893,0.08805137539828635
STAT,1939,15,30-34,1954,24.704307507494065
SIM,1879,12,na,1891,5389
SIM,1851,26,40-44,1877,10
STAT,1828,26,45-49,1854,5.488136917391639
SIM,1797,58,na,1855,2050
SIM,1879,32,20-24,1911,6
SIM,1910,15,35-39,1925,1
STAT,1826,29,45-49,1855,4.751194541313871
STAT,1764,99,na,1863,0.5071793044004692
SIM,1831,35,na,1866,3750
SIM,1841,19,35-39,1860,2
STAT,1838,21,na,1859,3781.384963161518
STAT,1862,49,25-29,1911,0.09735318492529631
STAT,1864,53,na,1917,3824.721964996144
SIM,1839,15,na,1854,4127
SIM,1888,27,20-24,1915,27
STAT,1806,99,na,1905,1.289563615917961
SIM,1923,24,35-39,1947,30
STAT,1862,38,15-19,1900,0.09645328116217738
SIM,1917,49,50-100,1966,1
STAT,1931,33,30-34,1964,41.669528039294406
SIM,1912,31,na,1943,7727
STAT,1894,30,25-29,1924,26.786980638962564
STAT,1823,71,na,1894,1601.7626634112935
SIM,1947,15,30-34,1962,38
SIM,1894,20,25-29,1914,176
SIM,1925,23,30-34,1948,86
SIM,1834,29,45-49,1863,2
SIM,1888,38,30-34,1926,19
STAT,1886,46,50-100,1932,0.5250917059523255
SIM,1884,82,na,1966,1623
STAT,1902,18,45-49,1920,0.18576908046240653
STAT,1886,39,15-19,1925,0.11851338918090892
STAT,1930,32,na,1962,9857.415435212073
SIM,1939,2,na,1941,8458
STAT,1921,35,15-19,1956,0.04336932098560425
SIM,1904,18,15-19,1922,16
SIM,1906,26,25-29,1932,142
SIM,1883,49,40-44,1932,2
SIM,1902,16,15-19,1918,18
STAT,1885,71,na,1956,2745.20021866325
SIM,1878,19,30-34,1897,4
STAT,1888,47,25-29,1935,0.1368539416400108
SIM,1838,31,20-24,1869,9
SIM,1841,42,50-100,1883,2
STAT,1883,40,20-24,1923,0.3183082305730971
STAT,1901,59,na,1960,5716.5380323598765
SIM,1860,2,na,1862,5838
STAT,1841,29,40-44,1870,5.321137739647615
STAT,1878,17,45-49,1895,0.1377848041484673
STAT,1928,44,50-100,1972,0.3014172866658286
STAT,1842,42,30-34,1884,1.770879990500259
STAT,1937,4,na,1941,7931.720534343059
SIM,1847,10,na,1857,4648
STAT,1897,22,20-24,1919,186.03905769748027
SIM,1821,34,50-100,1855,3
SIM,1913,43,30-34,1956,1
STAT,1913,16,25-29,1929,17.9427497550899
SIM,1921,16,25-29,1937,121
STAT,1814,94,na,1908,17.200609436449714
STAT,1891,17,30-34,1908,3.978907143558274
STAT,1881,49,35-39,1930,0.2675852635086799
STAT,1896,6,na,1902,6965.663452681106
SIM,1916,34,45-49,1950,3
STAT,1843,26,40-44,1869,5.201568660580877
STAT,1847,81,na,1928,824.3099584083133
STAT,1825,45,35-39,1870,0.3120722226846296
STAT,1908,36,50-100,1944,0.7982569090863408
SIM,1850,14,na,1864,4623
SIM,1947,24,20-24,1971,250
STAT,1833,42,50-100,1875,1.685812453951389
STAT,1841,41,na,1882,3529.5825146463226
STAT,1872,88,na,1960,449.87331690755445
STAT,1949,2,na,1951,9421.638385148992
SIM,1802,78,na,1880,685
SIM,1901,22,30-34,1923,66
STAT,1827,53,45-49,1880,0.02480047507424288
STAT,1893,10,na,1903,6630.918679713877
STAT,1928,24,45-49,1952,2.8190467369234686
STAT,1827,42,35-39,1869,3.439728007913797
SIM,1843,60,na,1903,2830
STAT,1819,48,15-19,1867,0.001653527055428481
STAT,1943,27,15-19,1970,1.5183971763526414
SIM,1909,11,na,1920,7908
STAT,1918,41,45-49,1959,0.3578276193368658
SIM,1857,34,35-39,1891,26
STAT,1868,40,25-29,1908,1.2463724024771967
SIM,1832,22,15-19,1854,6
STAT,1927,44,20-24,1971,0.0445763132063038
STAT,1939,24,20-24,1963,225.40500877519796
STAT,1905,43,30-34,1948,0.23149700996504827
SIM,1877,29,50-100,1906,1
STAT,1776,84,na,1860,200.52053971817313
SIM,1918,31,45-49,1949,4
STAT,1757,104,na,1861,0.10614860334422843
STAT,1875,53,na,1928,4405.30650152182
SIM,1853,19,na,1872,4555
SIM,1867,17,35-39,1884,1
STAT,1859,17,35-39,1876,1.0238682855064214
SIM,1905,44,40-44,1949,1
SIM,1926,41,45-49,1967,1
SIM,1832,26,30-34,1858,54
STAT,1854,16,45-49,1870,0.12049936092942723
STAT,1900,43,50-100,1943,0.204048573481005
STAT,1849,34,35-39,1883,16.53306295577966
STAT,1832,35,25-29,1867,4.845023956893211
STAT,1873,16,50-100,1889,0.10112973877585611
STAT,1917,34,na,1951,7929.362841292774
SIM,1835,42,35-39,1877,5
SIM,1882,16,na,1898,5286
SIM,1938,24,na,1962,7315
STAT,1840,43,na,1883,3435.7756055455916
STAT,1920,42,15-19,1962,0.003424615719699696
STAT,1834,71,na,1905,1773.8670831961704
SIM,1863,40,45-49,1903,5
STAT,1822,102,na,1924,0.3310189947894653
SIM,1855,45,na,1900,4012
STAT,1921,29,35-39,1950,33.54392743297051
SIM,1905,33,25-29,1938,5
STAT,1902,26,15-19,1928,1.2981025079071193
SIM,1931,34,40-44,1965,16
STAT,1848,19,25-29,1867,11.383243253175877
STAT,1908,34,45-49,1942,2.9760951183411515
SIM,1796,89,na,1885,82
STAT,1862,49,30-34,1911,0.16360743735405892
STAT,1816,52,30-34,1868,0.028056541652989656
STAT,1846,50,45-49,1896,0.022548234240138885
SIM,1833,45,35-39,1878,1
STAT,1843,91,na,1934,81.17432851440834
STAT,1852,19,45-49,1871,0.12444016839869004
STAT,1914,45,25-29,1959,0.1067669067624666
STAT,1869,24,35-39,1893,11.348192461726672
SIM,1864,21,20-24,1885,124
SIM,1914,36,30-34,1950,3
SIM,1861,43,45-49,1904,4
SIM,1864,22,na,1886,4519
SIM,1866,37,40-44,1903,16
STAT,1909,27,15-19,1936,1.3633211294235033
STAT,1904,23,15-19,1927,9.533462263270506
SIM,1860,91,na,1951,70
SIM,1884,17,35-39,1901,2
SIM,1856,19,25-29,1875,13
STAT,1882,16,20-24,1898,34.96471731777747
SIM,1864,81,na,1945,863
SIM,1858,24,30-34,1882,39
STAT,1923,34,40-44,1957,9.045923690706486
SIM,1840,35,25-29,1875,8
STAT,1837,29,20-24,1866,20.690915063450152
SIM,1849,21,25-29,1870,123
SIM,1867,70,na,1937,2624
STAT,1875,49,40-44,1924,0.34855229433046514
STAT,1938,31,20-24,1969,4.956976934490222
STAT,1905,49,na,1954,6435.284144808512
STAT,1933,18,50-100,1951,1.0103537709901929
SIM,1877,27,45-49,1904,4
SIM,1837,19,20-24,1856,35
SIM,1941,18,50-100,1959,1
STAT,1845,74,na,1919,1710.1128105647042
STAT,1892,36,35-39,1928,17.96850749360378
STAT,1872,35,50-100,1907,2.5156660409107854
STAT,1912,22,40-44,1934,6.509656623854885
SIM,1887,47,na,1934,5450
SIM,1806,68,na,1874,1541
SIM,1920,22,40-44,1942,10
STAT,1925,47,20-24,1972,0.0270398077912277
STAT,1782,102,na,1884,0.16982958990656305
STAT,1915,24,35-39,1939,19.535745553787592
STAT,1948,17,25-29,1965,100.15257061331552
STAT,1826,36,na,1862,3431.1307161503946
STAT,1871,28,15-19,1899,0.907156489319413
STAT,1864,51,50-100,1915,0.02739559034897521
STAT,1906,36,30-34,1942,3.4016880045956426
STAT,1910,55,na,1965,6707.761259611343
STAT,1938,32,50-100,1970,1.679273095405032
STAT,1892,47,45-49,1939,0.33500685362445765
SIM,1892,27,40-44,1919,13
SIM,1847,50,na,1897,3327
SIM,1873,27,30-34,1900,60
STAT,1912,33,20-24,1945,4.82816720853774
STAT,1858,34,30-34,1892,27.25355002182816
SIM,1872,57,na,1929,4178
STAT,1920,42,45-49,1962,0.37114270256530446
STAT,1934,24,45-49,1958,3.0522339016887163
SIM,1931,8,na,1939,10563
SIM,1845,29,20-24,1874,27
STAT,1868,54,45-49,1922,0.02711914033372487
STAT,1878,45,na,1923,4792.902180302482
STAT,1949,21,25-29,1970,217.73905779077867
STAT,1834,48,40-44,1882,0.23860705485968886
STAT,1922,22,50-100,1944,1.523532483860013
STAT,1886,20,25-29,1906,122.77254238942065
STAT,1901,31,25-29,1932,29.077969257604867
STAT,1840,45,30-34,1885,0.1445585725848093
STAT,1863,68,na,1931,2701.7014659123565
SIM,1922,45,25-29,1967,1
STAT,1845,49,25-29,1894,0.0869046972763165
STAT,1942,30,50-100,1972,1.7807802131408423
SIM,1966,1,na,1967,9450
STAT,1941,19,35-39,1960,8.72352073178746
SIM,1898,10,na,1908,7323
STAT,1889,61,na,1950,4653.3376917868445
SIM,1911,30,45-49,1941,4
STAT,1919,39,20-24,1958,0.5706151310925377
SIM,1818,53,na,1871,2620
SIM,1936,27,25-29,1963,119
STAT,1868,43,35-39,1911,3.454391144884466
SIM,1825,36,40-44,1861,12
STAT,1858,23,20-24,1881,112.46809139449321
SIM,1922,49,na,1971,8869
STAT,1902,15,35-39,1917,1.571828884039426
STAT,1874,31,na,1905,4954.854224394893
STAT,1892,65,na,1957,4377.102203009181
SIM,1898,35,35-39,1933,24
SIM,1931,23,25-29,1954,253
SIM,1822,47,50-100,1869,1
STAT,1917,37,15-19,1954,0.04027970894060358
SIM,1869,53,na,1922,4069
STAT,1926,30,na,1956,9244.91908170795
STAT,1925,36,40-44,1961,3.6312443736834576
STAT,1873,36,25-29,1909,5.936711039611784
SIM,1929,28,na,1957,9624
STAT,1855,33,na,1888,3626.0658251634263
STAT,1784,95,na,1879,4.217369623797001
STAT,1839,27,50-100,1866,1.2583063286741674
SIM,1835,25,na,1860,3801
SIM,1942,24,45-49,1966,5
STAT,1860,63,na,1923,2926.406766739964
STAT,1834,23,35-39,1857,10.314179081663106
SIM,1820,42,45-49,1862,7
STAT,1781,90,na,1871,57.48562861888582
STAT,1844,38,50-100,1882,2.0735246849930697
SIM,1866,23,20-24,1889,133
STAT,1939,18,40-44,1957,2.827043528793912
STAT,1856,21,20-24,1877,125.61600363137514
STAT,1928,27,25-29,1955,163.74615044468968
STAT,1839,33,15-19,1872,0.27081218338557944
STAT,1857,36,50-100,1893,1.9420111266227238
SIM,1903,20,45-49,1923,3
SIM,1851,71,na,1922,1969
SIM,1920,33,20-24,1953,8
SIM,1938,21,15-19,1959,11
STAT,1903,30,45-49,1933,5.054776534573795
SIM,1855,85,na,1940,391
SIM,1869,25,15-19,1894,1
SIM,1912,23,20-24,1935,6
STAT,1859,35,50-100,1894,1.992326573160829
STAT,1851,35,35-39,1886,11.314280780414341
STAT,1869,24,40-44,1893,4.052359612001408
STAT,1857,53,30-34,1910,0.009220031968070983
STAT,1904,23,20-24,1927,199.14212640222996
SIM,1926,23,na,1949,9105
STAT,1876,19,na,1895,5247.344786229331
SIM,1947,18,40-44,1965,3
STAT,1812,42,45-49,1854,12.253910931808768
SIM,1852,38,50-100,1890,6
STAT,1821,45,20-24,1866,0.036154347749379694
SIM,1842,48,40-44,1890,1
STAT,1875,30,15-19,1905,0.2984958403907029
STAT,1884,27,40-44,1911,5.973964631482954
SIM,1933,36,40-44,1969,10
STAT,1875,93,na,1968,224.91484173448984
SIM,1927,24,na,1951,9265
STAT,1853,40,40-44,1893,3.5947171629124264
SIM,1851,29,45-49,1880,2
STAT,1938,31,15-19,1969,0.2611528721842888
STAT,1939,18,35-39,1957,8.481130095334388
STAT,1897,37,25-29,1934,7.772801410490881
SIM,1844,31,45-49,1875,7
STAT,1830,32,50-100,1862,1.8147822871202284
STAT,1854,32,na,1886,3746.201772451951
SIM,1788,78,na,1866,538
SIM,1911,32,40-44,1943,12
STAT,1826,102,na,1928,0.3509612597108627
STAT,1928,34,na,1962,9537.135476730411
SIM,1874,80,na,1954,998
SIM,1897,19,40-44,1916,2
STAT,1865,94,na,1959,61.81814541304333
SIM,1870,23,40-44,1893,4
STAT,1847,23,45-49,1870,1.2937248423751897
SIM,1796,73,na,1869,960
STAT,1850,19,35-39,1869,1.016003475041307
STAT,1889,19,40-44,1908,0.45302860604979545
STAT,1910,22,30-34,1932,54.53105639696389
STAT,1955,11,na,1966,10531.789265878737
SIM,1900,62,na,1962,5679
SIM,1894,32,50-100,1926,4
STAT,1831,52,20-24,1883,9.934979922697593E-4
STAT,1825,30,30-34,1855,77.84872062492994
SIM,1872,17,na,1889,5408
STAT,1842,39,50-100,1881,1.9111558127311363
STAT,1862,20,50-100,1882,0.7310639569631254
SIM,1921,47,50-100,1968,1
STAT,1839,21,15-19,1860,6.666533470145809
STAT,1888,32,20-24,1920,6.452377265617019
SIM,1842,23,35-39,1865,12
SIM,1947,18,35-39,1965,12
SIM,1873,23,15-19,1896,6
SIM,1847,21,15-19,1868,6
SIM,1896,32,20-24,1928,9
STAT,1828,31,50-100,1859,2.1177364595531265
STAT,1834,35,35-39,1869,11.956800666987936
STAT,1838,40,45-49,1878,2.430326544844936
STAT,1845,55,na,1900,3186.2136098608676
STAT,1862,23,40-44,1885,3.6558451588280296
STAT,1946,21,50-100,1967,1.4791841126453007
STAT,1834,46,45-49,1880,0.37083267986396706
STAT,1936,34,15-19,1970,0.25181066839419225
SIM,1847,29,25-29,1876,88
STAT,1928,28,30-34,1956,97.43076729641112
STAT,1940,23,25-29,1963,189.98934025108014
SIM,1915,39,na,1954,7661
STAT,1811,46,na,1857,2834.5475565539573
SIM,1855,23,45-49,1878,3
SIM,1827,89,na,1916,69
STAT,1932,27,45-49,1959,4.570364467904527
SIM,1837,18,30-34,1855,3
STAT,1899,35,30-34,1934,14.887741256241863
SIM,1872,20,40-44,1892,5
STAT,1876,53,35-39,1929,0.017694378840657794
STAT,1868,42,50-100,1910,2.0275009196216174
SIM,1842,35,35-39,1877,14
STAT,1880,40,na,1920,4966.948994069619
SIM,1808,94,na,1902,9
SIM,1854,19,15-19,1873,13
SIM,1923,46,50-100,1969,3
STAT,1846,19,15-19,1865,11.284764576801685
STAT,1816,52,25-29,1868,0.016694801483852075
STAT,1874,68,na,1942,3160.1823412570757
STAT,1820,82,na,1902,522.342478367728
STAT,1895,17,na,1912,6646.462248002129
SIM,1889,42,30-34,1931,5
STAT,1814,44,15-19,1858,0.07425992690977287
STAT,1899,24,20-24,1923,189.4966710823928
SIM,1889,57,na,1946,5057
STAT,1948,15,50-100,1963,0.8663312885970994
SIM,1885,43,na,1928,4860
STAT,1864,20,40-44,1884,3.8779014084025363
STAT,1832,39,40-44,1871,7.058893476824574
STAT,1917,37,20-24,1954,0.5529304804354541
STAT,1947,16,na,1963,8375.61820583006
STAT,1931,40,25-29,1971,0.19320826401496113
SIM,1840,39,40-44,1879,18
STAT,1903,27,50-100,1930,1.839475375673502
SIM,1855,31,20-24,1886,6
STAT,1883,43,25-29,1926,1.2650104582416868
SIM,1902,19,25-29,1921,22
SIM,1925,17,50-100,1942,1
SIM,1871,32,na,1903,4654
STAT,1891,30,50-100,1921,2.3056846277180374
STAT,1910,39,25-29,1949,1.8833757754182288
STAT,1827,50,40-44,1877,0.01909413129034548
SIM,1846,40,45-49,1886,6
STAT,1841,25,25-29,1866,77.33904388022313
STAT,1904,35,15-19,1939,0.03546775698402415
SIM,1818,41,45-49,1859,3
STAT,1890,36,30-34,1926,13.201475364326614
SIM,1862,29,20-24,1891,23
SIM,1910,15,40-44,1925,1
SIM,1883,24,35-39,1907,14
STAT,1855,73,na,1928,1791.0530668849556
SIM,1873,58,na,1931,4085
STAT,1866,38,50-100,1904,2.27652588902245
SIM,1826,43,50-100,1869,3
SIM,1906,62,na,1968,5858
SIM,1836,63,na,1899,2256
STAT,1919,34,20-24,1953,5.268169642463925
STAT,1823,45,30-34,1868,0.30773695084309705
STAT,1886,56,na,1942,4348.382581276199
STAT,1892,21,30-34,1913,45.170686152239
SIM,1828,29,15-19,1857,1
STAT,1931,17,na,1948,9730.374650471787
STAT,1854,29,20-24,1883,18.583507503268397
SIM,1863,37,na,1900,4474
STAT,1886,47,20-24,1933,0.025464041072934006
SIM,1874,50,50-100,1924,1
SIM,1904,17,30-34,1921,8
STAT,1876,35,na,1911,4968.044076794343
STAT,1899,22,25-29,1921,158.40654526206094
STAT,1894,41,40-44,1935,5.861918391844315
STAT,1954,18,30-34,1972,30.418746845147492
STAT,1825,51,na,1876,2815.6674718818144
STAT,1830,81,na,1911,746.7325820362363
SIM,1873,19,25-29,1892,16
STAT,1843,29,45-49,1872,1.8867261124598096
STAT,1905,65,na,1970,5611.583513544387
STAT,1928,2,na,1930,10406.191543115874
STAT,1843,23,30-34,1866,31.09469321568529
STAT,1922,43,30-34,1965,0.2958128056235792
STAT,1875,47,45-49,1922,0.4884391773598879
SIM,1851,25,50-100,1876,3
STAT,1829,65,na,1894,2000.086013691494
SIM,1895,42,na,1937,6408
STAT,1764,100,na,1864,0.31048502656787924
STAT,1845,20,30-34,1865,34.56903185712982
STAT,1865,23,15-19,1888,6.082677280738733
SIM,1940,0,na,1940,8746
SIM,1923,2,na,1925,10057
STAT,1872,53,20-24,1925,0.001473736327816024
SIM,1927,34,20-24,1961,5
STAT,1901,2,na,1903,7536.80426699304
SIM,1895,8,na,1903,7279
SIM,1833,30,30-34,1863,31
SIM,1848,51,na,1899,3310
STAT,1877,32,45-49,1909,3.657071016354234
STAT,1943,26,na,1969,8061.025613371744
SIM,1885,32,45-49,1917,4
STAT,1797,62,na,1859,1778.063557678051
STAT,1950,0,na,1950,10519.551296911406
SIM,1841,34,na,1875,3709
STAT,1902,15,40-44,1917,0.5239429916821495
SIM,1851,23,30-34,1874,42
STAT,1835,52,35-39,1887,0.011368285719883471
STAT,1910,39,na,1949,7196.407149035967
SIM,1923,31,na,1954,9163
STAT,1875,36,35-39,1911,14.777876424792952
SIM,1883,47,45-49,1930,1
STAT,1910,20,35-39,1930,17.97150548680953
STAT,1894,21,50-100,1915,1.0611642420478873
SIM,1883,36,35-39,1919,19
SIM,1866,36,35-39,1902,25
SIM,1907,41,35-39,1948,1
STAT,1882,23,20-24,1905,135.15927477905157
STAT,1865,19,25-29,1884,10.588464718445767
STAT,1879,41,45-49,1920,3.1759236964945043
STAT,1912,48,25-29,1960,0.10269960031955584
SIM,1933,33,30-34,1966,59
SIM,1897,37,50-100,1934,5
STAT,1901,33,45-49,1934,4.9096223928743115
STAT,1930,25,15-19,1955,1.8144707008336687
SIM,1922,30,20-24,1952,9
SIM,1918,35,50-100,1953,2
SIM,1937,23,na,1960,7294
SIM,1914,39,35-39,1953,8
STAT,1898,41,na,1939,6367.317320722984
STAT,1894,30,30-34,1924,45.661542411225724
SIM,1837,88,na,1925,144
SIM,1848,41,30-34,1889,4
STAT,1837,33,50-100,1870,1.5849603776068728
SIM,1816,45,35-39,1861,1
SIM,1928,18,25-29,1946,139
SIM,1942,13,na,1955,8452
STAT,1906,37,45-49,1943,1.2662800030717083
STAT,1878,42,na,1920,4869.097555716222
SIM,1866,47,45-49,1913,2
SIM,1869,29,30-34,1898,67
STAT,1877,34,40-44,1911,9.016914702947975
SIM,1907,30,25-29,1937,16
STAT,1817,56,na,1873,2501.990371579804
STAT,1890,46,50-100,1936,0.3424895142732971
STAT,1910,28,45-49,1938,3.3586406674982814
SIM,1814,49,40-44,1863,2
STAT,1844,33,na,1877,4142.093097331726
SIM,1823,32,20-24,1855,7
SIM,1861,33,na,1894,4497
STAT,1888,24,45-49,1912,1.6541316241260695
SIM,1836,23,35-39,1859,14
STAT,1906,39,35-39,1945,4.447563070190873
SIM,1915,36,na,1951,7780
STAT,1871,22,50-100,1893,0.8182375797517136
STAT,1770,90,na,1860,47.76460204495258
SIM,1885,34,40-44,1919,15
STAT,1906,20,15-19,1926,9.766772138845981
STAT,1844,92,na,1936,67.26022255872155
SIM,1891,43,25-29,1934,1
STAT,1790,67,na,1857,1344.8311567644164
SIM,1872,46,30-34,1918,1
STAT,1822,86,na,1908,250.5167018217989
STAT,1862,21,45-49,1883,1.2411434620650232
STAT,1864,46,30-34,1910,0.1752501179307425
STAT,1918,35,na,1953,8083.354613319976
STAT,1787,84,na,1871,206.50073924503965
STAT,1810,50,50-100,1860,0.09720650776892246
STAT,1857,43,na,1900,3612.0639407188196
STAT,1866,36,na,1902,4411.446506737477
SIM,1914,37,45-49,1951,1
SIM,1841,93,na,1934,26
STAT,1879,83,na,1962,1268.6617272683384
STAT,1862,43,na,1905,3960.844492766294
STAT,1915,17,40-44,1932,0.5912787384018924
SIM,1829,33,45-49,1862,2
SIM,1923,17,40-44,1940,4
SIM,1852,96,na,1948,11
SIM,1887,41,45-49,1928,5
STAT,1873,24,25-29,1897,116.73581760764722
STAT,1925,33,30-34,1958,37.75424978015283
STAT,1880,19,20-24,1899,37.516467106897544
STAT,1884,24,30-34,1908,35.30013318412268
SIM,1890,7,na,1897,6913
SIM,1938,24,25-29,1962,206
SIM,1883,57,na,1940,4101
SIM,1881,21,20-24,1902,126
SIM,1914,20,15-19,1934,10
STAT,1917,38,50-100,1955,0.8762927202455655
SIM,1919,24,15-19,1943,8
SIM,1940,27,45-49,1967,2
STAT,1881,25,na,1906,4690.293395018127
SIM,1828,52,na,1880,2868
SIM,1829,29,50-100,1858,2
SIM,1844,33,40-44,1877,13
STAT,1845,46,20-24,1891,0.01854372889523748
SIM,1933,31,35-39,1964,39
SIM,1908,23,30-34,1931,68
STAT,1866,57,na,1923,3744.9066145472834
SIM,1825,33,30-34,1858,33
STAT,1916,43,30-34,1959,0.26417699584721166
SIM,1807,53,na,1860,2241
STAT,1941,16,30-34,1957,25.36383920310751
STAT,1868,40,30-34,1908,2.231408646918088
SIM,1825,39,45-49,1864,3
STAT,1845,58,na,1903,3047.35051956077
SIM,1803,79,na,1882,679
SIM,1925,38,na,1963,9092
SIM,1857,46,35-39,1903,1
SIM,1870,21,45-49,1891,2
SIM,1855,34,25-29,1889,26
SIM,1890,14,na,1904,6829
STAT,1806,49,40-44,1855,1.011566405674642
STAT,1862,47,50-100,1909,0.4219785237886758
SIM,1922,49,40-44,1971,1
STAT,1847,34,25-29,1881,16.339177554276688
STAT,1836,31,45-49,1867,2.9619536861331524
STAT,1914,30,20-24,1944,4.999410488322667
SIM,1860,27,50-100,1887,1
SIM,1903,49,30-34,1952,1
SIM,1786,71,na,1857,1190
STAT,1867,98,na,1965,23.92035016368829
STAT,1817,39,45-49,1856,12.434567276372206
STAT,1833,30,na,1863,3744.476745440781
STAT,1919,46,15-19,1965,8.087723059424477E-4
STAT,1867,27,40-44,1894,5.665883249392594
STAT,1916,49,na,1965,7565.538983267869
SIM,1834,22,25-29,1856,98
SIM,1823,39,40-44,1862,13
SIM,1890,23,20-24,1913,173
STAT,1868,51,40-44,1919,0.020325945168357822
SIM,1840,20,20-24,1860,144
STAT,1921,26,30-34,1947,88.47616237549043
STAT,1890,20,45-49,1910,1.7292629840470313
STAT,1914,49,40-44,1963,0.31399709657633734
SIM,1803,60,na,1863,2116
SIM,1938,17,50-100,1955,1
STAT,1842,42,25-29,1884,0.9891401789210804
STAT,1850,51,25-29,1901,0.005456845876544321
STAT,1935,15,50-100,1950,1.03940217960794
SIM,1874,83,na,1957,725
STAT,1925,20,25-29,1945,224.58660547654665
STAT,1851,20,30-34,1871,33.45312428765357
STAT,1829,25,na,1854,3122.7476424684373
SIM,1859,35,na,1894,4264
STAT,1846,42,50-100,1888,1.6377667872166688
SIM,1877,24,35-39,1901,15
STAT,1836,33,40-44,1869,7.2146938483857905
STAT,1901,45,45-49,1946,0.3801421354817391
STAT,1917,50,na,1967,7679.387317275293
SIM,1888,72,na,1960,3300
STAT,1856,36,25-29,1892,4.508062832957152
SIM,1868,31,30-34,1899,39
SIM,1933,20,25-29,1953,304
SIM,1876,40,30-34,1916,3
STAT,1945,24,20-24,1969,245.9399333074108
SIM,1883,26,50-100,1909,1
SIM,1874,21,na,1895,4598
SIM,1934,16,35-39,1950,12
SIM,1833,42,25-29,1875,2
STAT,1892,17,50-100,1909,0.12386596600259163
STAT,1928,29,15-19,1957,1.7545158504427398
STAT,1869,68,na,1937,2990.590196481773
STAT,1768,89,na,1857,61.48746812141199
SIM,1904,36,na,1940,7005
SIM,1864,36,25-29,1900,9
SIM,1901,47,na,1948,6391
STAT,1865,54,na,1919,3842.015836026041
SIM,1948,23,na,1971,8624
STAT,1868,43,na,1911,4409.026621980382
STAT,1849,44,30-34,1893,1.7939962812807702
SIM,1916,36,40-44,1952,6
STAT,1914,49,50-100,1963,0.45045377840437234
STAT,1915,26,30-34,1941,80.99844694847728
STAT,1892,33,25-29,1925,25.787051983063233
STAT,1928,24,20-24,1952,278.5910384414264
SIM,1894,22,45-49,1916,3
SIM,1922,3,na,1925,9935
STAT,1814,52,20-24,1866,0.0036643652039139033
SIM,1889,45,35-39,1934,1
STAT,1915,8,na,1923,8403.66713255103
STAT,1789,105,na,1894,0.015005998181203163
SIM,1827,31,45-49,1858,5
STAT,1925,39,45-49,1964,1.6486233911398347
STAT,1847,20,40-44,1867,3.950527965513982
STAT,1877,20,na,1897,4989.474561687081
SIM,1853,81,na,1934,679
SIM,1862,55,na,1917,3763
STAT,1920,25,50-100,1945,2.2196177635869883
STAT,1874,53,30-34,1927,0.012111725200479538
STAT,1925,31,35-39,1956,21.924696264989464
STAT,1841,81,na,1922,784.6113760990831
SIM,1903,11,na,1914,7658
SIM,1945,18,30-34,1963,38
STAT,1864,23,45-49,1887,1.2699409881735568
STAT,1926,16,35-39,1942,10.414043544031975
SIM,1813,78,na,1891,635
STAT,1855,40,45-49,1895,2.279607458998108
STAT,1881,43,20-24,1924,0.30777645985688695
STAT,1932,29,35-39,1961,39.678779150429634
SIM,1913,32,na,1945,7752
SIM,1840,71,na,1911,2103
SIM,1893,43,35-39,1936,1
STAT,1875,3,na,1878,6409.691065978314
SIM,1917,46,na,1963,7943
SIM,1901,20,35-39,1921,21
STAT,1854,91,na,1945,88.83326599970383
SIM,1872,23,45-49,1895,1
SIM,1866,34,30-34,1900,43
SIM,1885,83,na,1968,1518
SIM,1859,44,40-44,1903,9
STAT,1783,104,na,1887,0.05902392344233782
SIM,1840,55,na,1895,3218
SIM,1940,29,35-39,1969,42
STAT,1855,17,na,1872,4116.961914933359
STAT,1940,20,20-24,1960,228.9433628422647
SIM,1856,23,15-19,1879,7
STAT,1929,30,50-100,1959,2.123216160582323
SIM,1870,47,50-100,1917,1
SIM,1937,30,50-100,1967,2
STAT,1821,103,na,1924,0.1590786684496096
STAT,1875,23,20-24,1898,142.85052642912066
SIM,1774,86,na,1860,118
SIM,1842,20,30-34,1862,43
SIM,1853,59,na,1912,3114
STAT,1886,22,45-49,1908,1.4866495444159231
STAT,1841,22,20-24,1863,126.66386910746385
SIM,1894,57,na,1951,5366
SIM,1936,24,20-24,1960,185
STAT,1906,10,na,1916,7623.184903409352
SIM,1897,49,na,1946,6021
STAT,1922,46,35-39,1968,0.2998002855795979
STAT,1873,53,50-100,1926,0.03049408475408972
STAT,1848,23,15-19,1871,6.539247838989177
STAT,1825,33,35-39,1858,32.84457954625197
SIM,1913,19,30-34,1932,9
SIM,1833,33,35-39,1866,27
STAT,1952,17,15-19,1969,109.8298076010028
STAT,1866,43,25-29,1909,1.1880023020497328
STAT,1818,52,35-39,1870,0.03639541283843805
SIM,1783,82,na,1865,283
STAT,1929,41,20-24,1970,0.04625229823985354
SIM,1872,30,45-49,1902,5
SIM,1872,73,na,1945,2415
SIM,1883,21,30-34,1904,41
SIM,1849,37,40-44,1886,9
STAT,1831,66,na,1897,2116.2048370117113
SIM,1787,96,na,1883,2
STAT,1905,31,50-100,1936,1.5429264477966287
SIM,1835,22,na,1857,3780
STAT,1918,43,40-44,1961,0.5361503759388663
SIM,1903,36,30-34,1939,6
SIM,1852,40,na,1892,3807
STAT,1818,41,na,1859,3066.6802464057346
STAT,1844,50,40-44,1894,0.01724556392595162
STAT,1899,46,50-100,1945,0.38444463647840393
SIM,1849,33,25-29,1882,29
STAT,1885,43,35-39,1928,3.613975513466222
SIM,1850,70,na,1920,2157
SIM,1876,87,na,1963,676
STAT,1816,74,na,1890,1090.0926135448963
STAT,1853,69,na,1922,2321.949282846182
SIM,1901,28,45-49,1929,5
STAT,1905,19,30-34,1924,4.630377401411004
SIM,1936,29,15-19,1965,1
SIM,1812,53,na,1865,2567
SIM,1874,43,25-29,1917,1
SIM,1829,44,25-29,1873,2
SIM,1923,26,30-34,1949,13
SIM,1916,21,na,1937,7859
SIM,1818,43,40-44,1861,4
STAT,1951,21,35-39,1972,22.725598261225826
STAT,1866,31,30-34,1897,32.668791290969594
STAT,1888,35,25-29,1923,6.93810328836878
STAT,1921,23,15-19,1944,12.102406077341017
SIM,1861,40,40-44,1901,5
STAT,1849,46,35-39,1895,0.22208049812699748
STAT,1825,53,50-100,1878,0.030949938174563468
STAT,1864,9,na,1873,4999.95489957182
STAT,1937,18,30-34,1955,23.890067475625838
SIM,1839,16,15-19,1855,10
STAT,1829,50,45-49,1879,0.02301465833997922
SIM,1863,40,na,1903,4390
STAT,1921,28,20-24,1949,40.932689593706286
STAT,1783,101,na,1884,0.2398343368481468
STAT,1821,45,na,1866,2954.2859348251304
SIM,1861,44,35-39,1905,8
SIM,1930,28,na,1958,10143
SIM,1874,43,na,1917,4432
STAT,1812,54,15-19,1866,1.5665256384578264E-4
SIM,1883,17,na,1900,5280
STAT,1833,52,30-34,1885,0.008078496988026658
STAT,1835,36,50-100,1871,1.987269922274797
STAT,1907,35,na,1942,7115.518202307886
SIM,1845,40,na,1885,3935
STAT,1921,39,30-34,1960,4.100276916548493
STAT,1897,34,20-24,1931,7.234814220820536
STAT,1789,70,na,1859,1349.440533864854
SIM,1843,36,50-100,1879,5
SIM,1859,40,25-29,1899,2
SIM,1896,35,25-29,1931,13
SIM,1816,67,na,1883,1713
STAT,1828,62,na,1890,2244.555566457854
SIM,1828,42,50-100,1870,6
SIM,1837,29,na,1866,3638
SIM,1927,37,25-29,1964,2
SIM,1922,33,25-29,1955,20
SIM,1914,34,40-44,1948,11
SIM,1836,20,30-34,1856,40
STAT,1772,108,na,1880,0.008121806753973955
STAT,1845,23,35-39,1868,11.082960081856553
SIM,1859,91,na,1950,54
STAT,1805,54,15-19,1859,1.8548641191336063E-4
SIM,1838,92,na,1930,56
STAT,1858,21,25-29,1879,104.15764043252533
STAT,1908,47,20-24,1955,0.02019810889806822
STAT,1780,89,na,1869,67.12985324384762
SIM,1818,93,na,1911,39
STAT,1879,17,50-100,1896,0.10349422250841323
SIM,1786,74,na,1860,977
STAT,1882,26,25-29,1908,83.50927653720956
SIM,1832,29,35-39,1861,19
STAT,1912,45,20-24,1957,0.021556378336677447
STAT,1902,40,50-100,1942,0.2112917006098331
SIM,1898,31,na,1929,6762
SIM,1866,21,25-29,1887,130
SIM,1929,41,50-100,1970,1
STAT,1855,53,20-24,1908,0.0010948678728609303
STAT,1927,26,50-100,1953,2.451871121491765
STAT,1841,44,na,1885,3396.496414365126
STAT,1872,45,15-19,1917,8.199897703773728E-4
STAT,1856,33,20-24,1889,4.219530182721856
STAT,1919,37,25-29,1956,2.1358511516394225
SIM,1864,33,20-24,1897,2
SIM,1866,44,40-44,1910,8
STAT,1847,31,20-24,1878,4.888354305079103
STAT,1860,23,30-34,1883,29.89884224668911
STAT,1801,53,30-34,1854,0.036545756764326205
SIM,1905,8,na,1913,7840
SIM,1824,78,na,1902,904
STAT,1900,15,30-34,1915,4.486170725081968
STAT,1830,35,20-24,1865,1.485540711015634
SIM,1820,43,35-39,1863,8
STAT,1906,34,40-44,1940,7.265608790310518
SIM,1942,26,40-44,1968,12
SIM,1829,30,40-44,1859,12
SIM,1857,47,50-100,1904,3
SIM,1932,7,na,1939,10842
SIM,1814,60,na,1874,2224
STAT,1848,18,40-44,1866,0.36958993864920325
SIM,1896,21,40-44,1917,6
STAT,1767,116,na,1883,1.9730244722460685E-4
SIM,1935,26,50-100,1961,2
STAT,1832,23,25-29,1855,112.5391152631361
STAT,1870,43,45-49,1913,2.9461418017070735
STAT,1926,27,15-19,1953,1.7088591783855378
SIM,1888,22,15-19,1910,6
STAT,1876,31,50-100,1907,1.9217298814036057
STAT,1881,47,15-19,1928,7.771915749318998E-4
STAT,1883,41,50-100,1924,2.105774563774155
STAT,1891,24,na,1915,5867.104521667718
STAT,1870,32,35-39,1902,20.080222452973118
STAT,1903,43,20-24,1946,0.03148348807478124
STAT,1843,51,50-100,1894,0.02125742347993252
SIM,1842,100,na,1942,2
STAT,1890,61,na,1951,4606.47806836665
STAT,1893,24,50-100,1917,1.0373587607501578
STAT,1934,26,40-44,1960,12.671060506149123
SIM,1868,32,45-49,1900,4
SIM,1849,23,15-19,1872,4
STAT,1860,16,50-100,1876,0.09321921773180541
STAT,1819,103,na,1922,0.15017077138920032
SIM,1848,44,35-39,1892,6
STAT,1851,48,40-44,1899,0.26205661425831744
STAT,1860,36,45-49,1896,3.2852195275810834
STAT,1888,21,40-44,1909,4.989204916894585
SIM,1877,32,na,1909,4913
SIM,1840,23,25-29,1863,125
STAT,1858,44,40-44,1902,3.4935001818872693
SIM,1886,46,na,1932,4686
SIM,1882,32,na,1914,4959
STAT,1860,25,35-39,1885,16.22678228071607
STAT,1919,42,50-100,1961,0.2570653433011773
STAT,1839,29,25-29,1868,82.01838006950383
STAT,1917,24,45-49,1941,2.3998390216866783
STAT,1912,20,45-49,1932,2.1913757651179244
SIM,1873,98,na,1971,46
STAT,1934,37,20-24,1971,0.7347906412238795
SIM,1857,33,20-24,1890,6
STAT,1803,52,45-49,1855,0.10661604495442518
SIM,1870,3,na,1873,5889
SIM,1875,27,40-44,1902,7
SIM,1936,23,50-100,1959,1
SIM,1878,15,15-19,1893,15
SIM,1949,3,na,1952,9672
STAT,1812,43,35-39,1855,14.05751733373122
STAT,1892,24,35-39,1916,14.66145884611316
SIM,1908,26,35-39,1934,44
SIM,1919,28,30-34,1947,98
STAT,1947,21,15-19,1968,12.153614492012089
STAT,1877,18,50-100,1895,0.10247453179242515
STAT,1884,20,15-19,1904,6.618401136969138
SIM,1802,75,na,1877,962
STAT,1919,20,na,1939,8122.48598954205
SIM,1933,24,40-44,1957,9
STAT,1916,46,35-39,1962,0.2677380332862821
SIM,1938,28,40-44,1966,10
STAT,1831,44,15-19,1875,0.021310125426312294
STAT,1777,113,na,1890,8.739447472164459E-4
SIM,1881,24,25-29,1905,105
STAT,1889,24,15-19,1913,8.163908575437864
STAT,1941,16,na,1957,7659.339202886693
STAT,1819,66,na,1885,1782.5501453822626
STAT,1888,20,na,1908,5679.209470562563
SIM,1825,63,na,1888,1997
STAT,1830,41,na,1871,3587.175583772663
SIM,1891,41,50-100,1932,7
STAT,1920,17,na,1937,8338.27893434291
SIM,1828,74,na,1902,1287
STAT,1871,36,20-24,1907,1.5541643161697563
STAT,1913,18,15-19,1931,18.69561589298688
STAT,1925,24,40-44,1949,8.075857997632625
STAT,1908,36,40-44,1944,2.8461758994872066
STAT,1912,39,35-39,1951,4.7210683927626915
STAT,1812,54,45-49,1866,0.09242509046164384
STAT,1856,58,na,1914,3081.5639453644962
SIM,1865,47,na,1912,4187
SIM,1921,18,15-19,1939,93
SIM,1920,39,35-39,1959,10
STAT,1808,63,na,1871,1875.0552278461137
STAT,1923,35,25-29,1958,2.307337083332441
SIM,1897,24,15-19,1921,13
SIM,1925,24,45-49,1949,5
SIM,1856,18,40-44,1874,1
SIM,1892,20,15-19,1912,7
STAT,1892,49,40-44,1941,0.23906232927175566
SIM,1860,102,na,1962,1
SIM,1920,20,45-49,1940,3
STAT,1777,85,na,1862,148.12867703780128
STAT,1903,32,40-44,1935,12.470498873955071
STAT,1952,19,na,1971,8901.647729865765
STAT,1867,23,25-29,1890,107.9411859241342
STAT,1873,21,20-24,1894,141.83924109710958
STAT,1849,33,20-24,1882,4.458972121987246
STAT,1945,27,25-29,1972,145.8277678372051
STAT,1854,31,50-100,1885,1.4534014416486865
STAT,1851,23,35-39,1874,10.725195968049126
SIM,1862,31,50-100,1893,1
STAT,1932,24,40-44,1956,8.879999885309442
SIM,1865,0,na,1865,6821
SIM,1898,47,35-39,1945,1
STAT,1901,30,40-44,1931,12.360057439752758
SIM,1862,95,na,1957,30
STAT,1840,46,15-19,1886,5.897447177599566E-4
SIM,1855,20,40-44,1875,2
STAT,1923,1,na,1924,9900.472281965309
SIM,1858,44,50-100,1902,5
STAT,1804,89,na,1893,70.67148876933929
STAT,1879,86,na,1965,923.5867135558269
SIM,1830,93,na,1923,23
SIM,1890,26,25-29,1916,122
SIM,1906,24,35-39,1930,24
STAT,1828,39,20-24,1867,1.490729567988243
SIM,1841,96,na,1937,7
SIM,1836,39,20-24,1875,2
SIM,1823,35,25-29,1858,6
SIM,1875,23,25-29,1898,167
STAT,1798,84,na,1882,214.1272099068851
STAT,1859,53,35-39,1912,0.01361677003796333
STAT,1849,20,50-100,1869,0.7911961306493307
SIM,1940,24,40-44,1964,10
STAT,1914,33,25-29,1947,18.71372069349807
SIM,1849,14,na,1863,4852
STAT,1895,7,na,1902,6856.334919187356
SIM,1873,38,50-100,1911,4
STAT,1868,83,na,1951,762.8209878192613
STAT,1831,45,50-100,1876,0.3856032707021208
SIM,1905,37,40-44,1942,7
STAT,1890,45,20-24,1935,0.029876790903781154
STAT,1825,51,20-24,1876,0.0015735031147878374
STAT,1867,37,45-49,1904,3.7705297932036577
SIM,1928,29,50-100,1957,2
STAT,1870,25,na,1895,4764.167184889958
SIM,1869,50,na,1919,4207
STAT,1861,52,45-49,1913,0.024265620109907488
SIM,1886,68,na,1954,3165
SIM,1950,1,na,1951,9402
STAT,1838,44,25-29,1882,0.9015164734608897
STAT,1929,22,na,1951,9325.675992754697
SIM,1878,41,40-44,1919,9
STAT,1842,51,50-100,1893,0.022592774061965738
SIM,1825,43,40-44,1868,6
STAT,1874,4,na,1878,6036.086433966209
STAT,1932,25,25-29,1957,174.2778314304891
SIM,1836,31,50-100,1867,3
STAT,1792,93,na,1885,14.156869563377754
STAT,1905,45,20-24,1950,0.01996786918133989
STAT,1914,9,na,1923,8290.850560565077
SIM,1890,26,30-34,1916,85
STAT,1934,22,25-29,1956,250.7392261621896
SIM,1827,40,40-44,1867,6
SIM,1892,34,40-44,1926,19
STAT,1874,15,na,1889,5266.585649228487
STAT,1920,35,45-49,1955,1.5097126478712486
STAT,1936,30,35-39,1966,17.950464304774677
STAT,1884,34,40-44,1918,8.574539918795448
STAT,1903,48,20-24,1951,0.019220106320181913
SIM,1922,30,15-19,1952,1
SIM,1872,31,20-24,1903,6
SIM,1919,17,15-19,1936,106
STAT,1803,70,na,1873,1410.8072680691857
STAT,1898,45,35-39,1943,0.21798826993896941
STAT,1849,47,35-39,1896,0.22041933600100758
STAT,1925,32,na,1957,9068.603583284279
STAT,1921,22,15-19,1943,12.139918425275123
STAT,1930,27,50-100,1957,2.5560657094647947
SIM,1823,35,30-34,1858,13
STAT,1885,52,na,1937,4305.579928340666
STAT,1840,41,45-49,1881,2.2825763372192758
STAT,1820,39,50-100,1859,5.415880500329831
SIM,1827,33,35-39,1860,28
SIM,1848,29,na,1877,3957
SIM,1865,60,na,1925,3516
STAT,1880,19,15-19,1899,12.558478412190667
STAT,1852,52,35-39,1904,0.013648161603247437
SIM,1922,46,na,1968,8928
SIM,1873,29,35-39,1902,22
SIM,1892,27,35-39,1919,40
STAT,1886,24,35-39,1910,12.363026114700356
STAT,1796,83,na,1879,278.8097294942683
SIM,1818,40,30-34,1858,3
SIM,1854,23,na,1877,4196
STAT,1912,48,30-34,1960,0.17259238553378517
STAT,1915,24,na,1939,7576.5953839809845
SIM,1844,30,30-34,1874,51
STAT,1854,88,na,1942,210.45399762529877
STAT,1860,17,na,1877,4341.923661090532
STAT,1896,18,na,1914,6716.703689489164
STAT,1923,30,25-29,1953,21.56451375236339
SIM,1823,43,na,1866,3094
SIM,1830,25,20-24,1855,22
STAT,1847,39,25-29,1886,4.460066323901497
STAT,1844,41,45-49,1885,2.5072727402067136
STAT,1892,42,20-24,1934,0.40103199243717247
SIM,1903,22,50-100,1925,1
SIM,1907,34,40-44,1941,9
SIM,1815,48,na,1863,2613
STAT,1784,98,na,1882,0.967562608650214
SIM,1868,22,40-44,1890,6
STAT,1823,54,20-24,1877,0.0021090978328567817
STAT,1882,26,30-34,1908,49.71280364020289
STAT,1760,103,na,1863,0.012953631434742565
STAT,1855,41,20-24,1896,0.2405632191382907
SIM,1894,24,35-39,1918,18
STAT,1873,48,25-29,1921,0.11671326419720301
SIM,1842,22,20-24,1864,5
STAT,1914,30,15-19,1944,0.26338843724879896
SIM,1825,36,35-39,1861,18
SIM,1931,30,25-29,1961,32
SIM,1940,25,25-29,1965,166
STAT,1856,39,35-39,1895,10.91035783106628
SIM,1865,36,50-100,1901,3
SIM,1853,30,40-44,1883,13
STAT,1814,51,45-49,1865,0.07352035810337487
SIM,1857,65,na,1922,3046
STAT,1866,1,na,1867,6672.440055758479
SIM,1840,25,20-24,1865,29
STAT,1824,56,na,1880,2372.3526128015706
STAT,1908,15,50-100,1923,0.14755464115434416
SIM,1891,15,na,1906,6543
STAT,1829,51,20-24,1880,0.0011472684894039205
STAT,1919,21,50-100,1940,1.4592541340952905
STAT,1867,18,45-49,1885,0.12556386317701929
SIM,1910,22,35-39,1932,20
STAT,1863,29,25-29,1892,74.25020995214493
STAT,1834,22,20-24,1856,122.68332203747472
SIM,1840,15,na,1855,4749
STAT,1882,19,25-29,1901,11.08891450480009
STAT,1914,49,35-39,1963,0.256773327231677
STAT,1858,78,na,1936,1230.1445279137147
STAT,1907,40,25-29,1947,0.13370293229721203
STAT,1847,46,30-34,1893,0.14797522952606176
STAT,1853,36,45-49,1889,3.1870194808593713
STAT,1848,18,35-39,1866,1.1087697517511597
SIM,1887,34,45-49,1921,6
STAT,1896,42,20-24,1938,0.0293699747972662
STAT,1940,20,15-19,1960,10.960126566462815
STAT,1958,4,na,1962,10429.737436704852
STAT,1884,15,40-44,1899,0.3664528879256443
STAT,1879,34,45-49,1913,3.6522453790748974
STAT,1866,73,na,1939,2213.3529924931795
STAT,1924,19,40-44,1943,3.3450002257284743
SIM,1932,19,40-44,1951,5
SIM,1837,40,40-44,1877,8
SIM,1947,15,25-29,1962,98
STAT,1899,60,na,1959,5459.154087185977
STAT,1903,39,na,1942,6759.494206510402
SIM,1807,105,na,1912,2
SIM,1846,44,25-29,1890,4
STAT,1884,27,35-39,1911,19.24257307192023
STAT,1880,50,45-49,1930,0.03131992475768547
STAT,1892,48,35-39,1940,0.19715494048220433
SIM,1861,70,na,1931,2573
SIM,1919,24,20-24,1943,242
SIM,1875,37,45-49,1912,10
STAT,1833,92,na,1925,54.7534774206203
STAT,1860,48,15-19,1908,6.477895093020647E-4
SIM,1808,54,na,1862,2487
SIM,1858,13,na,1871,4771
SIM,1870,47,na,1917,4387
STAT,1829,100,na,1929,1.2564665637891868
STAT,1846,59,na,1905,2976.821779922738
SIM,1910,19,20-24,1929,42
STAT,1832,25,20-24,1857,21.114807992086494
STAT,1902,22,35-39,1924,16.63897371968021
STAT,1929,40,45-49,1969,0.43645811891163133
SIM,1853,23,35-39,1876,14
SIM,1894,31,40-44,1925,1
STAT,1817,43,40-44,1860,11.74462529234935
STAT,1833,40,30-34,1873,1.8822304634270615
STAT,1886,2,na,1888,6301.632303915239
SIM,1886,37,20-24,1923,2
SIM,1912,27,30-34,1939,78
STAT,1849,48,na,1897,3514.0778296379317
STAT,1879,46,na,1925,4766.231048473858
STAT,1865,15,30-34,1880,3.350998068423052
SIM,1890,19,25-29,1909,17
STAT,1904,27,30-34,1931,72.99577286528644
SIM,1884,44,50-100,1928,5
STAT,1902,19,20-24,1921,50.27908979355345
STAT,1918,45,50-100,1963,0.488306693953924
STAT,1816,43,35-39,1859,9.590742869230734
STAT,1818,51,45-49,1869,0.06258989149561338
STAT,1913,25,15-19,1938,1.4306322207614532
STAT,1911,34,na,1945,7376.381890390357
STAT,1844,51,30-34,1895,0.009658849527098268
STAT,1844,101,na,1945,0.9215080421076044
SIM,1853,75,na,1928,1527
SIM,1811,58,na,1869,2151
SIM,1870,20,30-34,1890,42
STAT,1874,53,25-29,1927,0.007206976909337934
STAT,1819,40,40-44,1859,11.063385120993944
SIM,1898,34,20-24,1932,11
SIM,1899,24,25-29,1923,137
SIM,1795,70,na,1865,1285
SIM,1808,46,45-49,1854,2
STAT,1878,37,20-24,1915,1.6259520829465957
STAT,1882,10,na,1892,5096.198770286488
SIM,1820,88,na,1908,115
SIM,1856,18,35-39,1874,1
STAT,1886,31,40-44,1917,9.283414005084998
STAT,1884,28,50-100,1912,1.2712291081257117
STAT,1889,16,30-34,1905,3.9788542474939796
SIM,1851,26,35-39,1877,24
STAT,1933,30,25-29,1963,25.186751182606454
SIM,1832,73,na,1905,1475
SIM,1859,41,30-34,1900,3
SIM,1859,4,na,1863,5200
SIM,1917,22,50-100,1939,2
STAT,1842,54,30-34,1896,0.008618535620266344
SIM,1838,76,na,1914,1179
SIM,1858,90,na,1948,102
SIM,1835,31,50-100,1866,4
STAT,1831,54,25-29,1885,0.004583587101000534
STAT,1871,23,45-49,1894,1.3948627226795165
STAT,1832,45,50-100,1877,0.38838993440507374
SIM,1863,33,45-49,1896,5
SIM,1867,35,50-100,1902,5
STAT,1837,36,20-24,1873,1.322041458358244
STAT,1856,95,na,1951,20.71758888690129
SIM,1910,21,na,1931,7601
SIM,1847,25,30-34,1872,70
SIM,1877,20,25-29,1897,132
SIM,1944,5,na,1949,8800
SIM,1873,95,na,1968,99
STAT,1859,17,40-44,1876,0.3412894482623923
STAT,1862,20,30-34,1882,31.93287017694093
SIM,1863,18,na,1881,4846
SIM,1868,41,40-44,1909,4
STAT,1942,30,35-39,1972,19.68258258803509
SIM,1778,82,na,1860,301
STAT,1841,28,na,1869,3870.4923705613282
SIM,1795,88,na,1883,87
STAT,1840,30,20-24,1870,4.851972440970565
STAT,1866,34,35-39,1900,18.710011192666286
SIM,1923,30,50-100,1953,4
STAT,1821,39,50-100,1860,4.261403029631265
SIM,1847,38,50-100,1885,2
STAT,1860,26,35-39,1886,16.110273983940527
STAT,1915,22,15-19,1937,11.113892286097679
SIM,1869,15,40-44,1884,1
SIM,1874,34,35-39,1908,27
SIM,1864,36,30-34,1900,17
STAT,1908,32,25-29,1940,17.63150026282533
SIM,1856,30,na,1886,4129
SIM,1923,22,15-19,1945,11
STAT,1829,43,45-49,1872,2.42556181121332
STAT,1923,27,40-44,1950,10.804303026554047
STAT,1939,19,50-100,1958,0.7569785829463833
STAT,1820,51,45-49,1871,0.05298241250172073
STAT,1841,28,35-39,1869,17.263723873734307
SIM,1896,30,na,1926,6640
STAT,1843,26,35-39,1869,16.75462966626092
STAT,1849,52,20-24,1901,0.0011610257786828003
STAT,1867,21,na,1888,4524.223190609871
SIM,1783,85,na,1868,137
STAT,1849,43,30-34,1892,1.8054064500450544
STAT,1866,52,20-24,1918,0.001367777460208414
STAT,1888,37,20-24,1925,1.84006649767544
STAT,1894,35,na,1929,6170.389291052561
STAT,1899,26,40-44,1925,8.317586835871186
SIM,1885,44,50-100,1929,6
STAT,1899,45,40-44,1944,0.2698896301256973
STAT,1855,33,45-49,1888,2.6497861848117594
SIM,1887,42,20-24,1929,1
SIM,1956,15,35-39,1971,10
STAT,1948,11,na,1959,9079.759075444226
SIM,1914,32,20-24,1946,5
STAT,1887,27,50-100,1914,1.444932480799393
STAT,1908,20,na,1928,7132.458889285099
STAT,1840,49,40-44,1889,0.24289356825932767
STAT,1839,25,30-34,1864,50.25307639403798
STAT,1862,36,50-100,1898,2.1295315370978005
STAT,1771,91,na,1862,26.4484070815339
SIM,1845,36,20-24,1881,3
STAT,1879,42,20-24,1921,0.33507585334147894
SIM,1841,52,25-29,1893,1
SIM,1916,32,25-29,1948,22
SIM,1789,76,na,1865,723
STAT,1881,42,45-49,1923,2.9179663456157576
SIM,1781,100,na,1881,2
SIM,1931,27,40-44,1958,12
SIM,1916,24,na,1940,7776
STAT,1870,48,15-19,1918,7.831645237843076E-4
SIM,1860,69,na,1929,2619
SIM,1878,33,na,1911,5173
STAT,1854,29,15-19,1883,0.7186991909718166
STAT,1828,40,na,1868,3334.2760260493696
STAT,1873,67,na,1940,3252.955956532255
STAT,1830,39,15-19,1869,0.10232965601602992
SIM,1852,41,45-49,1893,5
STAT,1878,18,20-24,1896,37.29682897978626
STAT,1948,15,35-39,1963,9.70291223000616
STAT,1828,46,na,1874,3101.2687678902603
SIM,1835,62,na,1897,2434
STAT,1848,51,30-34,1899,0.009807138508764482
SIM,1890,67,na,1957,4153
STAT,1891,19,35-39,1910,1.3624417899327648
SIM,1871,26,20-24,1897,22
STAT,1845,33,45-49,1878,3.1619905349970976
STAT,1896,34,45-49,1930,4.609967324329353
STAT,1927,3,na,1930,10183.853059699231
STAT,1939,25,35-39,1964,30.512429471695565
SIM,1832,28,35-39,1860,19
SIM,1868,34,35-39,1902,26
STAT,1924,40,25-29,1964,0.17197369639673052
STAT,1809,67,na,1876,1713.6743624089802
STAT,1906,32,20-24,1938,4.567733171802354
STAT,1860,22,30-34,1882,30.115068438074477
STAT,1864,34,25-29,1898,18.332757647965817
SIM,1831,30,20-24,1861,6
STAT,1840,110,na,1950,3.988775445269222E-4
STAT,1816,77,na,1893,849.0513565452159
STAT,1847,16,50-100,1863,0.09376070824364283
STAT,1869,29,50-100,1898,1.2428921956238417
STAT,1928,36,15-19,1964,0.04905147149468004
STAT,1851,44,25-29,1895,0.9820238242234824
STAT,1878,15,40-44,1893,0.38759001709288143
SIM,1851,33,40-44,1884,12
STAT,1923,49,45-49,1972,0.5103117881450862
STAT,1833,52,25-29,1885,0.004807039483735895
STAT,1838,46,20-24,1884,0.01692397548762982
STAT,1893,35,50-100,1928,3.1727199853717063
STAT,1860,110,na,1970,0.006292608249108621
SIM,1798,59,na,1857,1948
STAT,1881,20,40-44,1901,4.092034813162509
STAT,1898,33,50-100,1931,2.493611842818803
SIM,1942,22,25-29,1964,215
SIM,1897,16,30-34,1913,6
STAT,1765,97,na,1862,1.6689505678417815
SIM,1941,30,25-29,1971,28
STAT,1920,46,25-29,1966,0.11869128845725772
SIM,1830,47,na,1877,2855
SIM,1910,38,20-24,1948,1
STAT,1853,47,na,1900,3543.1058398609166
STAT,1899,38,35-39,1937,4.20343827533689
SIM,1872,54,na,1926,4378
STAT,1843,45,na,1888,3218.3412487916758
STAT,1843,33,40-44,1876,7.227812957201625
SIM,1810,70,na,1880,1367
SIM,1853,33,45-49,1886,4
SIM,1870,20,50-100,1890,1
STAT,1914,37,40-44,1951,3.019144810431673
SIM,1866,25,40-44,1891,7
STAT,1892,28,na,1920,6012.59781312847
SIM,1867,73,na,1940,2186
STAT,1823,49,40-44,1872,0.5141433309602816
STAT,1869,28,20-24,1897,22.87692959259009
STAT,1902,38,20-24,1940,0.4720566406016427
SIM,1906,29,40-44,1935,8
STAT,1869,20,25-29,1889,113.17702857045005
SIM,1831,49,40-44,1880,1
SIM,1883,23,20-24,1906,143
SIM,1925,33,35-39,1958,31
STAT,1940,30,25-29,1970,19.34239616380214
SIM,1862,36,20-24,1898,1
SIM,1931,29,na,1960,9789
STAT,1944,27,na,1971,8176.638067983441
STAT,1957,8,na,1965,10463.278889546793
SIM,1952,8,na,1960,9773
STAT,1890,21,20-24,1911,170.39292597140195
STAT,1895,34,50-100,1929,2.39057588675877
SIM,1846,33,45-49,1879,6
STAT,1854,36,20-24,1890,1.187389132734145
STAT,1890,32,45-49,1922,4.298793625018764
SIM,1855,36,20-24,1891,5
STAT,1875,26,50-100,1901,1.3347100842649207
SIM,1902,45,45-49,1947,1
SIM,1911,52,na,1963,7107
STAT,1810,46,35-39,1856,0.9310115969110955
SIM,1801,99,na,1900,5
STAT,1838,33,45-49,1871,2.9023711590420054
SIM,1900,45,40-44,1945,1
STAT,1858,25,40-44,1883,4.898109477989066
STAT,1839,89,na,1928,164.03354682041783
SIM,1840,35,30-34,1875,14
STAT,1916,34,40-44,1950,8.089806823415273
SIM,1949,22,35-39,1971,29
SIM,1822,40,20-24,1862,2
SIM,1922,37,40-44,1959,1
SIM,1847,87,na,1934,221
STAT,1790,64,na,1854,1504.0
STAT,1845,71,na,1916,2056.841892088778
SIM,1858,20,15-19,1878,4
SIM,1914,30,25-29,1944,26
STAT,1917,33,35-39,1950,19.243194028559998
STAT,1863,19,15-19,1882,10.766571525419634
STAT,1895,21,50-100,1916,1.0763936427635903
STAT,1834,32,30-34,1866,29.770358755906646
STAT,1867,34,40-44,1901,8.132345116527974
STAT,1819,43,45-49,1862,6.707253074340125
STAT,1826,39,na,1865,3329.728424322767
STAT,1827,40,30-34,1867,2.264975375144287
STAT,1873,45,20-24,1918,0.024870171834014895
SIM,1875,34,40-44,1909,15
STAT,1919,30,35-39,1949,20.067771065853083
STAT,1924,42,50-100,1966,0.2821413075719243
SIM,1909,14,na,1923,7855
STAT,1796,67,na,1863,1517.7425175452377
STAT,1921,27,30-34,1948,88.17357390016626
SIM,1831,41,45-49,1872,5
STAT,1856,48,25-29,1904,0.08862663601611409
SIM,1843,97,na,1940,4
STAT,1806,54,20-24,1860,0.004136650913767057
SIM,1825,46,45-49,1871,1
STAT,1932,22,20-24,1954,294.67896024544825
SIM,1842,32,30-34,1874,42
STAT,1858,28,45-49,1886,1.7766546318696177
STAT,1837,23,na,1860,3872.98289445307
SIM,1871,19,15-19,1890,12
STAT,1849,61,na,1910,2955.804479501592
SIM,1940,22,20-24,1962,243
STAT,1887,81,na,1968,1989.9976403092412
SIM,1865,44,na,1909,4266
STAT,1825,32,20-24,1857,9.593221960746193
STAT,1864,30,50-100,1894,1.6674027392306507
SIM,1924,34,40-44,1958,13
SIM,1946,22,na,1968,7977
STAT,1922,45,20-24,1967,0.025754084802197513
STAT,1931,30,15-19,1961,0.34046698259826724
SIM,1848,17,30-34,1865,5
SIM,1861,30,30-34,1891,45
STAT,1863,26,20-24,1889,20.890031019176742
STAT,1814,40,20-24,1854,0.9877967855670658
STAT,1832,35,30-34,1867,8.968448650288709
SIM,1869,37,20-24,1906,3
SIM,1892,37,45-49,1929,9
STAT,1837,76,na,1913,1320.449073693121
SIM,1844,33,35-39,1877,26
STAT,1906,30,25-29,1936,17.44747576269255
STAT,1856,18,na,1874,4204.470159532238
STAT,1892,45,25-29,1937,0.08296633303212629
SIM,1901,21,25-29,1922,191
SIM,1918,48,30-34,1966,1
STAT,1869,47,20-24,1916,0.02337379507799994
SIM,1865,44,35-39,1909,7
STAT,1892,23,20-24,1915,173.6928013757473
STAT,1840,40,na,1880,3569.0902871940757
SIM,1864,29,25-29,1893,85
SIM,1927,1,na,1928,10459
SIM,1863,43,na,1906,4280
SIM,1882,41,30-34,1923,5
STAT,1834,34,na,1868,3613.237853876067
STAT,1857,44,35-39,1901,2.8121000552534205
STAT,1825,54,25-29,1879,0.00711584451548487
STAT,1898,59,na,1957,5402.0264014080885
STAT,1920,48,20-24,1968,0.024597457519317963
STAT,1842,28,50-100,1870,1.1693079399452628
SIM,1892,24,30-34,1916,63
SIM,1949,11,na,1960,9612
STAT,1911,18,na,1929,7787.50403966876
STAT,1817,46,45-49,1863,1.1577331358576641
STAT,1881,31,20-24,1912,5.298153847660178
STAT,1862,45,45-49,1907,0.4114449312971028
SIM,1849,25,40-44,1874,5
STAT,1816,105,na,1921,0.02880030274443573
SIM,1811,74,na,1885,936
SIM,1884,27,45-49,1911,1
SIM,1881,37,na,1918,4033
SIM,1872,34,25-29,1906,25
STAT,1920,32,40-44,1952,8.65497334235643
STAT,1874,41,30-34,1915,2.3881732111889775
STAT,1884,37,45-49,1921,3.9755516721891793
STAT,1846,51,20-24,1897,0.0011356858105522859
SIM,1914,49,45-49,1963,1
STAT,1851,22,20-24,1873,127.57221495237317
STAT,1853,30,30-34,1883,29.044778280375077
STAT,1863,50,45-49,1913,0.02602520128557877
STAT,1873,36,30-34,1909,10.989231133647806
STAT,1775,81,na,1856,289.293195393
STAT,1945,20,35-39,1965,20.854642983372052
STAT,1837,29,15-19,1866,0.8002011414665838
STAT,1949,5,na,1954,9262.51247714283
STAT,1865,18,35-39,1883,1.0313553998788147
STAT,1912,32,15-19,1944,0.25544465001447264
STAT,1851,53,50-100,1904,0.023036114737431605
STAT,1861,42,35-39,1903,3.040245511001995
SIM,1886,62,na,1948,3692
SIM,1931,24,30-34,1955,97
STAT,1858,47,45-49,1905,0.3698304799279078
STAT,1912,2,na,1914,8327.314176182563
STAT,1943,23,35-39,1966,20.22500360174749
SIM,1878,67,na,1945,3300
SIM,1920,32,15-19,1952,1
SIM,1938,21,20-24,1959,202
SIM,1864,48,25-29,1912,1
STAT,1838,24,na,1862,3700.5173498001486
STAT,1875,33,30-34,1908,36.15168423226388
STAT,1936,26,na,1962,7245.318576096204
SIM,1839,18,35-39,1857,1
SIM,1894,34,45-49,1928,4
STAT,1882,29,50-100,1911,1.24953373906943
STAT,1895,37,20-24,1932,2.028589480865636
SIM,1931,20,15-19,1951,14
STAT,1856,29,25-29,1885,67.32633850747521
SIM,1863,41,20-24,1904,2
STAT,1811,83,na,1894,369.02497172644155
SIM,1873,18,35-39,1891,2
SIM,1830,28,25-29,1858,74
STAT,1913,17,30-34,1930,5.034357084623291
STAT,1914,40,25-29,1954,0.1439286153398351
SIM,1820,40,30-34,1860,4
SIM,1890,29,50-100,1919,5
STAT,1836,33,35-39,1869,16.847695913864413
STAT,1828,46,20-24,1874,0.02190070279267109
STAT,1864,42,45-49,1906,2.698572239748447
STAT,1960,11,na,1971,10332.177315156516
SIM,1921,17,30-34,1938,38
STAT,1883,45,na,1928,4508.806291141014
STAT,1803,88,na,1891,96.88484292397376
SIM,1819,49,25-29,1868,1
STAT,1886,34,45-49,1920,3.68589905315089
SIM,1881,36,30-34,1917,15
SIM,1891,34,35-39,1925,32
STAT,1844,54,35-39,1898,0.013520570114636093
STAT,1879,31,40-44,1910,9.198652869542624
SIM,1866,48,na,1914,4355
STAT,1845,109,na,1954,0.001096313735003113
STAT,1901,32,30-34,1933,49.36506366507932
STAT,1850,58,na,1908,3032.1904262313133
STAT,1875,48,35-39,1923,0.2874514234551026
SIM,1872,42,45-49,1914,7
STAT,1842,52,35-39,1894,0.012749058286620084
STAT,1923,20,15-19,1943,12.579620256591882
STAT,1940,27,40-44,1967,9.599923726946098
STAT,1833,86,na,1919,291.684600130709
STAT,1928,17,15-19,1945,115.47309172106227
STAT,1859,46,50-100,1905,0.39592025182668383
SIM,1899,35,na,1934,6603
SIM,1893,42,45-49,1935,1
SIM,1846,71,na,1917,1966
STAT,1838,41,20-24,1879,0.2546063949998462
STAT,1862,26,45-49,1888,1.937583990075116
STAT,1891,40,na,1931,5827.956292106108
SIM,1867,46,50-100,1913,1
STAT,1806,53,na,1859,2271.828578650482
STAT,1941,19,40-44,1960,2.9078404122896444
STAT,1887,41,40-44,1928,5.1036365163410355
SIM,1870,26,45-49,1896,3
STAT,1776,111,na,1887,0.0024380096953353107
SIM,1931,39,35-39,1970,9
SIM,1934,26,50-100,1960,1
SIM,1866,22,50-100,1888,4
STAT,1892,45,30-34,1937,0.13942953324501395
SIM,1887,31,40-44,1918,22
STAT,1885,42,45-49,1927,3.0049858436738974
SIM,1791,64,na,1855,1504
SIM,1827,43,45-49,1870,8
SIM,1892,28,50-100,1920,2
STAT,1858,22,50-100,1880,0.7366419673477013
SIM,1931,23,na,1954,9601
SIM,1936,17,15-19,1953,70
STAT,1923,24,30-34,1947,67.09509763361629
SIM,1824,43,35-39,1867,7
SIM,1841,40,30-34,1881,4
SIM,1844,45,na,1889,3231
SIM,1819,78,na,1897,685
SIM,1876,41,30-34,1917,4
SIM,1918,25,na,1943,8271
STAT,1850,52,25-29,1902,0.005401950007026285
STAT,1862,23,35-39,1885,10.237796850453313
STAT,1839,28,35-39,1867,18.843640082999187
SIM,1868,44,45-49,1912,6
SIM,1858,23,25-29,1881,107
STAT,1837,39,25-29,1876,4.7865042568163245
STAT,1883,34,35-39,1917,19.922823206407433
STAT,1803,53,35-39,1856,0.06198557037847361
STAT,1858,44,na,1902,3589.740476384453
SIM,1905,34,30-34,1939,41
STAT,1939,15,25-29,1954,87.83191283192744
STAT,1826,48,50-100,1874,0.48313537720379085
STAT,1854,17,20-24,1871,32.51090932156786
STAT,1844,22,50-100,1866,0.8222381627965449
STAT,1825,54,30-34,1879,0.011958572148222615
SIM,1862,17,20-24,1879,46
SIM,1843,26,45-49,1869,5
STAT,1775,99,na,1874,0.5202790222018672
STAT,1846,40,40-44,1886,3.5774467165519916
STAT,1862,48,25-29,1910,0.09817985934094708
STAT,1854,94,na,1948,30.638402921870938
STAT,1857,53,25-29,1910,0.005486299961182597
SIM,1888,37,30-34,1925,18
SIM,1871,94,na,1965,90
SIM,1883,33,30-34,1916,52
STAT,1880,26,20-24,1906,25.045173685596403
SIM,1848,43,20-24,1891,2
STAT,1938,33,na,1971,7676.840918602122
STAT,1899,48,45-49,1947,0.36374300769705953
STAT,1901,42,40-44,1943,0.4410752973693836
SIM,1876,84,na,1960,1028
SIM,1933,30,35-39,1963,34
STAT,1836,41,na,1877,3368.2749673132166
SIM,1853,41,na,1894,3826
SIM,1861,17,na,1878,5015
STAT,1886,34,na,1920,5043.921154182534
SIM,1914,51,na,1965,7364
SIM,1870,23,35-39,1893,18
STAT,1768,86,na,1854,116.0
STAT,1879,45,25-29,1924,0.12289176491335173
STAT,1868,41,30-34,1909,2.2191135852735693
SIM,1847,28,35-39,1875,26
STAT,1867,17,30-34,1884,3.081911342218508
STAT,1908,14,na,1922,7717.013595781712
STAT,1841,37,25-29,1878,4.921931835238803
STAT,1914,46,30-34,1960,0.17903118477715876
SIM,1861,41,30-34,1902,5
SIM,1908,24,45-49,1932,3
STAT,1871,20,40-44,1891,4.2061411113144525
STAT,1847,35,na,1882,3804.340354474137
SIM,1939,22,50-100,1961,2
STAT,1899,29,45-49,1928,3.050403946461641
STAT,1831,51,20-24,1882,0.001013370727529386
SIM,1846,30,40-44,1876,14
STAT,1763,96,na,1859,1.3756744389344262
STAT,1870,44,35-39,1914,3.542065482873169
STAT,1824,101,na,1925,0.610074208391805
STAT,1841,18,25-29,1859,10.541794732454772
STAT,1845,30,40-44,1875,8.112378038601936
SIM,1816,42,30-34,1858,3
STAT,1818,39,20-24,1857,4.349534950431183
SIM,1831,72,na,1903,1598
STAT,1877,37,45-49,1914,4.180656999067051
SIM,1874,31,30-34,1905,37
STAT,1942,24,40-44,1966,7.115270979943872
STAT,1807,50,30-34,1857,0.0403740374006052
SIM,1842,47,35-39,1889,2
SIM,1870,45,45-49,1915,2
SIM,1874,38,50-100,1912,1
STAT,1882,18,50-100,1900,0.09613392680081148
STAT,1863,90,na,1953,139.38229126893935
STAT,1938,30,45-49,1968,3.1996504953550158
SIM,1854,40,40-44,1894,6
STAT,1922,19,30-34,1941,28.328828869440695
STAT,1853,13,na,1866,4522.966052143423
SIM,1885,37,45-49,1922,6
SIM,1848,35,na,1883,3783
SIM,1880,35,50-100,1915,2
STAT,1927,43,15-19,1970,0.003882996601784359
STAT,1869,62,na,1931,3576.759326056221
SIM,1930,19,30-34,1949,38
SIM,1826,39,20-24,1865,3
STAT,1801,54,45-49,1855,0.0873229573513532
STAT,1850,15,30-34,1865,3.021815687669775
STAT,1814,41,50-100,1855,6.335837937464459
SIM,1936,28,30-34,1964,80
SIM,1841,56,na,1897,2883
STAT,1836,36,45-49,1872,3.288058327594028
STAT,1851,41,20-24,1892,0.24730315000599962
STAT,1872,52,20-24,1924,0.0014898113927437292
SIM,1857,43,30-34,1900,4
SIM,1896,47,30-34,1943,1
SIM,1893,56,na,1949,5322
STAT,1828,27,20-24,1855,39.95424987970072
SIM,1900,48,45-49,1948,1
STAT,1876,27,45-49,1903,2.3192674827804374
STAT,1906,35,25-29,1941,1.8462601567637016
SIM,1912,22,45-49,1934,4
SIM,1831,33,25-29,1864,24
SIM,1851,36,45-49,1887,4
SIM,1851,58,na,1909,3050
STAT,1895,30,na,1925,6330.367703893748
SIM,1827,27,na,1854,3759
SIM,1899,19,45-49,1918,3
STAT,1881,46,25-29,1927,0.11275911821867705
SIM,1823,47,25-29,1870,1
SIM,1829,56,na,1885,2649
SIM,1852,29,20-24,1881,24
SIM,1782,81,na,1863,322
STAT,1842,33,35-39,1875,18.025629792081208
SIM,1832,25,30-34,1857,58
SIM,1866,28,45-49,1894,2
SIM,1890,11,na,1901,6868
SIM,1850,33,35-39,1883,20
STAT,1886,21,30-34,1907,38.08941377393097
STAT,1859,52,45-49,1911,0.0232043587774902
STAT,1890,24,25-29,1914,140.23592747660476
SIM,1909,17,15-19,1926,20
STAT,1843,36,45-49,1879,3.294037291622023
STAT,1835,26,45-49,1861,1.888563609347103
STAT,1870,31,45-49,1901,3.471828505010269
SIM,1906,22,na,1928,6940
STAT,1895,18,20-24,1913,46.53270888581533
STAT,1881,62,na,1943,3567.879734194957
SIM,1890,41,50-100,1931,6
STAT,1838,30,40-44,1868,7.44630061029124
SIM,1927,30,35-39,1957,33
STAT,1814,47,50-100,1861,1.2723627991344355
STAT,1790,100,na,1890,0.415274955035947
STAT,1815,73,na,1888,1156.6110970409616
STAT,1838,49,25-29,1887,0.07817203645898547
SIM,1928,17,25-29,1945,151
SIM,1903,57,na,1960,6164
STAT,1820,41,35-39,1861,7.537653779650052
STAT,1878,18,45-49,1896,0.1374238079615983
SIM,1844,36,45-49,1880,5
STAT,1904,22,45-49,1926,2.0213537365433076
STAT,1927,40,35-39,1967,0.5113791773077615
STAT,1917,27,50-100,1944,2.1079832787589825
STAT,1935,36,50-100,1971,1.1870003087571386
STAT,1823,33,25-29,1856,51.034033869683235
SIM,1845,39,25-29,1884,3
SIM,1881,26,20-24,1907,19
SIM,1900,47,50-100,1947,1
SIM,1914,35,25-29,1949,4
STAT,1888,47,30-34,1935,0.22999065413941272
SIM,1859,42,45-49,1901,6
STAT,1821,44,45-49,1865,4.498120194527671
STAT,1866,33,20-24,1899,5.01583861298342
SIM,1890,38,25-29,1928,11
STAT,1937,35,50-100,1972,0.849546964612884
SIM,1894,21,30-34,1915,69
STAT,1864,31,20-24,1895,4.899799792651511
STAT,1887,19,na,1906,5674.226840066584
SIM,1785,86,na,1871,93
SIM,1918,46,50-100,1964,1
SIM,1836,27,20-24,1863,2
STAT,1894,31,30-34,1925,45.48254916497369
STAT,1920,43,20-24,1963,0.039320853385166124
STAT,1891,16,30-34,1907,3.98867940810814
SIM,1892,40,na,1932,6687
SIM,1907,40,35-39,1947,2
SIM,1839,23,15-19,1862,5
STAT,1815,47,25-29,1862,0.30952702688271166
STAT,1890,48,25-29,1938,0.07908945876291464
STAT,1784,103,na,1887,0.08923887048048824
SIM,1838,39,25-29,1877,10
SIM,1834,86,na,1920,216
SIM,1866,37,35-39,1903,22
SIM,1827,30,30-34,1857,31
SIM,1812,59,na,1871,2288
STAT,1818,78,na,1896,801.6027651469575
SIM,1849,22,30-34,1871,41
SIM,1888,29,35-39,1917,22
STAT,1882,38,25-29,1920,5.636426923044115
SIM,1835,40,30-34,1875,2
SIM,1821,35,20-24,1856,1
SIM,1870,13,na,1883,5155
STAT,1780,103,na,1883,0.09884013327969132
SIM,1868,74,na,1942,2094
SIM,1845,46,50-100,1891,2
STAT,1881,34,25-29,1915,19.823212086433053
STAT,1851,32,30-34,1883,28.17059527370292
STAT,1869,84,na,1953,651.0017528265207
STAT,1920,46,30-34,1966,0.19946730613532856
STAT,1856,45,20-24,1901,0.018885254233548143
SIM,1923,22,20-24,1945,278
STAT,1933,34,40-44,1967,10.638281436926967
SIM,1870,90,na,1960,242
STAT,1836,21,40-44,1857,3.6837871551833152
STAT,1832,38,35-39,1870,11.527607968015543
SIM,1823,99,na,1922,1
STAT,1795,82,na,1877,359.11180194501696
SIM,1917,16,35-39,1933,2
STAT,1897,26,50-100,1923,1.7328667958468669
STAT,1864,3,na,1867,5798.29109970839
SIM,1933,30,na,1963,10764
STAT,1871,26,na,1897,4805.027916724796
SIM,1853,26,45-49,1879,1
STAT,1846,37,na,1883,3768.466992740053
SIM,1882,44,35-39,1926,5
SIM,1929,38,40-44,1967,9
SIM,1812,44,45-49,1856,6
STAT,1845,26,45-49,1871,2.0975378221259113
STAT,1799,72,na,1871,1140.04469122934
SIM,1921,45,na,1966,8417
SIM,1850,76,na,1926,1369
SIM,1904,29,30-34,1933,85
STAT,1853,45,50-100,1898,0.3924627394739628
SIM,1906,25,25-29,1931,117
STAT,1814,43,25-29,1857,3.5778924431597416
STAT,1899,23,30-34,1922,49.13675415297368
STAT,1844,29,20-24,1873,22.860382588495423
SIM,1858,27,40-44,1885,7
SIM,1919,29,na,1948,8189
STAT,1873,42,50-100,1915,2.1652295248201745
STAT,1926,33,na,1959,9228.749897606001
SIM,1822,43,25-29,1865,3
SIM,1870,30,40-44,1900,16
STAT,1887,44,45-49,1931,3.3349681183177706
STAT,1888,66,na,1954,3912.4239609333463
STAT,1900,18,40-44,1918,0.5110831373561839
SIM,1855,43,20-24,1898,1
STAT,1813,47,na,1860,2736.926839018948
STAT,1910,21,25-29,1931,175.78253325432692
STAT,1857,99,na,1956,3.5139264731254505
SIM,1899,16,40-44,1915,1
STAT,1861,51,30-34,1912,0.010054161940516402
STAT,1947,21,20-24,1968,253.87383581900812
SIM,1844,43,45-49,1887,5
STAT,1827,43,35-39,1870,3.3779560306292225
SIM,1908,33,35-39,1941,21
SIM,1864,26,20-24,1890,24
STAT,1819,49,15-19,1868,0.0016288392547393945
STAT,1763,101,na,1864,0.12107963988138737
SIM,1947,19,40-44,1966,1
STAT,1840,45,25-29,1885,0.08601832335366423
STAT,1867,20,15-19,1887,6.356512601517035
SIM,1868,30,25-29,1898,22
SIM,1900,40,40-44,1940,1
STAT,1903,49,35-39,1952,0.2223465104964617
SIM,1849,44,40-44,1893,9
STAT,1906,32,15-19,1938,0.24064599310271184
STAT,1881,19,na,1900,4903.748847129217
STAT,1814,107,na,1921,0.004058689249005712
STAT,1914,23,na,1937,7512.927376100525
STAT,1954,17,25-29,1971,108.18323686964229
SIM,1881,31,na,1912,4091
STAT,1842,32,20-24,1874,4.861517852991355
STAT,1851,44,30-34,1895,1.758139420045397
STAT,1942,20,25-29,1962,195.7360654562913
STAT,1858,22,na,1880,3862.363161662311
STAT,1828,49,25-29,1877,0.10105541686621794
STAT,1901,35,40-44,1936,2.696797806981763
SIM,1807,50,na,1857,2397
STAT,1894,34,35-39,1928,26.04868347801048
STAT,1836,43,45-49,1879,2.337645095005456
STAT,1914,48,na,1962,7339.309737049223
SIM,1850,32,20-24,1882,5
SIM,1868,9,na,1877,5322
STAT,1939,19,40-44,1958,2.8260540635588334
SIM,1856,89,na,1945,127
SIM,1875,20,15-19,1895,11
STAT,1834,47,35-39,1881,0.19763853053454694
SIM,1949,15,35-39,1964,12
STAT,1923,35,50-100,1958,0.9838910754035258
STAT,1870,19,20-24,1889,35.0706678239471
STAT,1825,42,30-34,1867,2.6542673572112485
STAT,1906,31,50-100,1937,1.5546345221095348
STAT,1932,17,40-44,1949,3.740835349519392
STAT,1837,111,na,1948,1.4959523139221117E-4
STAT,1907,44,40-44,1951,0.4573830814032804
SIM,1914,46,40-44,1960,1
STAT,1807,53,35-39,1860,0.05495166355141333
STAT,1888,44,20-24,1932,0.3739799517373174
SIM,1882,4,na,1886,5581
SIM,1911,49,35-39,1960,1
STAT,1874,44,35-39,1918,3.6940634504772403
STAT,1940,24,30-34,1964,59.095524946567394
STAT,1852,8,na,1860,4733.636655311971
STAT,1873,39,35-39,1912,14.367954525451411
SIM,1899,28,40-44,1927,9
SIM,1848,45,50-100,1893,1
STAT,1868,37,na,1905,4527.072306189031
SIM,1921,48,na,1969,8334
SIM,1843,47,50-100,1890,2
SIM,1887,28,50-100,1915,2
SIM,1927,21,50-100,1948,1
STAT,1889,21,50-100,1910,1.018558935949696
STAT,1847,43,20-24,1890,0.24033657795246557
STAT,1876,24,40-44,1900,4.325535185425011
STAT,1831,32,45-49,1863,2.9418150938720724
STAT,1806,48,35-39,1854,0.8411629853294708
STAT,1870,41,na,1911,4603.525216209366
STAT,1900,22,50-100,1922,1.1424756080994667
SIM,1900,45,35-39,1945,2
STAT,1784,109,na,1893,0.0012868916609960679
SIM,1906,56,na,1962,6270
SIM,1927,33,45-49,1960,7
STAT,1868,21,50-100,1889,0.7892468248869111
SIM,1940,17,40-44,1957,2
SIM,1863,44,25-29,1907,2
SIM,1833,42,30-34,1875,4
STAT,1872,52,45-49,1924,0.02929962294536437
STAT,1909,16,35-39,1925,1.6668841072990914
SIM,1831,94,na,1925,14
STAT,1910,29,20-24,1939,35.358188518664655
STAT,1894,51,na,1945,5613.052932023376
SIM,1767,92,na,1859,26
SIM,1872,30,50-100,1902,2
SIM,1865,17,30-34,1882,3
STAT,1851,89,na,1940,162.8521439135968
STAT,1892,33,30-34,1925,43.95704703173769
SIM,1868,34,40-44,1902,13
STAT,1890,46,35-39,1936,0.19523017973881834
SIM,1943,17,15-19,1960,90
SIM,1826,42,na,1868,3118
SIM,1814,48,35-39,1862,1
SIM,1801,96,na,1897,5
STAT,1845,39,15-19,1884,0.0890482345703661
STAT,1853,33,35-39,1886,16.32998227292752
STAT,1949,22,25-29,1971,217.66720390170778
STAT,1898,44,20-24,1942,0.029734467709725248
STAT,1932,22,15-19,1954,14.107064125676185
STAT,1894,49,15-19,1943,5.731595257549546E-4
STAT,1923,39,35-39,1962,5.646265260165337
STAT,1857,17,30-34,1874,2.949015423918464
SIM,1879,37,20-24,1916,1
SIM,1940,22,15-19,1962,9
SIM,1881,53,na,1934,3620
STAT,1855,44,50-100,1899,1.5715567999117044
STAT,1914,45,na,1959,7394.4091489950215
SIM,1861,33,35-39,1894,23
STAT,1935,17,15-19,1952,125.3240025744793
STAT,1927,9,na,1936,9995.062229360556
STAT,1820,50,30-34,1870,0.02216883996044341
STAT,1932,29,40-44,1961,12.318499318107854
SIM,1823,31,15-19,1854,4
STAT,1867,27,35-39,1894,18.25022061041925
SIM,1874,33,20-24,1907,7
STAT,1919,33,45-49,1952,3.413533202835768
STAT,1857,50,20-24,1907,0.0011783235522281699
STAT,1914,29,na,1943,7573.867887616562
SIM,1891,33,20-24,1924,2
SIM,1821,38,25-29,1859,6
STAT,1827,31,50-100,1858,2.381493871016622
SIM,1835,87,na,1922,148
STAT,1883,50,30-34,1933,0.011981221478741364
STAT,1915,29,40-44,1944,9.533751492292591
STAT,1937,26,15-19,1963,1.390719597425843
STAT,1941,22,na,1963,7622.049466231097
STAT,1815,54,50-100,1869,0.07470036698187293
STAT,1868,44,35-39,1912,3.4325593928487965
SIM,1933,32,25-29,1965,37
SIM,1899,32,na,1931,6646
STAT,1839,38,50-100,1877,2.267212853638276
STAT,1832,32,20-24,1864,4.593767455308105
STAT,1853,48,15-19,1901,6.249278901778537E-4
STAT,1893,17,35-39,1910,1.4046284914089582
STAT,1901,46,20-24,1947,0.01919279727101127
SIM,1859,44,35-39,1903,5
SIM,1944,21,45-49,1965,4
STAT,1872,40,45-49,1912,3.0684436074530956
SIM,1813,84,na,1897,283
SIM,1834,23,30-34,1857,37
STAT,1831,32,50-100,1863,1.5456994465607174
STAT,1915,30,50-100,1945,1.7144441974659452
SIM,1880,40,45-49,1920,6
SIM,1918,41,na,1959,8252
SIM,1919,26,na,1945,8233
SIM,1940,29,40-44,1969,17
SIM,1890,22,15-19,1912,7
SIM,1860,23,40-44,1883,1
STAT,1882,22,15-19,1904,6.4904889083732735
SIM,1881,39,35-39,1920,22
SIM,1918,21,35-39,1939,24
STAT,1883,29,na,1912,4701.66891179148
SIM,1929,31,20-24,1960,6
STAT,1857,41,30-34,1898,1.8179931420159132
SIM,1913,37,50-100,1950,2
STAT,1916,30,25-29,1946,19.426687088442936
STAT,1922,40,na,1962,8630.873058677313
SIM,1782,84,na,1866,173
SIM,1893,41,na,1934,6108
SIM,1923,29,40-44,1952,11
STAT,1858,25,35-39,1883,15.777165644362519
STAT,1874,50,20-24,1924,0.0015478830345993235
SIM,1839,27,30-34,1866,43
STAT,1871,16,45-49,1887,0.13269868457235443
SIM,1863,44,50-100,1907,6
STAT,1815,44,20-24,1859,0.8891175603533021
SIM,1924,30,25-29,1954,28
STAT,1916,42,25-29,1958,0.14779183370573812
STAT,1893,24,40-44,1917,5.300902881772511
STAT,1800,99,na,1899,1.6175923465149809
STAT,1841,15,20-24,1856,33.57001903583867
STAT,1901,23,40-44,1924,5.873491161779244
SIM,1788,75,na,1863,709
SIM,1929,24,15-19,1953,15
SIM,1900,68,na,1968,5165
STAT,1898,18,30-34,1916,4.344771820260512
STAT,1877,41,40-44,1918,4.738430982883298
STAT,1901,41,na,1942,6586.965861368209
STAT,1841,34,20-24,1875,4.660691705134642
STAT,1876,17,40-44,1893,0.3820588334559427
STAT,1757,107,na,1864,0.026123478062558485
SIM,1861,45,50-100,1906,1
STAT,1867,15,40-44,1882,0.3578652084624999
SIM,1818,47,na,1865,2903
STAT,1826,33,40-44,1859,12.196453106081197
STAT,1909,22,50-100,1931,1.2357621497880387
SIM,1848,29,30-34,1877,58
STAT,1834,49,na,1883,3090.5960227370397
STAT,1821,61,na,1882,2192.059826452833
STAT,1759,105,na,1864,0.01661958610604414
SIM,1885,22,40-44,1907,6
SIM,1903,38,50-100,1941,1
STAT,1877,44,50-100,1921,2.1856410211517376
SIM,1876,44,35-39,1920,9
SIM,1868,89,na,1957,215
STAT,1912,38,20-24,1950,0.5171831544046207
SIM,1945,26,15-19,1971,1
SIM,1827,33,40-44,1860,14
SIM,1845,24,na,1869,4239
SIM,1899,21,15-19,1920,5
SIM,1927,21,45-49,1948,4
STAT,1856,26,20-24,1882,19.07964241934849
STAT,1926,23,35-39,1949,23.027561107283574
SIM,1885,41,40-44,1926,13
SIM,1859,35,45-49,1894,5
STAT,1880,29,25-29,1909,89.3561192255659
STAT,1773,116,na,1889,2.2236576444691064E-4
SIM,1834,33,40-44,1867,13
STAT,1919,21,45-49,1940,2.4953244742239398
SIM,1889,51,na,1940,5468
SIM,1856,54,35-39,1910,1
STAT,1886,24,40-44,1910,4.414749562831046
STAT,1897,5,na,1902,7074.785610173525
SIM,1885,34,35-39,1919,31
STAT,1916,49,45-49,1965,0.4475716605334085
STAT,1911,45,45-49,1956,0.41762411595124727
STAT,1831,51,45-49,1882,0.019929623551743072
SIM,1823,44,20-24,1867,1
SIM,1934,23,35-39,1957,34
STAT,1848,107,na,1955,0.007732783543206223
STAT,1831,69,na,1900,1894.8158566594316
SIM,1854,43,45-49,1897,1
STAT,1945,23,45-49,1968,2.489523410260315
SIM,1818,43,35-39,1861,6
STAT,1882,66,na,1948,3224.583111431573
STAT,1895,14,na,1909,6774.207988662449
SIM,1839,15,30-34,1854,4
SIM,1823,77,na,1900,845
SIM,1890,35,20-24,1925,2
SIM,1904,16,25-29,1920,21
STAT,1806,62,na,1868,1835.8849620009669
SIM,1835,43,35-39,1878,8
SIM,1868,71,na,1939,2572
STAT,1887,1,na,1888,6709.45434216989
STAT,1852,23,40-44,1875,3.9170971166804076
STAT,1812,84,na,1896,315.333552758542
SIM,1894,24,40-44,1918,5
STAT,1812,54,20-24,1866,0.004699581049281463
SIM,1950,20,25-29,1970,246
SIM,1860,16,35-39,1876,2
STAT,1847,24,20-24,1871,126.93380565506845
STAT,1917,21,35-39,1938,20.270389886447777
SIM,1814,42,50-100,1856,4
STAT,1762,92,na,1854,24.0
STAT,1902,1,na,1903,7760.9835561502405
STAT,1910,36,20-24,1946,0.5118152433940241
SIM,1869,37,na,1906,4566
STAT,1862,33,45-49,1895,2.997485037439624
STAT,1882,35,20-24,1917,1.5309685454864554
STAT,1853,31,45-49,1884,2.8709356718613885
SIM,1833,32,20-24,1865,7
SIM,1849,37,35-39,1886,18
STAT,1846,43,45-49,1889,2.2906338625859237
STAT,1781,84,na,1865,204.5983101882304
STAT,1925,32,25-29,1957,22.161970737679567
STAT,1841,21,15-19,1862,6.107588157950382
STAT,1849,64,na,1913,2749.7322973899195
STAT,1883,33,20-24,1916,5.340973069941815
SIM,1925,21,35-39,1946,25
SIM,1844,21,40-44,1865,2
STAT,1842,54,25-29,1896,0.005128384782467388
STAT,1862,45,20-24,1907,0.020920929503977326
STAT,1948,6,na,1954,9108.52952764232
STAT,1812,47,15-19,1859,0.002778214359797069
STAT,1897,27,20-24,1924,31.67071775182019
STAT,1910,48,20-24,1958,0.020773460021741942
STAT,1857,15,50-100,1872,0.09172326546435175
STAT,1906,27,40-44,1933,8.81577742323706
SIM,1858,96,na,1954,6
STAT,1852,16,35-39,1868,1.063987753321845
SIM,1943,6,na,1949,8693
SIM,1843,23,40-44,1866,1
SIM,1914,39,40-44,1953,6
STAT,1940,20,50-100,1960,1.3547747624507884
SIM,1908,21,35-39,1929,24
STAT,1936,21,45-49,1957,2.1736968960985497
STAT,1908,11,na,1919,7753.630556514756
STAT,1816,42,20-24,1858,0.8747562992974494
SIM,1819,40,50-100,1859,4
STAT,1841,103,na,1944,0.208230231023972
SIM,1840,32,20-24,1872,9
SIM,1840,38,35-39,1878,26
SIM,1837,39,50-100,1876,1
SIM,1847,72,na,1919,2020
STAT,1880,18,na,1898,5359.333109902185
SIM,1914,27,40-44,1941,8
STAT,1863,74,na,1937,1961.9959627004157
SIM,1939,15,35-39,1954,10
STAT,1877,34,35-39,1911,21.05622777472528
STAT,1876,50,30-34,1926,0.012612723338786436
STAT,1850,24,na,1874,3878.5185539312424
STAT,1915,22,20-24,1937,232.15533678522874
SIM,1871,29,25-29,1900,92
STAT,1906,39,40-44,1945,2.7526418796631775
SIM,1889,18,30-34,1907,4
STAT,1821,49,15-19,1870,0.0011374188824848448
STAT,1827,61,na,1888,2324.695713139853
STAT,1832,44,20-24,1876,0.2468388880685786
STAT,1898,42,30-34,1940,0.21792829933531171
SIM,1845,46,na,1891,3679
STAT,1835,23,40-44,1858,3.563353193572238
STAT,1848,54,35-39,1902,0.013728146759061605
STAT,1855,44,25-29,1899,0.9552600216372685
SIM,1861,31,45-49,1892,2
STAT,1848,60,na,1908,3127.216324006915
STAT,1801,53,25-29,1854,0.02174623522042518
SIM,1900,33,40-44,1933,23
SIM,1844,61,na,1905,2638
SIM,1853,23,40-44,1876,6
STAT,1913,36,50-100,1949,0.8410431920930392
STAT,1847,36,20-24,1883,1.2318786886752155
STAT,1902,20,na,1922,6783.808267546239
STAT,1842,19,45-49,1861,0.12341892145967297
SIM,1874,19,30-34,1893,3
STAT,1840,22,45-49,1862,1.2800220637016464
STAT,1903,46,30-34,1949,0.1574608802272623
STAT,1913,29,30-34,1942,78.30575944661182
SIM,1906,22,20-24,1928,187
STAT,1842,51,20-24,1893,0.0011038815125312435
STAT,1920,49,35-39,1969,0.2860835889236784
STAT,1894,69,na,1963,4229.743915830439
SIM,1900,46,na,1946,6547
SIM,1923,25,25-29,1948,177
SIM,1888,35,50-100,1923,4
STAT,1845,45,45-49,1890,0.36728636282097193
STAT,1901,56,na,1957,5852.660157162341
STAT,1882,29,35-39,1911,18.847592764245217
STAT,1866,19,30-34,1885,3.012804073864866
SIM,1828,39,30-34,1867,16
SIM,1869,8,na,1877,5298
SIM,1919,36,15-19,1955,1
SIM,1869,34,na,1903,4558
STAT,1856,36,30-34,1892,8.344712098302296
STAT,1836,40,40-44,1876,3.650867520202587
STAT,1915,25,25-29,1940,136.51858255628568
SIM,1861,19,20-24,1880,40
SIM,1890,29,35-39,1919,36
SIM,1922,47,45-49,1969,2
STAT,1845,23,40-44,1868,3.9576469969655204
STAT,1897,33,15-19,1930,0.3828273489674839
SIM,1875,27,35-39,1902,29
STAT,1827,41,45-49,1868,2.8951905801619935
STAT,1922,15,15-19,1937,106.53986644452996
STAT,1923,32,15-19,1955,0.2974306368610038
SIM,1877,88,na,1965,508
SIM,1870,33,45-49,1903,4
SIM,1814,42,20-24,1856,3
STAT,1916,46,40-44,1962,0.3274053656636192
STAT,1898,47,25-29,1945,0.08838729463891788
SIM,1890,16,20-24,1906,52
STAT,1836,24,45-49,1860,1.206372160452034
STAT,1873,33,20-24,1906,5.523420627800004
SIM,1823,38,35-39,1861,23
SIM,1899,18,30-34,1917,6
SIM,1881,33,20-24,1914,6
SIM,1859,30,50-100,1889,2
SIM,1878,11,na,1889,5654
STAT,1836,75,na,1911,1368.755450993115
SIM,1839,17,20-24,1856,36
SIM,1881,29,25-29,1910,83
SIM,1931,32,15-19,1963,3
STAT,1861,42,na,1903,3880.4301056684358
STAT,1912,19,na,1931,7847.485615002577
STAT,1873,29,25-29,1902,86.18447885406833
SIM,1919,27,25-29,1946,162
STAT,1852,21,50-100,1873,0.7776826966276423
STAT,1842,30,30-34,1872,32.060685181703114
SIM,1837,43,45-49,1880,3
SIM,1930,15,15-19,1945,137
STAT,1853,19,20-24,1872,33.346138999009135
STAT,1840,31,50-100,1871,1.627665382110936
SIM,1842,44,30-34,1886,4
SIM,1835,41,45-49,1876,3
STAT,1918,17,15-19,1935,20.01197106244718
SIM,1829,34,20-24,1863,5
SIM,1856,15,30-34,1871,5
SIM,1872,46,25-29,1918,1
STAT,1873,26,20-24,1899,24.156210683836143
STAT,1832,28,25-29,1860,73.46496197135826
SIM,1810,73,na,1883,1022
STAT,1858,37,35-39,1895,11.135737164166484
STAT,1810,44,45-49,1854,10.51778828727305
STAT,1834,31,na,1865,3727.5659378130686
STAT,1944,21,na,1965,7965.248769089331
SIM,1840,28,25-29,1868,101
SIM,1850,30,30-34,1880,41
STAT,1894,32,45-49,1926,4.524166739683762
SIM,1868,37,45-49,1905,6
SIM,1895,27,50-100,1922,2
STAT,1846,19,20-24,1865,33.71144856559199
SIM,1888,26,na,1914,5846
STAT,1864,46,25-29,1910,0.1042810609041563
STAT,1923,36,30-34,1959,4.26752599837062
STAT,1901,38,45-49,1939,1.2105166047078524
SIM,1829,53,na,1882,2785
SIM,1832,76,na,1908,1231
SIM,1850,35,25-29,1885,6
SIM,1808,69,na,1877,1537
STAT,1834,44,30-34,1878,1.7982498708971144
STAT,1938,24,15-19,1962,10.634594815959852
SIM,1832,57,na,1889,2642
STAT,1871,35,50-100,1906,2.4868803022430312
SIM,1947,19,50-100,1966,1
STAT,1904,30,na,1934,6972.896812795794
STAT,1815,76,na,1891,880.6114200775164
STAT,1848,15,30-34,1863,3.2782992179255217
SIM,1849,47,45-49,1896,2
STAT,1816,40,30-34,1856,6.8450301760640055
SIM,1844,40,40-44,1884,5
STAT,1842,35,25-29,1877,5.134014648911154
STAT,1848,29,50-100,1877,1.2342812013796107
SIM,1878,44,45-49,1922,11
SIM,1864,39,35-39,1903,9
STAT,1847,49,35-39,1896,0.20895206401454056
STAT,1838,53,20-24,1891,9.826690375525707E-4
SIM,1901,30,50-100,1931,5
STAT,1855,52,45-49,1907,0.021767269520564493
STAT,1829,54,25-29,1883,0.0047219719732894535
STAT,1861,64,na,1925,2922.1950846542345
SIM,1891,46,35-39,1937,1
STAT,1941,15,25-29,1956,90.19931407477706
SIM,1868,6,na,1874,5481
SIM,1894,46,45-49,1940,1
SIM,1928,19,15-19,1947,109
STAT,1787,101,na,1888,0.2687875372059461
STAT,1870,41,30-34,1911,2.2899081220118243
STAT,1886,46,45-49,1932,0.5045669495450714
STAT,1861,54,35-39,1915,0.014073933037188173
SIM,1889,73,na,1962,3385
SIM,1834,26,35-39,1860,20
SIM,1858,17,30-34,1875,4
STAT,1896,45,25-29,1941,0.08749916459987314
SIM,1921,36,50-100,1957,1
SIM,1856,29,50-100,1885,2
SIM,1938,33,20-24,1971,6
STAT,1836,97,na,1933,7.142842922971559
SIM,1833,21,na,1854,3795
STAT,1883,46,35-39,1929,0.2785869936305472
STAT,1883,52,20-24,1935,0.001456438921646521
SIM,1921,29,30-34,1950,103
SIM,1824,40,30-34,1864,4
STAT,1903,42,15-19,1945,0.002754220083565023
SIM,1856,86,na,1942,275
SIM,1885,44,45-49,1929,7
SIM,1859,32,40-44,1891,13
STAT,1887,4,na,1891,5942.178202762737
STAT,1884,49,50-100,1933,0.4795663263750673
SIM,1877,85,na,1962,768
SIM,1812,48,50-100,1860,1
SIM,1901,29,20-24,1930,33
SIM,1878,29,50-100,1907,5
STAT,1883,31,30-34,1914,34.78643313223268
STAT,1783,94,na,1877,7.271058417707076
SIM,1913,19,na,1932,8097
STAT,1833,43,35-39,1876,2.852744285212925
STAT,1856,32,15-19,1888,0.22462164357102057
STAT,1868,42,45-49,1910,2.8722929776948822
SIM,1883,63,na,1946,3645
SIM,1939,17,25-29,1956,114
SIM,1875,24,30-34,1899,44
STAT,1820,53,35-39,1873,0.03020313441824346
SIM,1904,25,15-19,1929,1
STAT,1829,40,40-44,1869,3.818757057459403
SIM,1909,29,15-19,1938,1
STAT,1762,95,na,1857,5.506157790053567
STAT,1867,24,30-34,1891,33.479681525934886
STAT,1873,52,na,1925,4394.899420765056
STAT,1815,98,na,1913,3.0195180832732094
SIM,1833,39,na,1872,3384
SIM,1931,36,30-34,1967,5
STAT,1876,41,na,1917,4849.700572331272
SIM,1854,19,20-24,1873,46
SIM,1929,29,50-100,1958,4
STAT,1818,87,na,1905,180.7514295568162
STAT,1877,25,45-49,1902,2.3442784829332455
SIM,1841,43,35-39,1884,6
SIM,1885,25,45-49,1910,3
STAT,1877,44,45-49,1921,3.096324788837878
SIM,1871,78,na,1949,1334
STAT,1846,34,na,1880,3842.310684070411
STAT,1828,39,15-19,1867,0.10859620735762193
STAT,1856,12,na,1868,4398.514779935696
SIM,1892,49,50-100,1941,1
STAT,1854,39,25-29,1893,4.369349989962525
STAT,1912,44,15-19,1956,0.0029689422762643842
STAT,1883,36,25-29,1919,5.740611827932092
SIM,1891,31,30-34,1922,59
STAT,1896,31,40-44,1927,11.610799591779108
SIM,1880,19,30-34,1899,3
SIM,1866,22,30-34,1888,47
STAT,1866,43,30-34,1909,2.126907338515839
SIM,1926,17,15-19,1943,103
SIM,1891,6,na,1897,6724
STAT,1929,41,15-19,1970,0.004021939194606987
SIM,1876,42,45-49,1918,7
SIM,1908,63,na,1971,5919
STAT,1842,45,35-39,1887,0.21387955805741618
STAT,1852,26,45-49,1878,2.0760465401480315
SIM,1822,32,45-49,1854,2
SIM,1870,93,na,1963,158
STAT,1897,37,30-34,1934,14.387951626059538
SIM,1921,30,na,1951,8639
SIM,1897,19,35-39,1916,1
SIM,1915,44,40-44,1959,1
STAT,1811,51,35-39,1862,0.05687781412504774
STAT,1837,17,20-24,1854,48.383616573712665
SIM,1922,34,30-34,1956,45
SIM,1845,17,20-24,1862,36
SIM,1854,29,30-34,1883,55
STAT,1846,29,30-34,1875,45.99413547003729
STAT,1881,23,45-49,1904,1.357022189634404
SIM,1934,18,na,1952,9968
STAT,1889,19,35-39,1908,1.3590857394599387
STAT,1914,34,30-34,1948,31.760643505660482
STAT,1923,46,40-44,1969,0.37330070764752094
STAT,1875,45,30-34,1920,0.20328792017554065
SIM,1882,19,na,1901,5258
SIM,1914,44,50-100,1958,2
SIM,1809,51,45-49,1860,1
STAT,1837,54,50-100,1891,0.020475762407190717
STAT,1830,34,45-49,1864,3.3404706425157236
STAT,1858,22,30-34,1880,32.17651764411495
STAT,1897,40,na,1937,6324.244688813074
STAT,1906,44,50-100,1950,0.2129865656416853
SIM,1791,80,na,1871,346
SIM,1854,38,na,1892,3903
SIM,1850,45,35-39,1895,1
STAT,1824,72,na,1896,1350.2063713300583
STAT,1836,30,30-34,1866,29.96559237939993
STAT,1839,86,na,1925,346.44376271627186
STAT,1840,33,25-29,1873,17.821508189642625
STAT,1947,10,na,1957,8938.464918571002
SIM,1924,46,40-44,1970,1
STAT,1825,35,na,1860,3371.576555941266
STAT,1916,40,35-39,1956,0.41791389928322575
SIM,1860,26,45-49,1886,3
STAT,1808,54,30-34,1862,0.0339089195170182
SIM,1881,56,na,1937,3478
STAT,1847,53,30-34,1900,0.008928031909766073
SIM,1944,8,na,1952,8740
SIM,1916,15,50-100,1931,4
STAT,1893,27,45-49,1920,2.8422405912909294
SIM,1874,43,30-34,1917,8
STAT,1864,56,na,1920,3682.170648673657
STAT,1930,17,30-34,1947,31.825251772460344
SIM,1792,65,na,1857,1573
SIM,1819,91,na,1910,32
STAT,1855,30,40-44,1885,6.798270587700373
SIM,1856,64,na,1920,2868
SIM,1920,29,50-100,1949,3
STAT,1912,29,50-100,1941,1.967366772257012
STAT,1948,3,na,1951,9217.60873638928
STAT,1851,47,35-39,1898,0.21601378308707472
STAT,1870,78,na,1948,1549.2477793813005
STAT,1832,47,25-29,1879,0.08878208248315879
STAT,1911,42,40-44,1953,0.48228332986485367
SIM,1881,43,30-34,1924,5
STAT,1834,23,50-100,1857,0.7207673157839886
STAT,1872,19,30-34,1891,3.2177919783517748
STAT,1824,40,50-100,1864,2.8829241742126723
STAT,1937,17,25-29,1954,85.16014213136546
STAT,1837,20,na,1857,3948.078499688683
SIM,1834,36,45-49,1870,3
SIM,1885,31,30-34,1916,45
SIM,1855,39,25-29,1894,7
STAT,1885,55,na,1940,4156.716684276353
SIM,1821,36,na,1857,3263
STAT,1927,20,50-100,1947,1.6467949023977664
SIM,1865,41,30-34,1906,4
SIM,1842,35,na,1877,3711
SIM,1863,30,40-44,1893,15
STAT,1826,36,45-49,1862,4.8892221569251815
STAT,1812,87,na,1899,167.0028838616949
STAT,1816,45,25-29,1861,0.29182256900178
SIM,1945,17,25-29,1962,110
SIM,1886,18,20-24,1904,36
SIM,1835,29,20-24,1864,23
STAT,1841,25,30-34,1866,46.0396839915797
SIM,1933,33,na,1966,10722
STAT,1877,31,30-34,1908,36.76542485539745
SIM,1827,36,45-49,1863,7
SIM,1860,5,na,1865,5093
SIM,1863,34,na,1897,4395
STAT,1904,8,na,1912,7535.407917244976
SIM,1849,34,30-34,1883,39
SIM,1891,36,25-29,1927,11
STAT,1805,80,na,1885,590.6400911493224
STAT,1890,36,25-29,1926,7.1318314795100015
STAT,1916,55,na,1971,7371.309485480714
STAT,1810,58,na,1868,2180.317484079766
STAT,1877,22,40-44,1899,4.370076799662996
STAT,1883,11,na,1894,5132.050849357943
SIM,1914,23,25-29,1937,219
STAT,1886,27,45-49,1913,2.367102489466204
SIM,1842,23,50-100,1865,1
SIM,1912,34,na,1946,7649
STAT,1901,49,25-29,1950,0.08994653913169104
SIM,1894,27,45-49,1921,3
STAT,1919,38,30-34,1957,3.949603701509212
STAT,1773,113,na,1886,9.035479606156066E-4
STAT,1906,23,25-29,1929,167.95006674545058
SIM,1832,40,50-100,1872,6
STAT,1825,57,na,1882,2500.3108639062984
STAT,1827,83,na,1910,480.05032641445064
STAT,1871,35,45-49,1906,4.037949127971261
STAT,1823,45,25-29,1868,0.1831162003897228
STAT,1862,30,40-44,1892,7.5462192960756465
STAT,1819,36,45-49,1855,12.477181914022381
SIM,1789,79,na,1868,514
STAT,1759,102,na,1861,0.06753104808980985
STAT,1827,29,20-24,1856,37.74319393329513
SIM,1828,29,20-24,1857,23
SIM,1927,38,30-34,1965,9
SIM,1857,49,na,1906,3924
STAT,1774,80,na,1854,348.0
STAT,1852,50,50-100,1902,0.024416825892923096
SIM,1892,17,30-34,1909,8
SIM,1893,49,50-100,1942,1
SIM,1824,87,na,1911,216
SIM,1857,19,30-34,1876,5
STAT,1848,53,20-24,1901,0.0011905443676451727
STAT,1837,46,50-100,1883,0.36000229328641137
SIM,1864,1,na,1865,6549
STAT,1886,30,35-39,1916,21.763869200911113
STAT,1895,42,50-100,1937,0.1928244797604248
SIM,1892,33,35-39,1925,40
STAT,1895,36,45-49,1931,5.271370378930218
STAT,1851,27,45-49,1878,2.01525396894242
STAT,1898,46,40-44,1944,0.2646865386420873
STAT,1866,70,na,1936,2614.6003284175563
STAT,1890,44,15-19,1934,0.03358386163206207
SIM,1939,15,40-44,1954,2
STAT,1826,42,na,1868,3244.5190158528344
STAT,1849,39,na,1888,3735.0022634780985
SIM,1949,19,15-19,1968,104
STAT,1787,107,na,1894,0.0034686391200972402
STAT,1904,61,na,1965,5851.826264964354
STAT,1917,15,40-44,1932,0.6106621393052458
SIM,1869,99,na,1968,26
STAT,1836,37,20-24,1873,1.2583047171815465
SIM,1871,43,45-49,1914,7
STAT,1941,26,40-44,1967,9.742803676419603
STAT,1853,44,na,1897,3607.4863487001917
SIM,1890,36,35-39,1926,30
STAT,1855,103,na,1958,0.3776579883191594
SIM,1928,29,25-29,1957,194
SIM,1897,39,25-29,1936,2
STAT,1873,43,30-34,1916,2.3421415187818417
STAT,1850,40,25-29,1890,0.9945349334487771
STAT,1881,87,na,1968,809.9371562855679
STAT,1815,47,30-34,1862,0.520177369635729
STAT,1852,53,40-44,1905,0.016509669442288846
STAT,1892,41,15-19,1933,0.03507331917078414
STAT,1924,29,45-49,1953,4.032367585949014
SIM,1886,31,na,1917,4982
SIM,1943,17,na,1960,8056
STAT,1853,24,45-49,1877,1.2849467110248314
SIM,1915,41,30-34,1956,1
SIM,1945,26,20-24,1971,45
STAT,1870,21,40-44,1891,4.144307314052466
STAT,1908,51,na,1959,6629.039880951473
STAT,1857,34,na,1891,3724.3616841584944
SIM,1919,18,20-24,1937,318
STAT,1850,24,20-24,1874,125.00580596403556
SIM,1836,45,45-49,1881,1
STAT,1806,52,30-34,1858,0.03473459702014355
SIM,1889,49,45-49,1938,1
STAT,1880,40,40-44,1920,4.833785987694519
STAT,1884,17,30-34,1901,3.178606768292024
SIM,1904,6,na,1910,7692
SIM,1795,85,na,1880,169
STAT,1863,43,45-49,1906,2.62679770141894
SIM,1828,77,na,1905,1052
SIM,1820,97,na,1917,5
STAT,1852,21,20-24,1873,131.42058497464856
SIM,1865,46,25-29,1911,1
STAT,1840,37,40-44,1877,7.473433809148545
SIM,1894,30,35-39,1924,48
SIM,1921,4,na,1925,9343
STAT,1833,27,25-29,1860,73.54493326702156
STAT,1884,33,35-39,1917,20.11088112534473
SIM,1901,29,15-19,1930,1
STAT,1909,39,20-24,1948,0.49912391902436476
STAT,1831,29,na,1860,3648.595199334757
STAT,1854,17,15-19,1871,10.882889151375693
SIM,1879,39,50-100,1918,4
STAT,1784,73,na,1857,790.1284184823676
STAT,1828,45,45-49,1873,0.43641778846234025
SIM,1862,17,15-19,1879,13
STAT,1864,24,20-24,1888,124.60025293344341
SIM,1851,89,na,1940,97
STAT,1872,30,35-39,1902,20.720542674343307
SIM,1825,42,35-39,1867,6
STAT,1814,57,na,1871,2218.5617125079416
SIM,1951,12,na,1963,9798
SIM,1924,10,na,1934,9957
STAT,1864,36,15-19,1900,0.10186429334499904
STAT,1893,72,na,1965,3806.3958954565874
STAT,1845,100,na,1945,1.6359267199758154
SIM,1882,43,20-24,1925,1
SIM,1830,30,50-100,1860,2
SIM,1872,24,20-24,1896,128
SIM,1925,15,40-44,1940,2
SIM,1836,72,na,1908,1518
STAT,1835,24,25-29,1859,97.1882388816007
STAT,1910,16,50-100,1926,0.15035356921127732
SIM,1876,32,40-44,1908,18
STAT,1862,27,20-24,1889,20.325499882583102
SIM,1859,69,na,1928,2473
STAT,1921,22,50-100,1943,1.5006081363239199
SIM,1848,48,45-49,1896,1
STAT,1857,46,25-29,1903,0.09093118216981037
SIM,1947,21,25-29,1968,227
STAT,1815,45,35-39,1860,0.7764414939790647
STAT,1950,19,45-49,1969,1.192029266863291
SIM,1905,23,15-19,1928,10
STAT,1917,28,na,1945,7905.788877909448
SIM,1890,38,30-34,1928,14
SIM,1935,19,15-19,1954,113
STAT,1903,0,na,1903,8443.618810975795
SIM,1901,53,na,1954,6074
STAT,1941,30,50-100,1971,1.755223601602699
STAT,1892,23,15-19,1915,8.315135512678163
STAT,1841,53,35-39,1894,0.012290582505320172
STAT,1776,78,na,1854,565.0
STAT,1929,16,15-19,1945,117.24903276036785
STAT,1901,23,35-39,1924,16.44807334687707
SIM,1955,16,35-39,1971,14
STAT,1810,67,na,1877,1614.2246572366464
STAT,1909,6,na,1915,7916.449727936092
SIM,1867,64,na,1931,3415
SIM,1887,17,20-24,1904,42
STAT,1903,20,35-39,1923,16.88040777912798
STAT,1939,21,25-29,1960,187.43319423676584
STAT,1817,42,35-39,1859,9.828539667008009
SIM,1892,15,35-39,1907,1
STAT,1889,39,25-29,1928,7.09770983546062
SIM,1841,27,25-29,1868,79
STAT,1831,48,25-29,1879,0.08702229938619922
STAT,1952,16,45-49,1968,1.2092520234372006
STAT,1877,22,35-39,1899,12.237924898923065
SIM,1861,24,45-49,1885,1
STAT,1839,45,20-24,1884,0.0195862143820481
SIM,1912,25,na,1937,7647
SIM,1840,42,30-34,1882,4
STAT,1849,37,30-34,1886,8.626443565716587
SIM,1823,45,35-39,1868,1
STAT,1869,46,45-49,1915,0.46314897340994404
SIM,1917,39,20-24,1956,1
STAT,1876,39,15-19,1915,0.11611844059332156
STAT,1882,38,30-34,1920,10.433386063758547
SIM,1851,32,35-39,1883,32
SIM,1916,15,na,1931,8451
STAT,1836,60,na,1896,2535.7539946384477
STAT,1842,54,50-100,1896,0.021866863046171657
STAT,1835,23,50-100,1858,0.6973294428218596
SIM,1938,30,na,1968,7725
STAT,1866,53,40-44,1919,0.019303072333993563
SIM,1882,41,na,1923,4818
SIM,1870,27,20-24,1897,25
STAT,1896,49,40-44,1945,0.2521234015546839
STAT,1849,19,30-34,1868,3.066922069449207
STAT,1947,16,35-39,1963,9.548386986413853
SIM,1922,37,35-39,1959,2
STAT,1870,16,na,1886,5085.498966574953
STAT,1828,27,15-19,1855,1.545191996687191
STAT,1927,19,15-19,1946,113.33602402401893
STAT,1860,29,50-100,1889,1.0452172676428855
STAT,1897,33,45-49,1930,4.687829025104979
STAT,1849,109,na,1958,0.001972190243120414
STAT,1879,28,50-100,1907,1.346578829512847
STAT,1862,80,na,1942,1067.8216837592154
STAT,1939,27,50-100,1966,2.021114732180678
STAT,1919,30,40-44,1949,8.59362759156159
SIM,1903,26,15-19,1929,1
STAT,1821,98,na,1919,3.600832888300706
SIM,1909,23,50-100,1932,3
SIM,1869,21,40-44,1890,3
STAT,1882,36,35-39,1918,13.982217008773212
STAT,1920,18,20-24,1938,306.3238265492247
STAT,1832,42,30-34,1874,1.833623229582091
STAT,1868,32,40-44,1900,8.333115202869418
STAT,1925,23,na,1948,8799.029023964054
STAT,1854,85,na,1939,420.2445944138899
STAT,1871,4,na,1875,5915.088768720341
SIM,1878,36,na,1914,5171
STAT,1845,49,na,1894,3394.4745333686287
STAT,1854,50,40-44,1904,0.01637067342688057
SIM,1848,38,na,1886,3660
SIM,1832,82,na,1914,620
STAT,1958,10,na,1968,10420.66681963917
SIM,1911,20,35-39,1931,26
STAT,1825,32,15-19,1857,0.5054083369076454
SIM,1920,20,na,1940,8349
STAT,1895,18,15-19,1913,15.576627147171438
SIM,1838,42,45-49,1880,6
STAT,1864,38,40-44,1902,7.8635497507542365
STAT,1915,33,na,1948,7747.121112037055
STAT,1757,110,na,1867,0.006429063450528011
STAT,1879,35,20-24,1914,1.6438657505505858
SIM,1882,41,25-29,1923,3
STAT,1906,9,na,1915,7635.860431726017
SIM,1882,25,20-24,1907,25
STAT,1881,38,40-44,1919,8.502856878093047
STAT,1867,32,20-24,1899,5.112631800771941
STAT,1843,16,30-34,1859,2.870168544168682
SIM,1911,18,20-24,1929,55
STAT,1837,85,na,1922,382.0763754277206
SIM,1898,56,na,1954,5716
STAT,1914,37,35-39,1951,4.878163433333148
STAT,1848,38,25-29,1886,4.814868311123248
STAT,1820,45,45-49,1865,0.9040462367292267
SIM,1879,43,45-49,1922,6
STAT,1881,31,50-100,1912,1.7958950811003274
SIM,1929,23,30-34,1952,94
STAT,1870,49,20-24,1919,0.02329712884775162
STAT,1933,31,30-34,1964,42.91015051560739
STAT,1929,34,15-19,1963,0.3292034754121157
STAT,1878,21,40-44,1899,4.408649435833062
SIM,1946,23,30-34,1969,75
STAT,1869,28,15-19,1897,0.884743140508971
STAT,1809,48,15-19,1857,0.0030448644079544515
SIM,1925,33,40-44,1958,15
SIM,1856,38,25-29,1894,7
STAT,1859,27,45-49,1886,1.8156076761492086
STAT,1925,16,50-100,1941,0.9161023304879633
STAT,1823,35,15-19,1858,0.23335457453504954
STAT,1843,32,35-39,1875,17.05450458519557
SIM,1897,15,na,1912,7011
SIM,1813,44,na,1857,3003
STAT,1820,57,na,1877,2420.162718558507
STAT,1897,15,15-19,1912,16.095598732977553
STAT,1861,46,15-19,1907,6.743118682236772E-4
SIM,1867,27,45-49,1894,3
STAT,1919,23,na,1942,8049.3604393274745
STAT,1876,25,25-29,1901,88.9612096987964
STAT,1935,28,50-100,1963,2.739398833493647
STAT,1860,16,30-34,1876,3.0327325001269916
STAT,1910,47,45-49,1957,0.40968361871657033
STAT,1917,33,40-44,1950,8.240518720835654
SIM,1868,40,35-39,1908,4
SIM,1884,25,25-29,1909,104
STAT,1854,35,15-19,1889,0.08740141357836193
SIM,1872,38,40-44,1910,14
SIM,1844,36,50-100,1880,2
SIM,1835,31,40-44,1866,14
SIM,1890,76,na,1966,3081
SIM,1893,25,50-100,1918,2
STAT,1866,38,45-49,1904,3.696396533476529
SIM,1888,15,15-19,1903,12
SIM,1909,45,na,1954,6966
STAT,1841,21,45-49,1862,1.2909736161301493
STAT,1872,11,na,1883,5366.5741311745605
STAT,1918,31,35-39,1949,19.688836665858933
SIM,1855,42,50-100,1897,2
SIM,1877,43,40-44,1920,12
SIM,1844,36,na,1880,3523
SIM,1866,23,na,1889,4573
STAT,1905,18,25-29,1923,16.507906537120753
SIM,1946,24,15-19,1970,8
STAT,1890,26,15-19,1916,1.1222857254686458
STAT,1905,37,50-100,1942,0.7739995424597116
SIM,1884,36,na,1920,5107
STAT,1860,32,35-39,1892,16.609227122078167
STAT,1892,28,45-49,1920,2.797293574761313
STAT,1906,56,na,1962,6279.302173936004
SIM,1838,24,15-19,1862,6
STAT,1814,48,25-29,1862,0.29379529387395764
STAT,1851,54,35-39,1905,0.012978618366871716
SIM,1880,30,35-39,1910,28
SIM,1906,39,45-49,1945,3
STAT,1818,41,40-44,1859,11.50821560586446
STAT,1903,18,20-24,1921,50.845931903861235
STAT,1856,48,30-34,1904,0.14894198696256208
STAT,1857,111,na,1968,0.001504799855626799
SIM,1880,74,na,1954,2404
SIM,1904,39,40-44,1943,5
SIM,1937,16,15-19,1953,80
STAT,1824,50,25-29,1874,0.008596951657812308
SIM,1864,48,30-34,1912,1
STAT,1861,67,na,1928,2664.764482482849
SIM,1841,59,na,1900,2730
SIM,1888,1,na,1889,6643
STAT,1874,43,20-24,1917,0.32603944712605326
SIM,1857,37,30-34,1894,15
STAT,1885,32,40-44,1917,8.718084614899748
STAT,1881,39,25-29,1920,5.563859802716239
STAT,1891,41,25-29,1932,1.6103228300728682
STAT,1823,93,na,1916,35.07051459942996
STAT,1807,52,20-24,1859,0.004806459783322639
SIM,1801,59,na,1860,2104
SIM,1896,61,na,1957,5202
STAT,1850,42,20-24,1892,0.2432034277600209
SIM,1807,47,45-49,1854,1
SIM,1885,41,50-100,1926,9
SIM,1913,18,25-29,1931,17
STAT,1885,15,25-29,1900,11.444730529890277
STAT,1839,48,25-29,1887,0.09046894837953917
STAT,1921,33,na,1954,8462.329480060063
SIM,1864,46,35-39,1910,1
STAT,1820,45,15-19,1865,0.0015322804674725997
SIM,1866,40,30-34,1906,2
STAT,1869,43,40-44,1912,4.369899941644216
STAT,1827,31,40-44,1858,11.271938760954878
SIM,1862,35,45-49,1897,7
SIM,1874,38,45-49,1912,4
STAT,1825,37,45-49,1862,5.243459926002738
STAT,1899,28,30-34,1927,69.43652843567587
STAT,1891,43,20-24,1934,0.39359408505063587
STAT,1859,29,40-44,1888,4.828364765124397
SIM,1843,24,25-29,1867,127
SIM,1900,20,50-100,1920,2
STAT,1864,28,50-100,1892,1.1507776945988972
SIM,1883,40,30-34,1923,2
SIM,1830,87,na,1917,170
STAT,1844,31,40-44,1875,8.462341501106708
STAT,1930,24,50-100,1954,1.6917350266503
STAT,1850,95,na,1945,20.38564696084145
SIM,1829,90,na,1919,67
SIM,1823,31,45-49,1854,5
STAT,1776,114,na,1890,6.000012321015602E-4
STAT,1843,14,na,1857,4234.794395071782
SIM,1845,30,50-100,1875,3
STAT,1805,109,na,1914,5.321785717336238E-4
STAT,1879,47,15-19,1926,8.410507467640605E-4
SIM,1855,79,na,1934,1041
STAT,1899,44,35-39,1943,0.34326156027218735
STAT,1841,15,50-100,1856,0.09276900963380641
STAT,1844,110,na,1954,4.4626225235124494E-4
SIM,1932,29,45-49,1961,6
SIM,1789,85,na,1874,131
STAT,1833,42,20-24,1875,0.25342279202621915
SIM,1831,37,40-44,1868,14
SIM,1926,31,35-39,1957,26
STAT,1794,63,na,1857,1775.8209290785437
STAT,1825,29,na,1854,3013.980089501667
STAT,1910,61,na,1971,6379.362024223413
STAT,1924,41,30-34,1965,0.3074788991167588
STAT,1899,69,na,1968,4711.726590954726
STAT,1938,23,30-34,1961,57.439028834335865
SIM,1846,34,20-24,1880,7
SIM,1873,54,35-39,1927,1
STAT,1868,77,na,1945,1660.9523213668224
SIM,1841,40,25-29,1881,2
STAT,1948,15,40-44,1963,3.2343042639310786
STAT,1855,49,25-29,1904,0.08504351116215128
STAT,1946,25,na,1971,8434.49859689795
STAT,1856,46,35-39,1902,0.21877244262020465
STAT,1875,87,na,1962,652.5739075905244
STAT,1924,47,45-49,1971,0.522424342834517
SIM,1933,27,na,1960,10493
STAT,1868,17,45-49,1885,0.12779154240263238
SIM,1851,16,30-34,1867,5
SIM,1902,28,20-24,1930,32
STAT,1824,52,20-24,1876,0.0017212049301285088
STAT,1854,35,45-49,1889,3.102749813039015
SIM,1833,37,45-49,1870,6
SIM,1887,5,na,1892,6453
STAT,1937,26,20-24,1963,35.960035016540104
STAT,1880,37,50-100,1917,2.612112372481215
STAT,1954,8,na,1962,9811.2469628364
STAT,1838,34,20-24,1872,4.452425272510913
STAT,1894,22,40-44,1916,5.406227010217817
STAT,1909,23,35-39,1932,17.629111492933966
SIM,1893,15,25-29,1908,18
STAT,1891,25,20-24,1916,29.48487205361339
SIM,1764,93,na,1857,5
STAT,1838,16,20-24,1854,31.881026256971015
SIM,1915,29,45-49,1944,5
STAT,1814,47,40-44,1861,0.8869239062332981
STAT,1880,22,40-44,1902,4.433455451200948
SIM,1846,16,20-24,1862,37
STAT,1824,34,20-24,1858,9.567401324120722
SIM,1832,34,20-24,1866,7
STAT,1943,23,40-44,1966,7.222206357948402
STAT,1872,49,25-29,1921,0.11447199698826986
SIM,1879,25,15-19,1904,3
SIM,1883,28,45-49,1911,3
STAT,1882,22,45-49,1904,1.371908144393803
SIM,1822,80,na,1902,571
STAT,1821,36,50-100,1857,5.121546492803771
STAT,1907,41,30-34,1948,0.2380524415190457
SIM,1890,22,45-49,1912,2
STAT,1922,47,40-44,1969,0.3657037197650519
SIM,1898,38,30-34,1936,4
STAT,1875,28,45-49,1903,2.3005838846885323
SIM,1867,29,40-44,1896,9
SIM,1917,23,35-39,1940,26
SIM,1918,10,na,1928,8989
STAT,1777,91,na,1868,31.482265931569238
STAT,1808,57,na,1865,2225.345868587231
STAT,1861,46,45-49,1907,0.39784433711080447
STAT,1872,82,na,1954,947.0412599208988
STAT,1907,29,45-49,1936,3.244684122326857
SIM,1877,30,35-39,1907,26
STAT,1831,48,50-100,1879,0.37105341805601283
SIM,1852,31,40-44,1883,10
STAT,1875,40,30-34,1915,2.41468610928381
STAT,1885,49,na,1934,4428.412735271911
SIM,1865,45,40-44,1910,1
SIM,1936,18,20-24,1954,223
STAT,1897,30,40-44,1927,11.801688883880942
STAT,1865,53,20-24,1918,0.0013322037784560114
SIM,1875,33,35-39,1908,32
SIM,1902,35,na,1937,7024
SIM,1928,26,20-24,1954,51
STAT,1833,24,20-24,1857,120.94482928208154
STAT,1895,4,na,1899,6922.998232810538
SIM,1806,90,na,1896,28
SIM,1871,40,40-44,1911,8
STAT,1930,37,20-24,1967,0.6944253191921363
SIM,1899,33,20-24,1932,9
STAT,1833,40,25-29,1873,1.0513359388283625
STAT,1899,26,35-39,1925,26.791550058367598
SIM,1875,45,50-100,1920,1
STAT,1902,37,15-19,1939,0.034559652298792466
STAT,1866,42,na,1908,4301.645866731865
SIM,1939,18,45-49,1957,1
STAT,1812,50,35-39,1862,0.05941021245949515
STAT,1937,29,25-29,1966,129.47853733902997
SIM,1846,62,na,1908,2852
SIM,1849,45,25-29,1894,1
SIM,1956,15,40-44,1971,4
STAT,1878,51,50-100,1929,0.032008659809695326
SIM,1938,31,25-29,1969,22
STAT,1873,44,15-19,1917,0.027956028220335324
SIM,1867,42,40-44,1909,14
STAT,1894,8,na,1902,6744.254475341459
SIM,1842,42,35-39,1884,6
STAT,1810,53,35-39,1863,0.05215118198252395
STAT,1867,33,35-39,1900,19.073749432348226
STAT,1862,52,na,1914,3697.014301812861
SIM,1926,29,20-24,1955,42
STAT,1867,49,15-19,1916,7.407726150638106E-4
STAT,1871,97,na,1968,53.32409808619633
STAT,1922,29,40-44,1951,10.572990306906263
STAT,1859,42,40-44,1901,3.6112350843332885
STAT,1910,29,15-19,1939,1.3674437658296703
STAT,1882,40,45-49,1922,2.9741958277057945
STAT,1848,85,na,1933,449.50021081891487
STAT,1909,26,45-49,1935,3.376193082785387
STAT,1926,23,40-44,1949,8.222979907044328
SIM,1930,29,40-44,1959,16
STAT,1923,28,na,1951,8653.013915653994
STAT,1895,33,40-44,1928,11.364474301297646
STAT,1804,98,na,1902,2.1853550269849835
STAT,1867,45,50-100,1912,0.46916508422604153
SIM,1841,24,20-24,1865,128
SIM,1861,21,40-44,1882,3
SIM,1884,23,50-100,1907,1
SIM,1831,23,20-24,1854,126
STAT,1943,26,45-49,1969,3.7175020317758642
STAT,1926,39,20-24,1965,0.6491561386195319
STAT,1928,18,20-24,1946,344.053801126008
SIM,1833,36,na,1869,3518
STAT,1873,46,35-39,1919,0.2881035210448115
SIM,1851,49,na,1900,3477
STAT,1880,46,na,1926,4800.290850477804
SIM,1890,33,30-34,1923,56
SIM,1941,19,45-49,1960,2
SIM,1914,20,na,1934,7786
STAT,1863,40,40-44,1903,4.016620546647081
SIM,1934,23,40-44,1957,10
STAT,1855,16,20-24,1871,31.985179134845502
SIM,1838,67,na,1905,2143
STAT,1882,51,30-34,1933,0.011767058897507385
SIM,1810,95,na,1905,23
SIM,1890,40,45-49,1930,8
STAT,1935,16,45-49,1951,1.38284837714186
SIM,1863,16,20-24,1879,36
SIM,1899,35,40-44,1934,20
SIM,1855,42,45-49,1897,5
STAT,1865,54,35-39,1919,0.01536161900441769
SIM,1943,16,45-49,1959,5
STAT,1919,15,45-49,1934,0.2246732000353942
STAT,1793,78,na,1871,606.8858240293853
STAT,1846,40,35-39,1886,2.880077977467263
STAT,1854,57,na,1911,3080.738758793805
STAT,1941,29,45-49,1970,3.6059640238732875
STAT,1899,43,20-24,1942,0.030296396050347146
STAT,1865,36,35-39,1901,13.039937094665625
STAT,1889,39,na,1928,5807.883689002015
SIM,1938,16,35-39,1954,12
STAT,1838,46,15-19,1884,5.641320200245812E-4
STAT,1841,19,na,1860,4245.051634241622
STAT,1928,36,20-24,1964,0.673342842164366
SIM,1873,36,35-39,1909,21
SIM,1918,19,15-19,1937,95
SIM,1847,32,45-49,1879,2
STAT,1827,34,50-100,1861,2.052125746755979
SIM,1873,64,na,1937,3512
SIM,1834,24,50-100,1858,3
SIM,1835,34,50-100,1869,2
SIM,1823,42,30-34,1865,5
STAT,1851,9,na,1860,4591.82876167755
STAT,1847,42,45-49,1889,2.2941150598178175
STAT,1853,21,40-44,1874,3.923722997217263
STAT,1931,23,na,1954,9536.317204247103
STAT,1824,53,35-39,1877,0.019685389880789383
STAT,1818,110,na,1928,2.835071066604927E-4
STAT,1832,45,35-39,1877,0.22139491442106982
STAT,1843,54,na,1897,2933.252068928665
STAT,1889,36,20-24,1925,1.9288323309615374
STAT,1882,33,30-34,1915,34.205232175315096
SIM,1944,27,15-19,1971,2
STAT,1933,19,45-49,1952,1.3434337308266262
SIM,1873,35,20-24,1908,2
SIM,1893,32,40-44,1925,20
STAT,1866,33,15-19,1899,0.2642539349092593
STAT,1868,35,45-49,1903,3.866916391976342
STAT,1854,53,45-49,1907,0.021890141116082746
SIM,1896,21,na,1917,6596
STAT,1857,43,20-24,1900,0.24819702194328025
STAT,1894,54,na,1948,5432.704253086668
STAT,1865,35,20-24,1900,1.4277945703838497
SIM,1865,43,20-24,1908,1
SIM,1866,25,35-39,1891,28
SIM,1892,31,na,1923,6863
SIM,1937,17,na,1954,7389
SIM,1826,41,40-44,1867,11
SIM,1888,33,45-49,1921,5
STAT,1871,50,40-44,1921,0.02142744595711475
STAT,1828,45,15-19,1873,7.396905442998057E-4
STAT,1850,17,50-100,1867,0.09179271285402273
STAT,1935,31,35-39,1966,25.553358702958576
STAT,1950,16,40-44,1966,3.3408555708349184
SIM,1906,20,25-29,1926,187
SIM,1839,23,20-24,1862,123
STAT,1807,50,25-29,1857,0.02402422037047105
SIM,1856,92,na,1948,43
SIM,1905,15,na,1920,7666
STAT,1852,24,25-29,1876,106.83638405114698
SIM,1834,77,na,1911,985
SIM,1868,18,na,1886,4966
SIM,1860,24,25-29,1884,120
SIM,1927,30,na,1957,9646
STAT,1942,24,35-39,1966,19.925542703220867
SIM,1929,26,50-100,1955,3
SIM,1815,79,na,1894,757
STAT,1914,51,na,1965,7266.012235801013
STAT,1806,53,15-19,1859,1.4068146399299073E-4
STAT,1895,36,15-19,1931,0.14848932410774848
SIM,1876,35,45-49,1911,10
SIM,1830,49,50-100,1879,2
SIM,1832,53,35-39,1885,1
STAT,1844,18,40-44,1862,0.37325785951467816
STAT,1900,49,50-100,1949,0.38002990911636686
STAT,1952,7,na,1959,9512.298551040498
SIM,1834,32,35-39,1866,26
SIM,1897,36,20-24,1933,3
STAT,1857,45,40-44,1902,0.2721893391766461
SIM,1887,35,20-24,1922,1
STAT,1828,42,40-44,1870,4.2351718185089
STAT,1830,75,na,1905,1421.5668138635278
STAT,1874,41,25-29,1915,1.3339345918876655
SIM,1885,4,na,1889,5503
SIM,1944,22,50-100,1966,1
SIM,1908,15,40-44,1923,1
STAT,1845,80,na,1925,953.217095500163
SIM,1858,32,20-24,1890,4
STAT,1871,47,15-19,1918,7.988635444090656E-4
SIM,1906,36,40-44,1942,5
STAT,1790,73,na,1863,904.8905887056517
STAT,1835,59,na,1894,2517.0617626972216
STAT,1891,44,35-39,1935,4.45946506389288
STAT,1893,23,35-39,1916,14.891958557084767
SIM,1809,70,na,1879,1348
STAT,1897,46,20-24,1943,0.01832575805638045
STAT,1893,39,15-19,1932,0.14230206205283444
STAT,1830,38,50-100,1868,2.26881429278873
SIM,1861,4,na,1865,5618
SIM,1910,30,na,1940,7715
STAT,1894,48,50-100,1942,0.3549085746393397
SIM,1840,18,na,1858,4701
STAT,1856,50,45-49,1906,0.022938737984113236
SIM,1836,42,40-44,1878,10
STAT,1834,42,35-39,1876,2.905891646417018
STAT,1847,24,15-19,1871,6.07665825412396
STAT,1935,13,na,1948,10924.679862164267
STAT,1826,48,15-19,1874,7.868647741863234E-4
STAT,1936,27,15-19,1963,1.3647483329504329
SIM,1858,34,40-44,1892,9
STAT,1936,22,50-100,1958,1.270748338549462
SIM,1862,100,na,1962,1
STAT,1826,32,35-39,1858,30.446184151327206
STAT,1841,50,30-34,1891,0.008760845362705548
STAT,1887,72,na,1959,3107.630220684704
SIM,1925,9,na,1934,9732
SIM,1927,30,40-44,1957,14
STAT,1886,40,50-100,1926,2.27502121693552
STAT,1931,4,na,1935,10669.98805338975
SIM,1906,7,na,1913,7659
STAT,1849,53,35-39,1902,0.013399146466371071
STAT,1850,43,35-39,1893,2.756409449178711
SIM,1814,57,na,1871,2310
STAT,1855,79,na,1934,1054.2048426808158
STAT,1910,44,40-44,1954,0.4717234853074735
SIM,1873,22,45-49,1895,1
STAT,1905,15,20-24,1920,52.021734480651865
STAT,1830,46,15-19,1876,6.994614534393468E-4
STAT,1897,49,30-34,1946,0.14433146117005582
SIM,1908,33,40-44,1941,10
STAT,1860,26,na,1886,3984.6438377250465
SIM,1845,20,40-44,1865,7
STAT,1774,106,na,1880,0.018780166830133428
STAT,1841,19,30-34,1860,2.9476053865023912
SIM,1862,9,na,1871,5177
STAT,1891,26,35-39,1917,24.170073854705297
SIM,1822,41,50-100,1863,2
STAT,1833,95,na,1928,17.4786843720117
STAT,1842,52,40-44,1894,0.01559027695454245
STAT,1816,44,40-44,1860,11.469751032731912
SIM,1885,38,20-24,1923,2
SIM,1889,35,50-100,1924,5
STAT,1877,82,na,1959,1251.3663139153796
STAT,1878,67,na,1945,3343.701052433105
STAT,1901,41,35-39,1942,0.35714080423291306
STAT,1854,32,40-44,1886,6.80808774989534
SIM,1895,26,15-19,1921,2
SIM,1839,21,na,1860,3719
SIM,1880,46,na,1926,4988
STAT,1920,48,15-19,1968,8.199145294191753E-4
SIM,1832,35,35-39,1867,20
SIM,1862,0,na,1862,6785
STAT,1849,21,15-19,1870,6.3548183886823875
STAT,1824,35,35-39,1859,23.308978955256787
STAT,1900,21,25-29,1921,160.86491249846551
STAT,1855,70,na,1925,2115.743829733976
STAT,1887,26,15-19,1913,1.0283368851451957
STAT,1853,51,35-39,1904,0.013686438569178784
SIM,1857,74,na,1931,1870
STAT,1906,46,40-44,1952,0.28501013930466795
SIM,1913,15,20-24,1928,63
STAT,1887,41,35-39,1928,4.108760325542623
STAT,1865,22,45-49,1887,1.2950062974007657
STAT,1845,35,50-100,1880,2.2302042413951138
STAT,1883,35,40-44,1918,8.768655810128012
STAT,1916,43,50-100,1959,0.242757238894461
STAT,1880,25,15-19,1905,0.9718340926382261
SIM,1869,24,45-49,1893,1
STAT,1855,46,20-24,1901,0.018146588903886676
SIM,1843,82,na,1925,583
SIM,1857,21,15-19,1878,7
STAT,1851,80,na,1931,958.9372197232897
STAT,1916,34,35-39,1950,18.891252799770616
SIM,1883,25,40-44,1908,10
STAT,1851,22,15-19,1873,6.1072206020024895
SIM,1840,77,na,1917,1438
STAT,1880,25,45-49,1905,2.3782772467740094
SIM,1919,39,25-29,1958,3
STAT,1860,19,35-39,1879,1.0257154206385422
STAT,1848,35,20-24,1883,1.329875663387411
STAT,1938,26,35-39,1964,30.05828654147346
STAT,1796,98,na,1894,1.4472783358144383
SIM,1824,44,40-44,1868,10
SIM,1900,30,30-34,1930,61
SIM,1895,41,35-39,1936,1
STAT,1852,38,15-19,1890,0.08905579658172863
STAT,1820,42,40-44,1862,9.099565140640495
STAT,1929,13,na,1942,10195.731829868522
STAT,1815,42,30-34,1857,6.939771176311307
SIM,1849,45,50-100,1894,1
SIM,1952,19,20-24,1971,336
STAT,1917,36,45-49,1953,1.4368118259843043
STAT,1849,70,na,1919,2219.3803235964633
STAT,1864,16,na,1880,4738.745647776555
STAT,1799,63,na,1862,1788.970286184724
STAT,1817,41,20-24,1858,0.8954111030707985
SIM,1831,40,50-100,1871,3
SIM,1779,95,na,1874,2
STAT,1851,40,15-19,1891,0.021623769873136425
SIM,1884,22,20-24,1906,153
SIM,1909,17,20-24,1926,63
SIM,1926,45,na,1971,9430
SIM,1898,34,50-100,1932,2
SIM,1925,36,45-49,1961,2
STAT,1833,45,25-29,1878,0.09115639459777915
STAT,1877,38,20-24,1915,1.6085737712274915
STAT,1884,15,35-39,1899,1.0993586001253774
SIM,1924,34,35-39,1958,30
STAT,1839,32,45-49,1871,3.3507852937866907
STAT,1944,19,20-24,1963,294.44663942027415
STAT,1859,25,25-29,1884,70.17693070738068
STAT,1918,47,15-19,1965,7.915615693724453E-4
STAT,1921,16,15-19,1937,104.70801608260739
STAT,1930,8,na,1938,10413.837003922794
STAT,1841,37,30-34,1878,9.110810042901381
SIM,1863,74,na,1937,2022
STAT,1883,82,na,1965,1484.9347036934846
SIM,1934,12,na,1946,10740
STAT,1842,60,na,1902,2839.436564460775
STAT,1885,19,40-44,1904,0.3657174770899294
SIM,1908,51,na,1959,6563
SIM,1843,21,20-24,1864,120
STAT,1834,107,na,1941,0.006267209541702834
STAT,1842,34,40-44,1876,7.6393823064213064
STAT,1814,45,20-24,1859,0.06413603779505321
STAT,1836,19,20-24,1855,45.16325574588975
STAT,1847,44,na,1891,3475.563961384072
SIM,1915,15,50-100,1930,1
SIM,1917,26,45-49,1943,8
STAT,1940,27,35-39,1967,30.922050128503198
SIM,1826,28,40-44,1854,9
STAT,1895,39,na,1934,6137.66063023463
STAT,1858,16,na,1874,4246.628959570539
STAT,1881,36,20-24,1917,1.512002169883
SIM,1827,36,na,1863,3391
STAT,1787,78,na,1865,581.850207651687
STAT,1913,25,20-24,1938,36.9920614116575
SIM,1891,35,40-44,1926,18
STAT,1823,40,50-100,1863,3.698669314255558
SIM,1868,22,35-39,1890,14
STAT,1904,47,20-24,1951,0.019530091231057194
STAT,1918,29,20-24,1947,38.94643425450536
SIM,1854,40,35-39,1894,7
STAT,1875,43,35-39,1918,3.738118665581972
SIM,1883,43,35-39,1926,7
STAT,1867,0,na,1867,7150.014872315931
STAT,1924,44,40-44,1968,0.5987041392571452
SIM,1844,19,20-24,1863,31
STAT,1874,46,25-29,1920,0.1194500728858003
SIM,1850,34,40-44,1884,12
SIM,1935,23,50-100,1958,2
STAT,1861,43,40-44,1904,3.753738095809538
STAT,1837,20,40-44,1857,3.9853071277375687
SIM,1819,69,na,1888,1571
SIM,1862,32,40-44,1894,16
STAT,1875,25,40-44,1900,6.27108894609987
STAT,1830,107,na,1937,0.0065121809883911365
STAT,1818,47,na,1865,2876.185473012626
SIM,1867,25,25-29,1892,87
STAT,1827,34,45-49,1861,3.905658703419287
SIM,1803,54,na,1857,2408
SIM,1797,80,na,1877,405
STAT,1835,21,20-24,1856,119.55229784228862
STAT,1945,20,40-44,1965,7.447046147088945
STAT,1913,38,na,1951,7463.049832265856
SIM,1895,76,na,1971,3713
STAT,1879,50,40-44,1929,0.022559008418401173
STAT,1894,25,45-49,1919,2.900109594157133
SIM,1864,43,30-34,1907,4
SIM,1919,20,35-39,1939,25
STAT,1808,52,35-39,1860,0.05109238556969478
SIM,1821,34,45-49,1855,5
STAT,1863,29,30-34,1892,44.20091109219612
STAT,1917,18,45-49,1935,0.21651619716818601
STAT,1849,50,30-34,1899,0.009551040411087614
STAT,1835,19,na,1854,3924.740464186763
STAT,1843,31,20-24,1874,4.599605088487645
SIM,1879,40,40-44,1919,11
STAT,1872,33,45-49,1905,3.5245698272888646
STAT,1884,36,na,1920,4721.069622332611
STAT,1880,43,45-49,1923,3.161209224064325
SIM,1932,26,40-44,1958,14
SIM,1882,28,25-29,1910,91
STAT,1821,106,na,1927,0.01345840908173387
SIM,1892,71,na,1963,4269
STAT,1874,28,25-29,1902,87.16782016552276
STAT,1902,66,na,1968,5287.221674925784
STAT,1932,36,40-44,1968,4.066179641953855
SIM,1813,42,45-49,1855,8
SIM,1948,20,30-34,1968,82
STAT,1869,46,15-19,1915,7.84997599297125E-4
SIM,1803,85,na,1888,215
SIM,1880,33,45-49,1913,5
STAT,1813,52,45-49,1865,0.0853367850510936
SIM,1845,21,na,1866,4298
SIM,1851,31,20-24,1882,6
SIM,1879,89,na,1968,456
SIM,1940,12,na,1952,8300
STAT,1924,26,40-44,1950,10.99512331446721
SIM,1844,37,20-24,1881,2
SIM,1835,34,45-49,1869,6
STAT,1850,25,35-39,1875,17.662790964022555
SIM,1913,29,40-44,1942,12
SIM,1904,28,25-29,1932,144
STAT,1816,40,25-29,1856,3.823350204075364
SIM,1769,96,na,1865,2
STAT,1873,32,45-49,1905,3.5784210050368537
SIM,1845,39,30-34,1884,9
SIM,1849,27,30-34,1876,62
SIM,1807,75,na,1882,804
STAT,1923,15,35-39,1938,9.994251816162805
STAT,1857,16,25-29,1873,10.546837580141709
SIM,1863,30,35-39,1893,25
STAT,1827,55,na,1882,2664.1894784268197
SIM,1953,17,15-19,1970,103
STAT,1888,37,15-19,1925,0.13404459616578243
STAT,1860,44,35-39,1904,2.9297967302948527
SIM,1886,33,40-44,1919,12
SIM,1790,70,na,1860,1312
SIM,1819,42,40-44,1861,8
STAT,1773,107,na,1880,0.014918246617397376
SIM,1925,35,na,1960,9132
STAT,1831,60,na,1891,2462.4514141495392
STAT,1856,44,15-19,1900,0.02122851035468896
STAT,1884,49,15-19,1933,7.810519927033012E-4
STAT,1840,35,20-24,1875,1.3436377507289516
SIM,1842,24,40-44,1866,7
STAT,1885,49,50-100,1934,0.4834200617032512
STAT,1945,15,na,1960,8124.1003048864595
SIM,1926,45,50-100,1971,2
STAT,1900,28,45-49,1928,3.099702953426025
STAT,1878,33,40-44,1911,9.108836872161547
SIM,1880,16,20-24,1896,39
SIM,1921,25,20-24,1946,42
SIM,1794,60,na,1854,1875
STAT,1831,100,na,1931,1.3707409764926575
STAT,1911,46,20-24,1957,0.021188195718758747
STAT,1868,19,50-100,1887,0.09471794354257314
STAT,1858,42,20-24,1900,0.2497303095146997
SIM,1849,21,50-100,1870,1
STAT,1956,9,na,1965,10500.074794916438
SIM,1864,84,na,1948,465
STAT,1823,38,25-29,1861,10.733244007928944
SIM,1836,41,na,1877,3204
STAT,1922,43,na,1965,8593.383038482008
STAT,1947,15,20-24,1962,308.5809867970443
SIM,1873,36,na,1909,4992
SIM,1831,38,25-29,1869,9
SIM,1882,45,40-44,1927,1
STAT,1836,33,50-100,1869,1.5242940496366368
SIM,1855,42,15-19,1897,2
SIM,1873,38,25-29,1911,6
STAT,1919,27,15-19,1946,1.5401946195464866
STAT,1910,1,na,1911,8332.803466487463
SIM,1815,70,na,1885,1373
SIM,1931,15,35-39,1946,14
SIM,1881,32,45-49,1913,3
STAT,1837,50,40-44,1887,0.015324958480053708
STAT,1805,100,na,1905,0.7941204397070969
SIM,1923,32,25-29,1955,26
STAT,1825,52,35-39,1877,0.017996453076116716
STAT,1870,22,50-100,1892,0.8085779353510161
SIM,1824,40,25-29,1864,2
STAT,1945,17,15-19,1962,100.11608609508579
STAT,1883,31,25-29,1914,20.407184286937213
SIM,1865,16,25-29,1881,16
SIM,1892,32,20-24,1924,8
SIM,1858,39,40-44,1897,10
SIM,1866,42,20-24,1908,1
SIM,1840,27,40-44,1867,8
SIM,1899,41,na,1940,6509
SIM,1909,29,20-24,1938,35
STAT,1812,48,20-24,1860,0.08194527249641949
STAT,1874,45,40-44,1919,0.3575565128216565
STAT,1881,24,20-24,1905,133.68065298087444
STAT,1943,17,50-100,1960,0.8023595220316249
SIM,1955,15,20-24,1970,325
STAT,1876,32,na,1908,4984.669064542261
STAT,1933,5,na,1938,10871.51235604284
STAT,1950,3,na,1953,9470.95923663454
STAT,1909,23,40-44,1932,6.295231566645959
STAT,1893,0,na,1893,7516.663352777954
STAT,1884,18,45-49,1902,0.12992943336102183
STAT,1931,23,15-19,1954,13.900981718858162
SIM,1824,56,na,1880,2751
SIM,1826,44,45-49,1870,5
SIM,1814,41,45-49,1855,6
SIM,1877,28,20-24,1905,24
SIM,1888,19,30-34,1907,4
STAT,1931,37,40-44,1968,4.004172933890212
SIM,1903,1,na,1904,7937
STAT,1884,32,20-24,1916,5.390630234903074
STAT,1915,32,25-29,1947,19.012748580302823
STAT,1924,44,35-39,1968,0.4819958878814335
STAT,1834,24,40-44,1858,3.6566759089564833
STAT,1856,43,30-34,1899,1.7785135675117336
SIM,1891,31,25-29,1922,34
SIM,1885,21,na,1906,4964
SIM,1875,17,30-34,1892,5
SIM,1881,68,na,1949,2517
STAT,1802,60,na,1862,2144.7823135376625
STAT,1847,42,15-19,1889,0.021168306536404335
SIM,1847,18,30-34,1865,2
SIM,1873,33,na,1906,5004
STAT,1923,27,35-39,1950,34.80144314614502
SIM,1878,39,20-24,1917,2
STAT,1844,39,na,1883,3937.887547789207
STAT,1886,31,na,1917,5108.268764718746
SIM,1926,2,na,1928,10303
STAT,1878,51,40-44,1929,0.022312225421098786
STAT,1892,43,35-39,1935,4.545200631249085
SIM,1949,16,40-44,1965,8
STAT,1896,47,20-24,1943,0.01796490656144514
STAT,1911,28,20-24,1939,35.83615516443594
SIM,1944,25,50-100,1969,4
SIM,1898,36,40-44,1934,20
STAT,1870,25,50-100,1895,1.2770047387892765
SIM,1931,27,35-39,1958,51
STAT,1807,54,40-44,1861,0.06585146211344027
SIM,1884,23,35-39,1907,14
STAT,1867,9,na,1876,5176.791011747968
SIM,1917,23,40-44,1940,10
SIM,1858,37,45-49,1895,4
SIM,1899,38,45-49,1937,3
STAT,1860,50,35-39,1910,0.014322474352266874
SIM,1833,92,na,1925,58
STAT,1872,16,20-24,1888,36.316588970534085
STAT,1891,41,30-34,1932,2.8829973130121087
STAT,1824,50,30-34,1874,0.014447655008623436
STAT,1931,37,50-100,1968,1.123036250229745
STAT,1783,88,na,1871,79.04274334953861
STAT,1827,52,na,1879,2827.1749861766634
SIM,1826,35,50-100,1861,3
STAT,1832,27,40-44,1859,5.2579862330466165
STAT,1851,42,35-39,1893,2.8036360642492526
STAT,1889,23,45-49,1912,1.7311273259625026
SIM,1819,60,na,1879,2143
SIM,1820,34,50-100,1854,2
STAT,1878,18,15-19,1896,12.48495547971513
STAT,1914,22,30-34,1936,59.31330622507132
SIM,1950,21,30-34,1971,76
STAT,1839,18,30-34,1857,3.2364225501112136
SIM,1949,22,40-44,1971,13
STAT,1840,17,20-24,1857,33.132182451478855
STAT,1837,39,30-34,1876,8.860124949551752
SIM,1927,19,50-100,1946,1
SIM,1900,33,35-39,1933,38
STAT,1798,103,na,1901,0.07769191723677382
STAT,1882,34,15-19,1916,0.27777366012051896
STAT,1855,30,35-39,1885,15.875267614767909
STAT,1897,49,25-29,1946,0.08588318267841918
STAT,1922,18,25-29,1940,100.99601365977408
STAT,1850,43,50-100,1893,1.6081244780665866
STAT,1847,36,15-19,1883,0.08973951841268113
STAT,1905,15,15-19,1920,17.414055208835666
SIM,1929,25,20-24,1954,50
STAT,1884,50,20-24,1934,0.0014927585081533981
STAT,1848,51,25-29,1899,0.0058356526101290725
SIM,1951,9,na,1960,9799
STAT,1876,44,50-100,1920,2.176992422797201
SIM,1805,89,na,1894,54
SIM,1897,23,45-49,1920,2
SIM,1896,39,40-44,1935,6
STAT,1903,36,15-19,1939,0.03502091450486192
SIM,1930,18,25-29,1948,143
STAT,1890,29,25-29,1919,103.53429284926125
STAT,1815,43,15-19,1858,0.08040015090085093
STAT,1843,17,45-49,1860,0.11693699472729004
SIM,1855,24,15-19,1879,4
STAT,1820,104,na,1924,0.07467118874354614
SIM,1918,50,na,1968,8062
STAT,1763,104,na,1867,0.02979804930646678
SIM,1967,0,na,1967,10529
STAT,1918,13,na,1931,8695.01233132219
SIM,1869,27,50-100,1896,1
SIM,1878,27,20-24,1905,30
STAT,1840,23,20-24,1863,125.58935760235221
SIM,1913,15,15-19,1928,20
STAT,1839,40,na,1879,3900.8413013910335
STAT,1838,52,45-49,1890,0.019536623843046563
STAT,1894,24,50-100,1918,1.0513470607422406
SIM,1886,21,40-44,1907,6
STAT,1942,21,30-34,1963,60.8824148348236
STAT,1859,45,45-49,1904,0.38314957830521446
STAT,1861,16,45-49,1877,0.12695901688898723
SIM,1872,28,50-100,1900,1
STAT,1887,27,20-24,1914,26.49891623219381
STAT,1936,33,45-49,1969,3.0855600885457926
STAT,1941,22,25-29,1963,192.79389071578285
SIM,1831,97,na,1928,2
SIM,1872,39,25-29,1911,10
STAT,1899,38,na,1937,6538.166747087356
STAT,1842,49,45-49,1891,0.34402406597637064
SIM,1840,31,15-19,1871,1
SIM,1860,24,50-100,1884,1
SIM,1854,69,na,1923,2324
SIM,1900,1,na,1901,7819
STAT,1815,67,na,1882,1718.9333815318555
STAT,1916,31,30-34,1947,32.98524990634725
SIM,1932,17,na,1949,9936
STAT,1873,48,30-34,1921,0.19614312644403198
SIM,1935,21,35-39,1956,40
STAT,1838,39,na,1877,3425.7745651879727
STAT,1910,4,na,1914,8053.666151388278
SIM,1875,68,na,1943,3307
STAT,1906,45,35-39,1951,0.2347262067078549
SIM,1837,44,20-24,1881,1
SIM,1898,18,40-44,1916,5
STAT,1872,30,40-44,1902,8.87316417224617
SIM,1890,16,15-19,1906,16
SIM,1897,71,na,1968,4219
STAT,1859,69,na,1928,2359.060121249863
STAT,1871,17,20-24,1888,35.802305240023806
SIM,1881,48,30-34,1929,3
SIM,1879,21,na,1900,4907
SIM,1918,22,40-44,1940,9
STAT,1915,20,25-29,1935,186.1645751333747
STAT,1945,21,50-100,1966,1.4568230434602363
STAT,1846,44,20-24,1890,0.2399718800153197
SIM,1828,36,20-24,1864,2
STAT,1841,32,30-34,1873,30.736279081100896
STAT,1833,47,45-49,1880,0.36403836659655536
SIM,1923,39,45-49,1962,3
STAT,1853,49,20-24,1902,0.01858999627265643
STAT,1888,43,45-49,1931,3.546770074966383
SIM,1889,29,25-29,1918,116
SIM,1890,36,na,1926,6205
STAT,1828,77,na,1905,1061.5216659822925
STAT,1898,42,25-29,1940,0.12172571724388993
SIM,1905,37,35-39,1942,8
SIM,1839,26,25-29,1865,88
STAT,1869,87,na,1956,382.3853956843447
SIM,1895,27,20-24,1922,36
STAT,1836,36,50-100,1872,2.0250397487370093
STAT,1789,73,na,1862,1015.4583951034655
STAT,1927,21,35-39,1948,23.496584992487506
SIM,1858,20,20-24,1878,115
SIM,1866,54,na,1920,4068
STAT,1931,19,40-44,1950,3.677783609204573
STAT,1832,31,45-49,1863,2.995747539052977
STAT,1861,18,40-44,1879,0.3513100490356628
SIM,1929,41,25-29,1970,1
STAT,1832,31,15-19,1863,0.24464503342799124
SIM,1861,49,20-24,1910,1
SIM,1822,52,na,1874,2637
STAT,1832,43,15-19,1875,0.02174305991427614
STAT,1925,42,50-100,1967,0.28719548643273
SIM,1860,22,35-39,1882,9
SIM,1887,53,na,1940,5129
STAT,1856,15,50-100,1871,0.09134097859004284
STAT,1877,41,50-100,1918,2.225571566724096
STAT,1896,29,20-24,1925,31.05750213055827
STAT,1873,50,45-49,1923,0.03020824333446939
SIM,1850,49,45-49,1899,2
STAT,1909,61,na,1970,6283.978183426591
STAT,1850,40,30-34,1890,1.7805383413087148
SIM,1871,25,45-49,1896,2
STAT,1829,44,20-24,1873,0.2534431735212003
STAT,1837,54,na,1891,2918.464108989713
STAT,1866,50,30-34,1916,0.011251858516566519
STAT,1879,53,45-49,1932,0.03016490921545415
SIM,1889,17,25-29,1906,18
SIM,1866,2,na,1868,6224
STAT,1843,85,na,1928,384.01236720792315
STAT,1811,49,15-19,1860,0.002623798994510065
SIM,1913,47,40-44,1960,1
STAT,1784,100,na,1884,0.3626079744372521
SIM,1923,20,25-29,1943,255
STAT,1829,38,20-24,1867,1.3228776280796672
STAT,1868,46,na,1914,4335.402587777972
SIM,1905,25,35-39,1930,33
STAT,1796,58,na,1854,2050.0
STAT,1861,23,50-100,1884,0.6991834651284365
STAT,1863,25,45-49,1888,1.991399468094429
SIM,1857,35,40-44,1892,10
STAT,1896,35,20-24,1931,2.0749338034734888
SIM,1837,38,20-24,1875,2
SIM,1902,66,na,1968,5435
STAT,1910,47,15-19,1957,6.943784303268013E-4
SIM,1840,45,50-100,1885,1
STAT,1906,49,45-49,1955,0.38359551258551905
STAT,1951,15,na,1966,8856.13476386759
SIM,1853,44,na,1897,3739
SIM,1863,34,20-24,1897,7
SIM,1845,35,45-49,1880,5
SIM,1933,19,50-100,1952,2
STAT,1852,22,35-39,1874,11.048734464749828
SIM,1854,26,20-24,1880,23
SIM,1840,31,45-49,1871,6
SIM,1867,22,20-24,1889,127
STAT,1891,49,na,1940,5500.217227689658
STAT,1832,25,15-19,1857,0.816594790771809
STAT,1900,43,40-44,1943,0.4344367519120973
STAT,1916,19,45-49,1935,0.21290001908070036
STAT,1849,35,40-44,1884,7.2341015846614996
SIM,1944,15,45-49,1959,1
STAT,1821,67,na,1888,1752.6381255065953
SIM,1796,95,na,1891,5
SIM,1940,20,25-29,1960,205
SIM,1837,26,20-24,1863,23
STAT,1837,30,50-100,1867,1.6351108217281962
SIM,1901,25,na,1926,6791
STAT,1835,106,na,1941,0.015725210741845207
SIM,1848,28,25-29,1876,85
SIM,1880,30,40-44,1910,15
STAT,1885,25,50-100,1910,1.2946956162062284
STAT,1859,22,20-24,1881,114.93394742838123
STAT,1809,109,na,1918,6.323553679700753E-4
STAT,1892,40,30-34,1932,2.9360311456234838
SIM,1849,25,35-39,1874,28
SIM,1909,31,35-39,1940,25
STAT,1888,25,15-19,1913,1.0903650575743193
STAT,1896,17,20-24,1913,47.271857997266316
SIM,1841,47,45-49,1888,2
SIM,1835,37,50-100,1872,5
STAT,1905,47,40-44,1952,0.28074788511134263
STAT,1898,17,25-29,1915,15.48766599840019
SIM,1891,9,na,1900,6697
STAT,1801,54,50-100,1855,0.09087507750114401
SIM,1937,33,30-34,1970,48
STAT,1841,33,15-19,1874,0.24810634967655468
STAT,1897,44,30-34,1941,0.21261757192359904
STAT,1841,44,50-100,1885,1.552515281234694
SIM,1837,26,na,1863,3749
STAT,1842,30,25-29,1872,18.808145933831184
SIM,1848,69,na,1917,2135
SIM,1896,37,15-19,1933,2
STAT,1837,35,45-49,1872,3.454607907944609
SIM,1928,26,15-19,1954,5
STAT,1864,39,25-29,1903,5.145528025716114
STAT,1932,39,45-49,1971,1.8460886077743472
STAT,1855,34,20-24,1889,4.064943568382326
STAT,1905,29,40-44,1934,8.686851619903988
STAT,1808,88,na,1896,107.87757208758406
STAT,1846,26,20-24,1872,21.895464326987916
SIM,1924,31,30-34,1955,55
STAT,1852,22,na,1874,4048.271229946095
SIM,1948,23,35-39,1971,23
SIM,1842,41,na,1883,3481
STAT,1817,93,na,1910,29.477475513226928
STAT,1929,33,30-34,1962,40.38864689524565
STAT,1907,17,45-49,1924,0.19390086617684685
SIM,1838,36,na,1874,3532
STAT,1945,24,50-100,1969,1.455352147304967
STAT,1915,39,45-49,1954,1.3769744753124658
SIM,1863,28,20-24,1891,25
SIM,1885,40,35-39,1925,8
STAT,1857,43,15-19,1900,0.021582350899879737
SIM,1850,30,25-29,1880,23
SIM,1813,75,na,1888,858
STAT,1823,41,45-49,1864,5.111619451193649
STAT,1885,22,50-100,1907,0.819779501564394
SIM,1848,16,25-29,1864,17
STAT,1876,22,20-24,1898,143.94853358108404
STAT,1873,28,40-44,1901,6.125427570695297
STAT,1795,73,na,1868,1064.5295051594073
STAT,1936,15,45-49,1951,0.9705822143101313
SIM,1829,62,na,1891,2321
SIM,1949,20,15-19,1969,17
STAT,1877,40,35-39,1917,3.835881755818635
SIM,1782,75,na,1857,766
SIM,1849,43,35-39,1892,7
SIM,1881,28,40-44,1909,9
STAT,1821,33,50-100,1854,6.021119900261139
STAT,1888,43,15-19,1931,0.03272683113243519
STAT,1806,93,na,1899,19.900026682553165
STAT,1874,46,na,1920,4665.688312919021
STAT,1898,48,30-34,1946,0.14736035477937218
SIM,1830,28,30-34,1858,51
STAT,1873,21,na,1894,4867.864743435738
SIM,1897,46,na,1943,6169
STAT,1928,8,na,1936,10148.09716557867
STAT,1932,20,25-29,1952,246.25038035894562
SIM,1861,48,na,1909,4254
SIM,1865,69,na,1934,2626
SIM,1880,19,25-29,1899,17
SIM,1869,28,na,1897,4608
SIM,1825,29,35-39,1854,20
STAT,1905,46,na,1951,6591.173792088045
STAT,1840,38,25-29,1878,4.864694501691256
STAT,1904,21,na,1925,6876.358159176703
SIM,1891,21,na,1912,6083
STAT,1834,27,45-49,1861,1.9380242927612723
STAT,1827,28,15-19,1855,1.875601543593699
STAT,1844,95,na,1939,21.47115135471584
STAT,1883,33,15-19,1916,0.2813832858025364
STAT,1819,37,20-24,1856,4.483071828762507
STAT,1890,33,50-100,1923,2.249156497871222
SIM,1906,25,na,1931,7048
STAT,1876,29,40-44,1905,6.212590622030338
STAT,1874,48,45-49,1922,0.4818958080562362
STAT,1817,46,50-100,1863,1.204827363134162
SIM,1864,39,50-100,1903,1
STAT,1890,26,20-24,1916,29.01910209729936
STAT,1878,36,45-49,1914,4.22510110027149
STAT,1869,31,40-44,1900,8.521373962506328
SIM,1876,47,45-49,1923,4
SIM,1901,22,na,1923,6691
STAT,1912,23,50-100,1935,1.2699691305334564
SIM,1842,27,45-49,1869,2
STAT,1934,18,50-100,1952,1.020928759047331
SIM,1918,43,45-49,1961,2
STAT,1837,17,15-19,1854,16.196210653666984
STAT,1863,25,15-19,1888,0.8137444437064387
SIM,1944,15,15-19,1959,98
STAT,1775,96,na,1871,2.267769469919848
STAT,1762,111,na,1873,0.002771228193786494
SIM,1885,22,35-39,1907,18
SIM,1899,34,35-39,1933,36
STAT,1936,15,15-19,1951,88.17741201329159
STAT,1868,47,45-49,1915,0.4513660801145186
STAT,1855,28,20-24,1883,18.306751364261512
STAT,1834,54,35-39,1888,0.011294052651168795
STAT,1897,34,na,1931,6387.029941161868
SIM,1908,18,15-19,1926,13
STAT,1829,26,20-24,1855,42.75714689617973
SIM,1871,29,30-34,1900,60
SIM,1887,49,40-44,1936,1
SIM,1817,38,40-44,1855,4
STAT,1940,15,35-39,1955,8.609785623734679
SIM,1847,48,25-29,1895,1
SIM,1855,70,na,1925,2318
SIM,1877,31,40-44,1908,11
SIM,1853,27,20-24,1880,23
STAT,1856,80,na,1936,963.9191208045703
STAT,1823,37,40-44,1860,16.986058629058544
STAT,1850,22,30-34,1872,32.780137627573545
STAT,1866,18,25-29,1884,10.774970849633833
SIM,1835,28,15-19,1863,1
SIM,1842,41,20-24,1883,4
SIM,1939,17,30-34,1956,29
STAT,1838,40,50-100,1878,1.7155246149744863
SIM,1851,18,na,1869,4480
STAT,1816,42,15-19,1858,0.07606576926467802
STAT,1844,16,45-49,1860,0.13489067853353837
STAT,1890,28,40-44,1918,7.358538571720668
STAT,1832,47,30-34,1879,0.1492032233888632
SIM,1787,81,na,1868,296
STAT,1894,19,15-19,1913,15.314010921397937
STAT,1820,107,na,1927,0.005279545083321549
SIM,1831,35,20-24,1866,2
SIM,1919,35,na,1954,8283
STAT,1845,40,na,1885,3720.8424191783242
STAT,1940,31,na,1971,7910.490025806145
SIM,1840,47,30-34,1887,1
SIM,1843,28,40-44,1871,6
STAT,1823,35,20-24,1858,3.203321483770942
SIM,1845,53,45-49,1898,1
STAT,1804,67,na,1871,1532.8719099459393
STAT,1862,21,na,1883,4209.4848773201775
STAT,1876,72,na,1948,2638.0103136894254
STAT,1904,16,15-19,1920,17.244968189803686
STAT,1913,28,25-29,1941,132.02126404505583
STAT,1842,36,30-34,1878,9.405218863333914
STAT,1900,25,40-44,1925,8.449382374968158
SIM,1833,67,na,1900,2012
SIM,1882,48,45-49,1930,1
STAT,1837,53,45-49,1890,0.019906924436873592
SIM,1825,46,50-100,1871,1
STAT,1845,27,20-24,1872,22.003435709479128
STAT,1854,39,30-34,1893,8.087945770498507
STAT,1883,47,40-44,1930,0.33812386701734937
STAT,1921,22,45-49,1943,2.5660398153404387
SIM,1912,16,15-19,1928,15
SIM,1921,28,25-29,1949,165
SIM,1888,44,30-34,1932,3
SIM,1908,21,40-44,1929,13
SIM,1823,74,na,1897,1091
STAT,1838,34,15-19,1872,0.23457112338202132
STAT,1946,16,15-19,1962,101.68125873988681
STAT,1873,32,15-19,1905,0.2922285389487174
STAT,1835,22,35-39,1857,10.050948972453108
SIM,1844,21,35-39,1865,14
SIM,1882,72,na,1954,2397
SIM,1949,19,45-49,1968,4
SIM,1842,44,na,1886,3332
STAT,1938,25,20-24,1963,36.56110544460547
SIM,1830,56,na,1886,2516
SIM,1864,28,na,1892,4494
SIM,1820,35,45-49,1855,4
STAT,1911,15,45-49,1926,0.20288407513673884
SIM,1850,36,30-34,1886,12
SIM,1945,12,na,1957,9034
STAT,1895,21,40-44,1916,5.50037111434908
SIM,1922,23,15-19,1945,12
STAT,1800,110,na,1910,2.3602627226686944E-4
SIM,1898,39,45-49,1937,2
STAT,1867,15,35-39,1882,1.073595563227594
STAT,1939,12,na,1951,7993.607283043418
STAT,1878,54,45-49,1932,0.029769261273736275
SIM,1845,17,15-19,1862,10
SIM,1846,40,50-100,1886,5
SIM,1889,9,na,1898,6630
STAT,1843,111,na,1954,1.503532346527075E-4
SIM,1874,35,50-100,1909,4
SIM,1843,22,35-39,1865,20
STAT,1828,49,30-34,1877,0.16982924387029485
STAT,1842,32,15-19,1874,0.2561237155755407
STAT,1925,43,40-44,1968,0.6104974824921713
STAT,1866,35,50-100,1901,2.3096019569514707
SIM,1899,21,20-24,1920,203
STAT,1861,36,na,1897,3979.479102796399
SIM,1836,30,40-44,1866,14
STAT,1897,31,na,1928,6468.51220517311
SIM,1848,66,na,1914,2411
STAT,1914,23,15-19,1937,10.951509253883689
STAT,1845,18,na,1863,4444.290240286924
STAT,1849,6,na,1855,4857.4684799999995
SIM,1934,29,50-100,1963,4
STAT,1858,47,na,1905,3525.6766668141554
STAT,1926,29,50-100,1955,2.3921649275364434
SIM,1901,9,na,1910,7397
STAT,1788,109,na,1897,4.4256672540609297E-4
STAT,1881,20,35-39,1901,11.459298548511384
STAT,1933,34,35-39,1967,24.842430526079074
STAT,1837,35,15-19,1872,0.09731291038822464
STAT,1836,21,35-39,1857,10.316045372984613
STAT,1850,27,25-29,1877,76.3266555874181
SIM,1954,16,15-19,1970,109
SIM,1906,32,25-29,1938,19
STAT,1901,20,30-34,1921,50.662384844644485
STAT,1870,24,45-49,1894,1.3740124734219237
STAT,1879,49,40-44,1928,0.3541049784269337
SIM,1918,25,45-49,1943,4
SIM,1942,18,50-100,1960,1
STAT,1851,18,na,1869,4300.8260802091345
STAT,1914,25,35-39,1939,30.779937921080485
SIM,1875,15,35-39,1890,1
STAT,1879,47,20-24,1926,0.025231544597428622
STAT,1903,48,15-19,1951,6.406696471178795E-4
SIM,1883,42,20-24,1925,1
SIM,1913,10,na,1923,8411
STAT,1869,90,na,1959,242.02026050848633
STAT,1872,19,25-29,1891,11.440305479849378
STAT,1858,27,30-34,1885,40.586296584050984
STAT,1875,42,20-24,1917,0.3298215630171091
STAT,1782,78,na,1860,586.6465512293984
SIM,1922,25,35-39,1947,54
STAT,1891,23,30-34,1914,44.328863924278444
STAT,1891,43,50-100,1934,2.618256254991129
SIM,1888,21,45-49,1909,1
STAT,1881,18,20-24,1899,34.51686246490222
SIM,1886,36,45-49,1922,8
SIM,1866,27,30-34,1893,58
STAT,1944,21,35-39,1965,20.537862369494537
SIM,1819,45,45-49,1864,1
STAT,1812,93,na,1905,27.702936290761482
STAT,1808,51,20-24,1859,0.004469971590899481
SIM,1877,54,na,1931,4213
STAT,1923,45,35-39,1968,0.305945410333328
STAT,1824,32,30-34,1856,78.55167938847146
SIM,1862,20,40-44,1882,7
STAT,1927,19,20-24,1946,338.57343841879924
SIM,1832,32,30-34,1864,42
SIM,1939,12,na,1951,8242
STAT,1866,53,35-39,1919,0.015785222739434654
SIM,1867,24,40-44,1891,2
STAT,1882,44,50-100,1926,2.0504046250815224
STAT,1922,15,20-24,1937,318.27099301771545
SIM,1865,41,25-29,1906,2
SIM,1890,44,50-100,1934,6
SIM,1908,36,45-49,1944,1
SIM,1868,38,20-24,1906,1
STAT,1846,47,25-29,1893,0.08781512888671571
STAT,1882,72,na,1954,2484.6152386932026
SIM,1842,29,50-100,1871,2
SIM,1858,28,na,1886,4095
SIM,1886,18,15-19,1904,9
SIM,1883,34,50-100,1917,3
STAT,1841,35,35-39,1876,12.344747513152443
STAT,1864,24,15-19,1888,5.964944890342606
SIM,1856,22,45-49,1878,1
STAT,1827,46,45-49,1873,0.43194210234459696
STAT,1822,42,45-49,1864,5.036731395549314
SIM,1914,42,30-34,1956,1
STAT,1816,46,30-34,1862,0.4829642601710052
STAT,1956,15,na,1971,9840.272769593043
STAT,1927,0,na,1927,11311.374274247455
STAT,1917,49,20-24,1966,0.02317381615894915
SIM,1857,38,45-49,1895,6
STAT,1850,45,25-29,1895,0.08919681371354138
STAT,1870,47,na,1917,4440.247973253936
SIM,1817,74,na,1891,1067
STAT,1898,44,15-19,1942,0.0025856060274530154
SIM,1852,34,45-49,1886,5
SIM,1903,32,45-49,1935,6
SIM,1872,36,20-24,1908,2
SIM,1794,63,na,1857,1683
SIM,1946,25,20-24,1971,38
SIM,1832,37,25-29,1869,5
STAT,1912,28,na,1940,7431.534742292019
STAT,1864,87,na,1951,318.0608411563203
STAT,1842,46,40-44,1888,0.2582146877167324
STAT,1839,20,45-49,1859,1.4193096932841567
SIM,1872,24,15-19,1896,1
STAT,1883,37,30-34,1920,10.575339289180329
STAT,1901,35,35-39,1936,4.357333375880873
STAT,1843,48,15-19,1891,5.532860926021063E-4
SIM,1930,15,20-24,1945,404
STAT,1859,24,40-44,1883,3.4256995140240454
STAT,1924,13,na,1937,9512.020905789685
STAT,1919,19,50-100,1938,0.831514804387804
SIM,1891,37,30-34,1928,15
STAT,1864,47,na,1911,4042.723242924633
SIM,1923,36,40-44,1959,6
STAT,1824,37,25-29,1861,8.74591453223382
SIM,1769,93,na,1862,11
STAT,1920,36,15-19,1956,0.0424922496590007
STAT,1818,44,45-49,1862,6.848231925419119
STAT,1828,30,40-44,1858,10.33580954118989
SIM,1905,22,30-34,1927,75
STAT,1844,34,45-49,1878,3.2983970425303184
STAT,1873,26,15-19,1899,0.9342181002356196
STAT,1945,12,na,1957,8665.53717737372
SIM,1847,20,45-49,1867,2
SIM,1878,41,35-39,1919,6
SIM,1918,25,15-19,1943,1
STAT,1870,87,na,1957,426.1753073653006
SIM,1861,1,na,1862,6725
STAT,1933,27,na,1960,10046.891670663224
SIM,1907,10,na,1917,7819
STAT,1906,42,30-34,1948,0.2346616313418754
SIM,1876,29,45-49,1905,2
SIM,1899,44,50-100,1943,1
SIM,1901,44,40-44,1945,1
STAT,1901,39,20-24,1940,0.4656857966202115
STAT,1860,31,20-24,1891,4.451357269251359
SIM,1888,35,na,1923,5578
SIM,1896,40,40-44,1936,1
SIM,1923,5,na,1928,9951
SIM,1824,46,30-34,1870,1
STAT,1936,30,40-44,1966,7.686932685480855
STAT,1870,51,35-39,1921,0.017151951949661813
STAT,1891,28,25-29,1919,105.22879585991598
STAT,1835,28,40-44,1863,5.022381270940569
STAT,1888,40,40-44,1928,5.423344762958938
STAT,1837,32,40-44,1869,7.580138774566839
SIM,1945,4,na,1949,9158
SIM,1830,24,45-49,1854,2
SIM,1845,32,40-44,1877,16
SIM,1804,64,na,1868,1727
SIM,1861,36,45-49,1897,3
SIM,1828,39,25-29,1867,4
SIM,1881,45,50-100,1926,1
STAT,1860,17,45-49,1877,0.12356020871915344
STAT,1885,46,na,1931,4535.687516583105
SIM,1858,35,25-29,1893,8
STAT,1900,46,45-49,1946,0.37402140253716337
STAT,1838,48,40-44,1886,0.23534055094203843
SIM,1934,26,45-49,1960,5
STAT,1885,35,45-49,1920,4.045558411623086
STAT,1896,31,35-39,1927,27.113447216181214
STAT,1878,36,15-19,1914,0.11901694655603773
STAT,1901,43,50-100,1944,0.20592360135469948
STAT,1865,38,25-29,1903,5.256580731729302
SIM,1871,69,na,1940,2754
SIM,1926,17,20-24,1943,328
STAT,1875,15,30-34,1890,3.3296132659026916
SIM,1851,19,35-39,1870,2
STAT,1893,13,na,1906,6600.661513752655
SIM,1870,84,na,1954,629
STAT,1764,103,na,1867,0.07641126236956648
STAT,1833,55,na,1888,2748.6623188792537
STAT,1891,46,25-29,1937,0.08134072905336356
STAT,1915,36,40-44,1951,3.069144768489266
STAT,1897,47,35-39,1944,0.21220127508078152
SIM,1861,18,15-19,1879,10
STAT,1827,28,45-49,1855,4.589981467961985
STAT,1853,18,15-19,1871,11.22861529121712
SIM,1854,29,25-29,1883,86
STAT,1817,37,na,1854,3126.6570407707536
SIM,1845,18,na,1863,4686
STAT,1769,96,na,1865,1.9735415745832934
STAT,1894,19,45-49,1913,0.1685636524217729
STAT,1846,29,25-29,1875,77.26252990790978
STAT,1870,49,50-100,1919,0.4768145515389806
SIM,1824,49,50-100,1873,1
SIM,1893,35,45-49,1928,2
STAT,1864,36,20-24,1900,1.398318759987156
STAT,1929,36,35-39,1965,6.276554989334076
STAT,1834,41,20-24,1875,0.2581403069559318
STAT,1809,106,na,1915,0.010791703418926723
SIM,1827,37,20-24,1864,2
SIM,1822,33,20-24,1855,6
SIM,1840,29,30-34,1869,70
STAT,1906,28,na,1934,6998.682354617176
STAT,1816,52,na,1868,2709.0492359471737
STAT,1863,22,40-44,1885,3.75738452733783
SIM,1830,42,45-49,1872,2
SIM,1894,28,20-24,1922,30
STAT,1832,29,30-34,1861,43.305964005334516
STAT,1928,39,25-29,1967,2.5073645214056763
SIM,1835,46,45-49,1881,1
SIM,1873,33,30-34,1906,43
STAT,1928,20,35-39,1948,23.881225975884927
SIM,1841,44,40-44,1885,9
STAT,1926,26,45-49,1952,4.196279996369593
STAT,1949,15,25-29,1964,101.83638296636859
SIM,1935,19,20-24,1954,363
SIM,1871,22,40-44,1893,5
STAT,1918,17,20-24,1935,59.78259702064666
SIM,1805,49,na,1854,2480
STAT,1841,59,na,1900,2819.830194975652
STAT,1854,20,40-44,1874,3.80785382354347
STAT,1930,13,na,1943,10329.5503132196
SIM,1830,24,15-19,1854,10
STAT,1843,19,35-39,1862,0.9707338630961411
SIM,1859,32,35-39,1891,29
STAT,1894,37,45-49,1931,5.1718955581182025
SIM,1877,94,na,1971,129
SIM,1884,29,40-44,1913,10
SIM,1904,25,20-24,1929,39
STAT,1829,40,35-39,1869,3.0743485435016873
STAT,1848,22,45-49,1870,1.3922104923388043
STAT,1849,38,45-49,1887,3.1933221246470564
STAT,1907,44,35-39,1951,0.368223217391576
STAT,1822,52,na,1874,2724.163934711176
SIM,1810,64,na,1874,1836
STAT,1883,18,50-100,1901,0.09695858165584939
SIM,1837,41,50-100,1878,2
STAT,1851,40,na,1891,3618.995900098784
SIM,1936,20,35-39,1956,17
STAT,1865,38,50-100,1903,2.241502945732106
SIM,1892,15,40-44,1907,2
STAT,1886,28,20-24,1914,24.92274244829994
STAT,1865,51,30-34,1916,0.010974061389294984
STAT,1857,47,30-34,1904,0.15167184935330255
SIM,1920,23,50-100,1943,2
STAT,1816,49,50-100,1865,1.1703180251664187
STAT,1927,27,na,1954,9196.43001085655
STAT,1910,32,40-44,1942,7.6233975349841705
STAT,1877,57,na,1934,4214.514136789562
STAT,1948,18,45-49,1966,1.1541268194071514
SIM,1801,90,na,1891,51
SIM,1894,35,na,1929,6422
STAT,1921,47,20-24,1968,0.025154510459452398
STAT,1834,29,50-100,1863,1.1006009246848534
STAT,1811,52,40-44,1863,0.06817113113542927
SIM,1835,28,45-49,1863,5
SIM,1812,90,na,1902,70
STAT,1875,34,50-100,1909,1.888885100725708
STAT,1885,17,45-49,1902,0.1313175821862267
SIM,1837,40,35-39,1877,2
STAT,1833,44,40-44,1877,3.4983339702318825
SIM,1841,15,25-29,1856,16
SIM,1888,34,20-24,1922,1
STAT,1838,28,20-24,1866,20.05180165979455
STAT,1826,54,45-49,1880,0.026824659580307452
STAT,1825,97,na,1922,6.2158761882506
SIM,1895,48,25-29,1943,1
SIM,1902,27,45-49,1929,6
SIM,1890,73,na,1963,3533
STAT,1823,43,50-100,1866,3.429702930507051
STAT,1898,39,50-100,1937,0.7169720184070607
SIM,1876,44,40-44,1920,10
STAT,1817,54,35-39,1871,0.03828940523677641
STAT,1855,15,45-49,1870,0.11855077958109425
STAT,1862,45,15-19,1907,6.973637033743699E-4
STAT,1878,30,50-100,1908,1.9481721826733522
SIM,1923,17,35-39,1940,8
STAT,1826,38,40-44,1864,10.026144236641212
STAT,1835,20,50-100,1855,0.8651326349934387
SIM,1907,41,na,1948,6945
STAT,1907,39,50-100,1946,0.778691712535686
SIM,1864,28,40-44,1892,8
STAT,1953,15,15-19,1968,110.92581647683622
STAT,1849,25,30-34,1874,47.90333317710148
SIM,1860,41,40-44,1901,8
SIM,1844,33,50-100,1877,2
STAT,1906,17,25-29,1923,16.676865647773145
SIM,1896,21,35-39,1917,20
STAT,1767,92,na,1859,17.679781846897054
STAT,1847,28,30-34,1875,45.80653091032537
STAT,1801,103,na,1904,0.1137595943942239
STAT,1921,28,15-19,1949,1.583032206924513
STAT,1782,111,na,1893,6.027233222885384E-4
STAT,1853,18,45-49,1871,0.12359508001145847
STAT,1893,29,40-44,1922,7.613471656076169
STAT,1902,40,35-39,1942,0.362165023937822
STAT,1915,24,40-44,1939,6.976077162905244
SIM,1853,41,35-39,1894,6
SIM,1844,39,na,1883,3403
SIM,1903,51,na,1954,6350
STAT,1887,41,na,1928,5244.233469472977
STAT,1890,39,na,1929,5749.3976601424965
STAT,1863,37,na,1900,4165.133614555326
STAT,1893,45,45-49,1938,0.34417775310265186
STAT,1915,17,35-39,1932,1.7738361125026765
STAT,1786,99,na,1885,0.6565680348166192
STAT,1856,28,40-44,1884,4.80217643357596
SIM,1840,49,na,1889,3494
SIM,1897,34,30-34,1931,53
STAT,1808,54,25-29,1862,0.02017720811318216
STAT,1888,21,35-39,1909,13.971725870584732
SIM,1833,27,50-100,1860,1
SIM,1924,46,35-39,1970,1
STAT,1878,48,15-19,1926,8.331181966739755E-4
STAT,1894,29,na,1923,6147.335848579413
STAT,1897,21,45-49,1918,1.8882020410605935
STAT,1906,6,na,1912,7688.021775874595
SIM,1901,17,15-19,1918,13
STAT,1887,48,25-29,1935,0.12847166473161833
STAT,1839,18,na,1857,4660.997329682725
SIM,1876,42,50-100,1918,3
SIM,1821,38,30-34,1859,17
STAT,1924,17,45-49,1941,1.2010838135226252
SIM,1883,21,25-29,1904,126
SIM,1938,33,na,1971,7711
STAT,1911,24,40-44,1935,6.401807011209873
SIM,1882,78,na,1960,1869
STAT,1892,40,50-100,1932,2.697974560328171
STAT,1906,24,30-34,1930,52.09239363785779
STAT,1788,100,na,1888,0.4643842937261952
STAT,1901,40,50-100,1941,0.20951493394970777
SIM,1874,15,20-24,1889,38
STAT,1843,51,40-44,1894,0.014817878267191562
STAT,1833,22,30-34,1855,32.56866896925523
STAT,1883,51,na,1934,4292.915481756878
STAT,1930,35,30-34,1965,4.809509176125763
STAT,1794,94,na,1888,8.97467836956557
STAT,1866,15,20-24,1881,34.312561163727494
SIM,1932,17,45-49,1949,2
SIM,1836,33,45-49,1869,6
SIM,1837,51,na,1888,2925
STAT,1864,42,15-19,1906,0.024900322299511314
STAT,1884,45,35-39,1929,0.2819813492903057
SIM,1848,25,20-24,1873,4
SIM,1852,34,na,1886,3926
STAT,1909,27,20-24,1936,35.25158892101709
SIM,1883,15,30-34,1898,3
STAT,1917,21,40-44,1938,7.238413480596225
SIM,1872,18,20-24,1890,36
SIM,1917,27,20-24,1944,37
SIM,1893,16,na,1909,6692
SIM,1825,32,na,1857,3193
STAT,1852,99,na,1951,3.0184646460256634
SIM,1899,31,30-34,1930,51
SIM,1913,43,25-29,1956,1
STAT,1871,29,20-24,1900,23.371093181951714
SIM,1875,90,na,1965,356
SIM,1914,24,30-34,1938,93
STAT,1866,47,40-44,1913,0.317540404332233
STAT,1915,46,50-100,1961,0.4614784597934152
SIM,1878,23,40-44,1901,5
SIM,1925,21,40-44,1946,6
SIM,1897,27,25-29,1924,135
STAT,1895,70,na,1965,4224.529139460399
STAT,1927,25,15-19,1952,1.7448025189580363
SIM,1862,39,30-34,1901,13
STAT,1843,44,35-39,1887,2.5456655036251346
SIM,1860,28,40-44,1888,8
STAT,1864,18,20-24,1882,32.913953696319744
STAT,1837,54,20-24,1891,0.001000444456899661
SIM,1880,43,na,1923,5078
STAT,1852,28,40-44,1880,5.520966945055693
STAT,1837,82,na,1919,650.3018380505088
STAT,1845,49,30-34,1894,0.1460481732191787
STAT,1862,83,na,1945,685.2794432013104
STAT,1936,25,50-100,1961,1.9258855019715644
STAT,1851,39,45-49,1890,3.0591662718124404
SIM,1891,16,35-39,1907,1
STAT,1868,74,na,1942,2132.488032690397
SIM,1855,76,na,1931,1469
SIM,1824,84,na,1908,344
SIM,1926,14,na,1940,10038
SIM,1841,22,30-34,1863,38
SIM,1855,20,35-39,1875,18
SIM,1808,60,na,1868,2134
STAT,1948,17,30-34,1965,28.169714427510144
STAT,1823,41,15-19,1864,0.04716604207676789
STAT,1875,45,25-29,1920,0.12096471166588624
STAT,1883,15,50-100,1898,0.09766494752920549
STAT,1857,31,15-19,1888,0.2279161198485007
STAT,1913,35,na,1948,7571.4818709261635
SIM,1877,34,45-49,1911,5
SIM,1857,25,30-34,1882,48
SIM,1948,4,na,1952,9413
STAT,1890,32,15-19,1922,0.3510571222651193
STAT,1913,38,35-39,1951,4.798052807335919
STAT,1856,26,15-19,1882,0.7378867293166051
STAT,1876,50,25-29,1926,0.007505091501159767
SIM,1937,22,45-49,1959,4
SIM,1921,38,35-39,1959,9
STAT,1927,43,45-49,1970,0.4208197271735101
SIM,1904,9,na,1913,7648
SIM,1847,33,20-24,1880,1
STAT,1831,36,25-29,1867,4.758974206660473
SIM,1911,24,50-100,1935,1
SIM,1874,47,40-44,1921,1
STAT,1930,28,25-29,1958,168.94575136749006
STAT,1863,54,50-100,1917,0.025965924141024232
SIM,1939,27,40-44,1966,9
STAT,1939,33,25-29,1972,19.036216116446145
STAT,1868,44,40-44,1912,4.263703422403675
SIM,1863,71,na,1934,2328
STAT,1831,91,na,1922,74.8192136178634
STAT,1829,87,na,1916,208.51156066373278
STAT,1869,34,45-49,1903,3.383337660341599
STAT,1921,30,na,1951,8566.501523446088
STAT,1931,7,na,1938,10567.244020235496
SIM,1907,21,20-24,1928,194
STAT,1920,17,45-49,1937,1.1316449575369742
SIM,1849,30,20-24,1879,6
STAT,1858,23,15-19,1881,5.384146109627224
STAT,1845,41,35-39,1886,2.8781008558397834
STAT,1847,20,35-39,1867,11.063024008361529
SIM,1848,41,25-29,1889,2
STAT,1837,47,15-19,1884,5.788585757753322E-4
STAT,1925,28,15-19,1953,1.6777125906251635
STAT,1933,22,35-39,1955,25.227187984157805
SIM,1924,13,na,1937,9888
SIM,1851,44,35-39,1895,5
STAT,1823,96,na,1919,10.304001428114756
STAT,1916,17,50-100,1933,0.16053593562340676
SIM,1816,89,na,1905,61
SIM,1855,28,30-34,1883,68
STAT,1844,64,na,1908,2807.299382931137
STAT,1889,37,50-100,1926,3.0573653650958756
STAT,1955,7,na,1962,10536.846042722009
STAT,1860,34,25-29,1894,16.654895602894705
SIM,1898,26,30-34,1924,92
SIM,1837,57,na,1894,2673
STAT,1872,37,25-29,1909,5.844023145513719
STAT,1844,43,40-44,1887,3.6728126721864536
SIM,1799,78,na,1877,547
STAT,1827,43,40-44,1870,4.195878655014256
STAT,1788,106,na,1894,0.007552792441692619
STAT,1924,22,25-29,1946,220.0676568333431
STAT,1825,49,45-49,1874,0.49788203838244594
STAT,1852,24,50-100,1876,0.7610513977143121
STAT,1865,33,30-34,1898,31.9000967868454
STAT,1922,33,15-19,1955,0.2919209795216935
STAT,1858,84,na,1942,523.751025559575
STAT,1854,54,na,1908,3210.0094457457762
STAT,1840,47,50-100,1887,0.3574939825562651
STAT,1841,18,50-100,1859,0.0911394173327626
STAT,1907,22,25-29,1929,169.92571992631161
SIM,1953,16,na,1969,9299
STAT,1851,20,25-29,1871,107.51258256084367
SIM,1849,49,40-44,1898,1
SIM,1929,28,25-29,1957,190
STAT,1854,23,45-49,1877,1.2470016996856275
SIM,1942,15,50-100,1957,1
STAT,1808,49,45-49,1857,1.4293415246337147
STAT,1917,45,40-44,1962,0.3341276092924368
SIM,1847,26,15-19,1873,2
STAT,1910,42,50-100,1952,0.2243166809498285
SIM,1843,51,na,1894,3243
SIM,1862,23,45-49,1885,2
SIM,1889,42,25-29,1931,4
STAT,1830,30,35-39,1860,20.736639416928114
STAT,1839,36,25-29,1875,5.428445833221211
SIM,1932,22,25-29,1954,255
SIM,1858,15,35-39,1873,1
STAT,1864,20,35-39,1884,10.859641232190238
STAT,1894,34,40-44,1928,11.154835498466923
SIM,1842,20,25-29,1862,130
SIM,1887,29,20-24,1916,31
SIM,1924,4,na,1928,10081
SIM,1820,94,na,1914,13
SIM,1837,25,45-49,1862,2
SIM,1816,49,45-49,1865,1
SIM,1875,20,20-24,1895,161
SIM,1873,26,25-29,1899,94
SIM,1868,49,na,1917,4264
STAT,1904,45,30-34,1949,0.15985863267652678
SIM,1902,16,20-24,1918,58
STAT,1879,29,20-24,1908,24.605297751962198
STAT,1889,27,25-29,1916,105.34038797899511
SIM,1929,35,30-34,1964,9
SIM,1868,52,35-39,1920,1
SIM,1822,89,na,1911,64
STAT,1811,43,45-49,1854,11.508850984608994
STAT,1834,20,25-29,1854,192.7621132029483
STAT,1938,28,25-29,1966,131.65461937801098
STAT,1895,76,na,1971,3422.330145777302
STAT,1910,35,45-49,1945,1.3297718228653255
SIM,1901,0,na,1901,7820
SIM,1906,22,15-19,1928,10
STAT,1914,19,40-44,1933,0.5813113486495131
SIM,1884,20,30-34,1904,51
STAT,1922,40,20-24,1962,0.041041302461781955
STAT,1896,24,na,1920,6266.754441272944
SIM,1915,22,25-29,1937,216
STAT,1848,54,na,1902,3433.476460549909
STAT,1865,32,na,1897,4378.430334125626
STAT,1910,19,50-100,1929,0.14918086307016587
SIM,1835,43,40-44,1878,12
SIM,1879,31,45-49,1910,6
STAT,1868,8,na,1876,5279.14919924344
STAT,1906,0,na,1906,8641.474486817224
STAT,1878,54,50-100,1932,0.030980214223821956
STAT,1850,64,na,1914,2665.3723961222377
SIM,1781,96,na,1877,9
SIM,1847,36,25-29,1883,6
STAT,1897,27,15-19,1924,1.224834398012683
SIM,1831,66,na,1897,2161
STAT,1858,52,30-34,1910,0.009321912078135338
SIM,1934,35,40-44,1969,1
STAT,1848,33,30-34,1881,30.067692659990513
STAT,1840,41,15-19,1881,0.021061836193533284
STAT,1858,30,20-24,1888,4.345050300520069
SIM,1856,33,30-34,1889,37
STAT,1807,78,na,1885,722.5887087152549
STAT,1800,54,25-29,1854,0.021276055249884174
SIM,1906,27,45-49,1933,3
SIM,1881,18,30-34,1899,3
SIM,1846,34,na,1880,3861
SIM,1918,19,na,1937,8265
STAT,1813,72,na,1885,1233.7776365660318
SIM,1899,16,35-39,1915,2
STAT,1901,10,na,1911,7323.807434934314
STAT,1828,33,45-49,1861,3.792344130389948
STAT,1926,35,40-44,1961,3.7006971796522308
SIM,1851,86,na,1937,250
STAT,1848,26,25-29,1874,83.40389533308853
STAT,1923,32,20-24,1955,5.645569946059478
SIM,1842,39,45-49,1881,7
STAT,1875,56,na,1931,4241.116203156806
STAT,1922,18,na,1940,8578.29323579532
STAT,1870,5,na,1875,5531.224660233656
STAT,1884,39,na,1923,4651.167832105883
STAT,1859,32,na,1891,3835.9692068567965
STAT,1788,94,na,1882,8.822724143146518
STAT,1908,21,30-34,1929,53.56047815248798
STAT,1904,38,25-29,1942,1.7924850588637138
STAT,1867,20,20-24,1887,132.77961364001004
STAT,1839,43,30-34,1882,1.8678976283583695
STAT,1865,26,25-29,1891,77.88147703493497
SIM,1832,22,20-24,1854,129
STAT,1829,25,45-49,1854,6.322113298876676
SIM,1768,86,na,1854,113
SIM,1793,81,na,1874,300
SIM,1893,22,50-100,1915,1
STAT,1867,48,50-100,1915,0.4586969964389196
STAT,1826,73,na,1899,1421.8647043083251
STAT,1851,12,na,1863,4499.317717083616
SIM,1916,21,30-34,1937,74
STAT,1853,33,40-44,1886,6.99299318144658
STAT,1819,63,na,1882,1993.5256594628152
SIM,1907,47,na,1954,6632
SIM,1833,30,25-29,1863,20
STAT,1780,74,na,1854,796.0
STAT,1873,18,30-34,1891,3.2621402920688696
STAT,1895,24,45-49,1919,1.8236047539088478
STAT,1898,19,na,1917,6865.6853480120235
STAT,1864,84,na,1948,600.5600185817947
STAT,1870,37,20-24,1907,1.5284601798648378
SIM,1862,58,na,1920,3634
SIM,1922,19,40-44,1941,4
SIM,1861,33,40-44,1894,17
SIM,1817,37,na,1854,3241
STAT,1886,42,35-39,1928,3.855798010082356
STAT,1880,29,30-34,1909,53.193410280974156
SIM,1848,60,na,1908,2875
SIM,1908,26,50-100,1934,2
SIM,1823,37,na,1860,3301
SIM,1846,28,20-24,1874,23
SIM,1842,44,25-29,1886,3
STAT,1896,16,45-49,1912,0.17460555993964735
SIM,1856,26,25-29,1882,90
SIM,1880,37,25-29,1917,10
SIM,1901,56,na,1957,5937
STAT,1885,50,35-39,1935,0.017555464205751818
SIM,1931,32,20-24,1963,9
STAT,1852,48,50-100,1900,0.3865213379636193
STAT,1846,99,na,1945,2.9008534146547507
STAT,1889,76,na,1965,3025.4952702587484
STAT,1903,46,25-29,1949,0.09369572948013839
SIM,1852,43,40-44,1895,7
STAT,1891,8,na,1899,6489.460682241518
STAT,1819,51,35-39,1870,0.035385609082002355
SIM,1892,42,30-34,1934,6
STAT,1889,34,30-34,1923,43.10651407066223
STAT,1778,103,na,1881,0.11166599361239708
SIM,1806,65,na,1871,1719
SIM,1912,38,25-29,1950,4
SIM,1875,24,50-100,1899,1
SIM,1833,49,45-49,1882,1
STAT,1947,18,25-29,1965,98.55067445817552
STAT,1841,15,15-19,1856,11.237421640933219
STAT,1820,39,15-19,1859,0.2477118213444741
STAT,1868,29,45-49,1897,2.1182283932866133
SIM,1905,19,40-44,1924,1
STAT,1825,30,25-29,1855,45.669332703823265
STAT,1910,17,15-19,1927,18.16821126247814
SIM,1821,42,na,1863,3091
STAT,1881,56,na,1937,3981.5313718062407
SIM,1947,16,na,1963,8634
STAT,1830,38,30-34,1868,9.848823880540142
SIM,1800,74,na,1874,924
SIM,1876,78,na,1954,1648
SIM,1847,43,30-34,1890,6
STAT,1834,44,25-29,1878,1.0044278599260172
SIM,1901,35,45-49,1936,3
STAT,1892,21,25-29,1913,145.1708092348461
SIM,1838,36,50-100,1874,4
SIM,1924,19,na,1943,9085
SIM,1847,28,40-44,1875,5
SIM,1940,17,35-39,1957,12
SIM,1869,33,40-44,1902,14
SIM,1887,16,na,1903,6265
STAT,1843,54,45-49,1897,0.019770205855007043
SIM,1920,29,na,1949,8399
SIM,1839,49,50-100,1888,2
SIM,1829,93,na,1922,25
SIM,1846,30,35-39,1876,28
STAT,1893,42,40-44,1935,5.750782968156905
STAT,1901,17,50-100,1918,0.1385181189442079
STAT,1828,52,50-100,1880,0.026272775658842156
SIM,1869,90,na,1959,207
STAT,1904,28,15-19,1932,1.3105361879278092
SIM,1851,80,na,1931,805
SIM,1906,17,35-39,1923,2
SIM,1849,40,30-34,1889,3
STAT,1866,25,30-34,1891,47.24432062793986
STAT,1830,44,na,1874,3451.9724345459053
STAT,1911,40,na,1951,7242.26659058599
STAT,1845,39,20-24,1884,1.2223892480337215
SIM,1860,44,45-49,1904,7
STAT,1817,51,30-34,1868,0.028110014233145547
STAT,1852,28,na,1880,3987.0104964455545
SIM,1790,79,na,1869,600
SIM,1892,35,25-29,1927,10
STAT,1845,51,45-49,1896,0.022469693602590112
STAT,1888,19,20-24,1907,42.09221010753864
SIM,1886,24,45-49,1910,4
STAT,1876,45,45-49,1921,0.49788560519633873
SIM,1794,69,na,1863,1331
STAT,1884,42,30-34,1926,2.289926658684383
STAT,1850,15,25-29,1865,10.743545512985932
SIM,1882,16,25-29,1898,8
SIM,1891,21,15-19,1912,10
STAT,1911,27,45-49,1938,3.403632336152473
STAT,1951,2,na,1953,9582.85696479513
SIM,1879,21,35-39,1900,17
STAT,1874,16,25-29,1890,11.747092063523276
SIM,1912,28,15-19,1940,1
STAT,1809,54,45-49,1863,0.10275171525005293
SIM,1928,32,45-49,1960,3
SIM,1900,27,40-44,1927,12
STAT,1850,52,30-34,1902,0.009078277182636525
SIM,1815,42,na,1857,2825
STAT,1798,56,na,1854,2023.9999999999995
STAT,1826,51,40-44,1877,0.02065351899409839
SIM,1857,31,25-29,1888,23
SIM,1862,24,na,1886,4353
SIM,1917,31,na,1948,8203
SIM,1932,14,na,1946,10682
STAT,1859,109,na,1968,0.01270918740823369
STAT,1860,29,45-49,1889,1.8141657088124605
STAT,1932,17,35-39,1949,11.222505398788455
STAT,1835,87,na,1922,228.17910705135228
STAT,1883,39,50-100,1922,2.411658235055769
SIM,1825,44,25-29,1869,2
SIM,1855,48,na,1903,3917
SIM,1896,19,20-24,1915,57
STAT,1910,25,35-39,1935,29.739923954309173
STAT,1817,62,na,1879,2145.3314980430905
STAT,1831,33,20-24,1864,4.511161624536357
STAT,1851,36,40-44,1887,6.9301870311963425
SIM,1930,27,20-24,1957,48
SIM,1926,24,50-100,1950,6
STAT,1772,114,na,1886,4.919104850103009E-4
STAT,1849,31,25-29,1880,18.956906615458546
SIM,1858,20,50-100,1878,5
STAT,1905,34,50-100,1939,1.5234905812199602
STAT,1836,18,45-49,1854,0.21471338372446247
SIM,1872,88,na,1960,539
SIM,1913,34,50-100,1947,4
SIM,1784,70,na,1854,1096
SIM,1939,32,20-24,1971,7
STAT,1834,39,45-49,1873,3.2328914253703407
SIM,1829,28,20-24,1857,20
STAT,1832,45,na,1877,3219.1866558441193
STAT,1857,41,25-29,1898,1.0154556330284847
STAT,1861,26,50-100,1887,1.090973958487188
STAT,1833,21,na,1854,3741.544077991019
STAT,1896,29,50-100,1925,1.693502979809405
SIM,1861,101,na,1962,3
STAT,1947,25,30-34,1972,89.59873221452965
STAT,1836,51,35-39,1887,0.011816063063941647
STAT,1838,30,35-39,1868,17.38854218928202
SIM,1850,39,na,1889,3759
STAT,1867,52,40-44,1919,0.019806252074151227
STAT,1953,0,na,1953,10589.536406459314
STAT,1885,48,20-24,1933,0.023820441776588663
STAT,1927,40,40-44,1967,0.6352021622628117
STAT,1860,54,na,1914,3434.2629315952076
SIM,1872,20,35-39,1892,18
STAT,1835,56,na,1891,2641.615382674901
STAT,1867,27,na,1894,4513.928761541926
STAT,1906,27,35-39,1933,28.39625804920666
STAT,1891,16,25-29,1907,14.181063038548407
SIM,1842,75,na,1917,1344
STAT,1908,24,35-39,1932,17.38460964626992
STAT,1822,49,50-100,1871,0.7419205187827428
SIM,1914,27,35-39,1941,40
STAT,1937,11,na,1948,7798.07752464328
SIM,1887,25,50-100,1912,2
STAT,1878,24,45-49,1902,1.4616530234713359
SIM,1874,31,25-29,1905,27
SIM,1846,43,50-100,1889,7
SIM,1856,103,na,1959,2
SIM,1898,32,25-29,1930,32
STAT,1906,25,na,1931,7071.053823202561
SIM,1888,63,na,1951,4270
SIM,1895,23,40-44,1918,7
SIM,1888,29,40-44,1917,14
STAT,1912,38,15-19,1950,0.03767559876965973
STAT,1857,26,35-39,1883,15.7583746894105
STAT,1838,43,50-100,1881,1.5022638137521829
STAT,1848,20,na,1868,4330.763050889526
STAT,1887,23,40-44,1910,4.692347840070341
STAT,1913,43,15-19,1956,0.0030205107746258037
SIM,1851,41,30-34,1892,3
STAT,1893,41,na,1934,5943.262657122204
STAT,1946,22,na,1968,8206.587051427938
SIM,1824,49,35-39,1873,1
STAT,1768,100,na,1868,0.3678641967529994
STAT,1911,30,35-39,1941,18.121570227824282
STAT,1859,39,15-19,1898,0.08935934496287662
STAT,1922,12,na,1934,9258.639332264176
SIM,1902,32,na,1934,7106
STAT,1877,51,na,1928,4537.138399764847
SIM,1865,26,35-39,1891,22
SIM,1833,50,50-100,1883,2
STAT,1883,21,15-19,1904,6.5659289858369
SIM,1814,94,na,1908,10
SIM,1874,25,30-34,1899,62
STAT,1843,41,30-34,1884,1.6795473686357671
STAT,1887,45,20-24,1932,0.027375743448308662
STAT,1904,24,na,1928,6812.7426959936265
STAT,1811,100,na,1911,0.986867417181571
STAT,1913,35,30-34,1948,3.6679511041487216
STAT,1871,31,35-39,1902,20.40315086221358
SIM,1921,35,30-34,1956,7
STAT,1889,20,40-44,1909,5.220130767179229
STAT,1879,25,50-100,1904,1.360503434534181
SIM,1888,37,25-29,1925,9
SIM,1897,20,40-44,1917,5
SIM,1908,48,45-49,1956,1
SIM,1925,45,40-44,1970,1
SIM,1849,76,na,1925,1401
SIM,1867,33,na,1900,4837
STAT,1863,37,15-19,1900,0.09927568735879919
SIM,1846,65,na,1911,2598
SIM,1889,26,20-24,1915,29
SIM,1900,21,35-39,1921,20
SIM,1828,32,40-44,1860,13
SIM,1919,32,50-100,1951,6
SIM,1941,22,35-39,1963,21
STAT,1858,45,25-29,1903,0.09159060010612811
STAT,1921,45,30-34,1966,0.2038680674059295
STAT,1816,49,35-39,1865,0.6671193974788291
STAT,1871,38,50-100,1909,2.451265411304462
STAT,1819,97,na,1916,5.621389065227216
STAT,1925,36,35-39,1961,5.867159289609126
SIM,1881,90,na,1971,467
SIM,1894,40,50-100,1934,6
SIM,1853,35,50-100,1888,4
SIM,1858,50,na,1908,3744
STAT,1875,21,25-29,1896,119.39312600801217
SIM,1833,46,40-44,1879,2
STAT,1866,37,30-34,1903,9.931560121618281
STAT,1856,20,45-49,1876,1.2802936432821979
SIM,1879,58,na,1937,4086
SIM,1909,20,50-100,1929,3
STAT,1899,66,na,1965,5021.7587922279035
SIM,1811,49,25-29,1860,1
STAT,1838,30,na,1868,3721.143372517168
STAT,1848,7,na,1855,5031.09123
SIM,1866,23,15-19,1889,6
SIM,1858,59,na,1917,3290
SIM,1907,22,35-39,1929,21
STAT,1779,89,na,1868,61.935973013050294
STAT,1839,33,20-24,1872,5.140321587862721
SIM,1880,34,20-24,1914,5
STAT,1867,30,30-34,1897,33.28918848620416
STAT,1912,32,45-49,1944,3.1279918947152794
SIM,1887,2,na,1889,6473
STAT,1905,33,15-19,1938,0.23782579120183842
SIM,1882,23,30-34,1905,41
STAT,1836,69,na,1905,1951.2209865419275
STAT,1890,48,30-34,1938,0.1329142305909064
STAT,1919,49,25-29,1968,0.1154935338256007
STAT,1921,25,50-100,1946,2.2550573108486756
STAT,1844,46,45-49,1890,0.3822017797302408
STAT,1931,33,25-29,1964,24.445097162308596
STAT,1823,62,na,1885,2292.120827925726
SIM,1911,46,na,1957,7260
STAT,1907,8,na,1915,7716.395253455722
STAT,1923,42,30-34,1965,0.3016857144597364
SIM,1910,61,na,1971,6493
SIM,1933,36,35-39,1969,15
STAT,1830,28,20-24,1858,25.548878269292516
STAT,1850,101,na,1951,0.8749199010166661
STAT,1888,39,40-44,1927,10.344215904257874
STAT,1928,37,na,1965,9601.11704586248
SIM,1874,37,30-34,1911,18
STAT,1939,23,15-19,1962,10.794514243815126
SIM,1839,36,35-39,1875,18
STAT,1861,34,45-49,1895,2.906282440378444
STAT,1865,18,40-44,1883,0.34378515319768865
STAT,1821,44,15-19,1865,0.04150514888425607
SIM,1901,32,40-44,1933,17
SIM,1924,21,20-24,1945,262
STAT,1843,17,na,1860,4109.18296048924
STAT,1898,27,35-39,1925,26.37136795122055
SIM,1788,69,na,1857,1275
SIM,1905,46,na,1951,6831
SIM,1908,29,na,1937,7138
STAT,1946,22,45-49,1968,2.528570032682941
SIM,1850,20,15-19,1870,7
SIM,1896,29,30-34,1925,91
STAT,1802,63,na,1865,1917.7992551347847
STAT,1856,39,50-100,1895,1.8938585609203757
STAT,1871,7,na,1878,5492.8065312912995
STAT,1905,43,25-29,1948,0.12930463672574288
SIM,1875,39,40-44,1914,18
STAT,1888,29,30-34,1917,59.681211333239276
STAT,1919,39,15-19,1958,0.04156799491214668
STAT,1922,27,20-24,1949,41.704807130863564
SIM,1878,73,na,1951,2306
STAT,1867,39,40-44,1906,8.19638483756612
SIM,1832,25,25-29,1857,91
SIM,1899,72,na,1971,4246
STAT,1806,90,na,1896,53.683772569817805
STAT,1830,40,45-49,1870,2.7591372025796255
SIM,1838,20,35-39,1858,14
SIM,1827,67,na,1894,1884
STAT,1916,21,20-24,1937,236.02866166021687
STAT,1811,77,na,1888,785.5065024617975
STAT,1890,0,na,1890,7238.527345908142
STAT,1842,20,15-19,1862,6.284945949244884
STAT,1918,10,na,1928,8734.869916898355
SIM,1925,0,na,1925,10243
SIM,1916,24,35-39,1940,24
STAT,1870,18,15-19,1888,11.809314326101447
STAT,1840,104,na,1944,0.09627753045050182
STAT,1871,66,na,1937,3288.698470596001
STAT,1925,46,45-49,1971,0.5331049666969099
STAT,1823,31,na,1854,3445.56354796385
SIM,1895,45,na,1940,6278
STAT,1880,44,20-24,1924,0.333325489969446
STAT,1879,31,35-39,1910,21.48062130147416
STAT,1898,32,15-19,1930,0.38921266635502577
SIM,1843,44,45-49,1887,5
SIM,1866,33,25-29,1899,25
STAT,1842,39,35-39,1881,11.010005825189848
SIM,1947,23,15-19,1970,16
STAT,1846,22,40-44,1868,3.938226728998436
STAT,1884,67,na,1951,3161.35311279314
STAT,1927,23,50-100,1950,1.6319690493912564
STAT,1939,28,45-49,1967,3.506330375868315
SIM,1910,34,40-44,1944,14
SIM,1837,29,25-29,1866,96
SIM,1902,8,na,1910,7658
STAT,1865,23,20-24,1888,127.05953560771701
STAT,1819,49,20-24,1868,0.04886522062565705
SIM,1839,52,na,1891,2890
STAT,1909,49,50-100,1958,0.417512334236875
SIM,1943,17,20-24,1960,287
STAT,1847,38,40-44,1885,6.851819871628553
SIM,1838,39,na,1877,3392
STAT,1907,32,35-39,1939,17.260913384433366
SIM,1850,39,35-39,1889,20
SIM,1915,32,35-39,1947,30
SIM,1923,24,40-44,1947,14
STAT,1829,106,na,1935,0.01436980044281758
STAT,1831,97,na,1928,6.936360425305063
STAT,1858,33,25-29,1891,16.058091610262046
STAT,1842,69,na,1911,2184.8997285402393
STAT,1926,38,45-49,1964,1.6806603122506818
SIM,1855,38,40-44,1893,10
STAT,1826,45,na,1871,3137.650143310882
STAT,1899,24,15-19,1923,9.071708710845343
STAT,1805,77,na,1882,784.9003797357125
STAT,1757,113,na,1870,0.001582211095778839
SIM,1829,38,30-34,1867,14
SIM,1870,39,50-100,1909,5
STAT,1844,30,na,1874,4273.154927872064
STAT,1949,22,30-34,1971,67.72833329856087
STAT,1822,36,15-19,1858,0.234680642165486
STAT,1935,17,20-24,1952,374.3856274599466
STAT,1862,39,50-100,1901,2.0980009563829487
SIM,1888,38,50-100,1926,4
SIM,1946,3,na,1949,8779
SIM,1884,73,na,1957,2607
SIM,1887,31,35-39,1918,38
STAT,1839,28,40-44,1867,5.85011364974373
STAT,1951,18,15-19,1969,109.10227495095923
STAT,1934,37,na,1971,10486.837066942886
STAT,1844,47,20-24,1891,0.019288623295628592
STAT,1921,35,20-24,1956,0.5953424222625538
SIM,1859,20,35-39,1879,20
SIM,1819,38,na,1857,3151
SIM,1907,46,35-39,1953,2
SIM,1920,26,50-100,1946,3
STAT,1911,40,45-49,1951,0.32454294750352897
SIM,1864,20,45-49,1884,2
STAT,1825,46,40-44,1871,0.3764010416042158
SIM,1852,46,45-49,1898,1
SIM,1856,24,na,1880,4172
STAT,1842,15,35-39,1857,1.0615081756131584
SIM,1854,22,40-44,1876,5
STAT,1813,53,20-24,1866,0.004252828822638277
SIM,1840,17,30-34,1857,1
SIM,1772,85,na,1857,121
STAT,1930,18,15-19,1948,118.18642834312182
SIM,1866,88,na,1954,189
STAT,1839,103,na,1942,0.22408842137027557
SIM,1920,32,45-49,1952,6
STAT,1854,34,50-100,1888,1.408824201490607
STAT,1834,26,50-100,1860,1.1246524184705504
SIM,1914,29,na,1943,7710
STAT,1916,16,40-44,1932,0.6008062807917721
STAT,1858,110,na,1968,0.004472932311771616
STAT,1886,65,na,1951,3602.903023486885
SIM,1864,59,na,1923,3669
STAT,1922,38,50-100,1960,0.9636192325225477
SIM,1834,38,40-44,1872,13
SIM,1898,22,15-19,1920,10
STAT,1864,30,45-49,1894,3.1734439426414607
SIM,1951,15,na,1966,9199
SIM,1938,25,50-100,1963,2
SIM,1930,38,50-100,1968,2
STAT,1829,29,25-29,1858,91.92617149492754
SIM,1924,16,40-44,1940,8
STAT,1835,44,45-49,1879,2.264841551618416
SIM,1873,23,20-24,1896,146
STAT,1902,34,40-44,1936,7.0394694291024615
SIM,1850,15,35-39,1865,1
STAT,1892,37,40-44,1929,11.067622407100346
SIM,1914,17,25-29,1931,19
STAT,1882,16,15-19,1898,11.704290981677389
STAT,1872,34,20-24,1906,5.439534541935099
SIM,1929,38,35-39,1967,14
STAT,1867,42,30-34,1909,2.1718335976416174
SIM,1831,43,50-100,1874,1
STAT,1844,28,15-19,1872,0.8904969693589606
STAT,1877,19,45-49,1896,0.13625696910666135
SIM,1828,46,na,1874,3109
STAT,1804,95,na,1899,8.944159822164275
SIM,1857,40,20-24,1897,1
SIM,1820,37,50-100,1857,4
STAT,1865,40,50-100,1905,1.9579488481283682
SIM,1925,18,15-19,1943,102
STAT,1913,37,20-24,1950,0.5255268355441639
STAT,1943,27,20-24,1970,39.26141238803395
SIM,1842,29,35-39,1871,26
STAT,1924,44,na,1968,8889.744384190626
STAT,1829,56,na,1885,2484.8151146375426
SIM,1929,25,na,1954,9681
SIM,1866,85,na,1951,438
SIM,1863,19,25-29,1882,11
STAT,1860,38,40-44,1898,7.143857060779524
STAT,1892,15,30-34,1907,4.048496495667057
STAT,1822,83,na,1905,448.23140084786496
SIM,1930,37,30-34,1967,6
STAT,1891,15,na,1906,6334.171305428195
SIM,1898,48,40-44,1946,1
SIM,1833,24,30-34,1857,41
STAT,1886,46,15-19,1932,8.551974997620726E-4
STAT,1857,48,45-49,1905,0.3668424342538736
SIM,1941,28,40-44,1969,13
SIM,1811,80,na,1891,489
SIM,1847,46,35-39,1893,1
STAT,1859,100,na,1959,3.257421643368771
STAT,1922,37,30-34,1959,4.187258186597665
STAT,1871,41,45-49,1912,3.0166189979807267
STAT,1907,26,40-44,1933,8.922433910775602
SIM,1841,25,na,1866,3932
STAT,1848,16,15-19,1864,12.134395264159961
SIM,1875,35,25-29,1910,2
SIM,1843,20,50-100,1863,1
STAT,1834,29,35-39,1863,16.601134787973287
STAT,1834,36,40-44,1870,7.323741254539117
SIM,1860,94,na,1954,26
SIM,1869,36,45-49,1905,6
STAT,1855,19,25-29,1874,10.04411682222666
STAT,1804,50,45-49,1854,0.08835772537921795
STAT,1926,41,35-39,1967,0.5019949141273863
SIM,1852,65,na,1917,2683
SIM,1911,15,na,1926,7979
SIM,1865,9,na,1874,5160
SIM,1906,26,30-34,1932,82
STAT,1830,52,45-49,1882,0.022031777517282913
STAT,1854,47,15-19,1901,6.103356519640986E-4
SIM,1866,49,50-100,1915,2
STAT,1904,41,15-19,1945,0.0027924199401997292
STAT,1853,75,na,1928,1628.8163973973205
SIM,1857,33,15-19,1890,3
STAT,1876,23,50-100,1899,0.8491848501177199
STAT,1865,17,50-100,1882,0.09263088239671058
SIM,1839,83,na,1922,438
STAT,1821,48,30-34,1869,0.2792620759637098
STAT,1867,35,25-29,1902,5.4975036407395415
STAT,1893,9,na,1902,6641.944307263935
STAT,1810,98,na,1908,2.9378271917847747
STAT,1862,41,35-39,1903,3.1399726287516376
STAT,1939,25,40-44,1964,9.472754698825609
SIM,1880,12,na,1892,5792
SIM,1910,25,45-49,1935,6
SIM,1938,18,25-29,1956,113
STAT,1874,25,20-24,1899,24.42422726374504
SIM,1829,37,50-100,1866,3
STAT,1912,59,na,1971,6707.055255021562
STAT,1885,47,45-49,1932,0.4722180820659963
SIM,1859,38,na,1897,4180
SIM,1895,26,45-49,1921,4
SIM,1939,30,30-34,1969,43
SIM,1915,26,40-44,1941,15
STAT,1839,46,35-39,1885,0.2255969469376223
STAT,1835,50,na,1885,2956.660395016558
STAT,1878,36,na,1914,4993.3825490491545
SIM,1889,32,50-100,1921,1
SIM,1923,34,na,1957,9071
STAT,1897,25,25-29,1922,114.97345066505669
STAT,1902,25,45-49,1927,3.187336774110338
SIM,1870,41,35-39,1911,5
STAT,1882,53,20-24,1935,0.0014284702598680165
SIM,1777,91,na,1868,22
SIM,1888,30,40-44,1918,17
SIM,1820,36,20-24,1856,2
STAT,1909,25,50-100,1934,1.9516660699017008
STAT,1880,77,na,1957,2000.3214761141815
SIM,1916,43,40-44,1959,1
STAT,1821,40,35-39,1861,6.095200286789529
STAT,1842,38,na,1880,3702.004610392824
STAT,1924,16,30-34,1940,29.37842815723903
SIM,1833,36,30-34,1869,12
STAT,1849,33,15-19,1882,0.23491603693863006
STAT,1884,30,na,1914,4797.202778646798
SIM,1822,58,na,1880,2334
STAT,1900,16,45-49,1916,0.18345860503299843
STAT,1872,42,na,1914,4685.441313552278
SIM,1784,79,na,1863,409
SIM,1864,50,na,1914,4172
STAT,1949,15,50-100,1964,0.8804296462211276
SIM,1828,35,45-49,1863,10
SIM,1889,11,na,1900,6605
STAT,1899,46,25-29,1945,0.09016291085072801
SIM,1924,17,50-100,1941,1
STAT,1868,48,20-24,1916,0.022768589005010414
STAT,1953,9,na,1962,9599.73173113391
SIM,1865,23,30-34,1888,40
SIM,1902,30,35-39,1932,39
STAT,1893,32,30-34,1925,44.694747327825525
SIM,1838,34,25-29,1872,25
SIM,1901,25,35-39,1926,33
STAT,1876,54,40-44,1930,0.021386051081850238
STAT,1903,24,15-19,1927,9.4271619812851
STAT,1892,7,na,1899,6587.111348506407
SIM,1877,23,na,1900,4883
SIM,1911,24,15-19,1935,13
SIM,1932,16,30-34,1948,38
SIM,1879,35,25-29,1914,8
SIM,1877,26,na,1903,4935
SIM,1827,98,na,1925,5
STAT,1857,35,30-34,1892,8.46948399693714
STAT,1892,27,30-34,1919,63.66729383993054
STAT,1907,19,35-39,1926,1.620032831035747
SIM,1878,70,na,1948,2833
STAT,1932,40,15-19,1972,0.004215519693605665
STAT,1814,88,na,1902,118.15031699671992
STAT,1858,49,40-44,1907,0.2639126185351637
STAT,1826,76,na,1902,1134.1416985482545
STAT,1885,29,15-19,1914,0.9055577015754608
STAT,1917,18,15-19,1935,19.670500493170763
SIM,1882,26,35-39,1908,27
STAT,1830,35,50-100,1865,2.3660433165143377
STAT,1885,40,25-29,1925,1.3039517397684006
STAT,1849,40,20-24,1889,0.25560063870842364
SIM,1856,16,15-19,1872,12
STAT,1825,36,30-34,1861,14.558326352640234
SIM,1933,24,35-39,1957,30
STAT,1859,63,na,1922,2868.249780149355
SIM,1902,38,30-34,1940,5
SIM,1915,19,35-39,1934,2
STAT,1898,50,na,1948,5969.526793144503
SIM,1796,98,na,1894,2
STAT,1850,40,50-100,1890,1.636170364098677
SIM,1860,60,na,1920,3262
SIM,1849,52,30-34,1901,1
STAT,1857,23,30-34,1880,32.138194696432706
STAT,1956,15,30-34,1971,32.58598289374749
SIM,1816,39,35-39,1855,21
SIM,1884,42,40-44,1926,6
STAT,1876,42,40-44,1918,4.692637203001881
STAT,1908,43,40-44,1951,0.464870820200936
STAT,1899,34,25-29,1933,28.10004751455508
SIM,1916,31,40-44,1947,13
STAT,1809,51,40-44,1860,0.07918144491210694
STAT,1874,26,35-39,1900,20.021636035435264
STAT,1925,24,35-39,1949,22.615562197217393
SIM,1839,86,na,1925,292
STAT,1818,38,15-19,1856,0.34840000022680884
STAT,1845,45,15-19,1890,6.225187350546882E-4
SIM,1939,23,25-29,1962,5
SIM,1893,29,15-19,1922,2
STAT,1860,26,40-44,1886,5.001524828506556
SIM,1864,24,25-29,1888,122
SIM,1880,15,na,1895,5688
SIM,1897,17,15-19,1914,16
STAT,1919,46,20-24,1965,0.024263190520983743
STAT,1937,17,na,1954,7233.242627434751
STAT,1805,103,na,1908,0.10735058058892401
STAT,1899,30,50-100,1929,2.5557582278670146
STAT,1888,24,50-100,1912,0.9673284720194271
STAT,1914,42,20-24,1956,0.03534814485335388
STAT,1880,71,na,1951,2839.885766472926
STAT,1870,36,45-49,1906,3.9717645159412696
STAT,1893,25,25-29,1918,109.02112978928032
STAT,1856,41,50-100,1897,1.6536502258081482
STAT,1916,18,na,1934,8254.189743318911
STAT,1936,32,na,1968,7420.67807210603
SIM,1845,23,45-49,1868,1
SIM,1907,24,25-29,1931,206
STAT,1825,103,na,1928,0.166052004445564
STAT,1807,52,50-100,1859,0.09837220633719028
STAT,1843,34,25-29,1877,16.894551803597466
STAT,1898,29,25-29,1927,114.78718312004719
SIM,1836,100,na,1936,1
STAT,1877,52,35-39,1929,0.017958445417732574
SIM,1841,19,40-44,1860,1
SIM,1811,45,45-49,1856,1
STAT,1921,48,35-39,1969,0.29265343337274846
STAT,1874,77,na,1951,1787.4893224365471
STAT,1891,18,na,1909,6288.359142934503
STAT,1893,20,30-34,1913,45.86933190280134
SIM,1920,36,25-29,1956,6
SIM,1848,35,30-34,1883,17
STAT,1901,17,40-44,1918,0.5171344364792045
STAT,1908,31,40-44,1939,7.495680891872302
SIM,1854,60,na,1914,3130
STAT,1875,23,15-19,1898,6.838633932479182
SIM,1851,34,25-29,1885,22
STAT,1898,24,30-34,1922,48.37777138464016
STAT,1835,41,40-44,1876,3.5371650199918827
STAT,1948,20,20-24,1968,258.01076268114576
STAT,1859,60,na,1919,3065.7706980967137
STAT,1911,16,20-24,1927,54.942712270229
STAT,1930,31,15-19,1961,0.3351243459697535
STAT,1943,11,na,1954,8425.040072327642
SIM,1815,73,na,1888,1001
SIM,1816,58,na,1874,2341
SIM,1924,24,25-29,1948,272
SIM,1876,40,25-29,1916,3
STAT,1859,50,25-29,1909,0.005775568953590141
SIM,1850,37,45-49,1887,5
STAT,1909,30,na,1939,7351.576790120516
STAT,1911,20,25-29,1931,178.03187054366865
STAT,1889,17,15-19,1906,14.778413307997567
SIM,1828,43,na,1871,3193
STAT,1934,33,40-44,1967,10.785750710052934
STAT,1826,41,30-34,1867,2.478688500576707
STAT,1905,40,20-24,1945,0.032536276560335545
STAT,1930,5,na,1935,10498.333120293615
SIM,1809,79,na,1888,555
SIM,1933,31,40-44,1964,16
STAT,1873,92,na,1965,242.1561769475995
SIM,1933,21,30-34,1954,102
STAT,1868,50,35-39,1918,0.01678025760570834
STAT,1886,62,na,1948,3896.6178184911487
STAT,1896,31,50-100,1927,2.453087144263533
SIM,1859,29,45-49,1888,3
SIM,1903,48,25-29,1951,1
SIM,1847,19,na,1866,4330
STAT,1887,26,45-49,1913,2.5165511628842383
STAT,1934,15,50-100,1949,1.028366463087583
STAT,1846,90,na,1936,120.76081633231502
STAT,1822,46,25-29,1868,0.18166484601880176
STAT,1861,31,40-44,1892,7.319848623276271
SIM,1860,34,35-39,1894,24
SIM,1875,48,50-100,1923,1
STAT,1920,20,35-39,1940,21.26233891233946
STAT,1843,22,25-29,1865,100.65569901444557
STAT,1852,34,35-39,1886,16.368206053327743
SIM,1851,22,25-29,1873,120
STAT,1849,47,40-44,1896,0.2695413588310674
STAT,1856,18,30-34,1874,2.919427125375782
STAT,1847,42,50-100,1889,1.61937533170146
STAT,1789,79,na,1868,575.0146384212238
STAT,1925,31,40-44,1956,9.388819223676514
SIM,1839,38,25-29,1877,4
SIM,1927,15,45-49,1942,5
SIM,1778,79,na,1857,473
STAT,1940,32,20-24,1972,5.098758829321964
STAT,1811,43,na,1854,2886.541539018646
SIM,1910,19,15-19,1929,16
SIM,1834,41,30-34,1875,3
STAT,1914,33,50-100,1947,1.6740237948265244
SIM,1891,38,45-49,1929,9
STAT,1785,80,na,1865,532.087165963356
SIM,1892,23,25-29,1915,182
STAT,1835,53,40-44,1888,0.013629175273141803
STAT,1896,55,na,1951,5513.40998514266
STAT,1817,44,25-29,1861,3.225738381121749
STAT,1867,24,50-100,1891,0.766476308537071
SIM,1865,28,25-29,1893,84
STAT,1832,50,20-24,1882,0.0010411083545308368
STAT,1898,36,30-34,1934,14.636311587176339
SIM,1843,41,40-44,1884,14
STAT,1902,37,45-49,1939,1.2268675107025815
STAT,1951,21,40-44,1972,8.115151101195611
SIM,1843,20,na,1863,3996
STAT,1847,18,20-24,1865,33.53037661508361
SIM,1891,55,na,1946,5449
STAT,1862,39,20-24,1901,1.3172480024787065
SIM,1889,36,30-34,1925,15
STAT,1894,40,35-39,1934,4.745373710115956
STAT,1934,21,40-44,1955,9.13022116725466
STAT,1880,47,25-29,1927,0.12197687854521087
SIM,1916,55,na,1971,7461
STAT,1912,36,25-29,1948,1.9507034767146811
STAT,1924,47,na,1971,8830.81320835239
STAT,1846,25,45-49,1871,2.087245154132022
SIM,1824,47,45-49,1871,1
STAT,1863,47,25-29,1910,0.10135633597097755
STAT,1866,48,na,1914,4139.853340939493
STAT,1902,19,15-19,1921,16.83071228316289
STAT,1857,28,25-29,1885,68.09705442283044
SIM,1891,39,50-100,1930,5
SIM,1910,37,45-49,1947,2
STAT,1884,35,25-29,1919,5.796429411909889
SIM,1911,49,na,1960,7191
SIM,1825,32,25-29,1857,18
STAT,1907,5,na,1912,7779.004782590241
SIM,1855,18,20-24,1873,28
STAT,1920,28,30-34,1948,86.48238119215168
SIM,1942,21,40-44,1963,8
STAT,1836,35,na,1871,3568.669226674355
STAT,1852,41,40-44,1893,3.601139758810548
SIM,1874,12,na,1886,5096
STAT,1841,41,50-100,1882,1.613348027453009
SIM,1907,31,30-34,1938,42
STAT,1916,24,25-29,1940,194.25511998389868
STAT,1887,10,na,1897,5851.009400003043
SIM,1780,80,na,1860,354
SIM,1796,64,na,1860,1728
STAT,1860,57,na,1917,3295.961304810474
STAT,1884,23,25-29,1907,113.81046848436786
SIM,1875,42,30-34,1917,4
STAT,1885,18,na,1903,5063.914050410985
SIM,1854,25,45-49,1879,3
STAT,1909,49,30-34,1958,0.1645569790656843
STAT,1851,26,30-34,1877,46.03691331365371
STAT,1866,11,na,1877,5040.570119203071
SIM,1938,25,30-34,1963,100
STAT,1841,52,20-24,1893,0.0010649695605252432
STAT,1856,24,25-29,1880,102.11763712298716
SIM,1860,48,50-100,1908,2
SIM,1903,36,25-29,1939,3
SIM,1834,34,25-29,1868,15
STAT,1815,106,na,1921,0.011285697185897878
STAT,1839,35,50-100,1874,2.3389507551870885
SIM,1891,15,20-24,1906,47
SIM,1839,33,30-34,1872,39
SIM,1870,39,20-24,1909,2
STAT,1931,26,na,1957,9772.530840322715
SIM,1875,30,30-34,1905,51
STAT,1816,47,45-49,1863,1.1595655846730524
STAT,1837,23,45-49,1860,1.2634569380182186
STAT,1816,51,50-100,1867,0.07262025644523142
STAT,1915,27,45-49,1942,3.5591142520440973
SIM,1838,18,20-24,1856,40
SIM,1853,13,na,1866,4780
SIM,1923,27,45-49,1950,2
STAT,1841,50,na,1891,3168.989894116905
STAT,1883,38,45-49,1921,3.9360027035203355
STAT,1826,34,25-29,1860,27.011564977887254
STAT,1890,30,50-100,1920,2.27684381834607
SIM,1855,19,50-100,1874,2
STAT,1853,78,na,1931,1236.2257440533974
STAT,1791,80,na,1871,513.494998912395
STAT,1931,30,20-24,1961,6.462448471576211
STAT,1909,41,35-39,1950,0.38278495746698143
STAT,1821,50,45-49,1871,0.042518079966194965
SIM,1897,37,35-39,1934,29
STAT,1903,45,na,1948,6535.271089536917
STAT,1843,38,40-44,1881,6.447091102663742
SIM,1928,40,na,1968,9735
STAT,1814,51,15-19,1865,1.246106715636197E-4
STAT,1849,43,25-29,1892,1.0084252284754567
STAT,1828,71,na,1899,1639.2094462894577
SIM,1849,42,50-100,1891,8
SIM,1849,45,na,1894,3726
STAT,1872,15,45-49,1887,0.13460484044913823
STAT,1906,15,35-39,1921,1.6223230843971324
SIM,1846,19,25-29,1865,18
STAT,1898,49,45-49,1947,0.35624195234809797
STAT,1902,22,40-44,1924,5.941660340551325
SIM,1851,49,50-100,1900,2
SIM,1808,91,na,1899,36
SIM,1905,12,na,1917,7795
SIM,1942,18,15-19,1960,91
STAT,1861,28,15-19,1889,0.7627029845748269
STAT,1907,18,50-100,1925,0.14504463443059765
STAT,1926,27,20-24,1953,44.186215543968856
STAT,1897,19,30-34,1916,4.279801329534317
SIM,1846,31,na,1877,3990
SIM,1934,27,20-24,1961,56
SIM,1924,40,50-100,1964,1
SIM,1848,31,15-19,1879,3
SIM,1883,26,na,1909,4956
SIM,1908,26,na,1934,7165
STAT,1821,36,na,1857,3187.6220427267067
STAT,1916,40,50-100,1956,0.24381630652218714
SIM,1798,90,na,1888,27
SIM,1887,84,na,1971,1610
SIM,1902,2,na,1904,7782
SIM,1838,28,30-34,1866,50
SIM,1893,44,40-44,1937,1
SIM,1938,15,20-24,1953,272
SIM,1892,30,30-34,1922,64
SIM,1924,28,40-44,1952,18
STAT,1773,95,na,1868,4.571405693207218
STAT,1851,24,40-44,1875,3.802393327155481
SIM,1861,79,na,1940,1147
STAT,1890,30,na,1920,5929.914255167444
STAT,1893,44,na,1937,5856.787493344844
STAT,1929,1,na,1930,10762.595933685507
STAT,1899,31,20-24,1930,7.510305303173629
SIM,1898,25,na,1923,6790
STAT,1930,38,35-39,1968,6.365261852867033
SIM,1871,33,50-100,1904,3
STAT,1915,30,na,1945,7842.488875547264
SIM,1858,42,30-34,1900,3
SIM,1873,16,15-19,1889,17
STAT,1838,19,25-29,1857,10.011410309365438
STAT,1833,25,35-39,1858,17.04256618247509
STAT,1939,27,30-34,1966,79.56247324217559
STAT,1882,18,40-44,1900,0.3589000806652198
STAT,1884,30,30-34,1914,35.09928211963648
SIM,1857,71,na,1928,2343
STAT,1930,25,20-24,1955,46.917027745374824
SIM,1861,37,20-24,1898,2
SIM,1932,19,35-39,1951,11
STAT,1860,23,na,1883,3969.856905035673
SIM,1818,84,na,1902,267
SIM,1934,31,25-29,1965,30
SIM,1840,42,50-100,1882,6
SIM,1842,26,30-34,1868,66
STAT,1921,38,25-29,1959,2.2175758000674284
SIM,1855,30,45-49,1885,2
STAT,1874,16,50-100,1890,0.10155985325038909
STAT,1865,16,15-19,1881,11.287171263636713
SIM,1947,5,na,1952,9373
STAT,1912,26,15-19,1938,1.4102247145834215
SIM,1865,38,35-39,1903,19
SIM,1889,46,40-44,1935,1
STAT,1862,89,na,1951,181.34351961830677
SIM,1920,26,15-19,1946,5
STAT,1814,44,50-100,1858,5.680883993475377
STAT,1895,48,15-19,1943,5.863221120164071E-4
SIM,1851,38,40-44,1889,12
STAT,1853,37,20-24,1890,1.2196382323452417
STAT,1883,18,25-29,1901,11.214878208339071
SIM,1903,7,na,1910,7703
STAT,1839,49,na,1888,3488.709325570797
STAT,1819,94,na,1913,20.91296573202638
STAT,1859,54,40-44,1913,0.01645770909643674
SIM,1845,86,na,1931,258
STAT,1924,19,35-39,1943,10.035000096170853
STAT,1834,26,30-34,1860,44.27266128270056
STAT,1934,18,15-19,1952,123.66852870431829
SIM,1863,2,na,1865,6006
STAT,1863,49,15-19,1912,6.923947181892104E-4
SIM,1862,27,na,1889,4415
SIM,1929,16,25-29,1945,144
STAT,1804,110,na,1914,1.8589785157244833E-4
SIM,1947,2,na,1949,9479
STAT,1826,44,35-39,1870,3.6729077868608933
STAT,1842,17,25-29,1859,10.833840388623432
STAT,1842,37,45-49,1879,3.4816078323161386
STAT,1885,15,na,1900,5100.805844925008
SIM,1911,28,30-34,1939,85
STAT,1925,21,30-34,1946,69.67659036452362
STAT,1944,25,15-19,1969,1.5422090803149673
STAT,1870,19,na,1889,4996.166440598765
SIM,1942,26,35-39,1968,55
STAT,1893,35,35-39,1928,18.27776955073049
STAT,1913,47,30-34,1960,0.1757715594105964
STAT,1875,27,30-34,1902,52.362022889346456
STAT,1900,34,na,1934,6628.308561179419
SIM,1866,30,20-24,1896,7
STAT,1907,16,30-34,1923,4.7428019614183325
SIM,1805,80,na,1885,424
SIM,1864,18,30-34,1882,5
SIM,1913,41,na,1954,7485
SIM,1896,31,45-49,1927,7
SIM,1829,40,45-49,1869,3
SIM,1848,45,40-44,1893,1
STAT,1825,39,35-39,1864,17.24996622837377
SIM,1878,26,45-49,1904,4
SIM,1879,52,na,1931,4407
STAT,1849,106,na,1955,0.019205703802556307
SIM,1834,44,35-39,1878,6
STAT,1903,28,30-34,1931,72.15723320113385
STAT,1832,42,50-100,1874,1.684951072134735
STAT,1871,39,30-34,1910,10.58624873774998
STAT,1829,109,na,1938,8.420191042998638E-4
STAT,1835,38,15-19,1873,0.08902568624478026
STAT,1856,18,50-100,1874,0.08973647126515377
SIM,1883,23,15-19,1906,7
SIM,1906,29,35-39,1935,36
STAT,1871,35,15-19,1906,0.11374505938541309
STAT,1934,26,35-39,1960,40.81440429080197
SIM,1906,24,40-44,1930,7
STAT,1874,23,30-34,1897,36.72046617199139
STAT,1818,53,40-44,1871,0.043626342396987816
STAT,1885,44,40-44,1929,4.460676026242065
STAT,1894,45,50-100,1939,0.3630080698280368
SIM,1915,16,30-34,1931,9
STAT,1908,28,15-19,1936,1.3439543839774792
STAT,1908,46,45-49,1954,0.4002231289247284
SIM,1883,27,30-34,1910,65
SIM,1856,36,35-39,1892,19
STAT,1821,39,na,1860,3103.4305050106555
SIM,1833,39,35-39,1872,20
STAT,1873,51,20-24,1924,0.0015214971137560904
STAT,1883,15,20-24,1898,35.341696118472285
STAT,1832,76,na,1908,1235.147073955912
STAT,1918,44,na,1962,7946.995121578613
SIM,1820,39,25-29,1859,10
SIM,1888,25,25-29,1913,104
SIM,1864,53,na,1917,4027
SIM,1875,32,20-24,1907,6
STAT,1911,19,25-29,1930,17.4248524159133
STAT,1792,68,na,1860,1423.1800728039439
SIM,1921,47,30-34,1968,1
SIM,1857,47,40-44,1904,1
SIM,1850,17,25-29,1867,13
STAT,1865,63,na,1928,3273.8614848124685
STAT,1821,38,20-24,1859,2.83792836300412
STAT,1847,75,na,1922,1569.252111666422
SIM,1879,39,40-44,1918,12
STAT,1923,32,50-100,1955,1.9136573960783858
STAT,1941,17,45-49,1958,1.039210334952711
STAT,1881,42,15-19,1923,0.02692472018897393
STAT,1860,22,25-29,1882,96.78464570105595
STAT,1889,24,20-24,1913,170.53385942793508
STAT,1825,100,na,1925,1.2283612260049706
STAT,1852,90,na,1942,125.65690251110964
SIM,1842,72,na,1914,1721
STAT,1839,26,15-19,1865,0.8989093355583699
STAT,1904,48,35-39,1952,0.22604191864806553
SIM,1864,41,50-100,1905,4
SIM,1895,11,na,1906,7235
STAT,1866,21,15-19,1887,6.242683159574233
STAT,1900,31,na,1931,6712.86892696842
STAT,1913,31,15-19,1944,0.25933376385967605
SIM,1906,42,50-100,1948,1
STAT,1857,38,35-39,1895,11.078945796803955
SIM,1874,21,15-19,1895,8
SIM,1914,15,35-39,1929,1
SIM,1897,24,20-24,1921,198
STAT,1888,31,45-49,1919,4.179628231014124
SIM,1928,20,45-49,1948,6
SIM,1916,52,na,1968,7588
SIM,1816,46,40-44,1862,1
SIM,1839,35,20-24,1874,1
SIM,1948,22,20-24,1970,278
SIM,1860,31,30-34,1891,45
STAT,1841,17,40-44,1858,0.34226987702590345
STAT,1836,38,na,1874,3459.214659888069
SIM,1929,26,35-39,1955,51
STAT,1816,83,na,1899,389.9414728389826
SIM,1833,98,na,1931,2
SIM,1924,22,35-39,1946,24
SIM,1884,47,50-100,1931,2
SIM,1891,28,35-39,1919,27
SIM,1893,40,25-29,1933,3
STAT,1870,101,na,1971,10.02888295906773
SIM,1834,31,20-24,1865,7
STAT,1876,47,50-100,1923,0.5106322054668166
STAT,1813,46,15-19,1859,0.002511438328256977
STAT,1875,37,40-44,1912,9.102367367274061
STAT,1898,26,20-24,1924,32.173117667126796
STAT,1848,36,35-39,1884,12.076220394671799
SIM,1886,3,na,1889,5907
STAT,1873,20,45-49,1893,1.4394808230226663
STAT,1870,33,40-44,1903,8.56267204304863
STAT,1893,22,20-24,1915,176.407580513513
SIM,1871,38,na,1909,4567
SIM,1840,46,na,1886,3632
STAT,1894,38,20-24,1932,1.9899684533252657
STAT,1927,37,15-19,1964,0.04821212003019974
SIM,1939,20,20-24,1959,237
STAT,1920,30,45-49,1950,3.5081961516131273
SIM,1892,39,40-44,1931,22
SIM,1931,32,50-100,1963,1
STAT,1929,22,45-49,1951,2.873377775927844
SIM,1885,52,na,1937,4546
STAT,1925,34,45-49,1959,3.768250455073944
STAT,1857,37,na,1894,3708.772034328843
STAT,1883,28,35-39,1911,19.078717481676716
STAT,1916,22,35-39,1938,19.926644327885533
SIM,1870,53,na,1923,4128
STAT,1852,31,30-34,1883,29.11276373242315
STAT,1808,46,40-44,1854,1.1146122420195828
STAT,1770,84,na,1854,170.0
SIM,1825,48,40-44,1873,1
STAT,1786,68,na,1854,1254.0
STAT,1952,17,20-24,1969,328.099171649661
SIM,1886,37,na,1923,4937
STAT,1875,22,na,1897,4917.767544134821
STAT,1822,48,15-19,1870,0.0012258195006323535
STAT,1862,51,45-49,1913,0.025171208289840565
SIM,1903,33,20-24,1936,6
SIM,1950,18,40-44,1968,6
SIM,1916,36,35-39,1952,6
SIM,1933,34,45-49,1967,5
SIM,1874,35,40-44,1909,8
SIM,1857,26,50-100,1883,3
SIM,1891,52,na,1943,5649
STAT,1834,22,15-19,1856,5.873176319381868
STAT,1942,18,40-44,1960,2.9512124139828284
SIM,1880,32,50-100,1912,4
STAT,1850,19,40-44,1869,0.3386678446222333
SIM,1938,28,35-39,1966,41
STAT,1869,22,45-49,1891,1.364616154382286
STAT,1866,35,40-44,1901,8.234859419892297
STAT,1859,103,na,1962,0.7684416145559566
STAT,1884,20,20-24,1904,138.25013823958045
STAT,1918,35,15-19,1953,0.041259743122122154
SIM,1837,22,40-44,1859,3
SIM,1848,97,na,1945,5
STAT,1880,37,15-19,1917,0.11947293026578981
STAT,1948,23,25-29,1971,214.11100968776165
STAT,1908,7,na,1915,7810.570605029321
SIM,1865,38,na,1903,4359
STAT,1839,21,20-24,1860,139.25556259778358
SIM,1892,20,20-24,1912,186
STAT,1933,16,40-44,1949,3.791185302816766
STAT,1791,83,na,1874,272.18540841491705
STAT,1908,36,35-39,1944,4.598690049493664
STAT,1917,48,45-49,1965,0.4571643383021145
SIM,1838,38,40-44,1876,12
SIM,1847,21,20-24,1868,142
STAT,1926,31,25-29,1957,22.580426764280084
SIM,1883,37,40-44,1920,13
STAT,1808,54,na,1862,2361.23427815749
SIM,1841,25,35-39,1866,24
STAT,1899,41,30-34,1940,0.22191499243659768
STAT,1919,29,na,1948,8114.652184873958
SIM,1891,18,25-29,1909,15
STAT,1817,48,40-44,1865,0.8140284314309653
STAT,1836,49,20-24,1885,0.016278573087459183
STAT,1871,53,45-49,1924,0.028651833893913042
STAT,1831,45,20-24,1876,0.01884055143171808
SIM,1833,61,na,1894,2431
SIM,1834,46,na,1880,3148
STAT,1898,39,35-39,1937,4.130414718975286
STAT,1850,107,na,1957,0.011532634505227008
SIM,1831,32,na,1863,3839
SIM,1941,22,na,1963,7721
STAT,1922,43,25-29,1965,0.1652287749883021
SIM,1877,22,45-49,1899,4
SIM,1941,16,40-44,1957,3
STAT,1863,44,20-24,1907,0.2769758560144788
STAT,1892,25,40-44,1917,7.6250542014280045
STAT,1838,110,na,1948,3.739868767868224E-4
STAT,1858,43,35-39,1901,2.830383565037067
SIM,1901,20,40-44,1921,6
STAT,1801,84,na,1885,239.8576593755558
STAT,1866,31,25-29,1897,19.164886545627773
STAT,1856,32,45-49,1888,2.7505554742601555
STAT,1897,29,40-44,1926,8.029150950201869
SIM,1860,21,20-24,1881,135
SIM,1866,43,35-39,1909,5
SIM,1907,34,35-39,1941,28
SIM,1865,25,20-24,1890,22
SIM,1842,36,40-44,1878,12
SIM,1856,23,20-24,1879,142
SIM,1864,32,45-49,1896,4
STAT,1830,34,15-19,1864,0.27279653620672817
STAT,1847,30,45-49,1877,3.186537152646986
STAT,1852,44,45-49,1896,2.3531625433720866
SIM,1822,44,50-100,1866,3
SIM,1898,31,50-100,1929,6
SIM,1924,1,na,1925,10266
STAT,1858,40,30-34,1898,1.8283228783953434
STAT,1849,26,50-100,1875,1.2081446729483845
SIM,1813,47,na,1860,2900
STAT,1872,32,50-100,1904,1.8597407155056325
SIM,1888,66,na,1954,3886
STAT,1827,47,20-24,1874,0.021671843170941875
STAT,1903,42,45-49,1945,0.29848858060010275
STAT,1848,23,20-24,1871,136.59672464898935
SIM,1839,48,35-39,1887,1
SIM,1915,41,50-100,1956,1
SIM,1808,54,35-39,1862,1
STAT,1822,43,20-24,1865,0.5202462016049298
SIM,1762,92,na,1854,9
SIM,1921,37,20-24,1958,1
STAT,1872,46,20-24,1918,0.024426040763914064
SIM,1783,91,na,1874,20
STAT,1904,35,20-24,1939,0.4868755118877119
SIM,1799,75,na,1874,712
SIM,1894,66,na,1960,4578
STAT,1826,31,20-24,1857,8.717173565952054
SIM,1850,27,35-39,1877,23
SIM,1879,29,30-34,1908,70
STAT,1860,104,na,1964,0.5175628017202413
STAT,1888,29,na,1917,5656.070402858598
STAT,1907,41,50-100,1948,0.21875089172666362
STAT,1952,1,na,1953,9801.506761619388
STAT,1848,23,na,1871,4238.146595445051
STAT,1889,37,35-39,1926,17.613221410417175
STAT,1867,45,35-39,1912,0.2674393810712042
SIM,1910,22,40-44,1932,8
SIM,1940,31,50-100,1971,3
STAT,1916,28,40-44,1944,9.698943241741702
STAT,1854,23,na,1877,3823.5572771688417
STAT,1884,39,40-44,1923,8.642061788140868
STAT,1877,88,na,1965,640.8271171693875
STAT,1935,29,20-24,1964,50.21278137098006
SIM,1904,67,na,1971,5295
STAT,1851,29,35-39,1880,17.26268493917806
STAT,1825,34,40-44,1859,12.951194793684971
STAT,1833,24,na,1857,3721.834488178258
SIM,1833,34,40-44,1867,1
STAT,1856,89,na,1945,163.69819854070383
STAT,1885,46,50-100,1931,0.49513052874883806
STAT,1906,59,na,1965,6133.257139500361
SIM,1829,30,35-39,1859,25
STAT,1934,36,45-49,1970,1.9019675280352153
STAT,1869,22,na,1891,4628.25711997998
STAT,1785,83,na,1868,282.0404539222785
STAT,1879,17,20-24,1896,37.45111684840784
SIM,1778,76,na,1854,615
SIM,1873,67,na,1940,3184
STAT,1857,25,20-24,1882,19.298055961475775
STAT,1772,117,na,1889,1.2106059202905006E-4
STAT,1932,31,50-100,1963,2.221226823623805
