Source,YOB,Age,NPA,Date,freq
SIM,1930,26,45-49,1956,4
SIM,1896,0,na,1896,3683
STAT,1868,71,na,1939,1288.4708499023152
SIM,1875,18,na,1893,2474
SIM,1921,20,35-39,1941,9
STAT,1839,17,35-39,1856,0.5088945332794268
STAT,1876,90,na,1966,219.6070319802316
STAT,1906,62,na,1968,2967.8019076568203
STAT,1890,48,20-24,1938,0.008249065435627857
SIM,1867,4,na,1871,2611
STAT,1810,57,na,1867,1277.1785769319379
SIM,1905,65,na,1970,2820
SIM,1859,55,na,1914,1919
SIM,1907,17,30-34,1924,4
SIM,1931,19,15-19,1950,56
STAT,1838,30,15-19,1868,0.12094496921404044
SIM,1863,60,na,1923,1731
STAT,1871,18,50-100,1889,0.04918570787365784
SIM,1867,74,na,1941,972
SIM,1901,51,na,1952,3122
SIM,1910,27,30-34,1937,47
STAT,1784,99,na,1883,0.30744357179152493
SIM,1941,16,na,1957,3967
STAT,1917,14,na,1931,4275.888158860947
SIM,1839,40,25-29,1879,2
STAT,1898,31,25-29,1929,14.08157566676836
STAT,1927,35,35-39,1962,3.044809064790277
SIM,1902,49,50-100,1951,3
STAT,1934,25,25-29,1959,89.54563316053141
STAT,1925,27,25-29,1952,78.56653586764948
SIM,1907,9,na,1916,4080
STAT,1925,33,na,1958,4536.03038148138
SIM,1884,2,na,1886,3040
SIM,1909,25,40-44,1934,10
SIM,1933,27,25-29,1960,112
STAT,1907,36,20-24,1943,0.247968646181976
SIM,1888,68,na,1956,1992
STAT,1902,27,30-34,1929,35.941119626918294
STAT,1855,21,na,1876,1893.7915677177737
STAT,1859,35,na,1894,1932.020078939893
STAT,1829,32,15-19,1861,0.12684280713028723
SIM,1860,40,50-100,1900,1
SIM,1872,47,50-100,1919,3
STAT,1942,24,20-24,1966,117.63303228916787
SIM,1797,62,na,1859,822
STAT,1913,20,35-39,1933,9.26081715482912
STAT,1922,26,45-49,1948,1.9816751534262524
SIM,1833,62,na,1895,1307
SIM,1878,16,25-29,1894,7
SIM,1924,7,na,1931,4835
STAT,1931,24,45-49,1955,1.4656317988855272
STAT,1916,34,20-24,1950,2.5195873974074496
SIM,1876,35,na,1911,2764
SIM,1869,23,20-24,1892,74
SIM,1914,26,na,1940,3995
SIM,1940,17,15-19,1957,49
STAT,1932,17,15-19,1949,60.73000716967833
SIM,1912,22,35-39,1934,18
STAT,1893,70,na,1963,2018.3268590300797
STAT,1815,88,na,1903,59.427099308207644
STAT,1918,42,30-34,1960,0.13722895611312455
SIM,1844,53,50-100,1897,1
STAT,1900,19,20-24,1919,24.739936750662274
STAT,1844,69,na,1913,1161.097138662426
STAT,1923,19,15-19,1942,53.55574045943462
STAT,1909,44,30-34,1953,0.11918469884908055
SIM,1875,93,na,1968,47
STAT,1896,23,15-19,1919,4.396906614836745
SIM,1904,25,50-100,1929,5
STAT,1909,31,25-29,1940,8.93659977621413
STAT,1852,88,na,1940,104.11476932283165
SIM,1924,34,20-24,1958,3
SIM,1970,1,na,1971,5241
SIM,1875,20,40-44,1895,2
STAT,1907,23,15-19,1930,4.878084366206158
STAT,1940,30,50-100,1970,0.864849996489458
STAT,1941,15,15-19,1956,47.219072396519394
SIM,1858,38,na,1896,1907
STAT,1787,105,na,1892,0.009548526432741046
STAT,1912,41,25-29,1953,0.06988517928854142
SIM,1854,24,na,1878,2300
STAT,1849,24,40-44,1873,1.9416057487357894
STAT,1826,40,na,1866,1525.005988750946
STAT,1904,22,35-39,1926,8.458054543980527
SIM,1860,6,na,1866,2563
STAT,1924,48,15-19,1972,4.419272423952411E-4
STAT,1801,96,na,1897,3.4173217357474734
STAT,1958,3,na,1961,5218.670386052678
STAT,1855,101,na,1956,0.5130445394931862
SIM,1850,10,na,1860,2295
SIM,1825,43,na,1868,1346
SIM,1829,57,na,1886,1390
SIM,1865,30,25-29,1895,11
SIM,1917,39,35-39,1956,7
STAT,1867,15,45-49,1882,0.06427678704443708
STAT,1829,101,na,1930,0.3364613038416103
STAT,1901,18,25-29,1919,8.002258635926506
STAT,1929,7,na,1936,5156.221166405695
SIM,1941,5,na,1946,4316
STAT,1943,23,25-29,1966,99.19717125726568
SIM,1915,23,15-19,1938,7
STAT,1867,20,40-44,1887,2.019222270716616
STAT,1920,18,35-39,1938,4.74167029956492
SIM,1884,54,na,1938,2210
SIM,1953,3,na,1956,4926
STAT,1841,48,25-29,1889,0.042718570009805286
STAT,1942,13,na,1955,4144.020496397351
SIM,1934,36,30-34,1970,2
SIM,1880,40,na,1920,2226
SIM,1939,28,30-34,1967,59
STAT,1838,41,na,1879,1667.1898176020493
STAT,1903,26,35-39,1929,13.926776205178612
STAT,1905,34,45-49,1939,1.4494817090241856
SIM,1884,22,na,1906,2522
STAT,1899,18,45-49,1917,0.09030967869973007
STAT,1855,22,15-19,1877,2.9010453550513358
STAT,1848,15,35-39,1863,0.5619605306148043
SIM,1926,17,40-44,1943,1
STAT,1809,60,na,1869,1155.7842801237264
SIM,1863,22,15-19,1885,3
STAT,1929,43,45-49,1972,0.2175034912217898
SIM,1887,46,50-100,1933,2
SIM,1935,35,35-39,1970,4
STAT,1827,89,na,1916,62.470992097163375
STAT,1920,23,30-34,1943,32.16677925571203
STAT,1922,31,40-44,1953,4.485072094384219
SIM,1940,20,45-49,1960,2
STAT,1857,30,25-29,1887,8.293988599321041
SIM,1917,31,25-29,1948,14
SIM,1888,36,na,1924,2931
SIM,1912,35,40-44,1947,2
SIM,1905,36,50-100,1941,3
STAT,1904,35,40-44,1939,1.3824829575771873
SIM,1892,73,na,1965,1907
SIM,1850,42,na,1892,1917
SIM,1857,24,40-44,1881,1
SIM,1839,20,30-34,1859,29
STAT,1910,33,15-19,1943,0.12448213585970319
SIM,1911,26,35-39,1937,2
SIM,1856,15,35-39,1871,3
SIM,1847,22,30-34,1869,21
STAT,1878,15,20-24,1893,18.67392388545416
STAT,1765,96,na,1861,1.2353282140110873
SIM,1882,42,50-100,1924,2
STAT,1912,21,30-34,1933,27.873367273782947
STAT,1926,36,30-34,1962,2.2532258542531305
SIM,1822,78,na,1900,353
SIM,1916,35,25-29,1951,1
SIM,1863,92,na,1955,44
STAT,1934,30,20-24,1964,3.368819215732818
STAT,1917,46,na,1963,3882.9595969718885
STAT,1938,18,20-24,1956,134.96916647052853
SIM,1902,20,25-29,1922,127
SIM,1950,19,25-29,1969,62
STAT,1944,27,35-39,1971,16.385817548338323
STAT,1913,32,na,1945,3796.5998124377616
SIM,1884,30,35-39,1914,10
STAT,1942,19,25-29,1961,45.693837176865976
SIM,1856,90,na,1946,1
SIM,1909,29,50-100,1938,1
SIM,1929,18,20-24,1947,257
SIM,1930,32,na,1962,5196
SIM,1925,38,30-34,1963,3
STAT,1932,20,45-49,1952,1.5008443944815073
SIM,1797,94,na,1891,5
STAT,1831,94,na,1925,12.55926137482655
SIM,1863,17,na,1880,2432
STAT,1914,32,45-49,1946,1.59813273826094
STAT,1950,15,50-100,1965,0.44780400103081297
STAT,1915,25,15-19,1940,0.731505311700736
STAT,1822,58,na,1880,1197.9437695987313
STAT,1910,16,25-29,1926,8.684498694602373
SIM,1913,34,45-49,1947,1
STAT,1919,41,35-39,1960,0.2206468044451425
STAT,1839,90,na,1929,55.895823147535765
SIM,1896,30,50-100,1926,1
STAT,1954,14,na,1968,4904.307529304515
STAT,1858,17,45-49,1875,0.06046334737166346
STAT,1894,2,na,1896,3466.2518958862574
STAT,1944,18,50-100,1962,0.4070098003288527
STAT,1917,30,20-24,1947,2.5988929607278686
SIM,1937,33,50-100,1970,1
STAT,1944,15,40-44,1959,1.5207959362635122
STAT,1877,4,na,1881,3014.7917102084634
SIM,1905,32,45-49,1937,1
SIM,1936,31,35-39,1967,15
STAT,1897,52,na,1949,2900.074352639077
STAT,1903,39,40-44,1942,1.3453998129984026
STAT,1922,9,na,1931,4654.252602853338
STAT,1908,35,25-29,1943,0.9394142178487601
STAT,1934,38,30-34,1972,2.5387559261684878
SIM,1887,19,na,1906,2791
SIM,1911,23,30-34,1934,38
SIM,1923,25,15-19,1948,1
SIM,1920,21,30-34,1941,44
STAT,1899,23,40-44,1922,2.8795501038624667
SIM,1793,80,na,1873,219
STAT,1917,38,30-34,1955,1.9013429141650682
SIM,1907,37,25-29,1944,1
SIM,1880,72,na,1952,1060
SIM,1884,86,na,1970,383
STAT,1905,13,na,1918,3764.8681892567424
STAT,1772,98,na,1870,0.4101926393049128
STAT,1848,20,30-34,1868,17.964623864673122
STAT,1927,40,30-34,1967,0.16251002841360138
STAT,1839,22,30-34,1861,16.22602907355458
STAT,1871,46,45-49,1917,0.23748045541878957
SIM,1888,18,35-39,1906,2
STAT,1909,27,na,1936,3612.7443803446554
STAT,1813,97,na,1910,2.3555073650034095
STAT,1940,22,45-49,1962,1.1571575862610723
SIM,1894,32,na,1926,3386
SIM,1804,81,na,1885,163
STAT,1882,49,25-29,1931,0.055176215471395444
STAT,1889,33,na,1922,2959.356517828449
STAT,1933,26,20-24,1959,24.50336729253173
STAT,1927,24,na,1951,4519.087334562728
STAT,1919,49,45-49,1968,0.23661997420683462
SIM,1898,25,40-44,1923,8
SIM,1935,15,40-44,1950,7
STAT,1885,83,na,1968,724.360872013682
STAT,1923,22,45-49,1945,1.322787598733643
STAT,1864,20,15-19,1884,3.099385620596493
STAT,1865,49,25-29,1914,0.052012799593895674
STAT,1924,23,15-19,1947,6.327675758133794
SIM,1868,48,na,1916,2074
SIM,1952,15,40-44,1967,1
STAT,1913,28,45-49,1941,1.7307262952068143
SIM,1833,47,50-100,1880,1
STAT,1845,43,na,1888,1697.8346797301558
SIM,1904,33,40-44,1937,4
SIM,1941,26,20-24,1967,26
SIM,1872,53,na,1925,2377
SIM,1925,25,25-29,1950,99
STAT,1908,40,20-24,1948,0.016680734356772153
SIM,1843,40,na,1883,2202
STAT,1869,25,20-24,1894,11.597952287019488
STAT,1912,29,40-44,1941,4.601010050654863
SIM,1921,28,45-49,1949,2
SIM,1942,25,25-29,1967,75
SIM,1902,33,30-34,1935,3
STAT,1889,65,na,1954,2104.669502979406
SIM,1899,24,45-49,1923,1
STAT,1826,72,na,1898,692.9761757843672
STAT,1837,24,na,1861,1882.0632507360936
SIM,1876,67,na,1943,1683
STAT,1806,105,na,1911,0.009885812816062895
SIM,1922,32,45-49,1954,4
STAT,1885,51,na,1936,2175.077395681735
STAT,1918,37,35-39,1955,2.573817993995708
SIM,1893,20,35-39,1913,7
STAT,1913,33,40-44,1946,3.911801568490423
SIM,1922,45,na,1967,4769
STAT,1859,21,45-49,1880,0.6505174676303355
STAT,1927,15,40-44,1942,1.765988609870725
STAT,1920,43,25-29,1963,0.07951685238153242
STAT,1930,40,50-100,1970,0.1566649767561428
SIM,1920,29,40-44,1949,9
SIM,1847,17,35-39,1864,2
SIM,1842,31,50-100,1873,4
SIM,1872,20,15-19,1892,4
STAT,1810,54,30-34,1864,0.02094866207290235
SIM,1922,13,na,1935,5133
STAT,1903,43,25-29,1946,0.06367938087147684
STAT,1940,19,15-19,1959,46.488527302679344
SIM,1839,35,na,1874,1739
SIM,1901,29,30-34,1930,47
SIM,1925,30,20-24,1955,2
SIM,1926,37,35-39,1963,3
STAT,1930,20,35-39,1950,12.26452160421218
SIM,1931,22,45-49,1953,1
STAT,1818,53,na,1871,1311.5511767182945
STAT,1846,60,na,1906,1447.3298232761035
SIM,1835,21,na,1856,1652
STAT,1861,33,50-100,1894,0.7657415514121907
SIM,1887,23,15-19,1910,3
SIM,1901,21,20-24,1922,133
STAT,1800,79,na,1879,252.26683794942073
STAT,1875,17,45-49,1892,0.06775364437826836
STAT,1780,85,na,1865,74.31154115540528
STAT,1876,15,na,1891,2646.047595870104
STAT,1822,106,na,1928,0.006788705236295141
SIM,1789,75,na,1864,386
SIM,1900,17,20-24,1917,33
STAT,1939,25,na,1964,3805.2215600724517
SIM,1926,27,na,1953,4392
STAT,1930,28,45-49,1958,2.219226940498849
STAT,1810,49,35-39,1859,0.5207152608538079
STAT,1858,22,40-44,1880,1.8944986652488085
STAT,1860,45,30-34,1905,0.08071742542851001
STAT,1917,25,25-29,1942,70.14766268474087
SIM,1848,71,na,1919,944
SIM,1946,18,20-24,1964,148
STAT,1877,32,na,1909,2487.5462858359233
SIM,1866,22,40-44,1888,3
STAT,1876,30,35-39,1906,10.645829646320504
STAT,1935,11,na,1946,5480.810331107013
STAT,1808,54,50-100,1862,0.049065921894692284
STAT,1908,48,30-34,1956,0.08115707505705935
STAT,1924,36,20-24,1960,0.314395357017221
SIM,1938,28,na,1966,3580
STAT,1926,44,30-34,1970,0.15875809790947343
STAT,1907,3,na,1910,3921.122869036453
SIM,1916,27,25-29,1943,83
SIM,1934,14,na,1948,5505
STAT,1910,21,20-24,1931,105.67060415966492
SIM,1904,48,na,1952,3343
STAT,1835,103,na,1938,0.1077148816161459
SIM,1864,33,50-100,1897,1
STAT,1851,39,na,1890,1765.9628215237678
STAT,1835,76,na,1911,711.0717194400593
STAT,1875,22,40-44,1897,2.161362965136146
STAT,1891,39,25-29,1930,3.564137121390069
STAT,1855,30,15-19,1885,0.11143517681315514
STAT,1902,31,15-19,1933,0.20408340398438077
SIM,1868,16,na,1884,2394
SIM,1889,31,25-29,1920,5
SIM,1857,27,45-49,1884,4
STAT,1858,18,na,1876,2112.1763701428545
SIM,1885,71,na,1956,1300
STAT,1914,24,45-49,1938,1.1525576030401805
SIM,1881,9,na,1890,2280
STAT,1916,46,15-19,1962,3.82242068704505E-4
STAT,1931,21,40-44,1952,4.420650249776868
SIM,1834,36,na,1870,1919
SIM,1918,35,35-39,1953,7
STAT,1904,38,45-49,1942,0.6205576745650779
STAT,1864,20,50-100,1884,0.3831132234125418
STAT,1942,27,25-29,1969,69.74939893640419
SIM,1848,21,35-39,1869,11
SIM,1930,23,40-44,1953,8
STAT,1809,103,na,1912,0.0662678989341938
STAT,1848,40,25-29,1888,0.5372401145285811
STAT,1922,43,35-39,1965,0.23312396716189004
SIM,1802,58,na,1860,1126
SIM,1872,16,30-34,1888,2
STAT,1846,32,15-19,1878,0.12771300721323248
SIM,1920,37,40-44,1957,2
SIM,1829,31,50-100,1860,1
SIM,1892,32,50-100,1924,2
STAT,1920,35,25-29,1955,1.090519651829421
SIM,1948,18,30-34,1966,18
SIM,1932,23,15-19,1955,5
STAT,1930,42,30-34,1972,0.1700164312014898
STAT,1885,20,35-39,1905,5.901631902312302
SIM,1826,60,na,1886,1440
SIM,1888,23,30-34,1911,43
SIM,1851,91,na,1942,33
STAT,1861,49,40-44,1910,0.14068472786274716
STAT,1886,9,na,1895,2766.8985692991705
SIM,1931,30,45-49,1961,3
STAT,1849,27,45-49,1876,1.0290436455684486
SIM,1891,56,na,1947,2565
STAT,1901,43,15-19,1944,0.0013479747497355285
STAT,1922,23,40-44,1945,3.883266841824403
SIM,1855,20,15-19,1875,3
SIM,1928,42,40-44,1970,3
STAT,1879,87,na,1966,405.8255673025578
STAT,1875,73,na,1948,1231.9578266487013
STAT,1864,16,30-34,1880,1.66112001183918
STAT,1913,45,35-39,1958,0.1275670242415549
STAT,1928,31,35-39,1959,11.556228847134626
SIM,1821,61,na,1882,1042
STAT,1935,37,35-39,1972,3.4171314929135903
STAT,1921,22,35-39,1943,10.741258248577175
SIM,1898,46,na,1944,3073
STAT,1860,0,na,1860,3204.1630868242137
STAT,1896,35,na,1931,3179.6694405317467
STAT,1812,49,45-49,1861,0.5271394511814118
SIM,1858,20,40-44,1878,2
STAT,1907,19,30-34,1926,2.351393542787917
STAT,1905,31,40-44,1936,3.650707358945896
STAT,1829,45,50-100,1874,0.18806790747801344
STAT,1933,22,50-100,1955,0.8819759445139912
SIM,1898,28,45-49,1926,5
STAT,1910,29,30-34,1939,37.90089451038776
STAT,1892,21,na,1913,3006.4628353158396
STAT,1902,22,25-29,1924,81.70437483721493
SIM,1846,26,30-34,1872,42
STAT,1802,108,na,1910,6.399736072358741E-4
STAT,1904,30,35-39,1934,14.79634665042795
STAT,1948,24,15-19,1972,6.17009198135451
STAT,1900,5,na,1905,3676.7850696879837
SIM,1902,3,na,1905,4002
SIM,1922,24,45-49,1946,2
STAT,1829,37,na,1866,1615.4443139692078
STAT,1884,34,na,1918,2356.4050639966404
SIM,1846,22,15-19,1868,3
STAT,1867,23,45-49,1890,0.6612579474711937
SIM,1915,19,30-34,1934,3
STAT,1903,23,30-34,1926,25.54225407064936
STAT,1850,27,50-100,1877,0.5764217671416436
STAT,1888,48,na,1936,2648.8536753849608
STAT,1881,69,na,1950,1428.7495473378942
SIM,1837,45,50-100,1882,4
SIM,1910,22,25-29,1932,2
STAT,1918,45,35-39,1963,0.1391665805682274
STAT,1923,30,45-49,1953,1.8373419193168623
SIM,1879,25,30-34,1904,39
SIM,1900,27,50-100,1927,4
SIM,1901,37,30-34,1938,2
STAT,1922,34,45-49,1956,1.7873587698638718
SIM,1869,26,25-29,1895,48
STAT,1773,83,na,1856,131.64826449000006
STAT,1777,97,na,1874,0.7014052110601325
STAT,1854,25,50-100,1879,0.5610842019109433
SIM,1826,92,na,1918,49
STAT,1841,45,20-24,1886,0.009248422638853252
STAT,1824,48,25-29,1872,0.06647722729457912
STAT,1888,21,15-19,1909,3.9446785654287146
SIM,1854,38,50-100,1892,1
SIM,1951,20,20-24,1971,161
SIM,1917,34,na,1951,3859
STAT,1925,24,20-24,1949,133.6699076874321
SIM,1913,20,na,1933,3965
STAT,1928,39,45-49,1967,0.8689684436438061
STAT,1830,45,45-49,1875,0.2025757791282602
SIM,1912,30,35-39,1942,8
STAT,1838,26,30-34,1864,21.59852022433852
STAT,1918,17,40-44,1935,0.3083653612175067
SIM,1869,37,50-100,1906,1
STAT,1880,20,na,1900,2523.599809341297
STAT,1937,15,50-100,1952,0.36966633212642114
STAT,1852,56,na,1908,1546.8420121817187
STAT,1829,40,15-19,1869,0.01104829081987652
STAT,1943,28,30-34,1971,42.11523482295579
STAT,1933,34,20-24,1967,3.317366134456224
SIM,1900,34,na,1934,3432
STAT,1916,37,25-29,1953,1.0175383313554525
SIM,1896,21,15-19,1917,4
STAT,1814,51,50-100,1865,0.03548834032807654
STAT,1943,20,20-24,1963,119.53583260021526
STAT,1908,27,25-29,1935,63.34337729531416
STAT,1911,42,20-24,1953,0.017005476481013974
STAT,1896,31,15-19,1927,0.1911658836178629
SIM,1903,4,na,1907,3591
SIM,1933,24,20-24,1957,156
STAT,1933,38,15-19,1971,0.026404636993093485
SIM,1930,34,45-49,1964,6
STAT,1921,51,na,1972,4129.562759262875
STAT,1934,7,na,1941,5463.168023426562
STAT,1904,27,40-44,1931,4.341826646933672
STAT,1903,40,20-24,1943,0.016023322903878714
SIM,1870,94,na,1964,76
STAT,1865,6,na,1871,2605.4293253805095
STAT,1840,49,20-24,1889,0.008268087177159617
SIM,1871,36,50-100,1907,1
SIM,1887,27,30-34,1914,3
STAT,1839,15,na,1854,2154.1854305651646
STAT,1935,21,25-29,1956,127.12592048581986
SIM,1943,21,25-29,1964,115
SIM,1897,72,na,1969,1938
STAT,1820,48,40-44,1868,0.28678310474855795
STAT,1872,39,15-19,1911,0.05644662877809258
STAT,1900,42,45-49,1942,0.14563509697210755
STAT,1952,17,40-44,1969,1.693517888880587
STAT,1909,39,35-39,1948,2.287007560042716
SIM,1923,20,45-49,1943,1
SIM,1919,25,na,1944,3974
STAT,1798,59,na,1857,1172.241247350249
STAT,1879,27,30-34,1906,26.54171786796078
STAT,1851,104,na,1955,0.050504456874913915
STAT,1856,70,na,1926,1086.4652608829424
SIM,1915,11,na,1926,4556
STAT,1907,44,20-24,1951,0.016136690585198277
STAT,1944,24,30-34,1968,31.31514520135737
SIM,1842,23,na,1865,2000
SIM,1854,56,na,1910,1871
SIM,1903,24,35-39,1927,12
STAT,1934,17,25-29,1951,59.226453576340155
SIM,1917,23,25-29,1940,99
STAT,1864,57,na,1921,1831.5519193804735
STAT,1913,41,40-44,1954,0.24752272613509677
STAT,1860,43,na,1903,1894.4363651939864
SIM,1840,75,na,1915,792
SIM,1877,84,na,1961,555
SIM,1909,47,na,1956,3745
STAT,1860,22,50-100,1882,0.34707165200924284
SIM,1905,33,na,1938,3660
SIM,1846,37,na,1883,1769
SIM,1897,16,35-39,1913,1
STAT,1764,109,na,1873,0.0016528474456425353
SIM,1888,7,na,1895,3215
STAT,1797,74,na,1871,465.99691044630055
STAT,1872,22,15-19,1894,3.3498979037539343
SIM,1869,18,25-29,1887,6
SIM,1781,79,na,1860,211
STAT,1850,38,25-29,1888,2.2164181913260492
STAT,1858,30,40-44,1888,3.508466501489147
STAT,1848,23,35-39,1871,5.759525172721183
STAT,1925,32,20-24,1957,2.927240112774984
SIM,1847,54,na,1901,1510
SIM,1838,24,30-34,1862,31
SIM,1932,28,20-24,1960,24
SIM,1934,19,40-44,1953,2
SIM,1838,93,na,1931,12
SIM,1916,49,na,1965,3730
STAT,1821,52,40-44,1873,0.014841262065639457
STAT,1871,16,na,1887,2565.733651487497
SIM,1912,27,40-44,1939,5
SIM,1853,39,na,1892,1770
SIM,1877,17,20-24,1894,23
SIM,1900,25,20-24,1925,1
SIM,1912,35,na,1947,3599
STAT,1869,17,20-24,1886,17.649748988250106
STAT,1897,15,30-34,1912,2.1682202279462035
STAT,1929,35,45-49,1964,0.8861481351895165
SIM,1775,83,na,1858,110
SIM,1898,20,35-39,1918,1
SIM,1879,32,50-100,1911,1
SIM,1925,33,25-29,1958,2
STAT,1889,16,35-39,1905,0.685037522687503
STAT,1808,75,na,1883,431.3985156476209
STAT,1785,84,na,1869,106.19879999664276
SIM,1829,25,na,1854,1965
STAT,1789,98,na,1887,0.7395192130616662
SIM,1848,30,25-29,1878,3
STAT,1917,33,25-29,1950,9.728138366105021
STAT,1804,61,na,1865,883.5306214004669
SIM,1866,30,40-44,1896,9
SIM,1913,31,40-44,1944,7
STAT,1924,28,20-24,1952,21.401429269692528
STAT,1926,19,40-44,1945,1.7238862510895019
SIM,1856,23,35-39,1879,8
SIM,1787,84,na,1871,74
SIM,1907,34,20-24,1941,2
SIM,1921,41,40-44,1962,2
STAT,1912,37,40-44,1949,1.4740813784905342
STAT,1934,26,na,1960,5094.336895067114
STAT,1889,41,25-29,1930,0.8033572688768539
SIM,1918,18,45-49,1936,1
SIM,1867,30,35-39,1897,2
STAT,1916,29,25-29,1945,68.1889327444304
STAT,1898,7,na,1905,3567.276527723589
STAT,1868,16,15-19,1884,5.8668439295698835
STAT,1893,30,50-100,1923,1.1844763695488298
STAT,1914,41,35-39,1955,0.2016064465763782
STAT,1930,12,na,1942,5177.533641368906
SIM,1878,21,20-24,1899,99
SIM,1818,73,na,1891,502
SIM,1942,17,25-29,1959,60
STAT,1919,46,40-44,1965,0.17309105113173748
SIM,1908,29,40-44,1937,6
SIM,1926,34,30-34,1960,20
STAT,1868,50,50-100,1918,0.014788046087756265
SIM,1843,42,50-100,1885,5
SIM,1924,29,25-29,1953,8
STAT,1934,33,50-100,1967,1.139918662138431
SIM,1873,70,na,1943,1305
STAT,1950,18,20-24,1968,161.90767400907959
STAT,1882,46,20-24,1928,0.011773503771764508
STAT,1930,25,40-44,1955,5.9954967658074345
STAT,1862,53,40-44,1915,0.009034995878399774
STAT,1860,48,35-39,1908,0.1141353545110841
SIM,1905,40,45-49,1945,1
STAT,1849,68,na,1917,1194.825673943214
STAT,1911,25,30-34,1936,38.81227975103351
STAT,1830,77,na,1907,570.2739188048786
SIM,1869,33,na,1902,2271
STAT,1908,44,15-19,1952,0.0014166254464797053
STAT,1816,62,na,1878,1117.1088504783256
SIM,1839,67,na,1906,935
STAT,1839,40,50-100,1879,0.8899970518956156
SIM,1925,21,50-100,1946,1
STAT,1936,33,35-39,1969,8.955604875868401
SIM,1849,25,45-49,1874,2
SIM,1886,15,20-24,1901,28
STAT,1915,17,15-19,1932,9.584481060121123
SIM,1836,19,25-29,1855,6
SIM,1899,21,40-44,1920,2
STAT,1875,16,50-100,1891,0.05094003637281466
STAT,1918,34,30-34,1952,16.75755986303568
STAT,1899,31,40-44,1930,6.03591380348378
STAT,1901,35,15-19,1936,0.01732383467605498
SIM,1876,16,15-19,1892,9
SIM,1832,88,na,1920,113
STAT,1923,27,15-19,1950,0.8189320877255503
SIM,1862,43,na,1905,2093
SIM,1923,17,15-19,1940,47
STAT,1831,38,15-19,1869,0.044398605078334076
SIM,1819,90,na,1909,15
STAT,1935,29,35-39,1964,20.656484718099435
STAT,1914,21,40-44,1935,3.335911401036255
STAT,1917,22,20-24,1939,119.28891986963299
SIM,1882,30,25-29,1912,13
STAT,1919,30,30-34,1949,17.300430754482253
STAT,1830,42,40-44,1872,1.9543090724130676
STAT,1918,28,45-49,1946,1.849625657636541
STAT,1856,48,20-24,1904,0.009175399197832876
STAT,1921,38,45-49,1959,0.7680132063591361
STAT,1887,16,25-29,1903,6.405757475899327
STAT,1940,31,35-39,1971,9.553744472117431
STAT,1836,18,na,1854,1911.2743725710402
SIM,1889,21,na,1910,2946
STAT,1840,23,na,1863,1892.343868555094
STAT,1874,39,25-29,1913,2.9476671750933825
STAT,1844,37,na,1881,1969.7481338083132
SIM,1918,32,30-34,1950,36
STAT,1914,40,45-49,1954,0.16755122356453903
STAT,1957,11,na,1968,5232.430075817822
STAT,1944,19,35-39,1963,4.55691512955375
SIM,1943,25,40-44,1968,6
STAT,1937,21,35-39,1958,9.259823440605551
SIM,1829,89,na,1918,36
SIM,1899,52,na,1951,3186
SIM,1927,12,na,1939,5438
STAT,1881,20,15-19,1901,3.2309793586580366
SIM,1786,78,na,1864,274
STAT,1861,92,na,1953,34.95552492368582
STAT,1873,17,35-39,1890,0.5618285425195584
STAT,1855,26,30-34,1881,19.90024837609731
STAT,1859,30,35-39,1889,8.346413442177349
STAT,1828,74,na,1902,720.4272013652114
STAT,1906,48,20-24,1954,0.009832777533985093
STAT,1926,28,30-34,1954,47.304582631100075
STAT,1905,18,50-100,1923,0.07134545942687263
STAT,1921,19,40-44,1940,1.601624487444896
STAT,1910,24,25-29,1934,86.96848825655414
SIM,1927,30,30-34,1957,30
STAT,1874,30,25-29,1904,10.677941181851878
STAT,1913,42,30-34,1955,0.12579090108881313
SIM,1827,77,na,1904,368
STAT,1807,48,25-29,1855,0.20309972927899683
STAT,1906,35,15-19,1941,0.017999801937418694
STAT,1857,87,na,1944,138.87350381484669
STAT,1876,47,na,1923,2335.292325576121
STAT,1853,73,na,1926,982.2435729230097
STAT,1866,27,45-49,1893,1.0383916447372283
STAT,1881,29,15-19,1910,0.4385521427964931
SIM,1831,82,na,1913,339
STAT,1809,92,na,1901,19.231569864454627
STAT,1919,38,40-44,1957,1.6221513020118086
SIM,1934,28,30-34,1962,75
STAT,1932,38,20-24,1970,0.3575715747744705
SIM,1890,38,20-24,1928,4
STAT,1898,29,50-100,1927,0.8696124031702518
SIM,1925,22,20-24,1947,147
STAT,1920,32,20-24,1952,2.697996146380106
STAT,1824,36,50-100,1860,1.7655554722185063
SIM,1875,40,35-39,1915,5
SIM,1919,39,45-49,1958,1
SIM,1877,25,20-24,1902,14
SIM,1927,38,40-44,1965,2
SIM,1833,23,40-44,1856,1
STAT,1901,27,15-19,1928,0.6423781162520772
STAT,1842,49,30-34,1891,0.08533272715100554
STAT,1867,49,35-39,1916,0.13039055917645564
STAT,1886,22,50-100,1908,0.43486483746690147
SIM,1882,39,25-29,1921,2
STAT,1921,30,35-39,1951,10.353638053752029
STAT,1937,34,40-44,1971,3.9035702290194463
SIM,1825,75,na,1900,465
STAT,1910,37,30-34,1947,1.758628904852332
STAT,1804,93,na,1897,9.060446203932573
STAT,1831,62,na,1893,1148.5471744976744
STAT,1832,23,50-100,1855,0.410354949518942
SIM,1902,36,35-39,1938,9
STAT,1952,18,30-34,1970,14.753075662232952
SIM,1929,33,45-49,1962,2
STAT,1940,30,45-49,1970,1.6460048421890636
SIM,1896,25,30-34,1921,53
SIM,1810,45,na,1855,1503
STAT,1907,27,30-34,1934,37.35049540030743
STAT,1864,5,na,1869,2605.2116178512674
STAT,1866,20,25-29,1886,54.75861437021711
STAT,1869,24,50-100,1893,0.39792647230479267
SIM,1814,59,na,1873,1084
SIM,1871,36,na,1907,2290
SIM,1879,21,15-19,1900,4
STAT,1917,42,15-19,1959,0.0016176667401807522
STAT,1930,36,45-49,1966,0.8995656517152527
SIM,1883,69,na,1952,1575
SIM,1848,37,45-49,1885,1
SIM,1841,38,25-29,1879,4
STAT,1926,20,20-24,1946,137.34346170649533
SIM,1922,16,45-49,1938,1
STAT,1836,53,50-100,1889,0.009451004993452364
SIM,1838,20,15-19,1858,2
SIM,1850,74,na,1924,780
SIM,1925,17,25-29,1942,62
SIM,1902,17,30-34,1919,5
SIM,1944,22,30-34,1966,43
STAT,1937,29,45-49,1966,1.6984512916254229
STAT,1846,40,15-19,1886,0.01088224191961439
STAT,1924,43,45-49,1967,0.19972682109134282
STAT,1930,17,40-44,1947,1.8277125999344532
STAT,1909,35,40-44,1944,1.443422291829324
STAT,1933,37,25-29,1970,1.3552063434892412
STAT,1829,69,na,1898,865.3192192313088
STAT,1888,25,30-34,1913,30.223299925395096
SIM,1934,27,40-44,1961,6
STAT,1917,49,35-39,1966,0.13513571874684938
SIM,1895,16,25-29,1911,12
STAT,1833,38,25-29,1871,2.529729131082838
SIM,1903,16,35-39,1919,1
STAT,1828,34,50-100,1862,0.9987767061167455
STAT,1905,43,35-39,1948,0.18227591657090764
SIM,1899,31,na,1930,3727
STAT,1863,72,na,1935,1130.1517278315898
STAT,1878,35,50-100,1913,1.2994577649484693
STAT,1915,20,45-49,1935,1.1329151982403225
STAT,1937,0,na,1937,4424.5859103759
STAT,1924,38,50-100,1962,0.49978130870346504
SIM,1854,88,na,1942,119
SIM,1863,26,30-34,1889,3
STAT,1912,47,na,1959,3562.091204734744
SIM,1917,35,40-44,1952,8
SIM,1922,21,40-44,1943,7
STAT,1932,25,15-19,1957,0.9352468604188411
STAT,1928,30,na,1958,4785.351652618862
STAT,1900,14,na,1914,3611.5591415634112
STAT,1950,4,na,1954,4714.973417883098
SIM,1846,69,na,1915,1050
SIM,1909,21,25-29,1930,109
STAT,1900,47,15-19,1947,3.1508994060720736E-4
SIM,1940,4,na,1944,4271
SIM,1945,21,35-39,1966,10
STAT,1921,8,na,1929,4591.628103870618
STAT,1904,28,na,1932,3446.8957281754447
STAT,1867,86,na,1953,211.0534903645347
STAT,1910,35,na,1945,3664.6849185204196
STAT,1913,4,na,1917,4150.099150501604
STAT,1914,49,na,1963,3654.563135617983
STAT,1825,55,na,1880,1640.6989730158275
STAT,1856,1,na,1857,2906.626190374966
SIM,1857,21,na,1878,2200
STAT,1926,27,40-44,1953,5.647090220268915
STAT,1850,22,na,1872,1965.0461295206699
SIM,1829,34,30-34,1863,18
SIM,1881,57,na,1938,1837
STAT,1821,41,na,1862,1667.9755046774633
STAT,1901,6,na,1907,3698.7255159955926
SIM,1812,57,na,1869,1096
STAT,1874,42,50-100,1916,1.091226412048601
SIM,1933,35,25-29,1968,1
STAT,1823,49,20-24,1872,0.016052967043888297
STAT,1893,39,35-39,1932,8.979316227195175
SIM,1932,0,na,1932,6289
STAT,1824,92,na,1916,20.706040144663454
STAT,1856,25,35-39,1881,7.8546887064122
STAT,1947,12,na,1959,4469.619264769042
STAT,1907,47,25-29,1954,0.047967175305595945
STAT,1854,36,na,1890,1776.6393101220854
SIM,1856,58,na,1914,1778
STAT,1916,38,15-19,1954,0.019747173973053724
STAT,1779,77,na,1856,375.6021835446001
STAT,1806,49,20-24,1855,0.03505922371904062
STAT,1902,19,30-34,1921,2.262666551153913
SIM,1892,20,40-44,1912,6
STAT,1836,102,na,1938,0.18485386304850676
SIM,1937,32,40-44,1969,6
STAT,1838,73,na,1911,795.1130780951162
STAT,1836,26,20-24,1862,9.645519246804055
SIM,1910,19,30-34,1929,2
STAT,1846,49,15-19,1895,2.9721572812603893E-4
STAT,1938,30,40-44,1968,3.976873502045849
STAT,1806,63,na,1869,875.7845827516919
SIM,1938,28,15-19,1966,4
STAT,1783,82,na,1865,168.84943243832262
STAT,1909,16,50-100,1925,0.07432192232596328
SIM,1821,93,na,1914,18
STAT,1795,62,na,1857,1032.7804735642342
STAT,1901,30,45-49,1931,2.488849825806077
SIM,1819,36,50-100,1855,1
SIM,1903,21,30-34,1924,37
STAT,1846,17,na,1863,2188.2742495003517
STAT,1787,96,na,1883,1.3521552082615402
SIM,1944,13,na,1957,4296
STAT,1799,76,na,1875,385.0378901723174
SIM,1918,27,35-39,1945,27
STAT,1901,25,50-100,1926,0.9118578832092518
STAT,1905,18,45-49,1923,0.09512727923583017
SIM,1874,20,25-29,1894,60
STAT,1921,31,25-29,1952,10.43071199668621
STAT,1893,30,35-39,1923,13.091763820815173
STAT,1884,20,40-44,1904,2.087846584532019
STAT,1938,26,50-100,1964,0.9959481307747864
SIM,1919,31,35-39,1950,9
STAT,1838,22,15-19,1860,2.8652426540448896
SIM,1841,81,na,1922,333
STAT,1903,47,50-100,1950,0.1983470880673525
STAT,1911,17,30-34,1928,2.4607522312340966
STAT,1903,17,45-49,1920,0.09396075737600847
STAT,1904,44,50-100,1948,0.10489724294813221
STAT,1920,26,35-39,1946,16.6885505652919
STAT,1865,31,50-100,1896,0.8484662185581165
STAT,1815,56,na,1871,1124.9512614705548
SIM,1878,90,na,1968,194
SIM,1919,44,40-44,1963,1
SIM,1903,29,40-44,1932,6
STAT,1815,47,20-24,1862,0.026625279395871865
STAT,1929,33,50-100,1962,1.0608358504169453
STAT,1841,37,20-24,1878,0.6791737945573696
SIM,1900,66,na,1966,2709
SIM,1934,20,20-24,1954,155
STAT,1867,40,35-39,1907,1.73986627072955
SIM,1868,5,na,1873,2670
SIM,1813,74,na,1887,491
SIM,1879,32,na,1911,2772
SIM,1824,37,na,1861,1568
STAT,1851,43,50-100,1894,0.7941539400019971
STAT,1882,54,na,1936,2048.6738796652257
STAT,1814,82,na,1896,218.38869039435178
STAT,1821,39,45-49,1860,3.4791670614145334
STAT,1846,92,na,1938,31.607110545879696
STAT,1909,40,15-19,1949,0.0014658806184125249
STAT,1888,28,35-39,1916,11.462111160230217
SIM,1933,16,20-24,1949,217
STAT,1925,16,20-24,1941,165.91954116641372
STAT,1882,38,20-24,1920,0.7504175088067776
SIM,1877,20,na,1897,2455
STAT,1882,86,na,1968,475.35268052185364
STAT,1880,53,50-100,1933,0.01576243235109717
STAT,1830,52,50-100,1882,0.011109408535280068
STAT,1811,63,na,1874,928.5392543673084
STAT,1815,77,na,1892,374.1766792082991
STAT,1874,35,na,1909,2459.667060167021
STAT,1893,38,na,1931,3006.416683917632
SIM,1854,15,25-29,1869,10
SIM,1907,26,20-24,1933,22
STAT,1906,22,45-49,1928,1.0258321923100264
STAT,1884,40,35-39,1924,1.8217600621586811
STAT,1886,68,na,1954,1629.659165949018
SIM,1847,22,na,1869,1997
STAT,1862,55,na,1917,1803.501753143661
STAT,1878,49,na,1927,2309.605176727632
STAT,1915,46,20-24,1961,0.011264548612362866
STAT,1866,69,na,1935,1372.4943754977885
SIM,1871,15,25-29,1886,7
SIM,1947,18,15-19,1965,55
STAT,1862,16,20-24,1878,17.814926065144526
STAT,1853,51,50-100,1904,0.012549377473078584
STAT,1858,18,50-100,1876,0.04508041369173324
SIM,1911,29,na,1940,3845
STAT,1830,45,na,1875,1634.4704329404894
STAT,1925,40,20-24,1965,0.0216681951068044
STAT,1834,59,na,1893,1156.8052715231274
STAT,1920,13,na,1933,4482.195685348076
STAT,1935,30,15-19,1965,0.17982557792713091
STAT,1877,38,50-100,1915,1.2734797408760596
STAT,1844,40,50-100,1884,0.8782661829763211
STAT,1882,15,35-39,1897,0.539322437344162
SIM,1914,22,45-49,1936,3
STAT,1924,27,na,1951,4407.609367312354
STAT,1901,26,25-29,1927,60.09831767398604
SIM,1908,37,40-44,1945,1
SIM,1958,9,na,1967,5244
STAT,1912,33,25-29,1945,9.136874488843855
SIM,1917,20,20-24,1937,5
SIM,1782,85,na,1867,13
SIM,1892,40,35-39,1932,4
STAT,1863,15,25-29,1878,5.855372159491411
SIM,1832,56,na,1888,1227
STAT,1939,18,15-19,1957,45.8459499882706
SIM,1859,24,15-19,1883,3
SIM,1861,58,na,1919,1687
STAT,1847,20,15-19,1867,3.072059945517407
STAT,1945,20,30-34,1965,31.833766950073684
SIM,1870,16,20-24,1886,24
STAT,1861,17,na,1878,2214.3108908555987
STAT,1922,42,45-49,1964,0.19298220402811564
STAT,1911,16,40-44,1927,0.283074948465045
STAT,1784,107,na,1891,0.004427600057779071
SIM,1920,33,25-29,1953,13
SIM,1938,31,45-49,1969,1
SIM,1929,24,na,1953,4376
STAT,1820,43,50-100,1863,1.925278928034174
STAT,1846,15,25-29,1861,5.4663682558426645
STAT,1867,31,45-49,1898,1.6655406508557513
SIM,1908,30,20-24,1938,1
STAT,1931,33,35-39,1964,12.094280976240341
STAT,1826,48,35-39,1874,0.13609164480735908
SIM,1925,10,na,1935,4868
STAT,1925,35,25-29,1960,1.1963592212223377
STAT,1929,32,40-44,1961,5.02419730989262
SIM,1861,69,na,1930,1280
SIM,1906,50,na,1956,3094
STAT,1847,27,35-39,1874,8.683492280653317
STAT,1879,23,15-19,1902,3.466426284211708
SIM,1889,35,40-44,1924,11
STAT,1922,18,45-49,1940,0.5825099611377438
STAT,1935,25,40-44,1960,6.424863352130643
STAT,1881,16,30-34,1897,1.555547325288498
SIM,1908,38,30-34,1946,5
SIM,1910,38,35-39,1948,5
SIM,1841,92,na,1933,18
SIM,1832,45,na,1877,1496
STAT,1894,41,50-100,1935,1.379957609200143
STAT,1908,42,50-100,1950,0.10971942144836727
STAT,1911,21,15-19,1932,5.108693163327389
STAT,1912,31,50-100,1943,0.8241512634604741
STAT,1845,53,40-44,1898,0.007568896728514126
STAT,1902,38,35-39,1940,2.1680877888287395
SIM,1841,60,na,1901,1307
SIM,1952,16,30-34,1968,14
STAT,1845,27,50-100,1872,0.5689266025468013
SIM,1811,94,na,1905,5
SIM,1914,19,15-19,1933,9
STAT,1853,51,25-29,1904,0.0029431764550079233
STAT,1858,25,45-49,1883,0.9137101266576043
SIM,1853,18,na,1871,2041
STAT,1909,47,35-39,1956,0.1195505789039518
STAT,1848,49,25-29,1897,0.04604609729653075
SIM,1849,88,na,1937,68
SIM,1885,27,20-24,1912,16
STAT,1905,40,30-34,1945,0.11774348627646415
STAT,1908,10,na,1918,3878.8294581982536
STAT,1921,35,40-44,1956,1.6911116934169568
SIM,1919,46,na,1965,3936
STAT,1917,37,40-44,1954,1.5694718834502983
SIM,1915,32,na,1947,4241
STAT,1911,49,40-44,1960,0.14970218996263487
STAT,1918,25,40-44,1943,5.04183615873567
SIM,1924,41,45-49,1965,1
STAT,1869,16,30-34,1885,1.5961881224003052
SIM,1845,74,na,1919,850
SIM,1881,25,na,1906,2078
SIM,1935,32,30-34,1967,29
STAT,1870,44,50-100,1914,1.033633544123815
STAT,1899,26,50-100,1925,0.889753751011638
STAT,1919,33,35-39,1952,9.912650211327293
SIM,1864,30,30-34,1894,29
STAT,1852,54,50-100,1906,0.011138831553518332
SIM,1896,20,25-29,1916,108
STAT,1841,40,na,1881,1842.6161900834288
STAT,1911,41,30-34,1952,0.12381431630756573
STAT,1843,95,na,1938,8.967412372952506
STAT,1935,28,45-49,1963,2.3781565393191997
STAT,1837,88,na,1925,93.6520617162917
SIM,1851,59,na,1910,1553
SIM,1818,41,na,1859,1393
SIM,1874,24,40-44,1898,4
STAT,1863,40,na,1903,2089.174754302948
STAT,1812,54,40-44,1866,0.022328243884261707
STAT,1918,31,na,1949,4074.004050875388
SIM,1901,24,25-29,1925,128
STAT,1895,3,na,1898,3486.8664293749625
STAT,1891,68,na,1959,2019.1213736647055
STAT,1794,77,na,1871,349.78101120880615
STAT,1833,74,na,1907,785.1707095638794
STAT,1856,30,30-34,1886,13.972577498075497
SIM,1842,55,na,1897,1453
STAT,1888,20,25-29,1908,68.65033992370951
STAT,1845,54,na,1899,1530.0251575013242
STAT,1844,15,15-19,1859,6.039496239951053
SIM,1931,31,35-39,1962,14
STAT,1867,54,na,1921,1991.8178061882054
SIM,1849,22,40-44,1871,6
SIM,1848,34,40-44,1882,9
STAT,1916,41,45-49,1957,0.1723650671606658
STAT,1930,21,25-29,1951,119.96149562000727
STAT,1950,17,30-34,1967,14.560839478580844
SIM,1862,38,45-49,1900,4
SIM,1898,41,40-44,1939,3
SIM,1926,25,40-44,1951,7
STAT,1881,50,50-100,1931,0.014914810917978765
SIM,1925,8,na,1933,4892
STAT,1906,15,50-100,1921,0.07240698085087259
SIM,1870,37,40-44,1907,7
STAT,1865,15,35-39,1880,0.5798607707604766
STAT,1890,38,50-100,1928,1.5077164755953034
STAT,1827,37,50-100,1864,1.4281186672023434
STAT,1945,23,35-39,1968,10.418422778026772
SIM,1852,15,15-19,1867,5
SIM,1890,3,na,1893,3577
STAT,1855,39,15-19,1894,0.04184329335398878
STAT,1849,9,na,1858,2344.713014619413
STAT,1903,18,35-39,1921,0.7872026194600449
SIM,1840,96,na,1936,1
STAT,1901,23,20-24,1924,97.26877502809747
SIM,1876,20,35-39,1896,9
STAT,1923,31,35-39,1954,10.628345023364721
STAT,1888,16,na,1904,3018.199159438236
STAT,1849,20,25-29,1869,54.898857219941014
STAT,1926,23,25-29,1949,113.06407298481781
SIM,1874,27,45-49,1901,4
STAT,1896,67,na,1963,2321.6672130975726
STAT,1952,6,na,1958,4759.734478157296
STAT,1862,87,na,1949,153.66845657473496
STAT,1897,31,30-34,1928,23.73809806195501
STAT,1892,53,na,1945,2685.1384129671133
SIM,1921,17,40-44,1938,2
STAT,1922,16,50-100,1938,0.4391059192429739
SIM,1896,28,35-39,1924,18
STAT,1884,15,45-49,1899,0.06536317085607493
STAT,1831,30,na,1861,1800.1945497905217
STAT,1865,38,20-24,1903,0.7073938501192063
STAT,1868,20,35-39,1888,5.714704194472532
SIM,1944,17,35-39,1961,6
STAT,1866,24,40-44,1890,1.936645785322487
STAT,1942,28,15-19,1970,0.7477358672791452
STAT,1882,24,50-100,1906,0.39646319060745655
STAT,1887,41,15-19,1928,0.015643060708825277
STAT,1852,20,45-49,1872,0.6373604554956482
SIM,1966,2,na,1968,5082
SIM,1777,85,na,1862,72
STAT,1913,17,40-44,1930,0.2885427313286979
SIM,1829,37,35-39,1866,5
STAT,1835,44,na,1879,1842.8488705175357
STAT,1788,81,na,1869,190.2260740648085
STAT,1943,27,40-44,1970,5.012308989231022
SIM,1868,91,na,1959,33
SIM,1873,38,20-24,1911,1
STAT,1852,38,35-39,1890,5.337441011648732
SIM,1817,56,na,1873,1317
SIM,1882,37,50-100,1919,1
SIM,1839,23,35-39,1862,7
SIM,1813,42,na,1855,1473
SIM,1860,38,35-39,1898,10
STAT,1908,32,20-24,1940,2.324154301445903
STAT,1874,37,50-100,1911,1.2697187878737297
STAT,1923,48,20-24,1971,0.013025890332000488
SIM,1902,36,na,1938,3660
SIM,1791,78,na,1869,237
SIM,1857,20,25-29,1877,65
SIM,1934,23,25-29,1957,145
SIM,1940,31,na,1971,4146
STAT,1906,19,15-19,1925,8.683519282383315
SIM,1915,28,20-24,1943,24
STAT,1930,41,40-44,1971,0.33310942252291076
STAT,1931,17,20-24,1948,179.3446013385458
SIM,1823,63,na,1886,1025
STAT,1927,32,30-34,1959,19.588947756867622
STAT,1762,100,na,1862,0.1380801138010795
STAT,1867,28,15-19,1895,0.4300526699933565
STAT,1823,39,50-100,1862,1.9538609329526908
STAT,1897,49,20-24,1946,0.008974252265115898
SIM,1922,29,50-100,1951,1
STAT,1917,46,30-34,1963,0.09422126547876385
SIM,1949,12,na,1961,4419
STAT,1904,31,25-29,1935,14.906492743178028
STAT,1877,27,20-24,1904,12.229138390890283
SIM,1849,41,45-49,1890,3
STAT,1914,29,50-100,1943,1.0051538983277553
STAT,1936,17,35-39,1953,4.055814168439334
STAT,1841,18,na,1859,2200.878249498903
STAT,1891,30,25-29,1921,12.911107084215628
STAT,1897,20,na,1917,3221.5223103989206
STAT,1870,21,na,1891,2352.709054279285
SIM,1792,63,na,1855,775
SIM,1796,77,na,1873,354
SIM,1906,20,45-49,1926,1
STAT,1859,26,15-19,1885,0.37763179763188803
STAT,1781,109,na,1890,0.0018743054709966398
STAT,1914,17,na,1931,4031.0024048788596
STAT,1840,55,na,1895,1449.441686764006
SIM,1859,87,na,1946,120
STAT,1870,39,40-44,1909,4.297859991621412
SIM,1855,73,na,1928,999
STAT,1907,28,20-24,1935,17.339165996866278
SIM,1910,35,30-34,1945,3
SIM,1899,20,na,1919,3624
STAT,1871,17,25-29,1888,5.722855645368389
STAT,1903,65,na,1968,2731.4495018800644
STAT,1928,44,40-44,1972,0.3212223420601394
SIM,1837,36,30-34,1873,4
STAT,1921,42,50-100,1963,0.13364052048126704
STAT,1829,49,15-19,1878,2.907639779540588E-4
SIM,1912,31,25-29,1943,17
STAT,1925,19,25-29,1944,52.62069159456804
SIM,1933,19,25-29,1952,60
SIM,1865,40,na,1905,2124
STAT,1820,52,25-29,1872,0.005781363664500574
STAT,1858,48,30-34,1906,0.07573924518072583
SIM,1869,54,na,1923,2025
STAT,1848,33,50-100,1881,0.7856742943543819
STAT,1820,56,na,1876,1122.4203214836987
STAT,1911,45,25-29,1956,0.05090250811918553
SIM,1916,32,20-24,1948,1
STAT,1839,25,35-39,1864,8.743006602305158
STAT,1902,35,30-34,1937,1.6574306949617057
STAT,1951,5,na,1956,4730.422202645813
STAT,1770,86,na,1856,34.71322397
STAT,1872,76,na,1948,962.0134589245207
SIM,1889,38,45-49,1927,2
STAT,1899,26,45-49,1925,1.5443303457976132
STAT,1871,91,na,1962,123.97533864698954
STAT,1880,53,35-39,1933,0.008985099901686515
SIM,1929,30,40-44,1959,6
STAT,1848,8,na,1856,2485.4128906724995
STAT,1872,30,15-19,1902,0.14576607175105674
SIM,1828,47,50-100,1875,4
SIM,1926,29,35-39,1955,22
STAT,1812,50,25-29,1862,0.008138392138849211
STAT,1840,44,na,1884,1647.2983435740293
SIM,1838,18,na,1856,2064
STAT,1940,27,15-19,1967,0.7267573538949225
STAT,1783,108,na,1891,0.0033863358914855467
STAT,1880,28,45-49,1908,1.1735646369054655
STAT,1840,37,50-100,1877,1.0179177119049516
SIM,1847,25,35-39,1872,1
STAT,1917,17,25-29,1934,9.412936551165586
STAT,1918,27,50-100,1945,1.0694115662539003
SIM,1865,44,50-100,1909,1
STAT,1938,33,45-49,1971,1.5963301172501938
STAT,1906,2,na,1908,3921.461612541534
STAT,1952,12,na,1964,4756.070655683796
STAT,1821,107,na,1928,0.0028248182400732514
SIM,1860,20,45-49,1880,4
STAT,1886,49,50-100,1935,0.25643772033779094
STAT,1896,27,30-34,1923,33.666215662597374
STAT,1918,21,25-29,1939,100.880082151376
STAT,1851,16,45-49,1867,0.060492312278972754
STAT,1857,44,50-100,1901,0.8215017537175584
SIM,1926,21,25-29,1947,134
STAT,1909,38,45-49,1947,0.6479116259073237
SIM,1926,27,50-100,1953,1
STAT,1883,17,na,1900,2496.23670038187
SIM,1869,65,na,1934,1567
STAT,1905,15,40-44,1920,0.2682969154465415
SIM,1838,40,30-34,1878,1
STAT,1829,36,30-34,1865,4.4402010315385105
SIM,1889,53,na,1942,2531
STAT,1883,21,50-100,1904,0.4042651887373432
STAT,1849,30,50-100,1879,0.8469397287314986
STAT,1924,27,30-34,1951,46.10106308700909
STAT,1920,45,50-100,1965,0.2536686035468208
SIM,1890,39,na,1929,3188
STAT,1840,28,15-19,1868,0.393702078068768
SIM,1803,75,na,1878,401
STAT,1847,24,30-34,1871,16.11557723960983
STAT,1918,29,35-39,1947,16.015394827528244
STAT,1909,19,40-44,1928,0.2753044179928695
SIM,1927,33,35-39,1960,2
STAT,1804,52,40-44,1856,0.028509993200116376
STAT,1931,30,30-34,1961,20.887855806340603
SIM,1941,18,20-24,1959,130
STAT,1805,78,na,1883,378.88544362657194
STAT,1905,27,20-24,1932,17.129052154641396
SIM,1772,86,na,1858,46
SIM,1857,30,50-100,1887,1
STAT,1933,18,20-24,1951,182.91512307839554
SIM,1889,30,35-39,1919,27
STAT,1937,23,na,1960,3588.889850468118
STAT,1895,15,20-24,1910,23.49192575203822
STAT,1913,36,45-49,1949,0.6820593393350148
SIM,1921,28,na,1949,4051
SIM,1906,17,15-19,1923,12
STAT,1935,34,30-34,1969,21.993987284776832
SIM,1921,36,45-49,1957,2
SIM,1932,27,30-34,1959,93
STAT,1914,37,15-19,1951,0.019344916208216965
SIM,1834,30,45-49,1864,2
STAT,1860,41,15-19,1901,0.011453352345980128
STAT,1801,64,na,1865,905.9106189198739
SIM,1879,41,30-34,1920,1
STAT,1849,40,40-44,1889,1.789338362842971
SIM,1833,26,45-49,1859,1
SIM,1855,24,30-34,1879,21
SIM,1877,16,30-34,1893,2
SIM,1898,21,25-29,1919,90
SIM,1807,89,na,1896,51
SIM,1878,37,30-34,1915,12
STAT,1925,44,15-19,1969,0.0018727235875564342
SIM,1858,16,20-24,1874,19
SIM,1866,36,na,1902,2407
STAT,1871,43,40-44,1914,2.2406739253584806
SIM,1807,78,na,1885,376
SIM,1866,25,45-49,1891,1
SIM,1870,73,na,1943,1276
SIM,1874,87,na,1961,356
SIM,1816,93,na,1909,13
SIM,1942,22,20-24,1964,148
SIM,1917,19,40-44,1936,5
SIM,1803,64,na,1867,784
STAT,1915,49,25-29,1964,0.0536195981755538
SIM,1872,21,na,1893,2571
SIM,1821,37,45-49,1858,8
SIM,1836,24,20-24,1860,79
SIM,1920,24,35-39,1944,14
STAT,1839,50,25-29,1889,0.002573675924808462
SIM,1943,28,45-49,1971,5
STAT,1887,53,na,1940,2389.0919772324455
SIM,1857,40,40-44,1897,6
SIM,1920,30,20-24,1950,3
STAT,1892,17,45-49,1909,0.08278838327310407
STAT,1852,17,15-19,1869,5.44344484195104
SIM,1913,27,20-24,1940,27
STAT,1840,15,30-34,1855,1.4637694295420813
SIM,1811,45,50-100,1856,3
STAT,1861,53,25-29,1914,0.002925010446477139
SIM,1908,33,25-29,1941,12
STAT,1826,30,45-49,1856,2.788063350091286
STAT,1912,24,35-39,1936,9.427995025114527
SIM,1935,31,na,1966,5152
STAT,1903,47,40-44,1950,0.13826148820004047
STAT,1934,22,20-24,1956,150.9908696133164
STAT,1912,30,20-24,1942,2.4409355519495683
SIM,1888,26,35-39,1914,15
STAT,1870,10,na,1880,2659.4895307337097
STAT,1925,39,40-44,1964,1.8119217168203805
SIM,1907,29,25-29,1936,70
STAT,1816,41,na,1857,1620.9663390332312
STAT,1860,49,25-29,1909,0.04656315443001117
STAT,1893,21,45-49,1914,0.8969739999024662
STAT,1833,33,40-44,1866,3.9238603305202653
SIM,1887,6,na,1893,2889
STAT,1821,95,na,1916,7.9639201571369735
STAT,1859,34,15-19,1893,0.11469238961521006
SIM,1838,42,50-100,1880,1
SIM,1882,42,na,1924,2070
STAT,1831,25,30-34,1856,23.189548805793716
SIM,1914,15,na,1929,4266
STAT,1909,32,15-19,1941,0.12374399122265171
SIM,1799,74,na,1873,666
SIM,1924,47,na,1971,4429
SIM,1851,37,30-34,1888,5
SIM,1922,34,na,1956,4764
STAT,1808,49,30-34,1857,0.33517369239318445
STAT,1895,39,45-49,1934,2.6028728556030067
SIM,1827,36,50-100,1863,4
STAT,1879,38,35-39,1917,7.417881880289875
STAT,1901,22,45-49,1923,0.9873079363173524
STAT,1920,31,50-100,1951,0.9182668496430493
SIM,1955,15,45-49,1970,2
STAT,1817,52,50-100,1869,0.03109722853993322
STAT,1856,33,35-39,1889,7.855867951481306
STAT,1898,43,40-44,1941,0.21231774849568583
SIM,1916,3,na,1919,4306
STAT,1904,23,25-29,1927,82.71647979990948
STAT,1836,34,20-24,1870,2.1111052488739133
SIM,1823,31,na,1854,1741
STAT,1819,37,25-29,1856,8.354502574231063
STAT,1894,27,20-24,1921,15.25482102708191
SIM,1862,25,25-29,1887,44
SIM,1881,19,15-19,1900,9
STAT,1854,25,25-29,1879,37.10323803963281
STAT,1871,22,20-24,1893,69.14846464746097
SIM,1856,36,na,1892,2142
STAT,1946,26,50-100,1972,1.120346762589847
STAT,1906,31,35-39,1937,8.589369044656811
STAT,1895,72,na,1967,2000.4461402378001
SIM,1829,25,40-44,1854,4
SIM,1853,27,25-29,1880,59
STAT,1915,12,na,1927,4170.831244237656
SIM,1896,16,40-44,1912,1
STAT,1813,41,15-19,1854,0.05324716354787722
STAT,1850,27,20-24,1877,10.571118252839781
STAT,1841,29,20-24,1870,10.740515800642092
STAT,1857,33,na,1890,1873.0583519017066
SIM,1857,53,na,1910,1845
STAT,1835,38,35-39,1873,6.4976993743915115
SIM,1903,25,25-29,1928,10
STAT,1944,20,15-19,1964,5.807850174177587
SIM,1844,21,15-19,1865,6
SIM,1838,23,40-44,1861,1
SIM,1894,22,50-100,1916,3
STAT,1910,20,45-49,1930,1.0724169635179792
STAT,1843,37,30-34,1880,4.196410513709436
STAT,1908,64,na,1972,2970.1685969734062
STAT,1929,24,40-44,1953,4.2707525918221325
SIM,1920,22,20-24,1942,121
SIM,1841,33,40-44,1874,5
STAT,1858,50,na,1908,1730.6591561648897
SIM,1865,72,na,1937,946
STAT,1840,23,30-34,1863,15.764710185639291
STAT,1921,20,20-24,1941,127.60276457947832
STAT,1828,48,45-49,1876,0.21219101686112649
SIM,1943,22,15-19,1965,5
STAT,1849,43,45-49,1892,1.1616995339825562
STAT,1842,31,40-44,1873,4.765960886942207
SIM,1864,33,35-39,1897,13
STAT,1868,37,20-24,1905,0.7440933952623306
SIM,1881,22,30-34,1903,20
SIM,1916,28,na,1944,3816
STAT,1883,27,45-49,1910,1.097391778120329
STAT,1938,22,40-44,1960,3.359457243616424
SIM,1937,24,40-44,1961,4
SIM,1844,25,na,1869,1800
SIM,1842,39,30-34,1881,5
SIM,1855,35,35-39,1890,14
STAT,1923,31,na,1954,4398.700985584368
SIM,1899,17,20-24,1916,24
SIM,1804,60,na,1864,1165
SIM,1908,0,na,1908,4050
SIM,1919,20,30-34,1939,41
SIM,1946,22,40-44,1968,6
STAT,1857,23,na,1880,1931.6895793211852
STAT,1885,40,na,1925,2347.0222493845117
SIM,1900,19,35-39,1919,4
STAT,1849,14,na,1863,2276.660639381797
STAT,1914,30,30-34,1944,16.129645524950522
SIM,1833,41,na,1874,1770
SIM,1840,23,50-100,1863,1
SIM,1847,21,40-44,1868,1
SIM,1890,71,na,1961,2076
STAT,1912,22,20-24,1934,107.51241490341023
STAT,1895,50,na,1945,2880.839539619466
SIM,1885,22,15-19,1907,3
STAT,1864,32,30-34,1896,15.912562516416878
SIM,1882,52,na,1934,1904
STAT,1884,38,30-34,1922,5.281904003313697
SIM,1874,29,25-29,1903,50
SIM,1921,21,25-29,1942,118
STAT,1828,35,25-29,1863,3.0990224248312903
STAT,1874,48,15-19,1922,4.084776418069577E-4
STAT,1878,31,20-24,1909,2.8456164986354593
STAT,1834,39,30-34,1873,3.866902204295562
STAT,1862,24,20-24,1886,60.65033014687483
STAT,1890,17,35-39,1907,0.6771953308041069
STAT,1932,21,35-39,1953,12.52289692430538
SIM,1871,23,25-29,1894,69
STAT,1847,35,35-39,1882,5.609886375459826
STAT,1845,32,20-24,1877,2.348387418949638
STAT,1950,11,na,1961,4693.299775613545
SIM,1891,26,20-24,1917,24
STAT,1841,49,15-19,1890,2.9288005196242154E-4
STAT,1880,50,30-34,1930,0.006404665586278147
STAT,1861,28,35-39,1889,8.098421439649798
STAT,1880,32,15-19,1912,0.1510533145488604
SIM,1824,36,45-49,1860,5
SIM,1827,55,na,1882,1249
SIM,1935,36,25-29,1971,5
STAT,1820,78,na,1898,397.71575470004103
STAT,1833,104,na,1937,0.04718999614723725
SIM,1961,7,na,1968,5232
STAT,1839,21,40-44,1860,1.9119653546033093
STAT,1845,27,25-29,1872,37.62183837912446
STAT,1857,39,25-29,1896,2.2466692325619784
STAT,1889,15,45-49,1904,0.08173024285398814
STAT,1913,21,25-29,1934,90.58172119613498
STAT,1827,36,20-24,1863,0.9181311842479982
STAT,1839,48,20-24,1887,0.008557873894562845
STAT,1893,18,15-19,1911,7.590773994267249
SIM,1870,24,20-24,1894,102
SIM,1874,33,na,1907,2291
STAT,1947,15,45-49,1962,0.5687011292988972
SIM,1829,36,na,1865,1823
SIM,1882,20,na,1902,2060
STAT,1869,49,45-49,1918,0.22690360315868255
STAT,1890,24,50-100,1914,0.5001283353181037
STAT,1896,22,25-29,1918,76.53287188602879
STAT,1863,23,25-29,1886,51.87429004127513
SIM,1835,23,15-19,1858,3
STAT,1863,36,30-34,1899,4.792339930756589
STAT,1878,92,na,1970,166.0989952057526
STAT,1931,27,50-100,1958,1.2987248499847017
STAT,1838,39,15-19,1877,0.04442742952670071
STAT,1945,15,50-100,1960,0.4135352996112874
SIM,1870,100,na,1970,18
SIM,1922,30,30-34,1952,35
STAT,1857,2,na,1859,2774.5897343616934
STAT,1844,58,na,1902,1564.643879635404
STAT,1897,34,35-39,1931,13.595240683255966
SIM,1878,48,50-100,1926,4
SIM,1892,38,30-34,1930,10
SIM,1904,5,na,1909,3955
SIM,1836,35,25-29,1871,6
STAT,1861,15,15-19,1876,5.792835292105587
STAT,1933,33,45-49,1966,2.1415646913662463
SIM,1865,94,na,1959,83
STAT,1895,26,25-29,1921,55.98549520390127
SIM,1867,85,na,1952,241
SIM,1869,34,25-29,1903,12
SIM,1890,15,35-39,1905,2
STAT,1810,46,na,1856,1540.4651429272978
SIM,1854,35,na,1889,2195
SIM,1819,36,na,1855,1621
SIM,1933,1,na,1934,5331
SIM,1940,29,30-34,1969,45
STAT,1855,17,40-44,1872,0.16375061350672576
STAT,1874,34,40-44,1908,4.446588398716825
SIM,1904,29,20-24,1933,19
STAT,1888,16,40-44,1904,0.2185763845900293
STAT,1817,47,30-34,1864,0.20815121663359007
STAT,1932,29,30-34,1961,51.81262103792176
SIM,1829,68,na,1897,1021
SIM,1853,32,20-24,1885,3
STAT,1846,39,35-39,1885,5.490006851612633
STAT,1927,36,25-29,1963,1.2384439848031379
STAT,1896,35,30-34,1931,7.192894664493357
SIM,1892,52,na,1944,2900
STAT,1848,47,45-49,1895,0.191785890085196
STAT,1831,50,35-39,1881,0.0058859624706789244
STAT,1851,24,45-49,1875,0.6215169890994274
STAT,1925,44,na,1969,4529.028898458771
STAT,1878,17,35-39,1895,0.5752967196742335
STAT,1932,38,50-100,1970,0.569509693270021
STAT,1815,39,20-24,1854,2.3156390659262445
SIM,1892,23,45-49,1915,2
STAT,1940,11,na,1951,4050.8822672281435
STAT,1922,39,15-19,1961,0.022027496014659483
STAT,1863,36,50-100,1899,1.1039825122963205
STAT,1829,44,30-34,1873,0.866808653781983
SIM,1932,38,50-100,1970,1
SIM,1887,38,35-39,1925,9
SIM,1890,61,na,1951,2626
SIM,1863,36,50-100,1899,1
SIM,1886,31,20-24,1917,3
SIM,1879,24,40-44,1903,2
SIM,1888,43,50-100,1931,2
STAT,1819,42,20-24,1861,0.340866583496373
STAT,1873,25,35-39,1898,9.946656822319312
STAT,1885,16,15-19,1901,5.980880933321286
STAT,1847,15,40-44,1862,0.17295385742822666
STAT,1858,72,na,1930,1000.7009784925772
STAT,1864,15,40-44,1879,0.19174974281163998
STAT,1923,23,35-39,1946,11.035437519568882
STAT,1912,40,35-39,1952,0.1981605551096613
SIM,1875,72,na,1947,1339
STAT,1856,47,50-100,1903,0.1892928144271066
SIM,1887,43,30-34,1930,2
STAT,1935,32,na,1967,5286.516811821255
SIM,1880,26,30-34,1906,21
STAT,1872,22,na,1894,2401.519752352643
STAT,1884,23,45-49,1907,0.6923827076565576
SIM,1865,37,45-49,1902,5
SIM,1840,21,30-34,1861,29
STAT,1876,39,35-39,1915,7.301710617722479
STAT,1857,42,40-44,1899,1.7707960999115615
SIM,1845,30,20-24,1875,2
STAT,1939,21,45-49,1960,1.1411402024599482
SIM,1882,28,20-24,1910,9
STAT,1869,24,30-34,1893,17.38142642520941
STAT,1870,26,20-24,1896,11.6750441083182
STAT,1907,40,40-44,1947,0.23400943277888356
SIM,1845,27,50-100,1872,5
STAT,1918,43,20-24,1961,0.018926601462422272
STAT,1835,25,15-19,1860,0.450423705979017
SIM,1822,33,30-34,1855,23
STAT,1844,49,40-44,1893,0.132622626782259
STAT,1834,32,45-49,1866,1.330279713267483
STAT,1932,14,na,1946,5284.9783944150195
STAT,1879,43,30-34,1922,1.2029967015955483
STAT,1940,23,35-39,1963,9.680385559876452
SIM,1842,32,45-49,1874,2
STAT,1872,51,35-39,1923,0.008783644793005446
STAT,1862,37,40-44,1899,3.818146829466806
STAT,1927,41,20-24,1968,0.022418976184437323
SIM,1907,45,na,1952,3617
SIM,1857,75,na,1932,941
STAT,1838,37,35-39,1875,5.713262376620763
SIM,1844,35,na,1879,1658
STAT,1807,80,na,1887,265.2975116936398
STAT,1874,28,20-24,1902,12.089838269807586
STAT,1927,13,na,1940,4971.828283852592
SIM,1884,39,35-39,1923,14
SIM,1838,43,35-39,1881,7
SIM,1931,17,na,1948,4797
SIM,1941,30,40-44,1971,6
SIM,1834,44,50-100,1878,4
STAT,1839,54,50-100,1893,0.010412992141509276
SIM,1855,15,40-44,1870,1
SIM,1936,32,25-29,1968,15
STAT,1829,31,25-29,1860,9.363644634599746
SIM,1902,14,na,1916,3920
STAT,1905,35,35-39,1940,2.2501936102636018
STAT,1841,22,35-39,1863,5.528137757306222
STAT,1866,35,45-49,1901,1.8820798822481708
STAT,1908,36,15-19,1944,0.01823689708748258
SIM,1921,29,20-24,1950,23
SIM,1947,21,45-49,1968,1
STAT,1864,27,35-39,1891,8.793909635258487
SIM,1872,42,na,1914,2509
SIM,1898,67,na,1965,2380
STAT,1848,44,40-44,1892,1.811651765497127
SIM,1872,27,35-39,1899,13
STAT,1880,15,25-29,1895,6.038685208522672
SIM,1867,53,na,1920,1861
STAT,1885,8,na,1893,2613.4219002906593
STAT,1892,25,45-49,1917,1.4167218071984782
STAT,1816,41,50-100,1857,3.1486852979065443
SIM,1849,56,na,1905,1602
STAT,1955,17,45-49,1972,0.6699516505932664
STAT,1771,110,na,1881,0.0015701718940508106
SIM,1914,47,na,1961,3843
STAT,1930,21,50-100,1951,0.8545484267775136
STAT,1937,30,25-29,1967,9.241929973845819
SIM,1837,31,25-29,1868,10
SIM,1867,39,35-39,1906,9
STAT,1928,32,25-29,1960,11.681293207107922
SIM,1907,35,na,1942,3768
SIM,1913,35,35-39,1948,2
SIM,1823,38,50-100,1861,1
STAT,1889,32,35-39,1921,12.612189205310628
STAT,1920,42,35-39,1962,0.22458381525387414
STAT,1827,49,40-44,1876,0.1710031918329775
STAT,1913,29,20-24,1942,18.220272032171444
SIM,1901,28,40-44,1929,6
SIM,1959,11,na,1970,5498
STAT,1833,47,15-19,1880,3.3271839082609774E-4
SIM,1897,32,35-39,1929,26
SIM,1936,15,35-39,1951,7
SIM,1888,34,35-39,1922,24
STAT,1886,33,20-24,1919,2.8703586757406114
STAT,1947,20,40-44,1967,3.8411307046911443
STAT,1853,39,40-44,1892,3.5836574731336133
SIM,1856,31,35-39,1887,4
STAT,1889,45,40-44,1934,0.21533711274632542
SIM,1901,20,45-49,1921,2
STAT,1909,15,25-29,1924,8.615352218570331
SIM,1894,28,25-29,1922,77
SIM,1839,56,na,1895,1327
STAT,1839,16,45-49,1855,0.06094161743543098
STAT,1922,19,20-24,1941,157.65847884255882
SIM,1826,38,35-39,1864,10
STAT,1825,34,45-49,1859,3.335564020604915
SIM,1831,23,30-34,1854,18
SIM,1846,37,35-39,1883,12
STAT,1902,22,50-100,1924,0.5820229617605535
SIM,1871,20,20-24,1891,79
SIM,1802,79,na,1881,272
SIM,1837,27,40-44,1864,6
STAT,1936,31,20-24,1967,2.393250053700072
SIM,1831,60,na,1891,1273
SIM,1851,22,45-49,1873,2
SIM,1895,49,na,1944,3018
SIM,1902,21,15-19,1923,3
STAT,1870,48,30-34,1918,0.09479879451083867
SIM,1893,29,35-39,1922,20
SIM,1843,38,35-39,1881,14
STAT,1871,38,na,1909,2352.318865034659
STAT,1928,15,35-39,1943,5.368993232709147
SIM,1896,33,30-34,1929,9
STAT,1885,29,35-39,1914,9.63110096793948
SIM,1874,35,45-49,1909,2
SIM,1887,83,na,1970,779
STAT,1801,109,na,1910,2.831470693528613E-4
STAT,1839,54,40-44,1893,0.0072585678172977066
STAT,1866,18,50-100,1884,0.04675227502922248
SIM,1936,20,30-34,1956,60
SIM,1833,34,45-49,1867,1
SIM,1899,26,50-100,1925,2
STAT,1896,18,40-44,1914,0.2438863158231392
STAT,1861,50,20-24,1911,6.282209729659978E-4
SIM,1894,21,na,1915,3294
STAT,1803,76,na,1879,471.8906086786941
STAT,1837,30,20-24,1867,2.360591153197536
STAT,1852,40,50-100,1892,0.8092890474066389
STAT,1934,26,15-19,1960,0.9600154554962714
STAT,1899,49,30-34,1948,0.07410809605956362
SIM,1931,23,35-39,1954,14
STAT,1855,37,35-39,1892,5.323935415085674
SIM,1906,33,50-100,1939,3
STAT,1829,27,40-44,1856,3.9640628435676333
SIM,1917,15,25-29,1932,12
SIM,1888,22,40-44,1910,3
STAT,1809,48,35-39,1857,0.4812393407596773
STAT,1864,29,15-19,1893,0.41054332362963875
STAT,1885,72,na,1957,1332.7029411211038
STAT,1886,28,25-29,1914,44.95115210726504
STAT,1818,38,35-39,1856,16.26774436484337
STAT,1884,32,50-100,1916,0.9125759919875516
STAT,1918,30,15-19,1948,0.13896908303011984
SIM,1878,32,25-29,1910,7
SIM,1893,16,15-19,1909,6
SIM,1920,31,50-100,1951,2
SIM,1861,26,20-24,1887,12
STAT,1891,28,20-24,1919,14.61828585435818
SIM,1834,31,50-100,1865,5
SIM,1827,37,25-29,1864,3
SIM,1830,76,na,1906,454
STAT,1869,33,20-24,1902,2.6430903716467973
SIM,1930,19,20-24,1949,185
SIM,1929,22,40-44,1951,9
STAT,1939,23,50-100,1962,0.6668931097359699
SIM,1836,38,na,1874,1914
STAT,1838,42,30-34,1880,0.9000497709679299
STAT,1944,16,30-34,1960,13.249336610967918
STAT,1854,38,45-49,1892,1.4886644045538275
STAT,1881,24,30-34,1905,17.2328632422559
STAT,1875,25,45-49,1900,1.1594388211594362
STAT,1928,20,30-34,1948,36.4875086495626
STAT,1849,36,na,1885,1904.555396785937
STAT,1798,80,na,1878,306.79167373
STAT,1853,26,20-24,1879,11.320189735112482
STAT,1919,42,25-29,1961,0.07813385645944446
SIM,1883,25,45-49,1908,1
STAT,1800,58,na,1858,894.274502734758
STAT,1830,29,45-49,1859,1.1168124530800618
SIM,1816,61,na,1877,998
SIM,1942,26,15-19,1968,4
STAT,1895,43,15-19,1938,0.0012557262300699117
STAT,1860,22,45-49,1882,0.5934925023220416
STAT,1824,37,20-24,1861,1.0750589147091396
SIM,1877,33,20-24,1910,7
SIM,1834,37,30-34,1871,8
SIM,1907,13,na,1920,4076
STAT,1878,39,45-49,1917,2.0690449179045305
STAT,1898,46,45-49,1944,0.18279158410602653
STAT,1847,23,40-44,1870,1.8989504586668202
STAT,1926,32,15-19,1958,0.15704143362643103
SIM,1832,29,20-24,1861,16
SIM,1916,39,40-44,1955,4
STAT,1888,70,na,1958,1762.8381628130396
STAT,1850,50,45-49,1900,0.011272045154981064
STAT,1907,47,na,1954,3322.086690403546
STAT,1893,28,30-34,1921,32.18063673581684
SIM,1887,35,30-34,1922,12
SIM,1859,28,50-100,1887,1
STAT,1937,13,na,1950,3885.393367007319
SIM,1917,45,na,1962,3719
STAT,1830,56,na,1886,1361.9739955755017
STAT,1929,27,45-49,1956,2.185382310165473
SIM,1879,54,na,1933,2486
STAT,1826,31,50-100,1857,1.3660959820522776
STAT,1899,39,15-19,1938,0.01663171769526005
STAT,1931,40,45-49,1971,0.22532889974134648
SIM,1853,15,30-34,1868,1
SIM,1886,34,25-29,1920,12
SIM,1937,27,45-49,1964,3
STAT,1881,49,45-49,1930,0.22496420413099466
STAT,1944,3,na,1947,4363.927474638179
SIM,1865,39,25-29,1904,3
STAT,1834,24,45-49,1858,0.5474923548752458
STAT,1945,24,25-29,1969,102.16815650678636
SIM,1845,25,25-29,1870,61
SIM,1854,44,30-34,1898,1
SIM,1900,16,30-34,1916,2
STAT,1915,29,30-34,1944,40.03899684397491
STAT,1865,42,na,1907,2128.9304499136715
SIM,1861,37,na,1898,2041
STAT,1851,21,40-44,1872,1.8978689795981183
STAT,1879,35,30-34,1914,5.670722921526433
SIM,1838,35,35-39,1873,13
STAT,1830,26,40-44,1856,3.4905384537712623
SIM,1928,21,35-39,1949,12
STAT,1816,94,na,1910,10.218342665628207
STAT,1825,49,30-34,1874,0.12642595135517687
STAT,1845,15,30-34,1860,1.4894699700658107
SIM,1849,26,20-24,1875,11
STAT,1838,45,35-39,1883,0.09892091028112449
SIM,1867,17,25-29,1884,11
STAT,1848,31,35-39,1879,9.742986629647197
STAT,1826,37,30-34,1863,6.160901282061406
STAT,1846,44,30-34,1890,0.8606891917461406
SIM,1827,34,20-24,1861,2
STAT,1843,22,45-49,1865,0.5903490360997207
STAT,1866,7,na,1873,2610.9604024743408
STAT,1908,39,40-44,1947,1.4005994274037108
SIM,1872,74,na,1946,1046
SIM,1932,12,na,1944,5985
STAT,1927,33,20-24,1960,3.0308192431052428
SIM,1849,25,50-100,1874,5
STAT,1888,33,30-34,1921,20.72609827418523
STAT,1857,37,45-49,1894,1.5713545926290222
STAT,1877,22,15-19,1899,3.438979576525973
SIM,1892,20,na,1912,3204
STAT,1892,49,20-24,1941,0.00839976856439588
STAT,1909,20,20-24,1929,104.9081017325935
SIM,1861,34,20-24,1895,2
SIM,1886,49,50-100,1935,1
SIM,1920,25,25-29,1945,93
STAT,1929,41,30-34,1970,0.16758453028666
STAT,1897,26,35-39,1923,13.11005285674111
STAT,1789,104,na,1893,0.020301261153953296
SIM,1869,31,20-24,1900,3
STAT,1866,42,50-100,1908,0.9868117914256824
SIM,1781,90,na,1871,4
STAT,1918,26,30-34,1944,42.24253931205503
SIM,1906,20,50-100,1926,6
SIM,1893,24,15-19,1917,4
STAT,1872,26,30-34,1898,25.657977242547222
SIM,1834,25,na,1859,2059
STAT,1929,28,50-100,1957,1.2584864217303502
STAT,1914,33,35-39,1947,9.24182388233951
SIM,1861,7,na,1868,2541
SIM,1876,26,50-100,1902,5
STAT,1837,25,25-29,1862,37.577754104404114
SIM,1935,33,20-24,1968,3
STAT,1836,37,25-29,1873,2.229436484830115
SIM,1918,27,50-100,1945,1
STAT,1863,20,20-24,1883,63.8111220528132
STAT,1853,34,20-24,1887,2.2546512098997495
STAT,1878,5,na,1883,2852.044251461411
STAT,1941,19,30-34,1960,12.666630840158863
SIM,1889,43,40-44,1932,8
SIM,1922,33,35-39,1955,12
STAT,1885,24,15-19,1909,3.295870610768612
SIM,1829,42,30-34,1871,3
STAT,1878,49,50-100,1927,0.2521240778103004
STAT,1837,35,na,1872,1816.2253651564508
SIM,1853,24,20-24,1877,57
STAT,1842,34,45-49,1876,1.8576455809836425
STAT,1859,17,25-29,1876,5.343449497037168
STAT,1880,2,na,1882,3404.24467170838
STAT,1807,90,na,1897,27.927705559314557
STAT,1820,46,na,1866,1328.854129408458
STAT,1851,39,30-34,1890,3.9948758178169843
STAT,1864,68,na,1932,1392.779644848913
STAT,1887,45,30-34,1932,0.11024436759613243
STAT,1867,33,na,1900,2260.3323628741755
STAT,1845,35,25-29,1880,2.480018746159181
SIM,1891,29,25-29,1920,68
STAT,1786,106,na,1892,0.0064879165281824195
STAT,1845,24,20-24,1869,61.61606574055609
SIM,1882,84,na,1966,439
STAT,1933,30,40-44,1963,5.335194632976147
STAT,1832,39,20-24,1871,0.6511709695464799
STAT,1928,17,50-100,1945,0.4771573642578835
STAT,1867,38,30-34,1905,5.044465959862738
SIM,1926,26,30-34,1952,89
STAT,1850,4,na,1854,2494.0
STAT,1855,21,25-29,1876,50.703824944583864
STAT,1878,34,25-29,1912,10.646965148816085
STAT,1854,42,15-19,1896,0.010351331659251704
STAT,1860,49,50-100,1909,0.19854011820636436
STAT,1868,28,30-34,1896,24.22229432040025
SIM,1824,38,25-29,1862,3
STAT,1854,68,na,1922,1146.8917241968404
STAT,1872,17,40-44,1889,0.1863345000298557
SIM,1846,34,30-34,1880,22
SIM,1923,29,30-34,1952,44
SIM,1898,36,45-49,1934,3
STAT,1878,26,25-29,1904,44.50332795881596
STAT,1868,24,15-19,1892,3.1645821491002932
STAT,1862,27,25-29,1889,37.03217466492391
STAT,1882,22,na,1904,2313.8395487088483
STAT,1942,20,50-100,1962,0.6970491754125105
STAT,1907,25,na,1932,3563.772649437134
STAT,1858,38,15-19,1896,0.04427542055811149
STAT,1918,22,15-19,1940,5.796148562009587
STAT,1872,15,50-100,1887,0.05050420206003683
STAT,1856,16,45-49,1872,0.060164562024413074
SIM,1900,32,45-49,1932,3
STAT,1782,109,na,1891,0.0020670083241238124
SIM,1886,39,45-49,1925,1
SIM,1917,5,na,1922,4252
STAT,1874,21,35-39,1895,6.053212923145517
STAT,1846,36,30-34,1882,4.2677172507536225
STAT,1852,24,na,1876,1898.7497888429696
SIM,1938,20,40-44,1958,4
SIM,1847,24,45-49,1871,1
STAT,1844,23,15-19,1867,3.2355254315088424
SIM,1870,27,25-29,1897,67
STAT,1938,34,35-39,1972,9.264309875512977
STAT,1816,38,25-29,1854,11.574938566223812
SIM,1945,26,40-44,1971,5
SIM,1912,46,na,1958,3391
SIM,1848,42,40-44,1890,5
STAT,1896,39,50-100,1935,1.624875416884278
SIM,1883,1,na,1884,3699
STAT,1837,27,50-100,1864,0.560129031698731
STAT,1883,29,25-29,1912,41.5106913694293
SIM,1845,16,35-39,1861,2
SIM,1903,22,20-24,1925,116
STAT,1903,32,20-24,1935,3.8881155436801014
SIM,1923,6,na,1929,4801
SIM,1852,23,15-19,1875,3
SIM,1911,32,20-24,1943,3
STAT,1839,24,45-49,1863,0.6261332911964766
SIM,1857,85,na,1942,243
STAT,1864,35,35-39,1899,6.50738997366673
SIM,1952,2,na,1954,4804
SIM,1902,46,na,1948,3418
SIM,1928,30,25-29,1958,16
STAT,1937,26,40-44,1963,4.588974648308711
SIM,1824,90,na,1914,22
STAT,1859,15,50-100,1874,0.04674600663215566
SIM,1864,25,35-39,1889,16
STAT,1794,98,na,1892,0.6317410149446152
SIM,1877,73,na,1950,1172
STAT,1898,38,45-49,1936,0.5862163555529258
STAT,1925,31,45-49,1956,1.8895440806102124
SIM,1825,32,45-49,1857,1
SIM,1854,36,30-34,1890,9
STAT,1862,49,35-39,1911,0.11956126136411395
SIM,1896,24,40-44,1920,3
SIM,1868,26,30-34,1894,42
STAT,1925,12,na,1937,4837.215557115765
SIM,1927,34,25-29,1961,12
STAT,1867,53,50-100,1920,0.014135403829415536
STAT,1875,19,na,1894,2605.5544489935164
SIM,1918,24,30-34,1942,37
STAT,1820,36,25-29,1856,7.596036188527677
STAT,1879,46,35-39,1925,0.1479789255925208
STAT,1797,63,na,1860,883.8774061037482
SIM,1867,36,30-34,1903,10
STAT,1887,21,na,1908,2674.989194230621
STAT,1911,19,45-49,1930,0.1003096403220918
STAT,1926,24,15-19,1950,6.495082146809607
SIM,1857,35,45-49,1892,2
STAT,1850,19,20-24,1869,16.393574875883186
SIM,1886,26,25-29,1912,63
STAT,1819,45,25-29,1864,0.11563851603371776
SIM,1874,55,na,1929,1916
STAT,1821,73,na,1894,711.4542556077689
STAT,1936,22,30-34,1958,27.740967811825936
STAT,1890,51,na,1941,2670.1428327229632
SIM,1882,34,40-44,1916,7
SIM,1946,1,na,1947,4516
SIM,1829,33,40-44,1862,8
STAT,1865,20,na,1885,2239.7415902646835
SIM,1930,15,40-44,1945,2
STAT,1857,55,na,1912,1629.8634942914975
STAT,1932,25,50-100,1957,1.318639958032394
SIM,1863,21,25-29,1884,3
SIM,1863,49,50-100,1912,2
STAT,1905,39,15-19,1944,0.017518942334286365
SIM,1849,24,na,1873,1990
SIM,1885,27,35-39,1912,14
STAT,1828,48,50-100,1876,0.22082251548942314
SIM,1819,58,na,1877,1168
SIM,1922,22,30-34,1944,46
STAT,1915,34,na,1949,3853.471398362768
STAT,1810,47,20-24,1857,0.0463569340849528
STAT,1870,29,25-29,1899,41.654198385798836
SIM,1934,24,15-19,1958,8
STAT,1888,24,40-44,1912,2.4685817550725835
SIM,1850,28,25-29,1878,47
SIM,1815,43,40-44,1858,3
SIM,1861,39,40-44,1900,4
STAT,1813,54,50-100,1867,0.04011356324131896
SIM,1818,36,35-39,1854,4
STAT,1873,26,50-100,1899,0.6572349015612888
SIM,1878,24,25-29,1902,68
STAT,1914,16,45-49,1930,0.1045142700412069
SIM,1836,48,50-100,1884,3
SIM,1915,27,30-34,1942,59
STAT,1907,43,45-49,1950,0.15303796636877867
STAT,1931,25,35-39,1956,19.606630814837953
STAT,1948,16,15-19,1964,52.48081349611745
SIM,1874,32,40-44,1906,9
STAT,1922,32,30-34,1954,17.983508343215938
STAT,1785,106,na,1891,0.008828114874439798
STAT,1934,29,40-44,1963,6.329363935581804
STAT,1891,36,na,1927,2960.2777981172057
SIM,1819,35,25-29,1854,1
STAT,1842,28,25-29,1870,46.760173821153806
STAT,1857,48,15-19,1905,3.113357429873646E-4
SIM,1876,37,20-24,1913,3
STAT,1838,34,30-34,1872,14.225031875643925
SIM,1812,79,na,1891,228
SIM,1871,68,na,1939,1411
STAT,1835,54,na,1889,1582.9162876520388
STAT,1923,0,na,1923,5345.07037888271
SIM,1903,30,20-24,1933,4
SIM,1930,32,30-34,1962,31
STAT,1927,44,25-29,1971,0.0902189230897621
SIM,1836,23,30-34,1859,23
STAT,1867,16,20-24,1883,17.341974089865037
SIM,1885,49,na,1934,2378
STAT,1843,27,15-19,1870,0.3765971795683504
STAT,1914,17,20-24,1931,28.295683904817217
SIM,1902,68,na,1970,2558
SIM,1831,26,35-39,1857,17
SIM,1875,38,30-34,1913,6
SIM,1922,17,20-24,1939,174
STAT,1919,34,25-29,1953,9.982030051916734
STAT,1874,19,50-100,1893,0.050395174904663775
SIM,1919,14,na,1933,4324
STAT,1840,48,45-49,1888,0.16470236947664432
SIM,1837,23,25-29,1860,68
STAT,1910,13,na,1923,3941.9872170940403
SIM,1879,36,35-39,1915,18
STAT,1842,26,45-49,1868,1.2451500437931102
SIM,1800,78,na,1878,406
SIM,1820,38,40-44,1858,3
SIM,1929,25,45-49,1954,2
STAT,1951,21,45-49,1972,1.3586368498044168
STAT,1887,37,30-34,1924,6.009876789990185
STAT,1892,22,40-44,1914,2.6409759532784136
STAT,1926,46,50-100,1972,0.2827560885206298
STAT,1864,24,30-34,1888,16.258923735176783
STAT,1835,20,45-49,1855,1.0999515974651635
SIM,1878,37,45-49,1915,2
STAT,1835,42,50-100,1877,0.950448866749636
SIM,1893,26,30-34,1919,68
STAT,1876,48,25-29,1924,0.059312999558021065
STAT,1885,43,50-100,1928,1.0544186292848174
STAT,1805,57,na,1862,1246.1085054090584
SIM,1894,25,20-24,1919,18
SIM,1888,25,45-49,1913,1
SIM,1924,25,na,1949,4415
STAT,1819,47,40-44,1866,0.3336439352865683
STAT,1890,19,15-19,1909,7.284911971651732
STAT,1928,23,35-39,1951,11.846051470991085
SIM,1932,39,25-29,1971,1
STAT,1877,21,na,1898,2472.825020383923
SIM,1862,54,na,1916,1919
STAT,1900,18,30-34,1918,2.2303577212898555
SIM,1942,29,40-44,1971,9
STAT,1886,38,40-44,1924,4.644984389245977
STAT,1947,23,45-49,1970,1.2840775553588222
STAT,1813,44,na,1857,1379.5290041261183
STAT,1876,69,na,1945,1530.4172626185295
STAT,1917,21,50-100,1938,0.7080245945427956
SIM,1888,31,30-34,1919,29
STAT,1836,21,15-19,1857,2.766490948973147
SIM,1907,31,50-100,1938,1
STAT,1903,15,30-34,1918,2.3032948995794014
SIM,1865,30,50-100,1895,6
SIM,1826,35,30-34,1861,12
STAT,1898,15,na,1913,3474.148811864494
STAT,1912,25,25-29,1937,65.88417696333099
SIM,1874,26,20-24,1900,12
STAT,1827,44,20-24,1871,0.165082582791389
STAT,1824,60,na,1884,1019.1308492934741
SIM,1919,36,40-44,1955,4
STAT,1821,48,35-39,1869,0.20224590580419588
SIM,1806,61,na,1867,1066
STAT,1883,71,na,1954,1319.278663825011
SIM,1877,20,15-19,1897,4
SIM,1926,28,45-49,1954,2
STAT,1840,15,45-49,1855,0.05999053819437539
SIM,1872,24,30-34,1896,26
SIM,1895,37,30-34,1932,14
SIM,1826,38,na,1864,2026
STAT,1885,26,30-34,1911,25.403192717874767
STAT,1922,14,na,1936,4617.507445915136
SIM,1863,39,na,1902,2129
STAT,1841,93,na,1934,21.855174431722112
STAT,1803,98,na,1901,1.3541989346165204
SIM,1894,38,40-44,1932,13
SIM,1932,34,na,1966,5725
STAT,1825,31,40-44,1856,11.785022221204116
STAT,1922,15,40-44,1937,1.6429107091635988
STAT,1886,25,20-24,1911,12.595211773682292
STAT,1864,18,45-49,1882,0.0612239535094322
STAT,1894,35,20-24,1929,1.0118816251700236
SIM,1936,23,35-39,1959,19
STAT,1849,35,45-49,1884,1.628341419131821
STAT,1848,72,na,1920,1031.101214015549
STAT,1800,109,na,1909,2.495699545401048E-4
SIM,1845,33,25-29,1878,16
SIM,1833,31,40-44,1864,4
SIM,1856,44,40-44,1900,3
STAT,1940,20,30-34,1960,29.578674667523032
STAT,1836,39,na,1875,1623.5014564006779
STAT,1837,33,25-29,1870,8.670555136272053
SIM,1859,15,25-29,1874,11
SIM,1901,19,na,1920,3659
STAT,1945,21,20-24,1966,123.11473531113569
SIM,1847,30,30-34,1877,22
STAT,1872,8,na,1880,2749.140651031366
SIM,1846,28,45-49,1874,1
STAT,1869,20,15-19,1889,3.272783586491062
SIM,1929,20,25-29,1949,6
SIM,1941,17,30-34,1958,14
STAT,1928,36,40-44,1964,1.9139827742638156
SIM,1916,24,20-24,1940,110
STAT,1863,19,na,1882,2319.353174007646
SIM,1817,37,30-34,1854,9
SIM,1870,29,40-44,1899,10
STAT,1834,91,na,1925,34.492192698132826
STAT,1933,17,30-34,1950,16.48803658194293
SIM,1845,22,20-24,1867,84
STAT,1795,94,na,1889,5.0284528659859395
STAT,1847,26,45-49,1873,1.0064365044307932
SIM,1863,37,35-39,1900,16
STAT,1851,61,na,1912,1414.9080456366448
STAT,1862,15,30-34,1877,1.61112622086319
STAT,1887,28,40-44,1915,3.366045160508587
SIM,1842,21,40-44,1863,3
STAT,1862,29,40-44,1891,2.5941175420499545
STAT,1864,47,50-100,1911,0.22279315167430172
STAT,1895,29,na,1924,3125.2392815618578
STAT,1955,10,na,1965,5269.596660773986
STAT,1846,20,20-24,1866,65.46352291215837
SIM,1844,57,na,1901,1337
STAT,1855,74,na,1929,835.3609914859478
SIM,1897,51,na,1948,2929
STAT,1844,39,25-29,1883,2.3577178925460927
SIM,1833,94,na,1927,9
STAT,1902,16,na,1918,3613.549943396706
SIM,1801,84,na,1885,23
SIM,1918,20,15-19,1938,9
STAT,1924,39,25-29,1963,1.170731631074831
STAT,1842,24,na,1866,2393.289523326275
SIM,1954,13,na,1967,4836
SIM,1828,37,40-44,1865,8
STAT,1819,36,50-100,1855,3.972212875672146
SIM,1939,24,15-19,1963,7
STAT,1830,24,25-29,1854,120.5763502711216
SIM,1880,22,15-19,1902,3
STAT,1851,15,20-24,1866,16.5148895529537
SIM,1895,28,40-44,1923,5
STAT,1829,35,40-44,1864,3.704695086732025
STAT,1853,37,25-29,1890,2.381028493615831
STAT,1852,103,na,1955,0.10884063592480042
STAT,1859,89,na,1948,85.3387131156958
STAT,1942,20,40-44,1962,3.5619210272146598
STAT,1834,21,40-44,1855,1.6776586634418238
SIM,1895,15,35-39,1910,1
SIM,1842,18,25-29,1860,10
STAT,1884,66,na,1950,1632.4459136473797
SIM,1852,25,30-34,1877,36
SIM,1892,19,na,1911,3469
STAT,1896,27,45-49,1923,1.4843877842916384
STAT,1812,47,30-34,1859,0.22327417921972134
SIM,1827,87,na,1914,88
SIM,1934,15,25-29,1949,77
STAT,1838,28,45-49,1866,0.9386811625504485
STAT,1965,5,na,1970,4956.475848088149
SIM,1906,29,30-34,1935,40
STAT,1837,42,15-19,1879,0.011117142941315872
STAT,1875,53,50-100,1928,0.015413320134105579
SIM,1861,17,30-34,1878,1
SIM,1863,25,40-44,1888,4
STAT,1857,21,35-39,1878,5.3485891202878095
STAT,1894,19,35-39,1913,0.709679519356167
STAT,1934,34,15-19,1968,0.17705341250339102
STAT,1846,49,na,1895,1671.7215669079953
SIM,1844,26,35-39,1870,2
STAT,1846,47,35-39,1893,0.1057485693406725
STAT,1849,48,15-19,1897,3.088112940744186E-4
SIM,1929,14,na,1943,4941
STAT,1871,27,40-44,1898,3.005821335797211
STAT,1889,41,50-100,1930,1.3216522727477016
STAT,1903,35,25-29,1938,0.9023905681331241
STAT,1853,17,30-34,1870,1.5855796376429507
SIM,1938,32,35-39,1970,1
STAT,1829,36,45-49,1865,1.6608223179615513
SIM,1865,21,35-39,1886,9
SIM,1895,29,45-49,1924,1
SIM,1908,25,25-29,1933,80
STAT,1899,27,20-24,1926,16.261573009794727
SIM,1835,28,35-39,1863,14
STAT,1827,28,35-39,1855,19.369951475743104
STAT,1872,48,40-44,1920,0.1716557492923418
SIM,1820,44,na,1864,1436
STAT,1819,38,na,1857,1469.9255902269306
STAT,1810,48,50-100,1858,0.93093399841378
STAT,1855,25,40-44,1880,2.620213553586033
STAT,1859,99,na,1958,2.4755539813877583
STAT,1898,49,15-19,1947,3.024884412383554E-4
SIM,1870,15,30-34,1885,2
STAT,1864,49,45-49,1913,0.21059651304564014
SIM,1871,36,30-34,1907,6
STAT,1847,49,50-100,1896,0.18005033478460028
SIM,1909,34,30-34,1943,24
STAT,1836,26,35-39,1862,7.93328316164061
STAT,1885,19,na,1904,2525.4705176438943
SIM,1930,35,35-39,1965,3
STAT,1907,15,15-19,1922,8.843187805670162
STAT,1941,28,na,1969,3910.5765407771946
STAT,1924,19,30-34,1943,14.58870342052478
STAT,1844,25,30-34,1869,24.743798643528418
SIM,1900,28,25-29,1928,6
STAT,1854,16,35-39,1870,0.49552831982385015
SIM,1859,36,30-34,1895,9
STAT,1887,15,35-39,1902,0.6216244428059575
STAT,1916,30,40-44,1946,4.110041484462274
STAT,1827,57,na,1884,1259.2737538045437
STAT,1837,49,35-39,1886,0.09663684464855381
STAT,1909,23,25-29,1932,86.36259144494605
STAT,1931,29,15-19,1960,0.9202103624954912
STAT,1880,41,na,1921,2462.6489874590457
STAT,1892,16,20-24,1908,22.523955428757233
STAT,1902,18,40-44,1920,0.2603662775827282
STAT,1944,18,45-49,1962,0.5426797337718033
STAT,1863,23,50-100,1886,0.3695276781592481
STAT,1842,17,20-24,1859,20.496808276911793
STAT,1937,22,25-29,1959,90.80818070724563
SIM,1828,38,45-49,1866,2
SIM,1894,36,25-29,1930,4
SIM,1927,25,35-39,1952,32
STAT,1873,16,45-49,1889,0.06728062076417053
SIM,1898,33,40-44,1931,8
SIM,1837,35,40-44,1872,2
SIM,1890,37,50-100,1927,4
STAT,1938,31,30-34,1969,16.002175421771554
SIM,1822,57,na,1879,1257
STAT,1818,49,25-29,1867,0.09954752479773961
STAT,1896,26,40-44,1922,4.018576420927159
SIM,1840,36,50-100,1876,2
STAT,1890,73,na,1963,1713.9165264951332
SIM,1861,37,25-29,1898,5
STAT,1919,31,20-24,1950,2.6678991626799666
SIM,1879,33,30-34,1912,23
SIM,1945,22,25-29,1967,167
STAT,1848,111,na,1959,1.3211925414605502E-4
STAT,1859,67,na,1926,1287.7288401960955
STAT,1804,107,na,1911,0.0014620383160091261
STAT,1817,57,na,1874,1112.6713039809938
SIM,1835,27,30-34,1862,27
SIM,1887,29,45-49,1916,2
STAT,1803,107,na,1910,0.0019659099868515758
STAT,1816,47,15-19,1863,0.001034356018836615
STAT,1953,17,35-39,1970,5.1285235811176255
SIM,1899,32,45-49,1931,3
STAT,1908,24,20-24,1932,102.54557446213057
STAT,1879,29,45-49,1908,1.1618952318816216
SIM,1850,17,20-24,1867,24
STAT,1886,36,25-29,1922,3.0851335044352792
STAT,1910,45,na,1955,3474.4641725068
STAT,1939,30,35-39,1969,9.423575341974425
SIM,1911,35,25-29,1946,5
STAT,1890,39,45-49,1929,2.435521548640719
SIM,1852,86,na,1938,67
SIM,1820,76,na,1896,455
STAT,1835,47,25-29,1882,0.04558683779580227
STAT,1852,34,na,1886,1835.2768953757177
SIM,1812,47,na,1859,1287
STAT,1866,29,25-29,1895,39.27891200270575
STAT,1922,35,35-39,1957,2.78519830407137
STAT,1957,2,na,1959,5241.071681518137
STAT,1833,39,15-19,1872,0.04882902606659772
STAT,1837,22,20-24,1859,61.543865665112605
STAT,1839,30,30-34,1869,15.552791745571565
STAT,1884,28,15-19,1912,0.45029482552707384
STAT,1928,6,na,1934,5104.62966229108
SIM,1869,38,40-44,1907,7
SIM,1927,31,20-24,1958,3
STAT,1827,27,30-34,1854,75.07775678306793
SIM,1897,24,35-39,1921,13
SIM,1792,84,na,1876,57
STAT,1825,104,na,1929,0.04867494947312241
SIM,1905,24,45-49,1929,1
STAT,1845,37,40-44,1882,3.3607189529605646
STAT,1802,81,na,1883,210.93758449808175
STAT,1877,27,35-39,1904,10.058268009777523
SIM,1950,20,40-44,1970,4
STAT,1867,36,15-19,1903,0.05367254174996616
STAT,1942,16,20-24,1958,143.0904452225096
STAT,1823,48,45-49,1871,0.3202365547076452
STAT,1835,46,20-24,1881,0.009619717318612109
STAT,1843,15,20-24,1858,15.462245416605956
SIM,1833,25,20-24,1858,4
SIM,1910,23,15-19,1933,4
STAT,1873,22,30-34,1895,18.238167151081388
STAT,1876,28,30-34,1904,26.168328522313498
STAT,1894,18,30-34,1912,2.0671346899893095
STAT,1919,38,50-100,1957,0.4549590503691742
STAT,1855,36,50-100,1891,0.9285955413817388
SIM,1884,28,30-34,1912,25
STAT,1863,93,na,1956,29.868742257720942
STAT,1838,21,25-29,1859,50.078073306053525
SIM,1883,19,25-29,1902,9
STAT,1889,24,35-39,1913,7.2219773495223345
SIM,1850,64,na,1914,1423
SIM,1846,21,25-29,1867,72
SIM,1870,19,na,1889,2805
SIM,1904,25,40-44,1929,4
STAT,1827,67,na,1894,942.6635961819267
STAT,1843,29,30-34,1872,20.60323318117331
SIM,1882,37,45-49,1919,3
STAT,1863,32,15-19,1895,0.1274391701365301
SIM,1858,27,25-29,1885,48
SIM,1920,2,na,1922,4950
STAT,1870,51,25-29,1921,0.0035297347553698735
SIM,1794,75,na,1869,469
SIM,1852,76,na,1928,589
STAT,1841,48,50-100,1889,0.18214723729900772
STAT,1887,48,35-39,1935,0.15588678543246137
STAT,1857,34,40-44,1891,3.389125281740006
STAT,1909,36,30-34,1945,1.749201992335767
SIM,1838,61,na,1899,1369
SIM,1879,27,45-49,1906,3
SIM,1937,20,25-29,1957,97
STAT,1836,72,na,1908,796.2855309117068
STAT,1885,29,na,1914,2382.1138709784373
STAT,1828,26,35-39,1854,25.077813106758978
SIM,1937,11,na,1948,3793
STAT,1858,33,45-49,1891,1.3759501911203813
STAT,1893,48,na,1941,2849.5650815217023
STAT,1905,66,na,1971,2756.640884921889
SIM,1839,44,40-44,1883,7
STAT,1851,93,na,1944,22.129111359682824
STAT,1870,31,50-100,1901,0.9124351777079606
STAT,1870,15,30-34,1885,1.6148058958607332
SIM,1851,29,30-34,1880,30
SIM,1871,37,35-39,1908,14
SIM,1896,27,45-49,1923,1
STAT,1894,38,25-29,1932,3.725352066740033
STAT,1855,26,45-49,1881,0.8774281579460822
STAT,1888,30,50-100,1918,1.1010468247352982
SIM,1859,37,35-39,1896,7
STAT,1873,93,na,1966,96.82921675873224
STAT,1817,37,15-19,1854,0.21268853902937238
SIM,1895,21,20-24,1916,4
STAT,1898,35,40-44,1933,6.050638272777483
STAT,1842,56,na,1898,1836.353359549083
SIM,1911,8,na,1919,4152
SIM,1874,7,na,1881,2622
SIM,1948,20,35-39,1968,18
STAT,1879,7,na,1886,2813.5565973796647
SIM,1828,30,20-24,1858,2
SIM,1879,22,na,1901,2696
STAT,1877,38,25-29,1915,2.986455619379216
STAT,1856,22,30-34,1878,16.019133946356853
SIM,1876,28,30-34,1904,37
STAT,1846,38,50-100,1884,0.9629218193726758
STAT,1851,48,20-24,1899,0.00897208477260485
SIM,1837,87,na,1924,126
SIM,1866,33,45-49,1899,3
SIM,1885,38,25-29,1923,1
STAT,1873,19,15-19,1892,6.0438566086338295
STAT,1861,38,na,1899,1967.5172636468544
SIM,1864,22,30-34,1886,27
STAT,1881,15,40-44,1896,0.17889542992412083
STAT,1830,24,na,1854,1690.5085591069692
STAT,1888,27,45-49,1915,1.3236053222769837
STAT,1831,47,40-44,1878,0.1278779554919687
STAT,1865,20,30-34,1885,16.86853760288636
STAT,1883,38,15-19,1921,0.05522627140160909
SIM,1950,16,20-24,1966,163
STAT,1919,25,35-39,1944,16.490132042723552
STAT,1891,49,50-100,1940,0.1696226992627366
STAT,1902,48,na,1950,3171.349716542571
SIM,1928,37,45-49,1965,2
SIM,1887,51,na,1938,2325
STAT,1929,20,25-29,1949,118.76804021426145
STAT,1936,25,35-39,1961,14.518369373893805
STAT,1863,28,45-49,1891,0.9901014345529904
SIM,1849,33,45-49,1882,5
SIM,1853,35,25-29,1888,3
SIM,1805,77,na,1882,287
STAT,1898,18,15-19,1916,8.104349781354129
SIM,1857,32,40-44,1889,5
SIM,1929,2,na,1931,5109
STAT,1886,16,30-34,1902,1.7038656891947084
STAT,1916,29,na,1945,3880.963743944825
SIM,1960,5,na,1965,5278
STAT,1835,27,30-34,1862,24.642204318287053
SIM,1887,41,na,1928,2550
STAT,1924,48,na,1972,4407.379475797892
STAT,1925,36,15-19,1961,0.02331411682178844
STAT,1878,43,15-19,1921,0.014374388817828607
SIM,1886,17,35-39,1903,3
STAT,1927,27,35-39,1954,18.44828900909728
SIM,1829,36,45-49,1865,3
SIM,1859,34,na,1893,2241
STAT,1852,25,15-19,1877,0.40658684139447837
STAT,1861,37,25-29,1898,2.4164529446946212
SIM,1889,22,35-39,1911,8
SIM,1900,56,na,1956,3103
STAT,1833,42,na,1875,1802.127551927285
SIM,1843,27,30-34,1870,42
SIM,1855,41,na,1896,1977
STAT,1826,44,50-100,1870,1.0589468130186415
SIM,1918,51,na,1969,4103
STAT,1866,28,20-24,1894,10.933015210544813
STAT,1853,19,na,1872,2256.6831204860046
SIM,1869,22,na,1891,2435
STAT,1852,39,25-29,1891,2.161583393182264
SIM,1886,23,20-24,1909,78
SIM,1830,38,35-39,1868,15
STAT,1887,29,45-49,1916,1.2430803320670574
STAT,1887,21,20-24,1908,77.94350444191811
SIM,1824,41,50-100,1865,1
SIM,1860,39,25-29,1899,6
STAT,1846,27,40-44,1873,2.7501167048879123
SIM,1913,19,20-24,1932,22
SIM,1944,25,35-39,1969,20
SIM,1935,27,35-39,1962,27
STAT,1878,23,20-24,1901,72.02837554804718
STAT,1822,38,35-39,1860,12.611092303430768
SIM,1818,95,na,1913,15
SIM,1854,27,40-44,1881,4
STAT,1826,35,15-19,1861,0.06835163992132075
SIM,1845,38,45-49,1883,3
SIM,1852,54,na,1906,1559
STAT,1857,17,15-19,1874,5.498116555530205
STAT,1861,17,30-34,1878,1.537534822104207
STAT,1898,22,35-39,1920,7.989990476413252
SIM,1874,23,na,1897,2272
STAT,1836,39,40-44,1875,3.319945399358068
STAT,1907,48,15-19,1955,3.304602520481179E-4
SIM,1887,22,25-29,1909,65
STAT,1847,32,30-34,1879,15.349058794977456
STAT,1836,25,30-34,1861,20.854118804734874
STAT,1893,26,15-19,1919,0.583843701086714
STAT,1843,49,25-29,1892,0.03803819972865842
STAT,1926,15,25-29,1941,53.947144568786044
STAT,1842,23,40-44,1865,2.3493566025878674
STAT,1849,32,40-44,1881,3.572924643054083
STAT,1874,88,na,1962,265.0209322636009
STAT,1881,16,45-49,1897,0.06375192659958152
SIM,1937,33,na,1970,3629
STAT,1905,19,20-24,1924,25.746550516422662
STAT,1831,106,na,1937,0.007629844070283607
STAT,1862,16,35-39,1878,0.5513831119558087
SIM,1889,8,na,1897,3238
SIM,1825,39,30-34,1864,9
STAT,1826,49,25-29,1875,0.05523529540527993
STAT,1879,22,25-29,1901,60.33686451668881
STAT,1817,39,30-34,1856,15.559761837807898
SIM,1909,37,35-39,1946,5
STAT,1874,56,na,1930,2109.3682708446795
SIM,1855,32,30-34,1887,24
SIM,1943,26,30-34,1969,70
STAT,1873,71,na,1944,1366.7151221760582
SIM,1844,37,25-29,1881,2
STAT,1884,16,20-24,1900,17.70089587856879
SIM,1837,20,20-24,1857,55
STAT,1876,17,25-29,1893,5.909507767329148
STAT,1935,26,30-34,1961,53.98726858940244
STAT,1860,38,20-24,1898,0.6332766038959097
SIM,1855,26,45-49,1881,1
SIM,1801,62,na,1863,744
SIM,1898,14,na,1912,3501
STAT,1837,38,45-49,1875,1.6387019021466704
STAT,1929,28,20-24,1957,23.079643313392857
STAT,1807,49,15-19,1856,0.0013811159195840277
SIM,1839,31,35-39,1870,15
STAT,1927,20,15-19,1947,6.66847260166016
SIM,1850,23,40-44,1873,2
SIM,1856,47,45-49,1903,3
SIM,1805,55,na,1860,1043
STAT,1834,31,50-100,1865,0.7062565574054096
SIM,1903,33,25-29,1936,14
STAT,1876,21,45-49,1897,0.7293923516217068
STAT,1899,34,45-49,1933,2.3965072505626726
STAT,1859,36,30-34,1895,4.35024330223784
SIM,1865,17,15-19,1882,7
STAT,1863,37,35-39,1900,6.329485048037107
STAT,1827,47,25-29,1874,0.059080015750020434
SIM,1844,25,30-34,1869,27
SIM,1838,26,45-49,1864,1
SIM,1844,39,40-44,1883,7
SIM,1838,32,30-34,1870,25
STAT,1846,28,45-49,1874,1.0120095577619044
STAT,1901,39,30-34,1940,1.6123286933365941
STAT,1799,97,na,1896,1.8027729515450854
STAT,1901,53,na,1954,2999.712503855678
STAT,1920,39,40-44,1959,1.6516245327639003
STAT,1946,20,25-29,1966,103.88884069774792
SIM,1953,15,35-39,1968,5
STAT,1861,36,20-24,1897,0.6500719893941733
STAT,1897,17,45-49,1914,0.08845051270378328
SIM,1907,30,40-44,1937,7
STAT,1916,26,20-24,1942,19.11233028941891
SIM,1816,54,50-100,1870,1
SIM,1899,39,30-34,1938,2
SIM,1939,30,35-39,1969,2
STAT,1827,102,na,1929,0.17433906176373923
STAT,1883,18,20-24,1901,17.476463621511357
STAT,1837,37,40-44,1874,3.6359896822403313
STAT,1897,23,30-34,1920,24.044351400003624
SIM,1860,27,30-34,1887,32
SIM,1887,73,na,1960,1285
STAT,1852,27,30-34,1879,22.243935844789785
STAT,1866,37,na,1903,2203.3865874732696
STAT,1870,53,na,1923,2101.1988758610105
SIM,1854,20,20-24,1874,3
SIM,1913,23,40-44,1936,3
STAT,1905,23,40-44,1928,3.033160683855995
STAT,1945,15,35-39,1960,4.631596213770936
SIM,1854,28,45-49,1882,1
STAT,1842,37,15-19,1879,0.05930823443708819
SIM,1899,25,20-24,1924,18
STAT,1853,48,30-34,1901,0.0790454805543024
STAT,1900,27,20-24,1927,16.4593570169455
SIM,1924,26,20-24,1950,1
STAT,1812,43,50-100,1855,2.6548420656234746
STAT,1887,33,15-19,1920,0.15990776581191943
SIM,1877,27,35-39,1904,10
SIM,1919,32,25-29,1951,3
STAT,1866,32,40-44,1898,4.05583852609784
STAT,1822,36,35-39,1858,13.729679531734318
STAT,1849,44,50-100,1893,0.8148406514963474
SIM,1870,1,na,1871,3561
SIM,1909,26,na,1935,3837
STAT,1867,47,20-24,1914,0.011361447770466812
SIM,1862,22,20-24,1884,72
STAT,1838,38,50-100,1876,0.9814837682999074
SIM,1846,38,50-100,1884,1
STAT,1889,21,30-34,1910,22.250287347110454
SIM,1880,19,na,1899,2437
STAT,1851,18,25-29,1869,5.186073189608192
SIM,1910,6,na,1916,3804
STAT,1846,25,50-100,1871,0.5958029984645723
STAT,1921,23,25-29,1944,105.04532293142539
STAT,1824,104,na,1928,0.0331599799277075
STAT,1825,37,15-19,1862,0.09272492724673528
SIM,1869,36,40-44,1905,1
SIM,1847,75,na,1922,724
SIM,1842,15,20-24,1857,23
SIM,1935,20,15-19,1955,10
STAT,1796,79,na,1875,271.93577703441485
STAT,1941,17,50-100,1958,0.389604073006261
SIM,1860,42,na,1902,2052
STAT,1871,25,25-29,1896,42.73423918130791
STAT,1896,38,35-39,1934,9.409037213938989
SIM,1863,28,45-49,1891,1
SIM,1888,30,50-100,1918,2
SIM,1897,21,30-34,1918,41
STAT,1883,24,40-44,1907,2.0466836118294234
SIM,1876,15,25-29,1891,15
STAT,1862,18,35-39,1880,0.5449069475350274
STAT,1833,36,45-49,1869,1.7882784643688885
SIM,1924,17,30-34,1941,25
STAT,1916,17,30-34,1933,2.6097429868920394
SIM,1770,84,na,1854,90
STAT,1839,33,35-39,1872,8.74431923866066
SIM,1892,16,20-24,1908,27
STAT,1919,1,na,1920,4659.57541459354
SIM,1919,23,35-39,1942,16
STAT,1878,47,30-34,1925,0.10101726848188931
STAT,1956,0,na,1956,5294.774980703475
SIM,1881,25,35-39,1906,17
STAT,1855,28,45-49,1883,0.8648735231253459
STAT,1909,59,na,1968,3203.3193535597984
STAT,1886,17,35-39,1903,0.5851395891750979
SIM,1941,29,25-29,1970,94
STAT,1892,28,15-19,1920,0.5729891102433788
STAT,1901,31,na,1932,3392.48366314223
SIM,1849,34,na,1883,1945
SIM,1858,24,20-24,1882,86
STAT,1844,36,20-24,1880,0.715611102586785
STAT,1900,67,na,1967,2516.5450790718724
STAT,1818,75,na,1893,530.385845780171
STAT,1905,26,45-49,1931,1.6267131735182967
STAT,1846,23,25-29,1869,53.217584418251896
STAT,1930,33,na,1963,4930.166079656617
STAT,1894,16,30-34,1910,2.077655064699475
STAT,1829,47,35-39,1876,0.10445062958128314
STAT,1898,47,na,1945,3066.7103356219486
STAT,1850,39,15-19,1889,0.04278147423333644
SIM,1841,27,20-24,1868,10
SIM,1843,72,na,1915,1147
SIM,1917,27,40-44,1944,3
STAT,1847,29,15-19,1876,0.4024645029181571
SIM,1908,31,45-49,1939,2
SIM,1913,30,na,1943,3788
SIM,1920,16,35-39,1936,7
STAT,1833,27,20-24,1860,10.979552543663901
STAT,1885,38,25-29,1923,2.880208495231895
STAT,1875,38,15-19,1913,0.05795560072308352
SIM,1809,58,na,1867,1018
STAT,1876,26,15-19,1902,0.4747641850950691
SIM,1893,38,25-29,1931,3
STAT,1780,100,na,1880,0.1907196058834222
STAT,1868,15,25-29,1883,5.63526890082261
STAT,1915,6,na,1921,4219.036959277502
STAT,1942,23,45-49,1965,1.1907386643784492
STAT,1905,34,na,1939,3483.7980854612315
STAT,1824,49,15-19,1873,4.553423900063864E-4
STAT,1920,15,30-34,1935,2.783482497103472
STAT,1808,47,15-19,1855,0.001460910388146178
STAT,1926,29,na,1955,4506.212377081582
SIM,1779,76,na,1855,385
STAT,1854,22,20-24,1876,60.766715629347225
SIM,1876,26,30-34,1902,47
SIM,1923,21,35-39,1944,14
STAT,1865,52,na,1917,1975.2005455549647
STAT,1818,47,25-29,1865,0.10255805629265824
SIM,1909,28,45-49,1937,3
STAT,1911,28,35-39,1939,14.719460349678643
STAT,1912,16,35-39,1928,0.8581598146718261
SIM,1852,36,20-24,1888,3
STAT,1879,26,40-44,1905,3.1681589241877806
STAT,1878,48,35-39,1926,0.14493932642746027
SIM,1904,21,25-29,1925,1
STAT,1895,23,20-24,1918,90.61219595805899
STAT,1896,29,45-49,1925,1.4737785869199131
SIM,1871,27,40-44,1898,1
SIM,1921,25,40-44,1946,7
STAT,1909,27,40-44,1936,4.495056706312233
STAT,1933,29,25-29,1962,88.22739342324738
STAT,1923,27,50-100,1950,1.154643356200296
SIM,1911,39,40-44,1950,2
SIM,1946,25,45-49,1971,5
SIM,1883,37,na,1920,2616
STAT,1926,21,45-49,1947,1.3856985825643457
STAT,1845,49,35-39,1894,0.10016018293481989
STAT,1835,49,25-29,1884,0.04443358438478779
SIM,1954,4,na,1958,4842
STAT,1840,26,35-39,1866,8.494435983792897
STAT,1863,39,35-39,1902,6.265781596383561
STAT,1924,15,15-19,1939,54.86561132423733
STAT,1838,25,40-44,1863,2.587876684991842
STAT,1914,29,15-19,1943,0.7129065230599502
STAT,1885,37,20-24,1922,0.774963466759549
SIM,1931,27,50-100,1958,1
SIM,1946,25,na,1971,4258
STAT,1916,33,45-49,1949,1.6325775026626408
SIM,1862,27,40-44,1889,7
SIM,1852,27,30-34,1879,7
STAT,1943,19,40-44,1962,1.4966488931119855
STAT,1894,66,na,1960,2259.4816263365897
STAT,1863,27,40-44,1890,2.680699482064201
STAT,1847,111,na,1958,1.0040961897428152E-4
SIM,1856,20,30-34,1876,21
STAT,1943,15,25-29,1958,46.42507305384706
STAT,1901,39,50-100,1940,0.3714224590149561
STAT,1886,15,na,1901,2705.802109555794
SIM,1893,37,20-24,1930,1
STAT,1822,35,30-34,1857,10.744207941464333
SIM,1794,65,na,1859,775
STAT,1887,26,40-44,1913,3.389527678104634
SIM,1836,32,20-24,1868,2
STAT,1860,75,na,1935,849.9512304407901
SIM,1824,80,na,1904,265
SIM,1859,39,35-39,1898,15
STAT,1855,48,40-44,1903,0.12724660496156776
SIM,1871,39,35-39,1910,13
STAT,1828,32,20-24,1860,3.1693141359288526
STAT,1854,27,40-44,1881,2.3567736228071867
STAT,1844,27,30-34,1871,24.389753297212547
SIM,1819,68,na,1887,755
SIM,1908,22,20-24,1930,99
SIM,1927,22,30-34,1949,43
STAT,1915,44,na,1959,3760.3824254727983
STAT,1931,3,na,1934,5365.52531859915
SIM,1913,52,na,1965,3493
STAT,1818,46,20-24,1864,0.021687394178714382
SIM,1869,25,35-39,1894,12
STAT,1889,11,na,1900,3221.041219509266
STAT,1938,25,45-49,1963,1.7293764499485114
STAT,1866,38,15-19,1904,0.052257088067169166
SIM,1830,36,35-39,1866,18
SIM,1833,28,25-29,1861,40
SIM,1895,70,na,1965,2174
SIM,1830,35,30-34,1865,1
SIM,1852,37,25-29,1889,3
SIM,1855,49,50-100,1904,1
SIM,1847,33,35-39,1880,9
STAT,1895,17,35-39,1912,0.7237272630475623
SIM,1905,30,30-34,1935,22
SIM,1917,36,30-34,1953,2
SIM,1933,29,na,1962,4663
STAT,1938,20,25-29,1958,92.35345712259678
SIM,1884,17,25-29,1901,7
STAT,1776,80,na,1856,206.0020786401
STAT,1844,28,35-39,1872,9.278302332554713
SIM,1842,76,na,1918,550
STAT,1898,69,na,1967,2313.0761131363474
STAT,1948,20,35-39,1968,10.928934803575652
SIM,1894,17,35-39,1911,1
SIM,1891,24,40-44,1915,2
SIM,1828,35,40-44,1863,6
SIM,1928,34,40-44,1962,8
STAT,1902,23,15-19,1925,4.694015752052711
STAT,1866,26,20-24,1892,11.009287129018025
STAT,1915,38,20-24,1953,0.2673775375385407
SIM,1891,20,25-29,1911,73
STAT,1883,20,25-29,1903,56.917509569880174
STAT,1931,16,45-49,1947,0.6624356618409312
SIM,1851,15,20-24,1866,23
STAT,1834,48,20-24,1882,0.007482608459504185
STAT,1919,22,30-34,1941,31.77668044847016
STAT,1874,37,45-49,1911,2.0616432031888006
SIM,1824,33,40-44,1857,9
SIM,1861,15,30-34,1876,5
STAT,1889,39,20-24,1928,0.9503486473193042
STAT,1901,15,20-24,1916,25.217696324338416
STAT,1943,24,15-19,1967,5.714661847311515
STAT,1851,6,na,1857,2296.681002387263
STAT,1931,22,30-34,1953,37.67373445968376
STAT,1829,38,45-49,1867,1.6065825402484444
SIM,1932,15,15-19,1947,67
SIM,1846,25,40-44,1871,4
SIM,1922,29,15-19,1951,1
STAT,1869,37,50-100,1906,1.2055924298382055
SIM,1946,20,25-29,1966,122
STAT,1890,41,na,1931,2865.3482011520373
STAT,1859,47,20-24,1906,0.009702581474802841
STAT,1895,40,na,1935,3079.200460498283
STAT,1896,26,50-100,1922,0.8581532008200677
SIM,1858,40,35-39,1898,5
SIM,1927,20,15-19,1947,6
STAT,1838,26,45-49,1864,0.9523072002239558
STAT,1865,74,na,1939,1023.5091736876218
SIM,1836,37,40-44,1873,6
STAT,1861,52,50-100,1913,0.012607959513755696
SIM,1849,30,40-44,1879,5
SIM,1831,39,na,1870,1718
STAT,1859,38,30-34,1897,4.307931784861495
SIM,1814,69,na,1883,761
STAT,1843,20,na,1863,1836.404628996816
STAT,1921,27,40-44,1948,5.246586295283181
STAT,1935,17,40-44,1952,1.9318889933241665
SIM,1840,24,35-39,1864,8
SIM,1882,74,na,1956,907
STAT,1870,18,35-39,1888,0.546151468569362
SIM,1899,28,25-29,1927,74
STAT,1895,28,40-44,1923,3.9371314131036845
SIM,1877,37,50-100,1914,1
SIM,1885,35,20-24,1920,1
STAT,1827,35,na,1862,1702.9651911266901
SIM,1905,17,20-24,1922,20
STAT,1849,89,na,1938,82.136400015827
STAT,1941,28,20-24,1969,19.055128634453073
SIM,1840,18,15-19,1858,5
SIM,1938,23,45-49,1961,2
STAT,1841,61,na,1902,1397.3928568399192
SIM,1896,55,na,1951,2721
STAT,1905,32,30-34,1937,14.638009125973078
STAT,1878,70,na,1948,1471.05984595007
STAT,1834,37,15-19,1871,0.041598234369970066
SIM,1951,19,40-44,1970,2
STAT,1923,20,30-34,1943,33.990703394545505
STAT,1855,34,30-34,1889,13.106530619143165
SIM,1895,24,25-29,1919,125
STAT,1881,27,35-39,1908,9.393863429576705
SIM,1943,17,40-44,1960,5
SIM,1935,24,30-34,1959,52
STAT,1887,24,25-29,1911,64.14867033871917
STAT,1786,79,na,1865,285.15021173246816
STAT,1785,94,na,1879,4.190765885477626
SIM,1924,33,45-49,1957,3
STAT,1906,27,15-19,1933,0.6674433852368404
SIM,1938,7,na,1945,3885
STAT,1892,19,25-29,1911,7.143378674834176
STAT,1919,20,15-19,1939,5.9204942555430105
STAT,1826,46,20-24,1872,0.011986834645085776
SIM,1846,26,45-49,1872,1
STAT,1869,36,25-29,1905,2.8408598304230583
STAT,1939,26,15-19,1965,0.7167836156966984
STAT,1913,25,40-44,1938,4.71773214218844
SIM,1863,49,na,1912,2014
STAT,1828,37,40-44,1865,4.510309785705622
STAT,1939,32,35-39,1971,9.412929707958524
STAT,1927,24,30-34,1951,35.56719607978855
STAT,1869,27,35-39,1896,9.474847200625648
STAT,1875,52,na,1927,2221.41416198307
STAT,1860,29,30-34,1889,20.712940339702584
SIM,1893,37,na,1930,3064
STAT,1826,94,na,1920,10.966768220278654
SIM,1883,15,na,1898,2887
STAT,1869,99,na,1968,10.576708033153256
STAT,1847,23,na,1870,1948.4506694712454
STAT,1945,10,na,1955,4334.659926603382
SIM,1916,31,45-49,1947,1
STAT,1879,31,15-19,1910,0.150711057037567
SIM,1866,89,na,1955,42
STAT,1811,95,na,1906,5.796092058090625
STAT,1926,39,35-39,1965,2.98119117939371
SIM,1833,27,20-24,1860,12
STAT,1837,46,30-34,1883,0.06943560779015913
SIM,1828,33,25-29,1861,2
STAT,1772,110,na,1882,0.001435936328656512
STAT,1915,21,35-39,1936,9.850900914045381
SIM,1895,9,na,1904,3435
STAT,1848,38,20-24,1886,0.6418743591768501
SIM,1931,20,30-34,1951,74
SIM,1859,47,50-100,1906,3
STAT,1832,24,35-39,1856,5.536326226929895
SIM,1879,20,25-29,1899,73
STAT,1842,39,15-19,1881,0.05286122233667864
STAT,1910,25,15-19,1935,0.698320325333585
STAT,1825,76,na,1901,691.3762619829157
SIM,1856,38,20-24,1894,1
STAT,1877,24,50-100,1901,0.4224290927206325
STAT,1908,31,45-49,1939,1.5055072776540879
STAT,1918,46,25-29,1964,0.05713056864984995
STAT,1877,29,35-39,1906,9.986379685403879
STAT,1881,18,45-49,1899,0.06342911355533849
STAT,1877,35,20-24,1912,0.8111822752580848
SIM,1923,30,na,1953,4458
STAT,1907,15,na,1922,3763.454081174461
STAT,1813,76,na,1889,416.68086818403873
STAT,1946,22,25-29,1968,103.81716973966076
SIM,1799,64,na,1863,939
STAT,1843,42,na,1885,1605.0192822801741
STAT,1869,38,40-44,1907,4.277205360928621
STAT,1860,27,15-19,1887,0.37860246709372464
SIM,1854,23,25-29,1877,73
SIM,1877,36,25-29,1913,3
STAT,1851,17,20-24,1868,16.320917090219773
SIM,1896,33,na,1929,3196
STAT,1893,37,20-24,1930,0.9885685861842817
SIM,1887,26,40-44,1913,3
STAT,1934,21,45-49,1955,1.5283723110563563
SIM,1896,36,35-39,1932,10
STAT,1871,39,35-39,1910,7.025711063051622
SIM,1843,16,25-29,1859,8
SIM,1851,42,50-100,1893,1
STAT,1903,33,50-100,1936,0.7535675197683261
SIM,1848,39,25-29,1887,5
STAT,1846,25,40-44,1871,2.7900378147624596
STAT,1788,104,na,1892,0.018712175035896634
STAT,1935,22,15-19,1957,7.3237590660788525
SIM,1915,31,50-100,1946,2
STAT,1927,18,45-49,1945,0.6261484271590173
STAT,1830,106,na,1936,0.00801035628572946
SIM,1833,101,na,1934,1
STAT,1875,49,20-24,1924,0.012186734581626552
STAT,1889,48,45-49,1937,0.1637082505531794
SIM,1811,62,na,1873,1168
SIM,1935,18,45-49,1953,2
STAT,1816,49,15-19,1865,0.0010039109880090504
STAT,1830,38,35-39,1868,6.339563731884188
SIM,1864,23,na,1887,2548
STAT,1828,102,na,1930,0.19031664398914716
STAT,1859,48,25-29,1907,0.04620260413866279
STAT,1892,18,20-24,1910,22.409903556003325
STAT,1948,21,50-100,1969,0.7634522477809006
SIM,1878,48,na,1926,2558
STAT,1858,26,20-24,1884,9.58493421045152
STAT,1852,36,20-24,1888,0.5939128075335911
STAT,1911,20,50-100,1931,0.6333382213415754
SIM,1863,34,30-34,1897,9
STAT,1843,42,50-100,1885,0.733643336668172
SIM,1883,22,40-44,1905,2
STAT,1907,31,50-100,1938,0.7835273395296316
STAT,1926,33,50-100,1959,1.0097721591462623
STAT,1917,34,15-19,1951,0.1346651042298261
STAT,1821,54,50-100,1875,0.02045979982231138
SIM,1913,32,30-34,1945,30
SIM,1902,25,30-34,1927,42
STAT,1884,26,15-19,1910,0.4534362142071503
SIM,1834,57,na,1891,1396
STAT,1876,37,na,1913,2456.9141629219407
SIM,1822,36,35-39,1858,5
STAT,1860,53,na,1913,1749.1693491638268
STAT,1879,27,45-49,1906,1.170259294129303
SIM,1854,25,40-44,1879,3
SIM,1877,38,40-44,1915,7
SIM,1835,25,30-34,1860,33
SIM,1892,26,15-19,1918,3
STAT,1837,47,35-39,1884,0.09914500986330467
SIM,1843,94,na,1937,63
SIM,1903,37,40-44,1940,2
STAT,1936,34,25-29,1970,9.051709441511653
SIM,1780,84,na,1864,115
STAT,1843,19,50-100,1862,0.041731276065309034
SIM,1814,80,na,1894,224
STAT,1904,20,20-24,1924,100.47902376045171
STAT,1929,25,na,1954,4756.752994590251
SIM,1915,39,25-29,1954,1
STAT,1836,28,35-39,1864,7.819770195226312
STAT,1951,17,25-29,1968,52.13734456732546
STAT,1844,54,50-100,1898,0.011620465590609112
STAT,1894,49,30-34,1943,0.06952007295761031
STAT,1870,17,30-34,1887,1.5958395034151134
SIM,1924,15,na,1939,4458
SIM,1925,29,40-44,1954,4
STAT,1917,29,40-44,1946,4.8987498352157015
STAT,1946,24,40-44,1970,3.776500011040443
STAT,1859,39,35-39,1898,5.687758968852906
SIM,1866,26,20-24,1892,15
STAT,1845,86,na,1931,162.12183103944463
SIM,1933,21,50-100,1954,1
SIM,1942,21,45-49,1963,1
SIM,1893,15,na,1908,3346
STAT,1856,60,na,1916,1476.8174439215074
SIM,1844,28,35-39,1872,12
STAT,1907,39,25-29,1946,0.9124740759681725
STAT,1865,23,35-39,1888,5.408115843820687
SIM,1876,24,15-19,1900,2
SIM,1912,20,20-24,1932,128
STAT,1884,88,na,1972,391.630059548872
STAT,1906,30,na,1936,3568.8298184793357
STAT,1888,36,35-39,1924,8.472294598951896
STAT,1828,34,35-39,1862,11.039265182802037
SIM,1892,19,25-29,1911,11
STAT,1826,30,na,1856,1625.985690283851
SIM,1819,49,50-100,1868,3
SIM,1873,17,na,1890,2448
SIM,1853,33,25-29,1886,12
SIM,1894,27,35-39,1921,16
STAT,1917,31,45-49,1948,1.6700494438847187
SIM,1859,29,35-39,1888,9
SIM,1871,29,35-39,1900,14
STAT,1919,27,na,1946,4086.8551796912807
SIM,1939,8,na,1947,4107
STAT,1908,63,na,1971,3013.1970508596823
SIM,1854,34,na,1888,2148
STAT,1864,50,25-29,1914,0.0032745349220948423
STAT,1915,26,50-100,1941,1.0279425490788174
SIM,1876,36,30-34,1912,6
STAT,1908,20,40-44,1928,3.1389737503363455
SIM,1853,31,30-34,1884,25
STAT,1827,42,20-24,1869,0.1708345257691693
STAT,1854,39,35-39,1893,5.254708530369972
STAT,1868,36,30-34,1904,5.1693539956417585
STAT,1892,38,15-19,1930,0.07081612405523349
SIM,1832,41,40-44,1873,6
SIM,1893,35,20-24,1928,1
STAT,1834,45,15-19,1879,2.8482751004906367E-4
STAT,1854,31,25-29,1885,7.954052857436527
STAT,1807,105,na,1912,0.01038626557182148
STAT,1836,48,30-34,1884,0.06309306273593
STAT,1894,33,20-24,1927,3.5000500790500224
SIM,1916,4,na,1920,4284
STAT,1845,33,25-29,1878,8.806737727758373
SIM,1936,31,20-24,1967,2
SIM,1827,36,35-39,1863,11
SIM,1852,3,na,1855,2602
STAT,1893,60,na,1953,2445.8463182565592
SIM,1846,15,na,1861,2140
SIM,1823,43,40-44,1866,5
STAT,1871,41,50-100,1912,1.0648659618474374
SIM,1890,72,na,1962,2011
SIM,1821,35,30-34,1856,1
STAT,1897,36,50-100,1933,1.6704372887336263
STAT,1823,97,na,1920,2.971190863416281
SIM,1882,53,na,1935,1871
STAT,1900,44,25-29,1944,0.06171956072139406
STAT,1886,27,35-39,1913,10.28954974652935
SIM,1815,44,45-49,1859,3
STAT,1882,34,40-44,1916,4.206490737037192
STAT,1875,28,15-19,1903,0.46893173743933536
STAT,1895,25,35-39,1920,12.812924537809364
STAT,1816,42,45-49,1858,4.294108008205698
STAT,1861,27,30-34,1888,21.288215659548353
SIM,1844,33,30-34,1877,47
SIM,1882,35,45-49,1917,3
STAT,1884,19,25-29,1903,5.613765421636029
STAT,1845,31,30-34,1876,15.327137918525347
STAT,1874,35,45-49,1909,2.0812228785059017
SIM,1928,32,25-29,1960,19
STAT,1832,36,50-100,1868,1.0707736275753452
SIM,1885,29,35-39,1914,11
SIM,1916,20,40-44,1936,6
SIM,1945,0,na,1945,4460
STAT,1885,40,15-19,1925,0.014023632634244337
SIM,1818,43,30-34,1861,2
STAT,1813,53,30-34,1866,0.016132123249670297
STAT,1824,41,40-44,1865,2.8533810696425155
STAT,1848,47,50-100,1895,0.19958734969307582
STAT,1887,52,na,1939,2415.151461502053
SIM,1880,27,35-39,1907,7
STAT,1859,45,20-24,1904,0.009845210927919948
STAT,1871,46,30-34,1917,0.09740723773800303
SIM,1890,34,40-44,1924,6
STAT,1940,12,na,1952,4044.846452649974
STAT,1880,44,30-34,1924,1.203004672798942
STAT,1854,49,35-39,1903,0.10287437679077198
STAT,1815,43,40-44,1858,5.543801906046756
STAT,1926,32,50-100,1958,1.0103986062821573
STAT,1891,32,40-44,1923,5.422969401563881
SIM,1848,93,na,1941,18
STAT,1913,10,na,1923,4086.4256021873944
STAT,1819,41,30-34,1860,2.5523580753273603
STAT,1876,42,15-19,1918,0.014383752751858802
STAT,1883,33,45-49,1916,1.7162705115398067
STAT,1843,43,15-19,1886,0.009468027580651498
SIM,1819,37,na,1856,1597
STAT,1927,22,15-19,1949,6.628920685666714
SIM,1818,38,35-39,1856,8
SIM,1835,35,30-34,1870,4
SIM,1855,51,na,1906,1840
SIM,1867,28,30-34,1895,4
STAT,1863,47,35-39,1910,0.12470048451689918
SIM,1823,42,na,1865,1575
STAT,1854,89,na,1943,78.84125650111395
STAT,1928,31,20-24,1959,3.084522743346628
STAT,1828,49,35-39,1877,0.12422027664984309
STAT,1811,46,50-100,1857,0.62193036627147
STAT,1833,34,45-49,1867,1.5615112373086348
STAT,1890,40,25-29,1930,0.8005219207073108
SIM,1778,81,na,1859,112
SIM,1833,102,na,1935,1
SIM,1852,23,na,1875,1870
SIM,1827,56,na,1883,1228
SIM,1935,22,15-19,1957,5
STAT,1842,88,na,1930,123.60118545978501
STAT,1856,101,na,1957,0.6260592981055771
STAT,1906,48,50-100,1954,0.20124417222777813
STAT,1831,26,35-39,1857,8.604183866240463
STAT,1856,44,40-44,1900,1.71820840338903
STAT,1929,30,25-29,1959,11.879740173655266
STAT,1895,71,na,1966,2060.7222665339177
STAT,1857,3,na,1860,2617.5479553968216
SIM,1909,57,na,1966,3577
STAT,1896,25,50-100,1921,0.8610203987478983
SIM,1864,44,40-44,1908,12
STAT,1859,28,30-34,1887,20.659836040602457
STAT,1836,40,na,1876,1617.920610819189
SIM,1824,42,45-49,1866,1
STAT,1880,39,35-39,1919,7.426814513614634
STAT,1886,32,30-34,1918,18.618920411798953
STAT,1879,33,50-100,1912,0.9616473010237286
SIM,1888,78,na,1966,1665
STAT,1825,47,15-19,1872,5.370992195376657E-4
STAT,1862,30,20-24,1892,2.37661394470579
STAT,1815,44,50-100,1859,2.47187394066492
SIM,1925,31,45-49,1956,3
STAT,1889,28,15-19,1917,0.563049573088474
SIM,1852,34,20-24,1886,1
SIM,1853,26,35-39,1879,15
SIM,1919,21,20-24,1940,9
STAT,1856,29,15-19,1885,0.35884192014465394
SIM,1836,34,35-39,1870,1
STAT,1830,45,30-34,1875,0.08309040439858609
STAT,1870,102,na,1972,3.1020521698365378
STAT,1854,38,50-100,1892,0.9168342807219273
STAT,1859,13,na,1872,2240.8290474779606
STAT,1835,37,30-34,1872,4.947242256308425
SIM,1872,43,35-39,1915,5
STAT,1877,36,25-29,1913,3.015787901119864
SIM,1831,61,na,1892,1273
STAT,1813,48,35-39,1861,0.3999994029231358
STAT,1850,31,40-44,1881,3.510026586203044
STAT,1788,105,na,1893,0.008225685024029802
STAT,1835,19,30-34,1854,3.4165341435205483
STAT,1877,19,35-39,1896,0.5689197559236935
STAT,1906,1,na,1907,4004.147253322647
STAT,1952,13,na,1965,4755.26212367233
STAT,1853,15,30-34,1868,1.6044240926128668
SIM,1869,87,na,1956,193
SIM,1894,54,na,1948,2975
STAT,1895,32,25-29,1927,13.509619967304396
STAT,1875,46,15-19,1921,4.160645856065564E-4
STAT,1825,29,15-19,1854,1.8456640018458563
STAT,1857,22,na,1879,1945.6594139130812
STAT,1919,16,30-34,1935,2.735253608586064
SIM,1914,48,na,1962,3821
SIM,1919,16,25-29,1935,78
SIM,1844,24,na,1868,1908
SIM,1870,23,30-34,1893,23
STAT,1881,40,30-34,1921,1.1305711905329578
STAT,1831,44,35-39,1875,1.364079576955846
STAT,1843,25,15-19,1868,0.38206392116417864
STAT,1851,30,45-49,1881,1.40313979923254
SIM,1885,36,25-29,1921,3
STAT,1833,29,20-24,1862,10.82245219142144
SIM,1868,27,35-39,1895,16
SIM,1841,34,45-49,1875,1
STAT,1852,51,45-49,1903,0.011058757934343097
STAT,1864,43,35-39,1907,1.6384306778389388
SIM,1843,19,30-34,1862,5
STAT,1828,41,25-29,1869,0.6236918195127482
SIM,1799,63,na,1862,980
STAT,1897,48,45-49,1945,0.17799231648745423
SIM,1858,16,na,1874,2169
STAT,1839,19,15-19,1858,5.439291369749141
STAT,1881,42,25-29,1923,0.6244122046738637
STAT,1836,18,35-39,1854,0.8409567853961835
SIM,1833,40,45-49,1873,1
SIM,1826,37,30-34,1863,11
SIM,1927,16,30-34,1943,22
STAT,1844,34,20-24,1878,2.5048655223721
STAT,1844,59,na,1903,1537.6381262728967
STAT,1848,50,40-44,1898,0.008718907713120321
STAT,1852,78,na,1930,592.5564313822312
STAT,1869,47,30-34,1916,0.09461043721137377
SIM,1859,44,30-34,1903,1
SIM,1872,43,na,1915,2490
STAT,1862,23,30-34,1885,15.790077974811174
STAT,1885,28,30-34,1913,25.227200374207932
STAT,1855,23,40-44,1878,1.8192711513018873
STAT,1887,47,50-100,1934,0.27565868989750425
SIM,1816,40,45-49,1856,3
STAT,1889,46,45-49,1935,0.29474750333166333
SIM,1857,43,50-100,1900,1
STAT,1850,5,na,1855,2352.8396000000002
STAT,1853,27,50-100,1880,0.6128351469980575
SIM,1880,62,na,1942,1629
STAT,1831,51,25-29,1882,0.002374161648333521
STAT,1844,35,30-34,1879,4.9993117478593385
STAT,1913,20,20-24,1933,109.36306836495575
STAT,1881,43,35-39,1924,1.7502106190331996
STAT,1892,31,45-49,1923,2.219115755339359
SIM,1873,42,40-44,1915,8
STAT,1848,27,15-19,1875,0.4422225444263313
STAT,1867,32,na,1899,2269.911388935483
SIM,1903,32,na,1935,3225
STAT,1843,18,25-29,1861,4.855517570921966
SIM,1843,37,30-34,1880,10
SIM,1907,46,na,1953,3584
STAT,1919,24,50-100,1943,0.7229339819315613
SIM,1861,91,na,1952,28
STAT,1853,40,na,1893,1930.6271608321547
SIM,1851,18,25-29,1869,5
STAT,1814,52,35-39,1866,0.019827762049022646
STAT,1860,17,15-19,1877,5.650950770691716
STAT,1933,39,40-44,1972,2.0560558628411054
STAT,1826,50,50-100,1876,0.01493442091270417
SIM,1863,23,40-44,1886,2
SIM,1847,19,15-19,1866,7
STAT,1868,18,na,1886,2467.4660921157083
STAT,1825,40,45-49,1865,2.2471919906979
STAT,1872,45,35-39,1917,0.1435761877928973
STAT,1846,54,25-29,1900,0.0026140623579347187
STAT,1818,37,30-34,1855,13.464228224595761
SIM,1839,57,na,1896,1302
SIM,1877,32,30-34,1909,19
STAT,1844,53,50-100,1897,0.011757201848102547
STAT,1872,23,na,1895,2394.0990563178734
SIM,1835,43,na,1878,1470
STAT,1801,108,na,1909,7.289901633656736E-4
STAT,1814,51,25-29,1865,0.008322998324416485
SIM,1865,43,45-49,1908,4
SIM,1937,30,25-29,1967,13
STAT,1885,18,30-34,1903,1.5981788534971322
STAT,1943,2,na,1945,4341.425420070853
SIM,1877,34,25-29,1911,14
SIM,1894,32,30-34,1926,34
STAT,1857,43,45-49,1900,1.171196113874564
STAT,1858,42,50-100,1900,0.8360876714162898
SIM,1933,22,50-100,1955,5
STAT,1928,16,25-29,1944,55.32676350890417
SIM,1831,42,35-39,1873,4
STAT,1845,21,na,1866,1953.5210784598748
SIM,1921,20,20-24,1941,110
STAT,1870,25,30-34,1895,25.144551443420468
STAT,1905,21,25-29,1926,83.83647072066358
SIM,1846,23,40-44,1869,2
SIM,1857,86,na,1943,180
STAT,1868,19,40-44,1887,0.17764008820007077
SIM,1882,17,15-19,1899,5
SIM,1893,28,30-34,1921,51
STAT,1878,22,50-100,1900,0.4275498002947706
STAT,1899,37,15-19,1936,0.01680081037872143
STAT,1827,35,30-34,1862,6.49916445541403
STAT,1838,23,40-44,1861,1.7968189614502874
SIM,1895,16,na,1911,3340
STAT,1873,40,na,1913,2390.3793530762887
STAT,1874,17,15-19,1891,6.137450645039025
STAT,1894,26,30-34,1920,32.85728677281424
SIM,1816,60,na,1876,1044
SIM,1911,51,na,1962,3744
STAT,1830,48,35-39,1878,0.11559295890495154
STAT,1841,36,45-49,1877,1.7747394733447497
STAT,1885,19,50-100,1904,0.04898924808250287
STAT,1860,35,15-19,1895,0.04680300967431109
STAT,1829,33,40-44,1862,3.7661289209736277
STAT,1834,27,15-19,1861,0.3543133239674529
STAT,1855,52,25-29,1907,0.002651953660185339
STAT,1869,38,50-100,1907,1.199612691386207
STAT,1889,17,50-100,1906,0.06101420126310095
STAT,1947,23,50-100,1970,0.7509225756057619
STAT,1871,24,35-39,1895,5.818805759514314
SIM,1868,37,35-39,1905,13
SIM,1868,42,30-34,1910,1
STAT,1866,41,45-49,1907,1.4060399843025386
STAT,1835,86,na,1921,166.52867943575652
STAT,1851,27,15-19,1878,0.4022352937074506
STAT,1858,36,15-19,1894,0.044710283578197535
SIM,1862,31,25-29,1893,10
STAT,1805,49,50-100,1854,1.0246037094218132
SIM,1941,26,na,1967,3992
STAT,1780,95,na,1875,2.218194659848739
STAT,1831,72,na,1903,793.6037986204902
STAT,1845,16,35-39,1861,0.5097481355741341
SIM,1863,70,na,1933,1154
SIM,1871,26,na,1897,2304
STAT,1819,36,35-39,1855,22.883579982704944
STAT,1866,48,15-19,1914,3.693922260478691E-4
STAT,1809,47,30-34,1856,0.3462826754055052
STAT,1853,32,20-24,1885,2.3019641491591813
STAT,1869,32,30-34,1901,17.14471772702283
STAT,1907,21,35-39,1928,8.681477894614275
SIM,1852,35,30-34,1887,5
STAT,1865,42,40-44,1907,2.071854208661248
STAT,1822,52,50-100,1874,0.021568248544457182
STAT,1823,42,35-39,1865,2.686495799105351
STAT,1879,24,40-44,1903,2.182584712806992
STAT,1913,54,na,1967,3523.520425474557
SIM,1926,24,15-19,1950,9
STAT,1892,32,50-100,1924,1.1612305450464853
STAT,1805,54,35-39,1859,0.03399381789732995
STAT,1818,44,20-24,1862,0.2919042830042396
STAT,1855,50,30-34,1905,0.004544996298270091
SIM,1814,45,50-100,1859,2
STAT,1868,26,30-34,1894,24.391276144907167
STAT,1910,22,50-100,1932,0.6234247399657337
STAT,1890,33,35-39,1923,12.445684811944282
STAT,1853,25,30-34,1878,24.47484428652155
STAT,1876,38,30-34,1914,5.530345330419506
STAT,1815,46,45-49,1861,0.5324648730000653
STAT,1833,47,50-100,1880,0.20428926357852345
SIM,1848,61,na,1909,1430
STAT,1869,34,25-29,1903,9.971701302578214
STAT,1880,26,30-34,1906,26.802369498411366
STAT,1943,21,45-49,1964,1.209140785597485
SIM,1861,32,20-24,1893,2
STAT,1917,48,50-100,1965,0.2378014666995964
STAT,1901,21,na,1922,3358.681294015202
SIM,1867,38,30-34,1905,6
SIM,1837,33,40-44,1870,9
SIM,1894,34,25-29,1928,2
STAT,1885,35,20-24,1920,0.7823233887083608
SIM,1867,52,na,1919,1881
SIM,1875,71,na,1946,1439
SIM,1882,32,40-44,1914,6
STAT,1896,13,na,1909,3447.2596546825853
STAT,1896,24,40-44,1920,2.768448071401862
SIM,1884,38,30-34,1922,11
SIM,1827,43,25-29,1870,3
STAT,1905,35,na,1940,3500.0254728267187
SIM,1861,25,30-34,1886,39
STAT,1882,37,45-49,1919,1.9503228677050413
STAT,1865,27,15-19,1892,0.4184298907177975
STAT,1854,24,35-39,1878,5.072072134820192
STAT,1904,31,50-100,1935,1.3334506781518296
STAT,1918,24,15-19,1942,5.759863664640785
STAT,1830,55,na,1885,1389.2165317633805
SIM,1862,24,35-39,1886,9
STAT,1875,31,45-49,1906,1.8161144568494239
SIM,1808,54,50-100,1862,1
SIM,1883,31,45-49,1914,3
STAT,1886,34,25-29,1920,10.829126257955364
STAT,1840,42,35-39,1882,1.3241255678349149
STAT,1844,17,30-34,1861,1.6030035912719542
STAT,1907,49,40-44,1956,0.14100006613282623
STAT,1872,52,25-29,1924,0.0035774871381847348
SIM,1815,41,40-44,1856,2
STAT,1885,41,na,1926,2334.0901567904034
SIM,1856,80,na,1936,356
STAT,1855,45,35-39,1900,0.10643152079256195
STAT,1819,43,25-29,1862,1.333490207712278
SIM,1866,29,25-29,1895,48
STAT,1895,22,30-34,1917,23.493749064549522
STAT,1909,29,50-100,1938,0.9530433171495869
STAT,1854,46,30-34,1900,0.07285335796877179
STAT,1881,50,25-29,1931,0.0034979360863803496
STAT,1864,46,40-44,1910,0.15647248091004154
STAT,1874,32,40-44,1906,4.4849870675826295
STAT,1928,21,20-24,1949,140.7499462292712
SIM,1840,37,50-100,1877,1
STAT,1899,40,45-49,1939,0.14551607799856386
STAT,1964,5,na,1969,5000.468016994487
STAT,1860,22,na,1882,2012.90003104948
STAT,1862,38,30-34,1900,4.625509061996794
STAT,1879,54,35-39,1933,0.008824419305987733
STAT,1827,45,25-29,1872,0.06066792937950047
SIM,1833,32,45-49,1865,2
STAT,1831,43,25-29,1874,0.490064896387509
STAT,1868,39,35-39,1907,6.758711526953467
STAT,1885,36,30-34,1921,5.383814073443729
SIM,1891,49,50-100,1940,2
SIM,1870,38,30-34,1908,9
STAT,1877,33,20-24,1910,2.805840639871267
STAT,1883,49,50-100,1932,0.23767568975021697
STAT,1800,89,na,1889,34.172925110432196
SIM,1840,42,na,1882,1731
STAT,1892,23,45-49,1915,0.8810399967258324
STAT,1862,31,30-34,1893,15.29095418382795
STAT,1832,37,50-100,1869,1.0594551417669165
STAT,1868,40,15-19,1908,0.013465012053225167
STAT,1830,53,30-34,1883,0.00429272746200313
STAT,1935,24,15-19,1959,7.318779755808092
SIM,1890,37,45-49,1927,6
STAT,1893,16,15-19,1909,7.629406110087571
STAT,1841,41,40-44,1882,1.7703883430221823
SIM,1859,26,30-34,1885,28
SIM,1876,89,na,1965,210
SIM,1858,38,30-34,1896,10
SIM,1880,37,35-39,1917,15
STAT,1825,32,45-49,1857,4.135430952037519
STAT,1854,36,30-34,1890,4.019027654764389
STAT,1828,101,na,1929,0.37042439174188785
STAT,1923,47,30-34,1970,0.10536843570729211
SIM,1866,90,na,1956,33
STAT,1858,29,25-29,1887,33.82235950975303
STAT,1775,84,na,1859,74.91616164029902
STAT,1762,98,na,1860,0.36844516538675876
STAT,1842,19,20-24,1861,20.256066952732198
STAT,1894,36,25-29,1930,3.7619416198194946
SIM,1830,43,30-34,1873,4
SIM,1947,20,40-44,1967,6
STAT,1856,92,na,1948,32.25106776315349
STAT,1865,44,50-100,1909,0.9611676160498233
STAT,1822,36,na,1858,1617.103266401478
SIM,1849,87,na,1936,99
STAT,1891,21,50-100,1912,0.511472545102471
SIM,1879,53,na,1932,2521
STAT,1919,41,20-24,1960,0.019351292975089224
STAT,1899,33,na,1932,3293.830626594403
STAT,1855,53,35-39,1908,0.006376171439808668
STAT,1822,50,20-24,1872,0.0010965717037501577
SIM,1850,19,20-24,1869,18
STAT,1805,53,25-29,1858,0.014271050981287163
SIM,1936,21,20-24,1957,98
SIM,1927,23,20-24,1950,176
STAT,1846,37,35-39,1883,5.605212414035642
SIM,1919,24,25-29,1943,125
STAT,1835,44,20-24,1879,0.139263418450411
STAT,1844,42,20-24,1886,0.12868693438391482
SIM,1947,11,na,1958,4836
SIM,1862,36,30-34,1898,8
STAT,1868,29,35-39,1897,9.247453495213552
STAT,1816,40,na,1856,1641.2088760327747
SIM,1900,12,na,1912,3804
SIM,1883,18,20-24,1901,20
SIM,1860,10,na,1870,2452
STAT,1939,20,40-44,1959,3.411301888862986
SIM,1893,18,30-34,1911,1
STAT,1803,77,na,1880,429.2175409358798
STAT,1828,39,40-44,1867,4.310639642283968
SIM,1871,44,30-34,1915,4
STAT,1897,45,40-44,1942,0.1320665399622564
STAT,1947,22,na,1969,4168.906834945896
SIM,1844,32,20-24,1876,2
STAT,1839,37,na,1876,1814.6050150352753
SIM,1881,40,25-29,1921,3
SIM,1823,62,na,1885,1072
STAT,1856,47,45-49,1903,0.18189374706093378
STAT,1898,48,na,1946,3042.3606555571105
STAT,1895,37,30-34,1932,7.029517897251846
SIM,1885,26,30-34,1911,32
STAT,1883,30,40-44,1913,4.320740050308984
STAT,1919,23,20-24,1942,122.558336167732
SIM,1919,47,na,1966,3924
SIM,1811,61,na,1872,1245
SIM,1862,39,35-39,1901,1
SIM,1815,75,na,1890,435
STAT,1831,105,na,1936,0.018425124535821312
SIM,1770,85,na,1855,67
SIM,1864,24,na,1888,2473
STAT,1818,52,20-24,1870,0.0012620682413609853
SIM,1923,29,na,1952,4333
STAT,1877,26,30-34,1903,26.34028327048667
SIM,1841,31,40-44,1872,9
STAT,1872,27,35-39,1899,9.797723473364309
SIM,1889,63,na,1952,2135
SIM,1893,69,na,1962,2123
STAT,1850,12,na,1862,2233.714312014289
SIM,1860,15,15-19,1875,5
STAT,1827,36,na,1863,1685.7479015722442
SIM,1836,39,40-44,1875,14
STAT,1869,67,na,1936,1556.6181081389143
STAT,1828,46,30-34,1874,0.0893702305482024
STAT,1863,44,30-34,1907,1.0149391135821442
SIM,1885,33,20-24,1918,3
STAT,1818,45,30-34,1863,0.17758504623941165
SIM,1901,25,50-100,1926,4
STAT,1833,31,40-44,1864,4.006200944742656
STAT,1823,45,40-44,1868,0.24245058876956876
STAT,1828,31,30-34,1859,21.244540725821768
STAT,1900,35,na,1935,3336.8546221243005
STAT,1904,49,na,1953,3193.4687774102404
SIM,1882,73,na,1955,948
SIM,1933,20,40-44,1953,11
STAT,1885,43,20-24,1928,0.15850737866569503
STAT,1813,45,30-34,1858,0.2922871267500339
STAT,1871,37,na,1908,2364.044525883038
SIM,1905,11,na,1916,3892
STAT,1820,108,na,1928,9.323881230412521E-4
STAT,1862,88,na,1950,119.74153473216504
STAT,1792,64,na,1856,792.63118424
SIM,1893,36,30-34,1929,8
SIM,1868,39,50-100,1907,2
STAT,1880,36,30-34,1916,5.6803479668778465
STAT,1881,26,50-100,1907,0.6249196378701568
STAT,1821,37,30-34,1858,10.50464915630095
STAT,1852,33,15-19,1885,0.1106668457185027
STAT,1890,36,40-44,1926,5.428545229828831
STAT,1940,32,na,1972,3951.668032545404
STAT,1894,34,na,1928,3076.4379705741944
STAT,1807,52,45-49,1859,0.0492558826262966
STAT,1925,20,40-44,1945,4.091705894101576
STAT,1893,42,15-19,1935,0.017688494005671095
SIM,1836,31,30-34,1867,26
STAT,1873,40,25-29,1913,0.6641452524959114
SIM,1891,30,40-44,1921,3
STAT,1836,41,30-34,1877,0.8739145067122269
SIM,1876,39,35-39,1915,8
SIM,1874,33,45-49,1907,5
STAT,1786,80,na,1866,259.3640780855011
STAT,1966,6,na,1972,4958.008883471201
STAT,1877,41,20-24,1918,0.16629948411330994
SIM,1840,40,35-39,1880,1
STAT,1770,85,na,1855,42.8929
SIM,1906,29,na,1935,3372
STAT,1841,33,40-44,1874,3.8941529270854005
SIM,1877,35,35-39,1912,15
STAT,1855,49,50-100,1904,0.1810083311022559
SIM,1844,15,30-34,1859,2
STAT,1805,88,na,1893,54.49829579766788
STAT,1839,17,50-100,1856,0.045437003481552204
STAT,1854,29,40-44,1883,2.3230518509201885
STAT,1767,97,na,1864,0.7173512688581132
STAT,1845,26,35-39,1871,8.643579415689807
STAT,1861,46,50-100,1907,0.2067124298637641
SIM,1898,68,na,1966,2316
STAT,1945,11,na,1956,4334.139767412189
SIM,1835,75,na,1910,533
SIM,1850,95,na,1945,5
STAT,1922,47,na,1969,4263.67025155526
SIM,1869,32,25-29,1901,12
STAT,1887,38,35-39,1925,7.936191506743717
STAT,1863,51,20-24,1914,6.63516062598625E-4
SIM,1895,38,35-39,1933,5
STAT,1889,43,40-44,1932,2.7809995736917212
SIM,1865,41,na,1906,2122
STAT,1853,18,35-39,1871,0.5426401876750114
SIM,1865,40,40-44,1905,3
STAT,1837,50,50-100,1887,0.010758553564190953
SIM,1897,43,40-44,1940,2
SIM,1794,64,na,1858,811
STAT,1927,43,50-100,1970,0.14868487752455276
SIM,1862,29,40-44,1891,6
SIM,1848,43,45-49,1891,1
STAT,1774,99,na,1873,0.22560012472769972
STAT,1861,34,20-24,1895,2.2492004111444586
SIM,1853,60,na,1913,1442
SIM,1798,78,na,1876,203
STAT,1842,32,50-100,1874,0.9965330967781879
STAT,1841,62,na,1903,1366.8039272036938
STAT,1863,52,30-34,1915,0.005298517938043533
STAT,1871,23,25-29,1894,57.26413789002779
STAT,1903,64,na,1967,2774.9608886135234
SIM,1947,1,na,1948,4988
STAT,1853,28,35-39,1881,8.35148053049399
STAT,1880,54,25-29,1934,0.0036537338469457862
SIM,1935,18,30-34,1953,26
STAT,1832,40,35-39,1872,1.5525205292976318
STAT,1869,35,35-39,1904,7.011275784341543
STAT,1952,19,50-100,1971,0.45331687768492446
STAT,1851,22,45-49,1873,0.6305390236795009
STAT,1887,30,25-29,1917,11.64287205654939
SIM,1818,39,50-100,1857,1
SIM,1918,22,15-19,1940,6
STAT,1811,50,45-49,1861,0.03597691323600667
STAT,1867,44,15-19,1911,0.01295889847318596
SIM,1940,25,50-100,1965,1
STAT,1868,18,30-34,1886,1.557178200778018
STAT,1834,69,na,1903,873.5236645119004
STAT,1880,42,na,1922,2448.538008760905
STAT,1914,16,50-100,1930,0.07838570253090518
STAT,1852,41,15-19,1893,0.010520652595649514
STAT,1914,15,50-100,1929,0.07855695669650356
SIM,1909,28,30-34,1937,56
SIM,1928,28,na,1956,4622
STAT,1851,37,15-19,1888,0.04297488367478544
SIM,1841,42,45-49,1883,1
SIM,1924,14,na,1938,4782
STAT,1915,45,na,1960,3753.035569039909
SIM,1829,67,na,1896,1073
SIM,1940,3,na,1943,4292
STAT,1908,18,50-100,1926,0.07316965526960793
STAT,1877,49,30-34,1926,0.09879972500173266
SIM,1861,28,35-39,1889,10
STAT,1893,34,15-19,1927,0.18106590677406056
STAT,1840,50,35-39,1890,0.00612156747332899
SIM,1845,41,na,1886,1950
SIM,1876,18,30-34,1894,2
STAT,1817,49,30-34,1866,0.2016352359332357
STAT,1837,35,40-44,1872,3.712289447910698
STAT,1872,44,25-29,1916,0.6432580831707153
STAT,1864,99,na,1963,5.53046414834829
STAT,1831,36,35-39,1867,5.716054720816408
STAT,1810,79,na,1889,353.21554861940405
SIM,1830,44,na,1874,1451
SIM,1866,35,na,1901,2414
STAT,1843,39,30-34,1882,3.7402460431776294
SIM,1834,58,na,1892,1396
SIM,1919,17,35-39,1936,6
STAT,1840,45,na,1885,1631.6680378147632
SIM,1835,38,35-39,1873,15
SIM,1899,30,na,1929,3641
STAT,1836,33,30-34,1869,13.778476689542822
SIM,1862,21,30-34,1883,31
SIM,1911,20,50-100,1931,1
STAT,1853,35,25-29,1888,2.4309934088092686
STAT,1869,42,25-29,1911,0.6297952140610625
SIM,1870,72,na,1942,1409
SIM,1895,30,25-29,1925,6
STAT,1859,46,30-34,1905,0.07885734057427503
STAT,1894,29,35-39,1923,12.457168276287067
STAT,1873,41,35-39,1914,1.8624989645569963
STAT,1927,18,30-34,1945,15.27802472885898
STAT,1879,65,na,1944,1781.2201912866515
SIM,1854,37,35-39,1891,10
STAT,1822,51,30-34,1873,0.00867154535969346
STAT,1871,16,35-39,1887,0.5574271841597089
STAT,1875,51,na,1926,2243.988688186222
STAT,1851,17,na,1868,2113.1882061632136
STAT,1833,49,15-19,1882,2.951143519564345E-4
STAT,1826,43,15-19,1869,0.014122924312781952
SIM,1888,14,na,1902,3192
SIM,1889,44,45-49,1933,1
SIM,1901,41,na,1942,3348
STAT,1917,21,45-49,1938,1.2107220105362055
SIM,1877,42,na,1919,2378
STAT,1833,42,45-49,1875,1.2877698997527727
SIM,1961,6,na,1967,5232
STAT,1865,50,40-44,1915,0.00984871305465373
STAT,1862,33,na,1895,2072.605487040218
STAT,1948,22,35-39,1970,10.92139513691864
SIM,1831,29,na,1860,1841
SIM,1877,42,25-29,1919,1
SIM,1885,34,30-34,1919,29
STAT,1863,25,40-44,1888,2.7196129210371445
STAT,1906,20,na,1926,3499.99030986697
SIM,1910,20,45-49,1930,4
STAT,1805,105,na,1910,0.011639603822666655
STAT,1880,47,35-39,1927,0.14780715765762073
STAT,1854,21,30-34,1875,15.820378483298507
STAT,1877,34,30-34,1911,18.044591854482704
STAT,1903,20,50-100,1923,0.5900709495328871
STAT,1868,93,na,1961,58.61451111821767
STAT,1827,38,35-39,1865,8.036442365492325
STAT,1851,19,15-19,1870,5.399189026510609
STAT,1797,96,na,1893,2.1438598484014113
SIM,1851,39,30-34,1890,8
STAT,1933,30,na,1963,5156.222769019687
SIM,1856,42,40-44,1898,5
STAT,1863,18,na,1881,2333.0951041712146
STAT,1843,46,20-24,1889,0.008159754627593056
STAT,1859,53,20-24,1912,5.898135464947942E-4
STAT,1911,33,50-100,1944,0.8088232660981965
SIM,1861,35,25-29,1896,3
STAT,1880,29,35-39,1909,10.161570228044033
SIM,1853,17,na,1870,2071
STAT,1947,22,40-44,1969,3.838480780831236
STAT,1880,21,25-29,1901,60.90434324309411
STAT,1836,40,20-24,1876,0.12227751768562636
SIM,1847,76,na,1923,644
SIM,1831,92,na,1923,10
STAT,1902,20,45-49,1922,1.0011975100367385
STAT,1821,41,50-100,1862,1.733966277480845
STAT,1900,36,25-29,1936,0.8760969667390143
STAT,1872,37,35-39,1909,7.18199218860563
SIM,1821,38,35-39,1859,12
SIM,1843,62,na,1905,1707
SIM,1871,25,40-44,1896,5
STAT,1806,50,35-39,1856,0.02585810449161329
SIM,1876,27,50-100,1903,2
SIM,1858,48,na,1906,1800
STAT,1808,53,na,1861,1155.4893099705164
STAT,1811,96,na,1907,3.7432901338766684
STAT,1937,32,25-29,1969,9.231489541151033
STAT,1848,42,40-44,1890,1.8341793024238409
STAT,1895,47,30-34,1942,0.07168394246605941
SIM,1912,13,na,1925,3949
STAT,1835,19,50-100,1854,0.1050163969950047
STAT,1920,48,45-49,1968,0.24193689259972526
SIM,1939,24,na,1963,3639
STAT,1870,30,50-100,1900,0.9160259996264963
STAT,1852,6,na,1858,2288.3099930682192
SIM,1934,32,50-100,1966,1
STAT,1869,39,30-34,1908,5.180752064387025
STAT,1915,47,25-29,1962,0.05393573763670784
STAT,1884,47,20-24,1931,0.01189621992491373
STAT,1933,36,50-100,1969,0.5784113266943961
SIM,1840,32,35-39,1872,12
SIM,1903,32,50-100,1935,2
SIM,1849,29,25-29,1878,47
STAT,1885,39,35-39,1924,7.039109000435372
STAT,1836,92,na,1928,26.260954470328564
STAT,1881,46,40-44,1927,0.16714762570024652
SIM,1948,16,15-19,1964,1
SIM,1923,26,50-100,1949,1
SIM,1929,13,na,1942,4941
STAT,1837,101,na,1938,0.38926776125611373
STAT,1829,37,35-39,1866,5.7963921634519275
STAT,1904,18,na,1922,3651.0700855607465
SIM,1877,24,30-34,1901,1
SIM,1886,36,40-44,1922,3
STAT,1878,36,40-44,1914,4.611703774766772
SIM,1846,59,na,1905,1396
STAT,1891,14,na,1905,3218.916633620118
SIM,1848,28,50-100,1876,5
STAT,1867,48,30-34,1915,0.0909213154947588
STAT,1769,105,na,1874,0.016619134326922823
STAT,1844,45,25-29,1889,0.046290880354594104
SIM,1890,17,na,1907,3415
STAT,1828,73,na,1901,771.0381452172738
STAT,1835,33,15-19,1868,0.13472371955934231
SIM,1884,16,15-19,1900,9
SIM,1863,27,35-39,1890,11
SIM,1886,22,30-34,1908,29
SIM,1929,32,40-44,1961,8
STAT,1823,41,25-29,1864,0.9768940003037643
STAT,1895,15,50-100,1910,0.06491872060247862
STAT,1878,22,30-34,1900,18.675373251479524
STAT,1925,23,45-49,1948,1.3569131117588096
SIM,1813,43,30-34,1856,1
SIM,1877,39,30-34,1916,3
STAT,1884,21,45-49,1905,0.6966256448446494
SIM,1893,39,35-39,1932,13
STAT,1789,77,na,1866,413.34489494579094
STAT,1880,19,40-44,1899,0.19296677310429936
SIM,1826,101,na,1927,1
SIM,1901,30,45-49,1931,5
STAT,1870,21,15-19,1891,3.2818114951385025
SIM,1854,33,40-44,1887,5
SIM,1872,35,35-39,1907,14
SIM,1822,56,na,1878,1285
STAT,1818,48,35-39,1866,0.24558581779151195
SIM,1899,53,na,1952,3132
STAT,1863,94,na,1957,23.439794174169087
STAT,1876,52,45-49,1928,0.015053601610733785
STAT,1895,40,25-29,1935,0.8555279582260911
SIM,1820,42,50-100,1862,1
SIM,1914,48,50-100,1962,3
STAT,1900,15,na,1915,3559.9169734699926
STAT,1858,28,15-19,1886,0.365384095586356
STAT,1904,29,na,1933,3434.3490277248884
SIM,1828,43,40-44,1871,2
SIM,1918,26,30-34,1944,46
STAT,1814,41,30-34,1855,4.172546286885592
STAT,1878,37,30-34,1915,5.5878212603889885
SIM,1880,34,30-34,1914,25
STAT,1957,12,na,1969,5231.64521130645
STAT,1872,34,30-34,1906,17.577173426685615
STAT,1930,3,na,1933,5300.094828803279
SIM,1857,22,na,1879,2369
STAT,1869,31,20-24,1900,2.6651385957844105
STAT,1881,32,30-34,1913,16.99817774957471
STAT,1945,3,na,1948,4423.878397335331
STAT,1900,29,35-39,1929,13.440798795054615
SIM,1909,20,20-24,1929,136
STAT,1893,38,30-34,1931,6.8009706447279425
STAT,1867,26,15-19,1893,0.4330528434636433
STAT,1821,42,na,1863,1646.9651664501876
SIM,1898,29,20-24,1927,15
STAT,1892,20,40-44,1912,2.656733519856429
SIM,1864,40,25-29,1904,1
STAT,1904,30,20-24,1934,3.9493565215266644
STAT,1880,73,na,1953,1259.861712661538
STAT,1876,36,na,1912,2468.739424766572
STAT,1873,33,35-39,1906,10.325441775048416
STAT,1853,41,30-34,1894,0.9550505594296178
SIM,1857,44,50-100,1901,3
SIM,1877,23,50-100,1900,2
STAT,1843,20,45-49,1863,0.5989186319618096
STAT,1872,41,20-24,1913,0.16199174226829846
STAT,1897,38,15-19,1935,0.07565943714249405
SIM,1845,35,40-44,1880,2
SIM,1939,18,15-19,1957,66
STAT,1809,93,na,1902,13.494792573887812
STAT,1850,46,50-100,1896,0.188593248118494
SIM,1867,21,na,1888,2205
STAT,1869,50,25-29,1919,0.003528091523202157
STAT,1823,34,35-39,1857,20.791130039191355
STAT,1869,98,na,1967,15.392362594454198
STAT,1873,47,45-49,1920,0.24051610790638572
STAT,1860,39,30-34,1899,4.355954489493336
SIM,1845,21,30-34,1866,20
SIM,1857,28,20-24,1885,9
STAT,1922,21,25-29,1943,107.33337953967484
STAT,1806,74,na,1880,461.7302206850245
STAT,1852,44,20-24,1896,0.11881677647137776
SIM,1930,21,25-29,1951,8
STAT,1803,108,na,1911,7.635790979930204E-4
STAT,1826,104,na,1930,0.03659967203146894
STAT,1855,27,35-39,1882,7.5704136354451785
STAT,1847,39,15-19,1886,0.04272695013236943
STAT,1890,25,35-39,1915,11.98911953988341
STAT,1890,32,25-29,1922,12.641021044684933
STAT,1890,72,na,1962,1771.8745427897875
SIM,1874,30,40-44,1904,6
STAT,1825,45,na,1870,1929.9979503265438
SIM,1814,42,35-39,1856,3
SIM,1819,39,40-44,1858,8
STAT,1837,36,30-34,1873,4.472997008495981
STAT,1944,18,30-34,1962,13.241388196141894
STAT,1859,49,35-39,1908,0.1113524481662676
STAT,1879,53,25-29,1932,0.0036733391261496774
SIM,1875,19,25-29,1894,8
STAT,1849,28,20-24,1877,10.794797337463308
STAT,1872,53,35-39,1925,0.008601459240876092
SIM,1956,15,na,1971,4976
STAT,1880,15,50-100,1895,0.052207642562640794
SIM,1856,69,na,1925,1196
SIM,1912,30,20-24,1942,2
SIM,1886,12,na,1898,2909
STAT,1840,45,40-44,1885,0.12416059438256129
STAT,1914,28,na,1942,3796.870122088829
STAT,1899,29,15-19,1928,0.6244057482290964
STAT,1779,78,na,1857,341.6364780866619
STAT,1840,22,na,1862,1906.0291579088805
STAT,1886,67,na,1953,1690.4651991629078
STAT,1948,8,na,1956,4543.470646535259
SIM,1933,23,45-49,1956,2
STAT,1840,31,30-34,1871,15.06267086843072
STAT,1867,19,25-29,1886,5.4457976599815465
STAT,1942,29,40-44,1971,4.9343965052738445
STAT,1805,50,20-24,1855,0.0031586375448017776
STAT,1847,50,25-29,1897,0.0026901470782375774
STAT,1931,28,na,1959,4885.602209196415
SIM,1843,15,15-19,1858,7
STAT,1882,53,na,1935,2072.723510399005
SIM,1790,82,na,1872,222
SIM,1828,34,50-100,1862,4
STAT,1857,40,40-44,1897,1.7908689247750795
STAT,1885,46,25-29,1931,0.05807186247385054
STAT,1932,39,25-29,1971,1.334069523017191
STAT,1936,23,20-24,1959,107.28935759755635
SIM,1820,45,na,1865,1435
STAT,1819,37,na,1856,1479.5559194456623
STAT,1837,54,30-34,1891,0.003949272085828252
STAT,1841,44,45-49,1885,1.1335770480356941
SIM,1870,31,30-34,1901,26
STAT,1925,41,45-49,1966,0.20392759827458493
STAT,1823,74,na,1897,613.7834998192842
SIM,1831,34,35-39,1865,5
SIM,1873,69,na,1942,1361
SIM,1864,47,50-100,1911,1
SIM,1878,35,30-34,1913,13
SIM,1890,30,25-29,1920,25
STAT,1831,33,30-34,1864,14.280776791500033
SIM,1925,31,na,1956,4488
STAT,1848,18,na,1866,2309.5816753608447
STAT,1936,19,35-39,1955,4.034063668495899
SIM,1851,17,15-19,1868,10
STAT,1860,43,15-19,1903,0.011319398289215432
SIM,1924,39,40-44,1963,3
STAT,1831,52,35-39,1883,0.005657364945182191
STAT,1827,51,30-34,1878,0.006012822149683186
STAT,1863,73,na,1936,1062.9077000256104
SIM,1895,71,na,1966,2094
STAT,1868,32,15-19,1900,0.13746482780125674
SIM,1851,37,na,1888,1894
STAT,1864,42,25-29,1906,0.5845331416854456
SIM,1897,2,na,1899,3648
STAT,1847,54,40-44,1901,0.007665679069201036
STAT,1899,47,15-19,1946,3.113036595877222E-4
STAT,1815,55,na,1870,1147.4528110961498
STAT,1881,17,35-39,1898,0.5342042677623987
SIM,1834,29,30-34,1863,33
SIM,1842,77,na,1919,490
SIM,1850,96,na,1946,1
STAT,1898,41,40-44,1939,0.21483032230989993
STAT,1859,68,na,1927,1241.4092338142418
SIM,1896,26,35-39,1922,20
STAT,1843,17,15-19,1860,5.115128354434198
STAT,1911,47,40-44,1958,0.15058482935716025
SIM,1942,12,na,1954,4396
STAT,1866,47,na,1913,2094.314838367904
STAT,1871,20,20-24,1891,69.56104376772792
STAT,1920,35,na,1955,4166.891982481162
STAT,1855,54,na,1909,1576.1650798895585
STAT,1843,74,na,1917,748.5166473794866
STAT,1835,51,45-49,1886,0.011326886911174526
SIM,1864,88,na,1952,139
STAT,1906,21,40-44,1927,3.0747534412288458
STAT,1826,29,30-34,1855,45.69890341134899
STAT,1868,46,25-29,1914,0.05575861465838851
STAT,1925,22,50-100,1947,0.7959760358109388
SIM,1891,4,na,1895,3429
STAT,1894,42,30-34,1936,0.10368488061575244
STAT,1861,23,15-19,1884,2.824077907352206
STAT,1893,49,na,1942,2825.571743535291
STAT,1896,43,30-34,1939,0.10596251363385881
SIM,1944,19,35-39,1963,7
SIM,1841,47,50-100,1888,2
STAT,1882,30,25-29,1912,10.101375851439204
SIM,1843,18,na,1861,2583
STAT,1851,92,na,1943,31.536427760699492
SIM,1905,49,50-100,1954,3
STAT,1916,39,40-44,1955,1.5314847575907362
SIM,1918,5,na,1923,4544
STAT,1852,15,15-19,1867,5.508139637955017
STAT,1877,44,25-29,1921,0.6603638301872946
STAT,1877,42,30-34,1919,1.1969654977895028
SIM,1928,22,25-29,1950,138
SIM,1829,35,35-39,1864,4
SIM,1885,44,25-29,1929,3
STAT,1871,28,30-34,1899,25.179184005806754
STAT,1831,26,50-100,1857,0.5704292411506194
SIM,1907,30,50-100,1937,1
SIM,1886,37,30-34,1923,16
STAT,1832,28,15-19,1860,0.4124790925411106
STAT,1859,57,na,1916,1632.4947548869206
SIM,1848,40,40-44,1888,7
SIM,1903,15,30-34,1918,3
STAT,1877,16,30-34,1893,1.6655673160397775
STAT,1914,48,20-24,1962,0.011027358220816156
STAT,1829,52,30-34,1881,0.0039048915722489355
STAT,1819,92,na,1911,21.17301761633148
STAT,1867,87,na,1954,167.5870240239588
STAT,1826,47,30-34,1873,0.09538684106103204
STAT,1807,59,na,1866,1013.6933712887088
STAT,1872,26,45-49,1898,1.1312940061387216
STAT,1888,44,35-39,1932,2.1295539683052005
STAT,1868,27,50-100,1895,0.6174892241294004
SIM,1828,41,na,1869,1599
STAT,1857,36,20-24,1893,0.6105417596943599
SIM,1892,21,45-49,1913,6
STAT,1828,96,na,1924,5.5740902362703855
STAT,1846,33,40-44,1879,3.8490466660959286
SIM,1918,33,20-24,1951,5
STAT,1883,48,15-19,1931,3.903806370370772E-4
STAT,1913,5,na,1918,4134.245771746688
STAT,1921,30,20-24,1951,2.7635340625065425
STAT,1784,108,na,1892,0.001719724138441969
SIM,1877,38,50-100,1915,1
SIM,1845,24,35-39,1869,8
STAT,1843,35,15-19,1878,0.045142893522246506
STAT,1795,84,na,1879,127.42674604132021
SIM,1820,34,25-29,1854,9
STAT,1836,43,25-29,1879,0.47578368079885475
STAT,1776,81,na,1857,166.71748224343293
STAT,1799,98,na,1897,1.0901187760697975
STAT,1814,60,na,1874,1136.9821130624155
STAT,1899,9,na,1908,3596.555485872359
SIM,1830,24,40-44,1854,3
STAT,1876,45,20-24,1921,0.012638876147842192
STAT,1906,49,25-29,1955,0.04679992844322822
SIM,1924,23,50-100,1947,1
SIM,1938,30,40-44,1968,5
STAT,1846,39,na,1885,1828.7112130593532
STAT,1884,18,15-19,1902,5.895296663227039
SIM,1844,43,25-29,1887,2
SIM,1869,37,30-34,1906,11
STAT,1837,24,35-39,1861,5.136939241757869
STAT,1843,73,na,1916,801.100911189998
STAT,1847,87,na,1934,131.9130764203506
SIM,1842,44,50-100,1886,1
SIM,1889,41,40-44,1930,5
STAT,1833,50,45-49,1883,0.011049777361184059
STAT,1822,43,30-34,1865,1.7849329427447056
SIM,1841,82,na,1923,278
SIM,1813,49,50-100,1862,3
SIM,1895,34,40-44,1929,9
STAT,1893,45,20-24,1938,0.008767390167677197
STAT,1856,37,15-19,1893,0.04348307479914725
SIM,1782,86,na,1868,6
SIM,1898,13,na,1911,3501
SIM,1885,42,30-34,1927,4
STAT,1887,34,40-44,1921,4.848412154806245
SIM,1825,30,45-49,1855,3
SIM,1876,8,na,1884,3054
STAT,1826,54,20-24,1880,6.739820583714558E-4
SIM,1868,16,30-34,1884,5
SIM,1937,12,na,1949,3778
SIM,1864,55,na,1919,2294
SIM,1914,21,40-44,1935,4
STAT,1863,29,35-39,1892,8.573013316613602
STAT,1831,40,20-24,1871,0.1260229402194762
STAT,1815,78,na,1893,338.22204210317386
SIM,1878,16,na,1894,2970
STAT,1875,18,20-24,1893,18.34016532338803
SIM,1864,19,15-19,1883,7
SIM,1860,41,na,1901,2072
STAT,1896,25,30-34,1921,33.89461832403437
STAT,1907,20,45-49,1927,1.040457931795177
SIM,1894,9,na,1903,3732
STAT,1832,46,45-49,1878,0.19301712017711226
STAT,1868,52,30-34,1920,0.005715353098852623
STAT,1877,37,35-39,1914,7.372978271279898
SIM,1830,25,30-34,1855,33
STAT,1863,21,25-29,1884,52.62730507831744
SIM,1938,30,50-100,1968,1
SIM,1904,31,25-29,1935,8
SIM,1885,37,35-39,1922,15
STAT,1856,19,15-19,1875,5.369935960936031
STAT,1832,32,35-39,1864,9.013891194213317
STAT,1930,20,20-24,1950,144.83448838696802
SIM,1912,31,50-100,1943,1
SIM,1871,21,25-29,1892,1
STAT,1814,44,35-39,1858,4.601262659207673
STAT,1782,108,na,1890,0.005321717577106183
STAT,1856,91,na,1947,44.87167510247586
STAT,1824,44,45-49,1868,1.7838313145222584
SIM,1887,72,na,1959,1346
STAT,1777,96,na,1873,1.1457499608940713
SIM,1932,13,na,1945,5985
STAT,1859,108,na,1967,0.014480128145528508
SIM,1944,26,25-29,1970,7
STAT,1868,50,45-49,1918,0.014210011736328139
STAT,1884,24,na,1908,2340.830273831612
STAT,1843,43,50-100,1886,0.7243040569923861
SIM,1853,30,20-24,1883,7
STAT,1908,23,45-49,1931,1.0409630480622152
STAT,1855,42,30-34,1897,0.8643138186288118
SIM,1833,33,50-100,1866,5
STAT,1838,49,15-19,1887,2.685118489969504E-4
SIM,1845,39,35-39,1884,4
SIM,1851,92,na,1943,33
SIM,1835,39,25-29,1874,2
SIM,1891,57,na,1948,2510
STAT,1934,31,45-49,1965,2.172128401414383
STAT,1806,53,40-44,1859,0.02977485479016743
STAT,1895,36,40-44,1931,5.801555330939521
STAT,1898,37,20-24,1935,1.05545305542581
STAT,1817,45,15-19,1862,8.879623320001262E-4
STAT,1900,41,20-24,1941,0.01554284265502072
SIM,1802,57,na,1859,1126
SIM,1823,32,35-39,1855,4
STAT,1871,49,35-39,1920,0.1375462869055802
STAT,1938,32,40-44,1970,3.972380903611184
STAT,1834,30,45-49,1864,1.3581966776706074
SIM,1903,46,45-49,1949,1
STAT,1814,93,na,1907,13.679245161072195
SIM,1928,15,35-39,1943,4
SIM,1890,23,35-39,1913,9
STAT,1882,23,35-39,1905,5.691486520696394
STAT,1877,86,na,1963,415.3480807694062
STAT,1901,28,40-44,1929,4.226362087665284
STAT,1937,12,na,1949,3891.4250758749254
STAT,1888,19,45-49,1907,0.07745411114624458
STAT,1825,33,50-100,1858,1.9359838875618554
STAT,1809,54,20-24,1863,0.0022727802092684683
SIM,1840,43,40-44,1883,7
STAT,1891,35,45-49,1926,2.5164861833270527
STAT,1881,35,35-39,1916,6.95134874374055
STAT,1850,105,na,1955,0.022451242884560265
SIM,1885,19,35-39,1904,1
SIM,1918,21,25-29,1939,106
SIM,1861,36,na,1897,2068
STAT,1894,18,50-100,1912,0.06353896320859573
SIM,1862,38,50-100,1900,1
STAT,1936,26,25-29,1962,63.62257890307991
STAT,1852,19,30-34,1871,1.4447995799412952
STAT,1859,53,50-100,1912,0.012071516773650513
STAT,1884,36,15-19,1920,0.056198855417567715
STAT,1907,46,na,1953,3347.12317172807
STAT,1835,102,na,1937,0.22004184020294557
SIM,1855,25,35-39,1880,12
STAT,1923,49,25-29,1972,0.06233107068062678
STAT,1816,39,15-19,1855,0.19521603856272957
SIM,1851,81,na,1932,519
SIM,1921,31,25-29,1952,14
STAT,1882,50,40-44,1932,0.010447711291497104
SIM,1892,18,15-19,1910,9
STAT,1860,21,na,1881,2027.4571735556078
STAT,1875,20,na,1895,2467.7061817199606
SIM,1822,44,35-39,1866,2
SIM,1832,44,45-49,1876,2
STAT,1872,50,30-34,1922,0.006131202835204192
SIM,1842,30,45-49,1872,2
STAT,1827,31,15-19,1858,0.20012713640723961
STAT,1837,31,25-29,1868,8.852503211746765
STAT,1848,73,na,1921,969.7506917816239
SIM,1832,23,na,1855,1796
SIM,1834,89,na,1923,18
SIM,1860,19,30-34,1879,1
STAT,1880,21,na,1901,2516.205661899927
STAT,1949,21,40-44,1970,3.9650221569037623
SIM,1844,36,35-39,1880,10
STAT,1874,51,45-49,1925,0.015080397944942028
SIM,1854,36,45-49,1890,2
STAT,1839,37,15-19,1876,0.047575910275000535
STAT,1864,51,35-39,1915,0.007883727152321373
SIM,1830,75,na,1905,504
STAT,1864,35,na,1899,2167.5996650348097
STAT,1847,25,35-39,1872,8.809543167444634
STAT,1894,22,15-19,1916,4.289837622147845
SIM,1909,24,15-19,1933,6
STAT,1845,30,20-24,1875,2.3976673744578423
STAT,1837,39,35-39,1876,5.754079471771315
SIM,1853,38,30-34,1891,9
STAT,1827,39,25-29,1866,3.196666221445857
STAT,1913,31,25-29,1944,9.316096241713904
STAT,1869,17,35-39,1886,0.5462707780427308
SIM,1863,24,30-34,1887,18
SIM,1902,47,na,1949,3387
SIM,1934,24,na,1958,5023
STAT,1850,34,45-49,1884,1.3681155871127164
SIM,1878,34,40-44,1912,4
STAT,1840,34,35-39,1874,8.4687562731582
SIM,1831,31,30-34,1862,26
SIM,1853,4,na,1857,2286
SIM,1868,34,30-34,1902,28
SIM,1911,17,30-34,1928,5
SIM,1881,44,40-44,1925,4
STAT,1858,28,na,1886,1921.958902487352
STAT,1855,24,30-34,1879,15.439373167840795
STAT,1860,20,45-49,1880,0.6616568481477687
STAT,1842,25,20-24,1867,13.251387432499953
STAT,1890,22,30-34,1912,21.983222108562067
SIM,1874,54,na,1928,1959
SIM,1845,31,25-29,1876,14
SIM,1868,44,25-29,1912,1
SIM,1878,68,na,1946,1664
STAT,1908,41,45-49,1949,0.15633162772413428
STAT,1903,17,30-34,1920,2.292642946092406
STAT,1932,13,na,1945,5293.925127881138
STAT,1936,27,na,1963,3619.440860428668
STAT,1854,69,na,1923,1101.3715916634678
STAT,1847,43,35-39,1890,1.3460291631470882
STAT,1846,36,45-49,1882,1.5963061146231914
STAT,1948,18,15-19,1966,52.44932971030064
STAT,1888,26,35-39,1914,11.542074207121505
STAT,1836,36,35-39,1872,5.533910445030042
SIM,1878,30,25-29,1908,25
SIM,1850,25,20-24,1875,17
STAT,1798,58,na,1856,1195.6887028124006
STAT,1865,21,na,1886,2223.660245646584
STAT,1837,25,na,1862,1921.5874699193441
SIM,1844,18,35-39,1862,1
SIM,1918,29,35-39,1947,23
SIM,1855,43,35-39,1898,1
SIM,1938,27,na,1965,3543
STAT,1852,47,25-29,1899,0.0434797216201833
SIM,1916,23,45-49,1939,2
STAT,1873,44,40-44,1917,2.2719681376223186
STAT,1840,41,25-29,1881,0.4756206303695719
STAT,1828,45,40-44,1873,0.16016708584114608
SIM,1858,17,na,1875,2153
STAT,1902,7,na,1909,3718.520808623049
STAT,1823,31,30-34,1854,53.81410366683798
STAT,1831,41,na,1872,1631.2280161191266
STAT,1835,55,na,1890,1551.9178477548205
STAT,1849,38,15-19,1887,0.04446193765922737
STAT,1863,54,25-29,1917,0.0030825461244937376
SIM,1927,24,50-100,1951,1
STAT,1870,28,35-39,1898,9.536008458045462
SIM,1773,82,na,1855,113
STAT,1842,47,15-19,1889,3.601937681333365E-4
STAT,1924,25,50-100,1949,1.1790441824436455
STAT,1847,36,50-100,1883,0.9637247611892934
STAT,1878,25,35-39,1903,10.185098492760236
STAT,1871,8,na,1879,2725.2418179174756
STAT,1886,46,na,1932,2406.0262679605817
STAT,1862,33,25-29,1895,8.89610678326567
STAT,1858,4,na,1862,2467.1399345252144
SIM,1855,40,na,1895,2007
STAT,1873,29,15-19,1902,0.46123014373927057
STAT,1883,39,na,1922,2305.144172644025
STAT,1854,58,na,1912,1484.1603365638498
STAT,1929,20,50-100,1949,0.8460468202066872
SIM,1886,25,35-39,1911,15
SIM,1881,36,na,1917,2088
STAT,1936,17,50-100,1953,0.3621261979458504
STAT,1775,85,na,1860,60.629649615494
SIM,1937,7,na,1944,3812
SIM,1844,88,na,1932,17
SIM,1829,28,45-49,1857,1
SIM,1855,36,50-100,1891,4
STAT,1850,16,15-19,1866,5.585800621398628
STAT,1902,47,na,1949,3196.73176677073
STAT,1921,36,45-49,1957,0.7694899197669033
STAT,1879,50,20-24,1929,7.889437395490864E-4
STAT,1899,19,20-24,1918,24.44264908491902
STAT,1921,15,25-29,1936,50.12109570134955
STAT,1896,46,35-39,1942,0.10587864358100965
SIM,1929,3,na,1932,5070
STAT,1878,32,25-29,1910,10.738907386890814
SIM,1837,31,50-100,1868,4
STAT,1872,23,40-44,1895,2.109404753808196
STAT,1900,36,na,1936,3347.579679519513
STAT,1891,17,15-19,1908,7.421026315153793
STAT,1901,24,25-29,1925,80.54422782988962
SIM,1886,32,25-29,1918,18
SIM,1847,55,na,1902,1482
SIM,1903,18,35-39,1921,4
SIM,1878,38,35-39,1916,16
SIM,1860,37,30-34,1897,5
STAT,1861,41,45-49,1902,1.261783900749007
SIM,1853,23,30-34,1876,19
STAT,1847,18,45-49,1865,0.06068417375178065
STAT,1936,16,30-34,1952,11.810109469939876
STAT,1845,23,30-34,1868,16.04150348709362
STAT,1842,29,15-19,1871,0.4979238046588314
STAT,1834,49,30-34,1883,0.0595913263735321
STAT,1914,6,na,1920,4169.4619080934
STAT,1932,36,20-24,1968,0.35825910297624347
STAT,1829,31,50-100,1860,0.837618781500027
STAT,1852,37,30-34,1889,4.063840475207427
SIM,1795,81,na,1876,102
SIM,1939,22,35-39,1961,11
STAT,1840,16,35-39,1856,0.5009525217796246
STAT,1849,41,45-49,1890,1.1754471167906342
SIM,1886,35,na,1921,2715
STAT,1883,26,20-24,1909,11.634821254178762
SIM,1857,41,45-49,1898,5
SIM,1944,16,30-34,1960,19
STAT,1858,46,15-19,1904,3.178542587296392E-4
SIM,1891,33,45-49,1924,2
STAT,1837,21,30-34,1858,16.02270647777349
STAT,1963,4,na,1967,5045.169343853286
SIM,1787,85,na,1872,58
SIM,1830,28,35-39,1858,11
STAT,1820,45,na,1865,1345.9845599687
STAT,1868,43,20-24,1911,0.15219335958979335
STAT,1906,39,30-34,1945,1.6752409429414294
STAT,1839,52,40-44,1891,0.0074240841527575974
SIM,1807,56,na,1863,1071
STAT,1805,89,na,1894,41.70373089324938
SIM,1870,26,35-39,1896,11
SIM,1870,95,na,1965,55
SIM,1952,18,30-34,1970,14
STAT,1928,42,25-29,1970,0.09201352712987194
SIM,1845,29,40-44,1874,3
STAT,1845,38,30-34,1883,4.049384088691882
STAT,1850,49,15-19,1899,2.998902657027269E-4
STAT,1837,29,40-44,1866,2.5854522567646443
STAT,1872,87,na,1959,258.4445705625892
SIM,1817,89,na,1906,39
STAT,1831,25,45-49,1856,1.0224577456383834
SIM,1918,36,25-29,1954,1
STAT,1898,44,45-49,1942,0.14038074095940817
SIM,1951,16,na,1967,4617
STAT,1836,47,40-44,1883,0.11302488446913339
STAT,1862,26,35-39,1888,8.508104772189373
STAT,1873,0,na,1873,3786.1790750467085
STAT,1830,27,30-34,1857,27.67903067043273
STAT,1930,42,45-49,1972,0.22132769662257296
SIM,1939,23,na,1962,3747
SIM,1938,33,45-49,1971,2
SIM,1903,5,na,1908,3579
SIM,1868,50,50-100,1918,1
SIM,1882,21,35-39,1903,7
SIM,1861,29,25-29,1890,43
SIM,1877,83,na,1960,555
STAT,1832,26,na,1858,1960.5016750687048
STAT,1906,46,20-24,1952,0.00998617120324801
STAT,1893,48,25-29,1941,0.041144497584875664
STAT,1894,40,45-49,1934,1.9657713521191778
STAT,1886,8,na,1894,2772.137909948974
STAT,1928,23,50-100,1951,0.8278164121238496
STAT,1886,31,20-24,1917,2.894302734603285
SIM,1884,21,na,1905,2538
SIM,1916,50,na,1966,3730
STAT,1903,48,45-49,1951,0.18908079052385257
STAT,1823,50,35-39,1873,0.011868412041745368
SIM,1893,68,na,1961,2173
SIM,1936,24,25-29,1960,116
SIM,1931,9,na,1940,5169
STAT,1936,9,na,1945,3847.741883196298
SIM,1837,22,na,1859,1751
SIM,1855,95,na,1950,1
STAT,1863,19,40-44,1882,0.1679663284567205
STAT,1832,43,40-44,1875,1.8552020361744181
SIM,1926,20,20-24,1946,146
STAT,1873,15,35-39,1888,0.5685058183996031
STAT,1896,28,35-39,1924,12.85444951155773
SIM,1915,10,na,1925,4556
SIM,1919,24,na,1943,3865
STAT,1872,54,na,1926,2126.2476737873058
STAT,1884,35,na,1919,2368.8268754151513
STAT,1837,66,na,1903,1118.099249268562
STAT,1928,17,35-39,1945,5.344163469834559
SIM,1894,31,20-24,1925,4
STAT,1822,53,25-29,1875,0.004958774715649666
SIM,1862,35,40-44,1897,4
STAT,1890,41,35-39,1931,2.244947536430253
SIM,1827,33,30-34,1860,29
STAT,1794,99,na,1893,0.36829869430256124
STAT,1853,29,25-29,1882,36.350455712169165
STAT,1921,19,50-100,1940,0.4290064548133599
SIM,1920,32,na,1952,4437
STAT,1819,40,20-24,1859,0.36401445367103163
STAT,1790,85,na,1875,76.38484118800521
SIM,1872,32,30-34,1904,30
STAT,1849,58,na,1907,1546.190313315345
SIM,1926,28,30-34,1954,52
STAT,1886,24,30-34,1910,18.875982702499144
SIM,1871,26,30-34,1897,31
SIM,1894,39,30-34,1933,10
SIM,1879,45,50-100,1924,3
STAT,1945,16,50-100,1961,0.4134319157863846
SIM,1894,24,30-34,1918,49
STAT,1854,35,40-44,1889,3.3355251356762734
STAT,1822,46,35-39,1868,0.21050649331106078
STAT,1921,33,25-29,1954,10.344420545884505
SIM,1837,37,35-39,1874,4
SIM,1895,37,45-49,1932,2
STAT,1819,48,30-34,1867,0.18586960256157667
STAT,1928,24,25-29,1952,115.8393116334939
STAT,1853,21,15-19,1874,3.2468135350229117
STAT,1876,34,15-19,1910,0.14723736424334413
STAT,1918,20,20-24,1938,121.79670661252607
SIM,1839,40,50-100,1879,1
STAT,1896,20,25-29,1916,76.98951058531485
STAT,1887,37,45-49,1924,2.2479472055697296
STAT,1844,38,35-39,1882,5.85233073952733
SIM,1835,74,na,1909,581
SIM,1839,88,na,1927,37
STAT,1880,52,30-34,1932,0.006280319433033153
SIM,1852,38,35-39,1890,14
SIM,1875,7,na,1882,2668
STAT,1842,32,45-49,1874,1.8966275184792163
STAT,1865,45,45-49,1910,0.21982231779989453
STAT,1918,28,30-34,1946,41.94988462181463
STAT,1886,39,30-34,1925,5.62622330072245
SIM,1861,21,15-19,1882,6
STAT,1820,40,45-49,1860,3.024664258323276
STAT,1835,53,30-34,1888,0.0044655161545224765
STAT,1948,21,45-49,1969,1.305503293961927
STAT,1838,37,50-100,1875,0.991728321864771
STAT,1863,26,30-34,1889,22.697996012734382
SIM,1878,27,30-34,1905,36
STAT,1905,47,15-19,1952,3.2791025922258713E-4
STAT,1851,24,50-100,1875,0.3634602413924001
STAT,1859,34,na,1893,1921.8888239602884
SIM,1818,39,25-29,1857,6
STAT,1909,30,20-24,1939,2.367680930352799
SIM,1903,43,40-44,1946,2
STAT,1930,31,25-29,1961,12.062874748215101
STAT,1802,53,20-24,1855,0.002110346187147569
SIM,1886,56,na,1942,2279
STAT,1840,18,50-100,1858,0.04420255253960721
SIM,1880,41,na,1921,2211
STAT,1820,44,25-29,1864,1.1304808532463015
STAT,1927,21,25-29,1948,115.37421033824555
STAT,1944,15,na,1959,4002.0179570914497
STAT,1862,30,50-100,1892,0.8055917996523477
STAT,1902,46,35-39,1948,0.11303310811700903
SIM,1890,20,30-34,1910,29
SIM,1852,22,na,1874,1897
STAT,1877,48,40-44,1925,0.1762204798385367
STAT,1907,42,20-24,1949,0.016337347190378288
STAT,1912,40,20-24,1952,0.017379191000188476
SIM,1932,20,45-49,1952,2
STAT,1860,46,20-24,1906,0.009935648351801054
SIM,1880,26,45-49,1906,4
SIM,1825,44,na,1869,1324
STAT,1836,61,na,1897,1178.2195513110753
STAT,1897,16,35-39,1913,0.7448092269751987
STAT,1880,29,50-100,1909,0.6736788618412692
SIM,1905,31,40-44,1936,2
SIM,1795,60,na,1855,986
SIM,1923,22,45-49,1945,3
SIM,1917,30,20-24,1947,3
STAT,1899,27,50-100,1926,0.8867107931831778
SIM,1896,1,na,1897,3599
SIM,1846,91,na,1937,4
STAT,1876,91,na,1967,182.64497242763892
SIM,1930,32,45-49,1962,3
STAT,1837,46,45-49,1883,0.1692851593291213
STAT,1865,31,35-39,1896,9.37791553202032
SIM,1859,54,na,1913,1942
STAT,1834,32,50-100,1866,0.6989605229953706
SIM,1818,72,na,1890,528
STAT,1854,43,40-44,1897,1.675857188502809
STAT,1913,34,45-49,1947,1.566102996906867
STAT,1845,45,40-44,1890,0.12634057869086693
STAT,1863,18,30-34,1881,1.4723788295069173
SIM,1892,46,50-100,1938,1
STAT,1904,50,na,1954,3165.7763072077596
SIM,1903,63,na,1966,2551
SIM,1887,25,30-34,1912,5
SIM,1943,28,na,1971,3989
SIM,1928,26,40-44,1954,11
STAT,1879,25,30-34,1904,26.72178559701318
STAT,1924,20,45-49,1944,1.3496446428823665
STAT,1876,16,na,1892,2640.279212111106
SIM,1838,72,na,1910,956
STAT,1864,39,15-19,1903,0.05066345810217892
STAT,1811,51,20-24,1862,0.0017930622164694808
STAT,1911,44,35-39,1955,0.1915179093269772
STAT,1922,32,45-49,1954,1.7961368004207394
SIM,1878,37,na,1915,2709
STAT,1828,42,na,1870,1718.3336518906897
STAT,1882,20,30-34,1902,17.530580899578382
STAT,1873,37,15-19,1910,0.05749719316623689
SIM,1867,16,15-19,1883,9
SIM,1921,34,45-49,1955,3
STAT,1840,76,na,1916,664.1182675529161
STAT,1870,11,na,1881,2638.559348126835
STAT,1915,22,45-49,1937,1.1736085476363045
STAT,1875,50,35-39,1925,0.009057786923042238
SIM,1895,33,50-100,1928,4
SIM,1837,55,na,1892,1265
STAT,1833,21,50-100,1854,0.41033901819219704
SIM,1886,66,na,1952,1831
SIM,1932,34,20-24,1966,7
STAT,1899,64,na,1963,2600.682354125991
STAT,1929,42,40-44,1971,0.32739970125724277
STAT,1874,43,50-100,1917,1.0846790535763096
SIM,1907,18,20-24,1925,29
SIM,1949,18,25-29,1967,67
STAT,1901,40,45-49,1941,0.1486345239493576
STAT,1944,25,na,1969,4092.1127869676116
STAT,1822,32,40-44,1854,13.353209408247988
SIM,1850,11,na,1861,2278
STAT,1855,102,na,1957,0.3172616127771914
STAT,1821,36,40-44,1857,9.108269233227443
STAT,1845,50,50-100,1895,0.011193951173138896
STAT,1889,64,na,1953,2164.9414736045564
SIM,1912,41,40-44,1953,3
STAT,1929,34,50-100,1963,1.0601250903971657
SIM,1878,47,na,1925,2582
SIM,1838,62,na,1900,1369
SIM,1888,47,na,1935,2886
STAT,1807,104,na,1911,0.023627165249030867
STAT,1894,3,na,1897,3437.620655226237
STAT,1886,46,40-44,1932,0.18308482154870492
SIM,1830,32,40-44,1862,6
STAT,1811,46,25-29,1857,0.14585988943207745
STAT,1954,18,40-44,1972,1.7463886225811174
STAT,1925,36,50-100,1961,0.5097313079053524
STAT,1827,54,35-39,1881,0.007456451160479365
STAT,1870,36,35-39,1906,7.0486031609063104
STAT,1891,35,50-100,1926,1.5498461525509675
STAT,1765,95,na,1860,2.0179166487162066
STAT,1823,38,15-19,1861,0.09353410761190152
STAT,1923,43,15-19,1966,0.0018106825497057931
SIM,1837,26,30-34,1863,28
STAT,1882,53,45-49,1935,0.013970217873593102
SIM,1867,5,na,1872,2596
STAT,1810,56,na,1866,1302.7250144656084
SIM,1952,17,50-100,1969,1
SIM,1859,0,na,1859,3208
STAT,1865,7,na,1872,2584.924596589765
SIM,1941,27,na,1968,3978
SIM,1860,7,na,1867,2543
STAT,1765,108,na,1873,0.004126768867718429
SIM,1912,36,na,1948,3574
STAT,1862,41,25-29,1903,0.5626367331873918
SIM,1935,21,25-29,1956,5
SIM,1838,25,35-39,1863,7
SIM,1899,19,15-19,1918,11
SIM,1848,17,na,1865,2137
STAT,1842,46,50-100,1888,0.22401081711848578
STAT,1847,40,30-34,1887,0.888066297732886
STAT,1863,36,45-49,1899,1.7925371071545875
SIM,1896,66,na,1962,2290
SIM,1891,35,50-100,1926,1
STAT,1904,41,40-44,1945,0.22741536290462916
STAT,1780,109,na,1889,0.0028427946021366574
STAT,1894,45,35-39,1939,0.1037134131418157
STAT,1870,45,50-100,1915,0.24601161181684536
SIM,1829,26,na,1855,2007
SIM,1846,36,na,1882,1780
STAT,1864,17,35-39,1881,0.5173283688558744
STAT,1822,57,na,1879,1221.9053331824393
STAT,1868,17,na,1885,2482.0855761592893
STAT,1873,49,na,1922,2255.5353887143524
SIM,1895,39,na,1934,3155
STAT,1885,47,35-39,1932,0.140091110649019
SIM,1828,72,na,1900,680
STAT,1844,53,25-29,1897,0.002757389339060355
SIM,1916,16,20-24,1932,43
STAT,1899,39,50-100,1938,0.3636297818322062
SIM,1929,40,40-44,1969,2
STAT,1792,97,na,1889,0.9539412903196249
STAT,1870,40,20-24,1910,0.15909821936017157
SIM,1835,20,na,1855,1718
SIM,1840,21,na,1861,1901
SIM,1906,19,15-19,1925,9
SIM,1896,56,na,1952,2721
STAT,1881,68,na,1949,1487.8003429495627
STAT,1946,16,40-44,1962,1.5673252519177159
STAT,1878,44,40-44,1922,2.326431852174893
SIM,1849,18,20-24,1867,14
STAT,1852,52,20-24,1904,5.566529107619278E-4
STAT,1866,91,na,1957,69.10722530493028
SIM,1863,19,35-39,1882,1
STAT,1810,48,30-34,1858,0.3669153553715066
STAT,1839,41,35-39,1880,1.5060818536933755
STAT,1929,6,na,1935,5170.076972692511
SIM,1911,47,50-100,1958,2
STAT,1898,16,50-100,1914,0.0672448597948848
STAT,1934,8,na,1942,5450.985158734321
SIM,1847,41,35-39,1888,5
STAT,1840,86,na,1926,155.53246608069094
SIM,1954,16,40-44,1970,3
STAT,1830,34,40-44,1864,4.029440808879381
SIM,1886,44,40-44,1930,8
STAT,1808,104,na,1912,0.025146415421444645
STAT,1895,44,40-44,1939,0.2032337886688278
SIM,1848,72,na,1920,856
STAT,1828,53,40-44,1881,0.00826219726767503
STAT,1839,48,50-100,1887,0.17515114544069402
SIM,1868,37,na,1905,2159
STAT,1840,38,15-19,1878,0.046076633022645065
STAT,1913,33,na,1946,3780.5781612292726
STAT,1845,44,na,1889,1676.2212442571913
SIM,1906,30,45-49,1936,1
STAT,1858,18,20-24,1876,16.313102314541474
STAT,1826,61,na,1887,1066.7692552523408
SIM,1879,26,35-39,1905,11
STAT,1838,42,na,1880,1645.9664912239746
STAT,1890,29,15-19,1919,0.5559398929175406
STAT,1829,29,35-39,1858,9.641058629454346
SIM,1919,28,40-44,1947,6
STAT,1853,44,35-39,1897,1.4772870528894049
STAT,1838,17,40-44,1855,0.16172971636880437
STAT,1820,37,35-39,1857,17.33308834394605
STAT,1943,22,20-24,1965,119.453367076578
STAT,1880,40,50-100,1920,1.1318967604399115
STAT,1861,45,25-29,1906,0.04882448865930026
STAT,1859,16,15-19,1875,5.629148619802461
SIM,1926,26,na,1952,4347
STAT,1923,21,40-44,1944,3.9648255842529774
SIM,1888,37,na,1925,2895
STAT,1855,22,50-100,1877,0.3585965004979917
STAT,1869,35,15-19,1904,0.05566513368644412
STAT,1889,47,20-24,1936,0.008390771373824456
SIM,1836,91,na,1927,27
SIM,1850,41,na,1891,1929
SIM,1862,22,na,1884,2178
SIM,1837,29,35-39,1866,6
SIM,1855,5,na,1860,2623
SIM,1877,28,25-29,1905,70
STAT,1895,25,15-19,1920,0.6024768905725577
STAT,1937,18,40-44,1955,1.3701064307517654
STAT,1869,46,40-44,1915,0.16858859247100721
SIM,1924,6,na,1930,4848
SIM,1946,17,45-49,1963,1
STAT,1792,87,na,1879,55.85204338900938
STAT,1904,41,25-29,1945,0.0649259518328078
STAT,1818,42,na,1860,1525.3376440907593
SIM,1879,64,na,1943,2104
STAT,1922,8,na,1930,4663.065797210065
SIM,1910,11,na,1921,3760
STAT,1854,80,na,1934,464.2482038724738
SIM,1848,15,35-39,1863,1
STAT,1933,32,20-24,1965,3.321649682733671
STAT,1903,42,35-39,1945,0.1806529238017737
STAT,1863,37,50-100,1900,1.098694436062421
STAT,1914,31,40-44,1945,3.9906428874554303
STAT,1855,19,35-39,1874,0.4854819082880012
STAT,1900,6,na,1906,3665.1664288677694
SIM,1903,53,na,1956,2803
STAT,1914,45,15-19,1959,3.70337855160161E-4
STAT,1838,24,30-34,1862,15.248831072284567
STAT,1890,47,45-49,1937,0.16353004261564716
STAT,1938,17,45-49,1955,0.49746626117570986
STAT,1911,47,50-100,1958,0.2160258999013375
STAT,1869,34,na,1903,2323.1963530076846
STAT,1908,32,na,1940,3603.727224494379
SIM,1875,19,na,1894,2453
STAT,1811,47,35-39,1858,0.3487338260026649
STAT,1772,97,na,1869,0.6700523364123506
SIM,1821,34,40-44,1855,7
STAT,1908,16,20-24,1924,26.61241871500741
STAT,1930,34,45-49,1964,2.049888493938499
SIM,1903,28,50-100,1931,4
STAT,1892,20,na,1912,3015.297657452174
SIM,1846,24,30-34,1870,20
STAT,1828,34,15-19,1862,0.15523509714487618
STAT,1835,75,na,1910,772.6604868466019
SIM,1846,19,35-39,1865,1
STAT,1884,48,30-34,1932,0.09520089224893527
STAT,1848,46,20-24,1894,0.009825318673347383
STAT,1918,28,50-100,1946,1.0656472375406862
SIM,1894,20,15-19,1914,4
STAT,1905,14,na,1919,3758.5055620168987
STAT,1916,51,na,1967,3754.236726193019
SIM,1885,38,50-100,1923,4
STAT,1784,78,na,1862,255.32040476293042
SIM,1922,31,40-44,1953,13
STAT,1886,20,15-19,1906,3.539046856509329
STAT,1928,28,40-44,1956,5.801373324376419
SIM,1845,43,40-44,1888,12
SIM,1894,31,na,1925,3373
STAT,1877,53,na,1930,2208.4741602796103
STAT,1880,25,40-44,1905,3.1989827760738008
STAT,1889,34,na,1923,2946.453723410718
SIM,1848,92,na,1940,24
STAT,1910,48,35-39,1958,0.12102589879471203
SIM,1915,20,45-49,1935,1
STAT,1837,43,40-44,1880,1.7876542618742324
STAT,1838,19,35-39,1857,0.479490425398494
STAT,1927,23,na,1950,4533.503876891249
STAT,1860,47,30-34,1907,0.07954805665315547
SIM,1882,36,20-24,1918,4
STAT,1862,77,na,1939,753.940379910124
STAT,1869,23,50-100,1892,0.39919591531549586
SIM,1828,62,na,1890,1102
STAT,1832,22,50-100,1854,0.6242213813643624
STAT,1858,50,35-39,1908,0.006919733733063103
STAT,1904,19,40-44,1923,0.2636814383256405
STAT,1794,78,na,1872,318.1503143651938
SIM,1862,24,15-19,1886,4
STAT,1824,38,na,1862,1409.7841650873086
STAT,1870,35,25-29,1905,2.88267344927933
STAT,1907,45,50-100,1952,0.20753328159053672
SIM,1895,27,30-34,1922,5
STAT,1854,90,na,1944,59.168786178956005
SIM,1875,40,na,1915,2308
SIM,1917,29,50-100,1946,2
SIM,1811,44,25-29,1855,1
SIM,1828,36,30-34,1864,10
SIM,1856,47,50-100,1903,1
STAT,1824,30,35-39,1854,27.744131707436328
STAT,1883,49,na,1932,2177.2494249535152
STAT,1826,71,na,1897,732.4323040008948
SIM,1925,32,20-24,1957,4
STAT,1877,52,25-29,1929,0.0036726209445711432
STAT,1887,0,na,1887,3550.485334162308
STAT,1835,48,35-39,1883,0.10939084188672477
SIM,1873,44,50-100,1917,1
STAT,1801,65,na,1866,872.7542902674064
STAT,1823,46,15-19,1869,5.584586799715258E-4
STAT,1845,48,45-49,1893,0.17027516791141578
SIM,1832,77,na,1909,550
STAT,1860,76,na,1936,782.2016178623549
STAT,1909,33,25-29,1942,8.862668853745108
STAT,1903,33,na,1936,3447.0908411553783
STAT,1956,1,na,1957,5263.4828605675175
SIM,1915,45,50-100,1960,1
STAT,1775,95,na,1870,1.8097910891706288
SIM,1921,31,40-44,1952,8
STAT,1921,41,40-44,1962,0.2849423411420899
STAT,1874,36,20-24,1910,0.8010408822052396
STAT,1880,18,30-34,1898,1.686204589781232
STAT,1852,45,30-34,1897,0.07414423006436624
STAT,1910,30,45-49,1940,1.5430834200950816
STAT,1856,33,50-100,1889,0.710759075567114
STAT,1905,32,45-49,1937,1.4619987587668435
STAT,1912,43,25-29,1955,0.06906782878795077
SIM,1836,27,25-29,1863,54
STAT,1885,82,na,1967,789.7179277110483
SIM,1846,27,35-39,1873,9
SIM,1936,26,na,1962,3854
STAT,1843,54,20-24,1897,4.8401635756835235E-4
STAT,1923,35,15-19,1958,0.022520767666999165
STAT,1895,18,25-29,1913,7.454624851769605
STAT,1933,35,25-29,1968,1.3575538987273204
SIM,1940,22,45-49,1962,1
STAT,1856,16,na,1872,2114.191438497094
STAT,1824,105,na,1929,0.014576795576420939
STAT,1913,49,15-19,1962,3.606431650413539E-4
STAT,1911,43,25-29,1954,0.0683487059466331
SIM,1821,42,40-44,1863,4
SIM,1853,93,na,1946,16
SIM,1949,13,na,1962,4419
STAT,1860,11,na,1871,2283.523390550734
SIM,1832,30,35-39,1862,12
STAT,1916,18,20-24,1934,28.951989357733776
STAT,1817,51,50-100,1868,0.031725480791646735
STAT,1932,33,15-19,1965,0.17252854851316357
STAT,1880,33,40-44,1913,4.5805887111271115
STAT,1845,85,na,1930,200.30620240365303
STAT,1870,33,30-34,1903,17.243267464607467
STAT,1939,24,na,1963,3699.8821294788454
STAT,1880,52,50-100,1932,0.015934364140169598
STAT,1838,27,35-39,1865,8.216466896371331
STAT,1813,42,40-44,1855,8.176674809184656
STAT,1828,27,25-29,1855,81.94295657369705
SIM,1880,23,40-44,1903,2
SIM,1931,27,na,1958,4805
SIM,1933,28,na,1961,4717
STAT,1869,54,40-44,1923,0.010053434461789646
STAT,1859,54,30-34,1913,0.0047024955465527
STAT,1931,22,45-49,1953,1.474864708290914
STAT,1822,35,45-49,1857,4.018786584494066
STAT,1811,43,20-24,1854,0.4398270536993256
STAT,1852,48,35-39,1900,0.10484078175712988
STAT,1903,45,40-44,1948,0.14029395352901938
STAT,1913,31,40-44,1944,3.9444331722710424
SIM,1949,15,20-24,1964,232
SIM,1882,0,na,1882,3315
STAT,1788,82,na,1870,153.94996174064954
STAT,1850,20,35-39,1870,5.44094892975056
STAT,1900,46,na,1946,3166.1022917572095
STAT,1873,30,30-34,1903,18.020870970967565
STAT,1876,16,15-19,1892,6.204004201592123
STAT,1846,61,na,1907,1418.0792875476934
STAT,1893,46,30-34,1939,0.07022430270532978
SIM,1921,27,na,1948,4261
SIM,1891,67,na,1958,1921
STAT,1886,36,na,1922,2524.489867038986
SIM,1876,66,na,1942,1781
SIM,1813,63,na,1876,956
STAT,1863,33,40-44,1896,3.8645058920171933
STAT,1778,82,na,1860,172.59345447576504
SIM,1941,22,50-100,1963,4
STAT,1891,21,35-39,1912,7.319171263756247
SIM,1923,37,30-34,1960,3
STAT,1843,47,30-34,1890,0.06498410393452883
STAT,1909,58,na,1967,3231.5306158360468
SIM,1928,29,45-49,1957,2
STAT,1813,53,50-100,1866,0.040930263015331154
STAT,1830,41,15-19,1871,0.01216955926939146
SIM,1883,38,na,1921,2613
STAT,1854,24,15-19,1878,2.8674398077908254
SIM,1823,73,na,1896,750
STAT,1875,10,na,1885,2735.354735972632
STAT,1917,32,20-24,1949,2.5781692697495058
SIM,1959,0,na,1959,5516
STAT,1906,43,15-19,1949,0.0014005720422521563
STAT,1894,65,na,1959,2299.305599316756
STAT,1940,21,40-44,1961,3.4590801285479924
SIM,1888,42,35-39,1930,5
STAT,1836,51,25-29,1887,0.002306079976900743
STAT,1846,18,30-34,1864,1.510506354750985
SIM,1854,18,30-34,1872,4
STAT,1833,43,na,1876,1779.1864681912537
STAT,1876,49,35-39,1925,0.142949685023134
STAT,1906,32,45-49,1938,1.4730199773836552
SIM,1887,17,30-34,1904,1
STAT,1886,49,45-49,1935,0.2464140964947542
STAT,1915,44,20-24,1959,0.017881272432878258
SIM,1937,16,40-44,1953,2
STAT,1888,44,50-100,1932,1.2424089842007353
SIM,1869,44,40-44,1913,6
STAT,1863,40,15-19,1903,0.012482974658960016
STAT,1887,27,30-34,1914,28.39626719829448
SIM,1910,55,na,1965,3083
SIM,1914,32,45-49,1946,3
SIM,1881,30,30-34,1911,31
STAT,1833,35,20-24,1868,0.6987159334383574
STAT,1911,36,35-39,1947,2.3682831430131492
STAT,1854,28,30-34,1882,19.6697250110853
SIM,1908,17,25-29,1925,13
SIM,1807,79,na,1886,303
SIM,1931,39,30-34,1970,3
STAT,1853,94,na,1947,16.52801722397837
SIM,1837,45,na,1882,1462
STAT,1878,47,45-49,1925,0.2462817700340328
STAT,1854,17,25-29,1871,5.087367683401924
STAT,1871,42,15-19,1913,0.013840056957564642
STAT,1902,21,20-24,1923,98.65299539991898
STAT,1946,19,45-49,1965,0.5592272791705535
SIM,1838,17,na,1855,2086
SIM,1843,93,na,1936,63
STAT,1841,52,45-49,1893,0.010794820348200807
STAT,1904,15,25-29,1919,8.25162371616376
SIM,1828,29,40-44,1857,3
SIM,1895,19,30-34,1914,3
SIM,1873,31,35-39,1904,12
STAT,1785,95,na,1880,2.5655030597716926
STAT,1841,26,15-19,1867,0.42445636952051147
STAT,1864,47,15-19,1911,3.628549910732621E-4
STAT,1915,37,30-34,1952,1.8578383988221374
STAT,1846,26,30-34,1872,23.28576493551359
SIM,1908,62,na,1970,2914
SIM,1916,19,25-29,1935,54
SIM,1862,28,30-34,1890,38
STAT,1872,77,na,1949,877.7218396535541
STAT,1901,21,20-24,1922,97.86484032297422
SIM,1845,19,na,1864,2305
STAT,1900,48,40-44,1948,0.1337878306178523
STAT,1888,41,30-34,1929,1.3767342675802259
STAT,1860,54,20-24,1914,5.924919834501743E-4
SIM,1862,43,40-44,1905,6
STAT,1828,52,na,1880,1497.762132214967
STAT,1901,47,30-34,1948,0.07695000876135459
STAT,1885,44,30-34,1929,1.1402036504804833
SIM,1828,28,30-34,1856,28
SIM,1870,41,na,1911,2586
SIM,1909,31,25-29,1940,17
SIM,1939,13,na,1952,4077
SIM,1912,15,25-29,1927,11
STAT,1818,53,30-34,1871,0.009979717251076225
STAT,1836,71,na,1907,841.6238053034009
STAT,1919,48,na,1967,4012.1091885717733
STAT,1923,39,30-34,1962,2.129186754816834
STAT,1921,33,40-44,1954,4.379825464491161
SIM,1845,10,na,1855,2431
STAT,1888,17,na,1905,3010.804571497613
STAT,1882,45,45-49,1927,0.23319190020627195
SIM,1855,74,na,1929,907
SIM,1815,44,na,1859,1489
SIM,1870,34,35-39,1904,15
SIM,1870,19,25-29,1889,8
SIM,1846,16,30-34,1862,2
SIM,1939,29,20-24,1968,19
STAT,1850,76,na,1926,725.4400672965414
SIM,1776,79,na,1855,192
SIM,1910,21,20-24,1931,160
SIM,1822,46,na,1868,1520
STAT,1862,19,25-29,1881,5.090827508176013
STAT,1854,35,na,1889,1795.183556258234
STAT,1803,52,25-29,1855,0.015361296179308167
STAT,1877,45,35-39,1922,0.14739421668401398
STAT,1910,36,50-100,1946,0.40707464594518145
SIM,1924,18,20-24,1942,202
SIM,1822,77,na,1899,407
STAT,1898,30,35-39,1928,13.977524997963712
SIM,1870,33,25-29,1903,16
STAT,1823,105,na,1928,0.01621619153701993
STAT,1830,37,45-49,1867,1.8123355947642654
SIM,1893,14,na,1907,3388
STAT,1887,19,30-34,1906,1.7876817593375318
STAT,1922,33,40-44,1955,4.447967879629021
SIM,1858,18,15-19,1876,5
STAT,1861,38,35-39,1899,5.906718994748562
STAT,1939,31,45-49,1970,1.6217926913670804
STAT,1866,16,na,1882,2438.7955467510483
STAT,1870,43,25-29,1913,0.6322830893058826
SIM,1854,26,30-34,1880,34
STAT,1770,96,na,1866,0.7838048278189236
STAT,1879,18,40-44,1897,0.19227470801316476
STAT,1906,31,na,1937,3554.8400055908955
STAT,1844,80,na,1924,489.42361072829124
STAT,1908,19,25-29,1927,8.440017781771592
STAT,1895,29,30-34,1924,32.9766167577347
SIM,1887,28,35-39,1915,12
STAT,1917,17,50-100,1934,0.08137983848445957
SIM,1836,38,30-34,1874,6
STAT,1838,16,30-34,1854,1.4177092079794051
STAT,1923,46,20-24,1969,0.013094678058640528
SIM,1913,53,na,1966,3493
STAT,1859,16,50-100,1875,0.046470672653092265
STAT,1953,16,50-100,1969,0.45803205530801283
SIM,1872,22,na,1894,2537
STAT,1867,53,na,1920,2015.2552244485407
STAT,1872,16,30-34,1888,1.633392689900987
SIM,1842,56,na,1898,1424
STAT,1941,27,30-34,1968,40.922027696156874
STAT,1811,44,30-34,1855,3.0234962919834434
SIM,1852,43,30-34,1895,1
STAT,1815,54,45-49,1869,0.029552963361264187
STAT,1913,42,45-49,1955,0.16375482179760603
STAT,1882,3,na,1885,2926.1273656793064
SIM,1844,29,25-29,1873,60
STAT,1853,63,na,1916,1475.5777366021605
STAT,1932,22,45-49,1954,1.4919426151752557
SIM,1884,1,na,1885,3250
STAT,1828,38,30-34,1866,5.368117344653021
STAT,1821,40,25-29,1861,1.0848820418856047
STAT,1951,4,na,1955,4731.4157999638055
STAT,1935,20,20-24,1955,153.08979867981168
SIM,1880,16,30-34,1896,3
STAT,1873,32,50-100,1905,0.9381525896890074
SIM,1839,98,na,1937,1
STAT,1879,34,na,1913,2493.6375318791593
STAT,1906,51,na,1957,3218.822006743792
STAT,1879,28,35-39,1907,10.134170579283618
SIM,1913,32,45-49,1945,2
STAT,1924,37,50-100,1961,0.5002865981676142
STAT,1917,40,50-100,1957,0.12409500206985444
STAT,1833,33,50-100,1866,0.8290188161976542
STAT,1836,29,25-29,1865,34.036145941191705
STAT,1856,15,35-39,1871,0.5083767537198095
SIM,1858,92,na,1950,10
STAT,1907,45,25-29,1952,0.04867230022510075
SIM,1943,20,20-24,1963,5
STAT,1894,48,40-44,1942,0.12399691006007683
STAT,1890,37,15-19,1927,0.06930376048874724
STAT,1949,17,20-24,1966,159.29667903973433
STAT,1931,37,15-19,1968,0.025703157410532824
STAT,1913,19,50-100,1932,0.07687373197011266
STAT,1821,33,35-39,1854,34.89685391884857
STAT,1882,27,15-19,1909,0.4438787758047781
STAT,1782,97,na,1879,0.9752212924104005
STAT,1918,32,na,1950,4057.4228543883232
STAT,1871,38,45-49,1909,1.9903912682876421
STAT,1878,17,na,1895,2647.9837998637036
SIM,1869,64,na,1933,1611
SIM,1885,40,na,1925,2503
STAT,1846,19,40-44,1865,0.1723158479554026
STAT,1864,90,na,1954,71.85428167439085
STAT,1844,50,20-24,1894,5.922200433563832E-4
STAT,1855,75,na,1930,774.8975629221951
STAT,1902,36,50-100,1938,0.38004072649357107
SIM,1828,39,35-39,1867,5
STAT,1911,40,20-24,1951,0.01719824173001194
STAT,1913,42,50-100,1955,0.11559163858471452
STAT,1804,83,na,1887,129.76909691953446
SIM,1911,20,25-29,1931,112
STAT,1810,44,15-19,1854,0.05584180122848909
STAT,1830,30,25-29,1860,10.151138763088923
SIM,1927,26,25-29,1953,88
STAT,1847,56,na,1903,1527.1495114123013
STAT,1912,46,45-49,1958,0.21125457826368915
STAT,1829,68,na,1897,901.0832119121003
STAT,1870,32,20-24,1902,2.680861880437761
SIM,1886,18,25-29,1904,10
STAT,1818,50,50-100,1868,0.026881120892374447
SIM,1801,85,na,1886,18
SIM,1844,58,na,1902,1337
SIM,1850,75,na,1925,710
STAT,1922,40,30-34,1962,0.14865387152390425
STAT,1844,31,15-19,1875,0.13614168035727126
SIM,1824,68,na,1892,836
STAT,1813,45,45-49,1858,0.7126008455382632
STAT,1853,47,40-44,1900,0.1409183362782884
STAT,1915,33,15-19,1948,0.13150454386906016
STAT,1859,88,na,1947,111.52034436142834
STAT,1852,102,na,1954,0.22234155075339196
STAT,1857,51,45-49,1908,0.011494060918400266
STAT,1837,24,15-19,1861,2.90411170828932
STAT,1827,46,35-39,1873,0.14551418801647292
SIM,1887,33,50-100,1920,1
STAT,1847,22,50-100,1869,0.37430208719006997
STAT,1903,20,25-29,1923,82.8341512426802
STAT,1869,28,25-29,1897,41.39202474355839
SIM,1920,32,35-39,1952,20
STAT,1827,56,na,1883,1284.4620546971541
STAT,1836,19,na,1855,1912.9830618598603
STAT,1878,48,na,1926,2329.217185428944
STAT,1884,46,50-100,1930,0.24531088356578948
STAT,1923,32,45-49,1955,1.8226908710694378
SIM,1900,34,25-29,1934,17
STAT,1880,52,na,1932,2271.7292671128444
STAT,1891,36,20-24,1927,0.9685691682366744
STAT,1834,90,na,1924,46.92815333079294
STAT,1844,43,30-34,1887,0.9197224552068856
STAT,1903,34,35-39,1937,8.292705994245694
STAT,1835,45,30-34,1880,0.08637316266596506
STAT,1950,5,na,1955,4696.962219426784
STAT,1897,42,35-39,1939,0.170058694479876
STAT,1824,45,20-24,1869,0.01443417715511066
STAT,1908,42,20-24,1950,0.01649376955175137
SIM,1824,58,na,1882,1249
STAT,1823,53,40-44,1876,0.013672427730890583
SIM,1937,34,50-100,1971,4
STAT,1912,32,35-39,1944,9.072093225135456
STAT,1921,44,45-49,1965,0.1886941455482075
SIM,1930,33,40-44,1963,6
STAT,1834,28,na,1862,1676.2654812486617
SIM,1845,24,15-19,1869,4
STAT,1885,50,45-49,1935,0.014799539987848383
STAT,1900,40,45-49,1940,0.14728594079068638
STAT,1931,31,40-44,1962,5.185358116358247
SIM,1911,34,35-39,1945,11
STAT,1890,44,40-44,1934,2.738497776623687
SIM,1863,38,na,1901,2121
STAT,1886,42,25-29,1928,0.6839486746318711
STAT,1855,85,na,1940,206.3466995729152
STAT,1823,43,na,1866,1505.2631396971296
STAT,1853,43,25-29,1896,0.5272126180341685
STAT,1935,31,25-29,1966,12.926755683223503
STAT,1835,52,20-24,1887,5.646491735733269E-4
SIM,1950,21,na,1971,4095
STAT,1890,30,30-34,1920,21.721305976792163
SIM,1855,20,na,1875,2208
STAT,1891,37,na,1928,2946.0980674642237
SIM,1871,57,na,1928,1864
STAT,1883,35,50-100,1918,1.224990184466962
STAT,1880,40,15-19,1920,0.014796037165380433
STAT,1836,44,35-39,1880,1.3245794994528357
STAT,1887,33,50-100,1920,1.0288404784586973
SIM,1873,38,na,1911,2236
STAT,1783,83,na,1866,136.64984567233452
SIM,1868,16,15-19,1884,6
SIM,1816,39,na,1855,1426
STAT,1800,80,na,1880,229.45434779365448
STAT,1813,43,na,1856,1395.6560767709273
STAT,1846,16,na,1862,2201.2395504525166
STAT,1862,45,40-44,1907,0.15081281310740166
STAT,1876,46,30-34,1922,0.10123380475679099
SIM,1894,17,20-24,1911,35
STAT,1884,55,na,1939,2059.43237862786
STAT,1903,41,25-29,1944,0.06443296433784586
SIM,1881,67,na,1948,1458
STAT,1934,32,20-24,1966,3.365013524672369
STAT,1880,36,45-49,1916,2.124689537741355
STAT,1831,48,15-19,1879,2.949704612468912E-4
STAT,1812,46,40-44,1858,0.4012766459798024
SIM,1844,44,35-39,1888,3
SIM,1823,44,50-100,1867,1
SIM,1859,23,na,1882,2220
SIM,1859,33,na,1892,2205
STAT,1821,62,na,1883,1141.2096253913317
SIM,1861,36,35-39,1897,10
SIM,1873,48,na,1921,2142
SIM,1871,67,na,1938,1411
STAT,1874,43,45-49,1917,1.5366286636365125
SIM,1882,43,45-49,1925,2
STAT,1893,1,na,1894,3490.634472928773
STAT,1853,36,35-39,1889,5.910192346986216
STAT,1841,21,50-100,1862,0.3891067426904928
STAT,1868,51,20-24,1919,7.157149657422535E-4
STAT,1885,32,15-19,1917,0.1431678068756532
STAT,1929,16,40-44,1945,1.8086586124741395
STAT,1841,30,35-39,1871,9.381329593658071
STAT,1891,40,40-44,1931,2.841051242356699
STAT,1906,47,30-34,1953,0.07995255915836472
STAT,1808,76,na,1884,392.3871478776066
SIM,1902,67,na,1969,2651
STAT,1883,18,na,1901,2489.6965602268706
STAT,1919,26,25-29,1945,72.052887353338
SIM,1771,91,na,1862,5
SIM,1869,23,na,1892,2266
SIM,1906,34,50-100,1940,1
STAT,1818,41,15-19,1859,0.02804109036222887
STAT,1864,40,30-34,1904,1.058365491504857
SIM,1887,52,na,1939,2292
SIM,1917,12,na,1929,4188
STAT,1868,47,35-39,1915,0.13451068939388158
SIM,1850,40,45-49,1890,1
STAT,1852,23,na,1875,1912.4814053332607
STAT,1871,92,na,1963,101.29157093474987
STAT,1837,17,25-29,1854,7.650532383652049
STAT,1827,53,25-29,1880,0.0034387316712685043
STAT,1901,52,na,1953,3032.4324499910813
STAT,1871,54,30-34,1925,0.005808680565806288
STAT,1919,19,35-39,1938,4.656850527144163
SIM,1909,1,na,1910,4358
STAT,1864,54,40-44,1918,0.009330915033134653
SIM,1833,73,na,1906,735
STAT,1900,33,20-24,1933,3.776417548655605
SIM,1966,3,na,1969,5082
STAT,1795,61,na,1856,1072.0162690099996
STAT,1850,35,20-24,1885,0.6121788639004391
STAT,1856,41,35-39,1897,1.4085414840167003
SIM,1805,54,na,1859,1063
STAT,1873,18,na,1891,2579.2169856110945
SIM,1889,7,na,1896,3242
STAT,1821,72,na,1893,756.463854979021
STAT,1834,38,na,1872,1569.347530667726
STAT,1868,18,15-19,1886,5.797936041215838
SIM,1836,60,na,1896,1366
STAT,1838,53,35-39,1891,0.0056705988982946095
SIM,1927,19,35-39,1946,10
STAT,1926,40,15-19,1966,0.0019186816211454244
SIM,1796,76,na,1872,398
SIM,1923,7,na,1930,4785
STAT,1873,52,40-44,1925,0.01072197699245978
SIM,1872,40,30-34,1912,1
SIM,1932,1,na,1933,6128
STAT,1842,40,45-49,1882,1.4302948172150969
STAT,1911,33,30-34,1944,15.412708531000007
STAT,1877,30,15-19,1907,0.1496423348128181
STAT,1845,41,25-29,1886,0.48397147240659844
STAT,1945,16,25-29,1961,47.820301244112486
STAT,1856,52,40-44,1908,0.008108648472802973
STAT,1886,17,20-24,1903,18.90558178680467
SIM,1953,16,25-29,1969,87
SIM,1829,45,50-100,1874,1
SIM,1859,18,15-19,1877,8
STAT,1822,54,35-39,1876,0.011815315442103588
STAT,1872,19,35-39,1891,0.554182732221465
SIM,1889,40,50-100,1929,1
STAT,1874,89,na,1963,227.75633897801598
SIM,1911,7,na,1918,4160
SIM,1878,34,50-100,1912,1
STAT,1921,41,25-29,1962,0.08134961719308821
STAT,1870,52,na,1922,2124.1181102708315
STAT,1837,56,na,1893,1391.3966724644833
STAT,1892,46,15-19,1938,2.8677462395918516E-4
SIM,1882,43,50-100,1925,1
STAT,1928,7,na,1935,5090.94925479614
STAT,1815,51,40-44,1866,0.022767239785917114
STAT,1915,30,45-49,1945,1.6301333513446103
STAT,1845,16,20-24,1861,16.469719783195476
STAT,1883,41,45-49,1924,1.485929443194337
STAT,1920,45,40-44,1965,0.17682436872529214
STAT,1941,23,15-19,1964,5.5520321685752
STAT,1847,51,35-39,1898,0.0064767626759258375
STAT,1859,42,15-19,1901,0.011204404420188573
STAT,1910,41,15-19,1951,0.0014727144077583288
SIM,1925,41,na,1966,4531
STAT,1894,37,35-39,1931,9.197169937067873
SIM,1871,36,45-49,1907,4
STAT,1832,51,40-44,1883,0.007628315231522462
STAT,1878,25,15-19,1903,0.4789138070692608
STAT,1920,31,30-34,1951,17.498234658237017
STAT,1821,44,40-44,1865,3.386467511627695
SIM,1821,92,na,1913,27
SIM,1837,86,na,1923,166
SIM,1854,29,35-39,1883,13
STAT,1825,47,50-100,1872,0.3297791978240806
STAT,1811,54,25-29,1865,0.008104824853028684
STAT,1861,37,na,1898,1977.3247946282092
STAT,1900,26,30-34,1926,35.45173113744238
SIM,1786,79,na,1865,215
SIM,1926,28,50-100,1954,1
STAT,1920,12,na,1932,4489.153873852548
STAT,1870,42,na,1912,2289.438272151804
STAT,1848,53,45-49,1901,0.0116585381212796
SIM,1868,92,na,1960,33
STAT,1816,95,na,1911,6.797650274882511
SIM,1918,52,na,1970,4078
STAT,1905,41,40-44,1946,0.22909072060345567
SIM,1923,30,45-49,1953,2
STAT,1936,23,40-44,1959,3.244266734965572
SIM,1811,95,na,1906,5
SIM,1847,48,50-100,1895,2
SIM,1945,9,na,1954,4216
SIM,1810,47,50-100,1857,3
STAT,1861,35,30-34,1896,4.515489372180097
STAT,1846,29,35-39,1875,8.73157635288969
STAT,1882,42,40-44,1924,2.1978642783117373
SIM,1869,15,20-24,1884,18
STAT,1842,57,na,1899,1809.3406016301155
STAT,1926,33,25-29,1959,11.288127569472122
STAT,1816,50,45-49,1866,0.0375090447687215
SIM,1903,32,35-39,1935,13
SIM,1879,33,na,1912,2763
SIM,1934,33,25-29,1967,22
SIM,1837,76,na,1913,551
SIM,1853,16,20-24,1869,26
STAT,1839,68,na,1907,1083.4506016599537
STAT,1851,45,15-19,1896,3.058943949188771E-4
STAT,1846,52,30-34,1898,0.004493251920749845
STAT,1854,46,45-49,1900,0.1776176907484773
STAT,1894,44,25-29,1938,0.05720277236259295
STAT,1888,15,30-34,1903,1.9088983882676647
SIM,1928,18,40-44,1946,6
STAT,1832,47,20-24,1879,0.00968939062587598
STAT,1862,34,35-39,1896,8.757407685452115
STAT,1924,42,20-24,1966,0.021227158100134827
SIM,1890,42,40-44,1932,5
STAT,1862,26,50-100,1888,0.564059511544417
STAT,1894,30,15-19,1924,0.18666621986588094
STAT,1870,47,40-44,1917,0.16900255789421734
STAT,1916,44,20-24,1960,0.018203074477180534
SIM,1855,19,na,1874,2354
SIM,1928,35,50-100,1963,3
STAT,1922,47,15-19,1969,4.2751754122812984E-4
STAT,1858,17,50-100,1875,0.0453475105287476
STAT,1944,21,25-29,1965,100.74320222249956
STAT,1845,34,35-39,1879,8.617448826364464
STAT,1926,30,20-24,1956,2.984195246757739
STAT,1913,43,40-44,1956,0.24571557592929802
SIM,1826,91,na,1917,67
STAT,1936,30,30-34,1966,15.467094213636406
STAT,1889,40,35-39,1929,2.277932516918084
STAT,1927,5,na,1932,5053.066973688363
SIM,1781,91,na,1872,1
STAT,1846,71,na,1917,1012.9600080729933
STAT,1881,39,15-19,1920,0.054119910940836104
SIM,1918,33,40-44,1951,9
SIM,1798,57,na,1855,1049
STAT,1878,40,25-29,1918,0.6800661700714722
SIM,1886,40,25-29,1926,4
STAT,1912,43,40-44,1955,0.24192306628471555
STAT,1902,43,30-34,1945,0.11312264546307663
SIM,1920,43,40-44,1963,1
SIM,1862,12,na,1874,2440
STAT,1831,41,30-34,1872,0.900499916459842
STAT,1931,34,45-49,1965,2.0811699124436727
SIM,1911,31,30-34,1942,24
STAT,1868,54,25-29,1922,0.0033250504671286972
STAT,1941,20,45-49,1961,1.1747424210574007
STAT,1840,53,40-44,1893,0.007261262509485587
STAT,1873,48,20-24,1921,0.012132529782955408
STAT,1832,57,na,1889,1373.5288545179371
STAT,1882,23,na,1905,2306.6897845033427
STAT,1877,63,na,1940,1860.0003552444055
STAT,1893,69,na,1962,2069.5906186541424
STAT,1809,104,na,1913,0.030798668708655916
SIM,1845,20,na,1865,2120
STAT,1871,35,40-44,1906,4.434208325997485
STAT,1905,45,na,1950,3318.351612369279
SIM,1861,33,30-34,1894,4
SIM,1847,86,na,1933,132
SIM,1853,34,35-39,1887,8
STAT,1844,46,35-39,1890,0.11108027269513703
STAT,1847,47,15-19,1894,2.980983001504194E-4
STAT,1899,10,na,1909,3590.585203765811
SIM,1962,8,na,1970,5266
STAT,1851,49,30-34,1900,0.07176541854915144
STAT,1860,1,na,1861,3022.8074561099634
STAT,1853,40,20-24,1893,0.13265986418446207
STAT,1865,53,45-49,1918,0.013169263899930905
STAT,1852,57,na,1909,1524.0879661825259
STAT,1862,23,na,1885,2096.547737941169
STAT,1911,52,na,1963,3449.8239656277315
SIM,1907,12,na,1919,4080
SIM,1900,35,na,1935,3492
SIM,1874,41,45-49,1915,2
SIM,1812,44,40-44,1856,1
SIM,1864,41,35-39,1905,2
SIM,1826,39,50-100,1865,2
SIM,1832,46,na,1878,1480
STAT,1918,31,25-29,1949,9.956103796080779
SIM,1819,57,na,1876,1191
SIM,1817,51,50-100,1868,1
STAT,1952,20,20-24,1972,135.1689513199134
STAT,1862,48,45-49,1910,0.20325755462850462
STAT,1867,22,na,1889,2258.953843436513
STAT,1911,22,25-29,1933,88.38068075039628
SIM,1820,42,25-29,1862,3
SIM,1842,87,na,1929,82
STAT,1903,31,30-34,1934,25.216921919230984
SIM,1826,39,na,1865,1966
SIM,1868,27,20-24,1895,17
STAT,1818,39,50-100,1857,2.686507979305713
STAT,1809,51,50-100,1860,0.04953446086359025
STAT,1764,108,na,1872,0.002637508490341863
SIM,1936,16,25-29,1952,76
STAT,1854,102,na,1956,0.2648226347284661
STAT,1934,25,na,1959,5096.4774155816585
STAT,1832,105,na,1937,0.019965154027456796
SIM,1876,18,15-19,1894,6
STAT,1877,22,na,1899,2465.3818170725654
STAT,1840,41,50-100,1881,0.7824726450443031
STAT,1864,89,na,1953,95.74443246241187
STAT,1861,42,20-24,1903,0.13312451988146973
STAT,1853,33,30-34,1886,14.715353085889019
STAT,1904,44,45-49,1948,0.14860442793569908
SIM,1815,54,na,1869,1244
STAT,1811,62,na,1873,963.8148789363798
SIM,1888,16,35-39,1904,4
STAT,1906,34,50-100,1940,0.7673333108458674
STAT,1886,35,35-39,1921,7.6141461114913955
STAT,1812,42,25-29,1854,2.1129535923154372
SIM,1901,31,20-24,1932,4
SIM,1820,35,35-39,1855,8
SIM,1948,19,20-24,1967,238
STAT,1814,48,15-19,1862,9.487115122879978E-4
STAT,1786,105,na,1891,0.0156675115387163
STAT,1899,15,40-44,1914,0.2547093580805321
STAT,1896,36,na,1932,3164.9157743276814
STAT,1894,55,na,1949,2688.721079513737
STAT,1904,59,na,1963,2986.8405055988947
STAT,1879,88,na,1967,353.4010205184133
STAT,1880,51,20-24,1931,7.864638509851828E-4
SIM,1957,9,na,1966,5433
SIM,1866,3,na,1869,2908
STAT,1819,44,35-39,1863,3.6406469007665416
SIM,1813,73,na,1886,491
SIM,1864,78,na,1942,936
SIM,1775,84,na,1859,80
SIM,1894,35,35-39,1929,19
STAT,1814,83,na,1897,185.81383333513034
SIM,1921,43,40-44,1964,3
STAT,1881,37,na,1918,2293.6979893422467
SIM,1800,55,na,1855,1090
SIM,1884,85,na,1969,426
STAT,1878,6,na,1884,2829.5986632024096
SIM,1873,6,na,1879,2650
STAT,1922,37,na,1959,4324.697991507355
STAT,1838,50,30-34,1888,0.0041237279562506175
STAT,1867,18,15-19,1885,5.736969049376486
STAT,1824,52,45-49,1876,0.016369821323670743
STAT,1899,54,na,1953,2902.6219333445492
STAT,1874,40,40-44,1914,2.349649635978915
STAT,1888,48,15-19,1936,2.656001387444529E-4
SIM,1845,28,30-34,1873,38
STAT,1829,26,30-34,1855,41.75290561607399
STAT,1892,46,50-100,1938,0.17607976702511333
SIM,1932,33,na,1965,5758
STAT,1847,17,35-39,1864,0.5127673536720982
SIM,1823,40,35-39,1863,4
STAT,1881,54,40-44,1935,0.009967505367898255
STAT,1875,41,na,1916,2408.1053213208643
STAT,1869,88,na,1957,167.0880589896563
STAT,1872,52,50-100,1924,0.015254007766259809
STAT,1929,19,45-49,1948,0.6409111645749809
SIM,1859,18,30-34,1877,2
STAT,1868,44,30-34,1912,1.0947845181968667
STAT,1845,75,na,1920,752.2135726040186
STAT,1853,102,na,1955,0.24244883542815993
SIM,1890,31,35-39,1921,20
STAT,1854,54,30-34,1908,0.004344460374958677
SIM,1853,19,25-29,1872,8
STAT,1927,43,35-39,1970,0.2548536552664094
SIM,1827,44,35-39,1871,2
SIM,1944,14,na,1958,4296
STAT,1882,31,35-39,1913,9.948279887015099
STAT,1891,43,45-49,1934,1.8579964889304044
STAT,1827,50,20-24,1877,7.603225314334149E-4
STAT,1878,18,25-29,1896,5.925742254846117
STAT,1894,41,20-24,1935,0.2074446118734217
STAT,1932,37,30-34,1969,2.4747162001416587
STAT,1844,90,na,1934,62.37741090339168
STAT,1820,34,30-34,1854,55.24928117657493
STAT,1857,56,na,1913,1607.7299480390188
SIM,1876,44,30-34,1920,2
SIM,1937,19,45-49,1956,1
SIM,1882,40,40-44,1922,4
SIM,1926,31,25-29,1957,5
STAT,1895,51,na,1946,2853.615605970061
STAT,1835,41,15-19,1876,0.012584368106681579
STAT,1901,33,20-24,1934,3.8109952760265084
STAT,1839,15,35-39,1854,0.5149426937685943
SIM,1814,58,na,1872,1108
SIM,1840,65,na,1905,1139
SIM,1863,93,na,1956,36
STAT,1876,53,20-24,1929,7.571783295497389E-4
STAT,1837,28,30-34,1865,21.89151951115777
STAT,1864,33,50-100,1897,0.8315305164191921
STAT,1893,49,35-39,1942,0.09916195461400656
STAT,1832,54,45-49,1886,0.009909065353234152
STAT,1896,17,30-34,1913,2.130877853138217
STAT,1806,95,na,1901,4.4827488180996085
SIM,1827,29,25-29,1856,33
STAT,1931,41,35-39,1972,0.2722671785323895
SIM,1883,2,na,1885,3460
STAT,1819,51,25-29,1870,0.006765318280093529
STAT,1844,16,50-100,1860,0.049564576710252696
SIM,1861,50,50-100,1911,1
SIM,1864,34,na,1898,2520
STAT,1871,31,25-29,1902,10.319678230588577
SIM,1832,87,na,1919,157
STAT,1830,76,na,1906,625.0399162683076
STAT,1805,51,30-34,1856,0.024970782241704844
STAT,1883,70,na,1953,1386.758323864245
STAT,1920,41,25-29,1961,0.07975753868400608
STAT,1832,36,15-19,1868,0.048975099343156636
STAT,1853,15,50-100,1868,0.049316304295604824
STAT,1855,49,15-19,1904,2.9480159454053386E-4
STAT,1910,45,30-34,1955,0.08430899241123038
SIM,1905,34,na,1939,3576
STAT,1876,27,50-100,1903,0.6670986927277837
SIM,1908,52,na,1960,3137
STAT,1860,42,na,1902,1905.8715947625626
SIM,1819,38,30-34,1857,10
STAT,1865,46,20-24,1911,0.01109849392472794
STAT,1930,31,40-44,1961,5.107418609176663
SIM,1898,28,50-100,1926,1
STAT,1914,49,30-34,1963,0.08867915176827902
STAT,1845,19,25-29,1864,5.171888793692448
STAT,1872,29,50-100,1901,0.644914506791384
SIM,1862,53,na,1915,1942
SIM,1903,22,40-44,1925,3
SIM,1934,30,20-24,1964,4
STAT,1888,18,35-39,1906,0.6524087783122193
STAT,1924,45,25-29,1969,0.06411533106225224
SIM,1884,27,50-100,1911,1
STAT,1867,16,50-100,1883,0.04792364757655902
STAT,1881,51,50-100,1932,0.01477386595480387
STAT,1815,40,35-39,1855,5.031086610259333
STAT,1894,34,30-34,1928,22.509109836546244
STAT,1821,47,45-49,1868,0.3458993779952098
SIM,1875,18,15-19,1893,6
STAT,1876,50,50-100,1926,0.01597612691468297
STAT,1920,34,35-39,1954,10.021557375402939
SIM,1800,99,na,1899,9
STAT,1844,38,na,1882,1949.4006355860731
SIM,1862,8,na,1870,2485
STAT,1925,11,na,1936,4844.433763423265
STAT,1879,51,30-34,1930,0.006304004751122916
STAT,1872,42,30-34,1914,1.1659598792853003
STAT,1820,41,20-24,1861,0.31021239895818264
SIM,1829,27,35-39,1856,14
SIM,1877,52,na,1929,2229
SIM,1853,38,na,1891,1757
SIM,1865,19,na,1884,2375
STAT,1905,44,45-49,1949,0.14969918938559376
STAT,1900,22,15-19,1922,4.6285675093995176
STAT,1884,44,15-19,1928,0.013568861058568664
STAT,1871,21,30-34,1892,17.927237084837703
STAT,1895,29,50-100,1924,0.8377005292892696
STAT,1860,35,50-100,1895,1.0232838549087864
SIM,1886,29,30-34,1915,44
STAT,1916,37,50-100,1953,0.4338971060334578
STAT,1878,29,30-34,1907,26.213382326917202
STAT,1850,42,45-49,1892,1.1445871500604443
STAT,1873,9,na,1882,2741.289095839518
STAT,1895,47,45-49,1942,0.17476663642636536
SIM,1863,16,30-34,1879,3
SIM,1880,42,30-34,1922,1
STAT,1827,43,30-34,1870,1.215658327334411
SIM,1918,18,30-34,1936,20
STAT,1909,40,50-100,1949,0.11213985911410287
STAT,1861,31,15-19,1892,0.12000836326172981
STAT,1855,16,30-34,1871,1.4354242237794521
SIM,1812,80,na,1892,228
STAT,1927,22,30-34,1949,35.7912555601151
SIM,1910,21,50-100,1931,4
SIM,1907,19,25-29,1926,12
SIM,1947,22,50-100,1969,1
STAT,1929,30,40-44,1959,5.029879469161223
STAT,1839,15,40-44,1854,0.17164757452772128
STAT,1948,22,50-100,1970,0.7632003085391331
STAT,1908,28,35-39,1936,14.276541278028628
STAT,1907,41,15-19,1948,0.0014288261366125806
STAT,1800,108,na,1908,6.425425569375273E-4
STAT,1776,108,na,1884,0.00436585807706692
STAT,1903,19,45-49,1922,0.09345686509615622
STAT,1893,20,40-44,1913,2.6883077244852465
SIM,1933,25,30-34,1958,66
SIM,1852,21,na,1873,1890
SIM,1912,37,35-39,1949,7
STAT,1850,85,na,1935,209.90852053649206
STAT,1865,25,35-39,1890,8.959154434299842
STAT,1923,28,50-100,1951,1.150579011586471
STAT,1916,47,25-29,1963,0.05490639734213967
STAT,1887,54,na,1941,2361.3068375372327
SIM,1823,32,na,1855,1715
SIM,1816,70,na,1886,683
STAT,1900,15,50-100,1915,0.06905551046746586
SIM,1841,69,na,1910,1039
STAT,1914,39,15-19,1953,0.019150218231199993
STAT,1882,25,50-100,1907,0.6300874059477278
SIM,1924,16,20-24,1940,138
STAT,1906,45,45-49,1951,0.1977910980293977
SIM,1897,20,20-24,1917,4
STAT,1836,62,na,1898,1152.4283253328763
STAT,1937,16,50-100,1953,0.3688604595223857
STAT,1869,30,45-49,1899,1.7261252073557003
STAT,1936,28,40-44,1964,4.5012269888579555
SIM,1836,82,na,1918,358
STAT,1900,24,15-19,1924,4.599591872345645
SIM,1884,23,45-49,1907,2
STAT,1921,34,30-34,1955,17.556393974856004
SIM,1944,15,35-39,1959,6
SIM,1959,9,na,1968,5501
SIM,1873,25,35-39,1898,12
STAT,1923,42,40-44,1965,0.2953816026905349
STAT,1851,54,20-24,1905,5.433784725356103E-4
SIM,1895,18,na,1913,3337
STAT,1902,21,15-19,1923,4.722780788752264
SIM,1894,76,na,1970,1730
SIM,1937,30,40-44,1967,4
SIM,1835,41,na,1876,1521
STAT,1859,28,15-19,1887,0.3722284728433784
SIM,1881,25,50-100,1906,5
STAT,1867,22,35-39,1889,5.573703684460742
SIM,1918,36,45-49,1954,3
SIM,1916,2,na,1918,4330
SIM,1892,31,50-100,1923,1
STAT,1847,21,25-29,1868,52.924519561461686
SIM,1935,22,30-34,1957,51
SIM,1918,25,35-39,1943,20
STAT,1904,37,35-39,1941,2.2127232738137366
SIM,1827,46,na,1873,1473
STAT,1878,18,na,1896,2641.046082308061
SIM,1855,21,25-29,1876,96
STAT,1920,36,35-39,1956,2.676730557856823
STAT,1921,45,40-44,1966,0.18035404481578565
SIM,1848,16,na,1864,2146
STAT,1870,37,40-44,1907,4.341555819823911
STAT,1911,27,25-29,1938,64.75885643392867
STAT,1849,37,na,1886,1884.881339537138
SIM,1919,34,40-44,1953,6
STAT,1911,30,25-29,1941,9.153047533325402
SIM,1900,30,45-49,1930,5
STAT,1850,33,50-100,1883,0.7263435173253052
STAT,1920,16,40-44,1936,1.5886008672017427
STAT,1782,96,na,1878,1.593030305482702
STAT,1904,48,45-49,1952,0.19052747959401575
SIM,1942,18,35-39,1960,13
STAT,1925,45,25-29,1970,0.06526629222213967
SIM,1848,31,35-39,1879,1
STAT,1914,19,20-24,1933,28.143939952650875
STAT,1917,15,25-29,1932,9.456670427166623
SIM,1870,101,na,1971,18
STAT,1897,19,50-100,1916,0.065982128052381
STAT,1900,37,20-24,1937,0.23343434290865178
STAT,1940,29,15-19,1969,0.726038042024767
SIM,1857,44,na,1901,1984
STAT,1904,51,na,1955,3135.859721104646
STAT,1950,19,30-34,1969,14.551085346944216
STAT,1886,13,na,1899,2749.7009992776766
SIM,1888,33,30-34,1921,29
STAT,1934,18,35-39,1952,5.719870271329587
SIM,1869,33,20-24,1902,2
SIM,1902,26,40-44,1928,5
STAT,1782,88,na,1870,46.20937928299875
STAT,1921,15,45-49,1936,0.5777646753371404
STAT,1942,26,15-19,1968,0.7484317471427306
SIM,1889,32,35-39,1921,13
STAT,1841,49,na,1890,1647.3350938382573
STAT,1951,15,30-34,1966,14.67234256899989
STAT,1786,78,na,1864,313.5000183960203
SIM,1920,10,na,1930,4828
STAT,1904,17,40-44,1921,0.26510313207682634
SIM,1873,15,na,1888,2490
SIM,1903,30,na,1933,3241
SIM,1887,7,na,1894,2878
SIM,1922,19,20-24,1941,157
STAT,1879,20,50-100,1899,0.43237551611816444
SIM,1799,73,na,1872,666
STAT,1835,22,45-49,1857,0.6959756887039646
STAT,1952,16,30-34,1968,14.761931498462966
SIM,1833,42,na,1875,1737
SIM,1837,56,na,1893,1265
STAT,1930,27,35-39,1957,19.29513190840223
STAT,1932,35,45-49,1967,0.9272516090765264
STAT,1790,83,na,1873,116.62404467136204
STAT,1857,32,na,1889,1892.6090029016812
STAT,1916,16,20-24,1932,29.09933620364717
STAT,1831,39,na,1870,1657.843101917541
STAT,1871,47,na,1918,2247.019908928867
SIM,1806,84,na,1890,75
SIM,1907,35,30-34,1942,4
STAT,1811,52,25-29,1863,0.008436044325693469
STAT,1902,34,20-24,1936,2.1962791805291766
STAT,1932,15,20-24,1947,182.26419676443737
SIM,1831,51,na,1882,1501
STAT,1863,22,20-24,1885,62.89808395662335
SIM,1802,70,na,1872,708
STAT,1905,16,45-49,1921,0.0956114153821423
STAT,1893,31,50-100,1924,1.1798332221801984
STAT,1915,18,25-29,1933,9.127961725373874
SIM,1923,18,25-29,1941,58
SIM,1912,15,na,1927,3858
SIM,1808,75,na,1883,327
STAT,1911,21,50-100,1932,0.6314825403530446
SIM,1940,15,20-24,1955,200
STAT,1866,48,30-34,1914,0.08939299402826335
SIM,1875,9,na,1884,2602
STAT,1840,75,na,1915,721.6402085787262
SIM,1829,32,50-100,1861,1
STAT,1934,34,50-100,1968,1.1391549166347978
SIM,1920,23,25-29,1943,7
STAT,1908,22,20-24,1930,103.19157163526249
STAT,1810,77,na,1887,426.9406997581204
STAT,1844,17,15-19,1861,5.968560497051937
SIM,1922,42,45-49,1964,1
STAT,1934,32,15-19,1966,0.17728203268259515
SIM,1926,19,35-39,1945,5
STAT,1913,40,30-34,1953,0.1272168014096383
STAT,1917,32,15-19,1949,0.13582800942397275
SIM,1877,18,30-34,1895,3
SIM,1852,13,na,1865,2190
STAT,1912,23,25-29,1935,89.03459799587655
SIM,1923,39,50-100,1962,3
STAT,1896,16,25-29,1912,7.5945761166409556
SIM,1847,35,35-39,1882,6
STAT,1803,75,na,1878,518.8062586482557
SIM,1827,54,na,1881,1270
STAT,1894,24,na,1918,3056.1040829164667
STAT,1898,38,na,1936,3235.1523813156277
STAT,1932,15,na,1947,4948.318688738571
STAT,1854,67,na,1921,1189.6846822161556
SIM,1878,46,na,1924,2609
STAT,1935,19,35-39,1954,5.764585672307985
STAT,1830,52,35-39,1882,0.0063327247543233526
SIM,1945,24,40-44,1969,8
STAT,1870,54,30-34,1924,0.00574132160641204
STAT,1890,18,na,1908,3108.837603646084
STAT,1829,25,25-29,1854,110.81756589153784
SIM,1860,34,50-100,1894,6
STAT,1889,26,35-39,1915,12.057957670257492
SIM,1902,15,30-34,1917,3
SIM,1882,51,na,1933,1932
STAT,1860,47,25-29,1907,0.04733438036220461
STAT,1937,24,40-44,1961,3.3032791811166575
STAT,1868,16,na,1884,2496.7916791494777
SIM,1837,25,25-29,1862,67
STAT,1872,21,na,1893,2408.770150505667
STAT,1924,29,30-34,1953,45.77157015900722
STAT,1792,98,na,1890,0.5839837791078679
SIM,1849,40,40-44,1889,8
STAT,1819,49,50-100,1868,0.4646411267427079
STAT,1899,31,na,1930,3321.307218657068
SIM,1805,49,50-100,1854,3
STAT,1836,52,50-100,1888,0.00964004630142328
STAT,1885,48,40-44,1933,0.16995120227847116
STAT,1903,30,20-24,1933,3.919368768967061
SIM,1816,62,na,1878,948
STAT,1908,41,na,1949,3488.583970866022
STAT,1825,78,na,1903,570.1845062041555
STAT,1852,53,25-29,1905,0.0026431036808096256
STAT,1918,19,35-39,1937,4.586246477084536
SIM,1861,89,na,1950,39
STAT,1869,18,30-34,1887,1.5774404014363916
STAT,1877,52,na,1929,2232.5635206676134
STAT,1931,2,na,1933,5410.2136836259
STAT,1933,31,15-19,1964,0.1750990138414781
SIM,1850,44,50-100,1894,1
STAT,1858,40,40-44,1898,1.8002800070625935
SIM,1906,27,na,1933,3502
STAT,1907,41,45-49,1948,0.15484902168376366
SIM,1898,66,na,1964,2442
SIM,1933,0,na,1933,5459
STAT,1924,41,45-49,1965,0.2003313660228077
STAT,1909,29,35-39,1938,14.375420020029356
STAT,1913,43,50-100,1956,0.11540900379575064
STAT,1866,60,na,1926,1783.6565510989783
SIM,1886,33,na,1919,2646
STAT,1943,22,15-19,1965,5.718549800683477
SIM,1911,30,20-24,1941,5
STAT,1854,103,na,1957,0.15735760955565464
STAT,1938,23,45-49,1961,1.123830987055586
STAT,1853,42,na,1895,1908.9878658843108
STAT,1903,36,35-39,1939,2.206490996233144
SIM,1911,36,35-39,1947,7
SIM,1840,44,na,1884,1685
SIM,1936,34,40-44,1970,8
STAT,1866,92,na,1958,56.462676290887174
SIM,1853,62,na,1915,1366
SIM,1857,76,na,1933,864
STAT,1823,39,20-24,1862,1.2267484450961952
STAT,1915,11,na,1926,4177.055056271501
STAT,1919,25,na,1944,4114.581747158918
SIM,1932,29,30-34,1961,85
STAT,1890,39,50-100,1929,1.4999818900754995
SIM,1911,41,na,1952,3890
SIM,1915,55,na,1970,3965
STAT,1952,5,na,1957,4760.496157542502
STAT,1849,8,na,1857,2363.3122822809646
STAT,1840,39,20-24,1879,0.6259726368729222
STAT,1910,34,25-29,1944,8.91428204893723
SIM,1916,28,35-39,1944,19
SIM,1856,25,35-39,1881,11
STAT,1786,107,na,1893,0.002519971658711334
SIM,1932,23,50-100,1955,1
STAT,1918,44,25-29,1962,0.0763953743116213
SIM,1930,30,30-34,1960,28
SIM,1844,26,na,1870,1854
STAT,1857,43,50-100,1900,0.8267266662482476
STAT,1889,20,20-24,1909,86.33528996534072
SIM,1915,29,30-34,1944,48
STAT,1878,20,15-19,1898,3.479515119107705
STAT,1839,35,35-39,1874,6.118149555429197
STAT,1928,34,40-44,1962,4.939478964521265
SIM,1853,94,na,1947,16
SIM,1939,27,20-24,1966,20
STAT,1905,24,50-100,1929,0.5916859986014752
SIM,1878,26,25-29,1904,56
STAT,1907,29,30-34,1936,36.77141229294263
SIM,1910,32,na,1942,3486
SIM,1916,22,20-24,1938,128
STAT,1871,53,35-39,1924,0.008499837402183782
STAT,1871,39,na,1910,2340.251469257033
SIM,1836,90,na,1926,38
STAT,1857,24,na,1881,1930.4371182094878
STAT,1923,30,na,1953,4416.011751650846
STAT,1917,45,20-24,1962,0.011706193286232805
SIM,1917,29,35-39,1946,20
STAT,1922,30,30-34,1952,18.128062338946336
STAT,1800,100,na,1900,0.3724099626774702
STAT,1933,31,45-49,1964,2.1441368845961377
STAT,1919,28,40-44,1947,5.067056836247833
STAT,1863,5,na,1868,2567.7414122186096
SIM,1819,67,na,1886,798
STAT,1893,23,45-49,1916,0.8915108011685369
STAT,1891,67,na,1958,2062.4745895367687
SIM,1870,74,na,1944,1175
SIM,1829,80,na,1909,353
SIM,1914,42,40-44,1956,1
STAT,1856,15,40-44,1871,0.16945892771807303
SIM,1924,19,25-29,1943,65
STAT,1835,21,na,1856,2148.438762112494
SIM,1871,99,na,1970,4
SIM,1878,78,na,1956,879
STAT,1918,41,20-24,1959,0.018983889616919714
STAT,1898,40,50-100,1938,0.10146170695737917
SIM,1815,77,na,1892,351
STAT,1857,101,na,1958,0.7511475349840937
SIM,1935,34,25-29,1969,19
STAT,1805,107,na,1912,0.001872120641447526
SIM,1881,26,na,1907,2116
STAT,1847,110,na,1957,2.546916065703163E-4
STAT,1867,30,40-44,1897,4.158338592747904
SIM,1941,16,20-24,1957,137
SIM,1919,45,na,1964,3951
STAT,1905,29,20-24,1934,17.006627612333602
STAT,1924,28,na,1952,4392.094582339418
SIM,1858,18,20-24,1876,27
STAT,1911,24,20-24,1935,105.7269746176769
SIM,1895,26,25-29,1921,6
STAT,1841,21,30-34,1862,16.996180677437767
STAT,1839,59,na,1898,1377.8633567233378
STAT,1847,23,50-100,1870,0.3716145982040452
STAT,1916,19,25-29,1935,9.228733307808382
STAT,1883,48,30-34,1931,0.09447219376750714
STAT,1921,37,35-39,1958,2.727677613735948
SIM,1918,20,na,1938,4126
SIM,1927,28,40-44,1955,8
SIM,1834,21,35-39,1855,6
SIM,1910,37,30-34,1947,2
STAT,1856,90,na,1946,61.049898098606604
STAT,1878,34,50-100,1912,0.9524173890229859
STAT,1907,26,20-24,1933,17.46012910080772
STAT,1940,32,45-49,1972,1.6441453817929341
SIM,1886,34,50-100,1920,6
STAT,1878,33,20-24,1911,2.8220752124633823
SIM,1866,13,na,1879,2744
STAT,1910,47,30-34,1957,0.08391404531754726
SIM,1878,23,20-24,1901,113
STAT,1889,40,50-100,1929,1.3289749245821498
STAT,1887,26,25-29,1913,47.86472317448295
SIM,1911,33,25-29,1944,2
STAT,1941,25,15-19,1966,0.7379344463177857
STAT,1920,8,na,1928,4518.769343440301
STAT,1895,20,45-49,1915,0.9252293168882539
SIM,1830,77,na,1907,397
SIM,1887,74,na,1961,1231
SIM,1888,16,na,1904,3122
STAT,1923,45,45-49,1968,0.25809905763067553
STAT,1924,41,15-19,1965,0.0018485017770486964
STAT,1907,25,50-100,1932,0.9552466117756436
STAT,1826,32,45-49,1858,2.445616846359272
STAT,1875,29,na,1904,2457.651891469132
STAT,1854,59,na,1913,1458.5437291547573
STAT,1894,56,na,1950,2652.2082472539405
STAT,1807,57,na,1864,1054.6512239490537
STAT,1931,19,20-24,1950,178.38281300721044
SIM,1879,43,30-34,1922,3
STAT,1869,30,15-19,1899,0.14096246547795827
STAT,1922,16,45-49,1938,0.5854745589906322
SIM,1940,30,na,1970,4091
SIM,1834,32,45-49,1866,1
SIM,1907,16,20-24,1923,43
STAT,1844,41,50-100,1885,0.8670858544670323
STAT,1865,11,na,1876,2504.5067534850655
SIM,1866,4,na,1870,2908
STAT,1900,24,45-49,1924,0.9722253037699242
SIM,1864,54,na,1918,2324
STAT,1915,43,na,1958,3766.9746310771816
STAT,1859,90,na,1949,64.04499741906739
STAT,1901,25,15-19,1926,0.646736220319112
STAT,1903,33,25-29,1936,8.42404518515097
STAT,1949,23,na,1972,4303.499493850859
STAT,1945,18,40-44,1963,1.5425535781839923
SIM,1860,22,45-49,1882,1
SIM,1923,35,45-49,1958,3
SIM,1858,18,na,1876,2147
STAT,1875,38,30-34,1913,5.500512732657982
SIM,1846,60,na,1906,1368
STAT,1875,21,na,1896,2460.4758026075224
STAT,1878,20,45-49,1898,0.7354723500546965
SIM,1928,30,na,1958,4860
SIM,1888,30,20-24,1918,4
STAT,1841,60,na,1901,1426.2166962715678
SIM,1902,27,25-29,1929,81
SIM,1913,29,20-24,1942,20
STAT,1933,16,20-24,1949,183.84604240564585
STAT,1913,23,40-44,1936,3.4151706428200437
STAT,1850,106,na,1956,0.01165915494238099
STAT,1852,22,45-49,1874,0.6282408168158765
SIM,1883,38,30-34,1921,11
SIM,1921,27,35-39,1948,1
STAT,1838,19,40-44,1857,0.15983015105347312
SIM,1887,82,na,1969,849
STAT,1897,33,30-34,1930,23.54171694035086
SIM,1856,22,25-29,1878,84
SIM,1905,19,20-24,1924,25
STAT,1913,27,35-39,1940,15.093756174015274
STAT,1914,42,45-49,1956,0.16638807197919372
STAT,1914,18,na,1932,4020.441178578078
STAT,1903,16,40-44,1919,0.2637363386594925
SIM,1877,21,na,1898,2489
SIM,1879,87,na,1966,321
SIM,1921,38,45-49,1959,2
SIM,1856,59,na,1915,1732
STAT,1907,56,na,1963,3181.7453943281275
SIM,1953,18,40-44,1971,5
STAT,1902,37,25-29,1939,0.8869699280310319
STAT,1899,41,40-44,1940,0.21748871130327743
SIM,1851,28,na,1879,2027
STAT,1817,67,na,1884,807.6254571294376
STAT,1921,48,45-49,1969,0.24676631102985266
STAT,1925,42,20-24,1967,0.021608215705285816
SIM,1891,36,na,1927,3045
STAT,1904,43,50-100,1947,0.1055644100194552
STAT,1930,24,30-34,1954,36.981349854813445
STAT,1870,97,na,1967,24.13596356133135
STAT,1863,40,50-100,1903,0.9549474916290575
SIM,1902,30,25-29,1932,25
STAT,1899,30,30-34,1929,24.396357382764325
SIM,1838,42,30-34,1880,3
SIM,1874,64,na,1938,1593
STAT,1860,44,20-24,1904,0.12935037947199093
STAT,1873,62,na,1935,1871.431403830929
STAT,1911,26,40-44,1937,4.601618780859232
SIM,1879,31,na,1910,2761
SIM,1928,40,40-44,1968,2
SIM,1901,19,30-34,1920,2
STAT,1879,67,na,1946,1670.819314188673
STAT,1932,23,na,1955,4827.204143225936
STAT,1813,53,na,1866,1227.0765819590831
STAT,1911,15,30-34,1926,2.472185244976946
SIM,1854,25,25-29,1879,54
SIM,1871,40,50-100,1911,1
STAT,1901,20,45-49,1921,0.9931987777391423
SIM,1871,22,20-24,1893,80
STAT,1860,23,50-100,1883,0.3445796775478163
STAT,1901,36,25-29,1937,0.8841187073638457
STAT,1930,35,40-44,1965,1.9769797544232113
SIM,1837,22,20-24,1859,60
SIM,1910,37,25-29,1947,1
STAT,1846,25,25-29,1871,39.399114074979366
SIM,1938,6,na,1944,3897
STAT,1902,40,25-29,1942,0.06428758696437147
SIM,1823,64,na,1887,1025
SIM,1914,25,20-24,1939,26
SIM,1834,56,na,1890,1415
SIM,1877,30,45-49,1907,5
SIM,1830,66,na,1896,855
SIM,1926,16,30-34,1942,19
STAT,1879,45,50-100,1924,0.2614431026991155
SIM,1874,21,35-39,1895,5
STAT,1909,38,25-29,1947,0.9357801680137628
STAT,1911,43,30-34,1954,0.12236623111347265
STAT,1937,27,45-49,1964,1.7001340081006373
SIM,1833,100,na,1933,1
SIM,1811,51,50-100,1862,1
SIM,1909,32,30-34,1941,24
SIM,1903,23,25-29,1926,101
SIM,1921,23,40-44,1944,3
SIM,1930,33,35-39,1963,16
STAT,1834,30,50-100,1864,0.7136287584386689
SIM,1887,45,50-100,1932,2
STAT,1909,41,25-29,1950,0.06778786362614479
STAT,1926,37,40-44,1963,1.849025781647231
SIM,1844,34,na,1878,1662
SIM,1848,48,na,1896,1699
STAT,1849,19,50-100,1868,0.04659593666568927
STAT,1848,22,25-29,1870,56.90910731515984
SIM,1897,23,30-34,1920,31
SIM,1925,15,25-29,1940,70
STAT,1901,20,15-19,1921,4.698817247399757
STAT,1808,47,30-34,1855,0.353540611833167
SIM,1853,5,na,1858,2257
STAT,1924,38,20-24,1962,0.3137920068925206
STAT,1926,20,50-100,1946,0.812731382109481
STAT,1906,25,20-24,1931,17.375263974645218
STAT,1915,35,45-49,1950,0.7015095028566409
SIM,1929,4,na,1933,5048
STAT,1855,37,50-100,1892,0.9241475687385201
STAT,1903,66,na,1969,2684.1407965075014
STAT,1889,23,30-34,1912,22.11476754199066
STAT,1943,0,na,1943,4782.262634323582
STAT,1927,38,40-44,1965,1.8793044709814304
STAT,1869,89,na,1958,143.59380701512072
SIM,1842,30,50-100,1872,1
STAT,1836,30,na,1866,1763.4694238207771
STAT,1813,77,na,1890,379.0004172741562
STAT,1871,45,35-39,1916,0.14187990861661406
STAT,1816,42,na,1858,1600.9604177663052
STAT,1936,26,45-49,1962,1.6699284929160318
STAT,1775,86,na,1861,49.0675754338193
STAT,1872,49,15-19,1921,3.976875345217774E-4
SIM,1833,46,50-100,1879,5
STAT,1781,108,na,1889,0.0029908970766059323
SIM,1839,87,na,1926,64
SIM,1849,32,35-39,1881,10
STAT,1882,31,na,1913,2344.1824328000116
STAT,1825,46,50-100,1871,0.3343820938564623
STAT,1940,10,na,1950,4057.089614338081
STAT,1856,32,30-34,1888,13.685395045340243
STAT,1837,87,na,1924,120.18693272284045
SIM,1915,26,20-24,1941,3
STAT,1884,30,40-44,1914,4.354067493948687
SIM,1936,17,na,1953,3905
SIM,1904,4,na,1908,3971
STAT,1833,73,na,1906,840.3299687100046
STAT,1917,48,25-29,1965,0.05577102762730965
STAT,1823,50,50-100,1873,0.02082058563287028
SIM,1854,87,na,1941,164
SIM,1897,0,na,1897,3762
SIM,1910,21,15-19,1931,8
STAT,1888,22,25-29,1910,68.24316235250555
SIM,1934,37,40-44,1971,3
STAT,1767,99,na,1866,0.26883768371692907
STAT,1837,32,20-24,1869,2.312073236057781
SIM,1872,48,50-100,1920,4
STAT,1822,81,na,1903,302.35419180994126
STAT,1936,15,35-39,1951,4.074658072566551
SIM,1896,22,25-29,1918,90
STAT,1964,3,na,1967,5002.919153207912
STAT,1910,31,20-24,1941,2.382521940983941
SIM,1911,33,30-34,1944,5
STAT,1826,95,na,1921,7.295532890858174
SIM,1915,25,50-100,1940,1
STAT,1872,15,25-29,1887,5.841653883954993
STAT,1923,45,15-19,1968,4.3745566168317565E-4
SIM,1886,33,20-24,1919,3
SIM,1857,52,na,1909,1845
SIM,1845,32,20-24,1877,2
SIM,1875,22,35-39,1897,9
SIM,1946,20,40-44,1966,6
STAT,1828,103,na,1931,0.0931638035655673
SIM,1906,15,20-24,1921,25
STAT,1922,33,35-39,1955,10.38685935195886
SIM,1919,37,45-49,1956,1
STAT,1918,27,40-44,1945,5.00786118411948
STAT,1820,55,na,1875,1144.8712466301156
SIM,1791,77,na,1868,276
SIM,1862,7,na,1869,2503
SIM,1902,37,na,1939,3650
SIM,1829,31,25-29,1860,23
STAT,1904,45,40-44,1949,0.14136736626765928
STAT,1922,45,na,1967,4283.737502131755
STAT,1824,69,na,1893,729.5903944194238
STAT,1903,33,30-34,1936,14.359770579606101
SIM,1799,65,na,1864,939
STAT,1895,41,na,1936,3072.809643790907
SIM,1854,37,50-100,1891,1
STAT,1866,21,35-39,1887,5.541883061739458
STAT,1916,36,15-19,1952,0.019941126184096335
SIM,1892,30,40-44,1922,2
STAT,1828,28,50-100,1856,1.0279830244313708
STAT,1918,16,30-34,1934,2.693783524549499
SIM,1926,27,40-44,1953,11
STAT,1915,35,15-19,1950,0.01976083341643032
SIM,1868,24,15-19,1892,6
STAT,1904,34,30-34,1938,14.406551981440463
STAT,1920,20,25-29,1940,104.31764755324983
STAT,1827,34,na,1861,1690.8735223196418
SIM,1938,29,25-29,1967,3
STAT,1928,30,25-29,1958,11.694504266382081
STAT,1846,37,50-100,1883,0.9729726266055108
SIM,1864,32,30-34,1896,31
STAT,1926,26,30-34,1952,47.63459326406517
STAT,1921,32,35-39,1953,10.271077671785513
SIM,1925,7,na,1932,4904
SIM,1897,23,25-29,1920,87
STAT,1889,23,25-29,1912,71.07305585952807
STAT,1912,44,30-34,1956,0.12343729900657753
SIM,1820,39,45-49,1859,1
STAT,1898,46,na,1944,3089.822205720741
STAT,1911,53,na,1964,3434.2307613030944
STAT,1938,28,15-19,1966,0.7057205438271612
SIM,1884,20,40-44,1904,3
STAT,1938,20,40-44,1958,3.361776470001682
SIM,1878,38,na,1916,2701
STAT,1925,25,30-34,1950,47.08771181399671
SIM,1938,18,15-19,1956,46
STAT,1842,47,30-34,1889,0.08716696533724134
SIM,1912,34,30-34,1946,26
STAT,1920,17,25-29,1937,49.097672246019776
SIM,1806,92,na,1898,2
SIM,1856,22,30-34,1878,26
SIM,1908,1,na,1909,3931
STAT,1834,37,30-34,1871,3.9480501444785503
SIM,1934,26,30-34,1960,8
SIM,1875,18,20-24,1893,24
STAT,1872,32,na,1904,2423.110083378452
STAT,1875,20,50-100,1895,0.42549100698082026
STAT,1928,38,35-39,1966,3.0865703515528247
STAT,1849,69,na,1918,1147.4030429444078
SIM,1952,12,na,1964,4780
STAT,1880,75,na,1955,1091.961231305639
STAT,1919,44,40-44,1963,0.27276794129050813
SIM,1861,37,40-44,1898,9
STAT,1831,49,20-24,1880,0.008736292495186645
STAT,1830,44,35-39,1874,1.5295310411521268
SIM,1920,26,35-39,1946,24
STAT,1914,23,35-39,1937,9.675855769611886
STAT,1849,50,50-100,1899,0.01197781617087161
SIM,1911,34,50-100,1945,7
STAT,1802,82,na,1884,170.71178713429754
STAT,1843,32,45-49,1875,1.4139604299529631
SIM,1855,10,na,1865,2512
STAT,1829,29,40-44,1858,2.9931206729551127
SIM,1923,39,30-34,1962,6
STAT,1888,43,30-34,1931,1.360632506745629
STAT,1903,21,30-34,1924,25.69877759220127
SIM,1868,20,20-24,1888,59
SIM,1922,34,45-49,1956,2
SIM,1918,34,25-29,1952,16
STAT,1830,105,na,1935,0.01934401421330466
STAT,1902,17,na,1919,3604.6967460353844
SIM,1851,32,45-49,1883,1
SIM,1833,93,na,1926,16
STAT,1849,20,45-49,1869,0.6687352334761891
STAT,1924,25,15-19,1949,0.8362384009437318
STAT,1870,46,30-34,1916,0.09627767826280587
SIM,1847,32,25-29,1879,12
STAT,1813,45,na,1858,1385.62186796514
STAT,1843,21,35-39,1864,4.9760167121019006
STAT,1926,45,40-44,1971,0.19753689199582466
SIM,1922,23,35-39,1945,20
SIM,1837,29,40-44,1866,3
STAT,1893,19,50-100,1912,0.062492277110370184
SIM,1907,32,20-24,1939,2
SIM,1765,93,na,1858,1
SIM,1908,39,35-39,1947,1
STAT,1912,26,35-39,1938,14.978097095692567
STAT,1839,32,25-29,1871,8.9363949463875
STAT,1882,87,na,1969,418.6288451551807
SIM,1897,22,40-44,1919,3
SIM,1927,44,40-44,1971,2
STAT,1823,52,na,1875,1333.5244225847687
SIM,1934,29,35-39,1963,29
STAT,1855,31,25-29,1886,7.932128036788994
SIM,1810,46,na,1856,1483
SIM,1893,39,50-100,1932,2
STAT,1917,48,30-34,1965,0.09372631122143828
SIM,1865,15,35-39,1880,1
STAT,1853,37,40-44,1890,3.620092089800495
STAT,1866,43,50-100,1909,0.9808909206771285
SIM,1809,89,na,1898,8
SIM,1862,32,20-24,1894,3
STAT,1856,18,45-49,1874,0.059457910718767715
SIM,1908,53,na,1961,3122
STAT,1921,9,na,1930,4582.949926754303
STAT,1869,97,na,1966,21.724975786445075
STAT,1890,82,na,1972,1049.9572327189437
STAT,1832,31,30-34,1863,15.708333395749657
STAT,1889,22,40-44,1911,2.5951634271002617
SIM,1902,22,25-29,1924,99
SIM,1922,22,45-49,1944,1
STAT,1910,19,30-34,1929,2.423619683346135
STAT,1855,20,15-19,1875,2.943157368030352
STAT,1831,38,50-100,1869,0.9707148337955523
STAT,1901,44,25-29,1945,0.06228467888340344
STAT,1933,19,25-29,1952,58.306006816921325
STAT,1884,31,50-100,1915,0.9163053547815124
STAT,1914,34,45-49,1948,1.5844501637305386
SIM,1820,67,na,1887,813
STAT,1919,45,30-34,1964,0.09808600945354755
STAT,1938,31,na,1969,3841.353316137975
STAT,1854,50,30-34,1904,0.004531505510025597
SIM,1896,31,50-100,1927,2
STAT,1854,32,20-24,1886,2.077418362917391
SIM,1780,85,na,1865,115
STAT,1844,14,na,1858,2379.1672991140977
STAT,1812,44,50-100,1856,2.5459815075360503
STAT,1894,38,40-44,1932,5.663988307862499
SIM,1913,29,na,1942,3659
STAT,1797,73,na,1870,512.3266053699007
STAT,1901,62,na,1963,2771.1030417012685
STAT,1785,85,na,1870,85.94668883728296
STAT,1884,48,25-29,1932,0.05664846426331407
STAT,1838,29,na,1867,1815.7576354999742
STAT,1844,15,50-100,1859,0.04985824175418484
STAT,1881,4,na,1885,2763.572800529638
STAT,1956,16,20-24,1972,181.2800416494534
STAT,1899,44,45-49,1943,0.14211786359943437
STAT,1914,22,45-49,1936,1.1598182669678139
SIM,1861,23,15-19,1884,7
STAT,1847,54,na,1901,1567.8231415193359
STAT,1907,29,25-29,1936,61.76988246447971
STAT,1865,48,15-19,1913,3.64266822954525E-4
STAT,1825,105,na,1930,0.021397021038889887
SIM,1915,29,25-29,1944,77
STAT,1911,29,45-49,1940,1.687604393705712
STAT,1819,47,na,1866,1370.2469466623581
STAT,1835,27,15-19,1862,0.4439788419842184
STAT,1857,15,35-39,1872,0.5143981574517998
STAT,1899,33,35-39,1932,13.978412479886952
STAT,1911,18,35-39,1929,0.8449246776831308
STAT,1848,28,na,1876,2093.394150138729
STAT,1881,39,50-100,1920,1.1832579032894024
STAT,1884,8,na,1892,2589.1350613799805
STAT,1853,23,15-19,1876,3.2003566736900657
SIM,1814,90,na,1904,24
SIM,1902,24,20-24,1926,127
STAT,1880,72,na,1952,1339.5658826810613
STAT,1852,34,50-100,1886,0.7046710414991614
STAT,1884,86,na,1970,510.66303430296875
STAT,1867,18,20-24,1885,17.138287264585742
STAT,1940,24,45-49,1964,1.1563708527541152
STAT,1944,17,50-100,1961,0.4071400851561026
SIM,1843,92,na,1935,87
SIM,1930,29,20-24,1959,31
STAT,1847,65,na,1912,1265.3375109347157
STAT,1838,18,na,1856,2017.7608008139339
STAT,1845,17,30-34,1862,1.4719756866595841
STAT,1901,51,na,1952,3063.248732237389
STAT,1922,29,20-24,1951,20.7176113967551
STAT,1768,92,na,1860,18.809718556148013
STAT,1910,17,35-39,1927,0.8388594910318693
STAT,1834,54,20-24,1888,4.33107059449689E-4
STAT,1827,47,40-44,1874,0.17559893706847274
STAT,1865,22,25-29,1887,53.43687816254409
STAT,1851,70,na,1921,1062.3906614803566
STAT,1910,23,20-24,1933,105.02699630601315
STAT,1884,65,na,1949,1683.1942193611183
SIM,1784,75,na,1859,424
SIM,1873,22,25-29,1895,55
STAT,1841,50,45-49,1891,0.011008550620933335
STAT,1930,23,40-44,1953,4.340145630694903
STAT,1950,15,15-19,1965,54.24400230145762
STAT,1888,79,na,1967,1219.5103834724973
STAT,1920,33,25-29,1953,10.180277971335025
SIM,1846,15,25-29,1861,3
SIM,1901,26,25-29,1927,66
STAT,1859,98,na,1957,3.602692291800446
SIM,1881,58,na,1939,1799
STAT,1894,24,15-19,1918,4.262982493059421
STAT,1925,22,20-24,1947,134.51197603559632
SIM,1901,15,15-19,1916,13
SIM,1937,34,35-39,1971,12
STAT,1861,17,15-19,1878,5.724796657985817
STAT,1860,48,50-100,1908,0.20022602130575884
STAT,1906,28,25-29,1934,62.01071866533751
SIM,1928,24,40-44,1952,6
STAT,1802,90,na,1892,27.545576232269607
STAT,1936,24,25-29,1960,89.094080090542
STAT,1918,44,30-34,1962,0.13677236312733146
STAT,1853,101,na,1954,0.4718923185568919
STAT,1768,105,na,1873,0.03585996957477478
STAT,1783,81,na,1864,208.6363924852621
STAT,1871,54,50-100,1925,0.014737726686743063
STAT,1913,38,45-49,1951,0.6754254654151062
SIM,1892,33,45-49,1925,5
STAT,1851,37,50-100,1888,0.9395871106795096
STAT,1826,92,na,1918,22.8538823008119
STAT,1829,46,50-100,1875,0.18563629127460346
SIM,1958,8,na,1966,5244
STAT,1951,16,15-19,1967,54.61676539103203
STAT,1813,42,na,1855,1411.7444040769997
STAT,1942,22,20-24,1964,117.71306357654112
STAT,1873,32,30-34,1905,17.87717172409335
SIM,1868,79,na,1947,540
SIM,1926,32,30-34,1958,34
STAT,1868,48,40-44,1916,0.16318132732254317
STAT,1924,23,50-100,1947,0.7821602579228213
SIM,1820,75,na,1895,512
SIM,1949,16,25-29,1965,55
STAT,1900,29,15-19,1929,0.6320001839517873
SIM,1809,60,na,1869,987
SIM,1944,24,25-29,1968,113
SIM,1872,84,na,1956,205
STAT,1858,43,45-49,1901,1.1773507926732227
STAT,1860,21,50-100,1881,0.34958164824363186
STAT,1941,29,30-34,1970,40.88152490645006
STAT,1823,44,na,1867,1486.2568739898802
SIM,1841,29,na,1870,1800
SIM,1907,38,35-39,1945,6
STAT,1879,20,30-34,1899,18.886160495784907
STAT,1941,25,45-49,1966,1.8058768637392157
SIM,1887,16,25-29,1903,13
SIM,1933,22,20-24,1955,151
STAT,1935,32,30-34,1967,22.02238701592781
STAT,1843,18,50-100,1861,0.04197852960468059
SIM,1881,32,30-34,1913,5
SIM,1858,40,50-100,1898,1
STAT,1913,17,50-100,1930,0.07728821281133624
SIM,1946,16,na,1962,4138
STAT,1879,17,30-34,1896,1.6799381123169919
SIM,1933,20,na,1953,4401
STAT,1891,48,50-100,1939,0.1710630501449571
STAT,1926,35,20-24,1961,0.32616506175443327
SIM,1814,41,30-34,1855,4
SIM,1844,66,na,1910,1085
SIM,1866,43,45-49,1909,3
SIM,1914,17,15-19,1931,10
STAT,1847,102,na,1949,0.21951097004456505
STAT,1855,19,40-44,1874,0.16182731213227539
STAT,1906,17,15-19,1923,8.730338296950507
SIM,1914,28,25-29,1942,69
SIM,1870,18,na,1888,2832
SIM,1876,90,na,1966,210
STAT,1929,34,35-39,1963,11.717335744981174
SIM,1868,68,na,1936,1368
SIM,1917,22,15-19,1939,5
STAT,1882,22,30-34,1904,17.426603856487016
SIM,1869,21,20-24,1890,103
SIM,1927,23,40-44,1950,5
STAT,1892,45,50-100,1937,0.17733172903207978
STAT,1926,29,35-39,1955,18.059681804095767
STAT,1842,44,50-100,1886,0.959183390764059
STAT,1902,37,30-34,1939,1.641837960899871
STAT,1925,42,15-19,1967,0.001878975380205593
SIM,1917,33,25-29,1950,2
SIM,1849,28,20-24,1877,21
SIM,1895,61,na,1956,2482
SIM,1937,33,45-49,1970,2
STAT,1892,34,15-19,1926,0.17893928565114528
STAT,1916,28,na,1944,3895.142061047038
SIM,1855,29,na,1884,2132
STAT,1911,34,40-44,1945,3.811580742152936
SIM,1929,23,na,1952,4413
STAT,1912,46,na,1958,3570.9471536758597
STAT,1872,19,40-44,1891,0.184727588102662
SIM,1891,21,35-39,1912,13
STAT,1879,5,na,1884,2858.3703074226028
STAT,1884,33,45-49,1917,1.7295087318626743
SIM,1840,31,30-34,1871,21
STAT,1871,19,50-100,1890,0.048896004054281995
SIM,1899,19,20-24,1918,36
STAT,1909,22,15-19,1931,4.992441584935203
STAT,1925,34,20-24,1959,2.923465189005048
STAT,1795,63,na,1858,994.980708231783
SIM,1824,30,35-39,1854,15
SIM,1902,4,na,1906,3978
SIM,1944,12,na,1956,4296
STAT,1817,42,45-49,1859,3.661453868063286
STAT,1956,2,na,1958,5260.377405679783
STAT,1874,36,na,1910,2448.2542050078478
STAT,1824,93,na,1917,14.529428369510352
STAT,1828,49,50-100,1877,0.21791785608974745
STAT,1885,28,na,1913,2390.81644283034
SIM,1890,22,30-34,1912,3
SIM,1874,5,na,1879,2684
STAT,1919,23,40-44,1942,3.7059773869944097
STAT,1847,45,35-39,1892,0.10586822625036671
STAT,1884,22,35-39,1906,5.812108986607004
SIM,1907,19,30-34,1926,4
SIM,1938,26,20-24,1964,25
STAT,1922,0,na,1922,5267.200138395996
SIM,1851,36,na,1887,1938
STAT,1905,49,15-19,1954,3.2256756975650386E-4
STAT,1862,54,na,1916,1826.391809495094
SIM,1875,33,45-49,1908,2
SIM,1825,42,45-49,1867,1
STAT,1909,35,20-24,1944,0.25417698522122556
SIM,1839,25,35-39,1864,9
STAT,1824,106,na,1930,0.006036251048195912
SIM,1933,28,35-39,1961,25
STAT,1867,33,45-49,1900,1.6517619251870517
STAT,1851,62,na,1913,1383.935708517659
SIM,1868,28,30-34,1896,23
SIM,1883,36,na,1919,2630
SIM,1898,1,na,1899,3622
STAT,1837,55,na,1892,1410.5519681925384
STAT,1912,40,15-19,1952,0.001511234081639451
SIM,1918,31,na,1949,4262
STAT,1863,95,na,1958,17.98160370277207
STAT,1897,49,50-100,1946,0.18367302242060973
STAT,1940,26,50-100,1966,1.025144023941233
STAT,1792,66,na,1858,735.6723585827926
STAT,1827,33,15-19,1860,0.18379576205813206
STAT,1898,16,35-39,1914,0.7531425692420982
STAT,1965,4,na,1969,4957.516926642745
STAT,1846,91,na,1937,43.97572216083659
STAT,1916,32,20-24,1948,2.541345382063602
STAT,1944,22,30-34,1966,31.33645036824776
SIM,1823,31,30-34,1854,11
STAT,1870,49,35-39,1919,0.1359512646540482
SIM,1924,32,20-24,1956,4
STAT,1915,39,30-34,1954,1.8391400817045123
STAT,1887,34,50-100,1921,1.024354733972617
STAT,1883,21,35-39,1904,5.7850341737317725
SIM,1825,31,35-39,1856,9
STAT,1915,39,50-100,1954,0.4236716337324722
SIM,1893,46,na,1939,2939
STAT,1813,74,na,1887,503.6528605087056
STAT,1848,25,35-39,1873,9.54130370011242
SIM,1905,34,45-49,1939,1
STAT,1888,46,35-39,1934,0.1673694833971119
SIM,1872,21,25-29,1893,73
SIM,1892,21,na,1913,3264
SIM,1866,69,na,1935,1423
STAT,1803,67,na,1870,931.9758138360706
STAT,1814,49,20-24,1863,0.027987560387453637
SIM,1788,70,na,1858,543
STAT,1813,44,35-39,1857,5.677591204284949
SIM,1903,27,40-44,1930,8
STAT,1876,28,50-100,1904,0.6647505053293822
STAT,1858,17,na,1875,2124.6907989486594
STAT,1833,35,50-100,1868,1.1128555092398975
STAT,1867,40,50-100,1907,1.0150602042654713
STAT,1816,93,na,1909,14.942155800351248
STAT,1928,35,30-34,1963,2.332172465436693
SIM,1875,40,50-100,1915,1
STAT,1901,41,20-24,1942,0.015685156413753638
STAT,1920,19,45-49,1939,0.5629321226355257
STAT,1929,33,45-49,1962,2.0190101793858637
SIM,1886,20,15-19,1906,4
STAT,1907,4,na,1911,3901.909366978174
SIM,1920,23,30-34,1943,1
STAT,1915,15,20-24,1930,28.7651496062913
STAT,1925,28,35-39,1953,17.857897331701125
STAT,1838,31,25-29,1869,8.609049751137636
STAT,1950,15,45-49,1965,0.5970720013744174
SIM,1855,18,na,1873,2360
SIM,1821,38,na,1859,1437
SIM,1938,9,na,1947,3866
SIM,1800,79,na,1879,363
STAT,1880,3,na,1883,3211.5644232896857
STAT,1900,69,na,1969,2407.1558688861614
SIM,1868,47,na,1915,2074
STAT,1869,57,na,1926,1973.374221013648
STAT,1885,18,15-19,1903,5.950596258264057
SIM,1898,23,40-44,1921,2
SIM,1820,36,40-44,1856,7
SIM,1943,23,25-29,1966,100
SIM,1933,26,15-19,1959,1
SIM,1887,47,50-100,1934,2
STAT,1874,87,na,1961,304.33491681817236
STAT,1912,23,30-34,1935,27.703598980814554
STAT,1908,25,30-34,1933,37.96393289417218
STAT,1931,39,15-19,1970,0.02564843876066006
STAT,1792,63,na,1855,822.7436
STAT,1841,19,20-24,1860,16.898059747653697
SIM,1839,22,30-34,1861,23
STAT,1796,77,na,1873,328.6957535990057
STAT,1890,23,50-100,1913,0.5017238170563428
STAT,1855,15,25-29,1870,5.133640883670549
STAT,1944,19,50-100,1963,0.4068673468987376
STAT,1882,48,15-19,1930,3.8642151296117453E-4
STAT,1925,26,15-19,1951,0.8455546706652296
SIM,1857,84,na,1941,318
SIM,1893,18,15-19,1911,9
STAT,1879,47,50-100,1926,0.25765552648239226
SIM,1900,33,na,1933,3413
STAT,1935,12,na,1947,5472.643923713663
STAT,1935,23,25-29,1958,127.04203122231196
SIM,1893,35,na,1928,3102
SIM,1916,25,30-34,1941,84
SIM,1919,25,50-100,1944,2
SIM,1821,60,na,1881,1042
STAT,1925,37,25-29,1962,1.1942904124928742
STAT,1917,19,40-44,1936,1.5062056453809545
STAT,1832,34,35-39,1866,8.82188350824764
STAT,1838,30,50-100,1868,0.7781553282390405
STAT,1922,13,na,1935,4625.324243887305
SIM,1940,18,25-29,1958,55
STAT,1901,54,na,1955,2964.8258474358363
STAT,1902,37,50-100,1939,0.37822033141366695
SIM,1846,30,50-100,1876,5
SIM,1863,15,25-29,1878,7
SIM,1839,36,na,1875,1700
SIM,1954,17,45-49,1971,4
STAT,1880,22,20-24,1902,73.0962056693048
SIM,1917,35,na,1952,3834
STAT,1883,16,na,1899,2502.367500758729
STAT,1842,20,35-39,1862,6.7228915378035525
SIM,1865,28,na,1893,2174
SIM,1868,17,na,1885,2368
STAT,1868,34,15-19,1902,0.13628790882158173
STAT,1903,10,na,1913,3725.9592754412993
SIM,1923,15,20-24,1938,200
STAT,1932,18,25-29,1950,57.83737038544467
SIM,1867,43,na,1910,2039
SIM,1901,17,35-39,1918,2
STAT,1911,61,na,1972,3232.3480184820937
STAT,1822,59,na,1881,1174.4520922769007
STAT,1806,54,45-49,1860,0.04023002803568677
STAT,1827,104,na,1931,0.039663760554478816
STAT,1844,47,40-44,1891,0.1348192565042385
STAT,1908,42,15-19,1950,0.0014342409080516686
STAT,1910,44,20-24,1954,0.01663235022750943
STAT,1918,32,30-34,1950,16.902270354423937
SIM,1854,6,na,1860,2704
SIM,1876,19,20-24,1895,16
STAT,1920,30,20-24,1950,2.719683022821631
SIM,1931,24,45-49,1955,1
SIM,1932,25,50-100,1957,2
STAT,1846,40,na,1886,1821.2730306519531
SIM,1780,82,na,1862,202
SIM,1834,59,na,1893,1396
SIM,1925,19,40-44,1944,4
STAT,1864,21,25-29,1885,53.395278026759044
SIM,1892,10,na,1902,3572
STAT,1873,45,45-49,1918,0.24405173201071614
STAT,1835,77,na,1912,648.7676153827213
STAT,1925,13,na,1938,4829.717873002235
SIM,1788,81,na,1869,234
SIM,1902,29,45-49,1931,3
STAT,1796,88,na,1884,45.517541817528446
STAT,1923,24,45-49,1947,1.3145067184650852
STAT,1898,32,35-39,1930,13.866067576254821
STAT,1924,25,45-49,1949,2.0464467926250345
STAT,1820,45,35-39,1865,0.24545282850493702
SIM,1867,54,na,1921,1860
STAT,1875,54,50-100,1929,0.015234063220945929
STAT,1839,18,45-49,1857,0.06022583937472782
STAT,1870,23,15-19,1893,3.2618229688186933
STAT,1874,15,35-39,1889,0.5722334543453124
SIM,1932,25,45-49,1957,9
SIM,1839,41,35-39,1880,3
SIM,1923,39,na,1962,4431
STAT,1821,54,40-44,1875,0.01426188001684765
SIM,1834,67,na,1901,1118
STAT,1848,95,na,1943,10.855254601126402
STAT,1904,15,45-49,1919,0.09511956254470379
STAT,1951,18,35-39,1969,5.046841981978382
STAT,1946,17,45-49,1963,0.5596021499355693
STAT,1872,28,50-100,1900,0.647270571672271
STAT,1861,69,na,1930,1231.6799850686484
SIM,1845,11,na,1856,2413
STAT,1832,44,45-49,1876,1.2185956714465809
SIM,1819,59,na,1878,1135
SIM,1866,32,35-39,1898,12
STAT,1860,44,na,1904,1882.463527365962
STAT,1868,39,50-100,1907,1.1732010887548578
SIM,1856,45,50-100,1901,4
SIM,1911,9,na,1920,4149
STAT,1884,57,na,1941,2001.5824325554108
STAT,1883,72,na,1955,1248.209122204758
STAT,1926,38,25-29,1964,1.2149239172731863
SIM,1888,8,na,1896,3215
STAT,1913,35,40-44,1948,1.5047178261141618
STAT,1871,36,na,1907,2375.422801100311
STAT,1847,42,30-34,1889,0.8656000435115466
STAT,1850,77,na,1927,661.8770086000185
STAT,1952,19,35-39,1971,5.077149970746174
STAT,1895,49,na,1944,2906.039539672347
SIM,1908,21,na,1929,3684
STAT,1894,64,na,1958,2335.9330292148443
STAT,1910,15,15-19,1925,9.114817932151574
STAT,1945,16,45-49,1961,0.5512425543818463
STAT,1926,41,25-29,1967,0.08910002856762242
SIM,1903,45,50-100,1948,1
SIM,1902,18,35-39,1920,2
SIM,1845,51,na,1896,1797
STAT,1919,39,50-100,1958,0.45444949623276065
SIM,1928,27,45-49,1955,2
STAT,1869,43,20-24,1912,0.1548212727723516
STAT,1926,38,na,1964,4642.242550803762
STAT,1882,51,45-49,1933,0.014266117881416514
SIM,1946,2,na,1948,4516
STAT,1930,38,45-49,1968,0.8978393124547498
SIM,1970,0,na,1970,5244
SIM,1846,81,na,1927,253
STAT,1884,45,20-24,1929,0.012071096203609003
STAT,1921,17,40-44,1938,1.610259981623044
STAT,1934,15,30-34,1949,16.735904704237296
STAT,1947,18,15-19,1965,51.6226038981195
SIM,1840,34,35-39,1874,9
STAT,1915,48,20-24,1963,0.011205374748965796
STAT,1879,21,15-19,1900,3.487668624363216
SIM,1854,25,na,1879,2353
STAT,1839,34,50-100,1873,0.7829691473344721
SIM,1901,23,20-24,1924,95
STAT,1825,47,30-34,1872,0.12997812065079445
STAT,1868,19,20-24,1887,17.21839925257526
STAT,1965,7,na,1972,4954.989016358782
STAT,1904,33,40-44,1937,3.594028666376295
SIM,1818,74,na,1892,461
SIM,1840,44,45-49,1884,1
SIM,1888,33,25-29,1921,18
STAT,1873,94,na,1967,75.9876961435827
STAT,1910,26,25-29,1936,64.34560474846735
SIM,1960,7,na,1967,5278
STAT,1849,80,na,1929,483.65129974000314
STAT,1859,28,50-100,1887,0.5248190168623919
STAT,1851,37,30-34,1888,4.0787066631767654
STAT,1902,25,na,1927,3429.2979984277613
STAT,1918,47,35-39,1965,0.1385146520495572
STAT,1935,27,40-44,1962,6.4192749353134655
SIM,1806,49,na,1855,1444
SIM,1887,21,15-19,1908,1
STAT,1913,24,30-34,1937,29.09985772431201
SIM,1877,36,50-100,1913,1
SIM,1908,61,na,1969,2946
STAT,1849,22,40-44,1871,1.969790391333163
STAT,1861,46,35-39,1907,0.11783281868404052
SIM,1848,19,15-19,1867,7
SIM,1921,24,30-34,1945,53
SIM,1875,30,40-44,1905,7
STAT,1924,45,30-34,1969,0.10774937685142462
SIM,1943,16,30-34,1959,16
STAT,1926,27,na,1953,4538.650965165077
SIM,1811,49,45-49,1860,2
STAT,1879,32,25-29,1911,10.795703147552839
STAT,1919,40,25-29,1959,0.07835073794622215
SIM,1921,35,40-44,1956,1
SIM,1943,27,40-44,1970,6
SIM,1800,90,na,1890,40
SIM,1855,42,30-34,1897,1
STAT,1935,16,30-34,1951,16.876379113815027
SIM,1847,34,50-100,1881,5
SIM,1887,32,25-29,1919,3
STAT,1817,54,20-24,1871,0.0014598276622503382
SIM,1824,89,na,1913,33
STAT,1856,39,na,1895,1805.980913765659
STAT,1892,38,30-34,1930,6.721093167586692
SIM,1880,17,na,1897,2444
STAT,1949,15,na,1964,4327.063060857509
SIM,1847,77,na,1924,586
SIM,1942,15,30-34,1957,24
STAT,1919,15,35-39,1934,0.9437019381666018
SIM,1917,26,30-34,1943,47
STAT,1895,48,50-100,1943,0.1804316936876505
STAT,1852,50,20-24,1902,5.676742686536627E-4
STAT,1857,54,20-24,1911,5.656654843383391E-4
SIM,1932,35,na,1967,5791
STAT,1919,48,35-39,1967,0.1408028623494847
SIM,1806,60,na,1866,1107
SIM,1846,31,25-29,1877,12
SIM,1858,69,na,1927,1082
STAT,1841,47,15-19,1888,3.004816200920322E-4
STAT,1919,26,45-49,1945,1.8912023319819176
SIM,1917,37,40-44,1954,1
STAT,1802,109,na,1911,2.48572148786486E-4
STAT,1838,20,15-19,1858,2.9068349496031347
SIM,1932,25,15-19,1957,1
STAT,1848,21,40-44,1869,2.0865410427064632
SIM,1904,22,35-39,1926,13
SIM,1912,33,40-44,1945,4
STAT,1902,33,15-19,1935,0.2023950577794471
SIM,1865,31,35-39,1896,14
STAT,1871,50,30-34,1921,0.006058765811664276
SIM,1856,21,40-44,1877,1
SIM,1869,24,25-29,1893,75
STAT,1911,21,na,1932,3662.3884944944916
STAT,1915,35,na,1950,3871.420708727231
STAT,1912,42,35-39,1954,0.19593948685472282
STAT,1853,104,na,1957,0.08205113747240009
STAT,1914,50,na,1964,3642.9771738245067
STAT,1864,80,na,1944,563.7807256513735
SIM,1814,44,35-39,1858,3
SIM,1882,43,na,1925,2078
STAT,1841,49,50-100,1890,0.1798285029681914
SIM,1927,15,35-39,1942,8
STAT,1824,37,na,1861,1423.772378783909
STAT,1873,35,35-39,1908,7.310810431372244
STAT,1909,26,30-34,1935,38.238763165727505
STAT,1895,33,20-24,1928,3.5501901884422793
STAT,1857,31,35-39,1888,8.115720546079181
STAT,1913,43,35-39,1956,0.19781706759751017
SIM,1866,80,na,1946,646
SIM,1888,13,na,1901,3197
SIM,1867,3,na,1870,2825
STAT,1935,35,35-39,1970,3.4230508165456954
SIM,1892,50,na,1942,2973
SIM,1927,26,45-49,1953,4
SIM,1943,27,na,1970,3985
SIM,1911,21,30-34,1932,46
SIM,1886,20,45-49,1906,5
SIM,1846,20,15-19,1866,3
SIM,1905,23,35-39,1928,8
SIM,1955,4,na,1959,5061
SIM,1868,23,25-29,1891,64
STAT,1868,44,25-29,1912,0.611501264918222
STAT,1909,37,40-44,1946,1.4298429005438624
SIM,1947,12,na,1959,4832
STAT,1875,72,na,1947,1309.8966790523139
STAT,1813,41,50-100,1854,4.073407713754328
STAT,1828,42,20-24,1870,0.15164329153943953
STAT,1858,32,35-39,1890,8.024551231160723
STAT,1880,35,35-39,1915,7.573572509566903
SIM,1881,35,35-39,1916,15
STAT,1860,84,na,1944,274.65556619553985
SIM,1918,38,40-44,1956,1
SIM,1876,44,25-29,1920,3
STAT,1836,70,na,1906,884.6719420011783
STAT,1804,60,na,1864,917.0963477272852
STAT,1897,22,50-100,1919,0.5521721921029081
STAT,1879,36,40-44,1915,4.63609407951561
SIM,1837,53,na,1890,1284
SIM,1905,20,30-34,1925,47
SIM,1890,22,25-29,1912,3
STAT,1820,42,30-34,1862,2.169214332250222
STAT,1863,29,40-44,1892,2.661540021038946
SIM,1884,55,na,1939,2176
STAT,1892,39,20-24,1931,0.9671251908806999
STAT,1902,44,40-44,1946,0.21992079093959194
SIM,1901,35,30-34,1936,1
STAT,1822,50,40-44,1872,0.01564442236552392
STAT,1903,34,50-100,1937,0.7502819653821363
SIM,1818,37,30-34,1855,14
SIM,1919,20,15-19,1939,4
STAT,1936,27,35-39,1963,14.50574113651033
STAT,1879,20,25-29,1899,60.69686861235286
STAT,1942,14,na,1956,4143.191692298072
SIM,1833,63,na,1896,1279
SIM,1930,15,50-100,1945,1
SIM,1797,61,na,1858,866
SIM,1827,37,40-44,1864,15
SIM,1924,8,na,1932,4828
STAT,1805,53,45-49,1858,0.05847166772352054
SIM,1928,20,25-29,1948,173
STAT,1837,26,35-39,1863,8.509919815400332
STAT,1855,20,na,1875,1907.4873267236485
STAT,1877,28,30-34,1905,26.15779879945561
SIM,1793,71,na,1864,526
SIM,1829,58,na,1887,1390
STAT,1856,20,30-34,1876,16.251670116633182
STAT,1931,18,45-49,1949,0.659081365209911
STAT,1869,2,na,1871,3276.401115450906
SIM,1936,6,na,1942,3973
STAT,1851,30,na,1881,1920.1086121917513
STAT,1868,72,na,1940,1219.0609252180777
SIM,1789,66,na,1855,704
SIM,1883,15,15-19,1898,5
SIM,1888,45,na,1933,2930
STAT,1888,43,50-100,1931,1.2503109494009497
STAT,1900,25,20-24,1925,16.571022699417473
STAT,1930,20,15-19,1950,6.933611458322705
STAT,1875,15,15-19,1890,6.184018815622802
STAT,1854,45,35-39,1899,0.10611560301940594
STAT,1894,47,30-34,1941,0.07067153453123455
SIM,1823,31,25-29,1854,8
SIM,1808,64,na,1872,805
STAT,1871,24,15-19,1895,3.289597392373317
SIM,1885,28,30-34,1913,35
SIM,1924,35,25-29,1959,1
STAT,1843,37,15-19,1880,0.04421505849058748
STAT,1916,28,20-24,1944,18.979920799087296
SIM,1905,64,na,1969,2870
STAT,1872,44,45-49,1916,1.4992063338750303
STAT,1916,35,25-29,1951,1.0272020161869646
SIM,1871,35,35-39,1906,10
SIM,1896,29,45-49,1925,2
STAT,1848,48,15-19,1896,3.224795762316692E-4
STAT,1914,27,15-19,1941,0.7180384784824669
STAT,1848,20,50-100,1868,0.4112780634841216
SIM,1861,60,na,1921,1603
STAT,1814,48,45-49,1862,0.5597402633738107
SIM,1887,36,40-44,1923,5
SIM,1924,15,15-19,1939,54
STAT,1856,45,45-49,1901,0.18456761336508135
SIM,1863,37,50-100,1900,1
STAT,1887,31,15-19,1918,0.16124169003175975
STAT,1787,106,na,1893,0.0039540447957980675
SIM,1851,17,20-24,1868,21
STAT,1847,42,25-29,1889,0.48348831457022495
STAT,1867,21,45-49,1888,0.670856867811373
SIM,1859,56,na,1915,1919
STAT,1909,38,30-34,1947,1.732188831151108
SIM,1924,28,20-24,1952,26
STAT,1831,45,40-44,1876,0.1312024073738795
STAT,1825,48,20-24,1873,0.015891259750105344
STAT,1917,13,na,1930,4283.126642887427
STAT,1843,17,20-24,1860,15.280636583362554
STAT,1917,15,na,1932,4214.746661132914
SIM,1885,40,45-49,1925,1
SIM,1949,16,30-34,1965,12
STAT,1848,32,50-100,1880,0.8723901456134908
SIM,1831,62,na,1893,1245
SIM,1950,18,20-24,1968,152
STAT,1908,29,40-44,1937,4.416098909723715
SIM,1836,93,na,1929,12
SIM,1892,72,na,1964,1957
STAT,1845,34,15-19,1879,0.12117930709606688
STAT,1885,42,na,1927,2320.715820191997
STAT,1840,78,na,1918,547.7045818144909
STAT,1786,89,na,1875,38.627418926586266
STAT,1927,34,30-34,1961,19.563686151510172
SIM,1910,28,35-39,1938,19
STAT,1942,18,20-24,1960,143.00460377628
STAT,1920,37,40-44,1957,1.6551481259686531
STAT,1946,26,na,1972,4216.5953728321765
SIM,1889,42,50-100,1931,6
SIM,1912,36,45-49,1948,2
SIM,1951,17,25-29,1968,75
SIM,1880,44,45-49,1924,9
STAT,1934,19,40-44,1953,1.9013803194487964
STAT,1844,16,25-29,1860,5.732970529894593
SIM,1919,33,35-39,1952,3
STAT,1848,9,na,1857,2465.8526912229067
STAT,1905,28,45-49,1933,1.615443367117949
STAT,1941,29,25-29,1970,68.67419092643279
STAT,1872,24,na,1896,2386.485821318781
SIM,1905,42,na,1947,3518
STAT,1792,95,na,1887,2.545442980930715
STAT,1880,25,25-29,1905,45.17397099478257
STAT,1910,47,25-29,1957,0.04993232400523387
STAT,1852,17,30-34,1869,1.461970878044764
STAT,1874,25,na,1899,2484.8620152691
SIM,1892,18,20-24,1910,30
STAT,1919,41,15-19,1960,0.0016827212191538581
STAT,1863,16,35-39,1879,0.5636360223336626
STAT,1889,49,15-19,1938,2.7513506856484356E-4
STAT,1894,34,25-29,1928,13.204790235986703
SIM,1930,31,na,1961,5272
STAT,1929,31,30-34,1960,20.239269258747754
STAT,1899,49,15-19,1948,3.06231543860768E-4
SIM,1889,33,40-44,1922,7
STAT,1875,34,15-19,1909,0.1464431149152275
STAT,1902,28,35-39,1930,13.72305435999318
STAT,1826,47,25-29,1873,0.056759111489280444
STAT,1943,17,25-29,1960,46.40047101488364
STAT,1866,49,20-24,1915,0.01098846797095871
SIM,1879,43,25-29,1922,1
STAT,1821,38,35-39,1859,13.119446918218157
STAT,1843,44,20-24,1887,0.10749623947385752
STAT,1831,43,45-49,1874,1.1421673755772739
STAT,1851,31,35-39,1882,8.064413527488481
STAT,1920,17,30-34,1937,13.809604663726784
SIM,1896,9,na,1905,3475
STAT,1837,39,40-44,1876,3.5612581278646473
SIM,1865,19,15-19,1884,9
STAT,1885,50,na,1935,2195.76779356369
STAT,1876,54,30-34,1930,0.006036870030901009
SIM,1888,67,na,1955,2034
STAT,1827,43,25-29,1870,0.6790163657938091
SIM,1860,17,30-34,1877,5
STAT,1924,22,40-44,1946,4.009227139060139
STAT,1869,17,40-44,1886,0.18209026989038637
STAT,1890,15,40-44,1905,0.22678057282142736
STAT,1820,39,30-34,1859,11.303918673667116
SIM,1806,63,na,1869,968
STAT,1868,70,na,1938,1354.3747239707313
STAT,1882,22,25-29,1904,56.00610483389594
SIM,1907,32,50-100,1939,3
SIM,1913,28,45-49,1941,2
SIM,1831,24,40-44,1855,2
STAT,1844,68,na,1912,1209.0857521658897
SIM,1937,31,30-34,1968,20
STAT,1842,87,na,1929,158.62167996173739
SIM,1890,35,45-49,1925,4
STAT,1877,37,50-100,1914,1.2798276861996096
STAT,1817,80,na,1897,283.0216179203798
SIM,1910,44,40-44,1954,1
STAT,1857,19,15-19,1876,5.433539483715417
SIM,1894,28,40-44,1922,11
STAT,1872,46,40-44,1918,0.17433361982719525
STAT,1884,18,20-24,1902,17.611265958515087
STAT,1886,28,40-44,1914,3.183203915644755
SIM,1781,78,na,1859,259
STAT,1922,25,40-44,1947,5.364362344495281
SIM,1804,82,na,1886,163
SIM,1930,25,40-44,1955,7
STAT,1895,46,35-39,1941,0.10445645775229592
STAT,1942,25,25-29,1967,69.81012054716741
STAT,1878,15,na,1893,2660.2867187802917
SIM,1844,80,na,1924,361
STAT,1909,15,50-100,1924,0.07448429809581217
SIM,1916,22,50-100,1938,4
SIM,1895,15,na,1910,3348
STAT,1819,37,40-44,1856,12.702102794772989
SIM,1875,94,na,1969,47
STAT,1877,55,na,1932,2155.4328377569436
SIM,1821,34,25-29,1855,12
SIM,1861,33,25-29,1894,3
SIM,1842,22,na,1864,1949
SIM,1884,38,25-29,1922,5
SIM,1849,38,30-34,1887,6
SIM,1942,24,20-24,1966,107
SIM,1891,25,na,1916,3078
STAT,1849,38,20-24,1887,0.610341067440678
SIM,1884,23,na,1907,2371
SIM,1826,83,na,1909,278
STAT,1888,40,20-24,1928,0.19123320661092924
STAT,1869,46,25-29,1915,0.056721395156150704
SIM,1839,34,na,1873,1770
STAT,1846,54,45-49,1900,0.010710394476352404
SIM,1870,17,30-34,1887,5
STAT,1908,30,na,1938,3632.694496056805
STAT,1835,43,50-100,1878,0.9383496526759131
SIM,1797,93,na,1890,6
SIM,1851,41,50-100,1892,1
SIM,1923,19,15-19,1942,70
STAT,1864,28,45-49,1892,1.0083540815119456
SIM,1833,21,40-44,1854,2
SIM,1945,23,35-39,1968,17
STAT,1915,19,15-19,1934,9.533081453014315
SIM,1842,31,35-39,1873,10
STAT,1886,35,15-19,1921,0.06045154608678568
STAT,1899,29,20-24,1928,16.145348503327266
STAT,1819,61,na,1880,1043.5045752145497
STAT,1897,53,na,1950,2868.782550374102
STAT,1951,6,na,1957,4729.665335093389
STAT,1819,44,15-19,1863,0.02776470661685784
STAT,1917,47,na,1964,3873.329857171395
SIM,1886,24,30-34,1910,45
SIM,1795,80,na,1875,154
SIM,1925,24,20-24,1949,161
STAT,1938,17,na,1955,3665.4715937902483
STAT,1894,1,na,1895,3539.339251428251
STAT,1850,6,na,1856,2334.322752348
STAT,1915,39,25-29,1954,0.9935584294898152
SIM,1904,17,na,1921,3796
SIM,1938,24,50-100,1962,1
SIM,1932,22,40-44,1954,5
STAT,1859,20,40-44,1879,1.9580024013388815
STAT,1878,21,20-24,1899,72.46976709325928
SIM,1888,24,35-39,1912,10
STAT,1838,35,40-44,1873,3.6101974529959286
SIM,1855,72,na,1927,1086
STAT,1917,24,20-24,1941,118.54215049883481
STAT,1928,40,50-100,1968,0.1517972798114989
STAT,1934,24,20-24,1958,150.88821326142477
SIM,1857,38,20-24,1895,5
STAT,1904,16,35-39,1920,0.797262643659981
STAT,1859,27,25-29,1886,34.95608751476529
STAT,1878,24,30-34,1902,18.558462169145386
STAT,1860,23,15-19,1883,2.7876492704389286
STAT,1871,29,35-39,1900,9.61276954450264
SIM,1912,16,35-39,1928,1
STAT,1904,40,na,1944,3395.4425918563256
STAT,1908,49,35-39,1957,0.11701324341375724
SIM,1923,39,25-29,1962,1
STAT,1904,36,45-49,1940,0.6266526496347055
STAT,1770,112,na,1882,4.038232667332967E-4
SIM,1852,16,25-29,1868,6
STAT,1827,88,na,1915,81.6368831556047
SIM,1902,27,30-34,1929,69
STAT,1855,46,40-44,1901,0.12923168227759993
STAT,1925,21,45-49,1946,1.3652283065769726
SIM,1935,34,30-34,1969,30
STAT,1858,38,30-34,1896,4.202139421991685
STAT,1826,63,na,1889,990.1107471914349
STAT,1834,31,35-39,1865,7.806102581831581
STAT,1841,38,na,1879,1867.5924910796043
SIM,1883,33,50-100,1916,2
STAT,1917,44,15-19,1961,0.001612284382784487
SIM,1867,27,25-29,1894,3
STAT,1767,96,na,1863,1.1717979497175883
STAT,1867,48,25-29,1915,0.05410193927710745
SIM,1862,20,na,1882,2219
STAT,1853,33,25-29,1886,8.63264483396644
SIM,1847,23,35-39,1870,4
SIM,1867,51,na,1918,1903
SIM,1833,41,35-39,1874,6
STAT,1868,27,na,1895,2303.6891009579044
SIM,1897,25,45-49,1922,6
SIM,1916,21,45-49,1937,2
SIM,1846,35,40-44,1881,9
STAT,1877,25,50-100,1902,0.6713542581881996
STAT,1813,49,40-44,1862,0.4802444606842968
STAT,1943,3,na,1946,4305.565246101068
STAT,1826,49,na,1875,1366.3022435454573
STAT,1830,49,40-44,1879,0.1395350164892121
SIM,1816,41,35-39,1857,2
STAT,1858,94,na,1952,15.836699835333247
STAT,1892,32,35-39,1924,12.834832697469313
STAT,1881,39,45-49,1920,1.9212566099152848
STAT,1918,23,25-29,1941,100.26565192580871
SIM,1905,10,na,1915,3892
SIM,1876,26,na,1902,2729
SIM,1884,77,na,1961,1027
SIM,1921,20,15-19,1941,4
STAT,1895,36,25-29,1931,3.815833467103069
STAT,1897,75,na,1972,1871.7050502365
STAT,1935,31,50-100,1966,1.156354578442741
SIM,1797,95,na,1892,3
SIM,1883,32,35-39,1915,12
STAT,1875,32,35-39,1907,10.503969951559869
STAT,1909,18,na,1927,3812.0078961156646
SIM,1916,34,20-24,1950,1
STAT,1837,26,50-100,1863,0.5641798429712647
STAT,1840,38,45-49,1878,1.6357202777767559
STAT,1831,93,na,1924,18.36525220780065
STAT,1937,23,35-39,1960,9.253712965529523
STAT,1908,21,45-49,1929,1.0473420936091529
SIM,1813,43,na,1856,1441
SIM,1868,38,40-44,1906,1
STAT,1829,102,na,1931,0.1728670886877426
STAT,1889,24,na,1913,2926.9789738550317
STAT,1809,102,na,1911,0.13537322057156773
STAT,1839,99,na,1938,1.3427003424377955
STAT,1850,103,na,1953,0.10989143405954686
STAT,1899,16,15-19,1915,8.246392245218088
SIM,1821,52,na,1873,1193
STAT,1825,41,35-39,1866,2.656942067329532
SIM,1926,23,25-29,1949,110
STAT,1867,28,30-34,1895,23.869258530968153
STAT,1889,25,45-49,1914,1.392146193475501
SIM,1906,32,40-44,1938,4
STAT,1839,23,35-39,1862,5.277640057789039
STAT,1853,46,30-34,1899,0.0802786088600092
SIM,1854,33,na,1887,2193
STAT,1776,79,na,1855,226.48293
STAT,1834,33,15-19,1867,0.10751382696659142
STAT,1896,34,na,1930,3162.99567911279
SIM,1925,39,35-39,1964,7
SIM,1927,18,50-100,1945,1
STAT,1914,20,30-34,1934,28.59898186529437
SIM,1880,20,15-19,1900,3
STAT,1834,50,na,1884,1367.1961491824693
STAT,1861,43,30-34,1904,0.9579235127503292
SIM,1793,89,na,1882,23
STAT,1826,41,na,1867,1505.6586890694275
STAT,1839,81,na,1920,383.3873636509996
STAT,1862,39,35-39,1901,6.1070559996642375
STAT,1858,2,na,1860,2772.0562539381463
STAT,1893,71,na,1964,1964.3769820882055
STAT,1908,34,20-24,1942,2.30425582011932
SIM,1848,19,na,1867,2104
SIM,1895,34,50-100,1929,1
STAT,1848,50,na,1898,1783.2347477633457
SIM,1804,80,na,1884,226
STAT,1917,39,35-39,1956,2.5204599405940873
SIM,1870,39,35-39,1909,13
SIM,1914,25,na,1939,4010
SIM,1845,23,30-34,1868,27
STAT,1891,23,50-100,1914,0.5083573197323403
STAT,1904,30,15-19,1934,0.20806750011285022
STAT,1849,25,15-19,1874,0.4266015313059212
STAT,1860,17,20-24,1877,16.881321267834362
STAT,1864,66,na,1930,1493.7728258378381
SIM,1944,24,30-34,1968,35
STAT,1837,23,30-34,1860,15.79344642172609
SIM,1858,37,25-29,1895,5
STAT,1805,50,40-44,1855,0.04506322722124444
SIM,1895,47,na,1942,3045
STAT,1934,36,30-34,1970,2.543637372065745
STAT,1911,23,15-19,1934,5.077577650475336
STAT,1829,34,30-34,1863,14.793899776040828
STAT,1894,28,30-34,1922,32.629652751771985
STAT,1846,29,40-44,1875,2.710766804122139
SIM,1892,24,15-19,1916,7
STAT,1903,24,35-39,1927,8.341285071331548
SIM,1907,35,25-29,1942,1
SIM,1842,54,na,1896,1479
STAT,1786,104,na,1890,0.03564119188042561
STAT,1877,87,na,1964,365.78459429119283
STAT,1852,34,20-24,1886,2.0788829086641494
STAT,1835,37,25-29,1872,2.6726481008058327
STAT,1839,20,30-34,1859,16.461568564777505
STAT,1919,47,45-49,1966,0.2380150781182648
SIM,1901,38,35-39,1939,4
STAT,1809,69,na,1878,826.2977327581364
STAT,1837,45,35-39,1882,0.1017182733619178
STAT,1853,29,50-100,1882,0.5497004442193255
SIM,1925,19,na,1944,4468
STAT,1866,42,35-39,1908,1.6914470139258049
STAT,1919,27,35-39,1946,16.37901145095295
SIM,1864,32,25-29,1896,24
STAT,1898,39,15-19,1937,0.016428426338218602
SIM,1927,27,35-39,1954,4
STAT,1897,46,45-49,1943,0.18076903897835273
STAT,1872,41,40-44,1913,2.2942960531070717
SIM,1853,49,na,1902,1653
SIM,1868,90,na,1958,43
STAT,1853,52,50-100,1905,0.012423130735699414
STAT,1840,24,50-100,1864,0.35832237325909194
STAT,1828,45,25-29,1873,0.05388799107844215
STAT,1864,35,50-100,1899,1.1295758032595815
SIM,1874,42,35-39,1916,4
SIM,1817,55,na,1872,1344
SIM,1909,23,25-29,1932,108
SIM,1858,21,45-49,1879,3
STAT,1856,23,35-39,1879,5.210345835270994
STAT,1856,32,25-29,1888,8.028428142321324
STAT,1858,31,45-49,1889,1.3962040965586093
SIM,1837,34,30-34,1871,14
STAT,1871,9,na,1880,2703.7941648104647
SIM,1911,24,35-39,1935,11
SIM,1936,28,na,1964,3862
STAT,1884,24,15-19,1908,3.2652416952516514
STAT,1898,20,35-39,1918,8.037663309910085
STAT,1843,19,na,1862,1955.257460674489
SIM,1941,15,15-19,1956,45
STAT,1891,36,50-100,1927,1.5426548664031308
STAT,1932,39,50-100,1971,0.568871842413559
STAT,1900,28,25-29,1928,59.14045554127937
SIM,1843,41,na,1884,2164
SIM,1846,38,45-49,1884,2
STAT,1770,110,na,1880,0.0010282850659173728
SIM,1953,17,35-39,1970,7
SIM,1929,35,45-49,1964,3
STAT,1924,17,na,1941,4429.230757840851
SIM,1853,91,na,1944,27
STAT,1839,67,na,1906,1123.876437102532
SIM,1860,34,20-24,1894,2
SIM,1885,34,25-29,1919,17
STAT,1873,20,30-34,1893,18.346986442975123
SIM,1843,37,25-29,1880,9
SIM,1877,53,na,1930,2229
STAT,1897,21,na,1918,3212.0832500294505
STAT,1877,34,25-29,1911,10.5857162749977
SIM,1857,42,35-39,1899,1
STAT,1841,71,na,1912,998.1833117339714
SIM,1863,48,50-100,1911,1
STAT,1858,48,15-19,1906,3.1297182380587925E-4
STAT,1901,29,30-34,1930,35.39915441493728
STAT,1943,29,35-39,1972,16.129030939128526
SIM,1861,27,30-34,1888,27
SIM,1877,75,na,1952,992
SIM,1847,85,na,1932,178
STAT,1848,24,45-49,1872,0.6833036002147573
STAT,1849,44,15-19,1893,0.01065151256260954
STAT,1794,76,na,1870,384.5564510799676
STAT,1826,44,20-24,1870,0.1591880860373506
STAT,1924,29,25-29,1953,76.88865704728985
STAT,1908,46,30-34,1954,0.08199665567300772
STAT,1762,101,na,1863,0.0865306649157225
SIM,1934,17,25-29,1951,83
STAT,1817,53,50-100,1870,0.030481418749165805
STAT,1838,38,45-49,1876,1.593635818639918
STAT,1842,27,15-19,1869,0.5051517418876802
STAT,1862,34,15-19,1896,0.12314742061875
STAT,1920,32,50-100,1952,0.9145295035650024
STAT,1867,23,na,1890,2242.7345548406383
SIM,1866,28,20-24,1894,15
STAT,1864,39,45-49,1903,1.7985525487354683
STAT,1939,16,na,1955,3720.512768209891
STAT,1858,28,20-24,1886,9.447788681551824
SIM,1851,39,na,1890,1848
STAT,1853,27,30-34,1880,24.124647259529702
STAT,1833,53,20-24,1886,5.294432375764537E-4
STAT,1834,36,na,1870,1602.2796387137278
SIM,1893,17,25-29,1910,7
STAT,1905,44,na,1949,3340.579255425974
STAT,1933,15,15-19,1948,61.67613774649432
STAT,1941,26,20-24,1967,19.072862276632087
SIM,1811,93,na,1904,11
STAT,1834,27,20-24,1861,9.161530160558275
STAT,1826,43,50-100,1869,1.0804036309789127
SIM,1854,29,40-44,1883,6
STAT,1876,38,25-29,1914,2.9876578057803167
SIM,1822,79,na,1901,291
STAT,1885,17,25-29,1902,5.696975885648605
SIM,1872,52,na,1924,2397
SIM,1931,17,15-19,1948,48
STAT,1864,25,40-44,1889,2.7592993376317376
STAT,1928,20,15-19,1948,6.757874153067317
SIM,1834,43,50-100,1877,1
SIM,1862,35,25-29,1897,2
STAT,1805,79,na,1884,344.62283295942115
STAT,1931,27,15-19,1958,0.921122047832168
SIM,1772,87,na,1859,34
SIM,1921,40,na,1961,4099
STAT,1923,17,15-19,1940,53.84449746119706
STAT,1886,16,50-100,1902,0.05237291012647611
SIM,1918,34,30-34,1952,26
STAT,1822,53,45-49,1875,0.020317202136650968
STAT,1860,21,35-39,1881,5.002512800855662
STAT,1809,47,25-29,1856,0.2060524990818344
STAT,1844,60,na,1904,1508.9304224553816
STAT,1854,39,40-44,1893,3.252192388920743
SIM,1864,57,na,1921,2211
STAT,1878,41,15-19,1919,0.014544495712776875
STAT,1941,22,40-44,1963,3.5080656447869663
SIM,1871,88,na,1959,246
STAT,1819,93,na,1912,14.85710646137982
STAT,1831,40,40-44,1871,1.784868353768399
STAT,1854,35,25-29,1889,2.1938614245735124
STAT,1922,16,na,1938,4313.941532024886
SIM,1936,20,15-19,1956,9
SIM,1932,29,25-29,1961,131
STAT,1893,35,20-24,1928,0.997957141835539
SIM,1872,25,40-44,1897,2
SIM,1800,76,na,1876,406
SIM,1951,17,na,1968,4645
STAT,1926,17,25-29,1943,53.69765742113172
STAT,1829,30,15-19,1859,0.13375090984975802
SIM,1947,20,35-39,1967,14
SIM,1838,28,45-49,1866,1
SIM,1936,16,45-49,1952,2
STAT,1880,0,na,1880,3824.97871324063
SIM,1819,81,na,1900,265
SIM,1926,35,35-39,1961,9
SIM,1875,28,30-34,1903,2
SIM,1908,27,25-29,1935,6
STAT,1850,37,15-19,1887,0.04367922608202296
STAT,1806,94,na,1900,6.73854371069029
SIM,1940,19,15-19,1959,47
STAT,1875,28,20-24,1903,12.125234827996774
SIM,1886,27,35-39,1913,14
STAT,1934,27,25-29,1961,89.4677453838064
SIM,1888,21,30-34,1909,33
STAT,1801,107,na,1908,0.0018768573501343256
STAT,1815,44,45-49,1859,3.5018214259768894
STAT,1884,38,15-19,1922,0.05565225177213299
STAT,1936,21,20-24,1957,107.36020364043287
STAT,1775,109,na,1884,0.0023193926269933925
SIM,1855,30,30-34,1885,30
STAT,1932,19,15-19,1951,60.40432459087883
SIM,1859,22,15-19,1881,2
STAT,1854,20,20-24,1874,61.64881446065967
SIM,1942,27,25-29,1969,8
STAT,1859,24,20-24,1883,57.250168741013084
SIM,1849,19,30-34,1868,4
STAT,1863,30,15-19,1893,0.12846354429668955
STAT,1838,52,25-29,1890,0.0023584945363744176
SIM,1904,35,40-44,1939,1
STAT,1935,28,30-34,1963,53.93707209086431
SIM,1862,76,na,1938,809
STAT,1882,35,45-49,1917,1.9688453203069853
SIM,1890,25,35-39,1915,12
SIM,1904,15,na,1919,3824
STAT,1925,25,25-29,1950,79.09955704448443
SIM,1944,21,20-24,1965,121
STAT,1831,95,na,1926,8.354923036989618
STAT,1896,21,15-19,1917,4.423850959896724
STAT,1947,20,25-29,1967,105.52209613086089
STAT,1866,22,40-44,1888,1.9647584283410626
STAT,1878,27,35-39,1905,10.116465071946802
STAT,1878,46,35-39,1924,0.14720041440838538
SIM,1872,27,50-100,1899,3
STAT,1914,58,na,1972,3487.2563025245413
SIM,1874,22,40-44,1896,2
STAT,1862,51,25-29,1913,0.003104197233520975
SIM,1853,17,30-34,1870,2
SIM,1837,21,na,1858,1699
SIM,1859,88,na,1947,81
STAT,1897,19,45-49,1916,0.087976170736508
SIM,1886,36,na,1922,2707
STAT,1810,49,50-100,1859,0.9134833405526707
SIM,1833,31,na,1864,1972
STAT,1880,51,40-44,1931,0.0112202171713451
SIM,1791,90,na,1881,2
STAT,1774,90,na,1864,18.682160640927414
STAT,1901,17,20-24,1918,25.101073078072794
SIM,1828,39,40-44,1867,3
SIM,1914,28,50-100,1942,1
STAT,1930,26,45-49,1956,2.221292262503848
STAT,1939,20,35-39,1959,9.55298001322975
STAT,1918,35,35-39,1953,2.598261855363089
SIM,1810,54,na,1864,1262
STAT,1890,18,45-49,1908,0.08040725641642303
SIM,1863,20,15-19,1883,4
SIM,1876,38,30-34,1914,16
SIM,1933,25,25-29,1958,94
STAT,1913,31,na,1944,3812.115120980149
STAT,1845,27,40-44,1872,2.664180507685534
SIM,1871,37,na,1908,2262
SIM,1887,20,25-29,1907,68
STAT,1828,49,40-44,1877,0.15190365223864374
SIM,1831,27,45-49,1858,2
STAT,1823,107,na,1930,0.0026082216684215694
SIM,1819,36,35-39,1855,14
STAT,1818,97,na,1915,2.7678156695021165
SIM,1899,22,45-49,1921,1
SIM,1914,24,45-49,1938,1
STAT,1945,17,35-39,1962,4.629141791989374
STAT,1803,51,50-100,1854,0.06687193335843836
STAT,1877,40,45-49,1917,1.575874922900454
SIM,1853,27,40-44,1880,7
STAT,1882,25,35-39,1907,9.504049760214249
STAT,1774,110,na,1884,0.001290052897714731
STAT,1915,36,20-24,1951,0.27000365835256157
SIM,1930,28,50-100,1958,3
STAT,1862,43,50-100,1905,0.9148023728192457
STAT,1899,32,45-49,1931,2.4172023723273512
STAT,1849,42,35-39,1891,1.4140469246395289
SIM,1937,8,na,1945,3812
STAT,1868,38,30-34,1906,5.11907560976422
SIM,1897,28,na,1925,3289
STAT,1928,16,45-49,1944,0.6377723612956858
STAT,1841,21,25-29,1862,54.622798833065644
STAT,1903,46,50-100,1949,0.19984190552064698
SIM,1875,6,na,1881,2668
SIM,1783,79,na,1862,294
STAT,1859,23,45-49,1882,0.5835007084849247
STAT,1906,24,45-49,1930,1.0194103044965301
STAT,1854,24,50-100,1878,0.3544425386773137
STAT,1843,47,25-29,1890,0.038668226761916856
STAT,1881,38,na,1919,2282.3212473151084
STAT,1790,86,na,1876,61.81825197345262
STAT,1859,36,na,1895,1923.055505773612
STAT,1871,90,na,1961,149.06436129686486
STAT,1824,49,50-100,1873,0.279580462322893
SIM,1925,15,30-34,1940,21
SIM,1866,31,45-49,1897,4
STAT,1927,37,35-39,1964,3.0395438171447124
STAT,1855,48,50-100,1903,0.18254536305921454
STAT,1871,17,40-44,1888,0.18471465670976095
SIM,1827,27,30-34,1854,26
SIM,1830,34,35-39,1864,13
SIM,1851,82,na,1933,428
STAT,1861,27,25-29,1888,35.760676492188324
STAT,1925,10,na,1935,4851.857104793599
SIM,1888,42,50-100,1930,2
SIM,1878,36,50-100,1914,2
SIM,1894,18,30-34,1912,2
SIM,1912,44,na,1956,3408
SIM,1943,28,30-34,1971,45
STAT,1836,49,35-39,1885,0.09008868110097298
SIM,1880,41,40-44,1921,6
STAT,1841,34,45-49,1875,1.5496890926889628
SIM,1838,42,25-29,1880,4
SIM,1862,74,na,1936,1004
SIM,1944,15,na,1959,3999
SIM,1915,25,15-19,1940,3
STAT,1801,63,na,1864,940.3265714343715
STAT,1828,30,20-24,1858,3.4135671749180143
STAT,1933,37,50-100,1970,0.5778849723871046
SIM,1775,92,na,1867,18
STAT,1837,40,15-19,1877,0.011405683314444031
STAT,1822,34,35-39,1856,22.6218724441194
STAT,1864,88,na,1952,125.11850353803676
SIM,1847,20,30-34,1867,24
SIM,1916,5,na,1921,4261
SIM,1823,34,35-39,1857,9
STAT,1908,37,25-29,1945,0.9305764208190868
SIM,1845,26,35-39,1871,15
STAT,1847,30,30-34,1877,15.671152555319447
STAT,1886,18,30-34,1904,1.6952380272643508
SIM,1867,24,20-24,1891,64
STAT,1867,45,20-24,1912,0.011528462815517303
SIM,1907,15,15-19,1922,7
STAT,1817,47,15-19,1864,8.601282695883747E-4
STAT,1917,15,30-34,1932,2.659858890660833
SIM,1912,8,na,1920,3991
STAT,1906,28,50-100,1934,0.9377411900034069
STAT,1851,48,na,1899,1682.146782248084
STAT,1919,28,na,1947,4072.46944945877
SIM,1939,20,40-44,1959,5
SIM,1921,29,na,1950,4033
STAT,1876,28,15-19,1904,0.47147503705167537
STAT,1891,38,15-19,1929,0.06987176333071082
SIM,1949,19,35-39,1968,6
STAT,1810,48,na,1858,1501.5398992605726
STAT,1950,19,25-29,1969,51.733879179371606
SIM,1901,52,na,1953,3072
STAT,1893,18,30-34,1911,2.038688889784118
STAT,1827,37,30-34,1864,6.199400840559385
STAT,1851,38,20-24,1889,0.5838339194617708
SIM,1887,39,45-49,1926,3
SIM,1929,30,25-29,1959,12
STAT,1824,47,15-19,1871,4.680454645797216E-4
STAT,1874,54,20-24,1928,7.421624670428312E-4
STAT,1862,22,na,1884,2111.7098144086217
SIM,1903,23,30-34,1926,34
STAT,1924,46,15-19,1970,4.4426099230176304E-4
STAT,1883,28,15-19,1911,0.4468481230035459
STAT,1907,25,15-19,1932,0.6775097244299942
SIM,1836,30,20-24,1866,3
STAT,1864,48,50-100,1912,0.22102417405000774
SIM,1834,27,30-34,1861,28
STAT,1812,45,30-34,1857,0.23056500565854607
SIM,1927,43,na,1970,5095
STAT,1879,39,45-49,1918,2.079987649387599
STAT,1897,33,25-29,1930,13.810560979518774
SIM,1835,37,30-34,1872,2
SIM,1865,50,na,1915,1982
STAT,1848,22,30-34,1870,17.707577985451742
SIM,1843,39,na,1882,2194
SIM,1882,19,15-19,1901,6
SIM,1881,66,na,1947,1524
STAT,1922,15,50-100,1937,0.4400652615130723
STAT,1908,19,na,1927,3761.634397602919
SIM,1847,19,20-24,1866,27
STAT,1902,21,50-100,1923,0.5837801399818987
SIM,1871,59,na,1930,1790
STAT,1853,74,na,1927,917.7691047963433
STAT,1928,16,50-100,1944,0.47832927097176436
STAT,1939,22,50-100,1961,0.6671132571108165
STAT,1921,7,na,1928,4601.890319282618
STAT,1878,24,25-29,1902,59.643702603255015
STAT,1933,21,50-100,1954,0.8846387070221279
STAT,1853,49,35-39,1902,0.11335938502167059
SIM,1920,27,40-44,1947,9
STAT,1835,34,20-24,1869,2.5307926341010023
STAT,1881,2,na,1883,3105.125557620958
STAT,1846,34,30-34,1880,15.336270495196727
SIM,1826,69,na,1895,1080
SIM,1900,27,20-24,1927,15
STAT,1860,27,30-34,1887,21.013612513234897
STAT,1881,51,35-39,1932,0.008421584853228449
SIM,1858,30,40-44,1888,7
SIM,1927,11,na,1938,5438
SIM,1938,24,40-44,1962,5
STAT,1865,29,15-19,1894,0.4154392939587619
STAT,1916,31,45-49,1947,1.646196195041405
STAT,1808,84,na,1892,125.41651702748379
STAT,1895,21,20-24,1916,91.16746958299738
SIM,1885,37,50-100,1922,1
STAT,1917,36,30-34,1953,1.9200174679344175
SIM,1902,23,15-19,1925,9
STAT,1850,24,45-49,1874,0.6317034220762817
STAT,1912,27,40-44,1939,4.634131052798548
SIM,1906,41,na,1947,3300
SIM,1850,51,na,1901,1834
SIM,1873,30,50-100,1903,4
STAT,1804,94,na,1898,6.196076741021329
STAT,1831,61,na,1892,1174.2515407241247
STAT,1835,30,50-100,1865,0.8942343225733519
SIM,1831,35,40-44,1866,8
STAT,1789,75,na,1864,499.6205840297146
SIM,1900,15,20-24,1915,28
STAT,1877,45,15-19,1922,4.2112597834091236E-4
STAT,1957,10,na,1967,5233.058042782956
SIM,1925,36,30-34,1961,2
SIM,1875,49,na,1924,2211
STAT,1847,57,na,1904,1504.6851420994267
STAT,1919,24,30-34,1943,31.577752906075673
STAT,1944,25,35-39,1969,16.400082520515575
STAT,1950,16,20-24,1966,162.00486241089058
SIM,1899,51,na,1950,3228
STAT,1931,20,30-34,1951,37.89851741473264
STAT,1893,47,15-19,1940,2.880122569877074E-4
STAT,1886,66,na,1952,1747.828945142484
STAT,1912,38,na,1950,3686.257929595928
STAT,1824,34,45-49,1858,2.727580279890824
SIM,1845,26,50-100,1871,1
STAT,1858,34,15-19,1892,0.11187582252303457
STAT,1883,19,na,1902,2482.8498946862455
STAT,1873,15,40-44,1888,0.18950195043847118
SIM,1891,22,40-44,1913,4
SIM,1897,41,na,1938,3182
STAT,1930,1,na,1931,5456.923711275753
STAT,1908,3,na,1911,3958.6657633179625
SIM,1927,24,30-34,1951,50
SIM,1845,35,25-29,1880,1
STAT,1857,64,na,1921,1370.2511624009987
STAT,1950,16,50-100,1966,0.4476920500305555
STAT,1783,109,na,1892,0.001315286723611901
STAT,1875,41,50-100,1916,1.1007284725404467
STAT,1895,27,50-100,1922,0.8437308314883282
STAT,1903,63,na,1966,2815.161393309991
STAT,1872,24,30-34,1896,17.973736787605795
SIM,1872,36,40-44,1908,3
STAT,1951,15,25-29,1966,52.16498835960688
STAT,1857,86,na,1943,174.89264380687197
SIM,1925,33,na,1958,4558
SIM,1932,26,20-24,1958,32
STAT,1946,26,40-44,1972,5.246381507524821
STAT,1883,22,40-44,1905,2.059576921311301
STAT,1939,19,25-29,1958,43.761630839056416
SIM,1909,28,50-100,1937,1
STAT,1900,21,40-44,1921,2.9324336680044905
STAT,1942,21,45-49,1963,1.1915249410824975
STAT,1837,35,25-29,1872,2.441669088178328
STAT,1840,21,na,1861,1919.8134182519295
STAT,1853,96,na,1949,7.100964256349
STAT,1795,60,na,1855,1112.74265
STAT,1853,24,20-24,1877,66.37146256919733
SIM,1950,21,45-49,1971,6
STAT,1857,35,45-49,1892,1.5862779376016753
SIM,1861,24,20-24,1885,59
STAT,1834,39,na,1873,1553.1361761473756
STAT,1855,52,na,1907,1612.1062014261609
STAT,1875,33,50-100,1908,0.9463354496722971
STAT,1787,97,na,1884,0.8277623753935497
SIM,1873,37,na,1910,2252
STAT,1899,35,15-19,1934,0.07857799419187404
SIM,1934,20,50-100,1954,1
STAT,1783,84,na,1867,110.5907201026203
STAT,1847,25,40-44,1872,2.734972038569725
STAT,1849,48,30-34,1897,0.07473239613731726
SIM,1862,20,20-24,1882,64
STAT,1906,29,na,1935,3485.730136305314
STAT,1873,23,35-39,1896,5.956541122838877
SIM,1845,23,25-29,1868,84
SIM,1899,25,50-100,1924,6
STAT,1837,23,25-29,1860,50.75741798390891
STAT,1839,19,20-24,1858,16.24902229874751
STAT,1836,33,25-29,1869,8.083033748471074
STAT,1821,33,15-19,1854,0.49072256336250003
STAT,1912,20,20-24,1932,108.15389519924585
STAT,1930,34,50-100,1964,1.077060049488517
STAT,1913,26,45-49,1939,1.7428003491018582
SIM,1879,34,35-39,1913,1
SIM,1860,19,na,1879,2307
STAT,1924,26,20-24,1950,21.55073191283655
STAT,1854,46,25-29,1900,0.04335075804294843
STAT,1887,36,35-39,1923,8.01413895846977
STAT,1864,37,na,1901,2147.2073763966464
STAT,1841,24,35-39,1865,5.4490386878802255
STAT,1842,34,na,1876,2308.7142730842697
SIM,1876,17,25-29,1893,9
SIM,1866,38,30-34,1904,13
STAT,1868,17,25-29,1885,5.569080932483152
STAT,1789,78,na,1867,375.96611609584306
STAT,1804,62,na,1866,851.1934006572093
STAT,1864,36,40-44,1900,4.008802083678338
STAT,1832,27,na,1859,1946.7604842765763
SIM,1895,36,35-39,1931,8
SIM,1952,17,40-44,1969,2
STAT,1871,43,20-24,1914,0.15820568253709508
STAT,1944,17,40-44,1961,1.5199900208730084
STAT,1827,34,20-24,1861,3.349860479855695
STAT,1856,37,na,1893,1824.342105591063
STAT,1877,24,15-19,1901,3.4174509666822703
STAT,1853,44,15-19,1897,0.011266250952192273
SIM,1920,20,20-24,1940,189
STAT,1778,80,na,1858,263.5149387196359
STAT,1922,48,na,1970,4251.817248255934
STAT,1926,45,50-100,1971,0.2833823635440622
SIM,1939,23,45-49,1962,1
SIM,1828,42,na,1870,1571
STAT,1900,44,30-34,1944,0.11049792277491027
STAT,1836,44,15-19,1880,0.010101655611058871
STAT,1911,27,30-34,1938,38.55073888024322
SIM,1904,26,45-49,1930,4
SIM,1855,25,40-44,1880,5
SIM,1844,33,25-29,1877,17
SIM,1850,24,45-49,1874,5
SIM,1830,24,25-29,1854,50
SIM,1903,20,20-24,1923,97
SIM,1908,24,20-24,1932,111
SIM,1838,25,40-44,1863,3
SIM,1840,29,20-24,1869,19
SIM,1828,44,30-34,1872,1
STAT,1865,35,45-49,1900,1.8559655859252542
STAT,1915,32,40-44,1947,4.021656740569167
STAT,1894,25,20-24,1919,15.35831474188638
STAT,1905,2,na,1907,3892.121015405832
SIM,1885,24,15-19,1909,2
SIM,1928,23,35-39,1951,18
STAT,1843,23,15-19,1866,2.772884330213031
SIM,1864,35,35-39,1899,14
SIM,1919,24,30-34,1943,39
STAT,1888,47,na,1935,2669.5575610962337
STAT,1872,49,45-49,1921,0.23463584285686045
STAT,1920,44,50-100,1964,0.13058911506245638
STAT,1863,54,45-49,1917,0.012629876592142004
STAT,1897,24,35-39,1921,7.852117860387461
SIM,1824,35,na,1859,1640
STAT,1812,48,35-39,1860,0.3177719262661788
STAT,1928,39,na,1967,4795.576416647052
STAT,1836,46,30-34,1882,0.06473061439463602
STAT,1921,30,15-19,1951,0.14559374944457343
STAT,1871,93,na,1964,81.17303911568985
STAT,1876,20,40-44,1896,2.1860512046707115
STAT,1932,32,40-44,1964,5.2572418255098565
STAT,1902,25,30-34,1927,36.18495598381936
SIM,1925,30,na,1955,4519
SIM,1890,44,35-39,1934,4
SIM,1924,19,30-34,1943,14
STAT,1882,85,na,1967,533.936155503722
STAT,1847,46,40-44,1893,0.12854771665572773
STAT,1947,25,45-49,1972,1.975967480628977
STAT,1893,2,na,1895,3418.5528710627937
STAT,1900,13,na,1913,3617.6730089485345
STAT,1879,11,na,1890,2726.0259385307486
SIM,1913,30,30-34,1943,20
STAT,1897,36,35-39,1933,9.623246915325637
STAT,1843,64,na,1907,1172.4667580785988
SIM,1911,19,na,1930,4023
SIM,1838,33,35-39,1871,12
STAT,1872,25,35-39,1897,9.864194446513402
SIM,1817,87,na,1904,56
STAT,1880,54,45-49,1934,0.014970159641986338
SIM,1841,91,na,1932,18
SIM,1904,38,45-49,1942,1
STAT,1897,16,40-44,1913,0.248269756699589
STAT,1853,71,na,1924,1103.848781406758
SIM,1827,49,50-100,1876,6
STAT,1842,24,45-49,1866,0.7805391385786954
STAT,1819,90,na,1909,40.079620848827645
SIM,1869,20,15-19,1889,3
SIM,1835,34,20-24,1869,3
SIM,1885,38,40-44,1923,6
SIM,1903,3,na,1906,3591
SIM,1910,25,30-34,1935,44
STAT,1916,19,30-34,1935,2.59574747025065
STAT,1909,34,15-19,1943,0.1226845445684046
STAT,1887,35,30-34,1922,6.066953318102223
STAT,1882,44,35-39,1926,1.747691910616175
SIM,1802,59,na,1861,1126
STAT,1846,35,35-39,1881,5.722835518361954
STAT,1815,57,na,1872,1102.8909672331179
SIM,1824,31,40-44,1855,8
SIM,1864,23,35-39,1887,6
STAT,1798,57,na,1855,1219.60516
SIM,1856,32,50-100,1888,1
STAT,1863,35,35-39,1898,6.389596934503847
STAT,1837,39,50-100,1876,0.9988134978305547
SIM,1915,3,na,1918,4633
STAT,1867,77,na,1944,822.2287603909218
SIM,1934,22,15-19,1956,6
SIM,1880,22,30-34,1902,22
SIM,1854,79,na,1933,608
SIM,1899,22,na,1921,3581
SIM,1869,27,35-39,1896,10
STAT,1811,49,30-34,1860,0.23334759944314276
SIM,1908,18,35-39,1926,1
SIM,1879,26,40-44,1905,6
STAT,1906,29,15-19,1935,0.6626730424171511
SIM,1829,35,40-44,1864,1
SIM,1881,32,25-29,1913,1
STAT,1811,52,30-34,1863,0.014177241295095282
STAT,1912,47,35-39,1959,0.12500971783250947
STAT,1917,18,35-39,1935,0.9090663494738116
SIM,1919,48,na,1967,3911
STAT,1939,16,20-24,1955,137.03973286782693
STAT,1877,84,na,1961,518.4314493873115
STAT,1862,36,30-34,1898,4.670939750509289
SIM,1814,41,25-29,1855,4
SIM,1851,23,15-19,1874,2
SIM,1864,86,na,1950,185
STAT,1897,30,20-24,1927,3.6895208890562827
STAT,1924,26,na,1950,4422.735121427637
STAT,1898,15,45-49,1913,0.08985569848253837
STAT,1905,30,30-34,1935,25.697789367666797
STAT,1910,18,40-44,1928,0.27888724253569397
STAT,1920,33,na,1953,4165.7353663370595
STAT,1894,45,15-19,1939,2.9632378772402276E-4
SIM,1914,29,15-19,1943,1
STAT,1828,75,na,1903,668.2826805303973
STAT,1927,34,25-29,1961,11.476880860651935
SIM,1870,23,25-29,1893,70
STAT,1856,35,35-39,1891,5.528904966032644
SIM,1947,16,20-24,1963,191
STAT,1896,76,na,1972,1754.4868275710166
SIM,1854,35,35-39,1889,17
SIM,1928,36,40-44,1964,5
STAT,1852,46,15-19,1898,3.042178089482861E-4
SIM,1923,32,40-44,1955,9
STAT,1852,53,30-34,1905,0.004441882617504178
STAT,1858,49,na,1907,1745.5213162718533
STAT,1831,48,45-49,1879,0.1740327186160552
SIM,1854,34,30-34,1888,34
SIM,1865,43,50-100,1908,4
SIM,1879,31,50-100,1910,2
STAT,1888,25,na,1913,2864.3036621734627
SIM,1825,84,na,1909,131
STAT,1841,28,50-100,1869,0.5898941136569275
STAT,1868,35,20-24,1903,0.7511601404014998
STAT,1832,29,20-24,1861,10.563739652429911
STAT,1854,27,na,1881,1877.6080925375904
SIM,1875,27,na,1902,2279
STAT,1926,34,15-19,1960,0.15683891541206452
STAT,1862,23,25-29,1885,50.746592375396894
STAT,1916,30,na,1946,3972.168016666732
STAT,1886,69,na,1955,1564.9779936525008
SIM,1943,24,15-19,1967,5
SIM,1835,21,15-19,1856,8
SIM,1924,31,45-49,1955,2
SIM,1834,23,15-19,1857,3
STAT,1838,82,na,1920,312.3426328094221
STAT,1936,24,30-34,1960,27.722107157795673
SIM,1839,24,45-49,1863,5
SIM,1883,78,na,1961,1066
SIM,1899,54,na,1953,3075
SIM,1896,26,40-44,1922,8
STAT,1888,26,40-44,1914,3.5833016109427605
STAT,1873,46,50-100,1919,0.2521861661020809
SIM,1824,57,na,1881,1271
STAT,1861,24,20-24,1885,58.56790359063468
STAT,1806,72,na,1878,558.1051691785749
SIM,1938,25,45-49,1963,3
STAT,1878,36,25-29,1914,3.033237226968034
SIM,1886,24,25-29,1910,106
SIM,1922,20,30-34,1942,47
SIM,1937,5,na,1942,3839
STAT,1864,34,na,1898,2156.233062203115
STAT,1926,22,15-19,1948,6.535998634216367
SIM,1855,33,35-39,1888,13
SIM,1849,15,15-19,1864,5
STAT,1906,42,40-44,1948,0.2294951262631719
STAT,1919,18,50-100,1937,0.41693672459447606
SIM,1882,11,na,1893,2323
STAT,1906,49,50-100,1955,0.19954969629762032
SIM,1907,39,40-44,1946,1
SIM,1952,10,na,1962,4781
STAT,1847,33,35-39,1880,8.81086579330585
STAT,1898,36,45-49,1934,2.742636706539995
STAT,1820,87,na,1907,89.6799441630185
STAT,1900,40,15-19,1940,0.0013590399181667644
SIM,1830,28,40-44,1858,6
STAT,1928,37,50-100,1965,0.536319498112374
STAT,1877,47,30-34,1924,0.10043614570706624
STAT,1908,43,50-100,1951,0.10906110491967708
SIM,1844,37,40-44,1881,6
SIM,1853,2,na,1855,2747
STAT,1891,15,35-39,1906,0.6893367640090882
STAT,1931,23,35-39,1954,12.304150230727155
SIM,1823,72,na,1895,800
SIM,1876,35,20-24,1911,1
SIM,1886,21,20-24,1907,82
STAT,1811,73,na,1884,538.2141922144153
STAT,1927,17,40-44,1944,1.7578215147521885
STAT,1866,19,50-100,1885,0.04647690412930035
SIM,1896,11,na,1907,3460
SIM,1832,24,35-39,1856,6
SIM,1826,61,na,1887,1440
STAT,1865,22,30-34,1887,16.627175016506836
SIM,1945,20,25-29,1965,94
STAT,1841,43,35-39,1884,1.3892214952776134
STAT,1916,30,50-100,1946,0.8683544874086759
SIM,1836,33,25-29,1869,15
SIM,1907,31,45-49,1938,4
STAT,1925,29,40-44,1954,5.523903822409081
SIM,1854,25,50-100,1879,3
SIM,1873,22,30-34,1895,24
SIM,1934,1,na,1935,5689
STAT,1887,33,30-34,1920,19.60529461012478
STAT,1842,48,20-24,1890,0.010668264428110604
SIM,1881,46,50-100,1927,2
SIM,1813,65,na,1878,956
STAT,1814,45,40-44,1859,0.4270292399685444
SIM,1903,26,35-39,1929,13
SIM,1837,24,na,1861,1722
STAT,1848,41,na,1889,1909.0096765959952
STAT,1888,47,40-44,1935,0.20313804391736048
SIM,1891,25,45-49,1916,2
SIM,1929,23,45-49,1952,1
STAT,1848,45,45-49,1893,0.1946051724266498
STAT,1947,24,40-44,1971,3.835871057244801
SIM,1880,24,30-34,1904,26
STAT,1873,18,45-49,1891,0.06670910094255098
STAT,1931,15,40-44,1946,1.8588726465700387
STAT,1933,36,15-19,1969,0.026455407059483054
STAT,1775,94,na,1869,2.956305480692981
STAT,1833,76,na,1909,670.28406793274
STAT,1874,38,15-19,1912,0.05778641399618838
STAT,1836,37,40-44,1873,3.389613104205171
STAT,1848,29,15-19,1877,0.43589502632186866
STAT,1898,33,40-44,1931,5.912812443202825
SIM,1935,17,40-44,1952,6
STAT,1836,23,15-19,1859,2.7269067581938904
STAT,1892,44,na,1936,2899.6578872027662
SIM,1910,16,25-29,1926,12
SIM,1904,49,na,1953,3345
SIM,1851,27,30-34,1878,5
SIM,1868,46,50-100,1914,2
STAT,1828,33,25-29,1861,11.576076630682993
STAT,1859,107,na,1966,0.030895553779825273
SIM,1859,38,30-34,1897,7
STAT,1866,78,na,1944,730.7277954318936
SIM,1834,20,45-49,1854,3
SIM,1875,41,na,1916,2298
STAT,1843,27,30-34,1870,20.902312829005954
SIM,1854,16,35-39,1870,2
SIM,1879,31,30-34,1910,41
STAT,1881,36,40-44,1917,4.282297732431712
STAT,1820,109,na,1929,3.6214887087045275E-4
SIM,1853,23,25-29,1876,59
STAT,1858,15,15-19,1873,5.558381117931491
SIM,1869,24,30-34,1893,25
STAT,1845,23,25-29,1868,51.55463068938916
STAT,1826,37,15-19,1863,0.06491371843892539
STAT,1863,34,30-34,1897,15.490751517032994
SIM,1854,32,30-34,1886,28
STAT,1902,16,25-29,1918,8.107759168999225
STAT,1895,24,25-29,1919,75.03219150548873
STAT,1951,19,40-44,1970,1.6816919597961884
SIM,1839,42,40-44,1881,9
SIM,1913,21,25-29,1934,93
STAT,1850,53,20-24,1903,5.559628245561119E-4
SIM,1840,98,na,1938,1
STAT,1893,28,15-19,1921,0.5797988543451834
SIM,1959,1,na,1960,5515
STAT,1842,106,na,1948,0.010931585182610453
STAT,1873,32,25-29,1905,10.487500587254976
STAT,1846,16,35-39,1862,0.5261906461982728
STAT,1923,29,15-19,1952,0.8130790267904889
SIM,1839,41,50-100,1880,4
STAT,1840,53,na,1893,1485.1098377909036
STAT,1872,20,15-19,1892,3.3698853024208657
STAT,1918,40,na,1958,3997.576564300783
STAT,1934,15,25-29,1949,59.501628317252184
STAT,1908,33,na,1941,3588.5194956070127
SIM,1862,23,na,1885,2147
STAT,1903,37,40-44,1940,1.359078331890842
SIM,1936,25,na,1961,3860
SIM,1815,43,na,1858,1520
SIM,1919,30,25-29,1949,25
SIM,1862,23,25-29,1885,63
STAT,1829,38,na,1867,1598.8785669650576
SIM,1868,40,45-49,1908,1
STAT,1876,23,45-49,1899,0.7249498422821374
SIM,1888,36,35-39,1924,15
STAT,1883,25,45-49,1908,1.1048368442742955
STAT,1877,38,40-44,1915,4.540577482899829
SIM,1906,18,25-29,1924,10
STAT,1832,31,25-29,1863,9.21516883404421
STAT,1905,25,40-44,1930,4.403486049783951
SIM,1933,29,40-44,1962,7
STAT,1830,46,na,1876,1613.663736813216
STAT,1862,17,30-34,1879,1.5922030473333888
SIM,1824,34,45-49,1858,2
STAT,1933,19,30-34,1952,16.39961462180147
SIM,1926,18,na,1944,4474
SIM,1930,28,45-49,1958,4
STAT,1852,27,15-19,1879,0.4007692148795361
STAT,1953,15,35-39,1968,5.131242780604351
SIM,1885,70,na,1955,1344
STAT,1832,35,40-44,1867,3.8585082148999303
STAT,1922,28,45-49,1950,1.9679461840596415
SIM,1918,22,30-34,1940,44
SIM,1941,28,20-24,1969,27
SIM,1870,71,na,1941,1507
STAT,1824,91,na,1915,28.808804497681304
STAT,1842,21,40-44,1863,2.383460218227054
SIM,1942,15,25-29,1957,65
STAT,1874,19,15-19,1893,6.104536755407064
SIM,1873,35,45-49,1908,2
STAT,1854,23,25-29,1877,50.11647467013985
SIM,1847,31,na,1878,1928
SIM,1871,29,40-44,1900,4
SIM,1895,33,30-34,1928,34
SIM,1840,35,40-44,1875,2
SIM,1898,22,35-39,1920,9
STAT,1862,56,na,1918,1779.0101993359701
STAT,1930,11,na,1941,5185.259678289557
STAT,1883,49,20-24,1932,0.011612819177219194
SIM,1840,31,25-29,1871,19
SIM,1938,30,35-39,1968,14
STAT,1875,74,na,1949,1151.0921149074804
STAT,1933,28,20-24,1961,24.480584453677007
SIM,1860,64,na,1924,1488
STAT,1921,16,35-39,1937,4.842644143323877
STAT,1899,39,30-34,1938,1.5785010215986526
SIM,1804,69,na,1873,839
STAT,1845,45,na,1890,1660.3165050397204
STAT,1847,28,45-49,1875,0.9920359604444177
STAT,1831,23,30-34,1854,41.91320118117242
STAT,1855,49,45-49,1904,0.1739330871754461
SIM,1827,33,25-29,1860,19
STAT,1863,25,25-29,1888,38.404619159204096
SIM,1840,76,na,1916,723
STAT,1846,30,15-19,1876,0.13039301276193455
STAT,1833,37,15-19,1870,0.04985368333253858
STAT,1832,24,na,1856,1929.305030513372
STAT,1837,20,20-24,1857,65.47389937388213
SIM,1854,22,20-24,1876,4
SIM,1850,21,40-44,1871,2
SIM,1851,68,na,1919,1341
SIM,1894,24,25-29,1918,120
SIM,1838,30,30-34,1868,5
SIM,1855,28,45-49,1883,1
SIM,1894,30,45-49,1924,3
SIM,1909,35,35-39,1944,6
SIM,1854,4,na,1858,2751
SIM,1892,28,30-34,1920,38
STAT,1886,24,25-29,1910,60.66415893682258
STAT,1908,25,25-29,1933,63.77311956583407
STAT,1839,45,45-49,1884,0.17489959422274584
STAT,1887,62,na,1949,2061.033612591748
STAT,1928,24,30-34,1952,36.04403128609113
STAT,1867,38,15-19,1905,0.0531505096416199
STAT,1907,46,15-19,1953,3.3561551061386986E-4
STAT,1815,54,na,1869,1170.2842768536366
STAT,1850,39,50-100,1889,0.9353584775168368
SIM,1857,21,35-39,1878,8
SIM,1864,89,na,1953,105
STAT,1846,22,20-24,1868,64.52684152485833
SIM,1811,84,na,1895,125
STAT,1871,46,25-29,1917,0.05796133098795734
SIM,1841,18,15-19,1859,6
STAT,1824,37,50-100,1861,1.712262707541476
STAT,1872,22,30-34,1894,18.086964327812293
STAT,1900,27,50-100,1927,0.8974955563640816
SIM,1910,34,20-24,1944,2
SIM,1938,20,25-29,1958,106
STAT,1884,28,30-34,1912,24.992761016526103
STAT,1893,38,25-29,1931,3.6740875695122175
STAT,1940,17,15-19,1957,46.51969028496497
STAT,1937,28,50-100,1965,0.9790486334423764
STAT,1865,30,50-100,1895,0.8518052953157539
STAT,1899,65,na,1964,2559.9036548132963
STAT,1917,34,50-100,1951,0.8664301546834396
SIM,1845,20,20-24,1865,74
SIM,1871,25,25-29,1896,49
STAT,1876,35,20-24,1911,0.8115088136113763
SIM,1847,32,30-34,1879,22
SIM,1845,39,40-44,1884,5
STAT,1873,36,40-44,1909,4.503739934022792
STAT,1831,24,35-39,1855,6.358583698451347
STAT,1820,42,50-100,1862,1.9933320847206324
SIM,1918,37,35-39,1955,5
SIM,1904,23,40-44,1927,4
STAT,1888,43,25-29,1931,0.7599929348052636
STAT,1907,38,20-24,1945,0.24555684321998525
SIM,1879,22,25-29,1901,89
STAT,1917,27,25-29,1944,69.67496484529013
STAT,1781,100,na,1881,0.1257448570026648
SIM,1866,19,30-34,1885,5
STAT,1858,19,30-34,1877,1.45797805288077
SIM,1825,37,30-34,1862,3
STAT,1846,32,30-34,1878,15.658095898265485
SIM,1832,34,45-49,1866,1
SIM,1925,34,50-100,1959,1
SIM,1947,19,25-29,1966,67
SIM,1912,12,na,1924,3958
STAT,1897,21,30-34,1918,24.1916957394715
SIM,1873,60,na,1933,1807
SIM,1925,27,25-29,1952,4
STAT,1836,27,30-34,1863,20.555728738573144
STAT,1783,106,na,1889,0.013912357414419513
STAT,1896,47,40-44,1943,0.12850598635498228
STAT,1943,26,30-34,1969,42.15442933688237
SIM,1861,27,na,1888,2100
SIM,1878,49,50-100,1927,2
SIM,1844,27,30-34,1871,26
STAT,1879,33,na,1912,2504.5574021525445
STAT,1927,31,20-24,1958,3.034459503317587
STAT,1891,25,45-49,1916,1.397829267538308
STAT,1942,1,na,1943,4374.420481811618
STAT,1830,45,25-29,1875,0.04944222362842677
SIM,1938,22,40-44,1960,6
STAT,1821,35,30-34,1856,11.663082092000565
STAT,1823,98,na,1921,1.79664940319919
SIM,1846,38,na,1884,1738
SIM,1934,33,50-100,1967,2
STAT,1929,38,15-19,1967,0.024893588826417165
STAT,1870,24,20-24,1894,67.91873959807688
SIM,1870,36,30-34,1906,7
STAT,1857,32,40-44,1889,3.439496575637755
SIM,1866,67,na,1933,1477
STAT,1826,39,30-34,1865,5.812730972340735
STAT,1866,54,50-100,1920,0.013736166538270651
STAT,1916,15,15-19,1931,9.762161015507267
SIM,1935,25,35-39,1960,37
STAT,1807,47,15-19,1854,0.0014405274456860677
STAT,1839,32,30-34,1871,15.233130689407155
SIM,1888,6,na,1894,3215
STAT,1809,83,na,1892,183.30829725548995
STAT,1888,29,45-49,1917,1.3141452672597544
SIM,1855,75,na,1930,798
SIM,1949,21,na,1970,4043
STAT,1811,45,15-19,1856,0.0010297675667220014
SIM,1851,50,na,1901,1714
SIM,1968,3,na,1971,5195
SIM,1901,20,na,1921,3449
SIM,1795,83,na,1878,47
SIM,1865,32,40-44,1897,6
STAT,1817,37,30-34,1854,20.186073518784518
SIM,1834,39,30-34,1873,8
SIM,1829,38,45-49,1867,2
STAT,1778,83,na,1861,139.67988270723666
STAT,1828,72,na,1900,819.8172729582918
STAT,1872,100,na,1972,9.47305153762706
SIM,1814,47,50-100,1861,3
SIM,1916,25,25-29,1941,114
SIM,1940,22,na,1962,3863
SIM,1849,31,45-49,1880,2
SIM,1897,73,na,1970,1839
STAT,1928,37,45-49,1965,0.8708223100901009
SIM,1939,14,na,1953,4065
STAT,1937,20,25-29,1957,90.87087081264686
SIM,1796,68,na,1864,839
SIM,1913,33,35-39,1946,1
STAT,1863,51,40-44,1914,0.009466162125196836
SIM,1935,31,20-24,1966,7
STAT,1849,21,35-39,1870,5.556076435373061
SIM,1828,26,35-39,1854,10
STAT,1926,38,30-34,1964,2.248901731552848
SIM,1895,23,20-24,1918,114
SIM,1868,34,25-29,1902,18
SIM,1944,27,35-39,1971,19
SIM,1880,25,35-39,1905,12
STAT,1840,24,na,1864,1878.7568395788692
SIM,1858,71,na,1929,942
STAT,1887,17,35-39,1904,0.6187496417319149
STAT,1851,16,na,1867,2125.7086299938765
SIM,1860,37,25-29,1897,2
STAT,1957,13,na,1970,5230.755831620528
STAT,1778,107,na,1885,0.00891177774899708
SIM,1909,27,40-44,1936,7
SIM,1864,20,30-34,1884,28
STAT,1887,23,20-24,1910,77.46877400956285
STAT,1788,90,na,1878,28.33060887961088
STAT,1862,27,40-44,1889,2.6224236281404285
SIM,1870,27,40-44,1897,3
STAT,1840,35,40-44,1875,3.705534923081279
STAT,1927,25,35-39,1952,18.573448259274542
STAT,1856,3,na,1859,2586.907657022957
STAT,1949,23,20-24,1972,131.03853475738146
STAT,1852,37,25-29,1889,2.1954080607618174
STAT,1866,15,na,1881,2453.2451607478533
STAT,1868,22,15-19,1890,3.184517783896678
STAT,1893,43,50-100,1936,0.09340307824015674
STAT,1886,30,45-49,1916,1.8745475060169803
SIM,1865,35,45-49,1900,2
SIM,1858,33,45-49,1891,2
STAT,1858,54,45-49,1912,0.01118321509647805
STAT,1905,33,35-39,1938,8.454576219635642
SIM,1876,22,15-19,1898,3
STAT,1918,48,40-44,1966,0.16891274476365598
STAT,1834,61,na,1895,1112.2651691411234
STAT,1923,39,25-29,1962,1.150250309506448
STAT,1891,34,35-39,1925,12.555253849634955
STAT,1845,20,20-24,1865,63.41790564633732
SIM,1939,20,35-39,1959,18
STAT,1812,58,na,1870,1143.797763180686
STAT,1854,42,35-39,1896,1.3573182689846905
STAT,1902,47,40-44,1949,0.13718943271342468
SIM,1914,23,40-44,1937,6
STAT,1875,18,15-19,1893,6.139292637377107
STAT,1896,43,25-29,1939,0.0591862691187301
SIM,1838,71,na,1909,1030
STAT,1894,46,25-29,1940,0.04236940610983461
SIM,1860,29,30-34,1889,36
STAT,1898,9,na,1907,3552.5943834297495
SIM,1876,38,25-29,1914,2
STAT,1854,26,30-34,1880,21.92885042270455
STAT,1857,38,20-24,1895,0.6046034830326832
STAT,1833,52,45-49,1885,0.0106206543081672
SIM,1814,81,na,1895,187
SIM,1933,2,na,1935,5253
STAT,1852,29,30-34,1881,19.95235011399548
STAT,1801,94,na,1895,7.9540679926405105
SIM,1896,35,45-49,1931,2
STAT,1938,16,40-44,1954,1.3963268708454293
STAT,1822,33,30-34,1855,45.375575326331266
STAT,1873,54,40-44,1927,0.010482935744521067
STAT,1837,29,35-39,1866,8.327929113032724
STAT,1901,29,na,1930,3354.8265040162805
STAT,1858,19,25-29,1877,5.183589995900144
STAT,1824,43,35-39,1867,2.203986337764858
STAT,1838,51,na,1889,1462.3917196348814
SIM,1903,52,na,1955,2823
STAT,1827,53,30-34,1880,0.005778979669912101
STAT,1894,44,30-34,1938,0.10241141461723936
STAT,1819,49,40-44,1868,0.32388664884546137
SIM,1878,33,50-100,1911,1
SIM,1825,45,na,1870,1319
STAT,1877,47,35-39,1924,0.14525888848513852
STAT,1829,52,25-29,1881,0.0023235718222497435
SIM,1829,35,na,1864,1880
SIM,1897,19,na,1916,3467
STAT,1875,16,20-24,1891,18.433504868403077
STAT,1868,38,25-29,1906,2.7654776130827226
STAT,1852,86,na,1938,168.26911098594317
SIM,1883,16,20-24,1899,29
STAT,1888,35,45-49,1923,2.39902830663137
SIM,1931,39,25-29,1970,5
SIM,1871,32,35-39,1903,2
STAT,1848,45,15-19,1893,3.298389976792793E-4
STAT,1859,33,na,1892,1930.3049535578018
STAT,1877,6,na,1883,2821.7710035003024
SIM,1886,67,na,1953,1759
STAT,1863,35,40-44,1898,3.9545863293014363
STAT,1879,42,40-44,1921,2.3678175723855355
SIM,1862,26,30-34,1888,4
SIM,1878,33,30-34,1911,26
SIM,1901,31,50-100,1932,1
STAT,1865,45,50-100,1910,0.2287642422160472
SIM,1884,32,na,1916,2408
SIM,1848,39,30-34,1887,9
STAT,1863,17,40-44,1880,0.18677207953458652
SIM,1834,81,na,1915,238
SIM,1853,39,40-44,1892,1
SIM,1914,16,na,1930,4238
STAT,1885,37,15-19,1922,0.05645429938333745
SIM,1834,26,25-29,1860,7
SIM,1830,33,30-34,1863,29
SIM,1876,37,na,1913,2737
SIM,1946,16,40-44,1962,5
STAT,1811,45,20-24,1856,0.030893054176219195
SIM,1851,23,20-24,1874,77
STAT,1893,17,25-29,1910,7.267247603749305
SIM,1864,39,45-49,1903,1
STAT,1843,23,20-24,1866,57.922092366536724
SIM,1846,43,35-39,1889,1
SIM,1896,65,na,1961,2339
STAT,1813,99,na,1912,0.8303828258836154
SIM,1869,63,na,1932,1668
STAT,1944,26,na,1970,4090.3940995970866
SIM,1870,32,na,1902,2641
SIM,1887,42,40-44,1929,5
SIM,1881,36,40-44,1917,12
STAT,1882,29,15-19,1911,0.44070629109999443
SIM,1926,22,20-24,1948,5
STAT,1834,20,45-49,1854,1.0607688136310407
STAT,1845,39,40-44,1884,3.291645118015081
STAT,1876,51,50-100,1927,0.015825152515339218
SIM,1850,20,na,1870,2208
STAT,1845,51,25-29,1896,0.002600482457510637
STAT,1918,22,20-24,1940,121.0743083369423
SIM,1837,32,30-34,1869,19
STAT,1917,24,na,1941,3893.099732962265
STAT,1879,25,na,1904,2532.460338026388
STAT,1906,52,na,1958,3205.496083635873
STAT,1906,60,na,1966,3036.090835883
SIM,1858,24,15-19,1882,4
SIM,1851,38,20-24,1889,3
STAT,1864,16,45-49,1880,0.06807867516870746
STAT,1828,41,na,1869,1740.4551044388957
STAT,1847,49,45-49,1896,0.17301253696641508
STAT,1914,46,20-24,1960,0.01108559200626357
SIM,1859,65,na,1924,1598
STAT,1865,44,35-39,1909,1.647491556318817
STAT,1882,47,45-49,1929,0.22981360456169236
SIM,1845,27,40-44,1872,3
STAT,1883,30,na,1913,2377.519889490332
STAT,1896,23,30-34,1919,23.740034884691738
STAT,1889,46,15-19,1935,4.995716190638743E-4
SIM,1880,25,40-44,1905,4
SIM,1872,30,30-34,1902,5
STAT,1831,25,50-100,1856,0.589080967623411
SIM,1887,44,35-39,1931,4
STAT,1849,26,20-24,1875,10.951496247664615
STAT,1875,43,na,1918,2379.941036562717
STAT,1865,32,40-44,1897,3.9995628227616455
STAT,1878,45,30-34,1923,0.10250223800225593
STAT,1880,16,30-34,1896,1.694786277374405
STAT,1780,87,na,1867,48.671569277046345
STAT,1779,90,na,1869,34.0668435083766
STAT,1846,38,45-49,1884,1.5634967703646308
STAT,1868,26,50-100,1894,0.6196082844622615
STAT,1844,52,20-24,1896,5.807221308933623E-4
STAT,1829,32,30-34,1861,15.551406089241688
SIM,1866,19,25-29,1885,10
STAT,1843,38,20-24,1881,0.5466208730195414
SIM,1856,37,na,1893,2144
STAT,1861,21,15-19,1882,2.865072649223817
STAT,1879,26,35-39,1905,10.204869523475264
STAT,1834,50,40-44,1884,0.006688400488506318
SIM,1835,37,25-29,1872,1
STAT,1902,70,na,1972,2421.653320824285
SIM,1804,51,na,1855,1446
SIM,1851,44,50-100,1895,2
SIM,1854,38,45-49,1892,1
STAT,1907,22,45-49,1929,1.0342867877909514
STAT,1821,35,35-39,1856,15.4781611378688
STAT,1808,103,na,1911,0.05410623853482365
STAT,1882,37,50-100,1919,1.2011591451491732
STAT,1841,28,15-19,1869,0.4183830577987409
SIM,1880,49,50-100,1929,2
STAT,1858,37,25-29,1895,2.281437213053265
STAT,1895,43,35-39,1938,0.16465709041346444
STAT,1859,47,15-19,1906,3.234190980029698E-4
SIM,1855,34,45-49,1889,2
STAT,1894,28,25-29,1922,54.81241240550814
SIM,1873,44,35-39,1917,1
STAT,1879,44,35-39,1923,1.8828349220233687
STAT,1881,15,35-39,1896,0.5366862586988665
STAT,1906,23,40-44,1929,3.0560260432116317
SIM,1818,71,na,1889,605
SIM,1853,20,20-24,1873,3
STAT,1821,94,na,1915,11.971499244087811
STAT,1837,27,40-44,1864,2.62298307261484
SIM,1892,24,20-24,1916,99
STAT,1855,42,25-29,1897,0.48276988265080306
SIM,1802,88,na,1890,17
SIM,1870,35,25-29,1905,4
SIM,1938,21,30-34,1959,1
STAT,1817,89,na,1906,48.06433237154832
STAT,1820,36,30-34,1856,14.060747915522999
SIM,1922,11,na,1933,5155
SIM,1887,26,35-39,1913,16
STAT,1887,20,na,1907,2682.8499445682037
STAT,1880,31,25-29,1911,10.908836895077007
STAT,1771,111,na,1882,9.839796208448216E-4
STAT,1896,41,30-34,1937,0.10721647680430074
SIM,1919,27,35-39,1946,30
STAT,1903,46,45-49,1949,0.19203049584824744
SIM,1910,34,na,1944,3400
SIM,1865,73,na,1938,877
STAT,1884,24,20-24,1908,68.20682313023235
STAT,1912,49,20-24,1961,0.010652313359177478
STAT,1920,43,40-44,1963,0.27852273753254847
STAT,1877,30,na,1907,2507.5415363910015
SIM,1890,40,na,1930,3185
STAT,1829,50,30-34,1879,0.004464577603200736
STAT,1923,32,na,1955,4380.798272573041
STAT,1863,19,35-39,1882,0.5038989561950113
STAT,1828,52,35-39,1880,0.007573400972723161
STAT,1832,53,40-44,1885,0.007332057186921561
STAT,1870,12,na,1882,2626.5802886863394
STAT,1943,24,50-100,1967,0.7063859709766704
STAT,1912,60,na,1972,3317.070657628819
SIM,1894,21,20-24,1915,140
SIM,1821,63,na,1884,962
SIM,1886,27,30-34,1913,41
STAT,1919,21,25-29,1940,102.43310430267623
STAT,1928,27,35-39,1955,18.69561785885673
STAT,1885,73,na,1958,1289.1102279170327
SIM,1842,18,30-34,1860,2
STAT,1876,50,45-49,1926,0.015351652923686409
SIM,1863,25,35-39,1888,16
STAT,1845,53,20-24,1898,5.305301651396428E-4
STAT,1838,43,na,1881,1625.6100148640633
SIM,1947,15,45-49,1962,1
STAT,1840,17,45-49,1857,0.05928593085219573
STAT,1861,36,15-19,1897,0.047356243596147846
STAT,1960,0,na,1960,5210.267715203039
STAT,1835,31,15-19,1866,0.13755084205719392
STAT,1864,33,35-39,1897,9.190728840717286
SIM,1911,43,40-44,1954,2
STAT,1787,103,na,1890,0.04673688972341965
STAT,1897,40,35-39,1937,0.17198639151455075
STAT,1839,42,40-44,1881,1.6807180920898868
STAT,1859,50,45-49,1909,0.011958362385860987
STAT,1890,21,40-44,1911,2.5795195963148223
STAT,1874,9,na,1883,2759.263455011422
STAT,1878,71,na,1949,1399.4780738461395
STAT,1814,41,25-29,1855,2.3306114490573675
STAT,1853,45,25-29,1898,0.04810873679094475
STAT,1844,37,25-29,1881,2.407193644250441
STAT,1855,25,35-39,1880,8.439897769598787
SIM,1886,47,50-100,1933,3
SIM,1838,63,na,1901,1331
SIM,1927,21,25-29,1948,184
STAT,1858,41,50-100,1899,0.8409060631581863
STAT,1864,34,45-49,1898,1.5756902535553567
SIM,1875,27,25-29,1902,63
STAT,1887,39,45-49,1926,2.2253226168325853
SIM,1941,3,na,1944,4330
STAT,1849,46,15-19,1895,3.1362882374435993E-4
SIM,1819,36,30-34,1855,4
SIM,1845,44,30-34,1889,3
STAT,1890,20,30-34,1910,22.114386531147957
SIM,1846,25,35-39,1871,12
STAT,1927,14,na,1941,4963.425894052882
STAT,1947,21,30-34,1968,32.82195346014969
STAT,1844,36,15-19,1880,0.05213061668106923
STAT,1869,35,na,1904,2335.44310439443
STAT,1873,48,na,1921,2274.6882638963575
STAT,1903,43,40-44,1946,0.22304901355502743
SIM,1852,21,15-19,1873,3
SIM,1931,28,na,1959,4970
STAT,1878,27,30-34,1905,26.402082956275628
SIM,1845,65,na,1910,1286
SIM,1878,39,45-49,1917,4
STAT,1849,31,45-49,1880,1.5952664498052256
STAT,1886,21,20-24,1907,73.70966719326493
STAT,1821,40,50-100,1861,1.7848059286572142
STAT,1895,27,30-34,1922,33.21400345811126
STAT,1849,44,20-24,1893,0.12249238785408945
SIM,1895,39,45-49,1934,6
SIM,1797,64,na,1861,741
SIM,1906,31,35-39,1937,16
STAT,1899,17,20-24,1916,24.574436751457558
SIM,1847,42,40-44,1889,7
STAT,1948,23,45-49,1971,1.304641803957221
SIM,1936,27,35-39,1963,34
STAT,1766,107,na,1873,0.0038592425831301532
STAT,1828,54,30-34,1882,0.004579891511606095
STAT,1830,28,40-44,1858,3.1370188045233895
STAT,1849,35,na,1884,1924.4348083562568
STAT,1909,29,na,1938,3586.9234199525827
SIM,1836,36,30-34,1872,7
SIM,1888,40,35-39,1928,7
STAT,1845,104,na,1949,0.048736789110190526
STAT,1916,50,na,1966,3768.4059324992163
STAT,1858,71,na,1929,1057.678097610875
STAT,1862,25,na,1887,2119.575516279522
SIM,1846,36,50-100,1882,1
STAT,1784,77,na,1861,280.7045139603664
STAT,1851,5,na,1856,2314.8992595600002
STAT,1853,27,25-29,1880,40.52541180215114
SIM,1827,30,20-24,1857,2
STAT,1829,35,35-39,1864,5.98583679765967
SIM,1857,26,20-24,1883,21
STAT,1850,33,35-39,1883,8.028119450981636
STAT,1869,52,25-29,1921,0.0034595938626613195
SIM,1766,92,na,1858,2
SIM,1916,15,15-19,1931,7
SIM,1861,27,25-29,1888,45
STAT,1939,15,45-49,1954,0.5060394420124052
STAT,1844,21,15-19,1865,3.2824928078473024
STAT,1825,34,50-100,1859,1.75258447458393
STAT,1889,35,na,1924,2961.985981877137
SIM,1870,36,35-39,1906,18
STAT,1838,41,40-44,1879,1.783613588786188
STAT,1855,43,35-39,1898,1.35319099921529
SIM,1840,38,50-100,1878,3
STAT,1838,43,35-39,1881,1.2736355032167275
STAT,1836,40,50-100,1876,0.813411297794253
STAT,1873,24,45-49,1897,0.709524503301357
STAT,1870,27,25-29,1897,41.954051848156105
SIM,1822,88,na,1910,35
STAT,1818,46,15-19,1864,7.229125033920101E-4
SIM,1921,29,15-19,1950,3
STAT,1954,17,35-39,1971,5.240842634044792
STAT,1861,39,25-29,1900,2.3921324206445416
STAT,1913,34,na,1947,3764.0948404463143
STAT,1938,34,40-44,1972,3.967258182372553
STAT,1924,21,35-39,1945,11.261301177791802
SIM,1867,6,na,1873,2560
STAT,1853,6,na,1859,2481.7852284967025
STAT,1871,29,40-44,1900,2.9843381680205137
SIM,1898,27,20-24,1925,20
STAT,1789,103,na,1892,0.04368117125818336
STAT,1840,31,25-29,1871,8.836396048341204
STAT,1880,10,na,1890,2747.585983424746
STAT,1908,15,15-19,1923,8.92785714044706
STAT,1835,46,15-19,1881,3.2065696189294767E-4
SIM,1945,17,35-39,1962,6
STAT,1868,53,20-24,1921,7.008699977052E-4
STAT,1828,36,30-34,1864,5.6151340597935135
STAT,1881,30,30-34,1911,17.134811517966387
STAT,1937,17,35-39,1954,4.121116379186181
STAT,1939,33,45-49,1972,1.6198471233340916
STAT,1828,51,25-29,1879,0.003178325978898763
SIM,1893,40,45-49,1933,6
STAT,1820,38,25-29,1858,6.571240187273096
SIM,1804,91,na,1895,13
STAT,1834,103,na,1937,0.08542423205773547
STAT,1885,40,45-49,1925,1.5198110800334843
SIM,1896,57,na,1953,2671
SIM,1883,19,30-34,1902,3
STAT,1831,27,45-49,1858,0.9671384992322775
STAT,1913,29,15-19,1942,0.7046514102090231
STAT,1934,9,na,1943,5440.682796784314
STAT,1899,19,15-19,1918,8.182073221208805
STAT,1895,42,25-29,1937,0.058743728167441056
STAT,1837,44,30-34,1881,0.8209008645779229
STAT,1871,40,15-19,1911,0.013996940654916464
STAT,1942,11,na,1953,4156.647103816466
STAT,1891,20,50-100,1911,0.5129755635035361
SIM,1845,26,30-34,1871,29
SIM,1846,41,40-44,1887,6
SIM,1891,34,na,1925,3100
STAT,1853,43,30-34,1896,0.9438806510057414
SIM,1879,85,na,1964,432
STAT,1847,35,50-100,1882,0.9737839493864555
SIM,1929,34,40-44,1963,10
STAT,1850,21,40-44,1871,1.928974348395099
STAT,1869,50,30-34,1919,0.0059291538669701774
SIM,1887,29,na,1916,2577
STAT,1818,43,na,1861,1506.2540410363115
STAT,1874,50,40-44,1924,0.011044044721856489
STAT,1854,44,30-34,1898,0.8511642379977647
SIM,1797,84,na,1881,99
STAT,1848,53,50-100,1901,0.012132783719846241
SIM,1898,32,45-49,1930,2
SIM,1880,42,na,1922,2192
STAT,1822,56,na,1878,1246.3461818076883
STAT,1838,25,35-39,1863,8.335738372075483
STAT,1885,22,15-19,1907,3.316633311730918
STAT,1896,24,50-100,1920,0.5417706991814019
STAT,1875,51,40-44,1926,0.010971707626335533
SIM,1909,22,20-24,1931,6
STAT,1880,17,40-44,1897,0.19400719391378432
STAT,1885,7,na,1892,2619.262856460566
STAT,1889,55,na,1944,2575.1184687359437
STAT,1842,31,50-100,1873,1.0069347325655902
SIM,1900,36,na,1936,3476
STAT,1859,18,30-34,1877,1.4940890920101042
STAT,1899,35,20-24,1934,1.0786614209212853
SIM,1876,57,na,1933,2319
SIM,1850,40,na,1890,1939
SIM,1892,75,na,1967,1718
STAT,1881,35,na,1916,2315.4815170823267
STAT,1909,49,na,1958,3386.568590242642
STAT,1849,28,15-19,1877,0.4174783534149898
SIM,1808,73,na,1881,390
STAT,1913,47,15-19,1960,3.627695057776603E-4
STAT,1938,19,45-49,1957,0.4971330144969433
SIM,1872,75,na,1947,940
STAT,1856,54,40-44,1910,0.007927870109689693
SIM,1815,43,35-39,1858,1
STAT,1837,89,na,1926,71.66536718715791
SIM,1866,27,na,1893,2408
STAT,1880,32,35-39,1912,10.741885222578468
STAT,1877,44,30-34,1921,1.1822642717884118
STAT,1930,34,na,1964,4926.86286838325
SIM,1848,41,45-49,1889,2
STAT,1852,58,na,1910,1499.794004001576
STAT,1874,34,35-39,1908,10.383637999062104
STAT,1862,20,20-24,1882,62.423929026387775
STAT,1869,39,50-100,1908,1.193458678279397
STAT,1889,18,50-100,1907,0.06085434405579162
STAT,1802,106,na,1908,0.0042421034813387186
SIM,1825,73,na,1898,584
SIM,1843,30,na,1873,2399
STAT,1830,25,35-39,1855,12.06241088453071
SIM,1858,40,na,1898,1927
STAT,1858,18,15-19,1876,5.4607418835384145
STAT,1896,40,20-24,1936,0.014892743751377542
SIM,1929,31,30-34,1960,32
SIM,1888,43,40-44,1931,7
STAT,1832,22,35-39,1854,8.93260692182205
STAT,1934,24,na,1958,4955.3923248674355
SIM,1896,34,35-39,1930,12
SIM,1821,41,35-39,1862,1
STAT,1814,92,na,1906,19.494435173253795
SIM,1843,29,30-34,1872,6
STAT,1846,52,25-29,1898,0.00267367053864468
SIM,1798,58,na,1856,1049
STAT,1829,53,35-39,1882,0.0055367574154503866
STAT,1861,37,30-34,1898,4.473008666861029
SIM,1845,73,na,1918,850
STAT,1857,31,50-100,1888,0.7342692199662793
STAT,1883,28,20-24,1911,11.554215659306948
STAT,1835,29,30-34,1864,24.28961262905036
SIM,1791,79,na,1870,173
STAT,1839,21,50-100,1860,0.37416154475656427
STAT,1820,39,35-39,1859,15.001512751109528
SIM,1898,12,na,1910,3508
SIM,1891,28,20-24,1919,15
STAT,1858,51,40-44,1909,0.00838188135979688
STAT,1860,25,15-19,1885,0.38409831774644776
STAT,1824,31,40-44,1855,9.86102590610178
STAT,1923,36,20-24,1959,0.30889517897832713
STAT,1894,43,20-24,1937,0.01423689958331888
STAT,1864,15,35-39,1879,0.5752491951286756
SIM,1897,59,na,1956,2623
SIM,1933,23,50-100,1956,1
SIM,1840,73,na,1913,792
SIM,1872,31,40-44,1903,13
STAT,1844,53,30-34,1897,0.004633946017248844
STAT,1856,48,na,1904,1720.2655377937517
SIM,1874,22,na,1896,2241
SIM,1837,35,35-39,1872,7
STAT,1794,67,na,1861,759.4923587580727
STAT,1854,29,35-39,1883,7.482718386984279
SIM,1830,34,40-44,1864,7
STAT,1927,4,na,1931,5072.443708655427
STAT,1867,27,25-29,1894,40.23803893343335
STAT,1875,54,45-49,1929,0.014638594975764755
SIM,1847,21,35-39,1868,8
STAT,1764,107,na,1871,0.00420876775710001
STAT,1830,42,20-24,1872,0.13798652146143087
STAT,1871,42,50-100,1913,1.058764279886052
STAT,1896,26,35-39,1922,12.944125918869226
STAT,1834,35,15-19,1869,0.04247118623302784
STAT,1881,91,na,1972,212.63291362773765
STAT,1894,47,35-39,1941,0.10221089709562566
SIM,1880,70,na,1950,1208
SIM,1952,15,25-29,1967,72
STAT,1875,19,25-29,1894,5.84610931218966
STAT,1921,29,na,1950,4186.621990981015
STAT,1932,24,50-100,1956,0.8694807033723877
STAT,1944,15,25-29,1959,47.11751500572198
SIM,1865,31,50-100,1896,1
SIM,1920,45,50-100,1965,1
STAT,1822,34,40-44,1856,9.68737118689604
SIM,1870,20,20-24,1890,78
SIM,1894,37,35-39,1931,19
STAT,1876,32,15-19,1908,0.1485088376263732
SIM,1862,29,35-39,1891,7
SIM,1962,6,na,1968,5268
SIM,1882,34,35-39,1916,14
SIM,1909,49,na,1958,3727
STAT,1856,109,na,1965,0.0038046742877016156
STAT,1890,20,na,1910,2936.265870997972
STAT,1865,47,45-49,1912,0.21663770985190017
SIM,1904,26,na,1930,3539
STAT,1834,53,45-49,1887,0.00868814640213496
STAT,1819,37,50-100,1856,3.5625139393806564
SIM,1872,15,35-39,1887,3
SIM,1888,22,35-39,1910,11
SIM,1926,25,25-29,1951,92
SIM,1848,29,50-100,1877,3
STAT,1880,19,35-39,1899,0.5789002857952602
SIM,1867,29,na,1896,2135
STAT,1855,41,40-44,1896,1.7007375793595063
SIM,1864,46,50-100,1910,2
STAT,1847,16,45-49,1863,0.06140539907058707
SIM,1937,13,na,1950,3766
STAT,1839,21,35-39,1860,5.354251078787108
STAT,1835,23,na,1858,2117.697938662993
SIM,1832,31,40-44,1863,7
SIM,1890,44,40-44,1934,6
SIM,1967,4,na,1971,5079
STAT,1873,39,45-49,1912,2.020606846658274
STAT,1890,26,50-100,1916,0.7921925870530288
SIM,1950,20,50-100,1970,4
STAT,1810,46,15-19,1856,0.0015749290567597383
SIM,1939,21,50-100,1960,1
STAT,1888,34,35-39,1922,11.969232965306594
SIM,1940,24,50-100,1964,1
STAT,1891,22,40-44,1913,2.605757505531405
STAT,1874,52,35-39,1926,0.00885600204550806
SIM,1885,73,na,1958,1193
SIM,1923,27,50-100,1950,2
STAT,1868,37,15-19,1905,0.05420548594497476
STAT,1870,42,20-24,1912,0.15731497847127437
STAT,1832,58,na,1890,1346.5939536808412
STAT,1881,32,25-29,1913,9.971845764096683
STAT,1876,47,15-19,1923,4.1519211253404723E-4
STAT,1832,38,15-19,1870,0.04794435553375522
STAT,1896,44,35-39,1940,0.16584411314727168
SIM,1881,39,45-49,1920,4
STAT,1846,19,35-39,1865,0.5169475139355617
STAT,1886,33,15-19,1919,0.15122168657939128
SIM,1878,36,35-39,1914,11
STAT,1836,48,na,1884,1465.6443870880362
STAT,1897,30,na,1927,3257.178369436001
SIM,1840,22,35-39,1862,9
STAT,1882,44,40-44,1926,2.17086993341637
STAT,1803,51,20-24,1854,0.003267358436778819
SIM,1881,24,45-49,1905,3
SIM,1839,65,na,1904,1035
STAT,1819,42,15-19,1861,0.02964057407885855
STAT,1806,103,na,1909,0.04838779540122895
SIM,1841,48,50-100,1889,2
SIM,1870,32,20-24,1902,3
STAT,1918,25,25-29,1943,71.19755757944617
STAT,1956,15,45-49,1971,0.6681110410276229
STAT,1865,53,na,1918,1953.8881316684271
STAT,1806,48,45-49,1854,0.7010728115507863
STAT,1849,29,25-29,1878,38.64454727861664
SIM,1829,43,35-39,1872,4
SIM,1862,42,35-39,1904,3
STAT,1891,19,15-19,1910,7.38122887233602
SIM,1928,20,30-34,1948,52
SIM,1849,19,25-29,1868,6
SIM,1954,5,na,1959,4839
STAT,1895,40,30-34,1935,1.5316710157185969
STAT,1854,81,na,1935,405.83649486123903
STAT,1873,51,35-39,1924,0.00885707402453509
STAT,1836,30,20-24,1866,2.200636251976108
STAT,1861,16,50-100,1877,0.04754029438848583
STAT,1836,49,40-44,1885,0.1101655869208496
STAT,1839,54,35-39,1893,0.005935744724095512
STAT,1854,50,50-100,1904,0.01149729080978605
STAT,1907,14,na,1921,3818.0488736149237
STAT,1818,51,na,1869,1364.5438209489607
STAT,1850,50,50-100,1900,0.011730569006426642
SIM,1885,44,30-34,1929,1
STAT,1870,26,15-19,1896,0.45152104648343755
STAT,1804,52,20-24,1856,0.0019983640870149828
STAT,1924,22,45-49,1946,1.3416396566246447
SIM,1938,24,35-39,1962,12
SIM,1837,78,na,1915,395
STAT,1915,27,50-100,1942,1.0244269855609682
STAT,1861,19,30-34,1880,1.519476002211622
SIM,1862,45,na,1907,2071
STAT,1807,99,na,1906,0.6708647928668487
SIM,1932,22,45-49,1954,6
SIM,1832,47,na,1879,1464
STAT,1866,31,45-49,1897,1.6375441187315503
SIM,1848,30,na,1878,1985
STAT,1833,48,50-100,1881,0.18353678762338024
SIM,1832,86,na,1918,157
STAT,1847,49,15-19,1896,2.9324134126219544E-4
STAT,1812,44,25-29,1856,1.547557396661461
STAT,1896,37,na,1933,3149.755827768651
SIM,1836,39,35-39,1875,19
STAT,1853,42,20-24,1895,0.13117295568805876
SIM,1831,30,40-44,1861,4
SIM,1894,19,35-39,1913,1
STAT,1884,39,20-24,1923,0.7600344601758426
SIM,1843,19,na,1862,2601
STAT,1902,49,50-100,1951,0.19360249942618005
SIM,1849,37,25-29,1886,2
STAT,1801,74,na,1875,495.75797963948133
STAT,1833,34,15-19,1867,0.12751941339166348
SIM,1890,26,40-44,1916,5
SIM,1881,23,35-39,1904,11
SIM,1863,22,30-34,1885,26
STAT,1875,19,30-34,1894,1.644323543848164
STAT,1850,18,15-19,1868,5.520193673232291
STAT,1827,37,25-29,1864,3.349101585136158
STAT,1847,34,45-49,1881,1.3663719521926243
SIM,1819,37,40-44,1856,5
STAT,1838,100,na,1938,0.7106932987121506
SIM,1818,38,50-100,1856,1
SIM,1821,94,na,1915,8
SIM,1827,28,35-39,1855,7
STAT,1845,76,na,1921,692.2546287317523
STAT,1837,45,40-44,1882,0.1243869168528661
STAT,1889,63,na,1952,2222.1621489397558
STAT,1864,27,50-100,1891,0.5830074389355722
STAT,1878,28,40-44,1906,3.1296579561575464
SIM,1886,28,40-44,1914,5
STAT,1815,53,40-44,1868,0.02187250947116804
STAT,1900,47,35-39,1947,0.1102815721883951
SIM,1856,44,35-39,1900,1
SIM,1869,55,na,1924,2002
STAT,1851,47,15-19,1898,3.01462844332679E-4
SIM,1828,73,na,1901,629
STAT,1844,91,na,1935,45.84739701399288
SIM,1857,29,25-29,1886,61
STAT,1888,61,na,1949,2227.622294300455
STAT,1820,35,15-19,1855,0.15815100693117567
STAT,1840,32,35-39,1872,8.64646968150959
SIM,1850,12,na,1862,2278
SIM,1853,36,35-39,1889,12
SIM,1931,1,na,1932,5331
STAT,1870,20,na,1890,2359.6227489336616
SIM,1914,20,30-34,1934,36
STAT,1901,49,45-49,1950,0.1845487111748019
STAT,1845,36,35-39,1881,5.486737614250496
SIM,1892,39,20-24,1931,1
STAT,1819,46,35-39,1865,0.2769214340245771
STAT,1824,46,45-49,1870,0.27997961370470337
STAT,1848,81,na,1929,441.5117485693961
STAT,1859,32,15-19,1891,0.11568281973721847
STAT,1954,16,na,1970,4598.430202669866
STAT,1849,47,25-29,1896,0.04482477207896914
STAT,1876,48,30-34,1924,0.09967879188458632
STAT,1906,20,30-34,1926,26.360057967558575
SIM,1878,60,na,1938,2192
STAT,1817,48,20-24,1865,0.025396639640738176
STAT,1824,51,na,1875,1217.9119234818643
STAT,1869,53,35-39,1922,0.0083180049152506
STAT,1891,37,45-49,1928,2.4928116490335936
STAT,1898,39,20-24,1937,0.22551746045098317
STAT,1888,17,45-49,1905,0.07787172122346313
STAT,1871,22,15-19,1893,3.310320574503425
SIM,1825,53,na,1878,1133
SIM,1873,32,40-44,1905,6
STAT,1876,47,20-24,1923,0.012455774332535278
STAT,1812,43,15-19,1855,0.03470382038721771
SIM,1840,38,45-49,1878,1
STAT,1822,53,50-100,1875,0.021143664561721995
STAT,1903,24,na,1927,3380.6206855984037
STAT,1949,16,15-19,1965,53.33882326208222
STAT,1832,38,45-49,1870,1.7020244190359821
SIM,1817,39,30-34,1856,10
STAT,1927,42,50-100,1969,0.14892017139535738
STAT,1890,40,na,1930,2881.223743981374
STAT,1894,10,na,1904,3368.2925159173947
STAT,1936,1,na,1937,4036.424141394096
STAT,1901,48,35-39,1949,0.11040768183567999
SIM,1849,35,na,1884,1965
STAT,1835,47,30-34,1882,0.0766112142563133
SIM,1904,46,na,1950,3394
SIM,1864,36,40-44,1900,7
STAT,1837,47,50-100,1884,0.17392867391779002
SIM,1904,16,35-39,1920,1
STAT,1849,29,30-34,1878,23.004974660155295
SIM,1840,23,45-49,1863,4
SIM,1965,3,na,1968,5217
STAT,1929,22,25-29,1951,118.06360550636586
STAT,1881,33,35-39,1914,9.81775514292423
STAT,1891,45,na,1936,2841.953277707453
STAT,1886,37,35-39,1923,7.542513942625849
SIM,1833,24,15-19,1857,1
SIM,1874,43,45-49,1917,3
STAT,1852,16,25-29,1868,5.228582147307756
STAT,1855,40,30-34,1895,0.874111231165084
SIM,1906,32,45-49,1938,1
STAT,1803,52,30-34,1855,0.025815511883476853
STAT,1949,0,na,1949,5191.837766175486
SIM,1860,16,25-29,1876,12
STAT,1874,23,50-100,1897,0.4204294429640363
STAT,1912,45,50-100,1957,0.22033492465956117
SIM,1870,33,30-34,1903,36
STAT,1853,46,35-39,1899,0.11610542608981961
SIM,1927,26,50-100,1953,1
SIM,1845,47,50-100,1892,1
STAT,1894,4,na,1898,3420.7763140156285
STAT,1895,48,35-39,1943,0.10285194296812918
STAT,1846,15,na,1861,2214.281669485788
SIM,1862,41,25-29,1903,3
STAT,1878,23,50-100,1901,0.42622867141185955
STAT,1874,35,15-19,1909,0.05862600354969578
SIM,1832,49,50-100,1881,2
SIM,1893,60,na,1953,2526
STAT,1832,23,45-49,1855,0.7017069369403476
STAT,1809,105,na,1914,0.013538786777638059
STAT,1793,82,na,1875,163.51775919570292
STAT,1825,39,15-19,1864,0.08546618193024794
STAT,1831,54,35-39,1885,0.005437645636900509
SIM,1883,18,15-19,1901,9
STAT,1828,39,35-39,1867,6.964887740598099
STAT,1874,53,45-49,1927,0.014767608585777879
STAT,1855,22,30-34,1877,15.663493443002947
STAT,1886,36,50-100,1922,1.315557810503464
STAT,1777,95,na,1872,1.8715899913327314
SIM,1894,36,50-100,1930,3
SIM,1828,29,35-39,1857,11
STAT,1814,42,35-39,1856,5.488163284579982
STAT,1936,20,15-19,1956,5.141468891480489
SIM,1937,22,25-29,1959,109
STAT,1919,26,50-100,1945,1.0896013106145288
STAT,1875,36,15-19,1911,0.05852482733332574
STAT,1867,24,15-19,1891,3.1184589065018646
STAT,1948,16,na,1964,4256.393441975765
STAT,1886,19,35-39,1905,0.5820016055119672
SIM,1842,45,na,1887,1693
SIM,1871,34,30-34,1905,33
SIM,1944,0,na,1944,4556
SIM,1862,85,na,1947,327
STAT,1845,32,15-19,1877,0.12372220560336689
SIM,1921,18,na,1939,4160
STAT,1872,86,na,1958,293.4635795049102
SIM,1829,44,45-49,1873,2
SIM,1880,22,35-39,1902,7
STAT,1813,41,35-39,1854,6.982033832386552
STAT,1929,40,25-29,1969,0.09373043553588013
STAT,1842,27,20-24,1869,13.061780649794734
STAT,1850,36,45-49,1886,1.5667973582164618
STAT,1857,39,30-34,1896,4.158728176720085
STAT,1839,39,15-19,1878,0.04659806874177099
STAT,1861,83,na,1944,333.18329177462584
SIM,1857,29,30-34,1886,41
STAT,1878,46,40-44,1924,0.1800050777757132
SIM,1881,38,50-100,1919,1
STAT,1939,30,40-44,1969,4.035460480598635
SIM,1822,42,35-39,1864,2
SIM,1858,9,na,1867,2325
STAT,1873,1,na,1874,3571.881339399065
STAT,1856,68,na,1924,1183.3540522630306
STAT,1892,48,15-19,1940,2.8236959114678103E-4
SIM,1878,36,40-44,1914,4
STAT,1858,49,20-24,1907,0.00931010622096246
STAT,1820,35,20-24,1855,2.1709817310933013
SIM,1833,40,na,1873,1811
SIM,1784,89,na,1873,35
STAT,1841,25,40-44,1866,2.822733748265085
STAT,1851,50,40-44,1901,0.008085960174581311
STAT,1823,41,na,1864,1544.0106673660232
STAT,1941,23,50-100,1964,0.6862834125763302
STAT,1910,0,na,1910,4489.033529459706
SIM,1831,93,na,1924,10
STAT,1842,48,na,1890,2000.1579493221655
SIM,1929,34,35-39,1963,14
STAT,1860,26,25-29,1886,35.55467122635433
STAT,1921,44,50-100,1965,0.1331958670641036
SIM,1827,88,na,1915,69
STAT,1883,42,35-39,1925,1.7875529484620205
STAT,1797,95,na,1892,3.3195420596773317
STAT,1819,36,na,1855,1487.80610070418
SIM,1852,37,30-34,1889,13
SIM,1887,20,na,1907,2593
STAT,1916,6,na,1922,4277.377399786681
STAT,1867,24,20-24,1891,65.1407138969165
STAT,1848,44,35-39,1892,1.4584978522550502
STAT,1882,76,na,1958,1030.0666793085204
SIM,1826,29,30-34,1855,28
STAT,1924,19,15-19,1943,54.319004282366805
STAT,1862,39,40-44,1901,3.7797188799399315
SIM,1930,19,15-19,1949,59
STAT,1866,43,45-49,1909,1.38959547494133
SIM,1880,42,25-29,1922,3
STAT,1872,42,25-29,1914,0.6512568721753224
STAT,1822,37,45-49,1859,3.71467201237273
STAT,1830,25,30-34,1855,31.480637807883564
STAT,1846,51,40-44,1897,0.008027499698694172
STAT,1910,38,35-39,1948,2.3223131298546784
STAT,1890,71,na,1961,1825.2635001697527
STAT,1812,89,na,1901,47.69546014721971
STAT,1870,43,na,1913,2275.7016425188963
STAT,1881,27,50-100,1908,0.6227824127086407
SIM,1932,19,15-19,1951,3
STAT,1895,23,15-19,1918,4.337846373164739
SIM,1891,42,35-39,1933,5
SIM,1889,32,na,1921,2920
STAT,1909,17,25-29,1926,8.575509152394552
STAT,1841,31,40-44,1872,3.975870143520984
STAT,1861,52,20-24,1913,6.160241048666683E-4
STAT,1922,19,15-19,1941,52.77550781638157
STAT,1851,84,na,1935,251.8885085392652
STAT,1900,20,35-39,1920,8.236093383872575
STAT,1833,37,20-24,1870,0.6843550214621908
STAT,1898,60,na,1958,2680.0024732423776
STAT,1880,50,na,1930,2316.7079976681366
STAT,1857,41,45-49,1898,1.1850560794586011
STAT,1891,19,45-49,1910,0.08124631126803626
STAT,1816,51,35-39,1867,0.02181181546896684
STAT,1893,17,na,1910,3238.942057823803
SIM,1867,20,na,1887,2378
STAT,1916,39,na,1955,3848.8979747795825
STAT,1876,18,30-34,1894,1.6578006538722145
STAT,1821,63,na,1884,1099.4413531020089
SIM,1832,28,45-49,1860,1
STAT,1923,26,45-49,1949,2.0109722214527666
SIM,1879,32,40-44,1911,11
STAT,1834,92,na,1926,24.790918579855983
STAT,1844,37,30-34,1881,4.455869110625587
STAT,1845,18,35-39,1863,0.5037609867703648
STAT,1872,16,50-100,1888,0.05020673230990322
SIM,1849,16,20-24,1865,22
SIM,1822,40,40-44,1862,7
SIM,1918,15,20-24,1933,26
STAT,1922,37,15-19,1959,0.02207448970707279
STAT,1940,23,40-44,1963,3.4567975123569767
SIM,1841,37,20-24,1878,5
STAT,1825,56,na,1881,1608.5248661549865
STAT,1828,32,15-19,1860,0.16697182585079065
SIM,1829,40,30-34,1869,5
SIM,1943,25,25-29,1968,81
SIM,1897,30,35-39,1927,19
STAT,1861,45,50-100,1906,0.20818219616871522
STAT,1856,24,45-49,1880,0.6181495801888361
SIM,1917,17,25-29,1934,18
STAT,1874,38,20-24,1912,0.7932497650534341
STAT,1872,51,50-100,1923,0.015409022532941198
STAT,1892,15,15-19,1907,7.556271320514795
STAT,1820,51,20-24,1871,0.0012287285440450667
STAT,1860,43,45-49,1903,1.2267397034669034
SIM,1878,91,na,1969,141
STAT,1851,35,15-19,1886,0.04387669414199143
STAT,1898,46,50-100,1944,0.19022717365554992
STAT,1895,41,15-19,1936,0.0012705865272699811
STAT,1865,84,na,1949,306.80062587574804
STAT,1834,81,na,1915,321.8784512576906
STAT,1888,31,30-34,1919,20.89899196906208
STAT,1869,33,15-19,1902,0.13924830619959008
SIM,1889,18,15-19,1907,12
SIM,1894,37,30-34,1931,13
STAT,1814,40,40-44,1854,8.39775108411966
STAT,1914,33,40-44,1947,3.9576289988062734
SIM,1877,37,35-39,1914,19
SIM,1801,86,na,1887,3
STAT,1869,37,35-39,1906,6.945315283506275
SIM,1833,42,45-49,1875,3
STAT,1861,91,na,1952,48.634450460091024
STAT,1886,37,30-34,1923,5.683424439721052
STAT,1895,35,50-100,1930,1.6347268800778105
STAT,1873,17,na,1890,2585.99228539884
STAT,1853,30,20-24,1883,2.3502699312191053
STAT,1881,31,40-44,1912,4.239331459968442
STAT,1865,45,15-19,1910,3.7257988606639945E-4
SIM,1897,50,na,1947,2972
STAT,1872,52,30-34,1924,0.006012165942949291
SIM,1922,33,40-44,1955,4
SIM,1833,71,na,1904,865
SIM,1870,39,40-44,1909,9
SIM,1927,34,na,1961,5105
SIM,1923,21,na,1944,4330
STAT,1841,63,na,1904,1334.3286658933337
SIM,1864,24,45-49,1888,1
STAT,1836,27,25-29,1863,34.53021978155253
SIM,1844,27,25-29,1871,43
STAT,1805,51,25-29,1856,0.014858647141114742
STAT,1892,21,45-49,1913,0.8864390301288432
STAT,1910,14,na,1924,3935.3252586971516
STAT,1889,30,35-39,1919,12.713567774483048
STAT,1851,17,15-19,1868,5.463357846586651
STAT,1851,29,15-19,1880,0.3964799310845669
STAT,1870,27,30-34,1897,24.975112082415944
SIM,1852,55,na,1907,1523
STAT,1849,66,na,1915,1281.4648246409197
SIM,1875,24,20-24,1899,4
SIM,1882,38,20-24,1920,4
STAT,1815,41,40-44,1856,6.068087524924398
STAT,1904,39,20-24,1943,0.23872856754275448
STAT,1821,50,25-29,1871,0.005196173490691881
STAT,1912,33,40-44,1945,3.868550720128929
SIM,1902,21,20-24,1923,91
STAT,1807,47,20-24,1854,0.04321586138469273
STAT,1935,25,25-29,1960,90.72777536827078
STAT,1914,15,40-44,1929,0.29327937631848927
SIM,1816,42,50-100,1858,1
SIM,1823,35,40-44,1858,7
SIM,1838,40,na,1878,1782
STAT,1799,99,na,1898,0.6355283452609312
STAT,1871,26,35-39,1897,9.715194349690766
STAT,1856,39,45-49,1895,1.5281128315060886
SIM,1920,33,40-44,1953,4
STAT,1848,10,na,1858,2446.4464305429824
STAT,1898,71,na,1969,2195.484185861793
STAT,1825,42,45-49,1867,2.146018897436795
STAT,1850,43,na,1893,1756.963950050511
SIM,1896,31,30-34,1927,36
STAT,1902,43,25-29,1945,0.0631856220487106
SIM,1922,15,40-44,1937,4
SIM,1833,30,45-49,1863,1
STAT,1882,26,40-44,1908,2.9407600520810306
SIM,1821,83,na,1904,225
STAT,1892,33,45-49,1925,2.2007573999283405
SIM,1880,21,25-29,1901,67
STAT,1857,52,35-39,1909,0.006749916505929336
STAT,1856,42,40-44,1898,1.739573990303861
STAT,1915,31,35-39,1946,9.429719917687471
SIM,1891,5,na,1896,3415
SIM,1881,20,30-34,1901,21
STAT,1897,22,40-44,1919,2.821599696363777
STAT,1852,49,25-29,1901,0.042771300202570056
SIM,1883,47,na,1930,2435
STAT,1825,30,45-49,1855,5.571398719122058
STAT,1930,29,20-24,1959,23.436370228243316
STAT,1932,31,35-39,1963,12.283794059183759
SIM,1917,32,20-24,1949,3
STAT,1906,23,35-39,1929,8.5580686382585
SIM,1873,29,45-49,1902,1
SIM,1891,65,na,1956,2025
STAT,1863,38,45-49,1901,1.7751024581734371
STAT,1851,32,45-49,1883,1.3743006584849187
STAT,1811,47,50-100,1858,0.6117787671870538
STAT,1877,25,20-24,1902,12.312104881200737
SIM,1917,13,na,1930,4173
STAT,1812,45,35-39,1857,0.3334617851944686
STAT,1847,88,na,1935,102.7893074082656
SIM,1844,30,20-24,1874,2
STAT,1832,35,50-100,1867,1.082182180611257
STAT,1846,18,na,1864,2175.3853141707964
STAT,1892,15,45-49,1907,0.08317303017566326
SIM,1849,34,20-24,1883,2
STAT,1821,52,20-24,1873,0.0010402754188601714
SIM,1832,55,na,1887,1256
STAT,1836,42,20-24,1878,0.11918414751169608
SIM,1838,31,40-44,1869,3
STAT,1819,46,30-34,1865,0.1914713914387945
STAT,1845,54,30-34,1899,0.004229837977963531
STAT,1889,45,35-39,1934,0.17609343372668487
SIM,1923,31,35-39,1954,17
STAT,1865,73,na,1938,1095.4120185877196
SIM,1851,14,na,1865,2368
STAT,1880,37,35-39,1917,7.502322047994853
SIM,1869,42,25-29,1911,3
SIM,1919,30,30-34,1949,38
SIM,1919,37,50-100,1956,3
SIM,1841,32,50-100,1873,4
SIM,1863,47,na,1910,2043
SIM,1890,41,35-39,1931,6
STAT,1842,41,35-39,1883,1.7085114599067157
STAT,1840,30,40-44,1870,3.7803795327417906
SIM,1905,36,45-49,1941,1
STAT,1841,43,40-44,1884,1.725601152373951
STAT,1842,23,35-39,1865,6.579117709207433
STAT,1850,52,45-49,1902,0.011053199153524136
STAT,1916,36,50-100,1952,0.4359854764657286
STAT,1860,36,50-100,1896,1.0185358178220094
STAT,1842,30,45-49,1872,1.936427476089318
STAT,1878,40,30-34,1918,1.2175378156302796
STAT,1894,31,20-24,1925,3.5292469197875143
SIM,1886,40,30-34,1926,2
SIM,1928,17,35-39,1945,6
SIM,1914,23,35-39,1937,13
STAT,1882,41,35-39,1923,1.7796213495349806
SIM,1822,48,na,1870,1485
STAT,1813,46,35-39,1859,0.4150005083232423
STAT,1831,41,25-29,1872,0.5029819373778597
SIM,1889,42,45-49,1931,4
STAT,1827,40,20-24,1867,0.17681368024189453
SIM,1850,23,35-39,1873,7
SIM,1827,37,50-100,1864,2
STAT,1897,37,40-44,1934,5.927396208451384
STAT,1852,17,50-100,1869,0.04493762031181677
STAT,1851,20,45-49,1871,0.6396920234775679
STAT,1941,21,35-39,1962,9.827199365917746
STAT,1818,74,na,1892,571.7706019492583
SIM,1858,28,30-34,1886,33
STAT,1863,32,35-39,1895,9.062607745852896
STAT,1866,25,15-19,1891,0.42719610180927153
STAT,1902,39,na,1941,3355.0153881097217
SIM,1869,28,40-44,1897,10
SIM,1859,38,25-29,1897,1
STAT,1847,52,40-44,1899,0.007840478718426898
SIM,1866,37,25-29,1903,1
SIM,1891,24,35-39,1915,8
SIM,1841,33,35-39,1874,12
SIM,1911,6,na,1917,4160
SIM,1934,16,na,1950,5105
STAT,1821,71,na,1892,799.5347943506927
SIM,1909,3,na,1912,4297
STAT,1833,51,na,1884,1601.1609072093092
SIM,1830,37,45-49,1867,1
SIM,1850,31,50-100,1881,5
SIM,1860,73,na,1933,1068
STAT,1842,25,na,1867,2443.5454998811624
STAT,1872,25,40-44,1897,3.0623944376510113
STAT,1878,49,45-49,1927,0.24226906539475535
SIM,1824,33,35-39,1857,12
SIM,1885,25,20-24,1910,13
STAT,1854,47,35-39,1901,0.10457828598916052
SIM,1820,53,na,1873,1265
STAT,1866,28,15-19,1894,0.4228237960632118
SIM,1848,17,15-19,1865,8
SIM,1850,41,35-39,1891,5
SIM,1911,28,na,1939,3830
STAT,1787,74,na,1861,376.3912793861647
STAT,1791,70,na,1861,596.9640750887486
STAT,1824,82,na,1906,231.961836814335
STAT,1877,31,20-24,1908,2.8292464999152305
STAT,1832,50,35-39,1882,0.0063628883359780584
STAT,1862,35,25-29,1897,2.5351443002293177
STAT,1929,26,40-44,1955,5.898749140025463
STAT,1811,48,25-29,1859,0.14114322487083963
STAT,1833,33,35-39,1866,9.162967555701876
STAT,1811,64,na,1875,894.5547176574652
SIM,1874,29,30-34,1903,33
SIM,1895,72,na,1967,2022
STAT,1773,85,na,1858,86.22520170760698
STAT,1896,42,40-44,1938,0.20856241871953715
STAT,1880,30,15-19,1910,0.15226750255765323
SIM,1853,36,30-34,1889,3
STAT,1905,37,15-19,1942,0.017697055324477018
STAT,1857,38,15-19,1895,0.04404396788155449
STAT,1909,32,20-24,1941,2.3488009346479157
SIM,1859,25,na,1884,2269
SIM,1937,26,40-44,1963,8
STAT,1831,51,30-34,1882,0.003989910586348017
STAT,1898,42,45-49,1940,0.14212634813733882
SIM,1870,17,25-29,1887,7
SIM,1849,18,15-19,1867,5
STAT,1862,17,25-29,1879,5.660803858666878
STAT,1883,24,35-39,1907,5.731514909613631
STAT,1878,47,50-100,1925,0.2563000111060123
STAT,1914,17,50-100,1931,0.07819365755970446
STAT,1845,36,30-34,1881,4.134358767961634
STAT,1833,51,35-39,1884,0.006426410058952116
SIM,1816,48,na,1864,1295
STAT,1897,43,40-44,1940,0.20996850342601373
SIM,1920,0,na,1920,5020
STAT,1877,43,20-24,1920,0.16435450854092468
STAT,1870,46,35-39,1916,0.13924457606302812
STAT,1821,38,40-44,1859,8.119758720713422
STAT,1832,38,50-100,1870,1.0482378225908513
SIM,1931,23,40-44,1954,8
SIM,1861,43,30-34,1904,1
STAT,1858,16,20-24,1874,16.506981899450235
SIM,1879,35,45-49,1914,3
SIM,1929,33,50-100,1962,1
STAT,1851,30,50-100,1881,0.7372429408084908
STAT,1896,45,na,1941,3038.4117207646127
STAT,1909,41,50-100,1950,0.11152196849038414
STAT,1773,82,na,1855,162.66930000000002
STAT,1955,16,40-44,1971,1.8763904671554203
SIM,1850,29,na,1879,2028
SIM,1883,39,na,1922,2585
SIM,1945,8,na,1953,4228
STAT,1856,17,na,1873,2101.738850924346
STAT,1940,26,45-49,1966,1.7793249235369772
SIM,1834,23,20-24,1857,74
STAT,1887,32,25-29,1919,11.550031263855495
SIM,1842,85,na,1927,115
STAT,1830,28,35-39,1858,10.104564940995402
STAT,1843,26,25-29,1869,35.366354073467576
STAT,1874,98,na,1972,24.41406231653072
STAT,1925,36,20-24,1961,0.32003919974220707
SIM,1922,18,45-49,1940,2
STAT,1879,41,30-34,1920,1.2172329961702162
STAT,1877,46,25-29,1923,0.06021405752394484
STAT,1886,38,na,1924,2499.936068675413
STAT,1854,100,na,1954,0.7967503363095416
STAT,1863,10,na,1873,2468.2786999664954
STAT,1851,53,45-49,1904,0.010812188641548011
SIM,1817,78,na,1895,341
STAT,1805,56,na,1861,1271.033471790877
STAT,1854,26,35-39,1880,8.402460129249224
STAT,1914,18,45-49,1932,0.10398505356919739
STAT,1832,103,na,1935,0.09772284851124123
STAT,1900,7,na,1907,3655.3437828384035
SIM,1832,78,na,1910,550
STAT,1885,50,50-100,1935,0.015401555148500255
SIM,1860,28,20-24,1888,11
STAT,1829,51,40-44,1880,0.0077410899893334256
SIM,1876,65,na,1941,1848
STAT,1835,35,30-34,1870,5.0510581243001855
SIM,1851,26,25-29,1877,63
SIM,1848,35,45-49,1883,1
SIM,1895,32,25-29,1927,25
STAT,1850,33,40-44,1883,3.437883988008074
STAT,1871,26,30-34,1897,25.354841373214477
STAT,1903,32,na,1935,3432.50146226494
SIM,1918,18,25-29,1936,55
STAT,1841,22,50-100,1863,0.38631295627797496
SIM,1832,25,40-44,1857,5
STAT,1830,40,25-29,1870,0.5739332311495259
SIM,1843,17,30-34,1860,4
STAT,1852,28,20-24,1880,10.288342237068319
SIM,1907,14,na,1921,4062
SIM,1907,28,20-24,1935,18
STAT,1866,46,15-19,1912,3.751548326719728E-4
SIM,1883,33,45-49,1916,3
SIM,1917,21,na,1938,3808
STAT,1912,36,45-49,1948,0.6745181477529214
SIM,1866,58,na,1924,2004
STAT,1900,49,30-34,1949,0.07500944774258629
STAT,1862,53,20-24,1915,6.33294128237421E-4
STAT,1804,50,25-29,1854,0.009987331220033147
SIM,1887,41,30-34,1928,1
STAT,1806,97,na,1903,1.8113153541307703
SIM,1839,25,na,1864,1859
SIM,1927,25,40-44,1952,9
STAT,1834,29,15-19,1863,0.34924111831400645
SIM,1828,27,40-44,1855,5
SIM,1811,53,na,1864,1405
STAT,1911,50,na,1961,3477.2400337853737
STAT,1867,17,50-100,1884,0.04764137729233308
SIM,1861,5,na,1866,2566
SIM,1944,23,na,1967,4280
STAT,1815,50,35-39,1865,0.018995057198470937
STAT,1837,58,na,1895,1349.0766155275755
STAT,1951,19,na,1970,4425.4204399941955
STAT,1891,16,40-44,1907,0.22927801656277305
SIM,1833,28,30-34,1861,29
SIM,1836,37,na,1873,1943
STAT,1852,46,20-24,1898,0.009126542296459086
STAT,1910,35,30-34,1945,1.775330816660845
STAT,1879,32,50-100,1911,0.9657226506093001
STAT,1919,25,40-44,1944,5.119453891302478
SIM,1816,42,45-49,1858,4
STAT,1837,42,35-39,1879,1.4577352663293037
SIM,1849,32,na,1881,1981
STAT,1869,43,na,1912,2253.1468438207185
STAT,1872,28,45-49,1900,1.1234564447058821
SIM,1917,4,na,1921,4269
STAT,1892,19,30-34,1911,2.0092039184353294
SIM,1778,89,na,1867,11
SIM,1920,36,45-49,1956,3
SIM,1834,38,20-24,1872,1
STAT,1848,48,20-24,1896,0.009674395796870757
SIM,1880,28,45-49,1908,2
STAT,1861,25,30-34,1886,21.597238616598656
STAT,1879,23,30-34,1902,18.716131162465864
STAT,1880,16,35-39,1896,0.5834510030003481
SIM,1895,46,50-100,1941,2
SIM,1838,43,50-100,1881,1
STAT,1887,46,50-100,1933,0.27773615634697973
STAT,1893,29,20-24,1922,14.937371017272122
SIM,1864,21,40-44,1885,2
STAT,1862,32,20-24,1894,2.3576627167371105
STAT,1875,33,45-49,1908,1.8010900604943838
STAT,1914,36,45-49,1950,0.6900497821776238
SIM,1844,24,20-24,1868,6
SIM,1877,37,30-34,1914,6
STAT,1860,19,15-19,1879,5.5845786139622
STAT,1895,45,30-34,1940,0.07273770754267994
SIM,1953,15,40-44,1968,2
STAT,1871,41,25-29,1912,0.6472714710739855
STAT,1925,18,20-24,1943,165.07939413023482
STAT,1870,32,50-100,1902,0.9087215665346892
SIM,1854,31,25-29,1885,10
STAT,1779,99,na,1878,0.41138090461185917
STAT,1901,42,25-29,1943,0.06305917673681921
STAT,1860,40,40-44,1900,1.8758002931368725
SIM,1872,98,na,1970,6
SIM,1849,66,na,1915,1221
SIM,1933,20,50-100,1953,1
STAT,1863,17,50-100,1880,0.05002822342400571
STAT,1830,46,35-39,1876,0.11862587128546677
STAT,1944,2,na,1946,4400.27373569502
SIM,1943,22,20-24,1965,136
SIM,1770,86,na,1856,45
STAT,1846,17,40-44,1863,0.17436380452617806
STAT,1858,34,20-24,1892,2.12352966726118
STAT,1887,18,40-44,1905,0.20570951780052812
STAT,1945,15,40-44,1960,1.5438654939782828
STAT,1816,96,na,1912,4.390126477027372
SIM,1870,40,na,1910,2581
STAT,1886,35,na,1921,2536.258104644537
STAT,1909,57,na,1966,3256.967532263023
SIM,1881,80,na,1961,649
STAT,1832,55,na,1887,1429.0257079466605
SIM,1890,32,40-44,1922,9
STAT,1846,35,40-44,1881,3.5419209283053483
STAT,1923,23,40-44,1946,3.940677024635311
STAT,1891,34,40-44,1925,5.376540102397073
STAT,1884,27,25-29,1911,42.13200378772644
SIM,1909,0,na,1909,4471
SIM,1934,13,na,1947,5526
STAT,1856,36,40-44,1892,3.406017748741469
SIM,1887,23,30-34,1910,29
STAT,1803,78,na,1881,390.40339870904813
SIM,1902,24,25-29,1926,114
STAT,1845,84,na,1929,243.0723520176359
STAT,1859,48,30-34,1907,0.07764604381470522
STAT,1935,22,20-24,1957,152.98418490579076
STAT,1811,110,na,1921,1.2046755453151691E-4
SIM,1866,16,20-24,1882,23
STAT,1860,37,15-19,1897,0.04636269751805414
STAT,1833,96,na,1929,6.075023788235393
STAT,1925,20,50-100,1945,0.8007252821504314
STAT,1843,41,50-100,1884,0.7431030383463206
SIM,1812,78,na,1890,265
SIM,1877,50,na,1927,2274
STAT,1905,41,50-100,1946,0.1076005529714691
STAT,1773,111,na,1884,0.0012953920937774888
STAT,1824,43,40-44,1867,2.737649379304685
SIM,1899,29,30-34,1928,52
STAT,1836,24,20-24,1860,56.55269342915895
STAT,1914,49,25-29,1963,0.05276775922131698
SIM,1865,17,na,1882,2396
STAT,1897,42,50-100,1939,0.09921441438339994
SIM,1861,8,na,1869,2541
SIM,1933,18,20-24,1951,293
STAT,1856,21,40-44,1877,1.8875862342747864
STAT,1863,50,30-34,1913,0.005403425073822312
STAT,1901,46,40-44,1947,0.13711905419827072
SIM,1832,43,40-44,1875,4
STAT,1837,48,45-49,1885,0.1650025923235981
SIM,1922,36,45-49,1958,1
STAT,1836,45,25-29,1881,0.03901403872533351
STAT,1846,31,25-29,1877,9.281576086737322
SIM,1849,55,na,1904,1623
STAT,1870,51,na,1921,2145.703891418501
SIM,1854,35,40-44,1889,5
STAT,1826,38,20-24,1864,0.866002138797842
SIM,1874,25,45-49,1899,1
STAT,1869,37,30-34,1906,5.233424150636114
STAT,1882,32,40-44,1914,4.2428160341897625
STAT,1850,34,15-19,1884,0.11172593123396288
STAT,1933,31,na,1964,5153.386846496726
STAT,1866,25,45-49,1891,1.04543643461349
STAT,1923,8,na,1931,4732.0045209139835
STAT,1925,47,50-100,1972,0.276984573677565
STAT,1887,36,40-44,1923,4.960031859779198
STAT,1812,42,30-34,1854,3.782868512700053
STAT,1894,40,15-19,1934,0.018138606598679195
STAT,1858,109,na,1967,0.0053767112695069135
STAT,1825,45,15-19,1870,5.522000053207224E-4
STAT,1949,22,15-19,1971,6.2752333602867765
SIM,1823,38,45-49,1861,3
SIM,1831,32,35-39,1863,2
SIM,1836,36,35-39,1872,13
SIM,1861,30,20-24,1891,3
STAT,1934,16,na,1950,5042.8692815753375
STAT,1781,89,na,1870,21.01789996044192
SIM,1853,39,35-39,1892,5
SIM,1892,27,25-29,1919,7
STAT,1867,39,20-24,1906,0.725868542910734
SIM,1917,35,25-29,1952,1
SIM,1893,38,30-34,1931,12
STAT,1831,104,na,1935,0.04191433957965675
STAT,1893,47,20-24,1940,0.008640375309993056
SIM,1805,53,na,1858,1062
STAT,1856,51,35-39,1907,0.006698288926851455
SIM,1828,70,na,1898,791
SIM,1886,43,35-39,1929,2
SIM,1823,41,40-44,1864,3
STAT,1927,44,40-44,1971,0.3160087539133392
SIM,1890,29,45-49,1919,1
STAT,1878,43,35-39,1921,1.8848416020454748
STAT,1854,22,15-19,1876,2.9090639975650303
STAT,1882,29,45-49,1911,1.0784986373424672
STAT,1845,39,35-39,1884,5.318454018744101
STAT,1892,36,15-19,1928,0.07151166377432051
STAT,1841,46,45-49,1887,0.17957023415225162
STAT,1838,22,30-34,1860,15.470185409579823
STAT,1883,61,na,1944,1846.905833165956
SIM,1810,48,50-100,1858,1
STAT,1844,19,30-34,1863,1.5841758205276602
STAT,1883,21,30-34,1904,17.658301528955345
STAT,1911,39,na,1950,3629.1636099041903
SIM,1945,20,30-34,1965,37
SIM,1838,34,45-49,1872,6
SIM,1915,22,45-49,1937,1
STAT,1823,32,35-39,1855,27.094298247187066
STAT,1851,18,30-34,1869,1.4586764958383047
SIM,1895,36,40-44,1931,3
SIM,1818,37,25-29,1855,1
STAT,1872,21,25-29,1893,58.303884400825694
STAT,1900,4,na,1904,3690.884247513485
STAT,1834,47,15-19,1881,2.526361228404224E-4
STAT,1877,28,25-29,1905,43.94076965278781
STAT,1897,25,45-49,1922,1.5136153799737972
STAT,1838,40,30-34,1878,0.9234101521485879
STAT,1909,35,25-29,1944,0.9493762920697663
STAT,1876,36,30-34,1912,5.584663113112242
STAT,1832,66,na,1898,1116.0416475615334
STAT,1890,23,35-39,1913,7.1796669817442025
STAT,1927,30,15-19,1957,0.15995513332934164
SIM,1846,22,30-34,1868,21
STAT,1852,55,na,1907,1568.1373169458432
STAT,1929,29,45-49,1958,2.183219316659999
STAT,1810,52,45-49,1862,0.053177605450282314
SIM,1864,32,na,1896,2546
STAT,1892,18,15-19,1910,7.50162026785299
SIM,1858,91,na,1949,18
SIM,1884,36,30-34,1920,3
SIM,1862,44,30-34,1906,1
STAT,1809,45,30-34,1854,0.3663954981820376
STAT,1819,49,35-39,1868,0.26486057793769485
STAT,1865,44,40-44,1909,2.046407529522134
STAT,1868,54,30-34,1922,0.005587932088891411
STAT,1947,24,35-39,1971,10.741939803926229
SIM,1869,24,na,1893,2232
SIM,1824,30,30-34,1854,26
SIM,1885,28,25-29,1913,54
STAT,1892,75,na,1967,1668.9933673268272
SIM,1891,21,30-34,1912,38
STAT,1849,91,na,1940,45.30666823065022
STAT,1937,20,30-34,1957,28.274965246067215
SIM,1869,32,na,1901,2297
STAT,1866,29,30-34,1895,23.382609939403114
SIM,1830,31,35-39,1861,11
STAT,1813,43,30-34,1856,3.873721592613129
STAT,1938,30,25-29,1968,9.392714914434633
STAT,1902,29,45-49,1931,1.573365210599751
STAT,1831,24,40-44,1855,2.270605460388376
STAT,1875,48,15-19,1923,4.0967358027152E-4
SIM,1901,29,na,1930,3387
STAT,1842,20,30-34,1862,20.521027595662
SIM,1871,1,na,1872,3367
SIM,1873,44,40-44,1917,3
STAT,1838,40,na,1878,1688.6868005733477
STAT,1899,38,25-29,1937,0.8571506033755859
STAT,1856,39,15-19,1895,0.043045436992565515
STAT,1925,46,30-34,1971,0.10944123021694238
STAT,1948,20,40-44,1968,3.9026456547660566
STAT,1949,22,45-49,1971,1.3264091313433617
STAT,1821,34,25-29,1855,25.836676135943588
STAT,1875,83,na,1958,507.72268560500595
SIM,1841,19,20-24,1860,19
STAT,1803,53,15-19,1856,1.0448535211538095E-4
SIM,1885,17,na,1902,2731
STAT,1885,38,30-34,1923,5.331449797035938
STAT,1880,34,30-34,1914,18.36114719668819
SIM,1857,43,45-49,1900,2
SIM,1910,29,45-49,1939,3
STAT,1869,36,50-100,1905,1.2113950119454235
STAT,1876,68,na,1944,1593.670025948422
STAT,1910,25,20-24,1935,18.056568267419134
STAT,1870,44,15-19,1914,0.013511550583726358
SIM,1872,33,35-39,1905,2
STAT,1818,47,30-34,1865,0.17235451293073414
SIM,1884,18,30-34,1902,5
SIM,1819,48,50-100,1867,2
SIM,1853,40,na,1893,1758
SIM,1862,22,15-19,1884,3
SIM,1850,20,30-34,1870,3
STAT,1839,36,na,1875,1833.5455404683137
STAT,1934,27,na,1961,5092.044443464331
STAT,1855,43,na,1898,1727.1510057567568
SIM,1913,54,na,1967,3465
STAT,1891,35,15-19,1926,0.07088694317179725
SIM,1924,46,na,1970,4443
STAT,1864,30,30-34,1894,16.04046995528575
SIM,1820,42,30-34,1862,4
STAT,1939,33,40-44,1972,4.02840253851496
SIM,1843,35,30-34,1878,14
SIM,1864,42,40-44,1906,3
STAT,1889,49,20-24,1938,0.008254059317490731
STAT,1945,19,na,1964,4057.8530676102664
SIM,1856,14,na,1870,2511
SIM,1908,39,na,1947,3377
STAT,1907,19,15-19,1926,8.7550861950165
SIM,1818,63,na,1881,874
SIM,1915,19,15-19,1934,12
STAT,1895,27,35-39,1922,12.726583218451541
SIM,1829,66,na,1895,1114
STAT,1865,76,na,1941,873.7487073185348
SIM,1841,15,na,1856,2092
SIM,1863,41,40-44,1904,4
STAT,1809,52,50-100,1861,0.04850678347421454
SIM,1829,44,50-100,1873,2
STAT,1828,36,35-39,1864,7.451885282350048
STAT,1919,21,20-24,1940,123.30937647605619
STAT,1854,40,15-19,1894,0.010468668978613727
STAT,1929,35,50-100,1964,0.5457583224629193
STAT,1824,44,15-19,1868,0.016459805672538057
STAT,1841,28,45-49,1869,1.023869109281073
SIM,1927,21,20-24,1948,190
STAT,1914,40,50-100,1954,0.11827145158898789
SIM,1842,14,na,1856,2285
SIM,1881,0,na,1881,3223
STAT,1891,31,35-39,1922,12.715426968960902
SIM,1935,16,30-34,1951,25
STAT,1854,23,30-34,1877,15.594013426758059
STAT,1933,15,45-49,1948,0.6788786490475108
SIM,1920,33,na,1953,4441
STAT,1897,61,na,1958,2600.347861832744
STAT,1936,25,40-44,1961,4.507309122448447
SIM,1914,42,45-49,1956,2
SIM,1935,30,50-100,1965,1
STAT,1885,41,20-24,1926,0.16038315914950718
SIM,1935,18,25-29,1953,71
SIM,1835,52,na,1887,1285
SIM,1841,40,45-49,1881,3
SIM,1918,19,35-39,1937,6
STAT,1850,38,30-34,1888,4.102731568167468
SIM,1867,29,20-24,1896,11
SIM,1839,41,30-34,1880,2
STAT,1866,47,25-29,1913,0.05361825379465745
SIM,1924,23,na,1947,4222
SIM,1871,90,na,1961,152
SIM,1827,57,na,1884,1196
STAT,1896,45,50-100,1941,0.18706204938679474
SIM,1853,16,15-19,1869,9
SIM,1873,91,na,1964,140
STAT,1889,66,na,1955,2041.2137174645768
STAT,1865,26,40-44,1891,2.7721575670937613
STAT,1898,32,30-34,1930,23.90599815057064
SIM,1944,25,40-44,1969,8
STAT,1927,16,30-34,1943,15.35577996452755
SIM,1918,29,na,1947,4110
SIM,1832,40,35-39,1872,4
STAT,1920,24,35-39,1944,10.504643593957764
SIM,1849,26,50-100,1875,4
SIM,1872,42,30-34,1914,4
STAT,1807,50,45-49,1857,0.05129792040774008
STAT,1846,69,na,1915,1113.696490903887
STAT,1845,16,15-19,1861,5.513168917604787
SIM,1941,15,45-49,1956,1
SIM,1944,9,na,1953,4301
STAT,1906,42,45-49,1948,0.15270320364429765
SIM,1862,23,30-34,1885,22
STAT,1885,39,50-100,1924,1.2218734754754907
STAT,1850,74,na,1924,849.7804433007205
STAT,1864,42,30-34,1906,1.0465028784131494
STAT,1894,17,50-100,1911,0.06370587259479404
SIM,1881,42,40-44,1923,5
STAT,1841,47,20-24,1888,0.0090144565321771
STAT,1852,35,30-34,1887,4.149118515872553
SIM,1869,86,na,1955,218
STAT,1780,84,na,1864,91.82199574373568
SIM,1915,46,50-100,1961,2
STAT,1816,53,20-24,1869,0.001796489279669057
STAT,1911,24,25-29,1935,87.82740232833648
SIM,1860,35,30-34,1895,3
SIM,1910,15,15-19,1925,11
STAT,1876,14,na,1890,2684.4326581475298
STAT,1902,15,15-19,1917,8.509500808502805
STAT,1927,45,na,1972,4683.028407207654
STAT,1948,24,20-24,1972,128.88551958695908
SIM,1878,30,30-34,1908,39
STAT,1883,44,20-24,1927,0.15484749852169796
STAT,1839,42,50-100,1881,0.7894086483365681
SIM,1919,31,40-44,1950,8
STAT,1862,54,30-34,1916,0.00504915974784369
STAT,1873,42,40-44,1915,2.300219619000451
SIM,1848,39,na,1887,1772
STAT,1907,17,na,1924,3746.0493893868725
STAT,1918,25,20-24,1943,19.745215687980618
STAT,1790,94,na,1884,3.7245296002544426
STAT,1858,74,na,1932,879.3815757715972
SIM,1820,44,50-100,1864,3
STAT,1865,41,35-39,1906,1.6775903859221333
STAT,1894,29,50-100,1923,0.8258695022323939
SIM,1865,31,30-34,1896,33
STAT,1868,19,na,1887,2452.932716833148
STAT,1949,9,na,1958,4617.197799812912
STAT,1886,15,20-24,1901,18.993419876979512
SIM,1856,29,45-49,1885,4
STAT,1888,31,50-100,1919,1.0967307211823358
STAT,1931,36,45-49,1967,0.913293076259267
STAT,1887,31,na,1918,2701.9107638107134
STAT,1882,40,25-29,1922,0.6345920685197003
SIM,1838,94,na,1932,12
SIM,1876,34,na,1910,2725
SIM,1848,34,35-39,1882,4
STAT,1909,45,35-39,1954,0.12069994304948106
SIM,1879,3,na,1882,3123
SIM,1852,44,na,1896,1681
SIM,1873,26,40-44,1899,4
STAT,1896,20,30-34,1916,23.95570457996025
STAT,1907,25,45-49,1932,1.6580051824543331
STAT,1772,89,na,1861,25.694799089133845
STAT,1951,18,30-34,1969,14.659874592980858
STAT,1871,45,40-44,1916,0.173498859279637
SIM,1889,35,35-39,1924,23
STAT,1825,87,na,1912,128.56949737274684
STAT,1870,49,40-44,1919,0.1662489746792755
STAT,1854,48,45-49,1902,0.17488937488493067
STAT,1873,31,na,1904,2453.3518632846126
STAT,1906,21,50-100,1927,0.6017130459743296
STAT,1944,15,20-24,1959,147.40857132871392
SIM,1778,80,na,1858,112
SIM,1870,43,na,1913,2554
STAT,1879,23,35-39,1902,6.131589620744039
STAT,1880,52,25-29,1932,0.0037370495439695245
STAT,1801,97,na,1898,2.1380473439704075
STAT,1911,48,50-100,1959,0.21542534789961187
STAT,1932,32,45-49,1964,2.1139714728864076
SIM,1873,41,35-39,1914,1
STAT,1927,18,25-29,1945,54.318387019029316
STAT,1865,24,50-100,1889,0.375212173340396
STAT,1848,29,45-49,1877,1.0667244861404248
STAT,1844,40,20-24,1884,0.1320269450557088
STAT,1859,44,15-19,1903,0.011066791028747462
SIM,1952,15,20-24,1967,163
STAT,1921,20,na,1941,4190.663714292045
STAT,1934,31,50-100,1965,1.1412877970878443
STAT,1892,37,25-29,1929,3.649034580976036
SIM,1887,23,35-39,1910,10
STAT,1883,41,na,1924,2294.6993281005794
SIM,1863,61,na,1924,1731
STAT,1902,31,20-24,1933,3.8737338701331234
SIM,1840,41,40-44,1881,4
SIM,1808,50,na,1858,1245
STAT,1842,43,20-24,1885,0.14605018889230392
STAT,1887,51,na,1938,2439.6947911005236
STAT,1934,37,40-44,1971,2.0873411652157445
STAT,1843,19,15-19,1862,5.05504959696335
STAT,1782,99,na,1881,0.3654781760968747
SIM,1909,26,30-34,1935,61
STAT,1900,43,20-24,1943,0.015361059473607807
STAT,1889,32,na,1921,2971.8979270807304
STAT,1856,34,50-100,1890,0.7034169343165054
SIM,1920,20,25-29,1940,171
STAT,1825,46,25-29,1871,0.07842185859225427
SIM,1911,50,na,1961,3764
SIM,1936,30,30-34,1966,4
STAT,1859,29,20-24,1888,9.555658909941679
SIM,1861,80,na,1941,480
STAT,1833,40,45-49,1873,1.3211933799885942
STAT,1914,5,na,1919,4182.679174284138
STAT,1840,41,30-34,1881,0.8515143508873636
SIM,1863,22,35-39,1885,8
SIM,1913,51,na,1964,3514
STAT,1919,24,25-29,1943,101.48546178251472
SIM,1909,46,na,1955,3766
STAT,1942,22,na,1964,3865.8712909085148
SIM,1925,26,15-19,1951,4
STAT,1856,50,25-29,1906,0.002782158817203338
SIM,1922,14,na,1936,5133
STAT,1861,33,15-19,1894,0.11901555512193246
SIM,1847,36,40-44,1883,4
STAT,1877,40,15-19,1917,0.01454094609955547
SIM,1846,22,35-39,1868,10
SIM,1897,27,40-44,1924,9
STAT,1924,47,25-29,1971,0.06381498156287675
SIM,1883,16,na,1899,2863
STAT,1838,109,na,1947,4.7627000356368016E-4
STAT,1844,33,15-19,1877,0.1333435207700452
SIM,1868,28,25-29,1896,40
STAT,1905,46,45-49,1951,0.19492525669951496
STAT,1840,48,15-19,1888,2.791563234736471E-4
STAT,1832,41,40-44,1873,1.9037164310678243
STAT,1848,64,na,1912,1419.2974116690464
SIM,1849,38,50-100,1887,1
SIM,1945,21,40-44,1966,4
STAT,1844,18,20-24,1862,17.72511060329643
STAT,1805,52,50-100,1857,0.06209025838884307
SIM,1833,23,35-39,1856,6
STAT,1830,47,45-49,1877,0.19739644398637304
SIM,1876,68,na,1944,1575
SIM,1919,15,35-39,1934,4
STAT,1881,60,na,1941,1856.7642501738183
STAT,1855,22,35-39,1877,5.131515321516668
SIM,1882,39,30-34,1921,7
STAT,1806,106,na,1912,0.004093715087131645
SIM,1831,39,50-100,1870,1
STAT,1849,25,45-49,1874,1.0439813987072253
SIM,1855,47,50-100,1902,5
STAT,1889,27,40-44,1916,3.730657887719277
STAT,1804,54,40-44,1858,0.027381628134066853
STAT,1926,42,30-34,1968,0.15928808680698067
STAT,1857,31,30-34,1888,13.992027609713965
STAT,1850,30,35-39,1880,9.101253719399743
STAT,1852,89,na,1941,79.67174492891044
STAT,1928,33,35-39,1961,11.542365528137958
STAT,1900,45,15-19,1945,3.197218116230003E-4
SIM,1868,39,na,1907,2124
STAT,1841,34,50-100,1875,0.8142434165560355
STAT,1865,49,30-34,1914,0.08741040015996794
SIM,1894,15,20-24,1909,30
STAT,1898,49,na,1947,3016.74397883732
SIM,1872,44,na,1916,2494
STAT,1937,21,40-44,1958,3.3066177412419737
SIM,1915,22,40-44,1937,4
STAT,1937,9,na,1946,3909.693945327547
STAT,1896,14,na,1910,3441.433785866172
STAT,1813,47,45-49,1860,0.6868012096805138
SIM,1823,41,na,1864,1594
SIM,1836,33,30-34,1869,25
SIM,1863,16,na,1879,2458
SIM,1901,17,30-34,1918,5
STAT,1859,51,20-24,1910,6.023062530940272E-4
STAT,1865,48,20-24,1913,0.010928014301281019
SIM,1894,53,na,1947,3021
STAT,1908,21,15-19,1929,4.954968938424328
SIM,1932,9,na,1941,6020
SIM,1916,21,15-19,1937,6
STAT,1890,29,na,1919,2924.302506177916
STAT,1907,48,35-39,1955,0.11566118572814296
STAT,1924,40,40-44,1964,0.30147566862232583
SIM,1848,70,na,1918,1006
SIM,1903,21,na,1924,3229
STAT,1856,46,50-100,1902,0.19071939550548772
STAT,1902,26,40-44,1928,4.290120912963731
STAT,1829,32,35-39,1861,9.020198461533743
STAT,1839,36,40-44,1875,3.7474693731617226
STAT,1880,38,45-49,1918,2.104024293972291
SIM,1936,31,40-44,1967,5
STAT,1818,43,15-19,1861,0.026226236402877433
STAT,1896,23,35-39,1919,7.777470152966114
STAT,1905,36,na,1941,3483.7853546328065
STAT,1807,48,30-34,1855,0.341320381661244
STAT,1807,82,na,1889,173.76098003971723
STAT,1821,97,na,1918,3.217929766988162
STAT,1835,43,15-19,1878,0.012266009428031823
STAT,1907,22,40-44,1929,3.0907633347803998
STAT,1903,39,35-39,1942,2.1738209271398556
STAT,1875,30,40-44,1905,4.5342746998604575
STAT,1814,51,30-34,1865,0.013987261207784908
STAT,1824,48,30-34,1872,0.11171867472456272
STAT,1923,49,30-34,1972,0.10475082812562671
SIM,1900,34,30-34,1934,26
STAT,1886,17,15-19,1903,6.328563402918071
STAT,1828,33,30-34,1861,19.73277694682359
STAT,1926,5,na,1931,4982.234726392602
SIM,1926,25,20-24,1951,28
STAT,1959,2,na,1961,5199.121526508027
STAT,1867,52,50-100,1919,0.014289588489214158
SIM,1852,24,na,1876,1891
STAT,1865,22,na,1887,2207.694365082839
STAT,1860,98,na,1958,4.244025170819884
STAT,1865,40,25-29,1905,0.5982090254251377
STAT,1871,47,35-39,1918,0.1398244672530467
SIM,1852,18,20-24,1870,22
STAT,1923,41,35-39,1964,0.23814438696395718
SIM,1859,2,na,1861,3208
SIM,1863,44,45-49,1907,3
SIM,1883,30,40-44,1913,6
STAT,1871,101,na,1972,5.542269964427368
STAT,1808,106,na,1914,0.004577508091892232
STAT,1895,24,30-34,1919,23.346674112191856
STAT,1917,26,15-19,1943,0.7498611374773512
STAT,1848,51,45-49,1899,0.011905474965966688
STAT,1885,34,15-19,1919,0.1419420612657723
STAT,1925,35,50-100,1960,0.5101496306024464
STAT,1908,47,40-44,1955,0.14393413714945386
SIM,1888,37,40-44,1925,8
STAT,1881,46,na,1927,2196.5861214500082
SIM,1774,90,na,1864,15
SIM,1858,15,na,1873,2194
STAT,1891,39,30-34,1930,6.597445346022914
STAT,1924,48,35-39,1972,0.1546746652410088
STAT,1878,94,na,1972,104.45815801165232
STAT,1928,31,40-44,1959,4.948727327476837
SIM,1927,24,25-29,1951,156
SIM,1865,96,na,1961,46
SIM,1785,82,na,1867,109
SIM,1911,39,35-39,1950,7
STAT,1867,31,na,1898,2279.1876828044974
STAT,1818,50,20-24,1868,0.00131340986758966
STAT,1837,20,50-100,1857,0.3874424895736827
STAT,1874,39,30-34,1913,5.456320120018188
STAT,1838,22,35-39,1860,5.068185698473598
STAT,1874,19,45-49,1893,0.0671935665395517
STAT,1869,19,35-39,1888,0.5398546595578467
STAT,1824,40,35-39,1864,2.3447695835194566
STAT,1933,38,35-39,1971,3.3257836581660656
STAT,1936,28,na,1964,3617.703528815661
STAT,1917,42,20-24,1959,0.018603166507305466
SIM,1831,41,30-34,1872,3
STAT,1854,98,na,1952,2.437986509536676
STAT,1845,22,na,1867,1939.4947971165338
SIM,1939,24,20-24,1963,170
STAT,1960,9,na,1969,5169.072956253605
STAT,1881,49,15-19,1930,3.812949403092159E-4
SIM,1832,24,na,1856,1781
SIM,1880,73,na,1953,980
STAT,1918,41,25-29,1959,0.0767609439920058
SIM,1840,35,50-100,1875,3
SIM,1909,25,20-24,1934,35
STAT,1850,15,40-44,1865,0.17317456481679133
SIM,1902,34,35-39,1936,3
STAT,1890,32,30-34,1922,21.54809929244167
STAT,1890,43,na,1933,2831.836177423679
SIM,1894,17,15-19,1911,12
STAT,1832,89,na,1921,71.53348374125135
SIM,1817,47,na,1864,1527
SIM,1877,19,35-39,1896,3
STAT,1782,107,na,1889,0.008492057346141004
SIM,1898,26,45-49,1924,1
STAT,1823,41,30-34,1864,1.7489553804847677
STAT,1883,47,25-29,1930,0.05666477688802679
STAT,1918,40,15-19,1958,0.0016529715514900976
STAT,1887,30,30-34,1917,19.846637564867187
SIM,1903,24,40-44,1927,8
STAT,1812,48,40-44,1860,0.3885896689379379
STAT,1863,41,na,1904,2077.663401406737
STAT,1818,53,25-29,1871,0.005938344092167823
STAT,1920,21,30-34,1941,32.36389802025651
SIM,1891,31,45-49,1922,4
SIM,1872,20,50-100,1892,1
SIM,1954,2,na,1956,4843
STAT,1900,44,na,1944,3209.9725140692876
SIM,1869,18,30-34,1887,2
SIM,1882,82,na,1964,499
STAT,1901,35,20-24,1936,0.23780897336027085
SIM,1918,16,30-34,1934,4
STAT,1845,17,25-29,1862,5.2333561732981995
SIM,1913,31,na,1944,3782
STAT,1874,44,50-100,1918,1.077823881957707
STAT,1908,28,30-34,1936,37.259104288951924
STAT,1868,41,20-24,1909,0.15399441980596434
STAT,1841,40,35-39,1881,1.4436558442883634
STAT,1767,106,na,1873,0.009967877902332119
STAT,1918,29,50-100,1947,1.0617682815960385
STAT,1932,39,30-34,1971,2.4694478540343234
SIM,1886,23,15-19,1909,3
STAT,1807,68,na,1875,737.494210235458
STAT,1878,23,15-19,1901,3.4481895547555745
STAT,1869,18,25-29,1887,5.608317812369065
SIM,1882,44,50-100,1926,2
STAT,1871,23,30-34,1894,17.8180476780596
SIM,1935,15,20-24,1950,178
STAT,1883,31,45-49,1914,1.7305873572009074
SIM,1913,19,15-19,1932,8
SIM,1831,27,50-100,1858,2
SIM,1876,88,na,1964,245
SIM,1783,81,na,1864,182
STAT,1881,42,30-34,1923,1.117899265084167
SIM,1870,63,na,1933,2036
STAT,1925,43,25-29,1968,0.08723430103220375
SIM,1898,35,na,1933,3289
SIM,1858,0,na,1858,3240
STAT,1881,15,50-100,1896,0.04791840707711424
STAT,1864,45,35-39,1909,0.1288662641539214
STAT,1850,40,45-49,1890,1.1575615955120373
SIM,1951,16,15-19,1967,65
STAT,1824,50,45-49,1874,0.017033252399040213
STAT,1836,26,15-19,1862,0.3730311340828391
STAT,1947,8,na,1955,4471.854774966925
SIM,1889,32,30-34,1921,28
STAT,1905,19,15-19,1924,8.618548700962931
STAT,1895,49,45-49,1944,0.17191913824295507
SIM,1896,34,na,1930,3142
SIM,1869,27,30-34,1896,28
SIM,1824,40,45-49,1864,2
STAT,1857,19,45-49,1876,0.05980779729451684
STAT,1800,78,na,1878,277.3473596858082
SIM,1930,23,na,1953,4909
SIM,1919,18,40-44,1937,1
SIM,1920,30,50-100,1950,1
STAT,1853,17,na,1870,2283.503573042133
STAT,1875,15,45-49,1890,0.06806843769125319
STAT,1943,16,15-19,1959,48.60707158149928
STAT,1935,8,na,1943,5508.7475914073375
SIM,1853,17,25-29,1870,3
STAT,1896,68,na,1964,2272.865768278261
STAT,1770,94,na,1864,2.0914604678898048
STAT,1885,44,25-29,1929,0.6368705100813374
STAT,1918,54,na,1972,3843.911011415335
STAT,1879,53,30-34,1932,0.0061732505353873255
SIM,1916,28,30-34,1944,52
STAT,1865,29,45-49,1894,1.0166651157048732
STAT,1814,43,45-49,1857,3.986486946188663
SIM,1843,95,na,1938,41
STAT,1903,35,na,1938,3448.0479256954304
STAT,1891,41,45-49,1932,1.8799840681981035
SIM,1900,36,25-29,1936,1
STAT,1891,38,20-24,1929,0.9591486305000937
STAT,1892,30,40-44,1922,5.540443988840098
SIM,1848,31,30-34,1879,8
STAT,1878,40,na,1918,2447.6816262034795
STAT,1867,46,30-34,1913,0.09233970965141984
SIM,1877,34,30-34,1911,24
SIM,1883,37,25-29,1920,4
STAT,1884,42,15-19,1926,0.013737587203610385
STAT,1871,48,45-49,1919,0.23383261104545572
STAT,1906,41,35-39,1947,0.18582331508926705
SIM,1818,40,na,1858,1424
STAT,1927,15,20-24,1942,171.17474590536946
STAT,1927,19,50-100,1946,0.46831988923824747
SIM,1874,53,na,1927,1994
STAT,1820,54,25-29,1874,0.005555159894115726
SIM,1850,30,45-49,1880,2
STAT,1816,40,45-49,1856,4.633038329351326
STAT,1932,12,na,1944,5302.143450228993
STAT,1824,47,20-24,1871,0.014041376288653803
STAT,1850,54,na,1904,1603.3718044711882
STAT,1912,30,50-100,1942,0.8273946504903966
SIM,1936,33,35-39,1969,10
STAT,1907,45,na,1952,3370.9218802022983
STAT,1912,48,45-49,1960,0.21014483565558648
SIM,1909,29,35-39,1938,22
STAT,1925,23,50-100,1948,0.793516469860283
SIM,1891,11,na,1902,3383
STAT,1875,37,25-29,1912,2.986353659158539
SIM,1845,76,na,1921,772
SIM,1943,25,20-24,1968,22
SIM,1861,35,na,1896,2067
SIM,1895,30,30-34,1925,5
STAT,1810,88,na,1898,71.29962701464027
SIM,1866,44,na,1910,2339
SIM,1898,25,35-39,1923,20
STAT,1935,25,20-24,1960,25.161530176624037
SIM,1870,2,na,1872,3362
SIM,1839,44,35-39,1883,3
STAT,1822,51,25-29,1873,0.005159927767607616
STAT,1947,11,na,1958,4470.289808240278
SIM,1910,7,na,1917,3792
SIM,1827,27,25-29,1854,39
STAT,1862,16,15-19,1878,5.963471021042838
STAT,1898,35,35-39,1933,9.776279120036312
SIM,1822,43,45-49,1865,2
STAT,1892,34,20-24,1926,3.3964700607273173
STAT,1915,7,na,1922,4207.729940226639
STAT,1838,74,na,1912,742.9218556489528
SIM,1835,66,na,1901,900
SIM,1858,94,na,1952,3
STAT,1838,52,30-34,1890,0.0039635811340518745
SIM,1877,18,25-29,1895,8
STAT,1853,49,40-44,1902,0.13862233336396387
STAT,1912,20,25-29,1932,89.84344535904987
STAT,1909,42,30-34,1951,0.12066673737080777
STAT,1780,101,na,1881,0.11951825541896421
STAT,1844,43,25-29,1887,0.5137188509561743
SIM,1871,38,45-49,1909,3
SIM,1894,18,25-29,1912,10
SIM,1887,20,30-34,1907,33
SIM,1926,29,50-100,1955,1
STAT,1881,34,45-49,1915,1.6831898055749148
SIM,1830,74,na,1904,504
SIM,1853,71,na,1924,909
STAT,1869,34,30-34,1903,16.997931498015372
STAT,1841,91,na,1932,43.33422013955145
STAT,1920,38,50-100,1958,0.4637446974349705
STAT,1855,52,30-34,1907,0.004456755499653929
SIM,1791,68,na,1859,620
STAT,1879,16,25-29,1895,5.987399909594887
SIM,1870,16,15-19,1886,6
STAT,1886,18,25-29,1904,6.027126993739184
SIM,1889,52,na,1941,2565
SIM,1890,49,na,1939,3017
STAT,1837,22,15-19,1859,2.946268232915535
STAT,1865,51,45-49,1916,0.013448199083782544
SIM,1857,24,35-39,1881,5
SIM,1874,25,na,1899,2331
STAT,1929,26,na,1955,4740.9130071182635
STAT,1840,33,45-49,1873,1.473492019768636
STAT,1870,29,na,1899,2350.0088280479467
STAT,1804,53,30-34,1857,0.015797934464700396
STAT,1863,27,na,1890,2135.675226706682
STAT,1833,65,na,1898,1195.6413124333203
STAT,1928,30,30-34,1958,19.93465070717825
SIM,1866,53,50-100,1919,1
SIM,1879,62,na,1941,2155
STAT,1900,28,30-34,1928,35.20612290546867
STAT,1919,50,na,1969,3987.03159408373
STAT,1902,41,30-34,1943,0.11446134182171348
SIM,1910,49,50-100,1959,1
STAT,1907,45,30-34,1952,0.08179650533330392
STAT,1823,44,35-39,1867,2.5528008705100986
STAT,1839,39,45-49,1878,1.6542312436043194
SIM,1934,35,25-29,1969,1
STAT,1825,43,20-24,1868,0.22256301304900655
SIM,1928,24,45-49,1952,2
STAT,1834,45,50-100,1879,0.17488423808000575
STAT,1926,35,25-29,1961,1.2182589098758096
STAT,1830,51,50-100,1881,0.01133171269783014
STAT,1910,32,25-29,1942,8.991261641802696
STAT,1856,79,na,1935,541.3495354828876
STAT,1902,40,20-24,1942,0.015899080850241425
STAT,1922,43,40-44,1965,0.2895715245898607
STAT,1890,35,35-39,1925,8.812024156545755
STAT,1829,110,na,1939,1.6293941281074633E-4
STAT,1863,31,25-29,1894,9.203459885772261
STAT,1923,25,50-100,1948,1.162476835858649
STAT,1859,54,25-29,1913,0.0027981791412282
SIM,1792,64,na,1856,744
SIM,1868,25,20-24,1893,11
STAT,1830,44,40-44,1874,1.8998846016821858
STAT,1879,56,na,1935,2149.7738914194583
SIM,1904,57,na,1961,3247
STAT,1842,46,25-29,1888,0.05253673849755309
STAT,1863,53,35-39,1916,0.0075804604386510415
STAT,1867,29,50-100,1896,0.6041404366632878
SIM,1902,31,30-34,1933,32
SIM,1921,49,na,1970,4065
STAT,1910,31,15-19,1941,0.12552054531478882
STAT,1860,13,na,1873,2262.83606523525
STAT,1942,27,50-100,1969,1.0547673977725869
SIM,1842,36,25-29,1878,3
STAT,1802,59,na,1861,995.904874496748
SIM,1814,50,na,1864,1278
STAT,1834,36,25-29,1870,2.155117768187996
STAT,1849,42,50-100,1891,0.8249730363263507
SIM,1915,25,45-49,1940,2
SIM,1798,80,na,1878,142
SIM,1881,35,na,1916,2099
STAT,1916,46,20-24,1962,0.011467272148129577
STAT,1926,45,35-39,1971,0.1615371784064921
SIM,1885,62,na,1947,1902
STAT,1806,51,40-44,1857,0.03099308525570735
STAT,1830,28,50-100,1858,0.6698995978066746
STAT,1829,25,50-100,1854,1.6758102203788754
STAT,1830,43,30-34,1873,0.9848910578850796
STAT,1842,45,15-19,1887,3.6954243305599226E-4
SIM,1909,28,25-29,1937,90
SIM,1932,28,15-19,1960,1
STAT,1816,73,na,1889,623.816721152168
STAT,1850,18,45-49,1868,0.060761613166634504
STAT,1863,52,25-29,1915,0.0031528370897715443
STAT,1914,27,na,1941,3810.282315840583
STAT,1913,22,35-39,1935,9.20588957485417
STAT,1903,55,na,1958,3035.1266215800724
SIM,1850,43,na,1893,1908
STAT,1933,35,30-34,1968,2.512918932715106
SIM,1807,57,na,1864,1048
STAT,1817,58,na,1875,1090.851819709927
STAT,1896,45,45-49,1941,0.17975017804473578
STAT,1838,24,50-100,1862,0.34910331332560934
STAT,1855,21,50-100,1876,0.3611898435748592
SIM,1928,39,na,1967,4916
SIM,1946,24,na,1970,4102
SIM,1926,17,35-39,1943,7
SIM,1900,37,35-39,1937,6
SIM,1942,18,30-34,1960,23
STAT,1856,100,na,1956,0.9751550569392644
SIM,1865,34,35-39,1899,1
STAT,1883,47,na,1930,2213.3112261337033
SIM,1825,42,na,1867,1389
STAT,1862,79,na,1941,609.7737940603681
STAT,1861,94,na,1955,16.773917656984583
STAT,1934,18,30-34,1952,16.614861563971655
SIM,1890,18,na,1908,3399
SIM,1831,44,35-39,1875,4
STAT,1857,34,35-39,1891,7.914258506412011
STAT,1872,55,na,1927,2099.5995423091263
SIM,1835,19,30-34,1854,1
STAT,1785,93,na,1878,6.84564325113141
STAT,1948,23,40-44,1971,3.8986663083119146
STAT,1869,12,na,1881,2611.6801405437395
STAT,1928,34,45-49,1962,1.986196939097009
STAT,1871,44,30-34,1915,1.1380334358818864
STAT,1826,45,30-34,1871,0.09801876363301766
STAT,1883,46,15-19,1929,3.964706678668548E-4
STAT,1924,28,15-19,1952,0.827679591652081
STAT,1843,41,na,1884,1625.7146295138862
STAT,1829,91,na,1920,34.16822974315372
STAT,1850,37,20-24,1887,0.5995965735054258
STAT,1849,24,35-39,1873,5.437255779618851
SIM,1931,25,50-100,1956,1
STAT,1887,85,na,1972,689.5290648644158
SIM,1936,34,45-49,1970,2
STAT,1858,40,na,1898,1849.8748171488764
STAT,1886,0,na,1886,3541.6292792561244
SIM,1845,22,15-19,1867,4
SIM,1921,22,35-39,1943,20
STAT,1829,54,45-49,1883,0.009150257206189253
SIM,1878,69,na,1947,1584
STAT,1883,34,50-100,1917,0.8978375323457137
SIM,1852,78,na,1930,456
STAT,1927,19,35-39,1946,5.2451837312760485
SIM,1935,19,35-39,1954,4
STAT,1846,103,na,1949,0.10891137967512171
STAT,1866,44,20-24,1910,0.14652228299796924
SIM,1865,41,45-49,1906,5
STAT,1854,13,na,1867,2133.43857492968
STAT,1893,36,30-34,1929,6.86776821766576
STAT,1888,39,na,1927,2780.320717140319
SIM,1918,35,40-44,1953,3
STAT,1957,4,na,1961,5237.613131858362
SIM,1794,73,na,1867,557
STAT,1820,49,45-49,1869,0.3893761246998195
STAT,1822,52,35-39,1874,0.01229460425648478
STAT,1841,107,na,1948,0.0035266588094051998
SIM,1952,4,na,1956,4781
SIM,1831,50,50-100,1881,1
SIM,1910,57,na,1967,3017
SIM,1931,25,na,1956,4789
STAT,1887,8,na,1895,2931.3677801744348
STAT,1910,23,50-100,1933,0.6214983575192393
STAT,1936,18,50-100,1954,0.36117742730723235
STAT,1910,36,40-44,1946,1.4514200045040218
SIM,1883,67,na,1950,1667
STAT,1927,30,50-100,1957,1.029145239262781
SIM,1920,29,35-39,1949,19
STAT,1930,17,50-100,1947,0.489565755932266
STAT,1872,40,30-34,1912,1.1791765948947104
STAT,1874,33,na,1907,2457.4835231259863
STAT,1916,24,50-100,1940,0.6914552939755217
STAT,1809,91,na,1900,26.757339043958343
SIM,1920,24,40-44,1944,5
STAT,1846,53,35-39,1899,0.006428385979705478
STAT,1816,38,30-34,1854,21.425950229561014
SIM,1948,17,20-24,1965,180
STAT,1941,26,na,1967,3914.215916108536
STAT,1947,24,50-100,1971,0.7506597527043002
STAT,1764,91,na,1855,9.182699999999999
STAT,1896,2,na,1898,3563.777288627878
STAT,1893,32,15-19,1925,0.1826295077134033
STAT,1912,49,na,1961,3541.2123284388185
STAT,1936,7,na,1943,3863.6438116005197
STAT,1883,29,30-34,1912,24.71118101589605
STAT,1887,17,30-34,1904,1.797320420300919
STAT,1846,38,na,1884,1847.7989764864583
SIM,1856,41,35-39,1897,2
STAT,1883,40,40-44,1923,2.245551843791911
SIM,1835,83,na,1918,165
SIM,1843,28,20-24,1871,17
STAT,1912,24,40-44,1936,3.3666706297745663
STAT,1835,53,25-29,1888,0.002657166611792415
STAT,1872,49,50-100,1921,0.24418035131780866
STAT,1876,45,na,1921,2369.621485102427
STAT,1909,40,na,1949,3545.1124376254884
SIM,1891,2,na,1893,3447
SIM,1807,88,na,1895,76
STAT,1898,17,40-44,1915,0.2504324711488931
SIM,1911,17,25-29,1928,11
STAT,1847,15,35-39,1862,0.5188615422432138
SIM,1852,75,na,1927,664
STAT,1929,17,45-49,1946,0.6443667714752143
SIM,1880,40,30-34,1920,3
STAT,1901,24,30-34,1925,25.06177416695886
SIM,1863,43,35-39,1906,2
STAT,1910,34,na,1944,3647.6941102514534
STAT,1881,52,40-44,1933,0.010194793312806573
STAT,1837,41,25-29,1878,0.5236127019412251
SIM,1858,20,35-39,1878,10
STAT,1864,4,na,1868,2761.513268869268
STAT,1835,28,20-24,1863,11.397597676567836
SIM,1872,34,45-49,1906,4
STAT,1895,20,15-19,1915,4.377254150363304
SIM,1828,26,30-34,1854,30
STAT,1826,103,na,1929,0.07874961707433714
SIM,1873,45,50-100,1918,2
SIM,1908,30,na,1938,3528
SIM,1914,21,50-100,1935,4
STAT,1893,44,15-19,1937,0.001213238922455369
STAT,1933,16,25-29,1949,58.76434852946207
SIM,1788,79,na,1867,286
SIM,1868,44,30-34,1912,2
STAT,1861,40,20-24,1901,0.1346335502959563
STAT,1912,29,35-39,1941,14.820186855104954
STAT,1832,80,na,1912,421.2171750858326
STAT,1866,38,na,1904,2192.457789999402
SIM,1935,32,na,1967,5155
STAT,1903,17,25-29,1920,8.151097347490381
SIM,1790,83,na,1873,173
STAT,1848,41,35-39,1889,1.4956739180154857
STAT,1821,40,na,1861,1689.2513679447275
STAT,1942,28,35-39,1970,15.902158890370423
SIM,1839,26,40-44,1865,3
SIM,1941,16,25-29,1957,61
SIM,1864,34,50-100,1898,1
STAT,1851,33,20-24,1884,2.108266189458121
STAT,1811,49,35-39,1860,0.33748619769467586
SIM,1894,34,30-34,1928,11
STAT,1884,46,30-34,1930,0.09668604882129696
STAT,1912,45,40-44,1957,0.1535885143699723
STAT,1840,51,40-44,1891,0.007415061659420535
STAT,1957,1,na,1958,5244.165739304326
SIM,1850,28,30-34,1878,31
SIM,1879,28,35-39,1907,12
SIM,1932,23,20-24,1955,162
SIM,1827,43,30-34,1870,2
STAT,1867,42,15-19,1909,0.01312003985225454
SIM,1899,21,35-39,1920,15
STAT,1928,18,40-44,1946,1.7767206900512063
SIM,1929,15,na,1944,4558
STAT,1843,44,50-100,1887,0.7150836663468729
STAT,1870,33,25-29,1903,10.11562569584461
STAT,1873,21,40-44,1894,2.1400734312171767
SIM,1899,62,na,1961,2765
STAT,1842,28,30-34,1870,27.836181029744694
STAT,1907,46,50-100,1953,0.20606809662250763
SIM,1898,22,30-34,1920,30
STAT,1908,18,20-24,1926,26.477664577238052
SIM,1901,39,45-49,1940,2
SIM,1884,29,20-24,1913,15
STAT,1886,34,30-34,1920,18.459512647906156
SIM,1900,17,15-19,1917,9
STAT,1853,26,15-19,1879,0.43779739658091504
STAT,1857,16,40-44,1873,0.17045612730400939
STAT,1889,42,35-39,1931,2.2524004749967292
SIM,1915,26,25-29,1941,11
STAT,1876,29,20-24,1905,12.146622058742775
SIM,1881,89,na,1970,193
SIM,1828,42,35-39,1870,1
STAT,1861,15,na,1876,2240.6277537122346
SIM,1879,46,50-100,1925,5
STAT,1890,45,45-49,1935,0.2941657122850052
STAT,1852,7,na,1859,2270.300993422772
STAT,1924,23,20-24,1947,132.17724797772678
SIM,1882,8,na,1890,2339
STAT,1836,93,na,1929,18.42731175182955
STAT,1887,33,35-39,1920,11.37155362449844
SIM,1895,33,35-39,1928,22
STAT,1813,44,40-44,1857,7.052336836225311
STAT,1855,44,45-49,1899,1.1113459170982003
SIM,1937,10,na,1947,3796
STAT,1907,26,25-29,1933,62.95796240686485
STAT,1934,33,25-29,1967,12.743020453168164
STAT,1870,45,25-29,1915,0.05769653396044233
STAT,1858,15,45-49,1873,0.06118194819108963
SIM,1900,33,20-24,1933,4
STAT,1919,43,35-39,1962,0.21998095311132773
SIM,1943,28,25-29,1971,81
SIM,1821,44,40-44,1865,4
STAT,1921,41,50-100,1962,0.13383324034736727
SIM,1906,52,na,1958,3053
STAT,1935,28,25-29,1963,90.60534789876138
STAT,1823,54,45-49,1877,0.01847621401404924
STAT,1922,46,45-49,1968,0.2528626610263387
STAT,1869,15,20-24,1884,17.85951448481881
SIM,1823,95,na,1918,12
STAT,1803,54,25-29,1857,0.014737004038673746
STAT,1892,33,50-100,1925,1.1563301521463893
SIM,1841,38,na,1879,1692
SIM,1798,89,na,1887,3
STAT,1861,60,na,1921,1600.6579796936487
STAT,1950,18,15-19,1968,54.19790789514927
SIM,1825,76,na,1901,414
SIM,1939,22,na,1961,3762
STAT,1911,46,35-39,1957,0.12344795091019455
STAT,1873,39,15-19,1912,0.05691850949177023
STAT,1896,65,na,1961,2408.5913179875943
SIM,1867,23,na,1890,2122
SIM,1871,35,40-44,1906,5
STAT,1936,21,25-29,1957,89.18412574726162
SIM,1939,26,45-49,1965,2
STAT,1873,50,25-29,1923,0.003678818107293246
STAT,1890,39,15-19,1929,0.06860624896574069
SIM,1878,15,na,1893,3018
SIM,1829,25,35-39,1854,7
STAT,1872,52,na,1924,2174.732269110188
STAT,1861,18,20-24,1879,17.0011938379951
STAT,1891,59,na,1950,2430.2595323657456
STAT,1942,21,15-19,1963,5.637097094108485
STAT,1920,46,45-49,1966,0.24321452417868974
SIM,1860,50,na,1910,1935
SIM,1900,67,na,1967,2653
SIM,1934,32,20-24,1966,4
STAT,1888,16,35-39,1904,0.6557291158041522
STAT,1925,21,15-19,1946,6.458886637159245
STAT,1890,74,na,1964,1651.5299649307108
SIM,1868,70,na,1938,1205
STAT,1900,46,25-29,1946,0.045714936971051466
STAT,1847,31,40-44,1878,3.8522562314626496
SIM,1874,21,30-34,1895,26
SIM,1904,23,45-49,1927,1
STAT,1838,36,50-100,1874,1.002079806263472
STAT,1843,75,na,1918,694.3390124421595
STAT,1877,27,15-19,1904,0.47295010730721526
STAT,1819,43,30-34,1862,2.3873776201685533
STAT,1905,67,na,1972,2703.989044019882
STAT,1808,46,25-29,1854,0.21627495952515718
SIM,1909,9,na,1918,4247
SIM,1924,38,35-39,1962,3
STAT,1833,30,35-39,1863,9.452897133046621
SIM,1933,21,15-19,1954,6
SIM,1898,15,na,1913,3442
STAT,1926,32,20-24,1958,2.9808240580871868
STAT,1854,39,50-100,1893,0.9121309208618237
SIM,1855,35,50-100,1890,2
SIM,1911,31,50-100,1942,3
STAT,1927,38,45-49,1965,0.8558232032696441
STAT,1925,47,40-44,1972,0.19307719482178465
STAT,1912,15,na,1927,3958.5797195505675
SIM,1838,27,35-39,1865,8
STAT,1778,91,na,1869,19.443738941799488
STAT,1892,52,na,1944,2714.4270811729693
STAT,1809,94,na,1903,9.228548849578921
STAT,1941,29,na,1970,3908.5821467413975
STAT,1836,43,30-34,1879,0.8518062637514984
SIM,1944,21,25-29,1965,101
STAT,1779,106,na,1885,0.015253049988481683
SIM,1818,94,na,1912,21
STAT,1814,103,na,1917,0.06717367687325876
STAT,1941,22,45-49,1963,1.1739319883462709
SIM,1865,39,30-34,1904,5
STAT,1857,50,40-44,1907,0.008417610946475819
STAT,1969,1,na,1970,4967.076294571985
STAT,1823,48,15-19,1871,5.42773364694856E-4
SIM,1811,70,na,1881,761
SIM,1844,43,30-34,1887,6
STAT,1843,48,35-39,1891,0.09323903124990254
STAT,1852,31,15-19,1883,0.1129891444964788
STAT,1872,22,35-39,1894,5.925468344953089
SIM,1855,31,40-44,1886,5
STAT,1880,19,na,1899,2664.57034448301
STAT,1849,21,30-34,1870,16.959428426410174
STAT,1947,14,na,1961,4467.9656576081325
STAT,1850,23,na,1873,1950.937098310712
STAT,1916,31,15-19,1947,0.13443513444135208
SIM,1857,21,30-34,1878,30
STAT,1823,75,na,1898,569.3578501023645
STAT,1899,16,45-49,1915,0.09076929638428494
SIM,1896,16,35-39,1912,3
SIM,1902,45,na,1947,3447
STAT,1943,21,na,1964,3924.3204602519977
SIM,1911,59,na,1970,3560
SIM,1855,15,35-39,1870,2
STAT,1812,54,35-39,1866,0.018259077984844895
SIM,1856,68,na,1924,1248
SIM,1805,76,na,1881,316
SIM,1844,40,50-100,1884,3
STAT,1840,54,50-100,1894,0.010295709834235984
STAT,1829,46,na,1875,1466.7502610169115
STAT,1838,71,na,1909,893.5508732564294
STAT,1846,16,30-34,1862,1.5284585712830998
STAT,1827,52,20-24,1879,7.30753100493341E-4
STAT,1927,31,25-29,1958,11.498369434762587
STAT,1948,7,na,1955,4544.061374513946
STAT,1901,45,30-34,1946,0.0780811858295906
STAT,1846,32,35-39,1878,9.082081177842188
STAT,1878,42,25-29,1920,0.67244369757301
SIM,1841,30,35-39,1871,14
SIM,1843,16,na,1859,2635
SIM,1854,32,35-39,1886,13
STAT,1884,49,35-39,1933,0.13652791434976258
SIM,1895,17,30-34,1912,2
STAT,1911,34,35-39,1945,8.900773150520035
STAT,1916,38,35-39,1954,2.4872460284806235
STAT,1862,33,30-34,1895,15.164454801898506
STAT,1882,45,na,1927,2223.0705311459815
STAT,1769,103,na,1872,0.0423185315078341
STAT,1804,106,na,1910,0.0037641623954304095
SIM,1854,16,30-34,1870,4
SIM,1891,40,40-44,1931,5
SIM,1857,30,na,1887,2141
STAT,1826,41,15-19,1867,0.014696910415533268
STAT,1876,51,20-24,1927,7.732159515585548E-4
SIM,1801,63,na,1864,699
STAT,1852,43,15-19,1895,0.010397607040738778
STAT,1864,49,15-19,1913,3.569429420171607E-4
SIM,1938,29,na,1967,3793
STAT,1897,18,35-39,1915,0.7410378251248622
SIM,1812,55,na,1867,1160
SIM,1918,31,25-29,1949,2
STAT,1922,49,15-19,1971,4.250116857223033E-4
SIM,1829,41,40-44,1870,6
STAT,1825,53,na,1878,1706.915867235377
STAT,1902,44,35-39,1946,0.17705058298751478
STAT,1843,41,15-19,1884,0.009713765916960555
SIM,1810,44,30-34,1854,3
SIM,1869,20,45-49,1889,4
STAT,1888,32,40-44,1920,5.169850399554814
SIM,1853,33,30-34,1886,18
STAT,1913,6,na,1919,4121.181555107968
STAT,1910,35,50-100,1945,0.4089722773119086
STAT,1795,83,na,1878,157.45304095059953
SIM,1863,30,na,1893,2207
SIM,1847,23,na,1870,1988
STAT,1920,44,na,1964,4128.354535877942
STAT,1806,48,15-19,1854,0.0011882580024909902
STAT,1866,21,30-34,1887,16.916104417630184
SIM,1809,69,na,1878,699
SIM,1891,29,30-34,1920,49
STAT,1815,46,na,1861,1331.3462700002774
SIM,1874,40,40-44,1914,6
STAT,1930,40,30-34,1970,0.17048835743227503
STAT,1857,35,15-19,1892,0.04468389088025116
SIM,1896,32,40-44,1928,9
STAT,1926,16,15-19,1942,56.373644874134946
STAT,1870,74,na,1944,1100.67525890004
SIM,1824,38,30-34,1862,8
STAT,1819,39,na,1858,1459.2806982305042
STAT,1779,76,na,1855,412.9447800000001
STAT,1874,67,na,1941,1639.415783088227
SIM,1950,21,15-19,1971,8
STAT,1845,33,30-34,1878,15.012114791156042
STAT,1827,36,15-19,1863,0.06688373706885582
STAT,1867,88,na,1955,130.58716085994917
STAT,1910,37,na,1947,3630.2083895598944
SIM,1934,16,15-19,1950,61
STAT,1866,40,40-44,1906,2.124822072579917
STAT,1894,27,15-19,1921,0.5899654588163932
SIM,1928,21,40-44,1949,6
STAT,1762,99,na,1861,0.22555476134646596
STAT,1816,52,45-49,1868,0.03604255502795496
STAT,1846,50,30-34,1896,0.004582215324261966
STAT,1901,20,na,1921,3368.551148881425
STAT,1833,38,30-34,1871,4.682690119411509
STAT,1837,26,30-34,1863,22.20930011813072
STAT,1892,55,na,1947,2620.5771404438087
SIM,1893,19,20-24,1912,31
SIM,1815,40,35-39,1855,5
STAT,1841,94,na,1935,14.945879586877483
STAT,1916,15,45-49,1931,0.10745359427712456
SIM,1847,20,na,1867,1965
STAT,1912,27,45-49,1939,1.717636594400681
STAT,1835,46,na,1881,1802.7907742555221
STAT,1845,53,na,1898,1548.0287316504175
STAT,1854,27,50-100,1881,0.5032809174632227
STAT,1874,31,35-39,1905,10.516106821132924
STAT,1861,43,25-29,1904,0.5350563786803553
SIM,1846,44,45-49,1890,1
SIM,1952,18,25-29,1970,67
SIM,1838,49,na,1887,1639
SIM,1843,61,na,1904,1748
SIM,1871,31,25-29,1902,16
STAT,1860,23,20-24,1883,58.23051353731273
STAT,1834,33,50-100,1867,0.6917398702658148
STAT,1894,40,50-100,1934,1.3876033034018873
STAT,1898,36,15-19,1934,0.07725738120300202
STAT,1899,8,na,1907,3603.3658473238006
SIM,1888,45,50-100,1933,1
STAT,1805,52,35-39,1857,0.035393469873096814
SIM,1777,87,na,1864,48
STAT,1942,25,30-34,1967,41.557740154938166
STAT,1885,18,50-100,1903,0.04912434001755113
SIM,1935,31,25-29,1966,21
STAT,1876,30,50-100,1906,0.9631806548679286
STAT,1902,56,na,1958,2974.4591248139345
STAT,1853,52,30-34,1905,0.004896413103917811
STAT,1909,16,15-19,1925,9.00286401286732
STAT,1901,27,35-39,1928,13.661507116822351
STAT,1910,39,45-49,1949,0.6511808500137003
STAT,1911,21,20-24,1932,106.71422318427909
SIM,1894,22,na,1916,3341
STAT,1872,43,35-39,1915,1.8254555001770734
SIM,1836,68,na,1904,1052
STAT,1907,23,20-24,1930,101.89709327307008
STAT,1820,46,40-44,1866,0.2956275611541157
SIM,1917,16,15-19,1933,11
STAT,1907,48,na,1955,3295.709322081742
STAT,1921,39,20-24,1960,0.2966456004314446
SIM,1909,17,35-39,1926,4
STAT,1883,43,45-49,1926,1.4685505770799248
SIM,1849,89,na,1938,45
SIM,1917,44,na,1961,3728
SIM,1941,18,15-19,1959,44
STAT,1814,61,na,1875,1095.368567724331
STAT,1829,60,na,1889,1143.6769552041376
STAT,1884,26,na,1910,2385.1223387461996
SIM,1900,15,25-29,1915,8
SIM,1864,17,35-39,1881,2
SIM,1880,43,35-39,1923,4
STAT,1840,54,45-49,1894,0.009893271681067657
STAT,1933,18,15-19,1951,61.23006246558041
SIM,1858,49,na,1907,1776
STAT,1906,49,30-34,1955,0.07864988050288588
STAT,1835,50,20-24,1885,5.874635850226198E-4
STAT,1830,54,na,1884,1416.96225987646
STAT,1945,17,50-100,1962,0.41331615484996453
SIM,1818,43,na,1861,1328
STAT,1874,16,40-44,1890,0.1896210107452365
STAT,1859,59,na,1918,1578.7450681646162
SIM,1841,38,30-34,1879,11
STAT,1894,33,na,1927,3089.9099780786178
STAT,1811,46,30-34,1857,0.24512564988028232
STAT,1917,55,na,1972,3751.769842248123
SIM,1891,43,45-49,1934,5
STAT,1777,98,na,1875,0.4293862421067919
SIM,1907,37,na,1944,3737
STAT,1820,47,na,1867,1311.9417017102587
SIM,1837,32,35-39,1869,10
SIM,1920,27,45-49,1947,2
SIM,1859,96,na,1955,12
SIM,1882,31,35-39,1913,14
SIM,1915,23,20-24,1938,149
STAT,1944,18,25-29,1962,47.07747640626825
STAT,1838,44,45-49,1882,1.0392611825527223
STAT,1856,17,35-39,1873,0.502405712218168
STAT,1883,22,50-100,1905,0.40304835051924387
STAT,1900,21,45-49,1921,0.9813036685016506
STAT,1834,33,20-24,1867,2.0407340572386348
STAT,1856,93,na,1949,22.630574249404802
SIM,1891,22,50-100,1913,1
STAT,1869,66,na,1935,1609.439926527548
SIM,1926,28,25-29,1954,81
SIM,1840,20,40-44,1860,3
SIM,1851,90,na,1941,33
STAT,1836,100,na,1936,0.6693926628776231
STAT,1838,20,na,1858,1883.9464336750937
STAT,1931,33,40-44,1964,5.179137551273395
SIM,1869,23,15-19,1892,3
SIM,1810,77,na,1887,464
SIM,1932,26,25-29,1958,111
SIM,1856,26,40-44,1882,5
SIM,1942,11,na,1953,4403
STAT,1921,18,50-100,1939,0.43018947587200806
STAT,1918,31,50-100,1949,0.8906168330380521
STAT,1864,26,na,1890,2182.5108606247272
STAT,1924,26,25-29,1950,77.70791165261313
STAT,1842,24,15-19,1866,3.6927258156447302
STAT,1863,16,30-34,1879,1.6372284753522226
STAT,1913,44,45-49,1957,0.1632099710231023
SIM,1849,86,na,1935,138
STAT,1843,72,na,1915,851.7819364061651
STAT,1890,42,40-44,1932,2.7725504632169535
SIM,1850,24,15-19,1874,4
SIM,1871,16,30-34,1887,1
SIM,1841,83,na,1924,235
STAT,1791,79,na,1870,254.37436713457635
STAT,1919,40,30-34,1959,0.1402730947814065
SIM,1861,38,na,1899,2061
STAT,1886,30,15-19,1916,0.15308323925615414
STAT,1918,28,25-29,1946,70.46885830341903
STAT,1949,19,20-24,1968,159.18996810600575
STAT,1811,87,na,1898,76.80471559699266
STAT,1823,51,40-44,1874,0.0142274620388784
STAT,1842,42,45-49,1884,1.3941112945917855
SIM,1830,30,25-29,1860,21
STAT,1876,44,15-19,1920,0.014207090349860257
SIM,1865,42,na,1907,2103
SIM,1878,33,35-39,1911,17
STAT,1901,23,na,1924,3338.2245768805583
STAT,1870,30,20-24,1900,2.702411029214661
STAT,1808,98,na,1906,1.2247243774243073
STAT,1902,34,25-29,1936,8.322282558720003
SIM,1842,33,20-24,1875,1
STAT,1882,48,20-24,1930,0.011592655586121112
SIM,1901,32,25-29,1933,19
STAT,1885,19,20-24,1904,17.72757947048018
SIM,1809,80,na,1889,204
STAT,1827,41,50-100,1868,1.1561399333501374
SIM,1909,15,na,1924,4136
SIM,1850,42,45-49,1892,2
SIM,1826,28,20-24,1854,12
STAT,1854,41,25-29,1895,0.48411084515056485
STAT,1848,26,40-44,1874,2.9408829505986245
STAT,1909,26,na,1935,3623.940127085423
STAT,1937,21,na,1958,3591.25969077585
SIM,1871,38,50-100,1909,1
STAT,1836,29,50-100,1865,0.5147028882260579
STAT,1854,45,40-44,1899,0.12976422282162234
STAT,1864,31,40-44,1895,3.968579919470983
STAT,1861,47,40-44,1908,0.14301489023510983
STAT,1863,38,50-100,1901,1.0932449116595515
STAT,1881,15,na,1896,2470.267029244996
STAT,1839,51,35-39,1890,0.006132792763087867
SIM,1863,40,30-34,1903,4
STAT,1911,30,na,1941,3745.3961401348265
SIM,1874,24,35-39,1898,10
SIM,1945,24,45-49,1969,3
SIM,1884,63,na,1947,1872
STAT,1810,53,20-24,1863,0.0026499035530947123
SIM,1910,34,25-29,1944,16
STAT,1874,0,na,1874,3811.0046735898636
STAT,1905,43,40-44,1948,0.22641136258975153
SIM,1957,10,na,1967,5433
STAT,1847,34,na,1881,1869.7941247887813
STAT,1890,24,45-49,1914,0.855219420807649
STAT,1883,25,15-19,1908,0.4514688577730062
SIM,1939,23,40-44,1962,4
STAT,1924,44,20-24,1968,0.02115653035675352
STAT,1823,33,45-49,1856,4.039062151052444
STAT,1855,12,na,1867,2137.261057798659
SIM,1892,41,na,1933,3152
STAT,1821,53,30-34,1874,0.008226126802681087
SIM,1930,31,40-44,1961,2
SIM,1935,35,40-44,1970,1
STAT,1878,26,na,1904,2510.7484391389958
STAT,1858,100,na,1958,1.3780751748211657
STAT,1904,32,35-39,1936,8.428314755063711
STAT,1880,35,40-44,1915,4.687360817483567
SIM,1903,20,25-29,1923,87
SIM,1874,56,na,1930,1883
STAT,1932,35,15-19,1967,0.026119766742237163
SIM,1869,4,na,1873,2625
STAT,1820,42,25-29,1862,1.211633235583642
STAT,1893,48,30-34,1941,0.06914561466322042
SIM,1937,26,50-100,1963,1
SIM,1879,40,25-29,1919,3
STAT,1915,32,45-49,1947,1.6171345936669066
STAT,1848,49,30-34,1897,0.07738302536914289
SIM,1892,4,na,1896,3629
SIM,1905,56,na,1961,3229
STAT,1805,87,na,1892,69.93954954655668
STAT,1862,36,35-39,1898,6.19883814187046
STAT,1937,24,45-49,1961,1.1054026605555742
SIM,1906,47,50-100,1953,2
STAT,1831,42,35-39,1873,1.4000210033618448
SIM,1898,69,na,1967,2316
STAT,1861,30,45-49,1891,1.475319559499275
STAT,1840,44,35-39,1884,1.2906279092660697
STAT,1927,35,40-44,1962,1.8844632026679942
SIM,1883,34,20-24,1917,7
SIM,1834,87,na,1921,51
SIM,1812,58,na,1870,1066
STAT,1875,34,20-24,1909,2.779655979955773
STAT,1906,30,45-49,1936,1.4848603212952949
SIM,1923,32,45-49,1955,2
STAT,1912,19,50-100,1931,0.07602377727118234
STAT,1849,12,na,1861,2297.474351874466
STAT,1848,19,na,1867,2295.978239292969
STAT,1906,45,15-19,1951,3.352388670372596E-4
SIM,1819,39,35-39,1858,11
STAT,1845,51,50-100,1896,0.011088168334552733
SIM,1889,55,na,1944,2436
STAT,1846,40,20-24,1886,0.12514577531633345
STAT,1930,22,35-39,1952,12.191778510378537
SIM,1924,35,30-34,1959,2
SIM,1893,77,na,1970,1623
STAT,1850,51,35-39,1901,0.006623616136171679
STAT,1916,35,30-34,1951,1.901416508485774
SIM,1890,63,na,1953,2470
STAT,1852,47,30-34,1899,0.07307008842704701
STAT,1911,31,30-34,1942,15.541278804610245
STAT,1917,45,25-29,1962,0.05618972515282284
STAT,1857,78,na,1935,615.8810745595551
STAT,1940,27,20-24,1967,18.791868571466647
SIM,1915,28,15-19,1943,4
STAT,1867,85,na,1952,260.7626800654023
STAT,1845,28,50-100,1873,0.5648417095405153
STAT,1779,79,na,1858,310.74229137328507
SIM,1904,41,40-44,1945,1
SIM,1941,18,na,1959,3978
STAT,1879,45,45-49,1924,0.25122382873910526
STAT,1874,41,45-49,1915,1.5548131676159445
STAT,1897,30,25-29,1927,13.98057023771815
SIM,1858,60,na,1918,1525
STAT,1812,80,na,1892,280.84955376003006
STAT,1895,46,40-44,1941,0.12773532518537808
SIM,1919,34,45-49,1953,1
SIM,1900,64,na,1964,2860
STAT,1851,36,25-29,1887,2.226438327660383
SIM,1845,29,35-39,1874,14
SIM,1856,34,na,1890,2101
SIM,1839,22,25-29,1861,60
SIM,1820,36,na,1856,1541
STAT,1914,8,na,1922,4149.014768496809
STAT,1902,5,na,1907,3740.332675317543
SIM,1912,32,35-39,1944,17
STAT,1832,35,na,1867,1868.1132606538342
STAT,1920,33,30-34,1953,17.353474832099785
SIM,1859,16,15-19,1875,7
STAT,1960,10,na,1970,5168.504358228417
SIM,1830,43,na,1873,1490
STAT,1908,43,25-29,1951,0.06629204458356738
SIM,1870,49,na,1919,2439
STAT,1843,45,30-34,1888,0.06667073670480497
STAT,1950,16,25-29,1966,51.783057571484406
STAT,1910,43,15-19,1953,0.001455490099676662
STAT,1907,28,15-19,1935,0.6705754859184744
STAT,1849,110,na,1959,4.0814581813701994E-4
STAT,1857,53,45-49,1910,0.011255657398679753
STAT,1864,52,40-44,1916,0.009543686877614994
STAT,1814,54,35-39,1868,0.01904804406335732
SIM,1946,25,50-100,1971,1
SIM,1826,42,50-100,1868,3
STAT,1864,7,na,1871,2564.366945717742
STAT,1866,24,35-39,1890,5.423365941399515
STAT,1797,64,na,1861,851.5274930403509
STAT,1781,80,na,1861,141.12483821126673
STAT,1836,46,35-39,1882,0.09361865722475055
STAT,1901,24,50-100,1925,0.5737586283190894
STAT,1818,42,50-100,1860,2.0738367724719113
STAT,1892,21,50-100,1913,0.5183854174881335
STAT,1812,51,30-34,1863,0.013406028658442551
STAT,1842,79,na,1921,629.4287439755584
STAT,1895,18,na,1913,3322.454287265265
SIM,1935,18,na,1953,4946
SIM,1845,42,na,1887,1922
SIM,1885,48,na,1933,2414
STAT,1901,41,15-19,1942,0.0013639267183410925
STAT,1938,25,50-100,1963,0.9963666047487806
STAT,1881,45,35-39,1926,0.13765800836616293
STAT,1876,54,25-29,1930,0.0035921870912044127
STAT,1917,18,30-34,1935,2.640621348473613
STAT,1850,20,na,1870,1993.571036229436
SIM,1867,26,20-24,1893,11
STAT,1902,16,20-24,1918,25.365369876452878
STAT,1904,24,30-34,1928,25.655836342152064
SIM,1859,79,na,1938,578
STAT,1840,44,45-49,1884,1.0667058121588577
STAT,1917,38,na,1955,3924.8024295448818
STAT,1822,53,40-44,1875,0.014738580519586245
STAT,1843,12,na,1855,2057.61582
SIM,1847,28,45-49,1875,2
STAT,1841,37,15-19,1878,0.049476242914500736
STAT,1883,47,20-24,1930,0.01180516240235026
STAT,1884,10,na,1894,2579.951755064423
STAT,1934,36,35-39,1970,3.3756796711687604
STAT,1886,1,na,1887,3341.173062050227
STAT,1913,24,na,1937,3697.3619788444607
STAT,1929,32,35-39,1961,11.73246575213515
SIM,1855,65,na,1920,1571
SIM,1901,32,30-34,1933,37
STAT,1839,108,na,1947,0.0012986423397903088
STAT,1907,24,50-100,1931,0.6010596560835761
STAT,1836,33,15-19,1869,0.11238216346815622
STAT,1898,18,na,1916,3449.0218833016356
STAT,1827,97,na,1924,3.1946506835791006
STAT,1869,3,na,1872,3090.9568123163845
STAT,1839,20,35-39,1859,5.392972622214608
SIM,1851,51,na,1902,1690
SIM,1924,18,15-19,1942,70
STAT,1835,40,45-49,1875,1.3814162263716292
SIM,1846,41,25-29,1887,4
SIM,1933,38,35-39,1971,4
STAT,1909,19,na,1928,3801.5248744013456
STAT,1825,54,20-24,1879,9.176606590356631E-4
STAT,1839,28,45-49,1867,0.9845433284147874
SIM,1910,38,40-44,1948,1
STAT,1916,45,30-34,1961,0.09270754223979705
STAT,1865,23,40-44,1888,1.9312000828711102
STAT,1848,26,45-49,1874,1.0900356762130694
STAT,1906,32,40-44,1938,3.663257680738369
STAT,1859,36,50-100,1895,1.0021393722683112
STAT,1902,38,40-44,1940,1.341851515567198
SIM,1864,25,40-44,1889,4
SIM,1905,34,40-44,1939,5
STAT,1822,66,na,1888,920.6064865534213
SIM,1842,15,na,1857,2218
STAT,1854,17,30-34,1871,1.4309137943397192
STAT,1871,67,na,1938,1590.645948311162
STAT,1856,25,40-44,1881,2.438532120836195
STAT,1788,89,na,1877,35.00631271421089
STAT,1805,70,na,1875,808.7585752036301
STAT,1872,25,na,1897,2439.7661799298144
SIM,1881,1,na,1882,3002
STAT,1846,36,50-100,1882,0.98312834238232
SIM,1870,42,30-34,1912,1
STAT,1845,31,15-19,1876,0.12501359605056925
SIM,1914,32,40-44,1946,7
STAT,1898,42,35-39,1940,0.17196140628208914
SIM,1921,17,35-39,1938,6
SIM,1846,29,na,1875,1848
STAT,1792,94,na,1886,4.157997616600862
STAT,1846,18,35-39,1864,0.5200103750445743
STAT,1925,38,35-39,1963,2.930883223839295
STAT,1943,4,na,1947,4284.467976395173
SIM,1899,29,20-24,1928,25
STAT,1806,49,15-19,1855,0.0011686397626593334
SIM,1923,25,45-49,1948,5
STAT,1872,47,45-49,1919,0.23852211836478956
STAT,1926,6,na,1932,4966.490864657201
SIM,1889,30,40-44,1919,15
SIM,1871,15,30-34,1886,2
SIM,1940,22,40-44,1962,8
STAT,1777,114,na,1891,1.4368206529792149E-4
STAT,1784,75,na,1859,339.29475099250527
STAT,1892,45,20-24,1937,0.008664417070998714
STAT,1809,84,na,1893,153.60685385118285
STAT,1955,2,na,1957,5277.666252889019
SIM,1930,40,na,1970,5248
STAT,1915,25,45-49,1940,1.790143453384503
STAT,1863,48,na,1911,1988.0615554705273
STAT,1972,0,na,1972,5121.973194200511
STAT,1913,17,35-39,1930,0.8656281438672536
SIM,1843,40,45-49,1883,1
SIM,1806,64,na,1870,921
STAT,1838,41,25-29,1879,0.5092127834936003
STAT,1839,82,na,1921,330.79428510535547
STAT,1863,15,30-34,1878,1.6469288864936715
STAT,1932,28,25-29,1960,87.08103331453665
STAT,1857,42,50-100,1899,0.831716968056587
STAT,1798,83,na,1881,162.61933843437942
SIM,1940,28,25-29,1968,12
STAT,1927,37,30-34,1964,2.290352758691641
STAT,1831,51,40-44,1882,0.007056536065259183
SIM,1896,63,na,1959,2429
STAT,1814,54,45-49,1868,0.032109559947752914
STAT,1844,42,50-100,1886,0.8560478515396671
STAT,1932,22,40-44,1954,4.458378069808702
STAT,1810,46,50-100,1856,0.9670072531759454
SIM,1858,14,na,1872,2246
SIM,1917,28,25-29,1945,106
SIM,1910,25,35-39,1935,23
SIM,1814,83,na,1897,127
STAT,1877,24,na,1901,2449.9480984143306
STAT,1905,25,50-100,1930,0.9403493308500425
STAT,1920,34,40-44,1954,4.291534505205856
STAT,1888,20,30-34,1908,21.36092631351165
STAT,1897,48,50-100,1945,0.18523268159967904
SIM,1856,26,45-49,1882,2
STAT,1928,38,50-100,1966,0.5357778154192805
STAT,1892,29,na,1921,3003.012289742981
STAT,1903,37,45-49,1940,0.6189155559693648
STAT,1894,48,35-39,1942,0.1013993425726864
SIM,1884,78,na,1962,963
SIM,1955,16,na,1971,4705
STAT,1875,48,25-29,1923,0.05899304469948611
SIM,1934,25,20-24,1959,31
STAT,1830,54,50-100,1884,0.01067779808320038
STAT,1881,61,na,1942,1819.2390446778056
STAT,1831,46,45-49,1877,0.17855703866419292
STAT,1885,75,na,1960,1193.2693066977038
STAT,1837,25,30-34,1862,22.36991611584247
STAT,1874,35,50-100,1909,1.2817774610583714
STAT,1879,42,25-29,1921,0.6760001069850761
SIM,1829,33,na,1862,1870
STAT,1888,23,50-100,1911,0.4846295632383528
STAT,1912,30,15-19,1942,0.12859800209538969
STAT,1826,28,50-100,1854,1.5826405651126814
STAT,1871,21,15-19,1892,3.32031472181609
SIM,1910,16,20-24,1926,26
SIM,1912,24,30-34,1936,35
STAT,1902,25,35-39,1927,13.864960728533335
STAT,1859,26,20-24,1885,9.764479260475643
STAT,1909,28,25-29,1937,63.25285435375851
SIM,1867,50,na,1917,1926
STAT,1929,26,50-100,1955,1.259657631241356
SIM,1937,32,35-39,1969,14
STAT,1822,50,na,1872,1403.5190696718757
STAT,1873,47,50-100,1920,0.25029981357963726
STAT,1877,34,15-19,1911,0.147178118249146
STAT,1929,23,na,1952,4653.186821837196
STAT,1900,17,25-29,1917,7.950483218292241
STAT,1844,54,30-34,1898,0.00458005322506824
STAT,1818,45,na,1863,1482.2661380129175
STAT,1816,40,35-39,1856,5.605602317342369
SIM,1846,9,na,1855,2250
STAT,1842,46,20-24,1888,0.010945154364217927
STAT,1875,46,50-100,1921,0.2554638701624782
SIM,1887,11,na,1898,2852
SIM,1899,16,15-19,1915,7
SIM,1837,52,na,1889,1321
SIM,1838,22,35-39,1860,5
STAT,1914,37,20-24,1951,0.2655529072656881
STAT,1882,15,40-44,1897,0.17977415619009648
SIM,1916,25,na,1941,3784
STAT,1824,34,50-100,1858,1.4331353924518655
SIM,1912,11,na,1923,3965
STAT,1899,21,45-49,1920,0.9695118244102809
STAT,1945,20,25-29,1965,102.30824684753271
STAT,1803,53,30-34,1856,0.025285476518070667
STAT,1865,18,45-49,1883,0.06171476496032604
SIM,1875,5,na,1880,2668
STAT,1825,49,25-29,1874,0.07522866454415308
STAT,1840,79,na,1919,490.0641516243338
STAT,1857,41,35-39,1898,1.4338221773623623
STAT,1886,32,15-19,1918,0.15186254652572975
STAT,1843,44,na,1887,1564.415589382571
STAT,1827,81,na,1908,321.57032483188215
STAT,1871,35,35-39,1906,7.164543031167021
STAT,1869,23,25-29,1892,56.03911673821688
SIM,1828,28,35-39,1856,13
STAT,1860,37,25-29,1897,2.3771416536482644
SIM,1920,32,40-44,1952,8
SIM,1942,27,20-24,1969,5
SIM,1847,33,40-44,1880,4
SIM,1808,71,na,1879,529
STAT,1842,86,na,1928,199.76283604525833
SIM,1936,16,40-44,1952,6
SIM,1897,24,40-44,1921,7
STAT,1919,38,35-39,1957,2.6209803310747306
STAT,1844,15,20-24,1859,18.04203937703238
SIM,1901,27,35-39,1928,32
SIM,1941,24,na,1965,3793
STAT,1864,50,50-100,1914,0.01396225316909703
SIM,1785,69,na,1854,626
SIM,1793,88,na,1881,46
SIM,1937,19,na,1956,3424
SIM,1826,84,na,1910,218
SIM,1919,16,40-44,1935,2
SIM,1927,38,35-39,1965,9
STAT,1944,0,na,1944,4847.086528245903
STAT,1910,27,35-39,1937,14.626997414071216
SIM,1874,31,35-39,1905,9
STAT,1912,32,40-44,1944,3.8849451888257738
SIM,1900,26,na,1926,3474
STAT,1926,25,20-24,1951,22.26559609165783
STAT,1889,24,40-44,1913,2.5789172530072095
STAT,1882,49,50-100,1931,0.23526525373912577
STAT,1883,42,50-100,1925,1.042881221118431
STAT,1917,27,20-24,1944,19.322955108222438
STAT,1919,41,50-100,1960,0.12872816385864888
SIM,1859,3,na,1862,2984
SIM,1852,15,20-24,1867,19
SIM,1843,17,20-24,1860,19
STAT,1887,19,35-39,1906,0.6154314142469834
STAT,1819,41,15-19,1860,0.030658958032868222
STAT,1858,20,45-49,1878,0.6431740213576911
SIM,1902,44,40-44,1946,1
STAT,1855,38,50-100,1893,0.9195637967975774
STAT,1882,38,15-19,1920,0.054666183016109364
STAT,1914,21,35-39,1935,9.341857149625186
SIM,1928,4,na,1932,5201
SIM,1888,29,45-49,1917,1
STAT,1919,30,25-29,1949,10.14916008514196
STAT,1868,19,25-29,1887,5.503670362211123
STAT,1856,48,15-19,1904,3.058463708948737E-4
SIM,1880,32,na,1912,2269
SIM,1884,46,na,1930,2338
STAT,1918,48,45-49,1966,0.2328470081809529
SIM,1916,24,15-19,1940,4
SIM,1879,23,35-39,1902,11
STAT,1943,25,20-24,1968,19.646668067340187
SIM,1876,27,na,1903,2716
STAT,1821,44,35-39,1865,2.7263272591933077
SIM,1888,21,35-39,1909,8
STAT,1934,27,20-24,1961,24.81208611333843
STAT,1903,42,40-44,1945,0.22439538587024893
SIM,1931,24,40-44,1955,4
STAT,1902,40,na,1942,3343.532985968571
SIM,1886,18,30-34,1904,2
SIM,1945,2,na,1947,4311
STAT,1908,35,50-100,1943,0.40058354356861364
STAT,1923,24,40-44,1947,3.9281456716969685
STAT,1855,52,40-44,1907,0.007882195662468663
STAT,1881,45,45-49,1926,0.23205207092231564
STAT,1834,67,na,1901,943.566849816363
SIM,1893,39,na,1932,3054
SIM,1936,20,25-29,1956,173
STAT,1839,33,40-44,1872,3.7445824367930447
SIM,1817,48,na,1865,1511
STAT,1903,31,50-100,1934,1.323325689747036
STAT,1908,24,15-19,1932,4.909128882281386
STAT,1869,32,15-19,1901,0.13983842435034857
STAT,1828,27,50-100,1855,1.2391613460330462
STAT,1906,54,na,1960,3175.275575638044
STAT,1843,31,50-100,1874,0.7506829113892857
SIM,1800,75,na,1875,439
SIM,1825,67,na,1892,757
STAT,1906,35,20-24,1941,0.24708815914425022
SIM,1821,53,na,1874,1149
SIM,1927,30,25-29,1957,16
STAT,1885,41,50-100,1926,1.0668966470479648
SIM,1876,19,25-29,1895,5
STAT,1838,45,50-100,1883,0.17353553922338769
STAT,1917,49,40-44,1966,0.1652516785436293
SIM,1836,27,30-34,1863,33
STAT,1895,18,30-34,1913,2.096747511847197
STAT,1923,35,20-24,1958,0.30914868089666225
STAT,1811,105,na,1916,0.01278213066937882
STAT,1815,47,15-19,1862,8.875085325129838E-4
STAT,1888,46,50-100,1934,0.29361389283939654
STAT,1901,39,na,1940,3328.211615952101
STAT,1834,51,na,1885,1340.3854326970243
SIM,1863,47,45-49,1910,3
STAT,1914,27,50-100,1941,1.0123896365797305
STAT,1801,88,na,1889,51.66099932764155
SIM,1922,21,35-39,1943,16
STAT,1851,47,25-29,1898,0.04341068574440431
STAT,1864,31,25-29,1895,9.373126849411957
STAT,1860,99,na,1959,2.916239455877175
STAT,1832,25,50-100,1857,0.6014089846555164
SIM,1884,18,20-24,1902,18
STAT,1908,46,35-39,1954,0.11859020453949723
STAT,1895,22,15-19,1917,4.351291865027674
SIM,1873,94,na,1967,66
STAT,1819,62,na,1881,1005.3123077616972
STAT,1899,19,50-100,1918,0.06754599531247936
STAT,1903,32,15-19,1935,0.2048410866210454
STAT,1855,47,45-49,1902,0.17681394241255835
STAT,1881,45,na,1926,2212.20428369288
STAT,1938,16,na,1954,3674.4740552255503
STAT,1879,21,50-100,1900,0.43110865585593816
STAT,1885,59,na,1944,1953.8378260342747
SIM,1869,57,na,1926,1920
SIM,1917,42,na,1959,3746
STAT,1828,27,30-34,1855,48.780378405395254
STAT,1835,40,50-100,1875,0.9751173334680024
SIM,1888,34,40-44,1922,11
SIM,1865,43,na,1908,2077
STAT,1868,38,50-100,1906,1.1792506445614577
SIM,1842,31,na,1873,1946
STAT,1928,16,40-44,1944,1.7857630458808313
SIM,1925,36,35-39,1961,5
STAT,1875,20,45-49,1895,0.7275895942139565
STAT,1942,21,na,1963,3867.1474495668745
SIM,1905,41,na,1946,3518
STAT,1938,33,50-100,1971,0.8387497174454058
SIM,1846,45,na,1891,1584
STAT,1865,38,15-19,1903,0.05153200881010349
STAT,1928,39,15-19,1967,0.024477987239025507
STAT,1914,34,40-44,1948,3.9403737363714773
STAT,1874,16,45-49,1890,0.06772177308362468
STAT,1938,30,35-39,1968,9.286763493833389
STAT,1915,20,50-100,1935,0.6625235329869209
STAT,1920,32,15-19,1952,0.1421409564904032
STAT,1876,41,45-49,1917,1.5678227192210132
SIM,1884,41,45-49,1925,1
STAT,1908,37,20-24,1945,0.24914368637338186
STAT,1834,47,25-29,1881,0.036379631992749226
STAT,1927,41,15-19,1968,0.0019494762952439735
SIM,1847,20,35-39,1867,9
STAT,1890,35,45-49,1925,2.48364881247932
SIM,1922,34,40-44,1956,14
STAT,1952,15,20-24,1967,164.23729701602014
STAT,1798,67,na,1865,885.2427229301907
STAT,1930,17,35-39,1947,5.483137482336221
SIM,1902,17,25-29,1919,13
STAT,1862,45,35-39,1907,0.12332823530214404
STAT,1809,50,45-49,1859,0.04860714194939918
SIM,1796,69,na,1865,796
SIM,1860,12,na,1872,2418
SIM,1900,10,na,1910,3821
STAT,1915,28,25-29,1943,67.50460006765547
STAT,1890,5,na,1895,3234.289403433281
STAT,1853,33,15-19,1886,0.12002366105137917
SIM,1830,46,na,1876,1434
SIM,1855,22,35-39,1877,8
STAT,1917,54,na,1971,3772.253176999229
STAT,1891,28,15-19,1919,0.5653480762484795
SIM,1893,16,20-24,1909,22
STAT,1879,63,na,1942,1880.6563607260848
SIM,1890,15,40-44,1905,1
STAT,1913,40,na,1953,3695.657127280161
SIM,1945,22,na,1967,3780
STAT,1838,65,na,1903,1131.3056532851274
SIM,1905,4,na,1909,3932
SIM,1889,42,35-39,1931,2
SIM,1864,26,na,1890,2568
STAT,1837,50,20-24,1887,5.256622470757448E-4
SIM,1934,0,na,1934,5827
STAT,1886,24,15-19,1910,3.4960324872850395
STAT,1931,37,20-24,1968,0.35283420733429605
STAT,1898,30,40-44,1928,5.9855997006380335
SIM,1926,19,na,1945,4433
SIM,1907,1,na,1908,4209
STAT,1920,46,35-39,1966,0.14427980268002302
STAT,1892,44,50-100,1936,0.09172268374308944
STAT,1855,41,25-29,1896,0.4855520961618103
STAT,1824,37,15-19,1861,0.07831555993148083
SIM,1920,26,30-34,1946,66
SIM,1857,30,45-49,1887,6
STAT,1947,20,35-39,1967,10.756668874694082
SIM,1894,24,15-19,1918,6
SIM,1786,70,na,1856,663
STAT,1813,73,na,1886,553.7263327821997
STAT,1912,26,30-34,1938,39.09003384435407
STAT,1902,19,25-29,1921,8.044521435315776
STAT,1843,71,na,1914,900.28002114526
STAT,1903,40,15-19,1943,0.0013933325016793304
SIM,1910,19,25-29,1929,10
STAT,1849,30,45-49,1879,1.611917558181237
STAT,1842,54,20-24,1896,6.461045984822678E-4
STAT,1868,15,50-100,1883,0.048719894208641444
STAT,1892,21,35-39,1913,7.418094456016782
STAT,1931,21,na,1952,4801.190912100681
STAT,1847,22,35-39,1869,5.356262240775182
STAT,1897,44,na,1941,3097.973612343466
STAT,1893,30,na,1923,3084.903431715752
STAT,1782,106,na,1888,0.013551083259356604
STAT,1910,32,30-34,1942,15.326657390808533
STAT,1954,18,35-39,1972,5.239165564401899
STAT,1886,46,35-39,1932,0.14971889647154635
STAT,1825,30,35-39,1855,32.35531859070089
STAT,1914,49,15-19,1963,3.664424671285147E-4
STAT,1921,25,45-49,1946,1.9578356846289373
SIM,1872,77,na,1949,729
SIM,1821,37,na,1858,1439
SIM,1780,81,na,1861,202
STAT,1879,44,50-100,1923,1.0984699414546464
STAT,1869,20,45-49,1889,0.6917750758888171
SIM,1850,38,50-100,1888,1
STAT,1930,36,na,1966,4964.433238222056
SIM,1930,18,15-19,1948,62
SIM,1869,15,15-19,1884,9
SIM,1936,28,35-39,1964,1
STAT,1937,8,na,1945,3917.0972591473355
SIM,1849,20,45-49,1869,1
STAT,1871,99,na,1970,12.98245701742602
STAT,1827,43,15-19,1870,0.014602503465456038
STAT,1848,51,35-39,1899,0.007062569904910856
SIM,1833,30,35-39,1863,11
STAT,1903,34,40-44,1937,3.5511879623801397
STAT,1778,108,na,1886,0.005584743761964001
STAT,1925,35,30-34,1960,2.21453729399349
SIM,1880,48,na,1928,2084
STAT,1888,23,35-39,1911,6.935048238239755
STAT,1814,90,na,1904,36.90213575430057
SIM,1847,46,na,1893,1699
SIM,1912,27,35-39,1939,18
STAT,1922,18,15-19,1940,52.921040678246776
SIM,1876,16,20-24,1892,22
STAT,1928,20,25-29,1948,117.2645715358011
SIM,1932,22,50-100,1954,1
STAT,1894,34,15-19,1928,0.1835923170732858
STAT,1814,51,40-44,1865,0.024737800767930716
STAT,1901,55,na,1956,2948.726843084259
STAT,1928,28,35-39,1956,18.68664396228448
STAT,1832,47,15-19,1879,3.2297940342551157E-4
STAT,1923,27,45-49,1950,2.004094696455398
SIM,1911,34,40-44,1945,5
STAT,1841,27,50-100,1868,0.5941601837764424
STAT,1877,50,50-100,1927,0.01596969837307358
STAT,1856,94,na,1950,15.47614450619797
STAT,1925,33,50-100,1958,0.9916202739295956
SIM,1931,27,45-49,1958,2
STAT,1881,42,40-44,1923,2.187121237647094
SIM,1877,20,45-49,1897,1
STAT,1943,17,20-24,1960,145.16527750779656
STAT,1875,45,20-24,1920,0.01257069767330782
SIM,1879,36,40-44,1915,12
SIM,1933,35,30-34,1968,2
STAT,1853,47,35-39,1900,0.11523695750266774
STAT,1877,53,30-34,1930,0.006105447240983498
STAT,1916,48,35-39,1964,0.13308205096192816
SIM,1896,23,35-39,1919,12
SIM,1896,32,25-29,1928,16
STAT,1885,16,20-24,1901,17.86693542327619
STAT,1945,25,30-34,1970,43.45041766599894
STAT,1904,27,35-39,1931,13.985338326064374
SIM,1918,32,25-29,1950,16
SIM,1887,27,na,1914,2708
STAT,1896,42,25-29,1938,0.0595435303005333
STAT,1856,33,40-44,1889,3.3641206769788465
SIM,1856,23,40-44,1879,2
STAT,1908,38,35-39,1946,2.2746784426261057
SIM,1916,38,35-39,1954,11
STAT,1888,32,25-29,1920,12.210328271269846
STAT,1943,22,na,1965,3923.025434500113
STAT,1848,23,40-44,1871,2.056685879531649
STAT,1868,47,na,1915,2161.6259512350343
SIM,1951,17,20-24,1968,177
STAT,1808,54,20-24,1862,0.002397357842215335
STAT,1870,44,30-34,1914,1.1248365063677872
SIM,1863,7,na,1870,2689
STAT,1924,22,50-100,1946,0.7845846244122551
STAT,1872,36,50-100,1908,1.2526759632883973
SIM,1932,8,na,1940,6020
STAT,1829,51,25-29,1880,0.0026044788546402678
STAT,1830,34,35-39,1864,9.409518252268537
STAT,1852,40,45-49,1892,1.1464928204448277
SIM,1857,29,na,1886,2071
STAT,1941,18,25-29,1959,45.04979299128917
SIM,1853,15,na,1868,2093
STAT,1872,84,na,1956,366.29698296255026
STAT,1842,38,50-100,1880,1.2832986632816115
STAT,1941,15,45-49,1956,0.5197475271487432
SIM,1922,30,25-29,1952,16
STAT,1879,30,30-34,1909,18.550461269994514
SIM,1877,20,20-24,1897,92
STAT,1901,46,25-29,1947,0.04613351320288942
SIM,1892,3,na,1895,3646
STAT,1860,34,20-24,1894,2.2126100143903185
SIM,1845,25,30-34,1870,37
SIM,1905,57,na,1962,3190
STAT,1843,28,na,1871,1782.7366392860622
SIM,1836,22,25-29,1858,2
SIM,1888,12,na,1900,3205
STAT,1932,2,na,1934,5472.860192823623
STAT,1845,45,35-39,1890,0.10331589402751867
SIM,1880,36,50-100,1916,1
STAT,1804,54,50-100,1858,0.03928112070569814
STAT,1804,109,na,1913,2.205665041245403E-4
STAT,1858,53,50-100,1911,0.01177506958119617
STAT,1789,101,na,1890,0.1736787322395887
STAT,1934,28,35-39,1962,20.397742838668844
SIM,1908,22,na,1930,3441
STAT,1876,18,20-24,1894,18.439635100400633
SIM,1841,40,35-39,1881,5
SIM,1943,18,25-29,1961,80
STAT,1816,97,na,1913,2.7466826303521756
SIM,1868,33,50-100,1901,1
STAT,1855,13,na,1868,2127.557892596253
STAT,1859,27,na,1886,1972.120877057172
SIM,1839,59,na,1898,1267
STAT,1840,30,25-29,1870,8.92862878367658
STAT,1917,22,15-19,1939,5.710677276320931
STAT,1851,39,25-29,1890,2.158151292031267
STAT,1821,41,30-34,1862,1.8869633061052018
STAT,1869,20,20-24,1889,68.36436382395252
STAT,1937,17,45-49,1954,0.4906090018620744
SIM,1805,79,na,1884,246
SIM,1835,45,na,1880,1448
SIM,1848,41,35-39,1889,3
STAT,1870,77,na,1947,857.2939675701666
SIM,1831,31,na,1862,1835
STAT,1868,16,20-24,1884,17.526267918839054
SIM,1901,26,20-24,1927,16
STAT,1880,44,na,1924,2418.464869054261
SIM,1898,31,45-49,1929,3
STAT,1848,40,50-100,1888,0.8838466344751246
STAT,1833,40,35-39,1873,1.598537319581898
STAT,1877,56,na,1933,2126.1620598202035
STAT,1783,100,na,1883,0.22970333395061882
SIM,1897,27,45-49,1924,1
STAT,1867,62,na,1929,1738.5779303236304
STAT,1889,27,45-49,1916,1.3827650612656808
SIM,1860,28,na,1888,2103
SIM,1838,35,40-44,1873,12
STAT,1860,83,na,1943,327.7630060688805
SIM,1840,20,25-29,1860,80
STAT,1878,51,20-24,1929,7.773768430661538E-4
SIM,1869,29,35-39,1898,1
STAT,1843,106,na,1949,0.00818917874128163
STAT,1850,27,15-19,1877,0.40882778101212297
STAT,1925,43,30-34,1968,0.15617753830575232
STAT,1897,26,40-44,1923,4.0700893685226855
STAT,1862,42,30-34,1904,1.0015294078763008
STAT,1830,31,50-100,1861,0.8938446235690654
STAT,1896,59,na,1955,2598.2584251338017
STAT,1903,45,45-49,1948,0.19339587069535677
STAT,1823,51,na,1874,1360.1978961687823
STAT,1834,44,20-24,1878,0.11113630103598086
STAT,1827,65,na,1892,1004.9509344614426
STAT,1812,46,35-39,1858,0.3281467906934985
STAT,1892,45,na,1937,2880.364059523454
STAT,1869,28,30-34,1897,24.640539155312574
SIM,1881,21,25-29,1902,4
STAT,1821,49,40-44,1870,0.24376523717677698
STAT,1886,76,na,1962,1236.39966940962
SIM,1847,30,na,1877,1958
SIM,1853,23,15-19,1876,2
SIM,1819,35,30-34,1854,3
SIM,1925,22,15-19,1947,5
SIM,1818,49,na,1867,1293
SIM,1914,18,na,1932,4233
STAT,1762,96,na,1858,0.9831382388085392
STAT,1881,29,na,1910,2306.8305523807794
STAT,1943,28,25-29,1971,70.74661925555758
SIM,1942,28,35-39,1970,19
STAT,1878,17,40-44,1895,0.19176558432774307
STAT,1882,62,na,1944,1788.1563124733877
SIM,1857,13,na,1870,2504
SIM,1888,30,25-29,1918,17
STAT,1916,18,15-19,1934,9.691555772111217
SIM,1869,21,25-29,1890,94
STAT,1851,20,35-39,1871,5.353211773885201
SIM,1850,34,na,1884,2006
SIM,1896,8,na,1904,3481
STAT,1889,41,na,1930,2891.428676859823
SIM,1923,28,25-29,1951,93
STAT,1914,30,25-29,1944,9.462328243295554
SIM,1884,62,na,1946,1872
SIM,1887,30,30-34,1917,41
STAT,1936,29,50-100,1965,0.9607313498887854
STAT,1869,49,50-100,1918,0.2361335798485136
STAT,1863,54,40-44,1917,0.009162012163570776
SIM,1931,38,25-29,1969,1
STAT,1919,35,30-34,1954,1.9879790056805748
STAT,1814,40,25-29,1854,2.397516049169094
STAT,1935,18,25-29,1953,59.69724066779256
SIM,1859,31,na,1890,2276
STAT,1923,38,25-29,1961,1.1515400343449145
STAT,1899,20,30-34,1919,24.837847120744403
STAT,1840,41,40-44,1881,1.6659507516956953
SIM,1878,93,na,1971,64
STAT,1771,113,na,1884,3.8642384107178654E-4
SIM,1858,28,20-24,1886,15
SIM,1886,26,30-34,1912,34
STAT,1832,39,15-19,1871,0.04743630176301095
SIM,1863,44,40-44,1907,6
SIM,1806,48,na,1854,1476
STAT,1831,86,na,1917,139.4271063713179
STAT,1769,86,na,1855,54.2231
STAT,1902,24,na,1926,3354.407941895549
STAT,1922,40,25-29,1962,0.08303189254226565
STAT,1936,22,25-29,1958,89.15469498576503
STAT,1878,26,30-34,1904,26.49268794906142
STAT,1839,48,15-19,1887,2.8526221222573345E-4
SIM,1944,22,25-29,1966,111
STAT,1828,82,na,1910,302.88532651307656
STAT,1845,23,15-19,1868,2.9710568302412383
SIM,1817,64,na,1881,1053
STAT,1848,59,na,1907,1586.7577223290996
STAT,1867,15,15-19,1882,5.8395472846537295
STAT,1861,40,50-100,1901,0.8956057740265593
STAT,1918,45,40-44,1963,0.1701808467024044
STAT,1927,45,30-34,1972,0.11363519289363858
STAT,1910,24,30-34,1934,27.06071770817497
SIM,1800,91,na,1891,30
SIM,1820,68,na,1888,777
STAT,1869,36,30-34,1905,5.258612906458047
STAT,1840,47,na,1887,1590.390186109364
STAT,1920,43,30-34,1963,0.14236081577801693
SIM,1948,19,15-19,1967,79
SIM,1856,66,na,1922,1367
STAT,1838,81,na,1919,362.0020778487079
STAT,1860,29,25-29,1889,34.79430923360988
SIM,1938,20,35-39,1958,14
STAT,1810,47,15-19,1857,0.0015452297769283307
STAT,1881,31,25-29,1912,10.01259703402517
STAT,1890,32,40-44,1922,5.352205628444478
STAT,1926,39,40-44,1965,1.8450894483502867
SIM,1919,27,45-49,1946,2
SIM,1936,24,40-44,1960,3
STAT,1859,2,na,1861,2823.982429731851
STAT,1917,38,25-29,1955,1.0271622583357667
STAT,1910,35,35-39,1945,2.356054449119231
STAT,1866,30,45-49,1896,1.6439885538626922
SIM,1837,84,na,1921,217
SIM,1882,41,35-39,1923,2
SIM,1934,16,30-34,1950,23
STAT,1830,31,30-34,1861,17.03285159133745
STAT,1839,50,na,1889,1564.5216510136777
STAT,1874,32,na,1906,2467.8980529092637
SIM,1879,20,30-34,1899,22
STAT,1940,20,25-29,1960,95.06076846179855
SIM,1925,33,30-34,1958,6
STAT,1863,40,20-24,1903,0.14355420082455314
STAT,1771,89,na,1860,28.096824732325043
SIM,1801,60,na,1861,822
SIM,1875,38,25-29,1913,1
STAT,1917,33,30-34,1950,16.582749977430083
STAT,1891,16,45-49,1907,0.08188498600289063
STAT,1902,17,35-39,1919,0.7831506422060736
STAT,1903,62,na,1965,2852.298317402572
STAT,1878,15,15-19,1893,6.251016901942001
SIM,1807,86,na,1893,153
SIM,1879,32,25-29,1911,13
STAT,1926,17,20-24,1943,167.99474597050542
SIM,1877,36,30-34,1913,6
SIM,1887,43,na,1930,2483
STAT,1823,41,40-44,1864,3.421755050592497
STAT,1921,27,35-39,1948,16.899634730522408
SIM,1843,25,20-24,1868,18
STAT,1916,5,na,1921,4290.9367599481175
STAT,1936,31,15-19,1967,0.12608574412163417
SIM,1840,24,40-44,1864,4
STAT,1823,67,na,1890,876.7260466527705
STAT,1867,38,25-29,1905,2.7251712507135215
SIM,1911,5,na,1916,4160
STAT,1953,5,na,1958,4805.444409659056
STAT,1822,82,na,1904,260.87724377745354
STAT,1826,96,na,1922,4.711674006902935
STAT,1837,21,15-19,1858,2.967575424463182
SIM,1845,21,15-19,1866,3
STAT,1908,45,20-24,1953,0.01023714932060662
STAT,1783,74,na,1857,455.26446969698327
STAT,1914,37,45-49,1951,0.6867444437209932
STAT,1866,31,35-39,1897,9.509867151679456
STAT,1965,3,na,1968,4958.905420160389
STAT,1835,25,20-24,1860,11.64667001835997
STAT,1787,88,na,1875,39.2222625351167
STAT,1901,30,15-19,1931,0.20324968672896251
SIM,1854,36,50-100,1890,1
STAT,1840,108,na,1948,0.0012840156342417434
STAT,1862,27,30-34,1889,22.045134430864934
SIM,1831,41,40-44,1872,4
SIM,1932,18,25-29,1950,86
STAT,1874,28,15-19,1902,0.46756280976358394
STAT,1914,25,na,1939,3836.132522186502
STAT,1918,39,na,1957,3994.8788130692765
SIM,1918,43,40-44,1961,1
SIM,1828,48,na,1876,1472
SIM,1838,31,25-29,1869,13
STAT,1851,63,na,1914,1351.053396083279
SIM,1824,47,50-100,1871,1
STAT,1920,30,25-29,1950,10.305598116457066
STAT,1927,33,15-19,1960,0.1596753749046333
STAT,1855,77,na,1932,650.6459856833893
SIM,1847,14,na,1861,2250
STAT,1789,74,na,1863,549.2931649347654
STAT,1864,42,40-44,1906,2.047437315797759
SIM,1934,17,20-24,1951,199
STAT,1904,15,40-44,1919,0.26633483989114254
SIM,1838,35,50-100,1873,1
STAT,1843,50,45-49,1893,0.009928815748859033
STAT,1846,51,25-29,1897,0.002700840999095581
SIM,1882,35,50-100,1917,1
SIM,1913,18,15-19,1931,11
SIM,1854,2,na,1856,2961
STAT,1847,58,na,1905,1480.7004609343617
SIM,1883,21,35-39,1904,10
STAT,1929,41,25-29,1970,0.09360577405661742
SIM,1878,19,35-39,1897,1
STAT,1881,0,na,1881,3488.891165357763
STAT,1819,52,30-34,1871,0.011145097458210107
STAT,1924,18,25-29,1942,52.010653060463206
SIM,1929,22,35-39,1951,18
SIM,1896,23,50-100,1919,1
SIM,1902,28,40-44,1930,1
STAT,1920,40,15-19,1960,0.0017175002755993084
STAT,1876,26,20-24,1902,12.276045259028692
STAT,1907,16,20-24,1923,26.36003387573888
STAT,1874,41,35-39,1915,1.8811984006708307
SIM,1884,26,20-24,1910,14
STAT,1870,53,20-24,1923,7.201089771849982E-4
SIM,1820,52,na,1872,1296
STAT,1832,24,40-44,1856,1.976983107798055
STAT,1807,50,35-39,1857,0.030430969775828737
SIM,1912,20,15-19,1932,6
STAT,1853,44,30-34,1897,0.9379153252913852
STAT,1886,43,30-34,1929,1.2171418186786649
STAT,1928,24,40-44,1952,4.216689708038966
STAT,1922,18,50-100,1940,0.4368824708533077
SIM,1872,42,40-44,1914,4
STAT,1830,39,40-44,1869,3.8683004754879278
STAT,1934,35,20-24,1969,0.3682034976541254
STAT,1873,20,35-39,1893,6.010654160795932
STAT,1922,47,20-24,1969,0.012825537518613773
STAT,1940,27,45-49,1967,1.778524227321385
STAT,1899,26,15-19,1925,0.6310588399135098
SIM,1883,46,50-100,1929,1
STAT,1857,79,na,1936,551.0657502729075
STAT,1937,18,35-39,1955,4.110319054272713
SIM,1872,13,na,1885,2855
SIM,1896,36,40-44,1932,11
STAT,1926,16,30-34,1942,15.140527641625368
SIM,1831,90,na,1921,25
SIM,1888,41,50-100,1929,1
SIM,1848,40,45-49,1888,2
SIM,1881,47,50-100,1928,1
STAT,1869,80,na,1949,607.4358791210848
STAT,1915,17,45-49,1932,0.10549784392564891
STAT,1856,36,45-49,1892,1.551078638470386
SIM,1925,38,25-29,1963,1
SIM,1927,20,na,1947,4958
STAT,1833,27,15-19,1860,0.42462358244136417
STAT,1910,26,20-24,1936,17.844963893801037
STAT,1880,18,50-100,1898,0.05183004857454598
STAT,1774,111,na,1885,8.084374494108906E-4
STAT,1905,18,15-19,1923,8.64231506739828
STAT,1880,76,na,1956,1045.6948339352193
SIM,1859,16,20-24,1875,26
STAT,1873,10,na,1883,2719.715150655261
STAT,1826,37,25-29,1863,3.328302973188204
SIM,1903,32,40-44,1935,8
SIM,1870,70,na,1940,1599
STAT,1861,15,20-24,1876,17.30517882492777
STAT,1849,65,na,1914,1321.3020824260657
SIM,1866,65,na,1931,1609
SIM,1911,10,na,1921,4144
STAT,1892,49,15-19,1941,2.79992039189325E-4
SIM,1874,84,na,1958,494
STAT,1863,29,50-100,1892,0.5683627356869623
SIM,1920,22,15-19,1942,5
STAT,1772,90,na,1862,20.79480090283602
STAT,1918,47,30-34,1965,0.09577298794514896
STAT,1925,24,15-19,1949,6.399133341074519
SIM,1882,2,na,1884,2860
SIM,1864,21,25-29,1885,65
SIM,1908,27,20-24,1935,3
STAT,1901,43,20-24,1944,0.015501708784697817
STAT,1921,20,15-19,1941,6.108683093753611
SIM,1898,0,na,1898,3711
SIM,1853,42,30-34,1895,3
STAT,1832,71,na,1903,908.898020685662
STAT,1916,41,15-19,1957,0.0015904505583580648
SIM,1794,89,na,1883,68
SIM,1886,37,50-100,1923,2
SIM,1919,49,na,1968,3886
STAT,1884,9,na,1893,2584.2415961139723
STAT,1877,83,na,1960,570.5324750047448
SIM,1790,75,na,1865,462
STAT,1836,37,30-34,1873,4.1268292605306796
SIM,1935,23,na,1958,5269
SIM,1862,51,na,1913,1969
STAT,1810,49,40-44,1859,0.6367603746613574
SIM,1919,20,25-29,1939,105
SIM,1915,35,na,1950,4244
STAT,1911,28,40-44,1939,4.569738942647598
SIM,1933,24,15-19,1957,7
STAT,1894,45,30-34,1939,0.07171041705412945
STAT,1905,47,20-24,1952,0.009837316429908715
STAT,1949,20,45-49,1969,1.3273248277883458
STAT,1848,18,45-49,1866,0.06572487591590748
STAT,1867,51,45-49,1918,0.013870575814325069
STAT,1857,95,na,1952,10.480132714298708
STAT,1808,49,25-29,1857,0.1994421952043278
STAT,1841,85,na,1926,205.00171373693192
STAT,1936,30,25-29,1966,9.07364778680429
SIM,1844,37,30-34,1881,7
STAT,1890,48,15-19,1938,2.749686059825071E-4
STAT,1856,14,na,1870,2165.985791184956
STAT,1900,26,15-19,1926,0.6387341949379488
SIM,1851,31,50-100,1882,4
STAT,1871,25,30-34,1896,25.43955509166974
STAT,1886,60,na,1946,2033.8030527022117
STAT,1893,41,45-49,1934,1.928038061368373
STAT,1828,38,35-39,1866,7.124067601694786
STAT,1902,22,30-34,1924,25.42276021253207
STAT,1785,104,na,1889,0.034019179956911415
SIM,1777,93,na,1870,1
SIM,1903,34,30-34,1937,29
STAT,1937,29,15-19,1966,0.6940371952538226
SIM,1896,39,45-49,1935,1
SIM,1899,24,15-19,1923,4
STAT,1888,39,45-49,1927,2.3525407888754857
STAT,1853,41,15-19,1894,0.011472079605078317
STAT,1929,40,35-39,1969,0.264309748855249
SIM,1833,31,50-100,1864,4
STAT,1869,64,na,1933,1706.9958017637252
SIM,1953,16,40-44,1969,2
STAT,1914,45,20-24,1959,0.0111101454276587
STAT,1873,21,25-29,1894,58.79129134038623
STAT,1955,17,50-100,1972,0.5024637379449498
SIM,1858,36,20-24,1894,5
STAT,1945,16,40-44,1961,1.5434795276047881
STAT,1836,52,30-34,1888,0.003799497086271784
STAT,1920,37,45-49,1957,0.7537438413651483
STAT,1820,86,na,1906,112.93992086520815
STAT,1827,54,30-34,1881,0.0051556033714807645
STAT,1900,16,50-100,1916,0.0689049694546468
SIM,1910,22,30-34,1932,1
STAT,1888,24,na,1912,2801.7521244290215
SIM,1836,30,na,1866,2073
SIM,1887,44,50-100,1931,2
SIM,1949,7,na,1956,4423
SIM,1846,45,50-100,1891,1
STAT,1896,75,na,1971,1832.113475529189
STAT,1901,37,35-39,1938,2.1614875556086455
SIM,1854,59,na,1913,1765
STAT,1847,38,45-49,1885,1.53263870715867
STAT,1892,61,na,1953,2368.269833911038
SIM,1869,25,40-44,1894,5
SIM,1938,33,40-44,1971,5
STAT,1826,50,45-49,1876,0.014350665069978143
STAT,1852,48,na,1900,1684.8218949377328
STAT,1878,22,15-19,1900,3.4588774861878964
STAT,1897,22,25-29,1919,77.51392423040362
STAT,1775,110,na,1885,0.0014534937775579494
STAT,1931,30,50-100,1961,1.0961463211408977
SIM,1870,27,30-34,1897,45
STAT,1892,48,25-29,1940,0.040661254995397376
SIM,1886,22,15-19,1908,4
SIM,1908,26,30-34,1934,8
STAT,1912,44,35-39,1956,0.19442301319621064
SIM,1875,58,na,1933,2006
SIM,1919,28,35-39,1947,21
STAT,1920,18,40-44,1938,1.5805568580339964
STAT,1852,25,20-24,1877,10.513173957476718
STAT,1853,100,na,1953,0.8779555313715453
STAT,1894,42,15-19,1936,0.0012454641196978562
SIM,1816,90,na,1906,35
SIM,1927,26,40-44,1953,10
STAT,1925,37,20-24,1962,0.3197479640704415
SIM,1954,15,na,1969,4524
SIM,1855,31,25-29,1886,15
SIM,1929,21,50-100,1950,4
SIM,1917,17,20-24,1934,34
STAT,1804,53,na,1857,1053.3150453951314
SIM,1966,5,na,1971,5081
SIM,1834,37,25-29,1871,5
STAT,1871,83,na,1954,398.34636129346563
STAT,1856,21,25-29,1877,51.855058153885274
SIM,1862,99,na,1961,2
STAT,1921,22,40-44,1943,3.8356276786292915
STAT,1777,89,na,1866,26.89710191111191
STAT,1912,22,15-19,1934,5.146904719921006
SIM,1890,49,50-100,1939,2
STAT,1875,97,na,1972,36.85648304701069
STAT,1852,32,na,1884,1873.7894350953354
SIM,1874,30,50-100,1904,1
STAT,1919,26,40-44,1945,5.102406109844438
SIM,1835,29,na,1864,1656
STAT,1847,30,35-39,1877,9.089654360433848
STAT,1847,31,25-29,1878,9.098389612058078
STAT,1837,17,30-34,1854,2.1518500338646698
SIM,1855,38,45-49,1893,2
SIM,1849,80,na,1929,442
STAT,1817,37,20-24,1854,2.919633213885469
SIM,1865,4,na,1869,2660
SIM,1910,27,25-29,1937,76
STAT,1936,26,40-44,1962,4.505416052617021
SIM,1858,23,15-19,1881,2
STAT,1845,42,30-34,1887,0.8554349517818911
SIM,1849,10,na,1859,2464
SIM,1938,28,45-49,1966,1
STAT,1851,48,15-19,1899,2.990692293486775E-4
STAT,1791,88,na,1879,42.57805287566149
SIM,1850,66,na,1916,1355
STAT,1893,28,25-29,1921,54.05813986603483
STAT,1889,19,45-49,1908,0.08091599281285093
STAT,1925,46,35-39,1971,0.15828277104664656
STAT,1888,56,na,1944,2431.471536820367
SIM,1855,30,35-39,1885,15
STAT,1853,70,na,1923,1160.3094386935884
STAT,1902,27,25-29,1929,60.37512830103177
SIM,1881,25,40-44,1906,3
SIM,1890,6,na,1896,3549
STAT,1884,51,45-49,1935,0.01452345015406612
STAT,1871,16,50-100,1887,0.04977027507872519
SIM,1906,58,na,1964,2925
STAT,1873,48,15-19,1921,4.0441730369260715E-4
STAT,1805,53,40-44,1858,0.0424167351912587
SIM,1859,95,na,1954,20
STAT,1842,70,na,1912,1263.2364483708773
STAT,1854,28,na,1882,1864.1268664331699
SIM,1936,27,45-49,1963,1
SIM,1855,81,na,1936,544
STAT,1851,8,na,1859,2260.6734927112643
SIM,1924,30,35-39,1954,1
STAT,1869,27,40-44,1896,2.941519403547965
STAT,1877,30,20-24,1907,2.840380792622309
STAT,1779,85,na,1864,98.12602211811468
SIM,1901,35,35-39,1936,5
STAT,1934,38,25-29,1972,1.3715118146542518
SIM,1862,21,15-19,1883,4
STAT,1829,38,50-100,1867,0.9894573573488238
STAT,1823,44,45-49,1867,2.109893569096786
SIM,1924,16,25-29,1940,58
STAT,1934,33,30-34,1967,21.721969217505283
STAT,1939,29,25-29,1968,66.73386520242708
SIM,1878,40,30-34,1918,6
STAT,1922,31,35-39,1953,10.47350482028433
SIM,1831,44,45-49,1875,3
STAT,1880,15,30-34,1895,1.698488983358126
STAT,1927,40,25-29,1967,0.0907713675934022
STAT,1858,80,na,1938,490.16740083746805
SIM,1940,25,45-49,1965,5
SIM,1951,16,30-34,1967,23
STAT,1848,38,15-19,1886,0.04675906516081105
SIM,1919,24,40-44,1943,5
STAT,1892,20,45-49,1912,0.8890439288403453
STAT,1909,35,na,1944,3627.5810831531826
STAT,1875,21,35-39,1896,6.070935484745097
STAT,1853,48,25-29,1901,0.047035326818661904
STAT,1921,24,30-34,1945,32.58148340157138
STAT,1868,79,na,1947,674.839918117101
STAT,1848,43,na,1891,1873.3997355124516
SIM,1946,23,na,1969,4433
STAT,1828,31,15-19,1859,0.17327804099470637
STAT,1766,89,na,1855,16.9953
STAT,1887,82,na,1969,919.3150508125865
SIM,1896,31,35-39,1927,22
STAT,1873,25,40-44,1898,3.0879953442787955
STAT,1865,26,45-49,1891,1.0274977613784804
STAT,1917,26,30-34,1943,41.619621506010546
STAT,1916,30,35-39,1946,9.597736311303217
STAT,1818,77,na,1895,445.3406978320916
SIM,1820,90,na,1910,27
STAT,1932,27,50-100,1959,1.3174929904918584
STAT,1865,51,35-39,1916,0.007977745230314746
STAT,1872,44,40-44,1916,2.253132473164359
SIM,1911,30,25-29,1941,15
SIM,1864,58,na,1922,2167
SIM,1930,31,35-39,1961,3
STAT,1880,40,20-24,1920,0.17015441821168706
STAT,1780,102,na,1882,0.07489850512340232
STAT,1923,20,25-29,1943,109.24026926704563
SIM,1948,20,40-44,1968,6
STAT,1898,45,na,1943,3111.7914533816147
SIM,1901,11,na,1912,3767
STAT,1894,31,na,1925,3115.685497709934
STAT,1805,50,25-29,1855,0.015161459507808561
STAT,1922,17,na,1939,4303.372375271426
SIM,1873,62,na,1935,1712
SIM,1869,44,50-100,1913,1
SIM,1873,26,45-49,1899,1
STAT,1930,33,50-100,1963,1.0777821635380878
STAT,1858,58,na,1916,1567.021710652435
STAT,1915,37,15-19,1952,0.019574927953692565
STAT,1908,43,30-34,1951,0.11868414384950085
STAT,1824,50,35-39,1874,0.010104471776229057
SIM,1835,39,50-100,1874,1
STAT,1831,43,40-44,1874,1.7165445112884548
STAT,1827,39,50-100,1866,1.3631174174958354
STAT,1921,38,15-19,1959,0.02163417739985039
STAT,1888,31,35-39,1919,12.121929948016179
STAT,1845,51,na,1896,1580.8171761794092
SIM,1807,49,na,1856,1193
SIM,1878,16,30-34,1894,4
STAT,1915,22,40-44,1937,3.5070991056228413
STAT,1941,20,na,1961,3812.6790307577853
SIM,1868,13,na,1881,2496
SIM,1898,30,30-34,1928,38
SIM,1910,20,50-100,1930,1
STAT,1802,89,na,1891,36.70394445191025
SIM,1883,61,na,1944,2059
STAT,1812,43,30-34,1855,2.889092842459489
SIM,1869,28,45-49,1897,1
SIM,1860,27,25-29,1887,43
STAT,1939,27,20-24,1966,18.525635910833152
STAT,1852,27,25-29,1879,37.366128114252476
STAT,1893,46,na,1939,2894.018974854215
STAT,1838,52,40-44,1890,0.007009969926573774
STAT,1882,46,na,1928,2207.375653196093
STAT,1943,16,30-34,1959,13.054623530220079
STAT,1932,38,na,1970,5103.215302503502
STAT,1938,22,35-39,1960,9.407794721523281
SIM,1829,40,35-39,1869,3
SIM,1843,96,na,1939,25
STAT,1850,102,na,1952,0.2244881395235065
STAT,1902,20,50-100,1922,0.5854956422135845
SIM,1946,22,35-39,1968,17
STAT,1903,30,25-29,1933,14.851524631448434
STAT,1908,48,25-29,1956,0.04829181279166366
STAT,1851,101,na,1952,0.4320692185557119
STAT,1864,45,45-49,1909,0.21723170212805515
STAT,1879,42,na,1921,2433.0471268774672
STAT,1916,16,25-29,1932,9.301280094319846
STAT,1949,6,na,1955,4618.998975702176
SIM,1910,47,50-100,1957,1
STAT,1830,85,na,1915,180.857399549316
STAT,1870,42,50-100,1912,1.0464865759687905
SIM,1895,46,na,1941,3071
STAT,1917,35,20-24,1952,0.278998225310724
SIM,1891,32,na,1923,3057
STAT,1876,39,na,1915,2432.186414707552
STAT,1839,36,45-49,1875,1.7065735183502584
STAT,1854,21,15-19,1875,2.9301021308646384
STAT,1797,66,na,1863,790.3363527183745
STAT,1866,13,na,1879,2506.8147470358117
STAT,1940,24,40-44,1964,3.4555876332276525
STAT,1873,27,45-49,1900,1.13684999176767
STAT,1916,53,na,1969,3721.795288425198
SIM,1914,35,45-49,1949,3
SIM,1930,24,na,1954,4924
SIM,1816,63,na,1879,948
SIM,1862,25,30-34,1887,30
STAT,1891,41,35-39,1932,2.2746289368025843
STAT,1854,25,30-34,1879,22.087438229190123
STAT,1877,38,30-34,1915,5.528120006643548
SIM,1840,27,45-49,1867,5
SIM,1841,30,na,1871,1809
STAT,1832,27,45-49,1859,1.0197958642039457
SIM,1885,38,30-34,1923,8
STAT,1918,43,15-19,1961,0.0016457915204056053
STAT,1839,66,na,1905,1162.0137276438015
SIM,1845,44,na,1889,1910
SIM,1923,22,40-44,1945,4
STAT,1927,43,40-44,1970,0.3165627387060749
STAT,1873,7,na,1880,2784.9517450285302
STAT,1876,17,30-34,1893,1.6621555012855826
STAT,1928,27,45-49,1955,2.151306541752625
STAT,1849,31,35-39,1880,9.264343986609878
SIM,1881,27,45-49,1908,1
STAT,1906,35,45-49,1941,0.6389928927864811
SIM,1924,17,na,1941,4417
SIM,1874,30,45-49,1904,5
STAT,1812,47,25-29,1859,0.1328573615610271
STAT,1924,24,na,1948,4327.0924710178515
STAT,1928,38,na,1966,4800.953484549752
SIM,1877,38,35-39,1915,9
SIM,1896,31,na,1927,3148
SIM,1847,36,45-49,1883,1
STAT,1851,47,na,1898,1695.6099250530053
SIM,1903,37,35-39,1940,8
STAT,1902,24,20-24,1926,97.74032391721138
STAT,1904,20,15-19,1924,4.810197614018247
STAT,1844,29,na,1873,2065.2411596851266
STAT,1884,15,15-19,1899,5.938245273913142
SIM,1905,30,25-29,1935,19
STAT,1812,110,na,1922,1.254605460494301E-4
STAT,1944,23,na,1967,3980.224464145443
STAT,1912,35,45-49,1947,0.6776625017610931
SIM,1881,20,35-39,1901,3
SIM,1867,18,20-24,1885,1
SIM,1785,85,na,1870,56
SIM,1922,7,na,1929,5180
STAT,1941,27,15-19,1968,0.7372925828190999
SIM,1892,27,20-24,1919,2
SIM,1907,21,na,1928,3585
STAT,1850,40,35-39,1890,1.4005560716302803
STAT,1871,28,35-39,1899,9.647887856299569
SIM,1897,40,40-44,1937,3
SIM,1877,28,na,1905,2444
SIM,1842,39,25-29,1881,2
SIM,1858,27,30-34,1885,28
STAT,1888,36,40-44,1924,5.243589031086697
STAT,1920,10,na,1930,4502.741889458026
STAT,1865,28,na,1893,2193.237914358122
SIM,1860,40,45-49,1900,7
STAT,1869,38,35-39,1907,6.910866519700084
SIM,1847,51,na,1898,1588
STAT,1870,47,35-39,1917,0.13820302663407663
SIM,1910,24,20-24,1934,136
SIM,1938,5,na,1943,3913
STAT,1889,39,15-19,1928,0.06923070487264713
STAT,1828,35,30-34,1863,5.736488349794388
SIM,1932,16,20-24,1948,199
SIM,1880,41,25-29,1921,3
STAT,1863,32,na,1895,2135.4853416332535
SIM,1826,52,na,1878,1696
STAT,1897,20,20-24,1917,93.86831881484923
SIM,1939,27,25-29,1966,77
STAT,1889,40,40-44,1929,2.8295005437116676
SIM,1925,28,35-39,1953,34
STAT,1924,16,20-24,1940,163.54502526709794
STAT,1834,39,25-29,1873,2.089016121887708
SIM,1861,44,30-34,1905,3
STAT,1859,43,na,1902,1863.939624506682
STAT,1882,83,na,1965,652.9562886528438
SIM,1926,18,25-29,1944,66
STAT,1901,34,30-34,1935,24.508823964576628
STAT,1918,18,25-29,1936,47.494525238743606
SIM,1868,30,45-49,1898,1
STAT,1936,35,30-34,1971,1.8095090691691378
STAT,1861,84,na,1945,279.1976030083832
STAT,1865,98,na,1963,9.215927911355509
STAT,1872,41,25-29,1913,0.6550100799333407
SIM,1844,81,na,1925,293
STAT,1846,54,40-44,1900,0.007769574291013681
SIM,1848,95,na,1943,10
STAT,1896,30,30-34,1926,23.529894819286525
STAT,1840,53,35-39,1893,0.005937948327525262
STAT,1859,18,20-24,1877,16.618679453289
STAT,1917,28,35-39,1945,15.83687450459945
STAT,1841,29,15-19,1870,0.4153790674437459
STAT,1943,18,35-39,1961,4.49151845083119
SIM,1927,22,25-29,1949,140
SIM,1908,22,15-19,1930,4
STAT,1870,98,na,1968,17.100571542838875
STAT,1936,29,45-49,1965,1.6675249484539112
SIM,1879,30,20-24,1909,5
SIM,1916,6,na,1922,4248
STAT,1927,7,na,1934,5023.599855975609
SIM,1836,35,30-34,1871,7
STAT,1916,31,50-100,1947,0.864950537818034
SIM,1810,53,na,1863,1286
SIM,1840,26,45-49,1866,1
STAT,1858,25,15-19,1883,0.37336885473682113
SIM,1814,67,na,1881,833
STAT,1810,46,25-29,1856,0.22678997308630133
STAT,1862,47,na,1909,1953.208193880458
STAT,1850,15,45-49,1865,0.06184804382323868
STAT,1853,44,50-100,1897,0.8618681348629623
STAT,1873,28,45-49,1901,1.1328482797966484
SIM,1831,52,na,1883,1501
SIM,1950,20,35-39,1970,15
SIM,1889,41,45-49,1930,2
STAT,1895,26,30-34,1921,33.32798516738373
STAT,1849,48,20-24,1897,0.009264346971460646
SIM,1881,28,45-49,1909,1
STAT,1799,73,na,1872,511.6760455945494
SIM,1890,10,na,1900,3520
SIM,1931,20,25-29,1951,202
SIM,1874,9,na,1883,2568
SIM,1855,35,40-44,1890,9
STAT,1812,67,na,1879,846.8246325133978
STAT,1932,25,45-49,1957,2.288740789297422
SIM,1898,32,35-39,1930,17
SIM,1857,51,na,1908,1863
SIM,1870,23,15-19,1893,3
STAT,1850,52,40-44,1902,0.008018252937955522
STAT,1931,41,40-44,1972,0.3381926918250059
STAT,1919,22,25-29,1941,102.1247806587252
STAT,1862,23,15-19,1885,2.9244901548566857
STAT,1815,39,15-19,1854,0.16868895980113807
SIM,1944,16,na,1960,3989
STAT,1867,94,na,1961,40.559944602209086
SIM,1880,44,40-44,1924,5
STAT,1907,0,na,1907,4355.256118384354
SIM,1894,24,na,1918,3249
STAT,1832,26,45-49,1858,1.0311563428407782
STAT,1927,16,na,1943,4637.1184792402355
STAT,1954,17,45-49,1971,0.623909721790645
SIM,1888,37,45-49,1925,9
STAT,1914,48,25-29,1962,0.05293131699081862
SIM,1876,43,na,1919,2638
STAT,1903,36,30-34,1939,1.6626319751488694
STAT,1897,60,na,1957,2628.631941523538
SIM,1797,70,na,1867,607
STAT,1896,38,na,1934,3134.1330388629203
STAT,1889,20,25-29,1909,71.71872905981941
SIM,1906,28,25-29,1934,69
STAT,1879,53,40-44,1932,0.010917980265495996
STAT,1912,41,30-34,1953,0.12511701402079564
SIM,1941,24,50-100,1965,2
SIM,1907,18,15-19,1925,10
STAT,1833,66,na,1899,1159.5927268634555
STAT,1881,54,35-39,1935,0.00815099739908776
STAT,1923,39,15-19,1962,0.022433962691222303
SIM,1878,17,30-34,1895,4
STAT,1892,2,na,1894,3378.401928928355
STAT,1892,24,na,1916,2978.6490534586355
STAT,1831,40,25-29,1871,0.5095710126376476
STAT,1846,95,na,1941,10.089783063434417
STAT,1765,93,na,1858,5.384494645217508
STAT,1878,18,30-34,1896,1.666721743314414
STAT,1834,20,35-39,1854,8.87695937121382
STAT,1847,35,40-44,1882,3.4720155585291943
STAT,1786,103,na,1889,0.056873939841424685
STAT,1871,32,30-34,1903,17.519503110517412
STAT,1829,29,na,1858,1676.8592270980819
STAT,1912,39,na,1951,3667.3474264171005
STAT,1918,30,50-100,1948,0.8941217904566422
STAT,1911,36,50-100,1947,0.4110949773166627
STAT,1852,28,25-29,1880,37.097839314392154
STAT,1942,20,35-39,1962,9.974772532672521
STAT,1851,44,20-24,1895,0.11862812254455206
STAT,1933,24,50-100,1957,0.8813763027399433
SIM,1860,28,25-29,1888,48
STAT,1862,43,20-24,1905,0.13751931356816782
SIM,1866,21,35-39,1887,7
SIM,1839,27,20-24,1866,2
STAT,1864,51,30-34,1915,0.005451034199991931
STAT,1899,62,na,1961,2673.1626860796587
STAT,1782,73,na,1855,487.52952
SIM,1949,16,15-19,1965,48
STAT,1898,18,20-24,1916,24.210462606666013
SIM,1910,26,25-29,1936,7
STAT,1854,50,na,1904,1639.1449194545987
SIM,1818,70,na,1888,686
STAT,1890,47,15-19,1937,2.771693304664106E-4
SIM,1907,16,25-29,1923,15
SIM,1859,40,45-49,1899,4
STAT,1925,28,30-34,1953,46.60577419316827
STAT,1845,34,30-34,1879,14.857039645363411
STAT,1837,80,na,1917,421.993756479887
SIM,1922,10,na,1932,5164
SIM,1871,25,35-39,1896,15
STAT,1945,27,45-49,1972,1.9141197637828462
SIM,1811,48,na,1859,1529
STAT,1841,48,na,1889,1668.5760671733753
STAT,1847,42,40-44,1889,1.6935087960092854
SIM,1933,28,30-34,1961,56
STAT,1897,21,50-100,1918,0.5538392482401108
SIM,1836,83,na,1919,275
STAT,1839,18,40-44,1857,0.16863239125641796
STAT,1922,42,50-100,1964,0.13622273186477668
SIM,1783,89,na,1872,54
STAT,1852,85,na,1937,207.90134423804088
STAT,1927,36,40-44,1963,1.8829179428418052
SIM,1853,34,30-34,1887,19
STAT,1894,30,20-24,1924,3.543136012958311
SIM,1948,23,45-49,1971,1
SIM,1918,39,45-49,1957,1
STAT,1902,26,25-29,1928,60.582319834867
STAT,1842,65,na,1907,1521.5319599058625
STAT,1882,51,35-39,1933,0.008462951297384199
SIM,1910,15,30-34,1925,5
STAT,1906,4,na,1910,3870.0138949577936
STAT,1887,77,na,1964,1268.6324464375814
STAT,1853,40,50-100,1893,0.8824764710134207
STAT,1851,51,20-24,1902,5.614169272570806E-4
SIM,1945,17,na,1962,3877
SIM,1852,20,na,1872,1882
STAT,1867,41,50-100,1908,1.0094672225399686
SIM,1935,36,40-44,1971,2
SIM,1901,4,na,1905,3843
SIM,1886,42,na,1928,2606
SIM,1846,40,35-39,1886,1
STAT,1910,34,20-24,1944,2.3525098956093378
STAT,1871,30,na,1901,2413.7294667281535
SIM,1928,15,30-34,1943,19
STAT,1879,45,40-44,1924,0.1822437264445303
STAT,1828,44,na,1872,1674.928610309425
STAT,1852,24,20-24,1876,61.19727013753132
STAT,1912,48,15-19,1960,3.561773877631193E-4
SIM,1901,37,25-29,1938,1
STAT,1858,21,35-39,1879,5.343705318671291
STAT,1902,61,na,1963,2846.111157197779
STAT,1894,41,15-19,1935,0.018038662876320475
SIM,1827,31,na,1858,1660
SIM,1926,29,40-44,1955,6
SIM,1865,17,20-24,1882,17
STAT,1902,15,30-34,1917,2.285435552290908
STAT,1904,23,40-44,1927,3.0109789512651233
STAT,1819,44,30-34,1863,2.31141166202257
STAT,1882,45,50-100,1927,0.24267767201949467
STAT,1841,50,35-39,1891,0.00653049614016626
STAT,1843,46,15-19,1889,2.7199158166670603E-4
STAT,1883,30,45-49,1913,1.7373979571931046
SIM,1942,26,30-34,1968,61
SIM,1906,26,20-24,1932,23
STAT,1769,91,na,1860,14.239726294705644
STAT,1920,39,35-39,1959,2.6686015104299807
SIM,1948,0,na,1948,5152
STAT,1867,18,50-100,1885,0.04736076958008124
STAT,1929,19,15-19,1948,58.22679108416945
STAT,1812,104,na,1916,0.030282555908070982
STAT,1853,40,15-19,1893,0.011535640986916226
STAT,1919,37,45-49,1956,0.7394641581582473
STAT,1936,34,40-44,1970,3.832491857156795
SIM,1894,20,45-49,1914,2
STAT,1849,28,na,1877,1990.5522037182886
STAT,1921,18,45-49,1939,0.5735859678293437
SIM,1845,50,na,1895,1819
STAT,1803,52,50-100,1855,0.06549886055995209
STAT,1899,22,35-39,1921,8.088861541313705
STAT,1895,74,na,1969,1864.5771266801632
STAT,1896,33,50-100,1929,1.2197788247421737
STAT,1837,19,45-49,1856,0.06468900556046119
STAT,1837,96,na,1933,5.857642411476143
SIM,1817,40,50-100,1857,1
SIM,1868,47,50-100,1915,1
STAT,1918,29,40-44,1947,4.972069062764966
STAT,1900,18,15-19,1918,8.304426179745835
STAT,1897,36,45-49,1933,2.712290087821627
SIM,1824,88,na,1912,46
SIM,1874,57,na,1931,1846
STAT,1829,83,na,1912,234.07858323139627
STAT,1864,46,35-39,1910,0.12795646832899474
STAT,1910,21,15-19,1931,5.058732350072363
STAT,1932,16,na,1948,4937.53135399712
STAT,1776,109,na,1885,0.002735952281155527
SIM,1869,36,35-39,1905,8
STAT,1934,26,30-34,1960,53.28383870124476
STAT,1887,55,na,1942,2331.6488236577648
SIM,1907,38,30-34,1945,2
STAT,1847,54,35-39,1901,0.0062686628046907476
STAT,1887,45,na,1932,2562.3168712339575
SIM,1909,15,20-24,1924,38
SIM,1766,93,na,1859,2
SIM,1819,42,30-34,1861,2
STAT,1902,34,50-100,1936,0.7444644097636615
STAT,1828,66,na,1894,1063.9751747765963
STAT,1895,22,50-100,1917,0.537860613839556
STAT,1908,40,na,1948,3507.912569121882
SIM,1855,42,40-44,1897,8
STAT,1849,38,na,1887,1865.4105152997201
SIM,1837,31,na,1868,1682
SIM,1840,35,na,1875,1892
STAT,1779,91,na,1870,20.855040258957985
SIM,1887,41,35-39,1928,2
SIM,1795,74,na,1869,376
STAT,1823,33,40-44,1856,10.044755451384328
STAT,1863,25,35-39,1888,8.760070336640894
STAT,1903,25,na,1928,3456.0959642895714
STAT,1879,41,35-39,1920,1.9172333547630065
STAT,1853,33,na,1886,2011.2244025897653
SIM,1870,33,na,1903,2629
STAT,1782,95,na,1877,2.6022253348405733
STAT,1907,44,15-19,1951,0.0014031905614569522
STAT,1881,43,30-34,1924,1.111191869493662
STAT,1864,34,40-44,1898,3.9185886901911737
SIM,1920,37,35-39,1957,5
STAT,1862,85,na,1947,239.10561579166847
STAT,1890,24,40-44,1914,2.555655607541868
STAT,1913,16,45-49,1929,0.10330404532616408
SIM,1828,36,50-100,1864,1
SIM,1926,16,35-39,1942,6
SIM,1888,19,40-44,1907,1
STAT,1895,33,30-34,1928,22.931546545564444
SIM,1911,31,25-29,1942,17
SIM,1920,25,na,1945,4440
SIM,1839,42,50-100,1881,2
SIM,1886,64,na,1950,1981
SIM,1927,15,25-29,1942,73
STAT,1924,27,15-19,1951,0.8306033153220145
STAT,1810,53,25-29,1863,0.01271953646152357
STAT,1812,44,20-24,1856,0.38272925352674686
SIM,1932,27,15-19,1959,1
SIM,1853,85,na,1938,167
STAT,1803,90,na,1893,32.86577136200904
STAT,1908,36,30-34,1944,1.7308471205944573
SIM,1827,53,na,1880,1308
SIM,1877,35,30-34,1912,8
SIM,1903,55,na,1958,2783
STAT,1886,20,45-49,1906,0.7480556972484398
SIM,1873,19,20-24,1892,17
STAT,1910,25,50-100,1935,0.984588265903037
STAT,1865,19,20-24,1884,16.650736667409568
STAT,1910,17,30-34,1927,2.436687136940685
SIM,1847,21,25-29,1868,71
SIM,1840,45,na,1885,1659
STAT,1782,89,na,1871,37.3972506537309
STAT,1913,40,50-100,1953,0.11690192536313807
STAT,1881,46,35-39,1927,0.13668614282709782
SIM,1886,33,30-34,1919,31
STAT,1847,80,na,1927,463.16594813025984
STAT,1930,16,45-49,1946,0.6543575171600632
STAT,1878,33,30-34,1911,18.22847387172871
STAT,1830,35,25-29,1865,2.691659600993479
SIM,1864,35,50-100,1899,3
STAT,1870,51,30-34,1921,0.005931915409945315
STAT,1879,26,na,1905,2524.027245100761
STAT,1866,5,na,1871,2652.5472049289456
SIM,1932,10,na,1942,6006
SIM,1827,44,30-34,1871,1
STAT,1866,54,45-49,1920,0.013199247998191721
STAT,1857,17,20-24,1874,16.424753233258667
STAT,1939,18,45-49,1957,0.5046333595054916
STAT,1841,24,45-49,1865,0.6511430392614246
SIM,1874,79,na,1953,807
STAT,1849,47,20-24,1896,0.009338494618733387
SIM,1861,50,na,1911,1875
STAT,1919,34,na,1953,4084.612987208623
SIM,1849,29,30-34,1878,32
STAT,1838,44,na,1882,1604.9159993748435
SIM,1866,38,20-24,1904,1
STAT,1825,31,50-100,1856,2.489896262283699
STAT,1886,35,30-34,1921,5.737400610305224
SIM,1860,33,na,1893,2077
STAT,1878,19,30-34,1897,1.6621382585203
STAT,1933,38,50-100,1971,0.5773013085649935
STAT,1860,44,25-29,1904,0.5230254407476514
SIM,1865,40,45-49,1905,4
SIM,1866,29,30-34,1895,25
SIM,1894,35,30-34,1929,11
STAT,1864,30,35-39,1894,9.303867546294786
STAT,1881,30,25-29,1911,10.052000877464826
SIM,1927,37,45-49,1964,2
STAT,1811,43,50-100,1854,2.925805997095783
STAT,1878,37,50-100,1915,1.2872327594535053
STAT,1848,19,20-24,1867,17.732670651463557
SIM,1893,12,na,1905,3397
SIM,1831,68,na,1899,1010
SIM,1840,19,na,1859,2072
STAT,1891,15,45-49,1906,0.0820638852727853
STAT,1921,31,50-100,1952,0.9330726030073743
SIM,1937,19,15-19,1956,52
STAT,1850,31,45-49,1881,1.411404747695144
SIM,1836,42,30-34,1878,1
STAT,1853,11,na,1864,2385.6520708201147
STAT,1919,15,25-29,1934,9.745969582262545
STAT,1918,16,35-39,1934,0.9273680818911936
STAT,1828,42,30-34,1870,1.0977655484963746
STAT,1903,44,30-34,1947,0.11328611110850613
STAT,1801,101,na,1902,0.22709702780082286
SIM,1934,15,30-34,1949,20
STAT,1869,24,15-19,1893,3.2192247903385423
SIM,1823,34,45-49,1857,1
STAT,1871,36,25-29,1907,2.9029613335187503
STAT,1867,57,na,1924,1911.6050652474069
SIM,1862,32,30-34,1894,32
SIM,1925,26,30-34,1951,58
SIM,1892,29,50-100,1921,2
STAT,1890,41,30-34,1931,1.4252955745972447
STAT,1917,37,25-29,1954,1.0322823789352857
STAT,1840,45,35-39,1885,0.10153319657502678
STAT,1839,29,20-24,1868,10.327983410575637
SIM,1833,65,na,1898,1182
SIM,1903,28,45-49,1931,1
STAT,1871,27,35-39,1898,9.681968385014828
SIM,1806,85,na,1891,58
STAT,1823,45,35-39,1868,0.19826566884355296
SIM,1845,32,30-34,1877,19
STAT,1871,62,na,1933,1833.9896716631613
STAT,1808,46,na,1854,1287.316233186417
STAT,1855,53,30-34,1908,0.004408667107812663
STAT,1821,45,25-29,1866,0.08690413335907815
STAT,1869,35,30-34,1904,5.2831266139467585
STAT,1890,36,35-39,1926,8.771136364459386
STAT,1838,44,40-44,1882,1.5618884909966775
STAT,1838,40,35-39,1878,1.4544403161894615
STAT,1894,25,na,1919,3124.3342479716484
STAT,1899,40,na,1939,3247.231955550797
STAT,1915,10,na,1925,4183.455743559146
SIM,1786,91,na,1877,18
SIM,1881,27,na,1908,2067
STAT,1933,34,15-19,1967,0.17477178238862007
STAT,1854,32,30-34,1886,13.418553191583458
STAT,1903,18,40-44,1921,0.2624008883460468
STAT,1948,19,25-29,1967,50.06479754755572
STAT,1858,29,30-34,1887,20.134341796237592
SIM,1825,46,na,1871,1288
STAT,1770,88,na,1858,22.735998460214766
SIM,1921,16,45-49,1937,1
STAT,1839,21,25-29,1860,52.52479216625577
STAT,1837,32,30-34,1869,14.934246396719438
STAT,1907,15,20-24,1922,26.417624296705693
STAT,1910,37,25-29,1947,0.9500638859118773
SIM,1936,34,na,1970,3788
SIM,1929,20,30-34,1949,2
STAT,1871,50,20-24,1921,7.510866986647141E-4
STAT,1886,15,50-100,1901,0.05248733251135087
SIM,1892,28,20-24,1920,19
SIM,1907,22,45-49,1929,2
STAT,1903,31,25-29,1934,14.793306654893152
STAT,1823,50,30-34,1873,0.008206159179430822
SIM,1890,25,45-49,1915,2
STAT,1850,84,na,1934,254.72480224315225
SIM,1781,76,na,1857,304
STAT,1842,34,50-100,1876,0.9760510619493212
STAT,1921,22,na,1943,4165.808130549648
STAT,1854,50,20-24,1904,5.617569021983981E-4
STAT,1874,53,40-44,1927,0.010712773676183826
SIM,1877,39,35-39,1916,5
STAT,1814,68,na,1882,843.7363663391518
STAT,1839,52,45-49,1891,0.010234134705892135
SIM,1932,26,50-100,1958,1
SIM,1916,36,30-34,1952,5
STAT,1922,44,40-44,1966,0.2890647744218284
STAT,1899,30,na,1929,3334.3779803400007
SIM,1856,28,na,1884,2184
SIM,1846,44,40-44,1890,6
STAT,1845,39,50-100,1884,0.9231960885443763
STAT,1884,16,50-100,1900,0.04891550935770649
STAT,1882,25,45-49,1907,1.0936319182735854
STAT,1869,39,35-39,1908,6.8754137744540245
SIM,1875,19,30-34,1894,2
STAT,1855,40,35-39,1895,1.3767908144418257
STAT,1794,74,na,1868,464.8232530031984
STAT,1942,28,30-34,1970,41.50166241088405
STAT,1943,27,25-29,1970,70.78059394064911
SIM,1843,28,25-29,1871,53
SIM,1836,67,na,1903,1095
SIM,1913,55,na,1968,3440
SIM,1909,27,50-100,1936,1
SIM,1814,41,40-44,1855,4
SIM,1879,78,na,1957,916
STAT,1878,24,50-100,1902,0.42487326423677
STAT,1884,28,20-24,1912,11.643337538129302
SIM,1896,35,40-44,1931,10
STAT,1808,99,na,1907,0.7140020647945973
SIM,1855,33,50-100,1888,3
STAT,1916,47,20-24,1963,0.011438833313202211
SIM,1871,22,30-34,1893,32
STAT,1860,26,20-24,1886,9.86037549527223
SIM,1895,39,50-100,1934,4
STAT,1873,32,40-44,1905,4.440405523652055
STAT,1845,37,35-39,1882,5.430059614695289
STAT,1849,20,40-44,1869,1.9983841664636781
STAT,1915,47,50-100,1962,0.2299759940455747
SIM,1846,47,45-49,1893,3
STAT,1830,52,25-29,1882,0.0026054638726297893
STAT,1925,32,15-19,1957,0.15421842246334067
SIM,1948,17,25-29,1965,72
STAT,1931,37,45-49,1968,0.9124619795598711
SIM,1865,27,na,1892,2284
STAT,1812,52,20-24,1864,0.0016289760976448255
STAT,1863,11,na,1874,2448.853346597759
STAT,1847,33,50-100,1880,0.7971624351215232
SIM,1876,64,na,1940,1933
STAT,1809,51,20-24,1860,0.002420250626618363
STAT,1900,8,na,1908,3647.192366202674
SIM,1910,41,na,1951,3289
SIM,1918,36,40-44,1954,3
SIM,1901,34,20-24,1935,2
STAT,1891,32,45-49,1923,2.180611619883039
STAT,1829,54,40-44,1883,0.0066378136960631075
SIM,1883,32,50-100,1915,2
SIM,1923,47,50-100,1970,4
SIM,1928,18,35-39,1946,6
SIM,1829,44,40-44,1873,8
SIM,1911,42,na,1953,3853
STAT,1823,37,50-100,1860,2.137833645240362
STAT,1824,41,45-49,1865,1.8986042869282784
STAT,1835,28,25-29,1863,41.09760712002597
SIM,1897,10,na,1907,3591
STAT,1883,46,45-49,1929,0.23391789092616805
SIM,1925,40,na,1965,4534
STAT,1863,22,30-34,1885,16.257697499509746
STAT,1950,17,15-19,1967,54.215256777318004
STAT,1880,22,30-34,1902,18.893675695320887
STAT,1832,23,40-44,1855,2.0969136394833705
STAT,1946,15,50-100,1961,0.4199241428526989
SIM,1900,16,15-19,1916,10
STAT,1872,53,30-34,1925,0.005947294672424869
SIM,1902,12,na,1914,3933
STAT,1877,30,45-49,1907,1.8324126591582384
STAT,1887,39,na,1926,2629.9695219558726
SIM,1781,92,na,1873,1
SIM,1832,41,45-49,1873,1
STAT,1875,32,50-100,1907,0.9503459094100074
STAT,1909,17,20-24,1926,26.828739852203128
SIM,1889,18,20-24,1907,22
STAT,1864,54,35-39,1918,0.007630421189552534
SIM,1917,39,40-44,1956,5
STAT,1909,39,40-44,1948,1.4154521677440108
STAT,1887,39,50-100,1926,1.3705251865610582
STAT,1921,23,40-44,1944,3.823775589102327
SIM,1800,54,na,1854,1117
SIM,1888,39,na,1927,2919
SIM,1853,37,35-39,1890,3
SIM,1834,66,na,1900,1163
SIM,1864,79,na,1943,802
STAT,1856,44,35-39,1900,1.3832698500872311
STAT,1838,47,45-49,1885,0.1625338982082464
SIM,1836,38,35-39,1874,21
SIM,1864,44,35-39,1908,7
STAT,1946,19,15-19,1965,50.80580859349792
STAT,1857,40,45-49,1897,1.1916219162169568
STAT,1842,45,45-49,1887,0.21803021901537512
SIM,1817,38,25-29,1855,2
STAT,1876,29,25-29,1905,43.79844905667655
SIM,1895,25,na,1920,3142
STAT,1907,49,na,1956,3285.5255802765096
STAT,1836,40,15-19,1876,0.010632828199125331
SIM,1840,23,40-44,1863,3
STAT,1809,47,na,1856,1460.6992280041761
STAT,1824,36,na,1860,1437.9495012687446
STAT,1922,38,na,1960,4320.330046535935
STAT,1834,36,20-24,1870,0.5769907482316465
STAT,1934,29,35-39,1963,20.387339989821125
STAT,1895,29,35-39,1924,12.63562394577289
STAT,1862,63,na,1925,1556.3063913520045
SIM,1879,56,na,1935,2402
STAT,1918,46,40-44,1964,0.16980474703119208
STAT,1792,67,na,1859,708.7467502586626
STAT,1840,51,45-49,1891,0.010221697156654467
STAT,1937,15,na,1952,3631.740938270193
STAT,1849,102,na,1951,0.22921971357744242
STAT,1918,42,25-29,1960,0.0766504082326573
STAT,1919,17,50-100,1936,0.41803196835155726
STAT,1768,104,na,1872,0.05722305132649525
STAT,1843,27,20-24,1870,9.737726993618672
STAT,1881,52,45-49,1933,0.014053570233742128
STAT,1900,37,30-34,1937,1.6139434177392022
STAT,1920,44,30-34,1964,0.1421116843504054
SIM,1903,33,40-44,1936,6
SIM,1851,27,20-24,1878,2
SIM,1923,26,20-24,1949,29
STAT,1935,29,40-44,1964,6.412921424566008
STAT,1904,20,na,1924,3448.399000411119
STAT,1833,32,50-100,1865,0.8376719676232017
STAT,1901,44,20-24,1945,0.01540373798517853
SIM,1908,28,35-39,1936,18
SIM,1865,42,50-100,1907,2
STAT,1834,54,25-29,1888,0.002078913788382953
STAT,1912,37,35-39,1949,2.3817373229214907
STAT,1901,49,40-44,1950,0.13387601408606337
SIM,1854,80,na,1934,521
STAT,1853,5,na,1858,2501.471811654423
STAT,1911,47,45-49,1958,0.2075818911255917
SIM,1888,22,25-29,1910,93
STAT,1928,17,na,1945,4687.773224584122
STAT,1835,30,na,1865,2114.2553432665704
SIM,1869,33,30-34,1902,19
STAT,1863,51,25-29,1914,0.003184876951907736
STAT,1848,41,30-34,1889,0.94958896891541
STAT,1869,43,30-34,1912,1.1207713687726484
STAT,1870,21,45-49,1891,0.6936833237227034
STAT,1819,47,35-39,1866,0.2728396673355054
SIM,1870,11,na,1881,2989
SIM,1885,25,na,1910,2594
SIM,1830,24,35-39,1854,8
STAT,1911,16,25-29,1927,8.770268130000227
SIM,1815,68,na,1883,749
STAT,1898,32,50-100,1930,1.254531444917128
SIM,1875,35,20-24,1910,3
STAT,1799,68,na,1867,732.6109718110373
STAT,1867,35,20-24,1902,0.7402121100601612
STAT,1829,61,na,1890,1101.8183786436664
STAT,1886,38,35-39,1924,7.505103073470424
SIM,1848,17,20-24,1865,25
SIM,1884,29,25-29,1913,65
SIM,1942,29,35-39,1971,25
SIM,1816,85,na,1901,93
STAT,1851,54,25-29,1905,0.002608216546504871
STAT,1853,53,20-24,1906,6.004439238575694E-4
STAT,1832,65,na,1897,1150.7363484678385
SIM,1856,41,30-34,1897,1
SIM,1889,40,30-34,1929,1
STAT,1869,42,na,1911,2266.747327787443
STAT,1921,15,40-44,1936,1.6177414843382618
STAT,1810,50,20-24,1860,0.0028153621670848976
SIM,1823,43,35-39,1866,6
SIM,1912,26,35-39,1938,18
STAT,1893,25,20-24,1918,15.146969271873294
SIM,1929,23,35-39,1952,15
STAT,1908,39,35-39,1947,2.2630093422154354
STAT,1849,81,na,1930,422.79829320671587
SIM,1931,28,20-24,1959,2
STAT,1823,36,45-49,1859,3.622680000485415
SIM,1922,42,40-44,1964,1
SIM,1894,38,35-39,1932,12
SIM,1866,81,na,1947,550
STAT,1808,46,20-24,1854,0.045057285336204886
STAT,1846,63,na,1909,1354.0815201843025
STAT,1923,28,20-24,1951,21.10070695461318
SIM,1899,20,35-39,1919,8
STAT,1847,9,na,1856,2276.7366400497
STAT,1876,53,50-100,1929,0.015496915864554537
STAT,1848,15,40-44,1863,0.1873201877172169
STAT,1917,18,50-100,1935,0.08116662330763028
STAT,1911,49,50-100,1960,0.21475968357460198
SIM,1935,19,40-44,1954,3
STAT,1792,73,na,1865,476.8912891844356
STAT,1864,27,na,1891,2175.046673481392
STAT,1926,40,50-100,1966,0.14677913329195563
STAT,1911,44,na,1955,3532.281709694239
STAT,1826,34,20-24,1860,3.3911491097017037
SIM,1862,28,35-39,1890,10
SIM,1890,34,35-39,1924,2
SIM,1909,18,25-29,1927,11
SIM,1881,24,40-44,1905,2
SIM,1852,31,45-49,1883,1
STAT,1854,28,35-39,1882,7.536832846824479
STAT,1882,34,35-39,1916,9.822963841763887
STAT,1818,41,45-49,1859,3.038952954648046
STAT,1829,50,25-29,1879,0.00265660813497825
STAT,1831,52,30-34,1883,0.003911663760324729
SIM,1831,36,45-49,1867,3
STAT,1909,56,na,1965,3279.5967498368964
STAT,1815,43,35-39,1858,4.4631221779412495
STAT,1901,36,20-24,1937,0.2367055397238793
STAT,1915,26,20-24,1941,18.851651451891705
STAT,1878,78,na,1956,859.9472382073827
SIM,1880,16,na,1896,2450
SIM,1916,39,35-39,1955,11
STAT,1875,37,20-24,1912,0.799537945311902
STAT,1888,43,40-44,1931,2.662018256101381
SIM,1785,90,na,1875,6
STAT,1830,32,20-24,1862,2.5949247304407757
STAT,1898,41,45-49,1939,0.1429454254250242
SIM,1854,96,na,1950,21
SIM,1815,46,na,1861,1476
STAT,1780,88,na,1868,39.38990101591361
STAT,1850,78,na,1928,598.2772468436427
STAT,1899,39,20-24,1938,0.22830809600108268
STAT,1855,40,25-29,1895,0.48824231129705714
SIM,1886,36,35-39,1922,5
SIM,1905,29,50-100,1934,1
SIM,1915,40,na,1955,4180
SIM,1955,3,na,1958,5064
SIM,1865,70,na,1935,1131
STAT,1890,20,35-39,1910,7.2448916790794495
STAT,1889,42,30-34,1931,1.430027373529809
SIM,1852,30,na,1882,1866
STAT,1906,39,15-19,1945,0.01765100817377063
STAT,1814,84,na,1898,155.70641791983917
STAT,1890,27,45-49,1917,1.3702926212990567
STAT,1835,52,na,1887,1646.873351907959
STAT,1844,31,45-49,1875,1.6670933318287766
SIM,1840,51,na,1891,1507
STAT,1868,40,20-24,1908,0.15484763024863438
SIM,1845,82,na,1927,374
STAT,1878,36,35-39,1914,7.451330138820062
STAT,1870,54,35-39,1924,0.008303564310557248
SIM,1923,38,na,1961,4430
STAT,1830,26,35-39,1856,11.243277354383615
STAT,1876,12,na,1888,2708.9743085745276
SIM,1935,17,na,1952,4847
SIM,1885,47,na,1932,2413
STAT,1916,38,30-34,1954,1.8741861100152741
STAT,1866,51,40-44,1917,0.009892909132564371
STAT,1805,51,50-100,1856,0.0633556208958687
STAT,1861,18,25-29,1879,5.434243060334739
STAT,1871,53,25-29,1924,0.003497075924466509
STAT,1856,35,45-49,1891,1.5583091931264932
SIM,1896,30,20-24,1926,4
SIM,1877,12,na,1889,2742
SIM,1883,37,20-24,1920,1
STAT,1869,58,na,1927,1941.9186359306905
SIM,1826,41,45-49,1867,3
SIM,1840,31,40-44,1871,11
STAT,1948,16,20-24,1964,156.7781261907561
STAT,1899,24,na,1923,3257.7936890672513
SIM,1918,22,20-24,1940,136
STAT,1879,48,45-49,1927,0.24561848174744638
STAT,1926,18,35-39,1944,5.185919733101663
SIM,1796,91,na,1887,8
SIM,1860,24,20-24,1884,73
SIM,1841,30,30-34,1871,23
STAT,1819,67,na,1886,834.3229872612874
STAT,1885,32,45-49,1917,1.7531302357118588
SIM,1893,32,45-49,1925,4
STAT,1878,25,na,1903,2519.137165901448
STAT,1908,31,50-100,1939,0.7910292426979609
STAT,1823,53,35-39,1876,0.011180723637493622
STAT,1871,33,20-24,1904,2.700868612987403
SIM,1915,18,25-29,1933,10
STAT,1810,106,na,1916,0.006305909957898309
STAT,1907,18,25-29,1925,8.383028308773211
STAT,1870,9,na,1879,2680.5857405115357
SIM,1786,75,na,1861,380
STAT,1837,35,35-39,1872,5.9981073369439475
STAT,1890,44,35-39,1934,2.2046693529508827
STAT,1932,29,15-19,1961,0.9335085121225352
STAT,1871,39,50-100,1910,1.2195478140438707
STAT,1896,41,25-29,1937,0.059886680982563396
STAT,1857,57,na,1914,1584.080240503365
STAT,1870,41,15-19,1911,0.013758399714537604
STAT,1844,50,na,1894,1728.0330183178767
STAT,1920,36,30-34,1956,2.0169662246292623
SIM,1864,35,45-49,1899,2
STAT,1822,50,25-29,1872,0.005263543932471051
STAT,1842,53,45-49,1895,0.012856241375120177
STAT,1877,41,15-19,1918,0.014460825486546923
STAT,1815,102,na,1917,0.12690911676510022
SIM,1811,91,na,1902,31
STAT,1903,35,40-44,1938,1.3719856634930185
SIM,1833,97,na,1930,3
STAT,1888,30,20-24,1918,3.248249595600654
STAT,1880,18,35-39,1898,0.5804966515871252
STAT,1884,47,15-19,1931,3.9654031535341853E-4
SIM,1877,49,50-100,1926,3
STAT,1865,42,45-49,1907,1.378586030553383
SIM,1863,63,na,1926,1627
STAT,1840,49,15-19,1889,2.7560266347582746E-4
SIM,1845,35,35-39,1880,8
SIM,1823,33,na,1856,1675
STAT,1887,40,30-34,1927,1.3095000570190727
STAT,1904,26,35-39,1930,14.03333232260769
STAT,1833,30,30-34,1863,16.2974066105903
STAT,1941,16,20-24,1957,141.0242423531945
SIM,1907,11,na,1918,4080
SIM,1846,67,na,1913,1110
STAT,1871,24,30-34,1895,17.761386286443376
STAT,1927,39,45-49,1966,0.8548646812819823
STAT,1832,31,40-44,1863,3.9017005292761042
STAT,1858,38,20-24,1896,0.6077806966474949
SIM,1841,36,na,1877,1753
SIM,1873,42,45-49,1915,3
STAT,1905,47,45-49,1952,0.19346721577940254
STAT,1859,42,45-49,1901,1.21427724378608
SIM,1911,35,40-44,1946,2
STAT,1928,3,na,1931,5165.76016231517
STAT,1910,39,40-44,1949,1.4299297777541833
STAT,1910,38,50-100,1948,0.40311533958948426
STAT,1841,41,45-49,1882,1.177994391758856
STAT,1844,42,25-29,1886,0.5203428149910101
STAT,1890,20,25-29,1910,71.07183135626994
STAT,1812,50,30-34,1862,0.01367702025404985
STAT,1924,26,50-100,1950,1.1751179653161081
SIM,1928,16,45-49,1944,5
STAT,1926,27,25-29,1953,79.74456496713033
SIM,1871,34,na,1905,2253
SIM,1810,47,na,1857,1454
STAT,1846,50,35-39,1896,0.006627170926522643
STAT,1785,87,na,1872,56.29220111487742
STAT,1898,61,na,1959,2651.1656466302898
SIM,1880,11,na,1891,2522
SIM,1815,40,30-34,1855,5
STAT,1873,35,45-49,1908,2.060535164630857
SIM,1893,19,25-29,1912,14
STAT,1915,48,30-34,1963,0.09039001962971337
STAT,1882,18,45-49,1900,0.06374067449421922
STAT,1826,51,20-24,1877,7.153491199626364E-4
STAT,1879,40,20-24,1919,0.1690779219575829
STAT,1866,20,40-44,1886,1.9932791587360097
STAT,1874,31,30-34,1905,18.130448941970954
STAT,1883,43,40-44,1926,2.2070604418743427
SIM,1860,71,na,1931,1148
SIM,1882,31,30-34,1913,24
STAT,1834,43,45-49,1877,1.0608434641133433
STAT,1859,64,na,1923,1412.1303822251573
STAT,1879,54,30-34,1933,0.006101455631660773
STAT,1910,25,30-34,1935,38.758946393879214
SIM,1826,28,25-29,1854,48
SIM,1839,97,na,1936,1
SIM,1913,31,35-39,1944,10
STAT,1875,52,20-24,1927,7.613083646993698E-4
SIM,1842,43,45-49,1885,1
STAT,1880,41,50-100,1921,1.1256600092898872
STAT,1816,52,40-44,1868,0.026146124640501124
STAT,1848,27,na,1875,2108.5334200950106
STAT,1870,43,30-34,1913,1.131990687512868
STAT,1911,42,15-19,1953,0.0014787371651734376
STAT,1821,33,30-34,1854,60.164435277478574
STAT,1889,16,40-44,1905,0.2283458541167869
SIM,1911,26,na,1937,4031
STAT,1885,11,na,1896,2600.168098643099
STAT,1901,27,30-34,1928,35.65398008503008
STAT,1930,16,35-39,1946,5.496604162534425
SIM,1830,51,na,1881,1287
STAT,1864,52,45-49,1916,0.013156016969458513
STAT,1872,31,na,1903,2433.012444025637
SIM,1863,40,35-39,1903,1
SIM,1809,50,na,1859,1203
STAT,1894,30,45-49,1924,2.28578058974629
STAT,1949,16,na,1965,4325.981295092293
STAT,1931,34,40-44,1965,5.175667529114043
STAT,1858,45,20-24,1903,0.009603436410812594
STAT,1912,21,25-29,1933,89.58020406414785
STAT,1909,15,30-34,1924,2.4232229907164835
STAT,1912,23,na,1935,3678.380681128369
STAT,1842,49,na,1891,1983.3166193888726
SIM,1871,0,na,1871,3578
STAT,1823,42,30-34,1865,1.7056303149638907
STAT,1923,35,45-49,1958,0.7994871570998952
SIM,1854,64,na,1918,1543
STAT,1933,30,35-39,1963,12.458704237016866
STAT,1905,31,35-39,1936,8.525102900629498
STAT,1928,33,na,1961,4776.982165424877
STAT,1857,42,35-39,1899,1.4256063762860762
STAT,1864,37,45-49,1901,1.8168382172625765
SIM,1822,54,na,1876,1339
STAT,1825,107,na,1932,0.003441509295564273
STAT,1940,32,40-44,1972,4.088829948390296
SIM,1872,37,45-49,1909,2
STAT,1885,19,25-29,1904,5.666424171853928
STAT,1855,54,45-49,1909,0.01062339933924309
STAT,1886,31,15-19,1917,0.15248315295827
SIM,1822,43,40-44,1865,5
SIM,1841,14,na,1855,2147
STAT,1884,35,20-24,1919,0.7750531649012122
STAT,1829,45,na,1874,1485.6625993419298
SIM,1941,30,35-39,1971,11
STAT,1873,26,na,1899,2451.969719197228
STAT,1898,17,50-100,1915,0.06708010988838736
STAT,1872,51,40-44,1923,0.010741142750676355
SIM,1839,23,40-44,1862,2
STAT,1901,47,25-29,1948,0.04578843452413182
STAT,1909,42,50-100,1951,0.11088294761093423
SIM,1875,41,50-100,1916,1
STAT,1860,48,40-44,1908,0.13957123319454415
SIM,1939,16,20-24,1955,3
SIM,1920,28,45-49,1948,3
STAT,1890,33,30-34,1923,21.457166313427564
STAT,1892,41,40-44,1933,2.8635840640213077
STAT,1819,40,15-19,1859,0.031653432463632045
STAT,1817,45,50-100,1862,0.545209329846113
STAT,1839,51,30-34,1890,0.004240388137127685
SIM,1917,15,30-34,1932,5
SIM,1942,22,15-19,1964,6
SIM,1821,34,35-39,1855,11
SIM,1842,79,na,1921,353
SIM,1852,42,50-100,1894,3
STAT,1808,53,45-49,1861,0.04812845572525896
STAT,1817,44,20-24,1861,0.35653544766385753
SIM,1826,47,na,1873,1793
STAT,1919,37,35-39,1956,2.623630197574281
STAT,1823,51,45-49,1874,0.019612622921948496
STAT,1920,47,35-39,1967,0.14392198876937654
STAT,1814,43,40-44,1857,5.991225483344453
STAT,1852,41,20-24,1893,0.1209874983153295
STAT,1900,38,na,1938,3315.0203107812576
STAT,1920,24,50-100,1944,0.7340772063910642
SIM,1887,41,25-29,1928,3
STAT,1899,49,25-29,1948,0.04409737904845515
SIM,1805,84,na,1889,102
SIM,1810,69,na,1879,873
SIM,1855,12,na,1867,2487
SIM,1867,17,30-34,1884,2
SIM,1905,19,na,1924,3759
STAT,1927,19,40-44,1946,1.7483946783219826
STAT,1837,52,35-39,1889,0.005894558830959159
STAT,1797,72,na,1869,563.2624266080684
STAT,1912,28,45-49,1940,1.7115905135883906
SIM,1864,41,30-34,1905,1
SIM,1850,42,40-44,1892,4
SIM,1930,18,na,1948,5084
STAT,1917,15,15-19,1932,9.903613933848828
STAT,1914,42,40-44,1956,0.2500618891827469
SIM,1926,7,na,1933,4919
STAT,1836,47,35-39,1883,0.09242689171827946
STAT,1875,44,45-49,1919,1.5313876696957076
STAT,1933,17,15-19,1950,61.39090664097976
STAT,1934,22,15-19,1956,7.228333771275982
SIM,1901,28,35-39,1929,14
SIM,1931,35,45-49,1966,4
STAT,1881,34,40-44,1915,4.1859296398441685
STAT,1861,31,45-49,1892,1.469536306826038
SIM,1941,17,15-19,1958,41
STAT,1841,64,na,1905,1299.9697027465804
STAT,1897,39,na,1936,3182.943497259615
STAT,1859,17,30-34,1876,1.5029414169559752
STAT,1880,25,35-39,1905,10.304155384517863
SIM,1919,17,40-44,1936,4
SIM,1870,34,30-34,1904,29
SIM,1963,6,na,1969,5080
STAT,1870,48,25-29,1918,0.05640919949584355
STAT,1880,66,na,1946,1738.5152657339277
STAT,1885,43,25-29,1928,0.6409211316332597
STAT,1866,30,50-100,1896,0.8637905907651924
STAT,1844,18,50-100,1862,0.04898242549585762
SIM,1822,32,na,1854,1777
SIM,1858,39,25-29,1897,1
STAT,1811,66,na,1877,830.2716220425236
STAT,1869,46,35-39,1915,0.1378645035068391
STAT,1872,78,na,1950,793.3815480812441
SIM,1882,40,45-49,1922,3
SIM,1883,44,45-49,1927,2
STAT,1890,42,45-49,1932,1.844820606400178
STAT,1906,36,20-24,1942,0.24594167008582093
SIM,1817,53,50-100,1870,2
STAT,1825,50,40-44,1875,0.014175046733831177
STAT,1764,92,na,1856,5.621465285999999
STAT,1912,34,30-34,1946,15.506965084552043
STAT,1834,51,20-24,1885,4.5961971068008973E-4
STAT,1940,28,20-24,1968,18.782848474552342
STAT,1907,40,35-39,1947,0.18839285872457343
STAT,1842,42,40-44,1884,2.0951868719304585
SIM,1935,33,na,1968,5144
STAT,1847,79,na,1926,523.4459881224401
STAT,1858,21,45-49,1879,0.6385560318843435
SIM,1925,15,15-19,1940,51
SIM,1927,37,35-39,1964,8
STAT,1935,32,50-100,1967,1.1556838927872441
SIM,1903,36,45-49,1939,4
STAT,1820,54,20-24,1874,0.001157325031926773
STAT,1952,17,25-29,1969,52.468810995010095
STAT,1874,40,45-49,1914,1.5634276539894265
STAT,1893,14,na,1907,3301.194882965019
STAT,1818,52,25-29,1870,0.00605792727594725
STAT,1831,64,na,1895,1092.3853080205954
STAT,1862,30,15-19,1892,0.12520928903555173
STAT,1892,51,na,1943,2742.011719066781
STAT,1924,40,na,1964,4476.404047299139
STAT,1864,43,30-34,1907,1.0402238611426704
SIM,1869,26,30-34,1895,33
STAT,1789,68,na,1857,864.6620535845683
STAT,1843,37,25-29,1880,2.2670263570306832
STAT,1894,15,50-100,1909,0.06400185936974508
STAT,1847,20,30-34,1867,16.58684540361914
SIM,1890,31,30-34,1921,38
STAT,1922,1,na,1923,4882.483840287552
SIM,1840,40,30-34,1880,4
SIM,1848,30,40-44,1878,3
SIM,1847,24,na,1871,1898
STAT,1942,24,15-19,1966,5.6314055418778795
SIM,1839,19,20-24,1858,18
SIM,1845,28,35-39,1873,15
SIM,1827,37,30-34,1864,9
STAT,1840,33,40-44,1873,3.6644316043232257
STAT,1928,24,50-100,1952,0.8251839559332959
STAT,1850,34,50-100,1884,0.7188403887913346
STAT,1831,50,40-44,1881,0.007197691233260098
SIM,1823,40,30-34,1863,6
SIM,1916,35,50-100,1951,1
STAT,1842,27,na,1869,2408.582157137898
STAT,1911,60,na,1971,3267.506387208457
STAT,1888,46,45-49,1934,0.2821371287618064
STAT,1911,44,40-44,1955,0.23789116865690302
SIM,1902,6,na,1908,3959
STAT,1845,30,15-19,1875,0.12631846580230707
SIM,1851,37,25-29,1888,7
SIM,1864,64,na,1928,1919
SIM,1920,34,30-34,1954,29
STAT,1945,27,35-39,1972,16.6343805242257
SIM,1902,47,50-100,1949,1
SIM,1944,15,25-29,1959,68
STAT,1806,50,30-34,1856,0.017879032240384552
STAT,1880,82,na,1962,722.6711991058991
STAT,1842,53,20-24,1895,6.537072133738053E-4
STAT,1876,6,na,1882,2830.988873563372
SIM,1872,43,30-34,1915,7
STAT,1849,54,45-49,1903,0.01103454964047498
SIM,1830,41,35-39,1871,1
SIM,1894,28,30-34,1922,49
SIM,1888,9,na,1897,3207
STAT,1863,26,na,1889,2151.1202702470596
STAT,1851,79,na,1930,529.3539626166785
STAT,1912,55,na,1967,3450.2990579327084
STAT,1898,43,35-39,1941,0.1709296378443966
SIM,1908,37,25-29,1945,1
STAT,1859,53,25-29,1912,0.002831104891111831
STAT,1877,17,50-100,1894,0.0510702767925681
STAT,1819,37,30-34,1856,15.464717615914891
STAT,1907,27,15-19,1934,0.6729442496773389
STAT,1867,52,20-24,1919,6.981883903082911E-4
SIM,1933,36,30-34,1969,1
STAT,1779,75,na,1854,454.00000000000006
STAT,1856,32,40-44,1888,3.399234772175417
STAT,1832,49,na,1881,1597.4340487043544
STAT,1860,46,15-19,1906,3.3118798706913074E-4
STAT,1860,33,50-100,1893,0.7532843301532605
STAT,1886,28,30-34,1914,26.759276223805617
STAT,1893,18,20-24,1911,22.676236206719288
SIM,1815,84,na,1899,142
SIM,1967,1,na,1968,5083
SIM,1816,47,na,1863,1315
STAT,1925,36,30-34,1961,2.212721373412416
STAT,1841,17,45-49,1858,0.06300253520646601
STAT,1903,41,na,1944,3351.093917504153
STAT,1910,38,na,1948,3612.2025559476797
SIM,1855,20,30-34,1875,19
SIM,1909,29,40-44,1938,9
STAT,1822,41,35-39,1863,2.9527568594808913
STAT,1851,36,20-24,1887,0.5960854369682498
STAT,1939,30,50-100,1969,0.852597286508085
STAT,1896,46,50-100,1942,0.18574139131812406
STAT,1857,53,40-44,1910,0.008165120952951417
SIM,1765,92,na,1857,4
SIM,1834,27,20-24,1861,18
STAT,1878,29,35-39,1907,10.044160802275336
STAT,1914,19,na,1933,4009.3849653369875
STAT,1860,46,na,1906,1862.8021611612917
STAT,1823,35,na,1858,1616.289766401136
SIM,1913,44,40-44,1957,1
STAT,1778,90,na,1868,31.761473654479875
SIM,1796,75,na,1871,437
SIM,1940,29,25-29,1969,73
SIM,1828,32,na,1860,1792
SIM,1876,40,45-49,1916,3
SIM,1840,34,45-49,1874,1
STAT,1941,29,50-100,1970,1.038507840385206
STAT,1884,29,50-100,1913,0.6325767318811159
SIM,1920,21,25-29,1941,126
SIM,1831,36,na,1867,1758
STAT,1817,47,25-29,1864,0.12385857399319854
STAT,1932,29,25-29,1961,87.03662198754621
SIM,1876,38,50-100,1914,2
STAT,1779,107,na,1886,0.009558628836281816
STAT,1947,9,na,1956,4471.318152393929
SIM,1895,41,na,1936,3171
STAT,1873,41,30-34,1914,1.182482658858122
STAT,1900,15,20-24,1915,24.988892412166074
STAT,1901,42,30-34,1943,0.11289626756690696
STAT,1899,22,45-49,1921,0.9665935938188062
STAT,1931,37,na,1968,5035.604206656384
SIM,1891,43,40-44,1934,6
SIM,1838,38,45-49,1876,2
SIM,1870,41,30-34,1911,4
STAT,1896,45,40-44,1941,0.13039504429319018
STAT,1921,26,45-49,1947,1.9513160917991226
SIM,1819,38,35-39,1857,14
STAT,1832,34,45-49,1866,1.519077314609443
STAT,1893,42,20-24,1935,0.2034176700784525
STAT,1905,44,40-44,1949,0.22498044277818433
STAT,1920,42,40-44,1962,0.278963499862331
STAT,1844,34,na,1878,2008.345651969333
STAT,1877,45,30-34,1922,0.10191257263247679
SIM,1886,29,35-39,1915,13
STAT,1832,40,30-34,1872,0.9856803350504647
SIM,1816,69,na,1885,754
SIM,1939,19,25-29,1958,65
STAT,1781,94,na,1875,2.388995925878655
STAT,1853,51,30-34,1904,0.004946171590114361
STAT,1888,21,30-34,1909,21.298338799413067
SIM,1872,30,25-29,1902,7
SIM,1934,27,25-29,1961,97
STAT,1878,41,na,1919,2434.1949004431012
SIM,1910,9,na,1919,3775
STAT,1863,64,na,1927,1555.6391557894988
STAT,1851,40,40-44,1891,1.7203093485437504
STAT,1846,41,20-24,1887,0.12355266959655654
STAT,1863,6,na,1869,2547.533287304449
STAT,1829,67,na,1896,934.7045340000833
STAT,1912,45,na,1957,3578.856426378157
SIM,1896,26,na,1922,3129
STAT,1901,4,na,1905,3724.6788127658137
STAT,1853,110,na,1963,9.97590365442559E-4
SIM,1874,20,40-44,1894,2
STAT,1904,26,na,1930,3470.942283028082
SIM,1903,21,25-29,1924,91
STAT,1911,49,35-39,1960,0.12242001543867491
STAT,1815,40,30-34,1855,3.194188445232233
STAT,1871,20,15-19,1891,3.330071832284684
STAT,1845,27,30-34,1872,22.39615934274693
STAT,1869,26,na,1895,2351.5089164908654
STAT,1897,29,45-49,1926,1.4926705205708597
STAT,1909,41,na,1950,3525.5788680941723
STAT,1862,37,35-39,1899,6.169145707170904
STAT,1868,40,45-49,1908,1.4592705788159535
SIM,1918,25,25-29,1943,73
STAT,1878,53,35-39,1931,0.00888128372010663
STAT,1931,21,35-39,1952,12.379550346883319
SIM,1853,27,30-34,1880,40
STAT,1882,31,30-34,1913,17.151478548078547
STAT,1884,63,na,1947,1777.1581135582571
SIM,1780,91,na,1871,2
STAT,1833,52,40-44,1885,0.007704474643643786
STAT,1836,53,20-24,1889,4.617755065623315E-4
STAT,1829,50,35-39,1879,0.006457033726563607
STAT,1852,27,na,1879,1910.8824142264255
STAT,1864,30,25-29,1894,9.410014104702386
SIM,1832,40,30-34,1872,4
SIM,1877,22,na,1899,2478
STAT,1870,32,25-29,1902,10.158494542815294
STAT,1885,81,na,1966,853.4077479397953
STAT,1862,34,30-34,1896,15.098337778962229
STAT,1898,45,50-100,1943,0.19157972652481517
SIM,1842,40,40-44,1882,7
SIM,1896,21,30-34,1917,35
STAT,1941,19,15-19,1960,47.16243486599022
SIM,1892,38,25-29,1930,8
STAT,1903,38,45-49,1941,0.6158457348117565
SIM,1794,68,na,1862,715
STAT,1862,53,na,1915,1847.8826851230751
STAT,1929,18,na,1947,4735.4365139126185
STAT,1834,43,50-100,1877,0.7488306784047246
STAT,1906,39,25-29,1945,0.9050152170808621
STAT,1872,54,45-49,1926,0.014330972320717802
STAT,1846,15,30-34,1861,1.5375145318758474
STAT,1876,42,45-49,1918,1.558839095039877
STAT,1851,43,45-49,1894,1.1250514182268088
SIM,1855,49,na,1904,1883
SIM,1847,25,40-44,1872,1
STAT,1831,30,20-24,1861,2.2911328143681775
STAT,1909,27,25-29,1936,63.47629089771848
STAT,1867,19,30-34,1886,1.531728681273483
STAT,1897,33,40-44,1930,5.847388588727595
STAT,1809,51,45-49,1860,0.047598260517127046
SIM,1898,11,na,1909,3515
SIM,1917,27,25-29,1944,70
STAT,1859,29,25-29,1888,34.45592016825926
SIM,1867,29,25-29,1896,51
STAT,1911,40,25-29,1951,0.0695407156719777
SIM,1871,42,35-39,1913,8
SIM,1917,2,na,1919,4314
STAT,1862,46,25-29,1908,0.050382529395505915
STAT,1819,83,na,1902,201.813467874183
SIM,1844,27,50-100,1871,1
SIM,1914,56,na,1970,3672
SIM,1884,42,45-49,1926,1
SIM,1886,7,na,1893,2930
SIM,1829,30,30-34,1859,8
STAT,1864,12,na,1876,2473.308625296971
STAT,1863,18,35-39,1881,0.5068845059349683
STAT,1824,40,30-34,1864,1.4886716311218067
STAT,1834,40,40-44,1874,1.6567956283203138
STAT,1823,49,15-19,1872,5.350984307721316E-4
SIM,1872,34,40-44,1906,8
STAT,1884,38,25-29,1922,2.8534423769311794
STAT,1852,33,50-100,1885,0.7120262728981996
SIM,1868,45,na,1913,2099
SIM,1971,0,na,1971,5116
SIM,1838,42,40-44,1880,4
STAT,1913,16,35-39,1929,0.8677541415139629
STAT,1910,9,na,1919,3966.6417526990454
STAT,1948,21,na,1969,4237.069287915535
STAT,1850,68,na,1918,1170.1619743443737
STAT,1919,34,40-44,1953,4.226389406228716
STAT,1936,36,na,1972,3732.1736790914724
SIM,1849,8,na,1857,2493
STAT,1896,41,35-39,1937,0.16887400042237644
STAT,1873,96,na,1969,43.63537577292262
STAT,1910,28,35-39,1938,14.57551038317369
SIM,1878,77,na,1955,930
STAT,1846,104,na,1950,0.05061765281780957
STAT,1899,46,20-24,1945,0.00940950107063922
SIM,1864,28,45-49,1892,1
STAT,1857,16,45-49,1873,0.060877173519050844
STAT,1909,18,35-39,1927,0.8281907306685552
STAT,1854,35,35-39,1889,5.38935286959394
SIM,1910,31,na,1941,3513
SIM,1911,38,45-49,1949,1
STAT,1847,45,45-49,1892,0.1784635811446807
STAT,1856,28,45-49,1884,0.8845105253190785
SIM,1912,26,45-49,1938,4
STAT,1891,31,30-34,1922,21.922219254451228
STAT,1816,41,35-39,1857,5.397011255045584
STAT,1836,27,50-100,1863,0.522174393168775
STAT,1855,44,40-44,1899,1.6702234496704769
SIM,1876,11,na,1887,3031
STAT,1807,98,na,1905,1.1507312181458496
STAT,1825,53,45-49,1878,0.018409534966799236
STAT,1843,51,20-24,1894,5.000841769460802E-4
SIM,1860,33,50-100,1893,1
SIM,1864,32,40-44,1896,6
STAT,1904,26,45-49,1930,1.6148168975283417
STAT,1928,17,40-44,1945,1.7813879264184227
SIM,1801,55,na,1856,945
STAT,1890,44,na,1934,2813.9389727823614
STAT,1883,32,35-39,1915,10.009301743086615
STAT,1810,87,na,1897,91.50127950340118
SIM,1879,88,na,1967,260
STAT,1803,54,20-24,1857,0.0030702093179404283
STAT,1887,42,20-24,1929,0.17886438900546153
STAT,1891,24,50-100,1915,0.5067407434555916
SIM,1929,30,35-39,1959,14
STAT,1839,45,na,1884,1667.3569428528497
STAT,1865,41,30-34,1906,1.0650859827413994
STAT,1836,44,30-34,1880,0.8409627700139422
STAT,1875,41,40-44,1916,2.3435444521358115
SIM,1858,30,na,1888,1975
STAT,1814,46,45-49,1860,0.5788575750576234
STAT,1916,34,15-19,1950,0.13274168797800978
STAT,1842,31,35-39,1873,11.129434103227968
SIM,1839,26,45-49,1865,1
STAT,1852,17,20-24,1869,16.261430139739666
STAT,1885,40,20-24,1925,0.16127176658338166
STAT,1863,42,35-39,1905,1.6184836477772577
STAT,1870,82,na,1952,462.7509685156958
SIM,1905,25,50-100,1930,2
STAT,1861,53,30-34,1914,0.004915642603261447
STAT,1870,45,20-24,1915,0.01202011180246362
SIM,1911,42,40-44,1953,1
SIM,1873,41,30-34,1914,4
STAT,1842,49,25-29,1891,0.05077649831122176
STAT,1925,45,20-24,1970,0.01359714484721478
STAT,1924,40,35-39,1964,0.2427075796612385
SIM,1883,41,40-44,1924,3
STAT,1903,47,35-39,1950,0.11306430135890322
SIM,1861,34,na,1895,2051
SIM,1888,26,40-44,1914,11
SIM,1901,21,15-19,1922,10
STAT,1892,37,20-24,1929,0.9769578369588444
STAT,1933,22,na,1955,4894.861725854781
STAT,1855,51,40-44,1906,0.00796229636388939
STAT,1936,15,25-29,1951,42.08054686260845
STAT,1805,54,na,1859,1322.1560392169436
SIM,1877,28,30-34,1905,44
STAT,1808,50,40-44,1858,0.03713770473286017
SIM,1875,63,na,1938,1780
SIM,1854,15,30-34,1869,2
SIM,1954,1,na,1955,4845
SIM,1901,25,30-34,1926,41
SIM,1846,61,na,1907,1327
STAT,1871,17,30-34,1888,1.6096562300165105
STAT,1959,1,na,1960,5202.190819091291
STAT,1835,20,na,1855,2075.6955828662553
STAT,1945,24,40-44,1969,3.719043284671205
STAT,1812,53,35-39,1865,0.01862816857486633
SIM,1850,31,35-39,1881,15
STAT,1923,32,40-44,1955,4.532855246753911
SIM,1885,63,na,1948,1831
STAT,1847,20,50-100,1867,0.379735512877943
STAT,1860,41,20-24,1901,0.1317135448648085
STAT,1814,52,30-34,1866,0.013709481181968571
STAT,1858,48,25-29,1906,0.045067980169048415
STAT,1881,37,45-49,1918,1.9407897959482028
STAT,1898,17,45-49,1915,0.0894401465178498
STAT,1832,87,na,1919,119.96575661696725
STAT,1837,28,35-39,1865,8.388156073641474
SIM,1849,21,35-39,1870,6
STAT,1914,45,45-49,1959,0.218499518451836
SIM,1842,43,50-100,1885,2
STAT,1842,42,15-19,1884,0.012863772940894237
STAT,1840,36,45-49,1876,1.6700452029838415
STAT,1909,17,30-34,1926,2.4120164107034605
SIM,1890,42,45-49,1932,6
SIM,1840,43,35-39,1883,1
STAT,1828,45,35-39,1873,0.1309777574151365
STAT,1804,91,na,1895,17.96496164285427
SIM,1831,33,40-44,1864,5
SIM,1871,12,na,1883,2569
STAT,1824,46,na,1870,1306.52946093837
SIM,1904,56,na,1960,3247
STAT,1817,98,na,1915,1.486280142048043
STAT,1927,32,25-29,1959,11.491700380490425
SIM,1873,47,50-100,1920,2
STAT,1898,40,30-34,1938,0.11041421075473502
STAT,1908,55,na,1963,3248.6359776260747
SIM,1895,16,30-34,1911,2
STAT,1822,87,na,1909,98.50683239052712
STAT,1847,64,na,1911,1301.5733119391
SIM,1868,31,20-24,1899,1
STAT,1848,50,45-49,1898,0.012019055036057423
STAT,1849,51,40-44,1900,0.008270455781037305
STAT,1875,11,na,1886,2713.8274942005273
STAT,1911,46,30-34,1957,0.08535544030493922
SIM,1865,42,35-39,1907,6
SIM,1860,17,20-24,1877,22
STAT,1907,48,30-34,1955,0.07997144838150343
STAT,1889,62,na,1951,2276.2457479100995
STAT,1890,59,na,1949,2398.547324268092
SIM,1870,37,35-39,1907,13
STAT,1825,46,20-24,1871,0.01633788796883671
STAT,1838,97,na,1935,3.5963212279025925
STAT,1865,15,40-44,1880,0.19328693477790854
STAT,1865,47,50-100,1912,0.22545009089934018
STAT,1850,30,30-34,1880,15.691150601085601
SIM,1850,13,na,1863,2278
STAT,1925,39,35-39,1964,2.9276006346285945
SIM,1915,19,na,1934,4388
STAT,1901,23,15-19,1924,4.656514484795275
STAT,1791,72,na,1863,493.87887687448574
STAT,1853,54,35-39,1907,0.0069237086254984904
STAT,1882,42,45-49,1924,1.4624315641836056
SIM,1936,18,na,1954,3635
STAT,1773,91,na,1864,18.325720477941925
STAT,1880,51,25-29,1931,0.0037750263086343853
STAT,1837,86,na,1923,151.3594014518486
STAT,1931,30,25-29,1961,12.253694455497216
STAT,1839,33,50-100,1872,0.791141640480637
STAT,1912,25,40-44,1937,4.665570519488677
STAT,1944,19,40-44,1963,1.5189717977979054
SIM,1916,41,na,1957,3798
STAT,1860,50,45-49,1910,0.012154018442490474
STAT,1918,49,45-49,1967,0.23212751092567374
STAT,1932,26,20-24,1958,24.17265470182345
SIM,1902,16,25-29,1918,13
STAT,1822,72,na,1894,706.1143338724061
STAT,1875,21,45-49,1896,0.7254577567029095
STAT,1905,40,25-29,1945,0.06576663224332505
STAT,1835,52,25-29,1887,0.0027103159067232594
SIM,1852,79,na,1931,399
SIM,1917,18,35-39,1935,8
STAT,1879,41,25-29,1920,0.6798959105525422
SIM,1862,35,35-39,1897,8
STAT,1918,33,na,1951,4040.300529942803
SIM,1830,73,na,1903,549
SIM,1858,15,15-19,1873,8
STAT,1868,63,na,1931,1722.3726042925541
SIM,1935,32,25-29,1967,20
STAT,1854,12,na,1866,2143.1685601929557
STAT,1877,48,35-39,1925,0.1441055329105665
STAT,1877,77,na,1954,901.0625300122888
STAT,1832,43,35-39,1875,1.4935586611023435
STAT,1837,34,50-100,1871,0.7676067648689887
STAT,1887,16,30-34,1903,1.8017346702430146
STAT,1847,51,30-34,1898,0.0044782187624678735
STAT,1877,54,20-24,1931,7.480712123431852E-4
STAT,1831,53,45-49,1884,0.00934967500678125
SIM,1940,26,20-24,1966,25
SIM,1885,41,na,1926,2494
SIM,1845,34,50-100,1879,1
SIM,1920,25,40-44,1945,11
STAT,1892,44,45-49,1936,0.1299404690084045
STAT,1794,90,na,1884,31.72488205100435
SIM,1843,41,45-49,1884,3
STAT,1802,99,na,1901,0.6616854812584573
STAT,1896,48,45-49,1944,0.17573956279056127
SIM,1836,23,15-19,1859,3
STAT,1921,37,na,1958,4242.719864721608
STAT,1873,44,35-39,1917,1.8290825600276281
SIM,1894,77,na,1971,1730
STAT,1901,45,35-39,1946,0.11292733492868304
STAT,1876,92,na,1968,149.22642182255382
STAT,1815,51,45-49,1866,0.031384746462481315
STAT,1838,40,25-29,1878,0.51577864565276
STAT,1854,34,na,1888,1796.2895605268534
SIM,1859,50,50-100,1909,1
STAT,1897,49,15-19,1946,2.991414790354926E-4
STAT,1881,30,35-39,1911,9.938612599149721
SIM,1841,36,50-100,1877,1
SIM,1910,37,40-44,1947,4
STAT,1867,28,20-24,1895,11.119933234954129
SIM,1909,25,25-29,1934,108
SIM,1891,32,35-39,1923,19
SIM,1806,69,na,1875,878
STAT,1922,47,45-49,1969,0.25223556162699334
SIM,1879,4,na,1883,3123
STAT,1840,42,30-34,1882,0.8406745732005675
STAT,1841,21,40-44,1862,1.9883353104894803
STAT,1913,16,50-100,1929,0.07747803399462308
SIM,1824,41,35-39,1865,4
STAT,1933,38,30-34,1971,2.5060397989089327
SIM,1884,0,na,1884,3454
SIM,1919,26,50-100,1945,1
SIM,1921,16,35-39,1937,6
STAT,1882,22,40-44,1904,2.0386893059899434
STAT,1856,52,45-49,1908,0.01117780982083403
SIM,1927,34,40-44,1961,11
STAT,1951,3,na,1954,4754.71389806432
STAT,1856,78,na,1934,605.0220567335238
STAT,1879,48,50-100,1927,0.25560974160212213
STAT,1878,50,30-34,1928,0.006330664414033117
SIM,1873,78,na,1951,749
STAT,1914,38,20-24,1952,0.26423576484565037
STAT,1855,24,50-100,1879,0.3534655412610728
STAT,1835,41,45-49,1876,1.3638307978099184
SIM,1917,17,30-34,1934,4
STAT,1821,42,20-24,1863,0.2532147675490375
SIM,1881,44,35-39,1925,1
STAT,1919,18,na,1937,4096.143034362686
SIM,1891,59,na,1950,2410
STAT,1835,79,na,1914,524.7119014139801
SIM,1854,86,na,1940,164
STAT,1859,50,20-24,1909,6.080523477805533E-4
STAT,1844,18,25-29,1862,5.665635025839357
STAT,1806,53,35-39,1859,0.024348596263063276
STAT,1895,36,35-39,1931,9.37382498979959
STAT,1883,43,15-19,1926,0.013550640647601184
STAT,1843,34,20-24,1877,2.1466999729430163
STAT,1866,47,20-24,1913,0.011170470061625018
STAT,1836,31,na,1867,1745.2527846727075
STAT,1849,51,50-100,1900,0.01186462580805687
SIM,1879,43,40-44,1922,7
STAT,1821,36,35-39,1857,14.716626297938564
STAT,1820,52,30-34,1872,0.00971590291870394
STAT,1920,45,45-49,1965,0.24375321879222056
SIM,1800,70,na,1870,596
SIM,1861,40,50-100,1901,1
STAT,1859,96,na,1955,6.975247388069922
STAT,1833,36,50-100,1869,1.1013597118294494
STAT,1902,37,40-44,1939,1.3485402753328495
STAT,1839,25,40-44,1864,2.7143153890999288
STAT,1915,29,15-19,1944,0.721383007112143
STAT,1868,41,na,1909,2241.113477099477
SIM,1852,18,25-29,1870,8
SIM,1886,26,na,1912,2690
STAT,1872,31,20-24,1903,2.7559590594729437
STAT,1881,38,50-100,1919,1.1893593165834755
STAT,1908,32,15-19,1940,0.12244551048823601
STAT,1863,16,50-100,1879,0.050324635527261234
SIM,1939,20,50-100,1959,1
SIM,1838,39,45-49,1877,4
SIM,1858,24,na,1882,1910
STAT,1859,37,15-19,1896,0.045616348266240045
STAT,1879,39,40-44,1918,4.567450466575727
STAT,1856,36,35-39,1892,5.503250846990248
STAT,1906,5,na,1911,3855.230441879054
STAT,1824,30,30-34,1854,47.83267913845716
SIM,1855,36,40-44,1891,5
SIM,1935,15,25-29,1950,72
STAT,1788,101,na,1889,0.13124603239332097
SIM,1937,21,40-44,1958,5
STAT,1886,16,25-29,1902,6.057801160597764
STAT,1829,98,na,1927,1.915463045258347
SIM,1890,23,30-34,1913,32
STAT,1874,22,50-100,1896,0.4217325966878016
STAT,1892,39,na,1931,2955.8645107154803
STAT,1834,43,20-24,1877,0.11256931981455473
SIM,1844,22,20-24,1866,72
STAT,1845,13,na,1858,2194.660309866711
STAT,1915,37,na,1952,3834.9992560920364
STAT,1945,17,40-44,1962,1.5430473533370592
SIM,1894,62,na,1956,2584
SIM,1823,32,30-34,1855,12
SIM,1924,9,na,1933,4815
STAT,1820,41,25-29,1861,1.2543370754132384
STAT,1890,27,50-100,1917,0.7894832884053077
SIM,1919,32,30-34,1951,8
SIM,1888,42,30-34,1930,3
STAT,1945,18,50-100,1963,0.4131838936804127
STAT,1873,32,na,1905,2443.366721201043
STAT,1833,41,35-39,1874,1.57818793950362
STAT,1877,46,na,1923,2351.9451907869075
STAT,1770,89,na,1859,18.40024355385181
STAT,1899,61,na,1960,2705.2469144854567
SIM,1800,85,na,1885,148
SIM,1827,32,na,1859,1648
STAT,1817,46,25-29,1863,0.1258459885441149
STAT,1788,99,na,1887,0.34211186916197145
STAT,1891,21,30-34,1912,22.34111834711964
STAT,1790,93,na,1883,6.084043255667358
STAT,1887,45,25-29,1932,0.06559995363983591
SIM,1846,39,na,1885,1717
STAT,1927,22,na,1949,4547.555824388611
SIM,1835,51,na,1886,1310
SIM,1887,39,40-44,1926,12
STAT,1854,20,15-19,1874,2.9512924103711042
STAT,1929,21,40-44,1950,4.310631670835184
STAT,1836,22,20-24,1858,57.373620877101196
SIM,1900,21,45-49,1921,1
SIM,1903,22,25-29,1925,87
STAT,1820,54,30-34,1874,0.00933575491203226
SIM,1864,42,45-49,1906,4
STAT,1865,34,35-39,1899,9.259784226858045
STAT,1780,108,na,1888,0.004536350235589157
STAT,1910,40,20-24,1950,0.01703005035192019
STAT,1852,18,20-24,1870,16.165650316216603
SIM,1825,39,35-39,1864,16
STAT,1879,31,30-34,1910,18.477743461816132
STAT,1881,51,na,1932,2106.279446276845
STAT,1889,31,na,1920,2984.042982017542
SIM,1860,18,20-24,1878,29
STAT,1882,23,30-34,1905,17.37275565057046
STAT,1902,49,35-39,1951,0.11035973127836142
STAT,1807,49,50-100,1856,0.8480058869840662
SIM,1872,32,25-29,1904,16
SIM,1935,33,25-29,1968,18
STAT,1882,41,30-34,1923,1.1298644590974785
STAT,1843,41,20-24,1884,0.11170830201158394
SIM,1812,70,na,1882,621
STAT,1847,43,30-34,1890,0.8545809549576446
STAT,1850,20,30-34,1870,16.608011970170434
SIM,1945,16,na,1961,3894
SIM,1823,66,na,1889,949
SIM,1870,48,na,1918,2459
SIM,1949,15,25-29,1964,85
STAT,1832,50,na,1882,1577.7335938416197
STAT,1840,40,40-44,1880,1.8543204473216537
STAT,1887,76,na,1963,1330.235659845004
STAT,1901,42,20-24,1943,0.015595280467502835
STAT,1958,14,na,1972,5209.336496120355
SIM,1824,34,50-100,1858,1
STAT,1879,57,na,1936,2118.1507174766775
STAT,1894,17,15-19,1911,7.716906261877267
STAT,1817,39,35-39,1856,20.64947319179346
STAT,1895,75,na,1970,1791.1500794314984
STAT,1888,37,40-44,1925,5.218472239627792
STAT,1891,81,na,1972,1164.0164529710617
STAT,1850,39,20-24,1889,0.5872728905876065
SIM,1841,41,35-39,1882,4
SIM,1861,0,na,1861,3410
SIM,1842,36,30-34,1878,2
SIM,1865,32,50-100,1897,4
SIM,1815,47,na,1862,1455
STAT,1826,44,25-29,1870,0.6436735570573963
STAT,1834,36,30-34,1870,3.9892605715230824
STAT,1917,19,30-34,1936,13.125505815074687
STAT,1933,30,45-49,1963,2.1453168088410006
STAT,1870,48,35-39,1918,0.1371056946026021
SIM,1855,43,30-34,1898,4
SIM,1916,19,na,1935,3908
STAT,1847,52,45-49,1899,0.010808136560959766
SIM,1841,67,na,1908,1093
STAT,1927,15,25-29,1942,54.71410913285088
STAT,1890,18,40-44,1908,0.22514037271449236
STAT,1909,42,20-24,1951,0.016668678716778677
STAT,1841,18,45-49,1859,0.06263145027409994
SIM,1885,10,na,1895,2804
STAT,1847,36,40-44,1883,3.4361496378095877
STAT,1809,53,50-100,1862,0.047500865290152655
STAT,1944,25,25-29,1969,71.89884318000085
SIM,1872,20,30-34,1892,33
STAT,1876,53,25-29,1929,0.0036344558123014774
SIM,1808,65,na,1873,770
SIM,1894,37,50-100,1931,2
STAT,1862,84,na,1946,290.155590359523
SIM,1890,41,30-34,1931,2
STAT,1862,53,25-29,1915,0.0030398116737408486
SIM,1920,24,na,1944,4333
STAT,1897,37,35-39,1934,9.577151562601223
SIM,1891,26,na,1917,3025
STAT,1952,3,na,1955,4762.82966402349
SIM,1882,45,na,1927,2062
STAT,1820,53,na,1873,1191.0348730912053
STAT,1950,22,45-49,1972,1.3485815422817096
STAT,1882,50,45-49,1932,0.014402218849544714
SIM,1834,44,25-29,1878,1
STAT,1831,33,25-29,1864,8.377704107717822
SIM,1831,27,40-44,1858,2
SIM,1890,32,45-49,1922,2
SIM,1836,23,25-29,1859,64
SIM,1920,46,50-100,1966,5
SIM,1869,25,30-34,1894,46
STAT,1861,18,15-19,1879,5.691077605670284
STAT,1870,18,40-44,1888,0.1820505000636275
STAT,1871,39,40-44,1910,4.348283813261096
STAT,1866,39,30-34,1905,4.934229022296918
STAT,1919,27,40-44,1946,5.084955880948772
SIM,1837,62,na,1899,1114
STAT,1837,81,na,1918,368.89850203958775
SIM,1882,77,na,1959,787
STAT,1815,50,30-34,1865,0.013133725256990868
SIM,1840,14,na,1854,2184
STAT,1830,79,na,1909,461.2275723509841
SIM,1936,24,30-34,1960,35
SIM,1851,36,25-29,1887,5
SIM,1853,15,25-29,1868,5
SIM,1901,5,na,1906,3826
SIM,1845,48,50-100,1893,2
STAT,1828,30,15-19,1858,0.17984002828843626
STAT,1927,33,25-29,1960,11.484575526254524
SIM,1908,3,na,1911,3868
STAT,1854,47,40-44,1901,0.12788430371468612
SIM,1930,1,na,1931,5659
SIM,1941,30,45-49,1971,1
STAT,1843,36,25-29,1879,2.290689176221048
STAT,1860,33,20-24,1893,2.222299239072675
SIM,1823,41,45-49,1864,2
SIM,1889,34,45-49,1923,3
STAT,1935,1,na,1936,5767.958734650822
STAT,1874,45,15-19,1919,4.177996557872283E-4
STAT,1833,23,35-39,1856,5.530315545478701
STAT,1782,74,na,1856,443.4422255064
STAT,1890,28,na,1918,2934.9858546889827
STAT,1828,45,na,1873,1660.5261288067404
STAT,1845,15,25-29,1860,5.295554086545784
SIM,1874,39,30-34,1913,5
STAT,1861,47,na,1908,1879.4435262544976
SIM,1787,86,na,1873,46
SIM,1873,31,30-34,1904,24
STAT,1818,38,40-44,1856,10.068271932206875
STAT,1949,16,50-100,1965,0.4403314182883218
STAT,1814,50,40-44,1864,0.025239035792466245
STAT,1949,17,25-29,1966,50.91741679172165
STAT,1885,19,15-19,1904,5.934232118553831
STAT,1835,28,15-19,1863,0.4407910738987717
STAT,1933,28,30-34,1961,52.54828306677567
STAT,1843,29,35-39,1872,7.894524427928592
SIM,1889,29,50-100,1918,4
SIM,1941,28,30-34,1969,54
STAT,1864,20,30-34,1884,16.73438378376946
STAT,1860,29,35-39,1889,7.936560832375999
STAT,1920,21,20-24,1941,125.210053570198
STAT,1881,67,na,1948,1543.3133231845093
STAT,1848,65,na,1913,1379.7841717281801
SIM,1925,19,30-34,1944,21
STAT,1828,50,50-100,1878,0.013823479255500875
STAT,1858,44,20-24,1902,0.12414269414574257
STAT,1806,107,na,1913,0.0015900398769928025
STAT,1824,49,20-24,1873,0.013660283716232027
SIM,1806,54,na,1860,1268
STAT,1852,20,50-100,1872,0.3727254267724599
STAT,1872,34,25-29,1906,10.3115089724293
SIM,1880,34,25-29,1914,15
STAT,1828,105,na,1933,0.01903372360002704
STAT,1893,40,na,1933,2993.937864605165
STAT,1929,5,na,1934,5186.466205903165
STAT,1839,44,35-39,1883,1.3188573627001077
STAT,1894,25,50-100,1919,0.837457940786681
STAT,1867,29,20-24,1896,11.079456677978895
STAT,1875,44,20-24,1919,0.16250019364932755
SIM,1851,29,35-39,1880,8
STAT,1861,31,na,1892,2010.968059069004
SIM,1846,35,na,1881,1812
STAT,1918,40,20-24,1958,0.019009171815434243
STAT,1841,25,35-39,1866,9.092229995356169
STAT,1883,19,50-100,1902,0.04816249035283793
SIM,1914,24,na,1938,3808
STAT,1775,92,na,1867,7.888438326006008
STAT,1808,53,20-24,1861,0.0024472097060210577
SIM,1831,31,25-29,1862,9
SIM,1911,21,20-24,1932,148
SIM,1897,35,35-39,1932,15
STAT,1777,108,na,1885,0.0038275214758147023
SIM,1847,44,35-39,1891,5
STAT,1858,79,na,1937,553.9616211263823
STAT,1878,18,40-44,1896,0.19126315849680434
STAT,1931,40,50-100,1971,0.15905569347927362
STAT,1890,22,25-29,1912,70.65029148181603
STAT,1809,78,na,1887,372.9342110139073
SIM,1859,33,20-24,1892,2
STAT,1854,65,na,1919,1268.294159178343
STAT,1864,41,40-44,1905,2.0592367423313167
SIM,1883,8,na,1891,2939
SIM,1886,63,na,1949,2043
SIM,1861,16,15-19,1877,7
STAT,1861,42,25-29,1903,0.5382860952518664
SIM,1893,29,40-44,1922,6
STAT,1855,38,40-44,1893,3.2786942232442753
STAT,1833,44,15-19,1877,0.011581933592399054
STAT,1853,16,15-19,1869,5.938663562084904
STAT,1960,8,na,1968,5169.69331945194
STAT,1798,89,na,1887,45.69087050077409
SIM,1869,30,50-100,1899,1
STAT,1879,16,35-39,1895,0.5797597511023117
STAT,1935,17,25-29,1952,59.85405830053998
SIM,1887,31,30-34,1918,7
STAT,1867,45,25-29,1912,0.055336618933183465
STAT,1899,48,25-29,1947,0.04447183187282433
SIM,1856,29,na,1885,2185
STAT,1903,21,20-24,1924,99.42391108123452
SIM,1829,27,na,1856,1899
STAT,1889,35,35-39,1924,8.892231435318639
STAT,1856,84,na,1940,257.596498224291
STAT,1807,49,20-24,1856,0.04143351403381946
SIM,1894,30,na,1924,3420
SIM,1888,37,35-39,1925,22
SIM,1872,41,40-44,1913,4
STAT,1885,29,40-44,1914,2.9900292611423698
SIM,1862,20,15-19,1882,3
STAT,1856,51,30-34,1907,0.0046313883416098855
SIM,1854,26,50-100,1880,4
SIM,1932,32,45-49,1964,2
SIM,1855,71,na,1926,1158
STAT,1820,49,35-39,1869,0.2309858370083493
STAT,1879,41,na,1920,2447.0688312807065
STAT,1880,37,40-44,1917,4.643263184381278
STAT,1809,101,na,1910,0.2634848000536566
STAT,1833,39,20-24,1872,0.6702892734903313
STAT,1842,64,na,1906,1565.10446830343
STAT,1907,38,30-34,1945,1.6977572616673604
STAT,1823,31,25-29,1854,31.569615849689797
SIM,1846,38,40-44,1884,5
SIM,1860,34,na,1894,2070
SIM,1852,18,15-19,1870,6
SIM,1900,37,30-34,1937,5
SIM,1926,17,25-29,1943,92
SIM,1915,32,45-49,1947,2
STAT,1894,19,40-44,1913,0.2365598534819224
STAT,1844,28,40-44,1872,2.8805009479616572
STAT,1870,45,30-34,1915,0.09696223161802917
SIM,1814,89,na,1903,35
STAT,1827,28,40-44,1855,6.013509970685181
STAT,1848,34,35-39,1882,8.594185250038645
SIM,1835,28,40-44,1863,2
STAT,1813,46,40-44,1859,0.5074863347221001
STAT,1838,30,30-34,1868,14.828308938057774
STAT,1891,16,35-39,1907,0.6878340098635483
SIM,1862,51,50-100,1913,1
STAT,1831,92,na,1923,26.172512765855277
STAT,1769,92,na,1861,8.7172756430929
STAT,1803,54,30-34,1857,0.024766354248132387
STAT,1809,90,na,1899,36.40454291695013
STAT,1838,54,45-49,1892,0.009447838276924253
STAT,1890,31,40-44,1921,5.374078126419002
STAT,1838,38,40-44,1876,3.499469174993306
STAT,1951,7,na,1958,4729.003181946476
SIM,1878,44,na,1922,2665
SIM,1832,30,30-34,1862,24
STAT,1918,17,25-29,1935,9.5538192784158
SIM,1924,5,na,1929,4864
STAT,1924,32,45-49,1956,1.855145648557085
SIM,1799,71,na,1870,827
STAT,1924,38,30-34,1962,2.1695288608906207
STAT,1823,40,40-44,1863,3.5067246482412755
STAT,1894,0,na,1894,3818.2222009884467
SIM,1932,38,30-34,1970,7
STAT,1833,28,na,1861,2002.103548854416
STAT,1882,19,45-49,1901,0.06356538763936008
SIM,1893,19,15-19,1912,8
STAT,1907,32,45-49,1939,1.485160157948721
SIM,1953,5,na,1958,4923
STAT,1881,41,40-44,1922,2.1997256657116213
STAT,1920,34,50-100,1954,0.9066996670356565
SIM,1887,43,25-29,1930,7
STAT,1937,22,30-34,1959,28.255458879113302
SIM,1831,40,40-44,1871,10
SIM,1915,38,30-34,1953,3
STAT,1870,16,15-19,1886,5.977091080682203
SIM,1914,49,50-100,1963,1
STAT,1850,44,15-19,1894,0.01043164307717199
STAT,1866,31,50-100,1897,0.8604045316493931
SIM,1926,35,25-29,1961,2
STAT,1884,34,20-24,1918,2.6691831765415484
STAT,1929,24,45-49,1953,1.4291560049062886
STAT,1827,87,na,1914,104.76743815046412
STAT,1875,37,30-34,1912,5.527931271765941
STAT,1772,113,na,1885,3.533880804747183E-4
STAT,1830,46,40-44,1876,0.14506249369455437
SIM,1883,37,30-34,1920,10
STAT,1829,48,40-44,1877,0.12607692380432856
SIM,1856,34,35-39,1890,17
SIM,1846,30,30-34,1876,22
SIM,1902,31,20-24,1933,4
SIM,1945,22,30-34,1967,54
STAT,1879,43,25-29,1922,0.6719441063431655
SIM,1882,21,30-34,1903,16
STAT,1900,26,50-100,1926,0.9005755246584136
SIM,1837,22,30-34,1859,19
STAT,1817,44,50-100,1861,2.3717357588132013
STAT,1808,46,30-34,1854,0.36346208826055143
STAT,1902,62,na,1964,2812.356278873413
SIM,1820,40,50-100,1860,1
STAT,1817,43,20-24,1860,0.37199378709006614
SIM,1892,34,20-24,1926,3
STAT,1918,35,25-29,1953,1.0576829154353307
STAT,1873,26,40-44,1899,3.0777123197823477
SIM,1832,25,35-39,1857,6
STAT,1870,52,20-24,1922,7.279637055680779E-4
STAT,1834,45,na,1879,1456.9995106878994
STAT,1838,59,na,1897,1301.0063591441035
SIM,1823,35,35-39,1858,16
SIM,1891,39,30-34,1930,5
STAT,1935,35,25-29,1970,1.393432444021852
SIM,1866,6,na,1872,2850
SIM,1831,37,50-100,1868,1
SIM,1936,32,30-34,1968,25
SIM,1926,32,20-24,1958,6
STAT,1832,33,45-49,1865,1.5355305305757132
STAT,1942,20,45-49,1962,1.1919540445385317
SIM,1855,39,45-49,1894,6
SIM,1776,86,na,1862,21
STAT,1916,54,na,1970,3703.44683765326
SIM,1863,30,30-34,1893,25
STAT,1849,47,30-34,1896,0.07533052046984783
SIM,1918,15,25-29,1933,12
STAT,1841,30,30-34,1871,16.17401953960894
STAT,1856,33,30-34,1889,13.544024914521883
SIM,1867,39,40-44,1906,8
STAT,1902,46,30-34,1948,0.07815432043405715
SIM,1838,36,40-44,1874,7
STAT,1851,50,45-49,1901,0.011146533895686863
STAT,1928,32,30-34,1960,19.912130911032715
STAT,1918,32,20-24,1950,2.61675653909533
SIM,1864,33,30-34,1897,28
STAT,1910,43,25-29,1953,0.06768028511475865
STAT,1882,26,35-39,1908,9.472401274512738
STAT,1900,43,15-19,1943,0.0013357443741975632
STAT,1808,49,35-39,1857,0.48475534045775615
STAT,1839,36,35-39,1875,6.054949070521612
STAT,1953,19,40-44,1972,1.7083627804831396
STAT,1893,27,25-29,1920,54.24909668637084
SIM,1893,45,na,1938,2978
SIM,1859,9,na,1868,2643
STAT,1866,23,45-49,1889,0.652762058124043
SIM,1924,18,na,1942,4329
STAT,1846,30,na,1876,1984.4056583399854
SIM,1855,43,50-100,1898,1
STAT,1827,28,na,1855,1661.8180875271994
STAT,1883,39,30-34,1922,5.214585833653922
SIM,1843,86,na,1929,231
SIM,1871,37,40-44,1908,6
SIM,1807,48,na,1855,1225
SIM,1890,26,35-39,1916,20
STAT,1860,36,25-29,1896,2.388582966055671
SIM,1914,27,50-100,1941,1
STAT,1929,17,na,1946,4747.8759488987325
STAT,1933,22,45-49,1955,1.5081788076529943
STAT,1865,50,45-49,1915,0.013576496980245866
SIM,1927,34,30-34,1961,30
STAT,1834,46,25-29,1880,0.04049307174007513
STAT,1870,83,na,1953,393.72703405189463
SIM,1866,37,30-34,1903,10
SIM,1788,71,na,1859,492
STAT,1936,23,25-29,1959,89.12527393641975
STAT,1862,50,20-24,1912,6.528774793303286E-4
STAT,1871,61,na,1932,1875.034169636504
SIM,1888,5,na,1893,3225
STAT,1957,9,na,1966,5233.633742494631
STAT,1861,28,40-44,1889,2.5142003135697757
STAT,1871,47,40-44,1918,0.17098534813227098
SIM,1943,17,25-29,1960,67
SIM,1941,22,45-49,1963,1
STAT,1866,43,15-19,1909,0.01282210447521948
SIM,1919,35,35-39,1954,7
STAT,1861,47,30-34,1908,0.08086355958183662
STAT,1909,25,na,1934,3636.0481674831417
SIM,1834,36,25-29,1870,5
STAT,1815,53,35-39,1868,0.017886397973278047
STAT,1820,49,na,1869,1278.759793906594
STAT,1841,15,40-44,1856,0.17850372265984576
STAT,1862,49,40-44,1911,0.14620634213094788
STAT,1863,37,40-44,1900,3.9173824732700457
SIM,1950,20,45-49,1970,1
STAT,1844,18,15-19,1862,5.933405675724303
STAT,1847,39,45-49,1886,1.5168065493137208
STAT,1853,18,40-44,1871,0.1808800730310777
STAT,1927,29,40-44,1956,5.7043036553605
STAT,1855,30,30-34,1885,13.662372557458394
STAT,1844,19,50-100,1863,0.048693919009687024
STAT,1876,29,15-19,1905,0.4697588679168072
SIM,1810,45,50-100,1855,3
STAT,1895,36,50-100,1931,1.6271417473542489
STAT,1888,8,na,1896,3098.9494367658917
STAT,1846,94,na,1940,15.167132258184141
SIM,1812,54,na,1866,1191
STAT,1806,51,45-49,1857,0.04272411289145913
STAT,1843,50,na,1893,1473.1115877570069
STAT,1834,39,35-39,1873,5.131794061838781
STAT,1832,34,na,1866,1867.1994138974057
STAT,1888,45,45-49,1933,0.2841431796098519
SIM,1928,31,40-44,1959,5
STAT,1848,52,35-39,1900,0.006991520451667449
STAT,1892,3,na,1895,3350.4963289954067
SIM,1823,70,na,1893,853
SIM,1896,25,na,1921,3144
SIM,1866,59,na,1925,1964
STAT,1835,101,na,1936,0.42828027599934887
STAT,1816,48,30-34,1864,0.24660298521756957
STAT,1916,30,45-49,1946,1.652674679786167
STAT,1932,37,na,1969,5108.374761012122
STAT,1832,51,45-49,1883,0.010515668202577098
STAT,1886,39,na,1925,2487.1113966431094
STAT,1802,68,na,1870,724.5525123172941
STAT,1840,43,45-49,1883,1.0804600688351291
SIM,1868,14,na,1882,2484
STAT,1847,46,35-39,1893,0.1051207965730391
STAT,1858,39,20-24,1897,0.604662781673693
STAT,1826,36,25-29,1862,3.4181529581660706
STAT,1850,15,35-39,1865,0.5195236643705716
SIM,1946,22,45-49,1968,2
STAT,1838,42,25-29,1880,0.502730504759727
STAT,1857,49,30-34,1906,0.07470892259113003
SIM,1811,85,na,1896,125
STAT,1861,99,na,1960,3.418556289910477
STAT,1897,42,30-34,1939,0.10796862765415569
STAT,1919,34,30-34,1953,17.015538059663076
STAT,1851,102,na,1953,0.22198852310955364
STAT,1911,32,50-100,1943,0.8122509651712192
SIM,1911,24,25-29,1935,96
SIM,1800,69,na,1869,693
SIM,1824,51,na,1875,1332
SIM,1842,39,35-39,1881,17
SIM,1799,67,na,1866,892
STAT,1938,22,45-49,1960,1.124201973706909
STAT,1811,72,na,1883,591.7237730074822
SIM,1873,32,45-49,1905,3
SIM,1864,36,35-39,1900,13
SIM,1869,28,35-39,1897,12
SIM,1908,19,30-34,1927,2
SIM,1840,33,45-49,1873,2
STAT,1838,46,40-44,1884,0.11942624245575847
STAT,1873,42,45-49,1915,1.5305375352679178
STAT,1901,45,25-29,1946,0.04646153161609908
STAT,1903,24,25-29,1927,81.82736639060067
STAT,1824,108,na,1932,9.106428861269004E-4
SIM,1847,36,35-39,1883,8
SIM,1836,20,20-24,1856,87
SIM,1870,42,50-100,1912,1
SIM,1829,82,na,1911,258
SIM,1925,5,na,1930,4935
SIM,1834,29,35-39,1863,9
STAT,1895,48,40-44,1943,0.1257732328252647
STAT,1895,21,15-19,1916,4.3644287957027394
STAT,1897,27,40-44,1924,4.056169662882339
STAT,1812,47,35-39,1859,0.322917201497175
STAT,1936,30,15-19,1966,0.12615512944282775
SIM,1841,51,na,1892,1516
STAT,1846,44,25-29,1890,0.48074531627562217
STAT,1821,48,40-44,1869,0.24731784995593042
SIM,1872,83,na,1955,225
STAT,1889,32,30-34,1921,21.744230666603958
SIM,1806,70,na,1876,796
SIM,1847,52,na,1899,1569
SIM,1887,80,na,1967,849
SIM,1922,8,na,1930,5180
STAT,1875,47,25-29,1922,0.05946519837458026
STAT,1879,47,40-44,1926,0.1796035267345279
STAT,1910,32,20-24,1942,2.372825076684137
STAT,1848,17,50-100,1865,0.04958571680893527
STAT,1933,9,na,1942,5385.0070586469255
STAT,1829,82,na,1911,275.11469046048165
STAT,1874,42,35-39,1916,1.8704191338349865
STAT,1822,88,na,1910,76.75849393534658
STAT,1817,51,20-24,1868,0.001550104986046004
STAT,1923,15,50-100,1938,0.44657118246604155
SIM,1929,21,na,1950,4448
STAT,1864,8,na,1872,2544.1853778549435
STAT,1892,23,na,1915,2988.151374830597
STAT,1881,25,50-100,1906,0.627007573088542
SIM,1902,39,na,1941,3590
SIM,1899,61,na,1960,2821
SIM,1910,34,50-100,1944,1
STAT,1892,33,15-19,1925,0.17972287739659443
SIM,1864,48,na,1912,2427
SIM,1909,39,40-44,1948,8
SIM,1869,95,na,1964,40
STAT,1891,40,45-49,1931,1.8904001731521722
STAT,1814,53,45-49,1867,0.03276015938934293
SIM,1900,27,30-34,1927,37
STAT,1849,18,15-19,1867,5.677764302004326
SIM,1881,34,45-49,1915,2
STAT,1877,40,50-100,1917,1.112382295330293
SIM,1857,18,15-19,1875,7
SIM,1885,40,50-100,1925,1
SIM,1897,32,30-34,1929,38
STAT,1871,43,25-29,1914,0.6397012299114636
STAT,1922,23,na,1945,4217.548192411358
STAT,1926,37,na,1963,4646.935956119446
STAT,1825,42,15-19,1867,0.019801790524606948
STAT,1901,38,35-39,1939,2.150766577332827
STAT,1840,69,na,1909,1028.7297988034725
SIM,1824,83,na,1907,168
STAT,1804,52,25-29,1856,0.009592147170224899
STAT,1859,29,15-19,1888,0.369555872408363
STAT,1944,22,20-24,1966,121.23504489021548
SIM,1916,51,na,1967,3707
STAT,1876,50,20-24,1926,7.805925511670835E-4
STAT,1893,35,25-29,1928,3.7274690709536675
STAT,1856,54,35-39,1910,0.006483071366332462
STAT,1884,42,20-24,1926,0.15798224430876115
STAT,1804,90,na,1894,24.442124684155477
STAT,1864,32,25-29,1896,9.334978223134847
STAT,1925,43,50-100,1968,0.14351449434441174
SIM,1838,43,30-34,1881,4
SIM,1876,33,na,1909,2759
STAT,1830,41,50-100,1871,0.9309712160790942
STAT,1927,8,na,1935,5012.397228296783
STAT,1860,26,30-34,1886,21.165581387597847
STAT,1817,38,20-24,1855,2.5617296894017483
SIM,1816,38,30-34,1854,9
SIM,1840,41,45-49,1881,1
STAT,1886,7,na,1893,2778.333593863289
STAT,1840,14,na,1854,2147.0
STAT,1844,28,na,1872,2080.1768293196405
STAT,1944,22,na,1966,3981.5383718081425
STAT,1814,53,na,1867,1305.9219646258787
SIM,1895,56,na,1951,2769
STAT,1839,29,45-49,1868,0.9774743073167689
SIM,1883,62,na,1945,2009
STAT,1812,54,25-29,1866,0.007512306295100695
SIM,1883,29,30-34,1912,32
SIM,1884,32,20-24,1916,3
STAT,1837,24,30-34,1861,15.680049476418095
SIM,1929,25,50-100,1954,1
STAT,1875,29,30-34,1904,25.932428607001434
STAT,1884,29,20-24,1913,11.60095578949051
SIM,1875,95,na,1970,25
STAT,1937,25,35-39,1962,14.78763075673794
STAT,1897,34,30-34,1931,23.43907505449093
STAT,1898,24,na,1922,3217.97331018959
SIM,1877,24,25-29,1901,2
SIM,1887,76,na,1963,1109
STAT,1838,53,30-34,1891,0.003920814093615456
STAT,1775,88,na,1863,32.13761765469886
SIM,1860,47,50-100,1907,1
STAT,1945,24,30-34,1969,31.790177079298925
STAT,1875,27,na,1902,2475.343635818655
STAT,1913,21,30-34,1934,28.184994771649254
STAT,1918,43,25-29,1961,0.07652930058764972
STAT,1924,48,30-34,1972,0.10694648277531768
SIM,1921,21,30-34,1942,44
STAT,1832,41,45-49,1873,1.2667092438424292
STAT,1823,73,na,1896,656.9025855337178
SIM,1884,19,20-24,1903,25
SIM,1918,33,25-29,1951,23
SIM,1873,68,na,1941,1361
STAT,1901,37,50-100,1938,0.3751986667069952
SIM,1903,6,na,1909,3570
STAT,1823,35,40-44,1858,8.289237218425448
SIM,1874,23,45-49,1897,4
SIM,1882,24,35-39,1906,9
STAT,1910,48,30-34,1958,0.08368076427156451
SIM,1935,29,40-44,1964,7
STAT,1828,51,50-100,1879,0.013552028922297546
STAT,1848,30,50-100,1878,0.890696898244987
STAT,1877,23,20-24,1900,71.61401738836298
STAT,1900,18,25-29,1918,7.929652952260315
STAT,1941,24,50-100,1965,0.6860432133819284
SIM,1872,28,40-44,1900,5
SIM,1873,26,35-39,1899,13
SIM,1885,23,20-24,1908,115
STAT,1834,28,30-34,1862,19.524211175928205
STAT,1905,11,na,1916,3776.339540002182
STAT,1800,102,na,1902,0.10284161159272519
STAT,1897,9,na,1906,3513.285776876837
STAT,1921,45,50-100,1966,0.25873220428976546
STAT,1891,22,45-49,1913,0.8719854185631868
STAT,1853,48,35-39,1901,0.11432197606009659
STAT,1863,32,30-34,1895,15.6245224408623
STAT,1916,49,35-39,1965,0.1326708274244558
SIM,1945,25,35-39,1970,35
SIM,1953,17,40-44,1970,1
STAT,1865,4,na,1869,2783.6513742424763
STAT,1868,73,na,1941,1146.5268001676025
SIM,1901,21,na,1922,3335
SIM,1856,31,30-34,1887,12
SIM,1879,37,40-44,1916,11
SIM,1879,44,30-34,1923,1
SIM,1830,83,na,1913,172
STAT,1926,42,20-24,1968,0.02200376011026757
STAT,1951,20,50-100,1971,0.7948106356723338
SIM,1816,43,50-100,1859,1
STAT,1865,19,45-49,1884,0.06135126499470975
STAT,1873,34,45-49,1907,1.7702293529233692
STAT,1869,31,15-19,1900,0.14040989261328465
STAT,1890,26,40-44,1916,3.7096947819135178
SIM,1867,2,na,1869,3101
STAT,1881,44,45-49,1925,1.4374093728471522
STAT,1907,1,na,1908,4037.1482114975606
STAT,1868,29,40-44,1897,2.8709237535547714
STAT,1811,88,na,1899,59.84777048748861
STAT,1837,17,40-44,1854,0.24693362028743446
SIM,1843,18,20-24,1861,32
STAT,1946,21,40-44,1967,3.7803168462695678
SIM,1814,43,45-49,1857,6
SIM,1887,9,na,1896,2866
STAT,1809,62,na,1871,1072.729113208952
STAT,1841,40,30-34,1881,0.916563194780735
STAT,1807,51,35-39,1858,0.029819121670999458
STAT,1867,84,na,1951,316.43652169187
STAT,1938,22,na,1960,3648.647750058066
SIM,1864,45,50-100,1909,3
SIM,1851,28,20-24,1879,15
SIM,1868,26,25-29,1894,56
SIM,1917,36,na,1953,3802
STAT,1850,20,50-100,1870,0.3802200954980638
STAT,1856,41,30-34,1897,0.894269425555465
STAT,1817,97,na,1914,2.4579208223189455
SIM,1907,42,na,1949,3667
STAT,1863,70,na,1933,1255.596748909934
STAT,1843,28,20-24,1871,9.667810113804487
STAT,1858,52,20-24,1910,5.816046697976372E-4
SIM,1860,34,25-29,1894,17
STAT,1867,37,25-29,1904,2.7387554778838252
STAT,1900,25,15-19,1925,0.6408682863314326
STAT,1841,22,30-34,1863,16.874148100173763
STAT,1820,46,30-34,1866,0.16715390170995023
SIM,1854,44,25-29,1898,3
STAT,1852,54,na,1906,1588.040126293885
SIM,1875,37,25-29,1912,4
STAT,1848,31,30-34,1879,16.797539682284608
SIM,1851,45,50-100,1896,2
STAT,1865,26,35-39,1891,8.929320450033618
STAT,1830,42,25-29,1872,0.557945492693569
STAT,1842,38,30-34,1880,5.570743520509951
SIM,1900,32,na,1932,3476
SIM,1841,105,na,1946,2
STAT,1873,52,45-49,1925,0.014780295400281996
SIM,1842,28,30-34,1870,31
STAT,1852,34,25-29,1886,7.877437042511237
SIM,1850,38,30-34,1888,11
STAT,1813,49,45-49,1862,0.6620192337900733
SIM,1882,42,35-39,1924,6
SIM,1780,75,na,1855,454
STAT,1842,34,15-19,1876,0.15170295872153824
STAT,1912,24,na,1936,3656.482082590861
STAT,1849,49,20-24,1898,0.009186341169960949
SIM,1881,29,45-49,1910,2
SIM,1884,27,25-29,1911,66
SIM,1888,43,45-49,1931,5
SIM,1950,21,50-100,1971,1
STAT,1851,85,na,1936,207.57124434686688
SIM,1927,23,25-29,1950,148
SIM,1840,35,35-39,1875,13
SIM,1817,70,na,1887,730
STAT,1931,40,40-44,1971,0.3386430871308899
SIM,1820,44,30-34,1864,1
SIM,1913,39,na,1952,3700
STAT,1832,30,40-44,1862,3.9437374513200423
SIM,1854,22,30-34,1876,2
SIM,1900,63,na,1963,2921
STAT,1900,31,45-49,1931,2.456600349860281
STAT,1856,45,50-100,1901,0.1920754481695648
STAT,1859,65,na,1924,1372.8166723840088
STAT,1837,42,30-34,1879,0.9255020842657646
STAT,1921,16,40-44,1937,1.6142148079024043
SIM,1866,39,20-24,1905,1
STAT,1915,36,15-19,1951,0.019669143149378083
SIM,1835,82,na,1917,200
STAT,1855,99,na,1954,1.4255531857390513
STAT,1878,25,30-34,1903,26.58120335623769
SIM,1868,23,20-24,1891,74
STAT,1846,48,40-44,1894,0.12828862884599757
STAT,1823,66,na,1889,910.0332641195462
SIM,1909,32,20-24,1941,3
SIM,1924,22,45-49,1946,2
SIM,1876,80,na,1956,596
SIM,1891,1,na,1892,3490
STAT,1878,48,40-44,1926,0.17724009019398684
SIM,1940,17,na,1957,3864
SIM,1794,95,na,1889,1
STAT,1886,37,50-100,1923,1.3092562885911527
STAT,1876,27,25-29,1903,44.11373820169588
STAT,1812,44,30-34,1856,2.7706269407514483
SIM,1871,33,na,1904,2325
STAT,1824,31,45-49,1855,3.9651832939739866
STAT,1897,45,35-39,1942,0.10799833900323821
STAT,1873,29,45-49,1902,1.1287247120581885
STAT,1854,51,50-100,1905,0.011388641411633578
SIM,1880,10,na,1890,2526
STAT,1937,31,40-44,1968,3.9108790230359456
STAT,1903,32,25-29,1935,14.733097896807742
STAT,1881,20,30-34,1901,17.44489237670759
STAT,1881,21,20-24,1902,67.29337668896859
STAT,1907,61,na,1968,3044.4530202533538
STAT,1846,22,30-34,1868,16.678693596348925
SIM,1886,25,30-34,1911,43
STAT,1896,60,na,1956,2573.0293358257522
SIM,1856,26,35-39,1882,12
SIM,1862,84,na,1946,397
STAT,1945,20,15-19,1965,5.89595176071991
SIM,1896,33,25-29,1929,5
SIM,1840,30,40-44,1870,9
SIM,1790,81,na,1871,222
SIM,1923,29,25-29,1952,83
SIM,1866,50,na,1916,2220
STAT,1920,43,na,1963,4135.591821565686
STAT,1825,49,35-39,1874,0.18284745038993602
STAT,1916,44,50-100,1960,0.12109001486599015
STAT,1855,34,25-29,1889,7.688841931293266
STAT,1911,31,20-24,1942,2.4060520915300163
SIM,1830,52,na,1882,1256
SIM,1828,32,30-34,1860,5
SIM,1918,37,40-44,1955,1
STAT,1923,41,45-49,1964,0.19682667628961956
STAT,1840,20,20-24,1860,62.32364091676931
SIM,1845,24,30-34,1869,29
STAT,1878,21,15-19,1899,3.46932013980872
STAT,1880,29,40-44,1909,3.1547164153035725
SIM,1832,31,45-49,1863,2
SIM,1910,30,20-24,1940,2
STAT,1936,34,30-34,1970,15.429697737433528
SIM,1949,19,40-44,1968,1
STAT,1860,40,45-49,1900,1.2481341927516107
SIM,1893,76,na,1969,1718
STAT,1837,47,40-44,1884,0.12124018321039022
SIM,1825,38,20-24,1863,3
SIM,1833,96,na,1929,6
SIM,1822,53,na,1875,1370
STAT,1851,32,15-19,1883,0.11223102953509846
STAT,1953,4,na,1957,4806.453764949696
SIM,1821,38,40-44,1859,2
STAT,1838,49,45-49,1887,0.1584221242494174
STAT,1873,36,35-39,1909,7.276888270970676
STAT,1921,49,20-24,1970,0.012508668430407672
SIM,1892,29,20-24,1921,22
STAT,1888,42,40-44,1930,2.678086776761951
STAT,1936,6,na,1942,3874.026201821401
STAT,1816,44,15-19,1860,0.036908412978648726
SIM,1857,39,30-34,1896,3
STAT,1943,16,na,1959,3942.218249502673
SIM,1877,21,20-24,1898,79
SIM,1911,32,25-29,1943,6
STAT,1848,102,na,1950,0.23936519653515304
SIM,1857,14,na,1871,2491
SIM,1929,6,na,1935,5010
SIM,1822,37,40-44,1859,8
STAT,1891,13,na,1904,3224.365811842131
STAT,1912,18,40-44,1930,0.2846048341247106
STAT,1919,30,15-19,1949,0.14110847526383946
SIM,1885,57,na,1942,2165
STAT,1851,39,35-39,1890,5.301628775841051
STAT,1918,49,na,1967,3923.7733034842945
SIM,1869,3,na,1872,2791
SIM,1927,35,na,1962,5166
STAT,1811,44,50-100,1855,2.778347937887981
STAT,1869,28,40-44,1897,2.931165255247475
SIM,1926,6,na,1932,4929
STAT,1787,73,na,1860,413.81232822780515
STAT,1866,54,20-24,1920,6.711482287681479E-4
STAT,1924,40,45-49,1964,0.2005981615777061
STAT,1910,49,45-49,1959,0.20338467963871296
STAT,1953,15,25-29,1968,52.99229983158694
STAT,1841,33,35-39,1874,9.093595062567877
SIM,1843,26,25-29,1869,76
STAT,1852,52,25-29,1904,0.00267193384701896
SIM,1805,85,na,1890,102
STAT,1817,54,25-29,1871,0.00700717245193649
SIM,1929,21,30-34,1950,50
STAT,1869,21,20-24,1890,67.87350769169655
STAT,1838,28,na,1866,1828.889058943186
SIM,1880,32,35-39,1912,15
SIM,1831,23,25-29,1854,57
STAT,1860,18,30-34,1878,1.5087624314225168
STAT,1881,28,40-44,1909,2.9061118891180544
SIM,1843,15,na,1858,2661
STAT,1900,39,na,1939,3298.0142565869482
SIM,1818,48,na,1866,1313
STAT,1896,1,na,1897,3638.9210074313355
SIM,1897,27,35-39,1924,19
SIM,1813,41,35-39,1854,3
STAT,1874,49,30-34,1923,0.0980193415286784
STAT,1915,24,50-100,1939,0.6820243266624794
STAT,1864,26,50-100,1890,0.5850081668662549
SIM,1844,16,15-19,1860,7
SIM,1864,95,na,1959,12
STAT,1826,29,35-39,1855,17.510412377417868
STAT,1846,49,50-100,1895,0.182490610368931
STAT,1835,51,na,1886,1679.814514538052
STAT,1877,93,na,1970,126.07060009138623
SIM,1855,44,na,1899,1932
STAT,1840,109,na,1949,4.987245124958356E-4
STAT,1872,46,na,1918,2291.021533870307
SIM,1777,92,na,1869,4
STAT,1912,46,50-100,1958,0.21984798447606343
STAT,1884,45,25-29,1929,0.057941259074524416
STAT,1942,18,30-34,1960,12.856714590946714
SIM,1889,56,na,1945,2436
STAT,1851,46,25-29,1897,0.0437378448236855
STAT,1857,32,50-100,1889,0.7266842189240277
STAT,1889,27,35-39,1916,12.016719455025214
SIM,1950,18,30-34,1968,14
STAT,1871,40,20-24,1911,0.16096480883769015
STAT,1889,19,na,1908,3128.507206988446
STAT,1919,23,25-29,1942,101.80921508648976
STAT,1947,15,na,1962,4190.350175456936
STAT,1900,47,30-34,1947,0.0762518298785634
STAT,1887,41,30-34,1928,1.3022847117048975
SIM,1902,43,na,1945,3502
STAT,1852,26,25-29,1878,37.636357158651606
STAT,1930,42,na,1972,4938.989416196084
SIM,1772,89,na,1861,17
SIM,1830,36,40-44,1866,11
STAT,1848,80,na,1928,505.05816716167874
STAT,1884,32,na,1916,2376.753881933604
SIM,1858,29,20-24,1887,10
STAT,1789,84,na,1873,133.43173188545805
STAT,1835,26,25-29,1861,41.69418619847143
STAT,1896,32,20-24,1928,3.6137765440499794
STAT,1856,42,45-49,1898,1.1574909045827613
SIM,1898,21,40-44,1919,3
SIM,1889,20,25-29,1909,1
STAT,1904,25,na,1929,3482.5391383588144
SIM,1820,39,35-39,1859,13
STAT,1837,48,50-100,1885,0.17171456189881654
SIM,1924,28,30-34,1952,60
STAT,1812,82,na,1894,211.83358093650574
STAT,1849,39,30-34,1888,4.1762506248132185
STAT,1856,35,50-100,1891,0.9597269094713788
STAT,1890,75,na,1965,1586.492714911739
STAT,1898,20,25-29,1918,78.84886021277167
STAT,1916,28,30-34,1944,40.74094932752384
SIM,1881,22,25-29,1903,52
STAT,1832,28,45-49,1860,1.009420896006472
STAT,1873,51,30-34,1924,0.0061240340370461435
SIM,1790,74,na,1864,462
STAT,1866,46,na,1912,2110.0983742069734
SIM,1880,27,40-44,1907,8
SIM,1810,90,na,1900,55
STAT,1872,32,35-39,1904,10.283234346101708
STAT,1941,19,25-29,1960,45.03402556374224
STAT,1827,59,na,1886,1210.3692935468305
STAT,1856,13,na,1869,2175.864214719784
SIM,1838,28,40-44,1866,4
SIM,1881,36,35-39,1917,11
SIM,1923,42,45-49,1965,1
STAT,1904,18,50-100,1922,0.07082370470711674
SIM,1815,74,na,1889,478
SIM,1840,28,45-49,1868,1
STAT,1853,52,20-24,1905,6.069933824542509E-4
STAT,1953,15,na,1968,4501.004254741161
SIM,1854,58,na,1912,1807
STAT,1816,101,na,1917,0.2917444571207581
SIM,1860,26,25-29,1886,6
SIM,1899,38,25-29,1937,1
STAT,1883,35,15-19,1918,0.05602866416733794
STAT,1878,43,30-34,1921,1.196667784265461
STAT,1884,31,na,1915,2386.4668018170014
SIM,1911,11,na,1922,4144
STAT,1911,36,30-34,1947,1.784545364790453
STAT,1887,49,40-44,1936,0.10662425508636689
STAT,1904,23,30-34,1927,25.737682171457305
SIM,1841,15,35-39,1856,1
STAT,1937,16,na,1953,3623.8237430247627
SIM,1831,37,na,1868,1731
SIM,1882,3,na,1885,2676
STAT,1866,47,30-34,1913,0.09010845516225162
STAT,1927,25,25-29,1952,81.42699538462189
STAT,1872,15,35-39,1887,0.5656471678733666
STAT,1893,4,na,1897,3373.7030777885107
SIM,1886,43,30-34,1929,1
STAT,1860,54,25-29,1914,0.0028439613878979363
SIM,1784,74,na,1858,424
STAT,1931,27,na,1958,4887.948424440147
STAT,1897,19,40-44,1916,0.2463333379643294
STAT,1829,41,20-24,1870,0.12517974908023388
SIM,1849,21,45-49,1870,5
STAT,1842,52,45-49,1894,0.012996473322267443
SIM,1904,24,35-39,1928,16
SIM,1855,43,na,1898,1955
STAT,1915,29,25-29,1944,67.25888332340922
STAT,1804,63,na,1867,820.039722193156
STAT,1872,47,na,1919,2273.8846927969585
SIM,1903,26,40-44,1929,7
STAT,1840,27,40-44,1867,2.6182105448958355
STAT,1888,47,35-39,1935,0.16611755966130148
SIM,1906,57,na,1963,2958
STAT,1845,29,50-100,1874,0.5607861460660145
SIM,1889,25,35-39,1914,21
STAT,1811,51,25-29,1862,0.00860669823757494
STAT,1840,25,50-100,1865,0.5672259982596191
SIM,1909,17,25-29,1926,11
STAT,1898,46,15-19,1944,3.098159834804213E-4
STAT,1812,51,20-24,1863,0.0016619044406517985
STAT,1825,52,na,1877,1741.0580098368569
STAT,1877,26,25-29,1903,44.24731334051405
STAT,1857,94,na,1951,15.75391244407839
SIM,1837,40,30-34,1877,1
STAT,1888,33,25-29,1921,12.15880068596509
STAT,1916,46,30-34,1962,0.09250265857144711
SIM,1830,31,30-34,1861,24
SIM,1866,43,na,1909,2354
STAT,1905,20,40-44,1925,3.060715859893648
STAT,1896,31,30-34,1927,23.43765763159493
STAT,1861,16,25-29,1877,5.498828494087084
STAT,1887,23,30-34,1910,20.023883308972096
SIM,1823,97,na,1920,6
SIM,1904,62,na,1966,3104
SIM,1838,47,na,1885,1690
STAT,1814,102,na,1916,0.1372235595547858
SIM,1895,23,30-34,1918,39
SIM,1863,31,20-24,1894,3
STAT,1846,26,50-100,1872,0.591525132935597
STAT,1827,40,50-100,1867,1.1761953287529316
SIM,1814,40,40-44,1854,4
STAT,1916,22,45-49,1938,1.1898370946519632
STAT,1900,29,30-34,1929,35.07797261809275
STAT,1853,80,na,1933,511.56461433960754
SIM,1829,42,25-29,1871,2
SIM,1935,25,25-29,1960,128
STAT,1832,53,35-39,1885,0.005995841171356414
SIM,1857,20,40-44,1877,3
STAT,1852,19,35-39,1871,0.4973900103540932
STAT,1822,36,40-44,1858,8.497437872597565
STAT,1829,40,30-34,1869,0.9197701455622133
SIM,1885,26,25-29,1911,58
STAT,1957,0,na,1957,5275.343016532031
STAT,1890,29,45-49,1919,1.3604988834158536
STAT,1921,23,30-34,1944,32.68542304686039
SIM,1840,21,25-29,1861,68
STAT,1823,38,45-49,1861,3.320460425338557
STAT,1888,40,15-19,1928,0.016628975386052253
SIM,1881,31,40-44,1912,4
SIM,1887,21,na,1908,2602
STAT,1897,40,40-44,1937,0.2136303796039663
STAT,1903,44,50-100,1947,0.1041007505199183
STAT,1878,31,na,1909,2512.1637160418413
STAT,1846,40,30-34,1886,0.9059465755951938
SIM,1794,67,na,1861,742
SIM,1831,38,45-49,1869,3
STAT,1831,31,35-39,1862,8.48286359791506
STAT,1915,42,45-49,1957,0.16907410305809123
SIM,1810,68,na,1878,909
STAT,1876,19,20-24,1895,18.38892610387454
STAT,1969,2,na,1971,4964.145719558188
STAT,1832,81,na,1913,368.21963011653327
STAT,1892,44,20-24,1936,0.013788377557555936
SIM,1828,49,50-100,1877,1
SIM,1825,44,50-100,1869,4
SIM,1939,20,na,1959,3639
SIM,1803,89,na,1892,29
STAT,1930,4,na,1934,5274.124364142142
STAT,1908,2,na,1910,3991.636682313875
STAT,1832,35,35-39,1867,6.234359351067096
STAT,1941,26,15-19,1967,0.7376245138503323
STAT,1777,99,na,1876,0.2628616696929358
STAT,1843,21,50-100,1864,0.34773006949765345
STAT,1896,39,40-44,1935,5.793474755512636
STAT,1903,40,na,1943,3369.6607482268837
SIM,1870,17,na,1887,2859
STAT,1825,53,20-24,1878,9.360780846837097E-4
SIM,1903,2,na,1905,3610
SIM,1862,29,na,1891,2129
STAT,1873,31,40-44,1904,4.4585518295985205
SIM,1949,17,15-19,1966,46
STAT,1836,95,na,1931,8.383155849052603
SIM,1939,15,45-49,1954,4
STAT,1825,46,30-34,1871,0.13179229140440024
SIM,1858,1,na,1859,2971
SIM,1895,43,35-39,1938,1
SIM,1854,25,35-39,1879,12
STAT,1831,51,50-100,1882,0.010123161544170338
STAT,1938,21,30-34,1959,28.725934971976866
SIM,1844,25,25-29,1869,39
STAT,1904,16,40-44,1920,0.26575422994018
SIM,1883,83,na,1966,794
STAT,1819,52,na,1871,1268.9921144639259
SIM,1877,28,40-44,1905,6
STAT,1892,37,30-34,1929,6.7545959635659765
SIM,1840,41,na,1881,1757
STAT,1875,39,20-24,1914,0.7914909515268157
STAT,1899,34,na,1933,3279.469525062449
SIM,1810,75,na,1885,529
SIM,1933,38,na,1971,4878
SIM,1840,32,30-34,1872,22
SIM,1848,24,35-39,1872,8
SIM,1835,67,na,1902,873
STAT,1873,22,25-29,1895,58.614329553451675
STAT,1855,25,50-100,1880,0.5595376104165756
STAT,1859,19,20-24,1878,16.520795431309125
STAT,1897,43,45-49,1940,0.13971043158791582
STAT,1887,43,35-39,1930,2.027206180920764
SIM,1881,26,40-44,1907,2
SIM,1888,40,40-44,1928,6
STAT,1851,14,na,1865,2177.7851356918673
SIM,1930,20,40-44,1950,5
SIM,1871,32,30-34,1903,5
SIM,1804,90,na,1894,23
SIM,1853,48,na,1901,1652
STAT,1852,31,20-24,1883,2.1446617777253136
STAT,1805,108,na,1913,7.271503783446338E-4
SIM,1815,78,na,1893,289
STAT,1914,21,45-49,1935,1.1163226405939441
STAT,1860,22,15-19,1882,2.8078093415109775
STAT,1906,21,na,1927,3489.7353382590577
SIM,1871,98,na,1969,9
SIM,1886,8,na,1894,2930
STAT,1901,17,30-34,1918,2.2566919103957326
SIM,1888,61,na,1949,2356
STAT,1879,52,40-44,1931,0.011037070253531595
SIM,1863,25,50-100,1888,3
SIM,1939,16,na,1955,4041
STAT,1855,31,20-24,1886,2.0933160514043965
STAT,1865,31,30-34,1896,16.16813347632898
STAT,1876,61,na,1937,1948.6934179557104
SIM,1927,20,20-24,1947,147
STAT,1835,19,35-39,1854,1.1761838642629225
STAT,1829,48,50-100,1877,0.18086736252178362
STAT,1883,50,40-44,1933,0.010554754465660133
STAT,1832,32,30-34,1864,15.540531952067015
STAT,1949,19,50-100,1968,0.4399132353504319
SIM,1906,36,na,1942,3415
SIM,1932,26,15-19,1958,1
STAT,1837,20,15-19,1857,3.134409379808079
STAT,1920,32,25-29,1952,10.22342080714116
SIM,1848,62,na,1910,1393
STAT,1862,19,40-44,1881,0.16431490042954047
SIM,1867,28,na,1895,2245
STAT,1851,43,20-24,1894,0.11938262070742299
SIM,1863,14,na,1877,2553
SIM,1946,21,30-34,1967,45
STAT,1846,25,35-39,1871,8.986914023737713
STAT,1906,29,20-24,1935,17.134831387970408
STAT,1802,67,na,1869,752.0785886623357
STAT,1836,25,25-29,1861,35.031465672478404
STAT,1875,51,45-49,1926,0.01512455024635927
STAT,1910,46,40-44,1956,0.14877893593202687
STAT,1926,15,30-34,1941,15.173606102929757
STAT,1824,33,35-39,1857,17.47113973312664
STAT,1838,66,na,1904,1097.1967878385806
STAT,1924,44,15-19,1968,0.0018396983912553134
STAT,1922,20,40-44,1942,3.9185449271553847
SIM,1822,33,25-29,1855,15
SIM,1827,63,na,1890,920
STAT,1813,51,50-100,1864,0.04261390506862626
STAT,1834,32,15-19,1866,0.10863609856249198
SIM,1832,33,35-39,1865,11
SIM,1885,17,15-19,1902,5
SIM,1851,29,na,1880,2030
STAT,1843,81,na,1924,364.72824105979674
STAT,1869,27,na,1896,2343.4667559964673
STAT,1921,19,45-49,1940,0.5720086064178134
STAT,1947,25,50-100,1972,1.1384380825972917
SIM,1909,35,25-29,1944,1
STAT,1842,50,40-44,1892,0.009614617280589988
STAT,1830,38,40-44,1868,3.9236202728945875
STAT,1832,50,30-34,1882,0.004399482790311091
STAT,1843,18,30-34,1861,1.3657017741334385
SIM,1914,29,20-24,1943,30
STAT,1854,42,30-34,1896,0.8617482995527351
STAT,1902,47,45-49,1949,0.18911627424004976
SIM,1851,18,30-34,1869,2
SIM,1931,24,na,1955,4679
SIM,1814,42,30-34,1856,4
SIM,1843,19,35-39,1862,2
SIM,1942,3,na,1945,4472
STAT,1834,50,45-49,1884,0.00921999133602269
STAT,1919,20,20-24,1939,123.67173465860593
STAT,1883,46,na,1929,2229.9915630251303
STAT,1910,39,50-100,1949,0.4010473578973903
SIM,1845,20,15-19,1865,3
STAT,1849,54,20-24,1903,5.610788165714875E-4
STAT,1912,43,50-100,1955,0.11362771761431226
SIM,1876,32,45-49,1908,2
STAT,1873,33,30-34,1906,17.80173005941768
STAT,1911,39,35-39,1950,2.333217523417694
STAT,1817,66,na,1883,838.3075120712454
STAT,1868,27,15-19,1895,0.43795492066781494
STAT,1901,39,25-29,1940,0.8710281398947026
STAT,1868,32,45-49,1900,1.6832956460289976
STAT,1930,18,50-100,1948,0.4882830936517234
SIM,1906,29,25-29,1935,51
STAT,1814,52,na,1866,1332.0432998290898
STAT,1870,19,50-100,1889,0.04847629784166302
SIM,1880,47,na,1927,2107
STAT,1850,23,35-39,1873,5.324590357783807
SIM,1878,23,30-34,1901,37
STAT,1840,23,25-29,1863,50.66506466802117
STAT,1767,105,na,1872,0.01590610353508564
STAT,1849,101,na,1950,0.4461437066009623
SIM,1916,10,na,1926,4238
STAT,1828,52,30-34,1880,0.0052364658130526895
STAT,1891,24,35-39,1915,7.2514591901146535
STAT,1803,53,na,1856,1389.59328176632
STAT,1881,24,25-29,1905,55.38345585188145
SIM,1870,15,25-29,1885,8
SIM,1922,21,45-49,1943,1
STAT,1807,67,na,1874,765.5119475144878
SIM,1921,24,35-39,1945,18
STAT,1917,33,50-100,1950,0.8702243327743356
SIM,1836,27,40-44,1863,3
STAT,1913,47,20-24,1960,0.01088309474646234
STAT,1821,34,na,1855,1693.0159000673546
STAT,1849,27,50-100,1876,0.5928753819354188
STAT,1901,31,15-19,1932,0.20245294795698504
STAT,1914,37,50-100,1951,0.42295016000427943
STAT,1850,41,35-39,1891,1.3928390076755979
SIM,1901,58,na,1959,2893
STAT,1808,48,20-24,1856,0.04265957283759112
STAT,1901,35,30-34,1936,1.644189207345211
STAT,1903,28,40-44,1931,4.293691656925839
SIM,1945,23,na,1968,3901
STAT,1873,54,35-39,1927,0.008572494203372829
STAT,1847,32,25-29,1879,9.004403247365518
STAT,1895,43,30-34,1938,0.10453920124367261
SIM,1836,34,30-34,1870,7
STAT,1913,24,35-39,1937,9.53340110937819
STAT,1869,24,25-29,1893,55.86091234698933
STAT,1925,21,20-24,1946,134.91807945475526
STAT,1856,18,40-44,1874,0.1664821904968546
STAT,1851,36,30-34,1887,4.121279480207307
SIM,1933,21,20-24,1954,124
STAT,1893,32,20-24,1925,3.4665146499089796
STAT,1895,25,30-34,1920,33.439338163468086
SIM,1911,28,40-44,1939,5
SIM,1918,19,40-44,1937,3
SIM,1855,32,25-29,1887,11
STAT,1810,45,25-29,1855,0.23116246699522558
STAT,1852,36,15-19,1888,0.043265176853172854
SIM,1876,25,25-29,1901,53
STAT,1828,34,30-34,1862,19.032407825247613
SIM,1854,42,35-39,1896,3
SIM,1881,33,30-34,1914,6
STAT,1826,41,20-24,1867,0.16901446065001477
SIM,1883,39,20-24,1922,1
SIM,1885,0,na,1885,3741
STAT,1910,47,40-44,1957,0.14840996417091548
SIM,1947,0,na,1947,5104
STAT,1891,42,35-39,1933,2.261595312994705
SIM,1916,16,25-29,1932,15
SIM,1937,32,45-49,1969,1
STAT,1892,47,25-29,1939,0.04098668930850691
STAT,1821,52,25-29,1873,0.00499332177760423
SIM,1831,30,na,1861,1880
SIM,1847,41,30-34,1888,8
STAT,1846,42,35-39,1888,1.3908353744014383
STAT,1887,26,50-100,1913,0.7238220010166201
SIM,1944,27,40-44,1971,11
STAT,1870,76,na,1946,939.6238053992487
STAT,1832,25,40-44,1857,2.816289635418072
STAT,1822,39,45-49,1861,3.396861251697557
STAT,1830,48,na,1878,1572.8415757602763
STAT,1859,23,50-100,1882,0.3412284974958903
STAT,1918,39,40-44,1957,1.5895708461817906
STAT,1934,21,50-100,1955,0.8937850112817055
SIM,1844,29,40-44,1873,4
SIM,1830,39,45-49,1869,3
SIM,1908,25,30-34,1933,59
STAT,1896,35,25-29,1931,3.885816636499092
SIM,1869,94,na,1963,52
STAT,1859,39,40-44,1898,3.5202116961598136
SIM,1903,29,45-49,1932,1
STAT,1828,27,40-44,1855,5.8027687388849705
STAT,1906,28,20-24,1934,17.19743003329159
SIM,1914,28,20-24,1942,19
STAT,1815,41,45-49,1856,4.037629993010664
STAT,1829,51,na,1880,1366.783503108826
STAT,1874,16,35-39,1890,0.5688629992992185
STAT,1883,51,40-44,1934,0.010455012035959645
STAT,1829,44,25-29,1873,0.4841633941835012
STAT,1882,32,45-49,1914,1.7060641984282978
STAT,1813,67,na,1880,822.9375285155434
STAT,1836,29,40-44,1865,2.4102606486018656
STAT,1860,51,20-24,1911,6.121608521236561E-4
SIM,1824,82,na,1906,196
STAT,1844,99,na,1943,1.4983976666610648
STAT,1897,38,na,1935,3174.308567228534
STAT,1921,26,35-39,1947,16.95762982452227
SIM,1886,21,15-19,1907,4
STAT,1805,104,na,1909,0.02647831802967915
SIM,1839,81,na,1920,281
STAT,1834,38,20-24,1872,0.5651313060007619
STAT,1912,17,na,1929,3940.272638223331
SIM,1898,24,45-49,1922,5
STAT,1936,27,40-44,1963,4.50338861539334
STAT,1887,44,35-39,1931,2.0143942378573456
SIM,1831,43,45-49,1874,1
STAT,1845,49,40-44,1894,0.12248159484926603
SIM,1859,36,25-29,1895,2
SIM,1879,57,na,1936,2359
STAT,1824,51,35-39,1875,0.009905736902750005
STAT,1895,18,40-44,1913,0.24061037980384659
STAT,1867,42,20-24,1909,0.15088045015174298
STAT,1893,37,15-19,1930,0.07201493917999897
STAT,1867,47,15-19,1914,3.787145925519678E-4
SIM,1965,4,na,1969,5215
STAT,1862,15,25-29,1877,5.728081944784802
STAT,1838,108,na,1946,0.0012262042778601995
STAT,1890,34,45-49,1924,2.1337311324127834
STAT,1830,52,na,1882,1474.2140210124865
STAT,1860,28,20-24,1888,9.719288829181806
STAT,1808,52,na,1860,1178.6015335618638
STAT,1843,44,25-29,1887,0.4346587018842398
STAT,1839,41,30-34,1880,0.9561968670607618
SIM,1846,66,na,1912,1166
STAT,1769,85,na,1854,67.0
STAT,1842,33,na,1875,2332.8122233514882
STAT,1929,32,45-49,1961,2.020262742286081
STAT,1857,45,15-19,1902,3.1844084704115707E-4
STAT,1823,43,45-49,1866,2.164621963974732
STAT,1907,40,45-49,1947,0.1557069670723323
SIM,1878,13,na,1891,3043
STAT,1838,51,40-44,1889,0.007150185055512373
STAT,1841,108,na,1949,0.0013697895481610742
STAT,1870,52,50-100,1922,0.01489898991740333
SIM,1896,37,40-44,1933,9
SIM,1851,44,25-29,1895,3
STAT,1908,16,25-29,1924,8.506364499977119
STAT,1949,19,15-19,1968,53.288167358622005
STAT,1822,50,50-100,1872,0.022443166648169532
STAT,1826,46,15-19,1872,3.995608033688961E-4
STAT,1894,15,25-29,1909,7.402883227878088
STAT,1850,99,na,1949,1.4501601468979568
SIM,1872,44,45-49,1916,11
STAT,1821,93,na,1914,17.50577493066973
SIM,1818,39,40-44,1857,5
SIM,1863,34,25-29,1897,2
STAT,1843,18,na,1861,1966.842161002795
SIM,1862,24,30-34,1886,27
SIM,1835,24,25-29,1859,49
STAT,1846,43,35-39,1889,1.3731300400853081
STAT,1884,19,30-34,1903,1.5789726396647596
STAT,1861,53,50-100,1914,0.012471919630602273
STAT,1827,31,45-49,1858,2.4506133150917737
STAT,1848,26,35-39,1874,9.472797139545612
SIM,1828,35,35-39,1863,15
SIM,1854,43,35-39,1897,3
STAT,1831,96,na,1927,5.395859944979003
STAT,1762,97,na,1859,0.6018575670338115
STAT,1833,48,30-34,1881,0.0723386037778427
SIM,1907,31,20-24,1938,3
STAT,1882,61,na,1943,1828.1750646383205
STAT,1939,15,40-44,1954,1.4169107821920004
STAT,1905,38,50-100,1943,0.3850028006282272
STAT,1854,24,30-34,1878,15.482048410353945
SIM,1907,43,na,1950,3647
STAT,1865,52,35-39,1917,0.00789748911329778
SIM,1891,10,na,1901,3384
SIM,1900,11,na,1911,3814
SIM,1904,21,30-34,1925,1
STAT,1812,54,50-100,1866,0.03203163956758049
STAT,1888,44,30-34,1932,1.3520333093029968
SIM,1892,19,30-34,1911,2
SIM,1861,44,na,1905,1956
SIM,1866,28,na,1894,2387
STAT,1844,66,na,1910,1296.7589290759865
SIM,1850,44,na,1894,1895
STAT,1894,22,45-49,1916,0.9067519034442982
SIM,1925,24,na,1949,4317
STAT,1849,23,45-49,1872,0.654433853736036
STAT,1864,44,45-49,1908,1.345606972940741
SIM,1921,10,na,1931,4533
SIM,1904,25,na,1929,3580
STAT,1927,22,20-24,1949,138.46987848069912
SIM,1936,35,35-39,1971,3
STAT,1841,31,45-49,1872,1.5987235022214386
SIM,1947,15,40-44,1962,5
SIM,1863,38,40-44,1901,8
SIM,1935,22,20-24,1957,146
STAT,1854,17,40-44,1871,0.16420322884720032
SIM,1845,81,na,1926,462
STAT,1848,19,45-49,1867,0.06533775639676283
STAT,1875,33,15-19,1908,0.14708440291192346
SIM,1869,49,50-100,1918,6
STAT,1887,26,35-39,1913,10.917914324684197
SIM,1897,42,na,1939,3162
SIM,1926,39,40-44,1965,4
STAT,1846,50,25-29,1896,0.0027266074393978903
SIM,1835,31,45-49,1866,2
SIM,1845,29,na,1874,2053
STAT,1930,0,na,1930,5886.9031147792275
SIM,1840,25,40-44,1865,2
STAT,1916,42,15-19,1958,0.0015881603095540295
STAT,1861,62,na,1923,1533.9784048767233
STAT,1928,35,35-39,1963,3.0950430543645457
SIM,1912,34,35-39,1946,12
STAT,1909,47,30-34,1956,0.08266068594755828
STAT,1833,29,na,1862,1987.7284453736431
STAT,1942,21,50-100,1963,0.6967982377093619
SIM,1930,23,45-49,1953,1
SIM,1933,24,25-29,1957,140
STAT,1828,37,35-39,1865,7.287503465753931
SIM,1830,32,25-29,1862,16
SIM,1895,19,na,1914,3344
SIM,1901,20,15-19,1921,2
STAT,1814,48,50-100,1862,0.582509357876409
STAT,1871,68,na,1939,1533.4304135504094
SIM,1878,43,35-39,1921,3
SIM,1924,24,15-19,1948,6
STAT,1859,32,20-24,1891,2.195790780924372
SIM,1846,44,50-100,1890,3
SIM,1884,31,na,1915,2419
STAT,1900,60,na,1960,2789.006226581766
STAT,1901,23,50-100,1924,0.575589001343361
SIM,1834,82,na,1916,193
STAT,1906,20,25-29,1926,84.71668846762138
STAT,1788,102,na,1890,0.08224795111992247
STAT,1880,32,30-34,1912,18.519705522303713
SIM,1858,34,20-24,1892,3
SIM,1835,38,50-100,1873,1
SIM,1937,26,35-39,1963,22
SIM,1851,22,15-19,1873,3
STAT,1852,47,50-100,1899,0.1853927032161539
STAT,1874,22,45-49,1896,0.7211627128577767
STAT,1853,43,na,1896,1897.5339386890053
STAT,1839,34,45-49,1873,1.4901670960611404
STAT,1886,39,35-39,1925,7.466601894703521
STAT,1898,17,na,1915,3458.082058294365
SIM,1892,41,45-49,1933,7
STAT,1916,24,15-19,1940,5.593872684277846
SIM,1910,25,na,1935,3412
STAT,1829,104,na,1933,0.03932887296796597
STAT,1834,48,15-19,1882,2.494200625850875E-4
STAT,1918,47,40-44,1965,0.16938363125855468
SIM,1795,84,na,1879,33
SIM,1886,32,na,1918,2655
SIM,1917,45,50-100,1962,3
STAT,1853,21,45-49,1874,0.6862857320778267
STAT,1920,28,40-44,1948,5.145159890034993
SIM,1915,33,20-24,1948,4
STAT,1836,45,30-34,1881,0.06556526015642733
STAT,1949,21,45-49,1970,1.3268469908503422
STAT,1819,48,35-39,1867,0.2688196732480696
STAT,1907,33,20-24,1940,2.2923977476250577
STAT,1856,31,40-44,1887,3.434715382072224
STAT,1840,21,35-39,1861,5.239646129247058
STAT,1931,15,50-100,1946,0.49791219496572353
STAT,1951,21,15-19,1972,6.427702496116628
STAT,1868,48,30-34,1916,0.09226607776922376
STAT,1845,45,25-29,1890,0.04250711025666708
STAT,1847,24,25-29,1871,51.79269097830302
STAT,1904,34,35-39,1938,8.356154888714105
SIM,1867,99,na,1966,3
STAT,1908,18,30-34,1926,2.380453268741784
STAT,1813,41,30-34,1854,4.432826051165925
STAT,1922,23,45-49,1945,1.2994885576546553
STAT,1925,24,25-29,1949,111.03959802225216
SIM,1864,22,25-29,1886,71
SIM,1872,46,na,1918,2469
SIM,1899,28,30-34,1927,45
STAT,1875,25,15-19,1900,0.4737808328526155
STAT,1895,28,35-39,1923,12.681785645522591
SIM,1822,87,na,1909,49
STAT,1894,38,30-34,1932,6.895864501819489
STAT,1864,21,20-24,1885,64.2774470720917
STAT,1869,35,50-100,1904,1.2170420872301715
STAT,1917,18,40-44,1935,0.3030221340358907
SIM,1874,31,50-100,1905,4
STAT,1812,57,na,1869,1166.6762851321273
SIM,1802,71,na,1873,621
SIM,1872,21,20-24,1893,80
SIM,1797,85,na,1882,71
STAT,1872,33,35-39,1905,10.23983909716116
STAT,1825,54,50-100,1879,0.01878145407798966
STAT,1948,15,na,1963,4257.457806427374
SIM,1865,74,na,1939,814
SIM,1903,36,35-39,1939,7
SIM,1920,33,30-34,1953,20
STAT,1871,32,20-24,1903,2.712314580517185
STAT,1855,44,na,1899,1716.2354114003742
STAT,1856,22,25-29,1878,51.482738836340395
STAT,1923,33,na,1956,4378.082177644048
STAT,1921,31,30-34,1952,17.780368927552786
SIM,1855,24,25-29,1879,63
STAT,1848,32,45-49,1880,1.6603554486750018
STAT,1849,21,40-44,1870,1.984035768148469
STAT,1907,26,15-19,1933,0.6752536170476423
STAT,1857,28,15-19,1885,0.36571803305675493
SIM,1879,84,na,1963,500
STAT,1827,47,30-34,1874,0.09928724964792278
STAT,1925,31,15-19,1956,0.15430792105755395
STAT,1851,42,45-49,1893,1.1318424730651995
STAT,1865,24,45-49,1889,0.6416127919647929
STAT,1822,51,na,1873,1375.9960673473192
STAT,1845,52,30-34,1897,0.004326290515065022
SIM,1924,45,na,1969,4449
STAT,1845,38,35-39,1883,5.3739670988754895
STAT,1889,30,25-29,1919,12.858615138670919
STAT,1913,39,na,1952,3708.348798482244
SIM,1835,21,20-24,1856,80
STAT,1880,30,20-24,1910,2.8902094460522916
SIM,1882,76,na,1958,846
SIM,1939,30,40-44,1969,3
SIM,1899,35,20-24,1934,1
STAT,1901,15,25-29,1916,8.060556955824078
STAT,1952,20,na,1972,4439.148489157165
STAT,1845,14,na,1859,2184.696552059916
SIM,1873,93,na,1966,87
SIM,1894,61,na,1955,2608
STAT,1884,41,45-49,1925,1.4973909588592504
SIM,1853,38,35-39,1891,9
SIM,1897,30,25-29,1927,24
SIM,1905,28,50-100,1933,1
SIM,1889,22,30-34,1911,28
STAT,1817,50,45-49,1867,0.031101289775119733
STAT,1903,19,na,1922,3613.383038778415
STAT,1850,8,na,1858,2297.7250929409224
STAT,1913,41,35-39,1954,0.19927194140055396
SIM,1968,1,na,1969,5200
SIM,1862,42,30-34,1904,1
STAT,1843,22,15-19,1865,2.792937622341443
STAT,1903,5,na,1908,3769.5611959625603
SIM,1836,37,35-39,1873,9
STAT,1930,24,35-39,1954,12.11545585797247
STAT,1955,16,50-100,1971,0.5026044671957645
STAT,1831,28,50-100,1859,0.5471070554477351
SIM,1854,31,na,1885,2302
STAT,1866,50,40-44,1916,0.009987289013744259
STAT,1831,32,35-39,1863,8.382470385363293
STAT,1902,39,45-49,1941,0.6079357822526584
STAT,1851,36,50-100,1887,0.9493943543600496
SIM,1843,16,30-34,1859,4
STAT,1896,33,35-39,1929,13.481954302928559
STAT,1849,53,45-49,1902,0.01116439151378024
STAT,1932,1,na,1933,5588.2577146307485
SIM,1867,32,20-24,1899,3
STAT,1830,31,20-24,1861,2.6369727170650044
STAT,1930,39,20-24,1969,0.34679101834291826
SIM,1929,31,25-29,1960,17
STAT,1844,105,na,1949,0.023198051624730744
STAT,1884,49,40-44,1933,0.16695413487698005
STAT,1875,49,15-19,1924,4.062241287256339E-4
SIM,1856,32,45-49,1888,3
STAT,1920,26,30-34,1946,43.55399769694914
STAT,1911,38,na,1949,3647.8772200430117
STAT,1946,23,30-34,1969,32.29261642620549
SIM,1857,21,40-44,1878,1
SIM,1945,3,na,1948,4285
STAT,1878,51,30-34,1929,0.006270839635320503
STAT,1917,39,na,1956,3920.406650823793
STAT,1798,82,na,1880,200.93826570416337
STAT,1932,18,20-24,1950,180.9459632345361
SIM,1853,79,na,1932,445
SIM,1874,47,na,1921,2156
SIM,1947,18,na,1965,4497
STAT,1803,84,na,1887,138.55557560521672
STAT,1929,26,35-39,1955,19.000298522304785
STAT,1824,52,na,1876,1194.02867459972
STAT,1862,35,30-34,1897,4.692713943205764
SIM,1872,26,50-100,1898,5
SIM,1940,18,20-24,1958,132
STAT,1903,29,35-39,1932,13.779949771412072
STAT,1855,108,na,1963,0.007029497663593942
STAT,1819,99,na,1918,0.9627717709148791
STAT,1828,50,20-24,1878,6.754143226127974E-4
SIM,1943,16,35-39,1959,4
STAT,1879,32,20-24,1911,2.8490234373621592
SIM,1902,38,40-44,1940,8
STAT,1907,39,na,1946,3486.5771607098204
SIM,1847,79,na,1926,447
SIM,1888,35,45-49,1923,2
STAT,1914,15,35-39,1929,0.8798380780138897
SIM,1884,47,na,1931,2317
STAT,1845,50,20-24,1895,5.469357467265494E-4
STAT,1950,16,15-19,1966,54.23044130088228
SIM,1888,23,25-29,1911,108
SIM,1838,32,25-29,1870,16
STAT,1886,46,25-29,1932,0.061598631069556764
SIM,1950,16,25-29,1966,65
STAT,1825,52,45-49,1877,0.018779014083699884
SIM,1884,17,30-34,1901,5
SIM,1768,88,na,1856,29
SIM,1865,64,na,1929,1495
STAT,1803,74,na,1877,570.386290937757
STAT,1880,17,35-39,1897,0.5820215480429974
SIM,1851,40,45-49,1891,2
SIM,1885,19,na,1904,2706
STAT,1897,23,25-29,1920,77.27440620453173
SIM,1843,23,20-24,1866,109
STAT,1808,52,45-49,1860,0.04912938367336255
STAT,1849,43,15-19,1892,0.010719258274906955
STAT,1835,23,20-24,1858,68.28565079449976
SIM,1911,26,30-34,1937,4
STAT,1837,50,30-34,1887,0.004240341969478639
STAT,1874,11,na,1885,2716.0035484542286
STAT,1935,16,35-39,1951,5.809900901619261
STAT,1861,43,15-19,1904,0.011506589557322686
STAT,1829,42,35-39,1871,1.4062664700087375
STAT,1910,60,na,1970,3220.3144760597092
STAT,1922,37,20-24,1959,0.30302250239935197
STAT,1917,25,30-34,1942,41.758677903428975
STAT,1926,39,30-34,1965,2.2463829616135094
STAT,1889,43,50-100,1932,1.3061947299935082
STAT,1942,16,25-29,1958,45.73727388560435
SIM,1892,66,na,1958,2343
STAT,1889,30,40-44,1919,5.444334921674137
SIM,1922,15,35-39,1937,8
STAT,1913,39,20-24,1952,0.25983620934743096
STAT,1899,34,15-19,1933,0.19570861321968042
SIM,1842,42,45-49,1884,2
SIM,1837,42,35-39,1879,2
SIM,1826,41,50-100,1867,4
STAT,1848,23,30-34,1871,17.580437575516196
STAT,1907,19,25-29,1926,8.359974980924083
STAT,1835,85,na,1920,205.75099081477762
STAT,1878,72,na,1950,1324.0881900080483
STAT,1962,10,na,1972,5084.022491118577
STAT,1880,11,na,1891,2743.382176870106
STAT,1895,41,20-24,1936,0.014611744274411781
STAT,1948,16,45-49,1964,0.5776643134432277
STAT,1938,31,25-29,1969,9.387548921231696
STAT,1772,112,na,1884,5.639141501503476E-4
STAT,1903,36,40-44,1939,1.3656196500144104
STAT,1777,90,na,1867,21.767824576662868
STAT,1908,18,15-19,1926,8.863286035196388
SIM,1907,34,25-29,1941,11
STAT,1843,40,45-49,1883,1.0663033489731126
STAT,1912,33,30-34,1945,15.574871524398421
SIM,1880,33,35-39,1913,22
STAT,1787,102,na,1889,0.07457974647489052
STAT,1858,42,na,1900,1829.1406290068117
STAT,1854,43,25-29,1897,0.478448868667805
SIM,1915,19,25-29,1934,12
SIM,1892,76,na,1968,1634
STAT,1933,23,20-24,1956,148.99591418435702
SIM,1931,29,20-24,1960,23
STAT,1854,27,35-39,1881,7.591338658391733
SIM,1836,77,na,1913,594
SIM,1852,21,20-24,1873,74
SIM,1896,22,20-24,1918,102
STAT,1848,16,40-44,1864,0.1862168718115625
STAT,1937,34,45-49,1971,1.5696512316618554
SIM,1866,52,50-100,1918,1
STAT,1860,38,15-19,1898,0.04613273853836461
STAT,1912,26,40-44,1938,4.6500341696587775
STAT,1870,33,15-19,1903,0.1406422311113229
SIM,1840,82,na,1922,358
SIM,1880,40,25-29,1920,2
STAT,1834,102,na,1936,0.174506112227765
STAT,1924,26,15-19,1950,0.8334537270685891
SIM,1834,72,na,1906,819
SIM,1813,42,35-39,1855,2
SIM,1898,22,40-44,1920,2
SIM,1941,23,20-24,1964,135
STAT,1881,22,35-39,1903,5.681221820568061
STAT,1844,47,30-34,1891,0.07622957975345843
STAT,1851,24,15-19,1875,2.9403930143572734
STAT,1858,33,15-19,1891,0.1123657371369517
STAT,1909,26,35-39,1935,14.65191638861123
SIM,1946,24,35-39,1970,14
SIM,1894,39,35-39,1933,24
STAT,1830,27,35-39,1857,10.60575210927512
SIM,1846,31,20-24,1877,2
STAT,1843,48,40-44,1891,0.11401801509408507
STAT,1904,49,20-24,1953,0.009606266714518186
STAT,1801,89,na,1890,41.80924675586031
STAT,1862,16,na,1878,2306.6284478028742
SIM,1902,36,30-34,1938,4
STAT,1919,24,na,1943,4012.1977254453946
STAT,1844,21,20-24,1865,68.56717733841313
SIM,1883,43,45-49,1926,4
STAT,1873,25,50-100,1898,0.659430806145754
SIM,1857,45,na,1902,1973
SIM,1920,26,40-44,1946,11
STAT,1924,19,25-29,1943,51.86762376454693
STAT,1923,29,20-24,1952,21.023900381298393
STAT,1872,40,25-29,1912,0.6586391818251973
STAT,1869,51,20-24,1920,7.280731711100684E-4
STAT,1892,43,45-49,1935,1.8831084773332465
SIM,1836,49,50-100,1885,4
STAT,1869,53,30-34,1922,0.005751306253081201
STAT,1878,62,na,1940,1916.293435166298
SIM,1884,24,20-24,1908,4
STAT,1910,20,15-19,1930,5.0735979921894785
SIM,1859,64,na,1923,1657
SIM,1897,30,40-44,1927,12
STAT,1830,41,30-34,1871,1.0131157373680777
STAT,1876,24,20-24,1900,71.41502109170891
STAT,1875,43,45-49,1918,1.5411275961030793
STAT,1938,24,35-39,1962,9.401398507712935
SIM,1917,26,35-39,1943,18
STAT,1862,26,na,1888,2104.356964072634
SIM,1879,33,25-29,1912,14
SIM,1861,37,30-34,1898,6
SIM,1847,34,45-49,1881,1
STAT,1933,16,15-19,1949,61.541683766206944
SIM,1862,27,35-39,1889,12
STAT,1834,66,na,1900,975.5855681634887
STAT,1838,31,20-24,1869,2.2719580354493014
STAT,1820,42,15-19,1862,0.02605663046248945
STAT,1834,24,15-19,1858,2.5901829297085404
SIM,1941,16,15-19,1957,47
STAT,1943,15,30-34,1958,13.057888002220638
STAT,1851,4,na,1855,2453.7834000000003
STAT,1798,88,na,1886,56.45727233507238
STAT,1893,79,na,1972,1396.2544116363442
STAT,1947,21,25-29,1968,105.48410817625376
SIM,1926,40,na,1966,4600
STAT,1853,37,30-34,1890,4.407435746419059
STAT,1830,86,na,1916,146.38055347322992
STAT,1864,11,na,1875,2484.5886578033983
STAT,1839,31,40-44,1870,3.8231609772812667
STAT,1933,23,na,1956,4893.246421485245
STAT,1907,36,25-29,1943,0.9261875289649368
STAT,1858,48,na,1906,1760.3434077652364
STAT,1836,48,35-39,1884,0.09125029738670574
STAT,1860,52,na,1912,1768.2487532109724
SIM,1872,24,25-29,1896,72
STAT,1825,34,15-19,1859,0.2723958413331651
STAT,1860,32,45-49,1892,1.4397459133476327
STAT,1873,6,na,1879,2807.043174814319
STAT,1818,76,na,1894,488.10879001303357
SIM,1875,64,na,1939,1780
STAT,1863,33,25-29,1896,9.127321276424132
STAT,1889,24,30-34,1913,22.04444258120714
STAT,1845,42,20-24,1887,0.11816819353073016
STAT,1910,8,na,1918,3974.1529016832264
SIM,1840,72,na,1912,846
STAT,1903,43,30-34,1946,0.11400663302925101
SIM,1916,20,na,1936,3718
STAT,1806,98,na,1904,1.0952842814893353
SIM,1839,26,na,1865,1821
STAT,1853,45,30-34,1898,0.08084940566399705
STAT,1817,48,15-19,1865,8.465539100336096E-4
SIM,1838,24,25-29,1862,86
STAT,1867,25,na,1892,2285.514420558558
STAT,1946,20,na,1966,4107.214600253996
STAT,1809,99,na,1908,0.8744909635172863
STAT,1873,20,50-100,1893,0.4200317864642107
STAT,1897,15,25-29,1912,7.708733790802398
STAT,1862,42,50-100,1904,0.9203243187316353
STAT,1892,25,15-19,1917,0.5789142346154525
STAT,1793,89,na,1882,37.181911239282805
STAT,1849,35,15-19,1884,0.04586877782482924
SIM,1847,31,40-44,1878,3
STAT,1859,35,25-29,1894,2.3610868693128726
SIM,1861,13,na,1874,2469
STAT,1927,44,30-34,1971,0.16152097454822797
STAT,1911,34,25-29,1945,9.002320859834827
SIM,1837,25,na,1862,1719
STAT,1878,54,35-39,1932,0.00877799439044179
SIM,1913,23,45-49,1936,2
SIM,1914,55,na,1969,3699
STAT,1871,35,25-29,1906,2.9164938650525936
SIM,1907,24,15-19,1931,9
SIM,1816,53,na,1869,1211
SIM,1918,21,na,1939,4116
SIM,1844,21,45-49,1865,1
STAT,1892,34,50-100,1926,1.1512885526830308
STAT,1940,29,20-24,1969,18.77326922183031
STAT,1915,18,20-24,1933,28.55710444231074
STAT,1893,39,40-44,1932,5.55738985769028
STAT,1884,39,15-19,1923,0.055366755720541956
SIM,1897,24,30-34,1921,46
STAT,1946,26,35-39,1972,16.89897509430968
SIM,1906,26,na,1932,3352
SIM,1848,31,40-44,1879,2
STAT,1905,23,45-49,1928,1.0150107532520343
STAT,1862,19,50-100,1881,0.04401290905507129
STAT,1912,19,35-39,1931,0.8514664631937072
STAT,1868,42,na,1910,2228.271896875698
SIM,1814,52,na,1866,1247
SIM,1920,19,35-39,1939,5
STAT,1883,25,na,1908,2374.773836283605
SIM,1874,21,40-44,1895,2
SIM,1937,23,30-34,1960,36
STAT,1852,16,30-34,1868,1.4706329058602814
STAT,1888,22,20-24,1910,82.15138900385621
SIM,1873,21,40-44,1894,1
STAT,1890,65,na,1955,2085.6855376183844
SIM,1860,16,30-34,1876,2
STAT,1897,30,15-19,1927,0.19437834589401176
STAT,1773,112,na,1885,8.11783363407539E-4
STAT,1922,41,50-100,1963,0.1364191754774643
SIM,1860,65,na,1925,1448
STAT,1857,22,45-49,1879,0.6345506083161041
SIM,1845,27,35-39,1872,18
SIM,1864,34,45-49,1898,2
STAT,1827,54,50-100,1881,0.013080745710379371
SIM,1929,24,35-39,1953,17
STAT,1820,45,50-100,1865,0.4305943892697643
SIM,1865,22,45-49,1887,1
STAT,1847,70,na,1917,1050.5336104819721
STAT,1906,27,50-100,1933,0.9410536990239712
STAT,1920,18,30-34,1938,13.773423499507828
STAT,1866,53,45-49,1919,0.013354561549006671
STAT,1923,39,na,1962,4395.123723344521
STAT,1848,96,na,1944,7.010649079045466
SIM,1804,68,na,1872,885
STAT,1856,34,45-49,1890,1.3387612703503873
STAT,1836,21,45-49,1857,0.5847589477260571
STAT,1834,42,45-49,1876,1.0745222424330558
STAT,1883,18,15-19,1901,5.850172152053042
SIM,1923,18,20-24,1941,149
STAT,1866,21,40-44,1887,1.9789674143762854
STAT,1900,66,na,1966,2565.547027293172
SIM,1903,33,30-34,1936,22
SIM,1861,9,na,1870,2515
SIM,1890,47,na,1937,3067
SIM,1853,35,30-34,1888,6
STAT,1849,7,na,1856,2382.059087298
STAT,1865,32,45-49,1897,1.6082504841814411
STAT,1855,32,35-39,1887,7.761637686308006
STAT,1918,15,20-24,1933,30.028283252560776
SIM,1830,42,35-39,1872,2
SIM,1855,46,50-100,1901,1
SIM,1829,31,20-24,1860,3
STAT,1879,10,na,1889,2747.6499435867768
SIM,1875,49,40-44,1924,3
STAT,1830,34,25-29,1864,9.516870165199583
STAT,1837,43,25-29,1880,0.5103663755066281
SIM,1928,28,50-100,1956,2
STAT,1866,77,na,1943,808.4076904026879
STAT,1826,48,40-44,1874,0.16642063955207115
STAT,1865,21,40-44,1886,1.9592336752495747
STAT,1872,1,na,1873,3553.9206428854022
STAT,1898,23,45-49,1921,0.9518285450181594
SIM,1946,16,35-39,1962,6
SIM,1941,26,25-29,1967,92
STAT,1881,82,na,1963,686.8953196075943
STAT,1849,44,na,1893,1782.6577197264367
STAT,1933,26,25-29,1959,88.35456301256377
SIM,1841,20,na,1861,2060
STAT,1929,23,30-34,1952,36.62261776230653
SIM,1856,23,30-34,1879,21
STAT,1914,56,na,1970,3539.126127898014
STAT,1867,49,40-44,1916,0.15944902628235802
STAT,1912,6,na,1918,4075.6156961579836
SIM,1917,39,30-34,1956,3
STAT,1843,43,na,1886,1584.5873868167475
STAT,1866,35,15-19,1901,0.05301634101615482
STAT,1887,83,na,1970,843.2325372073371
SIM,1785,84,na,1869,75
STAT,1921,38,na,1959,4238.434717658243
SIM,1842,46,50-100,1888,1
STAT,1839,44,na,1883,1683.329124830213
STAT,1822,42,35-39,1864,2.8809689039531503
STAT,1864,24,25-29,1888,52.25338193819455
STAT,1927,37,40-44,1964,1.8812044875138187
SIM,1916,20,45-49,1936,2
SIM,1890,48,50-100,1938,1
STAT,1845,105,na,1950,0.021424205124948657
STAT,1904,18,45-49,1922,0.09443160627615566
SIM,1925,25,30-34,1950,72
SIM,1819,37,35-39,1856,17
SIM,1888,40,25-29,1928,1
STAT,1917,49,30-34,1966,0.09343669691976401
SIM,1934,17,na,1951,5073
STAT,1930,20,50-100,1950,0.8570596114390295
SIM,1845,43,25-29,1888,3
SIM,1863,79,na,1942,554
STAT,1783,90,na,1873,31.072480797449387
SIM,1811,54,na,1865,1377
SIM,1899,39,na,1938,3543
STAT,1850,19,15-19,1869,5.487679732496952
STAT,1878,28,35-39,1906,10.080855114893545
STAT,1861,68,na,1929,1282.5858161100566
SIM,1897,17,40-44,1914,2
SIM,1836,36,na,1872,1954
SIM,1876,12,na,1888,3007
SIM,1886,28,35-39,1914,16
STAT,1889,17,40-44,1906,0.22778640677420073
STAT,1851,78,na,1929,591.6155869916831
STAT,1908,20,45-49,1928,1.050419823692572
SIM,1801,54,na,1855,968
STAT,1783,105,na,1888,0.022200452254646806
STAT,1909,39,30-34,1948,1.7233027024473033
STAT,1949,7,na,1956,4618.352315845577
SIM,1933,16,25-29,1949,83
STAT,1793,73,na,1866,484.7222462157576
STAT,1905,38,na,1943,3449.9012165911017
SIM,1827,29,40-44,1856,2
STAT,1773,90,na,1863,29.935183243395613
SIM,1820,36,30-34,1856,6
STAT,1902,38,30-34,1940,1.6336944446138078
STAT,1852,23,20-24,1875,61.63984421902388
STAT,1826,47,na,1873,1401.762492075951
STAT,1880,40,30-34,1920,1.2317700067111357
STAT,1867,27,30-34,1894,23.953575115374274
STAT,1926,30,50-100,1956,1.0115413252980616
STAT,1862,57,na,1919,1752.8409593037381
STAT,1796,87,na,1883,56.24310122022542
SIM,1888,32,40-44,1920,12
STAT,1840,53,50-100,1893,0.0104168578915143
STAT,1841,51,35-39,1892,0.006468782951641689
STAT,1874,8,na,1882,2781.151114280812
STAT,1945,19,45-49,1964,0.5507190390901658
SIM,1934,30,50-100,1964,1
SIM,1910,38,30-34,1948,5
STAT,1875,82,na,1957,553.5330836040795
STAT,1839,42,45-49,1881,1.1183289216815202
STAT,1843,45,50-100,1888,0.16915633153306925
STAT,1905,42,na,1947,3382.118707966719
STAT,1925,16,25-29,1941,53.03434122034787
STAT,1934,16,15-19,1950,62.17796495072264
SIM,1888,20,20-24,1908,93
STAT,1952,16,35-39,1968,5.081976325855
SIM,1855,41,40-44,1896,5
STAT,1858,49,15-19,1907,3.103366010494338E-4
STAT,1876,67,na,1943,1653.1332281655366
SIM,1915,16,20-24,1931,30
STAT,1923,23,na,1946,4279.900387767165
SIM,1847,42,45-49,1889,2
SIM,1865,33,na,1898,2154
SIM,1871,33,25-29,1904,7
SIM,1878,26,35-39,1904,11
SIM,1896,32,na,1928,3146
STAT,1886,43,20-24,1929,0.16813370751846105
SIM,1839,32,45-49,1871,1
STAT,1876,43,50-100,1919,1.0937548630795673
STAT,1842,17,15-19,1859,6.861219728685014
STAT,1898,55,na,1953,2831.131544499772
SIM,1863,32,35-39,1895,11
SIM,1814,68,na,1882,801
SIM,1887,35,25-29,1922,7
STAT,1908,56,na,1964,3228.9167572418833
STAT,1845,35,30-34,1880,4.590673023409412
STAT,1938,16,35-39,1954,4.188980369999307
STAT,1910,29,25-29,1939,63.6672255216757
SIM,1846,8,na,1854,2289
SIM,1899,27,50-100,1926,2
SIM,1884,43,50-100,1927,1
SIM,1881,33,na,1914,2128
SIM,1910,35,na,1945,3416
SIM,1850,17,15-19,1867,6
STAT,1879,35,25-29,1914,3.063493975272367
STAT,1943,23,30-34,1966,30.865738874563643
STAT,1819,52,20-24,1871,0.0013816237029772444
STAT,1830,70,na,1900,925.6639229841147
STAT,1878,44,25-29,1922,0.6641846902839227
STAT,1956,15,40-44,1971,1.8707113697875628
SIM,1879,25,25-29,1904,57
STAT,1830,24,30-34,1854,37.51798659927782
STAT,1907,15,45-49,1922,0.09733831608364643
STAT,1911,37,45-49,1948,0.6642978741599999
SIM,1917,23,30-34,1940,38
SIM,1861,43,50-100,1904,1
SIM,1938,25,40-44,1963,9
SIM,1886,44,25-29,1930,3
STAT,1912,36,35-39,1948,2.393200754535716
STAT,1895,10,na,1905,3416.545126994049
STAT,1919,45,35-39,1964,0.14185993109214556
STAT,1847,41,40-44,1888,1.7153451396368622
STAT,1929,24,na,1953,4638.389687743751
SIM,1902,28,30-34,1930,7
SIM,1922,20,na,1942,4756
STAT,1891,47,50-100,1938,0.1724321615073253
STAT,1767,90,na,1857,22.262703974994004
STAT,1884,23,15-19,1907,3.275658288609429
SIM,1880,30,30-34,1910,27
STAT,1936,19,50-100,1955,0.36018418938213737
STAT,1908,26,15-19,1934,0.6817188506056656
STAT,1919,29,45-49,1948,1.871263870284469
STAT,1949,19,30-34,1968,14.311846833145813
STAT,1838,34,25-29,1872,8.345001796256025
STAT,1838,96,na,1934,5.74813590330471
STAT,1847,43,50-100,1890,0.7852906055351341
STAT,1845,15,50-100,1860,0.04578287911602372
STAT,1882,22,50-100,1904,0.39896075426855676
STAT,1877,25,na,1902,2504.6453072122454
STAT,1935,37,30-34,1972,2.574872090167374
SIM,1890,31,na,1921,3213
SIM,1892,23,15-19,1915,5
STAT,1880,17,50-100,1897,0.051966200018594685
SIM,1920,36,35-39,1956,4
STAT,1872,30,30-34,1902,17.871469633321816
STAT,1909,49,40-44,1958,0.14533638028999227
STAT,1781,88,na,1869,25.970468257064034
STAT,1852,26,na,1878,1924.7017729562526
STAT,1928,4,na,1932,5140.447937519826
SIM,1848,21,30-34,1869,25
STAT,1842,71,na,1913,1201.767362793151
STAT,1848,33,40-44,1881,3.718704733948576
STAT,1898,29,15-19,1927,0.6167735665009185
STAT,1909,23,30-34,1932,26.87218962279717
STAT,1874,42,na,1916,2387.317304107941
STAT,1894,46,30-34,1940,0.0712041415097273
SIM,1849,37,30-34,1886,6
STAT,1912,29,45-49,1941,1.7053603241189295
SIM,1872,50,na,1922,2419
SIM,1894,36,30-34,1930,15
STAT,1858,29,50-100,1887,0.5114699577434129
SIM,1911,30,50-100,1941,5
SIM,1920,29,45-49,1949,3
STAT,1892,40,40-44,1932,2.8794498325989286
STAT,1917,23,na,1940,3905.519284286295
STAT,1844,24,25-29,1868,55.740653512103215
STAT,1876,37,15-19,1913,0.05856038842386204
STAT,1819,45,30-34,1864,0.19433695242965612
SIM,1852,24,25-29,1876,56
STAT,1858,51,45-49,1909,0.011554462632687843
STAT,1896,32,50-100,1928,1.2249481057484308
SIM,1846,34,25-29,1880,8
STAT,1837,59,na,1896,1325.7915531435697
STAT,1787,89,na,1876,31.742577069669945
STAT,1837,53,35-39,1890,0.005778966532284049
SIM,1856,33,40-44,1889,7
STAT,1873,25,na,1898,2460.1620588532096
STAT,1809,46,15-19,1855,0.0014943782760178388
STAT,1886,36,30-34,1922,5.710779071473412
STAT,1822,32,25-29,1854,31.538063531539922
STAT,1906,22,50-100,1928,0.5999018897059469
SIM,1900,15,15-19,1915,6
STAT,1882,52,35-39,1934,0.008377814007332514
SIM,1807,70,na,1877,578
SIM,1902,61,na,1963,2947
SIM,1907,26,25-29,1933,87
SIM,1914,20,25-29,1934,107
STAT,1925,20,45-49,1945,1.3692401803052663
SIM,1902,34,25-29,1936,3
STAT,1912,16,30-34,1928,2.492749982810648
STAT,1903,46,35-39,1949,0.11391639600099064
STAT,1862,38,35-39,1900,6.138546744463335
SIM,1837,25,35-39,1862,15
STAT,1813,46,na,1859,1367.9989917695511
SIM,1888,27,40-44,1915,4
SIM,1854,65,na,1919,1480
STAT,1896,16,35-39,1912,0.7353825743383882
STAT,1857,31,40-44,1888,3.475397431101027
STAT,1917,21,15-19,1938,5.727918310435342
STAT,1906,47,15-19,1953,3.3038219747281945E-4
STAT,1864,22,35-39,1886,5.403905673594053
SIM,1877,35,50-100,1912,1
STAT,1835,36,15-19,1871,0.05267020505861485
STAT,1882,24,45-49,1906,0.6779520301068375
SIM,1847,33,30-34,1880,22
SIM,1833,54,50-100,1887,1
SIM,1916,21,20-24,1937,126
STAT,1863,50,25-29,1913,0.0032152611699638946
STAT,1801,53,20-24,1854,0.0027287308952104582
STAT,1812,88,na,1900,62.32826751070881
SIM,1870,27,na,1897,2575
SIM,1864,85,na,1949,241
SIM,1862,5,na,1867,2551
STAT,1872,7,na,1879,2770.9480118849
SIM,1837,83,na,1920,261
STAT,1946,24,45-49,1970,1.2637603214576232
STAT,1951,18,40-44,1969,1.6822807580615096
SIM,1929,35,40-44,1964,2
SIM,1843,31,20-24,1874,2
STAT,1850,21,45-49,1871,0.6455080724174774
STAT,1885,10,na,1895,2604.1524518944975
STAT,1922,44,na,1966,4292.12324850836
SIM,1872,22,35-39,1894,9
STAT,1827,38,50-100,1865,1.3949941339131477
STAT,1909,48,45-49,1957,0.20096787027358476
STAT,1908,18,na,1926,3772.007418002426
STAT,1869,95,na,1964,39.81226768858724
STAT,1824,83,na,1907,197.3624092351088
SIM,1916,35,30-34,1951,2
STAT,1829,25,35-39,1854,25.277419565624104
SIM,1895,18,35-39,1913,1
STAT,1857,24,35-39,1881,4.763127192548321
SIM,1925,34,na,1959,4499
SIM,1870,38,35-39,1908,19
STAT,1877,22,45-49,1899,0.7269042680826961
STAT,1909,45,50-100,1954,0.21174218516386437
STAT,1873,18,40-44,1891,0.1867855280607116
SIM,1890,24,45-49,1914,1
STAT,1885,25,25-29,1910,42.815732806017934
SIM,1834,33,20-24,1867,2
STAT,1904,15,50-100,1919,0.07133967190852784
STAT,1882,77,na,1959,982.3642913897429
SIM,1815,49,50-100,1864,2
STAT,1863,30,20-24,1893,2.438383390829362
STAT,1874,21,30-34,1895,18.476893274239934
SIM,1908,36,35-39,1944,2
SIM,1908,55,na,1963,3095
STAT,1835,31,20-24,1866,2.6108705820247073
STAT,1899,38,30-34,1937,1.586640487298494
SIM,1902,39,35-39,1941,8
STAT,1910,59,na,1969,3251.8903311754234
SIM,1875,23,15-19,1898,3
STAT,1821,65,na,1886,1020.4350137139031
STAT,1904,38,15-19,1942,0.017480499953931326
SIM,1850,65,na,1915,1355
STAT,1800,70,na,1870,592.018139596461
STAT,1888,55,na,1943,2464.9454966650787
STAT,1821,51,30-34,1872,0.008560309600595756
SIM,1865,24,35-39,1889,10
SIM,1877,16,25-29,1893,9
STAT,1825,31,na,1856,2131.2489571484175
STAT,1838,44,50-100,1882,0.7335961267585313
STAT,1893,15,na,1908,3253.9906549923294
STAT,1877,42,15-19,1919,0.014377964956509006
SIM,1909,37,30-34,1946,4
SIM,1882,12,na,1894,2316
STAT,1893,24,20-24,1917,87.82298988922221
STAT,1867,23,15-19,1890,3.1284072415299295
STAT,1858,11,na,1869,2219.7350878727057
STAT,1793,83,na,1876,132.33492251708242
STAT,1804,54,35-39,1858,0.022391518385570568
STAT,1889,34,40-44,1923,5.354681012511669
STAT,1838,32,35-39,1870,8.424009885092575
STAT,1932,37,15-19,1969,0.02607459903634304
STAT,1908,35,30-34,1943,1.7389156893932425
STAT,1809,48,40-44,1857,0.5884869639147148
STAT,1919,42,30-34,1961,0.13988480695989325
SIM,1879,22,20-24,1901,98
STAT,1837,24,50-100,1861,0.35897553060812676
STAT,1887,18,35-39,1905,0.6171285176705774
STAT,1898,20,40-44,1918,2.870192965249489
STAT,1936,20,20-24,1956,107.39886723263666
STAT,1899,30,35-39,1929,14.150488005279064
STAT,1893,18,na,1911,3230.4560296323048
STAT,1894,62,na,1956,2401.0348672422456
SIM,1828,27,35-39,1855,12
STAT,1841,23,45-49,1864,0.6558520570309068
STAT,1799,74,na,1873,465.40518079143436
STAT,1870,45,na,1915,2253.611385005458
STAT,1833,50,na,1883,1633.1877183664765
STAT,1845,78,na,1923,570.9089035236631
STAT,1867,28,50-100,1895,0.606347541715131
SIM,1893,25,25-29,1918,71
SIM,1946,8,na,1954,4461
STAT,1908,21,20-24,1929,103.503116014466
STAT,1911,15,35-39,1926,0.8510801509551119
SIM,1786,76,na,1862,340
SIM,1869,30,na,1899,2304
SIM,1902,34,40-44,1936,5
SIM,1775,91,na,1866,18
STAT,1808,83,na,1891,149.6670728397004
SIM,1832,53,na,1885,1310
STAT,1844,35,na,1879,2009.0810493154847
SIM,1932,19,na,1951,5942
STAT,1876,32,20-24,1908,2.818865733792889
SIM,1881,64,na,1945,1578
SIM,1845,13,na,1858,2397
STAT,1867,5,na,1872,2687.07088359669
SIM,1920,16,30-34,1936,23
STAT,1855,78,na,1933,588.1254129190723
SIM,1942,16,15-19,1958,45
SIM,1933,20,45-49,1953,2
STAT,1793,80,na,1873,249.6582064766443
STAT,1863,97,na,1960,9.812299769002099
STAT,1920,24,25-29,1944,103.0497474687365
SIM,1879,31,35-39,1910,22
SIM,1826,34,25-29,1860,23
SIM,1826,46,na,1872,1835
SIM,1847,26,40-44,1873,4
STAT,1942,26,50-100,1968,1.0552422567881412
SIM,1851,20,na,1871,2167
STAT,1845,19,40-44,1864,0.16693128785121833
SIM,1866,40,40-44,1906,2
STAT,1843,26,30-34,1869,21.05347679237521
STAT,1945,17,na,1962,4060.5731968679693
SIM,1862,43,25-29,1905,3
STAT,1876,39,40-44,1915,4.519102736110634
STAT,1867,39,15-19,1906,0.052877847527158385
STAT,1826,40,45-49,1866,1.6249840325470983
SIM,1887,58,na,1945,2076
STAT,1784,105,na,1889,0.01819026714001027
SIM,1925,21,15-19,1946,5
STAT,1889,10,na,1899,3225.9769642645906
SIM,1846,32,35-39,1878,11
STAT,1867,51,50-100,1918,0.014434802603404401
STAT,1837,40,20-24,1877,0.1311653510317518
STAT,1839,33,30-34,1872,15.075772449385578
SIM,1865,31,40-44,1896,8
STAT,1821,44,25-29,1865,0.9668195839324843
SIM,1851,26,30-34,1877,47
SIM,1860,23,20-24,1883,72
SIM,1944,20,20-24,1964,5
STAT,1855,15,35-39,1870,0.4970902905944136
SIM,1884,39,40-44,1923,8
STAT,1939,26,45-49,1965,1.7541164453740326
STAT,1863,43,35-39,1906,1.6087727458905947
STAT,1833,22,40-44,1855,1.989118607381165
SIM,1855,28,40-44,1883,3
SIM,1916,28,40-44,1944,4
STAT,1852,28,15-19,1880,0.3978916919167011
STAT,1902,36,40-44,1938,1.3550308732155514
STAT,1839,26,40-44,1865,2.6948266046061913
STAT,1893,31,45-49,1924,2.2454890496236515
SIM,1907,28,30-34,1935,55
STAT,1930,28,15-19,1958,0.9068414555130053
SIM,1826,53,na,1879,1657
SIM,1850,37,50-100,1887,1
STAT,1897,21,35-39,1918,7.92543871469632
STAT,1916,16,15-19,1932,9.74087950449346
SIM,1838,44,45-49,1882,2
STAT,1934,25,30-34,1959,53.30622731671778
SIM,1847,83,na,1930,228
STAT,1905,37,20-24,1942,0.24293227434401768
STAT,1931,39,20-24,1970,0.35208306959872937
SIM,1891,42,50-100,1933,1
STAT,1866,18,15-19,1884,5.663260061200347
SIM,1834,26,30-34,1860,5
SIM,1933,28,40-44,1961,5
STAT,1856,26,40-44,1882,2.4210234602085916
SIM,1901,29,25-29,1930,74
STAT,1898,32,40-44,1930,5.937870255681802
STAT,1863,17,35-39,1880,0.560316206162118
STAT,1889,20,15-19,1909,4.133099529180662
STAT,1897,35,45-49,1932,2.7249337805634424
STAT,1906,24,40-44,1930,3.046307880394218
STAT,1827,50,na,1877,1446.471188631776
STAT,1836,41,15-19,1877,0.010497472296150463
STAT,1845,53,25-29,1898,0.002546544673881049
SIM,1950,18,15-19,1968,48
STAT,1893,17,30-34,1910,2.044044285812948
STAT,1910,15,50-100,1925,0.07524614271641226
SIM,1951,4,na,1955,4993
STAT,1878,41,20-24,1919,0.1672616916629848
STAT,1905,3,na,1908,3859.97209581858
SIM,1906,20,na,1926,3270
SIM,1839,41,40-44,1880,6
SIM,1856,50,na,1906,2024
SIM,1816,91,na,1907,28
SIM,1933,18,15-19,1951,85
SIM,1868,78,na,1946,622
STAT,1835,38,40-44,1873,4.021492025439384
STAT,1948,17,20-24,1965,156.73422831542268
SIM,1843,38,40-44,1881,5
STAT,1865,23,30-34,1888,16.507791899888318
SIM,1943,15,20-24,1958,129
SIM,1910,36,40-44,1946,1
SIM,1869,21,15-19,1890,5
STAT,1821,37,35-39,1858,13.940796356867107
STAT,1846,23,50-100,1869,0.3790966660299956
STAT,1956,4,na,1960,5256.90611629619
STAT,1847,28,40-44,1875,2.6764827116369023
STAT,1861,26,15-19,1887,0.38632379961210755
STAT,1831,65,na,1896,1061.9733010453017
STAT,1879,33,35-39,1912,10.628881814436234
SIM,1873,37,50-100,1910,1
STAT,1941,21,na,1962,3811.3064663067116
SIM,1829,32,35-39,1861,18
SIM,1928,34,45-49,1962,3
STAT,1920,29,35-39,1949,16.51260745195865
SIM,1867,38,na,1905,2112
STAT,1849,50,40-44,1899,0.008349357206640056
STAT,1813,52,35-39,1865,0.023806610917479473
SIM,1924,16,15-19,1940,47
SIM,1786,69,na,1855,663
STAT,1914,39,20-24,1953,0.26288023537199234
STAT,1926,26,35-39,1952,18.252109114662257
SIM,1867,35,25-29,1902,2
SIM,1859,32,45-49,1891,2
STAT,1859,37,50-100,1896,0.9973391246751462
SIM,1856,60,na,1916,1703
STAT,1812,98,na,1910,1.4748736076196727
STAT,1880,43,35-39,1923,1.9068741216872336
SIM,1890,5,na,1895,3549
STAT,1916,28,15-19,1944,0.7340300920380125
STAT,1868,44,15-19,1912,0.013150565715246124
SIM,1942,25,30-34,1967,50
STAT,1863,53,50-100,1916,0.013298293414854258
SIM,1864,26,40-44,1890,2
STAT,1925,28,40-44,1953,5.544084289221851
SIM,1829,38,40-44,1867,10
STAT,1849,75,na,1924,804.8879037015728
STAT,1911,17,25-29,1928,8.748780973081724
SIM,1907,23,20-24,1930,126
STAT,1882,16,40-44,1898,0.1793822485296021
SIM,1875,26,na,1901,2349
SIM,1907,15,na,1922,3988
STAT,1884,27,30-34,1911,25.08104629950034
STAT,1898,25,35-39,1923,13.301027884531637
SIM,1873,23,30-34,1896,1
SIM,1924,23,20-24,1947,185
SIM,1860,30,45-49,1890,1
STAT,1826,33,20-24,1859,3.581177414168622
STAT,1900,45,20-24,1945,0.009591662785835979
STAT,1930,41,35-39,1971,0.26817481514294683
STAT,1934,35,50-100,1969,0.5864433187738992
STAT,1781,95,na,1876,1.4624955259043948
STAT,1837,27,35-39,1864,8.448818591125752
SIM,1864,20,35-39,1884,11
SIM,1887,33,35-39,1920,14
STAT,1918,44,50-100,1962,0.1256827117871551
STAT,1858,52,50-100,1910,0.01190350843723392
STAT,1863,63,na,1926,1596.7556128196034
STAT,1909,45,25-29,1954,0.04965940463924329
STAT,1928,32,na,1960,4779.94573177858
SIM,1938,21,25-29,1959,8
STAT,1851,31,50-100,1882,0.7296272212299391
STAT,1931,27,20-24,1958,23.817584188690567
STAT,1935,15,20-24,1950,188.12524751482727
SIM,1843,40,50-100,1883,1
SIM,1947,19,20-24,1966,165
SIM,1895,40,na,1935,3170
STAT,1939,19,20-24,1958,136.90958617440887
SIM,1829,33,50-100,1862,1
STAT,1854,54,50-100,1908,0.011022721749313272
SIM,1879,23,na,1902,2730
STAT,1847,21,20-24,1868,63.71074616790829
SIM,1915,34,na,1949,4189
SIM,1875,34,20-24,1909,2
STAT,1831,54,45-49,1885,0.00916631691799645
SIM,1862,50,na,1912,1992
SIM,1942,18,40-44,1960,2
STAT,1854,53,35-39,1907,0.00635724522445888
STAT,1919,49,15-19,1968,4.0105046618273414E-4
STAT,1867,34,20-24,1901,2.549195075536182
SIM,1839,34,35-39,1873,2
STAT,1826,38,15-19,1864,0.06308625645894232
STAT,1828,76,na,1904,615.0138680653195
SIM,1871,43,35-39,1914,5
STAT,1877,49,35-39,1926,0.14289216432345958
STAT,1916,23,20-24,1939,117.22178301480429
STAT,1847,44,45-49,1891,1.105464059121065
STAT,1942,18,15-19,1960,47.8701852242933
SIM,1838,21,20-24,1859,2
STAT,1852,30,45-49,1882,1.398025594724779
STAT,1894,49,35-39,1943,0.10054556010822435
STAT,1893,29,15-19,1922,0.5776883865153668
STAT,1925,18,15-19,1943,55.2596277675867
STAT,1897,43,50-100,1940,0.0986191278970995
STAT,1934,18,40-44,1952,1.906623534167757
SIM,1828,46,50-100,1874,2
STAT,1883,15,na,1898,2507.834580143442
SIM,1864,27,na,1891,2567
SIM,1914,24,40-44,1938,5
STAT,1841,49,20-24,1890,0.008786409287690831
STAT,1892,30,na,1922,3048.6712060200152
STAT,1900,29,50-100,1929,0.8910809876115796
STAT,1842,20,40-44,1862,2.4006972242975095
SIM,1947,20,50-100,1967,4
STAT,1880,50,25-29,1930,0.003811040642707976
STAT,1926,45,25-29,1971,0.06646100987372512
STAT,1874,36,50-100,1910,1.2758300136390608
STAT,1846,17,35-39,1863,0.5230913832921652
STAT,1862,42,20-24,1904,0.13834941002833787
SIM,1854,17,35-39,1871,4
SIM,1855,44,45-49,1899,2
STAT,1861,21,20-24,1882,59.84779127531458
SIM,1896,29,40-44,1925,3
STAT,1843,38,15-19,1881,0.0398200686074422
STAT,1888,29,40-44,1917,3.5455237800296
STAT,1911,24,15-19,1935,5.061430953546826
SIM,1889,32,40-44,1921,11
STAT,1852,38,40-44,1890,3.3033963604400483
SIM,1844,65,na,1909,1138
STAT,1921,21,50-100,1942,0.7528782884399379
SIM,1878,21,25-29,1899,90
SIM,1967,2,na,1969,5080
STAT,1857,63,na,1920,1406.467705826019
STAT,1865,16,40-44,1881,0.17485511102678597
STAT,1920,24,40-44,1944,3.7511342517490895
SIM,1875,27,30-34,1902,41
SIM,1916,24,25-29,1940,99
STAT,1882,21,40-44,1903,2.0448442872947
SIM,1897,11,na,1908,3591
STAT,1835,34,25-29,1869,9.589842486892357
STAT,1885,27,15-19,1912,0.4561242792451853
SIM,1816,84,na,1900,114
STAT,1917,36,35-39,1953,2.5480691571737166
STAT,1934,21,15-19,1955,7.230719908845902
STAT,1816,48,50-100,1864,0.6256786468282929
SIM,1870,35,30-34,1905,13
SIM,1841,21,45-49,1862,3
SIM,1944,1,na,1945,4444
STAT,1926,35,15-19,1961,0.02376037172650711
STAT,1869,54,25-29,1923,0.0033824639047372136
STAT,1885,22,20-24,1907,69.28032984818083
SIM,1937,24,45-49,1961,1
SIM,1817,79,na,1896,341
STAT,1839,22,25-29,1861,52.14766415850204
SIM,1908,33,30-34,1941,20
SIM,1900,19,30-34,1919,3
STAT,1836,64,na,1900,1096.0766776436506
STAT,1927,30,20-24,1957,3.036129374473547
SIM,1855,21,20-24,1876,108
SIM,1908,38,25-29,1946,1
STAT,1821,41,20-24,1862,0.26066160223726575
STAT,1921,34,35-39,1955,10.183140804973894
SIM,1865,21,30-34,1886,25
SIM,1901,32,50-100,1933,1
STAT,1865,33,40-44,1898,3.98268466764959
STAT,1867,56,na,1923,1940.144592198649
SIM,1851,33,20-24,1884,3
SIM,1890,21,40-44,1911,3
STAT,1834,53,50-100,1887,0.009041562512118302
SIM,1806,91,na,1897,5
SIM,1920,22,25-29,1942,115
STAT,1848,54,50-100,1902,0.011991679445184427
SIM,1843,34,25-29,1877,2
STAT,1857,34,45-49,1891,1.3627895389692584
SIM,1856,54,50-100,1910,1
SIM,1942,21,15-19,1963,10
STAT,1810,105,na,1915,0.015227988306926607
STAT,1901,45,na,1946,3217.8095711130986
STAT,1949,22,20-24,1971,131.08179174865853
SIM,1865,41,35-39,1906,1
SIM,1847,45,na,1892,1701
SIM,1928,24,35-39,1952,14
SIM,1892,27,30-34,1919,6
STAT,1818,83,na,1901,204.53039299577165
STAT,1901,19,40-44,1920,0.25757588141762267
SIM,1875,41,45-49,1916,3
STAT,1818,36,15-19,1854,0.18241091186369793
STAT,1851,28,30-34,1879,22.165012062222466
STAT,1898,22,30-34,1920,24.38873424233786
SIM,1885,26,na,1911,2567
STAT,1923,47,15-19,1970,4.35406392236872E-4
STAT,1860,30,50-100,1890,0.7625573285761696
SIM,1935,30,20-24,1965,4
STAT,1799,67,na,1866,760.4431926624837
STAT,1894,58,na,1952,2571.5399473696816
STAT,1923,29,50-100,1952,1.1463909039842963
STAT,1771,95,na,1866,1.9550707035662067
STAT,1909,45,40-44,1954,0.14759878716012848
STAT,1812,51,na,1863,1313.7514339869447
STAT,1881,28,50-100,1909,0.6205902186159065
SIM,1824,48,50-100,1872,4
STAT,1856,20,35-39,1876,5.324207815274535
SIM,1869,26,na,1895,2316
STAT,1867,41,45-49,1908,1.4300785693630298
SIM,1848,31,na,1879,1963
STAT,1804,69,na,1873,655.6540401870678
SIM,1859,30,na,1889,2238
STAT,1907,38,50-100,1945,0.3911021242412055
STAT,1880,45,na,1925,2410.2214068326202
SIM,1874,78,na,1952,807
SIM,1785,91,na,1876,1
SIM,1839,31,30-34,1870,22
SIM,1866,12,na,1878,2763
SIM,1931,29,50-100,1960,1
SIM,1875,29,20-24,1904,11
STAT,1949,1,na,1950,4812.625935734029
SIM,1934,28,25-29,1962,100
STAT,1935,35,40-44,1970,2.118560857965425
SIM,1933,18,30-34,1951,31
STAT,1834,35,na,1869,1619.0039431227478
STAT,1887,15,30-34,1902,1.8056710330951622
SIM,1917,25,20-24,1942,1
SIM,1937,18,na,1955,3482
STAT,1911,35,50-100,1946,0.41301134998057276
STAT,1903,26,30-34,1929,36.34628282385326
STAT,1783,80,na,1863,257.7985820897839
SIM,1836,46,na,1882,1780
STAT,1943,26,35-39,1969,16.15227907285453
STAT,1804,51,30-34,1855,0.016448869635573897
STAT,1856,21,50-100,1877,0.3693906793745296
STAT,1861,78,na,1939,655.757004352293
STAT,1939,23,40-44,1962,3.4078235428187136
STAT,1871,42,30-34,1913,1.1521846600514105
STAT,1877,53,20-24,1930,7.568736529267229E-4
STAT,1853,49,na,1902,1821.7183302164617
SIM,1879,42,40-44,1921,3
SIM,1844,37,50-100,1881,1
STAT,1786,94,na,1880,4.390578821695104
STAT,1843,33,20-24,1876,2.169106846669109
STAT,1925,18,30-34,1943,14.841330972107269
STAT,1854,40,20-24,1894,0.1203896867517063
STAT,1908,31,15-19,1939,0.1229459003024671
STAT,1932,17,45-49,1949,0.6684644455762847
SIM,1833,32,na,1865,1927
SIM,1847,22,25-29,1869,55
STAT,1908,24,25-29,1932,85.18461308331176
STAT,1876,35,25-29,1911,3.0310660415527164
STAT,1895,44,25-29,1939,0.05802223299859028
STAT,1841,20,40-44,1861,2.0027148027733928
STAT,1885,44,15-19,1929,0.013696140916481983
STAT,1927,27,50-100,1954,1.223061206452905
SIM,1935,27,50-100,1962,1
STAT,1908,28,40-44,1936,4.432232235059332
STAT,1865,37,50-100,1902,1.132293133250643
STAT,1911,38,40-44,1949,1.451498168220027
SIM,1891,31,35-39,1922,19
STAT,1874,24,35-39,1898,5.997212648736038
SIM,1874,85,na,1959,417
STAT,1776,115,na,1891,1.0270543922403769E-4
STAT,1844,26,15-19,1870,0.44260835741556864
STAT,1835,24,na,1859,2102.492867463397
SIM,1905,3,na,1908,3962
SIM,1796,90,na,1886,24
STAT,1862,31,15-19,1893,0.12471846862253237
STAT,1836,37,50-100,1873,0.9506728238577506
STAT,1872,52,40-44,1924,0.01063308685460455
STAT,1891,44,na,1935,2851.14324946104
STAT,1809,68,na,1877,857.6891558627121
STAT,1849,34,na,1883,1925.6204437222368
SIM,1871,30,20-24,1901,2
STAT,1886,29,na,1915,2526.782287551884
STAT,1821,34,30-34,1855,44.04163720604311
STAT,1909,25,20-24,1934,17.87375093081656
SIM,1829,64,na,1893,1183
SIM,1889,77,na,1966,1088
STAT,1924,18,na,1942,4417.626173255305
SIM,1770,92,na,1862,7
SIM,1906,25,45-49,1931,1
STAT,1885,26,50-100,1911,0.6453138641158421
SIM,1824,40,35-39,1864,3
STAT,1876,77,na,1953,901.4252493217907
SIM,1895,15,30-34,1910,2
STAT,1853,12,na,1865,2374.8212104185914
SIM,1826,31,20-24,1857,3
STAT,1885,48,30-34,1933,0.09609390427008892
SIM,1893,26,50-100,1919,1
SIM,1893,22,20-24,1915,1
SIM,1928,17,45-49,1945,1
SIM,1874,18,15-19,1892,6
STAT,1864,28,40-44,1892,2.7205085037100747
STAT,1867,63,na,1930,1697.2693186991412
SIM,1851,13,na,1864,2383
STAT,1825,38,30-34,1863,8.44420377751028
STAT,1883,31,35-39,1914,10.0502060818397
STAT,1865,20,50-100,1885,0.386184510813326
SIM,1821,47,na,1868,1308
SIM,1939,17,20-24,1956,150
SIM,1901,24,30-34,1925,39
STAT,1913,28,15-19,1941,0.7072257117999748
STAT,1898,35,45-49,1933,2.755421863988903
STAT,1846,64,na,1910,1319.213921039557
SIM,1842,46,na,1888,1656
STAT,1788,68,na,1856,653.41025024
SIM,1872,12,na,1884,2872
SIM,1911,29,35-39,1940,22
STAT,1858,47,25-29,1905,0.045428683919368204
SIM,1901,27,na,1928,3334
STAT,1863,40,30-34,1903,1.0392075667002942
STAT,1924,15,45-49,1939,0.6039141466357656
STAT,1927,40,15-19,1967,0.0019520725517377865
SIM,1921,41,na,1962,4100
SIM,1933,22,na,1955,4574
STAT,1930,21,30-34,1951,37.32667123346071
SIM,1903,56,na,1959,2758
SIM,1834,28,20-24,1862,10
STAT,1920,27,45-49,1947,1.9137855079531445
STAT,1939,17,na,1956,3719.4710246347927
STAT,1832,39,50-100,1871,1.037129921098067
STAT,1773,102,na,1875,0.08690626800967435
SIM,1888,34,30-34,1922,42
SIM,1900,42,na,1942,3391
SIM,1850,72,na,1922,946
STAT,1888,62,na,1950,2178.8596422782184
STAT,1892,29,30-34,1921,31.686913057143997
SIM,1858,38,50-100,1896,4
STAT,1828,53,25-29,1881,0.0027798046665491794
STAT,1898,14,na,1912,3524.5467785195915
SIM,1854,27,na,1881,2327
STAT,1850,22,40-44,1872,1.9151243125736215
SIM,1871,40,30-34,1911,3
STAT,1880,54,40-44,1934,0.010859709018519688
STAT,1899,45,20-24,1944,0.009476404486312592
STAT,1819,68,na,1887,803.7867659275242
SIM,1921,0,na,1921,4813
STAT,1862,45,25-29,1907,0.050740759155141216
SIM,1925,16,15-19,1941,61
STAT,1906,27,45-49,1933,1.6333707868895562
STAT,1889,33,45-49,1922,2.16258126437102
SIM,1907,30,45-49,1937,2
SIM,1838,41,40-44,1879,4
STAT,1859,37,na,1896,1913.844069900956
STAT,1955,16,35-39,1971,5.629171075543952
SIM,1769,91,na,1860,26
STAT,1897,32,40-44,1929,5.872169142508984
SIM,1845,9,na,1854,2457
SIM,1833,38,30-34,1871,6
SIM,1847,43,40-44,1890,4
STAT,1877,46,30-34,1923,0.10119306986969151
STAT,1918,18,na,1936,4034.0400559304185
STAT,1944,27,30-34,1971,42.76392110691808
SIM,1841,19,15-19,1860,8
STAT,1868,48,na,1916,2144.4626411822305
STAT,1869,16,25-29,1885,5.6749721070907535
STAT,1873,63,na,1936,1826.9661936759062
SIM,1883,40,40-44,1923,4
STAT,1875,40,40-44,1915,2.3565289265209404
STAT,1916,26,25-29,1942,68.91549111244292
SIM,1916,26,na,1942,3849
SIM,1890,41,na,1931,3177
STAT,1928,19,45-49,1947,0.6327979561741708
STAT,1844,43,15-19,1887,0.011047717962714865
STAT,1885,44,na,1929,2292.2126028311313
STAT,1917,16,15-19,1933,9.882024055473035
STAT,1926,28,25-29,1954,79.46386409844602
SIM,1896,20,30-34,1916,39
STAT,1830,49,45-49,1879,0.19234967243859344
STAT,1858,37,30-34,1895,4.223085928195535
SIM,1934,23,30-34,1957,58
STAT,1888,25,25-29,1913,50.770138204310356
STAT,1870,37,30-34,1907,5.28581258175124
SIM,1850,30,35-39,1880,11
SIM,1864,29,45-49,1893,2
SIM,1906,18,20-24,1924,30
STAT,1842,23,45-49,1865,0.7861839392626008
STAT,1794,68,na,1862,731.6949384275272
SIM,1929,22,45-49,1951,1
SIM,1897,33,45-49,1930,4
STAT,1884,37,25-29,1921,2.8676660002926306
SIM,1911,39,45-49,1950,2
SIM,1914,27,45-49,1941,3
STAT,1913,30,na,1943,3827.117421271534
STAT,1861,24,25-29,1885,48.652360012975095
SIM,1838,31,na,1869,1905
STAT,1813,42,25-29,1855,2.3343998753342334
STAT,1839,43,40-44,1882,1.6593225507775824
STAT,1852,64,na,1916,1318.3570212323114
STAT,1831,102,na,1933,0.18423131177204985
STAT,1857,21,30-34,1878,16.326091878487023
STAT,1904,31,30-34,1935,25.409860848789297
STAT,1826,28,20-24,1854,29.024373330849976
STAT,1837,49,na,1886,1552.8912952025335
SIM,1892,37,25-29,1929,3
SIM,1924,26,25-29,1950,9
SIM,1832,22,30-34,1854,1
STAT,1938,32,na,1970,3839.125331214615
STAT,1880,33,25-29,1913,10.818590000854027
STAT,1821,54,35-39,1875,0.011662752377121529
STAT,1912,22,25-29,1934,89.31056764991476
SIM,1919,36,50-100,1955,3
SIM,1829,34,25-29,1863,15
STAT,1903,39,45-49,1942,0.6126864461921725
SIM,1807,80,na,1887,303
STAT,1926,23,30-34,1949,35.18050069989655
STAT,1952,18,25-29,1970,52.45202097549166
STAT,1911,28,30-34,1939,38.415040279384755
STAT,1833,21,45-49,1854,0.7016796943726519
SIM,1896,25,25-29,1921,89
STAT,1856,29,45-49,1885,0.8781597397472878
STAT,1917,47,40-44,1964,0.16622599723282458
STAT,1842,30,35-39,1872,11.24560116324428
STAT,1850,90,na,1940,60.36931141273461
SIM,1860,27,na,1887,2111
STAT,1947,25,40-44,1972,5.3310998910674
STAT,1893,19,20-24,1912,22.613876557150807
SIM,1864,31,40-44,1895,6
SIM,1915,41,na,1956,4168
SIM,1865,71,na,1936,1020
SIM,1837,20,25-29,1857,61
STAT,1843,49,na,1892,1485.7620395774463
STAT,1918,37,30-34,1955,1.9394196950435334
STAT,1836,52,20-24,1888,4.7101205292009467E-4
STAT,1935,32,20-24,1967,3.409436958587877
SIM,1887,16,35-39,1903,3
SIM,1912,31,30-34,1943,27
STAT,1882,30,na,1912,2353.40779134207
STAT,1900,48,25-29,1948,0.04501272770792248
SIM,1912,39,na,1951,3517
STAT,1911,38,35-39,1949,2.3452486489869973
SIM,1837,30,20-24,1867,1
STAT,1861,39,40-44,1900,3.6369743902476057
SIM,1928,21,30-34,1949,46
SIM,1928,32,40-44,1960,10
STAT,1859,31,15-19,1890,0.11615557291899883
SIM,1926,24,30-34,1950,55
STAT,1904,40,35-39,1944,0.18409858552544095
STAT,1870,29,35-39,1899,9.501297387258179
SIM,1865,39,20-24,1904,4
STAT,1883,40,na,1923,2307.4131746931375
STAT,1896,21,20-24,1917,92.40872441846288
SIM,1931,17,20-24,1948,175
STAT,1868,26,15-19,1894,0.43945786657148944
STAT,1854,99,na,1953,1.4213217551947868
SIM,1883,19,15-19,1902,7
SIM,1909,27,35-39,1936,19
STAT,1902,43,35-39,1945,0.17817665947539923
SIM,1868,18,35-39,1886,3
STAT,1866,20,50-100,1886,0.39007422774063233
STAT,1879,35,na,1914,2506.782765540551
STAT,1866,29,15-19,1895,0.42128471744554147
STAT,1923,17,20-24,1940,160.851916258385
STAT,1900,35,25-29,1935,4.077909810040211
STAT,1940,26,na,1966,3858.2853917878033
SIM,1880,29,45-49,1909,1
SIM,1852,20,45-49,1872,5
SIM,1885,27,25-29,1912,48
STAT,1877,27,25-29,1904,44.09598752888952
STAT,1908,17,25-29,1925,8.48552390695217
STAT,1932,40,40-44,1972,0.3435368881859206
SIM,1856,35,na,1891,2116
SIM,1961,8,na,1969,5231
STAT,1928,40,20-24,1968,0.022819199360906237
SIM,1835,33,20-24,1868,3
STAT,1941,22,35-39,1963,9.823956390126996
STAT,1873,50,35-39,1923,0.008941571878789651
SIM,1852,45,na,1897,1701
STAT,1944,16,na,1960,4001.0174526021765
STAT,1877,8,na,1885,2777.531099653674
STAT,1859,47,30-34,1906,0.07826748766677948
STAT,1891,23,40-44,1914,2.597705714839312
STAT,1894,24,20-24,1918,89.04838295254335
STAT,1912,17,45-49,1929,0.10191156720462356
SIM,1890,62,na,1952,2535
SIM,1926,35,40-44,1961,3
SIM,1910,32,25-29,1942,7
STAT,1910,28,50-100,1938,0.966308653616629
STAT,1920,0,na,1920,5104.209021753187
STAT,1936,17,30-34,1953,11.781174701738523
STAT,1913,35,35-39,1948,2.4312379623106413
STAT,1921,34,50-100,1955,0.9213189159510048
SIM,1877,80,na,1957,737
STAT,1866,84,na,1950,311.117452931666
SIM,1882,67,na,1949,1282
SIM,1907,52,na,1959,3452
SIM,1928,38,na,1966,4917
STAT,1930,32,30-34,1962,20.550654993396662
SIM,1869,44,30-34,1913,2
STAT,1868,34,20-24,1902,2.5868986805619008
STAT,1860,52,20-24,1912,6.060025139512921E-4
SIM,1890,32,50-100,1922,1
STAT,1845,23,na,1868,1925.569224473237
STAT,1765,92,na,1857,8.795606921522278
SIM,1853,26,50-100,1879,4
STAT,1929,27,40-44,1956,5.896094702912453
STAT,1824,32,40-44,1856,8.465062198324794
SIM,1864,30,na,1894,2587
SIM,1832,32,40-44,1864,6
SIM,1937,27,40-44,1964,12
STAT,1902,32,25-29,1934,14.618860023045897
STAT,1913,46,45-49,1959,0.21456631301404286
STAT,1864,21,50-100,1885,0.3803624704684397
STAT,1902,45,30-34,1947,0.0787100131267319
SIM,1871,20,25-29,1891,71
SIM,1891,29,20-24,1920,17
SIM,1898,42,na,1940,3176
STAT,1937,33,25-29,1970,9.225766017635523
STAT,1829,76,na,1905,558.6251136348426
STAT,1930,30,35-39,1960,11.933366822626411
STAT,1918,35,40-44,1953,1.6080906070426673
SIM,1944,17,30-34,1961,24
STAT,1833,81,na,1914,382.5885941661881
SIM,1935,17,35-39,1952,9
STAT,1876,20,35-39,1896,6.121798699286827
SIM,1826,30,45-49,1856,1
STAT,1822,35,40-44,1857,8.824864256198863
SIM,1872,8,na,1880,2969
SIM,1889,21,25-29,1910,76
SIM,1937,25,45-49,1962,2
SIM,1853,86,na,1939,126
STAT,1895,25,50-100,1920,0.8494549784901689
STAT,1885,21,45-49,1906,0.703160195733769
SIM,1893,21,45-49,1914,3
SIM,1939,22,45-49,1961,1
SIM,1924,24,na,1948,4339
SIM,1848,20,25-29,1868,1
SIM,1905,27,20-24,1932,24
STAT,1904,42,30-34,1946,0.11557235114483705
STAT,1918,24,30-34,1942,31.09899215694799
SIM,1921,35,35-39,1956,6
STAT,1924,46,20-24,1970,0.013327841492666064
STAT,1851,44,50-100,1895,0.7891348871011841
STAT,1827,33,20-24,1860,3.4886514766580694
SIM,1835,20,15-19,1855,2
SIM,1830,35,40-44,1865,1
STAT,1877,15,30-34,1892,1.6692061855242202
STAT,1900,48,30-34,1948,0.0756463903493276
STAT,1807,103,na,1910,0.050837346692983176
STAT,1829,30,20-24,1859,2.5387435701816443
SIM,1878,22,na,1900,2755
STAT,1863,20,25-29,1883,53.0079018133372
SIM,1924,27,30-34,1951,49
STAT,1862,94,na,1956,20.004302827198526
STAT,1863,33,30-34,1896,15.558586956161855
SIM,1920,34,na,1954,4417
STAT,1907,49,25-29,1956,0.04743927421743444
STAT,1872,29,45-49,1901,1.1193670632471528
STAT,1915,43,45-49,1958,0.16880696597525952
SIM,1869,31,25-29,1900,13
SIM,1923,21,50-100,1944,5
STAT,1887,30,na,1917,2712.5439360399887
STAT,1811,49,25-29,1860,0.1388514627932264
STAT,1837,71,na,1908,910.573719906174
STAT,1932,40,50-100,1972,0.1613542400911424
STAT,1846,36,35-39,1882,5.663718627457274
SIM,1887,24,25-29,1911,3
STAT,1880,48,35-39,1928,0.1466335688258192
STAT,1820,38,40-44,1858,9.990848360659996
STAT,1917,40,45-49,1957,0.17580125343607486
SIM,1903,62,na,1965,2551
STAT,1907,38,15-19,1945,0.017888249107708646
STAT,1865,30,30-34,1895,16.231761983303528
STAT,1915,32,35-39,1947,9.391340957622479
SIM,1907,24,20-24,1931,123
STAT,1821,108,na,1929,0.0010971876526268511
SIM,1880,23,30-34,1903,27
SIM,1916,29,na,1945,3967
STAT,1806,49,50-100,1855,0.7175454170401974
SIM,1900,29,40-44,1929,8
STAT,1909,46,25-29,1955,0.049308809242490224
STAT,1830,54,30-34,1884,0.004208513261905019
SIM,1888,44,40-44,1932,3
SIM,1923,32,35-39,1955,20
STAT,1916,27,30-34,1943,40.88486404897624
STAT,1926,43,20-24,1969,0.021968994169293345
STAT,1849,13,na,1862,2287.043818316956
STAT,1879,24,25-29,1903,59.959145258267284
SIM,1882,36,50-100,1918,1
STAT,1828,51,na,1879,1527.7207343920763
SIM,1911,24,40-44,1935,3
SIM,1837,36,35-39,1873,5
STAT,1891,75,na,1966,1627.5749888311143
STAT,1890,10,na,1900,3196.8788874129277
SIM,1916,19,20-24,1935,119
STAT,1878,47,40-44,1925,0.17865863979395083
STAT,1830,41,25-29,1871,0.5658844682326181
STAT,1895,47,40-44,1942,0.12677986495299143
STAT,1896,27,35-39,1923,12.899857008226691
STAT,1891,51,na,1942,2705.445919847836
STAT,1925,37,na,1962,4563.401618872518
SIM,1823,48,na,1871,1445
STAT,1922,36,15-19,1958,0.022094595789241
STAT,1806,48,na,1854,1222.0948509784923
STAT,1895,65,na,1960,2354.7387146887277
STAT,1914,16,40-44,1930,0.29264002727811494
STAT,1924,33,15-19,1957,0.1514048747256978
STAT,1807,89,na,1896,37.21312434617118
STAT,1850,53,na,1903,1622.238437499305
STAT,1942,17,30-34,1959,12.860830056564815
STAT,1946,22,40-44,1968,3.7790693417102976
STAT,1810,53,na,1863,1382.2594274960022
STAT,1835,46,30-34,1881,0.07759905016491266
STAT,1917,43,25-29,1960,0.07510264842707567
STAT,1944,28,45-49,1972,1.8846125498388657
STAT,1844,20,15-19,1864,3.3062315503790245
SIM,1950,17,30-34,1967,12
SIM,1919,3,na,1922,4445
STAT,1929,27,na,1956,4738.779596265062
STAT,1842,37,50-100,1879,1.296693507211103
STAT,1808,105,na,1913,0.01105411275511285
STAT,1873,78,na,1951,800.0140336562301
SIM,1852,39,35-39,1891,8
SIM,1874,32,na,1906,2284
STAT,1828,35,na,1863,1840.2121972469647
SIM,1849,15,20-24,1864,18
SIM,1859,48,50-100,1907,3
STAT,1858,73,na,1931,941.159270272269
STAT,1903,24,40-44,1927,2.9786141580922005
STAT,1914,4,na,1918,4198.718278106505
STAT,1875,17,50-100,1892,0.05081523328370128
STAT,1944,17,35-39,1961,4.5599697986021965
STAT,1899,71,na,1970,2240.2699835648855
STAT,1952,20,15-19,1972,6.4708965393462465
STAT,1853,109,na,1962,0.0023826467444709905
SIM,1922,16,40-44,1938,1
STAT,1891,46,15-19,1937,2.82950372134197E-4
STAT,1885,37,30-34,1922,5.358025604031937
STAT,1927,17,35-39,1944,5.273464238929257
SIM,1858,41,45-49,1899,2
STAT,1892,20,50-100,1912,0.5199087501260026
SIM,1879,63,na,1942,2104
STAT,1844,39,35-39,1883,5.791876162988016
SIM,1799,89,na,1888,9
SIM,1957,11,na,1968,5431
STAT,1848,30,30-34,1878,16.97286942342862
STAT,1838,23,25-29,1861,49.36153381824493
STAT,1851,18,15-19,1869,5.4311786688702535
STAT,1774,85,na,1859,53.812033034849634
STAT,1818,46,30-34,1864,0.17494497323369343
SIM,1832,25,na,1857,1810
SIM,1836,39,na,1875,1878
STAT,1778,99,na,1877,0.3835419551145933
STAT,1924,39,50-100,1963,0.49922155363771703
STAT,1882,15,na,1897,2482.4008692401926
STAT,1920,25,25-29,1945,73.40795106885695
STAT,1927,28,45-49,1955,2.115373967984653
SIM,1858,30,35-39,1888,14
SIM,1819,37,50-100,1856,1
SIM,1861,81,na,1942,402
STAT,1841,17,na,1858,2213.9182278610047
STAT,1901,26,50-100,1927,0.908821396458165
SIM,1856,30,30-34,1886,23
SIM,1910,0,na,1910,4020
SIM,1820,83,na,1903,184
STAT,1796,72,na,1868,527.9751165835606
STAT,1878,93,na,1971,133.10841277798602
STAT,1900,32,45-49,1932,2.446601986436351
SIM,1846,23,25-29,1869,70
STAT,1866,6,na,1872,2631.671658426155
SIM,1783,74,na,1857,492
SIM,1865,95,na,1960,61
SIM,1893,37,30-34,1930,12
STAT,1953,18,45-49,1971,0.6103430361526669
STAT,1903,25,25-29,1928,61.25973026937895
SIM,1936,33,na,1969,3819
SIM,1863,23,25-29,1886,81
STAT,1874,23,35-39,1897,6.0163446246424055
STAT,1840,15,35-39,1855,0.5039206141972462
STAT,1869,33,na,1902,2333.369845534214
SIM,1916,17,25-29,1933,9
SIM,1864,32,50-100,1896,3
STAT,1858,15,20-24,1873,16.604784077667706
SIM,1838,65,na,1903,1331
SIM,1952,17,35-39,1969,8
SIM,1902,35,25-29,1937,4
STAT,1933,28,15-19,1961,0.9467629422637518
STAT,1949,15,15-19,1964,53.352161302407836
STAT,1821,51,25-29,1872,0.005093737895063437
SIM,1928,14,na,1942,5099
STAT,1861,20,45-49,1881,0.6099759944530422
STAT,1820,71,na,1891,679.4432515039881
STAT,1839,40,30-34,1879,0.9685262056587983
STAT,1915,19,na,1934,4057.056695947486
SIM,1931,18,na,1949,5085
STAT,1821,96,na,1917,5.143338555083767
SIM,1911,25,25-29,1936,93
SIM,1841,61,na,1902,1274
STAT,1908,19,20-24,1927,26.40485099965065
SIM,1878,37,35-39,1915,19
STAT,1845,82,na,1927,340.9252703734745
STAT,1933,39,25-29,1972,1.3523212869870247
SIM,1897,31,30-34,1928,36
STAT,1900,21,35-39,1921,8.211961630257825
SIM,1847,40,30-34,1887,4
SIM,1861,23,20-24,1884,61
STAT,1849,96,na,1945,6.713503036999626
STAT,1939,20,50-100,1959,0.6675738037276207
STAT,1804,51,25-29,1855,0.009787757044190321
STAT,1840,38,50-100,1878,1.007402621940973
STAT,1889,31,30-34,1920,21.833091348391914
STAT,1848,49,20-24,1897,0.009592937384261108
STAT,1844,20,45-49,1864,0.6988450416062048
STAT,1875,45,na,1920,2356.8389262587193
SIM,1861,6,na,1867,2541
STAT,1927,44,na,1971,4692.195796310683
SIM,1894,52,na,1946,3062
STAT,1847,30,na,1877,1945.240297469401
STAT,1884,19,50-100,1903,0.04853398520420423
SIM,1862,47,na,1909,2030
SIM,1914,46,na,1960,3856
STAT,1876,47,30-34,1923,0.10047657589721017
STAT,1923,40,45-49,1963,0.19708880439947082
SIM,1907,36,na,1943,3747
STAT,1855,23,25-29,1878,49.978331922244706
STAT,1895,40,15-19,1935,0.018398451943328585
STAT,1837,46,40-44,1883,0.12280347140132915
STAT,1871,42,25-29,1913,0.6435626055447319
STAT,1935,7,na,1942,5521.059554213232
SIM,1937,27,50-100,1964,1
SIM,1842,18,15-19,1860,5
STAT,1853,23,20-24,1876,66.85145602344569
SIM,1903,22,na,1925,3199
STAT,1816,66,na,1882,962.325647336185
SIM,1835,36,25-29,1871,1
SIM,1815,53,na,1868,1286
STAT,1871,52,50-100,1923,0.015073789471523566
STAT,1850,45,15-19,1895,3.093388011420672E-4
STAT,1836,46,na,1882,1503.684518491933
SIM,1897,34,35-39,1931,18
SIM,1926,27,35-39,1953,28
STAT,1839,35,na,1874,1852.6837637478275
SIM,1874,47,50-100,1921,2
STAT,1838,23,50-100,1861,0.3516280023827172
STAT,1856,107,na,1963,0.018302409582318477
SIM,1854,39,45-49,1893,3
STAT,1840,51,na,1891,1516.5656115373954
STAT,1810,47,50-100,1857,0.9487718800410054
STAT,1894,27,25-29,1921,55.00603364393478
SIM,1785,81,na,1866,143
STAT,1940,19,50-100,1959,0.38377972946164046
STAT,1924,38,15-19,1962,0.022859023245679167
SIM,1899,24,na,1923,3569
STAT,1817,51,na,1868,1252.9411911820416
SIM,1874,88,na,1962,298
STAT,1911,35,30-34,1946,1.792864254933344
STAT,1907,37,30-34,1944,1.7062201134299728
STAT,1899,7,na,1906,3611.419312390431
SIM,1777,86,na,1863,54
SIM,1915,31,na,1946,4278
STAT,1921,40,35-39,1961,0.2297026770674491
SIM,1811,63,na,1874,1125
SIM,1885,16,na,1901,2781
STAT,1906,17,20-24,1923,26.080504245776535
SIM,1892,45,na,1937,3097
SIM,1914,17,20-24,1931,31
STAT,1772,103,na,1875,0.037832309231178585
SIM,1896,59,na,1955,2571
STAT,1815,42,40-44,1857,5.833621745989346
STAT,1896,24,25-29,1920,76.05376280660916
STAT,1917,40,15-19,1957,0.001622157008338748
STAT,1790,105,na,1895,0.005414281387809268
STAT,1888,16,45-49,1904,0.07806297551347115
STAT,1853,29,35-39,1882,8.291516900285043
STAT,1878,44,30-34,1922,1.1891048438689031
STAT,1832,56,na,1888,1401.002513813827
STAT,1909,19,50-100,1928,0.07374223688724654
SIM,1939,31,50-100,1970,1
STAT,1835,49,40-44,1884,0.13206648794957923
SIM,1919,21,na,1940,4225
STAT,1829,33,25-29,1862,8.894971204770497
STAT,1835,30,45-49,1865,1.7019298502423432
SIM,1941,27,30-34,1968,65
SIM,1882,27,na,1909,2193
STAT,1915,43,15-19,1958,0.0015576191725660184
STAT,1827,36,25-29,1863,3.4293111887228354
SIM,1920,18,na,1938,4746
SIM,1773,96,na,1869,2
STAT,1833,22,35-39,1855,5.5703103739637605
STAT,1902,40,30-34,1942,0.11509551812659101
SIM,1831,47,50-100,1878,6
SIM,1886,44,30-34,1930,1
STAT,1851,7,na,1858,2278.6061228984754
STAT,1874,20,30-34,1894,18.531189659943564
STAT,1846,39,45-49,1885,1.5473458487267646
STAT,1930,35,35-39,1965,3.1942920767316108
SIM,1861,29,35-39,1890,11
SIM,1886,73,na,1959,1551
STAT,1915,37,50-100,1952,0.4279790525311155
STAT,1954,18,na,1972,4595.67155656761
STAT,1776,100,na,1876,0.18355168550891615
SIM,1930,25,35-39,1955,22
SIM,1907,27,30-34,1934,54
STAT,1919,17,30-34,1936,13.599976135385148
SIM,1895,37,35-39,1932,17
SIM,1921,30,35-39,1951,17
SIM,1903,46,na,1949,3010
SIM,1888,41,30-34,1929,2
STAT,1862,52,25-29,1914,0.003072969009351754
SIM,1862,40,50-100,1902,1
SIM,1790,68,na,1858,866
STAT,1887,37,35-39,1924,7.9757512328587
SIM,1906,11,na,1917,3708
STAT,1846,20,25-29,1866,54.3805512777354
STAT,1901,28,25-29,1929,59.68195883691609
SIM,1824,73,na,1897,589
STAT,1894,16,15-19,1910,7.735859116713216
STAT,1813,54,30-34,1867,0.015810231806964236
STAT,1852,17,na,1869,2105.4859966929826
STAT,1859,20,35-39,1879,5.483172822350422
SIM,1885,15,30-34,1900,3
SIM,1843,30,45-49,1873,1
SIM,1904,32,25-29,1936,13
STAT,1904,35,na,1939,3474.429522861817
STAT,1908,49,na,1957,3334.2355492721213
STAT,1785,69,na,1854,663.0
STAT,1781,79,na,1860,155.1555550548795
SIM,1902,21,na,1923,3609
STAT,1878,10,na,1888,2741.5689304794973
SIM,1850,39,30-34,1889,4
SIM,1860,40,na,1900,2054
SIM,1924,28,15-19,1952,5
STAT,1868,37,25-29,1905,2.7792627563542402
STAT,1842,39,30-34,1881,5.01700996795906
STAT,1833,97,na,1930,3.8008386331094735
SIM,1846,76,na,1922,573
SIM,1849,65,na,1914,1277
STAT,1938,28,20-24,1966,18.247916772647365
SIM,1845,37,50-100,1882,1
STAT,1808,53,50-100,1861,0.050086223333519655
STAT,1832,101,na,1933,0.388551404447382
STAT,1880,45,30-34,1925,0.10370041962646137
STAT,1933,27,30-34,1960,52.573518355586366
SIM,1941,1,na,1942,4356
STAT,1902,48,35-39,1950,0.11129685076177558
STAT,1823,47,50-100,1870,0.33804381935232436
STAT,1822,32,30-34,1854,53.760319049124256
SIM,1876,37,25-29,1913,3
STAT,1842,28,20-24,1870,12.967997064729209
STAT,1913,30,35-39,1943,9.247258345477169
SIM,1850,28,20-24,1878,12
STAT,1917,41,50-100,1958,0.1239299557171015
STAT,1933,32,na,1965,5150.3978821257615
SIM,1902,38,35-39,1940,7
SIM,1830,32,30-34,1862,24
SIM,1875,73,na,1948,1206
STAT,1946,1,na,1947,4617.978720889734
STAT,1890,16,50-100,1906,0.060612357896125305
STAT,1831,31,na,1862,1781.6561717126913
STAT,1836,101,na,1937,0.3597918623700937
STAT,1937,30,20-24,1967,2.438977317370489
STAT,1862,52,30-34,1914,0.005164295190488877
SIM,1837,33,25-29,1870,14
SIM,1847,41,50-100,1888,2
STAT,1835,45,na,1880,1825.9591544465598
STAT,1918,38,45-49,1956,0.7246920237931168
SIM,1842,86,na,1928,115
STAT,1841,32,40-44,1873,3.934799404938414
SIM,1837,22,15-19,1859,6
STAT,1811,94,na,1905,8.712783443705465
SIM,1926,38,45-49,1964,3
STAT,1899,16,20-24,1915,24.634791991837556
SIM,1835,39,35-39,1874,17
SIM,1829,25,45-49,1854,3
SIM,1904,35,35-39,1939,5
STAT,1827,39,35-39,1866,7.852803317799511
SIM,1928,37,40-44,1965,3
STAT,1891,20,30-34,1911,22.406770183758045
STAT,1852,42,15-19,1894,0.010460369256276438
SIM,1885,24,20-24,1909,75
STAT,1834,46,50-100,1880,0.17265795988752075
STAT,1859,31,45-49,1890,1.4223578007840554
SIM,1904,46,45-49,1950,5
STAT,1918,27,35-39,1945,16.13068384462983
STAT,1877,24,20-24,1901,71.38628481306795
STAT,1904,45,35-39,1949,0.11560415492472904
SIM,1867,31,45-49,1898,1
STAT,1857,48,na,1905,1751.141096680421
STAT,1953,17,30-34,1970,14.897140194759436
SIM,1854,36,35-39,1890,18
SIM,1817,40,45-49,1857,2
SIM,1830,42,na,1872,1518
SIM,1866,37,na,1903,2398
STAT,1848,33,35-39,1881,8.683889832003235
STAT,1903,16,35-39,1919,0.7912089701684192
STAT,1921,43,45-49,1964,0.18902493919179303
SIM,1828,30,25-29,1858,14
STAT,1806,88,na,1894,46.28679457293942
SIM,1809,49,50-100,1858,5
SIM,1935,27,30-34,1962,78
SIM,1863,48,na,1911,2038
STAT,1816,49,30-34,1865,0.24294666381087135
SIM,1837,33,30-34,1870,30
STAT,1812,51,50-100,1863,0.03401364287198434
STAT,1903,27,45-49,1930,1.5970747351426056
STAT,1905,21,40-44,1926,3.05174796242416
STAT,1944,25,40-44,1969,5.091497512561352
STAT,1912,19,40-44,1931,0.2838221708308675
SIM,1878,23,15-19,1901,5
STAT,1847,15,45-49,1862,0.061769219775062174
STAT,1802,74,na,1876,460.2858897326142
SIM,1930,22,25-29,1952,159
SIM,1949,16,na,1965,4128
SIM,1911,27,45-49,1938,1
STAT,1806,64,na,1870,843.7308670229795
SIM,1920,19,40-44,1939,4
STAT,1876,31,45-49,1907,1.8259643407990414
SIM,1893,67,na,1960,2241
SIM,1844,10,na,1854,2082
SIM,1913,21,40-44,1934,4
SIM,1848,24,na,1872,1890
STAT,1887,21,25-29,1908,64.74767246727104
STAT,1853,26,25-29,1879,40.818488549939694
SIM,1856,33,35-39,1889,13
STAT,1858,19,50-100,1877,0.04481489005508894
STAT,1893,43,15-19,1936,0.0012209553603326716
SIM,1878,62,na,1940,2065
SIM,1884,31,45-49,1915,1
STAT,1911,32,20-24,1943,2.39625945951749
STAT,1927,27,30-34,1954,48.14658612030404
STAT,1795,87,na,1882,67.54437918130121
STAT,1855,20,20-24,1875,61.47888358084168
STAT,1929,25,45-49,1954,2.1936710997062185
SIM,1841,45,na,1886,1582
SIM,1862,30,25-29,1892,16
SIM,1889,35,45-49,1924,9
STAT,1865,27,na,1892,2200.9853829059507
SIM,1909,21,20-24,1930,104
STAT,1909,30,15-19,1939,0.12473866300957305
STAT,1909,49,35-39,1958,0.11884984396916853
SIM,1918,36,na,1954,4203
SIM,1853,16,25-29,1869,12
STAT,1911,29,na,1940,3659.398737813691
STAT,1886,17,25-29,1903,6.042959547754302
SIM,1835,73,na,1908,640
STAT,1803,106,na,1909,0.005061429898436126
STAT,1883,29,20-24,1912,11.512158314307065
SIM,1840,20,na,1860,1869
STAT,1897,44,40-44,1941,0.2086415024843613
STAT,1854,30,25-29,1884,8.037075850977123
STAT,1935,36,25-29,1971,1.392289829417754
STAT,1937,22,na,1959,3590.0745750778933
SIM,1871,83,na,1954,450
STAT,1886,45,na,1931,2423.1335911138453
STAT,1811,44,25-29,1855,1.6887997375671346
STAT,1849,111,na,1960,1.609074073423388E-4
STAT,1917,40,20-24,1957,0.0186548045883334
STAT,1816,38,20-24,1854,3.0989640392952427
STAT,1831,28,45-49,1859,0.9496043452104124
STAT,1837,43,30-34,1880,0.9137204427330611
SIM,1848,54,50-100,1902,1
SIM,1911,57,na,1968,3632
STAT,1896,24,30-34,1920,23.664541573758427
SIM,1849,18,25-29,1867,7
SIM,1905,19,15-19,1924,10
SIM,1962,4,na,1966,5269
STAT,1829,33,30-34,1862,15.162519075497778
STAT,1861,36,30-34,1897,4.494537501493181
STAT,1881,14,na,1895,2506.102119251478
STAT,1967,4,na,1971,4960.3950359201335
SIM,1878,34,25-29,1912,18
SIM,1946,17,40-44,1963,2
STAT,1908,25,na,1933,3597.894084620328
STAT,1895,2,na,1897,3515.9078280345284
STAT,1874,20,25-29,1894,59.55605345359744
SIM,1859,25,30-34,1884,26
SIM,1894,17,25-29,1911,13
STAT,1907,40,na,1947,3474.6444938143723
SIM,1854,20,25-29,1874,3
SIM,1863,20,20-24,1883,84
SIM,1841,22,35-39,1863,6
STAT,1903,22,20-24,1925,99.12464510888003
SIM,1861,15,15-19,1876,9
STAT,1765,107,na,1872,0.0065852344419206725
STAT,1901,17,15-19,1918,8.402477863269837
SIM,1861,26,25-29,1887,42
STAT,1814,50,50-100,1864,0.036207401787983186
SIM,1911,22,20-24,1933,102
STAT,1828,40,25-29,1868,0.6344181058795783
STAT,1845,16,25-29,1861,5.26436327297603
STAT,1825,86,na,1911,161.9161228798523
STAT,1895,31,25-29,1926,13.56482882060425
SIM,1873,90,na,1963,140
STAT,1902,6,na,1908,3728.5132240635394
STAT,1853,15,15-19,1868,5.973849535851064
SIM,1816,94,na,1910,6
SIM,1833,23,45-49,1856,5
STAT,1837,28,na,1865,1880.492951886576
SIM,1873,30,30-34,1903,20
SIM,1878,34,30-34,1912,31
STAT,1949,18,25-29,1967,50.901123218348296
STAT,1903,30,50-100,1933,1.328533541228653
SIM,1911,16,35-39,1927,3
STAT,1955,16,na,1971,4937.775124860698
STAT,1861,13,na,1874,2292.406511664381
STAT,1899,55,na,1954,2866.165001861741
STAT,1922,22,25-29,1944,107.0103060672604
STAT,1923,9,na,1932,4723.061032369456
STAT,1938,17,40-44,1955,1.3929058700118584
STAT,1858,108,na,1966,0.01212226917415997
STAT,1889,34,35-39,1923,12.50420867612069
STAT,1820,35,50-100,1855,3.4577556690561604
STAT,1800,54,20-24,1854,0.0021872772937772448
STAT,1854,83,na,1937,297.933405451125
STAT,1845,52,25-29,1897,0.0025743216039880805
SIM,1889,24,35-39,1913,5
SIM,1879,15,30-34,1894,4
SIM,1879,47,na,1926,2650
SIM,1906,25,50-100,1931,4
STAT,1872,26,35-39,1898,9.831346679006511
SIM,1858,61,na,1919,1484
SIM,1875,33,na,1908,2323
SIM,1789,71,na,1860,547
SIM,1924,34,50-100,1958,1
SIM,1871,36,40-44,1907,9
STAT,1952,11,na,1963,4756.784173309792
STAT,1856,43,40-44,1899,1.7291365463620385
STAT,1915,46,25-29,1961,0.05406983081713433
SIM,1904,26,50-100,1930,1
STAT,1920,28,35-39,1948,16.572932927815888
STAT,1955,15,45-49,1970,0.6703068663109306
STAT,1815,84,na,1899,144.0027065102844
STAT,1928,41,35-39,1969,0.25984242487084624
SIM,1853,30,na,1883,1849
SIM,1890,2,na,1892,3595
STAT,1842,58,na,1900,1780.4997124401318
SIM,1876,95,na,1971,92
SIM,1861,65,na,1926,1459
STAT,1876,46,na,1922,2352.891957417605
SIM,1878,43,50-100,1921,3
STAT,1839,51,na,1890,1533.8413814372989
STAT,1849,17,45-49,1866,0.06286629959958312
STAT,1895,44,30-34,1939,0.10387851349181261
STAT,1937,24,35-39,1961,9.250474165991587
STAT,1833,45,15-19,1878,3.413539448656862E-4
STAT,1880,51,na,1931,2294.8151070901736
STAT,1924,36,25-29,1960,1.1742978933721122
STAT,1846,33,25-29,1879,9.090809151559814
SIM,1838,41,na,1879,1782
SIM,1880,20,20-24,1900,64
SIM,1934,9,na,1943,5544
SIM,1867,37,50-100,1904,1
SIM,1859,24,na,1883,2226
STAT,1939,32,45-49,1971,1.6208520516060871
SIM,1834,51,na,1885,1599
STAT,1937,35,45-49,1972,0.6893853646763451
SIM,1904,20,30-34,1924,4
STAT,1897,40,25-29,1937,0.060990407855639334
SIM,1847,43,35-39,1890,5
SIM,1874,24,45-49,1898,1
STAT,1769,104,na,1873,0.026519754140014395
SIM,1816,38,na,1854,1448
STAT,1838,26,35-39,1864,8.27588777056398
STAT,1855,23,30-34,1878,15.551029560082185
SIM,1854,36,40-44,1890,9
SIM,1918,23,15-19,1941,6
SIM,1885,32,na,1917,2553
SIM,1801,61,na,1862,778
SIM,1796,84,na,1880,110
STAT,1864,17,40-44,1881,0.17244279960285716
STAT,1887,9,na,1896,2925.827495069905
STAT,1840,48,na,1888,1570.1445190401917
SIM,1824,33,na,1857,1651
STAT,1865,83,na,1948,366.12363912281825
STAT,1941,27,na,1968,3912.4545189462883
SIM,1805,75,na,1880,361
SIM,1927,13,na,1940,5429
STAT,1827,66,na,1893,974.6516637874303
SIM,1932,36,25-29,1968,1
STAT,1857,109,na,1966,0.00456485786773266
SIM,1851,44,na,1895,1805
STAT,1900,29,na,1929,3324.387663810344
STAT,1926,34,30-34,1960,19.229041987883015
SIM,1883,68,na,1951,1668
SIM,1913,25,35-39,1938,4
STAT,1854,43,na,1897,1722.0243506495126
SIM,1854,39,50-100,1893,1
SIM,1906,51,na,1957,3076
STAT,1853,98,na,1951,2.68646732095681
SIM,1861,26,30-34,1887,35
STAT,1905,25,35-39,1930,14.183947731728518
SIM,1854,33,25-29,1887,16
STAT,1928,42,40-44,1970,0.3222946922404761
STAT,1902,42,20-24,1944,0.015720877152035045
STAT,1931,26,15-19,1957,0.9215367393648821
SIM,1920,15,25-29,1935,70
STAT,1856,32,50-100,1888,0.7181778527863972
STAT,1912,15,25-29,1927,8.881906025970482
STAT,1891,39,20-24,1930,0.954228198025628
STAT,1911,46,50-100,1957,0.2165629760820209
STAT,1839,43,35-39,1882,1.3358628973838034
STAT,1853,26,30-34,1879,24.299114904544332
SIM,1873,47,na,1920,2156
STAT,1846,22,15-19,1868,3.0890712063742654
STAT,1928,31,30-34,1959,19.9236866492893
STAT,1949,15,20-24,1964,159.38113988719465
STAT,1832,42,40-44,1874,1.8793042395039183
STAT,1824,48,20-24,1872,0.013849422999074405
STAT,1863,45,30-34,1908,0.08748894692894303
SIM,1871,33,30-34,1904,4
SIM,1827,78,na,1905,323
SIM,1934,34,30-34,1968,8
SIM,1864,70,na,1934,1590
STAT,1827,36,30-34,1863,6.347873937375281
STAT,1830,92,na,1922,27.477776769232257
STAT,1899,19,25-29,1918,7.81282170132485
STAT,1863,17,na,1880,2343.9987059344426
SIM,1900,25,25-29,1925,13
SIM,1846,26,35-39,1872,8
SIM,1898,9,na,1907,3525
SIM,1848,34,45-49,1882,1
SIM,1902,33,35-39,1935,1
STAT,1854,28,50-100,1882,0.49966736047583676
STAT,1883,29,15-19,1912,0.4452215958358131
SIM,1837,21,30-34,1858,29
SIM,1937,34,na,1971,3637
SIM,1788,89,na,1877,34
SIM,1917,14,na,1931,4161
STAT,1882,32,50-100,1914,0.8964066072000205
STAT,1852,47,20-24,1899,0.009058275760081568
STAT,1918,24,na,1942,3951.367469587865
SIM,1884,20,35-39,1904,6
STAT,1816,38,15-19,1854,0.2257523756366346
SIM,1848,23,35-39,1871,6
STAT,1854,43,30-34,1897,0.856577809755419
STAT,1851,105,na,1956,0.02750169694666563
SIM,1813,89,na,1902,18
STAT,1909,50,na,1959,3375.8322442440913
STAT,1917,45,15-19,1962,3.9020609963584627E-4
SIM,1904,31,40-44,1935,2
STAT,1835,30,15-19,1865,0.13898657336000272
STAT,1917,20,50-100,1937,0.7101052027869618
STAT,1852,3,na,1855,2591.5198
STAT,1893,39,na,1932,2990.9937663291335
STAT,1915,21,50-100,1936,0.6883928768013652
SIM,1863,23,30-34,1886,24
SIM,1913,24,na,1937,3595
STAT,1816,42,50-100,1858,3.03113505592968
STAT,1887,34,25-29,1921,11.451144506946846
STAT,1894,27,30-34,1921,32.74491485205119
SIM,1859,22,20-24,1881,66
SIM,1895,34,25-29,1929,25
SIM,1913,28,50-100,1941,6
SIM,1863,32,na,1895,2197
STAT,1900,44,15-19,1944,0.0013273024697526346
SIM,1830,44,30-34,1874,3
SIM,1847,39,na,1886,1803
STAT,1800,94,na,1894,7.010831480153324
SIM,1902,35,30-34,1937,2
STAT,1822,97,na,1919,3.003747395079503
STAT,1875,50,45-49,1925,0.01526884079184218
SIM,1882,23,35-39,1905,7
STAT,1918,33,20-24,1951,2.605713826500347
STAT,1900,39,40-44,1939,1.3122869448284358
SIM,1945,24,35-39,1969,17
STAT,1841,47,45-49,1888,0.17728430507149354
SIM,1926,33,20-24,1959,3
STAT,1855,84,na,1939,250.40251871576726
STAT,1835,49,35-39,1884,0.10799829646950679
STAT,1789,99,na,1888,0.4527188718520908
STAT,1931,15,35-39,1946,5.576617616830587
SIM,1950,19,20-24,1969,182
SIM,1926,21,20-24,1947,144
STAT,1862,50,50-100,1912,0.013362225214581934
STAT,1865,33,35-39,1898,9.300333681710297
STAT,1878,40,15-19,1918,0.01462507990304264
STAT,1857,106,na,1963,0.04445377843961343
STAT,1836,23,20-24,1859,56.96167827920363
SIM,1943,21,20-24,1964,129
STAT,1885,42,50-100,1927,1.0607833292603797
SIM,1805,78,na,1883,246
STAT,1822,47,35-39,1869,0.20757471631336671
STAT,1873,43,40-44,1916,2.286418301286448
SIM,1849,28,50-100,1877,1
STAT,1843,59,na,1902,1310.8039705135434
SIM,1907,27,25-29,1934,68
SIM,1933,19,20-24,1952,185
STAT,1850,49,30-34,1899,0.07257350545223477
STAT,1906,40,45-49,1946,0.15443416784904324
STAT,1852,30,50-100,1882,0.7345558164226955
SIM,1822,63,na,1885,1071
STAT,1901,19,35-39,1920,0.772727599512859
STAT,1850,38,20-24,1888,0.5934027409011149
SIM,1918,25,40-44,1943,5
STAT,1942,19,20-24,1961,142.95455216495827
STAT,1921,45,35-39,1966,0.1474857846520934
STAT,1821,56,na,1877,1330.9344021135303
STAT,1829,36,na,1865,1632.18627598558
SIM,1937,23,25-29,1960,106
STAT,1787,95,na,1882,2.208754301449803
STAT,1831,25,40-44,1856,2.758559758614416
SIM,1881,43,40-44,1924,4
STAT,1906,42,35-39,1948,0.18475854749380563
SIM,1801,64,na,1865,660
STAT,1858,50,45-49,1908,0.011664693990901863
SIM,1940,30,45-49,1970,4
SIM,1852,85,na,1937,98
STAT,1931,26,45-49,1957,2.2551893125585956
STAT,1900,32,15-19,1932,0.19979955485365278
SIM,1919,34,35-39,1953,11
STAT,1918,21,20-24,1939,121.43984226215134
SIM,1835,36,30-34,1871,3
SIM,1895,31,20-24,1926,3
STAT,1818,73,na,1891,611.9382271814486
STAT,1898,30,na,1928,3293.6215030516887
SIM,1844,23,20-24,1867,4
SIM,1831,86,na,1917,124
STAT,1818,41,50-100,1859,2.1451432559573194
STAT,1898,42,50-100,1940,0.10032448075062883
SIM,1871,43,na,1914,2168
SIM,1875,57,na,1932,2006
STAT,1920,23,35-39,1943,10.538154926624422
STAT,1923,26,50-100,1949,1.15860578799524
SIM,1864,43,40-44,1907,5
STAT,1929,23,25-29,1952,117.69878896535113
STAT,1879,27,35-39,1906,10.16996886970498
STAT,1865,34,50-100,1899,0.8377782974052609
STAT,1935,21,20-24,1956,153.0346863522869
SIM,1928,36,35-39,1964,3
STAT,1902,48,40-44,1950,0.13610014861768013
SIM,1920,1,na,1921,5020
STAT,1842,21,50-100,1863,0.466430605016209
STAT,1861,20,15-19,1881,2.885792640381757
STAT,1905,36,45-49,1941,0.6312691686228965
STAT,1925,19,20-24,1944,164.62542579637656
STAT,1926,46,30-34,1972,0.1114445824083981
STAT,1852,45,25-29,1897,0.0441188802742462
STAT,1852,33,na,1885,1854.4331902308006
SIM,1871,37,50-100,1908,4
SIM,1882,9,na,1891,2335
STAT,1877,16,15-19,1893,6.201507808106534
STAT,1914,27,20-24,1941,18.56642336618077
SIM,1887,42,na,1929,2509
SIM,1876,37,30-34,1913,1
SIM,1871,39,45-49,1910,4
STAT,1912,14,na,1926,4016.0051148088623
SIM,1803,71,na,1874,545
STAT,1922,36,45-49,1958,0.7843580572387004
STAT,1941,30,40-44,1971,4.152793827842384
SIM,1907,29,20-24,1936,22
STAT,1932,30,45-49,1962,2.116362287151319
SIM,1844,19,30-34,1863,1
STAT,1893,48,20-24,1941,0.008571770730031713
SIM,1890,33,40-44,1923,10
SIM,1840,42,40-44,1882,6
SIM,1895,37,40-44,1932,11
STAT,1846,36,40-44,1882,3.5053328851159544
STAT,1872,23,25-29,1895,57.94877298457905
SIM,1849,81,na,1930,386
STAT,1799,77,na,1876,350.21891376403477
SIM,1922,27,20-24,1949,6
SIM,1900,29,35-39,1929,21
STAT,1909,46,30-34,1955,0.0828661941089485
STAT,1887,37,40-44,1924,4.936273307170858
STAT,1944,23,20-24,1967,121.19503732540171
STAT,1866,24,45-49,1890,0.6480752265467125
STAT,1922,25,35-39,1947,17.278999921461505
STAT,1882,33,40-44,1915,4.224911350525482
SIM,1917,44,35-39,1961,3
SIM,1888,83,na,1971,1037
SIM,1897,57,na,1954,2693
STAT,1876,43,na,1919,2392.8488920828704
SIM,1930,36,45-49,1966,1
STAT,1920,25,30-34,1945,43.69951708885501
STAT,1874,46,15-19,1920,4.1484999021737046E-4
STAT,1893,46,25-29,1939,0.04178636153763059
STAT,1944,9,na,1953,4283.02788912324
SIM,1828,63,na,1891,1072
STAT,1806,52,40-44,1858,0.030377863411408003
STAT,1868,37,30-34,1905,5.144592790002633
STAT,1889,33,50-100,1922,1.1362715047739917
STAT,1901,25,20-24,1926,16.72275070559662
SIM,1839,63,na,1902,1146
STAT,1845,52,50-100,1897,0.010976621361107131
STAT,1909,10,na,1919,3919.9627370213934
SIM,1906,46,50-100,1952,2
SIM,1930,24,45-49,1954,2
STAT,1857,46,15-19,1903,3.1619265466104653E-4
STAT,1866,68,na,1934,1429.2201221457535
STAT,1870,29,50-100,1899,0.6299049326253179
STAT,1916,20,na,1936,3884.710387818321
SIM,1829,88,na,1917,49
STAT,1882,45,40-44,1927,0.16916293762247278
STAT,1925,17,25-29,1942,52.90440708435802
SIM,1868,17,20-24,1885,23
SIM,1877,6,na,1883,2856
SIM,1803,68,na,1871,652
STAT,1837,34,40-44,1871,3.633188626433185
STAT,1804,105,na,1909,0.00908998405078583
STAT,1929,27,50-100,1956,1.2590907853072977
SIM,1924,29,20-24,1953,6
STAT,1833,41,na,1874,1825.3644412645847
STAT,1852,49,40-44,1901,0.12712580992508046
STAT,1921,40,40-44,1961,0.2853218191615749
SIM,1932,33,20-24,1965,6
SIM,1810,78,na,1888,406
STAT,1916,29,20-24,1945,18.91083388737863
SIM,1823,42,40-44,1865,1
SIM,1868,4,na,1872,2702
STAT,1859,58,na,1917,1606.472788494023
STAT,1853,18,na,1871,2270.0537369969165
STAT,1922,24,45-49,1946,1.2953561840413135
STAT,1842,28,15-19,1870,0.5015247523809265
SIM,1933,17,25-29,1950,63
STAT,1815,54,40-44,1869,0.021438420859466432
STAT,1836,19,30-34,1855,1.7778870889943161
STAT,1952,20,45-49,1972,1.367766864589523
SIM,1816,78,na,1894,376
STAT,1841,44,40-44,1885,1.7036342497042303
SIM,1842,30,na,1872,1956
STAT,1860,46,50-100,1906,0.20334959488238566
STAT,1856,47,na,1903,1734.0337658949568
SIM,1934,30,45-49,1964,3
SIM,1852,48,na,1900,1676
STAT,1877,53,50-100,1930,0.015490680149917032
SIM,1862,43,30-34,1905,1
STAT,1902,34,15-19,1936,0.11570855053267182
STAT,1818,52,na,1870,1337.7851300026143
STAT,1838,23,30-34,1861,15.359109478339034
STAT,1843,40,na,1883,1646.6768255025343
STAT,1915,40,40-44,1955,0.25480400007079196
SIM,1870,98,na,1968,23
STAT,1870,26,30-34,1896,25.060820087113875
STAT,1924,33,20-24,1957,2.8738357939829586
SIM,1896,35,na,1931,3142
STAT,1849,17,50-100,1866,0.04714972469968735
SIM,1904,23,35-39,1927,12
SIM,1904,34,45-49,1938,1
SIM,1885,72,na,1957,1251
STAT,1925,30,50-100,1955,0.9933576371636516
STAT,1937,21,30-34,1958,28.264786258578628
SIM,1880,23,25-29,1903,68
SIM,1909,24,30-34,1933,37
SIM,1841,85,na,1926,182
STAT,1892,19,15-19,1911,7.480990812116391
SIM,1945,21,30-34,1966,34
STAT,1863,48,35-39,1911,0.123710362669835
SIM,1854,30,20-24,1884,2
STAT,1855,35,50-100,1890,0.9329243101809785
STAT,1811,48,40-44,1859,0.419509032743061
STAT,1874,39,20-24,1913,0.7891803937587102
SIM,1903,16,30-34,1919,5
STAT,1909,31,50-100,1940,0.7994177595811618
SIM,1886,31,25-29,1917,21
STAT,1902,45,25-29,1947,0.04683570983889093
SIM,1868,1,na,1869,3316
STAT,1855,26,35-39,1881,7.625162300764673
STAT,1831,55,na,1886,1321.9577314730832
SIM,1909,35,40-44,1944,7
STAT,1802,54,30-34,1856,0.01668437297250942
STAT,1926,30,45-49,1956,1.925191566483688
STAT,1863,39,45-49,1902,1.7659961825630062
SIM,1904,47,na,1951,3373
STAT,1846,30,20-24,1876,2.4750068849462346
SIM,1901,36,na,1937,3441
STAT,1868,32,na,1900,2303.4842775987036
SIM,1825,74,na,1899,515
STAT,1806,67,na,1873,754.4385358353444
SIM,1893,21,15-19,1914,5
STAT,1940,17,20-24,1957,138.9702138361611
STAT,1885,21,15-19,1906,3.326646517749343
STAT,1849,24,45-49,1873,0.6497350186662112
STAT,1870,73,na,1943,1177.999121216705
STAT,1877,18,35-39,1895,0.5704885995725177
STAT,1939,26,na,1965,3803.6233670172196
SIM,1853,70,na,1923,972
STAT,1841,92,na,1933,31.146037383101195
STAT,1911,23,30-34,1934,27.415153677647808
STAT,1853,58,na,1911,1635.426704636186
STAT,1861,8,na,1869,2368.853811023253
STAT,1888,18,40-44,1906,0.21746960536197055
SIM,1895,0,na,1895,3656
STAT,1844,84,na,1928,263.19786137985614
STAT,1876,46,25-29,1922,0.060238296464795206
SIM,1863,26,35-39,1889,1
SIM,1880,26,40-44,1906,3
STAT,1856,50,35-39,1906,0.006762191637828937
STAT,1842,18,na,1860,2638.2400016577017
SIM,1839,66,na,1905,977
STAT,1857,39,15-19,1896,0.04381802232632211
STAT,1868,22,20-24,1890,66.52060138677734
SIM,1926,36,25-29,1962,2
STAT,1811,46,20-24,1857,0.030387478382507504
STAT,1862,16,25-29,1878,5.694343542130019
STAT,1916,23,15-19,1939,5.611717947350422
STAT,1887,31,20-24,1918,3.0605496760595856
STAT,1878,31,25-29,1909,10.78279335584912
STAT,1905,22,30-34,1927,26.007654050453766
STAT,1932,32,35-39,1964,12.276669458629435
SIM,1898,25,45-49,1923,2
STAT,1844,36,30-34,1880,4.9476688575039525
SIM,1913,21,na,1934,3720
SIM,1829,27,40-44,1856,2
STAT,1935,34,35-39,1969,12.757054193728578
SIM,1821,42,30-34,1863,4
SIM,1876,22,20-24,1898,74
SIM,1819,44,40-44,1863,6
SIM,1859,28,35-39,1887,10
STAT,1928,34,35-39,1962,11.53463214323411
SIM,1777,89,na,1866,19
STAT,1806,104,na,1910,0.022488711790675166
STAT,1948,22,45-49,1970,1.3050724778749192
SIM,1849,19,15-19,1868,6
STAT,1832,45,45-49,1877,0.1955079668607569
SIM,1923,40,40-44,1963,1
STAT,1865,43,na,1908,2116.1568672141884
STAT,1905,33,40-44,1938,3.620505697299408
STAT,1863,36,40-44,1899,3.936237048733479
STAT,1907,24,na,1931,3485.9458944258563
SIM,1837,48,50-100,1885,1
SIM,1846,23,30-34,1869,23
STAT,1765,89,na,1854,29.0
SIM,1830,38,45-49,1868,1
STAT,1831,41,50-100,1872,0.8274864079040188
STAT,1921,28,na,1949,4201.916968747259
SIM,1924,23,15-19,1947,9
STAT,1876,83,na,1959,541.1912605369996
STAT,1888,71,na,1959,1715.717498721047
STAT,1962,6,na,1968,5086.565298213248
STAT,1929,38,20-24,1967,0.34172103998692016
SIM,1830,45,na,1875,1454
SIM,1839,30,25-29,1869,12
SIM,1852,36,30-34,1888,9
STAT,1829,36,35-39,1865,5.892623108416776
SIM,1935,25,40-44,1960,5
STAT,1937,32,40-44,1969,3.908610713202587
SIM,1863,69,na,1932,1247
SIM,1841,38,20-24,1879,1
STAT,1898,21,25-29,1919,78.61783305234827
STAT,1868,102,na,1970,2.4748191919632427
SIM,1882,83,na,1965,499
STAT,1833,38,20-24,1871,0.6772856340904861
STAT,1842,55,na,1897,1861.6343540774546
SIM,1886,27,50-100,1913,4
STAT,1928,43,25-29,1971,0.09186814575700676
STAT,1813,42,30-34,1855,4.179328791966425
STAT,1907,32,50-100,1939,0.7803383832577455
STAT,1907,46,20-24,1953,0.010068474174981247
SIM,1935,8,na,1943,5441
SIM,1852,20,15-19,1872,4
SIM,1915,32,50-100,1947,1
STAT,1821,53,50-100,1874,0.02087124728842395
STAT,1822,38,45-49,1860,3.5544074626959126
SIM,1913,22,30-34,1935,62
SIM,1850,81,na,1931,381
STAT,1897,45,na,1942,3077.360225745204
SIM,1851,5,na,1856,2494
STAT,1844,81,na,1925,427.84433202645766
STAT,1880,33,30-34,1913,18.44155236499959
STAT,1878,27,50-100,1905,0.6706885375566528
STAT,1820,34,25-29,1854,32.41155131959951
SIM,1895,3,na,1898,3502
STAT,1856,5,na,1861,2302.357024141691
STAT,1921,42,30-34,1963,0.14543233143110385
STAT,1913,8,na,1921,4100.971183501834
SIM,1849,25,na,1874,2052
STAT,1841,24,50-100,1865,0.3807854175858706
STAT,1864,58,na,1922,1802.3569817855487
STAT,1933,36,20-24,1969,0.3631605421252152
SIM,1922,19,15-19,1941,56
STAT,1833,49,30-34,1882,0.07141773335175074
SIM,1895,23,15-19,1918,5
STAT,1922,21,40-44,1943,3.9070635905188182
STAT,1847,46,50-100,1893,0.18441191114246402
SIM,1845,30,25-29,1875,18
STAT,1916,23,45-49,1939,1.1861604980294889
STAT,1843,99,na,1942,1.2773523089131353
SIM,1826,37,na,1863,2024
SIM,1882,20,30-34,1902,27
SIM,1887,24,30-34,1911,1
STAT,1873,46,45-49,1919,0.24232872678272055
STAT,1822,44,30-34,1866,1.7422136444893337
STAT,1891,35,na,1926,2974.0775177997957
STAT,1935,24,25-29,1959,126.99756651138418
SIM,1918,27,30-34,1945,57
STAT,1891,23,35-39,1914,7.274592393927339
STAT,1786,70,na,1856,669.18862276
STAT,1882,48,45-49,1930,0.22798888454147256
STAT,1887,23,15-19,1910,3.7086358720016577
STAT,1824,32,35-39,1856,19.767546178169948
STAT,1804,108,na,1912,5.678703023211046E-4
STAT,1879,24,30-34,1903,18.656613865369227
SIM,1848,40,na,1888,1771
SIM,1832,32,35-39,1864,10
STAT,1890,50,na,1940,2695.6164077764506
STAT,1954,15,na,1969,4599.58009769429
STAT,1927,25,40-44,1952,5.7662310841110545
SIM,1804,53,na,1857,1418
STAT,1905,36,15-19,1941,0.017782232216795455
SIM,1943,24,25-29,1967,114
STAT,1921,50,na,1971,4145.1485176893875
STAT,1887,36,50-100,1923,1.3911226295150891
STAT,1933,16,na,1949,4991.264459153415
SIM,1870,16,25-29,1886,9
STAT,1818,49,35-39,1867,0.241955791880534
STAT,1906,35,50-100,1941,0.3935410744370586
STAT,1914,19,45-49,1933,0.10369909467188207
STAT,1924,34,20-24,1958,2.8719103240009893
STAT,1918,36,25-29,1954,1.052775266707711
STAT,1907,21,45-49,1928,1.0374093900550168
SIM,1924,23,45-49,1947,3
SIM,1858,39,na,1897,1911
STAT,1926,30,15-19,1956,0.15721904098987557
SIM,1889,23,45-49,1912,5
STAT,1869,54,30-34,1923,0.005684418561357867
STAT,1930,41,50-100,1971,0.15645661233705715
SIM,1909,33,20-24,1942,2
STAT,1811,97,na,1908,2.3419894722599373
STAT,1957,3,na,1960,5239.08007427916
SIM,1817,63,na,1880,1098
SIM,1794,74,na,1868,513
SIM,1862,28,50-100,1890,4
SIM,1897,20,na,1917,3505
SIM,1798,88,na,1886,22
SIM,1952,3,na,1955,4781
SIM,1900,22,20-24,1922,3
STAT,1906,39,na,1945,3458.076748778822
SIM,1904,33,45-49,1937,1
STAT,1943,20,50-100,1963,0.7073545491986533
SIM,1890,40,35-39,1930,2
SIM,1928,33,30-34,1961,31
STAT,1829,92,na,1921,24.558073445594303
SIM,1844,15,15-19,1859,4
SIM,1951,20,50-100,1971,1
STAT,1887,6,na,1893,2945.8141221506744
SIM,1854,55,na,1909,1903
STAT,1902,44,25-29,1946,0.06278628891736274
STAT,1919,49,na,1968,3999.711771179088
STAT,1938,15,45-49,1953,0.49977756197569884
STAT,1848,43,50-100,1891,0.8563182062972295
STAT,1881,16,35-39,1897,0.535516282654903
SIM,1844,26,25-29,1870,10
STAT,1913,32,25-29,1945,9.278179730010125
STAT,1833,103,na,1936,0.10153626849822973
SIM,1921,32,25-29,1953,6
STAT,1807,48,20-24,1855,0.042312445573549004
STAT,1832,96,na,1928,5.846862782536316
STAT,1837,49,45-49,1886,0.1629021093233188
STAT,1955,17,40-44,1972,1.875865077824617
STAT,1868,94,na,1962,45.998323745132495
STAT,1840,17,50-100,1857,0.044464448139146795
STAT,1857,20,25-29,1877,52.848702471656054
STAT,1903,29,40-44,1932,4.278062619294628
SIM,1852,29,na,1881,1940
STAT,1858,18,25-29,1876,5.2143022360706
STAT,1914,19,15-19,1933,9.421064657348136
STAT,1910,49,50-100,1959,0.2116579543950475
STAT,1931,23,40-44,1954,4.393725399279135
STAT,1944,26,25-29,1970,71.86864566586526
STAT,1872,20,20-24,1892,70.39269746115231
SIM,1878,22,30-34,1900,29
SIM,1919,31,30-34,1950,28
STAT,1837,30,25-29,1867,8.944904070798117
STAT,1906,61,na,1967,3003.4224984888997
SIM,1856,43,50-100,1899,1
STAT,1847,17,40-44,1864,0.17092246112023946
SIM,1886,57,na,1943,2245
STAT,1882,40,35-39,1922,1.789481392004927
SIM,1802,86,na,1888,40
SIM,1911,29,40-44,1940,7
STAT,1901,16,30-34,1917,2.262234384638096
STAT,1861,43,50-100,1904,0.8802540368119158
SIM,1908,9,na,1917,3808
SIM,1775,82,na,1857,110
SIM,1950,16,na,1966,4222
STAT,1836,26,25-29,1862,34.77993974894998
STAT,1878,4,na,1882,3023.1548139298397
STAT,1830,30,na,1860,1887.0018966696555
STAT,1808,74,na,1882,474.28841721650974
STAT,1828,53,30-34,1881,0.004671616220752847
STAT,1880,46,45-49,1926,0.2510384041096624
STAT,1850,22,35-39,1872,5.36309739709495
STAT,1888,31,na,1919,2856.3747259324323
SIM,1795,59,na,1854,986
STAT,1841,33,na,1874,1946.0836312516858
STAT,1953,15,40-44,1968,1.710414359232402
STAT,1864,98,na,1962,8.048525989388322
STAT,1868,33,15-19,1901,0.13688472622793557
SIM,1892,30,35-39,1922,1
SIM,1883,12,na,1895,2934
SIM,1921,23,35-39,1944,11
STAT,1934,19,25-29,1953,58.90883424723321
SIM,1898,15,35-39,1913,4
STAT,1918,36,30-34,1954,1.9487542277946694
SIM,1862,34,40-44,1896,5
STAT,1836,50,25-29,1886,0.0023522067512936093
STAT,1913,49,na,1962,3596.726182968557
STAT,1883,77,na,1960,1020.6984084471887
STAT,1818,36,na,1854,1572.2920802884385
STAT,1852,49,35-39,1901,0.10395802237473482
STAT,1866,36,15-19,1902,0.05277034519383984
STAT,1879,17,25-29,1896,5.9727307798163825
STAT,1838,50,na,1888,1491.642835641817
SIM,1800,60,na,1860,957
STAT,1814,46,na,1860,1456.5315885616992
STAT,1891,20,25-29,1911,72.01150208239957
STAT,1880,43,40-44,1923,2.368595787641481
STAT,1905,28,50-100,1933,0.930724957488099
STAT,1921,42,25-29,1963,0.08123247374433014
SIM,1923,31,45-49,1954,5
STAT,1940,16,45-49,1956,0.5121927356108028
SIM,1885,15,25-29,1900,7
STAT,1884,30,35-39,1914,10.16758391527615
STAT,1900,47,25-29,1947,0.045372989242507995
STAT,1921,44,na,1965,4210.762602160974
STAT,1930,20,30-34,1950,37.43635976757971
SIM,1863,85,na,1948,136
STAT,1822,47,40-44,1869,0.25383422393497507
STAT,1919,15,40-44,1934,0.3145673309352738
SIM,1888,21,na,1909,2900
STAT,1861,24,30-34,1885,15.13844619517575
STAT,1870,19,30-34,1889,1.5770958770885197
STAT,1898,8,na,1906,3559.3215010667654
SIM,1939,7,na,1946,4114
SIM,1821,68,na,1889,796
SIM,1874,17,15-19,1891,6
SIM,1937,15,40-44,1952,1
STAT,1915,31,45-49,1946,1.6237432286073394
SIM,1878,38,40-44,1916,6
STAT,1851,32,na,1883,1880.6440609417562
STAT,1908,62,na,1970,3052.946413159012
STAT,1834,60,na,1894,1135.207717103791
SIM,1871,27,na,1898,2277
SIM,1793,73,na,1866,526
SIM,1869,88,na,1957,193
SIM,1909,39,35-39,1948,5
STAT,1871,43,30-34,1914,1.1452715520911025
STAT,1822,107,na,1929,0.002636801000829395
STAT,1805,85,na,1890,108.82480006160742
STAT,1873,51,25-29,1924,0.0036440532761793237
STAT,1854,34,40-44,1888,3.264452289307277
STAT,1951,16,20-24,1967,163.15894450149133
STAT,1909,41,30-34,1950,0.12136214244702928
SIM,1926,36,30-34,1962,3
STAT,1872,27,40-44,1899,3.041758151582159
STAT,1913,23,35-39,1936,9.56381403801909
STAT,1856,63,na,1919,1381.6693177602317
STAT,1804,52,30-34,1856,0.016120136371991497
SIM,1842,19,20-24,1861,3
STAT,1877,5,na,1882,2844.1544994106644
STAT,1944,26,30-34,1970,42.783173535008835
SIM,1920,31,na,1951,4460
SIM,1875,70,na,1945,1439
STAT,1817,88,na,1905,62.8103084975084
STAT,1864,53,40-44,1917,0.009440710496205526
STAT,1909,34,25-29,1943,8.82402761754278
SIM,1832,71,na,1903,854
SIM,1927,15,40-44,1942,1
STAT,1870,27,na,1897,2366.9256890359748
STAT,1892,26,15-19,1918,0.5769864502141827
STAT,1826,65,na,1891,927.3168780476047
STAT,1861,35,25-29,1896,2.4394022911203246
SIM,1900,35,50-100,1935,3
STAT,1929,37,45-49,1966,0.8846157601593768
STAT,1920,20,30-34,1940,32.45900289874984
SIM,1875,54,50-100,1929,1
STAT,1854,40,50-100,1894,0.800853118342786
SIM,1832,44,50-100,1876,1
STAT,1872,39,50-100,1911,1.2341284095743783
STAT,1925,34,na,1959,4532.991241125788
STAT,1850,50,na,1900,1672.4029084164413
STAT,1926,31,20-24,1957,2.982553939372021
SIM,1888,43,na,1931,2934
STAT,1843,40,15-19,1883,0.009839016598256357
SIM,1888,31,50-100,1919,1
STAT,1927,29,35-39,1956,18.373975522759057
SIM,1912,30,30-34,1942,20
STAT,1878,48,50-100,1926,0.25426498901783057
STAT,1849,43,50-100,1892,0.8200231981083926
STAT,1856,40,25-29,1896,0.5022693474494062
SIM,1876,25,50-100,1901,3
STAT,1786,73,na,1859,503.56661730262135
SIM,1910,59,na,1969,2945
STAT,1877,51,25-29,1928,0.0037099429708579742
SIM,1822,38,50-100,1860,1
STAT,1878,40,20-24,1918,0.16818840980098823
SIM,1917,34,25-29,1951,6
STAT,1899,15,45-49,1914,0.09096760576485231
STAT,1859,46,25-29,1905,0.04692337575724522
STAT,1835,34,30-34,1869,16.347008471544115
STAT,1927,40,50-100,1967,0.14933353929561183
STAT,1825,83,na,1908,289.7047983248516
STAT,1867,40,45-49,1907,1.4380019601635303
SIM,1935,29,35-39,1964,40
STAT,1904,30,30-34,1934,25.509859498021537
SIM,1867,75,na,1942,903
SIM,1870,79,na,1949,714
SIM,1941,17,na,1958,3985
STAT,1872,26,50-100,1898,0.6517861208892044
STAT,1930,42,35-39,1972,0.2677886434091409
STAT,1825,35,15-19,1860,0.1008260857987806
STAT,1854,53,40-44,1907,0.007774002713696262
STAT,1922,48,15-19,1970,4.2632904246351575E-4
STAT,1853,29,40-44,1882,2.574147881289717
STAT,1848,21,35-39,1869,5.84313131090316
SIM,1934,31,20-24,1965,7
STAT,1840,16,40-44,1856,0.16698418359472658
SIM,1856,21,35-39,1877,7
SIM,1875,40,45-49,1915,2
SIM,1861,84,na,1945,224
SIM,1873,30,25-29,1903,12
SIM,1890,65,na,1955,2385
SIM,1905,32,na,1937,3679
SIM,1843,65,na,1908,1532
STAT,1870,22,15-19,1892,3.2719332425381364
SIM,1902,23,25-29,1925,126
SIM,1922,26,45-49,1948,3
SIM,1941,27,25-29,1968,96
STAT,1890,43,40-44,1933,2.7559151604376524
STAT,1953,19,35-39,1972,5.125088044712918
SIM,1843,34,30-34,1877,10
STAT,1818,45,25-29,1863,0.10567043971906466
STAT,1765,104,na,1869,0.02675805407803071
STAT,1835,45,25-29,1880,0.05139560042985896
STAT,1844,29,30-34,1873,24.04077379018245
STAT,1871,52,na,1923,2149.0389203816117
STAT,1871,49,45-49,1920,0.23186374046045297
STAT,1805,63,na,1868,1049.9591548949245
SIM,1868,17,15-19,1885,8
STAT,1820,48,45-49,1868,0.395331850364405
STAT,1835,27,50-100,1862,0.6259825788660264
SIM,1892,42,na,1934,3130
STAT,1860,19,30-34,1879,1.499875820701438
STAT,1900,20,45-49,1920,0.9841873374002333
STAT,1809,45,15-19,1854,0.0015140297084645046
STAT,1933,20,40-44,1953,4.533787461260789
STAT,1870,38,30-34,1908,5.259594951345758
SIM,1877,17,25-29,1894,8
SIM,1852,29,30-34,1881,5
STAT,1839,50,35-39,1889,0.006255462380366859
SIM,1812,85,na,1897,48
STAT,1919,44,35-39,1963,0.2195959864433829
SIM,1920,15,30-34,1935,22
SIM,1896,72,na,1968,2002
STAT,1846,33,50-100,1879,0.8132124596272996
SIM,1907,23,15-19,1930,6
SIM,1821,62,na,1883,1001
STAT,1841,30,na,1871,2007.660538651648
SIM,1863,91,na,1954,44
SIM,1916,29,25-29,1945,6
STAT,1876,36,15-19,1912,0.058842242766714604
SIM,1897,33,50-100,1930,1
SIM,1911,20,30-34,1931,45
STAT,1854,32,15-19,1886,0.10944649922202089
STAT,1885,16,50-100,1901,0.04937435104338173
STAT,1903,25,30-34,1928,36.46772033256069
STAT,1873,39,50-100,1912,1.2444454366012583
SIM,1880,22,25-29,1902,60
STAT,1843,34,50-100,1877,0.7276587341285233
STAT,1831,71,na,1902,838.7893826646336
SIM,1836,44,40-44,1880,4
STAT,1841,35,50-100,1876,1.1044301207721796
STAT,1916,20,40-44,1936,3.576809641736599
STAT,1907,37,25-29,1944,0.9217510907011949
STAT,1776,89,na,1865,30.68014911747156
STAT,1840,52,40-44,1892,0.007340466139126764
STAT,1889,41,35-39,1930,2.2653811087498648
SIM,1852,35,25-29,1887,2
STAT,1827,29,30-34,1856,41.63216350419927
STAT,1832,28,50-100,1860,0.5815698895092416
STAT,1848,34,40-44,1882,3.6802905140468885
SIM,1868,23,na,1891,2142
SIM,1835,29,30-34,1864,33
SIM,1789,74,na,1863,429
SIM,1936,34,35-39,1970,16
SIM,1876,58,na,1934,2260
STAT,1952,14,na,1966,4754.3110712475955
SIM,1941,20,40-44,1961,7
STAT,1928,44,45-49,1972,0.21373735256781898
SIM,1926,28,na,1954,4439
SIM,1905,26,45-49,1931,1
STAT,1868,88,na,1956,148.09661504977697
STAT,1923,6,na,1929,4755.324745692524
STAT,1830,45,35-39,1875,0.12017207253175304
STAT,1874,24,40-44,1898,2.1415624033771565
SIM,1922,44,na,1966,4786
STAT,1876,35,30-34,1911,5.610696746013747
STAT,1941,16,50-100,1957,0.38971319270021704
STAT,1908,29,25-29,1937,62.36129983256516
SIM,1826,93,na,1919,49
STAT,1899,41,35-39,1940,0.17509260022634948
SIM,1932,37,25-29,1969,4
STAT,1871,30,25-29,1901,10.360290569621492
SIM,1861,19,30-34,1880,1
STAT,1788,74,na,1862,415.09140231981195
STAT,1868,25,25-29,1893,41.110201139532705
SIM,1921,30,40-44,1951,10
STAT,1883,45,50-100,1928,0.24516405277664713
SIM,1899,30,45-49,1929,6
STAT,1848,40,35-39,1888,1.514959350547961
SIM,1856,38,na,1894,2097
SIM,1888,41,25-29,1929,2
STAT,1916,23,50-100,1939,0.6936611363892395
SIM,1902,30,30-34,1932,40
STAT,1798,98,na,1896,1.0808781322378835
STAT,1813,52,40-44,1865,0.029112084140524793
SIM,1928,35,na,1963,4915
STAT,1849,50,35-39,1899,0.00682774539500729
SIM,1878,25,35-39,1903,14
SIM,1893,36,25-29,1929,3
STAT,1791,78,na,1869,279.664420698326
STAT,1885,49,30-34,1934,0.09528479359613475
STAT,1924,37,25-29,1961,1.173229282289143
STAT,1895,35,40-44,1930,5.828600035102396
SIM,1884,35,30-34,1919,1
STAT,1884,45,50-100,1929,0.24705509251897334
SIM,1931,16,45-49,1947,3
SIM,1941,4,na,1945,4316
STAT,1853,19,30-34,1872,1.5669565165988641
STAT,1920,37,50-100,1957,0.4642135531236252
STAT,1906,45,na,1951,3343.3668720253304
SIM,1871,22,15-19,1893,1
STAT,1881,53,40-44,1934,0.010084791492961391
STAT,1828,44,40-44,1872,2.0762812587578026
SIM,1919,40,na,1959,3978
SIM,1898,45,na,1943,3100
STAT,1830,29,50-100,1859,0.6434426882878322
STAT,1861,49,45-49,1910,0.1939345549409401
SIM,1900,23,20-24,1923,99
STAT,1885,36,25-29,1921,2.9084972421015087
STAT,1869,17,25-29,1886,5.641546521379992
STAT,1902,41,20-24,1943,0.015811476914756598
SIM,1901,15,20-24,1916,37
STAT,1912,15,30-34,1927,2.4981960502000846
STAT,1823,52,40-44,1875,0.013947184134461497
STAT,1826,31,na,1857,1613.5433885461596
SIM,1855,50,na,1905,1866
STAT,1914,26,45-49,1940,1.7632175558938
SIM,1876,36,na,1912,2741
SIM,1831,46,na,1877,1639
SIM,1884,87,na,1971,330
STAT,1885,20,na,1905,2391.8591340698
STAT,1909,28,na,1937,3600.027520125843
STAT,1933,27,25-29,1960,88.31480345920814
SIM,1856,40,35-39,1896,1
STAT,1813,98,na,1911,1.4243517485439114
STAT,1929,18,45-49,1947,0.6426785305339489
STAT,1830,52,40-44,1882,0.00774401768171396
STAT,1913,30,40-44,1943,3.959956200577306
STAT,1866,47,50-100,1913,0.22862227820950445
STAT,1917,41,20-24,1958,0.018629993698230915
STAT,1918,30,na,1948,4090.036995899311
SIM,1942,16,20-24,1958,146
STAT,1883,20,35-39,1903,5.802034133743639
SIM,1842,29,30-34,1871,32
STAT,1816,45,15-19,1861,0.0010657097845010025
SIM,1879,17,35-39,1896,1
SIM,1838,25,na,1863,1914
SIM,1890,41,25-29,1931,1
STAT,1878,43,25-29,1921,0.6684090353875721
SIM,1906,31,45-49,1937,3
STAT,1951,19,25-29,1970,52.10241838584796
SIM,1846,16,25-29,1862,6
SIM,1897,35,40-44,1932,12
STAT,1883,36,15-19,1919,0.05576869116560148
SIM,1835,36,na,1871,1637
STAT,1872,38,40-44,1910,4.422960547839
STAT,1894,28,50-100,1922,0.8288866496370725
STAT,1909,44,35-39,1953,0.18772484867711187
STAT,1814,62,na,1876,1055.2780781456204
STAT,1935,36,30-34,1971,2.5772173579631197
STAT,1861,25,15-19,1886,0.38911766444280704
SIM,1921,20,30-34,1941,42
STAT,1784,90,na,1874,25.459694240694457
STAT,1871,46,35-39,1917,0.14087823646178088
SIM,1880,38,40-44,1918,10
SIM,1822,32,35-39,1854,20
STAT,1900,44,20-24,1944,0.015263977577734605
SIM,1886,43,25-29,1929,3
STAT,1863,22,15-19,1885,3.011098257640046
STAT,1932,31,45-49,1963,2.1151982878933855
STAT,1825,29,20-24,1854,47.72359737936573
STAT,1903,18,50-100,1921,0.07028593514376251
SIM,1833,29,20-24,1862,9
STAT,1785,91,na,1876,18.26652723849466
STAT,1889,35,40-44,1924,5.50349219701229
STAT,1895,40,20-24,1935,0.21158218592054104
STAT,1899,16,50-100,1915,0.06807697228821372
STAT,1820,43,15-19,1863,0.02516704664994902
STAT,1818,42,15-19,1860,0.02710897939888214
STAT,1834,29,30-34,1863,19.383966486733435
SIM,1857,17,15-19,1874,8
STAT,1888,15,na,1903,3024.793208633056
SIM,1934,34,25-29,1968,7
STAT,1885,33,15-19,1918,0.14256363873063796
STAT,1770,92,na,1862,5.58073481241223
STAT,1884,40,45-49,1924,1.5056872958594363
SIM,1937,34,40-44,1971,6
SIM,1891,20,35-39,1911,9
STAT,1892,54,na,1946,2653.9102532243055
SIM,1938,18,20-24,1956,136
SIM,1922,24,50-100,1946,1
STAT,1838,16,25-29,1854,5.040421049588003
STAT,1810,72,na,1882,685.7833216916326
STAT,1823,109,na,1932,3.934823930989442E-4
STAT,1880,24,40-44,1904,2.196480934385771
STAT,1776,95,na,1871,2.134827023766955
SIM,1820,37,30-34,1857,1
SIM,1940,19,20-24,1959,138
STAT,1863,79,na,1942,625.6221356068289
STAT,1923,16,45-49,1939,0.5941302097176873
SIM,1867,59,na,1926,1727
STAT,1937,33,30-34,1970,15.72639753498639
STAT,1857,27,15-19,1884,0.3683628785245612
STAT,1932,19,20-24,1951,180.44836183564107
STAT,1936,15,40-44,1951,1.358219436161469
SIM,1821,33,40-44,1854,4
STAT,1908,26,20-24,1934,17.627301567181934
SIM,1856,81,na,1937,297
STAT,1869,50,20-24,1919,7.350191016203807E-4
STAT,1831,26,40-44,1857,2.671217092827567
STAT,1845,53,30-34,1898,0.004279609840407469
SIM,1904,30,40-44,1934,17
STAT,1904,42,25-29,1946,0.06455392612880582
STAT,1876,30,45-49,1906,1.8331502899355892
SIM,1884,30,45-49,1914,2
STAT,1914,24,50-100,1938,0.674010319857266
STAT,1881,36,na,1917,2304.737682843066
STAT,1878,7,na,1885,2807.3297217230065
STAT,1905,17,50-100,1922,0.07153287556084201
STAT,1914,40,na,1954,3738.9523881737405
SIM,1852,49,45-49,1901,3
SIM,1892,40,45-49,1932,4
SIM,1911,25,30-34,1936,69
STAT,1849,17,15-19,1866,5.7114044743582975
STAT,1875,26,15-19,1901,0.47220314267921615
STAT,1929,34,40-44,1963,5.017718182414421
SIM,1850,19,na,1869,2184
STAT,1847,53,40-44,1900,0.00775587995305507
SIM,1816,53,50-100,1869,1
STAT,1835,35,15-19,1870,0.053219967321041194
STAT,1897,41,25-29,1938,0.060654350708354746
STAT,1938,23,50-100,1961,0.657211128582903
SIM,1868,24,20-24,1892,61
SIM,1878,5,na,1883,3200
SIM,1848,20,30-34,1868,1
STAT,1835,48,na,1883,1757.1838686160368
STAT,1896,10,na,1906,3463.061753800353
SIM,1816,39,30-34,1855,5
STAT,1920,29,40-44,1949,5.126431508035266
STAT,1926,34,25-29,1960,11.28056452400058
STAT,1861,44,15-19,1905,0.011433867911320401
STAT,1859,43,20-24,1902,0.12807754000959634
STAT,1921,30,30-34,1951,17.850342269248234
SIM,1809,81,na,1890,155
SIM,1916,26,20-24,1942,23
STAT,1839,41,50-100,1880,0.8786673894249845
STAT,1832,104,na,1936,0.04541767107408447
SIM,1856,34,40-44,1890,5
STAT,1842,35,15-19,1877,0.06055279363151496
STAT,1891,49,30-34,1940,0.06685454939352002
STAT,1903,31,na,1934,3446.5288346218513
SIM,1881,39,50-100,1920,1
SIM,1898,18,15-19,1916,7
STAT,1909,31,20-24,1940,2.358399621105815
STAT,1843,96,na,1939,5.791423932823915
STAT,1856,51,25-29,1907,0.0027558674163807666
STAT,1901,47,50-100,1948,0.19523679858438064
STAT,1913,20,30-34,1933,28.267819482733657
SIM,1917,31,20-24,1948,2
SIM,1872,28,na,1900,2581
SIM,1887,28,40-44,1915,3
SIM,1859,25,25-29,1884,39
STAT,1861,39,35-39,1900,5.876417526305504
SIM,1815,50,na,1865,1392
STAT,1841,95,na,1936,9.942596936374379
STAT,1907,34,20-24,1941,2.2824028934454117
SIM,1934,37,35-39,1971,5
STAT,1859,24,15-19,1883,2.7407175624705253
SIM,1837,24,35-39,1861,7
SIM,1935,26,30-34,1961,69
SIM,1938,13,na,1951,3849
STAT,1831,37,40-44,1868,3.4991809330840544
SIM,1847,21,na,1868,1981
STAT,1837,32,15-19,1869,0.1218090328594616
STAT,1911,45,35-39,1956,0.12372137514927446
STAT,1869,45,40-44,1914,0.16978729074365748
STAT,1874,82,na,1956,517.5159699577118
STAT,1829,35,50-100,1864,1.0390427554301453
SIM,1905,26,na,1931,3591
STAT,1896,15,35-39,1911,0.7369892108179713
STAT,1858,70,na,1928,1111.7771749436324
SIM,1797,69,na,1866,671
SIM,1832,22,na,1854,1930
SIM,1834,88,na,1922,31
SIM,1895,38,40-44,1933,1
SIM,1861,29,40-44,1890,2
STAT,1887,38,40-44,1925,4.911789391567288
STAT,1844,48,30-34,1892,0.07562431689021594
STAT,1877,17,15-19,1894,6.18631411397667
SIM,1867,24,15-19,1891,3
STAT,1906,41,45-49,1947,0.153583235584195
STAT,1881,23,35-39,1904,5.663666845142506
STAT,1822,40,15-19,1862,0.023081508266873652
STAT,1926,37,35-39,1963,2.987551284110853
SIM,1915,34,20-24,1949,4
STAT,1927,26,30-34,1953,48.311812519119435
STAT,1844,32,15-19,1876,0.13473533679918068
STAT,1922,31,50-100,1953,0.9475895788967954
STAT,1949,18,30-34,1967,14.316857733352489
STAT,1851,19,20-24,1870,16.129222893784767
STAT,1885,33,20-24,1918,2.706019133444875
STAT,1923,42,35-39,1965,0.2378014590467292
SIM,1803,65,na,1868,753
STAT,1879,28,40-44,1907,3.1462100408183096
STAT,1933,23,45-49,1956,1.5076811086464685
STAT,1938,27,45-49,1965,1.727872219289205
STAT,1841,40,25-29,1881,0.5119542189992127
STAT,1916,36,20-24,1952,0.27373724317758646
SIM,1909,62,na,1971,3443
SIM,1929,17,na,1946,4577
STAT,1915,3,na,1918,4269.562042584916
SIM,1806,79,na,1885,290
STAT,1799,107,na,1906,0.0015825410388001107
SIM,1860,34,30-34,1894,25
STAT,1901,24,na,1925,3327.6090227260793
SIM,1941,24,20-24,1965,179
STAT,1898,47,15-19,1945,3.0749855992398767E-4
STAT,1863,57,na,1920,1798.3982175366514
STAT,1958,2,na,1960,5220.65423466185
STAT,1928,41,40-44,1969,0.3227594658713308
STAT,1830,42,30-34,1872,0.9989024102514824
STAT,1846,37,40-44,1883,3.4691227964127065
STAT,1902,49,40-44,1951,0.13495418536631928
STAT,1852,34,30-34,1886,13.428013050683184
STAT,1869,36,na,1905,2324.6066483900386
STAT,1953,16,30-34,1969,14.901312562276866
SIM,1909,20,15-19,1929,7
STAT,1931,19,15-19,1950,59.71289087199323
STAT,1924,21,45-49,1945,1.3456901840787214
STAT,1839,31,35-39,1870,8.927815223843327
SIM,1796,78,na,1874,308
STAT,1858,19,15-19,1877,5.428578113844375
SIM,1893,33,20-24,1926,4
SIM,1882,24,40-44,1906,2
SIM,1898,39,na,1937,3203
STAT,1902,30,20-24,1932,3.888978666505827
SIM,1854,37,40-44,1891,5
STAT,1914,23,40-44,1937,3.455179956153125
STAT,1935,31,30-34,1966,22.035167413027366
SIM,1850,48,50-100,1898,3
SIM,1936,31,30-34,1967,21
STAT,1875,42,na,1917,2394.3068778296956
STAT,1898,70,na,1968,2255.7812178139593
STAT,1934,17,na,1951,5030.514251835477
STAT,1860,15,na,1875,2211.7252171762225
STAT,1863,41,15-19,1904,0.012414193468589144
STAT,1905,48,15-19,1953,3.2530665176436E-4
STAT,1834,25,15-19,1859,0.3594611851140412
STAT,1834,82,na,1916,277.7231653141605
SIM,1818,64,na,1882,874
STAT,1847,33,na,1880,1885.577879763867
STAT,1851,54,na,1905,1585.5186809670595
SIM,1902,20,20-24,1922,131
STAT,1859,43,15-19,1902,0.011137177993667438
STAT,1863,32,25-29,1895,9.166001804037167
STAT,1891,30,35-39,1921,12.765467601960585
SIM,1851,60,na,1911,1553
STAT,1855,81,na,1936,407.0447145581914
SIM,1847,31,35-39,1878,11
STAT,1890,46,45-49,1936,0.16476246586028206
STAT,1905,29,15-19,1934,0.6577148853085694
SIM,1860,80,na,1940,488
STAT,1840,22,35-39,1862,5.2020254700390645
SIM,1880,57,na,1937,1869
STAT,1895,19,na,1914,3313.3175379752856
SIM,1914,49,na,1963,3810
SIM,1823,94,na,1917,12
STAT,1910,42,25-29,1952,0.06808881802289601
STAT,1896,22,50-100,1918,0.5451836435428975
SIM,1922,23,40-44,1945,7
SIM,1815,46,50-100,1861,4
STAT,1818,42,20-24,1860,0.3117532462490811
SIM,1902,21,50-100,1923,1
STAT,1883,1,na,1884,3302.68074118871
STAT,1920,48,50-100,1968,0.251778392902142
SIM,1929,39,na,1968,4690
SIM,1944,15,40-44,1959,1
SIM,1953,2,na,1955,4927
SIM,1866,19,15-19,1885,6
STAT,1876,31,15-19,1907,0.14911573868281222
SIM,1846,27,40-44,1873,2
STAT,1831,48,20-24,1879,0.00884912162138878
STAT,1878,33,15-19,1911,0.1486779254765065
SIM,1840,66,na,1906,1091
SIM,1838,19,na,1857,2066
STAT,1849,99,na,1948,1.480725414798874
STAT,1880,48,40-44,1928,0.1793119066077737
SIM,1866,40,35-39,1906,1
SIM,1909,16,na,1925,4193
STAT,1865,49,20-24,1914,0.010836000420864236
SIM,1908,31,na,1939,3495
STAT,1860,45,20-24,1905,0.010006292778819518
STAT,1815,50,25-29,1865,0.007815109168508381
STAT,1820,38,35-39,1858,16.142647736721063
STAT,1916,23,na,1939,3849.7369098832114
STAT,1930,32,25-29,1962,12.055878280861137
STAT,1827,39,40-44,1866,4.8601795959253735
SIM,1835,39,40-44,1874,7
STAT,1933,24,20-24,1957,148.94376561439253
STAT,1911,26,35-39,1937,14.822147619214087
STAT,1914,7,na,1921,4158.287750179709
SIM,1926,34,na,1960,4562
STAT,1913,33,45-49,1946,1.572961107334847
SIM,1820,37,na,1857,1558
SIM,1887,17,25-29,1904,7
STAT,1924,48,25-29,1972,0.06363757591413197
STAT,1833,23,40-44,1856,1.9748367357801686
STAT,1838,27,40-44,1865,2.550848187049376
STAT,1844,32,20-24,1876,2.5574291072816715
STAT,1931,12,na,1943,5241.45109436396
SIM,1873,40,35-39,1913,3
STAT,1872,49,20-24,1921,0.011930636530238486
STAT,1902,55,na,1957,2992.62435464664
STAT,1808,102,na,1910,0.11052916844015294
STAT,1929,15,40-44,1944,1.8126101024975845
STAT,1865,23,50-100,1888,0.37792567972079133
SIM,1902,39,40-44,1941,3
SIM,1941,23,45-49,1964,1
STAT,1846,85,na,1931,208.03647502502383
STAT,1802,101,na,1903,0.1993663445378139
SIM,1871,9,na,1880,2596
STAT,1882,41,25-29,1923,0.6310954662221566
STAT,1884,25,na,1909,2393.0913328847055
STAT,1948,15,45-49,1963,0.5778087656346362
STAT,1860,15,15-19,1875,5.718111753847259
STAT,1788,80,na,1868,235.05013476437477
STAT,1878,56,na,1934,2138.464017319944
STAT,1864,16,35-39,1880,0.5718609773693679
STAT,1894,39,50-100,1933,1.5804095032331877
STAT,1865,40,35-39,1905,1.686885122949585
STAT,1871,46,40-44,1917,0.17227395733312276
SIM,1900,26,25-29,1926,64
STAT,1850,48,30-34,1898,0.07318976325887451
STAT,1884,41,15-19,1925,0.013816757222495285
SIM,1918,15,30-34,1933,3
STAT,1858,27,na,1885,1935.8583655520147
STAT,1837,42,25-29,1879,0.5169471122455135
STAT,1942,26,20-24,1968,19.3523064495235
STAT,1863,24,50-100,1887,0.3668744694300647
STAT,1934,16,20-24,1950,185.7468317645262
STAT,1896,34,35-39,1930,13.423172982167783
SIM,1818,42,na,1860,1364
STAT,1866,41,50-100,1907,0.9924988096047178
STAT,1912,18,35-39,1930,0.8538144529392906
SIM,1879,60,na,1939,2210
STAT,1829,43,35-39,1872,1.385584031296276
SIM,1864,33,na,1897,2541
STAT,1926,17,50-100,1943,0.464244783142028
STAT,1916,34,50-100,1950,0.8540549677327229
STAT,1892,76,na,1968,1598.2781183531897
STAT,1947,18,20-24,1965,154.21436081271
STAT,1850,26,50-100,1876,0.5805904062585802
STAT,1818,49,40-44,1867,0.29587736767444034
STAT,1886,43,15-19,1929,0.014620323182565976
STAT,1893,47,30-34,1940,0.06969902492109391
SIM,1850,29,20-24,1879,12
SIM,1858,79,na,1937,425
SIM,1847,44,40-44,1891,7
STAT,1848,30,25-29,1878,9.956998835879178
STAT,1878,47,na,1925,2347.859187376715
SIM,1854,89,na,1943,119
STAT,1895,43,25-29,1938,0.058391265798436405
STAT,1926,44,35-39,1970,0.2500559232360884
SIM,1861,25,25-29,1886,55
STAT,1815,47,na,1862,1314.4065923772064
STAT,1842,29,20-24,1871,12.874886845804454
SIM,1896,19,na,1915,3357
STAT,1835,42,15-19,1877,0.012424169100683523
STAT,1867,45,30-34,1912,0.09299626327010677
STAT,1935,27,35-39,1962,20.676949836720468
STAT,1835,61,na,1896,1402.5002991987642
SIM,1855,34,na,1889,2044
STAT,1844,25,15-19,1869,0.44580926795951786
STAT,1912,48,na,1960,3552.18859118558
STAT,1813,48,45-49,1861,0.6742847068446997
STAT,1861,93,na,1954,24.528291838950345
STAT,1855,33,35-39,1888,7.6814599690084435
STAT,1809,49,30-34,1858,0.32077842431105563
STAT,1830,45,40-44,1875,0.14695327692850974
STAT,1861,32,50-100,1893,0.7689866751814561
STAT,1851,29,30-34,1880,22.005867275615703
SIM,1890,16,na,1906,3475
STAT,1905,40,50-100,1945,0.1081967168814861
STAT,1872,56,na,1928,2071.0869805245684
SIM,1943,27,35-39,1970,21
SIM,1923,23,na,1946,4236
STAT,1904,19,45-49,1923,0.09417191935889621
SIM,1857,2,na,1859,3041
SIM,1803,74,na,1877,448
STAT,1828,97,na,1925,3.487429556322568
SIM,1904,32,30-34,1936,29
STAT,1823,42,na,1865,1524.5125458512111
SIM,1854,21,25-29,1875,68
STAT,1804,84,na,1888,105.02213013697923
SIM,1889,22,na,1911,2915
STAT,1884,41,na,1925,2312.399180819525
SIM,1904,41,na,1945,3508
STAT,1762,109,na,1871,0.002058170162201683
STAT,1896,38,50-100,1934,1.6332540099553483
SIM,1930,22,30-34,1952,59
SIM,1843,39,30-34,1882,14
STAT,1939,22,40-44,1961,3.408948495822336
SIM,1836,40,25-29,1876,4
STAT,1810,54,20-24,1864,0.0025969416753965787
STAT,1930,33,45-49,1963,2.0512628400413258
SIM,1950,17,25-29,1967,60
SIM,1821,84,na,1905,176
STAT,1850,23,40-44,1873,1.901373720009343
STAT,1942,17,25-29,1959,45.7244674489164
SIM,1883,31,na,1914,2685
STAT,1828,52,25-29,1880,0.0031159135116204614
SIM,1841,39,na,1880,1698
STAT,1897,29,na,1926,3208.39671197954
SIM,1825,77,na,1902,414
SIM,1852,39,40-44,1891,4
SIM,1935,30,na,1965,5168
SIM,1906,40,40-44,1946,4
STAT,1841,79,na,1920,522.8010741628186
STAT,1868,21,45-49,1889,0.6779860896763006
STAT,1901,7,na,1908,3688.8129316127242
STAT,1835,39,30-34,1874,4.845560146072297
SIM,1895,22,25-29,1917,89
STAT,1797,97,na,1894,1.341305914152343
STAT,1893,35,30-34,1928,6.899783211768367
SIM,1868,27,25-29,1895,63
STAT,1922,22,30-34,1944,33.29683822730247
STAT,1924,30,40-44,1954,4.634411442299131
SIM,1885,78,na,1963,993
STAT,1915,48,15-19,1963,3.73512163078168E-4
SIM,1916,29,30-34,1945,4
STAT,1921,33,35-39,1954,10.227733724010582
SIM,1881,88,na,1969,246
STAT,1869,53,25-29,1922,0.0034222648448832054
STAT,1937,23,50-100,1960,0.6466606602805602
SIM,1947,22,40-44,1969,5
STAT,1844,39,40-44,1883,3.5846508832935937
STAT,1814,99,na,1913,0.8864438794148034
SIM,1891,63,na,1954,2108
STAT,1826,87,na,1913,96.6739870925126
SIM,1859,27,na,1886,2206
STAT,1827,32,na,1859,1722.515388440337
SIM,1878,84,na,1962,571
STAT,1907,33,45-49,1940,1.4788927820821778
STAT,1909,37,35-39,1946,2.310259292215533
STAT,1861,32,15-19,1893,0.11951992922325456
STAT,1831,29,45-49,1860,0.9354160251615687
SIM,1923,45,na,1968,4406
SIM,1909,8,na,1917,4254
SIM,1856,30,25-29,1886,15
STAT,1924,8,na,1932,4799.443936927676
STAT,1905,60,na,1965,2996.7443631733745
STAT,1861,48,30-34,1909,0.08022150291875682
STAT,1848,49,na,1897,1798.54840454848
SIM,1880,39,50-100,1919,4
SIM,1918,26,50-100,1944,1
STAT,1836,50,50-100,1886,0.010029548301964765
SIM,1811,44,50-100,1855,1
SIM,1931,3,na,1934,5240
STAT,1870,22,20-24,1892,68.34660120022961
STAT,1910,18,25-29,1928,8.640524032017861
SIM,1932,30,40-44,1962,5
SIM,1909,19,na,1928,4163
STAT,1837,21,50-100,1858,0.3668202430283992
SIM,1902,23,30-34,1925,48
SIM,1892,29,na,1921,3236
STAT,1887,22,25-29,1909,64.55278197314455
SIM,1915,33,45-49,1948,4
STAT,1880,39,45-49,1919,2.0932306493442128
STAT,1797,94,na,1891,4.989991671693421
STAT,1872,53,na,1925,2151.266907926491
STAT,1908,29,30-34,1937,37.12348114934012
STAT,1845,42,15-19,1887,0.010275495644617124
SIM,1920,32,50-100,1952,1
STAT,1885,26,15-19,1911,0.45768957760057916
STAT,1830,33,40-44,1863,4.096022524836955
SIM,1835,28,50-100,1863,1
SIM,1929,28,20-24,1957,25
STAT,1821,42,50-100,1863,1.6844286389773868
SIM,1886,48,50-100,1934,1
STAT,1890,37,50-100,1927,1.5152320264464774
SIM,1821,87,na,1908,106
SIM,1946,24,40-44,1970,4
SIM,1916,17,30-34,1933,3
STAT,1839,18,50-100,1857,0.04516937953104586
STAT,1852,46,30-34,1898,0.07362077180011187
STAT,1867,54,50-100,1921,0.013971009082879432
STAT,1870,34,15-19,1904,0.1400290309836775
SIM,1893,26,15-19,1919,1
STAT,1825,39,30-34,1864,8.111516679211134
STAT,1917,47,50-100,1964,0.23846439772527261
SIM,1833,39,30-34,1872,4
STAT,1867,30,35-39,1897,9.710519335921417
STAT,1869,41,25-29,1910,0.6334247378087061
STAT,1881,11,na,1892,2517.993486521297
SIM,1789,90,na,1879,10
STAT,1839,20,50-100,1859,0.37686745306960395
SIM,1828,31,25-29,1859,15
STAT,1853,25,25-29,1878,41.11368480685291
STAT,1935,20,15-19,1955,7.328815077819319
STAT,1839,44,40-44,1883,1.638199374706183
SIM,1877,37,na,1914,2445
SIM,1931,40,na,1971,4923
STAT,1804,87,na,1891,54.61950420162097
STAT,1857,20,30-34,1877,16.444160954137725
STAT,1917,44,25-29,1961,0.0749712187923283
SIM,1771,92,na,1863,3
SIM,1924,27,25-29,1951,84
SIM,1827,84,na,1911,172
STAT,1905,24,45-49,1929,1.0117830190566932
SIM,1889,25,na,1914,2913
STAT,1811,45,30-34,1856,0.24920396113195423
SIM,1839,30,30-34,1869,21
STAT,1861,29,30-34,1890,20.983614341286206
STAT,1813,41,25-29,1854,2.475992939610579
STAT,1921,46,40-44,1967,0.17995546237674276
SIM,1918,4,na,1922,4544
SIM,1792,91,na,1883,4
STAT,1836,54,40-44,1890,0.006458806350331219
SIM,1807,55,na,1862,1095
STAT,1925,17,30-34,1942,14.880317403704973
SIM,1809,68,na,1877,722
SIM,1809,84,na,1893,84
SIM,1897,31,25-29,1928,18
SIM,1891,23,45-49,1914,2
SIM,1822,47,na,1869,1500
SIM,1854,33,50-100,1887,4
STAT,1819,54,40-44,1873,0.018940778645642926
STAT,1898,21,30-34,1919,24.46236596388916
STAT,1889,31,25-29,1920,12.80820936732733
SIM,1873,21,35-39,1894,6
STAT,1938,24,40-44,1962,3.3571732007080772
SIM,1909,2,na,1911,4321
STAT,1847,89,na,1936,78.65746170802709
STAT,1826,107,na,1933,0.0025877399540076814
STAT,1865,34,40-44,1899,3.9653201624986405
STAT,1873,19,na,1892,2572.1241389006645
SIM,1834,32,na,1866,2009
SIM,1890,19,15-19,1909,9
STAT,1884,0,na,1884,3509.472099414826
STAT,1920,35,35-39,1955,2.6789272782249682
SIM,1836,61,na,1897,1341
SIM,1933,17,30-34,1950,18
STAT,1911,30,30-34,1941,15.602440370864036
STAT,1968,3,na,1971,4961.373350782445
STAT,1961,7,na,1968,5128.522250363699
STAT,1883,23,45-49,1906,0.6870829860287693
STAT,1911,23,25-29,1934,88.10758444687755
STAT,1916,27,25-29,1943,68.67980013283832
SIM,1895,47,50-100,1942,2
SIM,1927,25,50-100,1952,1
SIM,1913,24,45-49,1937,1
SIM,1918,18,35-39,1936,5
STAT,1820,47,30-34,1867,0.1646340945080516
STAT,1896,66,na,1962,2366.8745163600493
STAT,1882,19,15-19,1901,5.774916635624094
STAT,1854,37,na,1891,1768.1292078266015
STAT,1870,29,40-44,1899,2.949731012195533
STAT,1904,40,40-44,1944,0.22867536416115702
STAT,1934,19,30-34,1953,16.569170694670742
STAT,1886,45,40-44,1931,0.18438659088032003
STAT,1935,33,20-24,1968,3.4073231076735526
SIM,1867,22,na,1889,2166
SIM,1830,31,25-29,1861,20
SIM,1889,39,50-100,1928,3
STAT,1936,21,na,1957,3525.8680424179756
SIM,1887,15,35-39,1902,1
STAT,1865,21,35-39,1886,5.486620871055246
STAT,1880,32,25-29,1912,10.864437928914045
STAT,1934,32,50-100,1966,1.1406258501655335
STAT,1916,39,25-29,1955,1.0072972606514101
SIM,1924,39,25-29,1963,1
SIM,1858,64,na,1922,1367
SIM,1876,36,25-29,1912,7
STAT,1826,44,30-34,1870,1.1523832990490765
STAT,1880,20,25-29,1900,61.08331736296761
SIM,1858,45,na,1903,1861
SIM,1940,5,na,1945,4254
STAT,1874,66,na,1940,1695.0472332846282
STAT,1868,36,25-29,1904,2.7926394995571173
STAT,1860,68,na,1928,1261.7204794107736
STAT,1822,43,25-29,1865,0.9969895757023464
STAT,1910,44,15-19,1954,0.0014462914022467053
STAT,1840,91,na,1931,40.62070427647513
SIM,1927,18,45-49,1945,5
STAT,1862,53,30-34,1915,0.005108572445383501
STAT,1861,16,na,1877,2227.4304562428697
STAT,1886,51,na,1937,2307.1722575569665
STAT,1915,43,20-24,1958,0.017912619517033077
STAT,1863,44,25-29,1907,0.5669029306266239
STAT,1891,29,na,1920,2962.9659457849293
STAT,1930,30,50-100,1960,1.0796704862705706
STAT,1836,24,na,1860,1753.6498635842704
SIM,1911,20,na,1931,3791
SIM,1932,2,na,1934,6128
SIM,1834,44,30-34,1878,5
STAT,1816,39,20-24,1855,2.679783464929344
STAT,1845,26,50-100,1871,0.5730410371938535
SIM,1928,22,30-34,1950,58
STAT,1866,22,na,1888,2229.9306430839843
STAT,1936,18,45-49,1954,0.4815699030763097
SIM,1854,71,na,1925,1238
STAT,1845,44,40-44,1889,1.631282055128895
STAT,1919,18,45-49,1937,0.555915632792635
SIM,1843,49,na,1892,1995
STAT,1902,33,25-29,1935,14.55716843374864
SIM,1910,33,25-29,1943,11
SIM,1833,72,na,1905,788
STAT,1879,31,50-100,1910,0.9696692042706816
STAT,1861,90,na,1951,66.16932035386533
STAT,1832,54,40-44,1886,0.007188271131044504
STAT,1827,35,25-29,1862,3.511042847444537
STAT,1942,29,25-29,1971,69.68036410611003
SIM,1944,18,45-49,1962,3
STAT,1835,50,50-100,1885,0.012023420897424256
STAT,1846,21,25-29,1867,53.99009891956124
SIM,1917,34,30-34,1951,7
STAT,1894,26,25-29,1920,55.19479985945414
SIM,1873,53,na,1926,1995
SIM,1853,24,na,1877,1860
STAT,1924,45,20-24,1969,0.01335736126105299
STAT,1836,18,40-44,1854,0.280318944695527
STAT,1838,72,na,1910,845.4152877141055
SIM,1917,11,na,1928,4193
SIM,1907,17,20-24,1924,31
STAT,1908,48,50-100,1956,0.20591092543929732
SIM,1866,74,na,1940,1135
STAT,1796,109,na,1905,1.490517916101739E-4
STAT,1896,44,na,1940,3058.764214736827
STAT,1911,35,25-29,1946,0.9685588450495197
SIM,1889,21,30-34,1910,22
SIM,1891,66,na,1957,1985
SIM,1933,29,25-29,1962,109
SIM,1853,44,40-44,1897,5
SIM,1835,35,25-29,1870,2
SIM,1824,32,45-49,1856,1
SIM,1897,46,50-100,1943,1
SIM,1871,32,25-29,1903,2
STAT,1762,106,na,1868,0.008363047509956109
STAT,1854,49,45-49,1903,0.17341680634839954
SIM,1944,22,na,1966,3980
STAT,1915,19,20-24,1934,28.478572405094383
SIM,1790,84,na,1874,133
SIM,1923,19,20-24,1942,227
STAT,1876,17,50-100,1893,0.051090834939108806
STAT,1825,44,50-100,1869,1.447256796909253
STAT,1950,20,40-44,1970,4.0327537246462715
STAT,1925,29,25-29,1954,78.00500612814787
STAT,1877,15,25-29,1892,5.934575261460103
STAT,1823,76,na,1899,523.9743358707049
STAT,1903,41,50-100,1944,0.10600261808303797
SIM,1783,80,na,1863,225
STAT,1813,45,40-44,1858,0.516937562054603
STAT,1915,41,na,1956,3778.3767322458207
SIM,1881,82,na,1963,602
SIM,1884,40,50-100,1924,2
STAT,1850,47,50-100,1897,0.1871825706225676
STAT,1817,54,30-34,1871,0.011775942706332549
STAT,1879,15,35-39,1894,0.581026388629524
STAT,1819,50,25-29,1869,0.0069015316870808295
SIM,1898,36,na,1934,3242
SIM,1818,79,na,1897,273
STAT,1879,21,20-24,1900,72.85304403185049
STAT,1841,18,15-19,1859,5.690068408820671
STAT,1899,58,na,1957,2785.8061015090075
SIM,1819,43,na,1862,1515
STAT,1877,19,40-44,1896,0.1896399296211569
SIM,1857,82,na,1939,496
SIM,1932,37,na,1969,5797
STAT,1844,44,15-19,1888,0.010907080513049502
STAT,1901,16,25-29,1917,8.042984941660379
SIM,1846,33,35-39,1879,19
STAT,1842,22,45-49,1864,0.7918695627229521
SIM,1887,21,20-24,1908,75
SIM,1834,35,na,1869,1954
STAT,1865,30,25-29,1895,9.522234051298856
STAT,1870,25,25-29,1895,42.23868191160664
STAT,1930,23,35-39,1953,12.15410591478147
STAT,1911,25,50-100,1936,0.9859430859515926
STAT,1849,29,15-19,1878,0.41448085883747016
STAT,1862,78,na,1940,681.49424880456
SIM,1928,35,45-49,1963,1
STAT,1808,68,na,1876,746.5943925781522
STAT,1893,15,50-100,1908,0.06312113102958943
STAT,1926,46,25-29,1972,0.06631413104190423
SIM,1875,30,35-39,1905,15
STAT,1884,45,30-34,1929,0.09737350577204755
STAT,1876,40,50-100,1916,1.1128300806111435
SIM,1778,87,na,1865,12
SIM,1845,75,na,1920,772
SIM,1793,79,na,1872,264
STAT,1863,42,na,1905,2065.7583901166777
STAT,1858,40,35-39,1898,1.4493428448916017
SIM,1818,98,na,1916,5
SIM,1921,19,na,1940,4198
STAT,1930,30,40-44,1960,5.110229235256051
STAT,1903,34,na,1937,3432.0615250879428
SIM,1807,58,na,1865,1014
SIM,1882,20,25-29,1902,72
STAT,1853,22,20-24,1875,67.3349207544627
SIM,1808,80,na,1888,198
STAT,1851,38,na,1889,1784.3956283647753
SIM,1902,26,35-39,1928,27
STAT,1838,33,35-39,1871,8.336989862979568
STAT,1909,34,30-34,1943,15.041587431104416
SIM,1843,31,na,1874,2414
STAT,1886,41,25-29,1927,0.6878902859704819
SIM,1906,19,20-24,1925,26
SIM,1837,21,25-29,1858,80
STAT,1828,35,50-100,1863,1.3214803022465795
STAT,1909,43,20-24,1952,0.016568666644478005
STAT,1925,18,na,1943,4481.76584102262
STAT,1820,35,30-34,1855,15.00996653393551
STAT,1835,23,15-19,1858,3.2690153848078083
STAT,1900,19,50-100,1919,0.06836753438571924
STAT,1893,55,na,1948,2651.7216411095915
STAT,1826,40,15-19,1866,0.014994086704810295
STAT,1844,35,25-29,1879,2.7007775960869718
STAT,1924,33,45-49,1957,1.8539954582549798
SIM,1843,23,15-19,1866,4
STAT,1847,16,35-39,1863,0.5158054477594014
SIM,1908,15,na,1923,3767
STAT,1910,15,20-24,1925,27.229076319069346
STAT,1932,36,15-19,1968,0.02609834853350854
SIM,1861,22,20-24,1883,4
SIM,1856,3,na,1859,2845
STAT,1880,36,40-44,1916,4.665611463290442
SIM,1861,68,na,1929,1354
SIM,1865,12,na,1877,2471
SIM,1932,33,45-49,1965,2
STAT,1900,32,20-24,1932,3.7924215676711763
SIM,1878,22,25-29,1900,79
STAT,1818,39,30-34,1857,11.662013954137054
SIM,1870,64,na,1934,1976
SIM,1791,69,na,1860,596
SIM,1872,23,35-39,1895,8
STAT,1927,17,50-100,1944,0.47084493409659617
STAT,1884,59,na,1943,1935.6805799603785
STAT,1773,84,na,1857,106.54294045175703
STAT,1900,42,na,1942,3249.887897213898
STAT,1904,33,35-39,1937,8.392747266797342
SIM,1842,83,na,1925,165
STAT,1860,12,na,1872,2273.1561943576335
STAT,1843,44,30-34,1887,0.7781792856733514
STAT,1891,45,15-19,1936,2.8496220530364056E-4
STAT,1961,10,na,1971,5126.676203384076
STAT,1898,34,45-49,1932,2.3672144727478215
SIM,1829,26,35-39,1855,2
SIM,1906,43,45-49,1949,1
SIM,1845,72,na,1917,938
STAT,1847,86,na,1933,166.12691445167252
STAT,1918,20,15-19,1938,5.83073168524801
STAT,1871,53,40-44,1924,0.010394086856414783
SIM,1846,20,20-24,1866,57
SIM,1865,23,35-39,1888,8
STAT,1828,42,15-19,1870,0.013186373889550042
STAT,1895,33,15-19,1928,0.18703786133463832
SIM,1938,31,50-100,1969,5
STAT,1857,23,35-39,1880,5.272059113126244
STAT,1795,68,na,1863,825.7486458188976
SIM,1926,39,35-39,1965,4
STAT,1840,19,45-49,1859,0.05858959934019859
STAT,1883,32,50-100,1915,0.9055908396025274
SIM,1851,44,30-34,1895,5
SIM,1829,43,50-100,1872,1
STAT,1913,46,15-19,1959,3.636714108766344E-4
SIM,1850,22,45-49,1872,3
STAT,1907,48,50-100,1955,0.20290276520412862
STAT,1906,46,15-19,1952,3.328720806359766E-4
STAT,1903,56,na,1959,3016.7034029870815
SIM,1937,22,40-44,1959,3
STAT,1946,15,35-39,1961,4.703151271332194
STAT,1864,23,35-39,1887,5.365105630857649
SIM,1826,39,30-34,1865,8
SIM,1839,43,45-49,1882,1
STAT,1824,39,na,1863,1395.943769157539
STAT,1839,38,na,1877,1795.8601452299602
STAT,1821,52,30-34,1873,0.008391554734905932
STAT,1885,26,na,1911,2407.495479061451
STAT,1775,101,na,1876,0.09751311621370981
SIM,1915,30,40-44,1945,11
SIM,1891,32,50-100,1923,1
STAT,1802,107,na,1909,0.001647675413186772
STAT,1852,30,15-19,1882,0.11416850515472712
STAT,1900,45,na,1945,3188.613905933096
STAT,1893,20,35-39,1913,7.528313470367907
SIM,1915,48,50-100,1963,2
STAT,1841,48,20-24,1889,0.008899702500522485
STAT,1918,39,35-39,1957,2.5683386731714135
SIM,1908,37,na,1945,3400
STAT,1881,17,40-44,1898,0.1780680995640635
STAT,1935,24,30-34,1959,39.51598292535285
SIM,1805,91,na,1896,23
STAT,1854,17,50-100,1871,0.0439829970313612
STAT,1845,20,na,1865,1967.6487968210506
STAT,1908,17,30-34,1925,2.38670643961357
STAT,1852,18,50-100,1870,0.044672937728180165
STAT,1830,48,45-49,1878,0.19485670188241308
SIM,1843,46,na,1889,2046
SIM,1912,33,35-39,1945,10
SIM,1857,60,na,1917,1640
STAT,1913,32,30-34,1945,15.81574283981115
STAT,1802,58,na,1860,1015.8252068021379
STAT,1929,22,40-44,1951,4.297656669505971
SIM,1928,25,50-100,1953,1
STAT,1863,106,na,1969,0.12069137629915508
STAT,1888,17,35-39,1905,0.654122579470432
STAT,1859,36,15-19,1895,0.04583590223795985
STAT,1839,40,25-29,1879,0.5409786035723796
STAT,1907,30,40-44,1937,3.7231376002157313
STAT,1911,33,35-39,1944,8.939750462536695
SIM,1921,32,30-34,1953,19
SIM,1943,24,30-34,1967,41
STAT,1857,26,na,1883,1951.6403931217556
STAT,1888,18,na,1906,3002.9162635202874
STAT,1848,34,na,1882,2025.1076885829643
SIM,1891,41,na,1932,2993
SIM,1867,78,na,1945,646
STAT,1824,33,40-44,1857,7.481671381138138
STAT,1904,43,45-49,1947,0.1495495812894484
STAT,1880,54,50-100,1934,0.015579115262853906
STAT,1892,31,50-100,1923,1.165976067641788
STAT,1818,52,50-100,1870,0.02583032898383119
SIM,1892,26,na,1918,3240
STAT,1820,45,40-44,1865,0.30015374387956245
STAT,1928,43,30-34,1971,0.16447361511782724
SIM,1905,23,40-44,1928,4
STAT,1936,16,50-100,1952,0.36301558613187357
SIM,1832,33,40-44,1865,7
SIM,1876,33,20-24,1909,3
STAT,1920,16,35-39,1936,4.765802325670941
STAT,1867,41,15-19,1908,0.013195650932095447
STAT,1854,42,25-29,1896,0.4813368900078519
SIM,1870,42,na,1912,2559
STAT,1868,33,20-24,1901,2.5982269500641797
SIM,1865,49,na,1914,1996
STAT,1854,46,40-44,1900,0.1288480874085017
SIM,1954,15,35-39,1969,6
STAT,1881,30,na,1911,2341.9044624730614
SIM,1894,23,50-100,1917,3
SIM,1859,29,40-44,1888,6
SIM,1810,44,na,1854,1505
STAT,1912,32,50-100,1944,0.82079696781819
STAT,1782,80,na,1862,251.1041045007901
STAT,1946,25,45-49,1971,1.945383747536813
STAT,1851,25,15-19,1876,0.4080742020443135
SIM,1924,24,20-24,1948,127
SIM,1839,33,35-39,1872,1
STAT,1852,41,50-100,1893,0.8048298647554287
SIM,1887,34,35-39,1921,24
STAT,1880,41,15-19,1921,0.014714511000599185
SIM,1901,42,na,1943,3321
STAT,1880,22,15-19,1902,3.499309417481311
SIM,1902,32,20-24,1934,5
STAT,1898,24,35-39,1922,7.939971747370558
STAT,1829,37,40-44,1866,3.587445881770144
SIM,1894,55,na,1949,2919
SIM,1917,37,35-39,1954,4
STAT,1869,25,50-100,1894,0.6324129569463783
STAT,1838,20,20-24,1858,60.72015359986347
STAT,1916,24,20-24,1940,116.84901774481717
SIM,1926,20,15-19,1946,7
STAT,1801,73,na,1874,545.0465380778629
STAT,1859,74,na,1933,901.5207399978407
SIM,1929,17,40-44,1946,1
STAT,1811,48,35-39,1859,0.34305645280064007
STAT,1896,28,40-44,1924,3.990735877796311
STAT,1870,15,15-19,1885,6.0125047335628885
SIM,1910,56,na,1966,3053
SIM,1886,19,25-29,1905,11
SIM,1888,77,na,1965,1782
STAT,1874,63,na,1937,1845.308881790582
STAT,1882,49,20-24,1931,0.011495045426085967
STAT,1848,12,na,1860,2416.173441381618
SIM,1897,22,35-39,1919,8
STAT,1893,31,15-19,1924,0.18337584741237162
STAT,1925,46,50-100,1971,0.2776732032215544
STAT,1912,30,na,1942,3784.8028834937577
STAT,1920,22,20-24,1942,124.83317130895175
SIM,1886,11,na,1897,2915
STAT,1856,48,50-100,1904,0.18778982948055536
SIM,1930,29,15-19,1959,1
STAT,1903,28,35-39,1931,13.83029203441735
SIM,1933,26,20-24,1959,29
SIM,1812,43,40-44,1855,4
SIM,1911,28,35-39,1939,24
STAT,1922,29,15-19,1951,0.801233596354059
STAT,1838,75,na,1913,689.1491717370817
SIM,1845,18,25-29,1863,8
STAT,1832,50,25-29,1882,0.0026178740318139222
STAT,1889,22,35-39,1911,7.2674729935487585
SIM,1809,65,na,1874,819
SIM,1948,18,20-24,1966,182
STAT,1833,35,na,1868,1933.9155614650617
STAT,1791,94,na,1885,3.9167100818112317
STAT,1837,54,25-29,1891,0.002349980061480438
STAT,1871,34,40-44,1905,4.314309946987803
STAT,1939,32,na,1971,3895.683014863746
STAT,1861,46,40-44,1907,0.14409270365847526
STAT,1939,25,45-49,1964,1.7548534838372432
STAT,1904,19,na,1923,3641.0296428254524
STAT,1925,26,20-24,1951,21.863627737612312
SIM,1836,35,50-100,1871,1
SIM,1848,86,na,1934,127
STAT,1879,34,35-39,1913,10.582539889725297
STAT,1853,64,na,1917,1437.5816098846549
STAT,1874,30,35-39,1904,10.557492190519765
STAT,1866,17,15-19,1883,5.696814297412107
SIM,1931,0,na,1931,5482
STAT,1837,18,25-29,1855,6.192266016955585
STAT,1869,11,na,1880,2623.591244795109
STAT,1832,49,50-100,1881,0.17589275795883685
STAT,1836,49,na,1885,1446.9867340404046
SIM,1828,57,na,1885,1206
SIM,1890,19,na,1909,3385
SIM,1833,87,na,1920,89
STAT,1886,23,50-100,1909,0.43352110511912884
STAT,1827,32,20-24,1859,3.6379143709042157
STAT,1900,37,15-19,1937,0.017005152947431247
STAT,1936,0,na,1936,4354.4749950311725
SIM,1922,41,na,1963,4816
STAT,1816,72,na,1888,685.8369571909459
STAT,1885,45,15-19,1930,4.0614386248018864E-4
STAT,1913,45,45-49,1958,0.215041554850262
STAT,1911,39,40-44,1950,1.444051982617059
SIM,1882,30,35-39,1912,12
STAT,1893,30,45-49,1923,2.254326007573339
STAT,1801,95,na,1896,5.291364191424173
STAT,1924,33,na,1957,4456.03817399723
SIM,1942,18,na,1960,3983
SIM,1869,85,na,1954,272
SIM,1940,2,na,1942,4313
STAT,1919,41,30-34,1960,0.14008653156534734
STAT,1855,27,40-44,1882,2.350277332184906
STAT,1926,41,30-34,1967,0.1595177924280771
SIM,1846,20,na,1866,1945
STAT,1891,24,40-44,1915,2.589445010666125
STAT,1894,23,20-24,1917,89.33246017590271
STAT,1863,48,40-44,1911,0.15128010028738606
STAT,1845,40,25-29,1885,0.49021186950540213
STAT,1911,20,20-24,1931,107.02781468129528
STAT,1941,21,45-49,1962,1.1743195137858196
STAT,1875,19,15-19,1894,6.122409582624316
SIM,1929,32,50-100,1961,2
STAT,1869,43,15-19,1912,0.013462720098642009
SIM,1865,33,45-49,1898,1
SIM,1928,25,35-39,1953,22
SIM,1863,27,40-44,1890,3
SIM,1826,29,50-100,1855,4
STAT,1896,69,na,1965,2220.7489562116407
STAT,1945,2,na,1947,4460.723977388561
STAT,1770,95,na,1865,1.2803502692327806
STAT,1852,110,na,1962,7.536862060166207E-4
STAT,1857,33,45-49,1890,1.3687573208883317
SIM,1864,48,50-100,1912,2
STAT,1876,43,15-19,1919,0.014297450235347653
STAT,1850,26,15-19,1876,0.4117843929535292
STAT,1867,34,45-49,1901,1.6445602431932356
SIM,1857,54,na,1911,1817
SIM,1917,24,20-24,1941,137
STAT,1862,7,na,1869,2472.539100728294
STAT,1893,42,45-49,1935,1.9169904032767326
STAT,1766,103,na,1869,0.02502340815533202
STAT,1890,16,45-49,1906,0.08081647719483372
STAT,1888,24,35-39,1912,6.91299478484215
STAT,1872,15,40-44,1887,0.18854906687455492
STAT,1905,48,20-24,1953,0.009759208137455245
SIM,1825,40,40-44,1865,5
STAT,1913,24,40-44,1937,3.4043104001758744
SIM,1873,37,45-49,1910,2
STAT,1894,35,15-19,1929,0.07371324024693794
SIM,1853,44,35-39,1897,1
STAT,1840,22,40-44,1862,1.857606661720422
SIM,1831,25,45-49,1856,1
STAT,1884,31,40-44,1915,4.336999549372408
STAT,1915,21,40-44,1936,3.517687344529876
STAT,1873,29,20-24,1902,11.926093621063249
SIM,1875,34,45-49,1909,1
SIM,1892,31,40-44,1923,5
STAT,1886,11,na,1897,2758.0791902320925
STAT,1829,41,15-19,1870,0.010885196160113119
STAT,1862,42,15-19,1904,0.012030384130496497
STAT,1836,51,30-34,1887,0.0038754955540874383
STAT,1920,38,45-49,1958,0.7529825600853696
SIM,1880,66,na,1946,1431
STAT,1897,19,35-39,1916,0.738999971105769
SIM,1853,28,30-34,1881,38
SIM,1853,64,na,1917,1281
STAT,1915,13,na,1928,4164.366455809088
STAT,1820,77,na,1897,439.9948608822124
STAT,1878,52,20-24,1930,7.69556432024908E-4
STAT,1824,67,na,1891,788.0923414974466
SIM,1915,27,20-24,1942,27
SIM,1949,17,20-24,1966,143
STAT,1911,23,na,1934,3640.0819881872244
SIM,1874,18,20-24,1892,17
STAT,1854,52,35-39,1906,0.00642658811016759
STAT,1857,15,45-49,1872,0.06123786454119849
STAT,1911,27,40-44,1938,4.585881244628693
SIM,1922,35,na,1957,4839
STAT,1819,38,30-34,1857,14.034028945166899
STAT,1909,24,20-24,1933,103.6330251355585
STAT,1884,48,35-39,1932,0.13768724091829465
SIM,1942,24,50-100,1966,1
STAT,1864,95,na,1959,20.817471601372546
STAT,1845,28,30-34,1873,22.235354918666005
STAT,1843,49,30-34,1892,0.06392530849343164
SIM,1797,60,na,1857,905
STAT,1847,41,35-39,1888,1.3809647359850021
STAT,1896,32,15-19,1928,0.1903878384715382
STAT,1866,18,20-24,1884,16.91809332550882
STAT,1923,28,15-19,1951,0.8160494467767561
STAT,1826,51,45-49,1877,0.014068532158693756
STAT,1950,10,na,1960,4693.863039178246
STAT,1925,43,na,1968,4536.968593497393
SIM,1878,44,40-44,1922,1
SIM,1892,51,na,1943,2931
STAT,1855,18,45-49,1873,0.05813788671702054
STAT,1878,16,na,1894,2654.4872937333516
STAT,1782,100,na,1882,0.22373842984298473
SIM,1848,18,na,1866,2131
SIM,1848,28,20-24,1876,14
STAT,1782,98,na,1880,0.5970109707877989
STAT,1865,37,45-49,1902,1.8385050803987053
SIM,1855,41,35-39,1896,6
SIM,1857,20,35-39,1877,9
SIM,1842,25,20-24,1867,11
STAT,1883,48,50-100,1931,0.23969391249341143
STAT,1827,44,15-19,1871,0.01435500797457763
SIM,1774,91,na,1865,9
SIM,1839,40,40-44,1879,4
STAT,1883,62,na,1945,1806.477064477953
SIM,1840,28,20-24,1868,18
STAT,1813,51,35-39,1864,0.024291314037959442
SIM,1896,41,na,1937,3107
SIM,1907,17,15-19,1924,11
SIM,1878,26,40-44,1904,4
SIM,1933,25,15-19,1958,5
SIM,1807,95,na,1902,12
SIM,1934,20,na,1954,5057
STAT,1922,17,45-49,1939,0.5840401463211049
STAT,1843,47,35-39,1890,0.09398527432806737
SIM,1837,43,40-44,1880,2
STAT,1850,75,na,1925,788.2733348146143
SIM,1827,38,30-34,1865,6
STAT,1834,25,20-24,1859,9.29463914056707
STAT,1872,23,50-100,1895,0.41279939477013594
STAT,1931,38,20-24,1969,0.35247784478488864
STAT,1898,31,40-44,1929,5.962136149811535
SIM,1871,26,25-29,1897,43
STAT,1832,28,20-24,1860,10.665530735903758
STAT,1876,37,20-24,1913,0.8038743217693086
STAT,1896,34,40-44,1930,5.7482093715003915
SIM,1781,85,na,1866,26
STAT,1821,46,45-49,1867,0.3509444984910522
SIM,1894,29,30-34,1923,45
SIM,1930,30,na,1960,5215
STAT,1882,52,40-44,1934,0.010244869676769347
STAT,1879,37,45-49,1916,2.1011346349032136
SIM,1888,46,na,1934,2927
STAT,1817,40,40-44,1857,6.011240075693427
STAT,1863,26,25-29,1889,38.12887399364103
STAT,1924,33,50-100,1957,0.9741332008664393
SIM,1905,63,na,1968,2915
SIM,1917,22,25-29,1939,103
SIM,1930,17,45-49,1947,4
STAT,1807,83,na,1890,140.62476114614307
STAT,1871,31,30-34,1902,17.59109888297111
STAT,1827,28,50-100,1855,1.2841644127091791
STAT,1886,29,30-34,1915,26.661872458350967
STAT,1794,83,na,1877,139.51896099002875
STAT,1853,34,15-19,1887,0.11878381663271843
STAT,1847,23,35-39,1870,5.317804277886416
STAT,1868,47,40-44,1915,0.16448735693661992
STAT,1826,33,15-19,1859,0.1886703892052343
STAT,1923,46,15-19,1969,4.364888846708558E-4
SIM,1909,53,na,1962,3644
STAT,1849,40,50-100,1889,0.8404259971237903
STAT,1861,29,25-29,1890,35.248996726459296
SIM,1844,28,na,1872,1732
STAT,1929,33,na,1962,4852.647504056121
STAT,1925,25,15-19,1950,0.8483797753170357
SIM,1869,37,25-29,1906,2
SIM,1886,34,20-24,1920,2
STAT,1845,46,30-34,1891,0.07093122592041459
STAT,1849,90,na,1939,61.64172548387784
SIM,1838,87,na,1925,115
STAT,1831,49,na,1880,1477.6854257371926
STAT,1860,45,15-19,1905,3.335427992317065E-4
STAT,1880,42,35-39,1922,1.9183844282567741
STAT,1882,21,35-39,1903,5.726364081252349
STAT,1847,25,30-34,1872,22.99126106398003
SIM,1811,69,na,1880,846
SIM,1847,47,50-100,1894,1
STAT,1845,44,35-39,1889,1.3132884691969633
SIM,1849,59,na,1908,1550
SIM,1827,39,50-100,1866,1
STAT,1858,26,15-19,1884,0.3706880663598105
SIM,1926,25,na,1951,4464
STAT,1912,43,35-39,1955,0.19476384993359436
STAT,1867,52,45-49,1919,0.013731037821632963
STAT,1878,34,20-24,1912,2.8097709645370403
SIM,1836,92,na,1928,20
SIM,1874,26,na,1900,2326
SIM,1896,36,50-100,1932,1
STAT,1841,39,na,1880,1848.300260646754
SIM,1890,21,35-39,1911,15
STAT,1855,31,15-19,1886,0.11028405143667525
STAT,1829,32,50-100,1861,0.8161017928951737
STAT,1907,18,na,1925,3736.2347399866776
SIM,1838,28,35-39,1866,12
SIM,1855,25,30-34,1880,27
SIM,1959,12,na,1971,5498
STAT,1918,3,na,1921,4457.046813032437
STAT,1786,88,na,1874,47.729419160492114
SIM,1919,38,45-49,1957,1
STAT,1801,98,na,1899,1.2928558484254655
SIM,1846,82,na,1928,201
SIM,1822,35,50-100,1857,2
SIM,1865,30,40-44,1895,6
SIM,1826,39,25-29,1865,5
SIM,1862,33,20-24,1895,5
STAT,1827,46,40-44,1873,0.1779430637926439
STAT,1950,17,20-24,1967,161.95950104941545
SIM,1833,41,50-100,1874,3
SIM,1868,38,na,1906,2168
SIM,1846,36,45-49,1882,5
STAT,1830,33,35-39,1863,9.564999347856189
STAT,1866,62,na,1928,1709.3536944265823
STAT,1844,46,40-44,1890,0.13583530458251578
STAT,1880,24,35-39,1904,6.151006023281407
SIM,1839,22,40-44,1861,3
STAT,1860,18,25-29,1878,5.364145111964387
STAT,1903,32,30-34,1935,25.11428904701972
STAT,1778,114,na,1892,1.2993904651176523E-4
STAT,1876,24,15-19,1900,3.418826648628426
SIM,1843,39,25-29,1882,4
SIM,1845,33,20-24,1878,1
STAT,1824,36,45-49,1860,2.866733542824492
SIM,1837,28,45-49,1865,5
STAT,1917,48,40-44,1965,0.1657638889605174
STAT,1908,31,na,1939,3618.454333632261
SIM,1869,79,na,1948,712
STAT,1862,47,45-49,1909,0.20488433625839625
STAT,1866,90,na,1956,83.09252883277456
STAT,1846,110,na,1956,2.260574550473593E-4
STAT,1923,48,na,1971,4330.274737255181
STAT,1812,42,na,1854,1456.5856655314265
STAT,1891,27,45-49,1918,1.3884098393008206
STAT,1860,30,40-44,1890,3.6092889484358204
SIM,1863,36,45-49,1899,1
SIM,1873,13,na,1886,2544
STAT,1835,39,25-29,1874,2.617716386382108
STAT,1897,54,na,1951,2835.4186093132507
SIM,1821,33,35-39,1854,7
SIM,1837,46,na,1883,1444
STAT,1855,36,45-49,1891,1.5077611709652605
STAT,1813,83,na,1896,174.0624754665273
STAT,1848,22,40-44,1870,2.0715596780198315
STAT,1919,25,50-100,1944,1.0932418058279356
SIM,1842,21,na,1863,2022
SIM,1920,40,na,1960,4426
SIM,1941,17,20-24,1958,129
STAT,1935,33,na,1968,5283.239171397919
STAT,1891,27,15-19,1918,0.5673451311099866
SIM,1838,16,na,1854,2099
SIM,1851,97,na,1948,5
STAT,1829,46,45-49,1875,0.17838014988907716
STAT,1788,83,na,1871,124.59170403670767
STAT,1870,50,25-29,1920,0.0035634089701376734
STAT,1894,37,40-44,1931,5.692221727631551
STAT,1905,32,35-39,1937,8.490405731823941
STAT,1838,49,20-24,1887,0.00805536255567365
STAT,1844,47,25-29,1891,0.04535974949877147
STAT,1849,20,35-39,1869,5.596257564687518
STAT,1837,33,20-24,1870,2.288189519529304
SIM,1842,92,na,1934,23
SIM,1910,10,na,1920,3770
STAT,1839,47,15-19,1886,2.8894042382097447E-4
STAT,1850,44,45-49,1894,1.1305292391164294
STAT,1848,40,40-44,1888,1.8817845894205985
STAT,1824,36,15-19,1860,0.08075306714786529
SIM,1911,32,30-34,1943,7
STAT,1899,42,40-44,1941,0.21624250098750966
STAT,1837,51,20-24,1888,5.153540104105895E-4
SIM,1856,22,40-44,1878,3
STAT,1852,70,na,1922,1064.0801779778967
STAT,1933,17,20-24,1950,183.3956196017521
SIM,1913,32,35-39,1945,14
STAT,1928,38,45-49,1966,0.8699427795569102
STAT,1886,47,30-34,1933,0.10274559363480186
SIM,1868,23,15-19,1891,3
STAT,1809,49,25-29,1858,0.19087641593222857
STAT,1926,38,40-44,1964,1.8471582656077674
STAT,1820,43,20-24,1863,0.2894210208425329
STAT,1845,29,na,1874,1896.4304201795157
STAT,1800,57,na,1857,912.1619995458527
STAT,1881,53,35-39,1934,0.008246908950178334
SIM,1830,36,na,1866,1577
STAT,1867,34,15-19,1901,0.13430153590230148
STAT,1772,96,na,1868,1.0945348368328771
STAT,1913,27,50-100,1940,1.0006666540725675
STAT,1843,34,na,1877,1721.1764536804317
SIM,1871,23,20-24,1894,67
STAT,1839,29,na,1868,1904.4720799472004
SIM,1938,22,na,1960,3526
SIM,1883,26,20-24,1909,11
SIM,1867,84,na,1951,315
STAT,1878,19,25-29,1897,5.909446463645292
STAT,1886,45,35-39,1931,0.1507834274694808
STAT,1899,1,na,1900,3772.920281487068
STAT,1913,42,40-44,1955,0.24610442091434273
SIM,1906,24,45-49,1930,1
STAT,1896,37,45-49,1933,2.6651346422528754
SIM,1877,29,30-34,1906,34
STAT,1939,22,35-39,1961,9.546389591914647
STAT,1922,7,na,1929,4673.487674724701
STAT,1829,28,45-49,1857,1.2460906126579727
STAT,1907,27,20-24,1934,17.400415459282957
SIM,1936,7,na,1943,3960
STAT,1869,45,35-39,1914,0.13884474742365013
STAT,1889,46,50-100,1935,0.3067372317769829
SIM,1789,65,na,1854,738
SIM,1855,4,na,1859,2659
SIM,1861,36,40-44,1897,6
STAT,1870,34,20-24,1904,2.6579094112175152
SIM,1815,90,na,1905,30
STAT,1853,36,40-44,1889,3.657877969222564
SIM,1838,45,50-100,1883,3
STAT,1861,17,50-100,1878,0.047260282054537646
SIM,1851,30,40-44,1881,4
STAT,1815,45,50-100,1860,0.5635213614050805
STAT,1868,97,na,1965,19.255687063849706
SIM,1937,21,50-100,1958,4
STAT,1881,23,40-44,1904,2.0224555458054687
STAT,1917,48,na,1965,3862.5620001684597
STAT,1885,48,25-29,1933,0.05717984331210232
STAT,1918,16,40-44,1934,0.30912271186156753
STAT,1908,19,50-100,1927,0.0729684387176165
STAT,1933,35,50-100,1968,0.5788860132252411
SIM,1890,56,na,1946,2798
STAT,1840,20,15-19,1860,2.983598144320047
STAT,1857,30,40-44,1887,3.511673013328712
STAT,1861,44,20-24,1905,0.13148947387832388
STAT,1841,54,45-49,1895,0.010554155093171553
STAT,1819,54,35-39,1873,0.01548895453566095
STAT,1873,15,30-34,1888,1.651374073703628
STAT,1879,32,15-19,1911,0.15009766303542413
STAT,1937,28,45-49,1965,1.6993179437767485
STAT,1875,26,20-24,1901,12.209824019949744
STAT,1818,39,25-29,1857,6.300168423398179
STAT,1896,19,45-49,1915,0.08686270332523843
STAT,1765,113,na,1878,3.988454744563756E-4
STAT,1824,54,45-49,1878,0.015732231733790868
SIM,1947,22,35-39,1969,24
STAT,1880,26,na,1906,2540.0973850879855
SIM,1882,30,50-100,1912,5
SIM,1884,56,na,1940,2136
STAT,1868,15,20-24,1883,17.630109262394548
STAT,1918,46,35-39,1964,0.13885902242517165
STAT,1924,27,20-24,1951,21.477028409694647
SIM,1898,21,35-39,1919,13
STAT,1923,39,50-100,1962,0.49048794048289474
SIM,1793,70,na,1863,593
SIM,1932,27,20-24,1959,34
STAT,1849,39,25-29,1888,2.256135382629294
SIM,1857,39,25-29,1896,2
SIM,1822,32,40-44,1854,7
STAT,1801,70,na,1871,724.31120257767
STAT,1826,62,na,1888,1027.725500510105
STAT,1843,30,40-44,1873,3.5901721736529364
SIM,1873,84,na,1957,296
STAT,1847,39,20-24,1886,0.5865244234775921
STAT,1854,33,20-24,1887,2.055958631228455
SIM,1818,37,50-100,1855,1
SIM,1876,15,20-24,1891,28
SIM,1868,39,30-34,1907,10
SIM,1887,34,50-100,1921,1
STAT,1838,36,45-49,1874,1.6270776185768214
SIM,1921,24,40-44,1945,5
STAT,1891,45,45-49,1936,0.16812784263950326
SIM,1849,31,na,1880,1988
STAT,1830,35,30-34,1865,4.9824337568489465
SIM,1934,24,20-24,1958,153
STAT,1833,75,na,1908,728.340053605646
STAT,1855,59,na,1914,1462.8859735924682
SIM,1859,15,20-24,1874,25
SIM,1917,20,na,1937,4091
STAT,1877,62,na,1939,1905.2695599897625
STAT,1878,87,na,1965,386.2042913212636
STAT,1823,38,20-24,1861,1.2839680429472156
STAT,1930,24,40-44,1954,4.326343967589294
STAT,1847,28,35-39,1875,8.621144806078224
SIM,1881,31,35-39,1912,17
STAT,1846,41,15-19,1887,0.010743710979977703
STAT,1890,29,20-24,1919,14.375017115894437
STAT,1848,46,50-100,1894,0.20109151421943716
STAT,1868,18,25-29,1886,5.53627904579083
STAT,1868,25,50-100,1893,0.621678473779949
SIM,1872,25,30-34,1897,37
SIM,1818,67,na,1885,787
STAT,1840,25,45-49,1865,0.9845244496487837
STAT,1833,26,15-19,1859,0.4276944284375455
STAT,1897,16,30-34,1913,2.163493507849282
STAT,1862,41,30-34,1903,1.0073012440044462
SIM,1938,17,15-19,1955,43
SIM,1872,99,na,1971,1
STAT,1855,90,na,1945,59.34493813623772
STAT,1864,26,45-49,1890,1.0153886551237183
STAT,1943,23,50-100,1966,0.7066332926290906
SIM,1870,28,30-34,1898,38
STAT,1837,65,na,1902,1152.857915418427
SIM,1838,25,30-34,1863,23
SIM,1876,18,25-29,1894,7
STAT,1861,26,20-24,1887,9.989229595590693
SIM,1862,13,na,1875,2429
SIM,1882,49,50-100,1931,1
STAT,1885,47,40-44,1932,0.17131141491287946
SIM,1842,28,25-29,1870,47
STAT,1966,2,na,1968,4963.118989505509
STAT,1838,18,45-49,1856,0.05742038901514842
STAT,1855,15,40-44,1870,0.16569677312511674
STAT,1873,31,35-39,1904,10.411574908072662
STAT,1845,60,na,1905,1393.549571012077
SIM,1929,42,40-44,1971,2
STAT,1874,15,45-49,1889,0.06812301765762811
STAT,1862,28,30-34,1890,21.88685036565133
SIM,1916,48,50-100,1964,3
SIM,1936,27,50-100,1963,2
SIM,1850,28,na,1878,2030
SIM,1853,3,na,1856,2538
SIM,1906,21,40-44,1927,7
STAT,1928,27,50-100,1955,1.2394583000385613
SIM,1855,28,35-39,1883,15
STAT,1874,45,45-49,1919,0.24650200439102343
SIM,1872,26,45-49,1898,2
STAT,1839,47,45-49,1886,0.1704749935402873
SIM,1826,62,na,1888,1383
STAT,1846,26,25-29,1872,39.116228435920995
SIM,1880,26,na,1906,2325
STAT,1874,97,na,1971,34.45831719598978
STAT,1844,29,25-29,1873,40.38451826501435
STAT,1871,36,30-34,1907,5.3735667532449245
STAT,1939,33,50-100,1972,0.8511061103962625
SIM,1899,20,40-44,1919,6
SIM,1831,38,20-24,1869,1
SIM,1814,40,35-39,1854,2
SIM,1817,85,na,1902,100
STAT,1858,3,na,1861,2615.1578699652473
STAT,1851,69,na,1920,1111.2059383521673
SIM,1942,15,15-19,1957,49
STAT,1865,19,15-19,1884,5.573763552653102
SIM,1873,19,15-19,1892,8
STAT,1865,77,na,1942,797.1908455832847
SIM,1890,19,20-24,1909,27
STAT,1934,15,15-19,1949,62.313809054461366
STAT,1942,25,15-19,1967,0.7487462205553639
STAT,1872,62,na,1934,1855.9163737585718
SIM,1844,87,na,1931,17
STAT,1807,54,45-49,1861,0.04729523659993793
STAT,1821,43,40-44,1864,3.4843587042743582
STAT,1902,46,na,1948,3220.8235267508276
SIM,1852,29,25-29,1881,6
SIM,1884,84,na,1968,485
STAT,1864,25,30-34,1889,23.19576600071377
SIM,1775,85,na,1860,80
STAT,1882,19,20-24,1901,17.25164967398898
STAT,1826,47,35-39,1873,0.1379561751507879
STAT,1850,26,45-49,1876,1.0077208237050321
STAT,1922,29,50-100,1951,1.1296895831302765
SIM,1852,82,na,1934,181
SIM,1938,8,na,1946,3875
STAT,1868,48,25-29,1916,0.05490212839139105
STAT,1842,80,na,1922,556.9437298193329
STAT,1944,22,15-19,1966,5.8038434475300065
SIM,1892,11,na,1903,3566
SIM,1820,38,45-49,1858,1
SIM,1938,30,45-49,1968,2
STAT,1891,69,na,1960,1972.822920566574
STAT,1870,19,25-29,1889,5.607092915355396
STAT,1813,103,na,1916,0.06292543602854268
STAT,1881,21,15-19,1902,3.221512589137169
SIM,1878,29,45-49,1907,1
SIM,1863,54,na,1917,1870
SIM,1930,29,50-100,1959,4
SIM,1924,17,15-19,1941,54
SIM,1949,22,na,1971,4392
SIM,1855,59,na,1914,1691
STAT,1814,77,na,1891,404.58760672323973
SIM,1874,20,35-39,1894,6
SIM,1885,37,40-44,1922,7
STAT,1820,46,25-29,1866,0.09946347774482676
SIM,1867,44,na,1911,2028
STAT,1834,40,50-100,1874,0.7781726178100349
STAT,1825,49,na,1874,1833.5884123657363
STAT,1838,31,15-19,1869,0.11969560768205938
SIM,1804,59,na,1863,1210
STAT,1867,16,15-19,1883,5.805152351147118
STAT,1888,29,35-39,1917,11.420389075606979
STAT,1871,32,15-19,1903,0.14289530742838363
SIM,1840,30,35-39,1870,8
STAT,1838,35,30-34,1873,4.39538909819341
STAT,1874,27,15-19,1901,0.4692144446086063
SIM,1876,28,50-100,1904,4
STAT,1844,31,50-100,1875,0.8759303892826036
SIM,1911,35,35-39,1946,5
SIM,1914,40,na,1954,3889
SIM,1820,36,25-29,1856,10
STAT,1908,25,15-19,1933,0.6839965591476272
SIM,1834,51,50-100,1885,1
STAT,1895,19,30-34,1914,2.0909814561896165
STAT,1919,45,40-44,1964,0.17347442962120038
STAT,1893,38,35-39,1931,9.02561764571771
STAT,1839,29,15-19,1868,0.3994247759872873
STAT,1858,95,na,1953,10.53520619845709
SIM,1909,25,na,1934,3828
STAT,1872,18,45-49,1890,0.06615605170702739
SIM,1802,80,na,1882,229
STAT,1867,16,na,1883,2470.537184990665
STAT,1872,16,25-29,1888,5.807246542578498
STAT,1834,28,25-29,1862,32.79744111923136
SIM,1836,28,30-34,1864,3
SIM,1908,34,20-24,1942,2
STAT,1828,28,30-34,1856,40.46720879941621
STAT,1796,78,na,1874,298.9717966010476
STAT,1866,20,35-39,1886,5.581961545637135
STAT,1793,98,na,1891,0.5863109375913413
STAT,1911,51,na,1962,3464.1656112583414
STAT,1914,22,35-39,1936,9.705846836336162
STAT,1826,51,50-100,1877,0.014640811408900598
SIM,1922,22,35-39,1944,17
STAT,1821,40,30-34,1861,1.9422888089773642
STAT,1906,36,na,1942,3510.0477298757514
STAT,1836,38,30-34,1874,4.084199114269396
SIM,1880,16,25-29,1896,9
SIM,1861,28,na,1889,2071
STAT,1916,17,15-19,1933,9.717014349707448
STAT,1862,44,40-44,1906,1.9353825734538852
STAT,1903,35,35-39,1938,2.2167768407743376
STAT,1854,36,25-29,1890,2.171198836057668
STAT,1828,38,50-100,1866,1.2366208904375198
STAT,1870,36,40-44,1906,4.3624519647349915
SIM,1890,38,50-100,1928,1
STAT,1898,29,20-24,1927,15.948002091652416
SIM,1902,15,na,1917,3845
SIM,1891,20,40-44,1911,2
STAT,1889,59,na,1948,2420.3789659510803
SIM,1900,16,20-24,1916,20
STAT,1866,50,35-39,1916,0.008167175614186055
SIM,1883,40,50-100,1923,2
STAT,1831,47,45-49,1878,0.17628035936699027
STAT,1860,15,20-24,1875,17.0819540780143
SIM,1939,4,na,1943,4146
SIM,1937,15,35-39,1952,4
STAT,1832,30,35-39,1862,9.209384450710212
STAT,1880,21,30-34,1901,18.9507173545581
STAT,1887,40,25-29,1927,0.7314324672735755
STAT,1800,85,na,1885,79.66067705459368
STAT,1864,21,15-19,1885,3.077132031840611
SIM,1843,34,na,1877,2385
STAT,1827,49,45-49,1876,0.23572869923708528
SIM,1832,31,na,1863,1727
STAT,1854,18,30-34,1872,1.4224857120910588
SIM,1935,21,30-34,1956,1
STAT,1887,27,25-29,1914,47.701025821226196
STAT,1826,93,na,1919,16.036569210479712
STAT,1829,43,40-44,1872,1.7210829297152535
STAT,1813,49,15-19,1862,0.0011220655535249253
STAT,1875,40,50-100,1915,1.1068270898052728
SIM,1856,25,45-49,1881,3
SIM,1862,36,25-29,1898,2
SIM,1791,75,na,1866,351
SIM,1872,21,15-19,1893,7
STAT,1809,46,20-24,1855,0.04483138771571664
STAT,1893,24,15-19,1917,4.204319674007013
STAT,1909,22,25-29,1931,86.6302790070779
SIM,1929,24,40-44,1953,3
STAT,1835,54,20-24,1889,5.427207700112416E-4
SIM,1852,7,na,1859,2315
SIM,1822,35,45-49,1857,4
STAT,1818,67,na,1885,879.5420403145272
STAT,1842,48,50-100,1890,0.2183438033171944
STAT,1890,47,20-24,1937,0.008315087228219923
STAT,1913,58,na,1971,3432.0671403289853
STAT,1862,27,50-100,1889,0.560009564251528
SIM,1837,25,40-44,1862,4
STAT,1852,41,45-49,1893,1.1401756450041771
STAT,1835,39,na,1874,1946.4431657881164
STAT,1884,56,na,1940,2031.4652869260938
SIM,1895,27,25-29,1922,8
STAT,1927,21,30-34,1948,35.899312490712134
STAT,1852,23,45-49,1875,0.6237300477511383
STAT,1896,16,40-44,1912,0.2451275389720549
STAT,1921,49,15-19,1970,4.1695524757887997E-4
SIM,1846,35,30-34,1881,7
SIM,1828,36,25-29,1864,2
SIM,1865,18,na,1883,2387
SIM,1866,41,40-44,1907,3
STAT,1896,41,na,1937,3114.646275280916
STAT,1913,18,na,1931,3973.8864135897875
STAT,1947,22,50-100,1969,0.7511704618581753
SIM,1820,46,na,1866,1407
STAT,1918,32,15-19,1950,0.1378609372250474
STAT,1877,52,30-34,1929,0.006172043591333994
STAT,1853,39,45-49,1892,1.63197462967602
STAT,1882,38,50-100,1920,1.1952013957892331
STAT,1906,31,40-44,1937,3.6782280689791165
STAT,1860,33,45-49,1893,1.4336701855933065
STAT,1929,15,35-39,1944,5.437829992648865
SIM,1860,23,45-49,1883,3
STAT,1881,26,45-49,1907,1.0846623117356384
SIM,1857,36,20-24,1893,1
STAT,1963,5,na,1968,5044.109858291076
SIM,1863,94,na,1957,36
SIM,1865,28,20-24,1893,13
STAT,1848,43,45-49,1891,1.213117462397419
STAT,1802,52,na,1854,1143.8270860447576
SIM,1896,2,na,1898,3569
SIM,1874,32,35-39,1906,15
STAT,1819,39,45-49,1858,4.813385021939145
STAT,1828,46,25-29,1874,0.05317897964838247
STAT,1829,25,40-44,1854,7.8475165403191385
SIM,1856,13,na,1869,2511
SIM,1906,21,35-39,1927,12
STAT,1895,59,na,1954,2563.358031753391
STAT,1776,86,na,1862,57.880042980455286
STAT,1853,28,50-100,1881,0.5536758367270255
STAT,1830,31,15-19,1861,0.13892600430345858
SIM,1785,75,na,1860,313
STAT,1863,41,20-24,1904,0.1427632171780098
STAT,1847,24,na,1871,1934.4607936644427
STAT,1873,18,35-39,1891,0.5603565517381569
STAT,1888,42,35-39,1930,2.156034557219739
STAT,1911,45,40-44,1956,0.15129356697649818
SIM,1883,29,25-29,1912,49
STAT,1929,33,35-39,1962,11.72519162336883
SIM,1905,35,na,1940,3600
STAT,1875,29,25-29,1904,43.562185055927934
SIM,1850,6,na,1856,2390
STAT,1868,45,15-19,1913,3.899654352243267E-4
STAT,1887,23,50-100,1910,0.45842228664418067
STAT,1861,47,25-29,1908,0.04811715895685074
STAT,1891,37,50-100,1928,1.5352655495930598
SIM,1834,33,45-49,1867,2
STAT,1833,49,50-100,1882,0.18120036431693456
STAT,1870,54,40-44,1924,0.01015407290492212
SIM,1848,46,na,1894,1722
STAT,1897,35,50-100,1932,1.6782242492501476
STAT,1876,21,na,1897,2473.820446732302
SIM,1860,23,15-19,1883,3
STAT,1918,43,30-34,1961,0.13701213436246584
SIM,1854,26,25-29,1880,54
SIM,1927,19,na,1946,4923
STAT,1822,40,20-24,1862,0.26543733073254594
STAT,1853,103,na,1956,0.14406309801141268
STAT,1942,2,na,1944,4284.088698862208
STAT,1838,34,50-100,1872,0.7464967444799119
STAT,1857,28,20-24,1885,9.45642335036005
SIM,1879,26,30-34,1905,42
STAT,1883,20,40-44,1903,2.0718655301567614
SIM,1851,69,na,1920,1282
STAT,1773,81,na,1854,201.0
SIM,1870,44,40-44,1914,5
STAT,1878,21,50-100,1899,0.42884061053247313
STAT,1849,36,20-24,1885,0.6231488266739309
SIM,1939,28,15-19,1967,4
STAT,1942,15,na,1957,3885.7559267962583
SIM,1827,39,45-49,1866,2
STAT,1881,50,30-34,1931,0.005878475979600657
SIM,1904,27,45-49,1931,1
STAT,1943,22,25-29,1965,99.22991712991853
STAT,1866,104,na,1970,0.6465510048311465
STAT,1871,77,na,1948,867.3520053372896
STAT,1864,39,20-24,1903,0.6954710191741402
STAT,1826,33,45-49,1859,2.3103222094231124
STAT,1852,23,15-19,1875,2.950862981090255
STAT,1829,39,na,1868,1582.478670946847
SIM,1826,90,na,1916,100
STAT,1879,36,30-34,1915,5.644410767170551
SIM,1888,32,35-39,1920,18
STAT,1879,19,45-49,1898,0.06848068069225298
STAT,1867,48,35-39,1915,0.131497770403251
STAT,1932,21,40-44,1953,4.471838303101033
STAT,1926,24,20-24,1950,135.6741584698006
STAT,1848,25,45-49,1873,1.0979187327139557
STAT,1872,48,45-49,1920,0.23662825274497315
SIM,1859,18,na,1877,2427
SIM,1937,33,35-39,1970,14
STAT,1841,51,40-44,1892,0.007910397419765267
STAT,1921,30,25-29,1951,10.47176130098607
STAT,1893,24,45-49,1917,0.8886757968208208
STAT,1921,49,45-49,1970,0.2460038031287704
STAT,1918,19,45-49,1937,0.5459816223050293
SIM,1857,18,20-24,1875,20
SIM,1874,41,50-100,1915,3
STAT,1831,29,15-19,1860,0.3822385238244394
SIM,1816,38,25-29,1854,1
STAT,1835,36,20-24,1871,0.7230181784738935
STAT,1849,18,20-24,1867,16.961422449879866
STAT,1855,33,40-44,1888,3.2894338946028143
SIM,1896,24,35-39,1920,9
SIM,1779,75,na,1854,428
SIM,1832,62,na,1894,1060
SIM,1887,36,30-34,1923,6
SIM,1829,33,35-39,1862,9
SIM,1911,35,na,1946,3942
SIM,1840,97,na,1937,1
SIM,1899,23,45-49,1922,3
SIM,1925,16,20-24,1941,161
SIM,1939,28,20-24,1967,20
STAT,1854,51,20-24,1905,5.564482994726234E-4
STAT,1913,39,15-19,1952,0.018928467963100493
STAT,1935,28,40-44,1963,6.416193683344512
STAT,1811,57,na,1868,1102.0054038093328
STAT,1864,23,40-44,1887,1.9158414387079248
SIM,1879,21,30-34,1900,23
STAT,1823,52,35-39,1875,0.011405407612894535
STAT,1842,24,50-100,1866,0.4564556539879949
STAT,1889,38,45-49,1927,2.4703626913059584
STAT,1844,26,20-24,1870,11.444587435696818
STAT,1845,29,45-49,1874,0.9733469084990816
STAT,1840,38,20-24,1878,0.6325064282770232
SIM,1879,38,na,1917,2753
STAT,1916,38,na,1954,3868.7446347558816
STAT,1947,17,15-19,1964,51.639128419213634
STAT,1837,62,na,1899,1246.8408575317171
STAT,1819,53,20-24,1872,0.001354355098692227
SIM,1849,41,40-44,1890,8
SIM,1871,58,na,1929,1832
SIM,1883,43,na,1926,2520
STAT,1895,28,na,1923,3136.656711993511
STAT,1803,109,na,1912,2.965817574514692E-4
SIM,1798,73,na,1871,402
SIM,1863,16,25-29,1879,8
STAT,1796,100,na,1896,0.22241608471197177
STAT,1874,57,na,1931,2078.3394635805544
SIM,1954,12,na,1966,4836
STAT,1837,53,40-44,1890,0.007066850486038954
SIM,1833,31,35-39,1864,7
STAT,1846,14,na,1860,2255.1664444653206
STAT,1872,31,15-19,1903,0.1451946687497926
STAT,1943,24,20-24,1967,119.37215258382986
STAT,1857,45,45-49,1902,0.18788025788991103
STAT,1848,19,15-19,1867,5.935936369817419
STAT,1917,16,20-24,1933,29.52098321615491
STAT,1856,32,na,1888,1870.4546410553553
STAT,1864,28,35-39,1892,8.762955073342376
SIM,1893,61,na,1954,2467
SIM,1886,19,30-34,1905,2
SIM,1923,18,15-19,1941,47
STAT,1855,16,25-29,1871,5.103403738865731
STAT,1932,24,45-49,1956,1.4868119461149911
STAT,1825,38,25-29,1863,4.561811211084809
STAT,1862,44,35-39,1906,1.5581092240979133
SIM,1864,29,20-24,1893,15
STAT,1951,20,na,1971,4411.104615782519
STAT,1829,30,na,1859,1713.3570537890116
STAT,1869,42,30-34,1911,1.1275365883024628
STAT,1934,24,50-100,1958,0.8928825921837695
SIM,1852,26,20-24,1878,16
SIM,1872,23,40-44,1895,2
SIM,1891,48,50-100,1939,1
SIM,1896,22,15-19,1918,4
SIM,1888,33,40-44,1921,11
STAT,1923,18,50-100,1941,0.443341337457176
STAT,1928,23,na,1951,4594.282754471631
STAT,1847,55,na,1902,1548.1737103995267
SIM,1865,30,35-39,1895,11
STAT,1821,45,30-34,1866,0.1460472255249216
STAT,1895,37,25-29,1932,3.7975556247956463
STAT,1891,38,na,1929,2931.4854210495996
SIM,1847,92,na,1939,31
STAT,1876,38,35-39,1914,7.339361542435175
SIM,1884,38,35-39,1922,20
STAT,1850,44,na,1894,1745.8599378861911
STAT,1883,17,15-19,1900,5.865539866503282
STAT,1905,51,na,1956,3177.107414166835
SIM,1856,43,45-49,1899,1
SIM,1891,17,15-19,1908,11
STAT,1917,34,20-24,1951,2.5560960136670827
SIM,1877,42,30-34,1919,2
SIM,1836,52,na,1888,1604
SIM,1853,29,45-49,1882,5
STAT,1892,29,25-29,1921,53.22876585780818
SIM,1928,28,45-49,1956,6
SIM,1942,27,na,1969,4357
SIM,1853,33,na,1886,1856
SIM,1909,31,30-34,1940,19
STAT,1857,30,35-39,1887,8.200430998291532
STAT,1849,36,15-19,1885,0.045394953349898765
SIM,1861,38,30-34,1899,4
SIM,1923,20,na,1943,4296
STAT,1865,80,na,1945,570.5041420268182
STAT,1909,38,40-44,1947,1.4227508797571653
SIM,1870,44,35-39,1914,1
STAT,1884,87,na,1971,449.7256144195954
SIM,1847,32,40-44,1879,5
STAT,1915,18,15-19,1933,9.559369719743614
SIM,1889,31,na,1920,2999
SIM,1920,22,30-34,1942,41
SIM,1911,21,15-19,1932,6
SIM,1860,18,na,1878,2282
STAT,1930,39,45-49,1969,0.8968337324248007
STAT,1869,17,30-34,1886,1.5867865743593672
SIM,1882,30,40-44,1912,4
STAT,1825,31,35-39,1856,27.520290520075978
STAT,1870,16,20-24,1886,17.855613838191793
STAT,1833,26,45-49,1859,1.0466559420278356
SIM,1932,33,50-100,1965,1
SIM,1897,44,45-49,1941,1
SIM,1930,32,35-39,1962,17
STAT,1892,40,35-39,1932,2.318144952857034
STAT,1939,20,45-49,1959,1.1415511608778641
SIM,1856,44,na,1900,2104
STAT,1884,34,15-19,1918,0.14062297689740916
STAT,1851,28,25-29,1879,37.23354923112453
STAT,1852,101,na,1953,0.432756336862844
STAT,1853,50,25-29,1903,0.002971254812990686
SIM,1844,56,na,1900,1362
SIM,1927,10,na,1937,5450
STAT,1817,43,15-19,1860,0.03234728758102379
STAT,1871,19,45-49,1890,0.065194672072376
STAT,1919,41,25-29,1960,0.07824653146475369
STAT,1922,44,35-39,1966,0.23271600021935662
SIM,1894,1,na,1895,3840
STAT,1853,38,30-34,1891,4.385574865116818
STAT,1839,32,40-44,1871,3.783667724385951
STAT,1859,26,50-100,1885,0.5324373690578376
STAT,1873,16,na,1889,2601.3140250061265
STAT,1903,21,15-19,1924,4.759686569004606
STAT,1888,33,50-100,1921,1.0876576602925625
SIM,1889,43,35-39,1932,4
STAT,1821,43,35-39,1864,2.8051360550938083
STAT,1889,26,45-49,1915,1.3875103466512282
STAT,1857,54,na,1911,1650.5497326965594
STAT,1869,47,25-29,1916,0.056297119120382696
STAT,1886,42,na,1928,2461.655465065572
STAT,1892,22,35-39,1914,7.3957659917041685
STAT,1889,44,45-49,1933,1.838747742610763
STAT,1922,32,35-39,1954,10.430877655665768
STAT,1890,43,35-39,1933,2.218691483124229
STAT,1882,49,15-19,1931,3.831678438220414E-4
SIM,1846,38,35-39,1884,14
STAT,1886,44,20-24,1930,0.16707110248694443
STAT,1901,61,na,1962,2804.3627843233435
SIM,1857,40,50-100,1897,1
SIM,1852,51,na,1903,1605
STAT,1888,36,50-100,1924,1.4706509085501167
SIM,1948,21,40-44,1969,6
STAT,1910,10,na,1920,3960.057127389565
STAT,1864,34,50-100,1898,0.8279050433676045
STAT,1806,70,na,1876,674.5960431217412
STAT,1868,45,20-24,1913,0.011698973347536317
STAT,1862,46,30-34,1908,0.08467064049460202
SIM,1843,37,35-39,1880,21
SIM,1900,19,25-29,1919,11
SIM,1929,27,45-49,1956,7
STAT,1834,29,na,1863,1664.2301223997702
SIM,1805,60,na,1865,909
SIM,1877,17,30-34,1894,3
STAT,1912,22,30-34,1934,27.78946843828886
STAT,1839,47,50-100,1886,0.17740956925733997
STAT,1839,50,40-44,1889,0.0076495368360650524
SIM,1855,21,15-19,1876,4
STAT,1838,38,35-39,1876,5.6542443762702685
STAT,1869,29,30-34,1898,24.55084759278724
SIM,1892,16,15-19,1908,6
STAT,1841,50,50-100,1891,0.011456356051105291
SIM,1873,44,na,1917,2192
SIM,1919,23,40-44,1942,3
SIM,1878,24,20-24,1902,82
SIM,1947,20,45-49,1967,1
STAT,1848,37,15-19,1885,0.04724712799297851
STAT,1877,39,30-34,1916,5.499760751009468
STAT,1893,44,50-100,1937,0.09281277078567896
STAT,1833,22,50-100,1855,0.389260029764597
STAT,1825,41,50-100,1866,1.550093937078375
STAT,1839,44,50-100,1883,0.7694382301106667
STAT,1822,42,40-44,1864,3.578553367849828
STAT,1823,45,na,1868,1477.9162616567423
STAT,1894,39,30-34,1933,6.860488716925155
SIM,1869,25,25-29,1894,60
STAT,1826,30,40-44,1856,6.93364288225598
SIM,1873,22,40-44,1895,2
STAT,1870,39,45-49,1909,1.9572178760970065
SIM,1841,32,45-49,1873,2
STAT,1849,50,na,1899,1707.6524241636268
STAT,1841,48,15-19,1889,2.9665648906826057E-4
SIM,1889,31,35-39,1920,2
SIM,1921,25,na,1946,4118
SIM,1811,60,na,1871,1245
STAT,1827,48,30-34,1875,0.0979793436863917
STAT,1906,34,45-49,1940,1.4604085683668715
SIM,1874,6,na,1880,2650
STAT,1795,101,na,1896,0.13211657820186484
SIM,1872,34,50-100,1906,1
STAT,1835,37,35-39,1872,6.565521208475059
STAT,1860,6,na,1866,2375.5411314640287
SIM,1861,59,na,1920,1651
SIM,1878,35,50-100,1913,4
SIM,1860,74,na,1934,969
STAT,1833,44,45-49,1877,1.2551919649518544
SIM,1896,29,35-39,1925,17
STAT,1831,44,40-44,1875,1.694371486423336
STAT,1888,46,na,1934,2689.676340120332
SIM,1820,74,na,1894,574
SIM,1866,44,45-49,1910,4
STAT,1912,40,30-34,1952,0.12581022837916492
SIM,1868,94,na,1962,3
STAT,1868,43,25-29,1911,0.6153905330873337
STAT,1939,6,na,1945,4041.4305300829888
STAT,1898,28,15-19,1926,0.619026824140791
STAT,1916,17,20-24,1933,29.02804282994824
STAT,1797,88,na,1885,48.559714751855374
SIM,1839,40,35-39,1879,3
SIM,1855,28,na,1883,2115
SIM,1885,39,30-34,1924,9
STAT,1833,32,45-49,1865,1.5942789159630146
STAT,1879,39,35-39,1918,7.379828146243987
SIM,1850,34,45-49,1884,1
STAT,1859,37,20-24,1896,0.6261879746886062
STAT,1873,33,50-100,1906,0.9341935857605198
STAT,1841,18,20-24,1859,16.998179022093833
STAT,1893,21,40-44,1914,2.680430982852505
SIM,1830,67,na,1897,814
SIM,1929,27,15-19,1956,1
STAT,1832,46,15-19,1878,3.2714738596249836E-4
STAT,1862,24,15-19,1886,2.903492315544814
SIM,1873,7,na,1880,2650
SIM,1858,76,na,1934,604
STAT,1866,31,na,1897,2240.876188488263
SIM,1829,38,35-39,1867,11
STAT,1831,30,15-19,1861,0.12070580979805495
STAT,1931,38,15-19,1969,0.02567719722154819
SIM,1912,34,40-44,1946,7
SIM,1895,31,na,1926,3208
STAT,1900,11,na,1911,3628.695863901698
STAT,1915,49,20-24,1964,0.011170750140991486
STAT,1852,37,35-39,1889,5.393152274645822
STAT,1824,44,50-100,1868,1.2591750419367969
STAT,1866,36,20-24,1902,0.7243928292481203
STAT,1805,54,40-44,1859,0.04156958293287067
STAT,1839,69,na,1908,1040.4484472800702
SIM,1874,36,20-24,1910,4
SIM,1837,77,na,1914,485
SIM,1860,37,35-39,1897,13
SIM,1870,24,15-19,1894,5
STAT,1808,77,na,1885,356.9035780950347
STAT,1813,52,na,1865,1251.6208099742496
STAT,1878,54,40-44,1932,0.010734233115557299
STAT,1927,36,35-39,1963,3.042312321357147
SIM,1915,25,na,1940,4169
STAT,1851,21,35-39,1872,5.314775713348705
SIM,1858,22,45-49,1880,4
SIM,1841,26,45-49,1867,1
SIM,1834,30,40-44,1864,5
STAT,1918,15,50-100,1933,0.0829816061578496
STAT,1880,26,25-29,1906,45.02354167136992
STAT,1904,46,40-44,1950,0.1403693126618097
SIM,1867,13,na,1880,2475
SIM,1815,42,45-49,1857,1
SIM,1887,39,35-39,1926,16
STAT,1856,29,20-24,1885,9.278626717915591
SIM,1940,24,45-49,1964,3
STAT,1872,45,40-44,1917,0.17557316638185108
STAT,1911,48,45-49,1959,0.20700481346826252
STAT,1852,20,40-44,1872,1.9046267922384446
STAT,1897,23,na,1920,3192.519417469371
STAT,1874,33,45-49,1907,1.795832233323643
SIM,1935,36,35-39,1971,7
SIM,1842,52,na,1894,1506
SIM,1874,94,na,1968,79
STAT,1822,54,40-44,1876,0.014448442850166898
STAT,1845,43,20-24,1888,0.11666391242708392
STAT,1889,38,15-19,1927,0.06958768972091538
SIM,1837,23,20-24,1860,74
STAT,1883,17,45-49,1900,0.06456289135472656
STAT,1879,6,na,1885,2835.874933103187
SIM,1848,42,35-39,1890,4
STAT,1930,42,40-44,1972,0.3326297449544776
SIM,1904,10,na,1914,3915
STAT,1813,53,25-29,1866,0.00959927985770055
STAT,1888,22,15-19,1910,3.9328050829467722
STAT,1946,18,45-49,1964,0.5594230772475899
SIM,1824,67,na,1891,881
SIM,1848,41,50-100,1889,1
STAT,1852,39,30-34,1891,4.001228856152639
SIM,1841,44,45-49,1885,5
STAT,1874,30,50-100,1904,0.9551883300464491
SIM,1937,19,20-24,1956,161
STAT,1880,44,25-29,1924,0.6719485587270615
STAT,1852,104,na,1956,0.06199018419097009
STAT,1930,36,40-44,1966,1.975358631024584
STAT,1904,34,40-44,1938,3.578358701390893
SIM,1877,46,na,1923,2355
STAT,1842,16,15-19,1858,6.901871753312021
SIM,1808,49,na,1857,1240
STAT,1833,25,50-100,1858,0.6073835817769992
STAT,1923,17,na,1940,4366.993394591248
STAT,1951,19,30-34,1970,14.654743636873317
STAT,1865,22,40-44,1887,1.9451663774612817
SIM,1824,44,45-49,1868,1
SIM,1860,39,30-34,1899,8
SIM,1849,28,na,1877,1975
SIM,1823,45,50-100,1868,2
SIM,1838,20,30-34,1858,21
STAT,1899,49,na,1948,3054.0742723589697
SIM,1830,42,40-44,1872,3
STAT,1853,54,50-100,1907,0.012146163094707854
STAT,1906,16,45-49,1922,0.09633217817682359
SIM,1860,20,40-44,1880,2
STAT,1864,53,35-39,1917,0.007720207199280166
STAT,1887,42,15-19,1929,0.015553425970963706
STAT,1883,35,45-49,1918,1.9890173413976922
SIM,1943,28,40-44,1971,6
STAT,1861,27,35-39,1888,8.15698861792651
SIM,1915,4,na,1919,4616
SIM,1807,64,na,1871,836
STAT,1801,67,na,1868,810.037782956903
STAT,1879,34,50-100,1913,0.9574545187912652
STAT,1886,82,na,1968,854.4657606310218
STAT,1902,18,na,1920,3595.252440560771
STAT,1915,24,45-49,1939,1.166261554154936
SIM,1833,35,20-24,1868,1
STAT,1929,19,20-24,1948,173.94332503919844
SIM,1848,30,35-39,1878,6
STAT,1846,70,na,1916,1064.7718040584791
SIM,1883,46,na,1929,2463
SIM,1924,17,20-24,1941,171
STAT,1874,27,45-49,1901,1.1482639330350841
STAT,1921,2,na,1923,4708.405996121242
STAT,1898,31,35-39,1929,13.922733099971698
SIM,1875,79,na,1954,513
STAT,1917,19,25-29,1936,46.6654765479616
STAT,1937,16,45-49,1953,0.49181394602984757
STAT,1858,44,15-19,1902,0.010795017465286725
SIM,1809,59,na,1868,987
STAT,1845,69,na,1914,1072.3134714544583
STAT,1816,44,45-49,1860,3.999948975733036
STAT,1890,18,35-39,1908,0.6754210790374001
SIM,1890,25,na,1915,3252
SIM,1891,35,45-49,1926,3
STAT,1921,34,40-44,1955,4.360729425465981
SIM,1962,7,na,1969,5266
STAT,1868,49,30-34,1917,0.09148919739440689
STAT,1766,96,na,1862,0.7239577101925048
STAT,1844,44,na,1888,1825.4300656339774
SIM,1868,69,na,1937,1297
SIM,1871,43,40-44,1914,10
SIM,1838,41,35-39,1879,6
STAT,1859,80,na,1939,502.50777375916573
SIM,1887,20,15-19,1907,3
SIM,1908,32,25-29,1940,14
STAT,1873,47,15-19,1920,4.0765407706449923E-4
SIM,1897,30,50-100,1927,1
SIM,1825,43,45-49,1868,2
STAT,1816,63,na,1879,1076.222666550819
STAT,1889,30,50-100,1919,1.1502591100513
SIM,1936,27,na,1963,3658
STAT,1897,32,35-39,1929,13.71264285731325
STAT,1884,34,45-49,1918,1.7219680737917533
STAT,1930,39,15-19,1969,0.02526292504451449
SIM,1875,31,40-44,1906,6
SIM,1939,31,40-44,1970,5
STAT,1857,19,50-100,1876,0.04485584797088764
STAT,1867,46,15-19,1913,3.815687266271387E-4
STAT,1828,29,45-49,1857,1.5417467240695533
STAT,1840,52,35-39,1892,0.00600271765097933
STAT,1940,28,15-19,1968,0.7264085103650532
STAT,1934,23,na,1957,4957.127319429234
STAT,1839,53,45-49,1892,0.010123708392415557
STAT,1879,16,40-44,1895,0.19325326155657052
STAT,1882,24,na,1906,2299.3545109886204
SIM,1836,29,45-49,1865,1
STAT,1843,15,15-19,1858,5.1759211419120765
STAT,1889,41,40-44,1930,2.813909995715815
SIM,1813,64,na,1877,956
STAT,1922,48,20-24,1970,0.012789882524312029
SIM,1787,70,na,1857,686
STAT,1819,51,30-34,1870,0.011369493330290283
STAT,1873,72,na,1945,1293.090178544434
SIM,1850,59,na,1909,1592
STAT,1825,35,20-24,1860,1.3840670036457974
STAT,1926,26,40-44,1952,5.666469546116635
STAT,1860,77,na,1937,713.6651121052553
SIM,1821,90,na,1911,34
STAT,1877,35,15-19,1912,0.05909275596353459
SIM,1879,24,35-39,1903,8
SIM,1894,46,na,1940,3191
SIM,1910,23,20-24,1933,95
STAT,1862,40,25-29,1902,0.5657540379364215
STAT,1866,32,35-39,1898,9.471161992372117
STAT,1902,36,35-39,1938,2.189382249542541
STAT,1949,22,na,1971,4304.920117489634
STAT,1863,43,40-44,1906,1.9983135257073295
SIM,1948,12,na,1960,5010
STAT,1902,47,50-100,1949,0.19680913930963895
SIM,1853,41,30-34,1894,5
STAT,1904,10,na,1914,3754.467219292815
STAT,1892,26,20-24,1918,14.919220950201321
STAT,1792,88,na,1880,45.20105871472529
STAT,1907,21,na,1928,3518.496670611118
STAT,1913,42,35-39,1955,0.19813011317632884
SIM,1910,18,35-39,1928,1
STAT,1836,54,35-39,1890,0.005281734177170769
STAT,1902,23,20-24,1925,98.05212968962435
STAT,1902,18,35-39,1920,0.7810987875234937
STAT,1869,44,20-24,1913,0.15384280232843037
STAT,1817,43,45-49,1860,3.5056370454700336
STAT,1920,21,15-19,1941,5.994137665691785
STAT,1854,54,25-29,1908,0.0025851334213412595
STAT,1890,40,30-34,1930,1.4331924650798344
STAT,1861,32,20-24,1893,2.268623459570819
STAT,1833,44,na,1877,1756.5374244511775
STAT,1847,95,na,1942,9.954861868250095
STAT,1894,33,25-29,1927,13.262615238426244
SIM,1862,44,na,1906,2082
SIM,1883,22,35-39,1905,8
STAT,1892,79,na,1971,1364.840243739888
STAT,1920,35,40-44,1955,1.658015255149078
SIM,1892,34,45-49,1926,3
SIM,1912,30,25-29,1942,9
STAT,1853,54,40-44,1907,0.008466706528227244
STAT,1827,42,25-29,1869,0.690765682327847
STAT,1900,38,20-24,1938,0.2322765085678249
STAT,1828,29,na,1857,1848.7521947522778
SIM,1897,7,na,1904,3607
STAT,1840,29,na,1869,1863.707849168501
STAT,1950,19,na,1969,4394.117844302729
STAT,1895,34,20-24,1929,3.5347113592206703
STAT,1851,25,20-24,1876,10.551632853971233
STAT,1845,41,30-34,1886,0.8664650518924825
STAT,1903,20,30-34,1923,25.774296280302558
SIM,1910,36,35-39,1946,4
STAT,1889,23,40-44,1912,2.587144372110521
STAT,1921,13,na,1934,4554.464747302886
SIM,1887,34,40-44,1921,7
STAT,1885,45,20-24,1930,0.01218432659214505
STAT,1912,25,35-39,1937,15.028140804571795
SIM,1933,29,30-34,1962,79
STAT,1830,51,35-39,1881,0.006459445368539606
SIM,1864,31,35-39,1895,12
STAT,1892,47,50-100,1939,0.17476269036776548
STAT,1868,57,na,1925,1939.8784614409465
STAT,1834,85,na,1919,163.17262871907565
SIM,1919,26,45-49,1945,5
SIM,1916,35,na,1951,3893
STAT,1858,44,45-49,1902,1.1699099356635279
SIM,1928,25,40-44,1953,5
SIM,1930,39,na,1969,5232
STAT,1886,47,25-29,1933,0.06113787330915649
SIM,1856,40,40-44,1896,6
STAT,1828,43,20-24,1871,0.1490935719366324
STAT,1832,59,na,1891,1323.3517420403105
SIM,1877,43,na,1920,2384
SIM,1888,36,45-49,1924,6
SIM,1849,62,na,1911,1418
SIM,1920,25,35-39,1945,22
SIM,1813,67,na,1880,862
STAT,1855,3,na,1858,2529.475766862444
STAT,1871,52,35-39,1923,0.00859255102777346
STAT,1882,21,na,1903,2320.825232659157
STAT,1925,29,30-34,1954,46.43612917510514
STAT,1893,36,15-19,1929,0.07236155100933367
STAT,1914,38,15-19,1952,0.019248965423824205
STAT,1867,15,50-100,1882,0.0482075902833278
STAT,1817,100,na,1917,0.4857263148892568
SIM,1897,23,40-44,1920,4
STAT,1778,81,na,1859,213.26263990580134
SIM,1873,31,50-100,1904,4
SIM,1842,21,35-39,1863,4
SIM,1812,43,35-39,1855,2
STAT,1858,41,40-44,1899,1.7903604642236786
STAT,1836,34,15-19,1870,0.1112212557195302
STAT,1855,28,na,1883,1858.9885240128558
SIM,1921,50,na,1971,4044
SIM,1865,42,40-44,1907,7
STAT,1826,49,30-34,1875,0.09282598345073897
STAT,1850,47,na,1897,1714.7026886830947
STAT,1932,17,50-100,1949,0.5013483341822131
STAT,1871,34,35-39,1905,10.074742406605894
STAT,1939,23,na,1962,3701.177541618413
STAT,1887,24,na,1911,2650.24198463776
STAT,1826,45,15-19,1871,4.050358720663574E-4
SIM,1889,29,20-24,1918,18
STAT,1904,49,15-19,1953,3.2020860881753707E-4
SIM,1853,92,na,1945,16
STAT,1847,21,15-19,1868,3.0500025551085925
STAT,1884,16,15-19,1900,5.925299899216011
STAT,1807,52,na,1859,1164.232699712451
STAT,1879,34,40-44,1913,4.531764214705947
SIM,1801,79,na,1880,115
SIM,1906,18,15-19,1924,9
STAT,1854,19,45-49,1873,0.05795520425181744
SIM,1854,18,na,1872,2554
STAT,1856,31,35-39,1887,8.020720147504603
SIM,1848,77,na,1925,505
STAT,1841,70,na,1911,1049.2392958710573
SIM,1847,44,50-100,1891,1
STAT,1929,21,35-39,1950,12.071455279382814
STAT,1930,20,25-29,1950,120.3140156859671
STAT,1909,24,15-19,1933,4.961188032927158
STAT,1876,25,20-24,1901,12.317061072399783
SIM,1893,27,20-24,1920,15
SIM,1907,20,40-44,1927,4
SIM,1828,26,na,1854,1787
STAT,1917,47,35-39,1964,0.13593247468611278
STAT,1943,1,na,1944,4432.966171512588
STAT,1866,39,25-29,1905,2.665617962930161
SIM,1873,25,45-49,1898,1
SIM,1928,20,na,1948,4642
SIM,1889,41,50-100,1930,4
SIM,1865,80,na,1945,382
SIM,1938,32,40-44,1970,1
STAT,1812,53,40-44,1865,0.0227795889475899
STAT,1893,64,na,1957,2280.4039654357575
SIM,1961,5,na,1966,5232
SIM,1869,22,20-24,1891,6
STAT,1920,17,40-44,1937,1.5847087950770968
SIM,1912,7,na,1919,3997
STAT,1927,33,30-34,1960,19.576802609258362
SIM,1887,16,40-44,1903,1
SIM,1937,21,35-39,1958,15
STAT,1944,19,na,1963,3997.2176846015645
STAT,1764,114,na,1878,1.5974500748469958E-4
STAT,1935,32,15-19,1967,0.1796224323884326
SIM,1846,11,na,1857,2210
SIM,1956,2,na,1958,5294
STAT,1865,25,45-49,1890,1.0309307608119838
STAT,1927,38,na,1965,4723.031774559532
SIM,1895,15,25-29,1910,12
STAT,1880,23,20-24,1903,72.8703383937867
STAT,1893,24,na,1917,3014.049094158401
STAT,1904,49,45-49,1953,0.18892323821583412
STAT,1816,41,40-44,1857,6.703818557904464
STAT,1894,49,na,1943,2864.9969102121654
SIM,1874,39,25-29,1913,2
SIM,1882,21,na,1903,2106
STAT,1848,37,45-49,1885,1.6772728442819766
STAT,1879,20,15-19,1899,3.497917522704742
SIM,1819,89,na,1908,26
STAT,1840,85,na,1925,192.16485177445537
STAT,1883,32,40-44,1915,4.286286272122074
SIM,1798,70,na,1868,590
SIM,1846,33,40-44,1879,9
STAT,1870,37,25-29,1907,2.85555390779964
STAT,1868,49,50-100,1917,0.2321254836985677
SIM,1878,27,25-29,1905,62
STAT,1818,54,20-24,1872,0.001212733736286886
STAT,1810,78,na,1888,388.33245227899346
STAT,1899,45,45-49,1944,0.18636928115804735
SIM,1876,49,50-100,1925,2
STAT,1855,49,20-24,1904,0.008844055615741826
STAT,1944,21,30-34,1965,31.346794810535236
STAT,1938,23,35-39,1961,9.40469014926518
SIM,1859,58,na,1917,1838
SIM,1937,0,na,1937,3991
STAT,1885,27,20-24,1912,11.79407055448903
STAT,1966,5,na,1971,4958.802291837896
SIM,1896,26,30-34,1922,58
STAT,1916,35,na,1951,3924.9543448919526
SIM,1884,25,20-24,1909,14
STAT,1900,51,na,1951,3035.4554205534646
STAT,1937,29,50-100,1966,0.978549318639321
SIM,1819,52,na,1871,1275
STAT,1921,37,45-49,1958,0.7687896839399154
SIM,1824,41,40-44,1865,7
SIM,1845,18,30-34,1863,3
SIM,1891,32,40-44,1923,7
STAT,1830,30,30-34,1860,17.303803642536018
STAT,1926,22,25-29,1948,113.41452386355625
SIM,1948,18,15-19,1966,54
SIM,1934,22,25-29,1956,155
STAT,1823,34,50-100,1857,1.8810759623148776
SIM,1925,34,20-24,1959,2
STAT,1858,98,na,1956,3.0160510510649403
STAT,1911,54,na,1965,3417.3000036498697
STAT,1915,34,50-100,1949,0.8424062544255777
STAT,1835,70,na,1905,1053.0742440733936
STAT,1911,15,40-44,1926,0.28369340007721344
STAT,1821,41,15-19,1862,0.022666227505723946
SIM,1923,34,50-100,1957,2
SIM,1879,42,35-39,1921,1
STAT,1809,47,35-39,1856,0.5008220514332697
STAT,1874,30,40-44,1904,4.521038031001166
STAT,1856,69,na,1925,1136.3867299287103
SIM,1828,66,na,1894,942
STAT,1888,26,30-34,1914,30.122656336643537
STAT,1839,35,45-49,1874,1.7243864301739558
SIM,1783,71,na,1854,599
STAT,1843,33,15-19,1876,0.11427700603987162
STAT,1886,29,50-100,1915,0.6772879350931288
STAT,1837,18,30-34,1855,1.7416863520188377
STAT,1910,18,30-34,1928,2.430303016641901
STAT,1878,50,25-29,1928,0.003767006887746895
STAT,1841,20,35-39,1861,5.608385040782886
SIM,1771,86,na,1857,41
SIM,1926,31,30-34,1957,9
SIM,1837,26,25-29,1863,43
STAT,1798,73,na,1871,595.6493532072586
STAT,1785,107,na,1892,0.003428928098381162
STAT,1880,41,20-24,1921,0.16921686736734065
STAT,1946,15,40-44,1961,1.5677171812130193
STAT,1822,39,15-19,1861,0.09568624382161778
SIM,1820,35,40-44,1855,3
SIM,1843,24,20-24,1867,80
STAT,1905,17,45-49,1922,0.09537716741445605
SIM,1792,85,na,1877,42
STAT,1853,32,25-29,1885,8.722750850249518
STAT,1904,30,25-29,1934,14.965156155306838
STAT,1814,48,20-24,1862,0.028461370404209062
STAT,1896,17,25-29,1913,7.575969405155184
STAT,1933,38,na,1971,5173.03376367176
SIM,1833,38,25-29,1871,7
SIM,1851,33,45-49,1884,3
STAT,1818,36,20-24,1854,2.504004020540285
STAT,1947,17,45-49,1964,0.5683997575094477
SIM,1838,23,35-39,1861,6
STAT,1864,36,na,1900,2157.542002589047
STAT,1845,46,25-29,1891,0.042207010058255
STAT,1899,27,15-19,1926,0.6289006186810052
SIM,1850,31,40-44,1881,4
SIM,1859,80,na,1939,488
STAT,1869,46,50-100,1915,0.2418537282747697
STAT,1830,44,50-100,1874,0.8923479448861573
SIM,1883,40,35-39,1923,8
STAT,1882,2,na,1884,3101.6826008896614
STAT,1838,33,40-44,1871,3.5701516567019316
SIM,1844,59,na,1903,1312
SIM,1851,15,15-19,1866,8
SIM,1829,35,30-34,1864,2
STAT,1862,32,na,1894,2081.388948402478
STAT,1875,40,35-39,1915,1.897159511317321
STAT,1888,49,na,1937,2626.550327438219
STAT,1852,35,15-19,1887,0.043716771098621626
SIM,1923,21,40-44,1944,5
STAT,1858,16,50-100,1874,0.04561618988718309
STAT,1804,78,na,1882,295.9173340087292
STAT,1843,33,45-49,1876,1.399354218711549
STAT,1918,31,30-34,1949,16.97134372337809
SIM,1935,33,30-34,1968,33
STAT,1853,95,na,1948,10.99509817807937
SIM,1917,24,15-19,1941,7
STAT,1835,24,20-24,1859,67.7953598217953
STAT,1829,26,25-29,1855,70.13796619800745
STAT,1886,42,30-34,1928,1.2244887511857798
STAT,1874,94,na,1968,82.31463384494353
STAT,1813,50,20-24,1863,0.0021245049115646768
STAT,1844,49,45-49,1893,0.18282091091798175
STAT,1864,50,30-34,1914,0.005503037908224652
SIM,1846,51,na,1897,1497
STAT,1887,15,25-29,1902,6.419752536428742
STAT,1844,44,20-24,1888,0.12543141912540937
STAT,1881,39,20-24,1920,0.7429186839896786
STAT,1951,15,15-19,1966,54.63042299678123
SIM,1877,46,50-100,1923,2
STAT,1835,42,20-24,1877,0.14287793694089906
SIM,1859,18,25-29,1877,8
SIM,1860,17,15-19,1877,5
STAT,1870,36,na,1906,2347.8767850660693
STAT,1843,51,45-49,1894,0.009834988440032322
STAT,1881,39,na,1920,2270.612939316381
SIM,1786,85,na,1871,63
SIM,1861,32,25-29,1893,17
STAT,1823,106,na,1929,0.006715124915479958
SIM,1825,52,na,1877,1171
SIM,1834,26,na,1860,2132
SIM,1902,27,40-44,1929,5
SIM,1954,15,40-44,1969,5
STAT,1909,42,15-19,1951,0.0014494504014842169
STAT,1899,45,15-19,1944,3.1587987168505506E-4
SIM,1865,58,na,1923,1750
STAT,1791,63,na,1854,775.0
STAT,1819,77,na,1896,439.42491528318277
STAT,1840,40,50-100,1880,0.8709471295586911
STAT,1858,64,na,1922,1377.4518828253256
STAT,1900,36,30-34,1936,1.6217114154190593
STAT,1939,26,20-24,1965,18.53397620012321
SIM,1930,29,45-49,1959,4
STAT,1865,43,45-49,1908,1.3703145143700628
STAT,1907,39,20-24,1946,0.2442971366142667
STAT,1886,17,30-34,1903,1.6996912182561816
STAT,1882,40,40-44,1922,2.2227781262327593
SIM,1919,31,25-29,1950,11
SIM,1881,11,na,1892,2279
SIM,1857,32,35-39,1889,13
SIM,1899,39,25-29,1938,5
STAT,1854,74,na,1928,832.8814122950612
STAT,1895,17,40-44,1912,0.24124243498350326
STAT,1954,16,45-49,1970,0.6240844654409684
STAT,1809,50,50-100,1859,0.050584381538840636
SIM,1924,39,30-34,1963,6
STAT,1916,39,30-34,1955,1.8645715352708965
STAT,1863,46,45-49,1909,0.2117936040508794
STAT,1892,44,15-19,1936,0.0011989894175894078
SIM,1909,28,40-44,1937,5
STAT,1871,54,25-29,1925,0.0034564049314649626
STAT,1963,8,na,1971,5041.941200745668
SIM,1861,96,na,1957,4
STAT,1937,29,20-24,1966,17.945818761958986
SIM,1953,16,35-39,1969,8
STAT,1807,106,na,1913,0.004300952573291274
STAT,1873,40,30-34,1913,1.189034237506785
STAT,1840,27,35-39,1867,8.433445933429267
SIM,1852,4,na,1856,2350
STAT,1945,16,35-39,1961,4.630438314717495
SIM,1873,16,na,1889,2484
STAT,1952,19,45-49,1971,0.6044225035798991
SIM,1904,19,na,1923,3819
SIM,1804,50,na,1854,1482
STAT,1890,13,na,1903,3182.2913921160384
STAT,1840,34,40-44,1874,3.6265780258505673
SIM,1873,43,45-49,1916,1
SIM,1890,40,40-44,1930,6
STAT,1870,17,35-39,1887,0.5493873601204715
STAT,1847,27,na,1874,1946.821605113335
SIM,1826,99,na,1925,1
STAT,1923,16,15-19,1939,53.9767404753617
SIM,1841,46,50-100,1887,1
STAT,1823,37,45-49,1860,3.4712018490636334
SIM,1945,26,50-100,1971,1
STAT,1849,32,35-39,1881,8.343465318739177
STAT,1887,20,50-100,1907,0.46258688856431524
STAT,1891,60,na,1951,2384.8865868964763
SIM,1823,57,na,1880,1197
STAT,1892,14,na,1906,3262.422311728108
STAT,1846,79,na,1925,530.5404068362916
SIM,1869,32,30-34,1901,16
STAT,1881,76,na,1957,993.9276507166948
STAT,1922,29,45-49,1951,1.9607828599496655
STAT,1817,109,na,1926,3.2550873090049596E-4
STAT,1834,37,20-24,1871,0.5710302363249776
STAT,1943,19,35-39,1962,4.489946419373401
SIM,1951,19,35-39,1970,6
STAT,1889,56,na,1945,2540.14835993051
STAT,1926,42,15-19,1968,0.0019133705477138929
STAT,1824,30,na,1854,1436.0695165790612
SIM,1875,8,na,1883,2638
STAT,1831,34,30-34,1865,14.112341941551929
STAT,1844,27,35-39,1871,9.345402321221087
STAT,1924,36,50-100,1960,0.5007422736366235
SIM,1890,35,50-100,1925,4
STAT,1857,49,25-29,1906,0.0444548956588341
SIM,1912,14,na,1926,3938
STAT,1858,32,45-49,1890,1.3817813082411594
STAT,1940,4,na,1944,4120.306057440668
SIM,1852,27,35-39,1879,1
STAT,1854,46,35-39,1900,0.10536642686208891
SIM,1866,32,45-49,1898,2
SIM,1808,74,na,1882,327
SIM,1931,16,15-19,1947,56
STAT,1846,39,50-100,1885,0.9529748369785561
STAT,1896,20,15-19,1916,4.4368509331307955
SIM,1831,37,45-49,1868,4
STAT,1809,52,20-24,1861,0.0023700383743351008
STAT,1874,46,20-24,1920,0.012445510654006701
STAT,1924,45,15-19,1969,4.4524498371577493E-4
STAT,1942,12,na,1954,4150.45369963178
STAT,1846,24,35-39,1870,5.385922070274447
SIM,1887,30,25-29,1917,25
STAT,1786,85,na,1871,90.04456992251811
STAT,1827,32,15-19,1859,0.19165951330371475
SIM,1909,56,na,1965,3601
SIM,1884,53,na,1937,2210
SIM,1959,8,na,1967,5501
STAT,1869,22,50-100,1891,0.40043325407057395
SIM,1889,28,45-49,1917,2
STAT,1897,51,na,1948,2929.545581185806
STAT,1919,26,35-39,1945,16.435219903021288
STAT,1936,23,30-34,1959,27.731813292448027
STAT,1851,43,15-19,1894,0.010381098013511487
SIM,1851,66,na,1917,1395
STAT,1918,18,30-34,1936,13.35869069213589
SIM,1839,32,na,1871,1763
SIM,1871,80,na,1951,542
STAT,1899,33,45-49,1932,2.40700177831613
STAT,1875,43,50-100,1918,1.0878547706024333
SIM,1925,29,35-39,1954,31
STAT,1866,93,na,1959,45.24805952599116
STAT,1880,51,50-100,1931,0.016096292846202395
STAT,1863,21,30-34,1884,16.37527195212601
STAT,1780,94,na,1874,3.6234353619013024
STAT,1894,23,15-19,1917,4.276582023895406
STAT,1917,29,35-39,1946,15.779228281402705
SIM,1824,42,50-100,1866,1
STAT,1826,30,50-100,1856,1.464914632530511
SIM,1823,42,35-39,1865,3
STAT,1823,82,na,1905,258.0496896824696
STAT,1890,28,45-49,1918,1.3654691912720838
STAT,1929,20,20-24,1949,142.97343699385587
STAT,1811,54,50-100,1865,0.03455807288101311
STAT,1896,39,35-39,1935,9.36076885303148
SIM,1871,21,30-34,1892,1
STAT,1876,43,20-24,1919,0.16442066882599482
STAT,1880,36,35-39,1916,7.538431133122512
SIM,1926,18,30-34,1944,20
SIM,1854,24,35-39,1878,11
SIM,1922,41,40-44,1963,1
STAT,1856,50,40-44,1906,0.008269194326618243
STAT,1813,45,35-39,1858,0.42272931573914035
STAT,1898,25,40-44,1923,4.12937863598463
STAT,1879,32,na,1911,2515.1714255684437
STAT,1879,30,25-29,1909,10.882480543649011
SIM,1894,17,30-34,1911,3
SIM,1875,17,na,1892,2480
SIM,1907,23,45-49,1930,2
STAT,1861,17,25-29,1878,5.46644039425691
STAT,1879,49,45-49,1928,0.24355037413113295
STAT,1896,46,40-44,1942,0.12947445528048027
STAT,1860,27,20-24,1887,9.789577999216169
STAT,1878,22,20-24,1900,72.2516330943086
STAT,1905,20,35-39,1925,8.57120195993117
STAT,1877,33,25-29,1910,10.632072109394661
STAT,1883,31,na,1914,2368.2000115235296
STAT,1875,22,35-39,1897,6.052661968936014
SIM,1830,29,40-44,1859,5
SIM,1886,22,20-24,1908,85
STAT,1903,23,35-39,1926,8.367894977359553
STAT,1818,37,35-39,1855,17.86847528066975
SIM,1890,33,35-39,1923,17
SIM,1885,33,25-29,1918,14
STAT,1902,33,30-34,1935,24.814396694569492
SIM,1910,33,30-34,1943,19
STAT,1781,101,na,1882,0.07880052953785996
STAT,1878,19,na,1897,2633.7832055817134
STAT,1772,99,na,1871,0.25111172992968145
STAT,1815,42,35-39,1857,4.696446055160652
STAT,1815,87,na,1902,76.26485371038682
SIM,1928,23,na,1951,4703
STAT,1900,29,25-29,1929,58.92518428310908
SIM,1825,29,30-34,1854,28
SIM,1909,20,45-49,1929,1
STAT,1925,37,15-19,1962,0.023292900975480615
SIM,1917,51,na,1968,3654
STAT,1919,33,40-44,1952,4.244897157836886
STAT,1895,15,15-19,1910,7.863822613604173
STAT,1873,41,na,1914,2377.2083628408377
STAT,1882,33,35-39,1915,9.865979512438116
STAT,1874,39,15-19,1913,0.05748996969238795
SIM,1911,23,35-39,1934,14
STAT,1867,47,na,1914,2130.120623372325
STAT,1910,28,40-44,1938,4.52504886895581
SIM,1845,66,na,1911,1242
STAT,1821,87,na,1908,105.5308674492586
STAT,1834,21,35-39,1855,4.698100667432657
STAT,1866,99,na,1965,7.23677460296753
SIM,1841,22,50-100,1863,1
STAT,1815,48,50-100,1863,0.5359199334093112
STAT,1855,51,35-39,1906,0.006511223677074711
SIM,1924,39,na,1963,4485
SIM,1826,34,30-34,1860,30
STAT,1838,48,45-49,1886,0.16046484168405545
STAT,1853,22,15-19,1875,3.2235014138414457
SIM,1802,89,na,1891,13
STAT,1885,25,30-34,1910,25.48806798426237
STAT,1826,54,50-100,1880,0.013794165581855346
STAT,1845,91,na,1936,42.34166101370347
STAT,1914,34,35-39,1948,9.201529530212508
STAT,1895,28,50-100,1923,0.8407608989614893
STAT,1872,35,30-34,1907,5.463160781611744
STAT,1929,37,15-19,1966,0.024918756770755626
SIM,1872,35,40-44,1907,5
SIM,1909,22,na,1931,4119
SIM,1822,44,40-44,1866,4
STAT,1876,28,25-29,1904,43.9584578432259
SIM,1930,33,na,1963,5204
STAT,1872,93,na,1965,89.07499826318059
STAT,1887,61,na,1948,2107.159330332731
SIM,1883,38,20-24,1921,1
STAT,1829,48,35-39,1877,0.10310028839550642
STAT,1891,39,15-19,1930,0.06951332118482428
SIM,1840,29,na,1869,1894
STAT,1904,28,50-100,1932,0.9239184957557758
SIM,1903,31,na,1934,3304
STAT,1890,19,na,1909,3100.288300236057
STAT,1917,44,30-34,1961,0.1342226653532229
SIM,1922,34,35-39,1956,17
SIM,1867,24,45-49,1891,1
SIM,1813,44,30-34,1857,1
STAT,1850,32,45-49,1882,1.3968249366514527
STAT,1859,38,35-39,1897,5.717087628386529
STAT,1824,48,15-19,1872,4.6164702722202545E-4
SIM,1848,49,na,1897,1676
SIM,1853,61,na,1914,1412
SIM,1946,20,30-34,1966,47
STAT,1917,17,na,1934,4195.254895053786
SIM,1828,34,35-39,1862,11
SIM,1936,24,na,1960,3578
STAT,1850,45,20-24,1895,0.009280172197410497
STAT,1924,15,20-24,1939,163.9023323516245
STAT,1945,21,15-19,1966,5.8938292180860525
SIM,1859,86,na,1945,120
STAT,1854,16,40-44,1870,0.1651761161714502
SIM,1877,27,40-44,1904,4
STAT,1867,103,na,1970,1.2966759931578073
SIM,1927,26,35-39,1953,22
SIM,1817,37,25-29,1854,1
STAT,1833,100,na,1933,0.751109362834236
STAT,1928,21,15-19,1949,6.738073581798832
STAT,1953,17,50-100,1970,0.45790380633252664
SIM,1836,31,20-24,1867,4
SIM,1898,33,35-39,1931,24
STAT,1887,25,35-39,1912,10.954392451547855
STAT,1920,31,25-29,1951,10.265200171840554
STAT,1906,47,20-24,1953,0.009911474642647715
SIM,1935,23,20-24,1958,4
STAT,1841,42,45-49,1883,1.1629985231517654
STAT,1918,20,45-49,1938,1.2324538874794273
SIM,1853,95,na,1948,6
STAT,1908,47,25-29,1955,0.048426438290110174
STAT,1927,23,20-24,1950,138.04200655619374
SIM,1822,37,35-39,1859,7
STAT,1942,29,30-34,1971,41.480496563054515
SIM,1893,25,30-34,1918,48
STAT,1937,21,25-29,1958,90.83815729915432
SIM,1897,26,na,1923,3437
STAT,1919,28,50-100,1947,1.082052594575282
STAT,1895,22,20-24,1917,90.8930554995526
SIM,1895,25,35-39,1920,18
STAT,1830,53,25-29,1883,0.0025543502007057163
STAT,1877,31,na,1908,2497.7119735683464
SIM,1834,29,na,1863,1967
SIM,1904,36,40-44,1940,2
STAT,1871,26,50-100,1897,0.6440856014559293
SIM,1945,21,25-29,1966,101
STAT,1836,55,na,1891,1303.7430019073358
SIM,1829,42,na,1871,1744
SIM,1856,46,50-100,1902,2
STAT,1770,114,na,1884,1.585875708597084E-4
STAT,1828,31,20-24,1859,3.2890132330548583
STAT,1860,51,45-49,1911,0.012039162968208932
STAT,1873,47,na,1920,2292.8938409938496
STAT,1891,33,45-49,1924,2.171409438847132
STAT,1891,46,20-24,1937,0.008488518630809554
SIM,1932,15,20-24,1947,206
STAT,1881,28,35-39,1909,9.360797030304594
SIM,1891,35,na,1926,3064
STAT,1854,21,20-24,1875,61.206175972832156
SIM,1819,83,na,1902,158
STAT,1857,24,40-44,1881,1.700879177631748
SIM,1884,25,na,1909,2373
STAT,1797,57,na,1854,1049.0
STAT,1822,35,na,1857,1632.6893943178318
STAT,1933,29,20-24,1962,24.468099355605634
STAT,1914,44,45-49,1958,0.16583445976252198
SIM,1835,42,na,1877,1487
SIM,1875,11,na,1886,2573
STAT,1859,12,na,1871,2251.0488090711438
SIM,1935,18,40-44,1953,2
SIM,1797,63,na,1860,785
STAT,1875,76,na,1951,982.6636372796517
STAT,1884,19,na,1903,2502.0010213375904
STAT,1885,18,25-29,1903,5.682049808828205
STAT,1835,27,25-29,1862,41.3948219415664
STAT,1934,37,25-29,1971,1.3728984420807533
STAT,1837,21,20-24,1858,61.98894629954333
STAT,1938,20,30-34,1958,28.736280032788667
SIM,1901,33,20-24,1934,4
SIM,1921,36,40-44,1957,1
STAT,1833,38,15-19,1871,0.04933869478371345
STAT,1845,19,35-39,1864,0.5007938345582876
SIM,1880,63,na,1943,1593
STAT,1875,38,20-24,1913,0.7955722371031548
SIM,1864,43,35-39,1907,4
SIM,1884,28,25-29,1912,44
SIM,1912,4,na,1916,4043
STAT,1893,61,na,1954,2396.4157641645934
SIM,1843,27,25-29,1870,57
STAT,1913,55,na,1968,3504.387709564231
SIM,1845,21,20-24,1866,58
STAT,1766,106,na,1872,0.006158333067053079
SIM,1952,18,40-44,1970,1
STAT,1839,91,na,1930,41.083430013438786
STAT,1944,18,40-44,1962,1.5195036240663284
STAT,1857,100,na,1957,1.169993512537334
SIM,1936,21,15-19,1957,5
SIM,1838,48,50-100,1886,5
STAT,1848,40,na,1888,1933.6247192723336
STAT,1918,34,35-39,1952,9.71979735004044
SIM,1817,57,na,1874,1317
SIM,1941,29,20-24,1970,23
SIM,1865,24,40-44,1889,1
STAT,1808,47,20-24,1855,0.04382735019638193
STAT,1857,4,na,1861,2469.394741121361
STAT,1928,26,45-49,1954,2.1586892590184683
SIM,1831,34,40-44,1865,5
SIM,1853,19,35-39,1872,1
SIM,1846,14,na,1860,2187
STAT,1864,37,50-100,1901,1.118949008934816
STAT,1852,79,na,1931,530.1957925435652
STAT,1814,44,40-44,1858,5.715391083491205
SIM,1893,18,25-29,1911,7
STAT,1932,37,20-24,1969,0.35793308719253486
STAT,1828,26,40-44,1854,7.785547596715856
STAT,1833,45,20-24,1878,0.010240627353967404
STAT,1860,37,30-34,1897,4.40024095750343
STAT,1930,27,na,1957,4814.47918995699
STAT,1940,16,15-19,1956,46.53271944640997
SIM,1867,35,30-34,1902,8
SIM,1862,21,20-24,1883,84
STAT,1868,27,20-24,1895,11.324262857898239
STAT,1824,42,45-49,1866,1.8597259098002525
STAT,1898,39,na,1937,3218.5560495994787
SIM,1814,74,na,1888,438
STAT,1859,24,45-49,1883,0.5793111733980029
STAT,1895,56,na,1951,2690.2025640908173
STAT,1843,19,30-34,1862,1.357657790683793
SIM,1926,34,35-39,1960,13
SIM,1925,19,25-29,1944,66
STAT,1850,38,15-19,1888,0.04322801967659566
SIM,1852,14,na,1866,2175
SIM,1861,30,50-100,1891,2
SIM,1931,34,45-49,1965,2
STAT,1919,31,15-19,1950,0.14055533004080523
SIM,1860,49,na,1909,1932
STAT,1923,34,45-49,1957,1.8203403569915466
SIM,1910,19,na,1929,3617
STAT,1828,26,na,1854,1778.1494593082386
STAT,1881,35,40-44,1916,4.302260219851827
STAT,1927,18,40-44,1945,1.753216022383537
STAT,1913,36,40-44,1949,1.497735935400992
SIM,1832,42,45-49,1874,1
STAT,1842,107,na,1949,0.004245937000777727
SIM,1918,39,na,1957,4195
STAT,1886,26,50-100,1912,0.6845044905808085
SIM,1831,27,35-39,1858,9
SIM,1915,56,na,1971,3926
STAT,1861,22,na,1883,2039.20434599735
SIM,1799,58,na,1857,1179
STAT,1909,28,30-34,1937,37.654220687322734
STAT,1874,49,50-100,1923,0.24869370059148146
SIM,1869,35,35-39,1904,9
SIM,1853,26,40-44,1879,3
STAT,1844,29,50-100,1873,0.6107045206156819
STAT,1917,4,na,1921,4369.804738359485
SIM,1913,29,45-49,1942,2
STAT,1865,40,40-44,1905,2.095339671880461
SIM,1934,19,35-39,1953,7
SIM,1821,39,40-44,1860,6
SIM,1858,70,na,1928,1001
SIM,1914,16,15-19,1930,11
STAT,1918,28,40-44,1946,4.99023351275138
SIM,1945,15,30-34,1960,18
STAT,1844,24,30-34,1868,17.344007235247553
STAT,1851,37,20-24,1888,0.5899278744043678
SIM,1912,42,na,1954,3443
STAT,1774,94,na,1868,2.6238780728085134
STAT,1779,113,na,1892,2.2239858619933035E-4
STAT,1919,16,25-29,1935,9.72472336857321
STAT,1886,14,na,1900,2745.0540045888974
STAT,1900,39,35-39,1939,2.1203190274888675
STAT,1869,32,20-24,1901,2.654291481699568
STAT,1905,29,45-49,1934,1.6095631532616395
STAT,1778,84,na,1862,113.04292907496662
STAT,1926,19,35-39,1945,5.171658453835633
STAT,1831,39,50-100,1870,0.9601598940969228
SIM,1877,32,20-24,1909,3
STAT,1840,40,35-39,1880,1.4928489245664274
SIM,1844,19,25-29,1863,6
SIM,1917,28,30-34,1945,67
SIM,1829,46,50-100,1875,3
SIM,1868,27,30-34,1895,45
STAT,1803,68,na,1871,897.8654990496703
STAT,1806,79,na,1885,287.4543857853944
SIM,1927,16,25-29,1943,89
STAT,1877,23,15-19,1900,3.428353129634509
STAT,1904,44,na,1948,3316.1493476611568
STAT,1920,47,40-44,1967,0.1759960315749705
STAT,1814,50,35-39,1864,0.02063939847601546
STAT,1865,49,15-19,1914,3.61199696305248E-4
STAT,1913,15,45-49,1928,0.10352974015971227
SIM,1866,68,na,1934,1423
STAT,1845,26,40-44,1871,2.68344766189796
STAT,1899,30,40-44,1929,6.059667700871196
STAT,1905,20,na,1925,3473.803184808229
SIM,1885,23,15-19,1908,4
STAT,1895,47,35-39,1942,0.10367512344830868
STAT,1823,34,40-44,1857,8.903391820557655
SIM,1833,47,na,1880,1661
STAT,1928,23,40-44,1951,4.230141558194023
SIM,1846,85,na,1931,82
SIM,1825,31,45-49,1856,1
SIM,1909,18,30-34,1927,5
STAT,1890,25,40-44,1915,3.7220893394137655
STAT,1893,43,20-24,1936,0.014040985885459876
STAT,1871,51,20-24,1922,7.439889293623326E-4
STAT,1851,23,50-100,1874,0.36608875867972057
STAT,1875,44,15-19,1919,0.01413045238487863
STAT,1952,16,40-44,1968,1.6939922066984614
SIM,1906,25,20-24,1931,18
STAT,1851,111,na,1962,2.4207950983702622E-4
SIM,1843,17,15-19,1860,5
STAT,1905,44,35-39,1949,0.18112393277817956
STAT,1953,16,25-29,1969,52.97905175662904
SIM,1926,28,40-44,1954,6
SIM,1915,7,na,1922,4583
STAT,1911,18,45-49,1929,0.10058625251651225
STAT,1901,30,na,1931,3405.8345345175403
STAT,1836,19,25-29,1855,6.320971505806761
STAT,1881,41,35-39,1922,1.7709226574845283
STAT,1851,91,na,1942,43.87737952625358
SIM,1854,21,30-34,1875,31
SIM,1871,52,na,1923,2032
SIM,1886,82,na,1968,854
STAT,1935,18,30-34,1953,16.790924201185522
STAT,1793,67,na,1860,720.3849694361536
SIM,1773,87,na,1860,60
SIM,1886,25,25-29,1911,62
SIM,1788,80,na,1868,286
SIM,1843,71,na,1914,1225
STAT,1900,26,20-24,1926,16.515841193828397
SIM,1922,26,15-19,1948,1
SIM,1936,23,40-44,1959,4
SIM,1875,42,na,1917,2277
SIM,1903,22,30-34,1925,36
STAT,1855,38,35-39,1893,5.297528695426851
STAT,1914,26,15-19,1940,0.7205025973654572
SIM,1871,36,35-39,1907,11
STAT,1845,24,15-19,1869,2.9497246422001053
SIM,1852,24,30-34,1876,19
SIM,1839,37,45-49,1876,2
STAT,1834,47,30-34,1881,0.061137993243720504
STAT,1853,16,20-24,1869,17.740817706834363
STAT,1856,43,35-39,1899,1.3920677180654044
STAT,1928,31,25-29,1959,11.688072289035569
SIM,1861,16,20-24,1877,27
SIM,1870,27,50-100,1897,1
STAT,1855,45,40-44,1900,0.13015054512619076
STAT,1842,38,25-29,1880,3.0094821152496096
SIM,1850,38,25-29,1888,7
SIM,1889,25,40-44,1914,4
STAT,1864,64,na,1928,1584.3175631882034
STAT,1938,27,15-19,1965,0.7060594523642962
STAT,1908,34,na,1942,3572.8735506061653
STAT,1906,16,15-19,1922,8.751780158338436
SIM,1880,35,30-34,1915,6
SIM,1928,21,25-29,1949,143
STAT,1867,53,20-24,1920,6.906549375768646E-4
STAT,1856,38,na,1894,1815.293368747332
SIM,1893,28,35-39,1921,18
SIM,1827,29,35-39,1856,7
SIM,1899,21,na,1920,3571
STAT,1837,109,na,1946,4.8534332157745033E-4
SIM,1872,28,35-39,1900,12
SIM,1927,41,na,1968,5123
STAT,1893,18,50-100,1911,0.0626646047734973
STAT,1858,0,na,1858,3114.6574896151496
STAT,1869,25,15-19,1894,0.448539594807096
SIM,1839,19,15-19,1858,5
STAT,1871,16,40-44,1887,0.1858090721446933
SIM,1854,5,na,1859,2729
SIM,1896,10,na,1906,3469
STAT,1879,46,40-44,1925,0.1809570857358319
SIM,1884,18,15-19,1902,6
SIM,1860,43,na,1903,2039
STAT,1937,15,30-34,1952,12.026480450286263
STAT,1834,43,15-19,1877,0.009788637034306217
SIM,1842,40,50-100,1882,1
SIM,1928,22,50-100,1950,4
STAT,1901,18,20-24,1919,25.035308266608247
SIM,1817,88,na,1905,39
SIM,1943,21,50-100,1964,4
SIM,1792,88,na,1880,18
SIM,1936,31,25-29,1967,17
STAT,1873,50,40-44,1923,0.010934265015132826
SIM,1878,53,na,1931,2392
SIM,1943,18,30-34,1961,23
STAT,1846,21,30-34,1867,16.799312661256753
STAT,1944,24,35-39,1968,10.25915119006024
SIM,1873,40,40-44,1913,4
STAT,1854,31,30-34,1885,13.558613670802849
SIM,1867,81,na,1948,456
STAT,1825,77,na,1902,630.7978739079726
SIM,1863,38,50-100,1901,1
STAT,1931,19,45-49,1950,0.6572688914555836
SIM,1918,23,20-24,1941,134
STAT,1842,16,45-49,1858,0.07596995439381199
STAT,1848,74,na,1922,906.0962563730783
SIM,1957,1,na,1958,5439
STAT,1880,28,50-100,1908,0.6761400114830678
SIM,1844,22,15-19,1866,8
STAT,1931,34,35-39,1965,12.086177807986264
STAT,1946,21,35-39,1967,10.58636627675475
STAT,1883,39,25-29,1922,2.817075090073233
STAT,1790,84,na,1874,94.3838393525333
STAT,1887,22,30-34,1909,20.08594889104543
STAT,1885,28,35-39,1913,9.666286249889074
SIM,1836,38,50-100,1874,2
STAT,1809,53,na,1862,1327.4676894263812
STAT,1831,40,na,1871,1652.2599192676953
SIM,1922,38,na,1960,4828
SIM,1935,26,25-29,1961,109
STAT,1936,33,40-44,1969,3.83506134826013
SIM,1887,36,na,1923,2619
SIM,1937,20,20-24,1957,113
SIM,1886,15,15-19,1901,9
STAT,1908,44,20-24,1952,0.01629119175461519
STAT,1843,21,45-49,1864,0.5946183961843239
STAT,1902,23,50-100,1925,0.5802245108087133
SIM,1829,73,na,1902,808
STAT,1771,104,na,1875,0.025924701917534643
STAT,1843,45,15-19,1888,2.7549867986134083E-4
STAT,1850,48,25-29,1898,0.04355093308967531
STAT,1846,45,30-34,1891,0.07419242199980358
SIM,1790,90,na,1880,47
STAT,1860,33,15-19,1893,0.11707938866906846
STAT,1852,42,20-24,1894,0.12029423994998263
STAT,1910,44,na,1954,3497.7375197771385
STAT,1911,31,15-19,1942,0.12676020538971872
STAT,1940,27,50-100,1967,1.0246827091304598
STAT,1865,46,na,1911,2080.820268248623
STAT,1911,20,na,1931,3673.1508264158906
SIM,1826,37,35-39,1863,12
STAT,1901,28,30-34,1929,35.52847807513076
SIM,1876,27,20-24,1903,21
SIM,1828,31,30-34,1859,23
STAT,1840,54,na,1894,1467.838010377395
SIM,1895,22,30-34,1917,32
SIM,1903,29,50-100,1932,5
STAT,1867,31,40-44,1898,4.142037905464334
SIM,1934,23,na,1957,5017
STAT,1915,47,30-34,1962,0.0906420044019508
SIM,1940,23,na,1963,3834
SIM,1930,18,20-24,1948,182
STAT,1917,45,na,1962,3891.559944449118
STAT,1860,43,50-100,1903,0.8659339058481337
STAT,1903,17,40-44,1920,0.26309018462977685
SIM,1926,24,25-29,1950,165
STAT,1914,31,30-34,1945,16.066417314492718
STAT,1914,41,40-44,1955,0.2504224975792611
STAT,1822,45,45-49,1867,0.35986683524623914
STAT,1841,32,35-39,1873,9.188512395614566
STAT,1875,48,30-34,1923,0.09914108996436612
STAT,1922,18,20-24,1940,158.0932352394674
STAT,1862,22,25-29,1884,51.11358793678299
STAT,1845,16,30-34,1861,1.480696991942123
STAT,1837,37,50-100,1874,1.0197731931248262
STAT,1856,2,na,1858,2742.111147999743
STAT,1918,24,25-29,1942,99.94680715268457
SIM,1871,24,35-39,1895,8
STAT,1878,25,25-29,1903,44.652019182694325
SIM,1870,22,25-29,1892,71
STAT,1859,35,30-34,1894,4.370522526762017
SIM,1913,6,na,1919,4120
STAT,1859,21,40-44,1880,1.9439439440972677
STAT,1787,67,na,1854,615.0
STAT,1898,28,45-49,1926,1.514885536686832
SIM,1858,38,25-29,1896,3
SIM,1922,31,30-34,1953,27
STAT,1838,45,40-44,1883,0.12096614143624185
STAT,1826,52,20-24,1878,7.012854172857933E-4
SIM,1867,21,40-44,1888,4
STAT,1855,22,na,1877,1880.1941442615591
STAT,1828,41,30-34,1869,1.1166095432687362
STAT,1784,84,na,1868,90.61413338783228
SIM,1853,16,30-34,1869,3
SIM,1797,91,na,1888,15
STAT,1880,29,na,1909,2513.3177890797215
STAT,1913,39,45-49,1952,0.6719605327775268
STAT,1944,20,50-100,1964,0.717904924943816
STAT,1868,23,na,1891,2275.9054873615446
SIM,1800,100,na,1900,5
SIM,1908,29,35-39,1937,17
SIM,1902,15,40-44,1917,1
STAT,1863,24,35-39,1887,5.249973043069948
STAT,1885,15,20-24,1900,17.90597043883284
SIM,1899,29,15-19,1928,4
SIM,1934,29,45-49,1963,3
STAT,1837,24,25-29,1861,50.392979722784446
STAT,1957,14,na,1971,5229.709680454203
STAT,1836,32,25-29,1868,8.167403021685082
STAT,1934,34,20-24,1968,3.3606740550521597
STAT,1871,46,na,1917,2263.954286995594
STAT,1916,49,40-44,1965,0.16223746859062485
STAT,1946,25,50-100,1971,1.1208175059423422
STAT,1815,53,na,1868,1193.6925589636182
STAT,1860,9,na,1869,2319.8948483688255
SIM,1844,32,25-29,1876,10
SIM,1916,21,50-100,1937,4
STAT,1891,30,40-44,1921,5.466560000281257
STAT,1817,82,na,1899,213.47188202315755
STAT,1830,50,20-24,1880,6.205996010019847E-4
SIM,1887,67,na,1954,1685
STAT,1842,89,na,1931,94.58333514939127
STAT,1908,21,50-100,1929,0.6124807798338512
STAT,1895,32,30-34,1927,23.028727776782468
SIM,1893,15,20-24,1908,23
SIM,1903,37,na,1940,3207
STAT,1860,74,na,1934,916.2709196015505
STAT,1927,26,25-29,1953,81.15584348999111
STAT,1864,35,40-44,1899,4.0274896355874645
STAT,1919,2,na,1921,4563.355182282183
STAT,1871,29,50-100,1900,0.6372951719617735
STAT,1906,38,50-100,1944,0.3879051286968147
SIM,1918,33,30-34,1951,42
STAT,1884,22,45-49,1906,0.6945288016536673
SIM,1891,39,25-29,1930,3
SIM,1845,24,25-29,1869,84
SIM,1835,26,20-24,1861,12
SIM,1836,41,30-34,1877,4
STAT,1832,25,na,1857,1974.2358100648821
SIM,1876,4,na,1880,3147
SIM,1921,39,45-49,1960,3
SIM,1928,31,35-39,1959,14
STAT,1940,31,40-44,1971,4.091202846041
SIM,1881,40,30-34,1921,1
SIM,1905,66,na,1971,2763
STAT,1894,17,20-24,1911,23.05303639807975
SIM,1867,38,35-39,1905,10
STAT,1802,83,na,1885,138.15704932778698
SIM,1872,68,na,1940,1621
STAT,1816,48,25-29,1864,0.1467389649962057
SIM,1841,41,40-44,1882,3
SIM,1921,20,25-29,1941,95
STAT,1931,28,50-100,1959,1.2981014620567095
STAT,1857,27,45-49,1884,0.9014594766611737
STAT,1851,49,20-24,1900,0.00889653981881952
STAT,1897,44,35-39,1941,0.16797001998957853
SIM,1784,90,na,1874,16
SIM,1848,15,na,1863,2162
SIM,1827,47,na,1874,1439
SIM,1919,25,30-34,1944,54
STAT,1799,83,na,1882,139.69362944704199
STAT,1891,49,25-29,1940,0.03978121909042445
STAT,1800,54,na,1854,967.8250907326733
STAT,1864,38,45-49,1902,1.807826699704955
STAT,1874,29,na,1903,2450.4773979917527
SIM,1959,2,na,1961,5512
STAT,1887,46,30-34,1933,0.10946604236090378
STAT,1904,37,45-49,1941,0.6236509834429552
STAT,1926,28,na,1954,4522.674913767696
STAT,1913,20,25-29,1933,90.84790555942406
SIM,1893,36,na,1929,3089
STAT,1833,41,40-44,1874,1.9603230559903675
STAT,1926,29,45-49,1955,2.0781293188829615
STAT,1857,88,na,1945,108.21301164260485
SIM,1917,19,35-39,1936,5
STAT,1862,107,na,1969,0.05088095241879792
STAT,1856,47,15-19,1903,3.082942270577119E-4
SIM,1831,40,35-39,1871,3
SIM,1875,48,na,1923,2247
SIM,1923,25,20-24,1948,32
STAT,1781,73,na,1854,274.0
STAT,1855,50,na,1905,1644.0248334172932
SIM,1812,48,na,1860,1288
SIM,1908,19,25-29,1927,16
STAT,1838,19,na,1857,2005.8761896971396
STAT,1899,18,na,1917,3491.7013417407493
SIM,1886,35,35-39,1921,3
SIM,1870,26,40-44,1896,4
SIM,1917,30,45-49,1947,3
STAT,1884,46,15-19,1930,3.9952879070791387E-4
STAT,1937,25,40-44,1962,4.590902827496257
STAT,1827,29,25-29,1856,69.93513944771577
STAT,1858,33,na,1891,1882.9013426617812
SIM,1958,3,na,1961,5245
STAT,1890,15,30-34,1905,1.976230627233348
SIM,1881,42,na,1923,2027
STAT,1879,3,na,1882,3211.6391842551757
STAT,1853,30,50-100,1883,0.7966620694864196
SIM,1882,42,40-44,1924,6
STAT,1887,47,45-49,1934,0.2648837578283949
STAT,1810,48,20-24,1858,0.045485376316216304
STAT,1921,15,35-39,1936,4.853224172018877
STAT,1775,79,na,1854,192.0
STAT,1862,26,40-44,1888,2.641388799722436
STAT,1937,26,50-100,1963,0.9799597843705277
STAT,1930,27,45-49,1957,2.2202926809857213
STAT,1878,35,35-39,1913,7.486065482659604
SIM,1902,52,na,1954,3195
SIM,1952,11,na,1963,4780
STAT,1861,54,30-34,1915,0.004858473679785519
SIM,1895,62,na,1957,2444
STAT,1882,35,50-100,1917,1.212566699099251
STAT,1795,93,na,1888,8.214010366209187
STAT,1848,52,40-44,1900,0.008549630704036911
STAT,1837,100,na,1937,0.7242325648032777
SIM,1823,88,na,1911,88
SIM,1844,29,35-39,1873,11
STAT,1843,68,na,1911,1030.7200228391853
SIM,1826,68,na,1894,1127
STAT,1874,42,40-44,1916,2.3233137579137133
STAT,1901,24,15-19,1925,4.641706768733627
STAT,1832,28,na,1860,1933.0413748126173
STAT,1909,26,40-44,1935,4.5487695414672675
SIM,1945,25,40-44,1970,7
SIM,1826,31,na,1857,2173
STAT,1855,48,45-49,1903,0.17541003970980276
STAT,1871,12,na,1883,2649.3211355369995
STAT,1910,36,25-29,1946,0.9546365952028995
STAT,1941,27,20-24,1968,19.064279488607596
STAT,1893,41,50-100,1934,1.3609680394188224
STAT,1806,73,na,1879,507.6357187297565
STAT,1842,35,20-24,1877,0.831224607996901
STAT,1851,47,30-34,1898,0.07295406980135587
STAT,1877,27,50-100,1904,0.6668302627305337
STAT,1905,42,45-49,1947,0.15156066965515194
STAT,1920,21,50-100,1941,0.7409318115890811
STAT,1882,52,na,1934,2095.332144235303
STAT,1833,46,50-100,1879,0.20692339844067312
STAT,1876,18,15-19,1894,6.172589723793021
SIM,1919,18,na,1937,3945
STAT,1901,38,40-44,1939,1.3311312421460717
SIM,1932,36,50-100,1968,3
STAT,1928,25,30-34,1953,49.123089601212556
STAT,1836,29,35-39,1865,7.763624245224588
SIM,1868,60,na,1928,1758
STAT,1824,98,na,1922,1.61501490736253
SIM,1831,24,30-34,1855,24
STAT,1852,54,20-24,1906,5.442426055961152E-4
SIM,1858,16,15-19,1874,6
STAT,1849,59,na,1908,1519.503068507522
STAT,1901,36,15-19,1937,0.017243452083158087
SIM,1914,5,na,1919,4394
STAT,1855,35,30-34,1890,4.049783736840403
STAT,1856,40,30-34,1896,0.8992241506254111
STAT,1917,44,50-100,1961,0.12333974627014263
SIM,1928,30,20-24,1958,7
STAT,1902,41,15-19,1943,0.0013749111103259308
STAT,1807,51,40-44,1858,0.03646452584501652
SIM,1900,26,30-34,1926,45
STAT,1965,6,na,1971,4955.682811952455
SIM,1831,83,na,1914,276
STAT,1868,28,35-39,1896,9.281237198616514
STAT,1846,48,na,1894,1685.9169879465035
STAT,1886,25,15-19,1911,0.4871076415618582
SIM,1851,35,na,1886,1988
SIM,1917,26,40-44,1943,8
SIM,1858,34,45-49,1892,3
SIM,1906,42,na,1948,3275
STAT,1819,39,50-100,1858,2.9644534932975266
SIM,1814,49,50-100,1863,1
SIM,1894,20,20-24,1914,120
SIM,1819,80,na,1899,299
STAT,1787,98,na,1885,0.506739570968423
STAT,1902,15,na,1917,3621.4446928270686
SIM,1899,35,45-49,1934,4
STAT,1923,24,35-39,1947,11.000344828256647
STAT,1855,53,na,1908,1594.7115755127722
STAT,1886,20,20-24,1906,73.92627116778654
STAT,1919,48,45-49,1967,0.237353396201096
STAT,1871,24,25-29,1895,57.08203793153751
SIM,1931,24,35-39,1955,11
STAT,1768,91,na,1859,30.725797242882834
STAT,1859,29,50-100,1888,0.52105081632132
STAT,1837,46,35-39,1883,0.10042339974202057
STAT,1860,49,30-34,1909,0.07825196861572772
STAT,1940,21,30-34,1961,29.568026344642725
SIM,1927,36,45-49,1963,1
SIM,1820,77,na,1897,455
STAT,1844,52,50-100,1896,0.011885445808374914
STAT,1954,15,30-34,1969,15.231471920679917
SIM,1874,0,na,1874,3576
STAT,1888,40,na,1928,2783.0574454887023
STAT,1831,35,45-49,1866,1.6287629206549266
STAT,1914,34,na,1948,3808.1918609578565
STAT,1933,23,15-19,1956,7.132829958785415
SIM,1850,50,na,1900,1851
STAT,1894,15,30-34,1909,2.0821942481604636
SIM,1845,34,35-39,1879,19
SIM,1868,63,na,1931,1631
STAT,1869,73,na,1942,1166.3238064262036
STAT,1909,19,35-39,1928,0.8259132061592164
SIM,1835,24,30-34,1859,20
SIM,1862,31,30-34,1893,15
STAT,1870,40,15-19,1910,0.013834628517669966
STAT,1882,37,15-19,1919,0.05493867886327118
SIM,1868,37,40-44,1905,5
STAT,1881,3,na,1884,2929.375451059612
SIM,1932,37,30-34,1969,4
SIM,1861,19,25-29,1880,5
STAT,1872,38,35-39,1910,7.1463695073501485
STAT,1930,15,45-49,1945,0.6557871331102434
SIM,1941,23,15-19,1964,7
STAT,1851,60,na,1911,1444.0931685735159
SIM,1877,23,25-29,1900,61
SIM,1909,24,25-29,1933,122
STAT,1898,47,20-24,1945,0.009224964912305946
SIM,1877,35,25-29,1912,4
STAT,1890,31,35-39,1921,12.549504662836812
SIM,1880,38,35-39,1918,20
STAT,1836,22,15-19,1858,2.746627543959519
STAT,1869,35,25-29,1904,2.8541028677293214
STAT,1871,15,na,1886,2580.935360762388
SIM,1930,20,35-39,1950,12
STAT,1933,35,15-19,1968,0.026477118296486177
SIM,1903,25,35-39,1928,1
STAT,1843,65,na,1908,1139.8252835336912
STAT,1830,27,40-44,1857,3.2926151692021457
STAT,1924,37,30-34,1961,2.1717223004140385
SIM,1919,15,na,1934,4261
STAT,1910,43,30-34,1953,0.12116954220969046
STAT,1853,19,25-29,1872,5.571044164487604
STAT,1815,46,15-19,1861,9.024820759888258E-4
SIM,1863,35,30-34,1898,4
SIM,1883,43,50-100,1926,2
STAT,1823,40,35-39,1863,2.823142099003937
STAT,1926,22,na,1948,4483.809667763008
STAT,1909,30,45-49,1939,1.5274601634031444
SIM,1935,24,35-39,1959,13
SIM,1823,48,50-100,1871,2
SIM,1880,26,35-39,1906,13
STAT,1867,22,45-49,1889,0.6660401155004873
STAT,1902,49,na,1951,3144.646951929285
SIM,1918,24,35-39,1942,12
STAT,1820,53,30-34,1873,0.009523932304303527
SIM,1825,83,na,1908,159
SIM,1767,87,na,1854,30
STAT,1907,55,na,1962,3201.176535901047
STAT,1919,36,45-49,1955,0.7401376834501868
STAT,1887,24,20-24,1911,77.22242330821244
SIM,1824,36,na,1860,1594
STAT,1826,110,na,1936,1.51632340818178E-4
SIM,1788,86,na,1874,93
SIM,1960,6,na,1966,5278
SIM,1773,81,na,1854,155
STAT,1902,44,50-100,1946,0.1032935714405623
STAT,1837,34,35-39,1871,8.48419329526398
STAT,1868,51,50-100,1919,0.01464829905222697
STAT,1936,36,45-49,1972,0.6762776508097059
SIM,1895,24,20-24,1919,140
STAT,1811,53,20-24,1864,0.0017226616617166722
SIM,1853,24,15-19,1877,2
SIM,1845,35,na,1880,2010
SIM,1858,23,20-24,1881,67
STAT,1848,49,15-19,1897,3.1976429819979846E-4
SIM,1919,35,40-44,1954,2
STAT,1895,25,na,1920,3169.0920249843102
STAT,1920,34,na,1954,4147.5727601398285
STAT,1894,40,na,1934,3035.7122416325165
STAT,1877,37,40-44,1914,4.563211009506982
SIM,1876,25,30-34,1901,35
STAT,1919,5,na,1924,4486.28280832227
SIM,1891,36,20-24,1927,1
STAT,1946,23,25-29,1969,103.7829100736466
STAT,1872,33,40-44,1905,4.385009352047562
STAT,1935,20,45-49,1955,1.54910689101484
STAT,1925,47,25-29,1972,0.06496055102311223
SIM,1794,80,na,1874,233
STAT,1916,35,15-19,1951,0.020034084335412643
SIM,1844,50,na,1894,1456
STAT,1931,16,40-44,1947,1.854820304200516
STAT,1858,22,35-39,1880,5.305337514483232
SIM,1907,46,50-100,1953,2
SIM,1836,21,na,1857,2134
SIM,1894,27,40-44,1921,4
STAT,1916,47,15-19,1963,3.812941083741178E-4
STAT,1941,15,20-24,1956,141.05950723000205
SIM,1952,17,na,1969,4312
STAT,1857,85,na,1942,216.08491024731828
STAT,1883,48,20-24,1931,0.011711429412875608
STAT,1858,9,na,1867,2255.0905396495446
STAT,1873,53,45-49,1926,0.014620816012912957
STAT,1866,48,20-24,1914,0.011081776529335716
STAT,1927,24,35-39,1951,11.65216509911799
SIM,1848,24,40-44,1872,3
SIM,1813,42,40-44,1855,7
SIM,1818,36,30-34,1854,3
SIM,1838,56,na,1894,1473
STAT,1859,52,50-100,1911,0.01220318918495619
SIM,1885,27,30-34,1912,32
SIM,1905,34,35-39,1939,13
SIM,1918,30,na,1948,4270
SIM,1830,35,35-39,1865,8
SIM,1827,36,40-44,1863,6
STAT,1877,27,30-34,1904,26.25019950170161
SIM,1899,55,na,1954,3032
STAT,1822,35,35-39,1857,14.258716564364759
STAT,1886,39,40-44,1925,4.621155619329146
SIM,1867,25,20-24,1892,14
SIM,1894,39,40-44,1933,13
SIM,1937,6,na,1943,3827
STAT,1851,94,na,1945,15.1332140944327
STAT,1864,33,na,1897,2165.675406977536
SIM,1857,20,na,1877,2248
STAT,1916,45,25-29,1961,0.055164817991183876
STAT,1907,33,15-19,1940,0.12077245141400787
STAT,1874,26,na,1900,2476.5874247582565
STAT,1819,48,40-44,1867,0.3287280568138406
STAT,1836,24,50-100,1860,0.33465115937528794
STAT,1835,20,40-44,1855,3.2869897475337337
STAT,1911,22,50-100,1933,0.6295817779065817
STAT,1825,47,20-24,1872,0.01611299075965318
STAT,1945,26,45-49,1971,1.9149815054603037
STAT,1842,47,20-24,1889,0.010805822549161433
STAT,1901,31,20-24,1932,3.842785970334426
SIM,1862,78,na,1940,646
STAT,1929,21,50-100,1950,0.8435679030234818
STAT,1831,32,40-44,1863,3.5896277943732673
STAT,1886,27,40-44,1913,3.1944483739209564
STAT,1862,19,35-39,1881,0.49294467274771114
STAT,1907,45,15-19,1952,3.3800180334548886E-4
SIM,1937,30,30-34,1967,22
SIM,1883,77,na,1960,1133
STAT,1864,41,35-39,1905,1.6578199095292265
STAT,1887,30,15-19,1917,0.16187624491181407
STAT,1802,80,na,1882,260.6420171729664
STAT,1942,5,na,1947,4211.732970875456
STAT,1881,9,na,1890,2526.045154915995
SIM,1909,34,35-39,1943,11
SIM,1849,22,35-39,1871,7
STAT,1819,36,40-44,1855,14.162879676557868
STAT,1929,42,30-34,1971,0.1673432085630472
SIM,1835,29,25-29,1864,42
SIM,1814,43,na,1857,1408
SIM,1870,19,35-39,1889,1
STAT,1841,36,15-19,1877,0.04999266716632891
SIM,1912,22,40-44,1934,3
SIM,1880,33,40-44,1913,9
STAT,1877,17,20-24,1894,18.480634544440555
SIM,1844,36,40-44,1880,6
STAT,1831,37,35-39,1868,5.65377865129517
SIM,1904,30,35-39,1934,30
STAT,1827,103,na,1930,0.08534245751458565
STAT,1859,25,20-24,1884,9.835095244329928
SIM,1927,28,50-100,1955,1
STAT,1867,78,na,1945,743.220798804958
STAT,1932,18,15-19,1950,60.57089455089378
STAT,1827,72,na,1899,750.9914592304717
STAT,1910,33,20-24,1943,2.36281175486053
SIM,1859,21,15-19,1880,4
SIM,1872,37,50-100,1909,1
SIM,1872,41,35-39,1913,4
STAT,1850,13,na,1863,2223.573249037744
SIM,1940,18,15-19,1958,41
SIM,1943,16,40-44,1959,1
STAT,1946,19,20-24,1965,151.77431408307132
SIM,1843,20,40-44,1863,2
STAT,1816,45,20-24,1861,0.031971321658069214
STAT,1915,37,20-24,1952,0.2687103408290528
SIM,1958,0,na,1958,5252
STAT,1853,17,35-39,1870,0.5458552752462118
STAT,1844,13,na,1857,2390.0179807466875
STAT,1847,53,35-39,1900,0.006342425209881675
STAT,1845,38,40-44,1883,3.3260027261764833
STAT,1892,38,20-24,1930,0.9721121260875288
STAT,1897,41,30-34,1938,0.10859085324323946
SIM,1925,18,na,1943,4800
STAT,1882,55,na,1937,2022.9425357366306
STAT,1835,53,50-100,1888,0.011329863271875929
STAT,1846,46,45-49,1892,0.17960532158838707
STAT,1904,22,40-44,1926,3.020311714462813
STAT,1847,103,na,1950,0.10745501005621547
STAT,1931,32,45-49,1963,2.083857222626571
SIM,1822,72,na,1894,672
STAT,1840,20,na,1860,1933.6973653350349
STAT,1846,23,20-24,1869,64.06353880270987
SIM,1875,22,45-49,1897,3
STAT,1899,42,50-100,1941,0.10156593257421753
SIM,1861,17,35-39,1878,1
SIM,1900,57,na,1957,3103
SIM,1913,26,40-44,1939,6
STAT,1908,45,50-100,1953,0.20952031446629135
SIM,1946,17,na,1963,4053
STAT,1812,73,na,1885,569.7991427333736
STAT,1888,77,na,1965,1361.9565896684926
SIM,1820,43,na,1863,1456
STAT,1964,7,na,1971,4998.967988599872
STAT,1878,47,35-39,1925,0.1460993553086106
STAT,1915,25,20-24,1940,18.91463719374688
STAT,1935,16,40-44,1951,1.936633746001871
SIM,1819,44,35-39,1863,4
SIM,1918,36,35-39,1954,7
STAT,1836,36,40-44,1872,3.4249932848375426
STAT,1883,36,20-24,1919,0.7655519369547471
SIM,1853,38,40-44,1891,3
STAT,1831,25,35-39,1856,8.88552092335031
STAT,1807,58,na,1865,1033.969513447413
STAT,1911,41,25-29,1952,0.0691575463286251
STAT,1929,30,30-34,1959,20.250406982588178
STAT,1832,52,45-49,1884,0.01030944961756352
STAT,1865,12,na,1877,2493.1362928242434
STAT,1905,26,40-44,1931,4.388822441238171
STAT,1924,39,20-24,1963,0.3134405598448009
SIM,1854,23,20-24,1877,80
STAT,1837,34,na,1871,1815.5593987106834
STAT,1880,4,na,1884,3029.7898769314897
SIM,1912,15,35-39,1927,1
STAT,1884,42,50-100,1926,1.0509253442813702
SIM,1892,42,50-100,1934,3
STAT,1806,52,35-39,1858,0.024841710790915877
SIM,1854,49,na,1903,2066
SIM,1877,77,na,1954,886
SIM,1876,7,na,1883,3087
STAT,1862,29,45-49,1891,0.9615073828589566
STAT,1887,44,40-44,1931,2.502150326638483
SIM,1881,36,50-100,1917,1
STAT,1933,39,30-34,1972,2.5032330343341553
STAT,1920,9,na,1929,4510.228869381199
SIM,1928,29,20-24,1957,26
STAT,1899,23,35-39,1922,8.063866959151042
STAT,1847,50,30-34,1897,0.004520941661165891
SIM,1836,44,35-39,1880,6
STAT,1842,45,50-100,1887,0.22689924450098323
SIM,1940,25,20-24,1965,20
STAT,1827,106,na,1933,0.00722016167513756
STAT,1897,48,15-19,1945,3.0168163843108213E-4
SIM,1886,37,25-29,1923,4
SIM,1904,24,40-44,1928,2
STAT,1913,27,45-49,1940,1.7368399719079308
SIM,1903,15,25-29,1918,10
STAT,1887,49,35-39,1936,0.08719273216422695
STAT,1836,26,30-34,1862,20.704386231716875
STAT,1815,52,45-49,1867,0.03076186906634026
STAT,1910,26,15-19,1936,0.690136730708153
STAT,1932,25,20-24,1957,24.18281148264616
STAT,1844,17,25-29,1861,5.699203333473516
STAT,1853,27,na,1880,2072.4463745676967
SIM,1817,54,na,1871,1343
STAT,1926,43,50-100,1969,0.1461415671229305
SIM,1795,68,na,1863,704
STAT,1861,53,na,1914,1778.0957302521426
SIM,1889,62,na,1951,2185
STAT,1859,18,15-19,1877,5.5630325360480235
SIM,1930,26,40-44,1956,7
STAT,1882,43,45-49,1925,1.4536569747985042
STAT,1868,26,na,1894,2311.5947550200717
STAT,1891,42,40-44,1933,2.809207524914749
SIM,1894,23,25-29,1917,95
SIM,1899,32,40-44,1931,11
SIM,1869,34,20-24,1903,8
SIM,1926,16,40-44,1942,3
STAT,1863,23,20-24,1886,62.44647571381478
STAT,1876,16,25-29,1892,5.92402162029888
STAT,1891,66,na,1957,2102.634916440788
STAT,1803,100,na,1903,0.4425612907885962
STAT,1848,71,na,1919,1089.8092376476268
SIM,1805,69,na,1874,656
STAT,1904,15,35-39,1919,0.7990044734120194
STAT,1909,29,45-49,1938,1.6541809617102416
SIM,1890,30,30-34,1920,37
SIM,1847,61,na,1908,1318
STAT,1922,26,40-44,1948,5.346499017888111
STAT,1935,19,45-49,1954,0.6862600719366064
STAT,1964,4,na,1968,5001.518335845014
SIM,1946,20,50-100,1966,1
STAT,1810,46,30-34,1856,0.3811331528877851
STAT,1873,43,35-39,1916,1.840715884417144
SIM,1890,43,45-49,1933,3
SIM,1960,9,na,1969,5275
STAT,1909,16,30-34,1925,2.4179403645967215
SIM,1859,27,20-24,1886,13
SIM,1917,16,30-34,1933,3
STAT,1872,23,30-34,1895,18.031075608039348
STAT,1884,81,na,1965,826.4263990653428
SIM,1874,63,na,1937,1659
STAT,1895,35,35-39,1930,9.417522293240221
STAT,1834,20,na,1854,1615.2395042376193
STAT,1932,22,na,1954,4842.166437517871
STAT,1938,20,50-100,1958,0.6578819402316388
SIM,1827,32,25-29,1859,12
STAT,1789,90,na,1879,37.49007984516301
STAT,1873,36,50-100,1909,1.2631480435588989
SIM,1881,43,35-39,1924,2
STAT,1896,49,45-49,1945,0.17425983567186468
SIM,1869,48,na,1917,2154
SIM,1872,31,25-29,1903,20
STAT,1866,17,45-49,1883,0.06270570329805551
STAT,1828,44,35-39,1872,1.671541857132073
SIM,1835,27,35-39,1862,15
SIM,1822,34,30-34,1856,21
STAT,1831,46,na,1877,1535.5860427514303
STAT,1935,19,50-100,1954,0.5146950539524547
STAT,1941,3,na,1944,4193.601271011678
STAT,1882,30,30-34,1912,17.218976937674228
STAT,1910,41,na,1951,3561.6393984854762
SIM,1858,31,40-44,1889,2
STAT,1857,46,20-24,1903,0.009485787983846368
STAT,1769,110,na,1879,0.0016062122033358413
STAT,1919,40,na,1959,4074.9433781572434
STAT,1936,26,35-39,1962,14.512271658756774
SIM,1871,89,na,1960,186
SIM,1855,30,50-100,1885,2
SIM,1830,25,25-29,1855,55
SIM,1926,20,45-49,1946,2
STAT,1878,37,25-29,1915,3.0187080206508567
STAT,1800,88,na,1888,42.225287421762275
STAT,1803,99,na,1902,0.7894844368920855
SIM,1863,38,35-39,1901,11
STAT,1894,18,35-39,1912,0.7116365197855777
STAT,1929,40,40-44,1969,0.3283084869897903
STAT,1896,30,25-29,1926,13.803625626235924
STAT,1850,16,na,1866,2160.54820617204
STAT,1868,21,15-19,1889,3.2075479783814567
SIM,1832,47,50-100,1879,2
SIM,1866,22,35-39,1888,6
STAT,1881,25,30-34,1906,24.682553870988738
STAT,1832,42,35-39,1874,1.5129625070622446
STAT,1865,37,15-19,1902,0.051788881663152715
STAT,1928,35,40-44,1963,1.9155535281569058
SIM,1861,90,na,1951,39
STAT,1889,25,na,1914,2992.326309247022
STAT,1836,86,na,1922,139.89825604836923
SIM,1868,33,25-29,1901,12
SIM,1798,79,na,1877,179
STAT,1824,47,50-100,1871,0.2873801566629821
STAT,1827,27,35-39,1854,28.767484195616834
STAT,1923,21,30-34,1944,33.891110633599475
STAT,1790,87,na,1877,50.0295113221152
SIM,1928,33,25-29,1961,18
STAT,1947,21,na,1968,4170.283028345246
SIM,1851,38,na,1889,1865
STAT,1868,25,30-34,1893,24.472770470574186
SIM,1927,33,40-44,1960,1
STAT,1892,48,30-34,1940,0.06833349863696454
SIM,1862,34,35-39,1896,17
SIM,1835,76,na,1911,533
STAT,1846,33,30-34,1879,15.49634776763641
SIM,1840,42,35-39,1882,4
SIM,1888,15,na,1903,3184
STAT,1856,53,45-49,1909,0.011057201252867233
SIM,1924,30,na,1954,4549
SIM,1870,29,45-49,1899,1
SIM,1849,32,45-49,1881,2
SIM,1895,44,40-44,1939,1
STAT,1770,111,na,1881,6.443954022584401E-4
STAT,1906,28,15-19,1934,0.6650939845208065
STAT,1818,98,na,1916,1.6736704571912349
SIM,1844,26,30-34,1870,8
SIM,1893,30,na,1923,3112
STAT,1925,40,na,1965,4556.761851104318
SIM,1868,30,20-24,1898,2
STAT,1807,48,15-19,1855,0.0014104136118037632
STAT,1840,37,45-49,1877,1.652793636037019
STAT,1871,28,40-44,1899,2.9952408446952044
STAT,1846,48,35-39,1894,0.10490892570010762
STAT,1876,52,na,1928,2233.4622306590536
STAT,1865,52,40-44,1917,0.009657500950561409
SIM,1866,34,na,1900,2451
SIM,1858,26,25-29,1884,47
SIM,1904,16,na,1920,3790
STAT,1883,50,35-39,1933,0.008631224466121997
STAT,1838,31,50-100,1869,0.7701169836983313
STAT,1925,44,20-24,1969,0.02153632009370364
STAT,1857,1,na,1858,2941.0533542099784
SIM,1931,31,40-44,1962,6
SIM,1853,22,25-29,1875,59
SIM,1865,89,na,1954,120
STAT,1850,41,40-44,1891,1.7300945924653317
SIM,1853,6,na,1859,2235
SIM,1905,31,30-34,1936,5
STAT,1795,90,na,1885,35.80286949733467
SIM,1918,29,50-100,1947,2
STAT,1829,45,30-34,1874,0.0741244848978001
SIM,1836,24,15-19,1860,2
STAT,1881,38,45-49,1919,1.9311634785602991
STAT,1898,16,45-49,1914,0.08965981305984641
STAT,1904,41,na,1945,3376.7337031751977
SIM,1865,45,50-100,1910,1
STAT,1895,49,50-100,1944,0.17891245882680049
SIM,1846,31,50-100,1877,4
SIM,1859,37,30-34,1896,1
SIM,1862,75,na,1937,921
STAT,1922,20,35-39,1942,10.973458987101015
STAT,1774,91,na,1865,11.436845101162943
SIM,1918,26,25-29,1944,73
STAT,1837,31,30-34,1868,15.090127412894637
STAT,1910,46,35-39,1956,0.12166501798199734
SIM,1854,33,30-34,1887,24
SIM,1843,23,45-49,1866,1
SIM,1913,22,25-29,1935,142
STAT,1905,18,20-24,1923,25.817548775555448
STAT,1900,19,15-19,1919,8.281589007751538
STAT,1822,32,na,1854,1586.8694770396153
STAT,1871,18,30-34,1889,1.6001753548217126
SIM,1848,27,45-49,1875,1
STAT,1814,47,45-49,1861,0.5692179294529678
STAT,1854,34,35-39,1888,7.623123122247641
STAT,1825,46,na,1871,1905.4304551557436
STAT,1791,104,na,1895,0.011860246878732144
STAT,1828,34,25-29,1862,11.165210656624907
STAT,1904,30,50-100,1934,1.3386983757849071
SIM,1914,38,25-29,1952,1
STAT,1857,45,50-100,1902,0.19552284433042064
STAT,1845,22,25-29,1867,51.92746992343948
STAT,1824,61,na,1885,981.8306602093329
STAT,1839,97,na,1936,3.808774034120151
STAT,1916,42,20-24,1958,0.01826384257342533
SIM,1899,17,15-19,1916,8
STAT,1946,20,20-24,1966,125.06179771147417
SIM,1877,74,na,1951,1099
STAT,1896,36,30-34,1932,7.15951963325011
STAT,1880,1,na,1881,3608.4849180712104
SIM,1856,75,na,1931,847
SIM,1912,30,50-100,1942,3
STAT,1833,72,na,1905,893.4927896969739
STAT,1823,49,45-49,1872,0.3157083398819156
STAT,1837,31,na,1868,1873.0063301673927
SIM,1818,39,35-39,1857,13
SIM,1897,1,na,1898,3680
STAT,1846,43,40-44,1889,1.7056133867673824
SIM,1898,73,na,1971,1983
SIM,1862,24,25-29,1886,73
STAT,1931,22,35-39,1953,12.342287900339201
SIM,1810,84,na,1894,266
STAT,1847,30,50-100,1877,0.8223858102437096
STAT,1846,45,na,1891,1724.3919009471044
SIM,1845,31,30-34,1876,23
STAT,1833,48,25-29,1881,0.04304445803146333
STAT,1876,24,45-49,1900,0.7226445017836803
SIM,1854,43,40-44,1897,4
STAT,1879,66,na,1945,1727.5164025193585
SIM,1904,20,25-29,1924,2
STAT,1840,19,15-19,1859,5.3228661771702095
SIM,1839,25,45-49,1864,6
SIM,1841,76,na,1917,544
SIM,1894,15,na,1909,3629
SIM,1927,44,na,1971,5082
SIM,1801,70,na,1871,473
STAT,1879,52,35-39,1931,0.009025641583281592
STAT,1839,60,na,1899,1352.1386478533134
STAT,1854,24,25-29,1878,49.75663838200827
STAT,1863,36,35-39,1899,6.359949204727752
SIM,1876,28,35-39,1904,11
SIM,1912,25,45-49,1937,3
STAT,1886,23,25-29,1909,60.8576863795094
SIM,1842,24,na,1866,2137
STAT,1907,49,30-34,1956,0.07972433660600456
STAT,1843,52,20-24,1895,4.950533301260027E-4
SIM,1917,29,45-49,1946,1
STAT,1802,54,25-29,1856,0.009927891259859205
STAT,1887,34,30-34,1921,19.519815525624622
SIM,1831,30,25-29,1861,6
SIM,1863,23,na,1886,2167
STAT,1810,47,na,1857,1520.8781730658998
STAT,1920,37,na,1957,4159.686368686264
STAT,1937,31,35-39,1968,9.132653709313354
SIM,1870,16,30-34,1886,2
STAT,1940,24,35-39,1964,9.676997424930494
SIM,1836,34,25-29,1870,7
STAT,1824,51,40-44,1875,0.01211330109885677
SIM,1936,25,30-34,1961,5
SIM,1885,17,20-24,1902,19
STAT,1890,21,25-29,1911,70.86359089039611
SIM,1895,34,30-34,1929,32
STAT,1830,61,na,1891,1232.813295215529
SIM,1912,45,na,1957,3397
STAT,1780,91,na,1871,15.793671740160075
STAT,1895,25,25-29,1920,56.1725497947177
STAT,1901,34,25-29,1935,14.377906622388947
STAT,1906,38,25-29,1944,0.9096818851516906
SIM,1844,16,20-24,1860,13
STAT,1838,51,35-39,1889,0.005847113960748908
STAT,1945,23,40-44,1968,3.720345405563149
SIM,1789,68,na,1857,636
SIM,1913,18,20-24,1931,39
STAT,1819,46,na,1865,1387.9112419731334
STAT,1835,23,45-49,1858,0.6909785832590702
STAT,1891,34,50-100,1925,1.1359356693354703
SIM,1859,89,na,1948,81
STAT,1874,49,25-29,1923,0.05832555803344389
STAT,1919,23,30-34,1942,31.678490505884383
STAT,1836,39,45-49,1875,1.511881842581438
STAT,1923,31,40-44,1954,4.551379360752173
SIM,1874,44,50-100,1918,1
STAT,1840,24,30-34,1864,15.651519566506407
STAT,1868,28,50-100,1896,0.6153156620604651
SIM,1937,9,na,1946,3803
STAT,1904,25,45-49,1929,1.6202122041682225
STAT,1864,67,na,1931,1444.7472016938402
STAT,1878,32,30-34,1910,18.305724027123162
SIM,1927,23,30-34,1950,55
STAT,1876,21,40-44,1897,2.1796460746410267
SIM,1881,29,20-24,1910,13
STAT,1905,22,25-29,1927,83.58412294379441
STAT,1870,67,na,1937,1572.2004072577195
STAT,1866,44,50-100,1910,0.9746916900584488
SIM,1844,39,45-49,1883,2
SIM,1864,40,30-34,1904,2
SIM,1867,28,25-29,1895,6
STAT,1872,36,45-49,1908,2.033970758073352
SIM,1899,8,na,1907,3938
SIM,1928,29,na,1957,4729
SIM,1802,55,na,1857,1183
STAT,1890,81,na,1971,1134.635046218209
STAT,1936,16,25-29,1952,41.988811270448
SIM,1886,32,30-34,1918,42
STAT,1920,40,20-24,1960,0.019751252102609765
SIM,1857,23,na,1880,2346
SIM,1804,84,na,1888,107
STAT,1885,66,na,1951,1647.7587304743324
SIM,1897,29,na,1926,3215
STAT,1837,36,25-29,1873,2.416446646497447
STAT,1862,16,30-34,1878,1.601636687422306
STAT,1935,36,na,1971,5319.960367296872
STAT,1781,107,na,1888,0.00477268271435673
SIM,1834,21,45-49,1855,3
SIM,1918,21,30-34,1939,38
SIM,1944,16,25-29,1960,71
SIM,1880,36,45-49,1916,4
STAT,1859,28,25-29,1887,34.70510280640926
STAT,1880,35,30-34,1915,5.706827647160671
STAT,1958,12,na,1970,5211.264486797478
STAT,1843,36,na,1879,1704.0204348872298
STAT,1914,48,30-34,1962,0.08895401968911841
STAT,1866,27,20-24,1893,10.971635367036784
STAT,1885,44,20-24,1929,0.15750561203252783
STAT,1879,33,40-44,1912,4.551609230952901
SIM,1926,11,na,1937,4889
SIM,1934,30,na,1964,5296
SIM,1888,20,na,1908,2923
STAT,1882,43,40-44,1925,2.1846770926418673
STAT,1827,73,na,1900,706.3074674062589
SIM,1888,29,50-100,1917,1
SIM,1925,22,45-49,1947,1
STAT,1877,25,30-34,1902,26.42828947443654
STAT,1926,20,45-49,1946,1.3897706104529732
SIM,1785,77,na,1862,280
SIM,1841,43,45-49,1884,4
SIM,1899,35,50-100,1934,2
STAT,1843,34,15-19,1877,0.11309652456747972
STAT,1845,42,25-29,1887,0.4778105155628624
STAT,1866,39,15-19,1905,0.05198900920538461
STAT,1865,46,45-49,1911,0.2182703722362271
SIM,1830,81,na,1911,219
SIM,1945,20,20-24,1965,117
SIM,1836,25,35-39,1861,10
STAT,1769,94,na,1863,3.2669241610760036
SIM,1865,29,20-24,1894,12
SIM,1885,25,30-34,1910,31
STAT,1929,21,25-29,1950,118.4200498564337
SIM,1928,23,25-29,1951,123
STAT,1861,18,30-34,1879,1.5284787420020138
SIM,1800,83,na,1883,186
STAT,1856,48,45-49,1904,0.18044951070926996
STAT,1824,50,40-44,1874,0.012356325457864997
STAT,1870,16,30-34,1886,1.605294689134113
SIM,1853,22,30-34,1875,19
SIM,1890,43,40-44,1933,7
SIM,1915,49,50-100,1964,1
SIM,1878,35,40-44,1913,7
STAT,1836,44,25-29,1880,0.46972695454228547
STAT,1820,34,20-24,1854,8.553520608033507
SIM,1887,33,40-44,1920,5
STAT,1815,52,40-44,1867,0.022315389743026878
STAT,1818,37,na,1855,1572.372743949924
SIM,1909,31,na,1940,3915
SIM,1854,29,45-49,1883,1
STAT,1896,45,35-39,1941,0.10663146170061598
STAT,1873,45,40-44,1918,0.1770409172971558
SIM,1870,31,20-24,1901,3
SIM,1826,76,na,1902,786
SIM,1871,26,40-44,1897,5
SIM,1917,30,50-100,1947,1
STAT,1863,38,35-39,1901,6.298090802198843
STAT,1852,72,na,1924,957.7693258102952
SIM,1906,24,50-100,1930,3
STAT,1863,26,40-44,1889,2.7000861002640986
STAT,1854,28,40-44,1882,2.339851988195432
SIM,1862,28,40-44,1890,4
STAT,1847,50,35-39,1897,0.0065385519922526265
STAT,1838,52,35-39,1890,0.005732452055978621
STAT,1813,44,30-34,1857,3.6046479868777976
SIM,1951,10,na,1961,4987
SIM,1900,18,na,1918,3738
STAT,1872,36,35-39,1908,7.2165595086520735
STAT,1881,53,na,1934,2062.592150979541
STAT,1885,67,na,1952,1593.6792889401647
STAT,1845,22,30-34,1867,16.157514440778417
SIM,1894,18,35-39,1912,3
SIM,1917,50,na,1967,3673
STAT,1822,42,30-34,1864,1.8290994166777397
STAT,1846,29,45-49,1875,1.0047433291371737
STAT,1856,86,na,1942,171.80899273332867
STAT,1872,24,40-44,1896,2.102696846691086
SIM,1871,38,35-39,1909,15
STAT,1895,16,35-39,1911,0.7255047496842886
SIM,1894,23,30-34,1917,32
STAT,1835,28,30-34,1863,24.465273291281758
SIM,1936,22,20-24,1958,154
SIM,1938,30,30-34,1968,23
STAT,1886,18,35-39,1904,0.5836065234514591
STAT,1837,36,40-44,1873,3.6739414979137814
STAT,1892,37,na,1929,2985.9164314625236
STAT,1875,37,15-19,1912,0.05824449341039911
STAT,1879,53,35-39,1932,0.008928254910597988
STAT,1889,19,15-19,1908,7.351219434609847
STAT,1880,22,25-29,1902,60.721021169932385
STAT,1858,28,25-29,1886,34.06696028459643
STAT,1825,38,15-19,1863,0.08897150617398078
STAT,1853,19,35-39,1872,0.5394440369696059
STAT,1859,37,30-34,1896,4.329405636820121
STAT,1861,38,25-29,1899,2.4044673380889363
SIM,1919,30,20-24,1949,4
STAT,1899,46,15-19,1945,3.1364975979095866E-4
SIM,1877,26,35-39,1903,10
STAT,1877,48,na,1925,2315.8178807921868
STAT,1894,37,25-29,1931,3.743921919460558
STAT,1843,47,20-24,1890,0.008055880951183796
STAT,1857,29,20-24,1886,9.388526230704468
STAT,1871,37,30-34,1908,5.347827368496883
SIM,1919,25,25-29,1944,91
STAT,1792,70,na,1862,633.7398351086289
STAT,1881,85,na,1966,515.2034517112726
SIM,1910,28,na,1938,3404
STAT,1844,43,20-24,1887,0.12704874970920757
SIM,1897,19,15-19,1916,9
STAT,1856,53,40-44,1909,0.008021156155781427
STAT,1816,51,45-49,1867,0.0367684888821426
SIM,1827,32,30-34,1859,20
STAT,1827,46,25-29,1873,0.059868693894069076
STAT,1848,67,na,1915,1294.2644906074177
SIM,1937,21,25-29,1958,136
STAT,1873,34,na,1907,2422.447590726115
SIM,1843,28,30-34,1871,39
SIM,1929,15,40-44,1944,3
STAT,1833,43,45-49,1876,1.2713765889289195
SIM,1856,42,50-100,1898,1
STAT,1886,23,30-34,1909,18.936199817920123
STAT,1827,51,20-24,1878,7.453912031670164E-4
STAT,1859,49,25-29,1908,0.04581357821181526
STAT,1878,54,30-34,1932,0.0060693561186406925
STAT,1917,22,45-49,1939,1.207077737284492
STAT,1831,35,35-39,1866,5.778875874069146
STAT,1881,17,45-49,1898,0.06359573437941256
STAT,1871,43,na,1914,2302.400877475641
SIM,1876,27,30-34,1903,49
SIM,1806,88,na,1894,24
STAT,1876,46,20-24,1922,0.012549645682238424
STAT,1823,100,na,1923,0.5871570702420896
STAT,1882,38,45-49,1920,1.940649266281225
STAT,1808,46,15-19,1854,0.0015019081900772128
SIM,1821,39,35-39,1860,15
SIM,1890,30,35-39,1920,23
STAT,1867,38,na,1905,2229.9414915049315
SIM,1890,38,45-49,1928,2
SIM,1902,31,50-100,1933,1
STAT,1833,26,na,1859,2031.1663866648928
SIM,1840,44,40-44,1884,4
SIM,1939,32,50-100,1971,1
STAT,1892,29,15-19,1921,0.5709034298820932
STAT,1894,42,20-24,1936,0.014322836602936498
STAT,1895,49,35-39,1944,0.10198592960833751
STAT,1928,22,20-24,1950,140.3262888911211
STAT,1818,108,na,1926,9.437164255350306E-4
SIM,1884,41,50-100,1925,2
STAT,1850,40,40-44,1890,1.739680230535583
STAT,1859,41,15-19,1900,0.01126897565066689
STAT,1902,64,na,1966,2736.101841488733
SIM,1866,28,25-29,1894,57
STAT,1877,45,25-29,1922,0.06064219139519491
STAT,1882,30,35-39,1912,9.987430615026
STAT,1830,39,35-39,1869,6.250181131912121
STAT,1837,53,30-34,1890,0.003995742571939913
SIM,1872,34,35-39,1906,18
SIM,1901,67,na,1968,2448
STAT,1873,22,50-100,1895,0.4175405020389475
STAT,1894,17,30-34,1911,2.072564809790961
SIM,1872,25,45-49,1897,2
STAT,1899,26,20-24,1925,16.317378444073462
STAT,1818,48,25-29,1866,0.10104102115747099
SIM,1830,38,na,1868,1562
SIM,1863,76,na,1939,694
STAT,1847,18,na,1865,2132.450669984516
SIM,1938,12,na,1950,3852
STAT,1865,51,40-44,1916,0.009755642716287254
SIM,1874,42,45-49,1916,3
STAT,1835,48,25-29,1883,0.04500651735066171
SIM,1873,18,15-19,1891,6
STAT,1832,44,40-44,1876,1.8314073366386183
SIM,1855,57,na,1912,1750
SIM,1861,36,25-29,1897,2
STAT,1855,37,na,1892,1773.3931221435812
SIM,1852,26,30-34,1878,48
SIM,1877,39,40-44,1916,1
STAT,1771,105,na,1876,0.01624623295066144
SIM,1815,92,na,1907,16
STAT,1896,28,45-49,1924,1.479162739290932
SIM,1822,43,35-39,1865,1
SIM,1881,49,50-100,1930,2
SIM,1831,55,na,1886,1401
SIM,1837,60,na,1897,1187
SIM,1857,35,20-24,1892,4
STAT,1805,50,30-34,1855,0.025479675251747696
STAT,1861,30,15-19,1891,0.120480647399536
STAT,1876,33,15-19,1909,0.14788213033158987
STAT,1850,35,45-49,1885,1.5831513112617968
SIM,1895,37,50-100,1932,1
STAT,1854,15,35-39,1869,0.49846427440006663
STAT,1829,37,45-49,1866,1.6336998466723467
STAT,1869,39,40-44,1908,4.255263297427057
STAT,1895,46,30-34,1941,0.07222417932742863
STAT,1865,18,15-19,1883,5.606787531211939
STAT,1872,92,na,1964,111.15201061067235
SIM,1896,71,na,1967,2063
STAT,1838,32,40-44,1870,3.6074162667373284
STAT,1864,25,45-49,1889,1.0227318699499592
STAT,1805,62,na,1867,1089.847576183232
STAT,1813,81,na,1894,237.10300234122036
STAT,1855,32,40-44,1887,3.323768422406271
STAT,1876,29,30-34,1905,26.07307580649228
STAT,1844,108,na,1952,0.0014492307704607687
SIM,1826,28,30-34,1854,28
STAT,1849,53,50-100,1902,0.011618536234242324
STAT,1948,21,35-39,1969,10.925000387046364
STAT,1860,26,15-19,1886,0.3813404918250282
SIM,1880,36,35-39,1916,10
SIM,1887,28,45-49,1915,1
STAT,1814,43,35-39,1857,4.823327344830974
STAT,1844,30,15-19,1874,0.13756270308008856
STAT,1884,18,na,1902,2508.900497706281
SIM,1883,30,50-100,1913,1
STAT,1859,54,20-24,1913,5.829540149490596E-4
SIM,1852,38,25-29,1890,2
SIM,1879,16,na,1895,2939
SIM,1893,19,30-34,1912,3
STAT,1809,76,na,1885,450.77515312210465
STAT,1937,15,25-29,1952,42.75808104574438
STAT,1869,43,25-29,1912,0.626016442776696
SIM,1843,88,na,1931,174
STAT,1857,52,45-49,1909,0.011378430665561157
STAT,1871,15,35-39,1886,0.5607298831715894
SIM,1888,52,na,1940,2751
STAT,1849,35,20-24,1884,0.6296531436478129
STAT,1830,31,25-29,1861,9.99218689755232
SIM,1910,45,50-100,1955,2
STAT,1839,28,15-19,1867,0.40231338609948153
STAT,1853,36,25-29,1889,2.405881246896269
STAT,1862,16,50-100,1878,0.049230625874789685
SIM,1841,38,50-100,1879,3
STAT,1840,46,40-44,1886,0.12258003001607129
SIM,1850,26,na,1876,2125
STAT,1881,34,35-39,1915,9.774949730501083
STAT,1879,28,45-49,1907,1.1661399814139686
STAT,1829,54,35-39,1883,0.005428118689204987
STAT,1821,33,25-29,1854,35.29498737510287
SIM,1835,26,30-34,1861,27
SIM,1945,15,25-29,1960,59
STAT,1864,47,40-44,1911,0.1553020667528344
STAT,1844,38,25-29,1882,2.3823273339053337
STAT,1932,29,50-100,1961,1.3161889949535552
SIM,1886,29,40-44,1915,6
SIM,1827,27,35-39,1854,8
SIM,1863,41,30-34,1904,1
STAT,1823,46,40-44,1869,0.23902051598933793
STAT,1930,28,na,1958,4812.168239945807
SIM,1776,84,na,1860,55
STAT,1867,104,na,1971,0.7385218119030292
STAT,1854,40,25-29,1894,0.4867930749937804
SIM,1874,46,50-100,1920,3
STAT,1855,27,45-49,1882,0.8711282237720289
STAT,1841,45,45-49,1886,0.18188563832816929
STAT,1891,41,40-44,1932,2.825397050011314
SIM,1877,23,30-34,1900,23
STAT,1891,36,45-49,1927,2.5048096874364147
SIM,1836,38,40-44,1874,6
STAT,1818,40,15-19,1858,0.029011264008953565
STAT,1777,81,na,1858,146.16021236063546
SIM,1846,32,40-44,1878,6
STAT,1801,80,na,1881,280.7284835906913
STAT,1892,69,na,1961,2023.0271366486404
SIM,1864,40,35-39,1904,3
SIM,1913,27,50-100,1940,2
SIM,1836,42,25-29,1878,3
STAT,1881,51,25-29,1932,0.0034648805903640563
STAT,1885,31,15-19,1916,0.1437528811017373
SIM,1883,40,45-49,1923,2
STAT,1853,41,20-24,1894,0.13192890833280568
STAT,1860,91,na,1951,47.84325647424756
STAT,1890,37,40-44,1927,5.402542498177951
SIM,1861,16,30-34,1877,1
SIM,1884,29,30-34,1913,42
SIM,1893,39,25-29,1932,8
STAT,1845,25,35-39,1870,8.706089135684017
STAT,1819,52,25-29,1871,0.006631793464936026
STAT,1848,18,15-19,1866,5.971106185248531
STAT,1890,24,35-39,1914,7.156835640742256
STAT,1851,36,15-19,1887,0.04342344789150469
STAT,1918,15,15-19,1933,10.051840593303039
SIM,1817,38,30-34,1855,7
SIM,1827,27,50-100,1854,2
STAT,1856,54,na,1910,1621.4477685179702
STAT,1892,40,45-49,1932,1.915950117679923
STAT,1895,29,40-44,1924,3.922800254759987
STAT,1797,58,na,1855,1028.42911
STAT,1834,36,15-19,1870,0.042032443901245234
STAT,1875,40,45-49,1915,1.5680050483841237
SIM,1851,75,na,1926,892
STAT,1880,36,na,1916,2511.037584218581
STAT,1929,31,na,1960,4858.47592806185
STAT,1885,39,25-29,1924,2.8654330256513556
SIM,1916,33,na,1949,3866
SIM,1862,15,35-39,1877,1
STAT,1881,47,40-44,1928,0.16589736146000866
STAT,1947,1,na,1948,4682.275486644854
STAT,1828,38,40-44,1866,4.40915767230145
STAT,1838,27,45-49,1865,0.9454696345263478
STAT,1851,23,na,1874,1919.4775726860416
STAT,1840,33,35-39,1873,8.5571516496996
SIM,1901,7,na,1908,3801
STAT,1844,26,30-34,1870,24.56613816926789
STAT,1939,31,35-39,1970,9.418392375536337
SIM,1882,41,40-44,1923,5
STAT,1805,94,na,1899,7.933993956138254
STAT,1854,4,na,1858,2392.903318196154
STAT,1829,42,40-44,1871,1.7467733183231506
SIM,1908,14,na,1922,3767
STAT,1874,41,40-44,1915,2.336703066484671
STAT,1942,29,na,1971,3965.8483551024
STAT,1871,2,na,1873,3323.6224409371603
STAT,1937,20,20-24,1957,109.39071402770115
SIM,1855,89,na,1944,82
SIM,1873,0,na,1873,3479
STAT,1891,26,50-100,1917,0.8026665001252712
STAT,1824,45,45-49,1869,0.28387213994414834
STAT,1835,40,15-19,1875,0.012746632741480624
SIM,1856,2,na,1858,3063
STAT,1807,50,40-44,1857,0.03721272866862518
SIM,1883,17,20-24,1900,1
STAT,1818,53,20-24,1871,0.0012371550769114763
STAT,1946,17,50-100,1963,0.4197016124516769
STAT,1868,87,na,1955,170.06570249853812
SIM,1829,41,na,1870,1764
SIM,1842,39,na,1881,1781
STAT,1954,15,25-29,1969,54.15287652298222
SIM,1831,48,50-100,1879,5
STAT,1864,73,na,1937,1082.5025398283435
STAT,1886,43,25-29,1929,0.6798449825840797
STAT,1940,3,na,1943,4140.594972807425
SIM,1868,33,30-34,1901,27
SIM,1942,1,na,1943,4531
STAT,1854,45,30-34,1899,0.0733713597687391
STAT,1840,30,30-34,1870,15.219892356473084
SIM,1827,44,25-29,1871,4
STAT,1813,47,35-39,1860,0.40742444698863134
SIM,1830,25,40-44,1855,5
STAT,1888,43,35-39,1931,2.1430983498764204
STAT,1909,20,45-49,1929,1.0615590634954404
SIM,1871,20,na,1891,2240
SIM,1943,15,15-19,1958,47
STAT,1896,33,40-44,1929,5.773381314029562
SIM,1875,18,25-29,1893,6
STAT,1886,35,25-29,1921,3.099515255219498
STAT,1849,27,20-24,1876,10.872864504606383
SIM,1905,49,na,1954,3348
STAT,1825,41,45-49,1866,2.1959664171538558
STAT,1834,109,na,1943,4.234811359056385E-4
STAT,1834,75,na,1909,612.7651791461778
SIM,1894,35,25-29,1929,8
SIM,1901,35,na,1936,3449
SIM,1945,23,25-29,1968,114
STAT,1830,44,30-34,1874,0.9710845303894133
STAT,1870,28,25-29,1898,41.8063735856506
STAT,1882,46,45-49,1928,0.23154556539081575
STAT,1869,51,25-29,1920,0.003494751058307898
SIM,1893,27,30-34,1920,43
STAT,1876,41,15-19,1917,0.014466646637089318
STAT,1937,23,25-29,1960,90.7782140076122
SIM,1810,93,na,1903,25
STAT,1867,43,15-19,1910,0.013041319613141018
STAT,1868,55,na,1923,1995.945032847747
SIM,1792,79,na,1871,198
SIM,1857,27,20-24,1884,10
STAT,1873,15,45-49,1888,0.0676792515558344
STAT,1864,17,45-49,1881,0.06158669916752898
SIM,1880,20,25-29,1900,73
STAT,1864,41,na,1905,2115.9653927401223
SIM,1871,35,30-34,1906,9
STAT,1873,48,45-49,1921,0.23860641000960905
SIM,1844,73,na,1917,846
SIM,1848,87,na,1935,127
SIM,1867,90,na,1957,87
SIM,1870,22,30-34,1892,24
STAT,1833,58,na,1891,1399.1418314346677
STAT,1910,27,50-100,1937,0.9697220753217615
SIM,1870,34,25-29,1904,21
SIM,1771,85,na,1856,53
STAT,1892,32,45-49,1924,2.210083954215127
SIM,1873,30,35-39,1903,14
STAT,1928,30,20-24,1958,3.0862201644370693
SIM,1886,29,na,1915,2651
STAT,1819,44,25-29,1863,1.2910587714571296
STAT,1893,25,15-19,1918,0.585794396426815
SIM,1882,36,45-49,1918,5
STAT,1844,51,20-24,1895,5.866235639466654E-4
STAT,1862,47,30-34,1909,0.08403730410370239
SIM,1868,28,35-39,1896,7
STAT,1793,76,na,1869,364.7550683863593
SIM,1859,35,30-34,1894,1
SIM,1880,24,na,1904,2270
SIM,1884,38,na,1922,2365
STAT,1863,24,na,1887,2127.749779136018
SIM,1922,29,na,1951,4675
STAT,1841,50,40-44,1891,0.007985863832986996
SIM,1891,19,20-24,1910,22
STAT,1935,15,15-19,1950,62.97412954613249
STAT,1909,0,na,1909,4443.583411717438
STAT,1873,40,35-39,1913,1.872818192799321
STAT,1853,16,30-34,1869,1.5949740347073773
STAT,1878,29,40-44,1907,3.1182660011971324
STAT,1861,35,20-24,1896,0.6531023844580586
SIM,1841,40,40-44,1881,3
STAT,1836,41,20-24,1877,0.12072092488548833
SIM,1867,37,30-34,1904,7
STAT,1835,53,20-24,1888,5.535764032795535E-4
STAT,1917,30,na,1947,4029.7244078395474
STAT,1838,89,na,1927,70.32560904451095
STAT,1883,19,20-24,1902,17.42840334655221
STAT,1943,20,45-49,1963,1.2095762330413797
SIM,1846,21,na,1867,1907
SIM,1817,40,na,1857,1664
STAT,1826,34,15-19,1860,0.178658957204704
SIM,1935,9,na,1944,5431
STAT,1876,49,25-29,1925,0.05881358410174253
SIM,1833,41,45-49,1874,5
SIM,1819,38,40-44,1857,11
STAT,1910,51,na,1961,3414.133392080122
SIM,1935,29,50-100,1964,4
STAT,1867,18,25-29,1885,5.478063453723982
STAT,1919,32,20-24,1951,2.6570408130878587
SIM,1928,20,20-24,1948,167
SIM,1881,40,35-39,1921,2
SIM,1919,22,20-24,1941,115
SIM,1927,32,20-24,1959,2
SIM,1868,49,50-100,1917,1
STAT,1894,45,25-29,1939,0.042670660976327476
STAT,1852,24,15-19,1876,2.929675784886028
SIM,1814,75,na,1889,389
STAT,1821,46,30-34,1867,0.14394672663516142
SIM,1810,61,na,1871,1087
SIM,1867,38,50-100,1905,2
STAT,1804,54,30-34,1858,0.01548213556243553
STAT,1815,40,na,1855,1416.2298734413482
STAT,1814,40,30-34,1854,4.2923271027245695
STAT,1923,38,30-34,1961,2.131574117828801
STAT,1878,65,na,1943,1771.8492634009926
SIM,1835,69,na,1904,787
SIM,1863,32,40-44,1895,3
STAT,1875,17,20-24,1892,18.388342781475497
STAT,1812,64,na,1876,947.0514130297332
STAT,1885,27,30-34,1912,25.316313798779646
SIM,1849,28,25-29,1877,59
SIM,1863,44,35-39,1907,2
SIM,1919,33,25-29,1952,4
STAT,1840,16,45-49,1856,0.0596371939244105
STAT,1877,42,20-24,1919,0.16534658806934074
STAT,1872,27,45-49,1899,1.1274249806377266
SIM,1861,10,na,1871,2495
SIM,1873,38,45-49,1911,3
STAT,1833,40,40-44,1873,1.9855997406893426
SIM,1843,56,na,1899,1860
SIM,1850,58,na,1908,1623
STAT,1945,22,20-24,1967,123.07410744848296
SIM,1924,33,50-100,1957,1
STAT,1877,50,20-24,1927,7.802784530304102E-4
STAT,1890,45,40-44,1935,0.21339478770026418
STAT,1818,36,30-34,1854,17.31245178660346
SIM,1824,45,50-100,1869,2
STAT,1832,31,35-39,1863,9.111220163405136
STAT,1800,63,na,1863,768.5790105862692
STAT,1871,45,30-34,1916,0.09809982248474526
STAT,1816,45,50-100,1861,0.6543463573611991
STAT,1920,22,50-100,1942,0.7387016068361982
STAT,1823,54,40-44,1877,0.013403084052205015
STAT,1804,77,na,1881,325.33761448676756
STAT,1827,54,25-29,1881,0.0030677970179257023
SIM,1860,24,15-19,1884,3
STAT,1871,75,na,1946,1032.9871695521365
SIM,1890,35,40-44,1925,8
SIM,1918,21,15-19,1939,5
STAT,1845,17,35-39,1862,0.5067457190556026
STAT,1847,25,45-49,1872,1.0137149779726362
STAT,1881,31,30-34,1912,17.06764305681595
SIM,1876,51,na,1927,2488
SIM,1938,33,35-39,1971,13
STAT,1817,95,na,1912,6.083005720735032
STAT,1875,89,na,1964,243.60730092093374
STAT,1895,41,25-29,1936,0.05908226957208912
SIM,1838,34,na,1872,1829
STAT,1870,20,15-19,1890,3.291455459635235
STAT,1934,10,na,1944,5431.651263341651
STAT,1840,49,45-49,1889,0.16260570831320662
SIM,1826,36,30-34,1862,10
STAT,1893,33,15-19,1926,0.18185881119085268
STAT,1854,48,35-39,1902,0.10374793439840656
SIM,1836,22,30-34,1858,1
STAT,1836,32,30-34,1868,13.922293986422565
STAT,1860,34,15-19,1894,0.11656892253447136
SIM,1844,32,30-34,1876,18
STAT,1871,41,15-19,1912,0.01391981751190787
SIM,1865,35,na,1900,2158
SIM,1873,86,na,1959,252
STAT,1769,111,na,1880,0.0010065650014644718
STAT,1819,54,na,1873,1219.7102647460852
STAT,1849,52,na,1901,1674.4984667612014
STAT,1938,24,na,1962,3646.1670910068424
STAT,1870,33,20-24,1903,2.669548643302315
SIM,1869,49,na,1918,2125
STAT,1820,37,25-29,1857,7.055836722261821
SIM,1878,38,45-49,1916,4
STAT,1866,42,45-49,1908,1.3979833751924842
SIM,1822,40,30-34,1862,1
SIM,1855,25,45-49,1880,1
STAT,1835,45,20-24,1880,0.010707417255691873
STAT,1846,76,na,1922,718.9703117175364
STAT,1880,27,30-34,1907,26.710705394726805
STAT,1880,18,40-44,1898,0.19349889506573023
STAT,1865,90,na,1955,72.71118619786003
STAT,1842,62,na,1904,1645.569838467379
STAT,1826,42,15-19,1868,0.014408261190170598
STAT,1832,47,45-49,1879,0.1905580084104974
SIM,1856,74,na,1930,952
SIM,1850,18,20-24,1868,17
STAT,1773,99,na,1872,0.3614882241544276
STAT,1828,50,25-29,1878,0.003241988597311665
SIM,1925,30,45-49,1955,1
SIM,1852,60,na,1912,1361
STAT,1924,20,35-39,1944,11.294393751483648
STAT,1872,53,25-29,1925,0.003538886051963723
STAT,1913,16,na,1929,3994.110917744774
STAT,1827,29,35-39,1856,15.95216289022758
STAT,1863,43,30-34,1906,1.021394325720699
STAT,1882,35,40-44,1917,4.3233927275958735
STAT,1891,20,35-39,1911,7.340679454558101
STAT,1813,101,na,1914,0.2501949842522412
SIM,1822,94,na,1916,7
STAT,1840,41,35-39,1881,1.341199031505986
SIM,1899,9,na,1908,3938
SIM,1930,16,na,1946,5108
SIM,1898,28,20-24,1926,19
STAT,1815,44,40-44,1859,5.262829666479347
SIM,1797,78,na,1875,307
SIM,1837,34,40-44,1871,8
STAT,1867,35,15-19,1902,0.05392274327877968
STAT,1799,92,na,1891,13.976368290379982
STAT,1839,74,na,1913,786.8099910603238
SIM,1835,29,35-39,1864,8
SIM,1899,68,na,1967,2579
SIM,1871,43,30-34,1914,4
STAT,1830,40,15-19,1870,0.012342650956584277
STAT,1819,86,na,1905,112.7936245863769
SIM,1823,44,40-44,1867,7
STAT,1849,38,25-29,1887,2.279684523759732
SIM,1877,33,50-100,1910,1
STAT,1890,15,50-100,1905,0.06074478151983853
SIM,1857,38,25-29,1895,3
STAT,1831,27,35-39,1858,8.404777026106391
STAT,1887,47,35-39,1934,0.15713443282912462
STAT,1836,24,30-34,1860,14.617561056197513
SIM,1845,36,40-44,1881,1
SIM,1891,40,na,1931,3009
STAT,1851,28,15-19,1879,0.39934724429863105
STAT,1818,69,na,1887,816.3377622990274
STAT,1918,23,15-19,1941,5.778238462952978
STAT,1834,44,15-19,1878,0.009664026699004267
SIM,1879,91,na,1970,136
SIM,1895,54,na,1949,2863
SIM,1840,31,35-39,1871,9
STAT,1869,40,20-24,1909,0.15752137455597526
STAT,1814,55,na,1869,1255.3339332264927
SIM,1839,19,na,1858,2018
STAT,1884,18,50-100,1902,0.048667821713917495
STAT,1876,38,20-24,1914,0.7998871051333327
STAT,1884,48,20-24,1932,0.011801763938709913
SIM,1820,35,25-29,1855,1
STAT,1856,24,50-100,1880,0.3614909963404122
STAT,1829,34,40-44,1863,3.6745697415522343
STAT,1946,11,na,1957,4401.099322222603
STAT,1848,54,45-49,1902,0.011522949322929119
SIM,1926,23,15-19,1949,5
STAT,1896,25,40-44,1921,4.032002990886814
SIM,1926,43,na,1969,4570
STAT,1833,51,45-49,1884,0.010833091227131242
SIM,1884,38,20-24,1922,1
STAT,1868,27,30-34,1895,24.307857980491587
STAT,1888,32,na,1920,2844.7492807978856
STAT,1838,57,na,1895,1345.3002009035067
SIM,1858,22,na,1880,1948
SIM,1873,35,50-100,1908,1
STAT,1875,45,15-19,1920,4.190228871901186E-4
STAT,1880,30,25-29,1910,10.951767824950817
SIM,1858,39,30-34,1897,5
STAT,1851,31,45-49,1882,1.388645365106468
STAT,1872,28,35-39,1900,9.763235486738067
SIM,1863,24,40-44,1887,2
SIM,1886,37,40-44,1923,9
STAT,1846,46,35-39,1892,0.1065455299043571
STAT,1962,7,na,1969,5085.853179071498
SIM,1964,5,na,1969,5249
STAT,1872,19,45-49,1891,0.06597412256483307
SIM,1821,77,na,1898,438
STAT,1896,42,30-34,1938,0.10660212639221212
SIM,1872,37,na,1909,2538
STAT,1775,102,na,1877,0.061108544537645526
STAT,1857,37,20-24,1894,0.6076172646654237
STAT,1874,44,45-49,1918,1.5269171704823292
STAT,1863,88,na,1951,122.85368018383537
STAT,1891,28,45-49,1919,1.3835226366664815
STAT,1888,26,45-49,1914,1.328147587024608
STAT,1834,43,na,1877,1489.4363380712782
SIM,1830,42,30-34,1872,7
SIM,1851,43,na,1894,1835
STAT,1882,47,50-100,1929,0.23916195418497735
STAT,1914,25,50-100,1939,1.0192580202948307
STAT,1807,53,45-49,1860,0.048265591761157696
STAT,1931,18,50-100,1949,0.4943110239074333
STAT,1862,22,30-34,1884,15.904270637991953
SIM,1951,20,45-49,1971,2
SIM,1951,6,na,1957,4991
SIM,1882,44,45-49,1926,5
STAT,1851,87,na,1938,133.40193889829862
SIM,1888,41,35-39,1929,1
STAT,1917,30,45-49,1947,1.676621801345995
SIM,1829,35,45-49,1864,1
SIM,1896,26,45-49,1922,2
SIM,1818,48,50-100,1866,4
STAT,1829,51,30-34,1880,0.004376971450677288
STAT,1791,103,na,1894,0.025519078403331067
SIM,1880,88,na,1968,315
STAT,1852,32,15-19,1884,0.1118219666338302
STAT,1901,15,na,1916,3592.512372942045
STAT,1905,29,na,1934,3459.6497066700917
STAT,1869,33,50-100,1902,0.8959183017005834
STAT,1877,15,50-100,1892,0.051307556746644487
STAT,1878,37,40-44,1915,4.589613713685641
SIM,1814,41,35-39,1855,4
SIM,1949,16,20-24,1965,160
STAT,1841,42,40-44,1883,1.74785129941551
STAT,1855,24,40-44,1879,1.8062087844355401
SIM,1880,28,35-39,1908,14
STAT,1822,42,na,1864,1541.4517511914448
STAT,1826,56,na,1882,1198.5836730821502
STAT,1859,16,25-29,1875,5.375108888389782
STAT,1856,45,40-44,1901,0.13388972618340617
STAT,1845,34,25-29,1879,8.715764127030631
STAT,1848,51,40-44,1899,0.008636514035231338
SIM,1793,64,na,1857,830
SIM,1878,27,40-44,1905,5
STAT,1897,68,na,1965,2321.981904405413
STAT,1863,34,40-44,1897,3.8476566463279998
SIM,1906,30,35-39,1936,10
STAT,1842,18,20-24,1860,20.376082076160788
STAT,1893,54,na,1947,2685.450904469732
STAT,1895,30,20-24,1925,3.593893351644618
SIM,1867,16,25-29,1883,7
SIM,1881,32,35-39,1913,2
STAT,1868,47,25-29,1915,0.05534154022074375
STAT,1873,32,35-39,1905,10.369199798196805
STAT,1880,38,35-39,1918,7.4651105306368
STAT,1814,51,35-39,1865,0.020229510020426687
SIM,1930,3,na,1933,5614
STAT,1881,42,35-39,1923,1.760775270657143
STAT,1853,44,25-29,1897,0.5238806342881925
STAT,1850,110,na,1960,5.012775343052466E-4
SIM,1898,39,25-29,1937,2
STAT,1831,52,25-29,1883,0.0023276015539584866
STAT,1889,17,na,1906,3145.375209434727
STAT,1900,45,25-29,1945,0.046039979224375555
STAT,1842,19,na,1861,2622.7007680479364
SIM,1853,34,25-29,1887,13
SIM,1891,31,40-44,1922,9
SIM,1894,32,20-24,1926,7
STAT,1877,16,na,1893,2639.2168053797323
STAT,1924,32,na,1956,4458.8026316288415
STAT,1835,37,20-24,1872,0.715549400690258
STAT,1830,47,35-39,1877,0.11709958557889262
SIM,1850,26,20-24,1876,3
SIM,1837,71,na,1908,806
STAT,1809,46,30-34,1855,0.3616398475227192
SIM,1848,9,na,1857,2264
STAT,1896,17,40-44,1913,0.24452697650157323
SIM,1861,28,25-29,1889,50
STAT,1833,48,15-19,1881,2.9891959844463464E-4
STAT,1847,106,na,1953,0.00909093279012748
STAT,1899,18,20-24,1917,24.510051727168737
STAT,1916,13,na,1929,4221.950917812745
STAT,1901,49,35-39,1950,0.10947804915462353
SIM,1852,34,30-34,1886,24
STAT,1919,35,25-29,1954,1.0739656638400972
STAT,1853,28,25-29,1881,36.61333948970524
SIM,1866,73,na,1939,1228
STAT,1839,53,40-44,1892,0.007343978284749343
SIM,1858,18,25-29,1876,6
STAT,1863,51,30-34,1914,0.005352362706874688
STAT,1846,30,25-29,1876,9.378455532386878
STAT,1896,36,45-49,1932,2.67796208061904
STAT,1893,49,25-29,1942,0.04079806091521103
STAT,1844,22,15-19,1866,3.2589245094869588
SIM,1879,43,35-39,1922,5
STAT,1814,52,25-29,1866,0.008157707732135349
SIM,1923,46,na,1969,4395
SIM,1857,3,na,1860,2853
SIM,1835,37,35-39,1872,8
STAT,1883,50,45-49,1933,0.014549778365464778
SIM,1858,54,na,1912,1685
STAT,1895,38,30-34,1933,6.994651488481479
STAT,1952,15,15-19,1967,54.97773932644697
STAT,1869,72,na,1941,1240.1103736589089
SIM,1824,40,40-44,1864,4
STAT,1850,27,45-49,1877,1.0004853881908304
SIM,1852,22,15-19,1874,2
SIM,1895,38,45-49,1933,3
STAT,1869,47,40-44,1916,0.16732754979932413
SIM,1874,17,na,1891,2451
SIM,1963,4,na,1967,5084
STAT,1829,45,45-49,1874,0.18071671920889482
SIM,1854,38,35-39,1892,10
SIM,1865,7,na,1872,2580
STAT,1907,49,50-100,1956,0.2022757956596478
STAT,1946,17,40-44,1963,1.566886400847179
STAT,1842,26,20-24,1868,13.15624247073461
STAT,1922,20,na,1942,4255.863103819693
STAT,1864,34,35-39,1898,9.150657262971762
SIM,1847,40,35-39,1887,1
STAT,1841,77,na,1918,646.4050182397866
STAT,1883,31,40-44,1914,4.303802749311773
STAT,1836,35,35-39,1871,5.591672421140423
STAT,1875,32,45-49,1907,1.8087228710100463
STAT,1893,41,15-19,1934,0.0177904331878374
SIM,1845,32,25-29,1877,11
STAT,1894,71,na,1965,2012.2106187499028
SIM,1927,15,30-34,1942,25
STAT,1887,38,45-49,1925,2.2367973874301015
STAT,1851,24,20-24,1875,61.42113968325419
STAT,1859,51,na,1910,1757.4634701437687
SIM,1831,30,30-34,1861,9
STAT,1827,41,na,1868,1613.9346172608912
STAT,1890,21,30-34,1911,22.049591378611687
SIM,1882,33,40-44,1915,3
SIM,1854,30,25-29,1884,18
SIM,1919,16,35-39,1935,6
STAT,1870,40,50-100,1910,1.0583490042644552
STAT,1910,27,40-44,1937,4.541033306193611
SIM,1798,63,na,1861,883
STAT,1827,37,35-39,1864,8.227269979882154
STAT,1816,89,na,1905,53.711033189365565
STAT,1844,34,30-34,1878,16.179538917000553
STAT,1834,27,25-29,1861,33.034765556865395
SIM,1877,36,na,1913,2471
STAT,1849,39,15-19,1888,0.04400264584320755
SIM,1842,27,25-29,1869,9
SIM,1843,36,30-34,1879,8
STAT,1870,41,20-24,1911,0.15822158817149704
STAT,1894,28,35-39,1922,12.5026780242955
SIM,1941,26,50-100,1967,1
STAT,1847,17,45-49,1864,0.0610437212700613
STAT,1839,40,35-39,1879,1.5255014876309176
STAT,1880,26,40-44,1906,3.1883301634294745
STAT,1837,32,25-29,1869,8.761056853569425
STAT,1844,10,na,1854,2431.0
SIM,1895,39,35-39,1934,20
STAT,1821,42,15-19,1863,0.02201867662829454
STAT,1841,88,na,1929,102.66266538453891
SIM,1954,17,40-44,1971,2
SIM,1844,35,35-39,1879,16
STAT,1809,47,20-24,1856,0.042927605977835646
SIM,1821,35,40-44,1856,1
SIM,1863,35,45-49,1898,1
STAT,1874,52,45-49,1926,0.014928689141615912
SIM,1838,42,35-39,1880,4
STAT,1899,16,na,1915,3509.471836652861
SIM,1861,27,35-39,1888,13
STAT,1857,40,50-100,1897,0.8411448796250901
SIM,1815,42,40-44,1857,2
STAT,1853,27,35-39,1880,9.24382185217165
STAT,1812,52,50-100,1864,0.03333970947845776
STAT,1855,52,35-39,1907,0.006445720766883337
STAT,1847,22,40-44,1869,1.912683526386274
STAT,1835,28,50-100,1863,0.6214880239497684
SIM,1883,32,45-49,1915,1
STAT,1884,50,na,1934,2175.3622636790583
SIM,1884,37,30-34,1921,6
STAT,1885,23,15-19,1908,3.3063849147976696
SIM,1927,35,25-29,1962,4
STAT,1826,40,50-100,1866,1.1470475490991743
STAT,1939,20,30-34,1959,29.159620584380693
SIM,1794,81,na,1875,233
STAT,1888,64,na,1952,2072.3173712953617
STAT,1860,59,na,1919,1604.5756145633088
STAT,1871,51,50-100,1922,0.015226972818073375
STAT,1870,36,25-29,1906,2.8692978444746733
STAT,1853,42,50-100,1895,0.8725852972911156
STAT,1862,39,na,1901,2034.2491525464825
SIM,1819,74,na,1893,506
SIM,1843,37,20-24,1880,1
STAT,1853,20,15-19,1873,3.270294247721553
STAT,1887,39,35-39,1926,7.895478844314122
SIM,1862,37,30-34,1899,8
STAT,1783,77,na,1860,342.5879956503724
STAT,1937,31,25-29,1968,9.236846912360196
STAT,1886,32,20-24,1918,2.882522922473448
STAT,1870,24,30-34,1894,17.555420665834653
STAT,1825,34,20-24,1859,5.170381207167861
SIM,1850,30,40-44,1880,13
STAT,1926,42,50-100,1968,0.14637283620413302
STAT,1898,38,20-24,1936,0.2266803305466877
STAT,1781,86,na,1867,39.65159844599689
STAT,1844,21,na,1865,2127.413742480413
STAT,1853,33,20-24,1886,2.278184859498368
SIM,1815,60,na,1875,1068
SIM,1816,41,45-49,1857,5
SIM,1893,23,15-19,1916,4
SIM,1898,8,na,1906,3542
STAT,1870,69,na,1939,1455.492275255482
SIM,1859,27,30-34,1886,40
SIM,1895,31,25-29,1926,23
STAT,1890,40,35-39,1930,2.25738573181254
STAT,1890,48,45-49,1938,0.1622316140772789
STAT,1831,26,45-49,1857,0.9900842634690776
SIM,1896,28,na,1924,3149
STAT,1920,41,35-39,1961,0.22490768231640976
STAT,1834,54,50-100,1888,0.00886425746577782
STAT,1876,37,30-34,1913,5.557912576800435
STAT,1799,81,na,1880,213.28362836859336
STAT,1829,26,40-44,1855,4.966801476057669
SIM,1894,16,na,1910,3676
STAT,1855,53,25-29,1908,0.00262333908019194
STAT,1841,21,35-39,1862,5.568116836190067
STAT,1906,38,30-34,1944,1.683879243460381
SIM,1882,20,35-39,1902,7
STAT,1855,35,45-49,1890,1.514789795616923
STAT,1885,29,50-100,1914,0.638510485363119
STAT,1838,44,35-39,1882,1.2574221232607783
SIM,1847,70,na,1917,984
SIM,1892,19,15-19,1911,10
STAT,1862,53,50-100,1915,0.01296141931141604
STAT,1876,41,50-100,1917,1.106698386866976
STAT,1909,43,na,1952,3484.345037372912
STAT,1819,41,20-24,1860,0.35257799833494047
STAT,1848,35,na,1883,2023.8607973260064
SIM,1927,28,na,1955,4990
SIM,1914,38,30-34,1952,5
SIM,1815,81,na,1896,213
STAT,1887,31,25-29,1918,11.597231998087715
STAT,1903,19,50-100,1922,0.07009264882211713
STAT,1822,50,30-34,1872,0.008845678082878327
STAT,1892,25,20-24,1917,14.969067946463046
STAT,1855,41,30-34,1896,0.8692948782813643
SIM,1923,14,na,1937,4721
SIM,1928,27,40-44,1955,9
STAT,1821,45,50-100,1866,0.3705495712423727
STAT,1863,18,40-44,1881,0.16896151176099275
STAT,1866,19,20-24,1885,16.81844575582157
STAT,1882,51,40-44,1933,0.010348980419792455
STAT,1846,37,45-49,1883,1.5798162724591338
STAT,1875,28,25-29,1903,43.721330699674745
STAT,1911,43,35-39,1954,0.19273600085236414
STAT,1906,14,na,1920,3786.8389044517658
STAT,1911,38,50-100,1949,0.40709656824673457
STAT,1845,31,20-24,1876,2.3728994704796933
STAT,1920,49,45-49,1969,0.2411893076015922
SIM,1947,20,30-34,1967,45
SIM,1880,24,40-44,1904,2
STAT,1879,71,na,1950,1406.879610973739
SIM,1904,32,na,1936,3582
STAT,1846,18,40-44,1864,0.17333680171751886
STAT,1863,46,35-39,1909,0.12564027376465883
STAT,1832,51,50-100,1883,0.010943424179285444
STAT,1862,31,20-24,1893,2.3672976180425427
SIM,1864,18,na,1882,2784
SIM,1908,46,na,1954,3211
STAT,1875,7,na,1882,2800.966470103928
STAT,1894,21,15-19,1915,4.3027890170892835
SIM,1862,91,na,1953,48
STAT,1861,26,30-34,1887,21.442170443331467
STAT,1845,50,25-29,1895,0.002625291461824882
STAT,1887,44,30-34,1931,1.2789195052984106
STAT,1941,20,35-39,1961,9.830738431753177
STAT,1795,100,na,1895,0.2458028581031551
STAT,1919,40,20-24,1959,0.01937706447083543
SIM,1939,20,45-49,1959,2
SIM,1905,17,na,1922,3806
SIM,1846,44,35-39,1890,4
STAT,1898,53,na,1951,2900.8800943031256
STAT,1831,78,na,1909,490.9898679873611
STAT,1892,42,50-100,1934,1.33727669920958
SIM,1885,21,15-19,1906,4
SIM,1841,22,na,1863,1858
STAT,1892,5,na,1897,3321.342715596853
SIM,1876,38,35-39,1914,15
SIM,1855,22,40-44,1877,2
STAT,1884,1,na,1885,3310.8359785879466
SIM,1864,32,35-39,1896,14
STAT,1811,44,20-24,1855,0.41766015548735724
SIM,1845,36,na,1881,2019
STAT,1880,68,na,1948,1620.9751794187302
SIM,1872,31,30-34,1903,41
STAT,1865,30,35-39,1895,9.414821632820974
STAT,1867,3,na,1870,3019.168691411403
SIM,1885,17,30-34,1902,3
SIM,1874,19,20-24,1893,23
STAT,1830,93,na,1923,19.281155958970274
STAT,1838,20,50-100,1858,0.3593121488562507
SIM,1853,31,20-24,1884,3
STAT,1828,49,45-49,1877,0.20939989463209852
SIM,1780,78,na,1858,343
SIM,1860,16,15-19,1876,8
SIM,1933,38,40-44,1971,1
STAT,1855,50,50-100,1905,0.011531519503838619
STAT,1827,43,20-24,1870,0.16792878078276519
STAT,1872,20,25-29,1892,58.4752167860087
STAT,1867,30,50-100,1897,0.8785585232723618
STAT,1873,41,25-29,1914,0.6604858121546587
STAT,1842,33,45-49,1875,1.8770353562133262
STAT,1899,27,na,1926,3308.0836233828063
STAT,1897,33,35-39,1930,13.654775504455392
STAT,1901,29,40-44,1930,4.21097812966618
STAT,1868,39,25-29,1907,2.751290712927607
STAT,1771,97,na,1868,0.7326908061182018
STAT,1855,16,40-44,1871,0.16472081913140985
SIM,1861,21,na,1882,2171
STAT,1894,34,20-24,1928,3.4847898607053636
SIM,1876,39,25-29,1915,1
STAT,1900,37,25-29,1937,0.8719004622683342
STAT,1886,20,na,1906,2537.1193912759277
STAT,1807,96,na,1903,3.0416529488281054
STAT,1947,16,45-49,1963,0.5685589540165722
SIM,1839,18,15-19,1857,5
STAT,1936,27,50-100,1963,0.9616831808177524
SIM,1881,73,na,1954,1004
STAT,1766,97,na,1863,0.44319243102564754
STAT,1871,21,20-24,1892,69.3572299094885
STAT,1806,50,25-29,1856,0.010638762883479088
STAT,1888,18,45-49,1906,0.07766769731385764
STAT,1835,36,30-34,1871,4.998880693876164
STAT,1892,37,15-19,1929,0.0711691229048415
STAT,1895,34,na,1929,3120.509607522016
STAT,1945,25,25-29,1970,72.98950529502565
STAT,1852,40,15-19,1892,0.010578942569205831
STAT,1936,15,30-34,1951,11.83591175757138
SIM,1896,23,40-44,1919,4
STAT,1899,48,na,1947,3080.007939207092
SIM,1829,27,45-49,1856,1
SIM,1939,21,35-39,1960,11
STAT,1827,38,25-29,1865,3.271420766662533
SIM,1829,32,40-44,1861,8
STAT,1924,20,50-100,1944,0.7892659031039134
STAT,1941,12,na,1953,4096.627015266609
SIM,1844,20,15-19,1864,2
STAT,1852,36,30-34,1888,4.106258121603589
SIM,1940,29,50-100,1969,1
SIM,1830,29,35-39,1859,16
STAT,1837,47,45-49,1884,0.1671301592508616
STAT,1955,15,40-44,1970,1.8768596820759398
SIM,1844,16,30-34,1860,1
SIM,1865,41,40-44,1906,7
STAT,1816,40,40-44,1856,6.9629168936974155
STAT,1945,26,na,1971,4152.4429126605
STAT,1842,46,15-19,1888,3.6483815788318963E-4
STAT,1894,29,25-29,1923,54.6128952243521
SIM,1899,16,20-24,1915,24
STAT,1909,25,15-19,1934,0.6912500415408844
SIM,1818,38,25-29,1856,6
STAT,1802,97,na,1899,1.8769716519144057
STAT,1968,4,na,1972,4959.984166244227
STAT,1868,38,35-39,1906,6.793562502591763
SIM,1914,6,na,1920,4381
STAT,1774,103,na,1877,0.033988749484864106
STAT,1856,32,35-39,1888,7.93786610838088
STAT,1900,42,20-24,1942,0.015453782166607453
STAT,1817,48,30-34,1865,0.2048662188533191
SIM,1860,36,30-34,1896,6
STAT,1879,45,35-39,1924,0.14903108505299495
SIM,1779,81,na,1860,182
STAT,1846,38,35-39,1884,5.547310569798653
STAT,1919,15,30-34,1934,2.7412294888718045
STAT,1837,28,40-44,1865,2.604150054153466
STAT,1888,21,50-100,1909,0.48759938436989525
STAT,1970,0,na,1970,5007.185650479887
SIM,1849,18,na,1867,2309
SIM,1891,27,20-24,1918,1
STAT,1901,48,50-100,1949,0.19368661840362061
STAT,1915,36,50-100,1951,0.43003893904916074
SIM,1828,28,40-44,1856,4
SIM,1854,37,45-49,1891,2
STAT,1864,50,35-39,1914,0.007958939127072203
SIM,1826,44,na,1870,1873
STAT,1874,49,15-19,1923,4.05038260062943E-4
STAT,1836,48,40-44,1884,0.1115860776898413
STAT,1827,30,15-19,1857,0.20954461436136373
SIM,1835,38,25-29,1873,2
SIM,1885,29,25-29,1914,48
STAT,1866,21,na,1887,2246.0573347474724
SIM,1845,28,40-44,1873,4
STAT,1898,45,45-49,1943,0.1840912684613638
SIM,1875,30,45-49,1905,2
STAT,1826,88,na,1914,75.33030422222767
STAT,1862,25,35-39,1887,8.569634749692161
STAT,1888,23,40-44,1911,2.4764568879763478
STAT,1861,27,20-24,1888,9.917506927094355
SIM,1912,51,na,1963,3341
STAT,1846,43,30-34,1889,0.8717870407752093
STAT,1847,42,35-39,1889,1.363385054895913
STAT,1877,29,25-29,1906,43.78082525125168
SIM,1886,33,25-29,1919,19
SIM,1870,25,35-39,1895,10
SIM,1932,28,na,1960,5615
STAT,1926,25,15-19,1951,0.8611004082391499
STAT,1893,17,15-19,1910,7.6107140651178575
SIM,1854,43,30-34,1897,2
STAT,1878,33,25-29,1911,10.693589197718136
STAT,1883,27,20-24,1910,11.595030165489465
STAT,1887,19,40-44,1906,0.2051438166265767
SIM,1944,15,30-34,1959,19
SIM,1886,38,30-34,1924,14
STAT,1893,20,45-49,1913,0.8996098567828399
STAT,1936,12,na,1948,3829.762497818702
SIM,1835,34,30-34,1869,34
STAT,1847,38,15-19,1885,0.043172926462729404
STAT,1821,37,40-44,1858,8.62810021626549
STAT,1860,109,na,1969,0.007565819536098742
STAT,1896,21,25-29,1917,76.7639313192999
STAT,1880,51,30-34,1931,0.006344141496487819
STAT,1850,48,15-19,1898,3.024367834191158E-4
STAT,1928,16,35-39,1944,5.357288827461843
SIM,1880,38,50-100,1918,4
SIM,1908,22,45-49,1930,1
STAT,1849,73,na,1922,928.6478528597023
STAT,1922,20,25-29,1942,107.64879049582764
SIM,1879,40,30-34,1919,1
SIM,1841,27,45-49,1868,1
STAT,1829,29,45-49,1858,1.109397542009563
SIM,1886,72,na,1958,1633
STAT,1776,96,na,1872,1.3068984074096544
STAT,1772,82,na,1854,112.99999999999999
SIM,1949,20,40-44,1969,4
STAT,1861,22,15-19,1883,2.8445014276023897
SIM,1891,34,45-49,1925,1
STAT,1844,18,30-34,1862,1.5935619001193626
STAT,1865,43,40-44,1908,2.05942308340928
STAT,1794,101,na,1895,0.11096867992554724
STAT,1834,24,20-24,1858,54.105688169574144
SIM,1933,13,na,1946,5064
SIM,1898,36,20-24,1934,1
STAT,1772,104,na,1876,0.023708373225902683
SIM,1852,37,35-39,1889,13
STAT,1825,43,50-100,1868,1.4805278411901575
SIM,1853,25,35-39,1878,13
STAT,1833,27,45-49,1860,1.0391409523640762
SIM,1923,30,35-39,1953,11
STAT,1863,27,50-100,1890,0.572454172823553
STAT,1878,30,20-24,1908,2.8568152142754184
STAT,1902,32,na,1934,3405.886444060346
STAT,1879,50,na,1929,2302.051149450185
SIM,1897,31,35-39,1928,16
STAT,1889,48,20-24,1937,0.008324148649116292
SIM,1860,36,na,1896,2088
SIM,1858,15,20-24,1873,13
STAT,1823,33,35-39,1856,23.456433347053064
SIM,1837,30,25-29,1867,17
STAT,1820,50,20-24,1870,0.0012534956523891265
STAT,1868,44,20-24,1912,0.15123149755718582
STAT,1894,25,30-34,1919,32.96706710627814
STAT,1905,16,40-44,1921,0.2677120281708682
SIM,1852,18,30-34,1870,2
STAT,1828,42,25-29,1870,0.6131663449121474
STAT,1906,46,na,1952,3319.7627019088313
STAT,1844,37,35-39,1881,5.913416330218491
STAT,1883,34,45-49,1917,1.708787572109493
STAT,1934,2,na,1936,5589.6188945523045
SIM,1833,78,na,1911,421
STAT,1857,17,na,1874,2126.6326291469427
STAT,1895,33,25-29,1928,13.452609371042369
STAT,1895,42,15-19,1937,0.0012633060664687247
STAT,1878,86,na,1964,438.5346285456114
STAT,1857,41,40-44,1898,1.7810012369995687
STAT,1922,38,15-19,1960,0.02205219447246865
SIM,1930,20,25-29,1950,124
SIM,1939,17,15-19,1956,48
SIM,1831,33,35-39,1864,10
STAT,1876,8,na,1884,2786.6044513682473
STAT,1816,43,45-49,1859,4.141187096656899
STAT,1810,103,na,1913,0.0745359836644497
STAT,1829,30,25-29,1859,9.619970686101297
SIM,1837,38,35-39,1875,5
STAT,1851,20,50-100,1871,0.37408891687231893
STAT,1885,47,25-29,1932,0.05763748494254613
STAT,1904,16,50-100,1920,0.07118415142376726
STAT,1874,72,na,1946,1306.0727667999222
STAT,1831,23,40-44,1854,4.903307364507138
SIM,1937,27,na,1964,3484
STAT,1836,77,na,1913,545.0199826253701
STAT,1864,31,30-34,1895,15.977591313061035
SIM,1871,8,na,1879,2621
STAT,1833,110,na,1943,1.9550802457612068E-4
STAT,1915,30,35-39,1945,9.46682989085964
SIM,1824,43,45-49,1867,2
STAT,1858,49,30-34,1907,0.07510152073630415
STAT,1825,46,15-19,1871,5.445957865828807E-4
STAT,1917,15,20-24,1932,29.585479561599197
SIM,1801,57,na,1858,899
STAT,1893,46,20-24,1939,0.008705492393093395
STAT,1872,38,50-100,1910,1.2404921342229427
STAT,1897,32,50-100,1929,1.2406503547463745
SIM,1846,35,45-49,1881,3
STAT,1896,29,35-39,1925,12.807659315335663
SIM,1852,92,na,1944,8
STAT,1866,50,45-49,1916,0.013767524587577585
STAT,1877,49,40-44,1926,0.17473670339829617
SIM,1836,22,na,1858,2261
STAT,1844,46,25-29,1890,0.04570159744768011
STAT,1829,38,35-39,1867,5.700179543508559
STAT,1835,32,15-19,1867,0.1361299418587431
SIM,1830,26,30-34,1856,30
SIM,1827,35,35-39,1862,15
STAT,1852,16,15-19,1868,5.4756966954874615
STAT,1925,38,40-44,1963,1.813953344566294
STAT,1938,15,40-44,1953,1.3993775138255697
SIM,1869,16,35-39,1885,1
STAT,1886,26,35-39,1912,10.324860770363998
STAT,1858,45,15-19,1903,3.201142654436714E-4
STAT,1854,36,40-44,1890,3.3010691610247376
STAT,1875,29,15-19,1904,0.4672248259150561
SIM,1857,42,45-49,1899,1
SIM,1868,32,na,1900,2186
STAT,1831,32,30-34,1863,14.451921601252804
STAT,1885,19,30-34,1904,1.5937838616500153
SIM,1850,33,45-49,1883,2
STAT,1812,51,25-29,1863,0.007977140943017168
SIM,1842,24,20-24,1866,3
SIM,1897,13,na,1910,3580
SIM,1806,56,na,1862,1211
STAT,1902,45,50-100,1947,0.1997022641940917
STAT,1838,41,30-34,1879,0.9116551409117362
STAT,1859,83,na,1942,322.4866591898699
STAT,1948,20,45-49,1968,1.305973444401912
STAT,1931,13,na,1944,5233.326845167695
STAT,1935,27,na,1962,5159.267382739473
STAT,1874,28,45-49,1902,1.1442220439908006
SIM,1861,24,30-34,1885,23
STAT,1822,45,35-39,1867,0.2134803262911427
SIM,1878,39,35-39,1917,19
SIM,1869,17,na,1886,2441
SIM,1873,54,na,1927,1995
STAT,1838,16,40-44,1854,0.1626879483847908
STAT,1928,25,25-29,1953,82.51865462185064
SIM,1838,33,50-100,1871,6
STAT,1915,50,na,1965,3701.786376865399
SIM,1833,89,na,1922,50
SIM,1837,29,45-49,1866,3
SIM,1877,68,na,1945,1636
SIM,1862,32,25-29,1894,17
STAT,1804,56,na,1860,992.7033163589124
SIM,1946,15,40-44,1961,1
SIM,1862,36,40-44,1898,4
STAT,1819,35,35-39,1854,25.022310277916485
SIM,1835,37,na,1872,1638
STAT,1903,41,35-39,1944,0.18169403059709505
SIM,1936,16,35-39,1952,3
STAT,1888,39,15-19,1927,0.06626876249718638
SIM,1831,23,na,1854,1892
STAT,1850,92,na,1942,31.89153158031982
SIM,1828,44,40-44,1872,5
STAT,1853,24,30-34,1877,17.155485400703014
SIM,1860,25,na,1885,2242
SIM,1882,28,45-49,1910,3
SIM,1848,29,20-24,1877,14
STAT,1843,33,50-100,1876,0.7352539069877061
SIM,1857,91,na,1948,44
SIM,1901,27,40-44,1928,11
SIM,1936,25,25-29,1961,7
STAT,1849,42,45-49,1891,1.168711804811424
STAT,1864,22,40-44,1886,1.9296966607319808
STAT,1885,28,20-24,1913,11.752555426137228
STAT,1887,35,40-44,1922,4.983153692914321
STAT,1840,17,35-39,1857,0.49800191142634265
STAT,1931,31,30-34,1962,20.876367485647116
SIM,1893,28,20-24,1921,19
SIM,1895,35,40-44,1930,1
STAT,1861,51,20-24,1912,6.222842847714692E-4
STAT,1808,59,na,1867,1026.2016654424524
STAT,1818,37,20-24,1855,1.9474123032041235
STAT,1860,47,20-24,1907,0.009861329702129582
STAT,1854,32,25-29,1886,7.871887491419209
STAT,1854,53,50-100,1907,0.01115242444561578
SIM,1873,43,40-44,1916,7
STAT,1832,40,25-29,1872,0.5505601893979188
SIM,1851,33,50-100,1884,1
SIM,1863,104,na,1967,3
SIM,1872,22,40-44,1894,2
SIM,1848,55,na,1903,1581
STAT,1921,35,na,1956,4250.069313231778
SIM,1818,89,na,1907,65
STAT,1859,38,50-100,1897,0.9923923226167576
STAT,1852,45,20-24,1897,0.009191433819222798
STAT,1837,37,30-34,1874,4.4267909493982165
STAT,1903,49,45-49,1952,0.1874887302676417
STAT,1842,30,40-44,1872,4.815707141716138
STAT,1860,21,45-49,1881,0.597784595719306
SIM,1805,82,na,1887,130
SIM,1909,23,15-19,1932,10
STAT,1875,25,20-24,1900,12.250618579820548
SIM,1870,38,40-44,1908,11
STAT,1922,44,50-100,1966,0.1357694868235206
STAT,1848,105,na,1953,0.023939109553529434
STAT,1909,16,25-29,1925,8.59657075073385
STAT,1866,47,15-19,1913,3.723486745235863E-4
STAT,1871,40,25-29,1911,0.6508576969843696
STAT,1860,38,30-34,1898,4.378415762354212
STAT,1825,37,25-29,1862,4.7542593224625325
STAT,1920,50,na,1970,4064.0245726768017
SIM,1861,40,45-49,1901,4
STAT,1855,44,35-39,1899,1.344638832100249
SIM,1856,30,35-39,1886,15
STAT,1791,96,na,1887,1.4678433173485372
STAT,1869,18,35-39,1887,0.5430532431600592
STAT,1884,35,15-19,1919,0.056460833685870127
STAT,1847,31,50-100,1878,0.813890564823892
SIM,1854,34,40-44,1888,10
STAT,1834,28,15-19,1862,0.3517679082837217
STAT,1932,28,30-34,1960,51.83905895799036
STAT,1892,28,25-29,1920,53.42322640191113
STAT,1916,42,45-49,1958,0.17211686146395438
STAT,1846,34,40-44,1880,3.809286014035157
SIM,1940,28,30-34,1968,3
STAT,1919,29,50-100,1948,1.0781139231310275
SIM,1917,16,25-29,1933,12
SIM,1904,30,25-29,1934,29
STAT,1924,6,na,1930,4823.096516067549
SIM,1774,82,na,1856,153
STAT,1822,74,na,1896,620.5089721516988
SIM,1849,40,45-49,1889,2
SIM,1878,31,25-29,1909,7
SIM,1845,37,30-34,1882,8
STAT,1872,17,na,1889,2572.988991556909
STAT,1889,39,45-49,1928,2.457689730699558
SIM,1868,36,35-39,1904,8
STAT,1850,32,40-44,1882,3.473768011567566
STAT,1890,15,45-49,1905,0.08099304202645138
STAT,1852,40,na,1892,1770.512265435208
STAT,1944,17,30-34,1961,13.245626796716845
STAT,1862,34,25-29,1896,8.857319757690632
STAT,1908,40,45-49,1948,0.15719778753344363
STAT,1832,27,15-19,1859,0.41671860995566756
SIM,1876,35,30-34,1911,7
SIM,1952,17,30-34,1969,25
STAT,1838,35,45-49,1873,1.644060766292625
SIM,1837,92,na,1929,48
STAT,1897,30,30-34,1927,23.831517610990087
STAT,1838,47,50-100,1885,0.16914544633214437
STAT,1859,29,30-34,1888,20.51149841783093
STAT,1870,27,35-39,1897,9.569693780151596
SIM,1867,29,30-34,1896,33
STAT,1842,36,50-100,1878,1.3102281641467386
STAT,1828,46,40-44,1874,0.1580597462965078
SIM,1846,41,30-34,1887,1
STAT,1870,58,na,1928,1961.3579299304452
STAT,1811,47,25-29,1858,0.14347905839324465
STAT,1907,22,50-100,1929,0.6048460977779175
STAT,1791,85,na,1876,80.3261914090229
SIM,1883,25,20-24,1908,12
SIM,1817,42,50-100,1859,3
SIM,1877,27,25-29,1904,50
STAT,1848,47,20-24,1895,0.009751825289670746
STAT,1875,44,50-100,1919,1.0809795284522254
STAT,1901,47,na,1948,3171.19254861119
STAT,1939,23,35-39,1962,9.54323928334931
SIM,1853,55,na,1908,1552
SIM,1857,69,na,1926,1261
STAT,1895,37,40-44,1932,5.77376588090432
SIM,1885,26,20-24,1911,11
STAT,1871,48,35-39,1919,0.13871426098305759
STAT,1880,31,15-19,1911,0.1516706139476272
STAT,1882,22,35-39,1904,5.709127725367781
SIM,1947,7,na,1954,4851
STAT,1821,89,na,1910,62.92621164374842
SIM,1899,19,25-29,1918,22
STAT,1868,35,30-34,1903,5.19345161111734
SIM,1840,59,na,1899,1357
SIM,1825,59,na,1884,989
STAT,1885,35,na,1920,2391.047159551207
STAT,1851,55,na,1906,1565.647472738405
SIM,1855,25,na,1880,2187
SIM,1821,45,na,1866,1353
STAT,1881,21,na,1902,2309.4811655590993
STAT,1857,44,45-49,1901,1.1637941544348762
SIM,1832,42,40-44,1874,5
STAT,1855,69,na,1924,1104.650495526381
STAT,1837,40,na,1877,1736.3387545799287
SIM,1851,11,na,1862,2413
STAT,1898,42,40-44,1940,0.21359934456306426
STAT,1766,113,na,1879,2.3374132731132554E-4
STAT,1855,19,45-49,1874,0.05779545456425728
STAT,1900,18,50-100,1918,0.06855606356051064
STAT,1911,48,40-44,1959,0.15016620353154733
SIM,1854,40,na,1894,2191
SIM,1872,69,na,1941,1546
STAT,1877,17,30-34,1894,1.6614866761154796
STAT,1877,26,20-24,1903,12.271105571946334
STAT,1806,54,40-44,1860,0.029183816921305637
STAT,1872,52,35-39,1924,0.008695281326387815
SIM,1880,33,30-34,1913,35
STAT,1840,42,25-29,1882,0.46956597974496717
STAT,1881,22,50-100,1903,0.39701065587121803
STAT,1936,18,35-39,1954,4.045187935318025
SIM,1846,47,50-100,1893,1
STAT,1940,27,na,1967,3856.5491633614993
SIM,1823,31,35-39,1854,2
SIM,1850,36,50-100,1886,1
STAT,1890,57,na,1947,2480.2078595044177
STAT,1888,48,50-100,1936,0.16307862218177666
SIM,1886,30,20-24,1916,8
STAT,1847,51,25-29,1898,0.0026647251883482326
SIM,1900,29,na,1929,3375
STAT,1836,19,35-39,1855,0.6120594786158661
SIM,1866,17,20-24,1883,20
STAT,1889,49,na,1938,2743.9463738250774
STAT,1867,27,15-19,1894,0.43157180273899765
STAT,1891,33,40-44,1924,5.400084470689279
STAT,1858,17,20-24,1875,16.409755776062486
SIM,1883,21,na,1904,2635
STAT,1905,41,30-34,1946,0.11709471966708082
STAT,1831,51,35-39,1882,0.005770531842374594
STAT,1889,31,35-39,1920,12.663730588807073
STAT,1872,33,30-34,1905,17.65414550107029
STAT,1896,35,50-100,1931,1.6569838611462018
STAT,1881,43,25-29,1924,0.6206657314458204
SIM,1928,26,50-100,1954,2
STAT,1824,42,40-44,1866,2.794951397867671
STAT,1878,38,30-34,1916,5.560105666937458
STAT,1934,30,45-49,1964,2.1733237294655887
SIM,1896,27,35-39,1923,18
STAT,1862,43,15-19,1905,0.011958201825713518
STAT,1851,27,25-29,1878,37.5028194749547
STAT,1860,18,15-19,1878,5.617666670652342
STAT,1817,44,15-19,1861,0.031003084080056253
STAT,1862,38,40-44,1900,3.799208821192651
SIM,1887,35,na,1922,2625
SIM,1880,27,45-49,1907,1
STAT,1852,48,25-29,1900,0.04313449263051904
SIM,1887,36,45-49,1923,6
SIM,1905,1,na,1906,3992
SIM,1860,39,35-39,1899,15
STAT,1823,59,na,1882,1160.9634373619606
STAT,1827,34,30-34,1861,21.63756797172128
SIM,1891,72,na,1963,1719
SIM,1907,4,na,1911,4124
STAT,1852,39,35-39,1891,5.310059939258977
SIM,1887,42,30-34,1929,2
STAT,1803,82,na,1885,211.5460526922785
STAT,1883,0,na,1883,3500.827582349703
STAT,1846,34,50-100,1880,0.8048119749193496
STAT,1911,40,30-34,1951,0.12450031303237412
STAT,1879,42,50-100,1921,1.1121292012750432
SIM,1790,67,na,1857,899
SIM,1865,44,45-49,1909,2
SIM,1820,60,na,1880,1072
SIM,1813,42,30-34,1855,3
SIM,1824,74,na,1898,589
STAT,1835,92,na,1927,31.259875513775718
STAT,1853,52,25-29,1905,0.0029135680998705446
SIM,1913,5,na,1918,4135
SIM,1829,36,35-39,1865,18
STAT,1868,31,15-19,1899,0.13802659604716877
SIM,1903,47,na,1950,2993
STAT,1879,42,30-34,1921,1.2102582511021616
STAT,1834,31,45-49,1865,1.3441657143271464
STAT,1879,36,45-49,1915,2.1112475104784063
STAT,1923,41,50-100,1964,0.1389364769827676
STAT,1918,5,na,1923,4418.2647918250395
STAT,1913,43,45-49,1956,0.1634960891791658
SIM,1845,58,na,1903,1594
STAT,1888,27,35-39,1915,11.50260031333315
STAT,1820,40,na,1860,1419.486577814764
STAT,1883,18,45-49,1901,0.06439373657937719
STAT,1903,17,na,1920,3632.8653509179917
STAT,1886,19,25-29,1905,6.010552394506399
STAT,1841,38,20-24,1879,0.6721579292595916
STAT,1911,35,35-39,1946,2.379323202673556
STAT,1882,9,na,1891,2538.4529745433983
STAT,1892,23,50-100,1915,0.5152280878923853
STAT,1858,88,na,1946,108.78167501213439
SIM,1830,41,40-44,1871,4
STAT,1858,51,50-100,1909,0.012024474652235408
STAT,1914,36,15-19,1950,0.019438024344828695
STAT,1788,76,na,1864,343.41241647998106
STAT,1916,44,25-29,1960,0.07360373498905151
SIM,1827,28,25-29,1855,38
STAT,1796,95,na,1891,2.7854334307476827
SIM,1940,30,35-39,1970,12
STAT,1861,37,35-39,1898,5.93616236005443
STAT,1873,28,15-19,1901,0.462915154903118
STAT,1859,53,30-34,1912,0.004757829098973765
STAT,1859,38,20-24,1897,0.6230820823341507
STAT,1931,9,na,1940,5266.05786024489
SIM,1921,18,40-44,1939,1
SIM,1944,18,35-39,1962,7
SIM,1880,35,45-49,1915,2
STAT,1887,40,15-19,1927,0.015729731529553106
STAT,1845,54,40-44,1899,0.007480870459561507
STAT,1857,45,20-24,1902,0.009553233814577282
SIM,1832,93,na,1925,31
SIM,1928,13,na,1941,5110
STAT,1828,26,25-29,1854,109.94248044817459
SIM,1924,19,20-24,1943,169
STAT,1872,35,45-49,1907,2.0434523771031112
SIM,1879,70,na,1949,1690
SIM,1894,19,25-29,1913,11
STAT,1798,96,na,1894,2.8570148323102846
SIM,1844,25,20-24,1869,10
STAT,1845,38,na,1883,1790.0585842509347
STAT,1770,106,na,1876,0.006667421482381359
STAT,1804,52,50-100,1856,0.04089985002824122
SIM,1910,49,na,1959,3178
SIM,1871,37,45-49,1908,5
STAT,1862,18,na,1880,2279.5363864725314
STAT,1901,31,45-49,1932,2.4790935344889182
STAT,1834,48,30-34,1882,0.06035970600612596
STAT,1836,25,20-24,1861,9.715274920734934
STAT,1843,25,na,1868,1821.6948831323496
SIM,1870,57,na,1927,2206
STAT,1818,40,50-100,1858,2.2193615345083666
SIM,1876,28,20-24,1904,16
STAT,1826,49,35-39,1875,0.13425245546480116
STAT,1933,26,50-100,1959,1.3361192201106638
SIM,1851,47,50-100,1898,3
STAT,1853,18,50-100,1871,0.048450007780062795
STAT,1920,33,35-39,1953,10.065442705599354
STAT,1866,38,25-29,1904,2.6793630956106425
STAT,1922,41,45-49,1963,0.1932604991468872
SIM,1828,88,na,1916,52
STAT,1881,74,na,1955,1080.4518200850066
STAT,1848,56,na,1904,1665.276422693387
STAT,1850,60,na,1910,1460.3538244708564
STAT,1904,45,45-49,1949,0.19487557517286877
STAT,1843,46,30-34,1889,0.0658220182265528
SIM,1869,38,30-34,1907,4
STAT,1894,49,40-44,1943,0.12295285607737096
STAT,1938,31,40-44,1969,3.9746862216197227
SIM,1839,40,na,1879,1633
SIM,1891,35,20-24,1926,4
STAT,1935,31,15-19,1966,0.17972667385927102
STAT,1864,24,50-100,1888,0.3722281478594822
SIM,1853,18,25-29,1871,8
STAT,1863,27,30-34,1890,22.535024401362943
SIM,1868,21,na,1889,2334
SIM,1829,35,50-100,1864,2
SIM,1855,26,35-39,1881,10
STAT,1883,35,20-24,1918,0.7691206568023098
STAT,1865,36,na,1901,2183.271958529196
STAT,1900,34,20-24,1934,3.7599523681434666
STAT,1879,17,40-44,1896,0.19277979106575707
SIM,1843,28,50-100,1871,5
STAT,1850,36,20-24,1886,0.6058550562363474
STAT,1921,42,40-44,1963,0.28453202417084517
SIM,1836,26,25-29,1862,5
STAT,1803,60,na,1863,1209.9241576900176
STAT,1940,26,15-19,1966,0.7270845419387955
STAT,1883,87,na,1970,434.9647068049356
STAT,1838,48,15-19,1886,2.719740790229121E-4
STAT,1894,18,20-24,1912,22.992637442716784
SIM,1893,29,50-100,1922,2
STAT,1929,20,35-39,1949,12.106928580122572
STAT,1871,54,na,1925,2101.1271457379867
STAT,1923,34,15-19,1957,0.14865646109394764
STAT,1895,48,45-49,1943,0.17337898933314005
SIM,1802,63,na,1865,993
STAT,1913,30,25-29,1943,9.352759057218197
STAT,1827,27,20-24,1854,34.97635428325882
STAT,1879,29,35-39,1908,10.097282198375026
SIM,1871,27,30-34,1898,40
STAT,1873,55,na,1928,2117.151707104603
STAT,1909,41,15-19,1950,0.0014578036162050721
STAT,1875,36,na,1911,2455.422189433733
STAT,1924,43,20-24,1967,0.02119361919033661
STAT,1907,46,25-29,1953,0.04832867378551156
STAT,1923,47,na,1970,4342.346460415134
STAT,1812,43,na,1855,1444.3524659892987
STAT,1822,41,40-44,1863,3.6677237263609355
SIM,1804,76,na,1880,421
SIM,1815,47,50-100,1862,2
SIM,1862,38,na,1900,2114
SIM,1835,27,20-24,1862,15
STAT,1895,17,25-29,1912,7.474207274829658
STAT,1932,30,35-39,1962,12.290553863808858
STAT,1917,18,25-29,1935,9.388274657401542
SIM,1787,79,na,1866,251
STAT,1845,18,25-29,1863,5.202531705437473
STAT,1847,26,35-39,1873,8.746290647502382
STAT,1934,37,50-100,1971,0.5854292094364251
SIM,1807,94,na,1901,15
STAT,1920,49,50-100,1969,0.25100039766807447
STAT,1870,32,30-34,1902,17.316342429660637
SIM,1862,44,40-44,1906,3
SIM,1856,38,45-49,1894,6
STAT,1843,109,na,1952,4.7985669502682463E-4
STAT,1777,101,na,1878,0.10084289475249925
STAT,1916,19,20-24,1935,28.87237138700001
SIM,1887,29,35-39,1916,14
SIM,1936,32,na,1968,3795
STAT,1860,42,15-19,1902,0.011387724637037662
SIM,1921,30,25-29,1951,17
STAT,1939,19,15-19,1958,45.829903905774685
SIM,1947,19,15-19,1966,51
STAT,1862,15,20-24,1877,17.920477678671908
SIM,1833,37,25-29,1870,2
STAT,1911,24,50-100,1935,0.6256404865555738
STAT,1839,105,na,1944,0.02078756030755436
STAT,1905,19,45-49,1924,0.09486567921793164
STAT,1871,36,40-44,1907,4.413633599364857
SIM,1777,79,na,1856,213
SIM,1910,17,na,1927,3665
STAT,1815,48,20-24,1863,0.026185014069761432
STAT,1881,18,35-39,1899,0.5328046525808613
SIM,1870,15,20-24,1885,22
STAT,1848,38,45-49,1886,1.659946615800544
STAT,1880,54,35-39,1934,0.0088806031898299
STAT,1920,46,40-44,1966,0.17643358687040922
STAT,1882,39,20-24,1921,0.7465678669865987
STAT,1894,36,35-39,1930,9.241436417507737
STAT,1895,9,na,1904,3422.226022190886
STAT,1902,42,30-34,1944,0.11380547833307508
STAT,1837,19,na,1856,2059.563020834023
STAT,1845,49,45-49,1894,0.16884145099760162
SIM,1937,20,35-39,1957,16
STAT,1926,18,50-100,1944,0.4630284618101959
STAT,1920,20,15-19,1940,6.011752099342861
STAT,1861,54,25-29,1915,0.0028909925749846096
SIM,1869,70,na,1939,1300
SIM,1900,32,20-24,1932,3
STAT,1854,29,50-100,1883,0.49607974882762035
STAT,1851,40,35-39,1891,1.3849612479895346
STAT,1868,17,50-100,1885,0.048147664050305516
SIM,1852,42,30-34,1894,1
STAT,1855,28,35-39,1883,7.516058065542684
STAT,1929,42,na,1971,4861.332108457652
SIM,1920,31,35-39,1951,21
STAT,1835,38,na,1873,1966.7597944649403
STAT,1900,52,na,1952,3004.9187390226975
SIM,1916,12,na,1928,4218
STAT,1824,46,20-24,1870,0.014236252084576715
SIM,1907,61,na,1968,3181
STAT,1937,24,50-100,1961,0.6464343290494622
SIM,1850,34,20-24,1884,1
SIM,1846,28,35-39,1874,11
STAT,1896,21,50-100,1917,0.5468296006408264
STAT,1838,28,35-39,1866,8.157472664055382
STAT,1844,45,35-39,1889,0.11251255755278397
STAT,1851,47,50-100,1898,0.1850983419104087
STAT,1923,47,20-24,1970,0.013062203257055103
STAT,1842,22,50-100,1864,0.46308163327219265
STAT,1848,88,na,1936,112.08634704906375
STAT,1885,15,50-100,1900,0.04948222228796949
STAT,1828,36,na,1864,1821.4790270119483
STAT,1878,53,40-44,1931,0.010860541209827596
SIM,1864,6,na,1870,2953
STAT,1903,46,40-44,1949,0.13930347821710448
STAT,1786,95,na,1881,2.6878245430653087
STAT,1842,34,20-24,1876,2.8794937654215382
SIM,1936,0,na,1936,4076
SIM,1820,92,na,1912,13
STAT,1818,91,na,1909,29.855108318169734
STAT,1883,55,na,1938,2043.6688157929052
STAT,1859,48,35-39,1907,0.11229799730356357
STAT,1840,60,na,1900,1336.9094093963406
SIM,1948,8,na,1956,5010
STAT,1832,41,na,1873,1763.3473163882636
STAT,1891,74,na,1965,1694.296380286809
STAT,1939,30,45-49,1969,1.6226851682095955
STAT,1870,17,20-24,1887,17.75044427268485
STAT,1912,44,40-44,1956,0.2414997009187174
STAT,1874,37,20-24,1911,0.7972038963794762
STAT,1825,93,na,1918,21.32749155159579
SIM,1810,82,na,1892,324
STAT,1915,48,25-29,1963,0.05378579628607779
SIM,1863,87,na,1950,83
STAT,1838,68,na,1906,1023.0159004519742
STAT,1928,41,25-29,1969,0.09214621768333596
STAT,1852,18,na,1870,2093.0846841724606
SIM,1924,31,na,1955,4487
SIM,1908,32,50-100,1940,1
SIM,1902,18,30-34,1920,3
STAT,1903,49,na,1952,3169.2205357076177
STAT,1873,16,35-39,1889,0.5651573191292294
SIM,1920,44,40-44,1964,2
SIM,1882,37,20-24,1919,4
STAT,1844,50,45-49,1894,0.011646993744002168
STAT,1778,76,na,1854,385.0
STAT,1891,49,15-19,1940,2.762582357862585E-4
STAT,1915,28,na,1943,3842.0150436137305
SIM,1856,42,na,1898,2112
STAT,1885,43,30-34,1928,1.1474555696808661
SIM,1882,36,na,1918,2093
STAT,1820,62,na,1882,962.4192391284847
STAT,1818,47,35-39,1865,0.24927305600452224
SIM,1821,43,40-44,1864,4
SIM,1884,17,15-19,1901,7
SIM,1911,33,35-39,1944,2
STAT,1835,47,35-39,1882,0.11080134298289705
STAT,1844,27,20-24,1871,11.362415297908512
STAT,1875,49,30-34,1924,0.09830632198686619
SIM,1861,35,35-39,1896,9
STAT,1825,50,35-39,1875,0.011591743851126548
STAT,1830,38,45-49,1868,1.78679150835455
STAT,1940,32,35-39,1972,9.548203300323603
STAT,1880,34,40-44,1914,4.560617344346598
SIM,1852,27,20-24,1879,3
SIM,1944,3,na,1947,4383
SIM,1795,66,na,1861,784
SIM,1811,46,na,1857,1570
STAT,1870,44,25-29,1914,0.6282870601814694
STAT,1856,49,20-24,1905,0.009098142336587125
STAT,1828,58,na,1886,1329.9984494342852
STAT,1911,46,na,1957,3517.5894146796886
SIM,1869,92,na,1961,70
SIM,1850,90,na,1940,67
STAT,1833,36,20-24,1869,0.6914981978459392
STAT,1922,30,50-100,1952,0.951318748390486
STAT,1813,43,40-44,1856,7.578767630103434
STAT,1876,85,na,1961,442.54353019482244
STAT,1903,33,35-39,1936,8.329020523729154
SIM,1832,32,50-100,1864,4
STAT,1876,48,35-39,1924,0.14416354204717122
STAT,1898,46,20-24,1944,0.009294487680153495
SIM,1843,16,15-19,1859,9
STAT,1818,52,30-34,1870,0.010180683436864632
STAT,1853,35,35-39,1888,5.971881886877659
STAT,1892,41,35-39,1933,2.305371974166792
SIM,1896,50,na,1946,2874
STAT,1820,53,25-29,1873,0.005667133217363252
SIM,1919,30,na,1949,3989
STAT,1833,80,na,1913,437.6542521748247
STAT,1913,18,40-44,1931,0.2877867493726166
SIM,1856,20,na,1876,2192
SIM,1820,82,na,1902,239
STAT,1833,90,na,1923,55.77936683704736
STAT,1938,7,na,1945,3980.7236794263613
SIM,1862,16,25-29,1878,8
STAT,1885,38,35-39,1923,7.0754058323553535
SIM,1937,24,50-100,1961,3
STAT,1940,29,50-100,1969,1.0236685240907473
STAT,1798,109,na,1907,2.3672204124185867E-4
STAT,1854,16,25-29,1870,5.117509816219454
STAT,1883,33,na,1916,2348.608308210478
STAT,1891,52,na,1943,2678.229133894168
SIM,1896,21,50-100,1917,1
SIM,1855,68,na,1923,1360
STAT,1830,43,40-44,1873,1.9268964715769719
STAT,1868,66,na,1934,1582.1215333654134
STAT,1778,98,na,1876,0.6265182709572239
STAT,1891,42,na,1933,2886.596660573942
STAT,1828,68,na,1896,992.0403828622597
STAT,1837,52,40-44,1889,0.0072082033538071145
STAT,1929,10,na,1939,5126.475168342025
SIM,1893,38,35-39,1931,14
SIM,1863,28,35-39,1891,8
STAT,1853,17,20-24,1870,17.63632429054111
STAT,1882,33,50-100,1915,0.8926237713176366
STAT,1903,27,na,1930,3432.8066766251163
SIM,1795,76,na,1871,308
SIM,1861,17,20-24,1878,20
SIM,1882,58,na,1940,1694
STAT,1891,37,20-24,1928,0.9639297219208206
SIM,1870,35,na,1905,2623
SIM,1882,33,50-100,1915,1
STAT,1832,63,na,1895,1214.9759158644501
STAT,1933,36,25-29,1969,1.3564407045303637
STAT,1861,46,25-29,1907,0.0484797877693656
SIM,1914,31,na,1945,4067
SIM,1920,7,na,1927,4865
STAT,1793,65,na,1858,776.1601815961313
STAT,1863,35,na,1898,2128.3630197336793
STAT,1857,28,45-49,1885,0.8949869976187467
STAT,1883,44,50-100,1927,1.0300724705301572
SIM,1830,44,45-49,1874,6
STAT,1813,92,na,1905,18.26155557513469
STAT,1807,54,20-24,1861,0.0024048426302443475
STAT,1863,54,35-39,1917,0.007492299683749533
STAT,1924,47,50-100,1971,0.2720999927501576
SIM,1876,40,na,1916,2692
SIM,1880,32,40-44,1912,3
STAT,1897,0,na,1897,3975.972279382853
SIM,1880,17,30-34,1897,1
SIM,1931,20,40-44,1951,6
SIM,1940,24,15-19,1964,7
STAT,1846,20,50-100,1866,0.3873810867520748
STAT,1826,46,30-34,1872,0.09669379589178256
STAT,1912,40,50-100,1952,0.11560939879743119
SIM,1875,88,na,1963,156
STAT,1931,34,na,1965,5002.047084382916
STAT,1861,76,na,1937,795.1370503846548
SIM,1909,27,30-34,1936,54
SIM,1873,75,na,1948,946
STAT,1913,40,40-44,1953,0.24889413280686262
SIM,1813,41,40-44,1854,6
SIM,1891,38,25-29,1929,8
STAT,1872,17,30-34,1889,1.623772006957471
SIM,1879,27,35-39,1906,20
STAT,1840,82,na,1922,327.0685243957781
STAT,1874,45,20-24,1919,0.012534000698941226
STAT,1931,36,15-19,1967,0.025726568587947866
STAT,1803,53,25-29,1856,0.015045903237643373
STAT,1932,24,15-19,1956,7.034098080495239
SIM,1846,33,50-100,1879,2
STAT,1821,79,na,1900,418.75840279374626
STAT,1820,49,40-44,1869,0.28246268003310426
STAT,1901,46,30-34,1947,0.0775299326576337
SIM,1819,45,50-100,1864,6
STAT,1898,2,na,1900,3649.844961010424
STAT,1915,22,50-100,1937,0.686320814242193
SIM,1812,63,na,1875,866
STAT,1843,49,35-39,1892,0.09245395860677838
SIM,1865,28,45-49,1893,1
STAT,1920,30,30-34,1950,17.56709768114712
STAT,1843,18,15-19,1861,5.0850002484265815
STAT,1881,40,20-24,1921,0.15617500192724149
STAT,1885,46,35-39,1931,0.14114688938159337
STAT,1908,58,na,1966,3181.5933948379866
SIM,1916,17,20-24,1933,24
STAT,1883,23,na,1906,2330.323228178573
STAT,1802,65,na,1867,810.3076531532988
STAT,1925,28,na,1953,4455.863556051895
STAT,1927,29,50-100,1956,1.2181344654303778
STAT,1866,53,na,1919,1981.3802436122899
STAT,1830,35,40-44,1865,4.092372542419567
STAT,1901,68,na,1969,2504.157129960797
STAT,1840,100,na,1940,0.7442000677812661
STAT,1946,20,35-39,1966,10.590178741101543
SIM,1844,28,25-29,1872,62
SIM,1848,33,na,1881,1909
STAT,1891,20,na,1911,2975.087483308471
STAT,1836,28,25-29,1864,34.282292803520974
SIM,1939,29,na,1968,3839
STAT,1914,42,35-39,1956,0.20131613329330822
STAT,1925,7,na,1932,4880.009651583574
STAT,1919,32,na,1951,4119.885804810999
SIM,1850,80,na,1930,457
SIM,1851,6,na,1857,2470
STAT,1872,32,40-44,1904,4.4035925124501
STAT,1795,78,na,1873,359.0460688692279
STAT,1870,16,50-100,1886,0.049343064429136954
STAT,1908,17,20-24,1925,26.547218289155634
SIM,1845,16,25-29,1861,8
STAT,1811,43,30-34,1854,3.183965356767598
SIM,1854,19,na,1873,2526
SIM,1880,2,na,1882,3209
SIM,1933,34,25-29,1967,3
STAT,1879,26,30-34,1905,26.632802050975126
STAT,1922,41,30-34,1963,0.1484561618747775
STAT,1816,47,25-29,1863,0.14894739078358116
SIM,1890,55,na,1945,2856
SIM,1837,39,na,1876,1566
SIM,1838,23,na,1861,1892
STAT,1871,86,na,1957,267.4300430273378
SIM,1869,16,20-24,1885,21
STAT,1850,39,25-29,1889,2.1935225914096512
STAT,1849,20,na,1869,2050.4763298251332
SIM,1920,27,na,1947,4420
STAT,1846,27,30-34,1873,23.118573143276617
SIM,1886,17,25-29,1903,11
SIM,1928,30,35-39,1958,17
SIM,1799,80,na,1879,333
STAT,1821,101,na,1922,0.3417989259291728
STAT,1920,29,na,1949,4120.18976220447
STAT,1925,34,25-29,1959,11.077782628536175
SIM,1875,66,na,1941,1657
STAT,1928,29,40-44,1957,5.798414623980986
SIM,1878,21,na,1899,2727
STAT,1859,40,na,1899,1896.4469577340578
STAT,1833,44,20-24,1877,0.13319222911876116
SIM,1897,34,na,1931,3229
STAT,1765,114,na,1879,2.4994449347757693E-4
STAT,1842,41,na,1883,2180.6657656132934
STAT,1883,38,25-29,1921,2.83160120425104
STAT,1881,25,45-49,1906,1.088286305131727
SIM,1876,15,15-19,1891,9
STAT,1898,29,45-49,1927,1.5093713533332915
STAT,1862,18,25-29,1880,5.6274617239393265
SIM,1789,80,na,1869,218
STAT,1910,29,na,1939,3623.611398249437
STAT,1912,31,35-39,1943,9.109167537011093
SIM,1870,18,25-29,1888,5
STAT,1832,48,20-24,1880,0.009565944124595566
SIM,1936,29,40-44,1965,4
STAT,1864,38,15-19,1902,0.05092470182252849
SIM,1903,44,40-44,1947,3
STAT,1923,20,40-44,1943,3.9764766608693245
STAT,1836,87,na,1923,111.08621021520761
STAT,1861,54,na,1915,1757.4164769093106
STAT,1866,51,35-39,1917,0.008089995804631996
STAT,1811,52,20-24,1863,0.0017575093165023959
STAT,1817,42,na,1859,1395.0935248597216
STAT,1871,39,45-49,1910,1.980180561081326
STAT,1844,42,30-34,1886,0.9315814875433119
STAT,1860,37,na,1897,1945.1573192939745
STAT,1893,37,30-34,1930,6.834871607903141
STAT,1931,31,45-49,1962,2.085066561232086
SIM,1887,26,30-34,1913,34
STAT,1926,46,35-39,1972,0.1611801812422137
SIM,1854,27,30-34,1881,28
STAT,1878,54,na,1932,2195.4192098454214
STAT,1907,31,na,1938,3584.1379107180487
SIM,1863,22,na,1885,2208
STAT,1883,47,15-19,1930,3.935050672712105E-4
STAT,1926,41,15-19,1967,0.0019161297745893017
SIM,1876,19,30-34,1895,2
STAT,1851,48,30-34,1899,0.0723748144871331
STAT,1846,87,na,1933,133.70093346614635
SIM,1935,17,30-34,1952,28
SIM,1921,40,40-44,1961,4
STAT,1927,17,30-34,1944,15.318158303614458
STAT,1859,45,30-34,1904,0.07941803187934321
SIM,1867,37,na,1904,2112
STAT,1869,27,25-29,1896,41.53823934605651
SIM,1835,58,na,1893,1122
STAT,1812,75,na,1887,471.40485064426514
SIM,1849,72,na,1921,988
STAT,1903,41,20-24,1944,0.015935034394678336
STAT,1906,34,15-19,1940,0.11926295469463453
STAT,1907,43,20-24,1950,0.016239323107236
STAT,1821,50,50-100,1871,0.02215590656800127
STAT,1884,19,15-19,1903,5.879084597403167
STAT,1822,44,45-49,1866,2.2680168630422544
STAT,1868,19,30-34,1887,1.5480064211754354
SIM,1873,22,na,1895,2308
STAT,1878,48,45-49,1926,0.24432629277996257
SIM,1822,34,45-49,1856,1
SIM,1860,89,na,1949,76
STAT,1812,96,na,1908,3.898437434410976
STAT,1914,44,15-19,1958,0.001530191200972653
STAT,1933,33,20-24,1966,3.319590259930376
SIM,1925,30,50-100,1955,2
STAT,1861,108,na,1969,0.01999598212067935
SIM,1833,34,20-24,1867,2
SIM,1846,25,30-34,1871,33
STAT,1919,10,na,1929,4434.390681818559
SIM,1883,75,na,1958,1237
STAT,1858,29,15-19,1887,0.3627606377800459
SIM,1844,19,na,1863,1994
SIM,1830,36,45-49,1866,1
SIM,1811,44,35-39,1855,4
SIM,1842,35,50-100,1877,1
STAT,1866,75,na,1941,962.7864659499056
SIM,1901,34,50-100,1935,3
STAT,1826,54,30-34,1880,0.005436788402984313
SIM,1920,49,na,1969,4308
SIM,1842,93,na,1935,13
STAT,1845,15,20-24,1860,16.56730118718801
STAT,1887,28,30-34,1915,28.29631233775649
STAT,1893,45,30-34,1938,0.07072361140182667
STAT,1842,17,45-49,1859,0.07552249136243243
STAT,1932,30,na,1962,5086.631199426261
STAT,1901,30,20-24,1931,3.857908973510586
STAT,1930,35,45-49,1965,0.900303900914002
SIM,1824,64,na,1888,999
SIM,1935,20,25-29,1955,188
STAT,1845,46,40-44,1891,0.12544861420530942
SIM,1907,29,na,1936,3731
STAT,1877,36,35-39,1913,7.408464817756956
STAT,1910,40,15-19,1950,0.0014808740236285222
STAT,1855,50,20-24,1905,5.634293140261395E-4
SIM,1926,32,na,1958,4531
SIM,1839,38,45-49,1877,1
STAT,1915,45,20-24,1960,0.011289498403835347
STAT,1908,16,na,1924,3791.204489020143
STAT,1862,42,25-29,1904,0.559412824706228
STAT,1838,25,30-34,1863,21.754719107530583
SIM,1908,18,25-29,1926,11
SIM,1865,88,na,1953,162
STAT,1879,49,15-19,1928,4.1279689684561237E-4
SIM,1898,27,45-49,1925,1
SIM,1853,15,20-24,1868,18
SIM,1859,39,25-29,1898,2
SIM,1899,15,na,1914,3853
STAT,1823,69,na,1892,811.6446112898174
STAT,1811,79,na,1890,304.76978734102636
STAT,1910,23,25-29,1933,87.24593031495571
STAT,1938,18,45-49,1956,0.4973070719721337
STAT,1925,40,45-49,1965,0.2041991831882253
SIM,1885,36,35-39,1921,13
SIM,1826,44,30-34,1870,1
STAT,1870,40,45-49,1910,1.499327760337828
STAT,1842,37,25-29,1879,3.0408945560132254
SIM,1936,10,na,1946,3946
STAT,1830,52,30-34,1882,0.0043786268281478585
STAT,1853,48,40-44,1901,0.13979944468823877
STAT,1838,19,45-49,1857,0.05708218292384918
SIM,1868,17,30-34,1885,2
SIM,1892,36,na,1928,3249
STAT,1870,37,na,1907,2336.630455265604
STAT,1897,17,35-39,1914,0.7429844443691093
STAT,1899,41,45-49,1940,0.14471428440879178
STAT,1841,100,na,1941,0.7939135999613673
STAT,1916,3,na,1919,4328.601139125168
SIM,1850,37,25-29,1887,2
STAT,1918,44,35-39,1962,0.21542674033855122
SIM,1886,40,na,1926,2623
STAT,1832,110,na,1942,1.8816528666027718E-4
STAT,1867,47,30-34,1914,0.0916490086232272
STAT,1870,35,35-39,1905,7.081461140598689
STAT,1935,19,30-34,1954,16.74474915963227
STAT,1820,45,25-29,1865,0.10098630556583237
STAT,1822,36,45-49,1858,3.869678709333041
STAT,1858,66,na,1924,1298.7296481918831
STAT,1852,53,20-24,1905,5.506466258548068E-4
STAT,1866,35,20-24,1901,0.7277696805659465
SIM,1824,42,na,1866,1524
STAT,1818,58,na,1876,1187.9888464619225
STAT,1830,46,45-49,1876,0.1999693256024398
SIM,1857,26,45-49,1883,1
STAT,1852,44,30-34,1896,0.8601301282078146
SIM,1825,81,na,1906,245
SIM,1905,30,40-44,1935,6
STAT,1927,20,25-29,1947,115.71325016121793
SIM,1866,20,na,1886,2412
STAT,1819,51,50-100,1870,0.028846565647788848
STAT,1913,27,na,1940,3766.1610888722225
SIM,1838,26,35-39,1864,13
SIM,1849,17,20-24,1866,21
SIM,1880,35,na,1915,2282
SIM,1883,53,na,1936,2309
STAT,1858,40,45-49,1898,1.197883933360691
SIM,1790,77,na,1867,412
STAT,1871,27,50-100,1898,0.6418828286989501
SIM,1855,1,na,1856,3287
STAT,1863,37,45-49,1900,1.7839508544113174
SIM,1851,18,15-19,1869,6
SIM,1872,15,30-34,1887,3
STAT,1885,35,30-34,1920,5.408911422443869
STAT,1909,29,30-34,1938,37.51715932402087
SIM,1874,35,20-24,1909,3
SIM,1917,29,30-34,1946,56
STAT,1840,24,45-49,1864,0.6127312349262329
STAT,1865,35,50-100,1900,1.143046658340989
SIM,1895,28,30-34,1923,48
SIM,1914,53,na,1967,3734
SIM,1853,87,na,1940,95
STAT,1812,47,40-44,1859,0.3948816054916173
STAT,1803,92,na,1895,17.362129213916834
STAT,1818,44,30-34,1862,2.1131331434945055
STAT,1871,53,30-34,1924,0.005877030429703745
SIM,1893,35,30-34,1928,11
STAT,1876,17,15-19,1893,6.18880439129822
SIM,1906,44,na,1950,3197
STAT,1912,47,45-49,1959,0.2107306669095952
STAT,1906,40,35-39,1946,0.1868528744273619
STAT,1851,76,na,1927,717.3624828709127
STAT,1941,4,na,1945,4173.0526247837215
STAT,1849,26,45-49,1875,1.0364856122645074
STAT,1869,40,na,1909,2292.441998180493
SIM,1927,18,35-39,1945,7
STAT,1877,91,na,1968,192.5472485696025
STAT,1916,45,na,1961,3820.577435704585
STAT,1845,107,na,1952,0.003445881599759919
STAT,1824,49,25-29,1873,0.06556935877928521
SIM,1942,28,na,1970,4188
STAT,1905,41,45-49,1946,0.15243411714640082
SIM,1869,46,50-100,1915,1
SIM,1828,37,30-34,1865,5
STAT,1823,37,15-19,1860,0.09778034540491334
STAT,1886,16,20-24,1902,18.952014221647694
SIM,1900,35,25-29,1935,1
STAT,1853,35,na,1888,1989.2229034998988
STAT,1898,49,25-29,1947,0.04355837182184217
STAT,1886,47,40-44,1933,0.1817153470835206
STAT,1940,17,na,1957,3772.92369269995
STAT,1928,32,35-39,1960,11.549526234403283
SIM,1929,30,na,1959,4681
STAT,1919,18,35-39,1937,4.669692180640926
SIM,1868,86,na,1954,98
STAT,1890,28,15-19,1918,0.55797090701909
SIM,1851,21,na,1872,2301
STAT,1821,41,25-29,1862,1.0539795086233656
SIM,1839,72,na,1911,761
STAT,1907,63,na,1970,2969.1771450203696
SIM,1917,29,na,1946,3802
SIM,1945,19,40-44,1964,2
STAT,1879,17,na,1896,2661.9884139939636
SIM,1877,5,na,1882,2898
SIM,1922,31,45-49,1953,2
SIM,1921,33,na,1954,4140
STAT,1836,107,na,1943,0.0029735219696494053
STAT,1862,49,45-49,1911,0.20154612601853258
STAT,1858,34,na,1892,1874.6918928077737
STAT,1918,26,na,1944,4038.7053899271305
SIM,1863,17,30-34,1880,3
STAT,1864,15,30-34,1879,1.6709619778889455
SIM,1889,69,na,1958,1765
STAT,1855,17,30-34,1872,1.4269695751013902
SIM,1881,41,na,1922,2037
STAT,1884,43,15-19,1927,0.013655161680388722
STAT,1929,24,50-100,1953,0.8357637774042244
SIM,1915,16,na,1931,4436
STAT,1846,54,35-39,1900,0.006353623850761505
SIM,1904,40,40-44,1944,2
STAT,1896,73,na,1969,1979.2650382883126
STAT,1937,19,40-44,1956,1.3696268935010032
SIM,1854,42,40-44,1896,6
SIM,1926,4,na,1930,4941
STAT,1840,37,15-19,1877,0.046557572749143745
SIM,1807,62,na,1869,912
SIM,1868,26,20-24,1894,12
STAT,1820,34,50-100,1854,2.899354384139229
SIM,1869,33,50-100,1902,4
STAT,1820,94,na,1914,10.173358844734441
STAT,1875,16,45-49,1891,0.06792004849708622
SIM,1838,47,50-100,1885,1
SIM,1864,61,na,1925,2012
STAT,1910,47,35-39,1957,0.12136328873740199
SIM,1840,69,na,1909,917
SIM,1864,71,na,1935,1590
STAT,1932,21,45-49,1953,1.4964469204056765
SIM,1940,15,na,1955,3809
STAT,1882,47,20-24,1929,0.011685437963551707
SIM,1911,13,na,1924,4138
STAT,1839,52,na,1891,1518.41093714004
STAT,1949,18,20-24,1967,159.24570410244164
STAT,1831,40,50-100,1871,0.8383264993923044
STAT,1940,20,40-44,1960,3.4603258458525
STAT,1843,47,50-100,1890,0.16487702360631556
SIM,1828,35,na,1863,1690
STAT,1874,48,25-29,1922,0.0588208294171362
STAT,1851,34,50-100,1885,0.7072488425283572
STAT,1853,32,30-34,1885,14.86894933249368
STAT,1878,45,40-44,1923,0.1812849495193196
STAT,1922,30,na,1952,4351.676603052655
SIM,1876,19,na,1895,2904
STAT,1846,42,40-44,1888,1.7276058087122899
STAT,1913,48,15-19,1961,3.617610065515983E-4
STAT,1917,31,20-24,1948,2.588705300321816
STAT,1882,20,50-100,1902,0.4013411813374206
SIM,1859,43,30-34,1902,7
STAT,1909,30,50-100,1939,0.8025638097152454
STAT,1921,21,35-39,1942,10.773687046587403
STAT,1830,39,na,1869,1740.7251881456439
SIM,1836,54,na,1890,1569
STAT,1883,51,35-39,1934,0.008549659394917144
STAT,1920,36,50-100,1956,0.46463637222234744
STAT,1918,18,50-100,1936,0.4106154091038074
STAT,1865,22,50-100,1887,0.380658809976422
STAT,1861,43,20-24,1904,0.1323257727621809
SIM,1900,50,na,1950,3205
SIM,1832,61,na,1893,1081
SIM,1930,30,40-44,1960,6
STAT,1840,28,50-100,1868,0.5550954658851991
STAT,1856,22,na,1878,1922.8840585071555
STAT,1814,47,15-19,1861,9.647753395794662E-4
STAT,1878,17,25-29,1895,5.9413084830717695
STAT,1866,46,50-100,1912,0.2303452607599892
STAT,1914,31,45-49,1945,1.6046637195997107
STAT,1837,44,40-44,1881,1.6060567986741272
STAT,1821,54,30-34,1875,0.008063960211383926
STAT,1899,17,50-100,1916,0.06791018370610756
STAT,1854,53,30-34,1907,0.00439558098177674
STAT,1833,47,25-29,1880,0.0479114881885626
STAT,1849,16,50-100,1865,0.0474290819926239
STAT,1873,49,20-24,1922,0.01203037388218293
SIM,1861,32,30-34,1893,30
STAT,1823,50,25-29,1873,0.004883003762186399
STAT,1910,20,20-24,1930,105.98112886724591
STAT,1807,47,50-100,1854,0.8844845946543185
STAT,1829,27,30-34,1856,33.32348646538566
SIM,1817,72,na,1889,607
STAT,1877,52,50-100,1929,0.01565964774913015
STAT,1811,46,35-39,1857,0.35452056816933286
STAT,1894,27,50-100,1921,0.8318146371598752
STAT,1936,31,30-34,1967,15.458587311818903
SIM,1845,44,40-44,1889,6
STAT,1896,18,30-34,1914,2.1252949531629954
SIM,1922,30,40-44,1952,7
SIM,1826,40,50-100,1866,2
STAT,1880,39,50-100,1919,1.2891727718523551
STAT,1920,41,20-24,1961,0.019724982937313295
STAT,1827,42,30-34,1869,1.236693393946382
STAT,1896,49,15-19,1945,2.953554050852793E-4
STAT,1805,53,35-39,1858,0.03468658259620747
STAT,1897,14,na,1911,3485.5485120019243
STAT,1937,30,35-39,1967,9.13767943300151
STAT,1799,60,na,1859,987.2344064017745
STAT,1904,40,25-29,1944,0.06528567590705567
SIM,1872,90,na,1962,77
SIM,1859,28,20-24,1887,11
STAT,1940,21,45-49,1961,1.1575395743205976
STAT,1856,16,35-39,1872,0.5053824146403998
SIM,1925,26,na,1951,4463
STAT,1914,30,40-44,1944,4.006347770716641
STAT,1875,14,na,1889,2677.032718758931
STAT,1881,22,40-44,1903,2.0287243039045335
STAT,1920,42,25-29,1962,0.07964268782830115
SIM,1919,29,40-44,1948,6
STAT,1841,53,45-49,1894,0.01067834423664372
STAT,1912,17,50-100,1929,0.07643367540346768
SIM,1880,44,35-39,1924,3
STAT,1872,44,35-39,1916,1.8139186214159535
STAT,1840,54,40-44,1894,0.007176814026500269
STAT,1810,47,30-34,1857,0.37394592111245084
STAT,1888,54,na,1942,2496.2990122590522
STAT,1872,50,20-24,1922,7.600664953036515E-4
STAT,1949,18,50-100,1967,0.44006725889104387
SIM,1848,28,45-49,1876,1
SIM,1885,8,na,1893,2807
SIM,1909,30,25-29,1939,13
STAT,1888,40,30-34,1928,1.3843621027664692
STAT,1873,23,na,1896,2414.1131686885437
STAT,1801,59,na,1860,1072.6546251079562
SIM,1818,42,30-34,1860,1
STAT,1888,19,35-39,1907,0.6506146541718608
STAT,1933,15,na,1948,5002.169187983219
STAT,1840,39,na,1879,1739.2665404288787
STAT,1916,48,40-44,1964,0.16274033622957423
STAT,1877,33,30-34,1910,18.12361079756006
STAT,1886,73,na,1959,1394.8025146484806
STAT,1849,19,20-24,1868,16.861519671650072
SIM,1830,33,40-44,1863,5
SIM,1885,33,30-34,1918,27
SIM,1835,42,30-34,1877,1
STAT,1872,49,na,1921,2236.835959329158
STAT,1831,31,40-44,1862,3.6326192097406844
STAT,1953,2,na,1955,4809.6276074262205
SIM,1844,17,20-24,1861,10
SIM,1874,71,na,1945,1229
STAT,1912,42,25-29,1954,0.06948473721121809
STAT,1894,33,30-34,1927,22.607679318374345
STAT,1936,32,35-39,1968,8.961160795561641
STAT,1821,57,na,1878,1304.8347784880843
SIM,1857,19,20-24,1876,15
STAT,1820,42,20-24,1862,0.29965123413420514
SIM,1928,15,25-29,1943,66
STAT,1853,67,na,1920,1310.9379434687607
STAT,1918,41,30-34,1959,0.13742685077824524
STAT,1890,29,50-100,1919,0.783840703551803
STAT,1841,46,20-24,1887,0.00913069021866065
STAT,1914,33,na,1947,3824.8682866878144
SIM,1949,19,25-29,1968,59
STAT,1904,40,50-100,1944,0.10740546613969401
SIM,1931,33,na,1964,4868
STAT,1912,8,na,1920,4055.628780599495
STAT,1937,28,na,1965,3684.798381536561
SIM,1859,15,15-19,1874,9
STAT,1890,41,25-29,1931,0.7961110449242137
SIM,1895,43,40-44,1938,1
STAT,1831,43,35-39,1874,1.38193030840417
STAT,1901,42,15-19,1943,0.0013561114182449989
SIM,1896,34,50-100,1930,1
SIM,1826,54,na,1880,1614
STAT,1822,53,35-39,1875,0.012052577555493665
STAT,1876,54,20-24,1930,7.483723455770757E-4
STAT,1925,31,20-24,1956,2.9289388973354384
STAT,1854,41,na,1895,1742.4028320602138
STAT,1868,34,na,1902,2283.762764764828
STAT,1904,5,na,1909,3798.4027454737616
SIM,1866,52,na,1918,2164
STAT,1824,32,50-100,1856,1.7884672877141528
STAT,1953,13,na,1966,4800.160956428761
SIM,1882,46,50-100,1928,1
STAT,1887,43,40-44,1930,2.5180644942420924
SIM,1930,30,50-100,1960,1
STAT,1793,97,na,1890,0.969605810566309
SIM,1901,13,na,1914,3759
SIM,1866,40,45-49,1906,1
SIM,1834,42,na,1876,1815
STAT,1926,43,30-34,1969,0.15903641162982565
STAT,1880,46,35-39,1926,0.14892108739130772
STAT,1927,42,35-39,1969,0.2552569612652083
STAT,1861,86,na,1947,186.2162695420784
SIM,1829,28,35-39,1857,14
STAT,1839,20,na,1859,1975.9924523530199
SIM,1836,18,25-29,1854,7
SIM,1837,17,na,1854,1943
STAT,1930,30,25-29,1960,12.069512980354299
SIM,1914,24,50-100,1938,1
SIM,1958,10,na,1968,5244
STAT,1821,48,45-49,1869,0.3409288121660726
STAT,1840,21,40-44,1861,1.87104073419192
SIM,1896,19,35-39,1915,3
STAT,1836,39,50-100,1875,0.9311333685681432
SIM,1897,66,na,1963,2397
STAT,1877,53,25-29,1930,0.0036329933645792207
STAT,1900,49,40-44,1949,0.13266133708405
STAT,1897,46,50-100,1943,0.18812235550919032
STAT,1789,82,na,1871,203.72299029444704
STAT,1892,49,30-34,1941,0.06775813057844128
STAT,1910,6,na,1916,3993.738288502265
STAT,1922,33,45-49,1955,1.7885571031229637
STAT,1929,42,45-49,1971,0.21784769057289513
STAT,1802,54,20-24,1856,0.0020683107756182826
STAT,1911,30,15-19,1941,0.12725906090848002
SIM,1818,57,na,1875,1083
STAT,1902,20,20-24,1922,98.94289809132657
STAT,1866,18,45-49,1884,0.06233636670562996
STAT,1922,46,15-19,1968,4.2858042067139514E-4
STAT,1853,89,na,1942,86.87679702283025
STAT,1898,32,na,1930,3267.358014997214
SIM,1930,33,45-49,1963,1
STAT,1810,44,50-100,1854,4.271897481816792
SIM,1931,11,na,1942,5159
STAT,1842,50,35-39,1892,0.007862420691511307
STAT,1914,11,na,1925,4127.973306049303
STAT,1771,87,na,1858,42.89811030229202
STAT,1847,45,50-100,1892,0.18572311634385158
SIM,1839,94,na,1933,5
STAT,1884,30,45-49,1914,1.7507991412087796
SIM,1937,17,40-44,1954,1
SIM,1889,47,na,1936,2668
SIM,1857,37,na,1894,2075
SIM,1885,34,na,1919,2518
STAT,1836,52,25-29,1888,0.0022608577485537197
SIM,1841,43,na,1884,1617
STAT,1847,18,35-39,1865,0.50974715395897
STAT,1790,79,na,1869,241.8930276045848
STAT,1859,19,na,1878,2139.0679132116975
STAT,1869,20,50-100,1889,0.4045468434195486
STAT,1906,31,45-49,1937,1.4790396688358174
SIM,1889,26,40-44,1915,4
STAT,1839,42,na,1881,1727.019164289084
STAT,1864,51,25-29,1915,0.0032435905670810477
STAT,1822,33,40-44,1855,11.270572237463346
SIM,1892,30,45-49,1922,1
SIM,1890,33,50-100,1923,1
STAT,1808,91,na,1899,21.84676128493545
STAT,1874,33,50-100,1907,0.9435728625318425
SIM,1858,86,na,1944,150
STAT,1837,107,na,1944,0.0032171273484241695
STAT,1857,48,25-29,1905,0.04483238433493423
SIM,1923,0,na,1923,5012
STAT,1812,43,25-29,1855,1.613727540228579
STAT,1821,47,na,1868,1556.192298780854
STAT,1929,41,40-44,1970,0.32787183670209386
STAT,1905,46,15-19,1951,3.303815129393737E-4
STAT,1916,41,20-24,1957,0.018290180433249217
SIM,1916,44,na,1960,3787
SIM,1876,43,30-34,1919,1
SIM,1835,91,na,1926,10
STAT,1863,30,25-29,1893,9.239679429134467
STAT,1921,20,30-34,1941,32.98235838256982
STAT,1853,57,na,1910,1661.917672333177
STAT,1867,16,45-49,1883,0.06389819676874536
STAT,1868,43,30-34,1911,1.1017475627937228
STAT,1893,48,35-39,1941,0.10000398819460511
STAT,1860,45,50-100,1905,0.20479545076478495
SIM,1872,42,35-39,1914,1
STAT,1912,52,na,1964,3502.153781601282
SIM,1837,42,40-44,1879,9
STAT,1846,45,45-49,1891,0.18088235098635078
SIM,1867,15,na,1882,2475
STAT,1927,41,30-34,1968,0.1622938900758112
SIM,1825,91,na,1916,16
SIM,1837,49,na,1886,1404
SIM,1946,10,na,1956,4457
STAT,1872,60,na,1932,1936.5900744472972
STAT,1842,94,na,1936,17.994160075211408
SIM,1854,93,na,1947,50
SIM,1909,15,15-19,1924,11
STAT,1911,32,30-34,1943,15.478025799875482
STAT,1822,49,15-19,1871,5.76670721794335E-4
STAT,1900,20,na,1920,3337.9877829298403
STAT,1871,32,25-29,1903,10.277677140190082
SIM,1895,22,na,1917,3129
SIM,1786,94,na,1880,4
SIM,1842,61,na,1903,1289
STAT,1832,52,40-44,1884,0.007478719376767686
STAT,1861,34,30-34,1895,14.528135446482263
STAT,1954,4,na,1958,4911.719213431794
STAT,1918,41,50-100,1959,0.1262841328704588
STAT,1850,43,45-49,1893,1.1377196271600813
SIM,1848,25,40-44,1873,3
STAT,1820,36,35-39,1856,18.660120904463845
STAT,1824,45,50-100,1869,0.2954194807448344
SIM,1821,39,50-100,1860,2
STAT,1840,51,50-100,1891,0.010637494989624326
STAT,1844,53,na,1897,1676.1998974502874
STAT,1924,46,25-29,1970,0.06397363618060467
STAT,1858,16,45-49,1874,0.06082158651624411
STAT,1848,16,35-39,1864,0.5586505830894832
STAT,1831,57,na,1888,1270.6189108664585
STAT,1864,42,35-39,1906,1.6483206014476246
STAT,1923,40,35-39,1963,0.2384615408132388
SIM,1832,45,50-100,1877,3
STAT,1810,62,na,1872,1117.0214875995043
STAT,1824,53,45-49,1877,0.016047860196926576
STAT,1854,47,45-49,1901,0.17628911042167886
STAT,1901,34,50-100,1935,1.28616634820437
STAT,1929,17,40-44,1946,1.8042273988735789
STAT,1910,44,30-34,1954,0.12040375070292522
STAT,1879,50,30-34,1929,0.006364145930162955
STAT,1864,18,35-39,1882,0.5142813047633129
SIM,1871,34,40-44,1905,5
STAT,1862,46,40-44,1908,0.1497480746468634
STAT,1858,27,50-100,1885,0.5188945329784612
SIM,1907,19,20-24,1926,34
STAT,1888,6,na,1894,3114.221653249056
STAT,1912,40,25-29,1952,0.07027238010290845
SIM,1833,24,na,1857,1962
STAT,1842,109,na,1951,6.405519409032595E-4
SIM,1903,30,30-34,1933,33
STAT,1891,44,45-49,1935,1.8462539511203653
STAT,1933,25,na,1958,5030.800757977452
SIM,1859,49,na,1908,2082
SIM,1889,15,na,1904,3188
SIM,1880,41,30-34,1921,5
STAT,1776,101,na,1877,0.1150263347578725
STAT,1856,40,35-39,1896,1.4163455479861033
SIM,1844,39,50-100,1883,1
SIM,1846,42,na,1888,1647
STAT,1806,58,na,1864,1019.0127644074244
STAT,1839,16,35-39,1855,0.5119096813022973
SIM,1848,23,na,1871,1868
SIM,1827,39,na,1866,1542
STAT,1867,19,15-19,1886,5.703178301675658
SIM,1875,19,15-19,1894,7
SIM,1860,57,na,1917,1772
SIM,1926,30,25-29,1956,5
STAT,1881,49,20-24,1930,0.011438858271277108
SIM,1894,48,na,1942,3152
STAT,1852,47,35-39,1899,0.10567988000436453
STAT,1872,41,30-34,1913,1.1726793318568405
STAT,1902,45,35-39,1947,0.11383679589603504
STAT,1837,40,25-29,1877,0.5303642386998746
STAT,1868,28,20-24,1896,11.284401452638436
STAT,1901,37,40-44,1938,1.3377665643050247
STAT,1877,29,50-100,1906,0.6620643020121736
STAT,1861,50,45-49,1911,0.012355011999455096
STAT,1825,61,na,1886,1431.627104606337
STAT,1864,106,na,1970,0.13972554062299233
STAT,1809,54,na,1863,1301.4362556643719
STAT,1865,47,20-24,1912,0.011015477190170974
SIM,1862,16,na,1878,2358
SIM,1878,43,40-44,1921,5
STAT,1938,14,na,1952,3933.041554659643
STAT,1931,40,35-39,1971,0.2726297761346487
SIM,1845,40,25-29,1885,3
STAT,1948,24,na,1972,4232.791287953095
STAT,1855,48,15-19,1903,2.9730490181380606E-4
STAT,1908,48,na,1956,3344.5702714107806
SIM,1870,89,na,1959,138
STAT,1921,45,45-49,1966,0.248618893781217
STAT,1815,61,na,1876,1001.2345790662823
STAT,1873,53,40-44,1926,0.01060628686071114
STAT,1840,50,25-29,1890,0.0025185877350402063
STAT,1882,70,na,1952,1372.6942342384377
STAT,1828,54,40-44,1882,0.008099973402211946
SIM,1865,56,na,1921,1827
SIM,1890,23,na,1913,3165
STAT,1827,45,35-39,1872,0.14745677428538814
STAT,1847,71,na,1918,999.4146449959195
STAT,1895,45,40-44,1940,0.12864354863876779
STAT,1923,15,na,1938,4387.2830827856
SIM,1885,18,20-24,1903,11
STAT,1890,49,20-24,1939,0.00817960830465987
STAT,1901,33,25-29,1934,14.440868810402304
STAT,1834,53,na,1887,1288.3309640596428
STAT,1924,34,50-100,1958,0.9734805316218585
SIM,1852,38,na,1890,1728
STAT,1845,41,50-100,1886,0.7962111270188593
STAT,1809,54,30-34,1863,0.0183337596762448
STAT,1880,43,30-34,1923,1.2106560188379982
SIM,1915,48,na,1963,4091
STAT,1858,56,na,1914,1616.178628245472
STAT,1868,52,20-24,1920,7.085148731868868E-4
STAT,1930,32,40-44,1962,5.10445630638334
SIM,1866,19,na,1885,2584
STAT,1794,61,na,1855,949.9124000000002
SIM,1926,19,30-34,1945,23
STAT,1823,41,35-39,1864,2.754736030002199
STAT,1821,45,40-44,1866,0.2582983983836472
SIM,1853,41,50-100,1894,1
SIM,1875,56,na,1931,2057
STAT,1928,14,na,1942,5029.968564575712
SIM,1840,80,na,1920,494
STAT,1797,109,na,1906,1.7763256729040573E-4
SIM,1891,42,45-49,1933,2
SIM,1945,14,na,1959,4209
STAT,1857,71,na,1928,1052.1490157062437
SIM,1829,25,30-34,1854,29
SIM,1878,17,25-29,1895,7
STAT,1810,48,35-39,1858,0.530662704290183
STAT,1916,47,50-100,1963,0.23411477920765522
STAT,1843,42,15-19,1885,0.009590109676837651
STAT,1820,47,50-100,1867,0.41770799077196263
STAT,1888,22,na,1910,2819.402071408116
STAT,1823,80,na,1903,342.12299992680846
STAT,1884,47,30-34,1931,0.09596283717611363
STAT,1888,16,30-34,1904,1.9047369897812407
STAT,1908,41,20-24,1949,0.016588823510466342
SIM,1896,16,30-34,1912,3
STAT,1926,32,25-29,1958,11.295130550413385
STAT,1849,50,45-49,1899,0.011509627935538242
SIM,1934,32,25-29,1966,21
SIM,1867,17,15-19,1884,9
STAT,1844,75,na,1919,814.4941288753175
STAT,1883,42,45-49,1925,1.4774150674848332
STAT,1851,44,15-19,1895,0.010315489474066087
SIM,1847,16,35-39,1863,2
STAT,1908,26,na,1934,3585.9130973185406
STAT,1886,40,20-24,1926,0.1710659797794273
STAT,1870,49,45-49,1919,0.2291749886687617
STAT,1866,15,40-44,1881,0.17766271522289329
SIM,1871,30,25-29,1901,13
STAT,1798,64,na,1862,990.0165151514549
STAT,1831,34,45-49,1865,1.4094967576726825
STAT,1841,49,25-29,1890,0.04217476261358046
SIM,1906,34,na,1940,3389
STAT,1924,11,na,1935,4775.103864644838
STAT,1846,51,30-34,1897,0.004538913389447687
STAT,1922,30,40-44,1952,4.50272276763334
SIM,1884,48,na,1932,2288
STAT,1876,45,30-34,1921,0.10195359715268897
STAT,1899,40,50-100,1939,0.10271723123404855
STAT,1890,32,35-39,1922,12.498428178859067
STAT,1784,83,na,1867,111.96606127249754
STAT,1878,41,25-29,1919,0.6763190054743785
STAT,1827,51,50-100,1878,0.015255672687472927
SIM,1837,27,30-34,1864,42
STAT,1942,24,50-100,1966,0.696094708304438
SIM,1889,29,45-49,1918,1
STAT,1831,40,30-34,1871,0.9122964866347454
STAT,1816,44,20-24,1860,0.42444672632972413
STAT,1918,30,25-29,1948,9.995285314513673
STAT,1847,93,na,1940,21.88213441282688
STAT,1862,60,na,1922,1663.4808324187038
STAT,1869,29,na,1898,2326.7175603943824
SIM,1849,29,50-100,1878,2
STAT,1904,42,40-44,1946,0.22611227287518554
STAT,1854,44,40-44,1898,1.665265771071472
SIM,1887,23,50-100,1910,1
SIM,1883,85,na,1968,703
SIM,1777,80,na,1857,165
STAT,1879,23,50-100,1902,0.42848290275371415
SIM,1855,15,30-34,1870,2
STAT,1843,57,na,1900,1355.4313800872524
STAT,1813,46,45-49,1859,0.6995722844839116
STAT,1866,85,na,1951,256.3794482628687
STAT,1892,45,15-19,1937,2.888136483162981E-4
STAT,1844,54,25-29,1898,0.0027253209010470823
STAT,1870,1,na,1871,3492.7852738056895
SIM,1888,17,35-39,1905,3
SIM,1911,30,30-34,1941,22
SIM,1875,34,na,1909,2308
STAT,1835,44,30-34,1879,1.008146033950567
STAT,1944,20,25-29,1964,100.77948283632061
SIM,1843,24,na,1867,2346
STAT,1881,38,15-19,1919,0.054398977696418736
STAT,1919,42,35-39,1961,0.22032907304674154
STAT,1868,46,35-39,1914,0.1355244119956087
SIM,1850,41,45-49,1891,5
STAT,1896,51,na,1947,2892.467887224237
SIM,1820,34,35-39,1854,7
SIM,1899,47,na,1946,3372
STAT,1878,16,20-24,1894,18.633214731383873
STAT,1880,37,45-49,1917,2.114512274855574
STAT,1899,17,45-49,1916,0.09054691160814345
STAT,1897,36,na,1933,3205.485897513138
STAT,1845,18,50-100,1863,0.04497865119959347
SIM,1816,76,na,1892,418
STAT,1873,47,20-24,1920,0.012229633069527455
STAT,1851,49,35-39,1900,0.1037929607586191
STAT,1845,16,na,1861,2132.454776424147
STAT,1897,41,35-39,1938,0.1710387464973055
SIM,1912,42,40-44,1954,2
STAT,1768,98,na,1866,0.9900499806140484
STAT,1887,46,45-49,1933,0.2668800203808437
SIM,1831,41,35-39,1872,1
SIM,1941,11,na,1952,4255
STAT,1903,3,na,1906,3802.649118287834
SIM,1868,29,25-29,1897,9
STAT,1918,19,30-34,1937,13.321954292732514
STAT,1813,52,30-34,1865,0.016460570969769113
STAT,1859,17,15-19,1876,5.595992934431823
SIM,1878,28,30-34,1906,2
SIM,1893,2,na,1895,3472
STAT,1934,31,20-24,1965,3.366966365164164
SIM,1843,44,30-34,1887,2
STAT,1849,19,na,1868,2183.183966388262
STAT,1842,41,45-49,1883,1.4120871641919488
STAT,1870,48,40-44,1918,0.16766067758453726
SIM,1906,12,na,1918,3701
STAT,1847,15,30-34,1862,1.5071692689344711
STAT,1893,33,na,1926,3047.3897870556975
SIM,1864,93,na,1957,23
STAT,1865,54,45-49,1919,0.013016105360774709
STAT,1903,30,30-34,1933,25.316161271414945
SIM,1845,68,na,1913,1132
SIM,1813,58,na,1871,1134
SIM,1787,78,na,1865,277
STAT,1891,3,na,1894,3305.8161494039246
STAT,1918,33,30-34,1951,16.83094277352826
STAT,1896,29,na,1925,3167.789748169838
STAT,1930,18,na,1948,4797.076570321068
SIM,1910,23,25-29,1933,87
SIM,1872,59,na,1931,2182
STAT,1832,46,20-24,1878,0.009814430211974569
STAT,1812,48,45-49,1860,0.5356726749590676
SIM,1912,31,35-39,1943,18
SIM,1843,20,35-39,1863,7
SIM,1903,46,40-44,1949,3
STAT,1892,15,na,1907,3215.772497946836
SIM,1846,21,15-19,1867,3
SIM,1857,33,40-44,1890,7
STAT,1770,105,na,1875,0.010639445772705503
SIM,1918,27,45-49,1945,2
STAT,1854,15,20-24,1869,16.105143596173125
STAT,1900,28,20-24,1928,16.401420080245863
STAT,1873,56,na,1929,2088.400786922122
STAT,1921,43,30-34,1964,0.14520254834744273
SIM,1944,24,35-39,1968,17
STAT,1925,36,25-29,1961,1.195378206660936
STAT,1911,16,30-34,1927,2.4667958811428963
STAT,1845,9,na,1854,2250.0
STAT,1844,30,50-100,1874,0.8850731953909924
STAT,1936,24,35-39,1960,9.082036401560401
STAT,1903,16,na,1919,3641.787730858595
STAT,1792,103,na,1895,0.02579940943065853
STAT,1845,37,na,1882,1808.7428983913167
STAT,1916,38,25-29,1954,1.0124913412319292
STAT,1904,46,35-39,1950,0.11478798959096045
SIM,1832,94,na,1926,25
STAT,1892,47,30-34,1939,0.06888040908510024
STAT,1838,21,15-19,1859,2.8859638746649825
SIM,1845,57,na,1902,1638
STAT,1928,26,50-100,1954,1.243711794375324
SIM,1910,18,30-34,1928,3
STAT,1902,23,25-29,1925,81.45190831896792
STAT,1913,37,45-49,1950,0.6787922750995998
STAT,1907,45,20-24,1952,0.010140063019901745
STAT,1881,49,50-100,1930,0.23411529001623455
STAT,1867,24,45-49,1891,0.6591551471982353
STAT,1927,31,30-34,1958,19.60031594011289
STAT,1930,34,40-44,1964,5.097873678139255
STAT,1933,35,20-24,1968,0.3634585781593061
STAT,1805,72,na,1877,669.1001912046324
STAT,1809,86,na,1895,102.45107763122037
STAT,1861,48,40-44,1909,0.14187935200664312
SIM,1837,23,15-19,1860,3
STAT,1822,64,na,1886,991.8836845543156
STAT,1812,101,na,1913,0.259069418357985
SIM,1866,26,45-49,1892,2
SIM,1917,35,30-34,1952,2
SIM,1840,38,na,1878,1823
STAT,1792,80,na,1872,245.62483952743014
STAT,1796,94,na,1890,4.187110562725757
STAT,1803,81,na,1884,261.39386221707474
STAT,1922,35,45-49,1957,0.7850017586808185
STAT,1828,69,na,1897,952.6663000664569
SIM,1905,18,20-24,1923,28
STAT,1815,49,25-29,1864,0.12361476808809883
STAT,1876,22,45-49,1898,0.7271968806433254
SIM,1926,33,30-34,1959,26
SIM,1909,36,35-39,1945,3
SIM,1921,37,45-49,1958,1
STAT,1865,37,na,1902,2172.8140858478428
STAT,1904,31,35-39,1935,14.738344971558266
STAT,1837,18,na,1855,2068.6976823083714
SIM,1909,29,45-49,1938,2
SIM,1830,28,na,1858,1684
SIM,1863,86,na,1949,111
STAT,1894,18,na,1912,3275.530541614515
SIM,1838,20,25-29,1858,67
STAT,1843,26,na,1869,1808.6151138714624
STAT,1852,44,50-100,1896,0.7903898458078846
SIM,1920,30,30-34,1950,33
STAT,1927,26,35-39,1953,18.51159867657116
STAT,1921,45,na,1966,4202.535814347721
STAT,1938,6,na,1944,3991.4206868671654
SIM,1939,19,30-34,1958,18
STAT,1898,19,50-100,1917,0.06672037301047846
STAT,1913,26,na,1939,3779.085561492527
SIM,1926,26,40-44,1952,14
STAT,1851,45,na,1896,1720.5356540394919
STAT,1903,17,35-39,1920,0.7892705081915066
STAT,1944,23,30-34,1967,31.326109339626242
STAT,1869,5,na,1874,2750.9625667678342
SIM,1908,37,30-34,1945,2
SIM,1899,32,35-39,1931,22
STAT,1904,39,45-49,1943,0.6173742136945594
SIM,1855,67,na,1922,1431
STAT,1863,51,50-100,1914,0.013579961543518978
STAT,1823,81,na,1904,299.0770840760175
STAT,1938,21,50-100,1959,0.6576451027331555
STAT,1934,29,30-34,1963,53.207146749479094
SIM,1942,29,30-34,1971,69
STAT,1883,30,50-100,1913,0.9128701074663411
SIM,1804,75,na,1879,463
SIM,1808,89,na,1897,40
SIM,1900,28,na,1928,3599
SIM,1793,86,na,1879,75
STAT,1902,18,30-34,1920,2.2689060427715355
SIM,1887,22,15-19,1909,2
SIM,1912,29,na,1941,3560
STAT,1930,41,30-34,1971,0.17026160791689018
STAT,1879,22,15-19,1901,3.4771707418038833
STAT,1841,39,25-29,1880,2.4846423873726913
STAT,1842,49,50-100,1891,0.2165053484932637
STAT,1913,44,35-39,1957,0.1974708877292146
STAT,1835,20,35-39,1855,9.204857378467581
STAT,1924,39,15-19,1963,0.022833421139644004
SIM,1800,93,na,1893,22
STAT,1945,22,35-39,1967,10.421861992484297
STAT,1914,40,35-39,1954,0.20272345280131343
STAT,1942,28,25-29,1970,69.71591922491466
STAT,1818,59,na,1877,1164.6923851828042
SIM,1935,26,35-39,1961,33
STAT,1853,49,45-49,1902,0.19109153448441699
STAT,1835,52,50-100,1887,0.011556485961582567
STAT,1930,21,35-39,1951,12.228586555911841
STAT,1939,32,50-100,1971,0.8516341235528653
STAT,1788,75,na,1863,377.5546868080314
STAT,1904,44,40-44,1948,0.22333514385075073
SIM,1953,11,na,1964,4918
STAT,1846,16,25-29,1862,5.434171346815752
STAT,1910,24,15-19,1934,5.0119323442961035
STAT,1814,45,na,1859,1475.302798196662
STAT,1910,42,15-19,1952,0.001464275754201873
STAT,1817,108,na,1925,8.380544550873976E-4
STAT,1849,33,40-44,1882,3.536016331491334
STAT,1929,29,20-24,1958,23.067872695303034
SIM,1909,34,40-44,1943,8
SIM,1929,29,15-19,1958,4
STAT,1881,75,na,1956,1037.903627410059
SIM,1837,21,20-24,1858,83
SIM,1854,16,25-29,1870,8
STAT,1952,18,40-44,1970,1.6929759631561443
STAT,1833,24,50-100,1857,0.383690323025936
SIM,1907,30,na,1937,3814
STAT,1939,25,15-19,1964,0.7170847913090481
STAT,1820,47,40-44,1867,0.29117104264000704
STAT,1907,47,15-19,1954,3.331051065944779E-4
SIM,1887,15,25-29,1902,9
STAT,1884,41,50-100,1925,1.0569818502834951
STAT,1918,26,40-44,1944,5.025046844327078
STAT,1918,42,50-100,1960,0.1261022837191253
STAT,1852,94,na,1946,15.157280396783028
STAT,1930,36,35-39,1966,3.1916727572286914
STAT,1864,49,20-24,1913,0.01070829767989003
STAT,1902,31,50-100,1933,1.3130648529461155
STAT,1877,38,na,1915,2443.7441487202377
STAT,1899,27,45-49,1926,1.5390487360149856
SIM,1906,16,15-19,1922,8
STAT,1859,30,45-49,1889,1.4372041193368044
STAT,1899,32,40-44,1931,6.0113476343036005
SIM,1923,16,15-19,1939,44
SIM,1927,32,35-39,1959,10
STAT,1860,38,na,1898,1935.5093389902759
STAT,1892,47,na,1939,2838.635674667531
STAT,1920,32,30-34,1952,17.427016843178
SIM,1836,25,20-24,1861,9
STAT,1935,34,50-100,1969,1.1541935406366373
STAT,1912,38,40-44,1950,1.4667699348532215
SIM,1864,5,na,1869,2974
STAT,1929,37,50-100,1966,0.5448145678099185
SIM,1858,32,45-49,1890,1
SIM,1934,27,30-34,1961,63
STAT,1895,16,20-24,1911,23.440713353898783
STAT,1925,43,15-19,1968,0.0018760065991048677
STAT,1852,19,na,1871,2080.7564153826834
STAT,1908,39,30-34,1947,1.7052195992874253
STAT,1825,92,na,1917,30.394030998426377
STAT,1810,45,30-34,1855,0.38848137188888177
SIM,1920,38,40-44,1958,2
SIM,1898,34,40-44,1932,11
SIM,1860,58,na,1918,1741
STAT,1834,22,40-44,1856,1.6604027878271614
STAT,1915,16,15-19,1931,9.608020710862736
STAT,1877,28,50-100,1905,0.6644830202057223
SIM,1869,71,na,1940,1210
STAT,1823,35,50-100,1858,2.3248531061821995
STAT,1869,29,25-29,1898,41.24135777349183
STAT,1943,27,30-34,1970,42.135459843680756
SIM,1836,76,na,1912,658
STAT,1917,41,15-19,1958,0.0016199995395176573
SIM,1887,20,20-24,1907,77
STAT,1903,22,30-34,1925,25.621424271648745
STAT,1888,34,50-100,1922,1.0829154728936872
STAT,1874,18,na,1892,2605.1122500724214
STAT,1927,19,45-49,1946,0.6244265189843298
STAT,1912,30,30-34,1942,15.766599605418467
SIM,1904,42,40-44,1946,1
STAT,1926,27,30-34,1953,47.47168295510205
STAT,1776,102,na,1878,0.07208355320271596
STAT,1929,41,na,1970,4868.342521688888
STAT,1935,28,35-39,1963,20.66702490079884
STAT,1947,17,20-24,1964,154.26372520477554
STAT,1874,46,50-100,1920,0.25471810796704747
SIM,1907,50,na,1957,3471
STAT,1938,29,15-19,1967,0.7053606263498094
STAT,1880,43,50-100,1923,1.1124947175720368
STAT,1875,67,na,1942,1644.2156550854618
SIM,1920,48,na,1968,4328
STAT,1918,28,35-39,1946,16.073903837496726
STAT,1884,28,na,1912,2368.5983027720645
STAT,1928,40,35-39,1968,0.2601884755433188
STAT,1868,65,na,1933,1631.3053909010807
STAT,1887,17,25-29,1904,6.390063370083372
STAT,1908,44,25-29,1952,0.0658730788617992
SIM,1902,24,30-34,1926,41
SIM,1910,18,na,1928,3613
STAT,1859,19,15-19,1878,5.5302662744107
STAT,1919,32,35-39,1951,9.954658871766146
SIM,1919,31,na,1950,4006
SIM,1943,28,35-39,1971,25
SIM,1935,31,30-34,1966,38
STAT,1908,43,15-19,1951,0.0014256354626033592
STAT,1883,86,na,1969,493.9020368639054
STAT,1841,38,50-100,1879,1.0705561714828271
STAT,1849,18,45-49,1867,0.062496017094941576
SIM,1957,2,na,1959,5440
STAT,1834,41,50-100,1875,0.7682663979640049
SIM,1795,77,na,1872,275
SIM,1877,16,20-24,1893,21
SIM,1888,30,na,1918,2959
SIM,1882,89,na,1971,202
STAT,1934,34,25-29,1968,12.734482629464537
SIM,1948,9,na,1957,5010
STAT,1917,34,25-29,1951,9.685723682828804
SIM,1901,25,25-29,1926,66
STAT,1883,22,na,1905,2337.5462460789577
STAT,1895,67,na,1962,2269.7581065234476
SIM,1828,26,25-29,1854,39
SIM,1929,27,20-24,1956,33
STAT,1903,15,40-44,1918,0.26431253999668525
SIM,1866,31,40-44,1897,7
SIM,1878,22,20-24,1900,72
SIM,1925,29,30-34,1954,56
SIM,1901,45,na,1946,3297
STAT,1828,39,50-100,1867,1.2089898862732313
STAT,1944,26,35-39,1970,16.393194485856952
SIM,1870,88,na,1958,138
STAT,1927,24,40-44,1951,4.160906100182022
STAT,1839,45,50-100,1884,0.18201415368881071
SIM,1823,58,na,1881,1167
SIM,1878,24,15-19,1902,7
STAT,1858,26,45-49,1884,0.9071496879482025
SIM,1862,15,20-24,1877,20
STAT,1823,48,20-24,1871,0.01628321526410405
STAT,1907,36,50-100,1943,0.3949434395526292
SIM,1919,1,na,1920,4445
STAT,1933,37,15-19,1970,0.026431332639058933
STAT,1947,19,15-19,1966,51.60453598675516
SIM,1845,15,20-24,1860,24
STAT,1868,20,45-49,1888,0.6828892343791427
SIM,1882,69,na,1951,1143
SIM,1842,22,40-44,1864,4
STAT,1944,24,40-44,1968,3.6634706431204367
SIM,1925,34,25-29,1959,18
STAT,1869,16,20-24,1885,17.75432194450322
STAT,1861,55,na,1916,1735.3908841639557
SIM,1926,28,35-39,1954,20
STAT,1950,22,15-19,1972,6.3801308986936425
STAT,1930,37,45-49,1967,0.8987470469721917
SIM,1935,24,40-44,1959,5
STAT,1890,39,20-24,1929,0.9417765718575457
STAT,1909,38,35-39,1947,2.298800406126144
SIM,1920,8,na,1928,4849
STAT,1944,19,45-49,1963,0.5424897958649834
SIM,1879,21,25-29,1900,78
SIM,1909,33,30-34,1942,28
SIM,1900,26,20-24,1926,18
SIM,1877,90,na,1967,252
STAT,1845,92,na,1937,30.432645436989226
SIM,1902,19,35-39,1921,1
SIM,1930,32,40-44,1962,7
STAT,1840,48,20-24,1888,0.008374697070871817
SIM,1828,89,na,1917,36
SIM,1899,33,45-49,1932,7
STAT,1927,15,50-100,1942,0.4730325483285166
STAT,1910,25,25-29,1935,65.10861057290651
STAT,1953,16,35-39,1969,5.1299599699092
STAT,1837,73,na,1910,810.2606073547462
STAT,1858,31,40-44,1889,3.4722240425287634
SIM,1811,77,na,1888,482
SIM,1851,7,na,1858,2460
SIM,1916,39,30-34,1955,1
STAT,1911,15,na,1926,3917.3636404373
STAT,1938,27,20-24,1965,18.256679979037315
STAT,1851,110,na,1961,6.140409644810933E-4
SIM,1906,24,15-19,1930,5
STAT,1922,32,40-44,1954,4.466817850960074
SIM,1951,19,30-34,1970,16
STAT,1925,33,20-24,1958,2.9254252239050627
SIM,1831,77,na,1908,576
SIM,1860,20,35-39,1880,8
SIM,1861,43,na,1904,1971
SIM,1869,17,25-29,1886,10
STAT,1878,39,50-100,1917,1.2742773342907374
STAT,1863,50,50-100,1913,0.013709516474200172
STAT,1870,54,50-100,1924,0.014566824203432199
STAT,1896,49,50-100,1945,0.18134837106237708
STAT,1835,21,45-49,1856,0.7010089328417685
STAT,1838,35,na,1873,1766.3817315112394
STAT,1882,37,20-24,1919,0.7541581331471875
SIM,1904,37,45-49,1941,1
STAT,1798,108,na,1906,6.094643321280571E-4
STAT,1898,30,50-100,1928,1.2646155469550164
STAT,1904,33,na,1937,3473.4651155062666
STAT,1922,34,35-39,1956,10.379900156193045
STAT,1874,73,na,1947,1228.3614371753272
STAT,1878,24,20-24,1902,71.79932531380439
STAT,1915,49,15-19,1964,3.7235801049425644E-4
STAT,1940,23,45-49,1963,1.1567757242576053
SIM,1920,20,30-34,1940,66
STAT,1862,29,50-100,1891,0.5539648967282901
STAT,1879,19,40-44,1898,0.1917459525661285
SIM,1784,81,na,1865,155
SIM,1886,24,20-24,1910,124
SIM,1842,60,na,1902,1321
SIM,1846,74,na,1920,740
STAT,1912,46,40-44,1958,0.15324908375321455
STAT,1859,22,45-49,1881,0.5877205419763143
STAT,1863,66,na,1929,1466.7334073172956
SIM,1935,26,na,1961,5016
STAT,1804,55,na,1859,1012.559610317233
STAT,1904,21,35-39,1925,8.483590150333029
STAT,1808,69,na,1877,719.2690378097918
STAT,1901,34,15-19,1935,0.19990269775538633
SIM,1829,51,na,1880,1544
STAT,1830,36,45-49,1866,1.8380455582441826
STAT,1855,21,15-19,1876,2.9220254981278937
SIM,1875,21,40-44,1896,2
STAT,1911,17,40-44,1928,0.28238141484130563
SIM,1837,24,25-29,1861,58
STAT,1934,23,50-100,1957,0.8931952105074473
SIM,1903,23,35-39,1926,12
SIM,1910,20,20-24,1930,96
STAT,1815,46,20-24,1861,0.02707448609528428
STAT,1841,54,20-24,1895,5.366519742561723E-4
STAT,1857,18,na,1875,2114.106762961267
SIM,1869,16,na,1885,2450
STAT,1849,36,45-49,1885,1.6115206522721894
STAT,1814,101,na,1915,0.2670862228089567
SIM,1799,59,na,1858,1179
SIM,1921,36,35-39,1957,6
STAT,1880,58,na,1938,2097.6584075820265
STAT,1924,47,15-19,1971,4.4315922504085465E-4
SIM,1825,92,na,1917,11
STAT,1896,15,25-29,1911,7.61116846389224
SIM,1900,34,20-24,1934,4
SIM,1942,26,25-29,1968,88
STAT,1917,3,na,1920,4391.322217223882
STAT,1847,20,25-29,1867,53.30726572939877
STAT,1910,32,15-19,1942,0.12500967669535762
STAT,1826,30,35-39,1856,16.19138792448074
STAT,1921,46,35-39,1967,0.14715984106801225
SIM,1834,23,45-49,1857,2
SIM,1851,20,40-44,1871,5
STAT,1912,20,30-34,1932,27.955276233146073
SIM,1895,17,25-29,1912,8
STAT,1774,83,na,1857,82.15997895533499
STAT,1852,39,na,1891,1768.7712265946943
STAT,1815,62,na,1877,964.5893934724564
STAT,1859,25,50-100,1884,0.5362879162968489
SIM,1908,38,40-44,1946,2
STAT,1854,18,25-29,1872,5.057403087746685
STAT,1893,32,na,1925,3060.3042710796544
STAT,1917,29,30-34,1946,41.18083649859662
STAT,1853,56,na,1909,1686.7294627299348
STAT,1887,24,50-100,1911,0.4569645037726522
STAT,1923,16,na,1939,4377.718805665127
STAT,1924,32,15-19,1956,0.15149880398416796
SIM,1906,13,na,1919,3693
STAT,1901,19,25-29,1920,7.980252424677705
SIM,1930,34,35-39,1964,18
STAT,1938,19,20-24,1957,134.9219272622639
SIM,1865,57,na,1922,1785
STAT,1840,93,na,1933,20.486640226657457
STAT,1948,19,30-34,1967,14.08162607459075
STAT,1902,40,15-19,1942,0.0013825288442577911
STAT,1897,46,na,1943,3055.6340625514445
STAT,1930,33,30-34,1963,20.537913587300757
STAT,1824,39,25-29,1863,3.758693373368869
STAT,1871,37,45-49,1908,2.0003128198742184
STAT,1896,22,15-19,1918,4.410535168507434
STAT,1798,65,na,1863,953.7819106969116
STAT,1913,36,35-39,1949,2.419957018165521
STAT,1768,99,na,1867,0.6060887971323081
STAT,1850,47,25-29,1897,0.0438994950806154
SIM,1855,20,25-29,1875,67
STAT,1830,54,45-49,1884,0.010260424885072908
SIM,1847,60,na,1907,1345
SIM,1878,25,25-29,1903,61
STAT,1921,39,45-49,1960,0.767153031568014
SIM,1867,68,na,1935,1332
SIM,1926,29,45-49,1955,2
STAT,1810,63,na,1873,1076.1385011533623
STAT,1914,33,45-49,1947,1.5913886181054786
STAT,1768,111,na,1879,0.0021719175991660976
STAT,1846,23,15-19,1869,3.0668916751125
SIM,1946,19,20-24,1965,174
STAT,1887,48,na,1935,2505.1460397967703
SIM,1805,92,na,1897,14
STAT,1916,37,15-19,1953,0.019845608189674516
SIM,1925,31,50-100,1956,1
STAT,1904,47,45-49,1951,0.19205237545512943
SIM,1899,46,na,1945,3406
STAT,1831,54,50-100,1885,0.009539184031197578
SIM,1926,36,35-39,1962,12
STAT,1772,105,na,1877,0.014857326249476437
STAT,1764,115,na,1879,1.001074038404367E-4
SIM,1936,22,35-39,1958,18
STAT,1817,73,na,1890,543.423367074436
STAT,1860,15,45-49,1875,0.06294012764726288
STAT,1908,46,50-100,1954,0.2080411010461594
STAT,1876,84,na,1960,491.76967462476085
STAT,1934,33,15-19,1967,0.17717211782233203
STAT,1918,29,45-49,1947,1.842893020242744
SIM,1956,15,15-19,1971,57
STAT,1843,20,40-44,1863,1.7897509375886398
STAT,1917,31,50-100,1948,0.8774836006922391
SIM,1854,23,15-19,1877,4
SIM,1901,24,15-19,1925,5
STAT,1784,93,na,1877,5.841045573990906
SIM,1884,16,na,1900,2527
STAT,1928,22,35-39,1950,11.882769227905314
SIM,1867,22,45-49,1889,1
SIM,1832,39,25-29,1871,2
STAT,1943,19,30-34,1962,13.04222554862219
SIM,1883,86,na,1969,612
STAT,1921,31,35-39,1952,10.313051792581327
STAT,1852,20,35-39,1872,5.333700232839914
SIM,1912,21,35-39,1933,11
STAT,1891,48,25-29,1939,0.040119021249343904
STAT,1916,46,25-29,1962,0.05504290374342338
SIM,1902,21,25-29,1923,87
SIM,1925,16,na,1941,4506
SIM,1833,56,na,1889,1506
STAT,1867,32,45-49,1899,1.6587619004067684
SIM,1835,27,na,1862,1662
SIM,1857,36,45-49,1893,4
SIM,1918,26,35-39,1944,21
SIM,1846,43,na,1889,1602
SIM,1901,28,30-34,1929,52
SIM,1933,33,20-24,1966,1
SIM,1838,46,50-100,1884,3
STAT,1832,49,25-29,1881,0.04125172144525979
STAT,1907,35,50-100,1942,0.3967845197241494
STAT,1918,36,35-39,1954,2.586205920354205
STAT,1908,36,25-29,1944,0.935055335877942
STAT,1841,36,20-24,1877,0.6862628902132725
STAT,1831,88,na,1919,86.26907774185806
SIM,1922,33,45-49,1955,2
STAT,1828,80,na,1908,401.5662125692701
STAT,1834,21,na,1855,1713.8589175398113
SIM,1888,74,na,1962,1782
STAT,1829,31,15-19,1860,0.1301870899873899
STAT,1851,33,50-100,1884,0.7146309805575163
SIM,1917,32,25-29,1949,15
STAT,1901,27,25-29,1928,59.89278142754103
STAT,1932,39,20-24,1971,0.35717109461072316
STAT,1872,24,50-100,1896,0.411486692694767
STAT,1871,54,35-39,1925,0.00840098429319638
STAT,1818,90,na,1908,40.61919499070714
STAT,1918,25,30-34,1943,42.38367695631958
STAT,1877,18,20-24,1895,18.432215281934123
SIM,1817,62,na,1879,1151
SIM,1921,28,50-100,1949,1
SIM,1896,20,15-19,1916,6
STAT,1895,19,25-29,1914,7.43412463342724
SIM,1810,83,na,1893,324
SIM,1893,1,na,1894,3472
STAT,1913,28,50-100,1941,0.997144307450232
STAT,1855,27,50-100,1882,0.5018936568995227
SIM,1847,48,na,1895,1653
SIM,1876,29,na,1905,2850
STAT,1828,28,25-29,1856,67.97820848684795
STAT,1926,28,40-44,1954,5.627212462693568
SIM,1836,28,25-29,1864,10
SIM,1934,28,40-44,1962,10
STAT,1850,29,25-29,1879,37.57207486000061
STAT,1886,74,na,1960,1344.0317031152758
STAT,1922,42,35-39,1964,0.23349288592164613
STAT,1833,36,na,1869,1913.938213715129
STAT,1879,15,25-29,1894,6.000480958083512
STAT,1882,60,na,1942,1865.884592247645
STAT,1924,28,50-100,1952,1.1669767931769277
STAT,1901,26,15-19,1927,0.6445825887054493
SIM,1870,24,na,1894,2499
STAT,1849,15,40-44,1864,0.1781177292564418
STAT,1888,20,15-19,1908,3.9562704378115003
SIM,1876,40,50-100,1916,7
STAT,1869,51,na,1920,2124.4375186951993
STAT,1828,89,na,1917,68.19624610987506
STAT,1870,0,na,1870,3702.3375808837072
SIM,1896,35,50-100,1931,9
STAT,1875,23,40-44,1898,2.1546843535738747
STAT,1927,30,na,1957,4707.683167623842
SIM,1871,41,na,1912,2221
STAT,1904,36,40-44,1940,1.3760682366540287
SIM,1918,34,35-39,1952,14
STAT,1944,16,40-44,1960,1.5204157372794467
STAT,1948,15,15-19,1963,52.493936980362534
STAT,1924,37,20-24,1961,0.31410925724233524
SIM,1952,16,40-44,1968,1
SIM,1914,16,20-24,1930,36
STAT,1856,47,20-24,1903,0.00924883494731455
STAT,1898,1,na,1899,3726.803452300428
STAT,1826,34,na,1860,1573.14456307961
STAT,1869,19,25-29,1888,5.575284820454211
STAT,1936,17,45-49,1953,0.48283493059446714
STAT,1909,32,25-29,1941,8.900227815124941
SIM,1932,28,50-100,1960,1
SIM,1845,23,20-24,1868,92
STAT,1920,44,25-29,1964,0.07937769788986472
SIM,1925,31,20-24,1956,4
STAT,1967,2,na,1969,4963.67053033561
SIM,1824,75,na,1899,550
STAT,1869,26,20-24,1895,11.559331105903704
STAT,1820,39,40-44,1859,9.284588347666336
STAT,1940,30,35-39,1970,9.559001923175181
STAT,1837,22,50-100,1859,0.3641864736834552
STAT,1837,23,20-24,1860,61.101980709637104
SIM,1876,73,na,1949,1198
STAT,1906,16,20-24,1922,26.14455841389057
STAT,1867,31,35-39,1898,9.672454100124611
STAT,1896,0,na,1896,3925.650521523405
SIM,1922,32,35-39,1954,18
STAT,1846,47,50-100,1893,0.1855132039371969
SIM,1926,18,40-44,1944,2
STAT,1902,30,15-19,1932,0.20488655929682437
SIM,1969,0,na,1969,5015
STAT,1843,108,na,1951,0.0012354385701367743
STAT,1923,18,15-19,1941,53.703424877848704
SIM,1899,30,40-44,1929,10
STAT,1869,82,na,1951,458.1645786536645
SIM,1941,10,na,1951,4262
SIM,1945,24,na,1969,3906
STAT,1934,26,25-29,1960,89.50802399460399
SIM,1911,25,35-39,1936,25
SIM,1907,3,na,1910,4141
STAT,1916,45,15-19,1961,3.830886947198358E-4
STAT,1780,79,na,1859,235.32736857828797
STAT,1845,47,45-49,1892,0.17163797342037343
SIM,1869,27,25-29,1896,50
SIM,1889,40,25-29,1929,3
STAT,1940,28,na,1968,3854.6980197630837
SIM,1931,18,15-19,1949,1
STAT,1939,31,na,1970,3897.9438222806716
STAT,1779,82,na,1861,185.12095087775282
STAT,1869,19,na,1888,2484.8505891005143
STAT,1791,95,na,1886,2.3977315778831993
SIM,1890,37,20-24,1927,1
STAT,1846,54,na,1900,1589.0723135210185
STAT,1886,48,45-49,1934,0.24850652140498405
SIM,1912,36,40-44,1948,2
STAT,1863,21,20-24,1884,63.35295819647401
STAT,1910,22,20-24,1932,105.35253564114433
STAT,1903,25,35-39,1928,13.973307318549384
SIM,1849,34,45-49,1883,2
STAT,1914,32,35-39,1946,9.28098965869922
SIM,1825,30,40-44,1855,7
STAT,1862,92,na,1954,36.32746435238749
SIM,1852,39,na,1891,1749
STAT,1858,55,na,1913,1638.4284871002942
SIM,1938,27,15-19,1965,1
SIM,1926,25,30-34,1951,58
STAT,1830,53,35-39,1883,0.006208490133809799
STAT,1888,35,50-100,1923,1.4775065388905688
SIM,1918,14,na,1932,4475
SIM,1820,48,45-49,1868,3
STAT,1834,25,45-49,1859,0.8796752080742116
STAT,1884,21,40-44,1905,2.0817291940393403
SIM,1782,79,na,1861,97
SIM,1839,41,na,1880,1629
SIM,1934,35,30-34,1969,3
SIM,1837,93,na,1930,31
STAT,1803,61,na,1864,1165.6409335185633
STAT,1933,0,na,1933,6094.192203315245
STAT,1903,18,45-49,1921,0.09371458019168336
SIM,1841,75,na,1916,598
STAT,1926,35,30-34,1961,2.2550750157660593
SIM,1853,56,na,1909,1531
STAT,1906,49,20-24,1955,0.009749985547148938
SIM,1827,60,na,1887,1080
STAT,1904,43,30-34,1947,0.114878917037968
SIM,1840,58,na,1898,1392
SIM,1842,25,45-49,1867,1
SIM,1906,33,na,1939,3400
STAT,1903,43,35-39,1946,0.17956900625896302
SIM,1872,91,na,1963,61
STAT,1908,33,20-24,1941,2.314346370293801
SIM,1902,51,na,1953,3236
STAT,1808,60,na,1868,1006.0778507831261
STAT,1852,21,45-49,1873,0.6327842074251896
STAT,1838,18,40-44,1856,0.16077712833939214
STAT,1824,54,20-24,1878,7.999440168220431E-4
SIM,1920,23,35-39,1943,1
STAT,1841,78,na,1919,584.2919600371257
SIM,1828,34,na,1862,1687
STAT,1905,32,40-44,1937,3.6358489799949867
STAT,1837,31,20-24,1868,2.3362062465850038
SIM,1879,24,30-34,1903,30
SIM,1934,24,25-29,1958,148
STAT,1837,33,15-19,1870,0.1205507455500233
STAT,1870,68,na,1938,1515.6483586086595
SIM,1807,63,na,1870,879
STAT,1834,30,40-44,1864,3.377703281572206
STAT,1909,39,45-49,1948,0.644587839266419
STAT,1878,27,25-29,1905,44.35112657719681
STAT,1877,90,na,1967,231.51324239753092
SIM,1887,68,na,1955,1571
STAT,1935,17,30-34,1952,16.83503198498619
SIM,1858,40,45-49,1898,2
STAT,1926,24,25-29,1950,112.7045292327261
SIM,1914,7,na,1921,4372
SIM,1858,55,na,1913,1658
SIM,1913,32,40-44,1945,10
STAT,1935,36,35-39,1971,3.4202439148761257
SIM,1904,36,35-39,1940,7
STAT,1821,53,40-44,1874,0.01454868704555252
STAT,1943,21,20-24,1964,119.49279970047921
SIM,1930,31,30-34,1961,9
STAT,1871,47,45-49,1918,0.235704101612257
SIM,1917,39,45-49,1956,1
STAT,1931,18,20-24,1949,178.87471848303878
STAT,1847,49,20-24,1896,0.008797247976218121
SIM,1850,49,50-100,1899,2
STAT,1844,48,40-44,1892,0.13374879160759495
SIM,1871,21,20-24,1892,4
STAT,1950,19,20-24,1969,161.85100632317642
SIM,1891,50,na,1941,2789
STAT,1917,45,30-34,1962,0.09442995568081845
STAT,1915,24,15-19,1939,5.517576167498829
SIM,1895,64,na,1959,2341
STAT,1912,23,35-39,1935,9.075972939785569
STAT,1836,49,45-49,1885,0.1518637765013567
STAT,1918,18,40-44,1936,1.5329645667661913
SIM,1847,17,na,1864,2160
STAT,1836,108,na,1944,0.0011549456682315256
STAT,1922,31,30-34,1953,18.05700033457767
SIM,1900,37,25-29,1937,1
SIM,1905,26,50-100,1931,4
SIM,1839,20,40-44,1859,4
STAT,1864,20,25-29,1884,53.7814286847153
STAT,1929,37,20-24,1966,0.3420665271793712
STAT,1945,27,na,1972,4150.574313349796
STAT,1910,16,15-19,1926,9.094947629059483
SIM,1877,19,25-29,1896,10
STAT,1891,45,20-24,1936,0.008548873678983174
SIM,1845,26,na,1871,2121
SIM,1809,75,na,1884,404
STAT,1912,41,35-39,1953,0.19706869045100703
STAT,1854,16,50-100,1870,0.04424359178698655
STAT,1923,23,45-49,1946,1.3187001850535562
SIM,1805,61,na,1866,909
SIM,1916,33,20-24,1949,2
SIM,1923,36,na,1959,4454
STAT,1805,49,15-19,1854,0.001668734281291498
STAT,1920,40,30-34,1960,0.14298188780921076
SIM,1918,1,na,1919,4649
STAT,1891,45,50-100,1936,0.17496694103578986
STAT,1783,99,na,1882,0.3752218856392218
STAT,1912,49,45-49,1961,0.20949548811341076
SIM,1916,32,50-100,1948,1
SIM,1815,82,na,1897,213
STAT,1944,27,45-49,1971,1.8855175982860428
STAT,1826,31,45-49,1857,2.5999891431814115
STAT,1903,44,25-29,1947,0.0632769271843691
SIM,1939,15,15-19,1954,58
SIM,1845,26,25-29,1871,39
SIM,1866,83,na,1949,382
STAT,1839,21,30-34,1860,16.343374502482412
SIM,1849,23,40-44,1872,2
SIM,1929,19,20-24,1948,172
STAT,1860,20,40-44,1880,1.9772317993438626
STAT,1940,16,20-24,1956,139.00913639435146
STAT,1863,23,15-19,1886,2.989478572150191
STAT,1891,27,20-24,1918,14.669923986791693
STAT,1911,42,30-34,1953,0.12310486027512337
STAT,1829,54,na,1883,1287.9458021351045
STAT,1869,102,na,1971,2.7921822183208
SIM,1892,41,50-100,1933,4
STAT,1850,44,20-24,1894,0.11996388890812405
STAT,1944,15,30-34,1959,13.25264977341127
SIM,1943,22,25-29,1965,110
SIM,1823,89,na,1912,67
SIM,1838,55,na,1893,1497
STAT,1813,54,45-49,1867,0.03854560643525623
STAT,1934,23,20-24,1957,150.94104262634397
STAT,1924,42,na,1966,4464.0129812971545
STAT,1931,22,40-44,1953,4.407344092525039
STAT,1915,42,15-19,1957,0.0015600841054526336
STAT,1847,16,40-44,1863,0.17193515920797442
SIM,1796,62,na,1858,1043
STAT,1819,35,20-24,1854,2.7270796262354104
STAT,1824,36,20-24,1860,1.1085192368333079
STAT,1858,35,na,1893,1884.574348721688
STAT,1876,18,50-100,1894,0.05095697695156834
SIM,1841,23,na,1864,1993
SIM,1932,29,20-24,1961,28
STAT,1923,30,35-39,1953,10.670172097988837
STAT,1860,48,25-29,1908,0.046958545382128715
STAT,1924,29,20-24,1953,21.323528067150843
STAT,1854,21,na,1875,1899.0261075882163
STAT,1921,47,50-100,1968,0.25752016831111174
SIM,1899,22,40-44,1921,4
STAT,1880,45,45-49,1925,0.2528233368679501
SIM,1816,45,50-100,1861,3
STAT,1886,26,20-24,1912,12.553269718475933
SIM,1952,15,30-34,1967,23
STAT,1831,39,15-19,1870,0.04391584270261892
SIM,1845,37,na,1882,1965
STAT,1870,17,50-100,1887,0.049052433779649345
STAT,1934,25,15-19,1959,0.9604188314054612
STAT,1927,18,35-39,1945,5.259647762623262
SIM,1870,36,40-44,1906,5
SIM,1942,23,20-24,1965,145
SIM,1832,31,50-100,1863,5
SIM,1904,65,na,1969,2942
STAT,1889,15,35-39,1904,0.6865341671719374
STAT,1837,26,25-29,1863,37.30794582993446
SIM,1834,31,45-49,1865,1
STAT,1872,50,35-39,1922,0.008867442121049365
STAT,1844,11,na,1855,2411.86803
STAT,1935,22,25-29,1957,127.08396893205958
STAT,1848,25,na,1873,2139.1412100074026
STAT,1959,9,na,1968,5191.743121624476
SIM,1837,70,na,1907,806
SIM,1848,8,na,1856,2288
SIM,1871,23,15-19,1894,3
STAT,1871,18,25-29,1889,5.689148025617168
SIM,1879,49,na,1928,2589
STAT,1902,27,40-44,1929,4.275448699441398
STAT,1933,29,15-19,1962,0.9462800931631972
SIM,1917,28,na,1945,3770
SIM,1877,29,25-29,1906,53
STAT,1862,54,40-44,1916,0.008929918876333981
SIM,1894,26,20-24,1920,2
SIM,1904,34,40-44,1938,5
STAT,1923,19,25-29,1942,51.13880553004574
STAT,1909,27,30-34,1936,37.78723174305829
STAT,1847,105,na,1952,0.02195347208434552
SIM,1809,74,na,1883,404
SIM,1917,27,30-34,1944,47
SIM,1820,37,40-44,1857,2
SIM,1834,41,na,1875,1840
STAT,1838,30,25-29,1868,8.698909486129352
SIM,1878,30,20-24,1908,5
SIM,1847,21,30-34,1868,27
SIM,1931,30,35-39,1961,16
SIM,1902,32,30-34,1934,43
SIM,1794,71,na,1865,633
STAT,1860,69,na,1929,1211.6427935829602
SIM,1941,29,15-19,1970,3
SIM,1845,31,20-24,1876,2
SIM,1837,18,na,1855,1925
SIM,1931,19,25-29,1950,58
STAT,1880,27,45-49,1907,1.1777101767275462
SIM,1930,26,35-39,1956,25
SIM,1913,28,20-24,1941,20
STAT,1942,27,15-19,1969,0.7480949528565165
SIM,1904,29,45-49,1933,4
SIM,1928,43,40-44,1971,1
SIM,1886,32,20-24,1918,4
SIM,1853,25,20-24,1878,15
SIM,1857,41,40-44,1898,4
STAT,1827,63,na,1890,1061.0520677667214
STAT,1888,21,25-29,1909,68.44919442773303
STAT,1936,16,35-39,1952,4.065775317968359
STAT,1868,15,15-19,1883,5.901604379364338
STAT,1899,26,na,1925,3319.436094827115
SIM,1925,27,na,1952,4638
STAT,1919,16,35-39,1935,0.9416446679413987
SIM,1927,16,35-39,1943,10
STAT,1878,32,20-24,1910,2.834034839486012
STAT,1762,115,na,1877,1.246564358634833E-4
STAT,1911,24,30-34,1935,27.32797348895289
STAT,1900,36,20-24,1936,0.23455787513052706
STAT,1799,91,na,1890,19.445652517433256
SIM,1846,30,25-29,1876,16
STAT,1942,25,20-24,1967,19.360437833413535
STAT,1888,17,40-44,1905,0.21804087244778378
SIM,1910,27,40-44,1937,6
STAT,1769,101,na,1870,0.10775880823578013
STAT,1914,32,na,1946,3841.077634304579
STAT,1926,13,na,1939,4902.134814055407
STAT,1918,46,na,1964,3956.7204138599986
STAT,1878,34,15-19,1912,0.14802968972142885
SIM,1914,30,35-39,1944,14
STAT,1867,91,na,1958,78.93761337687015
STAT,1925,27,15-19,1952,0.8426628736915551
STAT,1884,72,na,1956,1290.5681900748382
SIM,1902,25,40-44,1927,5
SIM,1933,27,15-19,1960,1
STAT,1905,28,20-24,1933,17.068757891057047
STAT,1907,39,15-19,1946,0.017796482389786098
STAT,1850,26,20-24,1876,10.647567789568887
SIM,1913,46,na,1959,3578
SIM,1896,21,25-29,1917,82
STAT,1785,78,na,1863,299.23279721087437
SIM,1908,34,25-29,1942,11
STAT,1893,22,45-49,1915,0.8942741081627595
STAT,1909,32,na,1941,3641.9431652376247
STAT,1810,94,na,1904,10.379972465731212
SIM,1935,18,35-39,1953,7
STAT,1887,30,20-24,1917,3.0725942455019526
SIM,1864,17,na,1881,2784
STAT,1858,24,na,1882,1928.6744343116472
SIM,1874,61,na,1935,1719
SIM,1878,75,na,1953,1076
STAT,1935,29,45-49,1964,2.3769436794841465
STAT,1878,32,na,1910,2501.9392097175523
STAT,1849,41,40-44,1890,1.76656008548398
SIM,1858,17,20-24,1875,19
STAT,1897,48,20-24,1945,0.009050457114015913
STAT,1797,80,na,1877,263.87594632903176
STAT,1859,72,na,1931,1025.8944598146875
SIM,1944,16,35-39,1960,5
STAT,1877,47,40-44,1924,0.17763086893790353
STAT,1907,53,na,1960,3234.6004061796552
STAT,1890,2,na,1892,3289.8530789852507
SIM,1890,24,na,1914,3162
STAT,1847,23,30-34,1870,16.23212388913382
SIM,1836,39,50-100,1875,1
SIM,1829,30,25-29,1859,6
STAT,1876,53,na,1929,2209.363173190242
STAT,1790,78,na,1868,265.94217883679624
STAT,1902,34,30-34,1936,14.186304277252606
SIM,1879,20,15-19,1899,2
STAT,1863,45,45-49,1908,0.21329949851036256
STAT,1898,31,na,1929,3280.710506759726
SIM,1874,33,50-100,1907,1
SIM,1869,24,20-24,1893,84
STAT,1920,48,40-44,1968,0.1755067626071921
STAT,1839,21,na,1860,1961.804826545126
STAT,1920,15,40-44,1935,0.31941603699121673
STAT,1943,22,50-100,1965,0.7068665585934265
STAT,1880,52,35-39,1932,0.009083106622139398
STAT,1909,43,30-34,1952,0.11994273694658295
SIM,1943,17,30-34,1960,20
SIM,1814,42,na,1856,1415
SIM,1854,62,na,1916,1650
SIM,1881,40,na,1921,2039
STAT,1847,40,na,1887,1785.3273482812351
STAT,1818,53,50-100,1871,0.02532043957161908
SIM,1908,24,na,1932,3392
STAT,1898,52,na,1950,2932.522006756023
SIM,1905,29,25-29,1934,77
STAT,1879,31,25-29,1910,10.839821219917908
STAT,1885,13,na,1898,2592.269592711448
SIM,1885,54,na,1939,2208
STAT,1790,103,na,1893,0.02650112286288812
SIM,1849,42,45-49,1891,2
STAT,1904,28,40-44,1932,4.326543417136465
SIM,1869,2,na,1871,2985
STAT,1920,22,30-34,1942,32.26648268721555
STAT,1896,20,20-24,1916,92.68027763192438
STAT,1936,21,30-34,1957,27.75012535319249
STAT,1947,20,50-100,1967,0.7516890379937334
STAT,1898,44,40-44,1942,0.2109759003251931
SIM,1889,16,na,1905,3135
STAT,1811,45,25-29,1856,0.1482866531286917
SIM,1858,21,40-44,1879,2
SIM,1839,22,35-39,1861,6
STAT,1821,78,na,1899,468.01198398871907
STAT,1879,72,na,1951,1331.0910063305837
STAT,1887,24,15-19,1911,3.696842409928692
STAT,1915,21,45-49,1936,1.177151774477482
STAT,1845,25,20-24,1870,10.585119503696859
STAT,1826,78,na,1904,428.73318103844053
SIM,1895,24,15-19,1919,6
STAT,1827,40,na,1867,1634.703122339769
STAT,1925,8,na,1933,4869.127230060542
SIM,1906,2,na,1908,3784
STAT,1926,31,15-19,1957,0.15713257051733104
SIM,1901,14,na,1915,3747
STAT,1891,21,na,1912,2966.370476982377
SIM,1838,23,30-34,1861,22
SIM,1909,28,35-39,1937,22
STAT,1922,31,na,1953,4334.618030768683
SIM,1881,51,na,1932,1922
STAT,1906,13,na,1919,3793.249496100175
SIM,1819,36,25-29,1855,2
SIM,1877,35,na,1912,2478
STAT,1832,38,20-24,1870,0.6581451613401419
STAT,1863,52,35-39,1915,0.007663145781634886
STAT,1813,59,na,1872,1089.7365094685626
STAT,1916,35,20-24,1951,0.27501330491237974
SIM,1886,27,25-29,1913,52
SIM,1958,11,na,1969,5244
STAT,1914,43,na,1957,3707.129801209798
STAT,1862,108,na,1970,0.023846884779642204
STAT,1821,35,40-44,1856,9.579590867149683
SIM,1860,44,50-100,1904,3
STAT,1899,24,40-44,1923,2.870393134532184
STAT,1935,33,30-34,1968,22.008733135977934
SIM,1881,39,20-24,1920,1
SIM,1941,19,20-24,1960,3
SIM,1920,17,na,1937,4425
STAT,1789,92,na,1881,14.049945494596804
SIM,1935,27,45-49,1962,2
STAT,1896,20,na,1916,3180.749222899461
STAT,1890,48,50-100,1938,0.16883086589806098
STAT,1901,69,na,1970,2446.736806970796
STAT,1876,21,35-39,1897,6.103861829097916
STAT,1889,45,50-100,1934,0.30891819422823413
SIM,1902,16,30-34,1918,2
SIM,1934,21,20-24,1955,9
STAT,1836,46,40-44,1882,0.11448224342797149
STAT,1839,47,20-24,1886,0.008668220339484483
STAT,1849,104,na,1953,0.05214962006634406
SIM,1858,24,45-49,1882,6
SIM,1944,21,30-34,1965,33
SIM,1875,30,50-100,1905,2
SIM,1847,24,35-39,1871,8
STAT,1931,35,na,1966,5044.327128511809
SIM,1862,37,45-49,1899,2
STAT,1905,35,45-49,1940,0.634211911894085
SIM,1820,38,na,1858,1526
SIM,1887,31,25-29,1918,3
SIM,1921,34,40-44,1955,13
SIM,1893,21,na,1914,2981
STAT,1903,40,30-34,1943,0.11599492254318518
SIM,1873,76,na,1949,842
STAT,1833,30,50-100,1863,0.8552501734004262
STAT,1842,40,na,1882,2208.783580594258
SIM,1843,55,na,1898,1891
STAT,1900,46,15-19,1946,3.1746457563294175E-4
STAT,1911,20,15-19,1931,5.123705620796323
STAT,1830,50,30-34,1880,0.005006169929474168
STAT,1876,20,na,1896,2481.090040551117
STAT,1902,3,na,1905,3773.164039658874
STAT,1920,43,35-39,1963,0.22422897282577306
SIM,1897,35,na,1932,3253
STAT,1952,17,30-34,1969,14.757798157643403
STAT,1836,88,na,1924,86.56059672389412
STAT,1925,45,50-100,1970,0.27828822018817023
SIM,1897,45,50-100,1942,1
SIM,1902,35,35-39,1937,5
STAT,1832,74,na,1906,755.6818803865385
STAT,1855,18,40-44,1873,0.16278612239317114
STAT,1815,93,na,1908,12.651041315626594
STAT,1889,27,na,1916,2972.162185067012
STAT,1854,37,45-49,1891,1.4960849860848084
SIM,1863,4,na,1867,2765
STAT,1793,66,na,1859,747.7527189497131
STAT,1842,32,40-44,1874,4.716728510980097
STAT,1873,39,20-24,1912,0.7813358047190222
SIM,1916,43,na,1959,3788
SIM,1910,34,30-34,1944,19
SIM,1862,69,na,1931,1267
STAT,1919,42,na,1961,4063.663589331306
STAT,1834,22,na,1856,1701.9442023725078
SIM,1863,55,na,1918,1838
SIM,1867,69,na,1936,1245
STAT,1909,36,40-44,1945,1.4367248123952354
STAT,1862,39,45-49,1901,1.7212597369066267
STAT,1920,28,na,1948,4135.242043241864
STAT,1922,19,45-49,1941,0.5809080587446147
SIM,1827,38,25-29,1865,2
STAT,1881,15,30-34,1896,1.5589458271917753
STAT,1855,50,35-39,1905,0.006573341756675293
STAT,1871,15,20-24,1886,18.116915797050392
STAT,1854,31,20-24,1885,2.0991020874810706
STAT,1908,9,na,1917,3885.279021373734
STAT,1914,39,50-100,1953,0.4186933547720676
STAT,1812,74,na,1886,518.2722062559947
STAT,1943,24,25-29,1967,99.16245224732565
STAT,1839,24,35-39,1863,5.239746602174115
SIM,1894,29,25-29,1923,67
STAT,1804,53,40-44,1857,0.027940148505632617
STAT,1889,71,na,1960,1817.8293063084734
STAT,1911,19,35-39,1930,0.8426011348195023
SIM,1907,39,na,1946,3729
STAT,1868,4,na,1872,2878.5525649144447
STAT,1933,38,25-29,1971,1.3538375850823174
SIM,1870,39,45-49,1909,2
STAT,1768,112,na,1880,0.0013610756018694185
SIM,1859,21,20-24,1880,82
STAT,1930,18,40-44,1948,1.8229239929226246
STAT,1931,32,35-39,1963,12.101784082371411
STAT,1921,32,25-29,1953,10.38825899885969
STAT,1907,29,20-24,1936,17.130638939705207
STAT,1927,15,30-34,1942,15.389328701095941
SIM,1917,36,40-44,1953,2
SIM,1920,48,50-100,1968,1
STAT,1871,44,40-44,1915,2.2265128661502147
SIM,1918,24,40-44,1942,3
STAT,1889,16,na,1905,3153.100305182423
SIM,1873,21,na,1894,2324
STAT,1886,29,25-29,1915,44.787529913594604
STAT,1931,25,45-49,1956,2.2561368900524195
SIM,1824,42,40-44,1866,4
SIM,1908,31,20-24,1939,2
STAT,1819,38,25-29,1857,7.581601802322582
STAT,1815,47,50-100,1862,0.5449306967269453
SIM,1823,47,50-100,1870,1
SIM,1918,31,30-34,1949,10
STAT,1903,48,40-44,1951,0.1371636919837322
SIM,1888,25,35-39,1913,20
STAT,1926,19,50-100,1945,0.4617551335402179
SIM,1882,80,na,1962,621
STAT,1817,74,na,1891,507.7530572596696
SIM,1901,22,20-24,1923,98
STAT,1806,48,20-24,1854,0.035647771431696444
STAT,1847,19,45-49,1866,0.060326743968382675
STAT,1883,33,40-44,1916,4.268198144053719
SIM,1911,22,30-34,1933,37
STAT,1831,89,na,1920,66.01568636040203
STAT,1925,27,na,1952,4471.6036007264465
STAT,1872,39,na,1911,2368.2309053397958
STAT,1923,16,20-24,1939,161.24697133816343
SIM,1875,87,na,1962,196
STAT,1938,34,45-49,1972,1.5952605760716363
SIM,1784,82,na,1866,106
SIM,1862,31,20-24,1893,1
SIM,1878,20,na,1898,2762
SIM,1926,22,25-29,1948,5
STAT,1828,41,20-24,1869,0.15424636593628782
STAT,1838,99,na,1937,1.267804732169311
STAT,1913,34,40-44,1947,3.894746113651804
SIM,1866,23,40-44,1889,2
STAT,1813,60,na,1873,1068.366776517883
SIM,1816,56,na,1872,1150
SIM,1868,39,25-29,1907,1
STAT,1902,54,na,1956,3008.9630238662335
SIM,1931,16,20-24,1947,188
SIM,1841,44,na,1885,1595
SIM,1943,26,40-44,1969,8
STAT,1870,38,40-44,1908,4.320021702957584
STAT,1918,22,25-29,1940,100.57643310410036
STAT,1895,38,50-100,1933,1.6113157736020358
STAT,1789,81,na,1870,251.72740676442237
STAT,1933,19,20-24,1952,182.41210648992993
STAT,1816,42,40-44,1858,6.4535441039364505
SIM,1877,26,20-24,1903,15
SIM,1938,32,45-49,1970,2
SIM,1899,18,20-24,1917,36
STAT,1893,47,25-29,1940,0.04147379955332911
SIM,1933,35,na,1968,4889
STAT,1802,75,na,1877,418.662236724094
SIM,1856,20,40-44,1876,2
STAT,1953,17,45-49,1970,0.6105384084433689
SIM,1927,39,40-44,1966,7
SIM,1846,22,na,1868,1892
STAT,1871,51,30-34,1922,0.00600151047474405
SIM,1892,35,na,1927,3309
SIM,1952,18,35-39,1970,8
STAT,1912,16,45-49,1928,0.10216186377086219
STAT,1913,41,30-34,1954,0.12651583683387124
SIM,1896,49,na,1945,2907
STAT,1944,18,35-39,1962,4.558510608266643
SIM,1891,33,40-44,1924,7
STAT,1873,87,na,1960,280.94286647285355
STAT,1915,47,20-24,1962,0.011236612531804207
SIM,1825,37,na,1862,1474
SIM,1871,10,na,1881,2596
STAT,1925,47,30-34,1972,0.10916981596600435
SIM,1886,28,na,1914,2681
STAT,1919,39,40-44,1958,1.6203344925535554
STAT,1836,33,na,1869,1709.382096146244
STAT,1848,20,40-44,1868,2.1016307515022503
STAT,1872,22,25-29,1894,58.12838970877922
SIM,1863,25,30-34,1888,40
SIM,1883,31,40-44,1914,7
STAT,1941,5,na,1946,4157.111563757047
STAT,1849,10,na,1859,2326.260123194358
STAT,1885,20,45-49,1905,0.7052265094063294
SIM,1868,54,na,1922,1941
STAT,1922,26,35-39,1948,17.221460851723034
STAT,1819,44,na,1863,1408.6358557719943
STAT,1939,17,15-19,1956,45.86062538839485
STAT,1845,28,25-29,1873,37.35171357956232
STAT,1943,28,40-44,1971,5.009903080916191
SIM,1838,88,na,1926,73
STAT,1861,18,50-100,1879,0.04698191899323643
SIM,1868,18,20-24,1886,24
SIM,1856,73,na,1929,1030
STAT,1901,24,20-24,1925,96.95946032350808
SIM,1894,39,50-100,1933,4
SIM,1832,30,na,1862,1752
STAT,1871,21,na,1892,2380.311763989308
STAT,1910,36,30-34,1946,1.767093281671539
STAT,1870,80,na,1950,613.5165276208479
SIM,1883,44,50-100,1927,1
STAT,1857,43,40-44,1900,1.760171323312092
STAT,1903,42,50-100,1945,0.10539522308142217
SIM,1869,39,na,1908,2288
STAT,1890,35,na,1925,2935.269084425929
SIM,1947,17,15-19,1964,57
STAT,1839,17,45-49,1856,0.06058267130873629
SIM,1921,9,na,1930,4533
STAT,1866,33,50-100,1899,0.8532865558740124
STAT,1885,57,na,1942,2020.3578571483674
STAT,1869,48,45-49,1917,0.22883035474564084
STAT,1882,34,50-100,1916,0.8887319316746916
STAT,1935,26,40-44,1961,6.422164909522749
SIM,1829,29,45-49,1858,1
SIM,1865,43,40-44,1908,5
STAT,1896,19,40-44,1915,0.24321562845462555
SIM,1918,20,25-29,1938,112
STAT,1858,23,40-44,1881,1.7116155026080844
STAT,1875,31,40-44,1906,4.516500343037009
SIM,1870,40,50-100,1910,1
STAT,1921,36,40-44,1957,1.6897249818283544
STAT,1862,40,50-100,1902,0.9307566372060546
SIM,1935,15,30-34,1950,22
SIM,1837,28,40-44,1865,2
SIM,1909,25,30-34,1934,67
SIM,1802,64,na,1866,955
STAT,1899,41,50-100,1940,0.10215125928994893
STAT,1917,25,15-19,1942,0.7523665179822322
STAT,1853,36,na,1889,1968.6742309067445
STAT,1940,19,25-29,1959,44.39053100032592
STAT,1887,33,25-29,1920,11.501290131922032
STAT,1893,53,na,1946,2717.050198275678
SIM,1816,40,40-44,1856,2
STAT,1841,55,na,1896,1546.2662760884195
STAT,1863,16,25-29,1879,5.8208840174720065
STAT,1932,20,na,1952,4871.057560106963
STAT,1936,34,na,1970,3703.9289351906905
STAT,1920,18,45-49,1938,0.5644844548864637
STAT,1818,107,na,1925,0.002429691371321621
STAT,1820,48,50-100,1868,0.4114131452967704
SIM,1871,16,25-29,1887,6
STAT,1829,28,40-44,1857,3.36191440118562
STAT,1861,109,na,1970,0.00886901790980612
STAT,1843,15,45-49,1858,0.05697215293928559
SIM,1872,20,25-29,1892,86
STAT,1909,46,35-39,1955,0.11984780145155169
SIM,1875,32,45-49,1907,2
SIM,1899,25,45-49,1924,1
STAT,1849,51,na,1900,1691.5151087552797
SIM,1884,17,na,1901,2534
SIM,1914,25,50-100,1939,1
STAT,1862,36,40-44,1898,3.8365237783651747
SIM,1856,84,na,1940,126
STAT,1828,47,45-49,1875,0.21501958323513176
STAT,1917,38,40-44,1955,1.561687302908385
SIM,1895,33,25-29,1928,21
STAT,1927,34,35-39,1961,11.347419693956821
STAT,1906,18,15-19,1924,8.7074648106125
SIM,1915,29,20-24,1944,23
STAT,1863,42,40-44,1905,2.0103757803896674
SIM,1819,41,na,1860,1548
STAT,1906,25,50-100,1931,0.9474381163153686
STAT,1885,49,40-44,1934,0.16852021315528642
SIM,1886,50,na,1936,2465
STAT,1852,46,25-29,1898,0.043807400979510025
STAT,1820,93,na,1913,14.876376516735075
STAT,1884,16,45-49,1900,0.06522067914360868
SIM,1789,81,na,1870,172
STAT,1840,27,50-100,1867,0.559109874786164
STAT,1923,49,20-24,1972,0.012985640330874605
SIM,1933,17,20-24,1950,169
STAT,1821,38,45-49,1859,3.6976860457893594
STAT,1910,29,40-44,1939,4.508577691072811
STAT,1857,39,na,1896,1838.394903830638
SIM,1829,74,na,1903,723
STAT,1873,35,50-100,1908,1.2690363723264937
STAT,1846,32,25-29,1878,9.185697405761326
STAT,1912,21,na,1933,3700.92188270855
SIM,1842,30,40-44,1872,11
SIM,1914,18,15-19,1932,13
SIM,1935,34,35-39,1969,16
SIM,1915,17,na,1932,4480
SIM,1925,25,15-19,1950,4
STAT,1853,25,na,1878,2102.5303194712624
STAT,1900,39,25-29,1939,0.8631251719369294
STAT,1811,49,40-44,1860,0.41269740651490483
SIM,1893,20,45-49,1913,4
SIM,1855,36,na,1891,2048
STAT,1926,21,20-24,1947,136.9410453636953
SIM,1832,46,50-100,1878,1
SIM,1914,32,na,1946,3972
SIM,1854,32,25-29,1886,15
STAT,1927,27,45-49,1954,2.122846387267836
SIM,1887,42,50-100,1929,2
SIM,1858,31,35-39,1889,1
SIM,1925,38,40-44,1963,3
SIM,1873,37,20-24,1910,1
STAT,1898,40,25-29,1938,0.06167280265587964
STAT,1895,38,45-49,1933,2.6162944461115583
STAT,1905,42,35-39,1947,0.1833761736125831
STAT,1855,25,30-34,1880,22.026555666499373
STAT,1891,4,na,1895,3289.6176502718454
STAT,1854,73,na,1927,891.3924100936052
SIM,1898,20,na,1918,3440
STAT,1907,48,25-29,1955,0.04758631593366951
STAT,1862,40,na,1902,2036.2515069112594
STAT,1890,68,na,1958,1968.1559202026008
STAT,1866,54,na,1920,1958.3367913790792
STAT,1900,31,15-19,1931,0.20061606222691633
STAT,1920,25,35-39,1945,16.744309114643656
STAT,1824,46,50-100,1870,0.2913686144616241
SIM,1881,35,50-100,1916,2
SIM,1840,37,na,1877,1836
SIM,1853,28,25-29,1881,55
SIM,1904,29,50-100,1933,2
SIM,1903,20,30-34,1923,39
STAT,1919,31,na,1950,4136.722264427219
SIM,1871,42,40-44,1913,11
SIM,1905,26,20-24,1931,18
SIM,1964,6,na,1970,5248
STAT,1795,77,na,1872,394.7426463815076
STAT,1865,37,20-24,1902,0.7109200133855986
STAT,1850,23,50-100,1873,0.3720888176793533
SIM,1880,3,na,1883,2930
STAT,1867,39,na,1906,2218.501891653512
STAT,1915,20,35-39,1935,9.480710647388984
STAT,1918,21,15-19,1939,5.813647641410231
STAT,1840,47,45-49,1887,0.16682606528775748
SIM,1928,35,40-44,1963,2
STAT,1947,24,45-49,1971,1.2836281282144466
SIM,1867,23,20-24,1890,76
STAT,1865,22,35-39,1887,5.447226933201068
STAT,1922,16,40-44,1938,1.639329163817623
STAT,1819,46,40-44,1865,0.3386353528262649
SIM,1854,47,50-100,1901,2
STAT,1827,45,20-24,1872,0.012639152543643941
STAT,1920,1,na,1921,4731.397594804334
STAT,1880,23,15-19,1903,3.4884965513812944
SIM,1885,39,40-44,1924,4
STAT,1929,35,35-39,1964,3.144067202388749
SIM,1850,35,45-49,1885,2
STAT,1843,48,25-29,1891,0.038361201041427234
STAT,1868,23,15-19,1891,3.1746776239444374
STAT,1871,44,na,1915,2287.8497039299964
STAT,1847,31,30-34,1878,15.509269549423
SIM,1853,36,25-29,1889,1
SIM,1806,87,na,1893,32
STAT,1812,102,na,1914,0.13310468576396553
SIM,1953,12,na,1965,4918
SIM,1917,23,15-19,1940,5
STAT,1880,49,40-44,1929,0.17780210035413616
SIM,1864,22,40-44,1886,2
SIM,1903,34,25-29,1937,17
SIM,1914,20,40-44,1934,4
STAT,1925,17,20-24,1942,165.51303829055595
STAT,1852,61,na,1913,1417.1581694115234
STAT,1845,36,25-29,1881,2.2335041497417505
STAT,1888,25,40-44,1913,3.595273872939649
SIM,1920,31,20-24,1951,4
STAT,1848,23,45-49,1871,0.6882452007561867
STAT,1875,19,20-24,1894,18.289729868748704
SIM,1914,22,35-39,1936,12
SIM,1955,13,na,1968,5047
STAT,1841,24,na,1865,1996.5351345339072
STAT,1862,33,20-24,1895,2.34771338007248
STAT,1941,18,30-34,1959,12.671065713158464
SIM,1868,31,na,1899,2213
STAT,1794,82,na,1876,172.39461385151216
STAT,1862,8,na,1870,2453.0802180055625
STAT,1908,32,50-100,1940,0.7878097536801799
SIM,1844,38,25-29,1882,3
STAT,1909,21,20-24,1930,104.60072099451698
STAT,1829,75,na,1904,607.0098704048103
STAT,1878,42,15-19,1920,0.014461155752342662
STAT,1839,25,45-49,1864,1.006058609034688
STAT,1887,79,na,1966,1135.9469552677317
SIM,1876,23,15-19,1899,5
STAT,1854,34,25-29,1888,7.710094296301623
STAT,1912,31,20-24,1943,2.431367084585926
SIM,1845,37,45-49,1882,6
SIM,1864,24,35-39,1888,12
STAT,1875,41,35-39,1916,1.8867061624099628
SIM,1872,36,na,1908,2580
SIM,1878,36,30-34,1914,5
SIM,1910,37,35-39,1947,8
STAT,1905,38,15-19,1943,0.017609277930067606
SIM,1836,39,45-49,1875,4
SIM,1873,22,35-39,1895,10
STAT,1856,22,40-44,1878,1.8740333651126933
STAT,1889,38,20-24,1927,0.9552490750744362
SIM,1879,28,45-49,1907,2
STAT,1892,16,na,1908,3208.762113901312
STAT,1811,89,na,1900,45.79730941014091
SIM,1896,25,40-44,1921,12
SIM,1899,26,20-24,1925,22
STAT,1874,20,35-39,1894,6.071000955946438
SIM,1829,34,40-44,1863,4
STAT,1929,33,40-44,1962,5.021082307560487
STAT,1881,16,40-44,1897,0.1785054378868863
SIM,1908,23,20-24,1931,102
STAT,1822,41,na,1863,1561.1633621033463
STAT,1854,3,na,1857,2536.4673714184373
STAT,1897,18,45-49,1915,0.08821877236049938
SIM,1917,21,20-24,1938,113
STAT,1859,25,15-19,1884,0.3803628025542275
STAT,1837,37,45-49,1874,1.6558063820734896
STAT,1807,74,na,1881,468.5073517241834
STAT,1828,39,45-49,1867,1.963037647047151
STAT,1872,18,40-44,1890,0.1852369898246798
SIM,1919,37,40-44,1956,2
SIM,1853,36,40-44,1889,2
SIM,1791,84,na,1875,64
STAT,1794,92,na,1886,11.889354876811028
SIM,1813,59,na,1872,1112
STAT,1930,40,40-44,1970,0.3335530480768528
SIM,1855,24,40-44,1879,3
STAT,1867,49,na,1916,2095.414258762205
SIM,1878,29,40-44,1907,4
STAT,1864,19,45-49,1883,0.06086334442326167
STAT,1832,50,50-100,1882,0.011162324075507934
STAT,1879,34,30-34,1913,18.244983852908902
STAT,1826,57,na,1883,1175.0794472530085
SIM,1838,34,35-39,1872,12
SIM,1871,27,45-49,1898,3
STAT,1883,36,45-49,1919,1.9797883009336066
STAT,1825,42,50-100,1867,1.5148368644379548
STAT,1875,68,na,1943,1585.073217972038
SIM,1851,74,na,1925,980
STAT,1893,29,50-100,1922,0.8145047280985009
STAT,1863,27,45-49,1890,0.9935989026904606
SIM,1806,77,na,1883,377
STAT,1869,44,15-19,1913,0.013377635707618588
STAT,1809,75,na,1884,495.5914917181797
STAT,1818,38,na,1856,1560.876866508499
SIM,1937,33,40-44,1970,6
STAT,1877,49,na,1926,2296.318694235915
STAT,1889,31,50-100,1920,1.1457500943398993
STAT,1829,35,30-34,1864,4.5104392788376915
SIM,1838,27,45-49,1865,3
STAT,1887,38,50-100,1925,1.377592234725198
SIM,1942,15,20-24,1957,158
SIM,1922,21,30-34,1943,55
STAT,1934,15,20-24,1949,186.15264452960076
STAT,1889,7,na,1896,3244.6954601865145
SIM,1856,23,45-49,1879,5
STAT,1877,69,na,1946,1529.8014468388362
SIM,1800,62,na,1862,957
SIM,1894,37,40-44,1931,23
STAT,1896,26,30-34,1922,33.78174924501533
STAT,1850,51,45-49,1901,0.01116552432826649
STAT,1902,37,35-39,1939,2.1788951085672337
STAT,1907,21,50-100,1928,0.6066721810428567
SIM,1861,74,na,1935,879
STAT,1892,48,20-24,1940,0.00847109518586083
STAT,1816,45,45-49,1861,0.6287693020800553
STAT,1816,57,na,1873,1277.2784657867978
STAT,1927,45,25-29,1972,0.06761763478915378
STAT,1792,102,na,1894,0.052703483883515534
SIM,1872,23,30-34,1895,24
SIM,1891,19,na,1910,3271
STAT,1872,91,na,1963,136.04397710080698
STAT,1894,17,na,1911,3284.13497524967
STAT,1929,28,45-49,1957,2.1843333266565925
STAT,1842,49,20-24,1891,0.010578437641625913
STAT,1824,31,50-100,1855,2.083401378888269
SIM,1923,20,35-39,1943,14
STAT,1859,23,20-24,1882,57.66419768035806
STAT,1930,22,25-29,1952,119.600411518191
SIM,1865,98,na,1963,25
SIM,1930,16,40-44,1946,2
STAT,1862,50,25-29,1912,0.003133811754601964
STAT,1892,36,na,1928,3000.287810072772
SIM,1849,27,20-24,1876,17
STAT,1849,51,35-39,1900,0.0067632232010244745
STAT,1854,96,na,1950,6.444171096603979
STAT,1831,49,45-49,1880,0.1718137458849572
STAT,1850,18,20-24,1868,16.49070512909354
STAT,1886,37,40-44,1923,4.668138355489206
SIM,1823,35,na,1858,1648
STAT,1864,23,30-34,1887,16.376507055837692
STAT,1833,26,20-24,1859,11.058955846642792
STAT,1877,39,25-29,1916,2.9711351020518006
STAT,1894,36,20-24,1930,1.0071864944292348
SIM,1857,44,45-49,1901,1
SIM,1881,19,na,1900,2202
SIM,1837,35,30-34,1872,4
SIM,1888,30,30-34,1918,37
SIM,1907,27,20-24,1934,24
STAT,1884,17,na,1901,2515.491084347271
STAT,1792,81,na,1873,198.78418262954924
STAT,1848,30,35-39,1878,9.844682196739509
STAT,1828,44,25-29,1872,0.592767943536002
STAT,1897,25,35-39,1922,13.153855194538922
STAT,1906,20,40-44,1926,3.0837889428313416
SIM,1855,31,30-34,1886,26
STAT,1909,23,15-19,1932,4.977014940437752
SIM,1841,26,20-24,1867,15
STAT,1923,15,45-49,1938,0.5954282432880555
SIM,1885,39,25-29,1924,2
SIM,1821,44,na,1865,1348
STAT,1865,15,45-49,1880,0.06903103134834289
STAT,1881,54,na,1935,2038.6042042636489
STAT,1855,26,40-44,1881,2.3672743621048196
STAT,1906,39,50-100,1945,0.3859151753866
STAT,1834,40,35-39,1874,1.3338285599648079
STAT,1854,29,45-49,1883,0.8610371231131021
STAT,1782,81,na,1863,203.21855177248943
STAT,1908,25,20-24,1933,17.686196601866143
SIM,1897,23,35-39,1920,8
STAT,1854,41,15-19,1895,0.010410986612541565
SIM,1850,37,na,1887,1971
STAT,1831,24,na,1855,1751.6216174664678
STAT,1917,45,50-100,1962,0.23958674643903186
SIM,1816,43,45-49,1859,2
STAT,1904,66,na,1970,2720.8520171622017
STAT,1784,82,na,1866,138.34926636908136
STAT,1876,47,25-29,1923,0.059787714007238535
STAT,1777,80,na,1857,180.60078136739833
STAT,1840,29,15-19,1869,0.39087529714823416
SIM,1849,40,na,1889,1873
STAT,1859,18,25-29,1877,5.311976579499622
STAT,1829,36,50-100,1865,1.0228623930533065
STAT,1937,27,40-44,1964,4.586909609716972
SIM,1938,11,na,1949,3852
STAT,1946,25,40-44,1971,5.248585913608535
SIM,1879,35,35-39,1914,11
SIM,1943,12,na,1955,4199
STAT,1862,54,50-100,1916,0.012810678004824272
SIM,1866,27,20-24,1893,14
STAT,1865,105,na,1970,0.3080859061068777
STAT,1846,77,na,1923,655.9741330048458
SIM,1830,27,na,1857,1800
STAT,1868,16,25-29,1884,5.602077166996767
STAT,1869,15,30-34,1884,1.6056453736511103
STAT,1914,24,35-39,1938,9.64508654826452
STAT,1889,23,35-39,1912,7.245016501998689
SIM,1887,34,30-34,1921,30
SIM,1888,26,45-49,1914,2
STAT,1887,69,na,1956,1683.7512865263852
SIM,1877,37,25-29,1914,7
SIM,1925,15,20-24,1940,171
SIM,1846,26,40-44,1872,6
STAT,1847,24,40-44,1871,1.8853159943735924
STAT,1830,25,40-44,1855,3.74484304803061
STAT,1845,43,15-19,1888,0.010144688585061151
STAT,1851,24,na,1875,1905.6957237141555
SIM,1881,29,na,1910,2064
STAT,1857,46,45-49,1903,0.18655382326920827
SIM,1873,29,20-24,1902,15
STAT,1830,25,25-29,1855,52.8822576029541
STAT,1849,29,20-24,1878,10.71729069258032
SIM,1857,29,20-24,1886,15
SIM,1856,1,na,1857,3271
STAT,1869,47,50-100,1916,0.2400446623872744
STAT,1912,41,50-100,1953,0.1149723910100573
STAT,1838,26,40-44,1864,2.569295730393602
STAT,1881,48,45-49,1929,0.22687448731418003
SIM,1811,78,na,1889,447
STAT,1868,86,na,1954,214.17505509544503
STAT,1940,16,50-100,1956,0.3841445517081022
STAT,1857,34,50-100,1891,0.7160419567332328
STAT,1888,49,50-100,1937,0.16170550018300606
STAT,1908,20,50-100,1928,0.6142806220564765
STAT,1911,14,na,1925,3974.1911319518904
STAT,1861,44,na,1905,1913.594222288941
SIM,1942,0,na,1942,4653
STAT,1878,35,40-44,1913,4.633201831263836
STAT,1858,27,20-24,1885,9.516114382820474
STAT,1848,37,20-24,1885,0.6485741299391212
STAT,1947,0,na,1947,5051.216327182246
SIM,1922,24,35-39,1946,21
SIM,1927,5,na,1932,5489
STAT,1808,50,35-39,1858,0.030369618426346733
SIM,1847,69,na,1916,1044
SIM,1850,27,na,1877,2135
SIM,1862,34,25-29,1896,12
STAT,1809,55,na,1864,1276.0932732891813
STAT,1955,5,na,1960,5273.0759761593135
STAT,1829,36,40-44,1865,3.6470041893307874
STAT,1886,44,15-19,1930,0.014527922740052155
SIM,1957,3,na,1960,5438
STAT,1767,112,na,1879,6.037207978459344E-4
STAT,1826,53,50-100,1879,0.01407079611519962
SIM,1872,24,40-44,1896,5
SIM,1901,39,35-39,1940,4
STAT,1867,17,20-24,1884,17.239829862475727
SIM,1876,16,25-29,1892,9
SIM,1912,32,25-29,1944,14
STAT,1878,25,50-100,1903,0.6752387088176123
SIM,1861,35,20-24,1896,1
STAT,1938,26,45-49,1964,1.7286501118395334
STAT,1853,35,20-24,1888,0.6508510702291718
STAT,1902,31,na,1933,3419.805050616354
STAT,1914,22,40-44,1936,3.465889554877697
STAT,1845,39,45-49,1884,1.4989940759601306
STAT,1879,27,40-44,1906,3.1573238206670586
STAT,1891,19,20-24,1910,22.050253311632844
SIM,1924,21,na,1945,4342
STAT,1820,35,25-29,1855,8.108832450832152
SIM,1858,28,25-29,1886,44
STAT,1872,71,na,1943,1355.3844230237944
STAT,1863,31,15-19,1894,0.1279599672030465
STAT,1864,24,40-44,1888,1.902085697178003
SIM,1922,22,40-44,1944,5
STAT,1860,90,na,1950,65.09286595135724
STAT,1938,33,35-39,1971,9.270521124666503
STAT,1873,21,30-34,1894,18.293229772697202
SIM,1912,20,na,1932,3558
SIM,1932,20,50-100,1952,1
STAT,1833,59,na,1892,1374.9926434241056
SIM,1875,17,20-24,1892,19
SIM,1896,70,na,1966,2063
STAT,1869,37,25-29,1906,2.827252111835333
SIM,1906,21,45-49,1927,1
SIM,1862,29,45-49,1891,1
STAT,1904,32,25-29,1936,8.524472250855048
SIM,1847,32,35-39,1879,13
STAT,1847,49,na,1896,1649.3672040436393
STAT,1910,39,35-39,1949,2.3103996634985227
SIM,1882,19,20-24,1901,13
STAT,1838,33,30-34,1871,14.37351023638579
STAT,1895,34,15-19,1929,0.1862223762592192
STAT,1956,10,na,1966,5252.334248344523
SIM,1842,40,35-39,1882,4
STAT,1954,17,50-100,1971,0.46793229134298375
SIM,1837,36,40-44,1873,3
SIM,1929,31,40-44,1960,8
STAT,1837,94,na,1931,13.63409407141023
STAT,1910,50,na,1960,3427.0189834579237
SIM,1916,25,20-24,1941,33
STAT,1884,46,20-24,1930,0.011985874264411531
STAT,1829,85,na,1914,161.64005329152383
SIM,1926,21,15-19,1947,7
STAT,1896,27,40-44,1923,4.00483288956759
SIM,1883,34,45-49,1917,3
SIM,1950,5,na,1955,4540
STAT,1937,34,30-34,1971,15.71586084863795
STAT,1810,46,20-24,1856,0.047247913263629954
STAT,1886,37,25-29,1923,3.0703557149490344
STAT,1875,34,45-49,1909,1.7932373078306287
STAT,1917,48,35-39,1965,0.1355545824064855
STAT,1909,24,25-29,1933,86.08795840415107
STAT,1839,32,35-39,1871,8.835590892581026
STAT,1852,71,na,1923,1012.3020365174925
STAT,1928,37,40-44,1965,1.9122410499392353
SIM,1846,33,30-34,1879,27
STAT,1890,38,45-49,1928,2.448080200067063
STAT,1882,16,na,1898,2476.989235345249
SIM,1894,37,25-29,1931,5
SIM,1816,87,na,1903,54
SIM,1865,102,na,1967,2
STAT,1914,17,45-49,1931,0.10425821007960596
SIM,1832,28,20-24,1860,15
SIM,1888,51,na,1939,2784
STAT,1819,46,25-29,1865,0.1139333888489777
STAT,1828,43,15-19,1871,0.012964659129504843
STAT,1848,22,35-39,1870,5.801177628090876
SIM,1845,34,40-44,1879,9
SIM,1864,25,45-49,1889,2
SIM,1868,39,40-44,1907,6
SIM,1859,40,na,1899,2162
STAT,1823,47,45-49,1870,0.32483038069287956
STAT,1929,32,30-34,1961,20.227530482577677
STAT,1797,79,na,1876,290.11065264798947
STAT,1895,27,25-29,1922,55.794024810303924
STAT,1932,20,35-39,1952,12.55969683603496
STAT,1830,32,15-19,1862,0.1367107524228054
SIM,1847,31,50-100,1878,1
SIM,1948,11,na,1959,5010
SIM,1829,33,30-34,1862,21
STAT,1880,35,na,1915,2522.7431122594658
SIM,1853,33,20-24,1886,1
STAT,1900,17,30-34,1917,2.236216608804926
SIM,1914,23,45-49,1937,2
STAT,1912,34,25-29,1946,9.097037716072498
SIM,1895,23,na,1918,3073
STAT,1884,39,30-34,1923,5.254807835776699
SIM,1896,24,30-34,1920,31
SIM,1871,74,na,1945,1017
STAT,1794,102,na,1896,0.05701348837214766
STAT,1894,39,40-44,1933,5.634932047843162
STAT,1879,19,50-100,1898,0.051360510519189745
SIM,1846,36,35-39,1882,18
STAT,1888,24,30-34,1912,21.101300824311853
SIM,1892,39,30-34,1931,16
SIM,1917,24,25-29,1941,132
STAT,1947,21,40-44,1968,3.8397478976374555
SIM,1856,22,35-39,1878,10
STAT,1864,42,na,1906,2103.8409110397206
SIM,1843,39,35-39,1882,21
STAT,1887,36,30-34,1923,6.038802654706227
STAT,1839,31,50-100,1870,0.8077434262545581
SIM,1894,47,na,1941,3191
SIM,1867,26,25-29,1893,44
SIM,1929,26,45-49,1955,2
STAT,1942,17,20-24,1959,143.05037989784736
SIM,1786,93,na,1879,10
STAT,1854,33,15-19,1887,0.10831591688505743
STAT,1861,36,25-29,1897,2.4280834644895273
STAT,1906,23,45-49,1929,1.022662370835788
SIM,1836,36,25-29,1872,8
SIM,1918,45,na,1963,4161
SIM,1934,23,15-19,1957,7
STAT,1906,47,na,1953,3294.930876898553
STAT,1929,36,45-49,1965,0.8854214937186611
SIM,1822,49,45-49,1871,3
SIM,1842,18,20-24,1860,16
STAT,1844,52,na,1896,1694.4833730454484
SIM,1833,79,na,1912,372
STAT,1837,34,25-29,1871,8.580988301714365
SIM,1867,14,na,1881,2475
STAT,1845,33,20-24,1878,2.3241285769118893
STAT,1787,80,na,1867,213.13575865319922
STAT,1880,90,na,1970,268.97951136397234
STAT,1802,98,na,1900,1.134985988196122
SIM,1940,20,35-39,1960,12
STAT,1850,37,50-100,1887,0.9549865950004792
STAT,1867,105,na,1972,0.40215466745367556
STAT,1832,27,50-100,1859,0.5875473456250581
STAT,1872,47,40-44,1919,0.17302960435088782
STAT,1857,20,35-39,1877,5.387269716854827
STAT,1813,51,40-44,1864,0.029704806812201973
STAT,1834,33,45-49,1867,1.3165371805683357
STAT,1885,15,15-19,1900,5.99394773939316
SIM,1902,45,50-100,1947,2
STAT,1842,95,na,1937,11.97043504843364
STAT,1859,26,25-29,1885,35.208887325764266
STAT,1840,15,40-44,1855,0.16797354779121687
SIM,1901,34,na,1935,3435
STAT,1921,14,na,1935,4546.767701879945
STAT,1856,25,45-49,1881,0.9038397834779218
STAT,1828,36,25-29,1864,3.033463211052765
SIM,1863,45,na,1908,2070
STAT,1776,97,na,1873,0.8000570670480422
STAT,1926,23,15-19,1949,6.515802398436638
SIM,1937,32,30-34,1969,19
STAT,1838,36,35-39,1874,5.77289639639553
STAT,1843,45,20-24,1888,0.008264967665980996
SIM,1869,39,40-44,1908,1
STAT,1826,41,50-100,1867,1.1243135646307345
SIM,1842,33,45-49,1875,1
STAT,1835,46,25-29,1881,0.04617464097541936
STAT,1819,107,na,1926,0.0023974160237424103
SIM,1893,15,15-19,1908,9
STAT,1868,49,40-44,1917,0.16180734054648732
SIM,1854,35,30-34,1889,7
SIM,1869,47,50-100,1916,1
STAT,1836,20,15-19,1856,3.1870658906674856
STAT,1813,50,na,1863,1302.1919011894684
STAT,1864,105,na,1969,0.2690599846392181
SIM,1841,54,na,1895,1467
SIM,1920,34,25-29,1954,19
SIM,1909,21,15-19,1930,5
STAT,1791,64,na,1855,746.6350000000002
STAT,1831,46,40-44,1877,0.1295295126755519
SIM,1833,25,na,1858,2060
SIM,1878,37,40-44,1915,16
STAT,1927,42,20-24,1969,0.022386692858731728
SIM,1862,26,25-29,1888,5
SIM,1878,33,25-29,1911,13
SIM,1871,24,40-44,1895,2
SIM,1872,26,35-39,1898,18
SIM,1888,33,35-39,1921,15
STAT,1867,69,na,1936,1395.9594427496393
STAT,1900,24,50-100,1924,0.5685528308856675
SIM,1878,31,na,1909,2821
SIM,1895,29,40-44,1924,9
STAT,1864,16,40-44,1880,0.1906203368264795
SIM,1803,59,na,1862,974
STAT,1906,30,35-39,1936,8.623171878420214
SIM,1831,44,na,1875,1635
SIM,1854,28,50-100,1882,4
STAT,1961,11,na,1972,5126.0610022396695
STAT,1814,49,45-49,1863,0.5504220000645846
STAT,1836,23,na,1859,1766.3321282652146
STAT,1868,36,50-100,1904,1.1908329737695873
SIM,1830,26,45-49,1856,1
STAT,1846,28,50-100,1874,0.5830613265669047
SIM,1929,33,35-39,1962,16
STAT,1865,68,na,1933,1409.3893603739405
STAT,1860,23,45-49,1883,0.5892312261553695
SIM,1895,36,30-34,1931,1
SIM,1945,25,50-100,1970,1
STAT,1887,29,40-44,1916,3.3537927561243364
SIM,1937,25,40-44,1962,11
STAT,1923,26,15-19,1949,0.8217424468939275
STAT,1927,39,na,1966,4717.741978972026
SIM,1859,16,25-29,1875,11
SIM,1845,34,25-29,1879,15
SIM,1907,21,50-100,1928,1
SIM,1911,44,na,1955,3795
SIM,1886,18,na,1904,2846
SIM,1888,23,40-44,1911,3
STAT,1875,30,50-100,1905,0.957984924885154
SIM,1816,77,na,1893,418
SIM,1819,39,45-49,1858,4
STAT,1864,48,45-49,1912,0.21238479300272306
STAT,1901,38,30-34,1939,1.6206425898223833
SIM,1901,68,na,1969,2448
STAT,1863,24,40-44,1887,1.8747284023940263
STAT,1823,60,na,1883,1138.1969443552925
SIM,1859,23,15-19,1882,3
STAT,1888,20,50-100,1908,0.489032248859052
SIM,1851,38,30-34,1889,7
SIM,1854,41,na,1895,2156
SIM,1776,83,na,1859,83
STAT,1854,26,25-29,1880,36.836836790508265
STAT,1864,26,35-39,1890,8.82408801627415
STAT,1937,35,40-44,1972,1.513823174127268
STAT,1871,23,20-24,1894,68.93479589170026
SIM,1906,20,35-39,1926,11
STAT,1853,38,40-44,1891,3.6021364330350845
SIM,1818,58,na,1876,1047
STAT,1806,57,na,1863,1039.3953063652466
STAT,1843,38,30-34,1881,3.779286068262783
SIM,1908,26,25-29,1934,10
STAT,1819,49,45-49,1868,0.4464792593296812
STAT,1866,29,20-24,1895,10.893219035178431
SIM,1881,21,30-34,1902,2
SIM,1861,38,40-44,1899,2
STAT,1796,63,na,1859,828.5041829319797
STAT,1809,49,35-39,1858,0.4639357378502012
SIM,1843,89,na,1932,139
SIM,1937,28,na,1965,3704
SIM,1824,31,50-100,1855,1
SIM,1828,38,40-44,1866,8
SIM,1876,36,50-100,1912,1
STAT,1859,33,15-19,1892,0.1151946382379274
STAT,1934,18,25-29,1952,59.07128026797012
STAT,1929,25,40-44,1954,5.918457603846274
SIM,1916,46,50-100,1962,3
STAT,1862,36,25-29,1898,2.523381230676255
STAT,1901,48,na,1949,3146.013279775219
SIM,1925,23,20-24,1948,148
SIM,1942,18,25-29,1960,80
SIM,1844,41,na,1885,1610
STAT,1917,23,20-24,1940,118.92031710723582
STAT,1860,30,35-39,1890,8.428382956557929
STAT,1888,5,na,1893,3124.093789624269
STAT,1837,41,15-19,1878,0.011260488965851155
STAT,1880,19,45-49,1899,0.06891668792128795
SIM,1952,6,na,1958,4781
STAT,1840,39,45-49,1879,1.6188232873073227
STAT,1922,24,40-44,1946,3.8709180532674012
STAT,1854,52,40-44,1906,0.007858799156595932
STAT,1872,26,40-44,1898,3.0521966641736333
STAT,1862,28,25-29,1890,36.76628365082977
SIM,1896,32,30-34,1928,31
STAT,1878,35,25-29,1913,3.0473770565102423
STAT,1836,25,50-100,1861,0.5297543556068475
STAT,1931,28,15-19,1959,0.9206799092492084
STAT,1898,21,35-39,1919,8.01411295641205
SIM,1924,27,20-24,1951,25
STAT,1862,61,na,1923,1629.861884795522
STAT,1926,16,25-29,1942,53.82953979362609
SIM,1796,93,na,1889,1
STAT,1854,37,30-34,1891,3.9997765122980686
STAT,1876,18,25-29,1894,5.894024856978747
SIM,1823,79,na,1902,440
STAT,1899,20,25-29,1919,79.82456485202474
SIM,1923,28,30-34,1951,66
STAT,1919,43,25-29,1962,0.07801040496623854
STAT,1888,32,30-34,1920,20.813933071747996
STAT,1906,15,45-49,1921,0.09654264113449683
STAT,1871,26,40-44,1897,3.0161365227048607
STAT,1908,28,25-29,1936,62.58912424481631
SIM,1854,28,40-44,1882,4
STAT,1839,39,20-24,1878,0.6396643177026311
SIM,1904,26,40-44,1930,7
STAT,1929,40,30-34,1969,0.16780771454700752
STAT,1922,23,30-34,1945,33.19395099718008
STAT,1959,0,na,1959,5233.118549720137
SIM,1886,38,45-49,1924,4
SIM,1930,23,30-34,1953,63
SIM,1829,41,30-34,1870,4
SIM,1929,34,45-49,1963,2
STAT,1830,28,45-49,1858,1.1627332577740737
STAT,1872,25,30-34,1897,25.743703776121702
SIM,1903,15,na,1918,3470
STAT,1856,46,45-49,1902,0.1832645660147239
STAT,1819,38,40-44,1857,11.526992132263619
STAT,1838,29,45-49,1867,0.9319414318033362
STAT,1844,15,25-29,1859,5.766937793498297
SIM,1891,36,45-49,1927,5
STAT,1832,95,na,1927,9.053253615558763
STAT,1849,44,45-49,1893,1.1543575929277858
SIM,1873,55,na,1928,1995
STAT,1793,102,na,1895,0.05291350574373826
STAT,1855,68,na,1923,1150.3061464801792
STAT,1859,15,20-24,1874,16.91582500110083
STAT,1878,16,35-39,1894,0.5767096583371594
STAT,1890,16,35-39,1906,0.6788585342129287
STAT,1886,29,40-44,1915,3.1716170533918073
STAT,1904,24,25-29,1928,82.45344139414574
STAT,1825,30,50-100,1855,2.927345071637785
SIM,1930,24,40-44,1954,3
STAT,1811,48,na,1859,1296.3811684628163
STAT,1864,38,50-100,1902,1.1133990218504997
STAT,1868,46,20-24,1914,0.011616378595702713
STAT,1916,27,20-24,1943,19.046966119829097
SIM,1890,36,45-49,1926,3
STAT,1825,49,20-24,1874,0.015672639177783623
SIM,1887,37,35-39,1924,5
SIM,1846,29,45-49,1875,1
STAT,1914,21,30-34,1935,28.515186848429057
STAT,1857,70,na,1927,1105.9652865497553
STAT,1766,112,na,1878,3.7298949576543565E-4
SIM,1864,46,45-49,1910,2
STAT,1882,15,45-49,1897,0.06420504016911355
SIM,1887,0,na,1887,3670
SIM,1883,19,20-24,1902,25
SIM,1877,14,na,1891,2740
SIM,1801,78,na,1879,147
SIM,1876,49,40-44,1925,3
STAT,1870,90,na,1960,134.91889840079065
STAT,1867,25,20-24,1892,11.234921436733861
STAT,1871,33,15-19,1904,0.14229228923103585
STAT,1937,25,50-100,1962,0.9803715404175025
SIM,1934,16,25-29,1950,72
SIM,1870,28,25-29,1898,60
SIM,1864,92,na,1956,40
STAT,1861,29,35-39,1890,8.040274773713113
STAT,1846,35,30-34,1881,4.312262926787335
SIM,1819,44,25-29,1863,3
STAT,1898,47,45-49,1945,0.18142430305691337
SIM,1839,30,35-39,1869,8
STAT,1915,28,30-34,1943,40.185271231256664
SIM,1912,24,25-29,1936,104
STAT,1845,36,40-44,1881,3.3957975415649315
STAT,1854,52,na,1906,1607.3210306660974
STAT,1864,27,45-49,1891,1.0119160259231952
SIM,1887,14,na,1901,2835
STAT,1874,27,20-24,1901,12.132544827600743
SIM,1947,22,45-49,1969,2
SIM,1879,42,50-100,1921,1
SIM,1820,34,20-24,1854,1
STAT,1872,16,na,1888,2588.2336879791046
STAT,1897,15,na,1912,3435.708186785307
STAT,1896,30,15-19,1926,0.1919182029735191
SIM,1909,22,25-29,1931,6
SIM,1948,21,35-39,1969,18
STAT,1933,27,50-100,1960,1.335517966461614
SIM,1859,24,25-29,1883,63
SIM,1829,95,na,1924,4
SIM,1888,22,30-34,1910,28
STAT,1880,42,40-44,1922,2.382893146520606
STAT,1810,49,25-29,1859,0.2142371337322644
SIM,1838,78,na,1916,576
SIM,1916,28,25-29,1944,75
SIM,1884,39,25-29,1923,3
STAT,1870,52,25-29,1922,0.0034942256237308527
STAT,1877,21,15-19,1898,3.4493621566173913
SIM,1933,12,na,1945,5078
SIM,1901,29,40-44,1930,5
STAT,1906,22,35-39,1928,8.584595036922595
STAT,1896,50,na,1946,2920.0624776379154
STAT,1828,47,30-34,1875,0.08819447320654607
STAT,1846,28,40-44,1874,2.7303708669468163
STAT,1878,38,45-49,1916,2.0797138499547976
STAT,1835,39,35-39,1874,6.430578139854049
SIM,1840,27,na,1867,1933
STAT,1856,24,35-39,1880,5.172935552173744
STAT,1954,3,na,1957,4913.094879998193
SIM,1941,27,50-100,1968,2
SIM,1956,1,na,1957,5296
STAT,1819,43,20-24,1862,0.32978790504569094
STAT,1939,22,45-49,1961,1.1407636261931362
SIM,1850,19,25-29,1869,6
STAT,1827,48,40-44,1875,0.1732857810746792
STAT,1886,34,20-24,1920,2.8578439119143817
SIM,1894,29,40-44,1923,4
SIM,1922,25,50-100,1947,4
STAT,1885,34,na,1919,2378.5088279335805
SIM,1840,20,30-34,1860,23
STAT,1836,38,25-29,1874,2.2064064059418182
STAT,1842,19,25-29,1861,6.474627153627101
STAT,1879,37,35-39,1916,7.454857975850093
SIM,1837,32,25-29,1869,19
SIM,1852,91,na,1943,18
SIM,1902,30,na,1932,3642
SIM,1827,38,40-44,1865,5
STAT,1912,31,na,1943,3769.9664561904606
STAT,1884,49,25-29,1933,0.05617148419421696
SIM,1943,2,na,1945,4327
SIM,1950,17,20-24,1967,162
STAT,1928,15,na,1943,4709.553302651205
STAT,1880,16,25-29,1896,6.025520874768091
STAT,1910,21,45-49,1931,1.0692747818148716
SIM,1852,15,25-29,1867,5
STAT,1811,102,na,1913,0.12780747809238285
STAT,1893,40,50-100,1933,1.3685085213715804
STAT,1851,48,50-100,1899,0.18362866107564002
STAT,1871,29,45-49,1900,1.1061423142884867
SIM,1814,96,na,1910,3
SIM,1826,77,na,1903,693
STAT,1847,94,na,1941,14.964316439555791
SIM,1872,27,45-49,1899,1
STAT,1829,32,25-29,1861,9.123108677965908
STAT,1856,17,45-49,1873,0.0598101927540893
STAT,1896,23,25-29,1919,76.29638531190095
STAT,1816,88,na,1904,70.18939820624597
SIM,1890,18,15-19,1908,9
STAT,1851,47,20-24,1898,0.00904389328529005
STAT,1908,35,15-19,1943,0.018321910753378256
STAT,1842,35,45-49,1877,2.1496239182759256
SIM,1847,22,40-44,1869,2
STAT,1865,29,20-24,1894,10.742073086232159
SIM,1864,72,na,1936,1491
STAT,1882,18,15-19,1900,5.790841449610523
SIM,1904,33,30-34,1937,21
STAT,1839,22,40-44,1861,1.8982374433572575
STAT,1919,47,40-44,1966,0.1726617853249307
STAT,1893,36,20-24,1929,0.9933266206974221
STAT,1875,26,45-49,1901,1.1555778898849753
SIM,1828,34,40-44,1862,6
STAT,1855,22,25-29,1877,50.33977148148174
SIM,1852,36,25-29,1888,2
STAT,1837,45,30-34,1882,0.07033092040693946
SIM,1876,18,na,1894,2892
SIM,1874,92,na,1966,137
STAT,1936,32,20-24,1968,2.3918619686689255
SIM,1863,36,35-39,1899,11
STAT,1857,53,50-100,1910,0.011713514629558034
SIM,1875,39,30-34,1914,3
STAT,1822,95,na,1917,7.433849138668706
STAT,1932,28,50-100,1960,1.3168605938564224
STAT,1887,25,40-44,1912,3.400852516986198
STAT,1916,20,35-39,1936,10.01646647873374
SIM,1913,15,na,1928,3994
STAT,1905,34,35-39,1939,8.417714267318027
STAT,1897,29,15-19,1926,0.6099491146099557
STAT,1908,47,30-34,1955,0.08138332068857361
STAT,1899,42,35-39,1941,0.17408931962705249
SIM,1902,20,15-19,1922,5
SIM,1913,34,35-39,1947,10
STAT,1895,24,20-24,1919,90.32404917491236
STAT,1901,16,20-24,1917,25.162721746351355
SIM,1813,80,na,1893,292
STAT,1867,70,na,1937,1334.6349444296475
SIM,1886,39,40-44,1925,5
STAT,1774,102,na,1876,0.05423707770415706
STAT,1910,28,30-34,1938,38.039357772680326
STAT,1914,12,na,1926,4121.822625823289
SIM,1894,3,na,1897,3792
STAT,1855,36,35-39,1891,5.3495598065590935
STAT,1878,39,40-44,1917,4.543421293117575
SIM,1833,32,40-44,1865,5
SIM,1951,7,na,1958,4990
STAT,1919,21,15-19,1940,5.9031472073742695
SIM,1856,53,na,1909,1942
STAT,1818,80,na,1898,318.7050053747493
SIM,1895,25,40-44,1920,6
SIM,1904,22,25-29,1926,94
STAT,1826,45,20-24,1871,0.01215108685049132
STAT,1926,38,35-39,1964,2.984533857313901
STAT,1851,18,20-24,1869,16.224786888558373
STAT,1905,20,25-29,1925,84.08283342259175
STAT,1877,15,na,1892,2644.982868032042
STAT,1919,21,30-34,1940,31.87261702571755
STAT,1858,48,20-24,1906,0.009389162973196778
STAT,1943,23,15-19,1966,5.716662679249251
SIM,1929,23,40-44,1952,4
STAT,1860,16,20-24,1876,16.9813413684948
STAT,1811,58,na,1869,1080.3950778406318
STAT,1817,42,50-100,1859,2.5845556641677065
SIM,1838,32,50-100,1870,1
STAT,1880,16,40-44,1896,0.19448367892715576
SIM,1854,24,25-29,1878,73
STAT,1825,32,40-44,1857,10.284415303804783
STAT,1884,38,20-24,1922,0.7639535418455098
SIM,1863,22,25-29,1885,68
SIM,1887,45,na,1932,2462
STAT,1884,24,45-49,1908,0.6901809306462096
SIM,1826,39,35-39,1865,20
STAT,1830,51,40-44,1881,0.007898978889598195
STAT,1859,41,na,1900,1885.9975349969434
SIM,1883,26,45-49,1909,1
SIM,1934,8,na,1942,5555
STAT,1829,39,45-49,1868,1.5801887615061876
STAT,1881,23,30-34,1904,17.28783856890501
SIM,1921,34,na,1955,4018
STAT,1907,18,30-34,1925,2.3578777064807395
SIM,1915,18,30-34,1933,3
STAT,1846,31,15-19,1877,0.12904605294010382
STAT,1873,38,45-49,1911,2.031026010090035
STAT,1815,45,45-49,1860,0.5414944686889851
STAT,1843,19,25-29,1862,4.826918572429235
SIM,1880,25,30-34,1905,35
SIM,1832,40,na,1872,1593
SIM,1881,24,35-39,1905,6
SIM,1927,21,30-34,1948,57
STAT,1858,37,15-19,1895,0.04449612131985797
STAT,1867,60,na,1927,1814.1511175415994
SIM,1918,23,30-34,1941,42
STAT,1859,0,na,1859,3173.001273985748
SIM,1884,18,25-29,1902,6
SIM,1822,32,30-34,1854,25
SIM,1922,25,45-49,1947,3
STAT,1882,36,45-49,1918,1.9597098780207602
SIM,1815,39,25-29,1854,4
STAT,1926,44,na,1970,4611.9340334879325
SIM,1885,9,na,1894,2807
SIM,1915,27,na,1942,4195
STAT,1869,48,30-34,1917,0.09385923033991547
SIM,1901,21,45-49,1922,3
STAT,1818,39,35-39,1857,15.476743604335326
STAT,1892,23,40-44,1915,2.6328153375827834
SIM,1881,38,45-49,1919,3
STAT,1799,61,na,1860,951.1016271274696
SIM,1868,85,na,1953,123
STAT,1867,28,25-29,1895,40.09640103638764
STAT,1846,23,na,1869,1987.680667794665
SIM,1849,19,na,1868,2280
STAT,1951,11,na,1962,4726.733668499543
STAT,1917,26,25-29,1943,69.91407096800069
STAT,1835,24,15-19,1859,3.2455438543448882
STAT,1885,37,25-29,1922,2.8945655403118433
STAT,1889,20,30-34,1909,22.315672266852324
STAT,1940,18,15-19,1958,46.50480398407378
STAT,1817,47,20-24,1864,0.025803870785595213
STAT,1869,34,20-24,1903,2.6315664976264164
STAT,1814,46,40-44,1860,0.41991702016730215
SIM,1828,34,25-29,1862,11
STAT,1879,30,15-19,1909,0.15130416938154265
SIM,1807,73,na,1880,517
STAT,1854,42,na,1896,1732.418863832508
SIM,1845,38,40-44,1883,9
SIM,1897,31,50-100,1928,1
SIM,1796,83,na,1879,155
STAT,1925,31,50-100,1956,0.9928112904632113
STAT,1849,37,20-24,1886,0.6167116992943891
SIM,1891,71,na,1962,1784
SIM,1901,17,25-29,1918,14
SIM,1929,30,30-34,1959,28
STAT,1914,25,45-49,1939,1.7691086878242543
SIM,1862,23,20-24,1885,81
SIM,1819,36,40-44,1855,10
SIM,1874,33,40-44,1907,5
STAT,1881,37,40-44,1918,4.261785526293366
STAT,1927,16,40-44,1943,1.7621387547012064
STAT,1843,30,35-39,1873,8.383741615544146
STAT,1899,38,15-19,1937,0.016717478359242966
STAT,1877,18,40-44,1895,0.19016287753437638
SIM,1912,21,20-24,1933,108
STAT,1841,17,15-19,1858,5.723781481748167
SIM,1927,21,15-19,1948,7
SIM,1833,42,50-100,1875,3
SIM,1836,43,na,1879,1847
SIM,1833,28,20-24,1861,14
STAT,1869,23,30-34,1892,17.4368756899033
SIM,1877,4,na,1881,2924
SIM,1925,26,25-29,1951,94
SIM,1869,35,40-44,1904,7
SIM,1893,37,25-29,1930,7
STAT,1940,22,35-39,1962,9.683581141653198
STAT,1852,30,na,1882,1913.110144807936
STAT,1841,35,45-49,1876,1.79326388932144
SIM,1843,24,15-19,1867,4
SIM,1831,25,35-39,1856,11
SIM,1886,27,40-44,1913,4
STAT,1930,26,40-44,1956,5.9929786571657955
SIM,1950,14,na,1964,4532
STAT,1821,49,35-39,1870,0.19934073179585188
STAT,1917,33,15-19,1950,0.13525481522420363
SIM,1913,20,25-29,1933,5
STAT,1818,46,25-29,1864,0.10409948720187713
SIM,1939,31,35-39,1970,11
SIM,1896,18,na,1914,3372
STAT,1887,25,25-29,1912,48.0246452431426
STAT,1925,32,45-49,1957,1.8884481450434591
STAT,1939,29,30-34,1968,39.726455245745335
SIM,1863,29,45-49,1892,1
STAT,1848,42,50-100,1890,0.8614871290716598
SIM,1895,25,25-29,1920,80
STAT,1855,29,45-49,1884,0.8586637312293061
SIM,1798,64,na,1862,839
SIM,1861,20,na,1881,2344
SIM,1836,53,na,1889,1569
STAT,1843,23,45-49,1866,0.5861103300205245
STAT,1878,27,40-44,1905,3.1407132668568813
STAT,1892,19,20-24,1911,22.348276321224315
SIM,1940,14,na,1954,4188
STAT,1856,23,na,1879,1909.0777509670745
STAT,1929,39,15-19,1968,0.024865708006931574
STAT,1852,35,20-24,1887,0.6001119641229816
STAT,1913,29,45-49,1942,1.7244264514922611
STAT,1911,27,35-39,1938,14.77145587435637
SIM,1815,61,na,1876,1008
STAT,1912,9,na,1921,4047.963642204162
SIM,1885,23,na,1908,2469
SIM,1843,17,25-29,1860,9
SIM,1910,15,25-29,1925,14
STAT,1888,35,35-39,1923,8.511789301309975
SIM,1869,32,20-24,1901,4
STAT,1937,29,na,1966,3682.9191343619764
STAT,1925,39,30-34,1964,2.20600149010774
STAT,1801,58,na,1859,1094.11012465239
SIM,1928,31,25-29,1959,26
SIM,1842,41,50-100,1883,4
STAT,1835,108,na,1943,0.001374796100990319
SIM,1821,36,30-34,1857,4
SIM,1848,42,50-100,1890,1
SIM,1857,90,na,1947,71
SIM,1831,35,50-100,1866,1
STAT,1857,27,20-24,1884,9.524811496907848
SIM,1921,29,45-49,1950,1
STAT,1904,4,na,1908,3812.9682843198634
STAT,1925,25,20-24,1950,21.93667687159473
STAT,1929,43,35-39,1972,0.2631616636320009
SIM,1870,25,20-24,1895,20
STAT,1843,26,15-19,1869,0.37932070221021985
SIM,1903,38,40-44,1941,1
SIM,1914,19,25-29,1933,11
STAT,1840,36,40-44,1876,3.66725674732585
STAT,1940,15,45-49,1955,0.5123208158147565
SIM,1885,35,25-29,1920,4
STAT,1877,35,25-29,1912,3.029846388361864
SIM,1868,48,50-100,1916,1
STAT,1804,76,na,1880,357.68287705923404
STAT,1848,15,45-49,1863,0.06690005077344002
STAT,1862,25,20-24,1887,10.419214243594798
STAT,1931,14,na,1945,5224.4825227993615
STAT,1882,29,20-24,1911,11.395405435645602
STAT,1900,38,15-19,1938,0.016920807388811996
SIM,1825,29,25-29,1854,42
STAT,1840,22,30-34,1862,15.878719390865713
STAT,1873,49,50-100,1922,0.24622164237345154
STAT,1868,49,25-29,1917,0.05443985247033553
STAT,1888,49,45-49,1937,0.15538476427469464
STAT,1961,6,na,1967,5129.2403440118605
STAT,1897,47,45-49,1944,0.1794168865667946
SIM,1933,25,20-24,1958,22
STAT,1846,24,40-44,1870,1.923274842630428
STAT,1921,21,20-24,1942,127.22888847926046
SIM,1822,40,na,1862,1654
SIM,1803,80,na,1883,195
SIM,1848,43,40-44,1891,4
STAT,1878,46,30-34,1924,0.10177857220195999
SIM,1896,35,35-39,1931,19
STAT,1852,17,25-29,1869,5.197785798460109
STAT,1904,21,20-24,1925,100.18462022083358
SIM,1877,47,50-100,1924,3
SIM,1896,49,50-100,1945,1
SIM,1916,20,50-100,1936,1
STAT,1893,29,30-34,1922,32.06349921809847
SIM,1875,31,35-39,1906,12
STAT,1872,17,45-49,1889,0.06654801954213055
STAT,1934,37,30-34,1971,2.5413226620571656
SIM,1878,85,na,1963,480
STAT,1905,27,45-49,1932,1.6211498144648653
SIM,1913,27,45-49,1940,3
SIM,1851,30,35-39,1881,8
SIM,1905,27,na,1932,3540
STAT,1867,46,20-24,1913,0.011447071868039747
STAT,1934,32,na,1966,5217.635869576045
STAT,1826,38,30-34,1864,5.987458547210393
STAT,1941,11,na,1952,4102.740098012649
SIM,1909,26,40-44,1935,5
STAT,1833,38,50-100,1871,1.078723145066407
STAT,1906,26,15-19,1932,0.669733875089647
STAT,1951,18,25-29,1969,52.12066061706391
SIM,1932,29,na,1961,5548
SIM,1860,17,25-29,1877,5
STAT,1836,35,20-24,1871,0.6094135899886303
STAT,1909,31,15-19,1940,0.12424968745057552
SIM,1834,38,30-34,1872,9
SIM,1849,71,na,1920,1033
STAT,1895,24,50-100,1919,0.5344935129167456
SIM,1893,52,na,1945,2768
STAT,1857,39,20-24,1896,0.6015018671647258
SIM,1829,44,35-39,1873,2
STAT,1859,47,25-29,1906,0.04657238890658106
SIM,1854,24,40-44,1878,2
STAT,1797,89,na,1886,39.299377148676555
STAT,1893,21,35-39,1914,7.506255511899731
STAT,1931,17,45-49,1948,0.6608126944694208
SIM,1892,24,45-49,1916,1
STAT,1832,23,35-39,1855,5.872178640316772
SIM,1830,34,30-34,1864,20
SIM,1848,39,20-24,1887,2
STAT,1919,15,50-100,1934,0.08425908601081239
STAT,1932,16,50-100,1948,0.502579654335335
SIM,1840,37,45-49,1877,1
SIM,1919,22,35-39,1941,10
STAT,1808,90,na,1898,29.72348474140877
STAT,1856,28,15-19,1884,0.36143703807805433
SIM,1858,85,na,1943,192
SIM,1881,20,na,1901,2124
STAT,1831,24,30-34,1855,19.409010365780425
STAT,1918,25,na,1943,4052.1992133074423
SIM,1914,26,15-19,1940,3
STAT,1821,58,na,1879,1279.2469684819337
STAT,1867,21,40-44,1888,2.0047242548128708
STAT,1846,24,25-29,1870,52.835482162128834
STAT,1896,48,40-44,1944,0.12748564882332378
SIM,1899,29,25-29,1928,82
STAT,1866,52,50-100,1918,0.014049390855506244
SIM,1889,44,40-44,1933,2
STAT,1829,43,30-34,1872,0.8796939598773333
STAT,1859,82,na,1941,379.02150720449197
STAT,1887,15,na,1902,2861.221692836294
SIM,1840,19,15-19,1859,6
STAT,1902,22,15-19,1924,4.7085652185781175
STAT,1880,89,na,1969,318.0441882917389
SIM,1857,38,na,1895,2044
SIM,1885,33,na,1918,2541
SIM,1922,18,20-24,1940,183
STAT,1832,37,45-49,1869,1.7202379873144045
SIM,1859,20,45-49,1879,1
SIM,1890,29,20-24,1919,16
STAT,1896,34,30-34,1930,23.142419198649634
SIM,1834,30,35-39,1864,9
STAT,1840,38,na,1878,1757.4206962208398
STAT,1902,15,25-29,1917,8.125472699484096
STAT,1830,83,na,1913,261.9081285321405
SIM,1849,38,25-29,1887,2
STAT,1921,28,40-44,1949,5.228118311523783
SIM,1885,28,35-39,1913,19
STAT,1822,34,30-34,1856,39.00157256825014
SIM,1840,23,35-39,1863,8
SIM,1943,21,15-19,1964,6
SIM,1839,37,20-24,1876,3
STAT,1902,29,35-39,1931,13.673102442122806
SIM,1854,72,na,1926,1144
SIM,1872,15,na,1887,2808
SIM,1910,29,35-39,1939,31
SIM,1930,27,45-49,1957,5
STAT,1927,23,15-19,1950,6.608437320748001
SIM,1908,45,na,1953,3242
SIM,1825,40,35-39,1865,4
STAT,1851,22,40-44,1873,1.8842422803246037
STAT,1837,36,50-100,1873,1.0304174049176253
STAT,1857,49,15-19,1906,3.087142960314111E-4
STAT,1914,18,20-24,1932,28.22154921298659
SIM,1859,28,40-44,1887,4
STAT,1898,28,20-24,1926,16.006264895873393
SIM,1818,37,35-39,1855,10
STAT,1863,24,25-29,1887,51.50183263877877
SIM,1938,17,20-24,1955,136
STAT,1872,21,15-19,1893,3.3600115384847737
SIM,1871,24,25-29,1895,59
STAT,1884,31,35-39,1915,10.127726986328268
SIM,1892,31,35-39,1923,16
STAT,1889,16,45-49,1905,0.08155207092456648
STAT,1771,98,na,1869,0.44853865768944073
STAT,1918,15,na,1933,4277.828463614158
SIM,1862,60,na,1922,1724
STAT,1822,48,40-44,1870,0.25029976929500236
STAT,1867,39,30-34,1906,5.0185878494886405
STAT,1916,49,30-34,1965,0.09173240063476709
STAT,1931,24,35-39,1955,12.265023032993442
STAT,1817,40,35-39,1857,4.839440397300931
STAT,1876,36,20-24,1912,0.8077434127162192
SIM,1868,25,30-34,1893,26
STAT,1922,27,45-49,1949,1.9748978244015354
SIM,1913,31,30-34,1944,28
STAT,1898,21,na,1919,3248.0218342236626
STAT,1925,35,15-19,1960,0.023333250086859672
SIM,1771,84,na,1855,53
SIM,1942,22,45-49,1964,1
STAT,1816,48,15-19,1864,0.001019019741421423
SIM,1814,44,40-44,1858,4
STAT,1826,48,25-29,1874,0.05599199044143938
SIM,1835,22,15-19,1857,5
STAT,1873,35,40-44,1908,4.524734703044922
SIM,1883,23,40-44,1906,2
STAT,1877,28,35-39,1905,10.022862906383109
STAT,1838,22,25-29,1860,49.7185127397161
STAT,1834,76,na,1910,563.9216667164361
STAT,1884,27,15-19,1911,0.45188546235456184
SIM,1859,71,na,1930,1235
SIM,1814,65,na,1879,876
STAT,1909,11,na,1920,3913.965194033751
SIM,1917,38,35-39,1955,5
SIM,1863,33,30-34,1896,5
STAT,1865,49,50-100,1914,0.22177679983296408
SIM,1833,35,45-49,1868,4
STAT,1827,48,25-29,1875,0.05830175766470932
SIM,1927,24,35-39,1951,12
STAT,1850,38,na,1888,1813.6412110138785
STAT,1825,35,45-49,1860,3.579325620187355
STAT,1936,35,25-29,1971,0.9775508710815648
SIM,1846,22,25-29,1868,73
STAT,1863,49,40-44,1912,0.15000632184296628
STAT,1828,90,na,1918,51.17991878053901
STAT,1848,19,50-100,1867,0.049003317297572103
STAT,1830,29,40-44,1859,3.013125876475786
STAT,1866,33,40-44,1899,4.038722887517707
STAT,1877,36,20-24,1913,0.8074183895008873
STAT,1882,0,na,1882,3485.0226901223423
STAT,1887,28,45-49,1915,1.2476216749639262
SIM,1881,35,40-44,1916,7
STAT,1935,21,15-19,1956,7.326176704391302
STAT,1892,26,45-49,1918,1.412004123580507
SIM,1822,35,35-39,1857,15
SIM,1873,49,50-100,1922,3
SIM,1832,35,45-49,1867,1
SIM,1837,38,na,1875,1586
SIM,1828,31,20-24,1859,2
SIM,1838,31,30-34,1869,23
SIM,1879,25,40-44,1904,4
STAT,1855,33,30-34,1888,13.24333426207035
SIM,1907,20,35-39,1927,14
STAT,1813,91,na,1904,25.40773516867669
STAT,1928,44,30-34,1972,0.16418578629137107
SIM,1838,24,na,1862,1792
STAT,1916,20,50-100,1936,0.6999627988186049
STAT,1938,30,30-34,1968,16.01098146157542
STAT,1894,39,25-29,1933,3.7062410106376578
STAT,1847,34,35-39,1881,7.935062998606716
STAT,1883,39,15-19,1922,0.054942960629318846
STAT,1893,39,25-29,1932,3.655239500280621
SIM,1844,34,25-29,1878,16
STAT,1843,16,20-24,1859,15.371172791102145
STAT,1913,22,25-29,1935,90.30907021533461
SIM,1864,21,30-34,1885,27
STAT,1869,26,35-39,1895,9.507362379965127
STAT,1923,22,35-39,1945,11.069642715559961
SIM,1854,21,20-24,1875,85
STAT,1814,76,na,1890,443.44199426032975
STAT,1923,17,50-100,1940,0.44450594302790924
STAT,1841,28,20-24,1869,10.818190407769878
STAT,1837,48,35-39,1885,0.09788289388774478
STAT,1842,16,20-24,1858,20.618249768045587
SIM,1878,25,40-44,1903,5
SIM,1921,22,25-29,1943,160
STAT,1910,17,25-29,1927,8.663221672800596
SIM,1877,37,40-44,1914,9
SIM,1931,22,35-39,1953,15
STAT,1920,17,35-39,1937,4.754126109973043
STAT,1869,37,40-44,1906,4.298526050137304
STAT,1836,34,25-29,1870,7.999536009849368
STAT,1764,105,na,1869,0.010717096777384999
STAT,1897,69,na,1966,2268.7388593373976
STAT,1845,47,30-34,1892,0.0704006603505299
STAT,1876,74,na,1950,1157.3351816395336
STAT,1938,25,na,1963,3749.9771994845137
STAT,1857,49,na,1906,1736.3964886463725
STAT,1934,22,45-49,1956,1.5278679481937072
STAT,1945,9,na,1954,4341.867426531424
SIM,1823,80,na,1903,385
STAT,1856,21,30-34,1877,16.13498312519576
STAT,1849,47,15-19,1896,3.1128288014275216E-4
STAT,1846,21,20-24,1867,64.99349481764905
STAT,1852,38,25-29,1890,2.1727294954941483
SIM,1838,24,40-44,1862,2
STAT,1842,38,15-19,1880,0.05869558037535308
SIM,1849,31,40-44,1880,12
SIM,1916,32,45-49,1948,2
SIM,1925,37,30-34,1962,3
STAT,1886,84,na,1970,712.1781083658394
STAT,1897,15,40-44,1912,0.24881216722413763
STAT,1951,15,20-24,1966,163.1997444376007
STAT,1765,115,na,1880,1.5663271572759316E-4
SIM,1943,18,40-44,1961,3
SIM,1868,36,50-100,1904,3
STAT,1941,29,20-24,1970,19.045410518849497
STAT,1895,27,40-44,1922,3.951039070632308
SIM,1885,36,20-24,1921,1
SIM,1793,65,na,1858,781
STAT,1908,32,45-49,1940,1.499379863034036
STAT,1913,26,40-44,1939,4.702022094154952
STAT,1849,41,na,1890,1815.2259661258117
SIM,1852,44,50-100,1896,1
STAT,1846,27,45-49,1873,1.019328335208703
STAT,1836,27,35-39,1863,7.8763221885400325
STAT,1861,75,na,1936,864.0070525428448
STAT,1906,19,25-29,1925,8.291637835435326
STAT,1909,1,na,1910,4119.024079325596
SIM,1890,34,na,1924,3250
STAT,1852,28,30-34,1880,22.084224385424207
STAT,1923,26,na,1949,4360.5890316530695
STAT,1862,28,40-44,1890,2.6035946264903815
SIM,1844,27,35-39,1871,8
SIM,1895,22,20-24,1917,96
SIM,1855,34,35-39,1889,16
STAT,1828,36,40-44,1864,4.612047358726287
STAT,1862,24,25-29,1886,50.38223184214153
SIM,1860,28,30-34,1888,26
STAT,1935,18,40-44,1953,1.9268274441616575
SIM,1870,28,40-44,1898,11
SIM,1888,47,45-49,1935,2
SIM,1865,67,na,1932,1313
STAT,1921,33,50-100,1954,0.925353457023628
STAT,1899,47,na,1946,3104.658931120187
STAT,1905,31,30-34,1936,14.697829291188212
STAT,1907,37,20-24,1944,0.24678087636676438
STAT,1932,16,15-19,1948,60.87916111440865
SIM,1810,62,na,1872,1040
STAT,1917,37,30-34,1954,1.9108205842630117
STAT,1871,85,na,1956,300.38869010573956
STAT,1876,15,20-24,1891,18.57397214132698
SIM,1836,36,40-44,1872,6
STAT,1830,43,50-100,1873,0.9050350241786586
SIM,1874,36,45-49,1910,3
STAT,1887,22,20-24,1909,77.70889449354793
SIM,1863,46,50-100,1909,3
SIM,1846,53,na,1899,1497
STAT,1946,21,25-29,1967,103.85144071509673
STAT,1897,22,30-34,1919,24.11887873529569
STAT,1834,42,na,1876,1508.6413417199403
STAT,1899,28,20-24,1927,16.20433227280026
SIM,1870,24,25-29,1894,105
STAT,1824,35,45-49,1859,2.9485171783478674
SIM,1841,98,na,1939,5
STAT,1860,19,25-29,1879,5.332550297254916
STAT,1819,75,na,1894,523.3403470284771
STAT,1870,19,35-39,1889,0.5429346364194885
STAT,1870,38,na,1908,2325.0407682074865
STAT,1881,26,35-39,1907,9.426100693950014
STAT,1927,29,na,1956,4584.634259617647
SIM,1850,68,na,1918,1208
STAT,1855,46,50-100,1901,0.18539311416004062
STAT,1888,28,45-49,1916,1.3189462315425686
SIM,1935,23,30-34,1958,3
SIM,1896,28,45-49,1924,2
STAT,1891,26,45-49,1917,1.3931744960774053
SIM,1786,83,na,1869,79
STAT,1881,23,50-100,1904,0.39578389294457594
STAT,1927,23,30-34,1950,35.680660580434335
STAT,1875,48,20-24,1923,0.012290218219030794
STAT,1844,42,na,1886,1872.808270181471
SIM,1808,58,na,1866,1047
STAT,1866,36,45-49,1902,1.8733470315945384
SIM,1894,37,na,1931,3307
STAT,1844,29,35-39,1873,9.211684121806975
SIM,1881,74,na,1955,916
STAT,1884,17,20-24,1901,17.657528683666303
STAT,1877,70,na,1947,1462.597269279206
SIM,1940,16,15-19,1956,44
STAT,1848,89,na,1937,85.77183535235505
SIM,1920,15,35-39,1935,5
SIM,1906,28,30-34,1934,44
STAT,1907,30,na,1937,3598.2430233696596
STAT,1855,5,na,1860,2251.242437441305
STAT,1915,39,20-24,1954,0.2660058907709681
SIM,1887,23,25-29,1910,75
SIM,1917,28,40-44,1945,10
SIM,1938,31,35-39,1969,12
SIM,1832,39,na,1871,1597
STAT,1878,55,na,1933,2167.9041557550986
STAT,1905,24,40-44,1929,3.0235152328813335
STAT,1873,17,45-49,1890,0.06688433790786959
STAT,1935,25,30-34,1960,54.00995276956563
STAT,1858,41,35-39,1899,1.441356965816249
STAT,1860,37,20-24,1897,0.6364333131290294
STAT,1827,94,na,1921,11.884895262766161
SIM,1841,29,25-29,1870,42
SIM,1855,2,na,1857,3058
STAT,1854,23,20-24,1877,60.33041061112849
SIM,1831,54,na,1885,1433
STAT,1833,29,25-29,1862,39.02373998976232
STAT,1881,19,45-49,1900,0.06325468349306132
SIM,1941,27,20-24,1968,26
SIM,1884,7,na,1891,2643
STAT,1830,36,30-34,1866,4.914006571002463
STAT,1883,17,20-24,1900,17.522372236771705
SIM,1921,26,40-44,1947,1
STAT,1914,28,15-19,1942,0.7155109830382086
SIM,1908,30,45-49,1938,3
SIM,1913,24,40-44,1937,4
SIM,1891,17,20-24,1908,30
SIM,1902,27,35-39,1929,18
STAT,1798,75,na,1873,492.7911843426762
STAT,1919,17,45-49,1936,0.5573759578020763
STAT,1878,49,35-39,1927,0.14371893729894103
STAT,1887,32,15-19,1919,0.16058543635333047
SIM,1935,16,40-44,1951,2
STAT,1863,45,25-29,1908,0.05205953816671965
STAT,1850,49,50-100,1899,0.18413277782050497
SIM,1869,35,25-29,1904,1
STAT,1888,46,40-44,1934,0.20466896779647809
STAT,1904,12,na,1916,3743.1372873494706
SIM,1943,25,30-34,1968,43
STAT,1933,27,20-24,1960,24.492340777250096
STAT,1851,25,45-49,1876,0.9986412259759372
STAT,1931,21,30-34,1952,37.78747475870748
STAT,1879,23,25-29,1902,60.150423605332236
SIM,1877,34,20-24,1911,2
STAT,1837,38,40-44,1875,3.5984299088227876
STAT,1838,90,na,1928,52.77796307572459
STAT,1925,28,25-29,1953,78.28998166139533
STAT,1870,26,25-29,1896,42.09802710084098
STAT,1863,56,na,1919,1825.247609877956
SIM,1902,20,na,1922,3519
STAT,1928,25,na,1953,4696.537896945828
STAT,1862,17,35-39,1879,0.5481354654263889
STAT,1870,89,na,1959,159.52951698626114
SIM,1781,84,na,1865,31
STAT,1930,29,45-49,1959,2.2180951347591944
SIM,1869,38,45-49,1907,2
STAT,1856,39,20-24,1895,0.5908963789174955
SIM,1880,34,na,1914,2256
SIM,1892,17,20-24,1909,37
STAT,1799,108,na,1907,6.146747648803511E-4
SIM,1883,52,na,1935,2338
STAT,1869,41,na,1910,2279.8106427705175
SIM,1847,38,na,1885,1818
SIM,1871,19,na,1890,2393
STAT,1844,44,50-100,1888,0.834391598276348
SIM,1876,34,20-24,1910,4
STAT,1836,38,40-44,1874,3.35459840083873
SIM,1878,6,na,1884,3164
STAT,1823,91,na,1914,32.048819593974585
SIM,1880,21,15-19,1901,3
STAT,1840,25,35-39,1865,8.555867109640113
STAT,1783,76,na,1859,376.64830156048737
STAT,1876,30,na,1906,2508.5509377414423
SIM,1933,28,25-29,1961,99
STAT,1871,26,25-29,1897,42.59193416483416
STAT,1899,35,45-49,1934,2.7895184620695646
STAT,1928,40,15-19,1968,0.0019842783124687847
STAT,1861,6,na,1867,2406.584392992058
STAT,1866,3,na,1869,2980.378196384906
SIM,1923,15,na,1938,4346
SIM,1844,38,40-44,1882,3
SIM,1911,34,na,1945,3912
STAT,1919,11,na,1930,4427.606064075376
STAT,1902,26,30-34,1928,36.06446008039322
STAT,1865,36,45-49,1901,1.84735390560656
SIM,1840,34,40-44,1874,4
STAT,1847,27,45-49,1874,0.9992102903289802
STAT,1866,105,na,1971,0.3520728841707525
STAT,1820,102,na,1922,0.1492326012778037
SIM,1830,37,35-39,1867,15
STAT,1834,47,20-24,1881,0.0075790903520329194
STAT,1862,71,na,1933,1164.2401962131532
STAT,1913,33,30-34,1946,15.74900040502715
STAT,1916,44,na,1960,3828.056510548001
STAT,1938,23,40-44,1961,3.35834862272603
STAT,1863,35,30-34,1898,4.814680046170824
STAT,1911,30,50-100,1941,0.818779953859662
SIM,1895,33,na,1928,3178
SIM,1928,7,na,1935,5173
SIM,1948,21,na,1969,4555
SIM,1805,51,na,1856,1093
SIM,1830,44,25-29,1874,3
SIM,1850,5,na,1855,2420
STAT,1858,34,45-49,1892,1.369951048287097
STAT,1909,35,30-34,1944,1.7573561247546283
STAT,1886,15,30-34,1901,1.7075882315394644
STAT,1886,48,30-34,1934,0.10192979362134152
SIM,1834,20,40-44,1854,2
SIM,1921,33,30-34,1954,11
STAT,1839,75,na,1914,729.8606839073775
SIM,1844,72,na,1916,846
STAT,1821,44,50-100,1865,1.5905741442133234
STAT,1928,33,25-29,1961,11.674050805319524
SIM,1874,29,20-24,1903,16
STAT,1893,22,na,1915,3033.0364293478488
STAT,1840,83,na,1923,278.28298329690386
SIM,1932,18,30-34,1950,18
SIM,1936,33,25-29,1969,13
SIM,1894,15,30-34,1909,3
SIM,1851,16,20-24,1867,1
SIM,1926,33,na,1959,4562
STAT,1822,37,35-39,1859,13.179713388704181
STAT,1939,8,na,1947,4021.6112593857015
STAT,1832,34,40-44,1866,3.7777978071027114
STAT,1855,47,40-44,1902,0.12826502929416342
STAT,1828,33,20-24,1861,3.054966701357683
STAT,1912,15,35-39,1927,0.8600346902966731
STAT,1812,95,na,1907,6.03632137623055
STAT,1902,19,40-44,1921,0.25965027031937565
SIM,1859,38,35-39,1897,10
STAT,1876,25,15-19,1901,0.47635043203374167
STAT,1941,27,50-100,1968,1.039536727266609
SIM,1889,21,35-39,1910,8
SIM,1910,26,30-34,1936,11
SIM,1898,51,na,1949,2959
STAT,1844,36,25-29,1880,2.672878563519392
SIM,1895,28,45-49,1923,5
STAT,1863,28,40-44,1891,2.6712634198873357
SIM,1900,6,na,1906,3853
SIM,1900,29,25-29,1929,97
STAT,1867,49,25-29,1916,0.05364640094839421
STAT,1924,18,30-34,1942,14.628932986236935
SIM,1873,36,45-49,1909,2
SIM,1898,30,25-29,1928,17
STAT,1822,44,25-29,1866,0.9731283459485642
SIM,1828,37,45-49,1865,1
STAT,1873,24,35-39,1897,5.937599322068251
STAT,1911,7,na,1918,4022.372132525355
STAT,1946,10,na,1956,4401.6275175247065
STAT,1919,24,35-39,1943,10.345184070605953
STAT,1943,16,25-29,1959,46.41346678558358
STAT,1854,26,40-44,1880,2.6085908283663577
SIM,1836,33,20-24,1869,2
STAT,1824,76,na,1900,471.0025016565513
STAT,1896,37,35-39,1933,9.455938669740902
SIM,1951,16,25-29,1967,71
STAT,1853,38,25-29,1891,2.369218592287496
STAT,1840,18,45-49,1858,0.0589367367194763
STAT,1871,52,40-44,1923,0.010507462375445843
STAT,1921,24,25-29,1945,104.71127880450352
SIM,1879,32,30-34,1911,29
STAT,1909,28,40-44,1937,4.479234106706014
STAT,1877,39,40-44,1916,4.517284320412549
SIM,1934,20,45-49,1954,1
STAT,1879,20,20-24,1899,73.06713072487439
STAT,1962,8,na,1970,5085.192018158219
SIM,1858,25,20-24,1883,16
STAT,1829,46,35-39,1875,0.10581873313256683
STAT,1843,29,20-24,1872,9.598395237187372
STAT,1881,27,45-49,1908,1.0809527666295022
STAT,1820,47,25-29,1867,0.09796408834988349
STAT,1894,16,na,1910,3292.200867374738
SIM,1807,93,na,1900,15
STAT,1883,64,na,1947,1718.1436238132385
SIM,1823,56,na,1879,1232
SIM,1870,58,na,1928,2159
SIM,1856,11,na,1867,2529
SIM,1948,20,45-49,1968,1
STAT,1911,49,45-49,1960,0.20636516859464568
SIM,1862,33,35-39,1895,6
SIM,1871,28,35-39,1899,3
SIM,1862,38,40-44,1900,8
STAT,1853,51,20-24,1904,6.131617900622773E-4
STAT,1863,28,35-39,1891,8.604333089057773
STAT,1871,31,15-19,1902,0.14347926804934447
SIM,1844,39,30-34,1883,10
SIM,1920,34,50-100,1954,1
STAT,1854,22,25-29,1876,50.478913267399804
STAT,1856,30,35-39,1886,8.104439002399388
SIM,1811,47,na,1858,1545
STAT,1963,7,na,1970,5042.596738321649
STAT,1879,59,na,1938,2048.410868601708
STAT,1946,9,na,1955,4402.111749817187
STAT,1824,52,35-39,1876,0.009710910968257835
STAT,1827,50,50-100,1877,0.015561267193892598
STAT,1831,33,40-44,1864,3.5471181418231184
STAT,1950,20,35-39,1970,11.293288306026842
STAT,1844,19,40-44,1863,0.1817906751764439
STAT,1903,18,na,1921,3623.3472436985853
SIM,1862,22,25-29,1884,63
SIM,1885,38,35-39,1923,6
STAT,1845,40,30-34,1885,0.8776373756849518
STAT,1883,49,15-19,1932,3.8709363207322517E-4
STAT,1794,81,na,1875,213.01694532498723
STAT,1862,19,na,1881,2268.9326447127946
SIM,1845,59,na,1904,1557
STAT,1858,65,na,1923,1339.1036224074687
STAT,1927,20,na,1947,4574.689132278473
SIM,1824,33,45-49,1857,1
STAT,1884,17,15-19,1901,5.910782914462934
STAT,1849,17,20-24,1866,17.06191714184533
STAT,1852,38,30-34,1890,4.021861003098534
SIM,1851,29,20-24,1880,10
STAT,1875,69,na,1944,1522.1616619507272
STAT,1868,45,30-34,1913,0.09437171484415557
SIM,1867,36,20-24,1903,1
STAT,1790,91,na,1881,16.234316889279885
SIM,1857,40,45-49,1897,1
STAT,1843,32,20-24,1875,2.191747599370607
STAT,1826,35,25-29,1861,3.504574562100641
STAT,1862,70,na,1932,1223.7898082842657
SIM,1830,24,30-34,1854,21
STAT,1923,48,25-29,1971,0.06252427067701875
STAT,1796,96,na,1892,1.7989164725797755
STAT,1840,20,30-34,1860,16.109217282225444
SIM,1816,39,25-29,1855,2
STAT,1812,103,na,1915,0.06515740577517641
SIM,1841,30,40-44,1871,6
STAT,1845,48,40-44,1893,0.12352164711799958
STAT,1877,38,35-39,1915,7.3364082990543515
STAT,1850,42,35-39,1892,1.3848580401616162
STAT,1803,83,na,1886,171.20422044386106
STAT,1874,26,45-49,1900,1.1522044723304543
SIM,1864,30,35-39,1894,13
STAT,1879,48,40-44,1927,0.1781774747322558
SIM,1833,36,20-24,1869,3
STAT,1828,67,na,1895,1029.055509540429
STAT,1864,18,na,1882,2367.1411934299867
STAT,1960,6,na,1966,5171.089419481373
STAT,1894,35,30-34,1929,6.99605579935375
SIM,1840,36,na,1876,1857
SIM,1860,38,30-34,1898,1
STAT,1816,44,50-100,1860,2.8234933865439986
SIM,1891,24,45-49,1915,4
STAT,1883,24,45-49,1907,0.6848980621331978
STAT,1944,23,15-19,1967,5.8019281791923225
SIM,1870,34,na,1904,2619
STAT,1833,30,40-44,1863,4.048016959938823
STAT,1885,46,15-19,1931,4.032764868110786E-4
SIM,1874,48,na,1922,2132
STAT,1893,26,25-29,1919,54.43526529367522
SIM,1882,26,45-49,1908,1
STAT,1859,39,25-29,1898,2.3153345672425014
SIM,1828,44,50-100,1872,3
SIM,1869,61,na,1930,1758
STAT,1938,25,40-44,1963,4.665804824379172
SIM,1857,17,20-24,1874,26
STAT,1827,44,30-34,1871,1.1950543291791775
STAT,1922,49,20-24,1971,0.0127503617873119
STAT,1837,95,na,1932,9.069944740064946
STAT,1849,40,45-49,1889,1.1906034993371972
STAT,1872,34,40-44,1906,4.365890711272634
SIM,1865,87,na,1952,162
SIM,1891,43,50-100,1934,2
STAT,1811,54,20-24,1865,0.0016885052564783857
STAT,1923,46,na,1969,4353.142253203079
SIM,1834,35,25-29,1869,2
STAT,1845,24,25-29,1869,51.18446844103933
STAT,1828,32,25-29,1860,12.00936929620686
STAT,1867,26,50-100,1893,0.6105775998809262
SIM,1881,30,40-44,1911,13
SIM,1853,40,30-34,1893,4
STAT,1891,32,50-100,1923,1.1457450813404713
STAT,1843,16,15-19,1859,5.145434966386213
SIM,1836,43,35-39,1879,6
STAT,1864,52,35-39,1916,0.007804416857169021
STAT,1880,53,30-34,1933,0.006212554786350727
STAT,1889,6,na,1895,3253.414611344919
STAT,1911,45,na,1956,3525.3805055970583
STAT,1813,51,20-24,1864,0.0020821127079391983
SIM,1840,28,na,1868,1871
SIM,1851,32,20-24,1883,2
STAT,1895,34,35-39,1929,13.242869894161126
STAT,1841,19,15-19,1860,5.656553905892719
STAT,1846,47,45-49,1893,0.1782618737829059
SIM,1832,92,na,1924,44
STAT,1886,49,40-44,1935,0.1787546325484204
STAT,1845,39,na,1884,1771.567279075622
STAT,1895,23,25-29,1918,75.27155505054945
STAT,1812,44,na,1856,1426.5753282103667
SIM,1922,20,25-29,1942,108
STAT,1864,41,25-29,1905,0.5879018191089395
STAT,1877,16,50-100,1893,0.05119570627293681
STAT,1817,42,20-24,1859,0.3885279830655744
SIM,1910,48,na,1958,3178
STAT,1817,39,20-24,1856,2.250501932410825
STAT,1792,101,na,1893,0.10257986664236743
STAT,1847,43,45-49,1890,1.112495027696104
SIM,1880,34,40-44,1914,3
STAT,1866,106,na,1972,0.18283496947871347
SIM,1870,29,30-34,1899,41
STAT,1896,32,30-34,1928,23.342266365034323
STAT,1947,18,45-49,1965,0.5682178695870451
SIM,1853,24,25-29,1877,54
STAT,1854,75,na,1929,772.5974556731445
STAT,1858,89,na,1947,83.24300116953559
SIM,1881,10,na,1891,2279
SIM,1886,36,30-34,1922,3
STAT,1838,17,45-49,1855,0.057760598942922216
STAT,1874,31,40-44,1905,4.503315561919641
STAT,1828,43,35-39,1871,1.6999908095793916
SIM,1841,25,45-49,1866,1
STAT,1845,90,na,1935,57.6077020594605
STAT,1880,40,25-29,1920,0.6880156822392505
STAT,1840,15,50-100,1855,0.044992903645781526
SIM,1838,40,35-39,1878,2
STAT,1767,111,na,1878,9.633791275247489E-4
SIM,1869,39,35-39,1908,6
SIM,1844,18,na,1862,1984
STAT,1866,37,20-24,1903,0.720922987596022
SIM,1886,41,na,1927,2610
SIM,1863,37,45-49,1900,2
STAT,1865,53,35-39,1918,0.007812275205765297
SIM,1887,35,35-39,1922,12
STAT,1837,18,40-44,1855,0.1998656549205762
SIM,1836,32,25-29,1868,19
STAT,1823,36,40-44,1859,7.955052744348434
STAT,1879,35,35-39,1914,7.525657665377598
STAT,1889,37,15-19,1926,0.06993456516412946
STAT,1949,15,45-49,1964,0.5872553715606526
STAT,1862,29,30-34,1891,21.807182230320347
STAT,1848,44,45-49,1892,1.2054505600350676
STAT,1882,50,30-34,1932,0.005907350787913951
STAT,1862,44,25-29,1906,0.55254207164016
SIM,1853,54,na,1907,1552
SIM,1860,42,45-49,1902,3
STAT,1807,73,na,1880,515.086636239304
STAT,1821,80,na,1901,370.5341851280185
SIM,1841,77,na,1918,485
STAT,1829,41,30-34,1870,0.9061925160992805
SIM,1813,43,40-44,1856,5
SIM,1791,85,na,1876,47
SIM,1892,20,45-49,1912,1
STAT,1911,13,na,1924,3980.918884867316
STAT,1897,31,35-39,1928,13.768681390572883
SIM,1828,87,na,1915,66
STAT,1812,50,20-24,1862,0.0016954984413505415
SIM,1849,41,na,1890,1839
STAT,1938,8,na,1946,3971.846665621241
STAT,1834,29,25-29,1863,32.56185326911526
STAT,1914,26,50-100,1940,1.0158638910872493
SIM,1843,22,15-19,1865,2
SIM,1932,30,35-39,1962,18
SIM,1774,81,na,1855,201
STAT,1900,38,50-100,1938,0.3699503329696386
STAT,1890,27,40-44,1917,3.697007625759374
STAT,1867,36,25-29,1903,2.7519372573465146
STAT,1911,44,50-100,1955,0.11173399440660567
STAT,1894,19,25-29,1913,7.329130871805902
STAT,1925,32,50-100,1957,0.9922354599147427
SIM,1870,66,na,1936,1846
STAT,1853,43,50-100,1896,0.8673497855073686
SIM,1906,20,40-44,1926,9
STAT,1914,20,25-29,1934,91.91220444792116
SIM,1915,30,35-39,1945,17
STAT,1883,32,na,1915,2358.5614374766296
SIM,1856,41,40-44,1897,6
STAT,1884,20,45-49,1904,0.6986727560197876
STAT,1939,24,45-49,1963,1.1399880386855237
STAT,1800,54,45-49,1854,0.04301645181179934
STAT,1899,28,15-19,1927,0.6266868885032485
STAT,1850,93,na,1943,22.378287709910413
STAT,1886,41,30-34,1927,1.231545506940549
STAT,1887,46,na,1933,2544.226914123048
STAT,1879,18,45-49,1897,0.06866952187741593
STAT,1828,59,na,1887,1303.917179840879
STAT,1870,23,20-24,1893,68.1354102025209
STAT,1866,45,50-100,1911,0.23198306117186263
SIM,1831,40,25-29,1871,1
STAT,1844,28,25-29,1872,40.67657608127793
STAT,1861,40,15-19,1901,0.011707265875446198
SIM,1852,28,25-29,1880,4
SIM,1877,41,30-34,1918,1
SIM,1919,18,35-39,1937,7
STAT,1767,103,na,1870,0.04050288844022043
STAT,1894,48,na,1942,2889.325026938994
STAT,1870,41,50-100,1911,1.0525175012509578
STAT,1880,42,20-24,1922,0.16824725471732574
STAT,1830,37,40-44,1867,3.9797126008584827
STAT,1838,34,35-39,1872,8.250868757694988
STAT,1890,34,na,1924,2919.876925797649
SIM,1804,77,na,1881,384
STAT,1840,40,25-29,1880,0.5293992389418544
STAT,1869,41,30-34,1910,1.1340346065982714
SIM,1936,9,na,1945,3951
STAT,1835,22,15-19,1857,3.292656659623909
STAT,1833,25,45-49,1858,1.0542252795348965
STAT,1824,45,na,1869,1323.3748895149106
STAT,1878,36,30-34,1914,5.614715748825864
STAT,1865,50,30-34,1915,0.0055686648683235425
STAT,1904,48,15-19,1952,3.2292765971231476E-4
STAT,1830,30,15-19,1860,0.14113598574015399
STAT,1843,52,45-49,1895,0.009736048456325594
STAT,1819,50,30-34,1869,0.011598407530350182
SIM,1875,36,25-29,1911,2
STAT,1903,26,na,1929,3444.587164728487
SIM,1933,8,na,1941,5123
SIM,1894,30,20-24,1924,4
STAT,1835,35,20-24,1870,0.730564914035884
SIM,1890,78,na,1968,1565
SIM,1872,24,35-39,1896,10
SIM,1897,37,45-49,1934,3
STAT,1900,53,na,1953,2972.4956658286433
STAT,1946,23,50-100,1969,0.7392999067863865
SIM,1888,31,35-39,1919,13
SIM,1907,60,na,1967,3220
STAT,1928,18,35-39,1946,5.330161761543595
STAT,1835,37,na,1872,1987.2884845099256
STAT,1823,40,25-29,1863,1.0011523966308016
STAT,1879,51,40-44,1930,0.011149231522649452
STAT,1895,36,30-34,1931,7.063351350219399
STAT,1930,38,15-19,1968,0.025291251245909904
STAT,1815,60,na,1875,1039.2719317690285
SIM,1950,6,na,1956,4539
SIM,1826,29,40-44,1855,4
STAT,1869,29,40-44,1898,2.920495813718374
SIM,1815,69,na,1884,718
STAT,1887,48,45-49,1935,0.2627805807912375
STAT,1850,25,45-49,1875,1.0150085853478297
STAT,1890,42,35-39,1932,2.232083987046507
STAT,1841,57,na,1898,1502.8312880724689
STAT,1830,30,50-100,1860,0.908063560011394
STAT,1864,24,35-39,1888,5.326584172428092
STAT,1861,48,25-29,1909,0.04773510871473337
STAT,1886,30,20-24,1916,2.9056930513646337
SIM,1882,59,na,1941,1653
STAT,1890,31,25-29,1921,12.692680253315928
STAT,1840,26,45-49,1866,0.9774555641003055
STAT,1823,51,35-39,1874,0.011634606834324756
SIM,1867,39,50-100,1906,1
SIM,1795,75,na,1870,344
SIM,1936,18,35-39,1954,4
SIM,1873,23,na,1896,2454
STAT,1851,29,25-29,1880,36.966212347645055
STAT,1828,45,30-34,1873,0.09056176365742537
STAT,1870,30,15-19,1900,0.14237354973177568
STAT,1928,23,30-34,1951,36.159016960024026
STAT,1844,44,30-34,1888,0.908014388352102
STAT,1869,49,40-44,1918,0.1646012577344835
STAT,1860,28,na,1888,1977.1900410481646
SIM,1787,88,na,1875,16
SIM,1861,41,na,1902,2013
SIM,1862,35,30-34,1897,4
SIM,1837,24,40-44,1861,2
SIM,1894,25,25-29,1919,66
STAT,1885,26,20-24,1911,11.83454469735398
SIM,1946,25,40-44,1971,6
SIM,1846,34,35-39,1880,9
SIM,1879,41,35-39,1920,1
SIM,1880,37,50-100,1917,1
STAT,1937,30,na,1967,3781.7665346333665
SIM,1802,62,na,1864,993
SIM,1878,42,30-34,1920,4
SIM,1861,18,25-29,1879,8
STAT,1838,47,40-44,1885,0.11790594638929669
STAT,1880,20,30-34,1900,19.0064061245029
STAT,1896,15,40-44,1911,0.24566308449625668
STAT,1868,17,30-34,1885,1.5664043222359871
STAT,1948,22,na,1970,4235.671055050526
SIM,1876,17,30-34,1893,2
SIM,1893,26,20-24,1919,23
STAT,1848,36,15-19,1884,0.047740285138458786
SIM,1941,20,35-39,1961,16
STAT,1825,39,25-29,1864,4.382083699197145
SIM,1936,23,30-34,1959,37
STAT,1862,9,na,1871,2433.7744766898586
STAT,1918,33,15-19,1951,0.13727916406995763
SIM,1947,24,45-49,1971,1
STAT,1854,35,30-34,1889,4.0609775528856975
SIM,1877,25,25-29,1902,49
STAT,1848,87,na,1935,143.84428922392104
STAT,1907,30,35-39,1937,8.69424142618939
SIM,1845,35,30-34,1880,2
STAT,1889,37,45-49,1926,2.482676768075612
SIM,1869,18,na,1887,2429
SIM,1828,79,na,1907,428
STAT,1839,51,40-44,1890,0.007499529418709818
STAT,1837,63,na,1900,1217.2159187567643
SIM,1894,25,50-100,1919,5
STAT,1891,43,35-39,1934,2.248025741116737
STAT,1924,30,35-39,1954,10.822240882343031
SIM,1821,37,40-44,1858,11
STAT,1858,27,15-19,1885,0.36802652604334707
STAT,1870,14,na,1884,2602.7850776873456
SIM,1842,29,25-29,1871,52
SIM,1877,30,20-24,1907,1
STAT,1870,18,25-29,1888,5.640314366976888
STAT,1886,25,25-29,1911,45.4159797316337
STAT,1844,45,15-19,1889,3.21464179131482E-4
STAT,1840,51,35-39,1891,0.00606371866070603
STAT,1854,33,35-39,1887,7.702691929883338
STAT,1817,75,na,1892,471.0018909752148
STAT,1899,44,20-24,1943,0.015080557858041075
STAT,1821,40,15-19,1861,0.023330798157899145
STAT,1855,34,35-39,1889,7.602110487528586
STAT,1849,37,15-19,1886,0.04492602348179431
STAT,1837,35,30-34,1872,4.519685358246667
STAT,1913,38,15-19,1951,0.0190260717109778
STAT,1838,50,40-44,1888,0.007293204801673181
SIM,1773,88,na,1861,60
SIM,1897,42,40-44,1939,1
SIM,1861,34,30-34,1895,18
SIM,1846,84,na,1930,106
STAT,1809,45,20-24,1854,0.04542093120769867
STAT,1853,34,30-34,1887,14.56334348851178
STAT,1879,52,25-29,1931,0.00371340678536375
SIM,1924,32,na,1956,4451
STAT,1870,38,25-29,1908,2.841390360416954
STAT,1877,51,50-100,1928,0.01581878472344804
SIM,1929,25,40-44,1954,6
STAT,1831,36,45-49,1867,1.6110569225887679
SIM,1842,70,na,1912,895
STAT,1851,21,50-100,1872,0.37140295844917565
STAT,1880,28,40-44,1908,3.1662415344891137
SIM,1832,84,na,1916,224
STAT,1910,45,35-39,1955,0.12193449321199591
SIM,1827,34,25-29,1861,10
STAT,1881,21,30-34,1902,17.39377884204384
STAT,1786,86,na,1872,72.8730704382939
STAT,1839,46,45-49,1885,0.17267312238829025
STAT,1865,59,na,1924,1792.3714768718958
STAT,1865,104,na,1969,0.5657727735462549
STAT,1889,42,40-44,1931,2.797786291440364
SIM,1898,18,20-24,1916,20
SIM,1863,34,35-39,1897,3
STAT,1852,92,na,1944,31.58658004168899
STAT,1853,54,25-29,1907,0.002848611520031093
STAT,1810,85,na,1895,142.37450072094632
STAT,1850,30,40-44,1880,3.897432595985782
STAT,1868,46,15-19,1914,3.872122792516429E-4
STAT,1832,29,15-19,1861,0.40854242077298925
STAT,1870,51,20-24,1921,7.353614416712909E-4
STAT,1822,41,20-24,1863,0.2589643807246944
SIM,1823,35,50-100,1858,1
SIM,1937,31,25-29,1968,12
STAT,1918,16,25-29,1934,9.577283623292866
STAT,1832,32,na,1864,1906.3494290830863
SIM,1863,56,na,1919,1807
STAT,1859,27,30-34,1886,20.80924642996964
SIM,1872,40,40-44,1912,5
SIM,1830,58,na,1888,1080
STAT,1871,22,25-29,1893,57.44163253455961
STAT,1896,35,35-39,1931,9.545742865096138
STAT,1862,52,50-100,1914,0.013102798507309917
SIM,1822,33,40-44,1855,5
STAT,1850,69,na,1919,1123.7182455826453
STAT,1807,52,35-39,1859,0.02921959142921582
STAT,1895,39,40-44,1934,5.715655495484082
STAT,1816,46,20-24,1862,0.03149761987384725
STAT,1895,57,na,1952,2650.629684373041
SIM,1890,20,35-39,1910,10
STAT,1820,44,20-24,1864,0.2795812898588641
SIM,1867,46,na,1913,2006
STAT,1834,26,15-19,1860,0.3568776369180066
STAT,1822,52,30-34,1874,0.00850084065348852
STAT,1872,46,35-39,1918,0.14256253990707948
SIM,1899,48,na,1947,3333
SIM,1914,37,50-100,1951,4
STAT,1887,14,na,1901,2902.7281922055645
SIM,1867,27,30-34,1894,2
STAT,1779,84,na,1863,121.24801942186417
STAT,1814,75,na,1889,487.5292657633055
STAT,1861,77,na,1938,725.4671420299512
STAT,1882,20,35-39,1902,5.743191632736269
SIM,1882,23,40-44,1905,2
SIM,1847,30,35-39,1877,16
STAT,1833,33,45-49,1866,1.577810014761117
STAT,1864,40,40-44,1904,2.0706460018012427
SIM,1872,37,40-44,1909,7
SIM,1811,87,na,1898,78
STAT,1832,47,50-100,1879,0.19830952029133564
STAT,1845,41,15-19,1886,0.01040798934903028
STAT,1867,53,45-49,1920,0.013582879923537539
STAT,1883,21,40-44,1904,2.065794964153402
SIM,1883,30,45-49,1913,2
STAT,1911,46,40-44,1957,0.15095920819348008
SIM,1833,34,na,1867,1903
SIM,1897,8,na,1905,3600
STAT,1901,39,35-39,1940,2.1397331447911103
SIM,1836,23,na,1859,2102
STAT,1829,44,35-39,1873,1.3652887068102795
STAT,1894,38,35-39,1932,9.151551974180016
STAT,1874,43,35-39,1917,1.8591966190319769
STAT,1849,72,na,1921,987.39803600181
SIM,1825,90,na,1915,16
STAT,1848,41,50-100,1889,0.8725952668182563
STAT,1853,18,25-29,1871,5.604052030949898
SIM,1841,33,45-49,1874,1
STAT,1842,108,na,1950,0.0016491643904720768
SIM,1856,41,50-100,1897,1
STAT,1882,53,40-44,1935,0.010134327532957002
STAT,1855,51,25-29,1906,0.0026789034286778383
STAT,1839,30,35-39,1869,9.021002176324764
STAT,1871,30,30-34,1901,17.660327366246783
SIM,1852,44,30-34,1896,1
STAT,1871,38,40-44,1909,4.370705532643557
STAT,1936,13,na,1949,3823.8263659470826
STAT,1903,22,15-19,1925,4.745359912431904
STAT,1835,29,50-100,1864,0.6170257399378091
STAT,1844,33,20-24,1877,2.5310108646034535
STAT,1845,54,50-100,1899,0.010731902941159485
SIM,1911,22,15-19,1933,4
SIM,1969,2,na,1971,5011
STAT,1846,28,35-39,1874,8.79472246015359
STAT,1861,19,40-44,1880,0.1743661055655101
SIM,1854,28,35-39,1882,12
STAT,1933,20,35-39,1953,12.696378805715113
SIM,1808,59,na,1867,1020
SIM,1929,22,30-34,1951,37
STAT,1866,49,15-19,1915,3.66281943504546E-4
STAT,1881,24,40-44,1905,2.0160241371698078
SIM,1862,30,30-34,1892,24
SIM,1834,41,50-100,1875,1
SIM,1884,23,15-19,1907,3
SIM,1852,33,20-24,1885,3
STAT,1862,17,50-100,1879,0.048940657488387176
STAT,1878,85,na,1963,492.58056852407276
STAT,1875,30,45-49,1905,1.8232616424879762
STAT,1860,16,15-19,1876,5.6844320756170985
STAT,1915,51,na,1966,3687.8676600883846
STAT,1895,20,20-24,1915,91.43537523242841
SIM,1882,43,35-39,1925,6
SIM,1843,35,20-24,1878,1
STAT,1881,52,35-39,1933,0.008336863709604975
SIM,1906,35,na,1941,3448
STAT,1905,49,20-24,1954,0.00967703560493787
STAT,1824,40,40-44,1864,2.912521227987483
STAT,1840,23,35-39,1863,5.1646749271641825
SIM,1891,37,20-24,1928,4
SIM,1893,34,20-24,1927,6
SIM,1857,92,na,1949,23
STAT,1822,43,40-44,1865,3.4921435846537987
STAT,1838,51,25-29,1889,0.0024056697195752883
SIM,1896,25,35-39,1921,22
SIM,1830,43,40-44,1873,5
SIM,1927,25,30-34,1952,81
SIM,1836,40,30-34,1876,3
STAT,1900,21,na,1921,3328.2074787258557
STAT,1853,26,na,1879,2087.4341517774606
SIM,1842,62,na,1904,1258
STAT,1938,28,45-49,1966,1.7270428406239462
SIM,1829,34,35-39,1863,7
SIM,1814,42,45-49,1856,8
STAT,1862,41,20-24,1903,0.1391467207381675
STAT,1848,41,40-44,1889,1.8578294715972747
STAT,1861,45,20-24,1906,0.010171768945172306
STAT,1872,18,35-39,1890,0.5557109372990373
STAT,1857,16,na,1873,2139.2327098077103
STAT,1847,40,35-39,1887,1.3987710919859837
SIM,1795,67,na,1862,744
SIM,1929,36,50-100,1965,3
STAT,1875,27,20-24,1902,12.168066421801512
SIM,1931,34,na,1965,4884
STAT,1858,57,na,1915,1592.4046406239809
STAT,1818,43,20-24,1861,0.3016017023433206
STAT,1821,88,na,1909,82.23176253381129
STAT,1855,17,45-49,1872,0.05848234774523999
STAT,1845,24,50-100,1869,0.36461371839080764
STAT,1883,37,20-24,1920,0.7618849431767336
STAT,1891,31,40-44,1922,5.445131085080155
STAT,1874,34,45-49,1908,1.7880024047863519
STAT,1823,36,na,1859,1600.9396121816872
STAT,1882,48,50-100,1930,0.2372630082687487
STAT,1885,41,15-19,1926,0.01394636241842965
SIM,1881,31,25-29,1912,19
STAT,1828,48,40-44,1876,0.15392839853175297
STAT,1863,42,20-24,1905,0.14194518394357974
SIM,1818,44,30-34,1862,1
SIM,1811,79,na,1890,391
SIM,1926,16,25-29,1942,66
STAT,1836,50,30-34,1886,0.003953014161800343
STAT,1886,42,15-19,1928,0.014708574630348064
SIM,1918,12,na,1930,4488
SIM,1841,22,40-44,1863,2
SIM,1883,27,20-24,1910,12
STAT,1864,39,50-100,1903,1.107687284868406
STAT,1923,45,20-24,1968,0.01312368139452242
SIM,1891,21,40-44,1912,6
STAT,1942,4,na,1946,4227.883485791179
STAT,1877,35,30-34,1912,5.6084390900948815
SIM,1881,18,na,1899,2235
SIM,1885,35,30-34,1920,8
STAT,1881,41,25-29,1922,0.6280107060193544
STAT,1919,25,30-34,1944,43.03616243970715
STAT,1863,53,30-34,1916,0.005241346929492042
STAT,1893,43,45-49,1936,0.13232102788607167
SIM,1868,38,35-39,1906,4
STAT,1818,54,30-34,1872,0.009782718443995333
STAT,1868,3,na,1871,3051.253513795256
SIM,1824,30,40-44,1854,6
SIM,1831,36,40-44,1867,4
SIM,1849,40,50-100,1889,3
STAT,1771,96,na,1867,1.1968551833091603
STAT,1828,40,30-34,1868,1.1358130558791684
STAT,1861,85,na,1946,230.07557673508828
STAT,1906,37,50-100,1943,0.389838728791621
STAT,1861,28,30-34,1889,21.135366271112794
STAT,1868,48,35-39,1916,0.13344267452009417
SIM,1827,62,na,1889,987
STAT,1826,52,45-49,1878,0.013791946016545688
STAT,1814,50,25-29,1864,0.008491638144442691
SIM,1815,43,45-49,1858,1
STAT,1885,34,20-24,1919,2.6942208900230553
STAT,1885,45,30-34,1930,0.09828689753910091
STAT,1873,33,45-49,1906,1.7779813516164167
STAT,1890,30,40-44,1920,5.395227417897161
SIM,1832,40,40-44,1872,5
SIM,1911,33,na,1944,3960
STAT,1827,28,25-29,1855,84.91890829308457
STAT,1895,31,30-34,1926,23.122837726328612
SIM,1812,72,na,1884,519
STAT,1836,54,na,1890,1320.2900977233237
STAT,1859,23,15-19,1882,2.7605382269399548
STAT,1859,44,20-24,1903,0.1272680899567357
SIM,1882,34,45-49,1916,4
STAT,1920,23,50-100,1943,0.7364190188710743
STAT,1787,71,na,1858,500.1855826355047
STAT,1883,56,na,1939,2015.9157932744376
STAT,1828,48,35-39,1876,0.12587602712699847
STAT,1886,21,na,1907,2529.685631459487
STAT,1832,40,na,1872,1786.0834911910588
STAT,1855,31,30-34,1886,13.521240248939847
SIM,1819,51,na,1870,1304
STAT,1853,37,35-39,1890,5.84914006004185
SIM,1906,23,45-49,1929,1
STAT,1825,48,15-19,1873,5.297081923874705E-4
SIM,1781,83,na,1864,54
STAT,1898,48,20-24,1946,0.009151718690902241
SIM,1835,28,25-29,1863,41
SIM,1842,26,20-24,1868,12
STAT,1824,33,50-100,1857,1.5807000833662774
SIM,1850,4,na,1854,2420
STAT,1886,28,35-39,1914,10.253330531421572
STAT,1900,27,25-29,1927,59.349365307160554
SIM,1852,69,na,1921,938
SIM,1812,43,25-29,1855,3
SIM,1878,45,50-100,1923,1
STAT,1848,53,35-39,1901,0.006916081945993957
SIM,1907,20,na,1927,3665
STAT,1884,33,20-24,1917,2.6808717774914106
SIM,1892,33,20-24,1925,3
STAT,1764,113,na,1877,2.5491089007723296E-4
STAT,1829,52,na,1881,1339.9847075701946
SIM,1938,15,35-39,1953,8
STAT,1819,37,35-39,1856,20.52333931310867
STAT,1881,24,35-39,1905,5.645656384574953
STAT,1855,4,na,1859,2386.3074384580295
SIM,1855,26,na,1881,2160
SIM,1863,105,na,1968,2
STAT,1813,54,25-29,1867,0.009407741149837195
SIM,1914,22,na,1936,3965
SIM,1953,15,30-34,1968,17
SIM,1897,34,40-44,1931,7
STAT,1844,16,30-34,1860,1.612501223478241
STAT,1865,41,40-44,1906,2.0837943502883993
SIM,1867,23,15-19,1890,2
SIM,1861,37,35-39,1898,18
SIM,1877,44,35-39,1921,5
SIM,1863,31,30-34,1894,26
STAT,1812,53,25-29,1865,0.007664160707748571
STAT,1869,33,25-29,1902,10.015368308402852
STAT,1869,49,na,1918,2163.1227891994463
SIM,1788,73,na,1861,432
STAT,1891,46,45-49,1937,0.16694086007046846
SIM,1908,17,20-24,1925,27
SIM,1827,37,35-39,1864,18
STAT,1896,35,40-44,1931,5.907957047100833
STAT,1797,108,na,1905,4.573326312154829E-4
STAT,1861,25,20-24,1886,10.061470957062403
STAT,1900,38,35-39,1938,2.131252352054909
STAT,1810,96,na,1906,4.459567803094431
SIM,1872,0,na,1872,3739
STAT,1832,32,45-49,1864,1.5521399275660104
STAT,1935,17,50-100,1952,0.5174701402331464
SIM,1884,39,30-34,1923,7
STAT,1833,25,15-19,1858,0.43078748256234334
STAT,1820,44,15-19,1864,0.02431141782254717
STAT,1876,39,30-34,1915,5.50197465887445
STAT,1934,30,na,1964,5223.536799851644
STAT,1824,77,na,1901,429.73326246140454
STAT,1880,45,25-29,1925,0.061706034224337555
SIM,1770,91,na,1861,7
STAT,1874,95,na,1969,63.14684820780998
STAT,1837,54,40-44,1891,0.006984663014886324
STAT,1871,34,25-29,1905,10.189683771364495
STAT,1869,44,35-39,1913,1.754142359601032
STAT,1829,27,45-49,1856,1.4692764026394876
STAT,1809,48,30-34,1857,0.3327426297459002
SIM,1837,44,40-44,1881,6
SIM,1840,32,45-49,1872,4
SIM,1845,67,na,1912,1190
SIM,1869,34,35-39,1903,18
STAT,1854,38,35-39,1892,5.281804185843349
SIM,1873,41,40-44,1914,2
SIM,1837,27,45-49,1864,1
SIM,1872,81,na,1953,362
STAT,1844,40,15-19,1884,0.011480604537965112
STAT,1850,45,45-49,1895,0.18251004628943204
STAT,1904,11,na,1915,3748.722884447297
SIM,1811,43,30-34,1854,1
SIM,1832,49,na,1881,1420
SIM,1877,33,25-29,1910,15
STAT,1832,29,45-49,1861,0.9997870531879665
STAT,1838,37,na,1875,1730.0767735897666
STAT,1845,27,35-39,1872,8.581518515485154
STAT,1866,52,45-49,1918,0.013500229020133913
SIM,1840,29,45-49,1869,2
STAT,1831,45,35-39,1876,0.10729168852045928
STAT,1842,36,20-24,1878,0.8226380577962931
STAT,1870,34,30-34,1904,17.168086818461774
STAT,1945,15,30-34,1960,13.45368448262578
STAT,1854,30,30-34,1884,13.700136076472813
SIM,1893,3,na,1896,3452
STAT,1827,47,35-39,1874,0.1435972619525664
STAT,1836,39,30-34,1875,4.042009337418995
SIM,1828,38,35-39,1866,10
STAT,1866,44,na,1910,2132.3698841548144
SIM,1894,28,35-39,1922,17
STAT,1860,44,15-19,1904,0.011247859692027592
SIM,1853,27,35-39,1880,14
STAT,1874,26,15-19,1900,0.470824664962779
SIM,1860,56,na,1916,1810
STAT,1864,37,40-44,1901,3.989599921697519
STAT,1849,29,na,1878,1976.2600388955902
STAT,1919,41,na,1960,4069.523703464294
STAT,1889,45,45-49,1934,0.29684321643972783
STAT,1910,42,30-34,1952,0.12190094789707287
SIM,1874,16,na,1890,2446
STAT,1854,38,40-44,1892,3.268962164826303
SIM,1876,29,25-29,1905,8
STAT,1831,47,na,1878,1516.0380472611366
SIM,1833,30,50-100,1863,4
STAT,1811,70,na,1881,715.2317124735181
STAT,1892,39,15-19,1931,0.07045283733883016
STAT,1920,39,45-49,1959,0.752139219618074
STAT,1854,50,25-29,1904,0.0026964330047712
SIM,1838,89,na,1927,42
SIM,1884,18,na,1902,2530
STAT,1865,20,35-39,1885,5.526299702922228
SIM,1883,84,na,1967,794
SIM,1895,29,35-39,1924,10
SIM,1834,29,50-100,1863,3
STAT,1858,97,na,1955,4.256892705910912
STAT,1835,38,30-34,1873,4.896137243800759
STAT,1840,23,40-44,1863,1.8442690458892697
SIM,1879,71,na,1950,1602
SIM,1892,69,na,1961,2176
STAT,1843,48,30-34,1891,0.06446813014928864
STAT,1880,23,35-39,1903,6.170628622300321
SIM,1822,33,35-39,1855,12
STAT,1895,39,35-39,1934,9.235032893839096
SIM,1834,75,na,1909,624
STAT,1852,25,25-29,1877,37.908540479292924
STAT,1768,113,na,1881,8.529452474235087E-4
STAT,1888,44,45-49,1932,1.7600793993281092
SIM,1948,22,40-44,1970,8
STAT,1830,33,25-29,1863,9.674125123442952
STAT,1834,26,20-24,1860,9.227835966319514
STAT,1929,31,25-29,1960,11.873206316559756
STAT,1857,20,50-100,1877,0.3764689271417725
SIM,1843,38,30-34,1881,11
STAT,1887,29,35-39,1916,10.802809550912793
SIM,1860,25,25-29,1885,5
STAT,1826,29,50-100,1855,1.1608830541006647
STAT,1861,45,15-19,1906,3.3905866659152107E-4
STAT,1939,21,40-44,1960,3.410073820182996
STAT,1858,43,20-24,1901,0.12493226606728779
STAT,1849,54,50-100,1903,0.011483412657838086
SIM,1947,21,40-44,1968,4
STAT,1875,27,15-19,1902,0.4705882079312533
SIM,1893,16,25-29,1909,4
STAT,1898,27,45-49,1925,1.5202367701176451
SIM,1963,5,na,1968,5081
STAT,1870,35,20-24,1905,0.771779591333262
SIM,1895,24,35-39,1919,11
STAT,1838,37,45-49,1875,1.6102699067769242
STAT,1872,69,na,1941,1490.1742060073675
STAT,1921,35,45-49,1956,0.7701214193307548
STAT,1843,67,na,1910,1069.1783687636123
STAT,1885,17,30-34,1902,1.6023770814505331
SIM,1916,27,20-24,1943,18
STAT,1864,43,45-49,1907,1.3541652976217098
SIM,1828,33,35-39,1861,2
SIM,1854,44,35-39,1898,2
STAT,1849,53,20-24,1902,5.676809459731552E-4
STAT,1855,34,40-44,1889,3.255454042471568
STAT,1890,35,40-44,1925,5.453851098927856
STAT,1894,72,na,1966,1953.3534581514682
STAT,1943,15,na,1958,3943.2040505153
STAT,1855,46,35-39,1901,0.10568011425576644
STAT,1876,39,25-29,1915,2.972331121236664
SIM,1796,60,na,1856,1135
STAT,1887,24,35-39,1911,6.5391612836215005
SIM,1886,15,25-29,1901,8
STAT,1797,70,na,1867,680.8297525504081
STAT,1844,48,25-29,1892,0.04499959308775122
STAT,1835,54,30-34,1889,0.0043779473827322895
SIM,1923,47,na,1970,4379
STAT,1906,45,20-24,1951,0.010057174857743684
STAT,1809,48,25-29,1857,0.19799561248600145
STAT,1939,21,35-39,1960,9.54954094042499
STAT,1893,35,15-19,1928,0.07269887378368996
STAT,1871,18,40-44,1889,0.18362668738174043
SIM,1863,34,40-44,1897,1
SIM,1889,46,na,1935,2691
SIM,1857,36,na,1893,2063
STAT,1901,36,30-34,1937,1.6365601694231298
SIM,1854,25,30-34,1879,33
SIM,1792,70,na,1862,540
STAT,1824,85,na,1909,136.2861561536811
SIM,1843,22,20-24,1865,72
STAT,1846,25,30-34,1871,23.454165846289957
STAT,1908,27,20-24,1935,17.56701619582217
STAT,1927,28,50-100,1955,1.2187560310061911
STAT,1916,21,40-44,1937,3.56632958948631
STAT,1826,44,15-19,1870,0.013842443011759785
STAT,1816,49,25-29,1865,0.14456330269252754
STAT,1859,113,na,1972,1.3622392416988308E-4
SIM,1847,15,na,1862,2185
STAT,1846,44,35-39,1890,1.355650094675022
SIM,1868,35,30-34,1903,3
SIM,1889,28,20-24,1917,15
SIM,1838,54,na,1892,1522
SIM,1861,15,20-24,1876,26
SIM,1921,32,na,1953,4137
SIM,1894,17,na,1911,3612
STAT,1919,33,30-34,1952,17.090050680630622
STAT,1886,45,25-29,1931,0.06203660953285873
SIM,1880,31,30-34,1911,3
SIM,1812,42,35-39,1854,3
SIM,1843,19,20-24,1862,22
STAT,1840,50,50-100,1890,0.010738978334889028
STAT,1842,100,na,1942,0.9558359091916657
STAT,1872,31,30-34,1903,17.801413472359194
STAT,1837,50,25-29,1887,0.002523178668264299
STAT,1869,25,25-29,1894,41.82004840095977
STAT,1823,44,40-44,1867,3.1709242470749164
SIM,1831,44,40-44,1875,14
STAT,1926,46,na,1972,4592.750995164096
SIM,1872,43,45-49,1915,5
SIM,1809,52,na,1861,1171
SIM,1938,15,40-44,1953,1
STAT,1853,15,20-24,1868,17.845930235923966
STAT,1885,16,25-29,1901,5.710967756652405
STAT,1835,22,20-24,1857,68.77948751485643
STAT,1862,24,30-34,1886,15.67670521495203
SIM,1868,87,na,1955,74
STAT,1932,35,20-24,1967,0.3585531165317995
STAT,1862,109,na,1971,0.010577047275162505
SIM,1884,23,20-24,1907,60
SIM,1927,28,35-39,1955,26
STAT,1816,100,na,1916,0.5427904837685502
STAT,1815,49,na,1864,1281.1706882414956
SIM,1946,22,30-34,1968,39
STAT,1883,43,50-100,1926,1.036623933791721
STAT,1896,18,45-49,1914,0.08710223447003099
SIM,1817,39,40-44,1856,6
SIM,1865,26,45-49,1891,1
SIM,1879,25,35-39,1904,12
SIM,1943,1,na,1944,4365
STAT,1864,45,40-44,1909,0.15758503123052903
SIM,1924,21,40-44,1945,8
SIM,1908,17,15-19,1925,10
STAT,1836,109,na,1945,4.4859244699780676E-4
STAT,1835,38,25-29,1873,2.6450396459245082
STAT,1815,49,50-100,1864,0.5270796398717601
STAT,1896,20,50-100,1916,0.5484365196433815
STAT,1829,44,40-44,1873,1.6958733893792532
STAT,1871,52,20-24,1923,7.365044007329478E-4
SIM,1917,27,na,1944,3869
STAT,1926,23,20-24,1949,136.10697866194556
SIM,1831,42,45-49,1873,3
SIM,1858,77,na,1935,537
STAT,1919,17,25-29,1936,48.35237409820478
SIM,1927,33,30-34,1960,8
SIM,1921,43,na,1964,4085
STAT,1904,6,na,1910,3786.3997927980645
STAT,1890,33,45-49,1923,2.1430749391474673
STAT,1774,104,na,1878,0.02129972963967979
STAT,1914,10,na,1924,4134.29878318758
SIM,1843,38,25-29,1881,6
SIM,1894,33,25-29,1927,8
STAT,1875,80,na,1955,641.6188894947365
SIM,1856,51,na,1907,2004
STAT,1910,45,40-44,1955,0.14910846564109373
SIM,1900,41,na,1941,3415
STAT,1917,46,35-39,1963,0.1362704253409584
SIM,1820,38,30-34,1858,8
SIM,1894,27,50-100,1921,5
SIM,1794,82,na,1876,233
SIM,1947,21,35-39,1968,14
STAT,1869,48,50-100,1917,0.23813870776791948
STAT,1924,31,na,1955,4461.390237966862
STAT,1896,74,na,1970,1907.2197908946184
STAT,1835,43,20-24,1878,0.14105910080364134
STAT,1919,28,35-39,1947,16.321357330645597
SIM,1846,37,45-49,1883,1
STAT,1857,26,45-49,1883,0.907978764188044
STAT,1874,46,45-49,1920,0.24476170024002286
STAT,1920,22,15-19,1942,5.976095311318055
SIM,1883,76,na,1959,1176
STAT,1892,60,na,1952,2417.1198255861327
SIM,1917,38,na,1955,3763
STAT,1883,16,15-19,1899,5.879945733550481
STAT,1838,80,na,1918,414.10473569368776
STAT,1874,40,30-34,1914,1.2009721071027057
SIM,1858,36,25-29,1894,3
STAT,1867,33,15-19,1900,0.13488965479721732
SIM,1879,39,na,1918,2729
SIM,1866,72,na,1938,1311
STAT,1874,23,40-44,1897,2.1483942972423873
STAT,1901,28,50-100,1929,0.9025251167222447
SIM,1831,39,45-49,1870,4
SIM,1919,15,30-34,1934,2
SIM,1843,25,na,1868,2439
SIM,1850,89,na,1939,85
SIM,1853,28,40-44,1881,8
STAT,1811,59,na,1870,1059.2085303641772
STAT,1938,34,50-100,1972,0.8381877551347173
STAT,1878,32,50-100,1910,0.9606420225316062
STAT,1841,101,na,1942,0.42672062084323537
STAT,1885,49,25-29,1934,0.056698389031414415
STAT,1910,26,50-100,1936,0.9730499060002824
STAT,1872,15,30-34,1887,1.6430703744062398
SIM,1946,19,na,1965,4120
STAT,1858,30,45-49,1888,1.4107774273834814
STAT,1938,22,30-34,1960,28.71645541343611
SIM,1832,60,na,1892,1117
SIM,1935,0,na,1935,5740
STAT,1870,54,25-29,1924,0.003416323567583609
STAT,1919,40,50-100,1959,0.1288996003270839
SIM,1882,40,30-34,1922,2
STAT,1825,30,na,1855,2132.0865844144346
SIM,1850,19,30-34,1869,1
STAT,1867,45,15-19,1912,3.842817558232509E-4
STAT,1813,53,40-44,1866,0.028531193132500726
STAT,1887,45,35-39,1932,0.15944433337244784
SIM,1868,84,na,1952,162
STAT,1845,28,40-44,1873,2.645051691640351
STAT,1842,19,30-34,1861,1.8211055075807436
SIM,1893,54,na,1947,2679
STAT,1872,40,na,1912,2370.5620049910717
STAT,1876,54,na,1930,2183.668279486041
STAT,1897,13,na,1910,3491.44906091487
SIM,1887,38,45-49,1925,1
STAT,1825,62,na,1887,1379.2295525777452
STAT,1846,21,na,1867,2016.534140883101
SIM,1923,20,40-44,1943,5
STAT,1886,25,30-34,1911,27.03598661305783
STAT,1867,2,na,1869,3200.3060116720403
STAT,1847,37,40-44,1884,3.4006542120510144
STAT,1836,42,25-29,1878,0.48191850334645525
STAT,1899,44,15-19,1943,0.0013113529280482706
SIM,1844,34,30-34,1878,26
STAT,1882,53,35-39,1935,0.008287417394193398
SIM,1892,13,na,1905,3559
SIM,1863,21,na,1884,2386
SIM,1919,23,25-29,1942,112
STAT,1902,35,35-39,1937,2.1995883394375313
STAT,1909,43,15-19,1952,0.001440753699075312
STAT,1931,17,50-100,1948,0.4956095208520656
SIM,1878,86,na,1964,422
SIM,1860,29,40-44,1889,2
STAT,1836,53,35-39,1889,0.00538738071295175
SIM,1827,34,30-34,1861,20
STAT,1836,34,30-34,1870,13.636145025339847
SIM,1866,30,45-49,1896,3
STAT,1878,51,25-29,1929,0.0037314086726576864
STAT,1831,30,30-34,1861,14.798987092521543
STAT,1910,28,na,1938,3636.8495305406036
SIM,1953,18,35-39,1971,5
STAT,1845,44,25-29,1889,0.46572289041632936
SIM,1889,49,na,1938,2648
SIM,1925,45,50-100,1970,3
SIM,1848,27,20-24,1875,12
SIM,1907,16,15-19,1923,12
STAT,1894,16,20-24,1910,23.109655052959493
STAT,1926,43,15-19,1969,0.001910347422248505
STAT,1863,44,40-44,1907,1.9856841842248594
STAT,1846,32,na,1878,1943.6195911836369
STAT,1927,22,25-29,1949,115.02693396512744
STAT,1915,20,40-44,1935,3.3854950072555594
STAT,1847,40,40-44,1887,1.737463044189393
SIM,1908,20,15-19,1928,5
STAT,1893,40,40-44,1933,2.9136709306328057
STAT,1879,38,45-49,1917,2.0907130071140942
SIM,1838,24,35-39,1862,10
SIM,1855,37,40-44,1892,12
STAT,1861,28,25-29,1889,35.50391483497442
SIM,1894,25,30-34,1919,48
STAT,1857,72,na,1929,995.4697482301486
STAT,1851,42,20-24,1893,0.12010324014831286
STAT,1852,34,15-19,1886,0.10952365720223059
SIM,1853,32,25-29,1885,12
STAT,1934,17,20-24,1951,185.29175202670316
SIM,1871,44,40-44,1915,3
STAT,1904,3,na,1907,3831.743829082367
SIM,1942,17,20-24,1959,153
STAT,1851,39,20-24,1890,0.5778029150737307
STAT,1853,35,15-19,1888,0.04741299783630156
SIM,1958,12,na,1970,5239
SIM,1889,78,na,1967,1016
SIM,1835,25,20-24,1860,14
STAT,1835,19,20-24,1854,38.001941166706054
STAT,1769,112,na,1881,6.307840894677404E-4
STAT,1852,22,15-19,1874,2.9722034015131205
STAT,1877,36,15-19,1913,0.058818565575863783
STAT,1830,51,20-24,1881,5.536667661147701E-4
STAT,1888,25,35-39,1913,11.580637730764948
STAT,1904,41,50-100,1945,0.10681366202126437
SIM,1860,22,15-19,1882,3
SIM,1873,36,50-100,1909,1
STAT,1848,36,na,1884,2002.954315289629
SIM,1828,35,30-34,1863,9
SIM,1858,33,20-24,1891,2
SIM,1895,26,30-34,1921,5
STAT,1823,39,15-19,1862,0.08936579201222193
SIM,1934,23,20-24,1957,162
SIM,1889,38,na,1927,2836
STAT,1826,39,40-44,1865,4.774345588635226
STAT,1862,41,15-19,1903,0.012099715500313293
SIM,1918,22,25-29,1940,116
SIM,1937,22,35-39,1959,9
STAT,1842,15,45-49,1857,0.07642006859785332
STAT,1945,23,30-34,1968,31.801307536936843
SIM,1853,24,30-34,1877,19
SIM,1855,40,40-44,1895,3
STAT,1879,19,na,1898,2647.7127158373382
SIM,1831,26,45-49,1857,1
SIM,1835,89,na,1924,26
STAT,1893,23,15-19,1916,4.217732061964059
STAT,1894,36,15-19,1930,0.07337121081219218
SIM,1939,30,na,1969,4009
STAT,1843,32,15-19,1875,0.11546980916858307
SIM,1925,17,na,1942,4488
SIM,1932,27,na,1959,5518
STAT,1887,26,30-34,1913,28.49371570600903
STAT,1935,33,15-19,1968,0.17951106648035176
STAT,1810,93,na,1903,15.17850505327291
SIM,1935,22,25-29,1957,150
SIM,1882,20,50-100,1902,1
SIM,1870,24,30-34,1894,38
STAT,1847,24,35-39,1871,5.279622443171191
STAT,1826,32,15-19,1858,0.19971910427364042
SIM,1856,44,45-49,1900,1
SIM,1907,21,40-44,1928,5
STAT,1786,110,na,1896,1.4766136018191716E-4
STAT,1797,100,na,1897,0.2650645101764154
SIM,1935,24,na,1959,4887
STAT,1836,35,15-19,1871,0.044394373068127164
STAT,1916,48,50-100,1964,0.23346394012145794
STAT,1929,22,35-39,1951,12.035120198991875
SIM,1931,10,na,1941,5169
STAT,1890,17,45-49,1907,0.08061847682570639
STAT,1926,35,na,1961,4654.985607670451
STAT,1899,31,45-49,1930,2.427080590329995
SIM,1908,33,20-24,1941,2
SIM,1893,43,na,1936,3028
STAT,1862,32,25-29,1894,8.93380745070766
STAT,1814,86,na,1900,103.85142270695519
STAT,1888,38,40-44,1926,5.192588617319239
SIM,1855,24,35-39,1879,8
STAT,1845,24,30-34,1869,15.926325492056288
STAT,1852,29,40-44,1881,2.3734722298910116
STAT,1872,61,na,1933,1897.4515890427167
STAT,1827,45,15-19,1872,4.2130471419414973E-4
STAT,1857,26,15-19,1883,0.3710268513170176
STAT,1861,33,20-24,1894,2.2590498685714304
STAT,1835,29,40-44,1864,2.889420079363094
SIM,1850,39,25-29,1889,1
SIM,1854,23,35-39,1877,7
STAT,1945,18,35-39,1963,4.627660466615939
STAT,1920,36,40-44,1956,1.6566556826398549
STAT,1842,39,25-29,1881,2.7103387034446804
STAT,1897,15,35-39,1912,0.7464364584546297
SIM,1908,20,45-49,1928,1
SIM,1876,26,20-24,1902,16
STAT,1900,35,30-34,1935,7.548471391936254
SIM,1921,35,na,1956,4108
SIM,1900,70,na,1970,2416
STAT,1797,81,na,1878,213.55480336408544
STAT,1801,57,na,1858,1115.9947823339587
STAT,1946,22,35-39,1968,10.582872775883422
SIM,1839,36,45-49,1875,3
STAT,1846,23,35-39,1869,5.424872655944126
STAT,1859,50,na,1909,1774.2299431061215
STAT,1843,53,50-100,1896,0.01002276582590851
STAT,1793,96,na,1889,1.5838573794738626
STAT,1867,50,40-44,1917,0.010158038280593659
STAT,1841,52,35-39,1893,0.006403706995148174
STAT,1900,24,20-24,1924,96.07973270847107
SIM,1833,23,na,1856,1939
SIM,1910,35,35-39,1945,7
SIM,1861,39,30-34,1900,1
SIM,1846,44,na,1890,1578
SIM,1812,64,na,1876,831
SIM,1896,38,40-44,1934,13
SIM,1880,34,35-39,1914,11
STAT,1844,45,20-24,1889,0.009643933857069811
STAT,1838,53,45-49,1891,0.009559009558084777
STAT,1825,70,na,1895,1023.9059078756127
STAT,1860,29,20-24,1889,9.649504335388277
SIM,1871,25,30-34,1896,30
STAT,1842,15,15-19,1857,6.94276463702409
STAT,1876,35,15-19,1911,0.05911654352868773
STAT,1904,35,45-49,1939,0.6295738724026535
SIM,1880,25,na,1905,2309
STAT,1888,41,40-44,1929,2.69352065008695
STAT,1883,24,na,1907,2322.9128003129636
STAT,1855,37,45-49,1892,1.5005389949563366
STAT,1921,48,20-24,1969,0.012547440020069689
SIM,1822,71,na,1893,722
SIM,1878,24,35-39,1902,9
STAT,1840,44,40-44,1884,1.6031345721946677
STAT,1854,18,40-44,1872,0.16323607182929034
SIM,1955,15,40-44,1970,2
STAT,1836,22,na,1858,1779.1061101359926
SIM,1843,25,25-29,1868,53
SIM,1826,29,35-39,1855,13
STAT,1870,15,20-24,1885,17.96140652260997
STAT,1884,50,40-44,1934,0.010636167135825297
STAT,1903,58,na,1961,2972.4902630588253
SIM,1856,36,45-49,1892,1
STAT,1898,24,40-44,1922,2.83530799622877
SIM,1900,49,50-100,1949,1
SIM,1913,30,25-29,1943,12
SIM,1833,39,25-29,1872,5
SIM,1854,41,30-34,1895,1
SIM,1813,43,35-39,1856,2
STAT,1917,43,50-100,1960,0.12355596921627111
STAT,1910,46,25-29,1956,0.05005646403604325
STAT,1931,24,40-44,1955,4.379753352509429
SIM,1844,74,na,1918,773
SIM,1881,23,25-29,1904,59
SIM,1836,24,25-29,1860,63
STAT,1832,26,40-44,1858,2.7820283080985213
STAT,1860,32,20-24,1892,2.2317170851720998
SIM,1845,35,50-100,1880,1
STAT,1863,25,30-34,1888,22.862146222612743
STAT,1932,38,25-29,1970,1.335565356216153
STAT,1848,98,na,1946,2.6522988948595474
SIM,1893,29,25-29,1922,80
STAT,1876,23,20-24,1899,71.64284533988979
SIM,1821,33,25-29,1854,8
STAT,1868,24,na,1892,2268.668107911736
STAT,1891,40,30-34,1931,1.4521413085054968
STAT,1900,41,50-100,1941,0.1033936904733095
STAT,1854,54,40-44,1908,0.007683591062135974
STAT,1895,15,25-29,1910,7.508933531868214
STAT,1853,39,30-34,1892,4.363076866058769
SIM,1879,40,50-100,1919,1
STAT,1833,29,30-34,1862,23.23070686108727
SIM,1938,31,40-44,1969,7
STAT,1848,36,45-49,1884,1.6947799208645071
STAT,1863,40,25-29,1903,0.5804582828742052
STAT,1846,41,30-34,1887,0.8944138756878669
STAT,1910,48,45-49,1958,0.20401508625524167
STAT,1905,30,25-29,1935,15.075403718438483
SIM,1878,54,na,1932,2366
SIM,1829,29,na,1858,1877
STAT,1845,43,35-39,1888,1.330222197774634
STAT,1861,44,30-34,1905,0.9518694361497466
SIM,1841,29,30-34,1870,30
STAT,1912,48,50-100,1960,0.21869309979766355
STAT,1874,28,na,1902,2459.429722180488
STAT,1859,28,na,1887,1957.9610491599012
STAT,1867,49,30-34,1916,0.09015575801829287
SIM,1854,95,na,1949,31
SIM,1840,22,25-29,1862,58
STAT,1845,32,25-29,1877,8.89866089480168
STAT,1898,27,15-19,1925,0.6212134956454631
STAT,1860,36,na,1896,1954.5194675435062
STAT,1928,15,30-34,1943,15.595647290550767
STAT,1943,23,20-24,1966,119.41394746544273
SIM,1840,26,40-44,1866,6
STAT,1828,28,40-44,1856,4.813858806499357
STAT,1876,26,25-29,1902,44.26512492895289
SIM,1874,17,20-24,1891,20
STAT,1814,54,40-44,1868,0.02329303668661766
STAT,1885,29,25-29,1914,42.22326425970117
SIM,1924,24,45-49,1948,2
STAT,1912,54,na,1966,3469.1364689591564
STAT,1882,90,na,1972,264.9595494605644
STAT,1837,108,na,1945,0.0012495644334014322
SIM,1870,27,35-39,1897,18
STAT,1865,44,45-49,1909,1.3616541266392443
SIM,1879,22,30-34,1901,36
STAT,1862,27,35-39,1889,8.447016579925052
STAT,1774,93,na,1867,4.2861218478364425
STAT,1887,42,30-34,1929,1.294822620306828
SIM,1792,78,na,1870,236
SIM,1910,40,na,1950,3331
SIM,1907,28,na,1935,3741
STAT,1896,47,35-39,1943,0.10508667132702369
STAT,1906,17,45-49,1923,0.09609616434029039
STAT,1832,22,25-29,1854,87.62818836240389
STAT,1791,102,na,1893,0.052130818768040266
STAT,1912,7,na,1919,4064.6930460922804
STAT,1881,45,40-44,1926,0.16833607841384832
STAT,1895,19,40-44,1914,0.239948701259386
STAT,1929,3,na,1932,5231.991237078515
SIM,1869,36,30-34,1905,3
STAT,1837,35,50-100,1872,1.0411727191059905
STAT,1861,21,na,1882,2053.9517193422253
SIM,1890,54,na,1944,2898
STAT,1906,48,25-29,1954,0.04719732996150409
STAT,1834,42,20-24,1876,0.11402081649944128
SIM,1825,82,na,1907,194
SIM,1936,15,30-34,1951,19
SIM,1894,68,na,1962,2342
STAT,1859,9,na,1868,2297.3329103179626
STAT,1874,32,50-100,1906,0.947571614746071
SIM,1859,62,na,1921,1757
SIM,1874,45,50-100,1919,2
STAT,1863,87,na,1950,157.6623805649693
STAT,1842,51,45-49,1893,0.013128546500058026
SIM,1948,17,15-19,1965,56
SIM,1846,34,40-44,1880,4
STAT,1917,17,20-24,1934,29.448656807275327
SIM,1925,17,20-24,1942,177
STAT,1916,24,45-49,1940,1.1823885076457545
STAT,1947,15,40-44,1962,1.5923635492599024
STAT,1896,42,na,1938,3096.799352123555
SIM,1852,25,20-24,1877,15
STAT,1829,47,45-49,1876,0.17607391819155685
STAT,1838,88,na,1926,91.90127026450998
STAT,1834,39,20-24,1873,0.5592933217052932
STAT,1880,44,40-44,1924,2.353626262263588
STAT,1844,25,20-24,1869,11.527353836241026
SIM,1944,20,na,1964,4280
STAT,1896,38,45-49,1934,2.6519155744273
STAT,1838,34,40-44,1872,3.533271990088201
STAT,1866,17,20-24,1883,17.018331296847254
STAT,1844,19,35-39,1863,0.5453719939529419
STAT,1893,31,na,1924,3072.8106102634247
SIM,1856,43,na,1899,2109
SIM,1884,26,25-29,1910,41
STAT,1836,37,35-39,1873,5.476745150132882
SIM,1949,21,15-19,1970,6
STAT,1895,35,25-29,1930,3.8336214707272442
SIM,1891,16,15-19,1907,9
SIM,1866,10,na,1876,2778
STAT,1851,45,25-29,1896,0.04404882956038179
STAT,1893,39,30-34,1932,6.766081665320492
STAT,1942,23,50-100,1965,0.696338426753802
SIM,1896,34,25-29,1930,16
STAT,1899,18,50-100,1917,0.06773225902479756
STAT,1931,20,25-29,1951,121.79931080424679
SIM,1876,28,na,1904,2754
SIM,1930,17,na,1947,5028
SIM,1879,6,na,1885,3063
STAT,1800,86,na,1886,64.46938594028262
STAT,1851,26,20-24,1877,10.475872130079722
SIM,1923,23,45-49,1946,2
SIM,1836,44,25-29,1880,2
STAT,1886,44,35-39,1930,1.904973736190422
STAT,1915,23,45-49,1938,1.169982097224108
STAT,1819,42,25-29,1861,1.378286602614422
STAT,1886,33,25-29,1919,10.87654800726705
SIM,1808,67,na,1875,696
STAT,1873,27,40-44,1900,3.067186543648691
STAT,1888,34,25-29,1922,12.105788314974276
STAT,1830,54,25-29,1884,0.0025042392722046786
STAT,1819,53,35-39,1872,0.015800808907125256
STAT,1895,23,50-100,1918,0.5361986245427918
STAT,1821,44,30-34,1865,1.7309189254422395
STAT,1823,42,45-49,1865,2.22039261871816
STAT,1823,39,45-49,1862,3.1724852391477976
STAT,1885,46,20-24,1931,0.012098305246404508
SIM,1882,31,40-44,1913,8
SIM,1887,35,40-44,1922,9
STAT,1840,35,35-39,1875,5.987193757734843
SIM,1833,26,na,1859,1942
SIM,1939,32,40-44,1971,11
STAT,1879,15,40-44,1894,0.19367547409008698
STAT,1879,54,45-49,1933,0.014875449666498721
SIM,1881,27,40-44,1908,5
SIM,1949,18,15-19,1967,50
SIM,1836,74,na,1910,801
STAT,1873,30,40-44,1903,4.47609813428492
SIM,1815,40,40-44,1855,3
STAT,1948,1,na,1949,4747.269656947603
SIM,1866,21,na,1887,2396
STAT,1859,105,na,1964,0.12043700100735172
STAT,1862,62,na,1924,1594.1842081373475
STAT,1824,43,45-49,1867,1.8215978590989985
STAT,1879,35,40-44,1914,4.657705834588097
SIM,1858,21,na,1879,1918
SIM,1822,93,na,1915,7
STAT,1880,13,na,1893,2735.0486308935583
SIM,1843,33,na,1876,2369
STAT,1808,49,20-24,1857,0.04155045927244839
STAT,1905,34,40-44,1939,3.6047202924591826
SIM,1897,24,45-49,1921,1
STAT,1818,38,25-29,1856,6.622163679095305
STAT,1889,24,45-49,1913,0.8630036507732181
SIM,1777,78,na,1855,249
SIM,1913,34,40-44,1947,7
STAT,1842,48,15-19,1890,3.5560850146499923E-4
STAT,1793,99,na,1892,0.34181341350637606
SIM,1886,39,35-39,1925,10
STAT,1809,53,20-24,1862,0.0023208892754480234
STAT,1850,29,na,1879,1921.414412979788
SIM,1865,23,40-44,1888,3
STAT,1854,52,20-24,1906,5.508504295799288E-4
STAT,1878,39,35-39,1917,7.341003166769081
STAT,1882,79,na,1961,879.619411360236
STAT,1873,65,na,1938,1730.368790881737
SIM,1865,36,na,1901,2163
STAT,1857,23,40-44,1880,1.8826151824769177
STAT,1938,23,na,1961,3647.443696300547
STAT,1839,54,45-49,1893,0.010005969663811768
STAT,1852,95,na,1947,10.083229211155944
STAT,1891,34,45-49,1925,2.161942093693759
STAT,1831,33,35-39,1864,8.283202181525484
STAT,1861,15,25-29,1876,5.531408490093735
STAT,1825,36,20-24,1861,1.3276070271159721
STAT,1876,44,20-24,1920,0.16338153019901458
STAT,1882,39,na,1921,2281.766087445919
STAT,1815,101,na,1916,0.24701062082039046
STAT,1901,14,na,1915,3644.6273883268905
STAT,1905,28,na,1933,3472.2888380405584
STAT,1862,45,30-34,1907,0.08527266551312465
STAT,1883,52,45-49,1935,0.014267295393334427
STAT,1875,43,20-24,1918,0.16353372680272085
SIM,1876,5,na,1881,3113
SIM,1949,21,45-49,1970,2
STAT,1837,38,35-39,1875,5.814139533148743
STAT,1904,43,na,1947,3337.240708941669
STAT,1833,45,45-49,1878,0.20139899698487684
STAT,1892,27,20-24,1919,14.868197214551635
STAT,1873,23,50-100,1896,0.4162503018876471
STAT,1918,17,50-100,1935,0.08259784452609725
SIM,1892,17,15-19,1909,11
SIM,1929,28,45-49,1957,6
STAT,1881,36,35-39,1917,6.919094485569591
SIM,1906,43,na,1949,3246
SIM,1899,37,25-29,1936,3
STAT,1780,78,na,1858,258.72375801564255
STAT,1873,54,na,1927,2144.022610776131
STAT,1830,32,35-39,1862,9.72193967146017
SIM,1830,82,na,1912,172
STAT,1904,22,30-34,1926,25.817458117038946
STAT,1869,45,25-29,1914,0.05712469550642607
STAT,1847,62,na,1909,1368.4899813766528
STAT,1859,36,20-24,1895,0.6292018515575671
SIM,1880,87,na,1967,366
SIM,1912,22,30-34,1934,45
STAT,1871,33,35-39,1904,10.118860638991897
STAT,1835,25,25-29,1860,41.99571543529685
STAT,1808,52,20-24,1860,0.0024981043493815186
SIM,1868,76,na,1944,708
STAT,1849,21,na,1870,2035.7539097769886
STAT,1921,32,50-100,1953,0.9292749975131334
SIM,1831,23,40-44,1854,5
SIM,1844,37,35-39,1881,13
STAT,1872,34,35-39,1906,10.195193398697533
SIM,1879,79,na,1958,835
STAT,1826,48,30-34,1874,0.09409765150987409
STAT,1880,24,25-29,1904,60.34089702409513
STAT,1827,49,30-34,1876,0.09668872079500071
STAT,1897,16,na,1913,3428.218342938115
STAT,1911,22,30-34,1933,27.50012907649418
SIM,1919,20,20-24,1939,118
SIM,1845,38,35-39,1883,13
SIM,1871,51,na,1922,2032
SIM,1867,39,25-29,1906,4
SIM,1891,28,na,1919,3044
STAT,1847,73,na,1920,889.314395474825
STAT,1856,30,50-100,1886,0.7332485231309529
STAT,1908,34,50-100,1942,0.781064841062824
STAT,1813,102,na,1915,0.1285451790091164
STAT,1834,44,na,1878,1470.475814099971
STAT,1850,33,45-49,1883,1.3823957350558438
STAT,1886,39,50-100,1925,1.2960792064036801
STAT,1820,43,30-34,1863,2.095156485105388
STAT,1875,19,50-100,1894,0.050542721604723596
STAT,1913,17,na,1930,3984.3253459962984
STAT,1814,45,35-39,1859,0.3492061549851941
SIM,1877,13,na,1890,2742
STAT,1832,45,15-19,1877,3.3136915644917824E-4
SIM,1877,29,40-44,1906,3
STAT,1845,47,na,1892,1636.2631823786942
SIM,1808,56,na,1864,1092
SIM,1916,34,50-100,1950,4
STAT,1822,65,na,1887,955.5807416996279
STAT,1834,42,15-19,1876,0.009914854144156927
STAT,1873,57,na,1930,2057.6804113464977
STAT,1910,43,20-24,1953,0.016738135242240382
STAT,1865,20,40-44,1885,1.9734027066835613
SIM,1891,17,na,1908,3284
SIM,1887,16,30-34,1903,1
STAT,1826,55,na,1881,1222.5580361714733
STAT,1845,25,15-19,1870,0.4093692658562408
STAT,1847,33,25-29,1880,8.911387761820235
STAT,1829,53,30-34,1882,0.00382827226837653
STAT,1875,58,na,1933,2051.1986886217733
STAT,1873,51,40-44,1924,0.01083093621073982
SIM,1866,42,45-49,1908,1
SIM,1802,73,na,1875,505
STAT,1830,60,na,1890,1258.2423735856955
STAT,1836,30,15-19,1866,0.11593809804473729
STAT,1766,104,na,1870,0.015681419188701917
STAT,1865,17,40-44,1882,0.17382521442283827
STAT,1858,42,45-49,1900,1.1844575379006266
SIM,1830,80,na,1910,256
SIM,1903,32,30-34,1935,24
SIM,1813,49,na,1862,1328
STAT,1860,92,na,1952,34.38686215830069
SIM,1857,28,50-100,1885,1
STAT,1856,54,45-49,1910,0.010928606002296386
STAT,1894,43,25-29,1937,0.05756659323181806
STAT,1861,47,35-39,1908,0.1169514292002839
SIM,1817,39,na,1856,1652
STAT,1864,82,na,1946,425.23724313892393
SIM,1910,35,40-44,1945,3
SIM,1858,23,na,1881,1997
STAT,1922,21,35-39,1943,10.941306752268808
SIM,1901,46,50-100,1947,1
SIM,1926,12,na,1938,4874
STAT,1934,19,na,1953,5003.536635158305
SIM,1926,10,na,1936,4897
SIM,1896,40,na,1936,3132
STAT,1833,42,40-44,1875,1.9353681434876107
STAT,1827,74,na,1901,659.9454452457123
STAT,1896,28,na,1924,3179.36262813625
SIM,1821,78,na,1899,392
STAT,1896,31,25-29,1927,13.749515413781083
STAT,1902,35,40-44,1937,1.3613475257349625
SIM,1822,85,na,1907,98
SIM,1855,33,25-29,1888,12
SIM,1905,40,40-44,1945,2
STAT,1813,50,30-34,1863,0.017137672319033993
SIM,1887,12,na,1899,2842
STAT,1880,21,20-24,1901,73.31688950672003
STAT,1911,8,na,1919,4013.402242669824
SIM,1889,24,40-44,1913,5
STAT,1863,44,35-39,1907,1.598605302136566
STAT,1848,58,na,1906,1614.6261700237092
STAT,1940,2,na,1942,4175.081143049009
STAT,1880,41,30-34,1921,1.224982953974157
STAT,1918,4,na,1922,4435.207283648578
STAT,1856,42,35-39,1898,1.4004705413132843
STAT,1866,103,na,1969,1.1351962160146543
STAT,1805,61,na,1866,1131.2513765655303
STAT,1831,54,40-44,1885,0.006649463792075336
STAT,1829,40,25-29,1869,0.5137454888124123
STAT,1873,23,25-29,1896,58.433211275131505
SIM,1850,35,na,1885,2020
SIM,1910,22,20-24,1932,3
SIM,1892,32,45-49,1924,2
SIM,1905,24,35-39,1929,13
STAT,1865,48,50-100,1913,0.22366001717759948
STAT,1859,39,50-100,1898,0.9873013500017335
STAT,1886,27,50-100,1913,0.6821634852230221
STAT,1882,44,45-49,1926,1.4444698627177779
STAT,1805,93,na,1898,11.601781002161625
STAT,1839,30,40-44,1869,3.863066453748489
STAT,1839,27,40-44,1866,2.675477749585119
STAT,1871,15,15-19,1886,6.064560804311523
STAT,1921,22,30-34,1943,32.786734055090626
SIM,1950,3,na,1953,4579
SIM,1868,19,25-29,1887,7
SIM,1871,44,35-39,1915,1
STAT,1836,26,50-100,1862,0.5259507193335902
STAT,1827,96,na,1923,5.106130717780074
STAT,1844,50,50-100,1894,0.012120769740800988
STAT,1930,40,25-29,1970,0.09522773156801159
STAT,1852,63,na,1915,1353.2019720116107
STAT,1827,52,25-29,1879,0.0035076147187475524
SIM,1928,17,40-44,1945,5
STAT,1879,36,50-100,1915,1.3002689436075912
SIM,1841,42,40-44,1883,3
SIM,1873,32,35-39,1905,15
STAT,1871,15,50-100,1886,0.050065158864436694
STAT,1917,49,45-49,1966,0.22780021128425731
SIM,1842,48,na,1890,1596
STAT,1944,22,25-29,1966,100.70995696576611
SIM,1869,72,na,1941,1120
SIM,1825,41,45-49,1866,3
STAT,1894,27,na,1921,3103.2805735908555
STAT,1877,16,20-24,1893,18.5260233015293
SIM,1825,68,na,1893,757
SIM,1909,17,30-34,1926,2
STAT,1815,53,45-49,1868,0.030151356541492064
STAT,1875,43,15-19,1918,0.014220324837853867
SIM,1935,27,25-29,1962,106
STAT,1938,5,na,1943,4004.0735593145996
STAT,1809,110,na,1919,1.2759879996634044E-4
STAT,1869,20,na,1889,2346.2370060073144
STAT,1896,44,30-34,1940,0.10529283054769283
STAT,1884,32,45-49,1916,1.7368381890203397
SIM,1872,40,35-39,1912,3
STAT,1913,25,na,1938,3791.711962327074
SIM,1863,30,25-29,1893,18
STAT,1850,82,na,1932,357.268613047673
STAT,1866,16,45-49,1882,0.06307722817198852
STAT,1922,34,40-44,1956,4.444987741149671
SIM,1870,32,25-29,1902,19
STAT,1811,104,na,1915,0.02907739181823703
SIM,1855,66,na,1921,1484
STAT,1850,29,30-34,1879,22.366535279921457
STAT,1946,12,na,1958,4400.43915732427
STAT,1955,3,na,1958,5275.660739712921
STAT,1817,49,40-44,1866,0.35661107776659723
STAT,1847,44,50-100,1891,0.780327568908152
SIM,1827,49,na,1876,1403
STAT,1904,32,40-44,1936,3.609259742489601
STAT,1904,17,50-100,1921,0.071009750252779
SIM,1910,19,35-39,1929,4
SIM,1880,79,na,1959,778
SIM,1890,44,45-49,1934,2
SIM,1923,48,50-100,1971,1
STAT,1885,68,na,1953,1536.3546449169871
STAT,1927,27,25-29,1954,80.87829050525534
STAT,1902,22,20-24,1924,98.3560498837652
STAT,1930,29,na,1959,4809.714034143436
SIM,1912,32,40-44,1944,6
STAT,1864,40,35-39,1904,1.6670051076725023
STAT,1845,41,20-24,1886,0.11969187104918629
STAT,1832,50,40-44,1882,0.0077809034329095125
SIM,1940,23,45-49,1963,2
STAT,1877,31,15-19,1908,0.14905573686035198
STAT,1856,87,na,1943,136.42493067989963
STAT,1822,38,50-100,1860,2.1890780752765884
STAT,1788,96,na,1884,1.4911822677365443
STAT,1928,22,40-44,1950,4.243253210614823
STAT,1908,27,15-19,1935,0.6793873721365941
STAT,1940,17,50-100,1957,0.3840369912336239
STAT,1850,21,35-39,1871,5.401882916434956
SIM,1880,33,na,1913,2234
STAT,1937,32,35-39,1969,9.127356770161956
STAT,1797,59,na,1856,1008.2616151529
STAT,1880,27,na,1907,2531.4102520309852
SIM,1851,84,na,1935,287
STAT,1924,39,35-39,1963,2.8759728416684758
SIM,1886,32,50-100,1918,1
SIM,1928,5,na,1933,5185
STAT,1778,101,na,1879,0.14714005681379938
STAT,1853,42,25-29,1895,0.5303949879619402
STAT,1881,20,25-29,1901,56.064880989546594
STAT,1932,23,45-49,1955,1.4873325124943642
STAT,1872,18,na,1890,2557.8340863966373
STAT,1843,53,20-24,1896,4.89711704693943E-4
STAT,1881,40,35-39,1921,1.780734504604901
STAT,1815,71,na,1886,651.0760885606511
STAT,1834,41,45-49,1875,1.0883774002345594
STAT,1917,33,20-24,1950,2.567289395431163
SIM,1815,91,na,1906,21
STAT,1920,19,na,1939,4147.842508707843
STAT,1855,15,30-34,1870,1.443928965385573
STAT,1869,15,15-19,1884,5.97839680561412
SIM,1900,27,na,1927,3466
STAT,1922,28,20-24,1950,20.793299005133782
SIM,1932,39,35-39,1971,6
STAT,1889,21,40-44,1910,2.6029984524421117
STAT,1897,43,35-39,1940,0.1690383423129967
STAT,1923,49,na,1972,4316.894188317064
SIM,1930,28,20-24,1958,28
SIM,1881,34,50-100,1915,3
SIM,1897,21,40-44,1918,5
STAT,1814,42,30-34,1856,3.484382024631763
STAT,1895,32,20-24,1927,3.565235482177066
STAT,1880,47,45-49,1927,0.24916063684692213
SIM,1870,55,na,1925,2283
STAT,1840,32,30-34,1872,14.907073478359829
STAT,1831,49,15-19,1880,2.9120949368176215E-4
STAT,1814,78,na,1892,365.7107835932035
SIM,1863,15,30-34,1878,5
SIM,1919,22,40-44,1941,4
STAT,1926,41,50-100,1967,0.14658391704467735
STAT,1921,12,na,1933,4561.535126749348
SIM,1883,45,50-100,1928,1
SIM,1888,43,35-39,1931,3
STAT,1855,38,na,1893,1764.597092257749
STAT,1927,43,30-34,1970,0.16180413177884095
STAT,1907,39,35-39,1946,2.2415475857620026
SIM,1915,39,35-39,1954,7
STAT,1879,19,35-39,1898,0.5752378243927996
SIM,1847,27,40-44,1874,2
STAT,1767,114,na,1881,2.3709038754100468E-4
SIM,1873,85,na,1958,296
STAT,1923,30,40-44,1953,4.569290981399256
STAT,1908,30,15-19,1938,0.1234297449024848
STAT,1817,107,na,1924,0.002157654167213505
SIM,1825,36,na,1861,1488
SIM,1842,22,35-39,1864,9
SIM,1804,66,na,1870,955
STAT,1934,33,20-24,1967,3.3629272162870736
SIM,1851,31,45-49,1882,1
STAT,1871,50,50-100,1921,0.015372240490710586
STAT,1877,39,na,1916,2431.2077412373033
SIM,1847,30,40-44,1877,8
STAT,1953,17,25-29,1970,52.96421762213719
SIM,1832,39,30-34,1871,13
STAT,1860,32,15-19,1892,0.11757555752181048
STAT,1841,31,35-39,1872,9.284420458955578
STAT,1917,20,15-19,1937,5.7447504291928775
STAT,1833,44,50-100,1877,0.8860178550740758
STAT,1843,31,45-49,1874,1.428719098237759
SIM,1829,40,na,1869,1805
STAT,1845,93,na,1938,21.354587303135343
STAT,1886,42,20-24,1928,0.16914859911313995
SIM,1920,47,na,1967,4342
STAT,1929,32,na,1961,4855.658012023575
STAT,1934,17,15-19,1951,62.02562893659337
STAT,1820,46,35-39,1866,0.24175151084708724
SIM,1888,31,40-44,1919,9
STAT,1889,18,40-44,1907,0.22718960638845234
STAT,1934,20,15-19,1954,7.251968175600411
SIM,1838,86,na,1924,115
SIM,1843,87,na,1930,231
SIM,1942,17,15-19,1959,48
STAT,1860,31,45-49,1891,1.4456296259251489
STAT,1793,100,na,1893,0.19161034520926923
STAT,1771,106,na,1877,0.010181026803191006
SIM,1925,17,15-19,1942,56
SIM,1781,86,na,1867,22
STAT,1917,17,15-19,1934,9.857813096537125
STAT,1897,33,50-100,1930,1.235414810249344
STAT,1933,29,35-39,1962,20.124614927236063
SIM,1941,29,35-39,1970,26
SIM,1876,20,na,1896,2720
SIM,1931,30,40-44,1961,9
STAT,1843,39,40-44,1882,3.0720890544611823
SIM,1851,39,40-44,1890,5
STAT,1881,33,30-34,1914,16.92644543947151
SIM,1916,34,na,1950,3865
STAT,1915,23,50-100,1938,0.6842000829261845
STAT,1908,43,20-24,1951,0.016394806934440863
SIM,1815,39,30-34,1854,10
SIM,1818,80,na,1898,230
STAT,1819,51,20-24,1870,0.0014094413740993413
STAT,1890,30,35-39,1920,12.59889232073409
SIM,1832,95,na,1927,17
SIM,1846,15,30-34,1861,2
STAT,1856,53,na,1909,1640.5270986755663
STAT,1843,35,na,1878,1721.8066980783792
STAT,1860,108,na,1968,0.017057806592638183
STAT,1860,39,na,1899,1925.5801760812556
STAT,1824,39,30-34,1863,6.957581388896754
SIM,1883,23,35-39,1906,8
SIM,1810,60,na,1870,1138
SIM,1900,25,30-34,1925,6
SIM,1909,34,20-24,1943,2
STAT,1886,26,15-19,1912,0.48548557311545715
SIM,1951,19,na,1970,4652
STAT,1796,93,na,1889,6.839672257711387
STAT,1860,39,40-44,1899,3.5778074368429986
SIM,1830,37,na,1867,1579
SIM,1889,60,na,1949,2251
STAT,1817,41,50-100,1858,2.7021395273201523
STAT,1879,48,na,1927,2341.535911815858
STAT,1839,107,na,1946,0.003343483277439583
STAT,1850,49,25-29,1899,0.043184234233060254
SIM,1888,28,40-44,1916,5
STAT,1814,49,15-19,1863,9.329178589554527E-4
SIM,1855,58,na,1913,1724
SIM,1832,31,35-39,1863,12
SIM,1889,30,50-100,1919,1
STAT,1819,35,15-19,1854,0.1986614547205001
STAT,1896,16,30-34,1912,2.1361113258866404
STAT,1860,48,30-34,1908,0.0789164450833294
STAT,1891,22,35-39,1913,7.297140558252337
SIM,1936,22,40-44,1958,4
STAT,1899,43,45-49,1942,0.14302176112977463
STAT,1849,15,50-100,1864,0.04771009444892805
STAT,1885,50,20-24,1935,7.525190109912766E-4
SIM,1926,32,25-29,1958,23
STAT,1829,25,30-34,1854,65.96934043125835
STAT,1869,42,20-24,1911,0.15575580761805993
STAT,1824,31,35-39,1855,23.027389568569564
STAT,1856,85,na,1941,212.27497032670922
STAT,1860,100,na,1960,1.9391534261855272
STAT,1847,32,50-100,1879,0.8054830752892611
STAT,1918,32,25-29,1950,9.915582453630725
STAT,1914,40,40-44,1954,0.2518099705168087
STAT,1846,53,30-34,1899,0.004444769732524953
SIM,1884,71,na,1955,1347
STAT,1858,19,20-24,1877,16.21701814190883
STAT,1882,36,15-19,1918,0.05520310172051244
STAT,1884,49,na,1933,2194.0433437393776
STAT,1871,84,na,1955,333.80230037308536
SIM,1885,43,25-29,1928,3
STAT,1942,30,na,1972,4072.2894105453242
STAT,1950,17,na,1967,4397.063384299111
STAT,1926,39,45-49,1965,0.8402419013995772
SIM,1837,25,30-34,1862,44
STAT,1857,47,50-100,1904,0.192690267500638
STAT,1834,49,40-44,1883,0.10539292413476188
STAT,1882,46,50-100,1928,0.24096436765503704
SIM,1892,58,na,1950,2681
STAT,1921,32,40-44,1953,4.398386656180241
SIM,1900,59,na,1959,3103
SIM,1933,14,na,1947,5056
STAT,1815,45,15-19,1860,9.177864625801174E-4
STAT,1831,29,50-100,1860,0.538932566732698
STAT,1902,33,na,1935,3391.5136032664122
STAT,1868,56,na,1924,1968.8400993016744
STAT,1877,43,25-29,1920,0.6645638738701537
SIM,1858,17,15-19,1875,6
STAT,1936,33,30-34,1969,15.440042565952725
SIM,1935,24,20-24,1959,154
STAT,1768,102,na,1870,0.14571128994437083
SIM,1919,27,40-44,1946,11
STAT,1850,46,20-24,1896,0.009214654181696787
SIM,1865,47,50-100,1912,3
STAT,1927,24,20-24,1951,137.60303297534503
STAT,1850,15,na,1865,2173.3492331553252
STAT,1889,26,na,1915,2982.36186263723
STAT,1885,36,na,1921,2379.9527007308902
STAT,1868,50,20-24,1918,7.22542997064513E-4
SIM,1921,31,50-100,1952,1
STAT,1922,19,50-100,1941,0.4356810440584609
STAT,1772,83,na,1855,91.45089999999999
SIM,1926,17,30-34,1943,27
SIM,1905,48,na,1953,3402
STAT,1895,16,15-19,1911,7.846679480306518
SIM,1818,66,na,1884,819
STAT,1883,40,45-49,1923,1.4941622773424943
STAT,1865,23,45-49,1888,0.6462528876984678
SIM,1910,25,50-100,1935,1
SIM,1830,69,na,1899,771
STAT,1875,46,25-29,1921,0.0599133502343331
SIM,1896,48,na,1944,2935
STAT,1933,24,15-19,1957,7.130333468299844
SIM,1868,34,50-100,1902,1
SIM,1909,32,25-29,1941,14
STAT,1884,33,15-19,1917,0.14123877796935555
STAT,1951,17,15-19,1968,54.60147269672254
SIM,1941,24,15-19,1965,8
STAT,1834,22,35-39,1856,4.6497774640844485
STAT,1817,64,na,1881,903.2127798444935
SIM,1860,67,na,1927,1317
STAT,1832,43,na,1875,1718.739600298516
STAT,1911,32,15-19,1943,0.1262442913537826
SIM,1899,70,na,1969,2476
STAT,1918,17,30-34,1935,2.687183754914353
STAT,1817,42,15-19,1859,0.033785043830461596
STAT,1852,43,20-24,1895,0.1195724745102827
STAT,1876,51,na,1927,2256.1591921318995
SIM,1891,40,45-49,1931,5
STAT,1849,83,na,1932,310.38543085453523
STAT,1954,15,45-49,1969,0.6242405255723613
SIM,1948,13,na,1961,5010
STAT,1840,39,15-19,1879,0.04560066140352115
SIM,1868,16,20-24,1884,20
STAT,1854,19,30-34,1873,1.414107271246842
SIM,1922,1,na,1923,5287
STAT,1863,33,na,1896,2126.473593491561
STAT,1863,55,na,1918,1850.3757120475616
SIM,1879,15,25-29,1894,8
STAT,1860,50,na,1910,1803.2589040140585
SIM,1834,39,40-44,1873,8
STAT,1921,1,na,1922,4807.684684863678
STAT,1856,23,25-29,1879,51.113092771495474
SIM,1937,23,50-100,1960,3
SIM,1829,48,50-100,1877,1
STAT,1850,37,na,1887,1832.571676431415
STAT,1877,19,25-29,1896,5.875451148010343
STAT,1928,42,35-39,1970,0.25946825177903216
STAT,1886,83,na,1969,783.7501742811983
STAT,1915,46,30-34,1961,0.09086735544345055
SIM,1878,26,30-34,1904,33
STAT,1938,25,35-39,1963,15.02889551760653
STAT,1949,16,20-24,1965,159.34129460222292
STAT,1940,30,40-44,1970,4.093454245876232
SIM,1864,23,25-29,1887,64
STAT,1837,54,35-39,1891,0.005711757151513588
SIM,1866,19,20-24,1885,18
SIM,1828,30,30-34,1858,19
STAT,1839,33,45-49,1872,1.5057211960159855
STAT,1789,91,na,1880,22.95067707961189
STAT,1910,42,na,1952,3541.2312047321566
SIM,1928,32,35-39,1960,19
STAT,1826,53,20-24,1879,6.874982087442634E-4
SIM,1878,22,15-19,1900,3
STAT,1891,47,20-24,1938,0.008425024511451096
STAT,1887,21,30-34,1908,20.146590127328693
SIM,1814,44,na,1858,1404
STAT,1937,17,40-44,1954,1.3737055392646398
SIM,1908,47,na,1955,3181
SIM,1946,25,35-39,1971,18
STAT,1849,16,45-49,1865,0.0632387759901652
STAT,1909,12,na,1921,3908.1333858946405
SIM,1862,15,15-19,1877,7
STAT,1882,21,50-100,1903,0.40016525167610195
STAT,1865,14,na,1879,2470.5500028134124
STAT,1929,23,50-100,1952,0.8384299847557476
STAT,1856,46,15-19,1902,3.1061764705770365E-4
STAT,1917,43,30-34,1960,0.13445796679511432
STAT,1854,15,15-19,1869,5.391128583655611
STAT,1892,78,na,1970,1446.3415924759054
SIM,1898,34,35-39,1932,24
SIM,1862,19,30-34,1881,3
STAT,1844,52,25-29,1896,0.0027874660982605865
STAT,1862,25,15-19,1887,0.40295304027598633
STAT,1863,47,45-49,1910,0.21020938789257884
SIM,1863,43,30-34,1906,4
SIM,1945,17,40-44,1962,5
STAT,1893,44,20-24,1937,0.013952246854663767
SIM,1879,34,25-29,1913,4
SIM,1847,33,45-49,1880,1
STAT,1860,32,50-100,1892,0.7564766616654885
STAT,1874,43,40-44,1917,2.309373875366232
SIM,1835,60,na,1895,1097
SIM,1910,32,30-34,1942,17
STAT,1828,29,30-34,1857,34.96712803682769
STAT,1878,15,25-29,1893,5.968912668765586
SIM,1858,51,50-100,1909,1
SIM,1888,40,30-34,1928,8
SIM,1846,52,na,1898,1497
STAT,1817,41,45-49,1858,3.8280310080065965
STAT,1780,92,na,1872,9.668569965891194
STAT,1807,52,40-44,1859,0.03573138600818324
STAT,1834,45,25-29,1879,0.04101519561215367
STAT,1834,84,na,1918,198.01061660446527
SIM,1837,21,15-19,1858,4
STAT,1854,51,30-34,1905,0.004488682782955857
STAT,1818,60,na,1878,1141.8527675093699
STAT,1822,33,na,1855,1591.854340378197
SIM,1883,22,na,1905,2682
STAT,1819,45,na,1864,1405.8032346202901
STAT,1849,33,35-39,1882,8.2572773219966
STAT,1860,44,50-100,1904,0.8604612035631737
SIM,1839,50,na,1889,1430
SIM,1956,3,na,1959,5294
STAT,1902,32,30-34,1934,24.919557226063482
SIM,1909,37,25-29,1946,3
STAT,1855,30,25-29,1885,8.014922182938749
STAT,1846,20,30-34,1866,16.920804034222467
SIM,1930,34,40-44,1964,8
STAT,1893,23,na,1916,3023.664346781163
STAT,1858,43,15-19,1901,0.010863675896955482
SIM,1820,59,na,1879,1114
STAT,1901,39,40-44,1940,1.3243025388738618
STAT,1939,7,na,1946,4030.5994962623663
STAT,1897,45,50-100,1942,0.1894599427046853
STAT,1869,21,50-100,1890,0.4016421970837962
SIM,1818,88,na,1906,88
STAT,1787,82,na,1869,139.59677973857302
STAT,1841,35,15-19,1876,0.05051448176294008
STAT,1881,20,na,1901,2316.267830301882
SIM,1812,61,na,1873,948
SIM,1836,29,30-34,1865,33
SIM,1882,43,40-44,1925,4
STAT,1841,43,45-49,1884,1.1481935519520436
STAT,1852,48,40-44,1900,0.128205298538777
STAT,1884,17,50-100,1901,0.048795666359780124
STAT,1838,18,35-39,1856,0.48233135709176445
STAT,1907,36,30-34,1943,1.7144322438781499
STAT,1911,42,25-29,1953,0.06876127358816209
STAT,1869,101,na,1970,4.515244778086322
SIM,1854,20,30-34,1874,1
STAT,1862,20,15-19,1882,2.98839920236726
STAT,1902,33,50-100,1935,1.3022020977292676
STAT,1868,26,20-24,1894,11.363124744524512
SIM,1832,38,na,1870,1611
SIM,1892,40,50-100,1932,2
STAT,1928,25,45-49,1953,2.165901711718491
SIM,1832,33,50-100,1865,3
SIM,1849,94,na,1943,3
STAT,1913,29,50-100,1942,0.9935147021711128
STAT,1850,46,15-19,1896,3.0715486920600445E-4
SIM,1857,33,35-39,1890,11
STAT,1890,80,na,1970,1217.0408845082634
SIM,1898,21,na,1919,3184
STAT,1883,16,45-49,1899,0.06472145892910287
STAT,1819,54,25-29,1873,0.006372598373222983
SIM,1913,4,na,1917,4148
STAT,1951,13,na,1964,4725.221234257331
SIM,1907,24,45-49,1931,1
STAT,1788,98,na,1886,0.5588419568786492
STAT,1875,23,35-39,1898,6.033959243452003
STAT,1907,34,15-19,1941,0.12024588352584273
SIM,1920,16,25-29,1936,58
STAT,1842,23,50-100,1865,0.4597567071452982
SIM,1876,42,na,1918,2662
STAT,1906,33,45-49,1939,1.466803833079097
SIM,1840,90,na,1930,45
STAT,1901,46,na,1947,3195.0918355410386
SIM,1904,44,40-44,1948,2
STAT,1799,109,na,1908,2.3874582542717724E-4
STAT,1917,24,30-34,1941,30.64039955621689
STAT,1812,54,30-34,1866,0.01262484820094291
STAT,1935,20,50-100,1955,0.9059104970995598
STAT,1854,72,na,1926,947.7856566651838
STAT,1830,62,na,1892,1205.8270121832609
STAT,1909,34,na,1943,3610.7623017205738
SIM,1870,20,15-19,1890,3
STAT,1798,74,na,1872,541.7847821967263
STAT,1879,16,30-34,1895,1.6840640692867432
STAT,1856,31,na,1887,1889.978114983132
STAT,1943,13,na,1956,4205.286877162434
SIM,1821,46,na,1867,1327
SIM,1925,24,30-34,1949,41
STAT,1912,16,25-29,1928,8.862543470833863
SIM,1888,34,45-49,1922,2
STAT,1908,46,25-29,1954,0.048791397946751885
SIM,1807,96,na,1903,8
STAT,1913,31,35-39,1944,9.211009092762898
STAT,1857,50,45-49,1907,0.011603716034930362
STAT,1835,69,na,1904,1101.4614453684285
STAT,1897,24,25-29,1921,77.02867359280127
STAT,1905,21,35-39,1926,8.546088338188571
STAT,1868,40,50-100,1908,1.0300733468006302
SIM,1847,37,na,1884,1813
SIM,1912,29,50-100,1941,1
STAT,1822,43,35-39,1865,2.811403391637019
SIM,1863,24,na,1887,2191
SIM,1899,37,na,1936,3577
SIM,1909,40,na,1949,3846
STAT,1853,41,50-100,1894,0.8776140256581366
STAT,1867,54,20-24,1921,6.826226206528458E-4
SIM,1830,43,35-39,1873,5
SIM,1941,26,30-34,1967,66
SIM,1859,70,na,1929,1315
SIM,1878,7,na,1885,3164
STAT,1841,54,na,1895,1565.8914980391548
STAT,1860,35,25-29,1895,2.399717655979415
STAT,1933,26,30-34,1959,52.59718708977678
STAT,1848,53,40-44,1901,0.008457380188740352
STAT,1889,72,na,1961,1764.6577990989506
SIM,1913,21,35-39,1934,9
STAT,1843,80,na,1923,417.22327330732435
STAT,1911,28,45-49,1939,1.6937697154700226
STAT,1783,75,na,1858,414.094903702285
SIM,1848,23,40-44,1871,3
SIM,1921,31,35-39,1952,13
SIM,1838,33,25-29,1871,9
STAT,1904,29,50-100,1933,0.9205554324312251
STAT,1865,36,15-19,1901,0.05203814437470755
STAT,1904,48,20-24,1952,0.009687838313114617
STAT,1872,43,30-34,1915,1.1589641200095888
STAT,1896,19,35-39,1915,0.7296468431181923
STAT,1877,52,20-24,1929,7.651293991434813E-4
STAT,1844,12,na,1856,2400.9181491438003
STAT,1901,35,25-29,1936,0.8882401416209667
SIM,1853,46,na,1899,1701
SIM,1898,7,na,1905,3551
SIM,1900,23,15-19,1923,8
STAT,1891,47,15-19,1938,2.8083390335063326E-4
SIM,1895,63,na,1958,2391
STAT,1774,101,na,1875,0.0865480678892512
SIM,1837,28,35-39,1865,9
STAT,1892,42,45-49,1934,1.8944753293091003
SIM,1891,73,na,1964,1644
SIM,1834,64,na,1898,1247
SIM,1930,30,25-29,1960,18
SIM,1902,31,25-29,1933,24
STAT,1916,14,na,1930,4214.815820761642
STAT,1914,43,45-49,1957,0.16612517882546657
STAT,1899,40,40-44,1939,0.21869371366557472
SIM,1887,69,na,1956,1526
SIM,1918,24,20-24,1942,116
STAT,1866,40,45-49,1906,1.4138301886419555
STAT,1869,71,na,1940,1310.7187951538465
SIM,1884,19,15-19,1903,8
SIM,1885,56,na,1941,2208
SIM,1845,30,30-34,1875,24
STAT,1829,28,35-39,1857,10.82896995831333
STAT,1867,71,na,1938,1269.6916080337012
SIM,1934,36,40-44,1970,3
SIM,1880,43,30-34,1923,1
SIM,1902,50,na,1952,3268
STAT,1865,81,na,1946,498.7233108770037
SIM,1927,32,40-44,1959,4
SIM,1849,19,20-24,1868,25
STAT,1872,51,25-29,1923,0.003613842392654842
STAT,1878,31,30-34,1909,18.380532795601255
STAT,1849,28,50-100,1877,0.5886185366931225
SIM,1920,35,35-39,1955,4
STAT,1836,18,25-29,1854,8.684881231028664
STAT,1867,17,15-19,1884,5.770960003798863
SIM,1949,8,na,1957,4422
STAT,1805,52,30-34,1857,0.02447205630116537
SIM,1879,41,40-44,1920,7
SIM,1847,23,25-29,1870,52
STAT,1820,84,na,1904,169.33297647441768
STAT,1799,82,na,1881,172.61044043870265
STAT,1909,63,na,1972,3060.4911794191694
STAT,1921,47,45-49,1968,0.24745423379981615
STAT,1831,110,na,1941,1.736509938899656E-4
STAT,1878,34,na,1912,2480.5186049780823
SIM,1887,36,50-100,1923,1
STAT,1853,46,40-44,1899,0.141980349290985
SIM,1819,40,30-34,1859,1
STAT,1846,24,na,1870,1973.4091205998998
STAT,1912,35,35-39,1947,2.4043569708806034
SIM,1875,17,15-19,1892,6
STAT,1915,49,35-39,1964,0.13032541354736668
STAT,1833,46,20-24,1879,0.0101102641677514
SIM,1879,38,40-44,1917,2
STAT,1852,41,na,1893,1760.7567428526602
SIM,1886,31,30-34,1917,34
SIM,1908,28,50-100,1936,2
SIM,1849,27,na,1876,2009
STAT,1808,50,na,1858,1226.222105342628
SIM,1843,18,15-19,1861,7
SIM,1830,38,50-100,1868,3
STAT,1926,43,na,1969,4620.01906685493
STAT,1831,50,25-29,1881,0.0024216531063566355
STAT,1873,30,35-39,1903,10.452548899759721
STAT,1884,49,30-34,1933,0.09439930073619923
STAT,1867,93,na,1960,51.684520875438466
STAT,1871,19,30-34,1890,1.5907503219818129
STAT,1879,81,na,1960,745.7546367852364
STAT,1837,30,30-34,1867,15.247635487480311
SIM,1887,34,na,1921,2588
STAT,1915,48,50-100,1963,0.22933666078212805
STAT,1916,36,na,1952,3906.7425567316554
STAT,1831,52,50-100,1883,0.009924634473698483
STAT,1859,42,na,1901,1875.190769121412
STAT,1821,40,20-24,1861,0.26830416432449894
STAT,1851,46,50-100,1897,0.1864933118832957
STAT,1862,48,40-44,1910,0.14744785305365973
SIM,1883,44,na,1927,2503
STAT,1885,48,35-39,1933,0.13897878723046583
SIM,1874,19,na,1893,2440
SIM,1929,41,40-44,1970,1
STAT,1907,19,20-24,1926,26.154434675346458
STAT,1796,101,na,1897,0.11954642137183769
SIM,1929,25,35-39,1954,30
SIM,1829,75,na,1904,659
STAT,1806,51,35-39,1857,0.025344812767554528
SIM,1844,18,25-29,1862,7
SIM,1870,26,na,1896,2631
STAT,1918,48,na,1966,3935.935343696314
STAT,1922,30,25-29,1952,10.634683570738954
SIM,1902,53,na,1955,3151
STAT,1825,51,45-49,1876,0.019155908873654152
SIM,1892,36,25-29,1928,7
STAT,1951,10,na,1961,4727.300944612896
STAT,1855,18,35-39,1873,0.48835833890414654
STAT,1837,51,30-34,1888,0.0041571888634571634
STAT,1856,33,45-49,1889,1.352735023139417
STAT,1908,0,na,1908,4396.955632906729
STAT,1862,106,na,1968,0.10300204951374126
STAT,1897,47,15-19,1944,3.040961619570211E-4
STAT,1920,21,25-29,1941,104.01199684591879
STAT,1932,20,40-44,1952,4.484979292427847
STAT,1871,28,50-100,1899,0.6396234011419296
STAT,1920,52,na,1972,4031.982040784763
SIM,1920,42,40-44,1962,2
SIM,1779,90,na,1869,31
SIM,1862,93,na,1955,18
STAT,1859,1,na,1860,2993.4094018781543
STAT,1926,36,40-44,1962,1.8507099276814203
SIM,1880,30,25-29,1910,19
SIM,1890,20,40-44,1910,6
STAT,1949,19,25-29,1968,50.88330782522188
STAT,1827,42,na,1869,1593.4298366888688
STAT,1860,52,45-49,1912,0.011918048988748754
STAT,1882,20,40-44,1902,2.050853287426861
STAT,1892,36,50-100,1928,1.5635048149070718
STAT,1892,30,45-49,1922,2.227848923117981
SIM,1915,26,na,1941,4366
STAT,1891,43,40-44,1934,2.7923522797652605
SIM,1893,51,na,1944,2803
STAT,1884,36,25-29,1920,2.8814682331293193
STAT,1912,42,40-44,1954,0.24338336648361736
STAT,1872,30,25-29,1902,10.484155501061363
STAT,1830,94,na,1924,13.185611314101415
SIM,1803,81,na,1884,157
STAT,1945,22,40-44,1967,3.7215735248263426
SIM,1873,31,na,1904,2303
SIM,1865,34,na,1899,2206
SIM,1836,20,na,1856,2102
STAT,1841,86,na,1927,165.92223704726058
STAT,1878,52,30-34,1930,0.00620775498858918
STAT,1831,79,na,1910,439.31809428037116
SIM,1849,49,na,1898,1743
STAT,1865,99,na,1964,6.332632705008825
STAT,1868,29,25-29,1897,40.54133312042675
SIM,1864,33,45-49,1897,3
SIM,1820,36,35-39,1856,14
SIM,1838,57,na,1895,1448
STAT,1838,50,35-39,1888,0.005964069360916476
SIM,1864,30,40-44,1894,4
STAT,1863,23,35-39,1886,5.28794045554073
STAT,1894,47,40-44,1941,0.12498932530298251
STAT,1874,47,20-24,1921,0.012352418234314733
SIM,1904,31,na,1935,3627
SIM,1880,37,45-49,1917,6
STAT,1898,54,na,1952,2867.1428588063804
STAT,1815,49,30-34,1864,0.2077414872613485
STAT,1897,28,40-44,1925,4.0418919456689935
SIM,1841,21,na,1862,1888
SIM,1940,20,40-44,1960,3
STAT,1891,11,na,1902,3234.190280933716
SIM,1886,19,na,1905,2823
STAT,1873,42,35-39,1915,1.8518268454900852
STAT,1841,52,40-44,1893,0.00783081882172243
STAT,1911,25,40-44,1936,4.616993368777257
STAT,1910,20,na,1930,3637.22899736312
SIM,1940,25,na,1965,3986
STAT,1790,69,na,1859,589.2391015031036
SIM,1881,30,35-39,1911,15
STAT,1892,43,15-19,1935,0.017375857988856647
STAT,1836,51,20-24,1887,4.8043335093186863E-4
STAT,1875,45,50-100,1920,0.25728026886063426
STAT,1888,41,35-39,1929,2.168459832057428
STAT,1852,49,na,1901,1670.635694582357
STAT,1941,30,35-39,1971,9.69757124484435
STAT,1915,40,35-39,1955,0.2051338419043618
STAT,1945,25,na,1970,4154.18767148252
STAT,1868,41,15-19,1909,0.013390819836811894
SIM,1913,48,na,1961,3564
SIM,1859,29,25-29,1888,47
STAT,1858,15,50-100,1873,0.04588646114331722
STAT,1841,40,40-44,1881,1.793215982479142
SIM,1784,72,na,1856,541
SIM,1903,42,40-44,1945,2
STAT,1872,37,45-49,1909,2.024228038142181
STAT,1766,95,na,1861,1.1825896144802261
SIM,1865,5,na,1870,2633
STAT,1857,47,20-24,1904,0.009414834289727197
STAT,1851,41,45-49,1892,1.1383653062701273
SIM,1863,103,na,1966,5
SIM,1876,71,na,1947,1295
STAT,1935,18,na,1953,5070.501470892566
STAT,1930,40,na,1970,4952.69890675886
SIM,1819,65,na,1884,853
STAT,1845,61,na,1906,1365.385934181923
SIM,1890,32,35-39,1922,14
STAT,1822,40,30-34,1862,1.9215354270204725
SIM,1869,31,30-34,1900,22
SIM,1810,44,50-100,1854,2
STAT,1822,46,45-49,1868,0.3548538025153752
SIM,1860,19,20-24,1879,16
SIM,1899,18,15-19,1917,11
STAT,1881,53,50-100,1934,0.014467434514383554
SIM,1919,34,50-100,1953,3
STAT,1870,37,35-39,1907,7.014840351765571
SIM,1855,32,50-100,1887,5
STAT,1852,19,20-24,1871,16.07043463585409
SIM,1838,40,40-44,1878,5
STAT,1894,70,na,1964,2067.4742042289427
STAT,1847,104,na,1951,0.049940790473726696
STAT,1909,42,25-29,1951,0.06739943916756698
STAT,1858,46,25-29,1904,0.045771051383718404
STAT,1850,42,40-44,1892,1.7201811504505051
STAT,1830,103,na,1933,0.0946825738467326
SIM,1840,41,35-39,1881,1
STAT,1930,38,20-24,1968,0.34717985978587845
SIM,1871,23,35-39,1894,5
STAT,1897,31,40-44,1928,5.896166540328118
STAT,1852,22,20-24,1874,62.08561896317951
STAT,1853,17,50-100,1870,0.048737069117162864
STAT,1917,19,50-100,1936,0.4034478426185924
STAT,1919,32,40-44,1951,4.262886539031597
STAT,1925,38,50-100,1963,0.5087530922882193
SIM,1929,24,50-100,1953,5
STAT,1841,16,40-44,1857,0.17745233573337924
SIM,1798,72,na,1870,450
SIM,1841,44,50-100,1885,2
STAT,1867,4,na,1871,2848.2837434775174
STAT,1906,23,na,1929,3468.4804103750853
STAT,1887,41,25-29,1928,0.7274022743788982
SIM,1904,63,na,1967,3038
STAT,1831,42,30-34,1873,0.8888598544302004
STAT,1902,47,35-39,1949,0.11218762046829378
SIM,1874,93,na,1967,108
STAT,1821,47,40-44,1868,0.25092361635072785
STAT,1925,43,20-24,1968,0.021574074724471468
STAT,1899,29,50-100,1928,0.8803733051520375
STAT,1921,48,15-19,1969,4.1824763276412117E-4
STAT,1899,17,na,1916,3500.873630653062
SIM,1838,37,40-44,1875,5
SIM,1868,19,30-34,1887,1
STAT,1906,30,40-44,1936,3.6927034665680636
STAT,1877,40,20-24,1917,0.1672208711131434
STAT,1832,41,35-39,1873,1.5326159137725703
STAT,1934,33,na,1967,5214.400935336911
STAT,1852,46,50-100,1898,0.18678989160536202
STAT,1932,40,35-39,1972,0.27656960522546026
STAT,1843,44,15-19,1887,0.009347499589549812
SIM,1914,30,40-44,1944,5
SIM,1927,26,na,1953,5011
SIM,1952,18,na,1970,4469
SIM,1910,38,45-49,1948,4
STAT,1912,32,30-34,1944,15.640876021207921
STAT,1830,30,20-24,1860,2.6789206647009
STAT,1839,46,15-19,1885,2.9266606280042374E-4
STAT,1880,59,na,1939,2061.452823467161
STAT,1931,0,na,1931,5959.577843557206
SIM,1810,51,na,1861,1348
STAT,1873,54,45-49,1927,0.014450775922682773
STAT,1851,42,15-19,1893,0.010443760576973325
STAT,1815,41,35-39,1856,4.885206302310154
STAT,1826,29,20-24,1855,21.2896749258263
STAT,1921,15,na,1936,4257.132936691181
SIM,1876,53,50-100,1929,1
STAT,1812,45,40-44,1857,0.4077761249545717
STAT,1935,32,25-29,1967,12.919258164927232
STAT,1802,53,25-29,1855,0.010129661225787767
STAT,1901,32,20-24,1933,3.827145831435163
STAT,1868,53,50-100,1921,0.014344472051764576
STAT,1879,51,35-39,1930,0.009117362247491358
STAT,1870,60,na,1930,1891.5183757250884
SIM,1896,47,50-100,1943,2
SIM,1861,12,na,1873,2484
SIM,1816,54,na,1870,1185
STAT,1899,47,25-29,1946,0.044827764321537324
SIM,1860,22,20-24,1882,76
STAT,1882,17,40-44,1899,0.1789427620207046
SIM,1827,91,na,1918,18
STAT,1813,53,35-39,1866,0.023331583222906363
STAT,1865,67,na,1932,1461.9766608652642
STAT,1833,57,na,1890,1421.8054096647231
SIM,1869,15,na,1884,2456
SIM,1799,57,na,1856,1216
STAT,1917,5,na,1922,4353.112084258952
SIM,1848,64,na,1912,1289
STAT,1833,49,25-29,1882,0.04249650208072281
STAT,1914,46,15-19,1960,3.6951940850025696E-4
STAT,1882,32,35-39,1914,9.907790387874947
STAT,1878,88,na,1966,336.3144209683828
STAT,1894,40,20-24,1934,0.20859396461846946
STAT,1933,25,50-100,1958,1.3366806259735728
STAT,1837,33,35-39,1870,8.572749800705262
SIM,1944,17,25-29,1961,65
STAT,1890,4,na,1894,3246.6917659793226
STAT,1913,40,25-29,1953,0.07105803351053157
SIM,1948,10,na,1958,5010
STAT,1838,34,na,1872,1765.7351710162873
STAT,1822,41,50-100,1863,1.722676065025484
STAT,1925,46,25-29,1971,0.06512205371632875
SIM,1918,27,25-29,1945,99
STAT,1932,8,na,1940,5337.122306492924
SIM,1931,33,45-49,1964,3
STAT,1875,42,45-49,1917,1.550430177166075
SIM,1845,33,35-39,1878,11
STAT,1888,22,50-100,1910,0.4861317102229416
STAT,1882,37,na,1919,2304.9645301941014
STAT,1902,38,45-49,1940,0.6110705742988112
SIM,1883,42,45-49,1925,4
STAT,1834,48,50-100,1882,0.15314404707447876
SIM,1842,48,50-100,1890,5
STAT,1791,87,na,1878,52.61096364223587
STAT,1868,6,na,1874,2694.2545092660307
STAT,1908,34,30-34,1942,14.883751795601313
STAT,1808,51,45-49,1859,0.05015125133191971
SIM,1823,41,35-39,1864,5
SIM,1878,52,na,1930,2424
STAT,1841,39,30-34,1880,4.5992316784686365
STAT,1828,27,na,1855,1825.8877860909822
STAT,1922,40,35-39,1962,0.23414100808718888
SIM,1885,85,na,1970,543
STAT,1883,9,na,1892,2564.4609734512414
SIM,1774,84,na,1858,98
STAT,1917,46,40-44,1963,0.1666392626040827
STAT,1897,34,45-49,1931,2.3410218111905046
STAT,1884,45,15-19,1929,4.0236951951569443E-4
STAT,1923,33,45-49,1956,1.8215608027293753
STAT,1836,54,25-29,1890,0.00217305632525045
SIM,1949,18,20-24,1967,171
SIM,1871,41,30-34,1912,1
STAT,1915,24,20-24,1939,115.25527874749677
STAT,1856,27,40-44,1883,2.4036405117642947
STAT,1936,17,25-29,1953,41.88593868283539
SIM,1913,45,na,1958,3596
SIM,1904,34,na,1938,3603
STAT,1846,40,25-29,1886,0.506024215465909
STAT,1878,34,35-39,1912,10.526865572401235
SIM,1930,40,35-39,1970,3
SIM,1890,41,40-44,1931,4
STAT,1846,44,40-44,1890,1.6839009283538326
STAT,1913,38,20-24,1951,0.26117604244517484
STAT,1876,19,15-19,1895,6.155615102052591
SIM,1916,34,30-34,1950,21
SIM,1797,79,na,1876,307
SIM,1911,21,25-29,1932,139
SIM,1862,90,na,1952,67
SIM,1912,5,na,1917,4022
STAT,1832,72,na,1904,859.9356843113256
STAT,1912,45,45-49,1957,0.21172248495544077
SIM,1956,0,na,1956,5298
STAT,1864,23,50-100,1887,0.3749200739907356
STAT,1858,50,50-100,1908,0.012139189997713804
STAT,1894,31,15-19,1925,0.18593448828400666
SIM,1850,57,na,1907,1669
SIM,1886,34,35-39,1920,13
STAT,1857,19,na,1876,2101.654674127425
STAT,1802,52,20-24,1854,0.0021532360700315173
STAT,1882,41,40-44,1923,2.210530618757217
STAT,1820,39,na,1859,1401.536048412947
STAT,1915,35,50-100,1950,0.4320436214527012
SIM,1903,38,na,1941,3179
SIM,1819,43,35-39,1862,1
STAT,1827,40,15-19,1867,0.015375103460152613
STAT,1917,2,na,1919,4427.896643499185
STAT,1921,44,40-44,1965,0.2835853192614032
SIM,1941,25,50-100,1966,1
SIM,1852,83,na,1935,140
SIM,1844,15,20-24,1859,14
SIM,1885,29,50-100,1914,2
STAT,1863,41,30-34,1904,1.0334815330077751
STAT,1893,23,20-24,1916,88.10315793144422
SIM,1864,27,40-44,1891,8
STAT,1842,35,50-100,1877,1.3239040934318904
SIM,1887,37,na,1924,2643
SIM,1814,76,na,1890,356
STAT,1850,25,15-19,1875,0.4147623868914096
STAT,1871,31,20-24,1902,2.723398813688899
STAT,1847,52,35-39,1899,0.0064116064434060266
STAT,1826,32,20-24,1858,3.790894524655521
STAT,1903,21,25-29,1924,82.59144717953913
SIM,1854,44,40-44,1898,5
STAT,1873,34,50-100,1907,0.9301205017266041
STAT,1890,66,na,1956,2049.5614641068346
SIM,1852,16,na,1868,2111
STAT,1856,30,40-44,1886,3.4705663322847253
STAT,1888,47,50-100,1935,0.2914176609209577
STAT,1817,45,25-29,1862,0.12786668231918927
SIM,1825,50,na,1875,1258
STAT,1824,52,40-44,1876,0.011875056813798622
SIM,1842,41,45-49,1883,1
STAT,1819,108,na,1927,9.311803577817892E-4
SIM,1834,29,20-24,1863,17
SIM,1850,35,50-100,1885,1
SIM,1897,44,na,1941,3141
SIM,1915,6,na,1921,4599
STAT,1766,98,na,1864,0.2713135424252809
STAT,1878,19,40-44,1897,0.19073718481093815
STAT,1893,77,na,1970,1559.3453918506207
STAT,1791,65,na,1856,719.308159
STAT,1863,20,30-34,1883,16.49369669439174
SIM,1932,34,50-100,1966,1
SIM,1864,42,35-39,1906,6
SIM,1904,31,35-39,1935,14
SIM,1859,26,20-24,1885,13
STAT,1818,68,na,1886,847.3508016390149
SIM,1932,36,30-34,1968,3
STAT,1874,41,na,1915,2401.0754665311633
STAT,1854,54,35-39,1908,0.006283310462498424
STAT,1833,101,na,1934,0.4037137714297736
STAT,1867,33,20-24,1900,2.560358237451471
SIM,1875,33,20-24,1908,2
SIM,1915,19,20-24,1934,38
STAT,1947,15,35-39,1962,4.777090371191857
SIM,1885,19,25-29,1904,12
STAT,1902,42,15-19,1944,0.0013670328696637629
SIM,1829,72,na,1901,865
STAT,1815,50,40-44,1865,0.023228241320563177
STAT,1945,25,45-49,1970,1.9157861356372712
STAT,1832,94,na,1926,13.609003691237392
STAT,1835,83,na,1918,297.9577118891281
SIM,1903,16,na,1919,3443
STAT,1838,21,50-100,1859,0.3567322876274626
SIM,1861,75,na,1936,813
STAT,1845,29,30-34,1874,22.07570507034999
STAT,1851,46,30-34,1897,0.07350387881489123
STAT,1885,33,na,1918,2388.9245389232856
SIM,1890,23,45-49,1913,4
STAT,1793,103,na,1896,0.025902219331674747
STAT,1910,35,25-29,1945,0.9590867577589008
SIM,1869,15,25-29,1884,9
SIM,1863,6,na,1869,2709
SIM,1872,38,na,1910,2554
SIM,1878,29,35-39,1907,10
SIM,1846,21,50-100,1867,1
SIM,1898,29,na,1927,3205
SIM,1923,24,20-24,1947,5
SIM,1852,61,na,1913,1336
STAT,1821,43,25-29,1864,0.9947670311825568
STAT,1899,24,35-39,1923,8.038223862220946
STAT,1832,53,45-49,1885,0.010107275103338911
STAT,1895,39,50-100,1934,1.6030497236834573
STAT,1924,36,30-34,1960,2.1737003677486895
STAT,1902,44,30-34,1946,0.11240771034375001
SIM,1853,29,30-34,1882,24
SIM,1863,53,na,1916,1901
STAT,1882,23,45-49,1905,0.6801147951554315
STAT,1842,31,na,1873,2381.765339710449
SIM,1955,15,35-39,1970,8
SIM,1901,32,20-24,1933,4
STAT,1916,43,20-24,1959,0.018234985702159315
STAT,1889,58,na,1947,2462.88842008169
STAT,1897,40,30-34,1937,0.10919250393994857
SIM,1903,16,25-29,1919,13
STAT,1839,23,25-29,1862,51.77324392984402
STAT,1935,36,40-44,1971,2.116823638061893
SIM,1928,22,na,1950,4668
SIM,1927,29,na,1956,5186
STAT,1807,76,na,1883,387.6043707363463
SIM,1947,9,na,1956,4841
STAT,1816,87,na,1903,90.07648444116674
STAT,1913,44,40-44,1957,0.24528557367142179
SIM,1800,92,na,1892,22
SIM,1918,29,40-44,1947,9
STAT,1849,52,45-49,1901,0.011286169280314836
SIM,1921,44,40-44,1965,3
SIM,1877,59,na,1936,1982
SIM,1918,15,na,1933,4409
STAT,1803,69,na,1872,865.0036217844529
STAT,1858,23,35-39,1881,4.793193103234596
STAT,1924,34,15-19,1958,0.15130343345963154
STAT,1889,40,na,1929,2907.4487193031828
STAT,1880,26,50-100,1906,0.6808569623734841
STAT,1912,33,35-39,1945,9.03380899172538
SIM,1851,35,25-29,1886,4
SIM,1887,66,na,1953,1754
STAT,1891,26,15-19,1917,0.5692921101266198
SIM,1920,33,35-39,1953,14
STAT,1771,103,na,1874,0.041368985139761984
SIM,1930,15,na,1945,4992
SIM,1874,40,45-49,1914,2
SIM,1838,43,45-49,1881,4
SIM,1861,97,na,1958,1
STAT,1880,44,35-39,1924,1.8948226772381702
STAT,1865,53,40-44,1918,0.009553296515304852
STAT,1857,30,na,1887,1932.3246335956737
STAT,1876,22,na,1898,2466.3742471876385
SIM,1879,44,45-49,1923,3
STAT,1887,45,40-44,1932,0.19497764150295258
STAT,1934,24,30-34,1958,39.00110739680872
STAT,1890,37,na,1927,2907.654735076356
STAT,1844,97,na,1941,4.25043320924697
STAT,1843,35,25-29,1878,2.314598983722906
STAT,1909,46,40-44,1955,0.14655673972277802
SIM,1888,24,25-29,1912,93
STAT,1861,23,na,1884,2024.5628587930871
SIM,1871,20,30-34,1891,26
SIM,1900,21,15-19,1921,8
STAT,1863,89,na,1952,94.01132168707633
SIM,1929,19,15-19,1948,48
STAT,1804,51,50-100,1855,0.04173390880228334
STAT,1805,95,na,1900,5.278010139381411
STAT,1939,10,na,1949,4007.3471568180476
SIM,1827,39,30-34,1866,11
SIM,1886,81,na,1967,948
STAT,1824,35,15-19,1859,0.08305683180277942
SIM,1812,51,50-100,1863,1
SIM,1942,24,30-34,1966,42
SIM,1920,32,30-34,1952,37
SIM,1785,76,na,1861,313
SIM,1838,34,50-100,1872,1
STAT,1856,51,40-44,1907,0.008191050440231704
SIM,1801,77,na,1878,171
STAT,1841,19,45-49,1860,0.06226255103198549
STAT,1844,47,35-39,1891,0.11024939225537743
SIM,1805,62,na,1867,875
STAT,1853,30,15-19,1883,0.12382138368964621
SIM,1876,74,na,1950,1106
STAT,1868,53,25-29,1921,0.0033641758320555014
SIM,1866,23,35-39,1889,9
STAT,1819,39,30-34,1858,12.868563306542105
STAT,1881,52,na,1933,2085.090275047302
STAT,1932,29,na,1961,4953.677389190232
STAT,1841,22,45-49,1863,0.6605951300647714
STAT,1902,46,50-100,1948,0.19829236620888144
STAT,1953,19,50-100,1972,0.45759706206751
SIM,1825,39,na,1864,1431
STAT,1919,35,45-49,1954,0.7435879314521243
STAT,1854,109,na,1963,0.002602523486589299
STAT,1956,11,na,1967,5251.703968234721
SIM,1821,55,na,1876,1116
SIM,1889,23,35-39,1912,9
STAT,1916,25,20-24,1941,19.176186992102608
SIM,1944,19,40-44,1963,2
SIM,1898,52,na,1950,2925
SIM,1901,38,30-34,1939,5
SIM,1918,16,35-39,1934,1
STAT,1941,17,25-29,1958,45.06421353962186
SIM,1889,21,40-44,1910,2
STAT,1829,74,na,1903,654.3734184308337
STAT,1916,27,15-19,1943,0.7366230050156675
STAT,1825,84,na,1909,242.76392985227585
SIM,1919,43,40-44,1962,2
SIM,1936,31,na,1967,3800
SIM,1928,36,na,1964,4915
STAT,1848,17,45-49,1865,0.06611428907858036
SIM,1829,28,40-44,1857,3
SIM,1857,78,na,1935,676
SIM,1910,26,na,1936,3571
STAT,1911,47,na,1958,3508.8657929312844
STAT,1861,38,40-44,1899,3.65572827630505
SIM,1843,31,45-49,1874,1
STAT,1920,27,35-39,1947,16.63147572235859
STAT,1841,23,na,1864,2010.9739273321536
STAT,1856,76,na,1932,733.6184751605068
SIM,1853,88,na,1941,95
STAT,1931,15,45-49,1946,0.663882926620965
SIM,1924,25,20-24,1949,29
STAT,1865,16,35-39,1881,0.524565302708651
STAT,1922,24,35-39,1946,10.840085105466585
SIM,1933,18,25-29,1951,102
STAT,1830,42,50-100,1872,0.9179103209195318
STAT,1850,21,50-100,1871,0.37749011521238773
STAT,1876,16,50-100,1892,0.051216314910639854
STAT,1920,2,na,1922,4633.694234471624
STAT,1860,81,na,1941,446.4695367972045
STAT,1872,15,na,1887,2603.568707667264
SIM,1893,29,na,1922,3044
SIM,1907,28,25-29,1935,71
STAT,1844,106,na,1950,0.009606313177801001
STAT,1883,78,na,1961,968.5203058073685
SIM,1855,30,25-29,1885,16
STAT,1926,8,na,1934,4942.135076247738
SIM,1950,15,20-24,1965,141
STAT,1900,33,15-19,1933,0.19895640073217027
STAT,1911,21,25-29,1932,88.6475097547581
STAT,1877,15,15-19,1892,6.215056631563338
SIM,1837,30,na,1867,1705
STAT,1807,54,50-100,1861,0.04921911055028762
SIM,1823,46,50-100,1869,1
STAT,1862,51,30-34,1913,0.005216775956612394
STAT,1816,48,na,1864,1502.8503033857694
SIM,1903,33,35-39,1936,14
STAT,1904,28,35-39,1932,13.936109935156622
SIM,1861,83,na,1944,280
STAT,1908,47,50-100,1955,0.20648495361033403
STAT,1847,30,25-29,1877,9.193356989762327
STAT,1911,36,25-29,1947,0.9640647320084895
SIM,1868,16,25-29,1884,7
STAT,1903,4,na,1907,3784.0161376082237
STAT,1931,33,45-49,1964,2.082565231148542
STAT,1925,18,25-29,1943,52.76579753779702
SIM,1895,25,50-100,1920,1
STAT,1870,53,50-100,1923,0.014738229816194545
SIM,1906,29,20-24,1935,15
SIM,1930,22,40-44,1952,6
STAT,1859,17,20-24,1876,16.717143428080387
STAT,1813,50,50-100,1863,0.04348153213514272
STAT,1921,25,30-34,1946,44.404109955742435
STAT,1835,31,45-49,1866,1.6843489148893405
SIM,1831,36,50-100,1867,1
SIM,1950,17,15-19,1967,53
STAT,1902,29,40-44,1931,4.244891267222491
SIM,1826,78,na,1904,611
SIM,1826,86,na,1912,166
STAT,1928,42,30-34,1970,0.164733894671408
STAT,1777,100,na,1877,0.1609186569526214
SIM,1920,32,25-29,1952,18
STAT,1896,25,25-29,1921,56.93734505965199
SIM,1888,22,na,1910,2889
SIM,1910,29,40-44,1939,11
STAT,1848,18,50-100,1866,0.04929365693693063
STAT,1904,26,40-44,1930,4.3567266520837995
STAT,1923,16,50-100,1939,0.4455976572882654
STAT,1850,51,na,1901,1656.598700931905
SIM,1907,26,30-34,1933,60
STAT,1926,45,30-34,1971,0.11169142044758723
STAT,1929,41,35-39,1970,0.26395821688927146
SIM,1851,53,na,1904,1668
STAT,1798,97,na,1895,1.7874913298349295
STAT,1839,24,40-44,1863,1.8710766123666234
STAT,1889,18,45-49,1907,0.08113912540772217
STAT,1909,48,35-39,1957,0.11921822829459885
STAT,1862,17,na,1879,2293.0424062453144
SIM,1800,61,na,1861,957
STAT,1873,20,25-29,1893,58.964056024538145
SIM,1852,47,na,1899,1676
SIM,1899,43,45-49,1942,1
STAT,1843,54,25-29,1897,0.0023232784079536065
SIM,1911,28,45-49,1939,2
STAT,1870,46,40-44,1916,0.17027622405011217
STAT,1811,43,25-29,1854,1.7784311074529373
STAT,1903,28,45-49,1931,1.5914530320749043
SIM,1905,30,35-39,1935,9
STAT,1867,48,na,1915,2113.2074656227496
STAT,1856,37,50-100,1893,0.9506980152214629
STAT,1892,49,25-29,1941,0.04031888722833611
STAT,1907,32,15-19,1939,0.12128427103778733
STAT,1912,32,25-29,1944,9.175595501861709
SIM,1912,26,40-44,1938,6
SIM,1806,49,50-100,1855,2
SIM,1867,60,na,1927,1699
STAT,1936,19,40-44,1955,1.3446879673544623
STAT,1871,0,na,1871,3734.3922994388477
SIM,1842,37,na,1879,1861
STAT,1915,27,25-29,1942,67.74305562345002
SIM,1851,73,na,1924,1048
SIM,1797,76,na,1873,383
SIM,1869,31,50-100,1900,2
SIM,1834,73,na,1907,757
STAT,1888,19,40-44,1907,0.21687156394722515
STAT,1900,15,15-19,1915,8.364925860650809
STAT,1826,58,na,1884,1152.0361392923774
STAT,1855,35,na,1890,1790.2352515127402
STAT,1898,20,30-34,1918,24.53425132025752
STAT,1911,5,na,1916,4045.9663113038728
SIM,1830,91,na,1921,30
SIM,1922,28,20-24,1950,30
STAT,1854,2,na,1856,2688.644659124907
STAT,1835,48,40-44,1883,0.13376937205585018
STAT,1914,28,20-24,1942,18.501069555931817
SIM,1865,21,25-29,1886,62
STAT,1927,44,35-39,1971,0.25440766136969306
SIM,1867,17,20-24,1884,21
STAT,1922,22,40-44,1944,3.895303329111358
STAT,1942,17,15-19,1959,47.88550858704116
STAT,1905,25,45-49,1930,1.6321482271145893
SIM,1909,23,30-34,1932,36
STAT,1925,44,50-100,1969,0.14326334397930898
STAT,1940,5,na,1945,4104.566488301245
STAT,1864,71,na,1935,1216.5201609854648
SIM,1888,24,30-34,1912,31
STAT,1835,94,na,1929,15.000506471592507
STAT,1918,39,45-49,1957,0.7238803687264688
STAT,1912,21,50-100,1933,0.6381266093573028
STAT,1940,20,35-39,1960,9.690266274178747
SIM,1893,39,40-44,1932,9
STAT,1937,35,35-39,1972,2.445949868666322
SIM,1820,81,na,1901,239
STAT,1930,26,na,1956,4816.6466809634185
STAT,1906,24,50-100,1930,0.5961463996134391
SIM,1904,31,30-34,1935,22
SIM,1814,73,na,1887,486
SIM,1854,42,na,1896,2138
SIM,1942,21,20-24,1963,140
SIM,1921,31,30-34,1952,26
STAT,1796,62,na,1858,859.9794300726384
STAT,1874,81,na,1955,559.2530230693797
STAT,1874,21,25-29,1895,59.38155421697842
STAT,1913,19,45-49,1932,0.1024983092934836
SIM,1925,21,20-24,1946,137
SIM,1923,27,25-29,1950,90
STAT,1874,10,na,1884,2737.548051620482
SIM,1858,42,45-49,1900,2
STAT,1930,19,45-49,1949,0.6492537535255746
SIM,1916,11,na,1927,4222
STAT,1937,33,40-44,1970,3.9061873745604005
SIM,1925,23,15-19,1948,7
STAT,1864,18,40-44,1882,0.17142711151319626
STAT,1816,56,na,1872,1302.826901321717
STAT,1810,47,25-29,1857,0.22251327322814712
STAT,1782,82,na,1864,164.4647739494757
STAT,1905,43,45-49,1948,0.15065130563722104
SIM,1865,65,na,1930,1495
SIM,1943,13,na,1956,4196
STAT,1837,23,50-100,1860,0.361571614802408
SIM,1888,27,35-39,1915,14
STAT,1799,106,na,1905,0.00407440858577305
STAT,1908,33,15-19,1941,0.12192879043397568
SIM,1926,39,45-49,1965,3
STAT,1934,21,20-24,1955,151.04071304862248
STAT,1829,34,25-29,1863,8.67872362494118
STAT,1920,45,35-39,1965,0.14459936728171568
SIM,1842,17,na,1859,2239
SIM,1881,3,na,1884,2556
STAT,1885,39,40-44,1924,4.356575932554648
SIM,1879,14,na,1893,2982
STAT,1917,21,20-24,1938,119.64906355092126
STAT,1805,64,na,1869,1011.5306498257708
STAT,1871,53,na,1924,2125.850790430695
SIM,1843,78,na,1921,732
SIM,1847,24,40-44,1871,3
STAT,1864,51,na,1915,1971.758611993734
STAT,1942,15,20-24,1957,143.12622677920436
STAT,1821,53,35-39,1874,0.011897290835715443
STAT,1807,51,na,1858,1187.5198629370464
STAT,1873,88,na,1961,244.65066698189034
STAT,1841,15,na,1856,2240.2304239573305
SIM,1906,27,25-29,1933,12
SIM,1929,30,50-100,1959,3
STAT,1847,18,40-44,1865,0.16991572782424122
STAT,1890,12,na,1902,3187.23160109774
SIM,1837,34,25-29,1871,6
SIM,1916,31,20-24,1947,4
STAT,1889,15,40-44,1904,0.22884473564048305
STAT,1869,21,15-19,1890,3.2492850003400564
STAT,1887,68,na,1955,1723.2657706473278
SIM,1892,1,na,1893,3704
SIM,1847,26,35-39,1873,9
STAT,1847,48,na,1895,1663.3728030452805
SIM,1848,23,45-49,1871,3
SIM,1905,59,na,1964,3117
STAT,1842,96,na,1938,7.730866067329896
STAT,1859,24,50-100,1883,0.33877847688386975
SIM,1884,32,45-49,1916,3
STAT,1914,30,35-39,1944,9.355591572513418
STAT,1891,73,na,1964,1758.2984436351278
STAT,1891,53,na,1944,2649.33104153945
SIM,1863,78,na,1941,554
STAT,1824,43,na,1867,1348.4666462470375
SIM,1811,45,na,1856,1582
SIM,1848,22,na,1870,1926
SIM,1897,17,35-39,1914,1
STAT,1876,49,40-44,1925,0.17480704299659305
STAT,1903,41,15-19,1944,0.0013856552395950775
STAT,1875,35,na,1910,2466.86845908388
STAT,1889,17,35-39,1906,0.6833591807569185
STAT,1860,54,30-34,1914,0.004779435156280874
STAT,1902,30,na,1932,3433.2634433141475
SIM,1941,22,15-19,1963,7
SIM,1786,92,na,1878,18
SIM,1874,30,na,1904,2317
SIM,1812,86,na,1898,23
STAT,1876,32,45-49,1908,1.8185326659319896
STAT,1928,43,40-44,1971,0.3217854666267362
STAT,1891,39,50-100,1930,1.5198137847225224
STAT,1917,23,15-19,1940,5.6930312835371
SIM,1866,20,30-34,1886,31
STAT,1913,31,30-34,1944,15.880375970009087
SIM,1901,23,30-34,1924,38
STAT,1908,31,20-24,1939,2.333652266169212
SIM,1882,37,na,1919,2091
STAT,1820,61,na,1881,998.9819795811552
SIM,1878,35,25-29,1913,4
STAT,1839,26,35-39,1865,8.680231814900612
SIM,1927,6,na,1933,5471
STAT,1831,33,na,1864,1745.1564198562505
STAT,1897,1,na,1898,3685.567264096729
STAT,1903,45,35-39,1948,0.11472636413176092
STAT,1933,22,15-19,1955,7.13518456969342
STAT,1904,57,na,1961,3036.8631650706466
SIM,1939,18,20-24,1957,197
SIM,1888,25,40-44,1913,3
STAT,1834,49,35-39,1883,0.08618580264540543
STAT,1858,20,30-34,1878,16.42914577573386
SIM,1806,86,na,1892,39
STAT,1922,21,30-34,1943,33.397364293826875
SIM,1803,58,na,1861,974
SIM,1931,20,35-39,1951,32
SIM,1916,19,35-39,1935,5
SIM,1942,23,15-19,1965,7
STAT,1908,19,35-39,1927,0.8172466650536561
STAT,1934,23,15-19,1957,7.22594842113146
SIM,1817,41,45-49,1858,4
STAT,1915,29,na,1944,3828.0301088549777
SIM,1868,22,na,1890,2319
SIM,1930,21,30-34,1951,5
SIM,1902,37,35-39,1939,1
STAT,1909,49,45-49,1958,0.2003468795544393
STAT,1934,22,50-100,1956,0.8934900622279828
STAT,1938,32,45-49,1970,1.5973204559328724
STAT,1920,41,15-19,1961,0.0017152160002327616
STAT,1778,77,na,1855,350.18444999999997
STAT,1859,49,40-44,1908,0.13616813630073074
STAT,1852,43,50-100,1895,0.7954168804925976
STAT,1923,20,35-39,1943,11.135690508183274
STAT,1836,56,na,1892,1286.0381719414343
SIM,1922,15,45-49,1937,1
STAT,1912,35,30-34,1947,1.8117276645509481
STAT,1933,25,20-24,1958,24.51366303100475
STAT,1927,43,25-29,1970,0.09037708298498583
SIM,1862,37,na,1899,2127
STAT,1907,22,na,1929,3507.9059956325787
SIM,1912,29,45-49,1941,1
STAT,1818,82,na,1900,240.38643340201634
STAT,1878,63,na,1941,1870.7623031467467
SIM,1900,5,na,1905,3865
STAT,1908,47,na,1955,3353.894097000443
SIM,1905,28,20-24,1933,20
STAT,1779,100,na,1879,0.2518391621852879
STAT,1937,6,na,1943,3936.401464829936
STAT,1841,37,50-100,1878,1.081730447000341
STAT,1941,16,15-19,1957,47.20726762842025
SIM,1895,49,50-100,1944,4
STAT,1823,38,na,1861,1570.7436764765782
SIM,1902,18,25-29,1920,7
SIM,1907,48,50-100,1955,2
STAT,1920,26,25-29,1946,73.16350259179768
STAT,1862,54,35-39,1916,0.007302503770851845
STAT,1838,33,50-100,1871,0.7542885451513253
STAT,1856,43,50-100,1899,0.8121500864881608
SIM,1839,30,40-44,1869,5
SIM,1849,63,na,1912,1379
STAT,1887,35,25-29,1922,3.2775494756957526
STAT,1902,25,50-100,1927,0.9192015361261899
STAT,1837,41,20-24,1878,0.12949561611311755
SIM,1879,34,30-34,1913,4
SIM,1920,16,na,1936,4444
SIM,1858,27,20-24,1885,12
STAT,1936,11,na,1947,3835.4773590837367
SIM,1881,20,25-29,1901,43
STAT,1913,31,50-100,1944,0.8333653707325833
STAT,1904,29,45-49,1933,1.597792296661855
SIM,1826,31,45-49,1857,2
STAT,1849,74,na,1923,867.6914077979911
STAT,1914,15,45-49,1929,0.1047426089286714
STAT,1826,54,25-29,1880,0.0032351137292739155
SIM,1907,25,20-24,1932,23
STAT,1903,42,25-29,1945,0.06406376345218999
STAT,1916,40,15-19,1956,0.00159256867469541
STAT,1885,22,45-49,1907,0.70104368354461
STAT,1919,37,40-44,1956,1.6237913312563783
SIM,1923,9,na,1932,4766
STAT,1919,19,40-44,1938,1.5522835989234232
SIM,1877,21,15-19,1898,3
STAT,1879,29,40-44,1908,3.134757836269732
STAT,1778,97,na,1875,1.0234216585926101
SIM,1856,31,25-29,1887,11
STAT,1893,45,25-29,1938,0.0420834708417735
SIM,1790,66,na,1856,933
STAT,1855,15,na,1870,2079.5025827769064
STAT,1882,17,na,1899,2470.920611718653
SIM,1908,27,30-34,1935,4
STAT,1876,76,na,1952,987.9932148028132
STAT,1931,28,20-24,1959,23.80615174828
STAT,1826,41,45-49,1867,1.59277755445785
STAT,1830,31,na,1861,1867.760918247193
STAT,1915,44,45-49,1959,0.16851155378480276
STAT,1910,38,30-34,1948,1.7499061054842646
SIM,1886,27,na,1913,2697
STAT,1893,32,45-49,1925,2.2363499091916825
STAT,1835,51,50-100,1886,0.01178764161362577
SIM,1926,41,na,1967,4595
SIM,1927,19,40-44,1946,3
STAT,1819,76,na,1895,481.6248879668371
SIM,1913,22,40-44,1935,9
SIM,1833,88,na,1921,89
SIM,1854,34,25-29,1888,19
STAT,1888,30,15-19,1918,0.17113045363601312
STAT,1921,28,35-39,1949,16.840148016270966
STAT,1876,17,20-24,1893,18.488073853897845
STAT,1908,18,25-29,1926,8.463291834315964
SIM,1879,16,30-34,1895,2
SIM,1933,15,20-24,1948,160
STAT,1905,38,20-24,1943,0.2417273302632713
STAT,1910,23,30-34,1933,27.147045312267977
STAT,1922,25,45-49,1947,1.9882961797046692
SIM,1808,81,na,1889,142
STAT,1868,33,na,1901,2293.763573947236
STAT,1860,53,20-24,1913,5.994637468257578E-4
STAT,1936,34,35-39,1970,8.949604620601566
STAT,1822,100,na,1922,0.593590786091176
STAT,1911,33,20-24,1944,2.386147244598326
SIM,1793,66,na,1859,739
STAT,1909,2,na,1911,4033.9662320875223
STAT,1852,31,45-49,1883,1.3835839903312726
STAT,1868,10,na,1878,2610.435377096323
STAT,1931,30,40-44,1961,5.188211632756263
STAT,1839,76,na,1915,671.6834887931205
STAT,1925,15,20-24,1940,166.28203600490443
SIM,1810,91,na,1901,55
STAT,1848,31,25-29,1879,9.854143037904551
SIM,1892,67,na,1959,2273
STAT,1902,31,25-29,1933,14.678601932912848
STAT,1913,47,45-49,1960,0.21403418855776807
SIM,1930,25,45-49,1955,2
STAT,1795,69,na,1864,795.5262453819262
STAT,1858,21,40-44,1879,1.9081995379311545
STAT,1905,22,40-44,1927,3.042562201057264
STAT,1884,71,na,1955,1329.454741256594
STAT,1815,94,na,1909,8.651541114104406
STAT,1860,61,na,1921,1542.7951542631777
SIM,1823,81,na,1904,322
STAT,1790,77,na,1867,292.3823112424511
STAT,1895,43,na,1938,3036.871229864793
SIM,1884,60,na,1944,1966
STAT,1875,47,30-34,1922,0.09993457045376905
SIM,1941,25,20-24,1966,20
STAT,1921,40,25-29,1961,0.0814579562749339
SIM,1840,81,na,1921,413
STAT,1852,44,25-29,1896,0.48043304655023444
SIM,1858,25,50-100,1883,1
SIM,1911,25,40-44,1936,8
SIM,1901,39,40-44,1940,1
STAT,1867,43,50-100,1910,0.9976608775026858
STAT,1923,21,45-49,1944,1.3267812101762733
STAT,1899,21,30-34,1920,24.765072228680616
STAT,1838,28,40-44,1866,2.532533097066362
STAT,1846,34,25-29,1880,8.996901093024201
SIM,1852,21,45-49,1873,4
SIM,1895,32,na,1927,3175
STAT,1916,28,25-29,1944,68.43804723637078
SIM,1924,28,25-29,1952,92
SIM,1868,2,na,1870,3101
STAT,1901,16,15-19,1917,8.423114493779593
STAT,1842,17,na,1859,2653.8713036361173
SIM,1864,24,40-44,1888,3
SIM,1908,16,na,1924,3767
STAT,1902,22,na,1924,3375.539405241106
STAT,1880,47,40-44,1927,0.1807470380902099
SIM,1903,24,na,1927,3138
STAT,1818,54,50-100,1872,0.024820616153291772
STAT,1863,31,20-24,1894,2.4288249279373115
STAT,1856,24,40-44,1880,1.8472188569073262
STAT,1801,54,20-24,1855,0.0026742593276999076
STAT,1928,25,50-100,1953,1.2478671921251017
STAT,1945,27,40-44,1972,5.164236640647804
STAT,1903,25,40-44,1928,4.33809155323768
STAT,1951,21,20-24,1972,134.26668167441474
SIM,1943,21,na,1964,3865
SIM,1846,28,40-44,1874,2
SIM,1899,40,40-44,1939,2
STAT,1917,52,na,1969,3808.1553859854316
STAT,1887,22,50-100,1909,0.4598432021387896
SIM,1859,23,20-24,1882,76
STAT,1930,16,40-44,1946,1.8322014935937567
STAT,1918,43,50-100,1961,0.12590304211084913
STAT,1938,22,50-100,1960,0.6574280798492534
STAT,1844,21,45-49,1865,0.693827334207472
STAT,1908,27,na,1935,3573.649274525712
STAT,1924,47,20-24,1971,0.013294788445764254
SIM,1848,21,25-29,1869,61
SIM,1904,2,na,1906,4001
SIM,1925,24,25-29,1949,154
STAT,1897,24,30-34,1921,23.96789036255162
STAT,1895,0,na,1895,3872.9202980206674
STAT,1917,30,50-100,1947,0.8809368732353215
STAT,1919,19,na,1938,4084.878641018189
SIM,1910,31,25-29,1941,2
STAT,1834,46,30-34,1880,0.06805085733015726
STAT,1857,20,40-44,1877,1.9237560777339033
STAT,1823,58,na,1881,1184.1853113168856
STAT,1913,32,40-44,1945,3.9283793292598994
SIM,1950,15,na,1965,4253
STAT,1851,48,25-29,1899,0.04306600489959376
SIM,1904,34,35-39,1938,11
STAT,1884,40,50-100,1924,1.0628380881491972
SIM,1860,46,50-100,1906,3
STAT,1812,66,na,1878,878.9958817867945
STAT,1937,32,30-34,1969,15.736153950435666
STAT,1821,50,30-34,1871,0.008732458311574917
STAT,1918,36,40-44,1954,1.6006290666259892
STAT,1773,103,na,1876,0.054461550973622624
STAT,1799,59,na,1858,1006.9813098886915
SIM,1836,45,na,1881,1810
STAT,1900,33,45-49,1933,2.436277326053588
STAT,1924,7,na,1931,4810.1706174044875
STAT,1915,44,15-19,1959,0.0015548933390140268
STAT,1921,23,35-39,1944,10.708067760589065
STAT,1829,31,20-24,1860,2.4710982377421424
STAT,1968,2,na,1970,4963.259389350399
STAT,1874,22,35-39,1896,6.034992752246847
SIM,1838,33,30-34,1871,27
STAT,1843,20,50-100,1863,0.35024482735808443
STAT,1926,17,30-34,1943,15.103433348903392
STAT,1909,47,25-29,1956,0.04918652339556884
SIM,1896,31,25-29,1927,25
SIM,1881,75,na,1956,873
SIM,1827,40,na,1867,1553
SIM,1866,21,40-44,1887,2
STAT,1923,18,20-24,1941,160.4304842377879
SIM,1848,22,35-39,1870,10
STAT,1896,22,20-24,1918,92.13057415796331
SIM,1891,42,na,1933,2958
SIM,1901,20,20-24,1921,97
STAT,1831,25,na,1856,1821.505626580505
STAT,1843,58,na,1901,1333.8258038886615
STAT,1924,19,20-24,1943,162.26943030460356
SIM,1917,29,25-29,1946,75
STAT,1901,37,na,1938,3362.0491451586627
SIM,1921,8,na,1929,4539
SIM,1884,40,na,1924,2378
STAT,1872,24,25-29,1896,57.764495886488106
SIM,1875,55,na,1930,2057
SIM,1796,82,na,1878,155
STAT,1866,86,na,1952,207.50583404051798
SIM,1839,17,na,1856,2040
STAT,1917,24,25-29,1941,98.47296947988791
SIM,1903,32,25-29,1935,16
STAT,1917,42,25-29,1959,0.07522149839453908
SIM,1921,32,40-44,1953,5
SIM,1931,18,20-24,1949,2
STAT,1932,29,20-24,1961,24.137862762773498
SIM,1786,84,na,1870,63
SIM,1820,61,na,1881,1018
SIM,1932,19,20-24,1951,5
SIM,1937,26,45-49,1963,2
STAT,1881,12,na,1893,2514.2416762263806
STAT,1905,40,40-44,1945,0.23036000422674507
STAT,1917,32,na,1949,3997.5912016560005
STAT,1909,29,25-29,1938,63.02261396391085
SIM,1882,14,na,1896,2304
SIM,1964,7,na,1971,5250
STAT,1843,89,na,1932,70.85521674542227
SIM,1819,73,na,1892,506
SIM,1940,29,20-24,1969,19
SIM,1930,24,35-39,1954,15
STAT,1854,15,50-100,1869,0.04450573053986635
STAT,1938,19,15-19,1957,45.1645435063574
STAT,1878,42,20-24,1920,0.16630328216975587
STAT,1901,44,15-19,1945,0.0013394555493171998
STAT,1903,42,30-34,1945,0.11469480184029278
STAT,1850,91,na,1941,44.37144388835994
SIM,1887,29,40-44,1916,7
STAT,1907,35,20-24,1942,0.24912458425290954
STAT,1896,48,50-100,1944,0.1828882904681187
SIM,1836,20,15-19,1856,4
STAT,1855,53,40-44,1908,0.007797146771270627
STAT,1925,19,na,1944,4469.440984959808
SIM,1866,44,50-100,1910,1
STAT,1806,66,na,1872,783.0999956771271
STAT,1905,5,na,1910,3826.385390100731
STAT,1904,25,30-34,1929,36.74674102140339
STAT,1949,17,50-100,1966,0.4402081254912011
SIM,1892,27,na,1919,3430
SIM,1912,25,30-34,1937,62
SIM,1900,37,50-100,1937,1
STAT,1819,84,na,1903,169.11363167452907
SIM,1844,32,na,1876,1729
SIM,1844,71,na,1915,900
SIM,1927,37,40-44,1964,6
SIM,1789,89,na,1878,24
STAT,1942,18,25-29,1960,45.70983561933273
SIM,1915,18,na,1933,4411
SIM,1933,34,30-34,1967,7
SIM,1837,31,20-24,1868,2
SIM,1950,18,25-29,1968,56
SIM,1906,24,20-24,1930,121
STAT,1864,20,na,1884,2221.9291458641915
STAT,1883,15,40-44,1898,0.18161605206318887
SIM,1933,16,30-34,1949,21
STAT,1868,25,15-19,1893,0.44092615065316454
SIM,1946,19,15-19,1965,54
SIM,1888,21,25-29,1909,79
SIM,1915,49,na,1964,4078
STAT,1889,32,25-29,1921,12.756079955202306
STAT,1898,21,40-44,1919,2.8617832998613086
SIM,1838,32,na,1870,1873
STAT,1848,33,na,1881,2046.2454036021759
SIM,1889,22,25-29,1911,79
STAT,1788,67,na,1855,678.2336
STAT,1888,31,25-29,1919,12.260227396774718
STAT,1931,41,50-100,1972,0.15884414940694616
STAT,1878,15,30-34,1893,1.6788641998123521
SIM,1934,17,30-34,1951,22
SIM,1831,53,na,1884,1466
STAT,1856,23,30-34,1879,15.904116564622012
STAT,1925,34,30-34,1959,18.883376522828378
STAT,1958,9,na,1967,5213.245271339109
SIM,1897,32,25-29,1929,24
SIM,1926,36,40-44,1962,3
STAT,1929,38,50-100,1967,0.5442643050964308
STAT,1943,24,na,1967,3920.358230314092
SIM,1923,26,15-19,1949,1
STAT,1818,106,na,1924,0.006255480989988979
STAT,1925,16,30-34,1941,14.916863719818526
STAT,1877,78,na,1955,814.4794315034079
STAT,1899,22,40-44,1921,2.8884754931362577
STAT,1923,36,15-19,1959,0.022502300637512223
STAT,1911,34,30-34,1945,15.345509121804845
SIM,1864,23,30-34,1887,30
SIM,1911,24,30-34,1935,40
STAT,1858,44,50-100,1902,0.8258187757489415
STAT,1861,7,na,1868,2387.64457381921
STAT,1901,21,50-100,1922,0.5791162240077201
STAT,1921,41,35-39,1962,0.22939717250694933
STAT,1862,48,na,1910,1937.6997208210482
STAT,1808,92,na,1900,15.70214120593451
STAT,1915,26,15-19,1941,0.7290693990127727
STAT,1781,97,na,1878,0.5480911886534579
SIM,1940,16,na,1956,3910
STAT,1867,29,15-19,1896,0.4284872782745806
STAT,1898,24,45-49,1922,0.9488017302450015
SIM,1900,24,20-24,1924,88
STAT,1820,100,na,1920,0.5404009778864644
SIM,1911,26,25-29,1937,9
STAT,1944,16,35-39,1960,4.561246947747566
STAT,1814,109,na,1923,3.3300603704601844E-4
SIM,1936,27,40-44,1963,7
SIM,1952,16,35-39,1968,12
STAT,1779,109,na,1888,0.003753819684928285
SIM,1843,44,25-29,1887,3
STAT,1857,25,40-44,1882,2.4674150040631373
SIM,1898,31,30-34,1929,34
SIM,1850,7,na,1857,2369
SIM,1879,25,na,1904,2785
SIM,1950,19,35-39,1969,6
STAT,1905,21,30-34,1926,26.08617343248554
STAT,1905,40,35-39,1945,0.18545483067380633
SIM,1839,96,na,1935,4
STAT,1901,33,30-34,1934,24.616150380234455
STAT,1935,19,25-29,1954,59.53307325595612
STAT,1955,16,45-49,1971,0.6701392895943528
SIM,1925,27,30-34,1952,5
STAT,1848,50,35-39,1898,0.007129947912685734
SIM,1839,73,na,1912,710
STAT,1814,52,40-44,1866,0.02424652039260386
STAT,1928,27,40-44,1955,5.804159320850423
STAT,1811,56,na,1867,1124.0479847910863
STAT,1949,18,na,1967,4323.3860939231645
STAT,1888,53,na,1941,2525.672584415808
SIM,1877,22,25-29,1899,72
SIM,1920,15,40-44,1935,5
STAT,1907,34,50-100,1941,0.7736574375313753
STAT,1918,40,50-100,1958,0.12645231444867555
STAT,1912,38,35-39,1950,2.3699239057997996
STAT,1942,19,35-39,1961,4.424532863775556
SIM,1828,33,na,1861,1760
SIM,1916,47,50-100,1963,3
SIM,1955,1,na,1956,5068
SIM,1821,86,na,1907,106
STAT,1762,107,na,1869,0.005240870983064196
SIM,1906,3,na,1909,3784
STAT,1869,22,25-29,1891,56.21281433451052
SIM,1920,38,35-39,1958,8
STAT,1822,96,na,1918,4.801002789226409
STAT,1829,43,na,1872,1518.4128162941445
STAT,1881,43,40-44,1924,2.173998510221211
STAT,1953,19,45-49,1972,0.6101294160900134
SIM,1856,32,35-39,1888,16
STAT,1925,45,15-19,1970,4.532377628904469E-4
STAT,1903,26,25-29,1929,61.055735367581896
SIM,1879,35,40-44,1914,4
STAT,1864,46,45-49,1910,0.21569804631103112
STAT,1837,44,25-29,1881,0.45852120551415626
STAT,1848,32,35-39,1880,9.642341577762938
STAT,1912,15,40-44,1927,0.28667824669721953
STAT,1893,16,50-100,1909,0.0629835269639449
STAT,1811,47,40-44,1858,0.42645164909981237
STAT,1803,51,25-29,1854,0.01568331976495501
STAT,1857,61,na,1918,1472.9413942264962
SIM,1896,17,na,1913,3377
STAT,1929,26,45-49,1955,2.186366174944197
STAT,1893,49,40-44,1942,0.12126090421977216
STAT,1928,24,na,1952,4579.672935312411
STAT,1919,34,35-39,1953,9.869431056405906
SIM,1934,7,na,1941,5567
SIM,1904,54,na,1958,3274
STAT,1892,30,50-100,1922,1.1705646811920605
STAT,1889,33,35-39,1922,12.55896576686422
STAT,1860,36,30-34,1896,4.421419557182333
STAT,1924,34,na,1958,4453.052628420651
SIM,1897,33,35-39,1930,17
SIM,1935,29,45-49,1964,4
STAT,1927,29,45-49,1956,2.1142951272609802
STAT,1873,24,40-44,1897,2.1202749042322195
SIM,1889,5,na,1894,3259
STAT,1802,96,na,1898,3.000034607071695
SIM,1894,2,na,1896,3792
SIM,1951,5,na,1956,4992
STAT,1841,15,35-39,1856,0.5355111369740793
STAT,1863,34,25-29,1897,9.087526155658928
SIM,1907,22,15-19,1929,4
STAT,1924,35,20-24,1959,0.31465337278290284
STAT,1890,36,45-49,1926,2.472124681989416
STAT,1961,8,na,1969,5127.855542471151
STAT,1942,30,45-49,1972,1.6943315512663688
SIM,1916,15,20-24,1931,26
STAT,1823,45,45-49,1868,0.33421926987034284
STAT,1857,23,45-49,1880,0.6299945349483944
STAT,1934,36,25-29,1970,1.374148917595765
STAT,1812,97,na,1909,2.439057380839228
STAT,1869,24,20-24,1893,67.24558742784214
SIM,1857,39,na,1896,2044
STAT,1858,47,30-34,1905,0.07634542787807776
SIM,1855,44,50-100,1899,3
SIM,1875,35,na,1910,2318
STAT,1912,36,40-44,1948,1.4811762125486423
SIM,1943,4,na,1947,4272
STAT,1905,15,50-100,1920,0.07186522773306477
STAT,1858,106,na,1964,0.052359818954702854
STAT,1944,26,40-44,1970,5.089359083606075
STAT,1835,44,25-29,1879,0.5631085978439123
STAT,1870,42,25-29,1912,0.6360996874304655
STAT,1908,15,20-24,1923,26.67056053697801
SIM,1913,14,na,1927,4047
STAT,1896,40,15-19,1936,0.0012950212657171804
SIM,1901,23,25-29,1924,90
STAT,1875,91,na,1966,171.3497661089322
SIM,1847,91,na,1938,47
SIM,1865,25,40-44,1890,3
STAT,1918,17,na,1935,4258.044965709447
STAT,1859,73,na,1932,964.8537394557139
STAT,1902,46,25-29,1948,0.04650504972742835
SIM,1879,37,35-39,1916,17
STAT,1905,50,na,1955,3189.098424241985
STAT,1868,26,25-29,1894,40.973304169738064
SIM,1860,81,na,1941,419
STAT,1922,43,45-49,1965,0.19267729214575124
STAT,1858,24,45-49,1882,0.5686590484016094
STAT,1935,37,25-29,1972,1.391022845672984
SIM,1927,34,35-39,1961,14
STAT,1823,36,50-100,1859,2.2311255662260714
STAT,1900,30,40-44,1930,6.133369387611987
SIM,1920,36,40-44,1956,3
STAT,1907,17,25-29,1924,8.40504953856425
SIM,1880,24,25-29,1904,63
SIM,1843,47,na,1890,2013
STAT,1866,30,30-34,1896,16.460150400356913
STAT,1913,35,45-49,1948,0.6852388475878223
STAT,1785,70,na,1855,638.7342
STAT,1847,34,40-44,1881,3.3980343956404058
STAT,1930,31,50-100,1961,1.079076667503122
STAT,1844,27,50-100,1871,0.619569599768523
SIM,1854,73,na,1927,1070
STAT,1826,89,na,1915,57.64500869997525
STAT,1775,100,na,1875,0.1556052088239581
STAT,1895,12,na,1907,3406.2349494084533
STAT,1945,24,35-39,1969,10.414776330054469
STAT,1833,21,35-39,1854,5.871950663057733
SIM,1910,16,30-34,1926,2
STAT,1867,17,na,1884,2455.985720971071
SIM,1928,32,30-34,1960,33
STAT,1802,53,30-34,1855,0.01702345861296296
SIM,1899,45,na,1944,3437
STAT,1822,33,25-29,1855,26.619220323345953
STAT,1851,45,20-24,1896,0.009176839919820278
SIM,1841,21,35-39,1862,5
STAT,1817,49,35-39,1866,0.2916212091265049
SIM,1908,23,15-19,1931,6
STAT,1887,17,na,1904,2847.9895181835236
STAT,1897,25,40-44,1922,4.083688049728283
STAT,1916,47,35-39,1963,0.13345305044215733
STAT,1800,61,na,1861,828.085606636861
STAT,1840,42,40-44,1882,1.6447431986266086
STAT,1925,30,15-19,1955,0.1543928371179689
STAT,1888,15,25-29,1903,6.786759628557567
STAT,1897,27,35-39,1924,13.065216475971054
SIM,1879,43,50-100,1922,3
STAT,1926,12,na,1938,4909.744918679361
STAT,1902,16,30-34,1918,2.2804533027869143
SIM,1885,15,15-19,1900,7
STAT,1793,74,na,1867,440.88881349046665
STAT,1789,69,na,1858,833.015422423373
STAT,1884,2,na,1886,3123.4426621998687
SIM,1835,22,20-24,1857,52
STAT,1935,35,30-34,1970,2.579332410539765
SIM,1851,39,35-39,1890,17
STAT,1846,106,na,1952,0.009214144898303116
STAT,1954,17,40-44,1971,1.7469476458277822
STAT,1808,81,na,1889,217.35459486100373
STAT,1911,37,35-39,1948,2.3569390667581165
SIM,1857,30,30-34,1887,25
STAT,1936,15,50-100,1951,0.3638086890740549
STAT,1904,41,30-34,1945,0.11623839716056714
STAT,1916,22,15-19,1938,5.629111903131095
STAT,1854,10,na,1864,2170.0209862160636
SIM,1924,22,15-19,1946,7
SIM,1838,36,35-39,1874,13
SIM,1919,39,na,1958,3963
SIM,1912,20,30-34,1932,40
STAT,1951,20,15-19,1971,6.430017302345471
STAT,1901,15,30-34,1916,2.2671768301277746
STAT,1877,19,30-34,1896,1.6525764636762414
STAT,1861,34,25-29,1895,8.522815095038741
STAT,1849,30,30-34,1879,16.139045115794186
STAT,1941,26,50-100,1967,1.0400047293948365
SIM,1844,40,na,1884,1628
STAT,1843,39,35-39,1882,4.963707748510695
STAT,1800,72,na,1872,489.7870174679355
SIM,1855,34,40-44,1889,5
STAT,1844,43,na,1887,1848.967420902061
STAT,1947,22,45-49,1969,1.2845014408342974
SIM,1923,13,na,1936,4734
STAT,1854,36,50-100,1890,0.925839216625582
STAT,1898,26,40-44,1924,4.115627805126802
SIM,1830,60,na,1890,1040
STAT,1820,46,50-100,1866,0.42410122059828126
STAT,1900,18,20-24,1918,24.80815918843046
SIM,1838,18,35-39,1856,2
SIM,1870,80,na,1950,600
STAT,1921,21,15-19,1942,6.090784652288912
STAT,1881,24,50-100,1905,0.3945253001650123
STAT,1813,90,na,1903,34.568347168267636
STAT,1901,48,30-34,1949,0.07633902569178944
SIM,1826,55,na,1881,1615
STAT,1899,25,45-49,1924,1.549490147990421
STAT,1878,45,25-29,1923,0.06099306665316941
STAT,1921,41,30-34,1962,0.145642055991732
STAT,1853,88,na,1941,113.53030725772676
STAT,1875,20,30-34,1895,18.585445169279133
STAT,1904,20,30-34,1924,25.971499775255996
SIM,1905,18,15-19,1923,10
SIM,1834,33,na,1867,1934
SIM,1839,35,40-44,1874,5
SIM,1865,25,na,1890,2216
STAT,1939,25,20-24,1964,18.541763740894375
SIM,1913,21,30-34,1934,34
STAT,1915,41,40-44,1956,0.25446511075069783
SIM,1779,82,na,1861,138
SIM,1864,26,35-39,1890,11
STAT,1831,23,25-29,1854,134.70181330845497
STAT,1876,42,20-24,1918,0.1654131477122684
SIM,1860,44,30-34,1904,1
STAT,1942,30,15-19,1972,0.13836606509529065
SIM,1897,67,na,1964,2342
STAT,1836,25,na,1861,1790.5022464399572
STAT,1888,35,40-44,1923,5.268032702827818
STAT,1896,8,na,1904,3475.3884792177614
STAT,1930,31,30-34,1961,20.56258129054518
STAT,1916,40,45-49,1956,0.17259461800260917
STAT,1922,39,na,1961,4315.491276883815
STAT,1892,19,50-100,1911,0.06175830460892175
STAT,1840,30,na,1870,1889.2259411327298
SIM,1838,34,40-44,1872,10
STAT,1898,63,na,1961,2585.6140309180173
SIM,1792,92,na,1884,4
SIM,1871,65,na,1936,1523
SIM,1905,28,na,1933,3559
STAT,1931,30,35-39,1961,12.115470699426611
SIM,1903,38,35-39,1941,4
STAT,1833,88,na,1921,97.12755794534532
STAT,1895,35,na,1930,3136.9594032156933
SIM,1885,65,na,1950,1760
SIM,1894,39,na,1933,3258
SIM,1909,39,45-49,1948,1
STAT,1946,25,35-39,1971,16.90607564608103
STAT,1827,27,50-100,1854,1.9071900873601748
STAT,1916,29,35-39,1945,15.553854200335847
SIM,1881,72,na,1953,1079
STAT,1933,27,15-19,1960,0.947217606714975
STAT,1886,21,15-19,1907,3.528677449219758
STAT,1870,54,20-24,1924,7.117341097803366E-4
STAT,1938,16,45-49,1954,0.49868804689059176
SIM,1869,15,30-34,1884,1
STAT,1920,24,30-34,1944,32.06448889767889
SIM,1860,0,na,1860,3270
STAT,1918,19,25-29,1937,47.36391529433706
STAT,1878,18,35-39,1896,0.5737894422686868
STAT,1881,46,45-49,1927,0.230413783301604
SIM,1855,38,50-100,1893,1
STAT,1893,19,15-19,1912,7.569899365783015
STAT,1853,15,25-29,1868,5.704253681471118
STAT,1849,43,na,1892,1793.9957730118724
STAT,1929,29,15-19,1958,0.8921276804521062
STAT,1864,43,40-44,1907,2.0351526919029714
SIM,1872,43,40-44,1915,6
STAT,1944,27,25-29,1971,71.83630477531561
STAT,1833,99,na,1932,1.3399028896199157
STAT,1807,48,50-100,1855,0.8659946851183067
STAT,1820,37,40-44,1857,10.727624122798542
STAT,1916,43,15-19,1959,0.0015856510162649334
STAT,1899,48,30-34,1947,0.07473738483991568
STAT,1916,26,30-34,1942,41.02517013082367
STAT,1924,17,25-29,1941,52.1472789312631
SIM,1890,32,na,1922,3213
STAT,1839,19,50-100,1858,0.044903331885608015
SIM,1918,46,na,1964,4162
STAT,1877,29,40-44,1906,3.1003275297012705
STAT,1855,91,na,1946,43.61852953013472
STAT,1897,21,25-29,1918,77.74794554649858
SIM,1932,17,25-29,1949,92
STAT,1936,36,30-34,1972,1.8080252717324186
SIM,1859,29,30-34,1888,25
STAT,1847,38,50-100,1885,0.9439170456322917
SIM,1889,24,45-49,1913,4
STAT,1839,23,30-34,1862,16.10952618480646
STAT,1874,40,35-39,1914,1.8916212336683433
STAT,1908,24,na,1932,3519.3221752914596
SIM,1894,21,15-19,1915,5
SIM,1902,22,na,1924,3578
STAT,1927,26,40-44,1953,5.747029534600962
STAT,1912,18,45-49,1930,0.10164455889854745
SIM,1950,16,30-34,1966,17
STAT,1889,30,30-34,1919,21.91901388281254
SIM,1878,4,na,1882,3229
STAT,1845,37,50-100,1882,0.9425689832387123
SIM,1818,38,40-44,1856,8
SIM,1831,45,na,1876,1639
STAT,1856,26,35-39,1882,7.7982920415001615
SIM,1929,32,45-49,1961,1
SIM,1833,43,50-100,1876,2
STAT,1821,43,50-100,1864,1.6365522023034627
STAT,1826,28,15-19,1854,1.122489585331354
STAT,1901,36,35-39,1937,2.171890913082311
SIM,1941,27,15-19,1968,1
SIM,1924,26,30-34,1950,5
STAT,1942,16,30-34,1958,12.864432097552127
SIM,1888,50,na,1938,2819
SIM,1922,30,35-39,1952,15
SIM,1897,30,30-34,1927,44
STAT,1798,66,na,1864,918.8734927654048
STAT,1874,25,40-44,1899,3.118998728849209
STAT,1874,47,15-19,1921,4.1174691229054443E-4
SIM,1841,52,na,1893,1494
STAT,1901,18,35-39,1919,0.7748584602786254
SIM,1882,40,35-39,1922,8
SIM,1859,73,na,1932,1069
STAT,1817,41,na,1858,1412.3979431899465
STAT,1851,49,40-44,1900,0.12692396314926727
STAT,1860,39,35-39,1899,5.7808189092524795
STAT,1835,41,20-24,1876,0.14472022541037302
SIM,1869,34,50-100,1903,1
STAT,1865,21,50-100,1886,0.38341170602568647
STAT,1836,28,40-44,1864,2.4276914733807393
STAT,1777,109,na,1886,0.0023985928832487994
SIM,1847,42,35-39,1889,2
STAT,1851,25,na,1876,1945.7128627515667
SIM,1901,69,na,1970,2397
SIM,1923,29,20-24,1952,21
STAT,1820,51,25-29,1871,0.005897896736295818
SIM,1871,73,na,1944,1101
SIM,1831,42,40-44,1873,7
SIM,1909,26,35-39,1935,23
STAT,1872,21,20-24,1893,70.18644685759116
SIM,1885,29,40-44,1914,4
SIM,1910,25,25-29,1935,78
STAT,1918,37,25-29,1955,1.0477324731801816
SIM,1864,20,25-29,1884,99
SIM,1875,24,na,1899,2463
STAT,1902,25,25-29,1927,60.78473299574286
STAT,1864,43,na,1907,2091.217865573481
SIM,1880,21,20-24,1901,70
STAT,1953,16,40-44,1969,1.7099867556425932
STAT,1864,40,na,1904,2127.688958903682
STAT,1892,46,20-24,1938,0.008603246286477462
SIM,1878,21,30-34,1899,30
SIM,1912,21,na,1933,3582
STAT,1919,31,30-34,1950,17.23261306592469
SIM,1844,28,40-44,1872,4
STAT,1852,18,15-19,1870,5.411382951831949
SIM,1927,31,30-34,1958,19
STAT,1915,29,20-24,1944,18.652903320054712
SIM,1867,91,na,1958,77
SIM,1860,18,15-19,1878,10
SIM,1917,18,40-44,1935,4
STAT,1961,5,na,1966,5130.061153796468
SIM,1940,27,50-100,1967,1
STAT,1861,52,25-29,1913,0.0029569155654281085
STAT,1848,35,40-44,1883,3.760416887207526
SIM,1836,23,20-24,1859,65
STAT,1877,61,na,1938,1947.9092944451672
SIM,1928,35,35-39,1963,7
SIM,1862,53,50-100,1915,1
STAT,1922,37,45-49,1959,0.7836442914066131
STAT,1874,50,na,1924,2258.7834338733614
SIM,1926,19,25-29,1945,71
STAT,1806,89,na,1895,35.4200438110504
STAT,1909,45,30-34,1954,0.08345538915639264
SIM,1900,8,na,1908,3833
STAT,1909,18,40-44,1927,0.27606359287327115
STAT,1882,16,35-39,1898,0.5381467144307516
STAT,1920,35,50-100,1955,0.46501768672546256
STAT,1839,42,35-39,1881,1.3530877038538627
STAT,1798,107,na,1905,0.0015691262638141577
STAT,1856,20,25-29,1876,52.23007005689378
STAT,1816,49,20-24,1865,0.03011735613250085
STAT,1823,42,40-44,1865,3.3369914463190598
STAT,1911,18,30-34,1929,2.454305060388263
SIM,1854,70,na,1924,1310
STAT,1857,21,25-29,1878,52.469248787909564
STAT,1894,16,25-29,1910,7.386744942441317
SIM,1899,49,50-100,1948,4
STAT,1883,46,50-100,1929,0.24343319456404405
STAT,1933,37,20-24,1970,0.36283006603188145
SIM,1817,41,na,1858,1657
STAT,1934,24,25-29,1958,125.34284519760881
SIM,1844,63,na,1907,1181
STAT,1848,17,40-44,1865,0.18512005443659238
STAT,1890,33,40-44,1923,5.329619320692441
STAT,1840,92,na,1932,29.195724991673732
STAT,1898,23,na,1921,3228.2391105611746
SIM,1857,47,na,1904,1933
STAT,1861,31,20-24,1892,2.2778944901457123
SIM,1858,32,na,1890,1930
STAT,1902,43,20-24,1945,0.015626551889122837
STAT,1817,46,30-34,1863,0.2114911772305146
SIM,1835,25,25-29,1860,56
SIM,1930,37,45-49,1967,2
STAT,1902,19,35-39,1921,0.7789507658578041
SIM,1876,23,20-24,1899,98
STAT,1912,32,na,1944,3754.6226927137664
SIM,1765,90,na,1855,15
SIM,1868,37,50-100,1905,1
STAT,1871,76,na,1947,950.6477622671359
STAT,1836,18,30-34,1854,2.4427792778230826
SIM,1854,21,15-19,1875,3
SIM,1942,24,25-29,1966,95
SIM,1864,40,na,1904,2544
STAT,1913,16,40-44,1929,0.2892513972519652
STAT,1863,58,na,1921,1769.7317499491169
SIM,1875,32,na,1907,2330
STAT,1862,18,40-44,1880,0.18163565969483053
STAT,1906,36,15-19,1942,0.017916282856429065
SIM,1879,31,25-29,1910,18
STAT,1945,26,50-100,1971,1.1033014939049264
SIM,1793,63,na,1856,830
SIM,1898,60,na,1958,2703
STAT,1847,37,45-49,1884,1.548636118260299
STAT,1839,73,na,1912,842.0844118544502
STAT,1881,83,na,1964,630.0478629568697
STAT,1874,47,50-100,1921,0.2528128165194538
SIM,1891,31,50-100,1922,3
STAT,1846,31,20-24,1877,2.449440063824741
STAT,1910,34,15-19,1944,0.12393939374735487
STAT,1891,50,na,1941,2731.256291805397
SIM,1848,25,na,1873,1945
STAT,1863,52,50-100,1915,0.013443347130391184
STAT,1855,33,50-100,1888,0.6949795261704667
STAT,1952,19,30-34,1971,14.74791208575117
SIM,1837,20,30-34,1857,18
STAT,1904,65,na,1969,2768.8077676987436
STAT,1889,9,na,1898,3231.3409903085026
SIM,1909,36,40-44,1945,1
STAT,1882,68,na,1950,1495.1083509877324
STAT,1881,43,na,1924,2233.888662208293
STAT,1874,20,50-100,1894,0.42424889353714534
STAT,1923,24,na,1947,4266.290304534059
SIM,1849,21,40-44,1870,3
STAT,1901,15,50-100,1916,0.06968779823322223
SIM,1904,32,40-44,1936,10
STAT,1922,40,40-44,1962,0.2908348270932219
STAT,1907,47,20-24,1954,0.009993161988152383
STAT,1927,16,50-100,1943,0.4720013373731604
SIM,1902,34,30-34,1936,6
SIM,1945,15,45-49,1960,1
STAT,1916,21,50-100,1937,0.6979119078180663
SIM,1951,17,30-34,1968,16
SIM,1882,32,50-100,1914,1
STAT,1823,89,na,1912,58.10126343443979
STAT,1921,46,na,1967,4193.248210198014
SIM,1889,24,na,1913,2871
SIM,1882,47,50-100,1929,3
STAT,1884,37,30-34,1921,5.308232838191126
STAT,1868,23,20-24,1891,66.3150527284922
STAT,1810,44,20-24,1854,0.6421806794428886
STAT,1936,32,15-19,1968,0.12601261439004363
SIM,1930,40,40-44,1970,2
STAT,1916,44,30-34,1960,0.1317744282315669
SIM,1806,78,na,1884,332
SIM,1859,17,na,1876,2495
STAT,1930,31,35-39,1961,11.926803470873963
STAT,1897,67,na,1964,2371.8379378592144
SIM,1892,37,30-34,1929,10
STAT,1906,21,45-49,1927,1.028929269410953
STAT,1839,84,na,1923,235.84917840342987
STAT,1879,40,15-19,1919,0.014702428790402467
SIM,1816,45,na,1861,1345
STAT,1933,1,na,1934,5649.0724047851
STAT,1945,21,30-34,1966,31.822306793971666
STAT,1828,81,na,1909,351.04115170380464
STAT,1943,17,30-34,1960,13.050968235631624
STAT,1840,45,45-49,1885,0.1711559597021523
STAT,1861,21,45-49,1882,0.6055963668128695
SIM,1914,21,45-49,1935,1
SIM,1844,18,30-34,1862,2
STAT,1917,36,25-29,1953,1.0372508103167029
SIM,1807,71,na,1878,517
SIM,1911,36,na,1947,3924
STAT,1939,28,25-29,1967,66.7679168400155
STAT,1907,37,50-100,1944,0.3930516604771722
STAT,1894,26,50-100,1920,0.8346692058438614
STAT,1950,7,na,1957,4695.5532359729095
SIM,1883,20,30-34,1903,30
SIM,1842,42,50-100,1884,3
STAT,1885,27,50-100,1912,0.6431068907005659
STAT,1921,44,35-39,1965,0.22830468136922696
SIM,1935,26,40-44,1961,9
STAT,1907,37,15-19,1944,0.01797741709650733
SIM,1873,48,50-100,1921,1
STAT,1834,42,50-100,1876,0.7584862866027345
SIM,1854,34,50-100,1888,1
SIM,1847,23,30-34,1870,22
SIM,1925,36,25-29,1961,1
STAT,1876,45,25-29,1921,0.06066660267971399
STAT,1971,1,na,1972,5036.540716472649
SIM,1922,28,na,1950,4729
STAT,1887,22,15-19,1909,3.720131077029679
STAT,1928,16,na,1944,4699.286476451425
STAT,1810,71,na,1881,753.9643146669661
STAT,1855,43,30-34,1898,0.8591279357170393
STAT,1932,26,15-19,1958,0.9348540567374655
STAT,1898,22,25-29,1920,78.38119337486073
SIM,1851,36,30-34,1887,6
STAT,1917,27,30-34,1944,41.47728240045998
SIM,1895,24,na,1919,3012
STAT,1920,42,30-34,1962,0.14258610181889078
SIM,1878,83,na,1961,661
STAT,1904,41,35-39,1945,0.18308420231919587
STAT,1775,103,na,1878,0.03829489160540633
STAT,1843,36,30-34,1879,4.240211902663955
SIM,1884,9,na,1893,2626
STAT,1939,19,na,1958,3716.9793956290428
SIM,1876,26,25-29,1902,63
STAT,1842,39,20-24,1881,0.7256403244155891
STAT,1908,34,25-29,1942,8.731434597484823
STAT,1800,64,na,1864,740.4490187988116
SIM,1940,26,15-19,1966,4
STAT,1929,39,20-24,1968,0.3413383124221348
SIM,1862,14,na,1876,2418
STAT,1844,51,na,1895,1711.7031062947729
STAT,1939,31,50-100,1970,0.8521283580005057
SIM,1893,27,50-100,1920,3
STAT,1833,46,15-19,1879,3.3700850914754587E-4
STAT,1946,22,30-34,1968,32.303276507452956
STAT,1845,36,na,1881,1827.622236090127
STAT,1904,23,35-39,1927,8.431919155439626
STAT,1874,50,45-49,1924,0.015224267270649667
SIM,1851,22,na,1873,2112
STAT,1845,20,15-19,1865,3.0359835019228565
STAT,1809,54,25-29,1863,0.010909344495598028
STAT,1846,21,15-19,1867,3.1114111383476026
STAT,1940,18,20-24,1958,138.92574336773353
STAT,1843,107,na,1950,0.0031807589149011974
SIM,1929,38,na,1967,4692
STAT,1854,53,25-29,1907,0.0026155522945266033
STAT,1941,19,20-24,1960,140.89031156939944
SIM,1839,31,25-29,1870,15
STAT,1905,24,35-39,1929,8.467025648978314
STAT,1886,75,na,1961,1291.1037346465966
STAT,1870,91,na,1961,112.21069861095357
STAT,1810,48,40-44,1858,0.6489246768926433
STAT,1865,32,35-39,1897,9.339747415804993
SIM,1805,93,na,1898,14
SIM,1916,34,25-29,1950,15
STAT,1927,40,20-24,1967,0.02244883313250356
SIM,1934,29,30-34,1963,75
STAT,1901,32,15-19,1933,0.20162896445880008
STAT,1815,63,na,1878,929.285421671364
SIM,1885,19,30-34,1904,5
STAT,1887,32,20-24,1919,3.0480932388780224
STAT,1926,29,30-34,1955,47.13239395032288
STAT,1927,16,35-39,1943,5.286415958026423
SIM,1895,32,20-24,1927,5
STAT,1866,33,35-39,1899,9.431193688764306
SIM,1838,30,25-29,1868,4
STAT,1883,31,50-100,1914,0.9092916566450727
SIM,1813,71,na,1884,628
STAT,1843,54,30-34,1897,0.0039043984732187293
SIM,1919,25,45-49,1944,1
SIM,1913,24,35-39,1937,14
STAT,1967,3,na,1970,4961.784335534083
SIM,1935,16,35-39,1951,9
SIM,1853,77,na,1930,565
SIM,1926,17,50-100,1943,1
STAT,1867,30,45-49,1897,1.6720952642917746
STAT,1862,93,na,1955,25.490981736070296
STAT,1826,29,25-29,1855,76.76658894650092
SIM,1848,43,35-39,1891,2
SIM,1927,19,45-49,1946,4
SIM,1944,16,40-44,1960,4
SIM,1848,41,40-44,1889,7
STAT,1853,54,20-24,1907,5.93460761023106E-4
STAT,1813,52,25-29,1865,0.009794719821495573
SIM,1851,76,na,1927,767
SIM,1877,81,na,1958,673
STAT,1834,100,na,1934,0.6319213957779853
STAT,1948,15,20-24,1963,156.81733052338686
SIM,1860,26,30-34,1886,7
SIM,1839,42,na,1881,1603
STAT,1944,24,20-24,1968,121.15261906233782
STAT,1835,29,35-39,1864,9.307031501258816
SIM,1876,35,25-29,1911,4
SIM,1896,38,45-49,1934,2
STAT,1843,28,15-19,1871,0.3738932118190498
SIM,1860,9,na,1869,2484
STAT,1831,52,45-49,1883,0.0095367008942978
STAT,1927,25,30-34,1952,48.473228369590146
SIM,1804,74,na,1878,518
SIM,1815,41,45-49,1856,3
STAT,1836,38,50-100,1874,0.9408523735872999
SIM,1893,32,20-24,1925,5
STAT,1878,19,45-49,1897,0.06812040658158043
STAT,1815,40,25-29,1855,1.7841413010331242
STAT,1845,23,20-24,1868,62.06166852053353
STAT,1846,55,na,1901,1569.1565678338682
STAT,1911,15,25-29,1926,8.789429085406413
STAT,1852,26,30-34,1878,22.40480232548678
STAT,1857,47,15-19,1904,3.138275336041817E-4
STAT,1816,59,na,1875,1227.6747844749418
STAT,1792,104,na,1896,0.011990533526992855
STAT,1868,35,25-29,1903,2.805657751524189
STAT,1888,38,45-49,1926,2.364671553947233
STAT,1820,48,30-34,1868,0.16215306420034525
STAT,1831,36,40-44,1867,3.537724223951343
STAT,1877,47,na,1924,2334.3526407598215
SIM,1884,20,45-49,1904,4
SIM,1800,84,na,1884,186
STAT,1882,31,25-29,1913,10.061778458101566
STAT,1942,27,20-24,1969,19.343597911621217
STAT,1871,54,40-44,1925,0.010273203626274678
SIM,1834,29,25-29,1863,48
SIM,1926,40,50-100,1966,2
STAT,1865,107,na,1972,0.07903289355694111
STAT,1843,35,20-24,1878,0.6196887331114935
STAT,1859,42,20-24,1901,0.12885064387283335
STAT,1902,24,15-19,1926,4.679088781961181
SIM,1830,29,na,1859,1648
SIM,1890,31,25-29,1921,20
STAT,1931,27,45-49,1958,2.2541744773679446
STAT,1939,30,na,1969,3900.0888711598095
SIM,1882,32,45-49,1914,3
STAT,1833,24,40-44,1857,1.9606574080172678
STAT,1850,36,50-100,1886,0.9649545757681643
STAT,1916,37,20-24,1953,0.27242604178276586
SIM,1939,18,25-29,1957,72
SIM,1851,26,20-24,1877,17
SIM,1884,69,na,1953,1563
SIM,1797,87,na,1884,55
SIM,1823,40,25-29,1863,1
SIM,1935,25,30-34,1960,78
SIM,1864,36,45-49,1900,5
STAT,1942,28,na,1970,3967.871969807
STAT,1801,71,na,1872,658.8117405285707
STAT,1843,26,20-24,1869,9.808149507079502
STAT,1900,36,15-19,1936,0.017086999675878713
STAT,1850,48,50-100,1898,0.18569634101182445
STAT,1835,91,na,1926,43.49260582933429
SIM,1837,49,50-100,1886,3
SIM,1895,22,15-19,1917,3
SIM,1956,15,20-24,1971,160
STAT,1820,64,na,1884,893.2593691402469
STAT,1851,20,40-44,1871,1.9115942261418166
SIM,1915,34,50-100,1949,1
SIM,1857,67,na,1924,1368
SIM,1857,34,45-49,1891,3
SIM,1918,28,35-39,1946,2
SIM,1841,24,40-44,1865,5
STAT,1874,32,45-49,1906,1.8034427617783475
STAT,1837,17,35-39,1854,0.7408008179708171
SIM,1791,82,na,1873,80
SIM,1922,18,15-19,1940,60
STAT,1915,26,na,1941,3868.8180666166354
STAT,1834,23,45-49,1857,0.5514922114820864
SIM,1811,49,40-44,1860,2
STAT,1839,30,50-100,1869,0.8161745089318242
SIM,1836,85,na,1921,177
STAT,1816,47,50-100,1863,0.6350951290714488
STAT,1937,15,45-49,1952,0.4928884428352282
STAT,1927,31,na,1958,4705.0939418816415
SIM,1905,50,na,1955,3321
SIM,1799,88,na,1887,46
SIM,1860,43,50-100,1903,2
SIM,1886,38,50-100,1924,2
SIM,1880,28,40-44,1908,5
STAT,1876,54,50-100,1930,0.015316686733049773
SIM,1907,51,na,1958,3471
STAT,1914,18,15-19,1932,9.447044028426316
SIM,1872,33,30-34,1905,8
SIM,1909,32,na,1941,3885
STAT,1893,29,25-29,1922,53.86136823692248
SIM,1879,17,na,1896,2943
SIM,1938,19,20-24,1957,1
STAT,1857,40,30-34,1897,0.9153635474830366
STAT,1872,37,40-44,1909,4.445007786459841
SIM,1882,25,40-44,1907,5
STAT,1770,104,na,1874,0.016977748691824248
STAT,1833,31,45-49,1864,1.6109197166358633
STAT,1851,22,35-39,1873,5.27661562372686
STAT,1861,19,35-39,1880,0.5230982864097616
STAT,1796,85,na,1881,85.87172333080038
STAT,1841,46,na,1887,1711.88319775147
SIM,1941,24,45-49,1965,4
STAT,1826,38,25-29,1864,3.234604024989931
STAT,1864,29,na,1893,2159.5012077372808
STAT,1801,53,45-49,1854,0.05366503890253564
STAT,1861,24,15-19,1885,2.8038010279774155
STAT,1933,24,45-49,1957,1.507153420258443
SIM,1839,18,20-24,1857,19
STAT,1950,21,40-44,1971,4.031301933305398
STAT,1847,46,45-49,1893,0.17720362826179925
SIM,1834,38,25-29,1872,3
STAT,1914,49,20-24,1963,0.010993283683913837
SIM,1855,37,45-49,1892,2
STAT,1943,26,25-29,1969,70.81245954744547
SIM,1783,87,na,1870,83
STAT,1898,41,30-34,1939,0.1098058284534764
STAT,1945,23,25-29,1968,102.20392788154489
SIM,1820,84,na,1904,155
SIM,1889,42,40-44,1931,5
SIM,1835,34,25-29,1869,14
SIM,1917,36,35-39,1953,10
STAT,1872,28,40-44,1900,3.0310511628885894
STAT,1862,6,na,1868,2492.1523396412713
STAT,1879,47,35-39,1926,0.14687204322908878
STAT,1833,82,na,1915,330.1050908184705
STAT,1905,37,45-49,1942,0.628245389305193
STAT,1919,19,45-49,1938,0.5543868648024551
STAT,1936,16,40-44,1952,1.355258517790638
STAT,1884,27,20-24,1911,11.684466861481711
SIM,1853,23,20-24,1876,67
SIM,1872,9,na,1881,2937
STAT,1920,15,35-39,1935,0.9582480554922275
SIM,1893,0,na,1893,3568
SIM,1874,30,30-34,1904,28
STAT,1880,43,25-29,1923,0.676222283559155
STAT,1845,16,50-100,1861,0.045513217958030344
STAT,1813,110,na,1923,1.21162889630378E-4
STAT,1910,41,25-29,1951,0.06848121538706393
SIM,1826,75,na,1901,786
STAT,1898,0,na,1898,4020.4576813459353
SIM,1841,31,45-49,1872,1
SIM,1942,28,40-44,1970,9
STAT,1865,50,35-39,1915,0.008053854152051631
STAT,1934,28,40-44,1962,6.332593558296534
SIM,1844,49,na,1893,1473
SIM,1888,53,na,1941,2715
STAT,1866,83,na,1949,371.27516848057326
SIM,1919,24,35-39,1943,15
STAT,1842,52,20-24,1894,6.608376516349461E-4
STAT,1862,47,25-29,1909,0.05000566807562753
SIM,1880,37,40-44,1917,7
STAT,1812,53,20-24,1865,0.001596700221929246
STAT,1892,46,25-29,1938,0.04129558024876769
STAT,1894,25,25-29,1919,55.37921263753713
STAT,1899,70,na,1969,2301.797017852072
SIM,1932,38,25-29,1970,2
STAT,1934,35,15-19,1969,0.026822774727015036
STAT,1874,19,na,1893,2597.948191384724
STAT,1825,30,40-44,1855,13.855527734614046
STAT,1902,17,40-44,1919,0.261050229183188
SIM,1894,24,20-24,1918,133
STAT,1813,82,na,1895,204.57721248005186
STAT,1833,37,na,1870,1894.1672319674474
SIM,1799,82,na,1881,206
STAT,1871,38,35-39,1909,7.061938809142524
STAT,1943,21,50-100,1964,0.7070999015609418
SIM,1915,31,40-44,1946,4
SIM,1873,39,20-24,1912,1
STAT,1868,23,50-100,1891,0.392420023414494
STAT,1917,35,15-19,1952,0.020324376586384883
STAT,1839,45,40-44,1884,0.12687631569332863
STAT,1825,32,35-39,1857,24.016085135637937
STAT,1926,33,30-34,1959,19.2419340837191
STAT,1861,30,50-100,1891,0.7751678993585981
STAT,1934,20,45-49,1954,1.5328636014084827
SIM,1837,61,na,1898,1151
STAT,1809,77,na,1886,410.01155602527274
STAT,1837,72,na,1909,861.5211136148286
SIM,1877,24,20-24,1901,2
SIM,1827,33,20-24,1860,1
STAT,1875,66,na,1941,1700.0099827182758
STAT,1889,43,45-49,1932,1.850442539460151
STAT,1947,2,na,1949,4585.5864978456375
STAT,1876,42,50-100,1918,1.1003570051102283
SIM,1919,2,na,1921,4445
SIM,1934,33,30-34,1967,43
SIM,1806,55,na,1861,1236
STAT,1892,21,40-44,1913,2.648949290643251
STAT,1850,24,50-100,1874,0.3694172199684156
STAT,1910,19,25-29,1929,8.616762590929811
SIM,1860,59,na,1919,1741
STAT,1867,39,25-29,1906,2.711191122197362
SIM,1837,22,25-29,1859,52
STAT,1844,74,na,1918,878.0471840573915
STAT,1890,23,30-34,1913,21.915293952246607
SIM,1965,6,na,1971,5215
SIM,1926,34,20-24,1960,3
STAT,1892,23,35-39,1915,7.372913074789801
SIM,1864,37,50-100,1901,1
SIM,1874,39,na,1913,2271
STAT,1810,44,25-29,1854,2.5966435837010624
STAT,1844,34,25-29,1878,9.491597804862701
STAT,1902,53,na,1955,3023.870706449027
SIM,1942,2,na,1944,4472
SIM,1842,23,45-49,1865,3
SIM,1877,48,50-100,1925,1
SIM,1833,30,40-44,1863,4
SIM,1861,52,na,1913,1839
STAT,1865,39,20-24,1904,0.7037649196680946
STAT,1928,23,25-29,1951,116.20885579492176
STAT,1907,31,40-44,1938,3.7085429008228865
STAT,1920,48,35-39,1968,0.14352188564059767
STAT,1849,49,15-19,1898,3.0621110297831216E-4
SIM,1936,24,35-39,1960,19
STAT,1835,110,na,1945,2.0740494045820232E-4
STAT,1851,49,50-100,1900,0.18208250774938317
STAT,1849,34,45-49,1883,1.4071676287719632
STAT,1879,54,40-44,1933,0.010791004155008273
SIM,1852,24,15-19,1876,2
STAT,1924,31,40-44,1955,4.616244549445316
SIM,1856,35,40-44,1891,7
SIM,1944,27,50-100,1971,1
SIM,1949,15,na,1964,3989
STAT,1879,28,na,1907,2506.5408812693495
STAT,1903,22,50-100,1925,0.5865711321053872
STAT,1768,110,na,1878,0.0034658075209697244
SIM,1863,37,40-44,1900,10
SIM,1897,43,45-49,1940,1
STAT,1818,109,na,1927,3.6654889684206124E-4
SIM,1898,17,15-19,1915,10
STAT,1816,109,na,1925,3.6375019450335963E-4
SIM,1883,21,40-44,1904,3
STAT,1851,22,na,1873,1933.3590909591287
STAT,1821,47,35-39,1868,0.20519454655440483
STAT,1854,5,na,1859,2257.464990386252
STAT,1886,24,20-24,1910,73.02775468797861
SIM,1886,15,30-34,1901,3
STAT,1948,13,na,1961,4540.427331195837
STAT,1824,74,na,1898,551.7322969835924
SIM,1861,24,25-29,1885,69
SIM,1936,23,25-29,1959,104
STAT,1928,24,35-39,1952,11.808381027313336
SIM,1837,23,35-39,1860,9
STAT,1915,20,na,1935,3842.415917289813
STAT,1864,74,na,1938,1011.4470731140111
STAT,1844,24,15-19,1868,3.212294358910608
STAT,1865,36,50-100,1901,1.1377429218462867
STAT,1872,53,45-49,1925,0.014499602700120202
STAT,1911,16,na,1927,3908.8237877011475
SIM,1932,31,40-44,1963,11
STAT,1861,46,na,1907,1893.6077119398076
SIM,1836,24,30-34,1860,31
STAT,1953,15,30-34,1968,14.905038821982366
STAT,1870,24,25-29,1894,56.42009988353991
SIM,1902,25,35-39,1927,15
SIM,1837,47,na,1884,1421
STAT,1834,21,50-100,1855,0.32830895998001103
STAT,1838,46,35-39,1884,0.09766164709324578
STAT,1855,53,45-49,1908,0.010748403269264638
STAT,1895,15,30-34,1910,2.1120228063298456
STAT,1827,53,50-100,1880,0.014662369868429337
STAT,1853,24,25-29,1877,55.13477678959718
SIM,1919,28,50-100,1947,1
STAT,1918,34,20-24,1952,2.594352914216805
STAT,1808,51,50-100,1859,0.05219130214784156
STAT,1904,68,na,1972,2612.783807343208
STAT,1880,29,45-49,1909,1.169292861627129
STAT,1908,38,40-44,1946,1.4078215519652921
STAT,1871,16,25-29,1887,5.756762979316564
STAT,1908,30,45-49,1938,1.5114320914525814
SIM,1906,41,40-44,1947,3
SIM,1916,38,40-44,1954,2
SIM,1955,15,na,1970,4676
SIM,1892,44,na,1936,3129
STAT,1840,50,30-34,1890,0.004232626651069349
STAT,1943,25,15-19,1968,0.7598158981992951
STAT,1885,32,20-24,1917,2.7174869282822267
STAT,1923,32,35-39,1955,10.585087659119626
SIM,1861,15,25-29,1876,8
SIM,1901,19,25-29,1920,10
STAT,1919,33,25-29,1952,10.025742288293694
SIM,1871,96,na,1967,16
STAT,1891,40,35-39,1931,2.2872315828239445
SIM,1882,68,na,1950,1211
SIM,1931,32,35-39,1963,2
STAT,1885,25,15-19,1910,0.4592187761250757
SIM,1901,26,30-34,1927,35
STAT,1794,84,na,1878,112.91269512923031
SIM,1847,8,na,1855,2341
STAT,1818,41,20-24,1859,0.32247252174861096
SIM,1856,42,45-49,1898,1
SIM,1868,34,20-24,1902,3
SIM,1828,32,25-29,1860,3
SIM,1780,90,na,1870,2
SIM,1912,38,na,1950,3537
STAT,1899,47,20-24,1946,0.00933911800263084
SIM,1787,77,na,1864,323
SIM,1939,15,20-24,1954,201
STAT,1850,24,40-44,1874,1.8877218566996763
SIM,1776,85,na,1861,33
SIM,1901,66,na,1967,2510
STAT,1903,48,35-39,1951,0.11216657080611354
SIM,1817,39,35-39,1856,9
STAT,1889,36,40-44,1925,5.477955993218153
SIM,1911,20,15-19,1931,6
STAT,1810,54,na,1864,1355.1533998710834
STAT,1870,20,50-100,1890,0.4068548626153133
STAT,1868,29,30-34,1897,24.134125169074
STAT,1849,16,15-19,1865,5.745243961290297
STAT,1823,32,30-34,1855,46.71232418464888
STAT,1925,36,na,1961,4567.558096740551
STAT,1862,48,35-39,1910,0.12057651562568222
STAT,1892,38,na,1930,2971.1062859624685
STAT,1895,66,na,1961,2313.9546401503185
STAT,1847,17,na,1864,2145.0852219417534
STAT,1861,49,30-34,1910,0.07954603786418091
SIM,1878,23,25-29,1901,103
STAT,1774,84,na,1858,66.49207096855261
STAT,1835,34,15-19,1869,0.1333320235362944
SIM,1916,30,45-49,1946,3
STAT,1858,39,15-19,1897,0.04404828765064836
SIM,1857,16,15-19,1873,9
SIM,1831,32,30-34,1863,6
STAT,1911,36,na,1947,3683.705832957685
SIM,1811,56,na,1867,1294
SIM,1833,32,35-39,1865,20
SIM,1815,48,50-100,1863,3
STAT,1899,38,20-24,1937,0.22948535587673022
SIM,1927,33,25-29,1960,1
STAT,1838,53,40-44,1891,0.006934332351066043
SIM,1874,31,40-44,1905,5
STAT,1856,22,50-100,1878,0.36673845429662055
STAT,1903,20,15-19,1923,4.773673432160837
SIM,1862,68,na,1930,1321
STAT,1869,28,35-39,1897,9.441495738479448
STAT,1824,54,na,1878,1147.6580437801458
STAT,1888,7,na,1895,3105.8755392183484
STAT,1948,17,15-19,1965,52.466118868338505
SIM,1897,36,40-44,1933,9
SIM,1893,35,25-29,1928,3
STAT,1831,56,na,1887,1296.034140358896
STAT,1895,32,na,1927,3147.456876836706
STAT,1905,28,15-19,1933,0.6601177137867531
STAT,1831,39,45-49,1870,1.559012230538291
SIM,1911,23,20-24,1934,121
STAT,1881,43,45-49,1924,1.4465515788253283
STAT,1916,45,50-100,1961,0.23521665614954754
SIM,1879,38,45-49,1917,1
STAT,1837,18,45-49,1855,0.07138057368508843
STAT,1856,41,25-29,1897,0.4995018433449598
SIM,1933,30,45-49,1963,2
STAT,1952,16,25-29,1968,52.48350637679557
STAT,1839,15,45-49,1854,0.06130269028118717
STAT,1849,97,na,1946,4.200303175098816
SIM,1838,31,50-100,1869,1
SIM,1820,39,na,1859,1493
STAT,1824,38,20-24,1862,1.0405636765549888
STAT,1888,44,40-44,1932,2.645194300722819
STAT,1929,16,35-39,1945,5.42597552326489
STAT,1848,42,45-49,1890,1.2204401030155125
STAT,1843,29,25-29,1872,34.610019377297604
STAT,1893,17,20-24,1910,22.735804013233967
STAT,1891,29,20-24,1920,14.565075293848318
STAT,1851,56,na,1907,1544.385980058617
STAT,1860,35,20-24,1895,0.6424775974226357
STAT,1889,19,20-24,1908,21.960604864870557
SIM,1855,80,na,1935,642
SIM,1872,36,35-39,1908,7
SIM,1896,44,40-44,1940,4
SIM,1937,16,35-39,1953,10
STAT,1894,19,30-34,1913,2.061450069591838
SIM,1851,29,25-29,1880,39
SIM,1819,42,na,1861,1535
STAT,1953,18,35-39,1971,5.1268824535716675
STAT,1863,43,25-29,1906,0.5705085446286772
STAT,1879,44,30-34,1923,1.195393762441464
STAT,1842,93,na,1935,26.31263719944347
STAT,1887,37,na,1924,2656.7081073526097
SIM,1820,39,40-44,1859,5
STAT,1839,22,na,1861,1947.7190678905324
SIM,1874,33,35-39,1907,15
SIM,1887,44,30-34,1931,2
SIM,1853,26,25-29,1879,59
SIM,1908,13,na,1921,3767
STAT,1866,55,na,1921,1933.7930766751983
STAT,1885,35,25-29,1920,2.9220555799926746
SIM,1901,29,35-39,1930,20
SIM,1935,15,na,1950,5036
STAT,1903,15,35-39,1918,0.7929375740799136
SIM,1900,27,25-29,1927,67
STAT,1847,31,na,1878,1925.145965196542
STAT,1911,25,35-39,1936,14.871670281250646
STAT,1897,37,45-49,1934,2.6992982183009615
STAT,1925,30,45-49,1955,1.8905839017561787
SIM,1811,76,na,1887,482
SIM,1897,19,20-24,1916,21
STAT,1881,51,30-34,1932,0.005822924381593435
STAT,1908,37,30-34,1945,1.722556362886811
STAT,1818,44,25-29,1862,1.1803086075018343
STAT,1901,26,20-24,1927,16.66706394574698
SIM,1876,29,30-34,1905,3
STAT,1845,26,25-29,1871,37.89391670103791
STAT,1870,39,30-34,1909,5.232613229245353
SIM,1880,4,na,1884,2672
STAT,1848,18,20-24,1866,17.837734910083938
STAT,1883,22,45-49,1905,0.6892126531269318
SIM,1941,21,40-44,1962,4
STAT,1898,44,35-39,1942,0.16984936253322003
STAT,1935,34,20-24,1969,3.4050402011914116
SIM,1914,32,35-39,1946,15
SIM,1918,43,na,1961,4191
SIM,1842,21,50-100,1863,1
SIM,1854,38,40-44,1892,5
SIM,1918,23,na,1941,4047
STAT,1876,7,na,1883,2808.7089911284284
SIM,1835,38,na,1873,1604
STAT,1803,52,na,1855,1417.3880250708849
STAT,1868,103,na,1971,1.470537563864559
SIM,1916,42,na,1958,3788
STAT,1926,26,25-29,1952,80.01822730451181
SIM,1849,9,na,1858,2464
STAT,1825,52,20-24,1877,9.548651591373962E-4
STAT,1921,20,50-100,1941,0.7550907042032535
STAT,1934,0,na,1934,6157.200226438606
STAT,1908,45,15-19,1953,3.4123801052230666E-4
STAT,1912,39,45-49,1951,0.6645309986871036
SIM,1893,20,na,1913,3133
STAT,1916,33,50-100,1949,0.85779495373099
SIM,1839,20,35-39,1859,6
STAT,1893,26,20-24,1919,15.096529864197958
STAT,1918,31,15-19,1949,0.13842432422464176
STAT,1910,47,50-100,1957,0.21290588302428362
SIM,1875,37,30-34,1912,5
STAT,1858,37,20-24,1895,0.6108103158139319
SIM,1824,31,45-49,1855,2
STAT,1838,43,30-34,1881,0.8086189173361713
STAT,1832,32,40-44,1864,3.860021315757055
SIM,1900,23,45-49,1923,1
STAT,1805,49,45-49,1854,0.984554054644442
STAT,1892,43,20-24,1935,0.19982235607927248
SIM,1918,25,30-34,1943,45
STAT,1822,42,25-29,1864,1.0216591378199302
SIM,1943,10,na,1953,4220
SIM,1914,33,na,1947,4014
STAT,1918,35,30-34,1953,1.9578385988935358
STAT,1903,23,20-24,1926,98.8183499554936
STAT,1842,73,na,1915,1069.3749797393941
SIM,1883,28,25-29,1911,3
SIM,1848,40,30-34,1888,2
SIM,1891,22,45-49,1913,3
STAT,1826,35,20-24,1861,0.9382814845057009
STAT,1819,36,25-29,1855,9.31529343039317
SIM,1877,25,30-34,1902,33
SIM,1840,32,40-44,1872,5
SIM,1826,54,50-100,1880,1
SIM,1917,33,30-34,1950,4
STAT,1814,52,45-49,1866,0.03342394169318497
STAT,1948,18,25-29,1966,50.08232636178231
SIM,1929,32,na,1961,4663
STAT,1855,46,na,1901,1698.3102126241822
SIM,1852,34,25-29,1886,20
STAT,1857,92,na,1949,32.82991429585582
STAT,1898,48,15-19,1946,3.050570213581914E-4
STAT,1909,44,50-100,1953,0.10952107437774097
SIM,1871,7,na,1878,2653
STAT,1846,47,40-44,1893,0.1293153930669491
STAT,1878,32,15-19,1910,0.1493080052586982
STAT,1817,39,25-29,1856,8.405848303017846
SIM,1825,39,25-29,1864,3
STAT,1868,64,na,1932,1678.0215097320204
STAT,1876,20,45-49,1896,0.7315357513732301
STAT,1887,49,50-100,1936,0.15296096396078915
STAT,1941,31,40-44,1972,4.150509791237072
STAT,1842,54,45-49,1896,0.01270672328792753
SIM,1861,18,30-34,1879,3
SIM,1901,12,na,1913,3758
SIM,1888,20,15-19,1908,4
STAT,1863,8,na,1871,2507.5928996767393
SIM,1867,100,na,1967,3
STAT,1834,45,20-24,1879,0.008544832817791385
STAT,1817,48,25-29,1865,0.12190386458906652
STAT,1844,31,20-24,1875,2.5841230988932393
STAT,1848,50,30-34,1898,0.004929849697394331
STAT,1882,14,na,1896,2518.4119795890933
SIM,1948,23,15-19,1971,7
STAT,1846,38,40-44,1884,3.4332867579257638
STAT,1846,22,50-100,1868,0.38183826477105154
STAT,1931,18,15-19,1949,59.87755414589446
STAT,1933,21,40-44,1954,4.520503463999295
STAT,1878,16,40-44,1894,0.19223656390932087
STAT,1924,38,25-29,1962,1.1720443207140316
SIM,1909,38,35-39,1947,5
SIM,1936,21,30-34,1957,39
STAT,1822,73,na,1895,664.1005310069979
STAT,1887,39,40-44,1926,4.886591911988549
STAT,1932,15,50-100,1947,0.5036776716595526
STAT,1853,18,30-34,1871,1.5762405735772345
STAT,1892,20,30-34,1912,22.709611742583377
SIM,1831,35,35-39,1866,13
SIM,1909,18,na,1927,4120
STAT,1907,34,45-49,1941,1.472444809552299
SIM,1922,42,na,1964,4802
STAT,1830,53,40-44,1883,0.007592096488979164
SIM,1827,36,25-29,1863,2
STAT,1811,81,na,1892,235.74230485310233
STAT,1779,93,na,1872,7.815725656924317
STAT,1863,22,25-29,1885,52.24944102785511
STAT,1876,19,50-100,1895,0.050816845264951525
STAT,1867,36,20-24,1903,0.7367775258694825
STAT,1886,27,25-29,1913,45.109939092871954
STAT,1930,34,35-39,1964,11.904514223538401
SIM,1817,92,na,1909,3
SIM,1878,30,50-100,1908,6
SIM,1802,65,na,1867,918
STAT,1926,36,35-39,1962,2.9902724320239944
SIM,1820,50,na,1870,1349
STAT,1867,37,30-34,1904,5.06961123157133
STAT,1951,20,45-49,1971,1.3591261352130939
STAT,1839,48,45-49,1887,0.16830484687251956
STAT,1866,31,40-44,1897,4.072413248017272
STAT,1917,21,na,1938,3929.452396460913
SIM,1823,35,45-49,1858,3
SIM,1871,22,25-29,1893,67
SIM,1934,26,25-29,1960,7
SIM,1890,26,45-49,1916,5
STAT,1928,21,30-34,1949,36.380600249219384
SIM,1936,20,20-24,1956,171
SIM,1894,27,25-29,1921,68
STAT,1823,35,35-39,1858,13.393280689761161
STAT,1837,41,na,1878,1714.2351622341275
STAT,1936,30,20-24,1966,2.3945670655861435
STAT,1873,33,40-44,1906,4.421667012342244
SIM,1864,63,na,1927,1972
STAT,1840,42,45-49,1882,1.094391674856046
SIM,1895,39,40-44,1934,3
SIM,1899,30,35-39,1929,26
STAT,1821,46,25-29,1867,0.08565424973424221
SIM,1871,11,na,1882,2584
STAT,1891,76,na,1967,1558.6146365543404
STAT,1839,20,25-29,1859,52.90464753556109
SIM,1926,26,35-39,1952,32
SIM,1949,15,15-19,1964,72
SIM,1859,48,na,1907,2083
SIM,1899,17,na,1916,3847
STAT,1854,39,45-49,1893,1.481027556158466
SIM,1902,28,na,1930,3762
STAT,1882,26,45-49,1908,1.0899901239857341
STAT,1841,30,25-29,1871,9.488359906020023
STAT,1842,36,15-19,1878,0.05992728327330139
STAT,1875,24,45-49,1899,0.7187463071035565
STAT,1877,25,25-29,1902,44.395149187307794
STAT,1897,28,45-49,1925,1.4981236908053912
STAT,1958,0,na,1958,5254.792060118183
STAT,1874,64,na,1938,1797.7921780844747
STAT,1899,40,35-39,1939,0.176062705734949
SIM,1875,27,20-24,1902,19
STAT,1916,47,30-34,1963,0.09227325197818989
STAT,1947,21,35-39,1968,10.75279647389919
SIM,1857,61,na,1918,1601
SIM,1897,32,50-100,1929,5
SIM,1813,57,na,1870,1134
SIM,1838,37,45-49,1875,2
SIM,1885,25,25-29,1910,56
STAT,1890,35,50-100,1925,1.5296223686075314
SIM,1864,94,na,1958,17
STAT,1889,32,50-100,1921,1.1410868914559353
SIM,1934,36,35-39,1970,10
STAT,1839,49,20-24,1888,0.008448932159885063
STAT,1857,17,50-100,1874,0.04538895522526772
STAT,1863,107,na,1970,0.059619126064256615
STAT,1863,21,15-19,1884,3.0328742950787126
SIM,1814,42,40-44,1856,10
STAT,1890,26,35-39,1916,11.9491957718156
STAT,1852,111,na,1963,2.971332498599926E-4
STAT,1910,22,15-19,1932,5.0435055656986485
SIM,1915,34,45-49,1949,5
SIM,1828,56,na,1884,1236
STAT,1831,27,40-44,1858,2.6093101219778605
STAT,1883,37,15-19,1920,0.05550155913491829
STAT,1887,20,20-24,1907,78.17255001345754
SIM,1829,41,50-100,1870,2
STAT,1853,28,40-44,1881,2.592763926280411
SIM,1935,28,35-39,1963,2
STAT,1872,50,40-44,1922,0.010843614911590891
STAT,1898,31,50-100,1929,1.259658254010953
SIM,1929,21,25-29,1950,126
STAT,1904,44,35-39,1948,0.1797993598124027
STAT,1817,38,15-19,1855,0.1866160935681145
SIM,1851,38,25-29,1889,7
STAT,1850,28,20-24,1878,10.495217623784393
SIM,1839,28,na,1867,1792
SIM,1925,25,na,1950,4453
SIM,1884,49,na,1933,2284
STAT,1924,37,15-19,1961,0.0228821342012224
STAT,1943,29,30-34,1972,42.09375605319609
STAT,1847,21,30-34,1868,16.467751853621152
STAT,1870,21,20-24,1891,68.55294556638441
STAT,1928,20,20-24,1948,141.16355544673013
STAT,1843,38,25-29,1881,2.041683267049369
STAT,1835,19,25-29,1854,12.146899037342834
SIM,1918,26,40-44,1944,9
STAT,1814,44,na,1858,1474.954298684525
STAT,1884,29,15-19,1913,0.4486557523621552
SIM,1809,66,na,1875,782
SIM,1855,21,30-34,1876,33
SIM,1902,22,30-34,1924,37
STAT,1933,17,na,1950,4979.035861228492
STAT,1859,45,25-29,1904,0.04725701024960747
SIM,1875,86,na,1961,234
SIM,1834,36,30-34,1870,10
STAT,1796,65,na,1861,768.9675078046471
STAT,1875,46,20-24,1921,0.012481948547734269
STAT,1874,6,na,1880,2825.4486769234295
SIM,1861,28,40-44,1889,3
SIM,1827,71,na,1898,725
SIM,1889,41,30-34,1930,2
STAT,1864,36,35-39,1900,6.477195684188917
STAT,1918,26,35-39,1944,16.186040101777913
SIM,1886,18,35-39,1904,2
STAT,1827,28,30-34,1855,50.55195288913191
STAT,1844,49,30-34,1893,0.07498756014200035
SIM,1873,77,na,1950,749
SIM,1843,19,25-29,1862,4
STAT,1887,48,40-44,1935,0.19062726860351584
STAT,1935,26,na,1961,5161.590098283698
SIM,1872,92,na,1964,42
STAT,1897,42,25-29,1939,0.060306801278795896
STAT,1927,28,35-39,1955,18.38335103178527
SIM,1868,37,25-29,1905,4
SIM,1886,10,na,1896,2922
SIM,1895,20,20-24,1915,107
STAT,1837,31,15-19,1868,0.12308045394875218
SIM,1867,77,na,1944,735
STAT,1816,46,15-19,1862,0.001049919738916399
STAT,1934,27,30-34,1961,53.25986097382921
SIM,1858,30,45-49,1888,2
STAT,1838,26,na,1864,1855.4374890300485
STAT,1764,94,na,1858,2.10672479744687
STAT,1853,3,na,1856,2810.63124248
SIM,1835,28,30-34,1863,30
SIM,1942,27,30-34,1969,4
STAT,1853,19,40-44,1872,0.1798146894009246
STAT,1841,16,45-49,1857,0.06337581877907474
STAT,1875,12,na,1887,2701.506717376857
STAT,1920,45,30-34,1965,0.09998013390376338
STAT,1944,21,15-19,1965,5.8057593481148855
STAT,1893,46,50-100,1939,0.17817240392433312
SIM,1873,20,na,1893,2479
STAT,1907,16,15-19,1923,8.8239096562538
STAT,1920,27,na,1947,4149.84951352949
SIM,1900,19,na,1919,3664
STAT,1826,36,30-34,1862,6.327219340273843
STAT,1841,25,45-49,1866,1.0462437783976664
STAT,1864,33,30-34,1897,15.845411502597596
STAT,1871,35,30-34,1906,5.398616333030185
SIM,1915,16,15-19,1931,9
SIM,1893,17,30-34,1910,4
STAT,1893,27,30-34,1920,32.294312716579206
SIM,1844,43,na,1887,1540
SIM,1860,87,na,1947,110
SIM,1865,11,na,1876,2491
STAT,1866,53,20-24,1919,6.790455282618331E-4
STAT,1894,19,na,1913,3266.5228326250763
STAT,1828,98,na,1926,2.1088137784126935
SIM,1908,28,40-44,1936,7
STAT,1917,39,30-34,1956,1.8992134101012033
SIM,1855,35,na,1890,2044
SIM,1893,74,na,1967,1814
SIM,1874,34,45-49,1908,4
SIM,1929,31,35-39,1960,20
STAT,1884,40,na,1924,2325.2110939471745
STAT,1841,22,40-44,1863,1.9740590629601655
SIM,1867,32,45-49,1899,2
SIM,1830,28,45-49,1858,1
SIM,1851,45,na,1896,1813
SIM,1932,16,15-19,1948,67
STAT,1892,45,45-49,1937,0.17040019592957237
STAT,1897,20,15-19,1917,4.4937256185087575
STAT,1938,29,20-24,1967,18.238610335093316
STAT,1924,16,15-19,1940,54.7460042915505
STAT,1903,24,30-34,1927,25.461029702704685
STAT,1818,38,30-34,1856,12.258047728592942
STAT,1906,39,20-24,1945,0.24230017262748565
STAT,1878,23,na,1901,2471.984389829288
SIM,1869,1,na,1870,3173
STAT,1866,34,45-49,1900,1.616916376527426
SIM,1857,4,na,1861,2664
STAT,1839,41,25-29,1880,0.534091945948903
SIM,1845,90,na,1935,58
SIM,1863,28,40-44,1891,7
SIM,1891,33,35-39,1924,19
SIM,1927,37,na,1964,5139
SIM,1943,16,25-29,1959,53
STAT,1825,54,45-49,1879,0.01804732560946693
STAT,1921,29,45-49,1950,1.930743866131877
STAT,1820,95,na,1915,6.76772523787114
STAT,1935,16,25-29,1951,60.00106089974434
SIM,1824,42,35-39,1866,4
STAT,1837,53,25-29,1890,0.0023776319207183924
STAT,1927,42,15-19,1969,0.0019466690493788225
STAT,1829,38,40-44,1867,3.527898915751094
SIM,1925,39,30-34,1964,2
STAT,1901,29,25-29,1930,59.464716506749696
STAT,1830,34,30-34,1864,16.22261861190561
SIM,1840,22,30-34,1862,19
STAT,1949,17,30-34,1966,14.321440594342683
SIM,1780,76,na,1856,454
STAT,1863,26,50-100,1889,0.5765941185950657
STAT,1803,54,50-100,1857,0.06283694821930154
STAT,1860,17,25-29,1877,5.395927122717192
STAT,1829,49,50-100,1878,0.17852923243561641
SIM,1941,28,25-29,1969,81
STAT,1855,28,40-44,1883,2.333402340939818
STAT,1833,49,20-24,1882,0.008853438346472208
STAT,1859,32,45-49,1891,1.4165688045348641
STAT,1933,28,25-29,1961,88.2724123535477
STAT,1785,76,na,1861,361.6903625311474
SIM,1865,32,45-49,1897,1
STAT,1827,110,na,1937,1.643268511629324E-4
SIM,1844,15,25-29,1859,7
SIM,1879,44,40-44,1923,6
STAT,1800,95,na,1895,4.663885533857196
SIM,1862,82,na,1944,473
STAT,1881,40,40-44,1921,2.2119133080389144
STAT,1888,30,na,1918,2867.6157797892038
STAT,1923,17,45-49,1940,0.592674590703879
STAT,1828,41,15-19,1869,0.013412728197153735
STAT,1856,15,45-49,1871,0.06052103089639284
SIM,1852,28,30-34,1880,3
STAT,1920,41,na,1961,4148.109675005066
STAT,1844,28,30-34,1872,24.214634868538543
SIM,1847,20,25-29,1867,73
STAT,1920,23,20-24,1943,124.44743680960707
STAT,1824,37,45-49,1861,2.7802020469335567
STAT,1832,22,30-34,1854,27.26598698092341
STAT,1841,34,40-44,1875,3.8539263273486077
STAT,1922,28,15-19,1950,0.8041607414529476
SIM,1845,28,na,1873,2057
SIM,1798,86,na,1884,38
STAT,1895,32,15-19,1927,0.1878305060702547
SIM,1930,28,15-19,1958,1
STAT,1857,32,45-49,1889,1.3830441671348346
SIM,1847,30,50-100,1877,3
STAT,1887,25,50-100,1912,0.7262403814869717
STAT,1852,4,na,1856,2444.83977932
SIM,1848,7,na,1855,2313
STAT,1909,26,25-29,1935,64.23478890386252
SIM,1821,37,35-39,1858,8
STAT,1946,23,40-44,1969,3.777822248827531
SIM,1903,39,45-49,1942,3
SIM,1866,75,na,1941,999
STAT,1869,50,50-100,1919,0.01504339035088994
STAT,1877,92,na,1969,157.31687849882235
SIM,1919,49,50-100,1968,3
STAT,1851,38,15-19,1889,0.04253095312642491
SIM,1837,38,40-44,1875,1
SIM,1906,0,na,1906,3955
SIM,1829,43,30-34,1872,4
SIM,1874,70,na,1944,1303
SIM,1884,15,na,1899,2583
STAT,1820,92,na,1912,21.200479573514418
STAT,1921,22,25-29,1943,105.37091907135594
SIM,1896,22,30-34,1918,35
STAT,1801,54,25-29,1855,0.01283644417417508
SIM,1905,27,45-49,1932,2
STAT,1853,21,20-24,1874,67.82188186626253
SIM,1899,28,50-100,1927,2
SIM,1920,17,35-39,1937,4
STAT,1912,17,35-39,1929,0.8560573231258801
STAT,1880,28,35-39,1908,10.198693472283145
STAT,1869,42,15-19,1911,0.01354398400265795
STAT,1813,68,na,1881,792.8180149718747
SIM,1882,21,25-29,1903,62
STAT,1896,29,40-44,1925,3.9762095992011335
SIM,1876,82,na,1958,501
SIM,1861,21,20-24,1882,63
STAT,1856,27,45-49,1883,0.890907239297233
STAT,1867,15,20-24,1882,17.44472351134686
STAT,1873,26,35-39,1899,9.913534455100987
SIM,1857,1,na,1858,3041
STAT,1878,38,50-100,1916,1.280848084966616
SIM,1819,39,50-100,1858,1
SIM,1848,56,na,1904,1558
STAT,1869,49,35-39,1918,0.13460383256991945
SIM,1835,38,40-44,1873,4
STAT,1888,33,na,1921,2832.74443883292
STAT,1886,46,30-34,1932,0.10351992265627076
STAT,1894,29,40-44,1923,3.8673976922330655
STAT,1869,27,50-100,1896,0.6281513717851918
STAT,1906,15,na,1921,3732.690387542324
STAT,1871,17,35-39,1888,0.5541439380450079
STAT,1888,22,30-34,1910,21.23423079962683
SIM,1868,53,na,1921,1977
STAT,1808,61,na,1869,969.2554014444636
STAT,1874,29,20-24,1903,12.04583125850549
SIM,1863,21,20-24,1884,2
SIM,1884,17,20-24,1901,22
STAT,1916,22,na,1938,3861.6694685410025
STAT,1906,18,20-24,1924,26.012173324652597
SIM,1880,33,25-29,1913,24
SIM,1921,12,na,1933,4524
SIM,1896,34,30-34,1930,28
STAT,1926,18,40-44,1944,1.7286400111200826
STAT,1826,86,na,1912,121.74798450036218
SIM,1892,39,25-29,1931,5
STAT,1836,36,25-29,1872,2.2527069475988095
STAT,1970,2,na,1972,4974.656403307413
SIM,1823,32,40-44,1855,2
SIM,1922,24,40-44,1946,6
STAT,1886,52,na,1938,2283.9621046459424
STAT,1892,24,45-49,1916,0.8782382895362444
STAT,1907,62,na,1969,3008.3458074331497
STAT,1851,26,15-19,1877,0.4051442292736354
STAT,1825,33,45-49,1858,3.6846145184272583
STAT,1910,29,35-39,1939,14.522455525378934
SIM,1869,100,na,1969,1
SIM,1922,26,50-100,1948,1
STAT,1867,27,20-24,1894,11.159213667062186
SIM,1858,63,na,1921,1409
STAT,1882,23,40-44,1905,2.032389756034435
SIM,1883,30,na,1913,2696
SIM,1890,23,40-44,1913,2
STAT,1875,21,40-44,1896,2.167888308946074
SIM,1858,46,na,1904,1839
SIM,1897,21,35-39,1918,8
STAT,1832,26,50-100,1858,0.5940925958093302
STAT,1857,43,35-39,1900,1.4170527380283595
STAT,1888,34,30-34,1922,20.635732485709777
STAT,1855,21,20-24,1876,61.037465196731226
SIM,1882,29,20-24,1911,9
STAT,1909,33,30-34,1942,15.107455938998445
SIM,1833,33,45-49,1866,1
STAT,1872,33,25-29,1905,10.356664027589591
SIM,1914,18,20-24,1932,37
STAT,1783,98,na,1881,0.6129273835133814
STAT,1901,36,50-100,1937,0.37700451834989107
STAT,1838,24,25-29,1862,49.00711800542994
SIM,1865,43,35-39,1908,3
STAT,1889,21,35-39,1910,7.2894141300802975
STAT,1914,24,40-44,1938,3.444192483892558
STAT,1827,38,40-44,1865,4.973835664528132
STAT,1865,31,25-29,1896,9.484906893817763
STAT,1900,19,30-34,1919,2.2242242375563093
SIM,1829,31,30-34,1860,29
STAT,1884,39,25-29,1923,2.8388042175375223
STAT,1845,45,30-34,1890,0.07143556098094006
SIM,1876,39,40-44,1915,1
SIM,1899,28,20-24,1927,20
SIM,1881,23,30-34,1904,23
STAT,1842,32,35-39,1874,11.014467048941622
STAT,1880,67,na,1947,1681.45719471254
STAT,1870,18,30-34,1888,1.5864400087399992
STAT,1878,54,25-29,1932,0.00361151765562354
STAT,1917,20,45-49,1937,1.2142798504981658
SIM,1824,40,na,1864,1539
STAT,1912,31,15-19,1943,0.12809389792717574
SIM,1915,38,25-29,1953,5
SIM,1846,24,25-29,1870,54
SIM,1833,21,45-49,1854,6
STAT,1953,14,na,1967,4799.200924237475
SIM,1940,22,35-39,1962,13
SIM,1926,35,30-34,1961,3
STAT,1851,53,na,1904,1604.17523899659
STAT,1882,50,35-39,1932,0.008543689159945689
SIM,1849,37,20-24,1886,3
SIM,1871,29,45-49,1900,1
STAT,1827,31,20-24,1858,3.7986394361239064
SIM,1844,33,20-24,1877,3
STAT,1826,106,na,1932,0.00666239271390459
SIM,1809,83,na,1892,106
STAT,1871,22,na,1893,2373.147025579698
SIM,1838,22,40-44,1860,6
SIM,1866,41,na,1907,2372
STAT,1951,17,20-24,1968,163.11325999703087
SIM,1864,33,40-44,1897,9
SIM,1928,26,35-39,1954,36
STAT,1911,19,40-44,1930,0.28086706120170185
STAT,1881,18,40-44,1899,0.17760156114320563
STAT,1906,20,35-39,1926,8.63581561985584
SIM,1878,20,20-24,1898,85
SIM,1923,22,35-39,1945,17
SIM,1865,40,50-100,1905,3
STAT,1865,38,45-49,1903,1.8293860951999277
STAT,1898,43,50-100,1941,0.09972253386612505
STAT,1894,22,20-24,1916,89.60935307691038
STAT,1926,44,20-24,1970,0.021930548429497078
SIM,1888,33,50-100,1921,1
STAT,1935,29,na,1964,5154.160971019214
SIM,1857,16,na,1873,2436
SIM,1902,32,50-100,1934,1
SIM,1919,21,30-34,1940,2
STAT,1879,70,na,1949,1478.8399636026436
SIM,1884,42,50-100,1926,3
SIM,1885,22,20-24,1907,68
STAT,1868,39,40-44,1907,4.183035093160792
SIM,1905,20,25-29,1925,137
STAT,1933,14,na,1947,5342.492621557285
STAT,1925,33,15-19,1958,0.1541228070414134
STAT,1851,44,45-49,1895,1.1179410932636153
SIM,1858,37,30-34,1895,3
STAT,1907,38,25-29,1945,0.9171792052913168
STAT,1922,22,na,1944,4230.620810716472
SIM,1817,61,na,1878,1204
STAT,1881,36,50-100,1917,1.2010409308483956
STAT,1840,16,na,1856,2095.6596469499436
STAT,1863,47,40-44,1910,0.1524908778575753
SIM,1850,32,35-39,1882,2
SIM,1918,3,na,1921,4558
STAT,1799,90,na,1889,31.76459949268722
STAT,1821,43,20-24,1864,0.2460176560164152
STAT,1861,42,50-100,1903,0.8855674414606802
SIM,1835,31,20-24,1866,3
SIM,1912,52,na,1964,3324
STAT,1831,32,25-29,1863,8.478104848980987
STAT,1939,27,15-19,1966,0.7164610630696351
STAT,1822,49,45-49,1871,0.3402360122295419
STAT,1936,33,25-29,1969,9.057778152874079
SIM,1914,20,35-39,1934,14
STAT,1847,43,40-44,1890,1.671950429036087
SIM,1918,29,45-49,1947,2
SIM,1928,27,50-100,1955,1
STAT,1891,22,na,1913,2957.4417018466597
STAT,1906,12,na,1918,3799.1381602485603
STAT,1842,21,45-49,1863,0.7975963041870145
SIM,1910,28,30-34,1938,44
SIM,1909,25,50-100,1934,1
STAT,1833,68,na,1901,1081.193283446163
STAT,1906,32,35-39,1938,8.554410312645055
STAT,1932,36,50-100,1968,0.5706047299086386
STAT,1836,54,20-24,1890,4.5272008887864423E-4
SIM,1859,26,25-29,1885,55
STAT,1902,28,30-34,1930,35.814606885831516
SIM,1855,43,40-44,1898,3
SIM,1849,25,20-24,1874,13
STAT,1880,81,na,1961,780.9537796836929
STAT,1816,42,35-39,1858,5.1955239932337225
SIM,1843,16,20-24,1859,25
SIM,1877,67,na,1944,1700
SIM,1907,29,35-39,1936,19
STAT,1897,34,40-44,1931,5.821893974480744
SIM,1860,16,20-24,1876,24
SIM,1835,80,na,1915,300
STAT,1839,53,na,1892,1502.0272831282991
SIM,1913,37,na,1950,3749
SIM,1943,23,30-34,1966,41
STAT,1833,42,35-39,1875,1.5580976070337398
SIM,1879,23,40-44,1902,5
SIM,1874,16,15-19,1890,11
STAT,1802,76,na,1878,380.8026106571342
STAT,1877,34,20-24,1911,2.793607174681429
STAT,1841,25,50-100,1866,0.6027851028344089
SIM,1869,33,25-29,1902,12
SIM,1889,33,45-49,1922,4
SIM,1885,34,20-24,1919,5
STAT,1834,98,na,1932,1.9336243334772538
STAT,1931,36,na,1967,5040.190780266427
SIM,1784,83,na,1867,106
STAT,1884,74,na,1958,1202.9136297308696
STAT,1866,52,40-44,1918,0.009793386466690777
SIM,1887,25,25-29,1912,8
STAT,1880,21,15-19,1901,3.5098741386386125
STAT,1858,49,25-29,1907,0.04468850777602503
STAT,1835,60,na,1895,1431.42948917499
STAT,1879,25,25-29,1904,44.88817406355979
SIM,1923,44,na,1967,4418
STAT,1872,37,50-100,1909,1.2466756454242462
STAT,1851,23,45-49,1874,0.6260117534894822
STAT,1872,25,50-100,1897,0.6539638204111737
STAT,1935,23,30-34,1958,39.52981836177945
SIM,1870,26,25-29,1896,50
STAT,1859,39,30-34,1898,4.285832094805156
STAT,1790,104,na,1894,0.012316661861755882
STAT,1929,23,40-44,1952,4.284376910397195
SIM,1928,33,40-44,1961,7
SIM,1853,23,na,1876,1840
STAT,1826,39,35-39,1865,7.7141175832655104
STAT,1894,15,15-19,1909,7.752760133804908
STAT,1909,23,20-24,1932,103.96362947729635
SIM,1819,76,na,1895,456
SIM,1869,30,20-24,1899,3
STAT,1932,22,35-39,1954,12.485203004563221
STAT,1789,83,na,1872,164.87301604529597
SIM,1835,24,15-19,1859,3
STAT,1852,16,20-24,1868,16.357777448913772
SIM,1855,36,35-39,1891,7
SIM,1917,23,20-24,1940,112
STAT,1868,32,20-24,1900,2.609237934146276
STAT,1915,22,35-39,1937,9.821249702294105
STAT,1883,33,35-39,1916,9.96706248973079
STAT,1929,35,40-44,1964,1.94589507044344
SIM,1937,23,40-44,1960,4
STAT,1887,37,50-100,1924,1.3844591521197125
SIM,1870,8,na,1878,3034
SIM,1862,38,35-39,1900,20
SIM,1876,32,20-24,1908,4
SIM,1933,37,na,1970,4892
STAT,1862,26,25-29,1888,37.299988582949496
SIM,1822,62,na,1884,1104
STAT,1872,38,na,1910,2380.442575753413
SIM,1834,39,35-39,1873,14
STAT,1875,8,na,1883,2778.92286398421
SIM,1848,44,45-49,1892,1
STAT,1887,44,25-29,1931,0.7143514383146703
STAT,1823,48,50-100,1871,0.3332631258772369
STAT,1905,27,50-100,1932,0.9340126821291937
STAT,1909,44,20-24,1953,0.016463952671284907
STAT,1946,16,35-39,1962,4.701975483514359
STAT,1826,80,na,1906,339.43639331519944
STAT,1882,17,45-49,1899,0.06390811375225007
STAT,1872,16,40-44,1888,0.1874385128706638
STAT,1901,17,25-29,1918,8.023279628553315
STAT,1897,46,40-44,1943,0.13113415019012295
STAT,1898,33,45-49,1931,2.377580724707546
SIM,1841,42,35-39,1883,1
STAT,1847,36,35-39,1883,5.551936249201327
STAT,1860,67,na,1927,1308.797941361549
SIM,1838,43,40-44,1881,6
SIM,1938,22,45-49,1960,1
STAT,1944,25,30-34,1969,42.80115001801641
SIM,1908,21,20-24,1929,5
SIM,1954,16,35-39,1970,6
SIM,1815,83,na,1898,186
STAT,1814,100,na,1914,0.49691384548355644
SIM,1933,27,20-24,1960,30
STAT,1852,37,20-24,1889,0.5877776882317691
SIM,1843,26,30-34,1869,46
STAT,1946,0,na,1946,4981.853284812434
SIM,1902,15,25-29,1917,17
STAT,1852,29,35-39,1881,7.645126082126447
STAT,1897,49,45-49,1946,0.17649362118262982
SIM,1925,28,40-44,1953,9
STAT,1865,17,45-49,1882,0.06208041862603338
STAT,1873,85,na,1958,358.32589124408196
STAT,1923,39,20-24,1962,0.30795708547001055
STAT,1860,28,15-19,1888,0.37588410137999173
SIM,1828,38,50-100,1866,1
STAT,1850,49,20-24,1899,0.008996715884892679
SIM,1896,37,35-39,1933,26
STAT,1903,27,35-39,1930,13.879146630556905
SIM,1784,80,na,1864,211
STAT,1832,25,35-39,1857,9.071473040805607
SIM,1846,75,na,1921,671
SIM,1913,15,35-39,1928,4
STAT,1844,38,40-44,1882,3.622066833685566
STAT,1863,29,45-49,1892,0.9864974653312174
SIM,1875,89,na,1964,156
STAT,1861,54,50-100,1915,0.012326871205298372
STAT,1846,26,40-44,1872,2.770005343252465
SIM,1933,19,35-39,1952,6
STAT,1804,54,na,1858,1032.659596848223
STAT,1854,17,35-39,1871,0.4926096580200879
STAT,1905,15,35-39,1920,0.8048906997374106
STAT,1879,32,30-34,1911,18.402539045926538
STAT,1917,28,40-44,1945,4.916646428214403
SIM,1897,36,na,1933,3230
SIM,1887,32,30-34,1919,10
SIM,1929,29,20-24,1958,31
STAT,1882,48,na,1930,2173.469019312703
STAT,1898,23,35-39,1921,7.965301405841135
STAT,1936,19,45-49,1955,0.4802455858428497
SIM,1919,22,na,1941,3956
STAT,1838,48,50-100,1886,0.1669922248003362
SIM,1873,31,25-29,1904,11
SIM,1916,16,30-34,1932,6
SIM,1880,30,20-24,1910,3
STAT,1809,46,na,1855,1479.4257155495059
STAT,1866,16,15-19,1882,5.730567339039047
STAT,1873,23,30-34,1896,18.181811214584545
SIM,1905,24,40-44,1929,3
SIM,1911,27,35-39,1938,23
STAT,1837,51,35-39,1888,0.006012463234997458
STAT,1887,23,25-29,1910,64.35331387684754
STAT,1925,19,35-39,1944,5.095259966318571
STAT,1835,26,30-34,1861,24.820414897249307
SIM,1891,30,30-34,1921,6
SIM,1831,76,na,1907,650
SIM,1895,23,25-29,1918,99
STAT,1838,106,na,1944,0.008127968680474044
STAT,1875,49,25-29,1924,0.05849632326311644
SIM,1820,53,50-100,1873,1
SIM,1885,37,25-29,1922,6
SIM,1846,48,50-100,1894,1
STAT,1884,15,20-24,1899,17.739568137107682
STAT,1919,16,40-44,1935,0.313881574153835
SIM,1870,97,na,1967,41
SIM,1927,16,40-44,1943,1
STAT,1862,23,20-24,1885,61.088948799253494
SIM,1789,72,na,1861,547
STAT,1925,9,na,1934,4859.924579595729
SIM,1898,32,40-44,1930,11
SIM,1870,23,20-24,1893,73
STAT,1892,42,40-44,1934,2.8471757273344664
STAT,1918,23,30-34,1941,31.19820244070946
STAT,1831,87,na,1918,110.71209381414491
STAT,1880,25,30-34,1905,26.89191959064824
STAT,1819,53,na,1872,1244.1071930905325
STAT,1825,39,na,1864,2044.4992376123582
STAT,1812,53,50-100,1865,0.032679129914966305
STAT,1825,51,40-44,1876,0.013896150831265348
STAT,1877,37,25-29,1914,3.0013422770734994
STAT,1886,49,35-39,1935,0.1461778540566056
STAT,1883,30,30-34,1913,17.395395858127053
STAT,1921,26,40-44,1947,5.264591197177526
SIM,1822,49,50-100,1871,2
STAT,1838,21,20-24,1859,60.28418289701643
STAT,1846,86,na,1932,168.37848179100357
STAT,1885,1,na,1886,3326.102370598734
SIM,1832,34,40-44,1866,3
SIM,1859,93,na,1952,31
STAT,1814,49,50-100,1863,0.57281204658409
STAT,1910,26,30-34,1936,38.304731481482335
SIM,1899,38,30-34,1937,2
STAT,1856,45,na,1901,1759.5243313036058
SIM,1920,9,na,1929,4842
STAT,1839,27,45-49,1866,0.9916634721447867
SIM,1868,56,na,1924,1915
STAT,1872,30,20-24,1902,2.7668049348174284
SIM,1848,53,na,1901,1627
STAT,1879,73,na,1952,1251.8910914539138
SIM,1899,14,na,1913,3916
STAT,1875,5,na,1880,2845.579647371494
STAT,1891,21,25-29,1912,71.80050838129816
STAT,1822,46,40-44,1868,0.2574193683696017
STAT,1866,52,na,1918,2002.992533043834
STAT,1889,80,na,1969,1212.08394658029
SIM,1926,23,30-34,1949,41
STAT,1826,47,20-24,1873,0.011824815445194868
STAT,1946,26,45-49,1972,1.9445666863628475
STAT,1818,48,40-44,1866,0.3003163707781992
SIM,1903,36,40-44,1939,2
SIM,1881,36,45-49,1917,2
SIM,1840,25,35-39,1865,8
SIM,1865,40,30-34,1905,1
STAT,1834,20,40-44,1854,3.1698996782621447
STAT,1945,20,20-24,1965,123.15907257726349
STAT,1861,19,50-100,1880,0.046705195490366266
SIM,1897,33,na,1930,3242
STAT,1888,37,35-39,1925,8.43171230782292
STAT,1908,49,30-34,1957,0.08090629969513306
SIM,1892,18,25-29,1910,8
STAT,1877,16,25-29,1893,5.921637887390123
SIM,1866,25,20-24,1891,17
STAT,1938,31,35-39,1969,9.281655773911782
SIM,1907,2,na,1909,4168
STAT,1891,25,40-44,1916,3.7713006559866247
STAT,1884,18,25-29,1902,5.629245847717249
STAT,1923,37,50-100,1960,0.49153435263033757
SIM,1852,38,40-44,1890,12
SIM,1883,24,45-49,1907,1
SIM,1833,57,na,1890,1473
STAT,1929,40,na,1969,4874.826040322516
SIM,1876,22,45-49,1898,5
STAT,1862,44,20-24,1906,0.13665019150641702
STAT,1815,110,na,1925,1.1962078567417971E-4
SIM,1914,30,na,1944,4043
STAT,1824,34,40-44,1858,6.78322735845568
STAT,1893,38,20-24,1931,0.9836652859968077
STAT,1854,19,na,1873,2036.554285824007
STAT,1914,27,45-49,1941,1.757187351852642
SIM,1964,4,na,1968,5249
STAT,1848,39,20-24,1887,0.6352437970465532
STAT,1824,30,25-29,1854,28.060660729598112
STAT,1861,16,30-34,1877,1.5466445585540907
STAT,1896,11,na,1907,3457.7632693170385
SIM,1847,27,45-49,1874,2
STAT,1858,25,20-24,1883,9.654251737929858
STAT,1836,33,20-24,1869,2.13314059118081
STAT,1869,46,30-34,1915,0.09532345666724477
STAT,1904,34,na,1938,3458.3208076026617
SIM,1790,69,na,1859,829
SIM,1856,82,na,1938,244
SIM,1854,22,25-29,1876,3
STAT,1837,39,45-49,1876,1.6217741114974948
SIM,1936,11,na,1947,3940
SIM,1839,32,35-39,1871,11
SIM,1858,3,na,1861,2578
SIM,1860,29,35-39,1889,11
STAT,1873,36,45-49,1909,2.05097428146697
STAT,1852,31,50-100,1883,0.7269678548390494
SIM,1904,23,na,1927,3523
SIM,1854,26,40-44,1880,4
STAT,1904,22,25-29,1926,82.97286595571262
STAT,1925,6,na,1931,4893.123221818047
STAT,1947,19,20-24,1966,154.16038578642562
STAT,1830,37,35-39,1867,6.430194543039247
SIM,1912,22,25-29,1934,125
STAT,1896,36,50-100,1932,1.6492954560304838
STAT,1919,33,na,1952,4102.499886714695
SIM,1832,30,25-29,1862,13
STAT,1914,41,na,1955,3718.350760514903
SIM,1880,1,na,1881,3421
STAT,1925,27,20-24,1952,21.788854130749684
SIM,1844,36,25-29,1880,2
SIM,1928,23,30-34,1951,41
STAT,1905,39,50-100,1944,0.3830277362610045
STAT,1838,31,30-34,1869,14.675132506727632
STAT,1857,22,35-39,1879,5.3101862504041435
SIM,1855,33,30-34,1888,23
SIM,1882,34,na,1916,2073
SIM,1895,55,na,1950,2825
STAT,1844,20,na,1864,2142.7990395846327
STAT,1808,48,15-19,1856,0.001421984510427011
STAT,1840,61,na,1901,1309.8904702324405
SIM,1908,24,25-29,1932,100
STAT,1857,41,na,1898,1830.0649480700185
STAT,1959,8,na,1967,5192.366205569144
STAT,1884,36,20-24,1920,0.7714569182160707
STAT,1909,36,35-39,1945,2.321378696170187
SIM,1926,38,35-39,1964,5
STAT,1815,47,45-49,1862,0.5236304749135556
SIM,1871,42,na,1913,2196
SIM,1838,25,45-49,1863,4
STAT,1876,23,15-19,1899,3.429733200205079
STAT,1924,34,45-49,1958,1.8527532812979486
STAT,1929,38,45-49,1967,0.8837222982416157
STAT,1785,79,na,1864,272.17317535909496
STAT,1845,48,35-39,1893,0.10101069296962416
STAT,1846,22,25-29,1868,53.60245000931879
STAT,1878,52,35-39,1930,0.008978158045416674
STAT,1910,16,20-24,1926,27.16971693269378
SIM,1867,39,30-34,1906,9
STAT,1827,34,25-29,1861,12.693507133702077
STAT,1792,72,na,1864,524.304109836995
STAT,1816,79,na,1895,357.4336652922464
STAT,1851,41,40-44,1892,1.7108304440332738
STAT,1897,16,45-49,1913,0.08866774868806906
SIM,1864,49,na,1913,2409
SIM,1949,22,20-24,1971,5
STAT,1840,17,40-44,1857,0.16600064675335363
STAT,1847,33,30-34,1880,15.190503017625337
STAT,1869,18,na,1887,2499.573074509374
SIM,1909,35,30-34,1944,3
STAT,1878,26,50-100,1904,0.6729901639172498
STAT,1806,80,na,1886,261.4598856788211
SIM,1932,34,45-49,1966,3
STAT,1807,65,na,1872,824.7810787361424
STAT,1849,31,40-44,1880,3.9672727897777573
STAT,1868,22,45-49,1890,0.6731181495524249
STAT,1915,47,15-19,1962,3.745534215901887E-4
STAT,1795,86,na,1881,83.4602485868049
SIM,1813,88,na,1901,45
STAT,1837,27,na,1864,1894.092536297192
STAT,1848,20,35-39,1868,5.885388399612379
STAT,1912,42,50-100,1954,0.11431359920956974
SIM,1863,24,25-29,1887,56
STAT,1834,48,25-29,1882,0.035916518930214233
STAT,1877,22,50-100,1899,0.4250902314501929
SIM,1846,31,30-34,1877,26
STAT,1870,35,15-19,1905,0.05622236140919468
STAT,1943,18,40-44,1961,1.4971729036282557
STAT,1861,107,na,1968,0.042664466417767666
SIM,1884,27,30-34,1911,43
SIM,1917,26,25-29,1943,75
STAT,1938,21,25-29,1959,92.32020987803267
SIM,1877,28,35-39,1905,19
STAT,1892,27,15-19,1919,0.5750131565544507
SIM,1892,36,20-24,1928,1
STAT,1843,27,na,1870,1795.6292573538637
STAT,1832,35,45-49,1867,1.757139894736367
STAT,1855,24,25-29,1879,49.61948749904299
STAT,1859,20,45-49,1879,0.6552219613125596
STAT,1817,72,na,1889,597.4508471854125
STAT,1899,25,na,1924,3330.5267489009566
STAT,1817,45,20-24,1862,0.026638893392461435
SIM,1846,21,20-24,1867,74
SIM,1851,42,na,1893,1847
SIM,1828,36,40-44,1864,8
STAT,1859,35,15-19,1894,0.04604957225321478
STAT,1954,16,50-100,1970,0.46806334908072617
SIM,1831,23,35-39,1854,5
STAT,1903,43,50-100,1946,0.10476285174293364
STAT,1858,26,na,1884,1949.8583484942021
STAT,1853,34,na,1887,1990.4484545110126
SIM,1894,70,na,1964,2198
STAT,1855,60,na,1915,1435.5738924654968
STAT,1887,27,40-44,1914,3.377935493445515
SIM,1853,57,na,1910,1509
STAT,1927,21,15-19,1948,6.648933976937293
STAT,1836,19,40-44,1855,0.20401983801779394
SIM,1930,2,na,1932,5614
STAT,1865,35,40-44,1900,4.075519815648257
STAT,1918,38,35-39,1956,2.5712184378217735
SIM,1888,42,25-29,1930,5
SIM,1873,35,40-44,1908,6
STAT,1850,111,na,1961,1.9762365512450045E-4
STAT,1871,50,25-29,1921,0.003605215985417315
STAT,1889,18,na,1907,3137.1343263860076
STAT,1899,29,25-29,1928,58.21710929223233
SIM,1840,35,45-49,1875,2
STAT,1836,79,na,1915,440.8026304199353
STAT,1889,44,50-100,1933,1.2979395792999495
STAT,1834,38,15-19,1872,0.04116851091480226
STAT,1935,26,35-39,1961,20.686258653114372
STAT,1829,37,50-100,1866,1.0061582847399935
SIM,1910,24,15-19,1934,10
STAT,1864,21,30-34,1885,16.614230908202
STAT,1833,28,20-24,1861,10.900719356400398
STAT,1852,19,25-29,1871,5.13673620385895
STAT,1876,27,30-34,1903,26.2607664201123
SIM,1893,29,30-34,1922,50
SIM,1920,19,na,1939,4421
STAT,1866,37,15-19,1903,0.05251757524036137
STAT,1841,37,45-49,1878,1.7564064145850997
SIM,1927,30,20-24,1957,4
STAT,1855,50,40-44,1905,0.008038257901054354
STAT,1895,18,35-39,1913,0.7218310976183778
SIM,1879,48,na,1927,2629
STAT,1870,28,40-44,1898,2.960507258616898
SIM,1856,20,35-39,1876,10
STAT,1848,103,na,1951,0.11717405100788812
STAT,1822,40,35-39,1862,3.026562560030421
SIM,1841,28,20-24,1869,15
SIM,1860,19,25-29,1879,6
SIM,1834,50,na,1884,1652
STAT,1842,42,na,1884,2152.905890417036
STAT,1903,45,30-34,1948,0.07932508602086932
SIM,1946,21,25-29,1967,120
STAT,1867,48,20-24,1915,0.011271237875169307
STAT,1869,25,30-34,1894,24.89534026144209
SIM,1888,28,45-49,1916,2
STAT,1815,91,na,1906,25.084357531834417
STAT,1908,16,30-34,1924,2.392568231781436
STAT,1952,20,50-100,1972,0.7998636939797403
STAT,1888,84,na,1972,822.5944518258503
SIM,1821,34,30-34,1855,23
SIM,1869,37,40-44,1906,12
STAT,1786,72,na,1858,553.6315152243603
STAT,1770,107,na,1877,0.004178273020363926
STAT,1825,36,15-19,1861,0.09671310685860039
STAT,1944,28,35-39,1972,16.37795235591512
SIM,1824,43,na,1867,1517
SIM,1847,41,25-29,1888,1
STAT,1850,20,25-29,1870,53.375291430505435
STAT,1925,37,30-34,1962,2.210707796962609
STAT,1843,32,50-100,1875,0.7429283569146344
STAT,1843,17,25-29,1860,4.884286015553576
STAT,1887,41,20-24,1928,0.1798951884351952
STAT,1914,38,50-100,1952,0.42085232721065813
STAT,1885,29,30-34,1914,25.135373364845822
SIM,1901,22,15-19,1923,3
STAT,1913,48,na,1961,3607.8745152205915
SIM,1835,35,na,1870,1650
SIM,1945,25,na,1970,3951
STAT,1875,39,15-19,1914,0.05765828849137412
STAT,1888,47,45-49,1935,0.28002674303866804
SIM,1872,21,30-34,1893,24
STAT,1802,73,na,1875,506.0477915197448
SIM,1865,22,35-39,1887,5
STAT,1854,31,15-19,1885,0.11058888237697503
STAT,1860,38,25-29,1898,2.3653510310461687
SIM,1880,56,na,1936,1869
SIM,1881,26,35-39,1907,9
STAT,1828,27,35-39,1855,18.691138693556386
SIM,1851,17,25-29,1868,8
STAT,1870,18,50-100,1888,0.04876351494468722
STAT,1913,34,35-39,1947,9.094980267138013
SIM,1840,50,na,1890,1524
SIM,1921,34,35-39,1955,21
SIM,1930,26,na,1956,5062
SIM,1928,36,45-49,1964,3
SIM,1906,44,45-49,1950,1
STAT,1919,30,20-24,1949,2.6783984847401476
SIM,1878,39,40-44,1917,10
STAT,1890,26,na,1916,2955.461176228181
STAT,1879,22,20-24,1901,72.63375636931463
SIM,1830,40,35-39,1870,1
STAT,1940,17,45-49,1957,0.5120493216448321
SIM,1879,26,45-49,1905,1
SIM,1836,27,35-39,1863,13
SIM,1943,26,35-39,1969,31
SIM,1887,22,20-24,1909,70
STAT,1897,47,na,1944,3032.777919763561
STAT,1858,46,20-24,1904,0.009535636149752254
STAT,1815,41,30-34,1856,3.101570442376155
STAT,1925,16,15-19,1941,55.54086342836612
STAT,1857,44,15-19,1901,0.010738585800622105
STAT,1921,43,na,1964,4218.1443547818435
SIM,1867,98,na,1965,5
SIM,1878,24,30-34,1902,24
STAT,1843,45,25-29,1888,0.039671842946127495
SIM,1883,28,30-34,1911,1
STAT,1927,24,25-29,1951,114.30684536682462
SIM,1863,84,na,1947,175
STAT,1924,23,45-49,1947,1.3374939900856744
STAT,1847,26,na,1873,1960.9008733842343
STAT,1856,51,45-49,1907,0.011291401318094058
STAT,1922,15,35-39,1937,4.928731842123086
SIM,1871,28,na,1899,2370
STAT,1833,32,35-39,1865,9.25860898653276
STAT,1944,21,20-24,1965,121.27506566188389
SIM,1822,86,na,1908,77
STAT,1863,49,45-49,1912,0.20678441581324197
STAT,1878,43,20-24,1921,0.16530546247673739
SIM,1781,87,na,1868,22
STAT,1870,27,40-44,1897,2.9709650556126546
STAT,1904,42,50-100,1946,0.10620161973788249
STAT,1814,47,na,1861,1437.9991746969686
SIM,1928,34,35-39,1962,13
STAT,1851,31,na,1882,1900.2738902278106
STAT,1889,29,50-100,1918,0.7909752425301846
SIM,1841,32,35-39,1873,13
SIM,1789,67,na,1856,677
SIM,1933,16,15-19,1949,70
STAT,1880,46,40-44,1926,0.18210921501854868
SIM,1888,44,na,1932,2952
STAT,1799,100,na,1899,0.3562581245029202
STAT,1823,83,na,1906,219.55899796943237
SIM,1926,35,na,1961,4596
STAT,1861,29,40-44,1890,2.4961483553183443
SIM,1932,23,45-49,1955,4
STAT,1868,95,na,1963,35.287154077840945
SIM,1804,73,na,1877,562
STAT,1888,28,40-44,1916,3.5584766349809294
STAT,1864,81,na,1945,492.8458347499177
STAT,1845,53,35-39,1898,0.006189518367030618
STAT,1911,36,40-44,1947,1.4657544501282496
SIM,1827,29,30-34,1856,27
STAT,1820,45,30-34,1865,0.1697130984893609
STAT,1843,54,50-100,1897,0.009906201059353189
SIM,1834,42,45-49,1876,3
SIM,1883,13,na,1896,2932
SIM,1887,22,30-34,1909,26
STAT,1820,41,50-100,1861,2.063586788514806
STAT,1887,35,50-100,1922,1.3976075284470837
STAT,1894,26,15-19,1920,0.5919900648381398
SIM,1922,21,na,1943,4635
STAT,1882,32,30-34,1914,17.081672030387864
STAT,1906,36,50-100,1942,0.3917150438516706
SIM,1884,30,na,1914,2424
STAT,1877,17,25-29,1894,5.907129874566017
SIM,1896,28,40-44,1924,5
STAT,1879,22,30-34,1901,18.7741432651552
STAT,1871,40,30-34,1911,1.1652452269302283
STAT,1847,53,45-49,1900,0.01069151676746701
STAT,1941,20,40-44,1961,3.5104874640912795
SIM,1842,90,na,1932,62
SIM,1829,37,40-44,1866,1
SIM,1853,19,30-34,1872,5
STAT,1918,31,20-24,1949,2.6274502616602873
STAT,1829,43,25-29,1872,0.49136059221215284
STAT,1909,33,20-24,1942,2.338888994703701
STAT,1860,101,na,1961,1.2449558911453706
STAT,1832,48,50-100,1880,0.19578298199849548
SIM,1862,43,35-39,1905,2
SIM,1949,19,30-34,1968,13
STAT,1896,34,25-29,1930,13.576316135579766
SIM,1930,15,35-39,1945,10
SIM,1938,20,na,1958,3534
STAT,1876,29,50-100,1905,0.6623308134899831
STAT,1917,42,50-100,1959,0.12375149658086886
STAT,1864,50,40-44,1914,0.00973264553866084
SIM,1889,25,45-49,1914,1
STAT,1802,100,na,1902,0.37092103022905326
SIM,1919,36,35-39,1955,10
STAT,1877,22,20-24,1899,71.83599059931483
STAT,1934,18,na,1952,5017.334304495669
STAT,1874,49,20-24,1923,0.012151158490451912
SIM,1872,45,na,1917,2496
SIM,1821,42,35-39,1863,1
STAT,1871,53,50-100,1924,0.01491114328312582
STAT,1909,20,15-19,1929,5.022229334635765
STAT,1805,86,na,1891,88.07952842586316
STAT,1847,47,50-100,1894,0.18303251004711837
STAT,1826,32,na,1858,1600.3614031281577
STAT,1889,44,35-39,1933,2.2247363121707817
STAT,1860,47,50-100,1907,0.20182853991266536
SIM,1939,6,na,1945,4114
STAT,1852,48,30-34,1900,0.07248991192493623
STAT,1827,35,15-19,1862,0.0684777944381958
STAT,1847,27,40-44,1874,2.695838834468385
STAT,1915,38,50-100,1953,0.425856276430561
SIM,1880,64,na,1944,1546
STAT,1766,105,na,1871,0.009827074962983831
STAT,1861,27,15-19,1888,0.38354999473089274
STAT,1880,33,35-39,1913,10.696554466939187
STAT,1893,62,na,1955,2343.9582230870315
SIM,1968,2,na,1970,5195
STAT,1901,29,35-39,1930,13.563865768024279
STAT,1933,21,45-49,1954,1.512732131368413
SIM,1818,81,na,1899,198
SIM,1941,21,45-49,1962,2
STAT,1792,105,na,1897,0.005270918633130789
STAT,1836,18,50-100,1854,0.07508541335597421
STAT,1871,48,40-44,1919,0.16962772446810082
STAT,1919,18,40-44,1937,1.5565641503368495
SIM,1873,35,35-39,1908,15
SIM,1890,32,30-34,1922,32
SIM,1887,17,35-39,1904,1
STAT,1865,35,35-39,1900,6.584994422204415
SIM,1884,44,25-29,1928,3
SIM,1837,23,30-34,1860,19
SIM,1952,16,25-29,1968,55
STAT,1847,52,30-34,1899,0.004433167881717449
SIM,1823,41,30-34,1864,4
STAT,1815,50,45-49,1865,0.03202023923278328
SIM,1869,41,na,1910,2258
STAT,1909,18,50-100,1927,0.0739455872521901
STAT,1870,39,35-39,1909,6.944239103826041
SIM,1918,16,na,1934,4403
STAT,1898,22,40-44,1920,2.8531693321287266
STAT,1922,20,30-34,1942,33.49550612677836
STAT,1834,101,na,1935,0.3396514310167094
STAT,1884,40,40-44,1924,2.2628726040419185
SIM,1842,47,na,1889,1626
STAT,1826,64,na,1890,953.8726938442285
SIM,1851,67,na,1918,1395
STAT,1822,40,50-100,1862,1.765735253387327
STAT,1880,28,na,1908,2522.4996879438363
SIM,1839,43,na,1882,1572
SIM,1956,4,na,1960,5294
STAT,1843,50,20-24,1893,5.048550572369692E-4
SIM,1863,33,25-29,1896,5
SIM,1793,72,na,1865,526
STAT,1845,53,50-100,1898,0.010858183616620783
STAT,1831,24,25-29,1855,62.37721808678343
STAT,1910,44,25-29,1954,0.06725254571283336
SIM,1890,41,45-49,1931,6
SIM,1797,86,na,1883,71
STAT,1882,41,45-49,1923,1.4708595896321985
SIM,1843,39,40-44,1882,12
STAT,1868,38,40-44,1906,4.2046047153505395
STAT,1913,44,50-100,1957,0.11520703803910812
STAT,1920,29,45-49,1949,1.900107324667157
STAT,1835,39,40-44,1874,3.9799500128165963
STAT,1801,72,na,1873,599.2353948325721
STAT,1858,30,50-100,1888,0.7412559318460779
STAT,1889,57,na,1946,2502.7827775559317
SIM,1876,38,40-44,1914,13
STAT,1858,17,15-19,1875,5.49309622027584
SIM,1866,17,15-19,1883,7
STAT,1867,43,45-49,1910,1.4133529138456165
SIM,1876,59,na,1935,2215
SIM,1834,28,na,1862,1998
SIM,1840,19,20-24,1859,19
SIM,1935,24,25-29,1959,153
STAT,1928,33,30-34,1961,19.89978538986788
SIM,1892,40,40-44,1932,10
STAT,1885,43,na,1928,2306.791525270844
SIM,1839,31,40-44,1870,7
STAT,1866,102,na,1968,1.9104614877392363
STAT,1874,36,15-19,1910,0.058353978893225196
SIM,1936,33,30-34,1969,16
STAT,1856,62,na,1918,1415.296768991469
STAT,1916,49,50-100,1965,0.2327425365464826
SIM,1821,69,na,1890,753
STAT,1903,15,25-29,1918,8.188968534524287
STAT,1838,22,50-100,1860,0.35417094980229774
STAT,1903,6,na,1909,3757.6493825833195
STAT,1848,31,40-44,1879,4.172242071628023
STAT,1818,100,na,1918,0.5469667261989414
STAT,1850,24,35-39,1874,5.286359799014923
SIM,1912,59,na,1971,3141
STAT,1870,25,15-19,1895,0.45302963516854894
STAT,1890,40,40-44,1930,2.8039786552466293
SIM,1822,32,25-29,1854,17
STAT,1838,29,40-44,1867,2.5143495094294255
STAT,1776,88,na,1864,37.90948859195794
STAT,1921,11,na,1932,4568.341956264181
SIM,1835,37,40-44,1872,2
STAT,1814,79,na,1893,327.223380727855
SIM,1945,26,35-39,1971,22
SIM,1859,63,na,1922,1702
STAT,1891,36,15-19,1927,0.07055802775548012
STAT,1837,42,20-24,1879,0.12784713691999763
STAT,1853,25,15-19,1878,0.4409635146158568
STAT,1809,49,40-44,1858,0.5673271295484957
STAT,1881,23,25-29,1904,55.56013708782071
STAT,1880,12,na,1892,2739.2945374265696
STAT,1829,26,35-39,1855,15.998427548948515
STAT,1831,70,na,1901,881.6925417459943
STAT,1824,45,15-19,1869,4.8113881527759314E-4
STAT,1913,56,na,1969,3483.1160761671754
SIM,1877,60,na,1937,1925
STAT,1798,99,na,1897,0.6301411423133638
STAT,1794,85,na,1879,91.3802441680861
STAT,1862,15,na,1877,2320.2949852660913
STAT,1876,44,25-29,1920,0.66062965714661
STAT,1866,29,na,1895,2216.002072769372
SIM,1880,25,25-29,1905,56
SIM,1913,23,35-39,1936,11
STAT,1944,16,25-29,1960,47.10573562697054
STAT,1905,23,35-39,1928,8.494036685638644
SIM,1892,65,na,1957,2396
STAT,1834,27,30-34,1861,19.665489650085085
STAT,1858,53,20-24,1911,5.753291554105206E-4
STAT,1897,46,35-39,1943,0.10723587072987538
STAT,1818,37,15-19,1855,0.14186449026763204
STAT,1835,84,na,1919,249.67962383173264
STAT,1813,42,35-39,1855,6.582756617418314
SIM,1842,27,30-34,1869,1
STAT,1809,53,25-29,1862,0.011140268002487947
STAT,1839,98,na,1937,2.303127570692114
SIM,1868,25,25-29,1893,35
STAT,1894,28,40-44,1922,3.8815264485056247
STAT,1849,22,45-49,1871,0.6591666704297214
STAT,1855,29,40-44,1884,2.316648512131872
STAT,1896,37,50-100,1933,1.6413953307960971
STAT,1933,37,30-34,1970,2.5085734581016155
STAT,1855,109,na,1964,0.003117863393710457
STAT,1830,42,35-39,1872,1.5733462904085564
SIM,1856,31,40-44,1887,2
STAT,1869,54,35-39,1923,0.008221266518086232
STAT,1818,47,40-44,1865,0.30482533635399645
SIM,1846,29,40-44,1875,2
STAT,1896,17,35-39,1913,0.7335808870312592
SIM,1867,41,45-49,1908,2
STAT,1871,51,na,1922,2170.8779525846153
STAT,1822,34,na,1856,1591.5341161281115
STAT,1826,48,na,1874,1383.918798201573
STAT,1928,36,35-39,1964,3.092505119059965
SIM,1906,33,45-49,1939,3
STAT,1875,53,20-24,1928,7.530938474442635E-4
SIM,1863,29,40-44,1892,3
STAT,1839,53,35-39,1892,0.006005589732686657
STAT,1844,27,15-19,1871,0.4394304294093247
STAT,1847,10,na,1857,2258.818722692509
STAT,1875,65,na,1940,1752.858671669099
STAT,1823,51,50-100,1874,0.02041042449881211
SIM,1873,40,30-34,1913,3
STAT,1865,40,30-34,1905,1.070987121782421
STAT,1900,42,15-19,1942,0.0013438072175025787
SIM,1867,82,na,1949,374
STAT,1850,48,20-24,1898,0.009073111483584455
SIM,1904,22,30-34,1926,44
STAT,1893,78,na,1971,1479.631655419217
STAT,1926,44,50-100,1970,0.14588581938046533
SIM,1837,26,35-39,1863,9
STAT,1874,30,30-34,1904,18.20179999796297
STAT,1937,31,30-34,1968,15.745286216441196
STAT,1824,34,35-39,1858,15.840138785020839
STAT,1874,21,40-44,1895,2.1615597070044372
STAT,1796,92,na,1888,11.17264898838804
STAT,1862,51,50-100,1913,0.013235952186304134
STAT,1867,30,na,1897,2288.1572592608004
STAT,1929,15,45-49,1944,0.6473605934700505
SIM,1854,32,na,1886,2220
STAT,1864,27,40-44,1891,2.7301185209036545
STAT,1900,39,50-100,1939,0.3680524877615044
STAT,1857,21,40-44,1878,1.9099435090957737
STAT,1858,1,na,1859,2938.367875702932
STAT,1913,22,30-34,1935,28.100157937386587
SIM,1872,27,40-44,1899,6
STAT,1821,52,50-100,1873,0.021290969396372973
STAT,1885,28,15-19,1913,0.45451872178224206
STAT,1918,26,25-29,1944,70.96046971270664
STAT,1770,103,na,1873,0.027092008061378788
SIM,1779,89,na,1868,45
SIM,1921,22,30-34,1943,54
STAT,1859,41,45-49,1900,1.2212751503978598
SIM,1846,13,na,1859,2202
SIM,1865,21,40-44,1886,2
SIM,1926,31,20-24,1957,3
STAT,1838,21,30-34,1859,15.582064633649416
STAT,1855,16,35-39,1871,0.4941624287828127
STAT,1841,34,35-39,1875,8.999658225571546
SIM,1846,21,30-34,1867,26
SIM,1902,22,20-24,1924,103
STAT,1827,37,40-44,1864,5.091940809947263
STAT,1891,30,30-34,1921,22.008492545228528
STAT,1834,52,20-24,1886,4.5060656787512706E-4
STAT,1863,32,20-24,1895,2.4189396104806065
STAT,1869,26,50-100,1895,0.6303070217997467
STAT,1881,50,40-44,1931,0.010396643448789713
STAT,1937,26,35-39,1963,14.781419951820116
STAT,1833,35,15-19,1868,0.05089984261474358
STAT,1891,49,20-24,1940,0.008287754363772467
STAT,1850,7,na,1857,2315.9516322870213
SIM,1852,5,na,1857,2337
STAT,1834,47,50-100,1881,0.15511870973005146
SIM,1882,30,30-34,1912,18
SIM,1900,28,30-34,1928,7
STAT,1835,37,15-19,1872,0.05212612184035934
SIM,1832,34,35-39,1866,8
STAT,1873,58,na,1931,2024.8809855896345
SIM,1840,83,na,1923,287
STAT,1875,28,30-34,1903,26.027167496689387
SIM,1909,55,na,1964,3622
SIM,1833,54,na,1887,1505
SIM,1909,31,20-24,1940,1
STAT,1907,47,30-34,1954,0.08061150372104854
STAT,1849,19,15-19,1868,5.644322270265522
STAT,1794,109,na,1903,1.383569693322096E-4
STAT,1833,48,20-24,1881,0.008967595841534946
STAT,1788,73,na,1861,456.3600408102861
STAT,1859,11,na,1870,2261.3151799882908
SIM,1834,71,na,1905,895
STAT,1897,30,50-100,1927,1.2506228786088045
STAT,1924,47,30-34,1971,0.10724462282677612
SIM,1909,23,na,1932,3828
STAT,1784,91,na,1875,15.58591562026833
STAT,1867,46,na,1913,2146.1740049291975
SIM,1838,85,na,1923,168
STAT,1861,46,30-34,1907,0.08147297745318643
SIM,1926,26,25-29,1952,137
SIM,1915,23,45-49,1938,2
STAT,1854,42,20-24,1896,0.11904030765192415
SIM,1852,37,40-44,1889,5
STAT,1868,24,20-24,1892,66.10417086081556
SIM,1829,49,na,1878,1620
STAT,1817,52,20-24,1869,0.0015194086207404168
STAT,1838,33,na,1871,1784.1656016816582
STAT,1849,18,50-100,1867,0.04687201282120618
STAT,1829,39,40-44,1868,3.4699407461117127
SIM,1837,39,40-44,1876,1
STAT,1873,17,40-44,1890,0.18727619168292087
STAT,1881,77,na,1958,947.8988612120047
STAT,1848,43,35-39,1891,1.4677741851049129
SIM,1857,19,15-19,1876,5
STAT,1939,20,25-29,1959,93.7140007780421
STAT,1884,43,20-24,1927,0.15703435084290865
STAT,1902,38,50-100,1940,0.37634435856985515
SIM,1825,35,na,1860,1464
STAT,1850,35,15-19,1885,0.04459581688837195
STAT,1891,25,35-39,1916,12.147632757408696
SIM,1856,43,35-39,1899,2
STAT,1838,16,35-39,1854,0.4880638168960579
STAT,1867,27,50-100,1894,0.6084894244893334
STAT,1840,22,25-29,1862,51.031470627123916
SIM,1898,23,45-49,1921,2
STAT,1844,37,40-44,1881,3.6598733251342015
STAT,1859,48,40-44,1907,0.13732440781452904
SIM,1848,63,na,1911,1348
STAT,1941,23,45-49,1964,1.173544590790116
STAT,1861,9,na,1870,2350.2109315304997
STAT,1873,51,45-49,1924,0.014930496191973243
SIM,1857,38,30-34,1895,6
STAT,1826,45,25-29,1871,0.05832521416164909
SIM,1818,97,na,1915,9
STAT,1947,20,na,1967,4171.784870898774
STAT,1885,31,45-49,1916,1.7602946348758042
STAT,1855,20,50-100,1875,0.36380194151493644
STAT,1870,17,15-19,1887,5.941886014216986
SIM,1887,34,25-29,1921,17
STAT,1944,24,25-29,1968,100.64148582702944
STAT,1908,16,15-19,1924,8.908394411880893
SIM,1862,40,30-34,1902,1
SIM,1805,90,na,1895,23
STAT,1869,40,15-19,1909,0.013697511570768829
STAT,1836,29,30-34,1865,20.261608171037466
SIM,1904,24,na,1928,3453
STAT,1876,38,15-19,1914,0.058269928897279694
SIM,1908,38,na,1946,3382
STAT,1928,41,30-34,1969,0.16497145356454102
STAT,1855,29,na,1884,1845.6409864104423
SIM,1901,59,na,1960,2856
STAT,1942,16,15-19,1958,47.89892028472088
SIM,1878,27,35-39,1905,16
STAT,1874,44,15-19,1918,0.014089202100890227
STAT,1827,105,na,1932,0.017435792502143346
STAT,1865,33,50-100,1898,0.8414470063529597
STAT,1851,15,na,1866,2138.303236054236
SIM,1868,17,25-29,1885,10
STAT,1926,33,20-24,1959,2.9789759471711714
SIM,1826,40,45-49,1866,4
STAT,1856,42,30-34,1898,0.8891452617470318
STAT,1893,36,25-29,1929,3.7101736144644426
STAT,1840,39,50-100,1879,0.9969961528563229
SIM,1880,31,35-39,1911,2
SIM,1881,81,na,1962,602
STAT,1906,22,na,1928,3479.231234890899
SIM,1889,61,na,1950,2185
SIM,1888,60,na,1948,2428
STAT,1926,21,50-100,1947,0.8103500791599001
SIM,1836,78,na,1914,594
SIM,1893,31,45-49,1924,2
SIM,1931,27,20-24,1958,17
SIM,1913,44,na,1957,3610
STAT,1856,46,na,1902,1747.1020895246013
SIM,1838,26,na,1864,1877
SIM,1879,28,40-44,1907,9
STAT,1809,47,15-19,1856,0.001430918940576134
STAT,1866,19,15-19,1885,5.629903459439879
STAT,1867,54,25-29,1921,0.003276588426289909
SIM,1861,27,40-44,1888,4
SIM,1928,31,30-34,1959,30
STAT,1921,40,50-100,1961,0.13401147560992857
SIM,1943,26,25-29,1969,111
STAT,1863,46,40-44,1909,0.15364010584932816
STAT,1853,27,40-44,1880,2.86979628962334
STAT,1882,35,35-39,1917,6.985493454579011
SIM,1918,24,25-29,1942,102
STAT,1919,43,30-34,1962,0.1396637889648966
STAT,1811,50,na,1861,1265.7310216220706
SIM,1862,67,na,1929,1402
STAT,1812,72,na,1884,626.4489184267006
SIM,1831,29,20-24,1860,8
SIM,1882,25,35-39,1907,10
STAT,1896,43,na,1939,3078.218556010813
STAT,1818,40,45-49,1858,3.1440955162299975
SIM,1831,47,na,1878,1618
STAT,1844,49,35-39,1893,0.1084530828991488
STAT,1815,44,35-39,1859,4.236921196186954
STAT,1935,26,25-29,1961,90.68966970261614
STAT,1935,35,na,1970,5324.326314875068
SIM,1876,75,na,1951,1013
STAT,1884,51,20-24,1935,7.38480544333991E-4
SIM,1823,44,35-39,1867,5
SIM,1859,24,20-24,1883,68
STAT,1928,15,50-100,1943,0.479374306960939
STAT,1815,64,na,1879,895.2735752381926
SIM,1950,16,15-19,1966,56
STAT,1819,78,na,1897,397.2005751736218
STAT,1885,27,na,1912,2399.2618445230605
STAT,1897,18,40-44,1915,0.2470126226766903
SIM,1924,21,45-49,1945,1
SIM,1840,42,45-49,1882,1
SIM,1844,21,20-24,1865,60
STAT,1878,89,na,1967,289.02525023601856
STAT,1871,52,25-29,1923,0.003535220958609911
STAT,1837,32,na,1869,1853.658174776763
STAT,1966,4,na,1970,4959.843859048296
STAT,1859,106,na,1965,0.06254413899312782
STAT,1916,26,15-19,1942,0.739150901097421
STAT,1885,38,40-44,1923,4.379040409857212
SIM,1836,19,30-34,1855,3
STAT,1798,106,na,1904,0.004039870919425755
STAT,1857,49,20-24,1906,0.009261437027610737
SIM,1824,39,30-34,1863,2
STAT,1855,21,30-34,1876,15.776770656315287
STAT,1904,2,na,1906,3863.657641198668
SIM,1843,32,na,1875,2446
STAT,1875,17,15-19,1892,6.155419837350962
STAT,1800,87,na,1887,52.17507404147077
SIM,1813,66,na,1879,896
SIM,1906,30,40-44,1936,3
STAT,1895,30,15-19,1925,0.18934031437096716
STAT,1918,34,25-29,1952,9.830689194963256
STAT,1865,41,45-49,1906,1.3865308523372757
SIM,1860,35,25-29,1895,2
STAT,1884,30,50-100,1914,0.919911407498908
STAT,1773,101,na,1874,0.13867947725226087
STAT,1846,43,25-29,1889,0.48694411485776146
SIM,1828,45,50-100,1873,3
STAT,1852,35,25-29,1887,2.2414778066153738
STAT,1825,45,50-100,1870,0.33905108808364237
STAT,1923,27,20-24,1950,21.17524381283436
SIM,1897,37,na,1934,3213
STAT,1872,16,35-39,1888,0.5623155060545925
SIM,1928,22,40-44,1950,6
SIM,1769,90,na,1859,58
SIM,1898,39,30-34,1937,2
SIM,1893,38,40-44,1931,11
SIM,1820,38,35-39,1858,9
STAT,1910,41,20-24,1951,0.01693621477448111
SIM,1847,78,na,1925,516
STAT,1832,42,45-49,1874,1.2504656750987877
SIM,1873,30,na,1903,2322
SIM,1890,58,na,1948,2679
SIM,1916,16,15-19,1932,13
STAT,1889,41,30-34,1930,1.438268652910989
STAT,1839,45,35-39,1884,0.10375399671745791
STAT,1765,111,na,1876,0.0010156097450994238
STAT,1844,30,45-49,1874,1.684494156465061
SIM,1843,64,na,1907,1592
SIM,1822,70,na,1892,773
SIM,1846,37,40-44,1883,10
STAT,1830,53,na,1883,1445.304684402379
SIM,1874,22,45-49,1896,4
STAT,1924,31,45-49,1955,1.856222257466415
STAT,1820,48,35-39,1868,0.2345188946109099
STAT,1881,20,20-24,1901,67.49112568723218
SIM,1838,27,40-44,1865,4
SIM,1844,29,30-34,1873,37
STAT,1842,43,50-100,1885,0.9715512380241054
STAT,1872,25,25-29,1897,43.24515859720236
SIM,1852,30,45-49,1882,3
SIM,1859,49,50-100,1908,4
STAT,1836,21,20-24,1857,57.78854261306299
STAT,1838,37,40-44,1875,3.535996013816026
STAT,1880,30,30-34,1910,18.668569547159546
STAT,1916,21,45-49,1937,1.1934293168958197
STAT,1821,49,na,1870,1516.8283714452139
STAT,1873,43,45-49,1916,1.5213543100563103
STAT,1852,32,45-49,1884,1.3692915677111508
SIM,1913,20,30-34,1933,3
STAT,1888,40,25-29,1928,0.7732473038080715
STAT,1831,30,35-39,1861,8.583776916260168
STAT,1897,43,30-34,1940,0.10732081588823075
STAT,1876,82,na,1958,590.0214344522697
SIM,1895,20,15-19,1915,5
STAT,1906,40,40-44,1946,0.23209656381814603
STAT,1929,24,35-39,1953,11.959778254842291
STAT,1861,49,35-39,1910,0.11504592258297618
SIM,1850,43,50-100,1893,3
SIM,1863,52,na,1915,1933
STAT,1866,22,45-49,1888,0.6574827845168738
STAT,1922,23,35-39,1945,10.87466654507994
STAT,1876,41,20-24,1917,0.16636642734093193
STAT,1856,45,35-39,1901,0.10948926231836431
SIM,1901,43,na,1944,3319
STAT,1817,71,na,1888,656.849772074071
STAT,1851,22,50-100,1873,0.3687362852075105
SIM,1863,30,20-24,1893,3
STAT,1826,53,25-29,1879,0.0032999912480370375
STAT,1898,49,30-34,1947,0.07320226446166428
STAT,1845,25,50-100,1870,0.5771852271246081
SIM,1850,29,30-34,1879,40
STAT,1780,77,na,1857,284.4462306536523
STAT,1862,31,na,1893,2089.8948203211853
SIM,1932,31,45-49,1963,1
STAT,1831,103,na,1934,0.09018491173865384
STAT,1918,23,na,1941,3963.9729034207407
STAT,1939,33,na,1972,3893.2676913945334
SIM,1854,35,25-29,1889,5
STAT,1880,38,40-44,1918,4.620232598986748
SIM,1832,40,45-49,1872,2
STAT,1820,37,30-34,1857,13.060804217158841
STAT,1848,34,45-49,1882,1.4798689915457814
STAT,1893,44,25-29,1937,0.05641560612630977
STAT,1876,23,na,1899,2458.753150763828
SIM,1887,38,40-44,1925,11
STAT,1825,47,na,1872,1881.1756781693193
STAT,1840,52,45-49,1892,0.01011886688325852
STAT,1821,33,na,1854,1667.9211091294464
STAT,1905,20,30-34,1925,26.162830525926505
STAT,1809,50,20-24,1859,0.002471549684443422
SIM,1848,24,45-49,1872,1
STAT,1832,50,45-49,1882,0.010726011751409964
STAT,1884,58,na,1942,1969.6772085804776
STAT,1819,48,50-100,1867,0.47158651106610466
STAT,1858,50,40-44,1908,0.00846184580263175
STAT,1866,16,50-100,1882,0.047307921128991404
STAT,1823,99,na,1922,1.0474286355710962
SIM,1900,36,30-34,1936,2
STAT,1931,29,20-24,1960,23.794010610888385
STAT,1794,69,na,1863,704.9149036810797
STAT,1908,40,50-100,1948,0.11096314382327518
SIM,1856,40,30-34,1896,3
STAT,1879,38,40-44,1917,4.591002308417911
STAT,1849,27,15-19,1876,0.4204975256491506
SIM,1909,22,30-34,1931,3
STAT,1892,24,15-19,1916,4.154939891884981
SIM,1849,17,15-19,1866,12
SIM,1945,23,30-34,1968,43
SIM,1872,23,25-29,1895,62
STAT,1824,40,45-49,1864,1.9379554129864045
STAT,1859,38,15-19,1897,0.045390091178839485
SIM,1825,29,20-24,1854,9
STAT,1848,11,na,1859,2427.192897134609
STAT,1924,39,30-34,1963,2.167098988566423
STAT,1937,23,30-34,1960,28.246134577683186
SIM,1932,39,30-34,1971,6
STAT,1869,51,30-34,1920,0.005873123362927312
SIM,1782,72,na,1854,312
SIM,1786,86,na,1872,52
SIM,1825,51,na,1876,1225
SIM,1829,65,na,1894,1151
SIM,1833,86,na,1919,124
SIM,1926,34,25-29,1960,17
STAT,1913,30,30-34,1943,15.94287202836026
SIM,1950,17,na,1967,4230
STAT,1887,36,25-29,1923,3.2623416461285237
STAT,1925,41,na,1966,4550.701357842348
STAT,1864,97,na,1961,11.359791660510538
STAT,1874,24,45-49,1898,0.7166481089372073
STAT,1891,31,45-49,1922,2.1895229784051464
STAT,1905,53,na,1958,3149.6531165357706
STAT,1816,39,30-34,1855,18.527774578060043
SIM,1865,59,na,1924,1702
STAT,1848,40,30-34,1888,0.9618331043335765
SIM,1908,18,30-34,1926,1
SIM,1861,45,na,1906,1964
STAT,1826,42,45-49,1868,1.5614951968554387
SIM,1861,39,35-39,1900,2
SIM,1883,29,na,1912,2686
STAT,1918,23,20-24,1941,120.70018872418115
STAT,1862,5,na,1867,2511.9211591638914
STAT,1847,24,50-100,1871,0.3689464053889402
SIM,1831,79,na,1910,445
SIM,1872,61,na,1933,2125
STAT,1860,17,30-34,1877,1.5177016944025474
SIM,1870,19,30-34,1889,5
STAT,1862,19,30-34,1881,1.4318869323756034
SIM,1810,85,na,1895,210
SIM,1960,8,na,1968,5278
SIM,1856,34,45-49,1890,1
STAT,1866,34,15-19,1900,0.13204402434754814
STAT,1795,103,na,1898,0.033228057368128214
STAT,1888,15,35-39,1903,0.6571617283720032
SIM,1830,31,20-24,1861,2
STAT,1825,33,15-19,1858,0.300900736887481
STAT,1833,34,na,1867,1933.1269897841553
STAT,1852,43,25-29,1895,0.4834886951032871
SIM,1921,30,30-34,1951,25
STAT,1837,48,na,1885,1572.91449674611
STAT,1878,33,50-100,1911,0.9565881131965231
STAT,1943,20,15-19,1963,5.722497644225272
SIM,1926,23,20-24,1949,125
STAT,1829,40,20-24,1869,0.12705533756621082
SIM,1934,33,20-24,1967,8
STAT,1843,19,20-24,1862,15.101160801782958
STAT,1846,35,25-29,1881,2.329613292487827
SIM,1937,24,35-39,1961,13
SIM,1904,25,35-39,1929,18
STAT,1896,31,20-24,1927,3.6285447210647135
SIM,1831,26,40-44,1857,3
STAT,1833,43,15-19,1876,0.011731272693791019
STAT,1874,33,35-39,1907,10.429108913926829
SIM,1948,15,20-24,1963,182
STAT,1868,27,25-29,1895,40.833175469477546
STAT,1937,34,35-39,1971,9.115586271432448
SIM,1881,43,45-49,1924,2
STAT,1854,45,25-29,1899,0.04365899051599132
STAT,1870,20,45-49,1890,0.6957217885631939
SIM,1949,20,na,1969,4056
STAT,1830,51,25-29,1881,0.002657600353381222
STAT,1901,27,50-100,1928,0.9057132272822782
STAT,1842,29,30-34,1871,27.63631724995112
STAT,1879,17,35-39,1896,0.5783393397121113
STAT,1830,69,na,1899,968.1968087944554
STAT,1867,46,25-29,1913,0.054945942403515184
STAT,1900,34,15-19,1934,0.19808895082497802
SIM,1815,42,35-39,1857,2
STAT,1898,41,50-100,1939,0.10090265295204402
STAT,1924,20,40-44,1944,4.033148471434143
STAT,1893,33,45-49,1926,2.226912512574894
SIM,1871,23,30-34,1894,22
SIM,1940,30,40-44,1970,7
STAT,1872,31,35-39,1903,10.325258146759017
SIM,1882,33,35-39,1915,7
STAT,1806,52,45-49,1858,0.04187602670345058
STAT,1862,18,50-100,1880,0.048652397015780585
STAT,1867,14,na,1881,2527.912609881591
STAT,1872,39,45-49,1911,2.0038550833149116
STAT,1948,24,45-49,1972,1.3041851793258359
STAT,1890,17,40-44,1907,0.22573179000430368
STAT,1881,53,45-49,1934,0.013901932210920055
SIM,1859,32,20-24,1891,2
STAT,1868,36,15-19,1904,0.05446637990471836
SIM,1932,20,40-44,1952,8
STAT,1880,49,45-49,1929,0.2451010264126507
STAT,1895,26,50-100,1921,0.8466262934117965
STAT,1852,96,na,1948,6.512051921440843
STAT,1841,31,30-34,1872,16.00694191776478
SIM,1873,46,na,1919,2180
STAT,1883,8,na,1891,2569.3169825482573
SIM,1880,39,45-49,1919,4
SIM,1813,50,na,1863,1307
STAT,1849,38,30-34,1887,4.219841588421612
STAT,1906,38,na,1944,3475.908157627448
STAT,1863,23,30-34,1886,16.140967231463264
STAT,1932,30,40-44,1962,5.263187548482816
SIM,1888,76,na,1964,1782
STAT,1905,39,20-24,1944,0.2404872690590207
SIM,1792,71,na,1863,475
SIM,1796,85,na,1881,110
SIM,1885,31,na,1916,2631
SIM,1918,21,20-24,1939,115
STAT,1901,38,25-29,1939,0.8755195552129452
STAT,1855,37,40-44,1892,3.2950376097888268
STAT,1844,23,20-24,1867,67.58608747438655
STAT,1893,38,15-19,1931,0.07165774508166618
STAT,1872,22,20-24,1894,69.9751856525498
SIM,1915,20,40-44,1935,7
STAT,1886,40,15-19,1926,0.014875303392943432
STAT,1895,41,30-34,1936,0.1057763208978924
SIM,1852,33,25-29,1885,16
SIM,1863,47,50-100,1910,3
SIM,1939,25,20-24,1964,24
SIM,1788,66,na,1854,646
STAT,1762,108,na,1870,0.0032842966189568397
SIM,1852,52,na,1904,1587
SIM,1951,20,15-19,1971,6
SIM,1948,19,na,1967,4533
SIM,1904,40,na,1944,3526
STAT,1883,20,30-34,1903,17.710192392665853
STAT,1850,30,45-49,1880,1.5671832491008757
SIM,1828,36,35-39,1864,12
SIM,1908,54,na,1962,3095
STAT,1910,11,na,1921,3953.9982399846585
SIM,1854,41,35-39,1895,2
STAT,1854,44,na,1898,1711.1411567534083
STAT,1808,52,50-100,1860,0.05112786699305571
STAT,1893,33,20-24,1926,3.4518859580863643
SIM,1895,27,35-39,1922,1
STAT,1918,17,35-39,1935,0.9250960300905602
STAT,1887,27,35-39,1914,10.88057505769378
STAT,1830,104,na,1934,0.04400467302100744
STAT,1829,34,35-39,1863,8.580826147433912
STAT,1949,17,15-19,1966,53.32388839156886
SIM,1812,49,na,1861,1266
STAT,1860,24,50-100,1884,0.3421055954630231
STAT,1791,93,na,1884,6.3979713185847835
STAT,1834,52,45-49,1886,0.008861928831898125
SIM,1850,37,30-34,1887,9
STAT,1853,17,15-19,1870,5.903684833704224
STAT,1867,6,na,1873,2665.9236357427835
STAT,1835,40,20-24,1875,0.14658626860977547
STAT,1839,42,30-34,1881,0.8590623544866859
STAT,1901,15,15-19,1916,8.44151700084143
SIM,1833,70,na,1903,929
SIM,1891,20,30-34,1911,26
SIM,1861,17,15-19,1878,10
SIM,1828,59,na,1887,1152
STAT,1850,30,na,1880,1947.7226295351295
STAT,1899,29,30-34,1928,34.656457854181355
SIM,1881,65,na,1946,1524
SIM,1889,45,na,1934,2716
SIM,1865,33,35-39,1898,14
SIM,1928,24,50-100,1952,5
STAT,1894,17,25-29,1911,7.368647417332336
STAT,1835,45,15-19,1880,3.5691359456970374E-4
STAT,1842,38,20-24,1880,0.8057301383244669
SIM,1840,67,na,1907,1051
SIM,1803,72,na,1875,482
SIM,1840,48,50-100,1888,5
STAT,1826,42,20-24,1868,0.16569499473763122
SIM,1852,23,20-24,1875,69
STAT,1774,100,na,1874,0.1381078843558032
STAT,1863,80,na,1943,553.5754904703464
STAT,1826,47,15-19,1873,3.9416016812311515E-4
STAT,1835,48,30-34,1883,0.07563595349883043
STAT,1891,28,na,1919,2973.790543362772
STAT,1806,71,na,1877,613.5923229422418
SIM,1928,25,45-49,1953,3
STAT,1870,52,30-34,1922,0.005872240340921269
STAT,1864,23,25-29,1887,52.63127448902575
STAT,1795,70,na,1865,766.4099848009477
STAT,1857,33,35-39,1890,7.948915779209366
STAT,1865,32,30-34,1897,16.102329173080317
SIM,1836,36,50-100,1872,1
STAT,1799,84,na,1883,113.05405431149113
SIM,1847,42,50-100,1889,1
STAT,1882,33,45-49,1915,1.698864607510931
STAT,1910,16,30-34,1926,2.4426716825629655
STAT,1862,105,na,1967,0.19834405174893854
SIM,1893,50,na,1943,2829
STAT,1945,1,na,1946,4554.780188276471
SIM,1897,64,na,1961,2489
STAT,1815,42,45-49,1857,3.8816193788798836
SIM,1902,25,25-29,1927,67
SIM,1835,30,45-49,1865,2
STAT,1927,15,35-39,1942,5.297965522866272
SIM,1824,34,na,1858,1617
SIM,1871,30,30-34,1901,28
STAT,1843,17,30-34,1860,1.373793417361699
STAT,1874,43,na,1917,2372.9934002832942
STAT,1855,24,35-39,1879,5.05809130343015
STAT,1940,19,20-24,1959,138.87711935755482
STAT,1829,47,40-44,1876,0.12772819816484185
STAT,1894,21,45-49,1915,0.9094894667391831
STAT,1887,42,35-39,1929,2.0394428379484553
SIM,1907,21,45-49,1928,4
STAT,1797,107,na,1904,0.0011774481378324007
STAT,1853,16,25-29,1869,5.670655627287255
STAT,1878,57,na,1935,2107.0072116251686
STAT,1862,17,40-44,1879,0.18271183238759348
STAT,1920,49,15-19,1969,4.087950925366783E-4
STAT,1861,22,45-49,1883,0.6012481848991533
STAT,1854,52,25-29,1906,0.0026440819386445787
SIM,1826,43,25-29,1869,1
SIM,1851,17,30-34,1868,3
STAT,1939,31,40-44,1970,4.033240977334304
STAT,1842,37,30-34,1879,5.628889953732004
SIM,1844,24,25-29,1868,4
SIM,1875,27,50-100,1902,4
SIM,1906,31,50-100,1937,1
SIM,1879,24,na,1903,2708
STAT,1847,19,40-44,1866,0.1689149241873564
STAT,1879,50,25-29,1929,0.003786929773185859
STAT,1909,24,30-34,1933,26.786736059796663
SIM,1893,34,25-29,1927,19
STAT,1946,20,40-44,1966,3.7816782504397257
SIM,1855,33,na,1888,2084
STAT,1870,66,na,1936,1625.5509907749536
SIM,1824,66,na,1890,920
STAT,1885,34,25-29,1919,10.209115362544905
STAT,1823,51,30-34,1874,0.008044499578944687
STAT,1861,35,15-19,1896,0.04757700088023212
SIM,1845,43,35-39,1888,3
STAT,1933,26,15-19,1959,0.9476440465359164
STAT,1924,9,na,1933,4790.372987886883
STAT,1876,49,30-34,1925,0.09883949645691813
SIM,1862,6,na,1868,2523
STAT,1910,48,40-44,1958,0.1479973844705203
STAT,1837,43,35-39,1880,1.439178296388931
STAT,1831,38,45-49,1869,1.5761502928380438
STAT,1868,31,na,1899,2312.8977715288265
SIM,1847,42,30-34,1889,1
STAT,1836,24,25-29,1860,46.97832484580888
STAT,1876,30,40-44,1906,4.558866806057773
STAT,1853,39,35-39,1892,5.790271067035023
SIM,1914,27,20-24,1941,22
SIM,1914,40,40-44,1954,1
STAT,1887,20,15-19,1907,3.74232749765686
STAT,1827,30,45-49,1857,2.5659329927890413
STAT,1842,51,40-44,1893,0.00952375914728841
STAT,1858,10,na,1868,2237.3429771025026
STAT,1815,48,na,1863,1297.6822991199563
SIM,1870,81,na,1951,508
STAT,1854,40,30-34,1894,0.8715166306972528
SIM,1863,24,35-39,1887,4
STAT,1816,70,na,1886,828.9887338413635
STAT,1841,32,45-49,1873,1.5822086884434912
STAT,1853,65,na,1918,1397.5593378654664
SIM,1846,49,50-100,1895,2
SIM,1903,27,45-49,1930,2
STAT,1856,50,30-34,1906,0.0046755725017514375
SIM,1874,95,na,1969,52
SIM,1866,76,na,1942,908
STAT,1827,29,40-44,1856,4.952438353524446
STAT,1818,43,25-29,1861,1.219519911284952
SIM,1884,30,40-44,1914,10
STAT,1924,35,na,1959,4490.692270443561
SIM,1891,64,na,1955,2052
STAT,1899,19,na,1918,3482.0991630509616
STAT,1821,53,25-29,1874,0.004894885323014198
SIM,1933,21,na,1954,4629
SIM,1917,24,30-34,1941,43
STAT,1855,30,20-24,1885,2.1151657132219808
STAT,1949,16,25-29,1965,50.93167766146685
STAT,1920,42,na,1962,4142.136397073063
SIM,1867,33,45-49,1900,2
SIM,1920,19,45-49,1939,1
STAT,1875,53,45-49,1928,0.014810845104328091
STAT,1919,46,35-39,1965,0.14154642064443185
STAT,1867,48,15-19,1915,3.7570759868710523E-4
SIM,1835,29,40-44,1864,2
STAT,1876,48,40-44,1924,0.1762914167254211
STAT,1816,86,na,1902,113.43931042272746
STAT,1852,32,20-24,1884,2.1225074215614126
SIM,1861,16,25-29,1877,7
STAT,1882,46,15-19,1928,3.9244978051328487E-4
STAT,1906,27,20-24,1933,17.25817882274767
STAT,1917,30,15-19,1947,0.1369198142664772
STAT,1843,49,40-44,1892,0.11305798340699284
STAT,1838,33,25-29,1871,8.432105445508121
STAT,1853,16,50-100,1869,0.049025831263303725
STAT,1936,20,na,1956,3527.1378120303057
STAT,1912,19,45-49,1931,0.10136503636157645
SIM,1872,49,50-100,1921,2
STAT,1836,26,na,1862,1777.6464403105167
STAT,1862,51,20-24,1913,6.467077871506573E-4
STAT,1841,45,15-19,1886,3.082804834544247E-4
STAT,1864,22,50-100,1886,0.3776314679304764
STAT,1883,39,20-24,1922,0.754216910110083
STAT,1916,21,na,1937,3873.3281863820107
SIM,1873,8,na,1881,2621
STAT,1926,41,20-24,1967,0.02203549121762094
STAT,1946,21,30-34,1967,32.31394010768849
SIM,1885,28,40-44,1913,4
SIM,1876,27,25-29,1903,69
STAT,1857,48,30-34,1905,0.07534331328902359
STAT,1806,48,50-100,1854,0.7295910264156368
SIM,1818,37,40-44,1855,5
SIM,1838,58,na,1896,1398
STAT,1836,85,na,1921,172.84833394908296
STAT,1863,38,40-44,1901,3.8979522562026254
STAT,1937,20,15-19,1957,5.23682388541386
SIM,1846,33,25-29,1879,17
STAT,1920,15,25-29,1935,9.89619287974881
STAT,1863,26,35-39,1889,8.69717303162381
STAT,1880,27,50-100,1907,0.6785284315621666
STAT,1898,34,35-39,1932,13.7473518410011
SIM,1923,43,na,1966,4419
STAT,1916,49,25-29,1965,0.05458456844667575
SIM,1948,15,45-49,1963,2
STAT,1935,18,50-100,1953,0.5161143684657356
SIM,1903,39,na,1942,3160
STAT,1920,38,35-39,1958,2.671593695368794
STAT,1856,17,40-44,1873,0.1674685804356204
SIM,1852,84,na,1936,98
STAT,1941,31,45-49,1972,1.668947251776831
SIM,1885,18,15-19,1903,5
SIM,1871,38,40-44,1909,7
STAT,1897,12,na,1909,3496.869208187561
STAT,1845,62,na,1907,1335.4976360826806
STAT,1859,34,20-24,1893,2.176991296817778
STAT,1849,76,na,1925,740.7302888975204
SIM,1868,83,na,1951,229
SIM,1935,15,35-39,1950,4
STAT,1885,0,na,1885,3525.6544102170174
SIM,1948,22,45-49,1970,2
SIM,1830,34,25-29,1864,11
SIM,1938,30,25-29,1968,13
STAT,1839,17,40-44,1856,0.169631520914605
STAT,1853,81,na,1934,447.1995545633981
STAT,1897,44,45-49,1941,0.13882746166028018
STAT,1921,42,35-39,1963,0.22906684057853935
STAT,1953,18,50-100,1971,0.4577572771145002
SIM,1904,27,50-100,1931,1
SIM,1918,15,35-39,1933,4
STAT,1845,99,na,1944,1.3838222057868053
STAT,1861,37,40-44,1898,3.673951073630256
STAT,1852,37,15-19,1889,0.04281824757627958
STAT,1835,47,40-44,1882,0.13549421339233464
SIM,1891,80,na,1971,1050
STAT,1891,33,50-100,1924,1.1409100370972138
STAT,1822,32,35-39,1854,31.18230881476004
SIM,1919,33,30-34,1952,5
STAT,1866,39,20-24,1905,0.7136672183924128
SIM,1921,36,na,1957,4100
STAT,1867,43,20-24,1910,0.1499751674508326
STAT,1925,27,30-34,1952,46.77040602236699
SIM,1864,40,40-44,1904,5
STAT,1801,56,na,1857,1138.3171822784395
SIM,1892,18,30-34,1910,1
STAT,1864,52,30-34,1916,0.005396196795940012
SIM,1945,20,15-19,1965,4
STAT,1817,54,50-100,1871,0.029877804971116428
STAT,1877,28,40-44,1905,3.1116539500795595
STAT,1884,18,30-34,1902,1.583326788332674
STAT,1865,50,na,1915,2014.308204384439
STAT,1907,36,15-19,1943,0.018063943385323016
SIM,1935,1,na,1936,5611
STAT,1901,18,30-34,1919,2.250779377590496
SIM,1933,27,30-34,1960,72
SIM,1848,21,40-44,1869,2
STAT,1859,44,25-29,1903,0.5146057484674565
SIM,1830,32,35-39,1862,13
STAT,1937,17,50-100,1954,0.36795675139655587
STAT,1804,85,na,1889,84.99440991985728
STAT,1846,32,20-24,1878,2.4241373479654316
STAT,1873,52,35-39,1925,0.008767971859848274
SIM,1815,45,50-100,1860,1
SIM,1890,35,35-39,1925,17
SIM,1958,1,na,1959,5250
STAT,1862,50,30-34,1912,0.005266544805019833
SIM,1934,36,25-29,1970,1
SIM,1865,46,50-100,1911,3
SIM,1869,34,30-34,1903,41
SIM,1859,35,25-29,1894,3
SIM,1890,30,40-44,1920,8
STAT,1883,38,30-34,1921,5.241474598343424
STAT,1883,52,40-44,1935,0.010349834614877892
SIM,1871,44,na,1915,2170
STAT,1856,43,45-49,1899,1.1505459591552651
STAT,1930,20,na,1950,4756.579036994728
STAT,1946,15,45-49,1961,0.559898857136932
SIM,1917,36,25-29,1953,1
STAT,1846,49,45-49,1895,0.17535742718973701
SIM,1871,26,35-39,1897,9
SIM,1907,37,30-34,1944,4
STAT,1892,29,20-24,1921,14.761931425732714
STAT,1900,22,na,1922,3318.1895742148895
SIM,1854,26,35-39,1880,11
STAT,1920,47,50-100,1967,0.2524802881030685
STAT,1904,36,na,1940,3458.3081698757364
STAT,1882,30,40-44,1912,4.276920392426541
STAT,1893,32,50-100,1925,1.1750313009659248
SIM,1835,26,25-29,1861,37
STAT,1808,67,na,1875,774.9578498839028
STAT,1827,49,35-39,1876,0.13983905906440575
STAT,1846,41,35-39,1887,1.4087690038200675
STAT,1902,42,25-29,1944,0.06356702419387383
SIM,1890,40,30-34,1930,1
STAT,1867,20,35-39,1887,5.654612409825033
SIM,1899,41,40-44,1940,3
SIM,1819,66,na,1885,826
STAT,1825,63,na,1888,1328.749750953399
SIM,1854,48,na,1902,2086
STAT,1816,47,30-34,1863,0.25031436747934555
SIM,1843,48,na,1891,1993
SIM,1902,44,na,1946,3471
STAT,1816,48,20-24,1864,0.030570619133577247
SIM,1842,47,50-100,1889,2
SIM,1876,31,45-49,1907,3
STAT,1886,18,40-44,1904,0.1945355190805276
STAT,1926,36,25-29,1962,1.2172599375697113
STAT,1879,34,25-29,1913,10.703274646848193
SIM,1815,52,na,1867,1327
SIM,1823,71,na,1894,800
SIM,1899,23,na,1922,3564
SIM,1928,30,40-44,1958,6
STAT,1825,38,20-24,1863,1.2213359765431315
SIM,1918,16,25-29,1934,17
STAT,1894,18,15-19,1912,7.696687967471152
STAT,1882,40,30-34,1922,1.136124505120693
STAT,1861,38,30-34,1899,4.450822543873397
STAT,1924,48,20-24,1972,0.013257828933885031
SIM,1854,32,20-24,1886,3
SIM,1919,38,na,1957,3972
STAT,1878,44,35-39,1922,1.8729294031205472
STAT,1911,32,25-29,1943,9.0800607149157
SIM,1867,39,na,1906,2093
STAT,1817,44,na,1861,1360.9975966099673
SIM,1915,24,na,1939,4114
STAT,1902,49,45-49,1951,0.18603497532417362
STAT,1827,27,15-19,1854,1.352676695833693
STAT,1861,30,20-24,1891,2.2868589773368724
STAT,1836,27,40-44,1863,2.4452483565809904
SIM,1833,38,20-24,1871,3
SIM,1891,38,30-34,1929,15
STAT,1843,47,15-19,1890,2.685291288320888E-4
SIM,1860,42,50-100,1902,1
STAT,1846,26,35-39,1872,8.922387981047274
SIM,1871,35,25-29,1906,5
STAT,1852,47,40-44,1899,0.12923139582160048
STAT,1884,42,na,1926,2299.14913351343
STAT,1935,19,na,1954,5056.557591847612
SIM,1829,29,40-44,1858,5
SIM,1909,25,35-39,1934,30
SIM,1919,17,na,1936,3984
SIM,1844,27,40-44,1871,3
SIM,1939,32,45-49,1971,2
STAT,1800,71,na,1871,538.4819392327531
STAT,1863,104,na,1967,0.42679543657953095
STAT,1921,17,45-49,1938,0.5750927107314605
STAT,1929,21,30-34,1950,36.84704200790173
SIM,1832,38,50-100,1870,1
STAT,1907,23,45-49,1930,1.0310908416166775
SIM,1836,51,na,1887,1604
SIM,1886,44,35-39,1930,2
SIM,1937,21,30-34,1958,48
STAT,1828,53,35-39,1881,0.006756469743820119
SIM,1873,51,na,1924,2059
STAT,1846,84,na,1930,252.4530677681526
STAT,1883,23,35-39,1906,5.749799271296353
STAT,1904,40,30-34,1944,0.1168824192908597
SIM,1810,44,25-29,1854,5
SIM,1822,36,40-44,1858,1
STAT,1851,45,50-100,1896,0.18781931625606355
STAT,1878,46,25-29,1924,0.06056245560259803
STAT,1948,21,40-44,1969,3.9012407023303393
STAT,1833,30,45-49,1863,1.6277342110358635
STAT,1950,17,50-100,1967,0.44756669625654677
STAT,1878,41,30-34,1919,1.210829182266157
SIM,1939,28,25-29,1967,83
STAT,1885,39,30-34,1924,5.3040994595771425
STAT,1951,17,30-34,1968,14.664567254502298
SIM,1863,25,na,1888,2175
STAT,1840,28,45-49,1868,0.9634696923800482
STAT,1844,26,25-29,1870,41.26704340950982
STAT,1905,21,na,1926,3463.624941476744
SIM,1912,43,na,1955,3417
STAT,1927,21,20-24,1948,138.88793115347107
SIM,1864,49,50-100,1913,2
SIM,1828,33,30-34,1861,6
SIM,1847,62,na,1909,1293
STAT,1857,30,30-34,1887,14.138073913237712
SIM,1886,41,30-34,1927,2
STAT,1818,45,15-19,1863,7.33821886785107E-4
STAT,1866,24,na,1890,2198.0237973257845
SIM,1935,21,20-24,1956,8
STAT,1836,47,na,1883,1484.5426145715312
STAT,1864,65,na,1929,1540.2101622290436
STAT,1909,36,25-29,1945,0.9449711860745624
STAT,1850,14,na,1864,2213.478226487113
STAT,1910,19,35-39,1929,0.8343608595476609
STAT,1827,70,na,1897,834.3503013335403
SIM,1846,24,35-39,1870,5
STAT,1829,41,35-39,1870,1.4273212467690948
SIM,1891,23,35-39,1914,8
STAT,1844,29,40-44,1873,2.8598189511552934
SIM,1827,27,40-44,1854,3
STAT,1832,33,na,1865,1886.6725801485663
STAT,1934,30,15-19,1964,0.17748253132606617
SIM,1877,76,na,1953,886
SIM,1909,39,na,1948,3851
STAT,1821,50,20-24,1871,0.001082536194391446
STAT,1864,20,20-24,1884,64.74229676284898
STAT,1930,32,35-39,1962,11.919885924860855
SIM,1841,30,45-49,1871,2
SIM,1875,10,na,1885,2581
STAT,1833,47,30-34,1880,0.08051791842624331
STAT,1912,33,50-100,1945,0.817333204613997
SIM,1830,37,40-44,1867,3
SIM,1832,48,na,1880,1444
STAT,1795,108,na,1903,4.2409927976319513E-4
STAT,1923,42,45-49,1965,0.19654324587576252
SIM,1890,26,50-100,1916,1
SIM,1875,20,35-39,1895,10
STAT,1843,42,20-24,1885,0.11028625532697647
STAT,1865,46,15-19,1911,3.6994947207077066E-4
STAT,1941,28,15-19,1969,0.7369386823793467
SIM,1817,42,45-49,1859,3
SIM,1852,26,25-29,1878,69
SIM,1900,58,na,1958,3103
STAT,1856,49,50-100,1905,0.18620863911632915
STAT,1851,19,30-34,1870,1.4500848912778168
STAT,1903,29,45-49,1932,1.5856601430381516
SIM,1911,29,45-49,1940,2
SIM,1829,81,na,1910,307
STAT,1876,33,45-49,1909,1.8108584580817562
SIM,1905,25,na,1930,3606
STAT,1856,41,40-44,1897,1.7495991936836686
SIM,1832,31,30-34,1863,21
SIM,1920,33,50-100,1953,1
STAT,1881,27,40-44,1908,2.9163775380519983
STAT,1835,43,25-29,1878,0.5703694003098568
SIM,1824,32,35-39,1856,7
STAT,1822,37,40-44,1859,8.157058250361743
STAT,1882,26,50-100,1908,0.6279892148859219
STAT,1895,44,35-39,1939,0.16361645760205135
SIM,1861,66,na,1927,1402
SIM,1852,30,20-24,1882,1
SIM,1952,19,na,1971,4763
STAT,1857,47,na,1904,1765.1564388045283
STAT,1934,34,na,1968,5210.907286710235
STAT,1896,32,35-39,1928,13.539089259604085
SIM,1858,43,45-49,1901,1
STAT,1838,24,35-39,1862,4.995667828979917
STAT,1939,21,50-100,1960,0.6673334771582787
STAT,1861,31,50-100,1892,0.7721292411931123
STAT,1915,41,45-49,1956,0.16931792086413563
SIM,1872,29,na,1901,2597
STAT,1948,17,45-49,1965,0.5775025674354636
SIM,1891,43,na,1934,2923
STAT,1870,16,25-29,1886,5.707348937541045
SIM,1850,22,35-39,1872,5
SIM,1906,10,na,1916,3718
STAT,1848,32,na,1880,2063.5186614657932
STAT,1822,34,25-29,1856,22.879962307580012
SIM,1872,20,20-24,1892,98
STAT,1860,50,20-24,1910,6.18000961207063E-4
SIM,1890,79,na,1969,1442
STAT,1864,19,40-44,1883,0.17041740582638362
STAT,1818,51,50-100,1869,0.026350487143979293
SIM,1826,39,40-44,1865,8
SIM,1895,57,na,1952,2716
SIM,1893,31,20-24,1924,3
STAT,1854,43,35-39,1897,1.3491743593707823
STAT,1911,30,20-24,1941,2.415520933589689
STAT,1897,42,40-44,1939,0.21123591893965168
SIM,1882,28,na,1910,2102
SIM,1889,22,40-44,1911,2
STAT,1908,15,25-29,1923,8.524948888554167
STAT,1868,31,45-49,1899,1.6901746568825098
SIM,1895,33,20-24,1928,5
STAT,1930,30,30-34,1960,20.5738969338588
STAT,1818,39,40-44,1857,9.578713541272913
STAT,1842,22,35-39,1864,6.626697396514409
SIM,1811,86,na,1897,125
STAT,1785,92,na,1877,11.18240264486166
STAT,1887,33,20-24,1920,3.0352302854099573
SIM,1808,82,na,1890,115
STAT,1834,99,na,1933,1.1272836501739043
STAT,1904,42,35-39,1946,0.18203512983990683
STAT,1874,31,45-49,1905,1.810812769751235
SIM,1894,15,25-29,1909,11
STAT,1860,51,na,1911,1786.2181073711267
SIM,1858,40,40-44,1898,4
STAT,1866,27,15-19,1893,0.424317393287584
SIM,1819,82,na,1901,199
SIM,1911,38,35-39,1949,12
SIM,1894,24,50-100,1918,4
SIM,1849,30,35-39,1879,12
STAT,1818,48,30-34,1866,0.16980505108175087
STAT,1910,34,50-100,1944,0.7974213417057485
STAT,1898,45,15-19,1943,3.120188364658704E-4
STAT,1832,51,35-39,1883,0.006238108264462571
SIM,1843,44,50-100,1887,4
SIM,1893,4,na,1897,3452
STAT,1936,28,45-49,1964,1.6683758201221737
SIM,1868,24,na,1892,2172
SIM,1879,30,50-100,1909,1
SIM,1873,32,30-34,1905,34
STAT,1886,24,50-100,1910,0.4321425080048501
SIM,1864,10,na,1874,2899
SIM,1950,7,na,1957,4538
SIM,1887,75,na,1962,1172
STAT,1840,20,35-39,1860,5.277538858249289
SIM,1911,58,na,1969,3593
SIM,1916,15,25-29,1931,8
STAT,1818,40,20-24,1858,0.33362951808334596
SIM,1841,45,50-100,1886,5
STAT,1844,35,15-19,1879,0.05267474681567515
SIM,1815,40,45-49,1855,2
STAT,1885,31,20-24,1916,2.7285922989389078
SIM,1895,24,30-34,1919,47
STAT,1886,15,25-29,1901,6.071036019119444
STAT,1887,24,30-34,1911,19.960207360049566
SIM,1893,39,30-34,1932,9
STAT,1846,23,30-34,1869,16.55894057632715
STAT,1942,3,na,1945,4248.702126209606
STAT,1855,33,25-29,1888,7.769096700206396
SIM,1856,41,45-49,1897,5
SIM,1912,42,35-39,1954,1
STAT,1861,14,na,1875,2281.9989861014246
SIM,1799,66,na,1865,892
STAT,1897,41,40-44,1938,0.2124532762123484
SIM,1899,60,na,1959,2821
SIM,1859,38,40-44,1897,9
SIM,1882,31,45-49,1913,2
STAT,1840,15,na,1855,2108.0762158613675
STAT,1810,49,na,1859,1482.4471759577712
STAT,1835,32,45-49,1867,1.6669495905985332
SIM,1915,39,30-34,1954,5
SIM,1859,47,na,1906,2083
SIM,1917,27,35-39,1944,16
STAT,1954,15,50-100,1969,0.468180394179271
STAT,1820,41,15-19,1861,0.02697499267069771
STAT,1946,24,35-39,1970,10.575677644717624
SIM,1878,61,na,1939,2122
STAT,1923,40,40-44,1963,0.2962015135980627
SIM,1920,16,40-44,1936,5
STAT,1881,21,35-39,1902,5.69837392608558
STAT,1850,21,30-34,1871,16.48876644422462
SIM,1940,17,20-24,1957,164
STAT,1837,48,40-44,1885,0.11969679567812193
STAT,1903,38,35-39,1941,2.1850301317155556
STAT,1909,3,na,1912,4000.645671010479
STAT,1932,17,20-24,1949,181.42128700649303
STAT,1780,93,na,1873,5.91890516171927
STAT,1915,38,15-19,1953,0.01947783631104225
STAT,1892,17,15-19,1909,7.521326142345933
STAT,1957,15,20-24,1972,180.65990407962985
STAT,1859,41,20-24,1900,0.12959321298322726
SIM,1876,24,20-24,1900,67
STAT,1910,43,na,1953,3519.9838175037635
STAT,1914,57,na,1971,3514.706157615518
SIM,1844,70,na,1914,969
STAT,1841,30,40-44,1871,4.017369571191392
STAT,1907,39,30-34,1946,1.6890477669150072
STAT,1912,16,40-44,1928,0.28605328811941955
STAT,1875,50,40-44,1925,0.011076379411776818
SIM,1822,38,45-49,1860,2
SIM,1833,29,30-34,1862,22
SIM,1909,34,25-29,1943,10
STAT,1870,19,40-44,1889,0.18097822261825275
SIM,1837,63,na,1900,1079
SIM,1848,84,na,1932,236
SIM,1864,43,45-49,1907,1
STAT,1862,54,25-29,1916,0.0030044586639752418
STAT,1896,38,40-44,1934,5.823348533489435
SIM,1827,85,na,1912,119
STAT,1946,19,na,1965,4120.544178066882
STAT,1968,1,na,1969,4966.18944112066
SIM,1854,23,30-34,1877,31
STAT,1909,27,35-39,1936,14.478903453461967
SIM,1868,22,20-24,1890,2
SIM,1839,40,30-34,1879,4
SIM,1929,16,na,1945,4891
STAT,1900,30,45-49,1930,2.466268120894186
SIM,1878,42,35-39,1920,7
STAT,1852,19,50-100,1871,0.0444098141249612
STAT,1914,29,20-24,1943,18.433725662748234
SIM,1908,2,na,1910,3888
STAT,1829,77,na,1906,509.67838117815774
STAT,1838,30,20-24,1868,2.295672330624654
STAT,1842,33,15-19,1875,0.15328640730904058
STAT,1881,29,45-49,1910,1.073226994852043
STAT,1915,4,na,1919,4248.641188576249
STAT,1858,28,30-34,1886,20.279951850524355
SIM,1768,89,na,1857,18
SIM,1908,17,na,1925,3694
STAT,1898,31,30-34,1929,24.00369318182064
STAT,1830,37,na,1867,1777.0898406521264
STAT,1832,52,35-39,1884,0.006115775205385667
STAT,1859,46,15-19,1905,3.2585650465781013E-4
STAT,1863,35,25-29,1898,2.6010340336533466
STAT,1883,57,na,1940,1986.261671955371
SIM,1890,33,45-49,1923,2
STAT,1916,17,25-29,1933,9.278491958088766
SIM,1924,17,25-29,1941,60
STAT,1845,19,30-34,1864,1.454686878998453
SIM,1858,62,na,1920,1438
STAT,1880,42,25-29,1922,0.6803041082084056
STAT,1898,25,45-49,1923,1.53055055553948
SIM,1846,30,20-24,1876,2
SIM,1807,97,na,1904,5
STAT,1820,36,40-44,1856,11.548938029787442
STAT,1860,41,45-49,1901,1.2412569733495498
SIM,1829,44,na,1873,1687
STAT,1926,42,na,1968,4627.330248647792
SIM,1957,0,na,1957,5445
STAT,1944,28,40-44,1972,5.084627078959883
STAT,1837,40,30-34,1877,0.949523068626097
STAT,1853,20,45-49,1873,0.6912488991738953
SIM,1869,37,35-39,1906,13
SIM,1894,13,na,1907,3704
STAT,1840,51,30-34,1891,0.0041926283292167445
STAT,1813,51,25-29,1864,0.009994140531909263
STAT,1935,23,20-24,1958,152.93370012477172
SIM,1941,29,30-34,1970,61
STAT,1815,40,40-44,1855,6.2492906148286895
STAT,1859,49,30-34,1908,0.07699226412578541
STAT,1895,42,na,1937,3055.2024445319853
STAT,1903,49,15-19,1952,3.177772414602634E-4
SIM,1865,32,na,1897,2163
STAT,1811,71,na,1882,650.5533087145378
STAT,1899,56,na,1955,2827.2424811364585
STAT,1889,42,45-49,1931,1.8616122127365706
STAT,1913,25,35-39,1938,15.196157171970507
STAT,1922,30,35-39,1952,10.514722532612168
SIM,1898,38,na,1936,3211
STAT,1851,16,15-19,1867,5.495727682637383
SIM,1956,9,na,1965,5292
STAT,1896,27,na,1923,3190.5935173172097
SIM,1845,40,30-34,1885,4
STAT,1857,24,45-49,1881,0.5691787660533538
SIM,1858,29,50-100,1887,1
SIM,1885,37,30-34,1922,10
STAT,1827,33,na,1860,1706.69147050408
STAT,1892,13,na,1905,3267.94513901304
SIM,1880,80,na,1960,720
STAT,1885,36,15-19,1921,0.05672601700479038
SIM,1839,70,na,1909,820
SIM,1846,77,na,1923,499
SIM,1809,45,na,1854,1309
STAT,1824,31,30-34,1855,39.70071034280793
SIM,1842,63,na,1905,1210
STAT,1922,49,25-29,1971,0.06120173372420622
STAT,1877,37,30-34,1914,5.555676160399125
STAT,1844,77,na,1921,683.8934082034593
SIM,1866,28,30-34,1894,32
SIM,1922,29,20-24,1951,31
SIM,1844,33,na,1877,1645
STAT,1891,22,30-34,1913,22.273871580894802
SIM,1848,47,na,1895,1699
SIM,1921,25,35-39,1946,20
STAT,1861,33,25-29,1894,8.560137293639006
STAT,1884,46,25-29,1930,0.057532193785458284
SIM,1880,22,20-24,1902,70
STAT,1840,26,40-44,1866,2.637145247774858
SIM,1885,79,na,1964,911
SIM,1943,23,20-24,1966,116
STAT,1933,29,30-34,1962,52.52148344241164
STAT,1879,25,35-39,1904,10.238965277850511
STAT,1907,20,40-44,1927,3.1092045890312137
SIM,1904,3,na,1907,3990
SIM,1930,30,35-39,1960,14
STAT,1816,43,15-19,1859,0.038211648326652345
STAT,1836,51,50-100,1887,0.009832868859763234
STAT,1809,52,na,1861,1354.0198040614105
STAT,1837,45,25-29,1882,0.04184980347516705
SIM,1819,38,50-100,1857,1
STAT,1856,40,40-44,1896,1.7592928975491648
STAT,1920,20,50-100,1940,0.7431091213145326
STAT,1935,17,35-39,1952,5.7956666444102956
STAT,1765,106,na,1871,0.010508296937655658
STAT,1859,37,25-29,1896,2.338874296707574
STAT,1825,29,30-34,1854,102.44008302992427
SIM,1829,25,25-29,1854,41
STAT,1902,46,40-44,1948,0.1382233433214693
STAT,1879,31,20-24,1910,2.8606663494042346
STAT,1883,34,15-19,1917,0.139546603059955
STAT,1876,50,na,1926,2277.6832993103835
STAT,1821,51,20-24,1872,0.0010611954443067008
STAT,1888,16,25-29,1904,6.77196449256731
SIM,1865,30,30-34,1895,20
SIM,1888,43,30-34,1931,4
STAT,1846,25,na,1871,2014.848153166354
STAT,1907,47,50-100,1954,0.20452670725977123
SIM,1896,16,25-29,1912,10
STAT,1924,43,15-19,1967,0.0018429235073932518
SIM,1943,17,35-39,1960,5
STAT,1881,13,na,1894,2510.3446016282296
STAT,1861,42,15-19,1903,0.011576045832316586
STAT,1911,37,30-34,1948,1.775997392493107
SIM,1835,23,20-24,1858,61
STAT,1878,49,40-44,1927,0.17574772863455349
STAT,1868,28,15-19,1896,0.4364133193470642
SIM,1885,24,25-29,1909,65
SIM,1889,26,35-39,1915,14
STAT,1934,17,30-34,1951,16.658506851923697
STAT,1790,92,na,1882,9.938324113279359
SIM,1882,23,45-49,1905,3
SIM,1887,32,35-39,1919,1
SIM,1875,80,na,1955,513
SIM,1946,15,35-39,1961,5
STAT,1929,34,na,1963,4849.3962302284
STAT,1810,51,45-49,1861,0.05426213094171867
STAT,1882,42,35-39,1924,1.7694241192021452
STAT,1866,53,50-100,1919,0.01389779792817533
STAT,1858,30,35-39,1888,8.192943177248466
STAT,1913,21,40-44,1934,3.297283159905782
SIM,1821,43,25-29,1864,3
STAT,1912,39,15-19,1951,0.018719185287777218
STAT,1916,22,20-24,1938,117.58512103881418
STAT,1918,16,20-24,1934,29.962821595070196
STAT,1927,18,50-100,1945,0.46961132036926295
SIM,1935,27,40-44,1962,9
STAT,1828,36,50-100,1864,1.2935246446995703
SIM,1928,37,na,1965,4907
SIM,1924,22,20-24,1946,141
STAT,1866,26,15-19,1892,0.42577353879024665
STAT,1873,53,35-39,1926,0.008673365443480512
STAT,1784,86,na,1870,59.34922088942031
STAT,1904,43,35-39,1947,0.18094291906086737
STAT,1877,24,25-29,1901,59.30058984166076
SIM,1914,39,na,1953,3887
SIM,1928,24,30-34,1952,49
STAT,1840,25,40-44,1865,2.656216885009223
SIM,1926,38,40-44,1964,5
STAT,1900,27,15-19,1927,0.6365497239912611
STAT,1865,33,45-49,1898,1.6014636671381952
STAT,1919,28,45-49,1947,1.8781001548481164
STAT,1915,40,45-49,1955,0.16954341360422925
SIM,1841,68,na,1909,1093
STAT,1825,85,na,1910,200.0520440340665
SIM,1902,16,35-39,1918,4
STAT,1889,5,na,1894,3263.727991799004
SIM,1890,42,35-39,1932,8
STAT,1804,50,20-24,1854,0.002080694101232169
SIM,1848,30,30-34,1878,11
SIM,1839,32,30-34,1871,21
STAT,1933,38,20-24,1971,0.36246360766518915
STAT,1963,6,na,1969,5043.302800713749
SIM,1854,11,na,1865,2662
SIM,1917,32,30-34,1949,32
SIM,1823,40,40-44,1863,7
SIM,1907,25,25-29,1932,76
STAT,1836,63,na,1899,1125.0466283229673
STAT,1883,33,50-100,1916,0.9017692462594049
STAT,1922,38,45-49,1960,0.7828528106722924
SIM,1822,39,45-49,1861,1
SIM,1823,55,na,1878,1259
STAT,1907,48,20-24,1955,0.009913816281966453
SIM,1927,28,45-49,1955,3
SIM,1867,33,20-24,1900,5
SIM,1910,35,25-29,1945,1
STAT,1875,24,15-19,1899,3.400384313813654
SIM,1824,30,45-49,1854,3
STAT,1891,20,40-44,1911,2.62130493879319
STAT,1894,21,20-24,1915,89.8798915504773
STAT,1929,22,30-34,1951,36.73613241145796
SIM,1869,41,30-34,1910,6
SIM,1953,18,45-49,1971,4
STAT,1796,71,na,1867,580.4667222792756
SIM,1926,16,20-24,1942,159
SIM,1938,28,20-24,1966,27
STAT,1878,53,25-29,1931,0.0036540138365425295
SIM,1849,58,na,1907,1578
SIM,1930,38,45-49,1968,1
SIM,1933,15,25-29,1948,68
SIM,1890,31,40-44,1921,8
STAT,1912,42,30-34,1954,0.12440009353045653
STAT,1952,17,35-39,1969,5.080553372483762
STAT,1882,31,40-44,1913,4.260154864488229
STAT,1883,21,45-49,1904,0.6912934464005974
SIM,1891,21,45-49,1912,1
SIM,1930,0,na,1930,5659
STAT,1885,43,15-19,1928,0.013783251063201413
STAT,1876,45,15-19,1921,4.2129550100886246E-4
SIM,1878,39,na,1917,2701
STAT,1935,0,na,1935,6222.446205500585
STAT,1890,27,na,1917,2945.353499005483
STAT,1902,35,25-29,1937,0.8953935889147479
STAT,1865,20,25-29,1885,54.21257596500031
STAT,1911,12,na,1923,3987.0988881439393
SIM,1874,20,30-34,1894,21
STAT,1918,2,na,1920,4494.1686460488
STAT,1945,18,45-49,1963,0.5509118582405506
STAT,1853,53,50-100,1906,0.01228908515506122
SIM,1859,39,40-44,1898,6
STAT,1825,39,20-24,1864,1.173217440705962
STAT,1905,49,25-29,1954,0.04644976873694907
SIM,1853,53,na,1906,1584
SIM,1876,31,20-24,1907,3
STAT,1902,48,45-49,1950,0.18761469102258382
STAT,1883,15,35-39,1898,0.5448481246435082
STAT,1859,36,25-29,1895,2.3501314262392614
STAT,1862,95,na,1957,15.346100870857075
STAT,1911,33,25-29,1944,9.041742858698754
STAT,1827,30,20-24,1857,3.9773938208994286
STAT,1868,52,50-100,1920,0.014500937163761567
STAT,1886,19,40-44,1905,0.194000546403056
SIM,1893,28,na,1921,3063
SIM,1835,50,na,1885,1345
SIM,1937,22,30-34,1959,37
STAT,1822,109,na,1931,3.977939377215326E-4
STAT,1908,44,50-100,1952,0.10837183873658471
SIM,1908,34,30-34,1942,25
SIM,1855,20,20-24,1875,64
STAT,1929,17,35-39,1946,5.412681883232894
STAT,1881,52,30-34,1933,0.005764345762314604
STAT,1817,40,50-100,1857,2.823391338091202
STAT,1879,23,20-24,1902,72.40931806213341
SIM,1838,23,25-29,1861,53
SIM,1939,25,45-49,1964,3
SIM,1919,4,na,1923,4425
STAT,1836,20,45-49,1856,0.6736567481820516
STAT,1896,37,40-44,1933,5.852376320036818
STAT,1907,16,45-49,1923,0.09712611855458406
STAT,1918,38,40-44,1956,1.5913531617229202
SIM,1864,41,40-44,1905,3
STAT,1791,106,na,1897,0.002158970777717194
STAT,1863,30,30-34,1893,15.750114572669991
STAT,1828,34,na,1862,1833.238156822639
SIM,1789,88,na,1877,40
SIM,1830,38,40-44,1868,6
STAT,1862,52,20-24,1914,6.402019068119215E-4
SIM,1862,30,na,1892,2168
STAT,1877,45,na,1922,2368.667986773527
STAT,1840,68,na,1908,1071.247616710721
STAT,1822,38,40-44,1860,7.8051328952220365
SIM,1907,29,30-34,1936,45
STAT,1813,42,50-100,1855,3.840464286892985
SIM,1866,30,35-39,1896,14
STAT,1847,51,40-44,1898,0.007920155482581666
STAT,1848,41,45-49,1889,1.2361766315349525
STAT,1900,49,35-39,1949,0.10848473851984533
STAT,1924,36,15-19,1960,0.022902975909299864
STAT,1843,33,na,1876,1739.1417883541312
STAT,1846,33,35-39,1879,8.988263279275074
SIM,1898,43,na,1941,3147
STAT,1813,43,25-29,1856,2.1637003578799225
STAT,1815,51,35-39,1866,0.018618069961325572
SIM,1835,30,20-24,1865,2
SIM,1888,41,40-44,1929,5
SIM,1841,22,45-49,1863,2
STAT,1885,64,na,1949,1747.6372922522169
STAT,1925,39,25-29,1964,1.191747924895579
STAT,1898,23,30-34,1921,24.31337305352904
SIM,1826,79,na,1905,537
SIM,1827,28,40-44,1855,2
SIM,1880,20,30-34,1900,18
STAT,1948,22,40-44,1970,3.899953292898571
STAT,1879,32,35-39,1911,10.673925781233041
SIM,1878,20,15-19,1898,4
SIM,1906,17,20-24,1923,31
STAT,1920,43,50-100,1963,0.13081804664408353
STAT,1880,34,25-29,1914,10.771420948450302
SIM,1844,20,45-49,1864,2
SIM,1942,17,30-34,1959,20
SIM,1889,31,30-34,1920,6
SIM,1909,37,40-44,1946,1
STAT,1905,22,45-49,1927,1.0181568579430784
SIM,1913,22,45-49,1935,2
STAT,1830,40,20-24,1870,0.1419404783343906
STAT,1916,22,50-100,1938,0.6958111929755337
STAT,1930,33,35-39,1963,11.912495595587444
SIM,1937,17,35-39,1954,4
STAT,1847,20,20-24,1867,64.1714975201026
SIM,1837,33,35-39,1870,14
STAT,1839,30,25-29,1869,9.123921562229576
STAT,1853,20,20-24,1873,68.31236464440937
STAT,1874,22,30-34,1896,18.42127782548447
SIM,1919,35,45-49,1954,3
STAT,1861,30,na,1891,2018.8820768101007
SIM,1906,23,40-44,1929,6
SIM,1882,21,50-100,1903,1
SIM,1902,21,30-34,1923,32
SIM,1911,27,40-44,1938,8
STAT,1870,20,20-24,1890,68.7543959465077
STAT,1896,24,35-39,1920,7.752737797879682
STAT,1899,25,15-19,1924,0.63316728697915
STAT,1838,31,35-39,1869,8.511938206768491
STAT,1913,48,20-24,1961,0.010852839743067172
STAT,1815,85,na,1900,118.66687032686495
STAT,1857,22,30-34,1879,16.20887053879949
SIM,1883,9,na,1892,2939
STAT,1918,25,35-39,1943,16.240119700380173
STAT,1885,20,40-44,1905,2.107431191926627
STAT,1855,31,35-39,1886,7.842652284405917
SIM,1869,78,na,1947,800
SIM,1887,23,20-24,1910,86
STAT,1859,33,45-49,1892,1.4105908841797272
STAT,1957,15,45-49,1972,0.6656590558423958
SIM,1855,3,na,1858,2810
STAT,1917,46,25-29,1963,0.0560655458602351
SIM,1838,64,na,1902,1331
STAT,1939,27,45-49,1966,1.7533270929736138
STAT,1854,66,na,1920,1230.055090279116
STAT,1935,25,35-39,1960,20.69495053233795
SIM,1878,45,na,1923,2637
SIM,1941,2,na,1943,4356
STAT,1844,42,15-19,1886,0.011190168811687648
SIM,1852,25,25-29,1877,48
STAT,1833,22,45-49,1855,0.6656346255348761
STAT,1906,43,na,1949,3387.168985258631
SIM,1783,73,na,1856,492
STAT,1828,50,na,1878,1558.278575810628
SIM,1847,30,25-29,1877,13
SIM,1872,21,35-39,1893,8
STAT,1851,52,45-49,1903,0.010930124686919878
SIM,1846,83,na,1929,154
STAT,1839,28,na,1867,1918.2450796188646
STAT,1835,32,20-24,1867,2.583900288912393
STAT,1928,35,45-49,1963,0.8723307914260322
STAT,1842,97,na,1939,4.83681635502495
SIM,1897,34,45-49,1931,4
STAT,1821,109,na,1930,4.2615865615679523E-4
SIM,1943,25,35-39,1968,23
STAT,1844,25,25-29,1869,41.565483581625884
STAT,1866,51,na,1917,2023.3474079679913
SIM,1823,49,na,1872,1417
STAT,1834,51,45-49,1885,0.009039187300335387
STAT,1818,49,30-34,1867,0.16729514745301227
STAT,1892,35,50-100,1927,1.5707932957995818
STAT,1850,22,45-49,1872,0.6408733244575197
STAT,1903,27,40-44,1930,4.308858840042788
STAT,1904,17,45-49,1921,0.09467966700370536
STAT,1886,28,na,1914,2536.0133762414025
STAT,1953,17,40-44,1970,1.7095079593510134
SIM,1841,78,na,1919,485
STAT,1828,51,30-34,1879,0.005341353432684058
STAT,1840,29,45-49,1869,0.9565519799887593
SIM,1865,22,30-34,1887,18
SIM,1934,24,30-34,1958,46
SIM,1832,85,na,1917,157
SIM,1893,20,40-44,1913,4
STAT,1885,23,20-24,1908,69.06625362894992
STAT,1926,24,30-34,1950,35.068626707670866
SIM,1814,48,50-100,1862,1
STAT,1848,44,50-100,1892,0.8509062752334312
STAT,1851,15,15-19,1866,5.528289306653574
STAT,1864,21,35-39,1885,5.442986315338178
STAT,1865,103,na,1968,0.993368051174181
STAT,1883,3,na,1886,2939.3976172013913
STAT,1895,42,30-34,1937,0.10517022257914749
STAT,1849,23,35-39,1872,5.476577606835932
STAT,1929,28,15-19,1957,0.8925828977299481
SIM,1873,30,40-44,1903,5
SIM,1833,33,na,1866,1931
STAT,1845,54,25-29,1899,0.0025169283593238123
STAT,1828,54,25-29,1882,0.002725224674855659
SIM,1886,74,na,1960,1485
STAT,1868,23,45-49,1891,0.6710382144703075
STAT,1861,20,na,1881,2068.805744588369
STAT,1899,72,na,1971,2174.7420865456133
STAT,1949,18,15-19,1967,53.30682474728354
SIM,1945,25,45-49,1970,6
STAT,1856,52,35-39,1908,0.006630904140247329
SIM,1893,23,20-24,1916,91
STAT,1848,39,15-19,1887,0.04627604401769986
SIM,1901,28,25-29,1929,69
SIM,1866,24,15-19,1890,3
STAT,1844,30,20-24,1874,2.6110957176566325
STAT,1907,24,20-24,1931,101.57306051646172
STAT,1854,41,30-34,1895,0.8667145740621113
SIM,1826,32,20-24,1858,3
STAT,1871,41,20-24,1912,0.16007789274099446
STAT,1943,24,30-34,1967,30.85493586595754
STAT,1886,12,na,1898,2753.9696522386466
STAT,1833,98,na,1931,2.298329113054967
SIM,1928,15,na,1943,4769
SIM,1931,19,na,1950,4746
SIM,1896,58,na,1954,2629
STAT,1879,58,na,1937,2084.3873950400994
STAT,1881,26,40-44,1907,2.9263857774107436
STAT,1873,79,na,1952,715.8205567542484
STAT,1889,34,45-49,1923,2.153152410058362
STAT,1924,24,20-24,1948,131.7569243291577
SIM,1930,27,50-100,1957,1
STAT,1944,17,na,1961,3999.8971677154486
SIM,1853,63,na,1916,1325
STAT,1908,27,30-34,1935,37.70810870318266
STAT,1894,47,na,1941,2912.4498789780773
SIM,1846,31,35-39,1877,20
SIM,1926,25,35-39,1951,20
SIM,1936,8,na,1944,3951
STAT,1875,52,45-49,1927,0.014972397270880898
SIM,1878,23,na,1901,2660
SIM,1898,24,35-39,1922,8
STAT,1859,27,50-100,1886,0.5286144687480022
SIM,1861,20,20-24,1881,3
SIM,1915,24,20-24,1939,124
STAT,1824,38,50-100,1862,1.6573216163408173
STAT,1837,49,40-44,1886,0.11817305546913943
STAT,1890,36,50-100,1926,1.5225249208171923
SIM,1916,27,30-34,1943,51
SIM,1878,34,35-39,1912,19
STAT,1938,15,35-39,1953,4.198132298409842
SIM,1879,24,25-29,1903,70
STAT,1849,34,15-19,1883,0.11491508115818445
STAT,1923,43,45-49,1966,0.1962327075472788
SIM,1932,24,20-24,1956,185
SIM,1847,43,45-49,1890,5
STAT,1870,15,25-29,1885,5.741164395832497
STAT,1895,45,25-29,1940,0.043281941261143785
STAT,1806,49,na,1855,1206.5483591599757
SIM,1910,32,20-24,1942,2
SIM,1850,47,50-100,1897,2
STAT,1874,80,na,1954,639.7458453286275
STAT,1892,16,15-19,1908,7.539798649036075
STAT,1927,27,40-44,1954,5.727374693592628
SIM,1863,31,35-39,1894,10
SIM,1921,21,40-44,1942,6
SIM,1894,28,50-100,1922,2
STAT,1910,28,25-29,1938,63.8998208696412
SIM,1878,55,na,1933,2335
STAT,1876,33,20-24,1909,2.806970120396282
STAT,1918,49,35-39,1967,0.1377027609105903
STAT,1945,27,50-100,1972,1.102805008232669
SIM,1876,23,45-49,1899,1
STAT,1839,43,45-49,1882,1.1040925945085145
STAT,1825,79,na,1904,510.17828877122986
STAT,1894,57,na,1951,2613.1942639368344
STAT,1820,48,na,1868,1295.2445028005527
SIM,1846,22,20-24,1868,76
STAT,1937,25,45-49,1962,1.7016140907545303
SIM,1861,82,na,1943,340
STAT,1841,16,na,1857,2227.0354667602232
SIM,1822,35,40-44,1857,6
STAT,1838,22,20-24,1860,59.851342463815875
STAT,1909,35,35-39,1944,2.3322001046557905
SIM,1873,24,na,1897,2290
STAT,1913,24,45-49,1937,1.1392115432517924
SIM,1856,33,45-49,1889,1
STAT,1848,31,50-100,1879,0.8814959992861164
STAT,1887,47,40-44,1934,0.19215296313077423
SIM,1900,38,35-39,1938,4
STAT,1868,25,na,1893,2319.3180842405955
STAT,1870,29,30-34,1899,24.796610281021934
STAT,1920,27,30-34,1947,43.40504302482555
SIM,1811,43,50-100,1854,1
SIM,1878,37,50-100,1915,3
STAT,1931,10,na,1941,5257.3162041968835
STAT,1838,25,25-29,1863,36.5443250211481
STAT,1792,89,na,1881,36.581216817827176
SIM,1871,50,na,1921,2066
STAT,1935,16,20-24,1951,187.71513447524498
STAT,1901,44,na,1945,3239.363743463161
STAT,1845,83,na,1928,290.0728570445671
STAT,1824,49,30-34,1873,0.11019295123276701
STAT,1872,20,30-34,1892,18.194881457552114
SIM,1943,16,20-24,1959,141
SIM,1871,34,25-29,1905,12
STAT,1764,106,na,1870,0.0067160830374838575
SIM,1929,15,35-39,1944,8
STAT,1806,50,40-44,1856,0.031620767705394535
STAT,1911,16,35-39,1927,0.8492247962260299
STAT,1904,58,na,1962,3013.145263751445
SIM,1917,35,35-39,1952,7
STAT,1854,44,25-29,1898,0.4754250718178244
STAT,1842,18,15-19,1860,6.820807144483059
SIM,1906,45,50-100,1951,2
SIM,1945,24,30-34,1969,35
SIM,1832,32,45-49,1864,2
STAT,1859,81,na,1940,439.28224566478747
STAT,1822,39,50-100,1861,2.092048975501452
STAT,1882,1,na,1883,3287.7704058614177
STAT,1914,17,15-19,1931,9.471860302418651
SIM,1841,84,na,1925,182
SIM,1889,43,50-100,1932,2
STAT,1830,43,25-29,1873,0.5501193318803143
SIM,1922,17,15-19,1939,59
STAT,1869,52,30-34,1921,0.005814039741896262
STAT,1861,52,na,1913,1797.4906544132623
STAT,1898,26,35-39,1924,13.256735461676143
STAT,1937,24,30-34,1961,28.236248430581007
STAT,1873,50,30-34,1923,0.006182458267675679
SIM,1898,26,50-100,1924,4
SIM,1921,24,45-49,1945,2
SIM,1942,4,na,1946,4455
STAT,1912,45,35-39,1957,0.12559808447069573
SIM,1840,40,40-44,1880,3
STAT,1916,29,30-34,1945,40.59265227197165
STAT,1916,35,50-100,1951,0.43801787942626647
SIM,1954,17,35-39,1971,8
SIM,1869,44,35-39,1913,9
STAT,1835,31,50-100,1866,0.8849968820211698
SIM,1916,19,30-34,1935,16
STAT,1804,53,25-29,1857,0.00940042372310609
SIM,1861,36,30-34,1897,10
STAT,1819,51,na,1870,1294.3747898161055
SIM,1892,20,35-39,1912,8
SIM,1893,26,25-29,1919,99
SIM,1950,19,30-34,1969,20
STAT,1877,36,50-100,1913,1.2859875666438338
STAT,1942,19,30-34,1961,12.852214740839878
SIM,1928,27,35-39,1955,21
STAT,1944,16,50-100,1960,0.4072541163086692
SIM,1885,21,45-49,1906,1
SIM,1863,23,35-39,1886,8
STAT,1855,23,35-39,1878,5.094671041508176
SIM,1858,2,na,1860,2783
STAT,1868,101,na,1969,4.002036242441247
STAT,1900,46,30-34,1946,0.07682649203901523
STAT,1845,15,15-19,1860,5.5458338791529975
STAT,1857,31,45-49,1888,1.3974801369495224
STAT,1848,33,45-49,1881,1.4953156017114602
STAT,1909,48,40-44,1957,0.14578686169262253
STAT,1844,22,45-49,1866,0.6888456539478625
SIM,1918,27,40-44,1945,6
STAT,1889,33,30-34,1922,21.65247001319089
SIM,1869,46,na,1915,2198
STAT,1844,82,na,1926,369.15264655906816
SIM,1880,29,40-44,1909,3
SIM,1833,49,na,1882,1608
STAT,1865,30,40-44,1895,4.031711877115829
SIM,1880,0,na,1880,3641
SIM,1889,23,30-34,1912,27
STAT,1932,40,45-49,1972,0.22858517411749196
STAT,1831,39,20-24,1870,0.60284467397949
STAT,1884,20,35-39,1904,5.846787338828065
SIM,1826,35,25-29,1861,3
STAT,1872,29,40-44,1901,3.0200181366556755
SIM,1881,41,40-44,1922,5
SIM,1901,25,20-24,1926,17
STAT,1871,44,25-29,1915,0.6356583181384231
STAT,1911,25,25-29,1936,65.19820177970085
STAT,1933,20,50-100,1953,0.8872383152859152
STAT,1944,15,35-39,1959,4.562387544633723
STAT,1946,23,45-49,1969,1.2642027924349748
STAT,1953,16,na,1969,4499.879003677477
STAT,1931,28,45-49,1959,2.253092473618809
SIM,1805,68,na,1873,689
SIM,1941,20,50-100,1961,1
STAT,1832,97,na,1929,3.658089699893847
STAT,1885,26,25-29,1911,42.673156415773896
STAT,1861,106,na,1967,0.08636881334824825
STAT,1946,17,35-39,1963,4.700658930378978
SIM,1835,34,na,1869,1596
STAT,1858,52,45-49,1910,0.011438224738603
SIM,1803,67,na,1870,680
SIM,1906,34,20-24,1940,3
SIM,1853,15,15-19,1868,8
STAT,1767,104,na,1871,0.025381945098832938
STAT,1774,92,na,1866,7.00140783402993
STAT,1845,30,na,1875,1922.3965531694566
STAT,1916,43,na,1959,3834.7673534164783
STAT,1864,44,na,1908,2078.001368663058
STAT,1820,39,45-49,1859,4.228141987333315
STAT,1872,95,na,1967,53.62500050297862
SIM,1787,71,na,1858,612
SIM,1865,31,45-49,1896,2
STAT,1879,74,na,1953,1169.7169602108793
STAT,1848,32,30-34,1880,16.62402109736661
STAT,1894,41,na,1935,3018.9854671811217
STAT,1928,32,40-44,1960,4.945857065626896
STAT,1941,2,na,1943,4228.52891988997
SIM,1845,34,na,1879,1981
STAT,1807,66,na,1873,794.5940912543991
SIM,1920,28,35-39,1948,23
STAT,1923,19,20-24,1942,159.98930040613402
STAT,1822,54,50-100,1876,0.02072743902692438
STAT,1853,36,30-34,1889,4.453439779339636
SIM,1830,33,25-29,1863,13
STAT,1857,36,15-19,1893,0.044476557626566805
STAT,1912,28,35-39,1940,14.874329414172541
STAT,1873,41,40-44,1914,2.3134758355380836
SIM,1830,35,na,1865,1635
STAT,1829,33,35-39,1862,8.794634417809755
SIM,1821,48,na,1869,1307
STAT,1903,45,50-100,1948,0.20126282103716941
SIM,1833,45,50-100,1878,2
SIM,1856,32,30-34,1888,27
SIM,1850,18,15-19,1868,7
SIM,1952,15,35-39,1967,5
STAT,1774,86,na,1860,43.55007833510381
STAT,1917,34,30-34,1951,16.510449187528483
SIM,1876,6,na,1882,3087
STAT,1874,23,45-49,1897,0.7189343200750459
STAT,1837,52,25-29,1889,0.0024251898945505286
SIM,1848,22,30-34,1870,19
SIM,1941,17,25-29,1958,59
STAT,1909,48,30-34,1957,0.0824308892406241
STAT,1824,32,45-49,1856,3.403857116984007
STAT,1933,17,25-29,1950,58.62037587556491
STAT,1940,19,na,1959,3770.3962563932937
STAT,1847,96,na,1943,6.429148440371961
SIM,1872,15,25-29,1887,9
STAT,1844,22,20-24,1866,68.07486500512333
STAT,1846,30,30-34,1876,15.98667467661495
SIM,1852,39,30-34,1891,1
STAT,1864,15,25-29,1879,5.94081767897708
STAT,1877,21,45-49,1898,0.7290988556381671
STAT,1844,39,30-34,1883,4.364286335691403
SIM,1839,35,35-39,1874,8
SIM,1908,60,na,1968,2993
SIM,1908,37,35-39,1945,5
STAT,1891,23,45-49,1914,0.8692909836198269
SIM,1888,31,25-29,1919,14
STAT,1811,54,30-34,1865,0.013620608564835565
SIM,1925,34,30-34,1959,27
SIM,1859,34,25-29,1893,7
STAT,1897,34,50-100,1931,1.2300284016766572
SIM,1852,22,20-24,1874,72
STAT,1874,27,na,1901,2468.1174957655844
STAT,1830,40,50-100,1870,0.9442127291817404
STAT,1879,30,50-100,1909,0.9734852665154221
SIM,1887,30,50-100,1917,7
SIM,1839,41,45-49,1880,4
SIM,1934,27,35-39,1961,29
STAT,1935,22,30-34,1957,39.54286750805712
SIM,1921,1,na,1922,4668
SIM,1887,26,25-29,1913,53
STAT,1931,39,25-29,1970,1.315065244106414
STAT,1898,32,45-49,1930,2.3876566357102447
SIM,1841,21,30-34,1862,27
STAT,1885,23,45-49,1908,0.6988774585624573
STAT,1797,87,na,1884,60.002118808668456
STAT,1851,29,20-24,1880,10.251838135844402
SIM,1871,42,25-29,1913,1
STAT,1888,21,20-24,1909,82.39941123166352
SIM,1891,19,15-19,1910,9
STAT,1915,17,20-24,1932,28.632120598278217
STAT,1875,38,na,1913,2431.5401599893003
STAT,1932,38,15-19,1970,0.02604826369131634
STAT,1857,25,35-39,1882,7.9477225667221845
SIM,1845,38,50-100,1883,4
SIM,1921,42,na,1963,4103
STAT,1886,16,15-19,1902,6.344106463754269
STAT,1899,31,35-39,1930,14.095018092298368
SIM,1854,30,30-34,1884,28
STAT,1905,16,50-100,1921,0.07170856153660671
STAT,1868,47,30-34,1915,0.09300453376733644
STAT,1883,19,15-19,1902,5.834084178634895
STAT,1845,18,40-44,1863,0.1679203386458423
STAT,1927,37,na,1964,4727.806859487613
STAT,1919,4,na,1923,4503.4861253209965
STAT,1901,27,20-24,1928,16.610062587052532
STAT,1904,35,35-39,1939,2.233737774868457
STAT,1805,49,20-24,1854,0.05006207247501086
SIM,1896,21,20-24,1917,101
STAT,1835,44,15-19,1879,0.012109863128012975
SIM,1878,29,na,1907,2759
SIM,1912,22,na,1934,3518
SIM,1923,17,20-24,1940,173
SIM,1936,32,40-44,1968,7
STAT,1837,38,50-100,1875,1.0092389360398466
STAT,1926,27,35-39,1953,18.189686901490116
SIM,1826,32,45-49,1858,4
STAT,1863,42,25-29,1905,0.5739522581777432
SIM,1902,24,35-39,1926,10
STAT,1786,71,na,1857,608.6738956038131
SIM,1845,12,na,1857,2413
STAT,1843,98,na,1941,2.1910363967017195
STAT,1926,44,25-29,1970,0.08867569469063012
SIM,1791,86,na,1877,33
STAT,1879,26,25-29,1905,44.73869644392813
STAT,1846,46,40-44,1892,0.1302899619825788
STAT,1795,91,na,1886,21.917800648878334
STAT,1866,20,30-34,1886,17.038440419844665
SIM,1867,30,40-44,1897,1
SIM,1931,19,20-24,1950,171
SIM,1838,80,na,1918,428
STAT,1907,24,45-49,1931,1.0278119727403368
SIM,1943,22,30-34,1965,45
STAT,1879,35,50-100,1914,1.3063303162751074
STAT,1870,32,15-19,1902,0.1412382565539807
STAT,1870,23,25-29,1893,56.6000881639011
STAT,1904,42,na,1946,3357.3850190560042
SIM,1888,23,na,1911,2811
SIM,1798,65,na,1863,839
STAT,1925,5,na,1930,4908.634506859724
STAT,1924,19,na,1943,4405.477701278855
STAT,1887,23,na,1910,2658.6966399528096
SIM,1903,61,na,1964,2605
SIM,1852,22,45-49,1874,4
STAT,1906,48,15-19,1954,3.2775896282488524E-4
STAT,1841,41,35-39,1882,1.4252781053905723
STAT,1859,30,40-44,1889,3.574187118833703
SIM,1862,41,30-34,1903,1
SIM,1925,46,50-100,1971,5
SIM,1828,86,na,1914,83
STAT,1855,83,na,1938,298.82038583215063
STAT,1841,32,na,1873,1966.396507170758
STAT,1863,33,35-39,1896,9.024363541165396
STAT,1870,50,na,1920,2166.174237967292
STAT,1925,15,25-29,1940,53.15020867525995
STAT,1930,25,35-39,1955,19.311929637231934
SIM,1886,58,na,1944,2205
SIM,1891,27,na,1918,3195
SIM,1905,38,50-100,1943,1
STAT,1832,40,40-44,1872,1.928440657985103
SIM,1924,29,30-34,1953,3
STAT,1902,23,30-34,1925,25.344203883475352
SIM,1847,40,40-44,1887,6
SIM,1897,33,30-34,1930,34
STAT,1859,50,50-100,1909,0.012444804225186297
SIM,1895,31,30-34,1926,28
SIM,1916,17,15-19,1933,7
SIM,1828,40,30-34,1868,3
STAT,1917,46,50-100,1963,0.2390572597294015
STAT,1940,18,50-100,1958,0.38391409939642906
STAT,1907,60,na,1967,3077.56764814742
STAT,1880,31,30-34,1911,18.595388754534675
STAT,1927,17,25-29,1944,54.461075035622656
SIM,1935,17,25-29,1952,106
STAT,1895,49,40-44,1944,0.124714222204876
SIM,1912,35,35-39,1947,4
SIM,1894,45,na,1939,3213
STAT,1845,51,20-24,1896,5.417672039199836E-4
SIM,1896,74,na,1970,1895
SIM,1805,52,na,1857,1063
STAT,1909,32,30-34,1941,15.171479582838032
STAT,1786,93,na,1879,7.172038978233697
STAT,1908,19,30-34,1927,2.3739070222527427
STAT,1842,20,45-49,1862,0.8033644610171176
STAT,1840,84,na,1924,233.1927915133065
STAT,1859,33,20-24,1892,2.186524543828872
STAT,1887,31,30-34,1918,19.768838745612907
SIM,1865,25,35-39,1890,7
STAT,1911,22,na,1933,3651.364705126066
STAT,1908,17,15-19,1925,8.886568845571782
SIM,1808,66,na,1874,721
STAT,1839,40,40-44,1879,1.8948793507388426
SIM,1910,23,30-34,1933,28
SIM,1827,48,50-100,1875,1
SIM,1846,25,25-29,1871,56
SIM,1919,34,30-34,1953,23
STAT,1844,33,25-29,1877,9.590669419971002
STAT,1850,39,30-34,1889,4.0603503510682994
SIM,1893,23,45-49,1916,1
SIM,1938,15,na,1953,3511
SIM,1821,40,30-34,1861,4
STAT,1907,27,25-29,1934,62.74264617543337
STAT,1841,36,50-100,1877,1.0930213576246033
SIM,1844,23,25-29,1867,1
STAT,1894,63,na,1957,2369.7733932707506
STAT,1905,38,45-49,1943,0.6251292921742387
SIM,1867,36,25-29,1903,3
STAT,1854,110,na,1964,0.001089650558600074
SIM,1928,33,45-49,1961,2
STAT,1822,41,25-29,1863,1.047116830421087
STAT,1950,6,na,1956,4696.210705471675
SIM,1905,29,20-24,1934,19
STAT,1894,37,30-34,1931,6.93023848470362
STAT,1855,61,na,1916,1406.560944098769
STAT,1913,40,35-39,1953,0.20037601323347037
SIM,1833,27,na,1860,1945
SIM,1915,27,25-29,1942,83
SIM,1941,19,na,1960,4229
STAT,1833,21,30-34,1854,17.92360637077032
STAT,1827,46,30-34,1873,0.10061266709722311
STAT,1836,23,25-29,1859,47.31806857820034
SIM,1829,47,50-100,1876,1
SIM,1869,25,na,1894,2291
STAT,1861,34,15-19,1895,0.11849664730160082
SIM,1923,16,na,1939,4433
STAT,1873,38,50-100,1911,1.2508623605106777
STAT,1816,49,na,1865,1483.7241448083937
SIM,1798,87,na,1885,30
STAT,1884,80,na,1964,886.4477781219823
SIM,1842,69,na,1911,959
STAT,1933,39,35-39,1972,3.32205878046892
STAT,1824,84,na,1908,165.38377806674401
STAT,1853,29,30-34,1882,21.63930933164974
SIM,1925,23,na,1948,4371
STAT,1855,20,30-34,1875,15.890867081963794
STAT,1931,17,15-19,1948,60.03484544094974
SIM,1871,31,20-24,1902,3
STAT,1908,36,20-24,1944,0.2503428285220021
SIM,1911,23,25-29,1934,108
STAT,1901,60,na,1961,2834.865941857732
STAT,1855,25,25-29,1880,37.000965417858474
SIM,1870,9,na,1879,3034
STAT,1869,96,na,1965,29.801472978291976
SIM,1823,87,na,1910,114
SIM,1856,35,35-39,1891,16
SIM,1854,39,40-44,1893,6
STAT,1826,52,50-100,1878,0.014352974305510751
STAT,1876,36,25-29,1912,3.0170018951199116
STAT,1921,18,35-39,1939,4.818123022449983
STAT,1952,16,20-24,1968,164.19623769176619
STAT,1879,4,na,1883,3029.860406426333
STAT,1839,52,35-39,1891,0.006071096867891205
STAT,1900,22,45-49,1922,0.9783499444594608
STAT,1809,45,25-29,1854,0.21802045962690464
SIM,1927,36,na,1963,5150
SIM,1876,81,na,1957,552
SIM,1891,30,35-39,1921,2
SIM,1908,17,30-34,1925,7
STAT,1843,41,45-49,1884,1.052729307340685
STAT,1937,22,40-44,1959,3.3055265573873642
SIM,1861,29,30-34,1890,36
SIM,1945,22,40-44,1967,6
STAT,1924,27,25-29,1951,77.44215059476115
STAT,1920,20,20-24,1940,125.57799710170605
STAT,1830,91,na,1921,38.23048218998839
STAT,1844,46,30-34,1890,0.07680407422868901
STAT,1854,41,20-24,1895,0.11972633957770437
SIM,1863,25,25-29,1888,60
STAT,1897,31,25-29,1928,13.925766402386293
STAT,1887,7,na,1894,2937.9193403033105
SIM,1913,38,na,1951,3717
STAT,1940,29,25-29,1969,67.6929002699796
SIM,1922,28,45-49,1950,2
SIM,1851,46,na,1897,1788
STAT,1860,19,20-24,1879,16.683044951784836
SIM,1884,29,50-100,1913,5
STAT,1829,34,50-100,1863,0.7763496150673246
STAT,1894,73,na,1967,1889.4592665353334
SIM,1932,27,25-29,1959,139
SIM,1946,18,na,1964,4164
STAT,1823,50,40-44,1873,0.014513372406150535
STAT,1889,31,40-44,1920,5.422993128781175
STAT,1903,23,25-29,1926,82.08840752653504
SIM,1864,96,na,1960,2
STAT,1914,28,45-49,1942,1.751002052374121
STAT,1837,30,15-19,1867,0.12436514590596076
STAT,1815,46,50-100,1861,0.5541244601442475
SIM,1914,36,50-100,1950,4
STAT,1926,21,na,1947,4497.346681273642
STAT,1883,26,15-19,1909,0.44996546647662206
SIM,1939,21,na,1960,3770
STAT,1846,42,25-29,1888,0.4932228416317335
STAT,1848,35,35-39,1883,6.075868931454607
STAT,1941,16,45-49,1957,0.519617590266956
STAT,1890,41,40-44,1931,2.788528732856222
SIM,1940,18,na,1958,3922
STAT,1830,40,30-34,1870,1.0275256193055196
STAT,1934,26,20-24,1960,24.823256578798897
SIM,1848,57,na,1905,1535
STAT,1922,38,20-24,1960,0.30271644967192857
STAT,1926,26,20-24,1952,22.191451656672623
STAT,1929,23,45-49,1952,1.4337152193036744
STAT,1906,16,na,1922,3724.55312249748
SIM,1882,32,35-39,1914,16
STAT,1869,74,na,1943,1089.7663117723878
STAT,1875,9,na,1884,2757.052741044654
SIM,1807,65,na,1872,787
STAT,1863,53,40-44,1916,0.009269820172173149
STAT,1829,30,30-34,1859,16.39836551190991
STAT,1889,36,35-39,1925,8.850971481458764
SIM,1843,35,25-29,1878,7
SIM,1908,44,na,1952,3266
SIM,1851,41,45-49,1892,1
SIM,1878,33,20-24,1911,3
SIM,1833,22,35-39,1855,5
SIM,1884,40,45-49,1924,3
STAT,1881,15,25-29,1896,5.54256353723207
STAT,1945,18,na,1963,4059.2738134449723
SIM,1936,15,40-44,1951,5
SIM,1820,35,30-34,1855,3
SIM,1825,40,50-100,1865,2
STAT,1860,8,na,1868,2338.29724770829
STAT,1933,33,50-100,1966,1.125228898687107
SIM,1866,30,50-100,1896,1
STAT,1863,20,15-19,1883,3.054807815191788
STAT,1874,59,na,1933,2009.910395287594
STAT,1895,26,na,1921,3158.53894854111
SIM,1884,14,na,1898,2600
STAT,1875,18,50-100,1893,0.050682097372497986
STAT,1917,29,25-29,1946,69.1769848283874
STAT,1910,17,20-24,1927,27.103151126208672
SIM,1902,30,20-24,1932,3
STAT,1827,39,30-34,1866,5.917233250902893
STAT,1907,49,35-39,1956,0.11530379266424295
STAT,1947,21,50-100,1968,0.7514184299400555
STAT,1926,36,na,1962,4651.168519472165
SIM,1897,36,35-39,1933,21
STAT,1876,40,45-49,1916,1.5765092853834761
SIM,1942,26,20-24,1968,31
SIM,1925,37,35-39,1962,4
SIM,1815,41,35-39,1856,1
SIM,1868,77,na,1945,622
SIM,1914,4,na,1918,4416
STAT,1787,72,na,1859,454.95380039777604
STAT,1813,47,40-44,1860,0.49822189402571176
SIM,1903,28,35-39,1931,17
SIM,1943,0,na,1943,4475
SIM,1830,30,20-24,1860,1
STAT,1874,32,35-39,1906,10.473306266370914
SIM,1863,20,30-34,1883,28
SIM,1891,70,na,1961,1784
SIM,1924,22,50-100,1946,4
SIM,1925,29,25-29,1954,99
STAT,1905,27,15-19,1932,0.6624495361540156
SIM,1877,8,na,1885,2821
SIM,1867,54,50-100,1921,1
STAT,1875,30,35-39,1905,10.588402354767934
SIM,1862,83,na,1945,397
SIM,1899,20,45-49,1919,1
STAT,1874,20,40-44,1894,2.167911688251012
STAT,1928,15,40-44,1943,1.7896645145224899
STAT,1840,29,20-24,1869,10.106918316652623
STAT,1845,67,na,1912,1158.296546941628
SIM,1926,24,20-24,1950,184
SIM,1958,13,na,1971,5239
STAT,1807,49,30-34,1856,0.33423033416982395
SIM,1909,27,25-29,1936,77
STAT,1935,34,25-29,1969,12.902597688554321
STAT,1941,10,na,1951,4109.0269091837
SIM,1871,20,15-19,1891,7
STAT,1949,20,50-100,1969,0.7762133791597788
STAT,1835,35,25-29,1870,2.728732534930294
STAT,1882,78,na,1960,932.1458288138991
SIM,1900,16,25-29,1916,10
SIM,1865,40,35-39,1905,2
STAT,1894,19,50-100,1913,0.06336423105977204
STAT,1937,27,35-39,1964,14.774768312841795
STAT,1851,23,15-19,1874,2.961657716763638
STAT,1910,26,35-39,1936,14.677193415552404
SIM,1832,64,na,1896,1029
STAT,1870,34,na,1904,2346.4523721269575
SIM,1883,30,35-39,1913,17
SIM,1902,15,20-24,1917,38
SIM,1930,23,35-39,1953,16
STAT,1816,102,na,1918,0.14989246717950305
SIM,1910,18,25-29,1928,15
STAT,1855,67,na,1922,1193.2265038226815
SIM,1889,34,35-39,1923,28
STAT,1836,25,15-19,1861,0.3757288673504151
STAT,1919,17,40-44,1936,1.5606530613576062
STAT,1826,49,40-44,1875,0.16417157373264418
STAT,1840,31,na,1871,1869.710237160828
STAT,1948,0,na,1948,5121.331726231556
STAT,1856,30,25-29,1886,8.196901443814047
STAT,1848,46,15-19,1894,3.2751033435566364E-4
STAT,1869,19,40-44,1888,0.17995156360492978
STAT,1833,24,35-39,1857,5.490607879862166
SIM,1926,38,30-34,1964,6
SIM,1899,44,na,1943,3468
STAT,1884,42,45-49,1926,1.4888109086649872
SIM,1919,32,40-44,1951,1
STAT,1950,17,25-29,1967,51.768558315364366
SIM,1921,26,na,1947,4271
SIM,1875,42,45-49,1917,2
SIM,1888,81,na,1969,1310
STAT,1863,86,na,1949,198.5547264844396
STAT,1820,91,na,1911,29.49672979591287
STAT,1918,24,20-24,1942,120.3163621240382
STAT,1925,28,20-24,1953,21.712157364209446
STAT,1864,51,40-44,1915,0.009640672038320497
SIM,1951,3,na,1954,5012
STAT,1886,28,50-100,1914,0.6797622697550372
STAT,1900,49,25-29,1949,0.044633720540621785
STAT,1867,42,45-49,1909,1.4218842191605794
STAT,1921,32,30-34,1953,17.70800282601763
STAT,1940,18,45-49,1958,0.5118854658619054
STAT,1872,36,40-44,1908,4.4664018513277
STAT,1836,20,20-24,1856,66.57382815650963
SIM,1877,44,na,1921,2353
STAT,1831,28,40-44,1859,2.5620035101473
STAT,1845,51,30-34,1896,0.004370255283214158
STAT,1911,38,45-49,1949,0.6610029567041665
SIM,1928,20,15-19,1948,9
SIM,1919,37,35-39,1956,7
STAT,1842,47,50-100,1889,0.2211591594165674
STAT,1936,17,40-44,1953,1.3519381344220505
STAT,1900,35,15-19,1935,0.0795337117325928
SIM,1880,23,35-39,1903,9
SIM,1841,24,35-39,1865,5
SIM,1912,32,30-34,1944,28
SIM,1818,39,30-34,1857,6
STAT,1927,39,35-39,1966,3.0330730271461612
SIM,1847,94,na,1941,5
SIM,1934,26,20-24,1960,2
STAT,1861,25,25-29,1886,36.27978387875686
STAT,1857,107,na,1964,0.021959277473600245
SIM,1767,88,na,1855,21
STAT,1811,43,15-19,1854,0.03824583282215363
STAT,1864,59,na,1923,1771.2483002799304
SIM,1910,39,40-44,1949,1
SIM,1844,20,20-24,1864,64
STAT,1898,37,15-19,1935,0.07688731834703964
STAT,1942,28,20-24,1970,19.334312984623637
SIM,1829,33,25-29,1862,17
SIM,1831,84,na,1915,219
SIM,1835,39,30-34,1874,5
STAT,1914,36,20-24,1950,0.2668310278892778
SIM,1856,45,na,1901,2087
SIM,1867,12,na,1879,2493
SIM,1891,26,15-19,1917,4
STAT,1806,50,na,1856,1193.7796394225916
STAT,1922,27,50-100,1949,1.1378218085965583
STAT,1906,43,45-49,1949,0.1517869844224319
STAT,1863,96,na,1959,13.460129451710035
SIM,1937,25,35-39,1962,36
STAT,1888,24,25-29,1912,67.81594829551725
STAT,1911,22,20-24,1933,106.39301337249441
STAT,1850,46,na,1896,1727.6253261224913
STAT,1853,32,15-19,1885,0.12127644674626813
SIM,1887,59,na,1946,2076
SIM,1896,24,25-29,1920,72
STAT,1902,39,40-44,1941,1.334967817292339
STAT,1887,40,20-24,1927,0.18089190281973197
STAT,1840,16,50-100,1856,0.04472789544330788
SIM,1837,32,20-24,1869,2
SIM,1890,26,na,1916,3182
SIM,1942,25,na,1967,4196
SIM,1896,22,35-39,1918,9
STAT,1905,16,35-39,1921,0.8031360380119831
STAT,1913,7,na,1920,4110.136788540279
STAT,1888,22,35-39,1910,6.9565439590732865
STAT,1904,32,30-34,1936,14.530960262448206
SIM,1913,16,35-39,1929,1
SIM,1828,64,na,1892,1033
SIM,1930,16,35-39,1946,10
STAT,1846,31,na,1877,1963.906747889333
STAT,1831,54,na,1885,1348.3625814055279
STAT,1854,48,40-44,1902,0.1268689023431915
STAT,1874,21,50-100,1895,0.4230058442790817
STAT,1829,32,20-24,1861,2.4076199660064574
STAT,1847,21,35-39,1868,5.39499832877579
STAT,1876,44,na,1920,2377.7260870849063
STAT,1923,18,na,1941,4355.551871897419
STAT,1930,22,30-34,1952,37.214317953047974
SIM,1874,19,15-19,1893,6
STAT,1831,35,40-44,1866,3.576604872666867
SIM,1880,36,40-44,1916,7
STAT,1855,45,na,1900,1710.385534497736
SIM,1863,31,na,1894,2193
STAT,1911,37,40-44,1948,1.4587334863121355
SIM,1834,41,45-49,1875,5
STAT,1824,107,na,1931,0.0023445402696297747
SIM,1863,46,na,1909,2046
STAT,1950,21,45-49,1971,1.3490267210996725
STAT,1862,15,15-19,1877,5.9988039764642105
STAT,1866,38,30-34,1904,4.959672140377052
STAT,1846,39,40-44,1885,3.397820905716391
SIM,1933,28,20-24,1961,23
SIM,1874,38,30-34,1912,1
STAT,1929,25,35-39,1954,19.063780912744225
STAT,1890,49,50-100,1939,0.16740931000719933
SIM,1763,95,na,1858,3
SIM,1870,15,15-19,1885,10
STAT,1847,40,25-29,1887,0.4960370331956494
STAT,1932,33,45-49,1965,2.112660810573217
SIM,1904,33,35-39,1937,11
STAT,1866,21,45-49,1887,0.6622376508499769
STAT,1956,3,na,1959,5258.378462265624
SIM,1822,39,50-100,1861,3
SIM,1948,23,20-24,1971,141
SIM,1821,91,na,1912,34
STAT,1909,26,20-24,1935,17.814231340216935
STAT,1794,103,na,1897,0.027909242827933722
STAT,1902,26,35-39,1928,13.818790409307312
STAT,1896,23,20-24,1919,91.84589068381518
STAT,1929,39,45-49,1968,0.8827325292675853
SIM,1868,93,na,1961,17
SIM,1937,20,40-44,1957,5
STAT,1892,48,50-100,1940,0.17337507460624546
SIM,1816,79,na,1895,326
STAT,1922,16,35-39,1938,4.917987206707259
SIM,1923,33,45-49,1956,1
STAT,1916,38,20-24,1954,0.27107480861552324
STAT,1944,28,30-34,1972,42.743394424786764
STAT,1817,51,45-49,1868,0.030485396901975326
STAT,1842,25,15-19,1867,0.5124846009461245
SIM,1881,49,na,1930,1962
SIM,1933,15,15-19,1948,52
STAT,1878,31,15-19,1909,0.1499181722196321
SIM,1947,20,25-29,1967,132
SIM,1917,26,20-24,1943,17
SIM,1944,17,40-44,1961,1
STAT,1883,30,35-39,1913,10.089757932936815
STAT,1925,37,35-39,1962,2.9338464087120943
SIM,1855,21,35-39,1876,12
SIM,1788,87,na,1875,78
SIM,1928,15,40-44,1943,8
STAT,1827,42,15-19,1869,0.014855176956181774
STAT,1909,41,20-24,1950,0.01676474068088012
STAT,1902,18,25-29,1920,8.066704873718498
STAT,1925,15,15-19,1940,55.66220703971273
SIM,1831,29,45-49,1860,1
STAT,1901,28,35-39,1929,13.61341861177113
STAT,1857,29,15-19,1886,0.36309217757940754
SIM,1881,59,na,1940,1799
SIM,1892,42,45-49,1934,4
STAT,1962,4,na,1966,5088.447852946991
SIM,1848,79,na,1927,505
SIM,1885,17,25-29,1902,11
SIM,1918,39,35-39,1957,9
STAT,1813,51,na,1864,1276.6559764357694
STAT,1822,45,40-44,1867,0.2610559412625726
SIM,1864,30,25-29,1894,17
SIM,1895,1,na,1896,3562
STAT,1894,33,15-19,1927,0.18439628487534226
SIM,1848,33,35-39,1881,7
STAT,1812,99,na,1911,0.8598365645061925
STAT,1915,33,45-49,1948,1.6103102856816334
STAT,1872,50,50-100,1922,0.015556026987977587
SIM,1933,37,35-39,1970,3
STAT,1920,27,40-44,1947,5.163334828631776
SIM,1891,15,35-39,1906,4
STAT,1862,100,na,1962,2.71094457972411
SIM,1824,33,50-100,1857,4
STAT,1869,15,25-29,1884,5.708595735975651
STAT,1790,76,na,1866,321.451137617172
STAT,1902,32,20-24,1934,3.8579677732816813
STAT,1854,30,15-19,1884,0.11174318952476586
STAT,1917,17,30-34,1934,2.6475579503034075
STAT,1868,43,15-19,1911,0.013234205896512079
STAT,1801,66,na,1867,840.8114832436197
STAT,1831,32,na,1863,1763.3117538645117
STAT,1916,25,25-29,1941,69.14574644811512
SIM,1911,20,20-24,1931,120
STAT,1855,22,20-24,1877,60.599216196618706
STAT,1920,23,25-29,1943,103.37849107034016
SIM,1863,22,20-24,1885,75
STAT,1906,26,45-49,1932,1.6389760851006
STAT,1872,0,na,1872,3767.140812895275
SIM,1934,20,15-19,1954,6
SIM,1833,37,30-34,1870,9
STAT,1894,24,25-29,1918,73.9724955201092
STAT,1837,64,na,1901,1185.8726088487774
STAT,1861,44,50-100,1905,0.8746908312992645
STAT,1880,31,20-24,1911,2.878879825023765
STAT,1889,47,15-19,1936,2.796921331007519E-4
SIM,1869,21,50-100,1890,1
SIM,1882,20,40-44,1902,3
STAT,1834,23,15-19,1857,2.6091062264670515
STAT,1823,53,45-49,1876,0.018847505534071225
STAT,1912,5,na,1917,4088.5354682376146
STAT,1840,18,40-44,1858,0.1650229029439764
STAT,1920,28,45-49,1948,1.9070489829651498
STAT,1921,15,30-34,1936,14.09746094438447
STAT,1872,32,25-29,1904,10.400554367018412
STAT,1905,29,50-100,1934,0.9273371186428425
SIM,1913,29,50-100,1942,1
SIM,1918,22,na,1940,4056
STAT,1827,33,25-29,1860,13.21942291992624
SIM,1901,26,35-39,1927,19
SIM,1925,17,30-34,1942,27
STAT,1872,27,50-100,1899,0.6495570123557631
STAT,1903,16,25-29,1919,8.171116583119025
SIM,1839,27,na,1866,1906
STAT,1929,20,40-44,1949,4.323298936719772
STAT,1955,15,35-39,1970,5.630578720224008
SIM,1844,16,25-29,1860,4
STAT,1888,42,50-100,1930,1.257858097988883
STAT,1940,26,20-24,1966,18.80032871939037
SIM,1921,33,35-39,1954,2
STAT,1877,26,15-19,1903,0.47457314747156787
SIM,1842,23,15-19,1865,3
STAT,1915,46,15-19,1961,3.754846234563606E-4
STAT,1818,50,na,1868,1391.837745482453
STAT,1926,20,15-19,1946,6.5749961243315775
SIM,1835,33,25-29,1868,11
STAT,1865,42,35-39,1907,1.6679777930107995
SIM,1874,30,35-39,1904,15
STAT,1920,26,na,1946,4164.09070373627
STAT,1825,37,30-34,1862,8.800437517547927
STAT,1952,19,25-29,1971,52.43366276815023
SIM,1933,17,15-19,1950,56
SIM,1942,29,25-29,1971,97
SIM,1838,20,20-24,1858,70
STAT,1934,29,25-29,1963,89.3791942175805
SIM,1868,3,na,1871,2836
SIM,1895,34,35-39,1929,19
SIM,1939,22,40-44,1961,3
SIM,1903,23,na,1926,3204
SIM,1909,15,30-34,1924,3
STAT,1905,59,na,1964,3026.1280667010406
SIM,1907,22,20-24,1929,109
SIM,1828,80,na,1908,375
STAT,1800,55,na,1855,949.0175200000001
STAT,1892,28,30-34,1920,31.802674793391947
SIM,1898,21,30-34,1919,32
STAT,1887,34,35-39,1921,11.321973650695618
STAT,1870,36,30-34,1906,5.311253485948935
SIM,1928,20,50-100,1948,1
SIM,1952,5,na,1957,4781
STAT,1816,65,na,1881,998.8848321945043
STAT,1913,33,35-39,1946,9.134808030149463
STAT,1880,53,40-44,1933,0.010987493568723949
STAT,1871,30,50-100,1901,0.926773099744352
STAT,1928,18,45-49,1946,0.6345429492847038
SIM,1860,39,40-44,1899,7
SIM,1913,7,na,1920,4112
STAT,1809,79,na,1888,339.20977031191956
STAT,1868,34,25-29,1902,9.802443132584294
SIM,1878,36,25-29,1914,4
STAT,1852,39,40-44,1891,3.286449937110991
SIM,1903,25,30-34,1928,1
STAT,1866,23,35-39,1889,5.462587318345231
STAT,1911,45,50-100,1956,0.21704264031712178
SIM,1901,22,50-100,1923,1
SIM,1933,11,na,1944,5087
STAT,1926,29,25-29,1955,79.1746156331277
SIM,1829,31,35-39,1860,22
STAT,1797,101,na,1898,0.14246952357472153
SIM,1832,32,na,1864,1717
SIM,1876,34,25-29,1910,20
STAT,1891,32,35-39,1923,12.663675181197233
STAT,1847,23,25-29,1870,52.16725184656134
STAT,1868,31,20-24,1899,2.619900930935183
STAT,1903,20,20-24,1923,99.71607919327077
SIM,1874,23,35-39,1897,6
STAT,1812,52,30-34,1864,0.013140406701350133
SIM,1893,44,na,1937,3003
SIM,1916,39,25-29,1955,1
STAT,1935,31,20-24,1966,3.4114155796240584
STAT,1905,37,na,1942,3467.098022784113
STAT,1897,8,na,1905,3519.938460567309
STAT,1918,38,30-34,1956,1.93746088115154
SIM,1936,18,45-49,1954,1
STAT,1831,52,40-44,1883,0.0069181491170116054
SIM,1924,25,25-29,1949,100
STAT,1860,20,50-100,1880,0.38693384406946724
STAT,1880,34,na,1914,2509.5141846738043
SIM,1925,26,20-24,1951,25
SIM,1776,87,na,1863,18
SIM,1947,18,20-24,1965,174
STAT,1813,104,na,1917,0.029245225648625486
STAT,1856,31,50-100,1887,0.7256740658870101
STAT,1895,58,na,1953,2608.3786472041347
STAT,1908,39,25-29,1947,0.9212105830639349
STAT,1893,49,30-34,1942,0.06856340858775613
STAT,1924,16,45-49,1940,0.6025976137960998
SIM,1814,51,na,1865,1278
SIM,1832,69,na,1901,854
SIM,1914,26,45-49,1940,1
SIM,1885,21,20-24,1906,102
SIM,1832,41,35-39,1873,4
SIM,1903,45,na,1948,3041
STAT,1834,46,na,1880,1438.4519069240378
STAT,1898,41,35-39,1939,0.1729524236697166
STAT,1872,63,na,1935,1811.819800718068
STAT,1888,9,na,1897,3093.0924223304046
STAT,1893,45,15-19,1938,2.922460818529622E-4
STAT,1917,26,20-24,1943,19.389266399308074
STAT,1849,40,35-39,1889,1.4405341075291656
SIM,1864,31,50-100,1895,5
SIM,1918,37,na,1955,4204
STAT,1921,29,15-19,1950,0.788958779218978
STAT,1939,18,20-24,1957,136.95752130686628
STAT,1918,22,30-34,1940,31.294903693121203
SIM,1872,67,na,1939,1722
STAT,1939,24,40-44,1963,3.406630804578728
SIM,1855,27,na,1882,2244
STAT,1918,27,25-29,1945,70.71778490628915
SIM,1771,88,na,1859,24
SIM,1920,41,na,1961,4418
SIM,1930,20,30-34,1950,56
SIM,1934,22,na,1956,5011
STAT,1851,27,30-34,1878,22.325307772025617
SIM,1899,1,na,1900,4054
STAT,1854,82,na,1936,350.1638444961743
STAT,1766,111,na,1877,5.951928379616634E-4
STAT,1804,50,30-34,1854,0.01678426512876449
STAT,1881,19,40-44,1900,0.17711315685006176
STAT,1914,39,25-29,1953,0.9818837960434208
STAT,1838,27,na,1865,1842.1154478588132
SIM,1854,33,35-39,1887,16
STAT,1884,44,50-100,1928,1.038017795128879
STAT,1885,47,30-34,1932,0.09686299646199717
SIM,1857,40,35-39,1897,2
SIM,1792,87,na,1879,25
SIM,1913,23,na,1936,3679
STAT,1834,29,20-24,1863,9.030377415427886
SIM,1934,29,25-29,1963,106
SIM,1837,35,25-29,1872,3
STAT,1796,86,na,1882,69.49598569161674
STAT,1831,37,50-100,1868,0.9814029261089556
STAT,1875,81,na,1956,598.1748744870481
SIM,1913,27,15-19,1940,1
STAT,1869,52,20-24,1921,7.20748755008701E-4
SIM,1828,31,50-100,1859,4
SIM,1889,32,45-49,1921,3
SIM,1910,15,20-24,1925,40
SIM,1906,26,45-49,1932,3
STAT,1917,22,na,1939,3917.6247447475653
STAT,1824,41,35-39,1865,2.2971578981112013
SIM,1790,91,na,1881,28
STAT,1853,23,25-29,1876,55.533507372531965
STAT,1928,29,50-100,1957,1.238231539740914
STAT,1901,25,30-34,1926,35.895868392995986
SIM,1909,24,20-24,1933,126
STAT,1930,40,35-39,1970,0.26853196265327556
STAT,1882,20,25-29,1902,56.340269150916676
STAT,1909,44,25-29,1953,0.06657163386375584
SIM,1922,39,25-29,1961,1
STAT,1887,43,25-29,1930,0.7188948537906267
SIM,1841,46,na,1887,1556
SIM,1842,29,20-24,1871,12
STAT,1874,25,35-39,1899,10.04652097115089
SIM,1902,38,45-49,1940,1
STAT,1896,21,30-34,1917,23.885514365540992
STAT,1830,47,40-44,1877,0.1431960643205335
SIM,1922,37,na,1959,4829
STAT,1822,48,45-49,1870,0.3450394019129348
STAT,1849,20,30-34,1869,17.082077744616527
SIM,1902,60,na,1962,2947
STAT,1917,43,20-24,1960,0.018573773504223918
SIM,1937,23,45-49,1960,1
SIM,1944,26,30-34,1970,2
STAT,1895,1,na,1896,3590.042199453238
STAT,1886,22,na,1908,2522.071277708794
SIM,1901,38,na,1939,3382
STAT,1861,22,20-24,1883,59.41808413395781
STAT,1899,18,15-19,1917,8.204635970126654
STAT,1930,42,50-100,1972,0.1562313148152918
SIM,1926,27,25-29,1953,115
SIM,1923,30,40-44,1953,5
STAT,1793,68,na,1861,694.0188795547901
SIM,1802,66,na,1868,887
STAT,1806,65,na,1871,812.8503172899389
SIM,1914,19,20-24,1933,32
STAT,1907,31,45-49,1938,1.4912294618584856
SIM,1878,20,25-29,1898,85
STAT,1917,37,35-39,1954,2.535863905910854
STAT,1867,101,na,1968,3.528875730099335
STAT,1852,44,15-19,1896,0.010331894164241311
STAT,1925,17,15-19,1942,55.40478831296665
STAT,1930,19,50-100,1949,0.486940315144181
SIM,1897,31,40-44,1928,8
STAT,1836,53,na,1889,1346.6988624152875
SIM,1837,30,30-34,1867,26
STAT,1841,23,50-100,1864,0.38353922925189926
SIM,1819,50,na,1869,1341
STAT,1906,19,20-24,1925,25.94063984800981
STAT,1938,21,na,1959,3649.8522012844905
SIM,1915,31,45-49,1946,2
SIM,1853,31,na,1884,1848
SIM,1857,20,30-34,1877,24
STAT,1923,48,15-19,1971,4.3419596246645355E-4
SIM,1863,106,na,1969,1
SIM,1880,32,25-29,1912,16
STAT,1831,31,25-29,1862,8.579643434029382
SIM,1867,40,45-49,1907,3
STAT,1858,107,na,1965,0.02586470336724412
SIM,1773,95,na,1868,5
SIM,1788,72,na,1860,492
STAT,1872,53,40-44,1925,0.010518355847443367
STAT,1895,42,20-24,1937,0.014528018979719403
SIM,1841,39,30-34,1880,4
SIM,1859,27,25-29,1886,61
SIM,1929,5,na,1934,5027
STAT,1954,17,na,1971,4597.142642213119
STAT,1944,17,25-29,1961,47.092546020994995
SIM,1878,31,30-34,1909,5
SIM,1872,35,50-100,1907,1
STAT,1850,31,35-39,1881,8.196586274712052
STAT,1942,15,25-29,1957,45.74871106337017
SIM,1952,17,25-29,1969,96
STAT,1821,54,na,1875,1384.63030484053
STAT,1811,47,30-34,1858,0.2411245310125707
STAT,1857,40,35-39,1897,1.4417663097289692
SIM,1861,23,25-29,1884,52
STAT,1902,15,20-24,1917,25.420787192532586
SIM,1855,37,50-100,1892,1
STAT,1848,30,40-44,1878,4.2157911946689515
SIM,1918,36,30-34,1954,2
STAT,1856,21,35-39,1877,5.285980003160866
STAT,1915,30,40-44,1945,4.053983388974494
SIM,1950,15,25-29,1965,65
STAT,1833,39,30-34,1872,4.634317930477989
STAT,1865,45,na,1910,2095.615312353842
STAT,1824,68,na,1892,759.7446599737834
SIM,1791,76,na,1867,310
STAT,1912,26,45-49,1938,1.7235310706623457
SIM,1876,20,40-44,1896,2
STAT,1800,101,na,1901,0.20016663083951336
SIM,1947,24,40-44,1971,5
STAT,1871,41,30-34,1912,1.1588247257298427
STAT,1932,16,45-49,1948,0.6701062057804466
SIM,1823,65,na,1888,977
STAT,1806,87,na,1893,59.40144577005135
STAT,1862,32,15-19,1894,0.12421086445523868
SIM,1920,26,45-49,1946,2
SIM,1935,6,na,1941,5463
STAT,1872,23,35-39,1895,5.907158647767182
STAT,1868,20,40-44,1888,2.0406806238367174
STAT,1921,35,35-39,1956,2.732402631369374
SIM,1838,79,na,1917,498
SIM,1879,21,20-24,1900,81
SIM,1885,49,50-100,1934,4
STAT,1915,15,50-100,1930,0.07949100172076366
STAT,1928,44,35-39,1972,0.2586049399303242
SIM,1890,20,25-29,1910,92
STAT,1871,45,na,1916,2280.0514502342476
SIM,1837,47,50-100,1884,2
STAT,1828,51,20-24,1879,6.621512764914252E-4
SIM,1871,82,na,1953,542
STAT,1936,14,na,1950,3817.364099388632
STAT,1886,44,na,1930,2431.4212157111992
STAT,1829,35,25-29,1864,2.4366740797894035
SIM,1856,30,40-44,1886,10
SIM,1933,19,30-34,1952,21
SIM,1936,29,50-100,1965,1
STAT,1943,27,35-39,1970,16.14501054727173
STAT,1925,19,30-34,1944,14.800517311933966
SIM,1911,27,30-34,1938,39
STAT,1811,48,50-100,1859,0.6018190325143151
STAT,1896,26,25-29,1922,56.74774370060335
STAT,1775,87,na,1862,39.71038879858996
STAT,1877,49,50-100,1926,0.2506736817948597
SIM,1904,24,45-49,1928,2
STAT,1861,100,na,1961,2.273169004975972
STAT,1903,27,30-34,1930,36.221978536595685
SIM,1883,24,15-19,1907,4
SIM,1854,16,na,1870,2577
SIM,1904,30,30-34,1934,50
STAT,1829,47,50-100,1876,0.18323624676621053
SIM,1854,10,na,1864,2662
STAT,1900,39,30-34,1939,1.5976997951216894
SIM,1820,85,na,1905,122
STAT,1925,47,35-39,1972,0.15789022977445089
SIM,1865,97,na,1962,25
STAT,1842,21,35-39,1863,6.674621176562122
STAT,1875,39,25-29,1914,2.956297337909216
STAT,1880,20,15-19,1900,3.5201882903292776
STAT,1845,22,15-19,1867,2.992543291071129
STAT,1872,38,45-49,1910,2.014187867072996
SIM,1937,23,35-39,1960,9
STAT,1921,17,50-100,1938,0.43131953304859527
SIM,1872,35,na,1907,2573
STAT,1874,25,45-49,1899,1.156054132591985
STAT,1932,23,50-100,1955,0.869785128167246
SIM,1830,44,40-44,1874,6
STAT,1856,34,40-44,1890,3.329369310385654
STAT,1859,35,20-24,1894,0.6321349577615807
STAT,1796,70,na,1866,638.1770751885787
SIM,1860,8,na,1868,2521
STAT,1831,42,40-44,1873,1.7390156033154103
STAT,1915,34,45-49,1949,1.6032893328360611
SIM,1912,20,25-29,1932,121
STAT,1889,40,30-34,1929,1.4462374211012572
SIM,1924,22,na,1946,4333
STAT,1849,27,na,1876,2004.94772840826
SIM,1923,34,45-49,1957,2
STAT,1839,37,45-49,1876,1.6889446139057003
STAT,1941,31,35-39,1972,9.692237580659684
STAT,1871,51,25-29,1922,0.003571146694355122
STAT,1911,18,25-29,1929,8.725859166932251
STAT,1841,47,na,1888,1690.0909246440945
STAT,1920,25,40-44,1945,5.198364587502477
STAT,1857,48,20-24,1905,0.009340080505466763
STAT,1918,44,40-44,1962,0.2675891732484902
SIM,1914,36,45-49,1950,2
SIM,1848,40,35-39,1888,5
STAT,1869,21,45-49,1890,0.6868081308439354
SIM,1924,36,30-34,1960,2
SIM,1907,39,35-39,1946,4
SIM,1783,88,na,1871,70
STAT,1784,85,na,1869,73.33401815077266
STAT,1934,27,35-39,1961,20.40753845712826
STAT,1822,44,40-44,1866,3.4085651376595854
STAT,1858,63,na,1921,1413.858745522531
SIM,1853,38,50-100,1891,1
SIM,1891,38,20-24,1929,1
STAT,1935,34,15-19,1969,0.17939079406580996
SIM,1864,21,35-39,1885,6
SIM,1883,39,25-29,1922,8
SIM,1885,18,25-29,1903,3
SIM,1877,82,na,1959,615
STAT,1825,45,20-24,1870,0.016566014731639836
SIM,1799,87,na,1886,67
SIM,1853,22,15-19,1875,3
STAT,1930,29,15-19,1959,0.9063789663706937
STAT,1932,31,40-44,1963,5.26029279533115
SIM,1888,46,50-100,1934,4
SIM,1910,34,35-39,1944,17
SIM,1880,38,45-49,1918,3
SIM,1876,25,20-24,1901,11
SIM,1838,95,na,1933,4
SIM,1905,43,40-44,1948,3
STAT,1814,45,45-49,1859,0.5886618032972499
STAT,1833,21,40-44,1854,2.096832230409627
STAT,1920,16,25-29,1936,49.21825697561006
STAT,1808,48,25-29,1856,0.2047659400686749
SIM,1928,23,40-44,1951,3
STAT,1861,16,20-24,1877,17.20325132164895
STAT,1902,41,25-29,1943,0.06393336236019775
SIM,1841,21,40-44,1862,2
SIM,1912,37,na,1949,3560
STAT,1948,18,20-24,1966,156.6840733623617
SIM,1781,77,na,1858,304
SIM,1908,26,20-24,1934,1
STAT,1904,20,25-29,1924,83.4679293272071
STAT,1936,19,na,1955,3538.584805308751
SIM,1933,29,35-39,1962,28
STAT,1862,28,50-100,1890,0.5559886955802021
STAT,1868,28,25-29,1896,40.68944269182501
SIM,1795,73,na,1868,418
STAT,1892,36,20-24,1928,0.9816599883028151
STAT,1836,42,15-19,1878,0.01036383947382047
STAT,1853,32,na,1885,2032.2172063311664
STAT,1883,38,20-24,1921,0.7581059938585776
STAT,1885,65,na,1950,1698.9830700359155
STAT,1844,19,25-29,1863,5.632264435537161
SIM,1881,37,50-100,1918,1
SIM,1832,23,40-44,1855,2
SIM,1835,24,20-24,1859,66
SIM,1901,65,na,1966,2583
STAT,1848,35,45-49,1883,1.7124697332085521
SIM,1907,15,20-24,1922,32
STAT,1926,34,20-24,1960,2.976980033286568
STAT,1909,37,25-29,1946,0.9404447740932654
STAT,1946,20,30-34,1966,32.32557731552209
STAT,1853,53,30-34,1906,0.004843580806526538
STAT,1954,15,40-44,1969,1.7478738966418295
SIM,1910,25,20-24,1935,25
SIM,1874,40,35-39,1914,3
STAT,1912,21,15-19,1933,5.162443675383913
STAT,1909,44,15-19,1953,0.0014316481356971562
STAT,1906,41,40-44,1947,0.23081771175150798
SIM,1920,21,15-19,1941,6
STAT,1865,27,45-49,1892,1.0239837190345658
STAT,1883,22,35-39,1905,5.767621220868838
STAT,1902,34,35-39,1936,8.22840579701969
SIM,1896,73,na,1969,2001
STAT,1937,18,45-49,1955,0.48932360627719573
STAT,1944,18,na,1962,3998.6172006217807
SIM,1845,16,30-34,1861,2
SIM,1909,18,35-39,1927,1
STAT,1866,46,20-24,1912,0.01125465488012838
STAT,1850,54,45-49,1904,0.01080677346904154
STAT,1866,40,35-39,1906,1.71062037876332
STAT,1934,18,20-24,1952,184.80628763639317
SIM,1868,30,na,1898,2218
STAT,1907,29,15-19,1936,0.6625109035326658
SIM,1843,30,50-100,1873,4
STAT,1923,7,na,1930,4742.580475374068
SIM,1824,31,35-39,1855,12
STAT,1897,22,35-39,1919,7.901583144165085
STAT,1841,46,15-19,1887,3.043560729000498E-4
SIM,1922,43,na,1965,4804
SIM,1856,35,45-49,1891,3
SIM,1886,59,na,1945,2150
SIM,1924,38,na,1962,4507
SIM,1851,77,na,1928,665
STAT,1822,108,na,1930,0.0010241598767321458
STAT,1854,6,na,1860,2239.698740911912
STAT,1943,29,25-29,1972,70.71053847973727
STAT,1805,92,na,1897,16.533819299076
SIM,1847,68,na,1915,1095
STAT,1826,54,na,1880,1246.9580442247036
SIM,1793,62,na,1855,854
SIM,1915,29,15-19,1944,3
SIM,1839,33,na,1872,1795
STAT,1905,27,na,1932,3484.5544697741607
STAT,1916,36,30-34,1952,1.8925939358863997
STAT,1851,21,na,1872,1947.340999334349
STAT,1877,25,15-19,1902,0.4761587561294791
SIM,1921,19,15-19,1940,38
SIM,1859,41,na,1900,2151
SIM,1882,48,50-100,1930,5
STAT,1913,19,15-19,1932,9.311973283645354
SIM,1910,16,35-39,1926,4
STAT,1805,52,40-44,1857,0.04328115734500427
STAT,1822,40,na,1862,1581.1239641696195
STAT,1915,41,35-39,1956,0.20486101389462902
STAT,1900,46,20-24,1946,0.009523945646567979
SIM,1829,43,na,1872,1725
SIM,1934,34,20-24,1968,2
STAT,1876,13,na,1889,2696.6755652135994
SIM,1911,21,50-100,1932,1
STAT,1835,90,na,1925,59.173613373243924
STAT,1902,25,20-24,1927,16.857427478435568
SIM,1838,31,35-39,1869,14
STAT,1929,23,35-39,1952,11.997931677576984
STAT,1883,2,na,1885,3115.7490112374294
SIM,1940,26,45-49,1966,1
STAT,1872,43,40-44,1915,2.2674628383024316
STAT,1891,38,50-100,1929,1.5276506324670782
SIM,1783,72,na,1855,536
STAT,1881,54,45-49,1935,0.013740252739307056
STAT,1903,23,15-19,1926,4.7306967503024895
SIM,1902,26,25-29,1928,91
STAT,1933,19,15-19,1952,61.061679793800046
SIM,1931,15,40-44,1946,3
STAT,1882,47,15-19,1929,3.8951425615504556E-4
SIM,1833,35,50-100,1868,4
SIM,1861,51,na,1912,1857
SIM,1863,43,40-44,1906,2
SIM,1898,44,na,1942,3123
STAT,1865,47,15-19,1912,3.671822500196813E-4
STAT,1928,25,40-44,1953,5.843536643492583
STAT,1919,35,na,1954,4103.638945532138
STAT,1932,26,45-49,1958,2.2877795181659177
SIM,1888,38,45-49,1926,3
SIM,1874,40,50-100,1914,4
SIM,1872,39,na,1911,2537
STAT,1904,39,15-19,1943,0.01739082498916765
SIM,1880,43,40-44,1923,9
SIM,1951,16,20-24,1967,191
STAT,1941,25,50-100,1966,1.040441714915101
SIM,1879,32,35-39,1911,16
STAT,1917,36,20-24,1953,0.2777036735452819
SIM,1929,31,50-100,1960,1
SIM,1930,27,15-19,1957,1
STAT,1869,27,30-34,1896,24.727580237749457
STAT,1926,16,20-24,1942,168.4073439632153
STAT,1804,53,35-39,1857,0.022848252335334183
SIM,1843,26,20-24,1869,22
STAT,1858,43,50-100,1901,0.8310711453877925
STAT,1896,47,45-49,1943,0.17714610284716772
SIM,1836,29,na,1865,2076
STAT,1850,16,45-49,1866,0.061483758845119786
STAT,1892,20,35-39,1912,7.4398933435132735
STAT,1842,37,20-24,1879,0.8141402066592571
STAT,1923,40,na,1963,4398.091760922656
SIM,1934,16,20-24,1950,202
STAT,1877,43,15-19,1920,0.014291697166769953
STAT,1943,16,20-24,1959,145.20593516964402
STAT,1920,23,15-19,1943,5.95762917680608
STAT,1835,26,20-24,1861,11.563046927628145
STAT,1916,29,40-44,1945,4.8287811889169845
STAT,1839,20,20-24,1859,63.68682414445893
SIM,1919,25,40-44,1944,10
STAT,1942,26,30-34,1968,41.54028590407309
STAT,1923,15,40-44,1938,1.6671994866277737
STAT,1851,38,25-29,1889,2.180677692595782
SIM,1925,18,20-24,1943,3
STAT,1815,86,na,1901,96.04540483645472
SIM,1893,17,20-24,1910,26
SIM,1942,18,20-24,1960,213
STAT,1869,41,15-19,1910,0.01362203828201389
STAT,1918,42,15-19,1960,0.0016483959860635854
STAT,1946,13,na,1959,4399.691082667525
SIM,1852,15,na,1867,2125
STAT,1845,40,15-19,1885,0.010542191446139638
SIM,1840,34,na,1874,1853
STAT,1903,33,40-44,1936,3.566738944176752
STAT,1937,20,na,1957,3592.553009859401
SIM,1844,48,na,1892,1490
STAT,1910,18,35-39,1928,0.8366616791653658
SIM,1889,41,35-39,1930,3
STAT,1878,20,50-100,1898,0.43010080589374183
SIM,1877,23,15-19,1900,3
SIM,1911,33,40-44,1944,3
STAT,1934,36,20-24,1970,0.3679015707860491
STAT,1830,50,25-29,1880,0.0029788779458531445
SIM,1902,35,40-44,1937,4
SIM,1918,38,na,1956,4202
STAT,1794,75,na,1869,422.7892862341192
SIM,1917,52,na,1969,3654
STAT,1894,15,20-24,1909,23.160144167244077
STAT,1885,17,20-24,1902,17.82316143148916
STAT,1846,78,na,1924,592.9415785644103
SIM,1897,28,45-49,1925,2
STAT,1917,16,na,1933,4205.558513411643
STAT,1942,19,40-44,1961,1.4748443733169152
SIM,1904,18,na,1922,3790
SIM,1847,20,20-24,1867,79
STAT,1917,18,20-24,1935,29.37150132644026
STAT,1912,23,40-44,1935,3.2409660221085668
STAT,1828,40,15-19,1868,0.013643401037652962
STAT,1923,33,40-44,1956,4.530044876500923
STAT,1921,21,na,1942,4178.385069609169
STAT,1810,55,na,1865,1328.7824380762843
STAT,1850,83,na,1933,303.9784267254821
SIM,1823,50,na,1873,1392
SIM,1852,24,20-24,1876,60
STAT,1925,35,na,1960,4571.30656812642
STAT,1814,69,na,1883,812.8556153311393
STAT,1840,35,45-49,1875,1.6874768387279013
SIM,1892,43,na,1935,3156
STAT,1889,20,35-39,1909,7.31083487626776
STAT,1881,36,45-49,1917,1.950130923069706
SIM,1905,25,40-44,1930,13
SIM,1931,33,40-44,1964,10
STAT,1887,60,na,1947,2150.623429849999
STAT,1914,48,15-19,1962,3.6757828402615554E-4
STAT,1898,49,20-24,1947,0.009074661219524842
SIM,1871,97,na,1968,9
STAT,1870,47,25-29,1917,0.05686067324138011
STAT,1886,41,15-19,1927,0.014793340471248317
SIM,1911,16,25-29,1927,11
STAT,1871,44,35-39,1915,1.7924881012699636
STAT,1906,44,na,1950,3365.7620772717974
SIM,1901,36,35-39,1937,2
STAT,1908,46,20-24,1954,0.010164875046403144
SIM,1878,24,na,1902,2730
STAT,1844,24,20-24,1868,67.10081936632044
SIM,1883,20,35-39,1903,7
SIM,1941,19,15-19,1960,2
SIM,1857,41,50-100,1898,3
SIM,1946,21,35-39,1967,11
STAT,1889,28,45-49,1917,1.377897728250026
STAT,1895,31,15-19,1926,0.18859810033863295
STAT,1910,36,35-39,1946,2.345122356475318
SIM,1911,23,15-19,1934,6
STAT,1840,53,45-49,1893,0.010009684309588164
STAT,1908,37,35-39,1945,2.2860170873795096
SIM,1836,18,30-34,1854,1
STAT,1821,86,na,1907,132.90204325830692
STAT,1835,47,na,1882,1779.8412476992492
SIM,1916,28,20-24,1944,18
STAT,1900,43,na,1943,3230.3885698306162
SIM,1884,24,na,1908,2514
STAT,1876,27,20-24,1903,12.23406118424281
STAT,1899,41,na,1940,3229.3397074757113
STAT,1858,59,na,1917,1539.9749159265737
STAT,1938,29,45-49,1967,1.7261620487752285
STAT,1889,33,40-44,1922,5.3781296578197635
STAT,1900,23,45-49,1923,0.975326843131081
SIM,1928,37,50-100,1965,1
STAT,1770,113,na,1883,2.5306392656375507E-4
SIM,1897,33,40-44,1930,11
SIM,1886,43,na,1929,2588
SIM,1847,37,45-49,1884,2
STAT,1917,45,35-39,1962,0.13657225001348822
STAT,1927,32,15-19,1959,0.15977443505436703
SIM,1950,19,40-44,1969,1
SIM,1918,25,50-100,1943,5
STAT,1886,23,15-19,1909,3.5071853366556036
SIM,1894,23,15-19,1917,5
SIM,1881,12,na,1893,2279
STAT,1834,38,25-29,1872,2.1108215732300866
STAT,1882,36,50-100,1918,1.2069403896154305
STAT,1908,28,20-24,1936,17.35783922863788
STAT,1810,52,20-24,1862,0.0027039461424603756
STAT,1844,83,na,1927,314.0898377983177
STAT,1915,21,na,1936,3820.498694964819
STAT,1937,27,50-100,1964,0.9795188024675611
STAT,1820,69,na,1889,741.3286592696169
STAT,1938,21,35-39,1959,9.41090031862843
SIM,1884,27,20-24,1911,19
SIM,1902,23,na,1925,3489
STAT,1846,48,45-49,1894,0.17684647450506974
SIM,1906,37,na,1943,3402
SIM,1907,36,30-34,1943,1
SIM,1964,3,na,1967,5252
STAT,1916,39,35-39,1955,2.4744864563545192
STAT,1875,36,20-24,1911,0.8033861650424553
STAT,1814,42,40-44,1856,6.8170417175953135
STAT,1907,17,20-24,1924,26.29545179274333
SIM,1894,15,15-19,1909,9
SIM,1836,20,45-49,1856,4
STAT,1910,41,30-34,1951,0.12260346575585394
STAT,1882,24,40-44,1906,2.025926756610245
SIM,1814,41,na,1855,1440
STAT,1869,19,30-34,1888,1.568149277471931
STAT,1839,46,50-100,1885,0.17969711351235218
STAT,1827,71,na,1898,793.7508156706499
STAT,1840,50,40-44,1890,0.007485802492979189
STAT,1892,49,50-100,1941,0.17191525647806083
SIM,1825,29,na,1854,1494
STAT,1921,20,25-29,1941,105.9996219834716
STAT,1820,53,20-24,1873,0.0011806528086915162
SIM,1823,33,40-44,1856,6
STAT,1902,4,na,1906,3754.6755358645455
STAT,1853,28,na,1881,2065.618217597435
STAT,1804,79,na,1883,269.15752949431976
SIM,1873,52,na,1925,2027
STAT,1842,45,20-24,1887,0.01108628274354323
SIM,1795,69,na,1864,704
SIM,1938,27,45-49,1965,7
SIM,1890,24,40-44,1914,1
STAT,1827,34,15-19,1861,0.17648371119986306
STAT,1881,33,40-44,1914,4.20426021437886
SIM,1817,54,50-100,1871,1
STAT,1922,45,45-49,1967,0.25342272524913934
STAT,1911,15,20-24,1926,27.49799483520005
STAT,1809,54,50-100,1863,0.04651623310799526
STAT,1950,18,na,1968,4395.656324016135
STAT,1886,15,15-19,1901,6.357966831446822
SIM,1832,25,50-100,1857,1
STAT,1829,33,50-100,1862,0.7956939026163898
STAT,1850,36,15-19,1886,0.044135142099915065
SIM,1910,31,30-34,1941,7
STAT,1824,46,15-19,1870,4.745413187298446E-4
STAT,1900,15,45-49,1915,0.09207401395662117
STAT,1875,75,na,1950,1067.776067630477
SIM,1802,56,na,1858,1159
SIM,1806,48,50-100,1854,4
SIM,1847,46,50-100,1893,2
SIM,1833,21,35-39,1854,8
STAT,1969,3,na,1972,4962.259344184756
STAT,1847,31,35-39,1878,8.995758230890562
SIM,1935,7,na,1942,5456
SIM,1835,27,25-29,1862,44
STAT,1894,25,15-19,1919,0.5939679782055645
SIM,1915,17,20-24,1932,1
STAT,1874,22,40-44,1896,2.1550534122863536
SIM,1903,21,15-19,1924,5
SIM,1843,31,50-100,1874,7
STAT,1854,51,25-29,1905,0.002670951712876113
STAT,1937,15,40-44,1952,1.3800879755415185
SIM,1895,2,na,1897,3526
SIM,1888,21,20-24,1909,95
STAT,1903,31,15-19,1934,0.20567819688235653
STAT,1951,18,20-24,1969,163.06106375383183
SIM,1856,42,35-39,1898,4
STAT,1868,25,20-24,1893,11.401090375474846
STAT,1883,46,20-24,1929,0.011894130498478888
STAT,1943,26,20-24,1969,19.638416466751913
SIM,1901,17,20-24,1918,38
SIM,1859,20,40-44,1879,3
SIM,1863,15,na,1878,2495
STAT,1931,29,50-100,1960,1.2974394303110603
SIM,1916,29,35-39,1945,1
STAT,1835,78,na,1913,586.4275352205954
SIM,1901,37,na,1938,3408
SIM,1870,96,na,1966,55
SIM,1855,31,35-39,1886,11
STAT,1830,43,35-39,1873,1.5512773585058524
STAT,1891,37,15-19,1928,0.07022005480253136
STAT,1922,27,15-19,1949,0.8070013863328391
SIM,1834,34,na,1868,1974
SIM,1882,29,na,1911,2090
STAT,1848,42,35-39,1890,1.4766339890391478
STAT,1876,52,50-100,1928,0.015665951481034897
SIM,1849,16,15-19,1865,8
STAT,1851,53,20-24,1904,5.497723246715405E-4
STAT,1863,15,50-100,1878,0.05062280384188999
STAT,1848,32,40-44,1880,4.129142811028105
STAT,1908,29,35-39,1937,14.224574667776603
SIM,1910,28,25-29,1938,72
STAT,1923,36,45-49,1959,0.7988315776310732
SIM,1822,42,40-44,1864,4
STAT,1822,52,40-44,1874,0.015034544598972846
SIM,1856,32,40-44,1888,4
SIM,1933,26,30-34,1959,77
SIM,1846,35,50-100,1881,1
STAT,1902,28,25-29,1930,60.16260784941211
STAT,1876,29,na,1905,2470.9812198207783
STAT,1899,57,na,1956,2807.734508016617
SIM,1907,29,40-44,1936,9
SIM,1882,25,45-49,1907,1
SIM,1924,39,35-39,1963,7
STAT,1911,35,40-44,1946,1.4725872549914103
SIM,1883,82,na,1965,893
SIM,1948,16,20-24,1964,1
SIM,1846,20,30-34,1866,21
SIM,1826,34,20-24,1860,4
STAT,1866,23,na,1889,2213.919741066641
SIM,1931,24,50-100,1955,5
SIM,1838,48,na,1886,1656
SIM,1856,4,na,1860,2680
STAT,1867,102,na,1969,2.1822214627361283
SIM,1876,28,25-29,1904,54
SIM,1912,53,na,1965,3300
STAT,1893,56,na,1949,2615.711261223324
SIM,1789,73,na,1862,486
STAT,1885,25,20-24,1910,11.874085401741782
STAT,1867,40,na,1907,2220.685609877241
SIM,1883,36,20-24,1919,1
STAT,1902,16,35-39,1918,0.785074073686606
STAT,1861,54,20-24,1915,6.022901478836217E-4
STAT,1925,44,30-34,1969,0.1559042276137173
SIM,1835,19,25-29,1854,5
SIM,1885,15,20-24,1900,24
STAT,1841,23,40-44,1864,1.9598853188881118
STAT,1868,89,na,1957,127.27275000762783
STAT,1816,64,na,1880,1036.8329169550598
SIM,1907,38,na,1945,3745
STAT,1864,75,na,1939,938.2385339620191
SIM,1861,67,na,1928,1354
STAT,1918,47,45-49,1965,0.23349612741516704
STAT,1908,47,35-39,1955,0.11770314980954175
STAT,1838,20,30-34,1858,15.694752959901514
SIM,1828,65,na,1893,988
SIM,1893,25,20-24,1918,20
STAT,1943,19,25-29,1962,46.369387896156404
STAT,1894,43,15-19,1937,0.0012379913349796694
STAT,1855,46,45-49,1901,0.17814647806851094
STAT,1923,18,45-49,1941,0.5911217832762345
SIM,1848,32,35-39,1880,4
STAT,1866,30,35-39,1896,9.547292538430101
STAT,1819,38,50-100,1857,3.232934799364
SIM,1861,17,25-29,1878,5
STAT,1829,78,na,1907,460.7033855307485
STAT,1922,28,50-100,1950,1.1338166758302988
STAT,1882,84,na,1966,593.3283203730659
STAT,1909,19,25-29,1928,8.529520454789639
STAT,1881,51,40-44,1932,0.010298395168198653
STAT,1853,17,25-29,1870,5.637255465642532
STAT,1929,16,45-49,1945,0.6459493473762857
SIM,1870,43,30-34,1913,3
SIM,1838,44,40-44,1882,9
STAT,1910,33,30-34,1943,15.261978896619324
SIM,1923,26,45-49,1949,3
SIM,1937,16,45-49,1953,3
STAT,1834,35,20-24,1869,0.583013483119271
STAT,1765,105,na,1870,0.016768469749079508
STAT,1927,36,30-34,1963,2.2924388780706857
SIM,1865,81,na,1946,327
SIM,1887,21,30-34,1908,22
SIM,1827,38,50-100,1865,1
STAT,1791,105,na,1896,0.005213645925421864
SIM,1901,49,50-100,1950,1
STAT,1879,21,30-34,1900,18.83082404553225
SIM,1813,87,na,1900,61
SIM,1887,35,50-100,1922,3
STAT,1915,26,45-49,1941,1.7841822756847334
SIM,1917,19,25-29,1936,64
STAT,1935,27,25-29,1962,90.64885935124995
STAT,1837,26,na,1863,1907.7904718853279
STAT,1889,36,45-49,1925,2.494626026743715
SIM,1890,64,na,1954,2385
STAT,1904,29,15-19,1933,0.6529049668019098
SIM,1771,87,na,1858,30
SIM,1943,27,25-29,1970,79
STAT,1900,59,na,1959,2816.3530143511157
STAT,1831,37,45-49,1868,1.593504555123069
SIM,1841,47,na,1888,1558
SIM,1841,31,35-39,1872,12
STAT,1917,39,25-29,1956,1.026011836606431
STAT,1892,30,35-39,1922,12.938000906671958
STAT,1873,49,15-19,1922,4.0101210999551553E-4
STAT,1920,36,na,1956,4163.475131055528
STAT,1812,105,na,1917,0.013311908751628923
SIM,1889,26,45-49,1915,2
SIM,1871,81,na,1952,542
STAT,1828,65,na,1893,1097.0512705847268
STAT,1829,53,40-44,1882,0.006770663338136833
STAT,1860,25,20-24,1885,9.931684993525744
SIM,1914,41,40-44,1955,2
SIM,1804,83,na,1887,130
SIM,1895,48,50-100,1943,1
STAT,1816,47,20-24,1863,0.031030707860742374
SIM,1888,54,na,1942,2663
STAT,1897,35,40-44,1932,5.983689408486089
STAT,1915,16,45-49,1931,0.10575694844934982
STAT,1896,44,40-44,1940,0.20600083840783032
STAT,1824,90,na,1914,39.19565237779769
SIM,1923,16,45-49,1939,1
STAT,1886,43,na,1929,2446.8855322751792
SIM,1925,39,25-29,1964,1
SIM,1859,57,na,1916,1890
STAT,1926,46,40-44,1972,0.197100335464514
STAT,1805,96,na,1901,3.4086972883166946
SIM,1897,36,45-49,1933,3
STAT,1833,31,35-39,1864,9.355248705662252
STAT,1795,109,na,1904,1.6472440125282265E-4
STAT,1827,27,25-29,1854,126.11819680031601
STAT,1863,45,40-44,1908,0.15473251742232982
STAT,1938,26,40-44,1964,4.6638451863529315
STAT,1910,15,30-34,1925,2.44800834074579
STAT,1833,23,50-100,1856,0.38646514275088734
STAT,1802,72,na,1874,556.3593692841065
SIM,1899,7,na,1906,3938
STAT,1942,29,35-39,1971,15.894048789336342
SIM,1877,19,30-34,1896,6
STAT,1768,90,na,1858,50.190789053681655
STAT,1894,18,25-29,1912,7.349341561098926
SIM,1928,30,30-34,1958,33
STAT,1820,54,50-100,1874,0.023686584715620733
STAT,1887,48,50-100,1935,0.273469959899718
SIM,1777,88,na,1865,36
SIM,1921,29,50-100,1950,2
SIM,1907,22,na,1929,3690
STAT,1934,37,35-39,1971,3.3726078026679964
STAT,1871,36,35-39,1907,7.1312995515024085
SIM,1881,44,na,1925,1992
SIM,1919,23,na,1942,3905
STAT,1912,20,50-100,1932,0.6400018146742983
STAT,1876,60,na,1936,1988.8888618537753
SIM,1848,85,na,1933,171
SIM,1832,70,na,1902,854
STAT,1887,49,45-49,1936,0.14698203401479037
STAT,1920,37,35-39,1957,2.674294733049174
SIM,1836,84,na,1920,225
SIM,1864,34,40-44,1898,11
SIM,1905,28,45-49,1933,3
SIM,1936,21,25-29,1957,115
STAT,1870,99,na,1969,11.750486729946305
STAT,1934,19,35-39,1953,5.704140628083432
SIM,1951,19,25-29,1970,66
STAT,1852,5,na,1857,2306.461847810488
STAT,1853,42,15-19,1895,0.01140634458894122
STAT,1833,24,45-49,1857,0.6561104273746649
STAT,1911,23,20-24,1934,106.0642589611734
SIM,1907,47,50-100,1954,2
STAT,1903,36,45-49,1939,0.6218944302904557
SIM,1886,17,30-34,1903,2
STAT,1847,63,na,1910,1335.9746594191433
SIM,1842,84,na,1926,165
SIM,1913,22,na,1935,3564
SIM,1935,36,30-34,1971,3
STAT,1853,24,15-19,1877,3.1773781127729706
STAT,1873,21,35-39,1894,5.9930429441048
SIM,1861,24,15-19,1885,1
SIM,1889,33,35-39,1922,15
STAT,1846,46,na,1892,1712.2176941264179
STAT,1932,21,na,1953,4856.78536145585
STAT,1936,31,25-29,1967,9.068657280521544
SIM,1919,28,45-49,1947,1
STAT,1845,54,35-39,1899,0.006117534268422054
STAT,1889,43,35-39,1932,2.2388860721467485
STAT,1849,11,na,1860,2307.9524560248183
STAT,1941,24,45-49,1965,1.1731338501833393
STAT,1832,48,15-19,1880,3.188645236690862E-4
STAT,1840,32,40-44,1872,3.702680291736867
SIM,1894,14,na,1908,3695
SIM,1905,20,35-39,1925,18
STAT,1857,46,na,1903,1778.4593144768153
STAT,1928,21,25-29,1949,116.92098634120119
STAT,1924,17,20-24,1941,163.14433995519354
SIM,1824,44,na,1868,1509
STAT,1818,37,25-29,1855,7.273778426232524
STAT,1907,31,35-39,1938,8.660159999798733
SIM,1868,62,na,1930,1675
STAT,1897,21,20-24,1918,93.59328464072168
SIM,1881,26,45-49,1907,4
STAT,1859,112,na,1971,3.9257615034548433E-4
STAT,1883,23,50-100,1906,0.40180293111613924
STAT,1900,28,na,1928,3336.532642629516
SIM,1879,40,35-39,1919,4
STAT,1826,85,na,1911,150.42314948708525
SIM,1856,21,25-29,1877,58
SIM,1906,31,40-44,1937,4
STAT,1821,42,30-34,1863,1.833054699380198
SIM,1865,22,40-44,1887,5
SIM,1908,27,35-39,1935,2
STAT,1835,62,na,1897,1371.799567649303
SIM,1898,17,20-24,1915,26
STAT,1896,39,45-49,1935,2.638311247530489
STAT,1874,58,na,1932,2045.2107325310803
STAT,1908,44,30-34,1952,0.11793406006037198
STAT,1882,27,45-49,1909,1.0862623577617034
SIM,1935,18,50-100,1953,1
SIM,1823,86,na,1909,163
STAT,1864,31,35-39,1895,9.267396385513313
STAT,1838,23,35-39,1861,5.031796125158553
STAT,1853,87,na,1940,145.69737334478938
SIM,1934,35,35-39,1969,8
STAT,1829,48,45-49,1877,0.1737976287672781
STAT,1906,38,15-19,1944,0.017742024760793507
SIM,1828,58,na,1886,1178
STAT,1896,23,50-100,1919,0.5434990260843499
STAT,1848,21,25-29,1869,57.32066972377653
SIM,1891,33,50-100,1924,6
STAT,1926,35,35-39,1961,2.9927264677275316
STAT,1893,27,20-24,1920,15.044899732062397
STAT,1923,38,50-100,1961,0.49103790293418087
SIM,1929,26,40-44,1955,8
SIM,1856,77,na,1933,646
STAT,1903,37,35-39,1940,2.195921904361187
STAT,1844,34,15-19,1878,0.13196608220049055
STAT,1867,32,15-19,1899,0.135461301489503
STAT,1863,39,50-100,1902,1.0876365652627376
STAT,1914,36,na,1950,3808.177944698643
STAT,1885,28,25-29,1913,42.37751842677462
STAT,1889,25,40-44,1914,3.755967895799948
STAT,1851,27,20-24,1878,10.400655368185744
SIM,1941,21,35-39,1962,12
STAT,1779,108,na,1887,0.005990105932832727
STAT,1870,24,15-19,1894,3.2514503717778496
SIM,1913,22,35-39,1935,14
SIM,1850,88,na,1938,111
STAT,1800,93,na,1893,10.251851958227292
STAT,1888,78,na,1966,1292.3333688046387
STAT,1871,14,na,1885,2625.3199063738407
STAT,1922,42,40-44,1964,0.2900297716290346
STAT,1904,47,15-19,1951,3.2551222679305154E-4
STAT,1843,66,na,1909,1105.4595512351502
SIM,1829,42,50-100,1871,2
SIM,1919,16,na,1935,3929
SIM,1823,36,45-49,1859,3
STAT,1861,46,20-24,1907,0.010099956256419386
SIM,1864,20,20-24,1884,98
STAT,1847,34,50-100,1881,0.7179242416355858
STAT,1875,20,35-39,1895,6.088775597245023
SIM,1832,63,na,1895,1029
SIM,1897,25,40-44,1922,5
SIM,1911,37,35-39,1948,1
SIM,1892,26,20-24,1918,23
STAT,1848,45,50-100,1893,0.2025213147012278
STAT,1868,24,50-100,1892,0.39117212774003607
STAT,1961,9,na,1970,5127.240199806055
STAT,1905,22,35-39,1927,8.520364612290624
STAT,1880,65,na,1945,1792.5609792585735
STAT,1884,79,na,1963,944.9596816070936
SIM,1856,76,na,1932,759
SIM,1892,28,na,1920,3303
SIM,1915,24,45-49,1939,3
STAT,1855,38,45-49,1893,1.493096321541354
STAT,1913,17,45-49,1930,0.103050950415115
SIM,1879,22,35-39,1901,8
SIM,1920,25,30-34,1945,57
SIM,1916,26,30-34,1942,56
STAT,1795,92,na,1887,13.417639201230338
SIM,1942,19,na,1961,4379
STAT,1764,93,na,1857,3.441348618783479
STAT,1858,31,na,1889,1910.6175390691017
STAT,1939,17,45-49,1956,0.5047948938715302
STAT,1853,47,25-29,1900,0.047411776322663836
SIM,1788,88,na,1876,50
SIM,1877,7,na,1884,2856
STAT,1830,54,40-44,1884,0.0074431556725526975
SIM,1958,2,na,1960,5249
SIM,1872,28,45-49,1900,1
STAT,1858,32,na,1890,1890.880859890518
STAT,1821,55,na,1876,1357.556076779171
STAT,1826,105,na,1931,0.016088849828313427
STAT,1852,42,50-100,1894,0.80021818963038
STAT,1841,26,45-49,1867,1.0387317480687719
STAT,1873,37,50-100,1910,1.257097564430252
STAT,1806,81,na,1887,211.59948547986986
STAT,1895,27,na,1922,3147.7367453370994
SIM,1822,34,40-44,1856,5
SIM,1846,23,35-39,1869,8
STAT,1874,45,50-100,1919,0.25652920414833463
STAT,1880,48,45-49,1928,0.24718230139035755
SIM,1893,28,25-29,1921,69
STAT,1870,39,25-29,1909,2.826814027868016
SIM,1881,43,na,1924,2006
STAT,1855,98,na,1953,2.4452446624111066
STAT,1889,22,25-29,1911,71.2933523181913
STAT,1857,18,20-24,1875,16.328011436714778
STAT,1791,71,na,1862,542.9806137784731
STAT,1795,85,na,1880,103.12646557124046
STAT,1913,30,50-100,1943,0.8366450192078781
SIM,1897,22,25-29,1919,81
STAT,1845,40,50-100,1885,0.8064775866975186
STAT,1914,35,na,1949,3825.9302611101925
STAT,1923,44,45-49,1967,0.19588930030907103
STAT,1845,20,45-49,1865,0.6417221493376053
STAT,1838,41,35-39,1879,1.43592529096437
STAT,1857,22,40-44,1879,1.8962301147004674
STAT,1881,25,40-44,1906,2.93616320086964
SIM,1826,37,25-29,1863,5
STAT,1932,28,15-19,1960,0.9339848443931761
STAT,1820,45,20-24,1865,0.02103881464095063
STAT,1930,37,15-19,1967,0.02531682123535761
STAT,1785,71,na,1856,580.9734662940001
STAT,1789,85,na,1874,107.9863006149012
SIM,1915,31,35-39,1946,23
STAT,1861,39,30-34,1900,4.427989824223327
STAT,1825,37,20-24,1862,1.2728602047865656
STAT,1818,44,15-19,1862,0.025382982501760312
STAT,1928,28,50-100,1956,1.2388633600545427
SIM,1822,64,na,1886,1025
SIM,1879,31,20-24,1910,7
STAT,1866,39,na,1905,2181.2104815367047
SIM,1902,43,40-44,1945,2
SIM,1932,17,20-24,1949,268
STAT,1909,16,20-24,1925,26.894631699867798
STAT,1908,26,30-34,1934,37.83751299763459
SIM,1801,71,na,1872,408
STAT,1849,46,20-24,1895,0.00940887298868878
STAT,1852,112,na,1964,1.1003141375565386E-4
STAT,1912,25,30-34,1937,39.22063857079483
SIM,1939,29,25-29,1968,80
STAT,1824,99,na,1923,0.9415375408432811
STAT,1862,43,30-34,1905,0.9955202314290431
SIM,1853,32,na,1885,1838
SIM,1829,41,35-39,1870,6
STAT,1832,25,45-49,1857,1.0438552736449167
STAT,1885,35,15-19,1920,0.056990452705343184
STAT,1878,79,na,1957,811.4892113343967
SIM,1846,41,35-39,1887,2
SIM,1867,38,25-29,1905,3
SIM,1831,85,na,1916,168
STAT,1911,24,35-39,1935,8.952914314731437
STAT,1866,16,20-24,1882,17.11916316790622
STAT,1921,39,15-19,1960,0.02160994712116256
SIM,1936,19,na,1955,3557
STAT,1888,32,35-39,1920,12.072593693127752
STAT,1896,47,50-100,1943,0.18435204571106448
STAT,1916,19,15-19,1935,9.66490399373791
STAT,1868,35,15-19,1903,0.054720282013259895
STAT,1849,16,20-24,1865,17.16300725457478
STAT,1876,5,na,1881,2853.445489566259
SIM,1869,22,25-29,1891,1
SIM,1923,23,40-44,1946,3
STAT,1874,65,na,1939,1747.741643846603
STAT,1836,84,na,1920,209.75212235648246
STAT,1825,35,50-100,1860,2.2044245972533973
SIM,1878,18,30-34,1896,4
STAT,1911,21,30-34,1932,27.583154371151345
STAT,1920,33,40-44,1953,4.310327533250831
SIM,1907,19,15-19,1926,15
STAT,1860,7,na,1867,2356.8456227594065
SIM,1896,32,35-39,1928,20
SIM,1857,16,20-24,1873,19
STAT,1932,23,40-44,1955,4.444601681572992
SIM,1794,88,na,1882,98
STAT,1846,15,40-44,1861,0.1764361008554001
SIM,1940,23,40-44,1963,5
SIM,1871,34,35-39,1905,15
STAT,1897,38,45-49,1935,2.6859096991381888
SIM,1950,15,15-19,1965,47
STAT,1872,46,45-49,1918,0.2403197097940491
SIM,1853,25,na,1878,1872
STAT,1866,40,50-100,1906,0.9979977773579597
STAT,1911,26,25-29,1937,64.98109176777449
SIM,1840,89,na,1929,64
STAT,1897,30,35-39,1927,13.82286702932785
STAT,1916,25,15-19,1941,0.7416204973536084
STAT,1934,34,30-34,1968,21.707415498129546
STAT,1925,26,30-34,1951,46.93090973365609
STAT,1886,19,30-34,1905,1.6905761226893727
SIM,1859,23,45-49,1882,3
SIM,1840,25,45-49,1865,4
SIM,1869,17,30-34,1886,1
STAT,1843,28,25-29,1871,34.860316449404344
STAT,1887,21,50-100,1908,0.4612315089808219
STAT,1822,40,25-29,1862,1.0732900627271202
SIM,1821,43,35-39,1864,4
STAT,1906,15,40-44,1921,0.2703194609115233
STAT,1852,10,na,1862,2217.1199265416167
STAT,1856,20,20-24,1876,62.874765105093445
SIM,1865,18,20-24,1883,29
STAT,1924,21,40-44,1945,4.021331346412843
SIM,1860,29,25-29,1889,56
SIM,1827,28,30-34,1855,25
SIM,1866,43,50-100,1909,4
SIM,1874,16,20-24,1890,25
STAT,1934,16,30-34,1950,16.69942043198205
STAT,1851,52,na,1903,1621.673091655553
STAT,1852,29,25-29,1881,33.51664362557509
STAT,1880,34,35-39,1914,10.64991748946333
SIM,1843,70,na,1913,1303
SIM,1862,77,na,1939,721
SIM,1942,16,30-34,1958,15
STAT,1838,35,50-100,1873,1.012539337621098
STAT,1930,19,15-19,1949,58.984715443701354
STAT,1879,24,35-39,1903,6.112091165750072
SIM,1851,28,25-29,1879,46
STAT,1838,32,50-100,1870,0.7621616752567274
SIM,1934,17,35-39,1951,9
STAT,1935,24,20-24,1959,152.88017332972808
STAT,1877,33,15-19,1910,0.14782262489368247
STAT,1902,45,40-44,1947,0.13920613866041182
STAT,1873,80,na,1953,633.3866614384291
STAT,1926,17,35-39,1943,5.199542534542163
STAT,1877,94,na,1971,98.93516412771625
SIM,1943,24,20-24,1967,114
STAT,1818,99,na,1917,0.9757331398379174
SIM,1933,19,40-44,1952,1
STAT,1863,105,na,1968,0.23240718703501775
STAT,1824,48,50-100,1872,0.28345151282513553
SIM,1868,18,25-29,1886,10
STAT,1813,43,35-39,1856,6.101402334467285
STAT,1898,23,40-44,1921,2.8443530388924487
STAT,1947,19,45-49,1966,0.5680189933326892
SIM,1924,19,15-19,1943,50
SIM,1894,19,30-34,1913,5
SIM,1924,25,15-19,1949,1
STAT,1840,24,40-44,1864,1.8310271941397849
STAT,1804,86,na,1890,68.78597594814055
SIM,1928,33,35-39,1961,15
STAT,1915,23,40-44,1938,3.496262169386465
SIM,1825,38,25-29,1863,3
SIM,1862,44,35-39,1906,7
SIM,1889,30,30-34,1919,36
STAT,1820,38,na,1858,1412.8649546717347
STAT,1879,42,35-39,1921,1.9062476076402148
STAT,1863,41,25-29,1904,0.5772599577355684
STAT,1884,29,25-29,1913,41.83087846954446
STAT,1912,30,25-29,1942,9.249350242465502
STAT,1878,50,20-24,1928,7.84793138222355E-4
STAT,1916,18,25-29,1934,9.25418230915857
STAT,1925,19,40-44,1944,1.6984200871093547
STAT,1796,108,na,1904,3.8374859455259623E-4
SIM,1875,37,20-24,1912,2
STAT,1826,36,20-24,1862,0.9151437856506106
STAT,1813,50,25-29,1863,0.010197623099819648
STAT,1882,39,50-100,1921,1.1890700126288347
STAT,1942,15,15-19,1957,47.910898009223175
SIM,1809,82,na,1891,130
SIM,1839,32,40-44,1871,8
SIM,1849,24,15-19,1873,4
STAT,1912,49,15-19,1961,3.5507679963493125E-4
SIM,1887,42,35-39,1929,3
STAT,1836,32,15-19,1868,0.11355518856604349
STAT,1859,45,15-19,1904,3.281734089248195E-4
STAT,1883,15,45-49,1898,0.06486285996382402
SIM,1892,29,25-29,1921,82
SIM,1924,18,25-29,1942,84
STAT,1867,37,20-24,1904,0.7332483615205674
SIM,1939,31,na,1970,3962
SIM,1888,82,na,1970,1161
SIM,1902,54,na,1956,3132
STAT,1898,30,30-34,1928,24.098157961027866
SIM,1857,0,na,1857,3241
STAT,1880,41,25-29,1921,0.684224715830112
STAT,1817,38,25-29,1855,9.568314895593353
STAT,1886,50,na,1936,2329.183037259065
SIM,1853,18,30-34,1871,5
SIM,1889,23,40-44,1912,2
STAT,1905,15,45-49,1920,0.09582030364408635
STAT,1869,75,na,1944,1010.889026126302
SIM,1920,30,25-29,1950,14
SIM,1837,33,50-100,1870,1
STAT,1927,41,50-100,1968,0.1491349256883486
STAT,1831,45,45-49,1876,0.18086313182520575
STAT,1907,54,na,1961,3218.653826177189
STAT,1917,27,35-39,1944,15.892817221218134
STAT,1939,28,20-24,1967,18.51674360559595
SIM,1868,31,45-49,1899,1
STAT,1898,19,20-24,1917,24.143883834497686
SIM,1840,20,35-39,1860,9
STAT,1867,42,50-100,1909,1.0036829753548142
STAT,1812,46,25-29,1858,0.1350089639515167
STAT,1881,1,na,1882,3291.4199253985134
SIM,1903,30,25-29,1933,25
STAT,1911,33,15-19,1944,0.12571154044426963
SIM,1903,35,35-39,1938,4
SIM,1868,61,na,1929,1723
SIM,1874,62,na,1936,1719
STAT,1877,54,30-34,1931,0.006034440889570861
STAT,1865,46,50-100,1911,0.2271491666660019
STAT,1906,33,40-44,1939,3.6477987333256547
SIM,1839,28,20-24,1867,11
STAT,1951,16,30-34,1967,14.668674483357638
STAT,1887,16,40-44,1903,0.20675644581116506
STAT,1894,78,na,1972,1515.661482506292
STAT,1871,13,na,1884,2637.2932175816613
STAT,1834,34,50-100,1868,0.6845938219127042
SIM,1817,86,na,1903,75
STAT,1880,50,50-100,1930,0.016249853966182816
SIM,1869,47,na,1916,2175
STAT,1896,36,40-44,1932,5.8805441264022855
SIM,1822,49,na,1871,1466
STAT,1931,36,20-24,1967,0.35315557891110516
STAT,1833,67,na,1900,1121.5348935677969
STAT,1926,42,25-29,1968,0.08897172452648501
SIM,1890,57,na,1947,2737
STAT,1845,18,30-34,1863,1.4633057498651592
STAT,1770,93,na,1863,3.4164142374625186
STAT,1826,31,15-19,1857,0.21232577931019778
STAT,1939,32,40-44,1971,4.030901697567449
SIM,1855,36,45-49,1891,1
SIM,1873,21,25-29,1894,60
SIM,1925,27,35-39,1952,1
STAT,1767,89,na,1856,27.508592580000006
SIM,1887,28,na,1915,2614
STAT,1839,34,40-44,1873,3.7059009002209726
STAT,1924,31,35-39,1955,10.779817698084246
STAT,1867,50,45-49,1917,0.014002903250037925
SIM,1869,26,40-44,1895,4
STAT,1833,45,50-100,1878,0.20959149821292375
STAT,1861,49,25-29,1910,0.047333179099355305
SIM,1906,34,45-49,1940,2
SIM,1929,29,45-49,1958,3
STAT,1857,50,35-39,1907,0.006883560369300766
STAT,1847,30,20-24,1877,2.426158738702193
SIM,1890,36,50-100,1926,4
STAT,1941,1,na,1942,4317.689201909399
STAT,1790,106,na,1896,0.0022420539226918187
STAT,1865,21,25-29,1886,53.82332966957163
STAT,1867,79,na,1946,665.0042419387245
STAT,1899,37,20-24,1936,0.23062927709110215
SIM,1863,38,45-49,1901,6
STAT,1849,49,25-29,1898,0.044094435558929584
STAT,1858,24,15-19,1882,2.690322425287163
STAT,1893,42,50-100,1935,1.3531696925529528
SIM,1870,37,25-29,1907,6
SIM,1937,20,30-34,1957,30
STAT,1887,19,45-49,1906,0.07326563097883257
SIM,1908,24,30-34,1932,33
STAT,1847,36,45-49,1883,1.5648005075028033
STAT,1826,39,25-29,1865,3.1402109678198835
STAT,1879,64,na,1943,1832.229459437388
STAT,1946,23,35-39,1969,10.57938042786737
STAT,1893,22,15-19,1915,4.230805250187136
SIM,1865,25,45-49,1890,3
STAT,1916,15,20-24,1931,29.16291135039102
STAT,1921,43,35-39,1964,0.22870491497042517
STAT,1871,33,30-34,1904,17.445570807391032
SIM,1815,67,na,1882,786
STAT,1964,6,na,1970,4999.667942111768
STAT,1835,99,na,1934,1.4214377115410461
STAT,1863,7,na,1870,2527.484200333363
STAT,1923,38,15-19,1961,0.022459116902152708
STAT,1831,85,na,1916,172.26621492187485
STAT,1857,25,45-49,1882,0.9145451987148165
SIM,1834,39,25-29,1873,6
SIM,1841,74,na,1915,683
STAT,1856,37,45-49,1893,1.5436489717921136
STAT,1860,66,na,1926,1353.2103035231796
SIM,1929,21,35-39,1950,15
SIM,1873,24,40-44,1897,3
STAT,1865,13,na,1878,2481.817454054821
SIM,1919,21,25-29,1940,5
STAT,1837,33,na,1870,1834.5098858313208
STAT,1879,17,45-49,1896,0.0688499086380476
STAT,1852,21,15-19,1873,2.993698154260711
STAT,1921,25,35-39,1946,17.014287401569497
STAT,1784,92,na,1876,9.541385824415869
STAT,1888,37,45-49,1925,2.3764587895433684
STAT,1929,20,30-34,1949,36.95532109872098
SIM,1863,35,40-44,1898,5
STAT,1818,66,na,1884,912.9562386490834
STAT,1946,2,na,1948,4522.6174603033605
STAT,1935,34,na,1969,5279.6994011530915
SIM,1932,35,50-100,1967,1
STAT,1891,17,45-49,1908,0.08168436778718355
STAT,1840,47,15-19,1887,2.827558048696375E-4
STAT,1924,35,50-100,1959,0.5011532192764301
SIM,1767,89,na,1856,12
SIM,1891,40,35-39,1931,7
STAT,1837,19,35-39,1856,0.5433877473846875
STAT,1865,24,40-44,1889,1.9173340662760963
STAT,1926,37,25-29,1963,1.2161522310265231
STAT,1894,48,25-29,1942,0.04171858623749312
STAT,1872,94,na,1966,69.90249563701362
STAT,1881,28,45-49,1909,1.0771478128909664
STAT,1908,19,40-44,1927,0.272415570790422
STAT,1898,26,45-49,1924,1.5254538221895333
STAT,1905,46,20-24,1951,0.009911454106626279
SIM,1888,30,35-39,1918,17
SIM,1845,33,na,1878,2028
STAT,1825,48,na,1873,1857.229640243392
SIM,1871,29,na,1900,2249
STAT,1909,34,20-24,1943,2.3286914386867936
SIM,1932,31,35-39,1963,20
STAT,1918,48,35-39,1966,0.13812958131685943
STAT,1878,17,30-34,1895,1.671100025380913
SIM,1860,11,na,1871,2439
SIM,1870,22,15-19,1892,3
STAT,1850,51,40-44,1901,0.008099736284982445
SIM,1908,29,25-29,1937,64
STAT,1911,31,25-29,1942,9.117167586994768
SIM,1896,37,45-49,1933,8
SIM,1901,38,25-29,1939,1
STAT,1859,38,25-29,1897,2.327273480195906
STAT,1881,48,15-19,1929,3.8453270569113507E-4
STAT,1913,37,15-19,1950,0.01912091143167893
STAT,1849,98,na,1947,2.539881326950503
SIM,1951,17,35-39,1968,9
STAT,1836,53,30-34,1889,0.0037249889484099927
STAT,1857,32,35-39,1889,8.031885152838186
STAT,1860,28,25-29,1888,35.04593907617683
STAT,1846,53,40-44,1899,0.007860997694197193
STAT,1943,17,35-39,1960,4.492956196814171
SIM,1864,47,na,1911,2458
SIM,1899,6,na,1905,3946
SIM,1928,26,45-49,1954,5
STAT,1873,20,20-24,1893,70.98116407173146
SIM,1860,21,15-19,1881,3
STAT,1907,21,40-44,1928,3.1000946195853514
STAT,1874,18,20-24,1892,18.286625846563243
STAT,1847,32,na,1879,1905.2592073760618
SIM,1813,56,na,1869,1169
SIM,1865,32,35-39,1897,10
STAT,1893,40,45-49,1933,1.9387204108320577
STAT,1864,36,50-100,1900,1.1243345715324564
STAT,1923,41,40-44,1964,0.2958075655849772
STAT,1954,18,45-49,1972,0.6237100706796721
SIM,1880,58,na,1938,1830
STAT,1870,36,20-24,1906,0.7681985340294755
SIM,1897,27,na,1924,3282
STAT,1839,31,25-29,1870,9.02967145249174
STAT,1883,40,35-39,1923,1.8078157202574496
SIM,1898,31,35-39,1929,20
SIM,1866,39,25-29,1905,2
STAT,1911,29,40-44,1940,4.553105092896362
STAT,1862,22,15-19,1884,2.9456398489723052
SIM,1822,37,45-49,1859,1
SIM,1847,31,25-29,1878,15
STAT,1926,44,15-19,1970,0.0019070043142595692
STAT,1831,48,na,1879,1496.7388975240297
STAT,1892,28,20-24,1920,14.815861160356414
SIM,1940,24,na,1964,3772
STAT,1846,18,45-49,1864,0.061905985559408495
STAT,1849,30,35-39,1879,9.361043566653406
SIM,1888,35,40-44,1923,5
STAT,1947,16,40-44,1963,1.5919654583725873
SIM,1868,29,30-34,1897,4
SIM,1837,17,30-34,1854,2
SIM,1917,16,20-24,1933,36
SIM,1835,44,na,1879,1463
STAT,1946,16,45-49,1962,0.5597588824226477
STAT,1836,41,50-100,1877,0.8030565719733324
STAT,1913,57,na,1970,3459.082575241622
STAT,1926,19,25-29,1945,53.40968789240195
STAT,1852,26,20-24,1878,10.43768936846204
STAT,1958,1,na,1959,5223.736239042885
SIM,1814,45,na,1859,1388
STAT,1906,18,45-49,1924,0.09584439238971888
STAT,1860,14,na,1874,2252.5627894990816
SIM,1879,46,na,1925,2659
STAT,1822,49,20-24,1871,0.017300136871606513
SIM,1809,67,na,1876,747
STAT,1830,63,na,1893,1177.1765623737867
SIM,1844,11,na,1855,2067
SIM,1903,30,50-100,1933,1
STAT,1873,26,45-49,1899,1.1407513614237401
SIM,1891,22,35-39,1913,7
STAT,1864,28,na,1892,2167.390509190735
STAT,1828,104,na,1932,0.043298809345133075
STAT,1862,46,35-39,1908,0.12245753796091094
STAT,1951,19,35-39,1970,5.045075587284688
SIM,1931,2,na,1933,5277
STAT,1852,47,na,1899,1698.3064481359324
STAT,1870,17,25-29,1887,5.67373265229893
SIM,1914,3,na,1917,4432
STAT,1927,41,25-29,1968,0.09065064167450287
SIM,1896,42,na,1938,3088
SIM,1812,71,na,1883,561
SIM,1857,30,35-39,1887,13
SIM,1797,92,na,1889,15
STAT,1827,29,50-100,1856,1.0575762110206501
SIM,1835,29,50-100,1864,1
STAT,1833,28,15-19,1861,0.42157478511943525
STAT,1854,44,35-39,1898,1.3406475774195596
STAT,1892,46,na,1938,2860.0286892632193
SIM,1939,26,20-24,1965,22
SIM,1901,33,30-34,1934,42
SIM,1938,22,35-39,1960,14
SIM,1839,35,45-49,1874,2
SIM,1879,61,na,1940,2155
STAT,1918,40,25-29,1958,0.07686317201078013
STAT,1928,28,45-49,1956,2.1502739146125847
STAT,1846,47,na,1893,1699.410305774353
STAT,1838,16,45-49,1854,0.058102824579696635
SIM,1827,48,na,1875,1424
STAT,1835,54,50-100,1889,0.011107684653114448
SIM,1858,47,na,1905,1827
STAT,1925,29,35-39,1954,17.79289458541373
STAT,1871,30,15-19,1901,0.14404392021659349
STAT,1820,48,25-29,1868,0.09648777280911318
SIM,1934,19,25-29,1953,81
STAT,1882,13,na,1895,2522.6753008475257
STAT,1933,34,50-100,1967,1.1244749953249866
SIM,1865,10,na,1875,2497
STAT,1884,26,20-24,1910,11.724564873348568
SIM,1902,23,20-24,1925,133
SIM,1910,58,na,1968,2976
STAT,1880,45,40-44,1925,0.1834040475945663
STAT,1844,27,25-29,1871,40.97074603782953
STAT,1898,33,35-39,1931,13.807552771083023
SIM,1827,30,45-49,1857,2
STAT,1884,43,50-100,1927,1.0446197922156824
STAT,1866,38,20-24,1904,0.7173472095775458
SIM,1924,15,20-24,1939,161
STAT,1906,36,45-49,1942,0.636027965763952
STAT,1883,79,na,1962,913.9441865751234
STAT,1910,24,50-100,1934,0.6195219927423283
SIM,1867,76,na,1943,828
SIM,1859,10,na,1869,2619
SIM,1927,42,na,1969,5106
STAT,1817,81,na,1898,247.41183795363747
STAT,1836,36,30-34,1872,4.1699043727006755
STAT,1908,23,15-19,1931,4.924789713570539
SIM,1863,62,na,1925,1681
SIM,1932,24,45-49,1956,2
STAT,1886,21,45-49,1907,0.7458638940555019
STAT,1919,43,40-44,1962,0.27324612200401527
STAT,1836,28,50-100,1864,0.5184251810258229
STAT,1878,24,na,1902,2464.123479469631
SIM,1901,15,30-34,1916,4
STAT,1890,49,15-19,1939,2.726533703201345E-4
STAT,1828,54,35-39,1882,0.006623810040448579
STAT,1919,3,na,1922,4525.661868476532
STAT,1840,27,45-49,1867,0.9704374331500658
STAT,1813,54,40-44,1867,0.027961897524141605
STAT,1894,42,na,1936,3012.0531548733547
SIM,1873,27,45-49,1900,1
STAT,1874,29,15-19,1903,0.4658608811360446
SIM,1871,39,50-100,1910,1
STAT,1843,25,20-24,1868,9.879081310891703
STAT,1930,22,40-44,1952,4.353598249285193
STAT,1861,51,na,1912,1815.7571715591469
SIM,1839,42,35-39,1881,3
SIM,1847,34,40-44,1881,5
STAT,1924,24,45-49,1948,1.3332407591972022
STAT,1895,45,35-39,1940,0.10519916384907031
STAT,1918,46,30-34,1964,0.09601109546189449
STAT,1874,47,45-49,1921,0.24293088272222743
SIM,1916,23,15-19,1939,10
STAT,1920,36,45-49,1956,0.7544303730045823
SIM,1906,27,20-24,1933,4
STAT,1821,45,35-39,1866,0.21122532626812973
STAT,1936,36,35-39,1972,2.3994434984220487
SIM,1909,61,na,1970,3489
SIM,1871,31,30-34,1902,23
SIM,1874,19,25-29,1893,13
STAT,1870,28,na,1898,2358.594110610566
SIM,1828,28,45-49,1856,1
SIM,1850,21,35-39,1871,8
STAT,1855,51,na,1906,1628.4887987415004
SIM,1909,17,na,1926,4125
SIM,1955,16,40-44,1971,6
STAT,1885,17,50-100,1902,0.049253383883325445
SIM,1851,25,20-24,1876,18
STAT,1829,99,na,1928,1.1166958007551637
STAT,1925,42,na,1967,4544.148347887054
SIM,1826,30,na,1856,2203
SIM,1927,43,40-44,1970,1
SIM,1942,20,na,1962,4374
STAT,1819,35,50-100,1854,4.3434612565046065
STAT,1926,32,30-34,1958,19.253871484039205
SIM,1852,27,25-29,1879,8
SIM,1857,62,na,1919,1560
STAT,1908,49,25-29,1957,0.04814259109013742
SIM,1934,32,30-34,1966,40
STAT,1950,21,35-39,1971,11.289222722236673
STAT,1866,19,25-29,1885,5.375829662616658
STAT,1926,20,na,1946,4510.562629778894
SIM,1833,48,na,1881,1628
SIM,1894,21,45-49,1915,1
STAT,1896,40,25-29,1936,0.06021848483399875
SIM,1909,54,na,1963,3644
SIM,1862,36,35-39,1898,7
SIM,1844,27,na,1871,1779
STAT,1921,40,30-34,1961,0.145836017895533
SIM,1882,66,na,1948,1282
STAT,1843,31,15-19,1874,0.11667506256487822
SIM,1859,41,45-49,1900,4
STAT,1884,50,45-49,1934,0.014662006111822846
STAT,1809,85,na,1894,126.58126398460578
STAT,1840,30,35-39,1870,8.827912333505406
SIM,1895,45,50-100,1940,3
STAT,1936,30,50-100,1966,0.8116773008300204
STAT,1927,38,35-39,1965,3.0364738778893967
SIM,1884,39,50-100,1923,1
STAT,1914,18,50-100,1932,0.07798879017689804
STAT,1938,24,50-100,1962,0.656981104687899
SIM,1881,20,20-24,1901,48
STAT,1863,34,35-39,1897,8.98501731612592
SIM,1876,39,30-34,1915,2
STAT,1823,84,na,1907,183.98385352844534
STAT,1946,8,na,1954,4410.4474955838405
SIM,1880,65,na,1945,1501
STAT,1868,39,30-34,1907,5.09281475188613
STAT,1940,25,na,1965,3859.906552539873
SIM,1926,36,na,1962,4591
SIM,1869,20,20-24,1889,91
STAT,1811,53,30-34,1864,0.013896136890227267
STAT,1868,96,na,1964,26.414199184967842
STAT,1911,46,45-49,1957,0.2080979741013631
SIM,1852,46,na,1898,1693
SIM,1855,33,40-44,1888,6
STAT,1877,7,na,1884,2799.563665702755
SIM,1827,39,35-39,1866,21
SIM,1844,36,30-34,1880,5
STAT,1921,42,na,1963,4224.8195697019755
STAT,1824,53,40-44,1877,0.01164149857291587
STAT,1883,63,na,1946,1763.5551694259568
SIM,1863,83,na,1946,249
STAT,1853,44,20-24,1897,0.1295618789524615
STAT,1884,11,na,1895,2576.0044288791746
STAT,1875,44,na,1919,2364.89980921164
SIM,1880,24,35-39,1904,5
STAT,1857,37,15-19,1894,0.044263514915535554
STAT,1927,45,40-44,1972,0.20097463829900017
STAT,1820,51,30-34,1871,0.009911743221802868
STAT,1913,32,35-39,1945,9.173520285755353
STAT,1819,39,35-39,1858,17.077964032177967
STAT,1847,25,na,1872,1975.081961870464
SIM,1844,28,50-100,1872,1
STAT,1888,34,40-44,1922,5.125588204238106
STAT,1856,31,25-29,1887,8.112227451899447
STAT,1887,42,25-29,1929,0.7232342593467069
STAT,1854,76,na,1930,711.013712481438
STAT,1859,10,na,1869,2279.25290031376
STAT,1920,19,40-44,1939,1.5762103266744023
SIM,1855,15,25-29,1870,10
SIM,1870,34,20-24,1904,3
SIM,1874,43,50-100,1917,1
STAT,1910,48,50-100,1958,0.21231400466947617
STAT,1900,16,20-24,1916,24.934416626707545
STAT,1901,45,20-24,1946,0.009679486204875102
STAT,1899,15,50-100,1914,0.06822570432363924
SIM,1830,30,30-34,1860,22
STAT,1786,87,na,1873,58.976175905711244
STAT,1864,30,20-24,1894,2.483335301441918
STAT,1855,34,50-100,1889,0.6878003876651259
SIM,1855,34,50-100,1889,1
SIM,1912,25,35-39,1937,20
STAT,1856,61,na,1917,1446.9709633798534
SIM,1852,6,na,1858,2315
SIM,1800,86,na,1886,124
SIM,1922,36,na,1958,4828
SIM,1886,42,30-34,1928,1
STAT,1950,18,25-29,1968,51.75199237670346
STAT,1871,78,na,1949,784.0081511444292
SIM,1909,26,50-100,1935,1
STAT,1895,37,35-39,1932,9.328924368098447
SIM,1846,32,50-100,1878,1
STAT,1896,42,35-39,1938,0.16790635239995616
STAT,1901,38,na,1939,3345.3733813986773
STAT,1904,25,35-39,1929,14.080219453387476
STAT,1941,18,15-19,1959,47.17894749761439
STAT,1879,50,35-39,1929,0.00920434329159695
STAT,1894,45,20-24,1939,0.008889721451415686
SIM,1835,38,30-34,1873,7
STAT,1837,70,na,1907,957.1485692877142
SIM,1929,34,50-100,1963,1
STAT,1803,54,35-39,1857,0.035819107399894856
SIM,1843,79,na,1922,639
SIM,1844,17,na,1861,2026
STAT,1831,23,35-39,1854,13.731179115159316
STAT,1942,23,15-19,1965,5.633377223906247
SIM,1864,31,25-29,1895,12
SIM,1921,32,35-39,1953,10
STAT,1828,46,35-39,1874,0.1292544657274628
STAT,1917,16,30-34,1933,2.6540603982791926
STAT,1833,51,40-44,1884,0.007858581425395797
STAT,1899,43,15-19,1942,0.0013196933902748069
STAT,1853,30,45-49,1883,1.5162278190273326
STAT,1843,17,50-100,1860,0.04222724809596585
STAT,1867,18,30-34,1885,1.5408040169332196
SIM,1899,0,na,1899,4134
STAT,1847,15,25-29,1862,5.358480896979424
SIM,1823,49,50-100,1872,2
STAT,1870,45,35-39,1915,0.14023463256896496
STAT,1860,53,25-29,1913,0.002877425850539713
STAT,1856,77,na,1933,669.3388243669435
STAT,1847,33,40-44,1880,3.77307968774561
SIM,1821,54,na,1875,1133
STAT,1900,40,50-100,1940,0.10396654614255502
STAT,1845,43,30-34,1888,0.8445452648457077
STAT,1850,43,40-44,1893,1.7098600635478025
SIM,1939,21,40-44,1960,3
STAT,1798,72,na,1870,654.8691724740908
SIM,1785,74,na,1859,344
SIM,1856,12,na,1868,2515
STAT,1838,49,50-100,1887,0.1648664137786279
SIM,1814,72,na,1886,566
SIM,1940,27,20-24,1967,29
SIM,1814,82,na,1896,153
STAT,1816,54,45-49,1870,0.034633404263181136
STAT,1907,35,15-19,1942,0.018148150805058494
STAT,1863,59,na,1922,1739.186179944995
STAT,1868,29,50-100,1897,0.6130759130505649
STAT,1834,52,na,1886,1314.1004743618594
STAT,1878,42,30-34,1920,1.2038911310517713
SIM,1921,30,50-100,1951,1
STAT,1925,40,15-19,1965,0.0018841909806193427
STAT,1863,49,na,1912,1971.322077173465
SIM,1853,29,35-39,1882,7
SIM,1864,31,na,1895,2582
STAT,1827,54,20-24,1881,6.391244085478986E-4
STAT,1859,51,50-100,1910,0.012327200825258284
STAT,1960,7,na,1967,5170.365466962645
STAT,1852,54,30-34,1906,0.004390223522662605
STAT,1845,29,35-39,1874,8.458730307477905
STAT,1831,30,25-29,1861,8.681708058687327
STAT,1864,96,na,1960,15.582918367207423
STAT,1895,64,na,1959,2392.249181860296
STAT,1932,27,20-24,1959,24.161777007207636
SIM,1870,26,30-34,1896,33
STAT,1881,16,50-100,1897,0.047813944949686125
STAT,1811,44,15-19,1855,0.03631827635178652
STAT,1912,24,30-34,1936,28.778115040860676
SIM,1869,35,50-100,1904,1
SIM,1882,50,na,1932,1963
STAT,1869,44,30-34,1913,1.113688093722005
SIM,1861,29,na,1890,2049
SIM,1872,31,35-39,1903,21
STAT,1920,35,30-34,1955,2.0186214942545533
STAT,1918,16,50-100,1934,0.0828007062564255
STAT,1903,35,30-34,1938,1.6703825501817127
SIM,1917,53,na,1970,3629
STAT,1866,45,45-49,1911,0.2229153197332007
STAT,1862,26,30-34,1888,22.20456319460218
STAT,1865,54,40-44,1919,0.009442191676831854
SIM,1773,89,na,1862,50
SIM,1872,1,na,1873,3516
SIM,1880,31,25-29,1911,6
STAT,1897,32,25-29,1929,13.86908853312858
STAT,1850,52,na,1902,1639.93331800053
SIM,1846,12,na,1858,2210
STAT,1788,72,na,1860,501.73163232108146
SIM,1822,40,35-39,1862,4
STAT,1872,31,25-29,1903,10.443057611497204
STAT,1924,28,25-29,1952,77.16955422466762
SIM,1874,31,na,1905,2337
SIM,1912,27,45-49,1939,1
STAT,1840,54,35-39,1894,0.005868889988476144
SIM,1845,41,30-34,1886,1
STAT,1881,44,na,1925,2219.770485863136
STAT,1909,17,35-39,1926,0.83036629034927
STAT,1904,27,45-49,1931,1.609294223738795
SIM,1925,16,30-34,1941,14
STAT,1848,54,40-44,1902,0.008359020857145301
STAT,1823,54,35-39,1877,0.010960465955817573
STAT,1890,11,na,1901,3191.9876627151857
STAT,1907,33,50-100,1940,0.7770453552803981
SIM,1869,19,na,1888,2444
SIM,1806,53,na,1859,1305
SIM,1920,24,30-34,1944,44
SIM,1870,65,na,1935,1911
STAT,1818,101,na,1919,0.29398914566466905
STAT,1849,15,45-49,1864,0.06361345926523743
STAT,1889,21,25-29,1910,71.50859318367414
STAT,1827,38,30-34,1865,6.0556086864252645
SIM,1902,29,40-44,1931,8
SIM,1879,47,50-100,1926,1
STAT,1835,49,30-34,1884,0.07467310781079035
SIM,1823,59,na,1882,1167
STAT,1908,40,15-19,1948,0.0014504987180620097
SIM,1838,41,25-29,1879,1
SIM,1901,44,na,1945,3320
STAT,1915,28,15-19,1943,0.7240184342126769
SIM,1915,28,25-29,1943,90
STAT,1855,35,40-44,1890,3.3263309812400643
STAT,1866,61,na,1927,1747.6088522012683
STAT,1814,40,35-39,1854,6.760737440398812
STAT,1870,42,15-19,1912,0.013679564084173305
STAT,1888,31,20-24,1919,3.235516457185899
SIM,1897,21,25-29,1918,89
STAT,1870,28,30-34,1898,24.88719968788584
STAT,1922,46,20-24,1968,0.012857423929960076
STAT,1819,53,30-34,1872,0.010925130725118467
STAT,1829,51,35-39,1880,0.006330330613352439
SIM,1862,46,na,1908,2057
SIM,1873,83,na,1956,337
SIM,1896,31,20-24,1927,4
STAT,1881,78,na,1959,899.4422714268468
STAT,1890,45,35-39,1935,0.1745050838021775
SIM,1851,40,50-100,1891,1
SIM,1910,48,50-100,1958,1
SIM,1869,40,na,1909,2294
SIM,1923,28,15-19,1951,2
SIM,1911,35,30-34,1946,3
STAT,1881,31,35-39,1912,9.899653237761054
STAT,1899,20,40-44,1919,2.905709782920517
STAT,1928,43,35-39,1971,0.2590582919412214
SIM,1808,72,na,1880,445
STAT,1886,44,30-34,1930,1.2094494823846162
STAT,1907,28,25-29,1935,62.52179206089581
STAT,1919,46,45-49,1965,0.23860682303940245
STAT,1803,51,15-19,1854,1.0891185209005128E-4
STAT,1894,29,30-34,1923,32.51088081575555
STAT,1857,25,na,1882,1965.7545105071977
SIM,1852,38,30-34,1890,11
STAT,1799,105,na,1904,0.009839190016356074
STAT,1838,40,20-24,1878,0.12755816130734493
STAT,1933,18,25-29,1951,58.46679049077096
STAT,1822,67,na,1889,886.9122891455664
SIM,1882,60,na,1942,1607
STAT,1857,46,50-100,1903,0.19414245304944788
STAT,1891,44,40-44,1935,2.7747046133571436
STAT,1869,22,20-24,1891,67.66920843354454
SIM,1921,25,45-49,1946,3
SIM,1880,31,na,1911,2342
STAT,1837,41,30-34,1878,0.9374356399624867
SIM,1842,91,na,1933,38
STAT,1875,0,na,1875,3807.9513075750956
SIM,1909,24,na,1933,3787
SIM,1900,29,50-100,1929,1
STAT,1870,42,30-34,1912,1.1388236292886007
STAT,1854,23,50-100,1877,0.3570058406129142
SIM,1888,32,25-29,1920,24
STAT,1880,23,30-34,1903,18.835294237422353
STAT,1772,102,na,1874,0.06037038510089614
STAT,1848,20,25-29,1868,57.73520852095703
STAT,1944,1,na,1945,4493.055328222822
SIM,1941,18,25-29,1959,60
SIM,1932,28,25-29,1960,104
STAT,1811,49,45-49,1860,0.5689053038922045
STAT,1841,20,25-29,1861,55.0178268297029
SIM,1812,87,na,1899,9
SIM,1900,25,na,1925,3625
STAT,1938,15,na,1953,3682.501909388015
STAT,1913,25,45-49,1938,1.7486232645728867
SIM,1873,14,na,1887,2528
STAT,1844,38,30-34,1882,4.409839982712826
STAT,1851,33,15-19,1884,0.11107168300000089
STAT,1803,53,50-100,1856,0.0641540600908666
STAT,1915,42,na,1957,3772.93586975139
SIM,1870,0,na,1870,3810
STAT,1810,86,na,1896,115.23364964851223
STAT,1933,25,15-19,1958,0.9480422242701096
SIM,1842,15,15-19,1857,8
SIM,1932,20,na,1952,5349
SIM,1899,21,45-49,1920,2
STAT,1912,17,40-44,1929,0.28535245756352684
SIM,1861,28,30-34,1889,30
STAT,1913,23,na,1936,3709.157098417427
STAT,1875,34,na,1909,2453.93253070894
SIM,1867,83,na,1950,315
SIM,1877,44,30-34,1921,1
STAT,1854,36,35-39,1890,5.333680854451034
SIM,1877,22,20-24,1899,77
STAT,1807,53,40-44,1860,0.035013005516839356
STAT,1853,28,30-34,1881,21.795803198615808
STAT,1890,21,35-39,1911,7.223664146459746
STAT,1912,18,50-100,1930,0.07623341917391059
SIM,1882,44,40-44,1926,7
STAT,1829,45,40-44,1874,0.13109619618790672
STAT,1874,44,40-44,1918,2.294778632473917
STAT,1930,25,45-49,1955,2.2222255972546963
SIM,1855,30,20-24,1885,2
SIM,1856,20,25-29,1876,83
STAT,1873,23,40-44,1896,2.1270388878957283
STAT,1807,50,na,1857,1211.2728194487422
SIM,1920,17,40-44,1937,6
STAT,1830,32,30-34,1862,16.761253363850976
SIM,1938,21,na,1959,3790
STAT,1861,52,30-34,1913,0.004969260928681924
SIM,1845,36,35-39,1881,6
SIM,1905,24,na,1929,3518
STAT,1858,22,45-49,1880,0.6339711995754137
STAT,1817,101,na,1918,0.26107303698982665
SIM,1897,9,na,1906,3600
SIM,1935,35,30-34,1970,3
STAT,1863,31,30-34,1894,15.688374123545126
STAT,1848,42,na,1890,1884.7079834129288
STAT,1905,58,na,1963,3052.7788258507176
SIM,1891,33,na,1924,3032
STAT,1822,33,35-39,1855,26.318950993950917
STAT,1875,42,50-100,1917,1.0944212983927895
SIM,1849,7,na,1856,2512
STAT,1941,17,20-24,1958,140.98475556533563
SIM,1927,38,45-49,1965,1
STAT,1877,26,50-100,1903,0.6691186485084324
STAT,1893,48,40-44,1941,0.12229059099595813
STAT,1805,55,na,1860,1296.4569934320805
STAT,1903,57,na,1960,2995.8881495064716
SIM,1866,22,45-49,1888,4
STAT,1864,33,25-29,1897,9.29558461503322
STAT,1882,50,25-29,1932,0.0035151177903350603
STAT,1850,46,45-49,1896,0.1812215253626287
STAT,1883,27,15-19,1910,0.44842658458127194
STAT,1931,20,35-39,1951,12.415929018908724
SIM,1880,21,30-34,1901,21
STAT,1848,21,50-100,1869,0.4083250869883055
STAT,1900,19,25-29,1919,7.907846406641599
SIM,1848,22,40-44,1870,1
STAT,1839,49,15-19,1888,2.8163082426409984E-4
STAT,1907,23,na,1930,3497.066566106074
STAT,1919,36,35-39,1955,2.6260198756611324
SIM,1880,40,50-100,1920,2
SIM,1909,38,40-44,1947,2
STAT,1837,36,35-39,1873,5.936146888153317
SIM,1879,40,na,1919,2727
SIM,1810,52,na,1862,1311
SIM,1898,37,na,1935,3245
STAT,1803,51,30-34,1854,0.026356690414571393
STAT,1840,52,na,1892,1501.308961485329
SIM,1831,30,35-39,1861,4
STAT,1933,33,15-19,1966,0.17488895799047366
SIM,1913,8,na,1921,4099
SIM,1815,85,na,1900,110
STAT,1836,39,35-39,1875,5.364180012781689
SIM,1933,23,15-19,1956,8
STAT,1849,26,15-19,1875,0.42353853231114474
SIM,1819,44,na,1863,1474
STAT,1836,30,45-49,1866,1.4196947595187328
SIM,1881,23,40-44,1904,2
SIM,1908,24,15-19,1932,5
STAT,1900,17,15-19,1917,8.32624093098502
STAT,1820,38,30-34,1858,12.163785094276932
STAT,1930,17,45-49,1947,0.6527543412430213
STAT,1845,46,35-39,1891,0.10258648381568439
SIM,1944,21,na,1965,4004
SIM,1851,4,na,1855,2495
SIM,1844,39,35-39,1883,12
STAT,1925,23,15-19,1948,6.419547502131296
STAT,1945,26,35-39,1971,16.64186936544014
STAT,1798,68,na,1866,852.8428392709458
STAT,1856,53,35-39,1909,0.00655935668457406
STAT,1825,43,15-19,1868,0.01935330652781116
SIM,1915,5,na,1920,4616
STAT,1836,57,na,1893,1267.1205504321758
SIM,1854,17,na,1871,2547
STAT,1813,84,na,1897,145.85913256668587
SIM,1933,9,na,1942,5112
SIM,1799,56,na,1855,1244
STAT,1917,6,na,1923,4339.356250072693
STAT,1878,37,35-39,1915,7.4156382674551145
STAT,1860,49,40-44,1909,0.13839604341104603
STAT,1820,70,na,1890,714.1960303403495
STAT,1878,45,35-39,1923,0.1482470385001968
SIM,1924,25,50-100,1949,1
SIM,1846,46,na,1892,1563
SIM,1868,37,30-34,1905,7
STAT,1846,105,na,1951,0.02225101400218091
STAT,1893,45,50-100,1938,0.17943924499399067
STAT,1820,34,15-19,1854,0.4506328158464946
STAT,1840,20,25-29,1860,51.77225117012569
STAT,1850,25,50-100,1875,0.5847891926618927
SIM,1887,38,na,1925,2594
SIM,1921,22,40-44,1943,6
STAT,1891,47,45-49,1938,0.1656921424371413
SIM,1836,37,50-100,1873,1
STAT,1915,35,20-24,1950,0.2712623154964652
STAT,1822,71,na,1893,746.318512120328
SIM,1829,71,na,1900,865
STAT,1868,58,na,1926,1908.956798765578
SIM,1871,25,50-100,1896,3
SIM,1874,8,na,1882,2590
STAT,1884,48,15-19,1932,3.9339178524951243E-4
STAT,1869,10,na,1879,2644.4026939968644
SIM,1869,42,30-34,1911,1
STAT,1881,21,25-29,1902,55.90061088824722
STAT,1808,66,na,1874,804.398847710092
STAT,1863,25,50-100,1888,0.5807640041448255
STAT,1810,50,45-49,1860,0.05536878718474185
STAT,1903,35,50-100,1938,0.3847959766815641
STAT,1868,17,20-24,1885,17.423038200797077
SIM,1778,88,na,1866,11
STAT,1938,9,na,1947,3964.339875423217
STAT,1923,19,na,1942,4343.574104249701
SIM,1872,66,na,1938,1791
SIM,1935,28,40-44,1963,1
STAT,1878,52,25-29,1930,0.0036938707014107495
SIM,1886,37,35-39,1923,16
STAT,1927,35,30-34,1962,2.2943202206516218
SIM,1828,27,na,1855,1769
STAT,1862,20,45-49,1882,0.6316641569387001
STAT,1930,25,na,1955,4818.670522582905
STAT,1850,28,15-19,1878,0.4058923975444558
SIM,1830,33,35-39,1863,11
SIM,1915,25,20-24,1940,28
SIM,1932,36,na,1968,5793
STAT,1919,27,50-100,1946,1.085874874132227
SIM,1878,42,25-29,1920,1
STAT,1924,18,15-19,1942,54.46879346439391
SIM,1932,18,15-19,1950,64
SIM,1893,38,na,1931,3068
SIM,1885,26,50-100,1911,4
STAT,1853,59,na,1912,1607.1992397141657
STAT,1828,37,50-100,1865,1.2649906666724022
STAT,1800,56,na,1856,930.4072864328002
STAT,1828,28,na,1856,1842.5221511723842
STAT,1866,17,50-100,1883,0.04702927747354163
SIM,1889,39,na,1928,2793
STAT,1923,24,50-100,1947,0.7687174085096812
STAT,1845,26,30-34,1871,22.55812669239835
STAT,1896,32,25-29,1928,13.693554886046995
STAT,1834,20,50-100,1854,0.6203326631867654
STAT,1849,19,25-29,1868,5.389597762104435
STAT,1844,40,45-49,1884,1.2442104294485663
STAT,1842,26,15-19,1868,0.5088049615113314
STAT,1927,28,40-44,1955,5.7072143346711846
STAT,1816,71,na,1887,754.0232826400885
SIM,1886,80,na,1966,1031
STAT,1876,46,15-19,1922,4.183211547717399E-4
STAT,1929,22,50-100,1951,0.8410287636353813
STAT,1911,23,50-100,1934,0.6276363702128503
SIM,1878,35,35-39,1913,14
STAT,1921,24,40-44,1945,3.811615982728983
STAT,1793,69,na,1862,668.617788563085
STAT,1815,52,35-39,1867,0.018248566420726767
STAT,1941,25,20-24,1966,19.08087624465483
STAT,1859,44,na,1903,1852.1595260797997
SIM,1916,40,na,1956,3799
STAT,1883,45,45-49,1928,0.2355810934458961
STAT,1893,63,na,1956,2313.4398870224377
SIM,1887,65,na,1952,1754
STAT,1893,17,50-100,1910,0.06282921732288325
SIM,1879,5,na,1884,3103
SIM,1901,38,40-44,1939,3
STAT,1847,50,40-44,1897,0.007995714989229888
SIM,1912,6,na,1918,4013
SIM,1875,18,30-34,1893,1
SIM,1916,36,na,1952,3866
STAT,1833,102,na,1935,0.20742006148518907
STAT,1866,44,15-19,1910,0.012741068774936097
STAT,1886,47,35-39,1933,0.14859899912593924
STAT,1930,15,35-39,1945,5.508612938740883
SIM,1873,79,na,1952,641
STAT,1877,31,45-49,1908,1.8252296015343383
STAT,1907,25,20-24,1932,17.51846559122651
STAT,1884,32,15-19,1916,0.14183733150832065
STAT,1829,41,25-29,1870,0.506161587639925
SIM,1853,26,30-34,1879,33
SIM,1908,19,35-39,1927,2
STAT,1910,38,25-29,1948,0.9453515690377546
STAT,1941,15,50-100,1956,0.3898106453615575
STAT,1890,42,30-34,1932,1.4171286309548023
SIM,1862,19,35-39,1881,2
SIM,1857,19,25-29,1876,5
STAT,1913,22,40-44,1935,3.287358337594466
SIM,1904,55,na,1959,3274
SIM,1871,13,na,1884,2549
SIM,1934,21,na,1955,5396
STAT,1899,21,35-39,1920,8.113282521704031
STAT,1940,28,50-100,1968,1.0241908614300763
SIM,1830,25,35-39,1855,14
STAT,1844,76,na,1920,749.5708018626659
STAT,1855,41,35-39,1896,1.3692046970542513
STAT,1901,48,40-44,1949,0.13501282204770507
STAT,1928,40,30-34,1968,0.16519115780442087
STAT,1899,23,45-49,1922,0.9636068196139057
SIM,1866,66,na,1932,1548
SIM,1870,29,35-39,1899,13
STAT,1810,70,na,1880,828.9239032366575
STAT,1907,43,15-19,1950,0.001412115129072692
STAT,1862,29,35-39,1891,8.355840624997983
STAT,1866,42,40-44,1908,2.101006158004041
STAT,1933,39,na,1972,5167.239965856452
SIM,1876,17,20-24,1893,25
STAT,1902,47,30-34,1949,0.07756972611721043
SIM,1858,31,na,1889,2003
STAT,1911,41,15-19,1952,0.001487259160161161
SIM,1896,34,40-44,1930,7
STAT,1830,50,50-100,1880,0.01270160466428419
STAT,1915,27,20-24,1942,18.787178803926235
STAT,1858,42,15-19,1900,0.010929251405387806
STAT,1839,51,45-49,1890,0.010338136357650091
SIM,1850,82,na,1932,316
STAT,1874,52,40-44,1926,0.010829625333532641
STAT,1902,24,50-100,1926,0.5783793968643415
SIM,1834,27,na,1861,2013
STAT,1940,6,na,1946,4091.596058198213
SIM,1874,42,40-44,1916,3
SIM,1923,27,20-24,1950,29
SIM,1865,41,50-100,1906,1
STAT,1856,4,na,1860,2440.488683635458
STAT,1870,35,na,1905,2358.8217178368327
STAT,1923,37,20-24,1960,0.3086140843654566
SIM,1890,43,35-39,1933,10
SIM,1827,86,na,1913,119
STAT,1861,24,na,1885,2010.026497466953
STAT,1891,29,15-19,1920,0.5632902092509352
STAT,1905,30,35-39,1935,14.905350602310028
STAT,1844,28,50-100,1872,0.6151210900421846
STAT,1837,51,25-29,1888,0.002473699134579636
STAT,1818,50,45-49,1868,0.025830393082325927
SIM,1863,31,25-29,1894,16
SIM,1889,23,na,1912,2892
SIM,1829,43,40-44,1872,6
SIM,1802,87,na,1889,31
STAT,1898,38,15-19,1936,0.01651313873995457
STAT,1819,36,30-34,1855,17.24320282750963
STAT,1900,50,na,1950,3064.4141341209074
STAT,1953,18,40-44,1971,1.708960916804021
SIM,1878,51,na,1929,2455
SIM,1927,36,35-39,1963,10
SIM,1883,14,na,1897,2926
SIM,1941,15,20-24,1956,141
STAT,1851,51,45-49,1902,0.011041199150372627
STAT,1817,41,15-19,1858,0.0353220879055559
STAT,1830,35,35-39,1865,6.612224104995288
SIM,1850,44,45-49,1894,2
STAT,1771,102,na,1873,0.06601398685075395
STAT,1858,20,35-39,1878,5.382350595950212
SIM,1837,69,na,1906,840
SIM,1872,7,na,1879,2997
STAT,1812,43,20-24,1855,0.3990939128975948
SIM,1836,21,20-24,1857,63
STAT,1848,24,40-44,1872,2.041918874916612
STAT,1865,44,na,1909,2102.782755813395
STAT,1844,52,30-34,1896,0.004684491682503052
SIM,1804,52,na,1856,1418
SIM,1900,17,25-29,1917,15
SIM,1844,30,45-49,1874,1
STAT,1939,29,15-19,1968,0.7157519420068641
STAT,1837,44,35-39,1881,1.2929804922101351
SIM,1917,3,na,1920,4283
STAT,1882,43,35-39,1925,1.758807574486932
STAT,1919,38,45-49,1957,0.7387172993585072
SIM,1888,32,50-100,1920,1
SIM,1913,30,35-39,1943,13
SIM,1827,36,30-34,1863,5
SIM,1864,41,na,1905,2529
STAT,1896,25,35-39,1921,12.987373873869208
SIM,1852,40,45-49,1892,1
STAT,1862,40,15-19,1902,0.012166754316597746
STAT,1817,40,na,1857,1429.9080160489827
STAT,1860,35,na,1895,1963.63071405673
SIM,1856,24,40-44,1880,2
STAT,1859,3,na,1862,2664.145024209028
SIM,1792,86,na,1878,30
SIM,1854,3,na,1857,2751
SIM,1907,17,25-29,1924,18
STAT,1886,27,30-34,1913,26.853801605456823
STAT,1842,44,45-49,1886,1.3588431408096897
SIM,1900,24,15-19,1924,4
SIM,1920,27,35-39,1947,24
SIM,1928,21,na,1949,4703
SIM,1849,28,30-34,1877,38
STAT,1832,22,40-44,1854,3.1897710267039487
SIM,1821,85,na,1906,144
STAT,1811,46,40-44,1857,0.4335280080758761
STAT,1830,38,na,1868,1758.8136407075629
STAT,1915,5,na,1920,4232.411379235888
STAT,1925,24,50-100,1949,0.7909930874861273
SIM,1837,34,35-39,1871,10
STAT,1844,51,50-100,1895,0.01200622846675042
SIM,1845,44,35-39,1889,7
STAT,1868,62,na,1930,1764.2921866472932
STAT,1859,75,na,1934,836.2686688367971
SIM,1866,20,35-39,1886,7
STAT,1933,15,20-24,1948,184.24770239687106
SIM,1912,17,35-39,1929,1
STAT,1824,38,15-19,1862,0.07580266147163875
SIM,1903,34,40-44,1937,8
STAT,1838,43,25-29,1881,0.45166101873844267
SIM,1907,53,na,1960,3424
SIM,1857,83,na,1940,394
STAT,1875,16,15-19,1891,6.170537654604742
STAT,1904,17,35-39,1921,0.795309350183014
SIM,1933,24,50-100,1957,5
SIM,1894,27,30-34,1921,47
STAT,1851,52,20-24,1903,5.557690729688746E-4
STAT,1912,27,35-39,1939,14.926872003625306
SIM,1840,22,40-44,1862,1
SIM,1883,16,15-19,1899,7
SIM,1803,73,na,1876,482
STAT,1875,22,45-49,1897,0.7232741288552337
SIM,1918,35,30-34,1953,1
STAT,1865,82,na,1947,430.3084470908963
STAT,1865,39,15-19,1904,0.051267649604907664
STAT,1920,31,15-19,1951,0.1427218343562331
STAT,1830,90,na,1920,52.01426148297739
SIM,1840,68,na,1908,984
STAT,1949,17,na,1966,4324.770020329671
SIM,1929,37,na,1966,4705
STAT,1812,53,30-34,1865,0.012880047980213508
STAT,1928,22,na,1950,4608.523090822271
SIM,1942,29,na,1971,4134
STAT,1899,17,15-19,1916,8.226188584217308
STAT,1874,50,35-39,1924,0.00903134500365389
STAT,1928,33,40-44,1961,4.942790634246212
STAT,1827,43,na,1870,1573.1849579726445
STAT,1823,32,25-29,1855,27.403413407855187
SIM,1817,39,25-29,1856,2
SIM,1831,32,25-29,1863,2
SIM,1922,20,35-39,1942,20
SIM,1878,82,na,1960,725
SIM,1850,8,na,1858,2351
STAT,1869,23,15-19,1892,3.229494583112842
SIM,1877,27,30-34,1904,28
SIM,1923,38,25-29,1961,1
STAT,1917,42,30-34,1959,0.13467074657470232
STAT,1923,40,50-100,1963,0.13912150858919117
STAT,1929,39,50-100,1968,0.5436547290747223
STAT,1804,70,na,1874,631.6571023162214
STAT,1901,46,35-39,1947,0.11213006794408652
SIM,1845,33,30-34,1878,25
STAT,1846,45,40-44,1891,0.13121634940940924
STAT,1846,31,30-34,1877,15.82153232720552
SIM,1911,27,na,1938,3886
STAT,1887,45,50-100,1932,0.2797109154097726
SIM,1923,22,na,1945,4291
STAT,1914,46,45-49,1960,0.21801663451605738
SIM,1796,86,na,1882,85
SIM,1839,71,na,1910,820
STAT,1888,42,25-29,1930,0.7645804173091185
STAT,1910,44,35-39,1954,0.18964494686926586
SIM,1936,33,40-44,1969,4
STAT,1915,38,25-29,1953,0.9986816664386455
STAT,1916,37,na,1953,3888.02925988491
SIM,1909,23,20-24,1932,118
SIM,1834,65,na,1899,1206
STAT,1854,45,na,1899,1705.3086438804346
SIM,1831,32,40-44,1863,2
SIM,1858,78,na,1936,478
STAT,1810,51,20-24,1861,0.0027590915085245024
SIM,1878,92,na,1970,88
STAT,1858,40,50-100,1898,0.8455651270080005
SIM,1833,80,na,1913,372
SIM,1847,90,na,1937,72
STAT,1845,68,na,1913,1116.6326201481381
STAT,1803,53,20-24,1856,0.003134563320727702
STAT,1871,16,30-34,1887,1.6191932784264422
STAT,1878,34,30-34,1912,18.148997725647963
STAT,1914,20,35-39,1934,9.369309225656357
SIM,1896,30,25-29,1926,21
STAT,1898,62,na,1960,2619.722822061255
STAT,1911,45,30-34,1956,0.08554449363587453
STAT,1866,22,35-39,1888,5.5020923413561675
STAT,1817,49,na,1866,1292.6107884286791
SIM,1860,82,na,1942,349
SIM,1927,35,40-44,1962,1
SIM,1874,22,35-39,1896,12
SIM,1919,36,45-49,1955,1
STAT,1862,18,30-34,1880,1.5828249713845948
STAT,1870,44,20-24,1914,0.1553828233204918
SIM,1877,38,na,1915,2450
STAT,1853,50,na,1903,1806.2073941762794
STAT,1865,50,25-29,1915,0.003313585674835172
SIM,1870,18,30-34,1888,6
STAT,1891,48,20-24,1939,0.008358129816830172
STAT,1854,19,35-39,1873,0.48682380591212815
STAT,1915,45,15-19,1960,3.7631628244055415E-4
STAT,1811,55,na,1866,1146.5314668561352
STAT,1937,26,45-49,1963,1.7008994128364139
STAT,1841,42,35-39,1883,1.4071343151089502
SIM,1822,33,na,1855,1774
SIM,1910,33,20-24,1943,2
STAT,1860,45,25-29,1905,0.048030203097858104
SIM,1859,39,30-34,1898,11
SIM,1917,18,30-34,1935,16
STAT,1872,21,30-34,1893,18.141570454881492
STAT,1916,4,na,1920,4307.390993543454
STAT,1866,30,na,1896,2249.694992860275
STAT,1822,98,na,1920,1.8163360123306247
STAT,1850,47,20-24,1897,0.009145728568417692
SIM,1883,45,na,1928,2493
STAT,1879,44,25-29,1923,0.6676974195910768
SIM,1846,50,na,1896,1522
STAT,1795,102,na,1897,0.06787885554855413
SIM,1859,26,na,1885,2224
SIM,1887,44,25-29,1931,3
STAT,1796,102,na,1898,0.06142056037242277
STAT,1830,27,50-100,1857,0.7031266673952213
STAT,1838,46,45-49,1884,0.1646296334419626
STAT,1897,31,50-100,1928,1.2457204369246575
SIM,1963,7,na,1970,5080
SIM,1944,25,30-34,1969,58
SIM,1798,71,na,1869,512
SIM,1954,14,na,1968,4836
STAT,1893,25,na,1918,3081.340345241246
STAT,1909,18,30-34,1927,2.405696927707418
STAT,1856,30,na,1886,1909.7053714704218
STAT,1837,33,30-34,1870,14.779975631441326
STAT,1851,41,15-19,1892,0.010503948200160236
STAT,1869,30,20-24,1899,2.6756270538354467
SIM,1849,26,na,1875,2037
STAT,1855,43,40-44,1898,1.6808463989115983
STAT,1793,90,na,1883,30.09132076595158
SIM,1855,41,25-29,1896,3
SIM,1945,26,45-49,1971,4
SIM,1807,66,na,1873,737
SIM,1859,25,20-24,1884,13
STAT,1886,77,na,1963,1179.1420007192607
SIM,1891,74,na,1965,1644
STAT,1878,58,na,1936,2073.421516671863
STAT,1806,54,35-39,1860,0.023865270901898137
SIM,1900,39,35-39,1939,10
SIM,1848,25,45-49,1873,1
SIM,1898,30,40-44,1928,12
STAT,1833,36,15-19,1869,0.0503740472405333
SIM,1955,2,na,1957,5067
STAT,1783,73,na,1856,500.52713886450005
STAT,1853,97,na,1950,4.4427182869847535
STAT,1876,39,50-100,1915,1.2674567944381943
STAT,1872,41,35-39,1913,1.8470579885288712
SIM,1880,41,35-39,1921,3
SIM,1897,29,50-100,1926,1
STAT,1835,29,25-29,1864,40.80252630090418
STAT,1937,33,35-39,1970,9.121697808964452
SIM,1841,13,na,1854,2165
SIM,1904,22,40-44,1926,4
SIM,1843,29,25-29,1872,9
SIM,1816,46,na,1862,1329
STAT,1766,94,na,1860,1.931767804371633
SIM,1942,26,na,1968,4156
STAT,1890,23,25-29,1913,70.43198208113719
STAT,1855,39,50-100,1894,0.9148464345200056
STAT,1942,27,30-34,1969,41.52159277541626
SIM,1872,33,40-44,1905,5
SIM,1911,37,na,1948,3911
STAT,1805,50,35-39,1855,0.03685077000889699
STAT,1913,15,35-39,1928,0.8696499784670209
STAT,1874,48,50-100,1922,0.2508054827562895
SIM,1897,65,na,1962,2442
STAT,1917,47,25-29,1964,0.055926503306501715
SIM,1890,27,na,1917,3346
STAT,1811,48,30-34,1859,0.23719903297180692
STAT,1873,31,25-29,1904,10.53035914899137
SIM,1839,64,na,1903,1096
SIM,1904,15,35-39,1919,3
STAT,1877,18,25-29,1895,5.891653194294652
SIM,1949,17,30-34,1966,16
STAT,1946,24,50-100,1970,0.739041151819011
STAT,1900,17,50-100,1917,0.0687361522794829
SIM,1930,15,45-49,1945,3
STAT,1857,17,45-49,1874,0.06051860696702362
STAT,1811,65,na,1876,861.814014991202
SIM,1878,32,30-34,1910,8
STAT,1785,105,na,1890,0.021318799503597677
STAT,1829,50,20-24,1879,5.534600539378419E-4
STAT,1873,40,40-44,1913,2.3262937139016833
SIM,1859,16,na,1875,2471
STAT,1945,25,40-44,1970,5.168732460998439
SIM,1844,28,30-34,1872,39
STAT,1862,30,na,1892,2098.1194485595383
SIM,1860,43,25-29,1903,3
STAT,1945,24,na,1969,4039.1878595176654
STAT,1941,28,25-29,1969,68.70923263507669
STAT,1883,44,15-19,1927,0.013465000598708341
STAT,1916,37,30-34,1953,1.883528410933504
SIM,1903,24,30-34,1927,39
SIM,1877,45,na,1922,2369
STAT,1828,29,35-39,1857,13.39832656524456
SIM,1881,40,40-44,1921,6
STAT,1873,45,35-39,1918,0.14477645139462939
STAT,1860,45,na,1905,1876.0470533579983
STAT,1941,21,40-44,1962,3.5092236886042047
STAT,1896,41,20-24,1937,0.01481068473330745
SIM,1935,16,25-29,1951,73
SIM,1948,14,na,1962,5007
STAT,1802,52,25-29,1854,0.010335532654027388
SIM,1765,91,na,1856,10
SIM,1827,79,na,1906,271
STAT,1883,49,25-29,1932,0.05574152945046457
STAT,1887,32,30-34,1919,19.68837957191827
STAT,1843,40,50-100,1883,0.7526847147652824
SIM,1836,29,35-39,1865,15
SIM,1848,18,20-24,1866,17
STAT,1924,25,na,1949,4437.512036509213
SIM,1889,30,na,1919,2913
SIM,1886,34,30-34,1920,27
STAT,1817,43,na,1860,1377.9598749140368
STAT,1887,46,40-44,1933,0.19360109935394176
STAT,1888,30,25-29,1918,12.308476625145286
SIM,1873,9,na,1882,2598
SIM,1890,21,25-29,1911,95
STAT,1842,16,na,1858,2669.5952194788497
SIM,1848,78,na,1926,505
STAT,1929,31,35-39,1960,11.73927453136334
SIM,1895,32,30-34,1927,37
STAT,1962,5,na,1967,5087.379278897872
STAT,1936,28,35-39,1964,14.498778380764804
STAT,1902,31,30-34,1933,25.021394300868003
STAT,1916,32,50-100,1948,0.8614301891291147
SIM,1849,30,45-49,1879,2
SIM,1937,31,35-39,1968,10
STAT,1902,48,50-100,1950,0.19524647474352044
STAT,1927,16,25-29,1943,54.59483237494127
SIM,1886,20,20-24,1906,89
STAT,1879,47,45-49,1926,0.24758430109816573
STAT,1844,45,na,1889,1808.1095661753855
SIM,1836,50,na,1886,1654
STAT,1936,10,na,1946,3841.3546316701922
SIM,1923,12,na,1935,4743
SIM,1899,15,15-19,1914,13
STAT,1827,49,na,1876,1464.2252817273422
SIM,1847,93,na,1940,20
STAT,1857,18,50-100,1875,0.0451216142789909
SIM,1948,18,25-29,1966,66
SIM,1815,51,na,1866,1373
SIM,1840,30,25-29,1870,9
STAT,1857,108,na,1965,0.010291874166326962
SIM,1819,43,30-34,1862,1
STAT,1874,37,15-19,1911,0.05807446333432665
STAT,1902,36,25-29,1938,0.891238962662183
STAT,1855,40,20-24,1895,0.12074810003559064
STAT,1872,30,na,1902,2442.587386581033
SIM,1830,68,na,1898,814
STAT,1855,2,na,1857,2681.233587939839
STAT,1863,48,45-49,1911,0.20854032535271175
STAT,1836,28,30-34,1864,20.408138606230192
STAT,1873,70,na,1943,1436.6211051527928
STAT,1842,43,15-19,1885,0.012700017111356652
STAT,1849,41,50-100,1890,0.8297273741804045
SIM,1860,72,na,1932,1148
STAT,1771,88,na,1859,34.71744066764493
STAT,1919,35,40-44,1954,1.6328467361097283
STAT,1922,22,35-39,1944,10.90837341894448
STAT,1898,18,45-49,1916,0.08920581333397304
STAT,1831,40,35-39,1871,1.4369354586282086
STAT,1886,25,50-100,1911,0.6867915062967765
SIM,1910,36,25-29,1946,1
STAT,1939,5,na,1944,4054.2419345963135
SIM,1889,19,20-24,1908,26
SIM,1915,33,50-100,1948,1
SIM,1828,31,na,1859,1737
SIM,1839,20,25-29,1859,79
STAT,1861,19,25-29,1880,5.402235368709367
STAT,1922,15,45-49,1937,0.5867536820174298
STAT,1890,26,45-49,1916,1.3749951045566402
STAT,1915,52,na,1967,3672.5998879756175
STAT,1832,30,25-29,1862,9.31445306434118
SIM,1852,53,na,1905,1559
SIM,1879,16,25-29,1895,11
STAT,1853,54,30-34,1907,0.0047872499617466315
STAT,1925,46,20-24,1971,0.013567095157102435
SIM,1831,35,45-49,1866,3
SIM,1892,12,na,1904,3559
SIM,1872,33,25-29,1905,7
STAT,1832,44,35-39,1876,1.4744023757560274
STAT,1866,15,45-49,1881,0.06345095429277298
STAT,1867,18,na,1885,2441.519965074549
SIM,1854,31,30-34,1885,6
STAT,1900,12,na,1912,3623.2891070644846
SIM,1895,30,na,1925,3276
STAT,1912,34,50-100,1946,0.8137696318418801
STAT,1850,45,na,1895,1739.9090842573487
STAT,1900,38,30-34,1938,1.605938258387216
STAT,1936,35,40-44,1971,1.4862586421239745
SIM,1809,51,na,1860,1171
STAT,1823,35,45-49,1858,3.7748654667064394
STAT,1840,90,na,1930,55.26626432173489
SIM,1908,18,20-24,1926,25
STAT,1914,43,40-44,1957,0.24966679139783826
STAT,1842,48,25-29,1890,0.05120766686623546
STAT,1896,22,30-34,1918,23.813618967300705
SIM,1863,102,na,1965,5
STAT,1897,22,na,1919,3202.414879446863
STAT,1829,31,30-34,1860,15.961427768552761
SIM,1923,31,40-44,1954,10
STAT,1885,37,na,1922,2368.552727294391
STAT,1850,32,35-39,1882,8.111915538494278
SIM,1842,21,45-49,1863,2
SIM,1845,22,25-29,1867,70
STAT,1840,32,25-29,1872,8.745116077161837
SIM,1878,3,na,1881,3229
STAT,1765,112,na,1877,6.364521589614559E-4
STAT,1842,41,40-44,1883,2.1222025098812476
STAT,1879,40,25-29,1919,0.6836628930934874
STAT,1886,81,na,1967,923.3774172828399
STAT,1832,41,30-34,1873,0.973043086312331
STAT,1932,34,45-49,1966,2.111245327830134
SIM,1880,35,40-44,1915,9
STAT,1928,18,na,1946,4675.491258735711
SIM,1896,32,50-100,1928,2
STAT,1890,20,20-24,1910,85.55655194884201
STAT,1857,41,50-100,1898,0.8365101713383561
STAT,1921,47,15-19,1968,4.194136025792916E-4
STAT,1878,20,20-24,1898,72.68272748478974
SIM,1865,26,na,1891,2186
STAT,1860,31,15-19,1891,0.11805604562751447
SIM,1867,45,na,1912,2022
SIM,1849,64,na,1913,1334
STAT,1842,20,50-100,1862,0.4698037962734523
SIM,1837,31,30-34,1868,28
STAT,1815,48,15-19,1863,8.728330345517049E-4
STAT,1888,40,35-39,1928,2.1804742451481944
SIM,1938,33,50-100,1971,4
SIM,1813,44,40-44,1857,5
STAT,1825,48,25-29,1873,0.07627804324234683
STAT,1849,22,35-39,1871,5.516183806567084
STAT,1937,30,30-34,1967,15.753950889430381
SIM,1910,42,na,1952,3290
STAT,1917,44,20-24,1961,0.01854126940059153
STAT,1832,102,na,1934,0.19962994057697597
SIM,1827,31,20-24,1858,1
SIM,1822,39,na,1861,1677
SIM,1909,26,25-29,1935,102
STAT,1834,21,45-49,1855,0.5614083001745558
STAT,1945,21,25-29,1966,102.27141587866764
SIM,1918,38,35-39,1956,11
STAT,1931,11,na,1942,5249.272510404462
STAT,1882,39,15-19,1921,0.05438574549723675
STAT,1846,35,50-100,1881,0.9933900617198864
STAT,1892,39,25-29,1931,3.612308671009094
STAT,1901,49,50-100,1950,0.1920557770766621
STAT,1900,30,35-39,1930,14.322595600229278
SIM,1854,35,50-100,1889,1
STAT,1852,40,20-24,1892,0.12165783297502182
SIM,1879,30,na,1909,2787
STAT,1902,43,15-19,1945,0.0013588306724457806
STAT,1911,43,40-44,1954,0.23940420322126135
STAT,1901,43,30-34,1944,0.11221888996150554
STAT,1852,49,30-34,1901,0.07187954686652832
SIM,1930,22,35-39,1952,15
STAT,1852,16,na,1868,2117.9607857208775
SIM,1854,34,35-39,1888,17
STAT,1841,53,40-44,1894,0.007746324286636044
STAT,1867,20,45-49,1887,0.6757084545147892
SIM,1842,53,na,1895,1506
STAT,1862,64,na,1926,1516.2315017746903
SIM,1892,59,na,1951,2623
STAT,1854,33,30-34,1887,13.2799395371144
SIM,1933,15,na,1948,4737
STAT,1864,33,40-44,1897,3.9357485538861154
SIM,1859,19,na,1878,2471
SIM,1862,33,30-34,1895,21
STAT,1872,35,40-44,1907,4.487222564024773
STAT,1936,18,40-44,1954,1.348396056509865
STAT,1846,34,35-39,1880,8.895414519600166
SIM,1837,79,na,1916,312
STAT,1882,21,25-29,1903,56.17519216230448
STAT,1837,22,25-29,1859,51.12449183528627
STAT,1914,41,50-100,1955,0.11761977589073251
STAT,1924,35,15-19,1959,0.02292177176214481
SIM,1850,41,40-44,1891,4
STAT,1848,27,45-49,1875,1.082209220057859
SIM,1840,41,30-34,1881,1
SIM,1881,71,na,1952,1142
STAT,1814,42,25-29,1856,1.9462314091086637
SIM,1853,21,20-24,1874,74
SIM,1939,24,45-49,1963,2
STAT,1824,42,35-39,1866,2.250118200739671
STAT,1843,97,na,1940,3.623404383571283
STAT,1871,82,na,1953,468.1801058876705
SIM,1897,58,na,1955,2647
STAT,1915,49,30-34,1964,0.09011071446905752
STAT,1820,54,35-39,1874,0.013502124878892767
SIM,1898,33,45-49,1931,4
SIM,1838,27,na,1865,1900
SIM,1908,48,na,1956,3174
STAT,1810,54,25-29,1864,0.012465319460431036
STAT,1878,46,50-100,1924,0.2582315833494664
SIM,1862,16,30-34,1878,1
SIM,1885,29,30-34,1914,29
STAT,1901,22,15-19,1923,4.670947713229153
SIM,1852,16,20-24,1868,16
SIM,1863,41,35-39,1904,3
STAT,1776,94,na,1870,3.487253787720859
STAT,1835,31,na,1866,2092.4150855706266
STAT,1806,51,30-34,1857,0.017524127677053334
STAT,1854,16,30-34,1870,1.4393918121130649
STAT,1913,19,na,1932,3962.9582259524163
STAT,1816,51,40-44,1867,0.026672734283397646
STAT,1874,96,na,1970,47.26857322595616
STAT,1844,16,20-24,1860,17.935771765101666
STAT,1906,44,45-49,1950,0.150827690680882
SIM,1818,65,na,1883,844
SIM,1880,27,na,1907,2305
STAT,1823,108,na,1931,0.0010130593782316216
STAT,1864,36,45-49,1900,1.825582758676638
STAT,1845,31,na,1876,1902.5381967752169
STAT,1868,41,45-49,1909,1.4512299979266774
SIM,1894,44,na,1938,3249
STAT,1877,29,30-34,1906,26.0625844118256
STAT,1878,23,25-29,1901,59.83397464261856
SIM,1846,43,40-44,1889,8
SIM,1787,72,na,1859,541
STAT,1844,54,20-24,1898,5.677752142032778E-4
SIM,1836,43,30-34,1879,2
STAT,1832,98,na,1930,2.212010260628811
STAT,1872,24,35-39,1896,5.888373883267284
STAT,1857,15,na,1872,2151.9074446567374
STAT,1955,17,na,1972,4936.392547825738
STAT,1966,3,na,1969,4961.233004289496
SIM,1840,34,50-100,1874,3
STAT,1833,47,20-24,1880,0.009981560504895924
SIM,1803,66,na,1869,715
STAT,1921,0,na,1921,5186.50716844705
SIM,1877,11,na,1888,2759
SIM,1886,23,25-29,1909,64
STAT,1838,43,40-44,1881,1.5820277036643244
STAT,1915,31,40-44,1946,4.038091774089714
STAT,1828,43,30-34,1871,1.0793077960308817
STAT,1852,45,15-19,1897,3.06380857804385E-4
SIM,1879,77,na,1956,974
STAT,1883,42,40-44,1925,2.220382738304167
STAT,1879,41,20-24,1920,0.16814630260759655
STAT,1873,42,30-34,1915,1.1757070332228656
STAT,1911,48,35-39,1959,0.1227994657879597
STAT,1884,48,na,1932,2212.6740593188424
SIM,1914,44,45-49,1958,1
SIM,1932,26,na,1958,5589
SIM,1859,28,25-29,1887,57
STAT,1826,50,20-24,1876,7.2969486175881E-4
STAT,1901,48,25-29,1949,0.045424874354010214
STAT,1832,34,50-100,1866,0.7981592620711677
SIM,1907,59,na,1966,3260
STAT,1856,49,15-19,1905,3.032711444519389E-4
STAT,1805,65,na,1870,974.5086280421478
STAT,1903,19,40-44,1922,0.2616792859030951
STAT,1843,105,na,1948,0.01977584820401263
SIM,1818,38,30-34,1856,5
STAT,1831,34,40-44,1865,3.5052816002477503
STAT,1866,49,25-29,1915,0.05274464380021064
STAT,1928,36,45-49,1964,0.8716154801770621
STAT,1901,26,30-34,1927,35.776335151247316
SIM,1945,23,40-44,1968,3
STAT,1846,51,35-39,1897,0.006564544161267001
STAT,1937,23,40-44,1960,3.304435733623426
SIM,1962,5,na,1967,5269
SIM,1824,72,na,1896,634
STAT,1830,32,na,1862,1848.7281055890528
STAT,1841,31,na,1872,1986.9214052873765
STAT,1822,47,45-49,1869,0.3499116641547238
SIM,1904,32,35-39,1936,15
STAT,1895,34,30-34,1929,22.831565002625776
STAT,1967,5,na,1972,4959.35335296259
STAT,1847,41,25-29,1888,0.48972248176306876
STAT,1874,17,45-49,1891,0.06755585473956982
SIM,1891,42,40-44,1933,6
STAT,1879,44,40-44,1923,2.338735847536091
STAT,1837,97,na,1934,3.664833974740049
STAT,1921,27,45-49,1948,1.9446425907651688
STAT,1910,35,20-24,1945,0.2567767730130371
SIM,1828,44,35-39,1872,1
STAT,1858,96,na,1954,6.803952219149544
STAT,1900,20,40-44,1920,2.9410509472800204
STAT,1853,50,50-100,1903,0.012669100472544126
SIM,1898,23,35-39,1921,12
SIM,1868,32,20-24,1900,1
STAT,1893,41,20-24,1934,0.204589970610048
STAT,1835,68,na,1903,1146.9852915917031
STAT,1834,83,na,1917,236.29797797590044
STAT,1812,45,50-100,1857,0.5849872442505973
STAT,1887,35,35-39,1922,8.051497908766446
STAT,1803,91,na,1894,24.15634195107665
STAT,1846,41,25-29,1887,0.499582527203028
SIM,1895,35,35-39,1930,7
STAT,1859,27,20-24,1886,9.69437029938543
SIM,1894,0,na,1894,3927
STAT,1875,37,na,1912,2443.660717146346
STAT,1877,15,20-24,1892,18.566498267753005
STAT,1954,16,35-39,1970,5.242310480979464
STAT,1918,22,na,1940,3976.259545416077
STAT,1906,37,20-24,1943,0.24476360948610978
STAT,1899,0,na,1899,4070.2082953817517
STAT,1876,81,na,1957,637.6059678315371
STAT,1893,46,15-19,1939,2.9018282451508023E-4
SIM,1824,65,na,1889,960
STAT,1936,25,30-34,1961,37.89023041875942
SIM,1873,32,50-100,1905,1
STAT,1858,16,15-19,1874,5.525642253146875
STAT,1823,50,na,1873,1387.404898932598
STAT,1841,38,15-19,1879,0.04896515332519394
STAT,1849,82,na,1931,364.79882334461865
SIM,1836,26,30-34,1862,6
STAT,1764,112,na,1876,4.067705332587054E-4
STAT,1776,87,na,1863,46.842318784082465
STAT,1909,17,50-100,1926,0.07413983361626467
STAT,1917,19,35-39,1936,4.518616674520333
SIM,1826,29,25-29,1855,53
STAT,1855,43,25-29,1898,0.47987326335489844
SIM,1882,31,50-100,1913,1
SIM,1832,42,35-39,1874,1
STAT,1876,15,50-100,1891,0.051328210409332206
SIM,1842,94,na,1936,7
SIM,1858,18,30-34,1876,2
SIM,1939,5,na,1944,4129
STAT,1829,53,25-29,1882,0.0022779801707981328
SIM,1944,18,40-44,1962,2
STAT,1845,21,20-24,1866,62.962565083796605
STAT,1895,17,30-34,1912,2.102255421050348
STAT,1940,18,na,1958,3771.7163571182873
STAT,1889,48,15-19,1937,2.7747137756393194E-4
STAT,1867,15,na,1882,2485.1748649451924
STAT,1823,52,45-49,1875,0.0192262585206476
SIM,1932,25,20-24,1957,42
STAT,1839,50,30-34,1889,0.004325205415322151
STAT,1924,25,20-24,1949,21.622735622459338
STAT,1904,24,40-44,1928,3.0014040382001004
SIM,1861,30,45-49,1891,2
SIM,1912,24,40-44,1936,2
STAT,1891,33,35-39,1924,12.61023447193258
STAT,1828,83,na,1911,257.7069512103863
SIM,1820,45,50-100,1865,2
STAT,1890,43,45-49,1933,1.833751682761777
STAT,1834,41,15-19,1875,0.010042698746456762
STAT,1843,53,25-29,1896,0.002350616072881215
STAT,1902,33,20-24,1935,3.841687149278433
STAT,1828,26,30-34,1854,65.44840488232036
SIM,1925,19,35-39,1944,6
STAT,1878,30,15-19,1908,0.1505081642233878
STAT,1919,31,25-29,1950,10.109375377608202
SIM,1838,44,50-100,1882,3
STAT,1906,37,na,1943,3493.234601249648
STAT,1892,77,na,1969,1524.261858692253
STAT,1869,47,35-39,1916,0.136833277020608
STAT,1874,31,50-100,1905,0.951443991792667
SIM,1873,45,na,1918,2178
SIM,1903,27,35-39,1930,21
STAT,1833,54,45-49,1887,0.010208196441118457
SIM,1927,31,25-29,1958,12
STAT,1867,51,20-24,1918,7.052835427483395E-4
STAT,1921,17,35-39,1938,4.830779665172735
SIM,1811,92,na,1903,11
STAT,1823,32,40-44,1855,11.602599423072876
STAT,1905,19,50-100,1924,0.07114925941344873
STAT,1896,44,25-29,1940,0.058812211897899716
STAT,1891,40,25-29,1931,0.8111059594208052
SIM,1938,14,na,1952,3841
SIM,1847,43,50-100,1890,1
SIM,1866,16,15-19,1882,6
STAT,1872,17,50-100,1889,0.049911014656597905
STAT,1860,42,20-24,1902,0.13095882625273317
STAT,1930,32,50-100,1962,1.0784508030359703
STAT,1928,26,35-39,1954,18.75977629378146
STAT,1950,15,20-24,1965,162.04537375432906
STAT,1864,53,45-49,1917,0.013014063546358048
STAT,1890,23,40-44,1913,2.5638085186311153
STAT,1875,42,15-19,1917,0.014306161808706098
SIM,1839,24,40-44,1863,2
STAT,1836,24,15-19,1860,2.707327567670059
STAT,1848,47,15-19,1895,3.250605570546833E-4
STAT,1841,40,45-49,1881,1.1931836192316754
STAT,1857,52,40-44,1909,0.008254183593929921
STAT,1871,19,35-39,1890,0.5476353468717509
SIM,1857,93,na,1950,14
SIM,1832,91,na,1923,44
SIM,1849,20,35-39,1869,8
STAT,1839,43,50-100,1882,0.7793594762432436
STAT,1860,47,15-19,1907,3.287107009258536E-4
SIM,1899,19,30-34,1918,3
SIM,1873,43,35-39,1916,3
STAT,1910,12,na,1922,3948.1067826070816
STAT,1880,26,35-39,1906,10.269842547087416
STAT,1934,30,50-100,1964,1.1419158508057874
SIM,1885,30,na,1915,2629
SIM,1857,32,45-49,1889,1
STAT,1817,50,na,1867,1278.0028017414827
STAT,1883,47,50-100,1930,0.24161231426870491
STAT,1816,43,50-100,1859,2.9231908833810287
SIM,1855,64,na,1919,1612
STAT,1856,108,na,1964,0.008577973323041024
SIM,1891,47,50-100,1938,2
STAT,1851,35,20-24,1886,0.6023072710784904
STAT,1874,48,20-24,1922,0.012254340033534273
STAT,1887,22,na,1909,2666.937476755986
SIM,1872,60,na,1932,2125
SIM,1949,19,20-24,1968,139
STAT,1890,22,50-100,1912,0.50327894900878
SIM,1821,35,35-39,1856,5
SIM,1824,43,50-100,1867,1
STAT,1916,33,15-19,1949,0.13332297615404137
SIM,1887,44,40-44,1931,5
SIM,1894,22,20-24,1916,110
SIM,1835,40,45-49,1875,2
STAT,1865,43,35-39,1908,1.6579699262527345
SIM,1936,26,35-39,1962,1
SIM,1854,41,25-29,1895,3
STAT,1888,32,50-100,1920,1.092267027147124
STAT,1894,31,45-49,1925,2.2768203298344845
STAT,1855,82,na,1937,351.2063206150987
STAT,1870,33,50-100,1903,0.9048867615239129
SIM,1844,17,25-29,1861,3
STAT,1910,38,40-44,1948,1.4373031428771428
SIM,1903,60,na,1963,2647
STAT,1849,32,45-49,1881,1.4366964695326097
STAT,1827,40,45-49,1867,1.666276720508248
STAT,1898,15,40-44,1913,0.2515960169329663
STAT,1905,52,na,1957,3163.9541894721847
STAT,1841,33,50-100,1874,0.8227423449796759
STAT,1886,22,20-24,1908,73.48780109501321
STAT,1818,38,50-100,1856,2.8238126933378376
STAT,1842,66,na,1908,1475.6577713147008
STAT,1845,37,30-34,1882,4.091650841888591
STAT,1887,78,na,1965,1203.7799557756925
STAT,1847,45,40-44,1892,0.1294617163733234
STAT,1829,44,50-100,1873,0.7965268692950046
STAT,1846,56,na,1902,1547.8474216426837
SIM,1864,27,35-39,1891,11
STAT,1920,46,50-100,1966,0.2531079959329824
STAT,1884,39,35-39,1923,6.973693727704527
SIM,1945,18,na,1963,4205
STAT,1947,21,45-49,1968,1.284925466238156
SIM,1901,23,15-19,1924,8
STAT,1913,15,50-100,1928,0.0776473051197842
SIM,1842,34,20-24,1876,2
STAT,1850,50,40-44,1900,0.00817700902022356
SIM,1901,3,na,1904,3858
STAT,1924,21,50-100,1945,0.7869533540078189
STAT,1886,36,35-39,1922,7.578816473534078
SIM,1889,43,45-49,1932,3
SIM,1848,19,20-24,1867,19
SIM,1825,37,25-29,1862,1
STAT,1840,31,40-44,1871,3.7413282121685674
SIM,1903,31,25-29,1934,5
STAT,1819,45,35-39,1864,0.2810658404181972
STAT,1863,17,25-29,1880,5.786599010609098
SIM,1844,42,30-34,1886,3
STAT,1895,73,na,1968,1935.011546990622
STAT,1936,28,50-100,1964,0.9612215728909598
STAT,1836,31,20-24,1867,2.1779036794931956
SIM,1862,39,na,1901,2160
SIM,1871,17,25-29,1888,11
SIM,1875,25,45-49,1900,1
STAT,1892,47,15-19,1939,2.8462954977197035E-4
STAT,1852,32,50-100,1884,0.7194582768985621
STAT,1920,47,45-49,1967,0.24261135215872653
STAT,1854,51,na,1905,1623.654999965752
STAT,1899,63,na,1962,2638.3581079069018
STAT,1817,48,35-39,1865,0.29629411831056107
SIM,1919,23,30-34,1942,40
STAT,1823,34,45-49,1857,3.580112337473406
SIM,1875,81,na,1956,480
STAT,1856,27,35-39,1883,7.7423003046421925
STAT,1836,42,30-34,1878,0.8627895750417802
SIM,1917,15,20-24,1932,37
STAT,1883,88,na,1971,378.77596597987394
SIM,1855,32,35-39,1887,9
SIM,1892,28,25-29,1920,60
STAT,1834,45,30-34,1879,0.06892831551252392
STAT,1841,26,50-100,1867,0.5984571057960583
SIM,1890,25,40-44,1915,3
STAT,1844,104,na,1948,0.052772018528016426
SIM,1808,51,na,1859,1213
SIM,1922,28,50-100,1950,1
STAT,1825,31,45-49,1856,4.738834851018442
STAT,1911,37,na,1948,3666.060882017821
STAT,1817,37,25-29,1854,10.905120116952496
STAT,1852,27,20-24,1879,10.362746758796481
SIM,1878,20,50-100,1898,1
STAT,1939,29,20-24,1968,18.507300066357093
STAT,1877,49,45-49,1926,0.2408753623808865
SIM,1892,39,35-39,1931,20
STAT,1884,28,25-29,1912,41.98369913439365
STAT,1892,43,50-100,1935,1.3292530390143225
STAT,1894,44,15-19,1938,0.0012301672297425979
STAT,1824,53,na,1877,1170.6137761492632
STAT,1834,34,20-24,1868,2.0196521666671647
SIM,1901,34,25-29,1935,11
SIM,1853,78,na,1931,502
STAT,1858,35,45-49,1893,1.594613886701642
STAT,1847,32,35-39,1879,8.90283204836546
STAT,1812,68,na,1880,815.8308509634077
STAT,1894,46,40-44,1940,0.12593129136237305
SIM,1908,20,20-24,1928,118
STAT,1884,22,40-44,1906,2.0754631891652826
STAT,1831,42,25-29,1873,0.4964802810824494
SIM,1886,25,20-24,1911,17
STAT,1919,23,35-39,1942,10.378186704325705
SIM,1906,19,na,1925,3599
SIM,1848,42,45-49,1890,2
STAT,1893,15,15-19,1908,7.646074552612266
SIM,1898,50,na,1948,2990
STAT,1833,50,35-39,1883,0.006554952681027058
STAT,1862,21,20-24,1883,61.97572521597828
STAT,1899,36,45-49,1935,2.77657509640556
STAT,1819,47,30-34,1866,0.18864914132934402
STAT,1851,46,15-19,1897,3.0373478049074983E-4
SIM,1851,27,25-29,1878,3
SIM,1853,35,35-39,1888,12
STAT,1927,42,25-29,1969,0.09052010475049159
STAT,1829,52,40-44,1881,0.0069061718587840465
SIM,1838,37,35-39,1875,16
STAT,1825,94,na,1919,14.585018372474297
STAT,1843,27,25-29,1870,35.112423651220105
STAT,1832,37,20-24,1869,0.6651880519703308
SIM,1834,24,15-19,1858,2
SIM,1865,63,na,1928,1538
SIM,1857,42,40-44,1899,1
STAT,1896,43,40-44,1939,0.20731104420721994
STAT,1936,20,30-34,1956,27.760118996031068
SIM,1910,24,na,1934,3257
SIM,1894,60,na,1954,2678
STAT,1874,12,na,1886,2703.6728923442465
STAT,1881,37,50-100,1918,1.1952879447896323
SIM,1914,38,na,1952,3905
SIM,1851,38,35-39,1889,10
SIM,1870,21,20-24,1891,112
SIM,1907,44,na,1951,3644
STAT,1873,30,na,1903,2463.00685013715
STAT,1949,20,40-44,1969,3.9664500789321777
SIM,1825,31,40-44,1856,2
STAT,1769,90,na,1859,23.2606852473221
STAT,1890,25,45-49,1915,1.3795891363807888
STAT,1923,22,na,1945,4293.166271546243
STAT,1770,87,na,1857,28.093412158921
SIM,1861,73,na,1934,943
STAT,1841,25,na,1866,2038.4597834049282
STAT,1923,37,15-19,1960,0.022481823543932085
STAT,1816,58,na,1874,1252.2310350727184
STAT,1927,31,15-19,1958,0.1598671580060106
STAT,1897,20,25-29,1917,77.9764164466874
STAT,1860,24,20-24,1884,57.81241845011483
STAT,1897,39,45-49,1936,0.5767559969263703
STAT,1821,39,40-44,1860,7.639912295936668
STAT,1878,25,20-24,1903,12.383342626358187
STAT,1843,38,35-39,1881,5.015518049966851
SIM,1836,21,15-19,1857,3
SIM,1880,9,na,1889,2548
STAT,1849,42,40-44,1891,1.7564376961941564
STAT,1879,46,45-49,1925,0.24945018850820724
STAT,1817,99,na,1916,0.8664864600125883
STAT,1855,40,15-19,1895,0.010499835352808733
STAT,1865,32,50-100,1897,0.8450129610485846
SIM,1813,50,50-100,1863,1
SIM,1869,27,40-44,1896,5
SIM,1903,20,15-19,1923,6
STAT,1853,43,15-19,1896,0.011337906521407568
STAT,1831,53,35-39,1884,0.005546417384636346
STAT,1851,21,45-49,1872,0.6350990347489989
SIM,1902,29,na,1931,3619
STAT,1850,61,na,1911,1430.8400736783005
SIM,1818,49,50-100,1867,2
STAT,1863,28,50-100,1891,0.5704391341352145
STAT,1885,9,na,1894,2608.48253289911
SIM,1815,44,50-100,1859,1
SIM,1855,34,30-34,1889,28
STAT,1939,16,15-19,1955,45.873469959983666
STAT,1948,14,na,1962,4539.519245729598
STAT,1772,111,na,1883,8.998582190791764E-4
STAT,1897,28,35-39,1925,13.019226913975636
STAT,1845,35,35-39,1880,6.092315584088472
STAT,1821,37,45-49,1858,3.9291815026436976
SIM,1857,68,na,1925,1319
STAT,1847,34,30-34,1881,13.680562302624368
STAT,1925,34,15-19,1959,0.15401954476069565
SIM,1947,16,15-19,1963,61
STAT,1820,63,na,1883,927.1946949763822
SIM,1852,37,na,1889,1758
STAT,1898,40,40-44,1938,0.21602059579271787
STAT,1915,27,na,1942,3855.5867088288096
STAT,1862,32,30-34,1894,15.228720000299774
STAT,1902,60,na,1962,2877.068413325158
STAT,1919,36,40-44,1955,1.6252703272541793
SIM,1869,16,30-34,1885,2
STAT,1880,51,35-39,1931,0.00917541125940905
SIM,1841,37,50-100,1878,1
SIM,1870,38,45-49,1908,4
SIM,1920,34,35-39,1954,23
STAT,1917,28,30-34,1945,41.33128236641036
STAT,1838,45,45-49,1883,0.16675239138428458
STAT,1855,54,35-39,1909,0.006302016565963692
STAT,1873,22,35-39,1895,5.975003884843044
SIM,1819,35,na,1854,1627
STAT,1851,49,25-29,1900,0.042703389138339175
SIM,1925,39,40-44,1964,2
STAT,1805,52,25-29,1857,0.01456188460084396
SIM,1860,32,na,1892,2150
STAT,1861,51,25-29,1912,0.002986964427569457
STAT,1936,29,na,1965,3615.8585000159637
SIM,1877,22,15-19,1899,4
SIM,1872,32,40-44,1904,12
SIM,1822,41,40-44,1863,4
STAT,1870,43,20-24,1913,0.1563710886004467
SIM,1924,32,50-100,1956,3
STAT,1879,27,na,1906,2515.395071922516
SIM,1823,40,na,1863,1615
STAT,1860,21,40-44,1881,1.786362092560339
STAT,1888,49,20-24,1937,0.007900920517199511
STAT,1933,23,50-100,1956,0.8816848924523012
SIM,1843,19,15-19,1862,7
STAT,1843,30,50-100,1873,0.7585184065287273
SIM,1922,31,35-39,1953,10
SIM,1887,40,30-34,1927,5
STAT,1899,39,25-29,1938,0.8527534207802693
SIM,1879,38,35-39,1917,2
STAT,1917,39,40-44,1956,1.559938213129128
SIM,1832,27,45-49,1859,1
SIM,1877,38,30-34,1915,6
STAT,1872,54,35-39,1926,0.008501424269904703
SIM,1891,12,na,1903,3379
SIM,1786,90,na,1876,35
STAT,1862,38,45-49,1900,1.7301353311554541
STAT,1839,38,15-19,1877,0.047084451121859786
STAT,1841,27,45-49,1868,1.0312736541176382
SIM,1799,81,na,1880,258
SIM,1927,23,35-39,1950,23
SIM,1936,29,45-49,1965,1
SIM,1890,70,na,1960,2153
STAT,1895,25,20-24,1920,15.578330902754539
SIM,1895,26,na,1921,3313
STAT,1938,27,50-100,1965,0.9954999541159372
SIM,1886,65,na,1951,1900
STAT,1869,38,30-34,1907,5.2074663668489585
STAT,1878,16,30-34,1894,1.6752042758567613
STAT,1831,23,na,1854,1568.0579014188486
STAT,1860,38,35-39,1898,5.810627427957901
STAT,1879,40,30-34,1919,1.2239771100465733
STAT,1820,52,20-24,1872,0.0012044508196219033
STAT,1886,38,30-34,1924,5.655234654500038
STAT,1912,47,40-44,1959,0.15286902602550664
STAT,1890,20,15-19,1910,4.09581927297676
SIM,1866,35,20-24,1901,1
STAT,1904,67,na,1971,2668.883743634404
STAT,1947,23,40-44,1970,3.837214082173561
SIM,1811,55,na,1866,1330
STAT,1828,34,20-24,1862,2.9465377483096815
STAT,1891,18,45-49,1909,0.08147035474358112
STAT,1841,16,35-39,1857,0.532356976377302
STAT,1840,99,na,1939,1.3275774083187935
STAT,1881,33,25-29,1914,9.929764574972191
SIM,1856,27,na,1883,2306
SIM,1888,20,25-29,1908,77
STAT,1883,36,50-100,1919,1.219306230011035
SIM,1865,101,na,1966,2
STAT,1892,22,45-49,1914,0.8837708486481552
STAT,1810,45,15-19,1855,0.0016052935725006942
STAT,1832,64,na,1896,1183.6902860309406
SIM,1894,38,30-34,1932,11
STAT,1860,27,25-29,1887,35.299388686949115
STAT,1903,41,30-34,1944,0.1153557905199722
SIM,1880,43,25-29,1923,1
STAT,1837,24,20-24,1861,60.663268488141924
STAT,1896,41,15-19,1937,0.001287885698543078
STAT,1928,29,45-49,1957,2.149177274916131
STAT,1829,84,na,1913,196.15083039041306
STAT,1854,24,20-24,1878,59.897238262940604
STAT,1882,28,45-49,1910,1.0824387142623821
SIM,1934,29,40-44,1963,9
STAT,1879,41,15-19,1920,0.014621418407767345
STAT,1875,46,30-34,1921,0.1006877145586679
STAT,1943,18,30-34,1961,13.046791925796215
SIM,1902,13,na,1915,3925
SIM,1879,30,25-29,1909,14
SIM,1915,18,20-24,1933,28
STAT,1880,19,50-100,1899,0.051687515940965975
SIM,1903,54,na,1957,2803
SIM,1898,30,35-39,1928,15
SIM,1874,32,45-49,1906,3
STAT,1820,79,na,1899,355.8601486754088
SIM,1831,31,40-44,1862,3
SIM,1896,30,30-34,1926,34
STAT,1875,35,20-24,1910,0.8071312540612999
STAT,1835,19,15-19,1854,12.720988796828209
STAT,1924,18,20-24,1942,162.71690178451098
STAT,1834,31,40-44,1865,3.3428096378842325
STAT,1830,24,35-39,1854,12.291263361345086
SIM,1833,31,45-49,1864,1
STAT,1870,41,25-29,1911,0.6397655439975714
STAT,1891,18,15-19,1909,7.401583226208094
SIM,1932,18,20-24,1950,204
STAT,1850,17,15-19,1867,5.5529002557385905
SIM,1894,36,35-39,1930,18
STAT,1844,73,na,1917,939.7311358120977
SIM,1847,9,na,1856,2322
STAT,1873,24,30-34,1897,18.12399305492217
STAT,1913,15,40-44,1928,0.2898833429395734
STAT,1927,31,50-100,1958,1.0285792093811863
SIM,1845,24,20-24,1869,95
SIM,1864,7,na,1871,2953
STAT,1861,53,20-24,1914,6.093772047751567E-4
STAT,1872,43,25-29,1915,0.6473493309422705
STAT,1820,50,25-29,1870,0.006016778850801786
SIM,1888,40,50-100,1928,2
STAT,1807,81,na,1888,214.7052762136627
STAT,1862,86,na,1948,193.52491225330266
STAT,1853,10,na,1863,2404.576084605964
SIM,1862,24,20-24,1886,80
SIM,1920,26,na,1946,4417
STAT,1782,72,na,1854,536.0
SIM,1900,26,50-100,1926,6
STAT,1853,45,40-44,1898,0.14298985768624992
STAT,1803,52,20-24,1855,0.0032002701866395765
SIM,1890,28,45-49,1918,1
SIM,1917,18,25-29,1935,68
STAT,1922,41,40-44,1963,0.290448016773188
SIM,1892,25,20-24,1917,23
STAT,1830,26,30-34,1856,29.342852399501908
SIM,1877,36,35-39,1913,8
STAT,1959,3,na,1962,5197.145860327954
SIM,1891,20,50-100,1911,2
SIM,1849,57,na,1906,1578
STAT,1922,17,50-100,1939,0.43803010974082857
STAT,1854,26,50-100,1880,0.5570556173412229
STAT,1819,106,na,1925,0.006172384912186631
STAT,1847,48,20-24,1895,0.008871949793479212
STAT,1861,40,45-49,1901,1.2687748501734635
STAT,1843,21,40-44,1864,1.7769005258567538
STAT,1881,32,40-44,1913,4.22207738092637
STAT,1869,36,35-39,1905,6.978743464702199
STAT,1849,48,25-29,1897,0.04446886338866212
STAT,1909,18,25-29,1927,8.55304131841528
SIM,1930,41,40-44,1971,4
STAT,1861,45,na,1906,1907.0716377019849
SIM,1841,53,na,1894,1467
STAT,1943,29,40-44,1972,5.007348030344928
STAT,1814,41,40-44,1855,8.163405133311295
SIM,1852,43,50-100,1895,2
STAT,1907,18,20-24,1925,26.226557709046332
SIM,1849,33,na,1882,1965
STAT,1936,32,25-29,1968,9.063397459298843
STAT,1862,37,30-34,1899,4.64856594910435
STAT,1821,34,40-44,1855,10.93924319453903
STAT,1835,41,50-100,1876,0.9627040898129545
SIM,1890,28,20-24,1918,16
STAT,1880,17,25-29,1897,6.01075834862491
STAT,1934,24,15-19,1958,7.223419339184061
SIM,1826,29,na,1855,2189
SIM,1843,41,50-100,1884,2
SIM,1870,32,30-34,1902,25
SIM,1844,54,50-100,1898,1
STAT,1892,1,na,1893,3449.6369315651764
STAT,1919,37,50-100,1956,0.455419023582993
STAT,1891,43,na,1934,2869.2770806104986
STAT,1857,19,20-24,1876,16.231839449352524
SIM,1919,15,25-29,1934,12
SIM,1875,39,35-39,1914,7
SIM,1847,27,35-39,1874,10
STAT,1910,23,15-19,1933,5.027921133500637
STAT,1867,39,35-39,1906,6.660204464496866
STAT,1897,36,40-44,1933,5.955925089630715
STAT,1858,38,25-29,1896,2.27012128447652
STAT,1859,16,20-24,1875,16.816190791844345
STAT,1847,48,50-100,1895,0.1815792319173443
STAT,1819,82,na,1901,237.1932065654916
STAT,1915,15,45-49,1930,0.10598800229435154
SIM,1919,26,35-39,1945,20
STAT,1811,86,na,1897,96.72528883192828
STAT,1815,92,na,1907,18.029131132430656
STAT,1834,37,25-29,1871,2.132854664044769
SIM,1864,24,30-34,1888,34
SIM,1837,48,na,1885,1406
STAT,1838,40,15-19,1878,0.01109201462581496
STAT,1863,50,20-24,1913,6.698461083222705E-4
SIM,1942,24,15-19,1966,5
STAT,1926,29,40-44,1955,5.606729409329363
STAT,1927,6,na,1933,5037.0992820515075
STAT,1832,88,na,1920,93.47971687107321
STAT,1847,37,35-39,1884,5.494584747747076
STAT,1823,47,20-24,1870,0.0165167996450992
STAT,1872,40,50-100,1912,1.0835676794173583
SIM,1902,30,50-100,1932,4
STAT,1882,47,na,1929,2190.8644833101857
STAT,1919,20,30-34,1939,31.966278220904805
STAT,1873,86,na,1959,319.0103744567813
SIM,1847,38,45-49,1885,2
STAT,1956,16,15-19,1972,60.68272588484546
STAT,1814,51,na,1865,1358.6871196499258
STAT,1863,16,40-44,1879,0.18787868498917265
STAT,1839,27,35-39,1866,8.617907750469623
SIM,1854,17,25-29,1871,13
STAT,1864,34,30-34,1898,15.776325508446273
STAT,1870,2,na,1872,3295.0936273082875
SIM,1838,34,30-34,1872,26
STAT,1940,21,35-39,1961,9.686777778320039
STAT,1874,54,45-49,1928,0.014595861297925287
STAT,1926,18,30-34,1944,15.063862353529265
STAT,1858,46,30-34,1904,0.0769207954278783
STAT,1916,52,na,1968,3738.6941861465807
STAT,1847,48,45-49,1895,0.1744816726501291
STAT,1833,89,na,1922,74.32492116651656
STAT,1890,38,20-24,1928,0.9466327981118599
STAT,1906,22,40-44,1928,3.065498433370748
STAT,1930,15,40-44,1945,1.8362044192276734
SIM,1864,35,40-44,1899,9
STAT,1874,34,50-100,1908,0.9394588848512039
STAT,1899,49,20-24,1948,0.009186954396974043
SIM,1845,43,na,1888,1905
STAT,1890,42,na,1932,2848.929755959436
STAT,1882,28,20-24,1910,11.437036247586816
STAT,1934,35,25-29,1969,1.3752766444442086
STAT,1869,25,na,1894,2359.3656039520265
STAT,1898,22,na,1920,3238.2452885026487
STAT,1791,89,na,1880,34.458418192272845
STAT,1896,46,45-49,1942,0.17848114178774
STAT,1846,17,25-29,1863,5.402164077583008
SIM,1820,91,na,1911,17
STAT,1936,23,35-39,1959,9.085216227239934
STAT,1874,71,na,1945,1380.436902751126
STAT,1938,31,45-49,1969,1.5982474394477524
STAT,1839,38,45-49,1877,1.6714978160440546
SIM,1855,37,35-39,1892,14
STAT,1877,46,40-44,1923,0.17896956125609922
STAT,1865,28,15-19,1893,0.41695701750247105
STAT,1916,25,50-100,1941,1.0456388178286622
STAT,1830,27,45-49,1857,1.2204049133407735
STAT,1864,35,45-49,1899,1.8340929499644731
SIM,1888,28,35-39,1916,13
SIM,1900,7,na,1907,3844
STAT,1856,24,30-34,1880,15.789925007688018
SIM,1929,33,40-44,1962,5
STAT,1836,47,30-34,1883,0.0639065936733923
STAT,1818,84,na,1902,171.39033341866678
STAT,1893,18,25-29,1911,7.248207415027484
STAT,1848,63,na,1911,1456.8102762833428
SIM,1869,93,na,1962,52
STAT,1867,25,15-19,1892,0.4344997275564062
STAT,1908,34,15-19,1942,0.12139718090768352
SIM,1828,71,na,1899,732
SIM,1882,18,15-19,1900,6
SIM,1834,38,35-39,1872,18
SIM,1836,47,na,1883,1756
STAT,1938,20,35-39,1958,9.41428946283505
STAT,1871,17,50-100,1888,0.049477128158511484
STAT,1903,44,35-39,1947,0.17843413013940637
STAT,1858,81,na,1939,428.4945384640978
STAT,1812,45,25-29,1857,0.13719570452413518
STAT,1897,25,30-34,1922,34.32910345374442
SIM,1888,39,45-49,1927,2
STAT,1841,84,na,1925,248.77037319725733
SIM,1834,27,25-29,1861,44
STAT,1832,49,15-19,1881,2.8647004918853165E-4
SIM,1908,25,20-24,1933,21
STAT,1812,42,15-19,1854,0.04543986523515291
STAT,1918,19,50-100,1937,0.409486216728772
SIM,1872,97,na,1969,6
SIM,1919,29,45-49,1948,2
STAT,1908,45,25-29,1953,0.04913831444674589
SIM,1881,22,35-39,1903,7
SIM,1882,35,na,1917,2107
SIM,1858,38,20-24,1896,1
STAT,1903,42,na,1945,3331.8921493568537
SIM,1889,14,na,1903,3197
SIM,1886,49,na,1935,2464
STAT,1834,48,35-39,1882,0.0872970955029662
STAT,1849,45,45-49,1894,0.186356841053016
SIM,1836,37,30-34,1873,6
STAT,1826,38,35-39,1864,7.945999819687092
STAT,1901,47,35-39,1948,0.11129133503586477
STAT,1971,0,na,1971,5066.483634754046
STAT,1861,17,20-24,1878,17.101924171364434
STAT,1936,21,15-19,1957,5.139617962679556
SIM,1858,29,30-34,1887,25
SIM,1927,36,40-44,1963,2
STAT,1931,19,50-100,1950,0.4929516685916877
STAT,1788,69,na,1857,629.4954350812161
SIM,1944,2,na,1946,4407
SIM,1864,38,45-49,1902,6
SIM,1881,20,15-19,1901,2
STAT,1832,24,45-49,1856,0.6615736265121394
STAT,1895,28,30-34,1923,33.09709016593871
SIM,1944,21,15-19,1965,10
STAT,1893,29,35-39,1922,12.28574542627842
STAT,1850,17,45-49,1867,0.06112161950552203
STAT,1877,76,na,1953,987.5956619087317
SIM,1849,35,45-49,1884,3
STAT,1914,31,35-39,1945,9.31891765354917
STAT,1810,48,25-29,1858,0.21832979613335954
SIM,1906,15,15-19,1921,9
STAT,1951,18,na,1969,4426.9698794520045
SIM,1878,14,na,1892,3031
SIM,1877,34,50-100,1911,5
STAT,1828,37,30-34,1865,5.491269305814306
SIM,1870,50,na,1920,2409
STAT,1881,30,15-19,1911,0.13975762578091191
STAT,1840,34,45-49,1874,1.458270847204426
SIM,1908,39,40-44,1947,1
STAT,1881,35,45-49,1916,1.959221711812516
SIM,1837,91,na,1928,72
STAT,1888,45,50-100,1933,0.29570154575240853
STAT,1927,30,30-34,1957,19.61110204623832
STAT,1876,19,30-34,1895,1.6532417020740662
SIM,1840,21,35-39,1861,5
SIM,1913,26,50-100,1939,5
SIM,1824,46,50-100,1870,2
SIM,1919,48,50-100,1967,1
STAT,1860,24,45-49,1884,0.5850005459515739
STAT,1864,48,20-24,1912,0.010799227172684032
STAT,1900,16,15-19,1916,8.346690322274592
STAT,1821,51,50-100,1872,0.021719132566893177
STAT,1876,28,20-24,1904,12.190997288874284
SIM,1823,33,50-100,1856,1
STAT,1855,51,30-34,1906,0.00450204608325144
STAT,1865,28,45-49,1893,1.0203792963435638
STAT,1886,39,45-49,1925,2.104444631516478
STAT,1879,43,na,1922,2418.4488441162025
STAT,1893,15,45-49,1908,0.08416150803945256
STAT,1905,26,50-100,1931,0.9372179675783118
SIM,1879,33,50-100,1912,6
STAT,1890,58,na,1948,2440.6733462239176
SIM,1817,37,20-24,1854,4
SIM,1939,19,15-19,1958,41
SIM,1938,26,45-49,1964,4
STAT,1860,35,30-34,1895,4.442030579069212
STAT,1814,44,45-49,1858,3.8029501660454916
STAT,1932,39,na,1971,5097.499701364696
STAT,1888,63,na,1951,2127.0899371776877
SIM,1822,44,45-49,1866,6
STAT,1864,30,15-19,1894,0.13083178621546046
SIM,1903,34,35-39,1937,13
STAT,1828,37,25-29,1865,2.9665477696152283
SIM,1965,5,na,1970,5215
SIM,1908,28,30-34,1936,42
SIM,1877,29,na,1906,2477
SIM,1895,18,25-29,1913,13
STAT,1894,42,50-100,1936,0.09527799819458639
SIM,1869,5,na,1874,2606
STAT,1908,41,50-100,1949,0.11035173690080889
SIM,1894,39,45-49,1933,3
SIM,1845,15,30-34,1860,2
STAT,1889,17,45-49,1906,0.08135226835080128
SIM,1945,16,35-39,1961,6
STAT,1789,67,na,1856,897.5109545200002
STAT,1865,35,na,1900,2193.449564508518
STAT,1871,25,35-39,1896,9.747654037636092
SIM,1884,28,20-24,1912,10
SIM,1828,27,25-29,1855,46
SIM,1839,29,20-24,1868,4
SIM,1885,43,30-34,1928,1
STAT,1804,92,na,1896,12.912136531185077
STAT,1857,40,na,1897,1840.2044747257578
STAT,1880,17,30-34,1897,1.690634050994838
SIM,1851,12,na,1863,2401
STAT,1854,27,25-29,1881,33.28083666915759
STAT,1877,32,20-24,1909,2.817731466660575
STAT,1918,41,15-19,1959,0.0016507730993266163
STAT,1838,44,30-34,1882,0.7983251985184817
STAT,1944,24,na,1968,3978.8313855829924
STAT,1837,26,40-44,1863,2.641952290057452
SIM,1862,27,25-29,1889,42
SIM,1922,6,na,1928,5180
STAT,1877,43,30-34,1920,1.1897837048027655
STAT,1873,48,50-100,1921,0.24831243305981499
SIM,1946,20,35-39,1966,14
SIM,1837,32,na,1869,1659
STAT,1858,54,50-100,1912,0.011638125521966858
STAT,1911,18,40-44,1929,0.2816415755344215
STAT,1919,17,na,1936,4106.903120538497
SIM,1885,32,20-24,1917,5
SIM,1823,34,40-44,1857,4
STAT,1937,16,35-39,1953,4.1312379120707545
SIM,1845,26,40-44,1871,2
SIM,1924,16,na,1940,4480
STAT,1861,61,na,1922,1568.3086819240402
SIM,1846,44,30-34,1890,1
STAT,1865,75,na,1940,949.4275796961116
SIM,1914,22,40-44,1936,5
STAT,1876,78,na,1954,814.8072971144597
SIM,1886,25,na,1911,2686
SIM,1853,38,45-49,1891,2
STAT,1879,45,30-34,1924,0.103044350189945
STAT,1877,60,na,1937,1988.0885643302818
STAT,1834,34,45-49,1868,1.302936636844588
STAT,1808,47,25-29,1855,0.21037127112939774
STAT,1926,15,20-24,1941,168.77527406066753
SIM,1862,15,na,1877,2360
STAT,1845,15,na,1860,2145.089352711618
SIM,1866,29,na,1895,2400
STAT,1875,49,35-39,1924,0.14217856492146974
STAT,1922,44,45-49,1966,0.19234010688449615
STAT,1854,27,30-34,1881,19.81197499152446
SIM,1836,37,25-29,1873,5
STAT,1849,45,20-24,1894,0.009475771938575121
SIM,1862,27,30-34,1889,26
STAT,1891,5,na,1896,3277.0513108478067
STAT,1894,49,45-49,1943,0.169491086803292
STAT,1895,28,25-29,1923,55.597629842971656
STAT,1844,51,25-29,1895,0.002815792975595073
STAT,1882,25,40-44,1907,2.9505855018020304
SIM,1829,42,35-39,1871,6
STAT,1841,24,40-44,1865,1.9458133422984953
SIM,1864,38,20-24,1902,1
STAT,1881,41,30-34,1922,1.1243417432731215
STAT,1870,81,na,1951,536.3238781155928
STAT,1866,32,45-49,1898,1.630879314168313
SIM,1798,56,na,1854,1069
SIM,1850,73,na,1923,881
STAT,1945,26,40-44,1971,5.166561593364816
STAT,1837,28,50-100,1865,0.5561073052511339
SIM,1824,81,na,1905,265
STAT,1855,92,na,1947,31.350381914489034
SIM,1927,20,30-34,1947,48
SIM,1833,58,na,1891,1447
STAT,1881,30,20-24,1911,2.6527578334509885
STAT,1846,53,25-29,1899,0.0026448216335327028
SIM,1842,34,45-49,1876,1
STAT,1887,18,25-29,1905,6.373321404053759
STAT,1874,51,35-39,1925,0.008945998793369358
SIM,1935,30,30-34,1965,31
SIM,1875,28,25-29,1903,8
STAT,1819,48,45-49,1867,0.45315316284358037
STAT,1929,42,35-39,1971,0.26357811705695094
SIM,1883,31,50-100,1914,1
STAT,1910,39,30-34,1949,1.74092908716313
STAT,1875,38,25-29,1913,2.9715413450091117
STAT,1900,37,na,1937,3331.5447728546146
SIM,1882,75,na,1957,907
SIM,1953,13,na,1966,4916
STAT,1803,54,40-44,1857,0.04380165123371699
STAT,1788,103,na,1891,0.04026201703222444
SIM,1844,31,20-24,1875,3
STAT,1956,16,45-49,1972,0.6679440132673663
STAT,1855,42,40-44,1897,1.6909923530297764
STAT,1903,44,40-44,1947,0.22163934378935965
STAT,1894,32,na,1926,3103.0046577342564
SIM,1870,35,40-44,1905,13
STAT,1810,61,na,1871,1159.4576371180242
STAT,1835,27,20-24,1862,11.480024250687771
STAT,1865,17,35-39,1882,0.521475613075697
SIM,1874,41,35-39,1915,3
STAT,1821,64,na,1885,1059.2017995784754
STAT,1947,20,30-34,1967,32.833773618652415
SIM,1879,35,30-34,1914,13
STAT,1866,41,35-39,1907,1.7011948604763347
SIM,1896,33,35-39,1929,1
SIM,1883,38,25-29,1921,4
STAT,1870,45,40-44,1915,0.17148692171743726
SIM,1843,27,20-24,1870,17
SIM,1911,44,40-44,1955,5
STAT,1921,21,25-29,1942,105.68904309106003
STAT,1828,43,na,1871,1696.4927134602021
STAT,1848,16,45-49,1864,0.06650600947438452
STAT,1888,33,35-39,1921,12.021647347742757
STAT,1836,78,na,1914,492.64901249489833
STAT,1906,3,na,1909,3889.070339621941
SIM,1934,15,20-24,1949,204
STAT,1843,37,20-24,1880,0.6069520901884626
STAT,1907,16,na,1923,3755.2497512775008
SIM,1865,19,20-24,1884,32
SIM,1849,17,na,1866,2312
STAT,1917,24,15-19,1941,5.674927444055451
STAT,1823,33,30-34,1856,40.44040959196672
STAT,1825,41,40-44,1866,3.300281710843001
STAT,1858,35,20-24,1893,0.6166112553972093
STAT,1853,45,35-39,1898,0.11693095865794471
SIM,1945,16,40-44,1961,5
STAT,1874,19,20-24,1893,18.23633762548519
STAT,1803,52,15-19,1855,1.0667557905251192E-4
STAT,1876,15,15-19,1891,6.217558479076508
SIM,1805,86,na,1891,82
SIM,1826,45,na,1871,1855
STAT,1915,28,20-24,1943,18.72104793453641
SIM,1820,41,30-34,1861,4
SIM,1917,17,40-44,1934,1
STAT,1901,47,40-44,1948,0.13609340367286762
STAT,1891,27,na,1918,2984.2952626874307
SIM,1875,36,30-34,1911,9
STAT,1886,53,na,1939,2259.318153536814
STAT,1891,25,50-100,1916,0.8053483099975628
STAT,1853,34,25-29,1887,8.54346961283157
STAT,1855,42,35-39,1897,1.3613591541401302
STAT,1946,16,50-100,1962,0.4198191618169857
SIM,1775,90,na,1865,30
STAT,1908,30,20-24,1938,2.3428361840105323
SIM,1923,28,20-24,1951,26
SIM,1853,22,na,1875,1874
SIM,1875,25,20-24,1900,12
SIM,1865,42,45-49,1907,1
STAT,1791,92,na,1883,10.451127639884975
STAT,1937,16,40-44,1953,1.3770793837548387
STAT,1863,53,25-29,1916,0.0031188179775729088
STAT,1874,51,40-44,1925,0.010939678499234945
SIM,1938,23,35-39,1961,14
STAT,1810,45,20-24,1855,0.048158849537148454
SIM,1780,74,na,1854,500
SIM,1784,88,na,1872,35
SIM,1869,101,na,1970,1
SIM,1880,42,40-44,1922,7
SIM,1893,75,na,1968,1814
SIM,1916,38,30-34,1954,2
STAT,1828,99,na,1927,1.229417344676816
STAT,1820,101,na,1921,0.29046012160419576
STAT,1817,59,na,1876,1069.4602155254152
STAT,1885,41,45-49,1926,1.5114369209825
STAT,1892,32,40-44,1924,5.496264235828841
STAT,1919,22,20-24,1941,122.93821525286333
SIM,1831,33,30-34,1864,21
SIM,1872,32,35-39,1904,20
SIM,1817,71,na,1888,660
STAT,1842,47,na,1889,2025.9482708095704
STAT,1862,47,35-39,1909,0.12154155557696329
STAT,1855,45,45-49,1900,0.1794131348002003
STAT,1862,35,40-44,1897,3.8544082325642712
STAT,1901,5,na,1906,3710.450539701048
STAT,1921,24,35-39,1945,10.674016105110395
STAT,1819,43,15-19,1862,0.028677210683288885
STAT,1918,16,na,1934,4268.502797563481
STAT,1861,0,na,1861,3246.0346719402496
SIM,1834,40,na,1874,1860
SIM,1888,36,40-44,1924,7
STAT,1868,37,50-100,1905,1.1851288838252307
SIM,1916,30,20-24,1946,2
STAT,1910,36,na,1946,3647.680780498485
SIM,1893,41,45-49,1934,1
STAT,1890,24,30-34,1914,21.84560331747847
STAT,1909,17,40-44,1926,0.2767887794754969
SIM,1852,77,na,1929,504
SIM,1908,28,25-29,1936,80
STAT,1886,34,15-19,1920,0.1505623600259051
SIM,1841,37,na,1878,1729
SIM,1868,27,50-100,1895,4
SIM,1849,39,30-34,1888,6
STAT,1877,17,na,1894,2632.750724206552
STAT,1917,23,25-29,1940,98.78711249763036
SIM,1862,98,na,1960,2
STAT,1908,17,na,1925,3781.9160380220446
STAT,1910,34,30-34,1944,15.195436668630059
STAT,1839,24,30-34,1863,15.993859786799552
STAT,1853,46,25-29,1899,0.04776908910920068
STAT,1890,22,35-39,1912,7.201920917378904
STAT,1901,33,15-19,1934,0.20077809022878396
SIM,1927,22,20-24,1949,158
SIM,1894,22,15-19,1916,5
STAT,1810,110,na,1920,1.435189921946818E-4
SIM,1854,63,na,1917,1596
STAT,1919,20,25-29,1939,102.73411526038919
SIM,1913,13,na,1926,4061
STAT,1908,49,40-44,1957,0.14309048018741147
STAT,1863,19,45-49,1882,0.05998795986125367
STAT,1920,44,35-39,1964,0.22383657212332794
SIM,1918,2,na,1920,4598
STAT,1823,31,35-39,1854,31.21350521739859
SIM,1900,65,na,1965,2782
STAT,1839,35,40-44,1874,3.7865847940846185
SIM,1861,34,25-29,1895,14
STAT,1812,49,40-44,1861,0.38239946593199586
STAT,1864,6,na,1870,2584.708602418778
SIM,1927,39,45-49,1966,1
STAT,1941,18,20-24,1959,140.93964044355474
STAT,1867,29,30-34,1896,23.782374429915432
STAT,1821,46,35-39,1867,0.20818741464933108
STAT,1875,35,45-49,1910,2.0873162707481843
STAT,1908,38,30-34,1946,1.7140124833268922
STAT,1817,46,15-19,1863,8.739297480288441E-4
STAT,1886,22,15-19,1908,3.518056130097605
STAT,1808,82,na,1890,175.90507362101047
STAT,1828,26,50-100,1854,1.6625769651824172
STAT,1949,23,15-19,1972,6.273162533277879
STAT,1907,18,15-19,1925,8.779229074972678
STAT,1884,37,15-19,1921,0.055929662900117555
STAT,1912,37,45-49,1949,0.6712872058251852
SIM,1925,23,25-29,1948,138
SIM,1942,20,20-24,1962,1
SIM,1875,25,na,1900,2351
SIM,1901,37,35-39,1938,5
SIM,1828,55,na,1883,1270
STAT,1855,44,30-34,1899,0.8536982471633074
SIM,1833,41,40-44,1874,9
SIM,1824,41,na,1865,1538
STAT,1865,91,na,1956,60.473166448898205
STAT,1933,39,50-100,1972,0.5766547310994005
SIM,1847,24,30-34,1871,28
STAT,1821,35,25-29,1856,6.300745463390251
STAT,1848,101,na,1949,0.46589045220746816
SIM,1838,30,na,1868,1969
SIM,1879,36,45-49,1915,2
STAT,1870,43,15-19,1913,0.013597486699668265
STAT,1917,35,25-29,1952,1.0420860897732505
STAT,1859,51,45-49,1910,0.011845355861314603
STAT,1868,42,20-24,1910,0.15311203178047622
STAT,1930,18,45-49,1948,0.6510441248689647
SIM,1816,44,45-49,1860,6
SIM,1847,35,40-44,1882,3
STAT,1854,11,na,1865,2152.942921054543
STAT,1858,25,na,1883,1963.9595782661543
SIM,1831,31,35-39,1862,10
SIM,1811,71,na,1882,761
STAT,1867,61,na,1928,1777.4871234560837
STAT,1829,44,na,1873,1499.0960063065015
STAT,1830,24,40-44,1854,4.3891235889745275
SIM,1860,29,na,1889,2075
STAT,1873,25,45-49,1898,1.14456275539922
SIM,1903,22,35-39,1925,13
SIM,1927,20,25-29,1947,133
SIM,1919,26,40-44,1945,6
STAT,1873,21,50-100,1894,0.4188010933298705
STAT,1938,33,40-44,1971,3.9699180274509436
SIM,1925,35,25-29,1960,1
SIM,1849,20,40-44,1869,1
SIM,1925,24,15-19,1949,10
SIM,1892,33,50-100,1925,1
STAT,1945,0,na,1945,4913.675011086207
STAT,1816,41,45-49,1857,4.460637518150134
STAT,1856,23,40-44,1879,1.8605778055511846
SIM,1812,56,na,1868,1126
SIM,1873,25,40-44,1898,3
SIM,1897,68,na,1965,2274
SIM,1845,25,35-39,1870,12
STAT,1845,33,15-19,1878,0.1224441552194841
STAT,1839,43,na,1882,1705.0342103276832
SIM,1860,18,30-34,1878,2
STAT,1853,66,na,1919,1355.4229238288221
STAT,1870,30,45-49,1900,1.743404332631768
STAT,1866,20,na,1886,2262.300653439164
STAT,1816,54,20-24,1870,0.0017610206225862001
STAT,1844,43,50-100,1887,0.845150362389567
STAT,1826,35,30-34,1861,6.487191246307467
STAT,1837,29,45-49,1866,0.9582956024976772
SIM,1865,3,na,1868,2838
SIM,1891,36,50-100,1927,2
SIM,1896,27,na,1923,3148
STAT,1903,32,50-100,1935,1.3179397541897662
STAT,1883,45,20-24,1928,0.011978700121335513
STAT,1846,50,20-24,1896,5.680432430388659E-4
STAT,1894,35,25-29,1929,3.779478399593607
SIM,1843,18,30-34,1861,7
STAT,1931,38,na,1969,5030.518246407663
STAT,1837,18,35-39,1855,0.5995969300457799
SIM,1873,39,na,1912,2240
STAT,1919,39,45-49,1958,0.7378899359832255
STAT,1936,35,35-39,1971,2.401412656800627
SIM,1845,29,45-49,1874,1
STAT,1882,28,15-19,1910,0.44231632251394515
SIM,1872,34,30-34,1906,26
STAT,1901,45,15-19,1946,3.226492563492241E-4
STAT,1833,37,50-100,1870,1.089982666006251
SIM,1864,65,na,1929,1854
SIM,1853,21,15-19,1874,3
STAT,1893,26,30-34,1919,32.40513828952939
STAT,1916,44,15-19,1960,0.00158287612698647
STAT,1831,63,na,1894,1121.2576936316082
SIM,1864,23,40-44,1887,3
STAT,1877,47,25-29,1924,0.059763656373665736
STAT,1831,41,40-44,1872,1.7617888778560653
STAT,1822,50,35-39,1872,0.012793336076076205
SIM,1834,35,30-34,1869,5
SIM,1874,24,na,1898,2198
STAT,1827,58,na,1885,1234.5793954924363
STAT,1861,41,50-100,1902,0.890670986211673
SIM,1860,19,15-19,1879,9
STAT,1925,45,30-34,1970,0.10968363104154419
STAT,1805,51,40-44,1856,0.04416320156878681
SIM,1850,31,45-49,1881,1
STAT,1941,19,na,1960,3825.052721144674
STAT,1862,21,15-19,1883,2.966942496094262
STAT,1893,15,20-24,1908,22.84143787447308
STAT,1828,35,35-39,1863,7.612935443927271
SIM,1942,28,30-34,1970,47
SIM,1860,51,na,1911,1936
SIM,1915,18,15-19,1933,10
STAT,1934,20,20-24,1954,151.48456281767827
STAT,1886,36,40-44,1922,4.690606359953382
STAT,1887,15,20-24,1902,20.084390052487414
SIM,1834,24,20-24,1858,60
SIM,1912,50,na,1962,3341
STAT,1822,52,25-29,1874,0.005058351414481181
SIM,1870,10,na,1880,3012
SIM,1896,36,45-49,1932,2
STAT,1852,19,15-19,1871,5.37950990624566
SIM,1885,64,na,1949,1760
SIM,1870,21,15-19,1891,5
STAT,1909,42,na,1951,3505.377301179993
STAT,1888,36,45-49,1924,2.387896815288601
SIM,1881,50,na,1931,1937
SIM,1894,36,40-44,1930,9
STAT,1949,23,45-49,1972,1.3259714163300178
SIM,1895,15,20-24,1910,28
STAT,1856,35,40-44,1891,3.42189534313361
STAT,1948,20,50-100,1968,0.7637271895691459
SIM,1935,33,35-39,1968,17
SIM,1823,96,na,1919,9
SIM,1885,24,na,1909,2542
SIM,1801,53,na,1854,968
STAT,1927,33,35-39,1960,11.355027562423643
STAT,1819,45,40-44,1864,0.3437033697759189
STAT,1934,28,30-34,1962,53.23429624056177
SIM,1839,74,na,1913,648
STAT,1836,46,25-29,1882,0.03851739001236001
STAT,1872,42,40-44,1914,2.281149736722767
SIM,1851,15,na,1866,2323
STAT,1876,15,45-49,1891,0.06843761387910961
SIM,1819,35,35-39,1854,13
SIM,1876,50,na,1926,2514
STAT,1922,21,na,1943,4243.393424925497
STAT,1871,23,15-19,1894,3.300091683928209
STAT,1907,32,na,1939,3569.550469421426
SIM,1910,8,na,1918,3783
SIM,1870,33,20-24,1903,3
STAT,1785,77,na,1862,328.98270304745574
STAT,1842,44,20-24,1886,0.1441909699877049
SIM,1831,75,na,1906,650
STAT,1863,25,na,1888,2166.6770111873843
SIM,1794,66,na,1860,775
SIM,1872,14,na,1886,2855
STAT,1878,26,35-39,1904,10.151182114779347
SIM,1935,31,50-100,1966,1
SIM,1838,35,45-49,1873,1
STAT,1926,18,25-29,1944,53.55696955868836
SIM,1905,18,na,1923,3777
SIM,1870,44,30-34,1914,4
STAT,1842,26,na,1868,2426.000843192016
STAT,1846,19,45-49,1865,0.06154135930446359
STAT,1885,12,na,1897,2596.2938481761207
SIM,1886,26,35-39,1912,15
SIM,1867,16,20-24,1883,20
SIM,1839,95,na,1934,5
STAT,1817,45,30-34,1862,0.2148870654130214
STAT,1847,35,45-49,1882,1.5811336177744124
STAT,1855,76,na,1931,713.1304781816671
STAT,1836,45,40-44,1881,0.11595839378080108
SIM,1842,78,na,1920,416
STAT,1843,29,15-19,1872,0.3712086585581889
STAT,1894,46,35-39,1940,0.1029811964450345
SIM,1824,41,45-49,1865,4
STAT,1933,24,na,1957,4891.533785237725
SIM,1881,27,50-100,1908,3
STAT,1894,47,25-29,1941,0.04205248295213304
STAT,1899,20,35-39,1919,8.137124295890997
STAT,1841,27,15-19,1868,0.42140877278735434
STAT,1869,65,na,1934,1659.4730386426234
SIM,1835,81,na,1916,242
STAT,1827,44,25-29,1871,0.6675078262365911
SIM,1853,35,40-44,1888,8
STAT,1826,29,15-19,1855,0.8233576004181812
SIM,1855,35,45-49,1890,2
SIM,1910,24,25-29,1934,125
SIM,1954,3,na,1957,4842
STAT,1883,32,45-49,1915,1.7235438666571
STAT,1865,25,40-44,1890,2.7814196946770355
STAT,1867,25,45-49,1892,1.0633099040306915
STAT,1921,37,40-44,1958,1.6881873320948904
STAT,1852,18,30-34,1870,1.4533598695730803
STAT,1862,34,20-24,1896,2.337477349735364
SIM,1848,32,na,1880,1941
SIM,1918,33,35-39,1951,25
STAT,1858,47,15-19,1905,3.154767088743415E-4
SIM,1905,5,na,1910,3932
STAT,1902,24,25-29,1926,81.1928912505136
STAT,1892,47,20-24,1939,0.00853889400425461
SIM,1891,32,45-49,1923,3
STAT,1807,97,na,1904,1.903010167434305
STAT,1867,36,30-34,1903,5.094011546880889
STAT,1876,75,na,1951,1073.567261192464
STAT,1897,26,45-49,1923,1.508575040758484
STAT,1865,51,na,1916,1995.2729918530054
STAT,1851,31,40-44,1882,3.4534262112204073
STAT,1839,32,50-100,1871,0.7993994366613488
SIM,1892,36,30-34,1928,9
STAT,1825,48,50-100,1873,0.32524110334167633
SIM,1833,48,50-100,1881,4
SIM,1838,22,30-34,1860,16
SIM,1914,20,45-49,1934,1
STAT,1853,31,20-24,1884,2.325991642829611
SIM,1825,34,20-24,1859,2
SIM,1889,40,40-44,1929,4
STAT,1898,43,45-49,1941,0.14127359004851475
SIM,1820,44,35-39,1864,1
STAT,1912,20,15-19,1932,5.177614084651943
STAT,1863,51,35-39,1914,0.007741020447335075
STAT,1809,45,na,1854,1498.5007233323795
STAT,1850,53,45-49,1903,0.010933935134657607
SIM,1884,39,na,1923,2382
SIM,1893,40,50-100,1933,3
STAT,1908,33,25-29,1941,8.769670360255535
SIM,1881,34,35-39,1915,9
SIM,1899,29,50-100,1928,1
STAT,1853,4,na,1857,2651.549514155632
STAT,1897,47,50-100,1944,0.1867152002899815
STAT,1806,56,na,1862,1060.1855449007503
STAT,1887,38,na,1925,2643.530835140142
STAT,1833,33,na,1866,1953.304626576695
STAT,1912,31,25-29,1943,9.213092789515038
STAT,1921,39,na,1960,4233.687670774464
STAT,1901,49,30-34,1950,0.07569625109546456
STAT,1947,23,35-39,1970,10.745700799205952
STAT,1904,24,35-39,1928,8.405105652525332
STAT,1892,68,na,1960,2070.5037885193906
STAT,1888,30,30-34,1918,20.981238423682925
SIM,1838,33,40-44,1871,5
SIM,1907,0,na,1907,4209
STAT,1862,44,30-34,1906,0.9892285435664114
STAT,1939,16,45-49,1955,0.5049362760288185
STAT,1932,27,15-19,1959,0.9344333724119337
STAT,1942,25,50-100,1967,1.05568564475894
STAT,1885,40,50-100,1925,1.0728078181258378
STAT,1840,33,30-34,1873,14.753083409328372
SIM,1848,88,na,1936,127
STAT,1884,36,30-34,1920,5.333781652305672
STAT,1838,42,35-39,1880,1.4176459620103932
STAT,1873,34,35-39,1907,10.280422848909204
STAT,1884,25,20-24,1909,11.763738121292468
SIM,1800,68,na,1868,715
STAT,1843,51,na,1894,1459.1906832527022
STAT,1906,20,45-49,1926,1.0319528913827043
SIM,1818,96,na,1914,9
STAT,1836,44,20-24,1880,0.11616903325278659
STAT,1880,80,na,1960,837.672590807252
SIM,1872,76,na,1948,809
SIM,1861,31,20-24,1892,3
STAT,1929,25,50-100,1954,1.2638663060404713
SIM,1937,25,50-100,1962,2
STAT,1864,10,na,1874,2504.297478962836
SIM,1862,36,na,1898,2146
SIM,1920,34,40-44,1954,7
STAT,1875,52,50-100,1927,0.015581443913936963
STAT,1831,50,30-34,1881,0.004069722620739412
STAT,1897,39,15-19,1936,0.01624664973286658
SIM,1831,78,na,1909,503
STAT,1910,35,15-19,1945,0.01870559508950771
STAT,1930,35,na,1965,4968.507414301783
STAT,1845,17,50-100,1862,0.045245145104257554
STAT,1903,47,45-49,1950,0.19059410773930258
SIM,1942,23,25-29,1965,131
STAT,1917,53,na,1970,3790.942523640778
SIM,1920,20,15-19,1940,9
STAT,1937,7,na,1944,3925.8519089041915
STAT,1864,46,50-100,1910,0.22447220375841467
STAT,1899,23,na,1922,3268.1865222078727
STAT,1910,7,na,1917,3983.035069889079
STAT,1849,52,50-100,1901,0.011745267672427818
STAT,1892,35,45-49,1927,2.550498073138533
STAT,1853,42,30-34,1895,0.9495781197240862
STAT,1875,47,15-19,1922,4.1295242250621937E-4
SIM,1906,28,20-24,1934,19
STAT,1825,44,45-49,1869,2.05028046816345
SIM,1938,20,30-34,1958,30
STAT,1928,26,40-44,1954,5.824077666469749
SIM,1920,31,25-29,1951,23
STAT,1878,61,na,1939,1959.1798828008075
STAT,1799,69,na,1868,705.7974102427531
STAT,1821,48,na,1869,1536.3842773816511
SIM,1814,43,35-39,1857,5
SIM,1842,31,40-44,1873,8
STAT,1929,19,na,1948,4722.414063499357
SIM,1816,86,na,1902,75
SIM,1874,40,na,1914,2269
SIM,1899,23,40-44,1922,2
SIM,1833,44,45-49,1877,1
STAT,1913,18,45-49,1931,0.1027809569250274
SIM,1836,35,35-39,1871,14
SIM,1841,18,20-24,1859,19
STAT,1855,14,na,1869,2117.898779763866
STAT,1942,20,na,1962,3868.5401240115175
SIM,1887,50,na,1937,2341
STAT,1905,41,35-39,1946,0.18443297455679358
STAT,1920,30,50-100,1950,0.9218806216800353
STAT,1877,45,20-24,1922,0.01263379046333015
SIM,1884,61,na,1945,1918
STAT,1821,43,30-34,1864,1.7809538711207171
STAT,1868,45,25-29,1913,0.056155069448696304
STAT,1895,26,35-39,1921,12.770257499098458
SIM,1886,28,25-29,1914,56
STAT,1954,2,na,1956,4914.962565773188
STAT,1845,106,na,1951,0.008871763342241238
STAT,1929,16,na,1945,4759.536814093261
SIM,1906,19,30-34,1925,4
SIM,1840,33,35-39,1873,13
STAT,1845,21,15-19,1866,3.0141851403790505
SIM,1861,14,na,1875,2457
SIM,1819,37,25-29,1856,2
STAT,1840,46,45-49,1886,0.16897714433514385
SIM,1916,22,15-19,1938,5
STAT,1789,102,na,1891,0.08923265905005591
STAT,1792,74,na,1866,433.7660099034871
SIM,1831,49,50-100,1880,2
STAT,1897,2,na,1899,3609.460300093131
SIM,1912,24,35-39,1936,13
STAT,1810,107,na,1917,0.002449278486747281
STAT,1823,49,50-100,1872,0.3285507124900648
SIM,1851,24,20-24,1875,108
SIM,1914,54,na,1968,3734
STAT,1888,60,na,1948,2273.571167597603
STAT,1842,31,45-49,1873,1.9164241802613151
STAT,1877,23,50-100,1900,0.42377670263501194
SIM,1901,34,30-34,1935,19
STAT,1876,51,45-49,1927,0.015206579803557576
STAT,1892,22,50-100,1914,0.5168250773814941
SIM,1863,42,40-44,1905,3
SIM,1903,14,na,1917,3522
SIM,1869,23,25-29,1892,62
STAT,1881,34,30-34,1915,16.852646137355414
SIM,1925,28,30-34,1953,76
SIM,1927,4,na,1931,5511
SIM,1887,49,50-100,1936,2
STAT,1920,41,30-34,1961,0.14279172189842448
STAT,1908,22,15-19,1930,4.940054481919674
STAT,1917,20,20-24,1937,120.00066550083872
SIM,1816,41,40-44,1857,8
STAT,1778,109,na,1887,0.0034997913733099814
SIM,1850,40,35-39,1890,6
SIM,1896,24,na,1920,3134
SIM,1858,22,40-44,1880,2
STAT,1821,100,na,1921,0.6359168094832888
STAT,1843,24,20-24,1867,57.50621174334498
SIM,1905,32,40-44,1937,2
SIM,1851,35,30-34,1886,4
SIM,1879,33,40-44,1912,6
STAT,1834,74,na,1908,660.5778003343801
SIM,1916,33,25-29,1949,13
STAT,1875,32,40-44,1907,4.498118186640846
SIM,1883,32,40-44,1915,8
STAT,1816,108,na,1924,9.365108892751465E-4
SIM,1774,89,na,1863,26
STAT,1894,16,50-100,1910,0.06386233531631903
STAT,1895,24,15-19,1919,4.324052021698077
STAT,1814,43,30-34,1857,3.0622840880963524
STAT,1867,38,20-24,1905,0.7296114496474254
SIM,1840,52,na,1892,1507
STAT,1832,48,na,1880,1617.962737845532
STAT,1906,37,15-19,1943,0.017830463861546773
STAT,1856,38,15-19,1894,0.0432673987481435
SIM,1935,16,na,1951,5000
STAT,1812,44,35-39,1856,4.3639454411165595
STAT,1864,32,35-39,1896,9.229678082224275
SIM,1822,43,30-34,1865,1
SIM,1926,42,na,1968,4585
STAT,1834,46,15-19,1880,2.8120165284658687E-4
STAT,1843,35,30-34,1878,4.284470482750769
STAT,1879,22,50-100,1901,0.4298110188018119
STAT,1897,24,40-44,1921,2.803935991870514
STAT,1842,40,35-39,1882,1.7305412500194626
STAT,1828,33,15-19,1861,0.16094755715641998
STAT,1872,51,30-34,1923,0.00607326296841151
STAT,1880,83,na,1963,662.862930667895
SIM,1862,25,35-39,1887,12
SIM,1838,33,na,1871,1855
SIM,1828,26,40-44,1854,2
STAT,1821,33,20-24,1854,9.314469366070291
STAT,1877,79,na,1956,768.5835155381908
SIM,1899,16,na,1915,3859
STAT,1880,43,na,1923,2433.8467807083384
STAT,1827,52,50-100,1879,0.014956079531280059
SIM,1900,19,20-24,1919,31
SIM,1815,45,na,1860,1479
STAT,1887,17,40-44,1904,0.2062498925189277
SIM,1859,32,na,1891,2208
STAT,1879,43,35-39,1922,1.8948101219943738
STAT,1877,44,20-24,1921,0.16331578804694602
SIM,1866,38,25-29,1904,1
STAT,1860,36,15-19,1896,0.04658584370942231
STAT,1826,37,20-24,1863,0.8910882046395688
STAT,1922,24,na,1946,4204.13638915949
SIM,1827,70,na,1897,725
STAT,1868,53,30-34,1921,0.005653684438916001
SIM,1929,31,45-49,1960,5
STAT,1931,31,35-39,1962,12.10880719054193
STAT,1893,28,20-24,1921,14.991941685005541
SIM,1891,41,35-39,1932,2
SIM,1856,29,20-24,1885,10
SIM,1827,30,na,1857,1664
STAT,1809,48,na,1857,1442.1950530687031
STAT,1854,25,35-39,1879,8.463226092594045
STAT,1908,22,45-49,1930,1.0441895939073897
STAT,1857,51,35-39,1908,0.006818510723810872
SIM,1906,48,50-100,1954,2
SIM,1845,22,30-34,1867,29
SIM,1870,36,25-29,1906,4
STAT,1866,76,na,1942,886.0427567490387
STAT,1948,19,15-19,1967,52.43097244490205
STAT,1863,28,na,1891,2128.157649908675
STAT,1843,29,na,1872,1769.9365902159898
STAT,1899,36,20-24,1935,1.0736564319282111
STAT,1832,33,35-39,1865,8.917433848704006
STAT,1883,41,35-39,1924,1.7978546556388308
STAT,1943,23,na,1966,3921.73083610673
SIM,1916,22,45-49,1938,1
SIM,1858,39,50-100,1897,5
STAT,1831,44,45-49,1875,1.1274137205148766
SIM,1855,48,50-100,1903,2
SIM,1887,43,35-39,1930,4
SIM,1944,20,30-34,1964,3
SIM,1885,7,na,1892,2818
SIM,1849,73,na,1922,924
STAT,1851,34,15-19,1885,0.10992431251461088
STAT,1830,29,35-39,1859,9.705496839974789
STAT,1779,92,na,1871,12.767038545728898
STAT,1899,47,30-34,1946,0.07533554909976783
STAT,1910,37,35-39,1947,2.3338892203878006
STAT,1810,45,50-100,1855,0.9856510815024668
STAT,1878,28,25-29,1906,44.19501061164507
STAT,1882,17,35-39,1899,0.5368282549803967
STAT,1934,36,50-100,1970,0.5859624352525047
STAT,1869,23,20-24,1892,67.46011057948488
SIM,1888,75,na,1963,1782
SIM,1838,32,40-44,1870,4
SIM,1860,88,na,1948,110
STAT,1816,50,35-39,1866,0.02225112828365151
STAT,1852,25,na,1877,1938.6210722550425
STAT,1912,34,40-44,1946,3.8516838389891657
STAT,1846,52,40-44,1898,0.007946743051725312
SIM,1888,25,30-34,1913,38
SIM,1864,62,na,1926,1972
STAT,1848,29,20-24,1877,11.27099987595154
STAT,1934,23,25-29,1957,125.38673055330248
SIM,1886,23,30-34,1909,30
STAT,1932,37,50-100,1969,0.5700854796044215
STAT,1827,41,20-24,1868,0.17379881682321896
STAT,1908,57,na,1965,3206.6372316169154
STAT,1805,54,45-49,1859,0.05730386437561221
STAT,1897,23,40-44,1920,2.8128809533020127
STAT,1923,22,40-44,1945,3.9528914592443756
SIM,1860,27,20-24,1887,17
STAT,1788,66,na,1854,704.0000000000001
SIM,1843,63,na,1906,1650
STAT,1835,50,45-49,1885,0.011553450066988165
STAT,1875,13,na,1888,2689.241876879966
SIM,1929,31,na,1960,4657
STAT,1858,49,35-39,1907,0.10861790194057196
STAT,1831,26,na,1857,1810.5479039309994
STAT,1829,54,30-34,1883,0.0037531563491208933
STAT,1881,47,45-49,1928,0.22869028820250797
SIM,1847,47,na,1894,1686
SIM,1931,22,40-44,1953,4
SIM,1827,35,50-100,1862,1
STAT,1818,81,na,1899,278.60554159849823
STAT,1819,85,na,1904,139.35977931771245
STAT,1896,45,30-34,1941,0.07372803919958555
STAT,1851,34,45-49,1885,1.3460542569921559
STAT,1856,38,45-49,1894,1.5359924728920245
STAT,1909,15,20-24,1924,26.953390090264566
STAT,1847,21,50-100,1868,0.3770090118954795
STAT,1878,19,35-39,1897,0.5722115213024481
STAT,1862,15,50-100,1877,0.049522312294202536
SIM,1806,71,na,1877,721
STAT,1836,54,30-34,1890,0.0036519419151316733
SIM,1910,28,40-44,1938,7
STAT,1943,25,25-29,1968,70.84221327702183
STAT,1891,15,40-44,1906,0.22977893464028898
STAT,1894,32,20-24,1926,3.514882884823979
STAT,1843,88,na,1931,92.59335983354326
SIM,1879,23,30-34,1902,24
STAT,1838,58,na,1896,1323.8561157011047
STAT,1869,34,15-19,1903,0.13864118358455987
STAT,1820,54,40-44,1874,0.016511169813826488
SIM,1826,48,na,1874,1793
STAT,1822,89,na,1911,58.73790231414526
STAT,1880,15,35-39,1895,0.5847257050373299
SIM,1875,65,na,1940,1717
STAT,1859,19,25-29,1878,5.280689037446368
SIM,1796,92,na,1888,5
STAT,1932,3,na,1935,5427.654367630899
SIM,1918,30,30-34,1948,3
SIM,1928,16,35-39,1944,8
STAT,1888,45,35-39,1933,0.16855951356286572
STAT,1836,48,45-49,1884,0.15382192966600494
STAT,1872,40,20-24,1912,0.16288926210248317
STAT,1914,47,20-24,1961,0.011058099738088035
SIM,1896,64,na,1960,2387
STAT,1878,23,30-34,1901,18.617666348132445
STAT,1837,27,25-29,1864,37.04007477887555
STAT,1954,16,40-44,1970,1.7474369281676685
STAT,1827,52,30-34,1879,0.005894741459152307
STAT,1871,27,30-34,1898,25.26812781571809
SIM,1910,17,30-34,1927,4
STAT,1902,28,40-44,1930,4.260399120019364
STAT,1836,43,20-24,1879,0.11766693331387217
STAT,1857,42,45-49,1899,1.1782657081233034
STAT,1873,38,20-24,1911,0.7853647257621819
SIM,1832,24,40-44,1856,1
STAT,1902,17,30-34,1919,2.2748661921950863
SIM,1902,69,na,1971,2498
STAT,1872,45,45-49,1917,0.2420284305134741
SIM,1845,27,25-29,1872,62
STAT,1863,108,na,1971,0.027942292003795787
STAT,1898,44,50-100,1942,0.0990922874520911
STAT,1894,43,30-34,1937,0.10306277133205798
STAT,1846,16,40-44,1862,0.17539689222136176
SIM,1846,28,na,1874,1892
SIM,1857,30,40-44,1887,3
SIM,1905,40,na,1945,3540
SIM,1851,39,25-29,1890,2
SIM,1953,4,na,1957,4923
STAT,1831,41,35-39,1872,1.4183549749555775
STAT,1844,18,35-39,1862,0.5486032671967305
STAT,1939,28,15-19,1967,0.7161171617593616
SIM,1881,31,30-34,1912,23
STAT,1809,61,na,1870,1113.4825754711987
SIM,1908,32,20-24,1940,2
STAT,1871,1,na,1872,3523.025695290609
SIM,1951,17,40-44,1968,4
STAT,1850,29,15-19,1879,0.4029780901300866
STAT,1948,17,na,1965,4255.201651812013
SIM,1827,33,na,1860,1604
STAT,1805,71,na,1876,735.6225372479656
STAT,1828,35,40-44,1863,4.711722936674859
STAT,1943,17,40-44,1960,1.4976521523169972
STAT,1852,15,20-24,1867,16.45469560603331
SIM,1855,22,30-34,1877,21
STAT,1876,52,20-24,1928,7.654373990858755E-4
STAT,1926,7,na,1933,4953.18066913992
SIM,1838,36,45-49,1874,5
SIM,1887,43,50-100,1930,2
SIM,1897,29,20-24,1926,22
STAT,1861,15,30-34,1876,1.5558082692600328
SIM,1884,79,na,1963,866
SIM,1909,30,na,1939,3940
SIM,1876,37,50-100,1913,1
STAT,1897,27,45-49,1924,1.5034157141190905
SIM,1808,88,na,1896,40
STAT,1834,39,15-19,1873,0.04074322723712168
SIM,1814,40,30-34,1854,1
STAT,1819,35,30-34,1854,18.854775855049198
STAT,1863,49,50-100,1912,0.21519598491662797
STAT,1916,48,30-34,1964,0.09201673233769056
STAT,1827,98,na,1925,1.9317733218534479
SIM,1829,34,na,1863,1862
STAT,1873,33,na,1906,2433.055713637575
STAT,1889,29,20-24,1918,14.505858904874676
SIM,1880,89,na,1969,315
STAT,1873,31,30-34,1904,17.95022915676137
STAT,1864,48,15-19,1912,3.599739224441403E-4
STAT,1879,24,na,1903,2477.1556960946177
SIM,1934,31,na,1965,5303
STAT,1834,46,20-24,1880,0.00843605700603426
STAT,1841,22,na,1863,2025.5171404002272
SIM,1862,25,40-44,1887,5
SIM,1852,18,35-39,1870,2
STAT,1828,28,35-39,1856,15.505788124991993
STAT,1877,23,na,1900,2457.7637872578125
SIM,1853,25,30-34,1878,34
SIM,1838,70,na,1908,1134
SIM,1843,18,25-29,1861,11
STAT,1874,15,40-44,1889,0.19074449582564956
STAT,1843,11,na,1854,2067.0
SIM,1965,2,na,1967,5218
STAT,1836,47,25-29,1883,0.038027063637502655
SIM,1880,55,na,1935,1907
STAT,1834,44,50-100,1878,0.7392979884507128
STAT,1895,19,35-39,1914,0.7198460620999273
STAT,1861,48,na,1909,1864.5207446560366
SIM,1812,43,30-34,1855,1
SIM,1899,37,30-34,1936,1
STAT,1780,86,na,1866,60.14033025706949
STAT,1837,28,45-49,1865,0.9652259246365676
SIM,1845,28,45-49,1873,1
STAT,1771,112,na,1883,6.166305089948243E-4
STAT,1854,23,15-19,1877,2.8881769180625128
STAT,1766,114,na,1880,1.464786775861884E-4
STAT,1896,48,35-39,1944,0.10425228315668715
STAT,1845,25,30-34,1870,22.72126537781104
STAT,1900,27,30-34,1927,35.330486216952345
STAT,1911,6,na,1917,4033.1810577601523
SIM,1816,83,na,1899,139
SIM,1855,88,na,1943,117
STAT,1823,38,50-100,1861,2.0449954579543532
STAT,1918,45,30-34,1963,0.0962237499492824
SIM,1860,15,20-24,1875,19
STAT,1923,25,15-19,1948,0.8244879919069777
SIM,1892,74,na,1966,1814
SIM,1842,38,na,1880,1830
STAT,1835,93,na,1928,21.935054648016415
STAT,1820,40,20-24,1860,0.3209563048130044
STAT,1855,30,na,1885,1867.3080370176517
SIM,1842,16,na,1858,2250
STAT,1932,38,30-34,1970,2.4722167367795147
STAT,1854,25,40-44,1879,2.6274559621747713
STAT,1910,30,15-19,1940,0.1260145222419774
SIM,1797,71,na,1868,607
SIM,1881,2,na,1883,2787
STAT,1840,52,50-100,1892,0.010530481790028705
STAT,1917,27,40-44,1944,4.934014158050742
STAT,1856,20,15-19,1876,3.009981922311608
STAT,1823,47,15-19,1870,5.505595038790748E-4
SIM,1827,35,30-34,1862,10
STAT,1822,43,na,1865,1521.9848704719361
STAT,1947,22,35-39,1969,10.749248051062803
SIM,1853,40,50-100,1893,1
SIM,1917,25,25-29,1942,7
SIM,1921,7,na,1928,4549
STAT,1913,47,na,1960,3617.9323672014098
SIM,1834,80,na,1914,304
SIM,1933,22,15-19,1955,5
SIM,1922,12,na,1934,5142
STAT,1916,46,50-100,1962,0.23469682733945704
SIM,1935,30,25-29,1965,18
STAT,1886,26,30-34,1912,26.945956777636347
STAT,1792,71,na,1863,576.4307418197556
STAT,1866,41,40-44,1907,2.113114302960002
STAT,1919,24,40-44,1943,3.6941923789037676
SIM,1874,41,40-44,1915,7
SIM,1914,17,na,1931,4247
STAT,1825,44,15-19,1869,0.018918390884515225
STAT,1890,38,15-19,1928,0.06896001383672308
SIM,1826,85,na,1911,218
SIM,1833,32,50-100,1865,1
SIM,1841,17,20-24,1858,17
SIM,1877,29,35-39,1906,13
STAT,1812,42,50-100,1854,3.476149436474688
STAT,1841,15,45-49,1856,0.06375131401864458
SIM,1894,26,30-34,1920,2
STAT,1865,52,45-49,1917,0.013312910200999697
SIM,1917,28,50-100,1945,1
STAT,1859,20,na,1879,2009.0419275042411
SIM,1910,27,na,1937,3401
SIM,1916,18,na,1934,4171
SIM,1934,22,20-24,1956,163
SIM,1810,49,50-100,1859,3
STAT,1871,34,30-34,1905,17.36950811867081
STAT,1852,87,na,1939,133.6140875783882
SIM,1943,14,na,1957,4192
STAT,1847,22,30-34,1869,16.349513395312158
STAT,1849,30,40-44,1879,4.008682479794028
STAT,1943,15,15-19,1958,48.6192263880963
STAT,1956,12,na,1968,5250.916212639486
STAT,1858,28,50-100,1886,0.5151688702316762
SIM,1869,28,30-34,1897,33
STAT,1843,39,25-29,1882,2.020592678900748
STAT,1845,47,35-39,1892,0.10181913691674307
STAT,1885,74,na,1959,1242.1866156208523
STAT,1925,22,15-19,1947,6.439445388381393
SIM,1898,53,na,1951,2884
STAT,1851,33,45-49,1884,1.3601041326827692
STAT,1930,19,na,1949,4783.884609752683
SIM,1840,30,30-34,1870,21
SIM,1864,20,15-19,1884,5
STAT,1885,19,35-39,1904,0.5486796801813147
STAT,1892,35,15-19,1927,0.0718450246888769
STAT,1945,25,35-39,1970,16.648861887432872
SIM,1826,28,35-39,1854,9
SIM,1859,39,50-100,1898,1
STAT,1826,33,na,1859,1586.8376472798338
STAT,1808,49,15-19,1857,0.0013850140907760292
SIM,1927,24,40-44,1951,8
STAT,1860,36,20-24,1896,0.639496501370595
SIM,1930,41,na,1971,5238
SIM,1843,25,30-34,1868,31
SIM,1882,45,50-100,1927,2
STAT,1784,76,na,1860,308.612326660253
STAT,1839,83,na,1922,281.45300953904064
SIM,1817,49,na,1866,1491
STAT,1877,48,25-29,1925,0.059289132942058835
STAT,1899,24,45-49,1923,0.9605425499275336
SIM,1872,37,35-39,1909,12
STAT,1860,82,na,1942,385.22284573936395
STAT,1927,30,25-29,1957,11.504697018122556
STAT,1835,25,30-34,1860,24.99991428179257
SIM,1919,27,50-100,1946,1
SIM,1936,19,40-44,1955,5
STAT,1860,60,na,1920,1574.6181878394123
SIM,1856,25,40-44,1881,2
SIM,1884,19,25-29,1903,11
SIM,1880,42,35-39,1922,3
STAT,1820,60,na,1880,1036.9337550146936
STAT,1925,46,15-19,1971,4.5223610743445886E-4
STAT,1832,30,30-34,1862,15.877574981935625
SIM,1833,55,na,1888,1506
SIM,1879,15,na,1894,2946
STAT,1892,34,45-49,1926,2.1911620976646513
SIM,1877,36,40-44,1913,7
STAT,1896,12,na,1908,3452.6112020457563
STAT,1880,18,45-49,1898,0.06910673143272798
SIM,1852,44,25-29,1896,1
STAT,1880,27,35-39,1907,10.234719685576378
STAT,1830,36,35-39,1866,6.5214138885886594
STAT,1850,41,45-49,1891,1.1511834311207658
STAT,1875,47,20-24,1922,0.01238858357259721
STAT,1777,107,na,1884,0.006107714548031183
SIM,1927,35,35-39,1962,7
STAT,1849,31,50-100,1880,0.8381908413337026
STAT,1879,52,30-34,1931,0.006240586463326618
STAT,1912,35,40-44,1947,1.4880809079615842
STAT,1858,47,20-24,1905,0.00946430959135211
STAT,1926,22,20-24,1948,136.5288528171506
STAT,1898,16,40-44,1914,0.2510475376160523
STAT,1914,35,45-49,1949,0.693266538918204
SIM,1867,29,35-39,1896,12
SIM,1919,19,40-44,1938,6
STAT,1885,58,na,1943,1988.1533529054223
STAT,1920,40,25-29,1960,0.07986375748145645
STAT,1816,55,na,1871,1328.8863628981496
SIM,1875,42,50-100,1917,1
STAT,1863,18,45-49,1881,0.06034338238349243
SIM,1821,36,35-39,1857,13
SIM,1929,22,25-29,1951,124
STAT,1825,43,45-49,1868,2.097414447696467
STAT,1869,36,40-44,1905,4.319215090420417
SIM,1946,22,25-29,1968,113
STAT,1827,80,na,1907,367.85367410817247
STAT,1842,63,na,1905,1606.4710991053937
STAT,1872,42,35-39,1914,1.8364743462546003
SIM,1893,16,30-34,1909,7
STAT,1924,17,15-19,1941,54.611876581036206
SIM,1898,31,40-44,1929,9
STAT,1844,44,25-29,1888,0.5071792099835024
STAT,1860,29,15-19,1889,0.3731852535320834
STAT,1860,37,50-100,1897,1.0136570312546416
STAT,1865,28,20-24,1893,10.781317080404833
STAT,1814,46,35-39,1860,0.3433900873773075
STAT,1868,80,na,1948,597.1253531467355
STAT,1897,21,15-19,1918,4.480559002446525
SIM,1892,2,na,1894,3663
STAT,1848,25,40-44,1873,2.9621511961872486
STAT,1907,17,15-19,1924,8.80229107759598
SIM,1905,58,na,1963,3159
STAT,1876,26,30-34,1902,26.350886451777374
STAT,1848,28,20-24,1876,11.352510904244015
STAT,1864,44,40-44,1908,2.022290526890145
SIM,1889,70,na,1959,1689
STAT,1824,39,15-19,1863,0.07330785848002329
STAT,1870,53,25-29,1923,0.0034565229292507975
STAT,1858,36,20-24,1894,0.6137501791721665
SIM,1868,20,15-19,1888,6
STAT,1787,104,na,1891,0.021721436867856513
STAT,1855,36,na,1891,1781.9285599457203
SIM,1862,23,15-19,1885,1
STAT,1919,35,35-39,1954,2.638261408597022
SIM,1836,22,20-24,1858,4
STAT,1881,37,35-39,1918,6.885952022983713
SIM,1830,90,na,1920,46
STAT,1821,36,25-29,1857,5.990744995946821
SIM,1872,44,40-44,1916,7
STAT,1843,46,50-100,1889,0.16700297143265325
STAT,1906,38,20-24,1944,0.24354958198305876
STAT,1871,18,35-39,1889,0.5508800302499228
STAT,1940,25,45-49,1965,1.780072554009661
SIM,1879,37,45-49,1916,5
STAT,1864,72,na,1936,1150.9862199131778
STAT,1908,46,15-19,1954,3.388288701680192E-4
STAT,1823,43,40-44,1866,3.2531746491159312
STAT,1901,22,na,1923,3348.571663320216
SIM,1901,37,40-44,1938,1
STAT,1885,45,25-29,1930,0.058484764914144394
SIM,1928,3,na,1931,5221
STAT,1919,22,15-19,1941,5.885378734280074
STAT,1844,107,na,1951,0.003731188101389687
STAT,1880,37,na,1917,2499.0097141901733
SIM,1884,45,na,1929,2341
STAT,1888,42,30-34,1930,1.368845580226991
STAT,1805,51,35-39,1856,0.036114767721311405
STAT,1866,45,15-19,1911,3.7782225781212645E-4
STAT,1869,48,35-39,1917,0.13574682080106443
STAT,1790,70,na,1860,567.67295038809
SIM,1858,39,35-39,1897,15
SIM,1917,43,na,1960,3736
STAT,1886,48,35-39,1934,0.14741912307287922
SIM,1877,26,30-34,1903,33
STAT,1873,27,50-100,1900,0.6549871581979488
STAT,1814,48,na,1862,1419.7025187977865
STAT,1870,31,20-24,1901,2.691817577980139
STAT,1901,35,50-100,1936,0.37876197390882793
STAT,1858,23,45-49,1881,0.5727715481170901
STAT,1815,95,na,1910,5.755351210746814
SIM,1922,35,45-49,1957,1
STAT,1818,54,25-29,1872,0.0058211216626378945
STAT,1890,34,40-44,1924,5.306382180454223
STAT,1923,38,20-24,1961,0.3083023841402476
STAT,1938,22,25-29,1960,92.28974420877286
SIM,1932,17,15-19,1949,88
SIM,1915,23,50-100,1938,5
STAT,1918,19,40-44,1937,1.528748914207584
SIM,1856,28,20-24,1884,7
SIM,1836,35,40-44,1871,9
STAT,1848,66,na,1914,1338.1836789505755
SIM,1888,21,15-19,1909,4
STAT,1841,51,45-49,1892,0.010904519817565518
SIM,1884,26,30-34,1910,30
STAT,1867,26,20-24,1893,11.19750914834954
STAT,1928,19,40-44,1947,1.771834708153566
STAT,1890,27,35-39,1917,11.908329522275988
STAT,1895,26,40-44,1921,3.96459799577787
STAT,1798,90,na,1888,36.97762149627647
STAT,1917,37,na,1954,3944.366487322001
STAT,1932,26,50-100,1958,1.318086129250021
SIM,1904,39,na,1943,3538
STAT,1811,106,na,1917,0.005293080310189768
STAT,1861,41,20-24,1902,0.13389171943382552
STAT,1838,51,30-34,1889,0.0040428616510285445
SIM,1835,68,na,1903,839
STAT,1796,61,na,1857,892.6504360313868
SIM,1831,43,40-44,1874,4
STAT,1854,18,35-39,1872,0.4897081871343495
SIM,1873,43,50-100,1916,1
STAT,1903,40,25-29,1943,0.06478995700092094
STAT,1884,37,20-24,1921,0.7677616395778158
SIM,1847,32,50-100,1879,5
STAT,1853,7,na,1860,2462.2535787484335
SIM,1876,18,20-24,1894,28
STAT,1840,36,35-39,1876,5.925346046217439
STAT,1868,18,20-24,1886,17.32041650579439
STAT,1824,51,45-49,1875,0.01669824218421399
SIM,1927,22,15-19,1949,6
STAT,1879,40,na,1919,2460.626885419366
STAT,1835,54,25-29,1889,0.002605059574535167
STAT,1857,15,40-44,1872,0.17146606241161377
STAT,1873,89,na,1962,210.2503366975667
STAT,1875,23,45-49,1898,0.7210392117970706
STAT,1897,43,na,1940,3117.6773330885876
STAT,1865,38,na,1903,2162.036927982035
STAT,1817,46,20-24,1863,0.02621791550301685
STAT,1913,27,40-44,1940,4.685941178592943
SIM,1766,91,na,1857,8
SIM,1868,36,30-34,1904,7
SIM,1863,42,35-39,1905,2
SIM,1892,37,20-24,1929,1
STAT,1839,38,20-24,1877,0.6463410204438157
STAT,1891,42,45-49,1933,1.8692117594873292
SIM,1853,28,35-39,1881,15
STAT,1867,55,na,1922,1966.8544759824915
SIM,1953,15,25-29,1968,64
SIM,1883,20,40-44,1903,3
STAT,1932,28,20-24,1960,24.150179354244173
STAT,1899,21,40-44,1920,2.8971960532565593
STAT,1861,18,35-39,1879,0.5261975902161348
STAT,1810,104,na,1914,0.03464134376788963
SIM,1886,19,35-39,1905,3
STAT,1908,48,40-44,1956,0.14353400024817833
SIM,1872,20,na,1892,2537
STAT,1846,53,na,1899,1607.7706866062497
STAT,1906,25,15-19,1931,0.6719715403189092
SIM,1852,15,30-34,1867,6
STAT,1836,54,50-100,1890,0.009265670785530767
SIM,1949,0,na,1949,4696
STAT,1851,30,40-44,1881,3.4894724617502866
STAT,1849,42,na,1891,1804.8247213399115
STAT,1869,29,35-39,1898,9.40712869399138
STAT,1850,39,na,1889,1794.9062973041061
STAT,1845,35,40-44,1880,3.770595887281449
SIM,1882,34,50-100,1916,1
SIM,1911,34,30-34,1945,23
STAT,1881,32,35-39,1913,9.859361649083366
STAT,1803,54,na,1857,1362.343588231985
STAT,1841,47,50-100,1888,0.18449586972055035
SIM,1825,60,na,1885,989
SIM,1940,28,20-24,1968,3
SIM,1890,33,na,1923,3196
STAT,1859,52,20-24,1911,5.962470521879015E-4
SIM,1908,35,25-29,1943,1
STAT,1902,57,na,1959,2953.9353568527176
STAT,1819,54,30-34,1873,0.010709505702660852
SIM,1894,23,na,1917,3344
SIM,1897,12,na,1909,3585
STAT,1814,41,35-39,1855,6.57207366270814
STAT,1823,36,35-39,1859,12.853324316752008
STAT,1925,41,15-19,1966,0.0018816850066151192
STAT,1859,15,15-19,1874,5.662500749215338
STAT,1856,23,50-100,1879,0.3641052721947709
STAT,1876,19,25-29,1895,5.877816288622055
STAT,1810,49,30-34,1859,0.3600374087700442
STAT,1845,28,35-39,1873,8.51990321254397
SIM,1859,94,na,1953,20
SIM,1814,66,na,1880,833
SIM,1949,17,25-29,1966,52
SIM,1874,77,na,1951,954
STAT,1873,22,40-44,1895,2.1336318101892133
SIM,1899,13,na,1912,3920
SIM,1926,19,40-44,1945,7
STAT,1845,52,na,1897,1564.914155387045
SIM,1860,35,na,1895,2110
STAT,1929,43,40-44,1972,0.3268824097292563
SIM,1831,36,35-39,1867,11
STAT,1851,46,20-24,1897,0.009112051429986352
STAT,1866,30,40-44,1896,4.088439932552877
STAT,1945,15,25-29,1960,47.83225930893973
SIM,1904,27,40-44,1931,6
STAT,1909,19,30-34,1928,2.399081261156222
SIM,1877,51,na,1928,2274
SIM,1934,37,na,1971,5365
SIM,1882,38,na,1920,2081
SIM,1930,25,na,1955,5068
SIM,1856,83,na,1939,196
STAT,1895,38,35-39,1933,9.28265290323268
STAT,1883,45,15-19,1928,3.9928965281573375E-4
STAT,1904,33,25-29,1937,8.48849897795644
STAT,1845,44,30-34,1889,0.8337942036242219
STAT,1828,47,50-100,1875,0.2237661421856723
STAT,1829,28,na,1857,1678.085448332678
STAT,1773,110,na,1883,0.0020671040480276523
SIM,1915,42,na,1957,4159
STAT,1822,49,na,1871,1420.321630097448
STAT,1866,44,45-49,1910,1.3808132315397006
STAT,1941,28,30-34,1969,40.902385122862725
STAT,1873,8,na,1881,2763.0341747951556
STAT,1923,44,15-19,1967,0.0018075138552438076
SIM,1912,33,25-29,1945,10
STAT,1828,47,35-39,1875,0.12755399023256123
STAT,1844,15,30-34,1859,1.6220551281832398
SIM,1874,44,45-49,1918,2
SIM,1917,19,30-34,1936,19
STAT,1935,10,na,1945,5489.208820602535
STAT,1817,39,15-19,1856,0.16394387000764332
SIM,1849,37,50-100,1886,1
STAT,1914,42,na,1956,3712.996335419762
SIM,1914,21,35-39,1935,15
STAT,1887,18,30-34,1905,1.7926114407997311
STAT,1889,26,40-44,1915,3.743460522706934
SIM,1842,32,na,1874,1913
STAT,1901,22,50-100,1923,0.577373084173457
STAT,1886,29,35-39,1915,10.2160084082872
SIM,1836,69,na,1905,1052
SIM,1875,26,20-24,1901,10
SIM,1827,38,35-39,1865,19
SIM,1828,27,30-34,1855,23
SIM,1845,23,15-19,1868,3
SIM,1932,27,50-100,1959,2
SIM,1933,36,na,1969,4894
STAT,1915,38,30-34,1953,1.8486235203639798
STAT,1825,49,15-19,1874,5.224208463869444E-4
STAT,1884,27,na,1911,2376.965220347686
STAT,1921,30,50-100,1951,0.9367446420040294
STAT,1806,96,na,1902,2.8950936691932707
STAT,1852,25,30-34,1877,22.566832180543077
STAT,1777,82,na,1859,118.28745986346226
STAT,1822,51,35-39,1873,0.012541491228380648
STAT,1903,34,30-34,1937,14.297161979879013
SIM,1832,79,na,1911,477
SIM,1838,41,50-100,1879,2
SIM,1866,20,40-44,1886,2
STAT,1837,23,15-19,1860,2.925114027003202
STAT,1843,36,20-24,1879,0.6132873484984517
STAT,1882,16,45-49,1898,0.06406507318154488
SIM,1860,25,30-34,1885,8
SIM,1943,9,na,1952,4231
STAT,1842,47,25-29,1889,0.05186794581647924
STAT,1910,37,50-100,1947,0.40512475839110396
STAT,1923,25,na,1948,4375.158308821444
STAT,1924,0,na,1924,5421.247065382221
SIM,1936,22,25-29,1958,155
SIM,1865,66,na,1931,1413
SIM,1918,47,na,1965,4148
STAT,1804,52,na,1856,1074.3836484082126
STAT,1885,16,30-34,1901,1.6063125471911506
STAT,1927,15,na,1942,4647.249483113425
STAT,1928,22,25-29,1950,116.56905417231421
STAT,1928,38,40-44,1966,1.9103096864787972
SIM,1917,22,20-24,1939,106
STAT,1841,109,na,1950,5.320399584012428E-4
STAT,1926,15,15-19,1941,56.4968079153905
STAT,1911,40,15-19,1951,0.0014954993616438188
STAT,1840,29,50-100,1869,0.5511098804401435
SIM,1864,23,50-100,1887,1
SIM,1864,36,50-100,1900,1
SIM,1877,23,20-24,1900,76
STAT,1842,44,15-19,1886,0.01253834589352908
STAT,1850,35,50-100,1885,0.9750266005518652
SIM,1862,37,35-39,1899,14
SIM,1859,72,na,1931,1154
STAT,1875,6,na,1881,2823.18493554668
SIM,1810,76,na,1886,464
STAT,1854,22,30-34,1876,15.706788165788424
SIM,1885,80,na,1965,816
STAT,1838,25,50-100,1863,0.5526321831254358
STAT,1864,50,na,1914,1990.5694937092867
STAT,1909,22,20-24,1931,104.28587282432353
STAT,1864,37,35-39,1901,6.446169916861653
STAT,1889,42,50-100,1931,1.3140792052248578
STAT,1837,57,na,1894,1370.9292274125307
STAT,1862,24,na,1886,2081.4945251827476
STAT,1825,38,na,1863,2064.7360944685834
STAT,1871,37,35-39,1908,7.09714062665071
STAT,1819,38,35-39,1857,18.624661964421456
STAT,1871,25,40-44,1896,3.026213814707839
SIM,1852,93,na,1945,3
SIM,1894,29,35-39,1923,14
STAT,1906,21,35-39,1927,8.610512680089661
SIM,1862,22,30-34,1884,26
SIM,1895,18,30-34,1913,1
STAT,1827,53,20-24,1880,7.164024649324559E-4
STAT,1867,19,50-100,1886,0.04708181464725455
STAT,1813,66,na,1879,854.2012959472111
STAT,1877,20,15-19,1897,3.459498487184843
STAT,1816,46,50-100,1862,0.6446512612279766
STAT,1948,9,na,1957,4542.925430057675
STAT,1871,15,30-34,1886,1.628786832872058
STAT,1912,16,na,1928,3949.9500157619464
SIM,1864,37,45-49,1901,2
SIM,1877,69,na,1946,1567
STAT,1890,25,50-100,1915,0.7948394022625636
SIM,1901,27,30-34,1928,68
STAT,1867,22,40-44,1889,1.9903303346633145
STAT,1910,49,35-39,1959,0.12065192876743636
STAT,1923,48,30-34,1971,0.10507551145602581
SIM,1858,29,25-29,1887,46
STAT,1814,104,na,1918,0.03121963806361574
SIM,1854,17,30-34,1871,2
STAT,1898,19,45-49,1917,0.08896049734730463
STAT,1881,84,na,1965,572.5118921116484
STAT,1812,81,na,1893,245.51306290594303
SIM,1820,35,na,1855,1563
STAT,1852,65,na,1917,1281.653961761204
STAT,1830,33,30-34,1863,16.490678086095123
STAT,1900,17,20-24,1917,24.873327305972115
SIM,1833,40,40-44,1873,6
STAT,1854,37,35-39,1891,5.308132523158214
STAT,1909,43,50-100,1952,0.11021764992526864
STAT,1939,18,na,1957,3718.280793906909
SIM,1900,43,na,1943,3359
SIM,1862,52,na,1914,1942
STAT,1899,48,20-24,1947,0.009264965405689954
STAT,1930,23,25-29,1953,119.23084624659981
STAT,1888,33,40-44,1921,5.148033630868691
STAT,1894,44,20-24,1938,0.014146922377952304
SIM,1934,15,15-19,1949,68
STAT,1915,28,50-100,1943,1.0208210025717936
STAT,1846,17,30-34,1863,1.5194559502982423
SIM,1868,39,35-39,1907,12
SIM,1922,32,40-44,1954,10
STAT,1828,32,30-34,1860,20.471374987788053
STAT,1862,37,25-29,1899,2.5112942345813156
STAT,1890,37,45-49,1927,2.460283204762687
STAT,1926,25,25-29,1951,80.2855782801848
STAT,1840,62,na,1902,1281.2169678390521
STAT,1838,54,40-44,1892,0.006853686065823144
STAT,1870,34,25-29,1904,10.071521567810727
STAT,1848,104,na,1952,0.054457811946426064
SIM,1887,10,na,1897,2862
SIM,1927,25,25-29,1952,122
STAT,1878,24,15-19,1902,3.4372243119714523
SIM,1927,21,na,1948,4846
SIM,1886,24,15-19,1910,5
STAT,1818,51,20-24,1869,0.0012874831361855388
STAT,1823,46,45-49,1869,0.32949089851010455
STAT,1874,49,na,1923,2278.1808992388555
SIM,1839,28,45-49,1867,1
STAT,1858,20,40-44,1878,1.9219994943002299
SIM,1875,22,40-44,1897,2
SIM,1889,76,na,1965,1203
SIM,1923,38,30-34,1961,4
STAT,1840,31,35-39,1871,8.736719999100293
SIM,1882,18,20-24,1900,17
SIM,1944,24,40-44,1968,10
SIM,1923,19,30-34,1942,26
SIM,1935,19,na,1954,4970
SIM,1896,23,30-34,1919,40
STAT,1895,23,30-34,1918,23.421153379940062
STAT,1936,24,40-44,1960,3.2431312416083333
STAT,1850,21,na,1871,1979.257196189309
SIM,1867,26,30-34,1893,30
STAT,1888,23,30-34,1911,21.16861702645598
STAT,1914,32,40-44,1946,3.974400970903487
STAT,1885,42,20-24,1927,0.15946416364758054
SIM,1934,25,25-29,1959,101
STAT,1907,44,50-100,1951,0.10734407010744679
SIM,1908,25,15-19,1933,5
STAT,1940,22,40-44,1962,3.457938632105573
STAT,1797,65,na,1862,820.3615867950745
SIM,1826,51,na,1877,1734
SIM,1920,20,50-100,1940,1
SIM,1921,11,na,1932,4529
STAT,1858,39,25-29,1897,2.2584755622871544
STAT,1915,19,30-34,1934,2.5603432875679255
STAT,1901,37,30-34,1938,1.628721046211593
STAT,1838,54,35-39,1892,0.005604649833107446
STAT,1838,107,na,1945,0.003156984315182924
SIM,1855,32,40-44,1887,4
STAT,1918,15,25-29,1933,9.598207716113995
SIM,1871,72,na,1943,1189
STAT,1853,43,20-24,1896,0.1303859179539303
STAT,1886,45,30-34,1931,0.10425596980308048
STAT,1844,41,20-24,1885,0.1303462420451496
SIM,1942,10,na,1952,4405
STAT,1902,29,30-34,1931,35.68424171676709
SIM,1819,38,45-49,1857,5
SIM,1829,32,30-34,1861,32
STAT,1794,100,na,1894,0.20645719906518678
STAT,1919,25,25-29,1944,72.29362512500427
STAT,1846,21,50-100,1867,0.3845996905491948
STAT,1871,20,na,1891,2387.3065722459864
STAT,1889,48,na,1937,2767.246590113836
SIM,1836,32,30-34,1868,26
SIM,1864,26,45-49,1890,2
STAT,1864,47,45-49,1911,0.2140846249246246
STAT,1904,64,na,1968,2812.914263348042
STAT,1952,15,25-29,1967,52.49663053442918
STAT,1902,16,40-44,1918,0.26169137304715373
SIM,1835,84,na,1919,135
STAT,1817,49,25-29,1866,0.11998129625845547
STAT,1934,38,40-44,1972,2.085232950638876
STAT,1857,18,45-49,1875,0.06016215237198787
STAT,1847,32,40-44,1879,3.8124624245916396
SIM,1868,55,na,1923,1915
SIM,1910,29,30-34,1939,62
STAT,1857,77,na,1934,681.3522082503292
SIM,1834,25,20-24,1859,18
SIM,1848,54,na,1902,1602
STAT,1833,50,40-44,1883,0.008015770688599228
SIM,1901,28,na,1929,3393
STAT,1829,52,35-39,1881,0.005647570458291271
SIM,1937,26,na,1963,3506
SIM,1811,52,na,1863,1446
SIM,1885,27,na,1912,2567
STAT,1904,28,45-49,1932,1.6036295080712344
STAT,1918,19,na,1937,4022.9464457766076
STAT,1955,1,na,1956,5280.781914218408
SIM,1902,46,50-100,1948,2
STAT,1800,96,na,1896,3.012077194330994
STAT,1825,40,40-44,1865,3.3772677804724065
STAT,1878,29,45-49,1907,1.155782547732905
SIM,1891,49,na,1940,2787
SIM,1901,10,na,1911,3778
STAT,1823,90,na,1913,43.60383618227836
STAT,1856,26,45-49,1882,0.8973502138325501
SIM,1929,32,35-39,1961,17
STAT,1883,48,25-29,1931,0.056214858559535855
SIM,1889,54,na,1943,2482
STAT,1892,31,40-44,1923,5.518725448403846
STAT,1893,16,20-24,1909,22.791643539906733
STAT,1896,43,35-39,1939,0.1668989142855564
STAT,1912,38,45-49,1950,0.6679576212842925
SIM,1893,78,na,1971,1517
SIM,1807,87,na,1894,109
SIM,1873,28,20-24,1901,12
STAT,1825,54,na,1879,1673.443251951614
SIM,1894,35,20-24,1929,1
SIM,1936,15,25-29,1951,68
STAT,1784,106,na,1890,0.011399294708630237
SIM,1934,19,30-34,1953,25
SIM,1888,24,40-44,1912,4
STAT,1852,31,na,1883,1893.34771701207
STAT,1869,33,30-34,1902,17.072367018214788
SIM,1945,15,35-39,1960,7
SIM,1943,3,na,1946,4289
STAT,1906,44,15-19,1950,0.0013917204269451222
STAT,1866,33,45-49,1899,1.6239970034625224
SIM,1887,44,na,1931,2458
SIM,1831,43,35-39,1874,1
STAT,1919,32,25-29,1951,10.068230219821336
SIM,1883,23,45-49,1906,6
STAT,1851,37,25-29,1888,2.203439219735651
STAT,1832,33,40-44,1865,3.8187153579076503
SIM,1872,25,35-39,1897,16
STAT,1888,31,15-19,1919,0.1704596222577599
STAT,1936,8,na,1944,3855.0278859006503
SIM,1870,35,35-39,1905,14
STAT,1864,25,35-39,1889,8.887903160969909
SIM,1820,54,na,1874,1266
SIM,1813,81,na,1894,251
STAT,1915,27,15-19,1942,0.7265759816681486
STAT,1856,38,20-24,1894,0.5939433080879869
STAT,1914,28,50-100,1942,1.00882602505897
STAT,1851,86,na,1937,168.00193803702368
SIM,1849,32,40-44,1881,6
SIM,1923,27,15-19,1950,1
SIM,1857,12,na,1869,2523
STAT,1880,50,20-24,1930,7.939668376005078E-4
STAT,1878,28,30-34,1906,26.309147624269542
STAT,1895,35,30-34,1930,7.09627808051298
STAT,1879,43,50-100,1922,1.1054564260673927
STAT,1954,18,50-100,1972,0.467782553009754
STAT,1840,46,na,1886,1610.8969036933815
STAT,1943,26,15-19,1969,0.7594967755220516
STAT,1845,38,50-100,1883,0.9328322456418565
STAT,1814,50,30-34,1864,0.014270669796949284
STAT,1844,17,20-24,1861,17.83013006940521
SIM,1840,21,40-44,1861,4
SIM,1868,33,20-24,1901,3
STAT,1873,27,35-39,1900,9.879630167264542
STAT,1874,34,na,1908,2446.768894965157
SIM,1877,33,30-34,1910,28
SIM,1886,28,30-34,1914,36
SIM,1779,80,na,1859,182
STAT,1905,45,45-49,1950,0.19631121386943318
STAT,1920,34,30-34,1954,17.277813681831834
SIM,1944,22,15-19,1966,6
STAT,1870,43,50-100,1913,1.0402076565129772
SIM,1875,59,na,1934,1954
STAT,1909,29,40-44,1938,4.462929694557603
SIM,1875,29,25-29,1904,46
SIM,1906,1,na,1907,3827
SIM,1840,33,40-44,1873,9
SIM,1923,15,15-19,1938,63
STAT,1901,21,15-19,1922,4.685049712864876
STAT,1910,33,25-29,1943,8.953318517674289
STAT,1902,19,45-49,1921,0.0927322168496156
SIM,1819,37,30-34,1856,4
SIM,1837,94,na,1931,14
STAT,1847,37,50-100,1884,0.953769484406208
STAT,1833,31,50-100,1864,0.8464154391091999
STAT,1925,34,50-100,1959,0.9909558883460631
STAT,1928,22,30-34,1950,36.27109464246923
SIM,1862,61,na,1923,1670
STAT,1862,49,na,1911,1921.3842891717347
SIM,1831,38,50-100,1869,1
SIM,1794,72,na,1866,557
STAT,1812,42,20-24,1854,0.522558421980424
STAT,1869,45,30-34,1914,0.0960012253179898
STAT,1783,97,na,1880,1.0012208558159061
SIM,1936,22,30-34,1958,58
STAT,1836,94,na,1930,12.60170141460616
STAT,1845,38,45-49,1883,1.5146403103662138
STAT,1849,67,na,1916,1239.4071490962046
SIM,1827,32,20-24,1859,5
STAT,1929,36,50-100,1965,0.5453108006384996
SIM,1884,29,35-39,1913,16
STAT,1838,35,35-39,1873,5.833152865496103
STAT,1835,21,15-19,1856,3.316468906371657
SIM,1868,52,na,1920,2009
SIM,1881,27,35-39,1908,11
STAT,1932,34,15-19,1966,0.17241295438565982
SIM,1918,34,40-44,1952,12
STAT,1888,45,40-44,1933,0.2061242046815297
STAT,1855,32,30-34,1887,13.3815658371683
STAT,1824,39,20-24,1863,1.0063168397970597
STAT,1837,27,30-34,1864,22.04983734328254
STAT,1919,44,25-29,1963,0.07787388675754758
STAT,1871,27,25-29,1898,42.44626974999043
STAT,1871,28,45-49,1899,1.1101833817982316
STAT,1889,29,45-49,1918,1.3728821805191955
STAT,1903,30,15-19,1933,0.20648762838562823
STAT,1926,11,na,1937,4917.071354998308
STAT,1870,50,20-24,1920,7.42376903408501E-4
STAT,1916,45,20-24,1961,0.011492670950931129
STAT,1847,48,15-19,1895,2.95731399647225E-4
SIM,1894,23,20-24,1917,102
SIM,1843,21,15-19,1864,4
STAT,1889,19,50-100,1908,0.060686994609638195
STAT,1923,21,35-39,1944,11.103062934994293
STAT,1886,23,20-24,1909,73.26072378962964
STAT,1937,15,35-39,1952,4.140263686908212
SIM,1917,29,40-44,1946,7
SIM,1845,27,30-34,1872,40
SIM,1937,32,25-29,1969,13
STAT,1815,49,15-19,1864,8.584351744355079E-4
SIM,1847,23,40-44,1870,5
STAT,1823,43,35-39,1866,2.619017809663977
STAT,1869,26,30-34,1895,24.812438778371487
STAT,1805,50,50-100,1855,0.06464677919074122
STAT,1868,54,20-24,1922,6.927188796318889E-4
SIM,1862,34,30-34,1896,25
STAT,1926,19,30-34,1945,15.022436732057056
SIM,1869,45,50-100,1914,1
SIM,1846,35,35-39,1881,16
SIM,1906,4,na,1910,3784
SIM,1922,9,na,1931,5173
SIM,1927,32,25-29,1959,11
STAT,1862,46,na,1908,1967.9282975461044
STAT,1882,63,na,1945,1745.6697184890197
STAT,1870,59,na,1929,1927.5048920598458
STAT,1857,54,45-49,1911,0.011124754103133109
SIM,1897,29,45-49,1926,2
SIM,1914,29,30-34,1943,71
STAT,1886,35,20-24,1921,0.8298347555123009
STAT,1899,25,50-100,1924,0.892726530357729
STAT,1825,32,50-100,1857,2.172853537657599
STAT,1917,36,15-19,1953,0.020230071479024062
SIM,1829,42,40-44,1871,6
SIM,1845,27,na,1872,2058
SIM,1863,32,30-34,1895,24
STAT,1838,47,35-39,1885,0.09641841432574874
STAT,1933,2,na,1935,5532.419059626287
SIM,1877,38,25-29,1915,5
STAT,1890,34,35-39,1924,12.391421626164204
STAT,1847,30,15-19,1877,0.12781950195865668
STAT,1903,21,50-100,1924,0.5883420416507558
STAT,1863,15,40-44,1878,0.18899184696781315
STAT,1869,38,25-29,1907,2.8132289413606286
STAT,1871,43,50-100,1914,1.052411694206736
STAT,1787,87,na,1874,48.46442917968207
STAT,1891,18,20-24,1909,22.111058723121428
SIM,1846,46,50-100,1892,3
STAT,1840,40,30-34,1880,0.9477954077760653
STAT,1819,44,20-24,1863,0.3192941088485132
STAT,1910,46,30-34,1956,0.08412266953800154
STAT,1939,23,45-49,1962,1.140387174196492
SIM,1807,72,na,1879,517
SIM,1834,21,40-44,1855,2
SIM,1966,4,na,1970,5082
STAT,1970,1,na,1971,4977.593183285551
SIM,1870,22,20-24,1892,77
SIM,1819,75,na,1894,506
STAT,1888,38,35-39,1926,8.389891014776117
SIM,1854,57,na,1911,1842
STAT,1841,27,20-24,1868,10.896426751848152
STAT,1857,96,na,1953,6.768384110875536
STAT,1839,23,40-44,1862,1.8846080985139528
SIM,1821,33,30-34,1854,18
SIM,1858,26,20-24,1884,9
STAT,1833,41,45-49,1874,1.3043745882613393
SIM,1853,22,20-24,1875,59
STAT,1884,73,na,1957,1248.3537045774904
SIM,1857,15,na,1872,2437
STAT,1893,19,25-29,1912,7.228274844636156
STAT,1799,75,na,1874,423.318590292465
STAT,1925,44,25-29,1969,0.08708164100539742
SIM,1843,28,35-39,1871,12
STAT,1882,44,na,1926,2230.673898159318
STAT,1800,62,na,1862,797.777673433952
STAT,1916,32,15-19,1948,0.13388798344417577
SIM,1857,31,na,1888,2159
STAT,1935,28,na,1963,5156.790934395752
STAT,1845,34,20-24,1879,2.3001203287123895
SIM,1779,83,na,1862,108
SIM,1832,54,na,1886,1277
STAT,1929,32,25-29,1961,11.86631985689615
SIM,1901,39,50-100,1940,1
STAT,1815,79,na,1894,302.6275543922358
STAT,1920,11,na,1931,4495.852694367155
SIM,1914,33,35-39,1947,2
STAT,1862,22,20-24,1884,61.530739508927574
SIM,1792,62,na,1854,815
STAT,1861,20,50-100,1881,0.3567111214589907
STAT,1865,29,na,1894,2185.2545283498625
STAT,1896,40,30-34,1936,0.10781051272943998
STAT,1879,36,35-39,1915,7.4907386138102465
SIM,1896,38,35-39,1934,20
SIM,1860,28,35-39,1888,9
SIM,1869,24,15-19,1893,4
STAT,1902,38,na,1940,3372.3153659369773
SIM,1867,28,20-24,1895,2
STAT,1841,39,15-19,1880,0.048459343291344686
STAT,1866,45,20-24,1911,0.011334677704723732
STAT,1900,23,15-19,1923,4.614265235795473
SIM,1853,34,20-24,1887,4
STAT,1821,34,35-39,1855,25.545234037982024
STAT,1850,29,20-24,1879,10.419861961245621
STAT,1871,22,30-34,1893,17.873276101212355
STAT,1886,59,na,1945,2072.49656354357
SIM,1882,1,na,1883,3092
STAT,1870,75,na,1945,1021.0083836608552
STAT,1850,50,35-39,1900,0.006686806457192146
SIM,1907,18,25-29,1925,10
STAT,1895,36,na,1931,3122.403911584769
STAT,1852,28,35-39,1880,8.461994646641141
STAT,1832,37,15-19,1869,0.04845741385613436
STAT,1842,43,45-49,1885,1.3763642578116317
SIM,1844,64,na,1908,1181
STAT,1836,32,20-24,1868,2.15540593448403
SIM,1850,43,45-49,1893,4
SIM,1903,23,40-44,1926,3
SIM,1906,59,na,1965,2925
SIM,1905,31,35-39,1936,1
STAT,1871,24,20-24,1895,68.71558324076472
STAT,1915,15,15-19,1930,9.629011956928846
STAT,1945,19,40-44,1964,1.5420136844316266
SIM,1864,16,na,1880,2805
SIM,1908,29,30-34,1937,49
STAT,1832,26,35-39,1858,8.961114822242838
STAT,1936,22,15-19,1958,5.1379218887518725
STAT,1793,75,na,1868,401.01923808652367
SIM,1891,3,na,1894,3429
STAT,1830,84,na,1914,219.4711544660778
STAT,1877,14,na,1891,2683.3524847655417
SIM,1881,22,40-44,1903,2
STAT,1837,25,40-44,1862,2.661058691462152
STAT,1883,44,45-49,1927,1.4592693374327796
STAT,1907,23,50-100,1930,0.6029771233357839
STAT,1897,39,20-24,1936,0.2230221637278257
STAT,1851,83,na,1934,300.5937068621373
SIM,1780,77,na,1857,405
STAT,1859,28,20-24,1887,9.624764720635842
STAT,1922,43,50-100,1965,0.1360074999484304
SIM,1887,36,35-39,1923,15
STAT,1850,17,20-24,1867,16.58841086911261
STAT,1892,35,20-24,1927,0.9862361239177934
SIM,1822,61,na,1883,1147
STAT,1856,15,na,1871,2126.717806376651
STAT,1864,44,35-39,1908,1.628075795954997
STAT,1807,51,45-49,1858,0.050266519318180096
STAT,1945,22,25-29,1967,102.23766631142766
SIM,1919,25,35-39,1944,21
STAT,1825,44,20-24,1869,0.21756148342124043
STAT,1932,15,15-19,1947,61.01216763986353
SIM,1883,60,na,1943,2102
STAT,1904,37,40-44,1941,1.3694768698004562
STAT,1871,23,na,1894,2365.8140012706585
STAT,1769,102,na,1871,0.06752921235711634
STAT,1919,29,40-44,1948,5.048612749363889
SIM,1866,42,na,1908,2371
STAT,1833,53,45-49,1886,0.010412383277184039
STAT,1813,69,na,1882,763.8008756239037
SIM,1814,43,40-44,1857,5
STAT,1883,20,50-100,1903,0.40545316651523267
SIM,1927,29,40-44,1956,1
SIM,1872,44,35-39,1916,4
SIM,1940,15,15-19,1955,57
SIM,1912,25,40-44,1937,7
SIM,1841,41,45-49,1882,2
STAT,1879,48,35-39,1927,0.14570587920584982
STAT,1902,25,15-19,1927,0.651944714338071
STAT,1934,1,na,1935,5707.47832189953
SIM,1845,25,40-44,1870,5
STAT,1921,25,40-44,1946,5.282180859439462
STAT,1926,14,na,1940,4893.850206219654
SIM,1940,26,50-100,1966,2
SIM,1877,66,na,1943,1700
SIM,1934,15,na,1949,5110
STAT,1845,22,20-24,1867,62.510493866494954
SIM,1856,67,na,1923,1315
SIM,1840,26,35-39,1866,12
STAT,1847,47,45-49,1894,0.175878145122401
SIM,1913,16,na,1929,3972
SIM,1882,81,na,1963,577
SIM,1945,21,na,1966,3945
STAT,1826,28,25-29,1854,104.65646585407714
STAT,1877,46,35-39,1923,0.1463536135142249
STAT,1896,3,na,1899,3534.3404882238115
STAT,1941,17,15-19,1958,47.194049593484316
STAT,1876,16,20-24,1892,18.533480882058882
STAT,1816,53,45-49,1869,0.035330954492671755
STAT,1931,35,45-49,1966,0.9140425911840377
SIM,1881,34,40-44,1915,3
STAT,1904,25,40-44,1929,4.371283024555571
SIM,1817,41,50-100,1858,1
STAT,1888,49,15-19,1937,2.633637855762245E-4
STAT,1935,19,40-44,1954,1.9215286686902129
STAT,1880,53,25-29,1933,0.003696726779390094
SIM,1786,68,na,1854,723
STAT,1825,32,na,1857,2124.390447681596
STAT,1901,34,20-24,1935,3.794379336623031
SIM,1843,17,na,1860,2625
STAT,1947,13,na,1960,4468.859429494031
SIM,1834,28,25-29,1862,45
SIM,1860,45,50-100,1905,3
STAT,1890,15,35-39,1905,0.6803416790733082
STAT,1873,34,40-44,1907,4.402388544168432
STAT,1832,36,45-49,1868,1.7386158199181203
SIM,1882,42,45-49,1924,4
STAT,1836,45,35-39,1881,0.09482578952540899
STAT,1930,27,40-44,1957,5.9902818167700715
SIM,1866,45,na,1911,2336
SIM,1831,24,35-39,1855,9
SIM,1893,28,50-100,1921,1
STAT,1857,51,40-44,1908,0.008338064523031619
SIM,1872,22,30-34,1894,25
STAT,1829,90,na,1919,46.48738740565131
STAT,1842,30,50-100,1872,1.017444938783221
STAT,1886,33,30-34,1919,18.54034856766116
STAT,1885,28,50-100,1913,0.6408431544452997
SIM,1829,50,na,1879,1581
STAT,1901,40,15-19,1941,0.0013714835929381824
SIM,1888,27,45-49,1915,1
STAT,1851,39,15-19,1890,0.04209160838062896
STAT,1830,53,50-100,1883,0.010891465515955198
STAT,1886,38,25-29,1924,3.0551267506028865
SIM,1887,43,40-44,1930,5
SIM,1944,20,25-29,1964,1
SIM,1843,15,20-24,1858,27
STAT,1854,37,50-100,1891,0.9214044467779462
SIM,1871,75,na,1946,908
STAT,1883,48,na,1931,2195.7375349982008
STAT,1886,37,na,1923,2512.3975605758724
STAT,1926,17,40-44,1943,1.7331809451964972
SIM,1934,17,40-44,1951,2
STAT,1852,18,25-29,1870,5.167170840107182
SIM,1888,29,na,1917,2904
SIM,1893,22,na,1915,3304
STAT,1851,34,20-24,1885,2.0864877997210183
STAT,1850,22,50-100,1872,0.3747797361851628
SIM,1909,44,40-44,1953,2
STAT,1869,35,20-24,1904,0.7641303753742599
STAT,1849,33,45-49,1882,1.4218553950023367
STAT,1890,31,30-34,1921,21.636158457363127
SIM,1866,26,na,1892,2372
STAT,1840,43,35-39,1883,1.3072694493563766
SIM,1862,28,45-49,1890,1
SIM,1862,37,50-100,1899,1
SIM,1894,38,25-29,1932,8
STAT,1935,25,na,1960,5163.758877012043
SIM,1868,24,30-34,1892,17
SIM,1949,21,20-24,1970,151
SIM,1816,41,50-100,1857,1
SIM,1908,31,50-100,1939,5
SIM,1855,82,na,1937,462
STAT,1819,47,25-29,1866,0.11225403342813464
STAT,1874,42,45-49,1916,1.545904088165505
STAT,1857,93,na,1950,23.03675086140203
SIM,1825,34,45-49,1859,2
STAT,1913,41,na,1954,3675.2940565088466
STAT,1814,53,35-39,1867,0.019433992885177574
STAT,1954,15,35-39,1969,5.243621386326046
STAT,1852,50,45-49,1902,0.011164260193168535
STAT,1860,39,25-29,1899,2.353216780256903
STAT,1932,36,na,1968,5113.027616142815
STAT,1878,26,40-44,1904,3.151491367333161
STAT,1920,44,40-44,1964,0.2780353227418665
STAT,1952,19,40-44,1971,1.6923834215690399
SIM,1892,25,45-49,1917,5
STAT,1823,31,40-44,1854,13.366568653058602
SIM,1835,65,na,1900,939
STAT,1872,85,na,1957,329.6306549679991
STAT,1936,20,25-29,1956,89.21624359495586
SIM,1937,29,na,1966,3695
STAT,1830,110,na,1940,1.8231123960282317E-4
STAT,1932,23,35-39,1955,12.44662372727912
STAT,1834,49,25-29,1883,0.035459301302003
STAT,1899,33,40-44,1932,5.985979747286837
STAT,1783,91,na,1874,19.021951294582564
STAT,1896,34,50-100,1930,1.2144605890662967
SIM,1831,40,30-34,1871,2
SIM,1940,23,35-39,1963,15
STAT,1874,18,45-49,1892,0.06737885840015212
SIM,1817,65,na,1882,1001
STAT,1890,22,40-44,1912,2.571755242329915
SIM,1819,35,40-44,1854,8
STAT,1864,22,30-34,1886,16.49494073028111
SIM,1844,42,na,1886,1568
SIM,1886,26,40-44,1912,8
STAT,1921,28,45-49,1949,1.9377974488456762
STAT,1921,43,50-100,1964,0.13342936845890666
SIM,1891,41,40-44,1932,8
SIM,1931,26,na,1957,4979
STAT,1942,22,15-19,1964,5.635236852067429
STAT,1881,44,35-39,1925,1.7391492879209096
STAT,1837,79,na,1916,476.9153253468279
STAT,1888,48,45-49,1936,0.15670421375450766
STAT,1911,37,50-100,1948,0.4091258323753159
SIM,1852,90,na,1942,27
SIM,1866,35,45-49,1901,6
STAT,1842,72,na,1914,1137.0281549594836
SIM,1901,39,30-34,1940,2
STAT,1875,96,na,1971,50.558283442860265
STAT,1934,20,50-100,1954,0.8964114969678213
SIM,1853,32,30-34,1885,26
SIM,1918,30,25-29,1948,3
STAT,1830,26,25-29,1856,49.2911321830757
STAT,1905,42,40-44,1947,0.22777803077439787
STAT,1855,35,35-39,1890,5.374497474842362
STAT,1900,29,20-24,1929,16.341718911153755
SIM,1849,39,25-29,1888,1
STAT,1862,35,35-39,1897,6.227734831488566
STAT,1906,33,35-39,1939,8.518310701125696
STAT,1928,40,na,1968,4798.8148808881915
SIM,1900,49,na,1949,3230
STAT,1814,91,na,1905,27.12306977941091
STAT,1823,40,30-34,1863,1.7923857350216077
STAT,1876,22,15-19,1898,3.4403639247325013
SIM,1847,53,na,1900,1533
STAT,1820,43,25-29,1863,1.1702675910632252
STAT,1881,81,na,1962,742.2926176638473
SIM,1890,30,na,1920,3215
STAT,1796,64,na,1860,798.1809298366693
SIM,1899,27,20-24,1926,22
STAT,1835,28,35-39,1863,9.374339257124975
STAT,1858,32,40-44,1890,3.4363559681694413
STAT,1934,36,15-19,1970,0.026800780051738887
STAT,1873,38,15-19,1911,0.057212007088132344
SIM,1830,29,45-49,1859,1
STAT,1849,45,na,1894,1776.5814389606016
SIM,1828,48,50-100,1876,2
SIM,1846,32,30-34,1878,15
SIM,1869,56,na,1925,1963
SIM,1888,39,20-24,1927,4
SIM,1943,11,na,1954,4203
STAT,1910,37,40-44,1947,1.4444677026824475
STAT,1838,32,30-34,1870,14.52353838793314
SIM,1890,48,na,1938,3045
STAT,1895,33,na,1928,3134.174608816456
SIM,1918,44,na,1962,4177
SIM,1866,32,40-44,1898,6
STAT,1895,16,30-34,1911,2.107418596612047
STAT,1774,109,na,1883,0.00205858409962936
STAT,1927,34,40-44,1961,4.859308921504845
SIM,1840,36,45-49,1876,2
SIM,1860,18,25-29,1878,12
SIM,1868,43,30-34,1911,1
STAT,1928,25,35-39,1953,18.822455069161776
SIM,1857,33,45-49,1890,1
STAT,1869,22,15-19,1891,3.2395046524890327
STAT,1847,19,na,1866,2119.8905355383067
STAT,1928,34,25-29,1962,11.66622919127996
STAT,1905,12,na,1917,3770.7127940875785
STAT,1919,48,40-44,1967,0.17218178556172747
SIM,1881,24,30-34,1905,23
STAT,1854,28,45-49,1882,0.8672640792017706
STAT,1879,43,40-44,1922,2.353610666951223
STAT,1892,22,na,1914,2997.4133821815403
SIM,1908,23,25-29,1931,87
SIM,1880,71,na,1951,1141
SIM,1893,59,na,1952,2593
STAT,1925,38,30-34,1963,2.208474982087677
STAT,1848,52,45-49,1900,0.011785705887809058
STAT,1935,9,na,1944,5498.3360584595775
STAT,1910,52,na,1962,3399.998879836911
SIM,1935,34,40-44,1969,6
SIM,1836,25,30-34,1861,31
SIM,1936,34,25-29,1970,12
SIM,1913,42,40-44,1955,4
SIM,1839,21,25-29,1860,2
SIM,1933,38,30-34,1971,5
SIM,1930,9,na,1939,5548
STAT,1837,42,na,1879,1692.4129486188858
STAT,1913,23,25-29,1936,93.82028172975892
STAT,1833,83,na,1916,280.8666154719875
STAT,1854,15,30-34,1869,1.4479200612739687
SIM,1871,17,30-34,1888,4
STAT,1859,26,na,1885,1986.383107770967
STAT,1880,24,30-34,1904,18.77539800174734
SIM,1829,44,30-34,1873,1
STAT,1906,48,30-34,1954,0.07931773583864726
SIM,1881,37,45-49,1918,5
STAT,1854,34,30-34,1888,13.142757761696007
STAT,1936,36,40-44,1972,1.4850399100374319
SIM,1841,29,20-24,1870,14
STAT,1834,68,na,1902,909.6267502284684
STAT,1880,15,40-44,1895,0.19490857963075087
STAT,1838,46,50-100,1884,0.17132643180907395
STAT,1832,24,50-100,1856,0.3868851764444378
SIM,1850,40,40-44,1890,5
STAT,1859,19,30-34,1878,1.485288907258165
SIM,1917,15,15-19,1932,11
STAT,1858,41,na,1899,1839.6820069063847
STAT,1888,35,30-34,1923,6.41379143728565
STAT,1843,24,45-49,1867,0.5819020578509768
STAT,1848,28,45-49,1876,1.0744389578578437
STAT,1839,26,45-49,1865,0.9988351082218193
STAT,1812,65,na,1877,912.3893313128449
SIM,1820,51,na,1871,1328
STAT,1931,32,40-44,1963,5.182350608650759
STAT,1901,44,30-34,1945,0.11150966657694884
SIM,1899,69,na,1968,2476
STAT,1873,37,45-49,1910,2.0411501146587434
STAT,1909,25,25-29,1934,64.44940542392422
STAT,1851,103,na,1954,0.10866782183258869
SIM,1851,24,45-49,1875,1
SIM,1855,44,40-44,1899,8
STAT,1906,29,30-34,1935,36.78041150448514
STAT,1875,20,40-44,1895,2.174258887486409
STAT,1904,45,50-100,1949,0.20280271688072923
SIM,1832,27,20-24,1859,14
SIM,1896,35,30-34,1931,11
SIM,1856,28,45-49,1884,1
STAT,1835,51,20-24,1886,5.759434241203264E-4
STAT,1892,38,25-29,1930,3.630935369454395
STAT,1904,21,25-29,1925,83.2233682942784
STAT,1929,30,35-39,1959,11.745734685440338
SIM,1863,35,35-39,1898,10
STAT,1854,52,50-100,1906,0.01127407167903254
SIM,1912,45,50-100,1957,5
STAT,1793,72,na,1865,532.9136253567702
STAT,1811,80,na,1891,269.6724986308338
STAT,1845,32,30-34,1877,15.168808583826978
STAT,1866,48,25-29,1914,0.05319252485952788
STAT,1869,81,na,1950,531.00829681007
STAT,1816,50,40-44,1866,0.02720995109554457
STAT,1827,64,na,1891,1033.7299770217273
STAT,1876,29,35-39,1905,9.990399664731916
STAT,1856,36,50-100,1892,0.9552737766114315
STAT,1895,11,na,1906,3411.3178129497483
SIM,1903,38,45-49,1941,1
SIM,1822,95,na,1917,2
SIM,1862,52,50-100,1914,1
SIM,1864,19,na,1883,2739
SIM,1948,19,25-29,1967,101
STAT,1862,25,25-29,1887,37.56973931120393
SIM,1847,26,45-49,1873,4
STAT,1769,87,na,1856,43.88275483
STAT,1902,23,na,1925,3365.1089884789126
STAT,1869,39,45-49,1908,1.9378196147524398
SIM,1870,25,25-29,1895,49
STAT,1870,46,25-29,1916,0.05728919643068161
STAT,1938,32,35-39,1970,9.276272413562914
STAT,1920,30,15-19,1950,0.14328350569857148
SIM,1841,50,na,1891,1515
SIM,1884,16,20-24,1900,27
SIM,1886,22,25-29,1908,84
STAT,1838,42,40-44,1880,1.7609081878009398
STAT,1909,15,15-19,1924,9.022533135101835
STAT,1841,106,na,1947,0.009079732265917972
SIM,1820,69,na,1889,777
SIM,1898,34,45-49,1932,4
SIM,1817,38,35-39,1855,11
STAT,1878,22,25-29,1900,60.01943469582867
SIM,1846,42,40-44,1888,6
SIM,1937,30,35-39,1967,16
STAT,1836,35,25-29,1871,2.276220303332232
SIM,1909,48,na,1957,3741
STAT,1837,21,25-29,1858,51.49422033730813
SIM,1879,92,na,1971,108
STAT,1885,18,20-24,1903,17.77646474853866
STAT,1887,84,na,1971,766.2285419095632
SIM,1901,33,25-29,1934,19
STAT,1781,87,na,1868,32.09003862234528
STAT,1891,77,na,1968,1486.4351927355083
STAT,1932,19,30-34,1951,16.22306572838831
SIM,1836,38,45-49,1874,1
SIM,1831,91,na,1922,18
STAT,1911,0,na,1911,4533.3679101583975
STAT,1844,27,na,1871,2095.2205126001104
STAT,1863,71,na,1934,1194.4994111079766
SIM,1858,36,30-34,1894,6
STAT,1825,47,25-29,1872,0.07734235203852938
SIM,1912,21,25-29,1933,105
STAT,1883,26,na,1909,2366.8658394087797
STAT,1913,19,20-24,1932,27.818046735428485
STAT,1832,23,30-34,1855,17.924302251047074
STAT,1888,19,50-100,1907,0.058090583359683416
STAT,1873,20,15-19,1893,3.3980567613005386
SIM,1858,93,na,1951,6
STAT,1883,41,40-44,1924,2.233178853132617
STAT,1884,25,45-49,1909,1.1133588537518129
STAT,1933,18,na,1951,4965.99078727207
SIM,1810,92,na,1902,55
STAT,1828,44,30-34,1872,1.0612458300530183
STAT,1865,16,45-49,1881,0.062448238752284335
STAT,1874,7,na,1881,2803.212395836042
STAT,1847,44,40-44,1891,1.661383702324579
STAT,1861,44,25-29,1905,0.5316748223670952
STAT,1864,32,40-44,1896,3.9524277991987358
STAT,1839,53,50-100,1892,0.010535520241922836
SIM,1844,79,na,1923,418
SIM,1893,18,20-24,1911,19
STAT,1842,40,40-44,1882,2.1495664913156953
SIM,1921,19,20-24,1940,118
STAT,1848,82,na,1930,380.94516690064637
STAT,1884,70,na,1954,1397.4548965213214
STAT,1846,52,35-39,1898,0.006498504847004659
STAT,1895,29,45-49,1924,1.4539824604293465
SIM,1840,23,30-34,1863,23
SIM,1844,35,25-29,1879,4
STAT,1845,37,25-29,1882,2.210432051874917
STAT,1914,26,na,1940,3823.358200887622
SIM,1859,78,na,1937,649
SIM,1921,23,25-29,1944,108
STAT,1949,8,na,1957,4617.751930044517
SIM,1862,15,30-34,1877,5
STAT,1868,104,na,1972,0.8375446694990595
SIM,1839,49,na,1888,1483
STAT,1928,15,25-29,1943,55.44763936271488
SIM,1819,72,na,1891,555
STAT,1828,38,45-49,1866,2.0079021260771754
STAT,1803,51,na,1854,1445.738720247361
STAT,1925,21,50-100,1946,0.7983791570737309
SIM,1943,15,25-29,1958,55
STAT,1865,5,na,1870,2626.0967064603524
SIM,1845,21,25-29,1866,59
STAT,1834,22,45-49,1856,0.5556338288783647
STAT,1878,36,50-100,1914,1.2934282809191076
STAT,1879,33,30-34,1912,18.324880331152734
STAT,1830,87,na,1917,116.2334784854182
SIM,1919,22,30-34,1941,42
SIM,1887,33,30-34,1920,27
STAT,1824,50,na,1874,1242.2728908536455
SIM,1842,22,45-49,1864,5
STAT,1898,25,na,1923,3289.817345647921
SIM,1940,19,30-34,1959,17
SIM,1836,44,30-34,1880,3
STAT,1864,41,30-34,1905,1.0525338976466643
STAT,1867,29,25-29,1896,39.95045013661521
SIM,1872,41,30-34,1913,1
STAT,1935,15,25-29,1950,60.13214898453061
SIM,1878,30,na,1908,2746
SIM,1881,34,na,1915,2089
STAT,1863,17,30-34,1880,1.6275851996323987
STAT,1819,42,30-34,1861,2.46757761716522
STAT,1852,53,50-100,1905,0.011269900496290189
SIM,1872,35,45-49,1907,2
SIM,1894,33,30-34,1927,5
STAT,1910,27,30-34,1937,38.17372929981566
STAT,1949,20,35-39,1969,11.107612155704622
STAT,1844,53,20-24,1897,5.744561391010228E-4
SIM,1876,17,15-19,1893,8
SIM,1947,19,na,1966,4519
SIM,1846,90,na,1936,13
SIM,1806,62,na,1868,1018
STAT,1927,39,40-44,1966,1.8771996499739314
STAT,1862,40,20-24,1902,0.13991766708379927
SIM,1919,34,25-29,1953,10
SIM,1939,31,45-49,1970,5
SIM,1825,69,na,1894,713
STAT,1844,67,na,1911,1254.1993010237127
SIM,1942,16,25-29,1958,58
STAT,1836,53,25-29,1889,0.00221652232810458
STAT,1901,38,50-100,1939,0.37333768132012835
SIM,1836,29,40-44,1865,2
SIM,1862,37,40-44,1899,8
STAT,1912,44,50-100,1956,0.11342886910848722
STAT,1934,16,25-29,1950,59.37191476752054
STAT,1889,79,na,1968,1292.0901699005306
STAT,1860,34,50-100,1894,0.7500000104737923
SIM,1881,30,25-29,1911,17
STAT,1871,69,na,1940,1472.5685604365938
STAT,1897,74,na,1971,1948.4343967817658
SIM,1940,19,25-29,1959,58
SIM,1829,59,na,1888,1349
STAT,1897,17,40-44,1914,0.24766149579567487
STAT,1829,103,na,1932,0.08462189725442376
STAT,1852,62,na,1914,1386.136577083105
SIM,1873,92,na,1965,110
STAT,1860,43,20-24,1903,0.1301730732952167
SIM,1928,12,na,1940,5119
SIM,1955,14,na,1969,5047
STAT,1840,24,35-39,1864,5.127592561187146
STAT,1932,20,30-34,1952,38.337355870778794
STAT,1945,19,35-39,1964,4.62604078545262
STAT,1859,40,15-19,1899,0.011331411729295304
SIM,1811,49,na,1860,1502
SIM,1937,18,40-44,1955,1
STAT,1838,50,25-29,1888,0.0024537885123015204
STAT,1868,17,15-19,1885,5.832288218824715
STAT,1911,29,35-39,1940,14.665881514005806
SIM,1891,18,na,1909,3327
STAT,1831,31,30-34,1862,14.625005998858224
SIM,1867,22,15-19,1889,2
STAT,1932,19,25-29,1951,57.67831761688469
SIM,1859,16,30-34,1875,2
SIM,1833,64,na,1897,1235
SIM,1838,26,40-44,1864,4
SIM,1879,18,na,1897,2926
STAT,1857,30,50-100,1887,0.7419333919046545
STAT,1859,22,15-19,1881,2.7805022329726987
STAT,1837,51,50-100,1888,0.01054757832879717
STAT,1913,26,35-39,1939,15.14555396858784
STAT,1839,106,na,1945,0.008608128723358262
SIM,1921,26,35-39,1947,1
STAT,1866,82,na,1948,436.3630864564117
STAT,1854,37,40-44,1891,3.2852570397434313
STAT,1929,36,40-44,1965,1.9442994364856767
STAT,1930,23,30-34,1953,37.09932571057306
STAT,1932,37,25-29,1969,1.3369156410135767
STAT,1798,81,na,1879,248.28650154968904
SIM,1846,32,25-29,1878,6
STAT,1911,47,35-39,1958,0.12314179999193728
SIM,1869,35,30-34,1904,8
STAT,1839,80,na,1919,438.56798788693357
STAT,1846,24,50-100,1870,0.37637475196790016
STAT,1955,4,na,1959,5274.183554705802
SIM,1874,46,na,1920,2180
STAT,1927,20,20-24,1947,139.2960686345704
STAT,1838,32,25-29,1870,8.520118267208389
STAT,1865,106,na,1971,0.1599920919003626
SIM,1862,19,40-44,1881,1
STAT,1906,30,30-34,1936,14.866906557601371
STAT,1936,26,30-34,1962,37.87431652198354
SIM,1822,34,35-39,1856,12
STAT,1887,44,na,1931,2571.0805318121998
STAT,1855,26,50-100,1881,0.5055233142961691
STAT,1911,9,na,1920,4005.816912431178
STAT,1929,34,45-49,1963,2.0176574425656764
STAT,1883,49,30-34,1932,0.09367673789598477
STAT,1847,16,na,1863,2157.7946323261554
STAT,1932,0,na,1932,6028.58560739487
SIM,1871,24,30-34,1895,21
STAT,1793,101,na,1894,0.10298864444653014
STAT,1827,95,na,1922,7.906307724602563
STAT,1879,33,25-29,1912,10.75014528027017
STAT,1869,1,na,1870,3472.9712904927987
STAT,1894,20,15-19,1914,4.315433236472146
STAT,1809,70,na,1879,796.055235739189
STAT,1863,24,30-34,1887,16.025075086741364
STAT,1898,16,na,1914,3466.5751674546277
SIM,1899,18,25-29,1917,11
STAT,1926,4,na,1930,5001.339844598971
STAT,1904,33,30-34,1937,14.469639610140677
STAT,1772,88,na,1860,31.7494119475273
STAT,1856,52,na,1908,1658.421466296911
SIM,1859,1,na,1860,3208
STAT,1896,36,35-39,1932,9.501450618202089
STAT,1924,42,15-19,1966,0.0018458399344897453
SIM,1912,33,30-34,1945,18
STAT,1886,35,50-100,1921,1.321690454211003
STAT,1846,27,35-39,1873,8.858325235343354
SIM,1887,33,25-29,1920,15
STAT,1896,30,20-24,1926,3.64282459347112
SIM,1854,27,35-39,1881,12
STAT,1901,13,na,1914,3650.7972356551477
SIM,1905,43,na,1948,3515
SIM,1873,21,30-34,1894,20
STAT,1819,100,na,1919,0.5397009716217539
SIM,1830,26,40-44,1856,4
STAT,1885,30,45-49,1915,1.767222145686896
STAT,1902,36,30-34,1938,1.649740216537083
STAT,1904,15,30-34,1919,2.3209177979571396
SIM,1849,24,20-24,1873,87
STAT,1914,39,30-34,1953,1.8175295898872388
STAT,1916,18,30-34,1934,2.602905460266382
SIM,1940,20,30-34,1960,39
STAT,1918,15,30-34,1933,2.699668802539034
SIM,1914,26,50-100,1940,2
STAT,1894,39,35-39,1933,9.104604512552472
SIM,1811,44,30-34,1855,2
STAT,1848,57,na,1905,1640.7802065155672
STAT,1815,39,50-100,1854,3.68815360950188
SIM,1924,18,30-34,1942,22
STAT,1865,21,30-34,1886,16.74742150289764
STAT,1848,24,35-39,1872,5.718171781981045
SIM,1893,30,45-49,1923,1
SIM,1879,27,40-44,1906,4
SIM,1922,39,30-34,1961,3
STAT,1900,26,25-29,1926,59.553036692649414
STAT,1899,30,45-49,1929,2.4366321885089497
SIM,1937,34,45-49,1971,1
STAT,1922,45,15-19,1967,4.295296812669952E-4
STAT,1940,15,40-44,1955,1.4344986331155092
SIM,1910,36,30-34,1946,2
SIM,1912,15,30-34,1927,6
STAT,1844,48,35-39,1892,0.10937401208086975
SIM,1857,46,na,1903,1956
SIM,1922,23,45-49,1945,4
STAT,1950,19,15-19,1969,54.17893862738597
SIM,1858,21,35-39,1879,9
SIM,1816,44,50-100,1860,2
STAT,1872,32,30-34,1904,17.728961719526694
SIM,1859,36,50-100,1895,1
SIM,1936,35,na,1971,3850
STAT,1864,54,45-49,1918,0.012862709987313904
STAT,1840,26,50-100,1866,0.563153315592115
STAT,1846,48,50-100,1894,0.18404022909793566
SIM,1932,24,15-19,1956,6
STAT,1890,46,40-44,1936,0.11952260224387526
SIM,1916,30,50-100,1946,4
STAT,1877,54,25-29,1931,0.003590741651749164
STAT,1829,45,35-39,1874,0.10720483357845886
STAT,1866,51,45-49,1917,0.013637421480224973
STAT,1912,41,40-44,1953,0.2447859902075063
STAT,1920,34,25-29,1954,10.135891959380004
STAT,1860,97,na,1957,5.990070952872768
STAT,1815,70,na,1885,715.8064674083921
SIM,1853,84,na,1937,211
SIM,1884,76,na,1960,1110
STAT,1870,35,30-34,1905,5.336012584340277
SIM,1813,41,30-34,1854,1
STAT,1864,22,25-29,1886,53.01189993052693
STAT,1923,44,20-24,1967,0.020786408212611823
STAT,1839,31,30-34,1870,15.39213140683981
STAT,1917,47,30-34,1964,0.0939875967403765
STAT,1786,96,na,1882,1.6454324287737203
STAT,1830,32,25-29,1862,9.83285595783645
SIM,1904,20,20-24,1924,6
STAT,1933,18,30-34,1951,16.44483792609824
SIM,1856,21,30-34,1877,29
STAT,1860,49,35-39,1909,0.11317433482610076
STAT,1919,47,35-39,1966,0.1411953855212337
STAT,1854,19,40-44,1873,0.16227461136621582
STAT,1801,100,na,1901,0.42251395895890687
SIM,1850,36,na,1886,1993
SIM,1889,30,25-29,1919,22
SIM,1828,37,35-39,1865,6
SIM,1916,26,25-29,1942,79
SIM,1826,82,na,1908,335
STAT,1792,96,na,1888,1.5582692840661652
STAT,1906,44,20-24,1950,0.016004784045436614
SIM,1849,79,na,1928,504
SIM,1909,33,na,1942,3890
SIM,1935,20,20-24,1955,208
STAT,1821,42,25-29,1863,1.023868394833949
STAT,1887,28,35-39,1915,10.842275433490704
SIM,1886,38,40-44,1924,16
SIM,1950,4,na,1954,4551
STAT,1921,46,50-100,1967,0.258160406118285
STAT,1940,31,45-49,1971,1.6450995395258587
SIM,1920,41,40-44,1961,1
STAT,1927,37,45-49,1964,0.856688458612843
SIM,1879,44,50-100,1923,3
STAT,1915,49,50-100,1964,0.22862801050031117
SIM,1770,93,na,1863,6
SIM,1941,18,30-34,1959,17
SIM,1945,24,25-29,1969,104
STAT,1919,29,35-39,1948,16.26194758996204
SIM,1927,29,35-39,1956,1
SIM,1905,23,45-49,1928,1
STAT,1937,24,25-29,1961,90.74644163270955
SIM,1895,28,35-39,1923,16
STAT,1878,38,40-44,1916,4.566849229665759
SIM,1841,99,na,1940,5
STAT,1803,85,na,1888,112.13302733730193
STAT,1877,54,na,1931,2182.7896057955586
STAT,1881,25,35-39,1906,9.457594483580339
STAT,1894,26,na,1920,3113.9302149258992
STAT,1883,54,na,1937,2069.6637930334045
STAT,1927,44,50-100,1971,0.1484246789888847
SIM,1870,56,na,1926,2244
STAT,1832,42,na,1874,1740.9005834026443
STAT,1860,107,na,1967,0.036395422447380275
SIM,1856,21,na,1877,2209
STAT,1839,19,45-49,1858,0.05987110918081069
SIM,1785,83,na,1868,92
STAT,1879,49,na,1928,2321.8201794383667
SIM,1861,38,35-39,1899,7
STAT,1853,38,35-39,1891,5.820128325344042
STAT,1854,97,na,1951,4.03179564659028
SIM,1815,39,na,1854,1557
SIM,1949,14,na,1963,4418
SIM,1901,30,20-24,1931,4
STAT,1871,33,25-29,1904,10.234305342658478
STAT,1914,25,40-44,1939,4.773001188230166
STAT,1895,38,40-44,1933,5.7451280021350355
STAT,1865,69,na,1934,1353.4506966606994
STAT,1890,44,45-49,1934,1.822162372126723
SIM,1926,17,na,1943,4363
SIM,1922,25,40-44,1947,11
STAT,1885,46,30-34,1931,0.09759299204247489
STAT,1914,41,45-49,1955,0.1666280163226984
SIM,1881,28,na,1909,2079
STAT,1895,37,50-100,1932,1.6193477383844221
STAT,1908,26,25-29,1934,63.56075507767986
SIM,1766,88,na,1854,29
STAT,1828,37,na,1865,1802.9561139750633
STAT,1828,47,40-44,1875,0.1559803076961092
SIM,1847,31,30-34,1878,27
STAT,1914,23,45-49,1937,1.1562344285228832
SIM,1872,22,25-29,1894,84
STAT,1932,34,20-24,1966,3.272592910614932
STAT,1824,75,na,1899,511.79791332791996
SIM,1910,32,50-100,1942,4
STAT,1923,31,45-49,1954,1.83013953899314
SIM,1948,1,na,1949,5152
STAT,1900,41,45-49,1941,0.1464743952569297
STAT,1884,49,20-24,1933,0.011702393086345976
SIM,1895,48,na,1943,3046
STAT,1855,32,25-29,1887,7.8501891541689615
SIM,1802,72,na,1874,559
STAT,1875,29,50-100,1904,0.658757971729953
SIM,1931,26,20-24,1957,2
STAT,1767,113,na,1880,3.783337123861117E-4
SIM,1827,64,na,1891,898
STAT,1903,34,25-29,1937,8.387316348143711
SIM,1925,32,50-100,1957,1
STAT,1851,49,na,1900,1667.9831063415543
STAT,1923,26,20-24,1949,21.247911670748316
SIM,1888,38,na,1926,2912
SIM,1911,34,25-29,1945,12
STAT,1872,53,50-100,1925,0.01508941702246187
SIM,1804,67,na,1871,919
SIM,1899,22,35-39,1921,9
STAT,1828,29,40-44,1857,4.159585556602602
SIM,1862,21,na,1883,2156
STAT,1889,22,30-34,1911,22.183313982195656
SIM,1931,31,45-49,1962,2
SIM,1925,16,25-29,1941,71
STAT,1903,48,na,1951,3196.131966868654
STAT,1840,77,na,1917,605.9282249499296
SIM,1791,83,na,1874,64
SIM,1845,37,40-44,1882,6
SIM,1897,22,30-34,1919,34
STAT,1880,54,30-34,1934,0.006140302774185465
STAT,1921,16,45-49,1937,0.5765051483449052
STAT,1831,24,50-100,1855,0.4443455235975611
STAT,1888,26,na,1914,2854.7655309784227
STAT,1898,18,50-100,1916,0.0669043600004798
STAT,1848,97,na,1945,4.386212596304794
STAT,1908,23,na,1931,3530.5493221358515
SIM,1902,29,35-39,1931,8
STAT,1811,45,50-100,1856,0.6322778171064197
SIM,1868,46,na,1914,2089
STAT,1928,19,35-39,1947,5.31550381669935
STAT,1945,16,30-34,1961,13.450321061505129
SIM,1908,29,50-100,1937,1
STAT,1948,20,na,1968,4238.595182181124
SIM,1844,23,30-34,1867,1
SIM,1847,44,na,1891,1697
SIM,1915,28,30-34,1943,62
SIM,1878,43,30-34,1921,4
STAT,1778,106,na,1884,0.014220846297089505
STAT,1930,10,na,1940,5193.205282371586
SIM,1919,31,20-24,1950,2
SIM,1863,32,25-29,1895,14
STAT,1904,18,35-39,1922,0.7932256396855346
SIM,1905,39,30-34,1944,2
STAT,1887,46,35-39,1933,0.15831865637883843
STAT,1851,40,45-49,1891,1.1446724514777702
STAT,1854,101,na,1955,0.4282453382630156
SIM,1821,39,na,1860,1404
SIM,1843,54,na,1897,1928
STAT,1819,53,25-29,1872,0.006500904170473564
STAT,1852,54,25-29,1906,0.0026123643850018098
STAT,1930,26,35-39,1956,19.30381862678429
STAT,1906,26,20-24,1932,17.31740434560965
STAT,1836,23,30-34,1859,14.723274164700056
STAT,1862,43,25-29,1905,0.5560563477579906
STAT,1850,104,na,1954,0.05107314289351501
SIM,1896,23,25-29,1919,100
STAT,1871,29,na,1900,2377.5798578693393
STAT,1836,50,20-24,1886,4.900430960453171E-4
STAT,1800,65,na,1865,713.3485847107754
STAT,1907,28,30-34,1935,37.21902165649835
SIM,1923,19,25-29,1942,89
STAT,1766,88,na,1854,21.0
STAT,1933,36,30-34,1969,2.5108583391902783
SIM,1819,44,30-34,1863,3
SIM,1939,29,30-34,1968,52
STAT,1888,23,25-29,1911,68.03229098083632
STAT,1813,75,na,1888,458.10753233290336
SIM,1857,21,45-49,1878,5
STAT,1910,30,20-24,1940,2.3918981818568215
STAT,1931,39,30-34,1970,2.434269720538289
STAT,1902,32,50-100,1934,1.3077206789946254
STAT,1918,41,na,1959,3992.25978747026
STAT,1834,53,20-24,1887,4.4177017280606305E-4
STAT,1859,29,na,1888,1943.9028888269324
STAT,1910,49,40-44,1959,0.14754007255250642
SIM,1827,35,25-29,1862,2
SIM,1891,58,na,1949,2461
SIM,1886,71,na,1957,1633
STAT,1915,19,25-29,1934,9.102859830629097
STAT,1906,47,50-100,1953,0.202854839654636
STAT,1886,26,25-29,1912,45.264744519127376
SIM,1888,32,30-34,1920,38
SIM,1932,29,15-19,1961,1
STAT,1825,50,45-49,1875,0.019540368178943692
SIM,1894,26,25-29,1920,10
STAT,1849,21,45-49,1870,0.6639337144998301
SIM,1914,26,20-24,1940,21
STAT,1788,91,na,1879,17.343432143920186
STAT,1924,29,15-19,1953,0.8246668379384675
STAT,1907,46,30-34,1953,0.08121902200565081
STAT,1904,19,50-100,1923,0.07062893951917215
STAT,1894,20,45-49,1914,0.9121621016971556
SIM,1885,36,50-100,1921,1
STAT,1836,32,na,1868,1727.2243234070386
SIM,1903,48,na,1951,2961
STAT,1879,89,na,1968,303.70930302331925
STAT,1911,26,30-34,1937,38.68303485946257
STAT,1875,54,20-24,1929,7.443353659984864E-4
SIM,1913,30,40-44,1943,4
STAT,1854,26,na,1880,1883.8147587430162
STAT,1870,53,30-34,1923,0.005808878867642728
STAT,1904,36,35-39,1940,2.223373231593068
STAT,1918,18,35-39,1936,4.5988934340281125
SIM,1898,22,45-49,1920,4
SIM,1910,39,35-39,1949,5
STAT,1926,31,50-100,1957,1.0109849775691473
SIM,1796,67,na,1863,883
SIM,1792,77,na,1869,266
SIM,1860,26,na,1886,2217
SIM,1822,92,na,1914,9
SIM,1905,2,na,1907,3992
STAT,1861,47,50-100,1908,0.2051662208883831
STAT,1924,27,50-100,1951,1.1710990618747275
STAT,1915,34,15-19,1949,0.13093118405779108
STAT,1838,67,na,1905,1061.1867892617183
SIM,1915,33,na,1948,4220
SIM,1921,21,35-39,1942,16
SIM,1836,47,50-100,1883,2
SIM,1907,18,30-34,1925,3
SIM,1885,18,na,1903,2751
STAT,1817,43,50-100,1860,2.4745673191229507
SIM,1868,36,25-29,1904,2
STAT,1902,39,35-39,1941,2.1569654984720485
STAT,1936,29,35-39,1965,14.49138400379062
STAT,1928,37,35-39,1965,3.089690939401621
SIM,1928,28,40-44,1956,9
STAT,1762,114,na,1876,1.9891878638435428E-4
STAT,1881,22,30-34,1903,17.341423567729297
STAT,1832,48,45-49,1880,0.18813022731078433
STAT,1872,70,na,1942,1424.7108531374631
SIM,1867,92,na,1959,50
STAT,1842,48,30-34,1890,0.08605732986849828
STAT,1905,49,30-34,1954,0.07806141765749519
STAT,1861,79,na,1940,586.7451372142577
STAT,1848,21,30-34,1869,17.835637865324756
STAT,1886,44,25-29,1930,0.6755483622941485
STAT,1896,33,25-29,1929,13.635768084427877
SIM,1945,21,20-24,1966,103
SIM,1864,44,50-100,1908,2
SIM,1869,31,na,1900,2297
STAT,1829,42,25-29,1871,0.49869507002411145
STAT,1911,44,30-34,1955,0.12159287653283547
SIM,1886,9,na,1895,2928
SIM,1936,19,35-39,1955,6
SIM,1926,18,35-39,1944,4
STAT,1896,21,na,1917,3171.4296276763657
SIM,1875,31,na,1906,2338
STAT,1941,27,25-29,1968,68.74222890495105
SIM,1899,15,20-24,1914,33
STAT,1856,44,50-100,1900,0.8070172979415555
SIM,1911,45,50-100,1956,2
STAT,1829,50,na,1879,1394.1222396758546
STAT,1902,20,15-19,1922,4.736659200208875
STAT,1913,21,35-39,1934,9.23368296056547
SIM,1904,26,35-39,1930,18
SIM,1953,16,30-34,1969,20
SIM,1829,32,25-29,1861,18
STAT,1867,21,35-39,1888,5.61401229272249
SIM,1837,42,25-29,1879,2
STAT,1888,41,25-29,1929,0.768986711164089
SIM,1918,37,45-49,1955,3
STAT,1859,40,45-49,1899,1.228041659944152
STAT,1908,30,50-100,1938,0.7941422804372751
SIM,1912,36,35-39,1948,6
STAT,1812,50,na,1862,1340.0293825685198
STAT,1827,48,35-39,1875,0.14170566242056934
STAT,1846,45,35-39,1891,0.10730308971776457
SIM,1890,4,na,1894,3549
STAT,1943,21,15-19,1964,5.720437545073351
SIM,1780,83,na,1863,160
STAT,1909,21,15-19,1930,5.007514202685283
STAT,1847,54,45-49,1901,0.010567174427461365
SIM,1898,28,na,1926,3179
SIM,1854,27,50-100,1881,1
STAT,1837,34,30-34,1871,14.627298483168538
STAT,1866,4,na,1870,2811.6887904695204
STAT,1828,31,25-29,1859,12.462940826246248
STAT,1922,31,25-29,1953,10.592995611141658
SIM,1856,24,35-39,1880,6
STAT,1840,21,25-29,1861,51.40052640672419
SIM,1853,25,25-29,1878,45
SIM,1911,31,20-24,1942,3
STAT,1829,42,30-34,1871,0.8928250410675979
STAT,1852,45,50-100,1897,0.18811800471867593
SIM,1876,30,45-49,1906,2
STAT,1822,41,30-34,1863,1.8746768984062292
STAT,1830,47,na,1877,1593.121908334722
SIM,1859,34,30-34,1893,6
SIM,1884,8,na,1892,2639
STAT,1920,19,35-39,1939,4.7286307062411135
SIM,1917,21,15-19,1938,7
STAT,1851,32,50-100,1883,0.7220901720346341
STAT,1920,51,na,1971,4048.743840283536
STAT,1845,25,25-29,1870,38.167962673030246
SIM,1918,23,25-29,1941,117
STAT,1941,24,15-19,1965,5.550088957316198
STAT,1889,8,na,1897,3237.4597893102987
STAT,1916,20,45-49,1936,1.1969363403731133
SIM,1880,86,na,1966,422
STAT,1882,69,na,1951,1435.7675005370297
SIM,1816,92,na,1908,21
SIM,1854,26,na,1880,2331
STAT,1819,60,na,1879,1083.1477841130895
STAT,1937,21,20-24,1958,109.35133337065116
SIM,1905,20,40-44,1925,4
STAT,1905,30,40-44,1935,6.382922736041558
STAT,1867,64,na,1931,1653.564633742638
SIM,1849,27,25-29,1876,60
SIM,1900,17,30-34,1917,3
SIM,1862,21,25-29,1883,69
SIM,1922,27,na,1949,4934
SIM,1850,33,50-100,1883,4
SIM,1909,30,20-24,1939,2
STAT,1824,47,na,1871,1289.8984323101872
SIM,1866,11,na,1877,2778
SIM,1914,30,30-34,1944,24
STAT,1907,38,na,1945,3504.5555305817047
SIM,1948,20,na,1968,4662
STAT,1877,51,20-24,1928,7.72904821649273E-4
SIM,1837,42,30-34,1879,3
SIM,1928,6,na,1934,5185
STAT,1841,20,50-100,1861,0.3919207335574351
STAT,1921,34,45-49,1955,1.7534779476341453
SIM,1878,43,25-29,1921,3
STAT,1829,59,na,1888,1166.553060724954
STAT,1877,21,20-24,1898,72.05286973722389
STAT,1765,94,na,1859,3.2962799319092535
SIM,1905,39,25-29,1944,1
SIM,1837,24,30-34,1861,22
STAT,1904,18,40-44,1922,0.26440856187078526
SIM,1813,72,na,1885,570
STAT,1923,29,30-34,1952,45.1284106592571
SIM,1931,29,30-34,1960,54
STAT,1910,21,50-100,1931,0.6253069137762002
STAT,1952,15,30-34,1967,14.765622904189014
STAT,1920,33,50-100,1953,0.9106701890599581
SIM,1920,28,40-44,1948,8
STAT,1819,35,25-29,1854,10.18591333704346
STAT,1811,53,25-29,1864,0.008268775590524613
SIM,1839,89,na,1928,25
SIM,1904,23,25-29,1927,97
STAT,1860,85,na,1945,226.33266587909657
SIM,1897,43,na,1940,3160
STAT,1892,41,45-49,1933,1.9053932325315062
SIM,1845,34,30-34,1879,32
STAT,1912,28,40-44,1940,4.6178189114926935
STAT,1854,21,25-29,1875,50.84397299349307
STAT,1896,33,30-34,1929,23.24376200097389
SIM,1808,57,na,1865,1071
STAT,1925,41,20-24,1966,0.021639376407312352
SIM,1774,83,na,1857,124
SIM,1863,5,na,1868,2741
SIM,1897,74,na,1971,1743
STAT,1867,17,25-29,1884,5.510520418991842
STAT,1845,43,25-29,1888,0.47172798769974705
STAT,1945,19,50-100,1964,0.4130392793176243
STAT,1825,60,na,1885,1486.015263240956
SIM,1874,86,na,1960,417
STAT,1856,16,40-44,1872,0.1684608146338135
SIM,1931,29,25-29,1960,74
STAT,1861,39,na,1900,1957.4239000843454
STAT,1917,31,15-19,1948,0.13638308859455262
SIM,1933,23,20-24,1956,167
STAT,1914,21,25-29,1935,91.64290168888876
STAT,1850,67,na,1917,1213.8231946561557
STAT,1837,52,30-34,1889,0.004075666389844769
STAT,1878,53,30-34,1931,0.006140773312262305
SIM,1820,37,35-39,1857,5
SIM,1897,25,35-39,1922,16
STAT,1911,41,20-24,1952,0.017103479418079572
STAT,1825,106,na,1931,0.0088605064122043
STAT,1873,30,25-29,1903,10.571800607372275
STAT,1889,25,35-39,1914,12.0982448255265
STAT,1901,37,25-29,1938,0.8798837787555729
SIM,1848,26,na,1874,2033
STAT,1798,100,na,1898,0.35323822014660233
STAT,1868,49,35-39,1917,0.13231908720063493
STAT,1849,29,50-100,1878,0.5843922555996656
SIM,1885,58,na,1943,2116
SIM,1836,31,25-29,1867,19
STAT,1923,29,25-29,1952,75.8082556096463
SIM,1856,52,na,1908,1971
STAT,1925,23,20-24,1948,134.09633402964639
STAT,1890,36,na,1926,2921.649435874193
STAT,1903,31,20-24,1934,3.9040048433927086
STAT,1919,26,30-34,1945,42.892852018782925
SIM,1837,54,na,1891,1262
SIM,1908,20,na,1928,3426
SIM,1903,26,45-49,1929,2
SIM,1875,17,25-29,1892,7
STAT,1878,35,30-34,1913,5.64088947599448
STAT,1880,42,50-100,1922,1.1192099774366575
SIM,1949,18,30-34,1967,17
STAT,1840,21,30-34,1861,15.993553102139067
SIM,1878,25,30-34,1903,43
STAT,1858,29,20-24,1887,9.379953558818283
STAT,1915,37,25-29,1952,1.0036598191415882
SIM,1923,28,50-100,1951,1
SIM,1905,48,50-100,1953,1
SIM,1872,11,na,1883,2889
STAT,1895,22,25-29,1917,75.50486508365795
SIM,1858,19,20-24,1877,1
SIM,1927,26,30-34,1953,79
STAT,1771,94,na,1865,3.1936206729494705
STAT,1868,49,na,1917,2126.406265743475
STAT,1881,22,25-29,1903,55.73235004947358
STAT,1919,44,30-34,1963,0.13941937733420803
STAT,1872,17,35-39,1889,0.5590034677239311
STAT,1865,97,na,1962,13.007477539280336
STAT,1873,49,45-49,1922,0.23659734403732818
STAT,1936,35,na,1971,3735.2365730814017
STAT,1831,53,50-100,1884,0.009730000753789048
SIM,1922,21,25-29,1943,157
STAT,1873,64,na,1937,1779.9218141887516
STAT,1868,5,na,1873,2715.626489740287
SIM,1916,27,na,1943,3826
STAT,1842,32,na,1874,2357.16170375124
SIM,1866,29,20-24,1895,14
SIM,1845,89,na,1934,88
STAT,1946,18,40-44,1964,1.5663849971989077
SIM,1930,31,25-29,1961,2
STAT,1807,75,na,1882,426.14023190776555
STAT,1931,20,40-44,1951,4.433640817371767
STAT,1794,91,na,1885,19.421338293983844
SIM,1839,80,na,1919,329
SIM,1936,32,35-39,1968,17
STAT,1860,46,25-29,1906,0.047691109863987245
STAT,1923,47,25-29,1970,0.06269857270915022
STAT,1908,1,na,1909,4075.8019934792214
STAT,1793,81,na,1874,202.0483865015482
SIM,1949,20,45-49,1969,1
SIM,1877,32,25-29,1909,14
SIM,1886,38,35-39,1924,14
SIM,1838,41,30-34,1879,1
STAT,1816,54,50-100,1870,0.036042220648591736
STAT,1905,35,40-44,1940,1.392667640955173
STAT,1868,30,45-49,1898,1.6968262156478489
SIM,1855,45,50-100,1900,2
STAT,1928,16,30-34,1944,15.561648779457371
STAT,1907,42,45-49,1949,0.1539617367895157
STAT,1870,44,na,1914,2261.319208138176
SIM,1821,39,45-49,1860,2
SIM,1786,77,na,1863,302
STAT,1868,19,35-39,1887,0.5329202337447645
STAT,1884,44,20-24,1928,0.15604189374558142
SIM,1870,28,na,1898,2589
SIM,1904,23,30-34,1927,28
STAT,1808,85,na,1893,103.3507350216683
STAT,1909,28,35-39,1937,14.427937713305779
STAT,1851,38,30-34,1889,4.03657362334615
STAT,1878,38,35-39,1916,7.378856701648537
STAT,1910,27,25-29,1937,64.12554278022759
SIM,1906,65,na,1971,2757
SIM,1900,35,30-34,1935,3
STAT,1904,16,45-49,1920,0.09491220189835632
SIM,1926,5,na,1931,4941
STAT,1930,24,45-49,1954,1.4477589903966614
SIM,1854,66,na,1920,1480
STAT,1832,45,40-44,1877,0.14182611820353938
STAT,1872,9,na,1881,2727.504914107749
STAT,1912,25,na,1937,3749.7888851357247
SIM,1917,28,35-39,1945,22
STAT,1941,13,na,1954,4090.277243392946
STAT,1857,62,na,1919,1440.6987071068786
STAT,1937,28,40-44,1965,4.5847078931043095
SIM,1883,54,na,1937,2267
SIM,1943,18,35-39,1961,5
SIM,1936,16,30-34,1952,16
STAT,1853,23,30-34,1876,17.279552588286922
SIM,1843,26,na,1869,2368
SIM,1861,23,30-34,1884,16
STAT,1875,90,na,1965,206.02600260786127
STAT,1911,31,50-100,1942,0.8155703364405322
SIM,1836,43,25-29,1879,3
STAT,1806,53,45-49,1859,0.041044776500515044
STAT,1941,24,20-24,1965,115.93443034223733
STAT,1841,20,30-34,1861,17.11909578517532
STAT,1852,51,20-24,1903,5.623097468148856E-4
STAT,1920,20,na,1940,4124.167352501278
STAT,1935,18,35-39,1953,5.780481997801941
STAT,1853,111,na,1964,3.9329002567207457E-4
SIM,1882,10,na,1892,2332
STAT,1873,44,45-49,1917,1.5117393508167545
STAT,1884,64,na,1948,1731.3962921341317
STAT,1910,21,na,1931,3626.571916400846
STAT,1924,46,30-34,1970,0.107511250728583
SIM,1868,24,25-29,1892,55
STAT,1840,37,na,1877,1775.7643418723808
SIM,1852,62,na,1914,1300
STAT,1924,10,na,1934,4782.42096872699
STAT,1827,33,30-34,1860,22.53405295825528
STAT,1872,47,35-39,1919,0.14149617210857451
STAT,1909,21,45-49,1930,1.0584486954393986
STAT,1909,28,50-100,1937,0.9565250683985576
SIM,1948,19,30-34,1967,26
STAT,1931,25,40-44,1956,6.086988397685077
SIM,1866,51,na,1917,2194
SIM,1909,33,25-29,1942,11
STAT,1838,95,na,1933,8.900385400654523
SIM,1782,78,na,1860,125
SIM,1881,44,45-49,1925,1
SIM,1893,17,15-19,1910,9
SIM,1900,29,30-34,1929,64
STAT,1859,26,30-34,1885,20.959737344100265
STAT,1934,31,15-19,1965,0.17738491593383682
SIM,1946,9,na,1955,4458
STAT,1825,69,na,1894,1070.952867337761
STAT,1906,23,50-100,1929,0.5980481928667555
SIM,1835,33,30-34,1868,33
STAT,1845,77,na,1922,631.5992781622762
STAT,1940,30,30-34,1970,16.480338137689138
STAT,1836,38,35-39,1874,5.420170372732007
SIM,1876,19,35-39,1895,2
SIM,1823,39,50-100,1862,1
STAT,1773,104,na,1877,0.03412942014864009
SIM,1837,85,na,1922,166
STAT,1861,45,30-34,1906,0.08205226645435416
STAT,1871,21,25-29,1892,57.615053846637956
SIM,1903,17,na,1920,3454
STAT,1919,45,45-49,1964,0.23913531207909733
STAT,1848,29,na,1877,2078.363580140733
SIM,1900,40,na,1940,3445
SIM,1870,25,na,1895,2635
SIM,1844,38,35-39,1882,7
STAT,1938,30,na,1968,3843.4672231106874
STAT,1860,46,30-34,1906,0.08014756040498473
STAT,1885,17,15-19,1902,5.96622777503465
SIM,1845,37,35-39,1882,14
STAT,1861,70,na,1931,1177.572283324583
STAT,1781,96,na,1877,0.8953105110481523
SIM,1937,20,na,1957,3461
STAT,1830,36,40-44,1866,4.03616917872642
STAT,1869,44,25-29,1913,0.6220600188583473
STAT,1871,15,25-29,1886,5.790871210747869
STAT,1902,32,15-19,1934,0.20325278453016438
STAT,1817,53,20-24,1870,0.0014893201932901436
STAT,1844,36,na,1880,1988.3272420760557
STAT,1915,39,15-19,1954,0.01937791501076661
STAT,1835,109,na,1944,5.339845535856499E-4
SIM,1880,35,35-39,1915,12
STAT,1923,33,35-39,1956,10.57852490477097
SIM,1928,21,20-24,1949,140
SIM,1885,20,45-49,1905,1
SIM,1904,61,na,1965,3151
SIM,1877,26,25-29,1903,59
SIM,1883,51,na,1934,2371
STAT,1933,32,15-19,1965,0.17499745641344996
STAT,1811,49,na,1860,1279.8864828978622
STAT,1820,85,na,1905,139.5405325935087
STAT,1869,32,25-29,1901,10.05781227620845
STAT,1934,31,na,1965,5220.663854611725
STAT,1870,31,15-19,1901,0.1418154454168271
SIM,1915,42,45-49,1957,1
SIM,1917,21,45-49,1938,1
STAT,1888,20,20-24,1908,82.64155097602328
SIM,1824,59,na,1883,1218
SIM,1896,20,20-24,1916,126
SIM,1813,44,35-39,1857,4
SIM,1901,33,50-100,1934,1
STAT,1924,28,30-34,1952,45.9387873449428
SIM,1932,28,30-34,1960,62
SIM,1844,67,na,1911,1056
SIM,1931,33,35-39,1964,19
STAT,1825,48,30-34,1873,0.12818949057330467
STAT,1894,24,30-34,1918,23.016943947948374
SIM,1834,20,35-39,1854,8
SIM,1882,13,na,1895,2310
STAT,1926,34,50-100,1960,1.0090956117996346
SIM,1875,21,35-39,1896,8
STAT,1857,65,na,1922,1332.1033700397552
SIM,1898,24,40-44,1922,2
SIM,1910,20,15-19,1930,4
STAT,1850,38,50-100,1888,0.9451215834741246
STAT,1892,39,30-34,1931,6.686613959636971
SIM,1876,72,na,1948,1295
STAT,1912,43,30-34,1955,0.12365369296927373
STAT,1881,52,50-100,1933,0.014625240863298545
SIM,1915,24,15-19,1939,8
SIM,1944,27,45-49,1971,2
STAT,1777,88,na,1865,33.23502027815632
STAT,1873,46,40-44,1919,0.17579100842103793
STAT,1822,44,35-39,1866,2.7441172896623263
STAT,1781,93,na,1874,3.9024403376109236
STAT,1896,9,na,1905,3468.81999499204
SIM,1875,28,na,1903,2409
SIM,1919,38,40-44,1957,3
SIM,1858,87,na,1945,110
STAT,1878,39,na,1917,2445.2746907285746
STAT,1858,113,na,1971,1.1404202090971252E-4
STAT,1811,50,20-24,1861,0.001829334640746137
STAT,1877,36,30-34,1913,5.582415932716841
SIM,1810,67,na,1877,946
STAT,1916,36,25-29,1952,1.0224357988318566
STAT,1819,50,50-100,1869,0.029427364484456993
SIM,1913,47,na,1960,3564
STAT,1837,37,35-39,1874,5.874826490798695
SIM,1862,92,na,1954,29
STAT,1832,70,na,1902,955.3871598857007
STAT,1925,38,25-29,1963,1.193084179176256
STAT,1856,31,30-34,1887,13.82824077252038
STAT,1872,35,35-39,1907,7.250200438687582
STAT,1833,52,na,1885,1569.762141818934
STAT,1834,37,na,1871,1585.7280961192264
SIM,1889,6,na,1895,3249
STAT,1931,23,45-49,1954,1.4703073763422951
SIM,1885,36,30-34,1921,11
SIM,1880,29,35-39,1909,13
SIM,1931,32,na,1963,4955
STAT,1936,27,45-49,1963,1.6691770250942195
SIM,1933,38,25-29,1971,1
STAT,1819,69,na,1888,774.3681702945767
SIM,1839,21,30-34,1860,2
SIM,1848,33,40-44,1881,5
STAT,1872,29,35-39,1901,9.727697309566336
SIM,1803,82,na,1885,157
SIM,1885,24,30-34,1909,20
STAT,1846,22,na,1868,2002.055425751562
STAT,1886,48,40-44,1934,0.18027252722767745
SIM,1949,6,na,1955,4424
STAT,1919,27,45-49,1946,1.8847344200065395
SIM,1925,32,na,1957,4495
STAT,1820,44,30-34,1864,2.023925390272982
STAT,1831,46,35-39,1877,0.10592366715184953
STAT,1856,24,na,1880,1895.3705727151307
STAT,1905,1,na,1906,3974.18799755535
STAT,1911,34,50-100,1945,0.8052967966580085
SIM,1847,84,na,1931,178
SIM,1830,44,35-39,1874,3
STAT,1853,53,25-29,1906,0.002882130700072942
STAT,1804,50,50-100,1854,0.042584870919171916
SIM,1912,31,40-44,1943,7
SIM,1851,46,50-100,1897,4
STAT,1907,24,15-19,1931,4.862572057921621
SIM,1967,3,na,1970,5079
STAT,1805,49,na,1854,1445.8625189854122
SIM,1871,66,na,1937,1481
SIM,1883,0,na,1883,3699
STAT,1880,23,25-29,1903,60.53339321451731
STAT,1889,40,25-29,1929,0.8078082925689088
STAT,1897,20,50-100,1917,0.5554667658640926
STAT,1928,31,na,1959,4782.719709209923
STAT,1907,42,15-19,1949,0.001420638962849791
STAT,1905,33,45-49,1938,1.455829124004847
SIM,1850,67,na,1917,1291
STAT,1877,24,30-34,1901,18.45170076889908
SIM,1864,31,30-34,1895,22
STAT,1846,9,na,1855,2322.57633
SIM,1849,11,na,1860,2464
STAT,1888,57,na,1945,2395.7045905137393
STAT,1916,48,25-29,1964,0.05475375755752854
STAT,1858,54,20-24,1912,5.686380773330962E-4
STAT,1888,0,na,1888,3570.5074626771047
SIM,1918,53,na,1971,4078
SIM,1927,27,na,1954,5192
SIM,1827,39,40-44,1866,7
SIM,1894,38,na,1932,3294
SIM,1924,36,25-29,1960,1
STAT,1922,17,40-44,1939,1.6353128073662688
STAT,1911,44,25-29,1955,0.06791674212505035
STAT,1842,49,15-19,1891,3.5261427788266394E-4
STAT,1845,47,40-44,1892,0.1245102585710537
SIM,1885,86,na,1971,473
STAT,1872,79,na,1951,709.8860739611739
STAT,1890,3,na,1893,3262.6788925528317
SIM,1910,35,50-100,1945,3
SIM,1923,8,na,1931,4770
STAT,1942,26,25-29,1968,69.78080029653763
SIM,1930,17,40-44,1947,3
STAT,1882,52,45-49,1934,0.014122600735529465
STAT,1936,29,40-44,1965,4.498931363093636
STAT,1905,17,40-44,1922,0.2670561337018495
SIM,1830,26,35-39,1856,8
STAT,1819,39,40-44,1858,10.569725099443495
STAT,1821,70,na,1891,840.4301241939712
STAT,1910,42,20-24,1952,0.016839170263823325
STAT,1831,34,35-39,1865,8.185505821103025
SIM,1883,29,50-100,1912,3
STAT,1939,15,na,1954,3728.6412060390558
STAT,1887,16,na,1903,2854.984229545911
SIM,1861,11,na,1872,2495
SIM,1821,79,na,1900,392
SIM,1864,87,na,1951,185
STAT,1952,18,35-39,1970,5.078927595404567
SIM,1923,34,20-24,1957,4
STAT,1843,46,25-29,1889,0.039166820385423295
STAT,1904,31,40-44,1935,6.311405864951847
SIM,1923,16,20-24,1939,145
SIM,1849,70,na,1919,1101
STAT,1823,34,na,1857,1580.6501591677707
STAT,1950,18,30-34,1968,14.556180009947692
STAT,1901,22,20-24,1923,97.57026715360207
SIM,1849,31,35-39,1880,14
STAT,1945,17,45-49,1962,0.5510882064666194
SIM,1838,29,45-49,1867,3
STAT,1866,23,40-44,1889,1.9506514628255744
STAT,1868,34,30-34,1902,16.70941114509503
STAT,1915,34,20-24,1949,2.48522198492983
STAT,1941,29,15-19,1970,0.736562843651333
SIM,1855,11,na,1866,2504
SIM,1818,56,na,1874,1104
STAT,1832,43,45-49,1875,1.2344283686721558
STAT,1865,43,50-100,1908,0.9672808309011177
SIM,1840,43,45-49,1883,4
SIM,1878,76,na,1954,1076
STAT,1799,66,na,1865,789.3327721221548
STAT,1910,58,na,1968,3280.5293524220683
SIM,1798,62,na,1860,916
STAT,1901,40,20-24,1941,0.01577206046692641
STAT,1881,90,na,1971,255.66366510086402
STAT,1893,3,na,1896,3390.315624347815
SIM,1889,79,na,1968,1016
STAT,1897,32,30-34,1929,23.64148400284285
STAT,1917,16,25-29,1933,9.436054885635404
SIM,1876,10,na,1886,3031
STAT,1890,64,na,1954,2145.413859465916
STAT,1915,16,20-24,1931,28.702441580149575
SIM,1876,34,30-34,1910,32
STAT,1862,28,35-39,1890,8.386367000881192
STAT,1893,16,na,1909,3246.896955364446
STAT,1926,45,na,1971,4602.92345600186
STAT,1812,52,25-29,1864,0.007819084903956572
SIM,1903,24,25-29,1927,115
STAT,1831,28,35-39,1859,8.252399000609357
SIM,1874,23,40-44,1897,2
STAT,1931,41,45-49,1972,0.22502921230469053
SIM,1870,28,35-39,1898,13
SIM,1893,53,na,1946,2720
SIM,1890,34,45-49,1924,1
STAT,1868,16,30-34,1884,1.5756851075192764
SIM,1921,23,30-34,1944,36
SIM,1855,41,30-34,1896,4
STAT,1922,35,40-44,1957,1.7237874705674912
STAT,1917,43,15-19,1960,0.0016151108267312665
STAT,1910,24,20-24,1934,104.69301045776004
SIM,1843,85,na,1928,307
STAT,1930,21,40-44,1951,4.366742143136034
SIM,1869,38,35-39,1907,9
STAT,1863,65,na,1928,1512.3301616923193
SIM,1859,18,20-24,1877,26
STAT,1870,84,na,1954,329.93144272446614
SIM,1872,51,na,1923,2417
STAT,1853,26,35-39,1879,9.31067248058223
STAT,1837,25,50-100,1862,0.568259949408014
STAT,1892,31,na,1923,3036.7204148924184
SIM,1803,57,na,1860,1001
SIM,1894,32,25-29,1926,17
STAT,1866,79,na,1945,653.8260022406412
STAT,1823,37,na,1860,1585.7583091792494
SIM,1849,29,20-24,1878,16
STAT,1887,13,na,1900,2907.642107367015
SIM,1832,100,na,1932,2
SIM,1870,25,30-34,1895,33
STAT,1839,77,na,1916,612.8305815050674
STAT,1880,27,40-44,1907,3.1774260742705454
SIM,1844,17,30-34,1861,3
SIM,1853,29,40-44,1882,2
STAT,1826,70,na,1896,769.8954148894139
STAT,1845,29,40-44,1874,2.6260602204943746
STAT,1833,29,15-19,1862,0.41854787816227756
SIM,1918,39,40-44,1957,2
STAT,1830,39,45-49,1869,1.7615992274060197
SIM,1861,26,35-39,1887,8
SIM,1864,25,na,1889,2519
SIM,1823,43,45-49,1866,2
SIM,1911,43,na,1954,3830
STAT,1849,23,40-44,1872,1.9556472963233913
SIM,1845,25,50-100,1870,1
STAT,1815,49,20-24,1864,0.02575307788633009
STAT,1887,21,15-19,1908,3.7313624780887262
STAT,1847,41,30-34,1888,0.8767612137627464
STAT,1851,35,50-100,1886,0.9593039643113854
STAT,1864,40,25-29,1904,0.5911591057817976
STAT,1819,41,25-29,1860,1.4256414533131516
STAT,1820,40,15-19,1860,0.0279092454041855
STAT,1890,6,na,1896,3224.069048918432
SIM,1830,59,na,1889,1079
STAT,1838,36,na,1874,1748.1350082247288
STAT,1834,77,na,1911,514.5108502787416
STAT,1879,30,20-24,1909,2.871924292631349
STAT,1875,50,na,1925,2265.3966868772127
SIM,1940,16,20-24,1956,137
STAT,1854,15,25-29,1869,5.1478305380887965
SIM,1878,79,na,1957,879
SIM,1917,25,30-34,1942,9
STAT,1866,26,45-49,1892,1.041955131286227
SIM,1885,20,15-19,1905,5
SIM,1899,38,na,1937,3573
SIM,1835,59,na,1894,1097
SIM,1814,97,na,1911,3
SIM,1919,32,35-39,1951,1
STAT,1884,47,25-29,1931,0.057101852975943064
SIM,1866,31,35-39,1897,16
SIM,1887,30,20-24,1917,5
STAT,1924,42,45-49,1966,0.2000428888557349
STAT,1901,25,25-29,1926,60.29911372268258
STAT,1932,16,20-24,1948,181.86686081549107
STAT,1812,90,na,1902,35.794488931285464
SIM,1862,15,25-29,1877,6
SIM,1821,36,40-44,1857,4
SIM,1943,20,na,1963,4171
STAT,1909,25,30-34,1934,38.366523689613956
STAT,1886,32,25-29,1918,10.922641554627576
SIM,1911,40,na,1951,3890
STAT,1855,47,35-39,1902,0.10488962700113334
STAT,1817,96,na,1913,3.9285875846223037
STAT,1841,39,20-24,1880,0.6652145378503403
SIM,1864,44,45-49,1908,5
SIM,1885,18,30-34,1903,1
SIM,1840,74,na,1914,792
SIM,1927,42,40-44,1969,1
SIM,1854,24,30-34,1878,24
SIM,1930,10,na,1940,5537
STAT,1923,30,30-34,1953,18.396067453010943
SIM,1943,15,30-34,1958,14
STAT,1861,41,15-19,1902,0.01164275884047249
STAT,1900,23,20-24,1923,96.38624095470706
STAT,1855,39,na,1894,1755.5447091744663
STAT,1827,36,35-39,1863,8.42430970737674
STAT,1868,30,15-19,1898,0.138569789622489
STAT,1850,36,na,1886,1851.69973469077
STAT,1905,4,na,1909,3841.0582325490686
STAT,1905,43,na,1948,3361.825995718917
SIM,1890,21,30-34,1911,29
STAT,1935,15,30-34,1950,16.913249998812443
STAT,1858,31,35-39,1889,8.10831007422749
STAT,1855,23,50-100,1878,0.35602177762441617
STAT,1916,38,50-100,1954,0.4317449763875319
SIM,1868,21,20-24,1889,4
STAT,1929,31,40-44,1960,5.0271130354531826
SIM,1816,52,na,1868,1212
SIM,1937,31,40-44,1968,3
STAT,1856,19,45-49,1875,0.059107703624634175
STAT,1836,35,30-34,1871,4.213429095254659
SIM,1880,32,30-34,1912,30
STAT,1894,27,35-39,1921,12.54684291134343
STAT,1913,23,30-34,1936,29.192690480038546
SIM,1948,21,45-49,1969,1
SIM,1909,15,25-29,1924,19
STAT,1879,49,50-100,1928,0.25345750757783225
SIM,1900,4,na,1904,3865
SIM,1918,20,20-24,1938,110
STAT,1869,48,40-44,1917,0.1659989690539175
STAT,1878,64,na,1942,1822.5901738407183
STAT,1899,28,50-100,1927,0.8835895711911738
STAT,1859,29,35-39,1888,7.85937449181282
STAT,1863,62,na,1925,1635.617893980582
SIM,1918,35,25-29,1953,1
SIM,1858,84,na,1942,192
STAT,1846,62,na,1908,1387.0375319432746
STAT,1919,42,40-44,1961,0.2736785340878741
STAT,1945,22,30-34,1967,31.811805432729646
STAT,1883,51,45-49,1934,0.014412282959911132
SIM,1876,16,30-34,1892,2
STAT,1846,20,15-19,1866,3.133912631038458
STAT,1911,42,35-39,1953,0.19389939723577881
SIM,1854,39,35-39,1893,20
STAT,1856,44,45-49,1900,1.143274508693404
STAT,1921,18,40-44,1939,1.6060411004711914
STAT,1882,32,na,1914,2334.641610298514
STAT,1840,101,na,1941,0.4000000944317528
STAT,1859,27,15-19,1886,0.3749204013248912
STAT,1824,78,na,1902,388.44019327148806
STAT,1917,31,na,1948,4013.927888160817
STAT,1846,24,30-34,1870,16.440047382989118
SIM,1893,13,na,1906,3388
SIM,1898,20,25-29,1918,7
SIM,1928,24,25-29,1952,145
STAT,1835,44,50-100,1879,0.9264044615973488
STAT,1853,50,20-24,1903,6.190114482482232E-4
STAT,1871,19,40-44,1890,0.182545126193062
STAT,1931,20,na,1951,4815.299740339887
STAT,1870,47,30-34,1917,0.0955575212294001
SIM,1844,35,30-34,1879,8
SIM,1835,36,35-39,1871,6
STAT,1924,24,15-19,1948,6.30755374922293
STAT,1830,78,na,1908,515.4762979469176
STAT,1905,31,25-29,1936,8.622364639198945
SIM,1839,58,na,1897,1302
STAT,1879,51,25-29,1930,0.0037511432868292524
STAT,1895,16,25-29,1911,7.4925640567687415
STAT,1901,43,25-29,1944,0.06268082167639828
STAT,1851,77,na,1928,654.5071821217635
STAT,1940,29,30-34,1969,40.29736573586393
SIM,1927,32,30-34,1959,21
SIM,1918,13,na,1931,4488
STAT,1811,103,na,1914,0.06256431667578329
SIM,1776,78,na,1854,212
SIM,1834,74,na,1908,682
SIM,1818,59,na,1877,1022
SIM,1839,18,na,1857,2022
STAT,1916,33,20-24,1949,2.5306209045512937
STAT,1916,46,na,1962,3812.133959571678
STAT,1845,31,25-29,1876,8.991543539565388
STAT,1856,20,50-100,1876,0.372062085145877
SIM,1775,93,na,1868,7
STAT,1854,33,25-29,1887,7.790570893632849
SIM,1907,20,45-49,1927,1
STAT,1911,43,na,1954,3554.747715254646
SIM,1797,77,na,1874,353
SIM,1924,33,20-24,1957,2
STAT,1807,49,25-29,1856,0.1988808580850937
STAT,1882,21,30-34,1903,17.479216297542617
SIM,1836,44,na,1880,1818
SIM,1935,23,25-29,1958,2
STAT,1893,40,15-19,1933,0.017889001586579446
STAT,1887,25,30-34,1912,28.58891679894954
STAT,1903,19,35-39,1922,0.7850378122565298
STAT,1898,15,35-39,1913,0.7547880070975711
SIM,1931,30,30-34,1961,30
STAT,1841,39,50-100,1880,1.0594973262314102
STAT,1877,39,35-39,1916,7.298772524480203
SIM,1864,20,50-100,1884,1
STAT,1881,28,na,1909,2315.2580918350573
STAT,1906,47,25-29,1953,0.04757507606546388
STAT,1829,46,40-44,1875,0.12940119336083916
SIM,1936,34,30-34,1970,28
SIM,1836,25,25-29,1861,44
STAT,1846,42,30-34,1888,0.8830279870503607
SIM,1862,33,25-29,1895,10
STAT,1887,75,na,1962,1389.0914652266572
STAT,1937,22,35-39,1959,9.256767698870151
STAT,1925,35,20-24,1960,0.3203018472569577
SIM,1871,27,35-39,1898,13
SIM,1887,13,na,1900,2842
SIM,1913,31,25-29,1944,13
STAT,1900,28,50-100,1928,0.8943363720056804
STAT,1910,45,25-29,1955,0.05016733384383814
SIM,1922,0,na,1922,5427
SIM,1841,39,25-29,1880,6
STAT,1925,37,50-100,1962,0.5092674524151586
SIM,1885,39,35-39,1924,14
SIM,1854,42,30-34,1896,4
SIM,1839,24,35-39,1863,9
STAT,1890,49,45-49,1939,0.16086562388674822
SIM,1867,36,na,1903,2123
SIM,1875,19,20-24,1894,25
STAT,1867,19,20-24,1886,17.037342752597326
SIM,1922,20,40-44,1942,3
STAT,1863,27,35-39,1890,8.634727329256755
STAT,1833,39,25-29,1872,2.503597029158752
STAT,1873,24,na,1897,2406.436288812113
SIM,1876,13,na,1889,2990
SIM,1841,104,na,1945,4
STAT,1868,37,35-39,1905,6.8274265382213395
STAT,1828,43,25-29,1871,0.6028566092586086
SIM,1902,17,35-39,1919,1
SIM,1931,35,na,1966,4942
STAT,1860,48,20-24,1908,0.009783030744294673
STAT,1928,5,na,1933,5120.8114263985
STAT,1787,81,na,1868,172.49076947803414
SIM,1903,28,40-44,1931,3
STAT,1931,21,25-29,1952,121.44243882359034
STAT,1834,110,na,1944,1.6448430799710902E-4
SIM,1859,28,30-34,1887,32
STAT,1928,34,30-34,1962,19.88645253365667
STAT,1898,56,na,1954,2792.6847781254646
SIM,1892,68,na,1960,2231
SIM,1823,34,na,1857,1660
SIM,1876,37,35-39,1913,16
SIM,1914,29,25-29,1943,100
SIM,1945,22,35-39,1967,15
STAT,1839,16,40-44,1855,0.170636570313753
SIM,1906,38,30-34,1944,1
STAT,1922,46,na,1968,4274.270442252047
SIM,1895,25,30-34,1920,55
STAT,1866,49,30-34,1915,0.08864030501854538
STAT,1914,20,40-44,1934,3.3457143440643637
SIM,1911,19,35-39,1930,2
STAT,1862,25,30-34,1887,22.365144935237176
STAT,1867,50,50-100,1917,0.014572512849835342
SIM,1858,17,25-29,1875,6
STAT,1927,23,25-29,1950,114.6715007391752
STAT,1895,34,25-29,1929,13.393955994184621
STAT,1842,50,45-49,1892,0.013253794861499192
STAT,1826,45,50-100,1871,0.24869223436034607
STAT,1935,33,50-100,1968,1.154967368773716
SIM,1866,5,na,1871,2875
STAT,1951,12,na,1963,4726.024658449268
STAT,1920,31,20-24,1951,2.7090218653721694
STAT,1933,8,na,1941,5395.203994195956
STAT,1829,81,na,1910,318.8552542366677
STAT,1843,43,20-24,1886,0.10888231129666405
SIM,1828,34,30-34,1862,20
STAT,1869,50,na,1919,2144.7049807634157
SIM,1852,16,15-19,1868,4
STAT,1890,30,25-29,1920,12.742631368279584
STAT,1858,87,na,1945,139.603289202195
STAT,1835,22,na,1857,2133.012971800523
STAT,1919,32,30-34,1951,17.162476330746365
STAT,1863,39,40-44,1902,3.8779557611283058
STAT,1844,16,15-19,1860,6.003923607097743
STAT,1867,24,na,1891,2235.6026589562466
STAT,1891,46,na,1937,2821.8890875668367
STAT,1857,54,50-100,1911,0.011577286454416273
STAT,1942,23,20-24,1965,117.67421826556082
STAT,1890,28,50-100,1918,0.7867043072301207
SIM,1770,90,na,1860,11
STAT,1941,30,45-49,1971,1.6698656778996754
STAT,1900,28,15-19,1928,0.634309068962812
STAT,1904,34,45-49,1938,1.4388815400861985
SIM,1944,25,25-29,1969,84
STAT,1814,85,na,1899,128.3114307510227
STAT,1875,28,na,1903,2466.630426220572
SIM,1863,36,40-44,1899,8
SIM,1912,34,45-49,1946,2
SIM,1860,66,na,1926,1366
STAT,1908,41,15-19,1949,0.0014425064701254877
STAT,1936,25,25-29,1961,63.649311613957764
STAT,1855,36,40-44,1891,3.31089680548711
STAT,1864,104,na,1968,0.4941050880361738
STAT,1856,21,na,1877,1936.7902122309733
STAT,1887,43,30-34,1930,1.2870536845849874
SIM,1871,39,40-44,1910,5
SIM,1853,31,25-29,1884,19
STAT,1906,29,25-29,1935,61.78499964939572
STAT,1870,13,na,1883,2614.6556141757032
SIM,1848,18,15-19,1866,6
STAT,1904,21,30-34,1925,25.8954032809145
SIM,1867,61,na,1928,1661
SIM,1867,44,30-34,1911,1
STAT,1841,49,30-34,1890,0.07087703229759201
STAT,1870,26,35-39,1896,9.602534447963633
STAT,1927,21,na,1948,4561.285293120899
STAT,1873,42,25-29,1915,0.6567012284510128
STAT,1925,20,na,1945,4443.930201160081
STAT,1872,14,na,1886,2648.3424807011893
SIM,1843,57,na,1900,1837
SIM,1910,24,30-34,1934,42
SIM,1926,27,30-34,1953,71
STAT,1767,110,na,1877,0.0015372989412685285
SIM,1879,41,50-100,1920,3
STAT,1894,32,15-19,1926,0.18517773491669076
STAT,1919,16,50-100,1935,0.08407540120330881
STAT,1890,19,45-49,1909,0.08018613646127787
STAT,1901,16,na,1917,3584.6806959690316
STAT,1845,12,na,1857,2204.669509439567
STAT,1928,17,45-49,1945,0.6362098190105113
SIM,1851,52,na,1903,1668
SIM,1894,63,na,1957,2584
STAT,1849,41,35-39,1890,1.4221961083403192
STAT,1900,38,25-29,1938,0.8675758359754834
STAT,1769,93,na,1862,5.336541803188611
SIM,1875,31,45-49,1906,1
STAT,1801,81,na,1882,227.19356176994643
STAT,1902,24,30-34,1926,25.2636093151259
STAT,1859,44,30-34,1903,0.9213102878415553
SIM,1831,28,45-49,1859,1
SIM,1850,33,na,1883,2011
STAT,1855,47,50-100,1902,0.1840063736661236
STAT,1889,42,na,1931,2874.860790541415
SIM,1888,69,na,1957,1992
STAT,1918,27,30-34,1945,42.09806982760784
STAT,1860,29,na,1889,1962.9938165534388
STAT,1812,59,na,1871,1121.3678890447134
STAT,1919,17,35-39,1936,4.681958912992967
SIM,1858,25,na,1883,1994
SIM,1870,59,na,1929,2126
SIM,1850,22,40-44,1872,3
STAT,1871,52,30-34,1923,0.005941135279368127
STAT,1958,13,na,1971,5210.378571834722
SIM,1854,15,35-39,1869,3
STAT,1827,41,15-19,1868,0.015112941409586442
STAT,1939,17,20-24,1956,137.0013617426239
STAT,1943,28,35-39,1971,16.137260942209043
STAT,1892,16,45-49,1908,0.08299171296988031
STAT,1881,19,35-39,1900,0.5313394397862637
STAT,1806,51,25-29,1857,0.010427580004854534
SIM,1890,47,50-100,1937,1
SIM,1839,30,50-100,1869,5
STAT,1880,52,40-44,1932,0.011107341786601376
STAT,1846,15,35-39,1861,0.529308271919881
STAT,1834,28,20-24,1862,9.095712984120954
SIM,1842,28,20-24,1870,14
SIM,1947,17,20-24,1964,171
STAT,1842,22,40-44,1864,2.3663469738601837
STAT,1832,49,20-24,1881,0.008594109035320423
STAT,1858,41,45-49,1899,1.1912835928878738
STAT,1782,75,na,1857,403.3417450538562
SIM,1837,20,15-19,1857,1
SIM,1855,44,35-39,1899,3
STAT,1807,72,na,1879,566.2968614172672
STAT,1847,44,35-39,1891,1.3375222588359983
SIM,1890,24,35-39,1914,13
STAT,1821,49,45-49,1870,0.3360315188445486
SIM,1825,30,35-39,1855,14
SIM,1920,23,na,1943,4673
STAT,1833,27,na,1860,2016.582612008639
STAT,1808,110,na,1918,1.0418153010391728E-4
STAT,1830,51,30-34,1881,0.004466245081366247
SIM,1877,91,na,1968,187
STAT,1860,31,50-100,1891,0.7595681038481509
STAT,1877,42,25-29,1919,0.6685753258251047
SIM,1953,10,na,1963,4918
STAT,1884,21,35-39,1905,5.829656251925299
SIM,1907,32,45-49,1939,2
STAT,1911,22,15-19,1933,5.0933159969057735
SIM,1839,43,40-44,1882,8
SIM,1919,22,25-29,1941,96
SIM,1867,37,25-29,1904,2
STAT,1820,44,50-100,1864,1.8598233275210034
SIM,1906,21,50-100,1927,3
SIM,1910,17,25-29,1927,8
STAT,1902,17,25-29,1919,8.08789515903517
STAT,1876,34,20-24,1910,2.794731730671354
STAT,1837,22,30-34,1859,15.907663445263076
STAT,1851,15,45-49,1866,0.0608507230376646
STAT,1900,45,30-34,1945,0.07737274360889405
SIM,1892,21,35-39,1913,10
STAT,1934,35,30-34,1969,2.5457248664562377
STAT,1881,29,50-100,1910,0.6183312702201443
STAT,1899,42,45-49,1941,0.14388507155912938
STAT,1914,43,35-39,1957,0.20099805380270477
SIM,1886,34,na,1920,2665
SIM,1905,17,15-19,1922,7
STAT,1891,2,na,1893,3333.3496172423465
SIM,1793,87,na,1880,56
SIM,1825,38,30-34,1863,9
STAT,1926,40,20-24,1966,0.022064837451431337
STAT,1877,18,30-34,1895,1.6571335810240573
SIM,1879,20,20-24,1899,75
STAT,1884,29,30-34,1913,24.901787366425935
STAT,1906,53,na,1959,3191.0072413378393
STAT,1847,47,na,1894,1676.6856874032624
STAT,1919,26,na,1945,4100.880189940881
SIM,1864,4,na,1868,2974
STAT,1909,9,na,1918,3926.480694975052
STAT,1851,46,na,1897,1708.388672321974
STAT,1826,36,15-19,1862,0.06666611197808929
SIM,1901,50,na,1951,3174
STAT,1869,4,na,1873,2916.0086567392773
STAT,1839,109,na,1948,5.044056711979539E-4
STAT,1884,33,50-100,1917,0.908724921301364
STAT,1941,28,50-100,1969,1.0390377496375212
SIM,1912,21,30-34,1933,34
STAT,1880,45,35-39,1925,0.1499799458087172
STAT,1882,24,35-39,1906,5.6733875935605775
STAT,1864,19,na,1883,2353.1987318006845
STAT,1861,26,25-29,1887,36.019295030507344
STAT,1923,49,15-19,1972,4.3285429694243227E-4
STAT,1957,15,15-19,1972,60.4751374607802
STAT,1912,46,35-39,1958,0.12532051270401542
SIM,1889,37,45-49,1926,5
STAT,1841,56,na,1897,1525.2679800591386
STAT,1909,43,25-29,1952,0.0669950425325616
STAT,1813,54,35-39,1867,0.022866037747707322
SIM,1848,94,na,1942,10
SIM,1892,29,30-34,1921,56
STAT,1879,15,30-34,1894,1.6877433497892842
SIM,1887,21,25-29,1908,64
STAT,1897,45,45-49,1942,0.18205434263737252
SIM,1823,33,35-39,1856,6
SIM,1869,62,na,1931,1721
STAT,1910,19,40-44,1929,0.2781203026187207
STAT,1898,34,40-44,1932,5.887032580950461
STAT,1881,50,na,1931,2126.3736775294988
SIM,1885,42,25-29,1927,3
STAT,1879,21,25-29,1900,60.51902678731864
STAT,1817,38,30-34,1855,17.71156171247243
SIM,1818,50,na,1868,1260
STAT,1856,83,na,1939,307.4053942555115
SIM,1865,33,40-44,1898,5
STAT,1876,26,50-100,1902,0.6693879996867123
SIM,1879,86,na,1965,376
STAT,1869,26,25-29,1895,41.68078763978456
STAT,1824,33,45-49,1857,3.008429209493858
SIM,1846,39,45-49,1885,4
STAT,1832,79,na,1911,476.0376735746945
STAT,1952,4,na,1956,4761.496071717564
SIM,1890,23,50-100,1913,1
SIM,1916,38,25-29,1954,1
SIM,1927,7,na,1934,5459
STAT,1856,55,na,1911,1601.126263242198
STAT,1864,49,50-100,1913,0.2191631505045067
SIM,1862,30,20-24,1892,3
SIM,1837,39,35-39,1876,4
STAT,1903,16,30-34,1919,2.298273716698318
SIM,1826,36,25-29,1862,6
STAT,1876,27,15-19,1903,0.4731404915820442
STAT,1818,43,30-34,1861,2.183334025786731
STAT,1814,53,40-44,1867,0.023764996959069463
SIM,1893,27,25-29,1920,62
STAT,1818,44,na,1862,1487.3958243652587
SIM,1851,20,35-39,1871,6
STAT,1887,16,35-39,1903,0.6202693015206404
SIM,1843,36,25-29,1879,5
SIM,1874,26,45-49,1900,1
SIM,1895,16,35-39,1911,4
SIM,1925,35,30-34,1960,2
STAT,1927,32,20-24,1959,3.0326995168056627
STAT,1855,100,na,1955,0.7991223493297398
STAT,1857,33,40-44,1890,3.4039665760114164
STAT,1913,18,50-100,1931,0.07708571769377055
STAT,1805,53,30-34,1858,0.023983294241366214
STAT,1835,43,30-34,1878,1.0211452125057656
STAT,1829,39,35-39,1868,5.606534010899172
STAT,1891,24,45-49,1915,0.8665266382919162
STAT,1855,39,45-49,1894,1.4854367374118465
STAT,1838,20,25-29,1858,50.440234187519934
SIM,1935,32,20-24,1967,3
SIM,1849,42,na,1891,1829
SIM,1787,87,na,1874,27
SIM,1774,80,na,1854,201
STAT,1853,31,15-19,1884,0.12254230879613214
STAT,1912,47,50-100,1959,0.2193027614745628
SIM,1906,28,na,1934,3353
STAT,1880,16,50-100,1896,0.052093829901854204
SIM,1843,43,30-34,1886,3
STAT,1809,46,25-29,1855,0.21519065099739354
STAT,1810,64,na,1874,1036.7518320111494
SIM,1868,42,25-29,1910,3
STAT,1828,40,20-24,1868,0.15689910345875202
SIM,1819,46,50-100,1865,1
STAT,1835,100,na,1935,0.7968153379585646
STAT,1825,91,na,1916,42.28793582996131
STAT,1886,38,50-100,1924,1.30276237739974
STAT,1908,54,na,1962,3266.3723796475615
STAT,1801,87,na,1888,63.834176853628485
SIM,1826,43,30-34,1869,2
SIM,1852,36,35-39,1888,15
STAT,1925,26,na,1951,4486.94896619082
STAT,1830,44,25-29,1874,0.5424075777520834
SIM,1863,8,na,1871,2666
STAT,1928,18,50-100,1946,0.4759072119635277
SIM,1901,6,na,1907,3812
STAT,1844,36,35-39,1880,6.566087354026801
STAT,1917,35,30-34,1952,1.928967878892479
SIM,1910,33,na,1943,3449
STAT,1885,34,30-34,1919,17.402631539214575
SIM,1893,34,30-34,1927,27
STAT,1829,49,45-49,1878,0.171550891384372
STAT,1908,38,25-29,1946,0.9259607617718242
STAT,1840,43,40-44,1883,1.6238056177080915
STAT,1841,33,45-49,1874,1.5658644726918705
SIM,1911,16,30-34,1927,4
STAT,1881,50,35-39,1931,0.008501928073523245
STAT,1849,49,30-34,1898,0.07410314936184105
STAT,1843,20,35-39,1863,5.012002892872724
STAT,1920,22,25-29,1942,103.69892073541261
SIM,1889,19,15-19,1908,9
STAT,1902,63,na,1965,2775.7394001224816
STAT,1852,93,na,1945,22.164303215253163
STAT,1837,49,50-100,1886,0.1695286355258446
STAT,1845,17,40-44,1862,0.1689152494651923
STAT,1840,18,35-39,1858,0.4950686801680415
SIM,1799,72,na,1871,741
STAT,1924,48,50-100,1972,0.27134355477031213
STAT,1775,93,na,1868,4.829144174414356
STAT,1843,28,30-34,1871,20.752234222893694
STAT,1928,30,15-19,1958,0.16259411144883518
SIM,1883,29,20-24,1912,12
SIM,1895,17,na,1912,3344
SIM,1863,44,30-34,1907,1
STAT,1903,22,25-29,1925,82.34284692352877
STAT,1923,25,45-49,1948,2.0176911329254077
SIM,1925,28,25-29,1953,116
SIM,1863,20,25-29,1883,72
STAT,1864,13,na,1877,2462.0798041381227
STAT,1873,27,na,1900,2443.5839827575737
STAT,1878,16,25-29,1894,5.955900439147677
STAT,1860,28,30-34,1888,20.86273477538989
SIM,1928,34,50-100,1962,1
STAT,1876,37,25-29,1913,3.002550456042286
SIM,1942,28,25-29,1970,76
SIM,1846,20,25-29,1866,60
SIM,1944,22,20-24,1966,123
STAT,1913,45,40-44,1958,0.15599624642707044
STAT,1815,43,45-49,1858,3.6887768607857994
SIM,1840,43,na,1883,1708
STAT,1948,23,na,1971,4234.27328360236
SIM,1851,28,30-34,1879,37
SIM,1914,57,na,1971,3629
SIM,1888,20,30-34,1908,27
SIM,1857,77,na,1934,777
SIM,1902,32,25-29,1934,20
STAT,1902,35,50-100,1937,0.3818123357313647
STAT,1853,41,na,1894,1919.9894051759693
SIM,1912,28,na,1940,3731
STAT,1835,36,25-29,1871,2.700544727844466
STAT,1890,33,na,1923,2932.663337951116
STAT,1934,28,25-29,1962,89.42480086602218
STAT,1824,44,na,1868,1331.3842138373896
STAT,1882,34,45-49,1916,1.6914575578221827
STAT,1918,43,35-39,1961,0.21580439803511275
SIM,1825,66,na,1891,757
SIM,1905,27,50-100,1932,1
STAT,1860,20,35-39,1880,5.537022660562558
STAT,1899,32,35-39,1931,14.037651368662715
SIM,1874,49,na,1923,2108
SIM,1931,25,45-49,1956,2
STAT,1881,44,40-44,1925,2.160258839636613
STAT,1821,54,25-29,1875,0.004798389501023588
STAT,1854,30,20-24,1884,2.1210121429174076
STAT,1855,20,25-29,1875,51.07051121510833
STAT,1931,1,na,1932,5524.290277863787
STAT,1838,39,45-49,1877,1.5771735606333679
SIM,1857,41,35-39,1898,3
STAT,1917,28,25-29,1945,69.42970896903469
SIM,1863,77,na,1940,624
STAT,1944,27,40-44,1971,5.087068872018452
STAT,1875,29,20-24,1904,12.081098973222863
STAT,1860,42,45-49,1902,1.2341445708922567
STAT,1804,54,25-29,1858,0.00921251032852816
SIM,1911,22,25-29,1933,103
STAT,1887,47,na,1934,2525.196096805407
SIM,1870,87,na,1957,183
SIM,1832,33,45-49,1865,1
STAT,1806,59,na,1865,999.0299240973948
STAT,1850,47,15-19,1897,3.048573507843435E-4
SIM,1941,25,na,1966,4025
STAT,1844,17,50-100,1861,0.04927264135342932
STAT,1854,52,30-34,1906,0.004443526634159319
SIM,1945,1,na,1946,4363
STAT,1845,103,na,1948,0.10486442273472443
STAT,1876,44,30-34,1920,1.1827401877942716
SIM,1926,43,35-39,1969,2
STAT,1818,36,25-29,1854,9.352703787399424
STAT,1809,53,30-34,1862,0.0187218394623973
SIM,1829,28,na,1857,1869
STAT,1833,54,20-24,1887,5.190608556875795E-4
STAT,1907,20,50-100,1927,0.6084549540582472
STAT,1871,45,25-29,1916,0.058373447527501496
STAT,1883,85,na,1968,554.7715739586482
STAT,1859,15,45-49,1874,0.06232800884287421
STAT,1885,27,25-29,1912,42.527214220831944
STAT,1908,45,30-34,1953,0.08257966813000556
SIM,1901,24,20-24,1925,133
SIM,1885,1,na,1886,3520
STAT,1821,39,35-39,1860,12.344138203354984
STAT,1891,46,50-100,1937,0.17373167443207727
STAT,1928,40,25-29,1968,0.09226893536737456
STAT,1890,16,40-44,1906,0.22628619117267681
SIM,1943,27,30-34,1970,52
STAT,1900,68,na,1968,2463.6473015097813
SIM,1889,17,na,1906,3120
STAT,1842,29,25-29,1871,46.42443577311793
SIM,1861,25,20-24,1886,20
SIM,1868,18,30-34,1886,2
SIM,1825,40,45-49,1865,4
SIM,1865,18,15-19,1883,5
STAT,1889,70,na,1959,1867.754380910203
STAT,1867,44,20-24,1911,0.14902732439254332
STAT,1884,31,45-49,1915,1.7439360085752404
STAT,1877,32,15-19,1909,0.14844908001133028
SIM,1831,25,40-44,1856,8
STAT,1827,27,na,1854,1583.5896059060785
STAT,1870,23,30-34,1893,17.611424997326143
STAT,1813,48,40-44,1861,0.48914212587513073
STAT,1863,15,35-39,1878,0.5669755080762321
STAT,1869,41,20-24,1910,0.15665343178217184
SIM,1914,47,50-100,1961,2
STAT,1940,25,15-19,1965,0.7273900457580137
SIM,1789,82,na,1871,139
SIM,1873,31,40-44,1904,5
STAT,1954,5,na,1959,4910.687752396973
STAT,1926,43,25-29,1969,0.08883114920173318
STAT,1834,38,30-34,1872,3.9072654867891927
STAT,1909,36,na,1945,3610.749106927352
SIM,1892,19,20-24,1911,29
STAT,1869,56,na,1925,2002.8359376565759
SIM,1874,32,50-100,1906,1
SIM,1919,16,30-34,1935,22
STAT,1921,21,30-34,1942,32.88572007250888
STAT,1855,54,40-44,1909,0.00770646595432075
SIM,1827,92,na,1919,10
STAT,1865,66,na,1931,1511.5869443798097
SIM,1813,41,na,1854,1500
STAT,1897,35,35-39,1932,9.668106931487738
SIM,1812,65,na,1877,791
STAT,1879,18,35-39,1897,0.5768240906420655
SIM,1821,70,na,1891,719
SIM,1889,34,40-44,1923,11
SIM,1901,27,25-29,1928,95
STAT,1881,22,na,1903,2302.5296272507653
STAT,1932,39,15-19,1971,0.026019089635982068
STAT,1817,40,45-49,1857,3.999804407091158
STAT,1936,22,20-24,1958,107.32477477323155
SIM,1906,16,20-24,1922,26
STAT,1871,42,20-24,1913,0.15916064641558858
SIM,1854,94,na,1948,31
STAT,1853,25,20-24,1878,11.402056500788136
SIM,1880,18,na,1898,2421
STAT,1895,16,50-100,1911,0.06477719779156521
STAT,1885,80,na,1965,915.3887180381591
STAT,1884,19,20-24,1903,17.56283497712917
STAT,1909,37,30-34,1946,1.740823314792479
STAT,1898,37,45-49,1935,2.7294994767156675
STAT,1889,44,40-44,1933,2.76342365638599
STAT,1943,18,25-29,1961,46.38562286415886
STAT,1912,53,na,1965,3486.324046508443
SIM,1878,21,15-19,1899,6
SIM,1892,34,na,1926,3239
STAT,1893,19,30-34,1912,2.033082495337212
SIM,1897,44,40-44,1941,2
STAT,1890,67,na,1957,2010.4148401423938
STAT,1900,48,35-39,1948,0.10940593650521926
STAT,1888,15,40-44,1903,0.21905392214029515
STAT,1819,109,na,1928,3.616797627660248E-4
SIM,1932,30,45-49,1962,8
STAT,1847,72,na,1919,945.5761780699893
STAT,1875,35,15-19,1910,0.05879764842200382
STAT,1857,18,15-19,1875,5.4657326490181335
STAT,1855,29,35-39,1884,7.462092768632089
STAT,1866,14,na,1880,2495.433808084269
STAT,1918,37,40-44,1955,1.592962053396851
SIM,1892,31,45-49,1923,3
STAT,1835,26,15-19,1861,0.4471896637700876
STAT,1880,39,40-44,1919,4.596530805753948
STAT,1900,35,20-24,1935,1.0917808146023433
STAT,1920,38,40-44,1958,1.6534764263614252
STAT,1933,21,na,1954,4909.639741476623
SIM,1864,34,35-39,1898,19
STAT,1895,31,20-24,1926,3.57980528970617
STAT,1861,48,35-39,1909,0.11602283485243368
STAT,1864,107,na,1971,0.06902162255694573
SIM,1875,62,na,1937,1780
SIM,1938,27,20-24,1965,29
SIM,1894,69,na,1963,2263
STAT,1844,33,30-34,1877,16.348418075722773
STAT,1851,28,20-24,1879,10.325978662642173
SIM,1934,31,50-100,1965,1
SIM,1887,37,40-44,1924,1
STAT,1826,28,30-34,1854,62.30165740165548
SIM,1880,44,30-34,1924,1
SIM,1867,34,20-24,1901,2
STAT,1812,46,30-34,1858,0.226890066605255
STAT,1898,19,15-19,1917,8.082062819455409
STAT,1814,110,na,1924,1.2934287484904402E-4
STAT,1828,110,na,1938,1.7938684833015484E-4
SIM,1863,29,35-39,1892,10
STAT,1808,48,30-34,1856,0.3441205414875517
STAT,1932,9,na,1941,5327.0351453336525
STAT,1830,54,35-39,1884,0.006086692736918491
SIM,1859,33,50-100,1892,1
STAT,1912,22,35-39,1934,9.104104623070857
STAT,1885,37,35-39,1922,7.110674779260487
STAT,1832,73,na,1905,808.769511094802
SIM,1875,29,30-34,1904,32
SIM,1893,37,35-39,1930,21
STAT,1864,52,25-29,1916,0.003210960045976211
SIM,1926,33,25-29,1959,13
SIM,1853,47,na,1900,1675
SIM,1886,6,na,1892,2939
STAT,1929,4,na,1933,5206.35448001683
SIM,1842,38,30-34,1880,3
SIM,1834,28,30-34,1862,26
SIM,1946,18,15-19,1964,49
STAT,1909,40,20-24,1949,0.016857626201249
STAT,1848,43,40-44,1891,1.823174226609298
SIM,1939,15,na,1954,3682
STAT,1891,48,15-19,1939,2.7860408215802903E-4
STAT,1903,11,na,1914,3720.258557749874
SIM,1850,25,45-49,1875,1
STAT,1908,35,20-24,1943,0.2515098341524696
SIM,1856,43,40-44,1899,7
SIM,1920,22,35-39,1942,15
STAT,1872,44,30-34,1916,1.1516394667711276
SIM,1834,49,na,1883,1691
STAT,1837,25,35-39,1862,8.5714629191599
SIM,1877,16,15-19,1893,10
STAT,1888,23,na,1911,2810.690119007464
SIM,1866,41,45-49,1907,1
SIM,1859,30,45-49,1889,2
STAT,1854,29,na,1883,1850.74243553218
STAT,1853,19,50-100,1872,0.04816463723423822
STAT,1863,45,35-39,1908,0.1265336009876315
STAT,1869,34,50-100,1903,0.8920120979051688
SIM,1852,33,30-34,1885,20
STAT,1858,39,30-34,1897,4.180582446756867
STAT,1938,18,15-19,1956,45.180356631178306
SIM,1904,33,na,1937,3602
STAT,1842,25,45-49,1867,1.2541548758013639
STAT,1856,34,35-39,1890,7.774716835542505
STAT,1844,41,15-19,1885,0.011334456442196814
SIM,1850,29,25-29,1879,41
SIM,1934,28,35-39,1962,22
STAT,1914,35,15-19,1949,0.019528637221536613
SIM,1851,18,20-24,1869,21
STAT,1926,28,35-39,1954,18.12565920359686
STAT,1791,86,na,1877,65.00798670732222
STAT,1869,28,na,1897,2335.2177530153604
STAT,1843,82,na,1925,314.69482095121384
STAT,1874,40,na,1914,2414.378693130312
SIM,1919,32,na,1951,4057
STAT,1836,31,15-19,1867,0.1147404574919352
STAT,1879,37,40-44,1916,4.61388718887473
SIM,1828,40,na,1868,1622
STAT,1935,27,30-34,1962,53.96297431853718
STAT,1869,16,15-19,1885,5.943184048429053
STAT,1934,38,35-39,1972,3.3692014687873013
SIM,1873,61,na,1934,1758
STAT,1913,41,50-100,1954,0.11625779575438715
SIM,1854,48,50-100,1902,3
STAT,1876,38,na,1914,2444.7278686738478
SIM,1836,75,na,1911,742
SIM,1883,39,30-34,1922,7
STAT,1887,32,50-100,1919,1.0332005849270895
STAT,1904,46,45-49,1950,0.19349975361214836
STAT,1927,35,25-29,1962,1.2394603422838106
STAT,1830,41,20-24,1871,0.13994992403918485
STAT,1950,20,45-49,1970,1.3495125456160946
STAT,1870,46,50-100,1916,0.24427476983741847
STAT,1783,107,na,1890,0.008718457020894275
SIM,1896,45,50-100,1941,1
STAT,1863,31,na,1894,2144.212285635792
STAT,1846,27,50-100,1873,0.5872779824811193
SIM,1895,32,50-100,1927,5
SIM,1832,30,40-44,1862,10
STAT,1896,52,na,1948,2863.3696602787622
SIM,1876,44,na,1920,2611
SIM,1831,38,na,1869,1732
SIM,1869,25,20-24,1894,16
SIM,1908,38,35-39,1946,4
SIM,1918,32,20-24,1950,4
STAT,1901,19,30-34,1920,2.2445897343021217
SIM,1893,24,20-24,1917,114
STAT,1894,23,na,1917,3065.8534970370424
STAT,1838,98,na,1936,2.1746594833004185
SIM,1845,52,na,1897,1762
SIM,1933,22,45-49,1955,1
STAT,1868,36,20-24,1904,0.7476747573500371
STAT,1897,37,na,1934,3190.131620064051
STAT,1820,47,35-39,1867,0.23810716158649142
STAT,1854,49,40-44,1903,0.12580066618546182
SIM,1847,22,35-39,1869,5
STAT,1939,24,50-100,1963,0.6666596971475621
SIM,1861,76,na,1937,813
STAT,1818,46,35-39,1864,0.25301958950223563
STAT,1877,50,45-49,1927,0.015345475660566264
STAT,1906,49,15-19,1955,3.2499923235789976E-4
STAT,1843,30,45-49,1873,1.4436318148855263
SIM,1860,33,20-24,1893,3
STAT,1839,22,35-39,1861,5.315807556041416
STAT,1834,34,15-19,1868,0.10640315077290022
STAT,1918,33,25-29,1951,9.873738695676405
SIM,1867,40,50-100,1907,1
STAT,1842,33,50-100,1875,0.9862389098884692
SIM,1945,15,na,1960,3905
STAT,1875,39,30-34,1914,5.472295102339448
SIM,1830,53,na,1883,1229
STAT,1908,48,35-39,1956,0.11737593505307123
STAT,1849,100,na,1949,0.8300502457738048
STAT,1935,30,50-100,1965,1.1569909234506381
STAT,1826,43,20-24,1869,0.16241362082489166
STAT,1853,47,30-34,1900,0.07967812486573637
SIM,1825,43,50-100,1868,1
STAT,1831,43,30-34,1874,0.8773742463943163
SIM,1826,33,20-24,1859,2
STAT,1874,33,40-44,1907,4.466060422157429
SIM,1846,36,40-44,1882,8
SIM,1928,43,na,1971,4905
STAT,1815,109,na,1924,3.0797555591817845E-4
SIM,1845,80,na,1925,538
STAT,1862,31,25-29,1893,8.970316639430141
STAT,1897,44,50-100,1941,0.09799585500878981
STAT,1926,33,15-19,1959,0.15694406793758256
STAT,1843,36,15-19,1879,0.044676567432161716
STAT,1868,40,na,1908,2253.530429767496
STAT,1914,40,30-34,1954,0.12870716818809827
SIM,1948,15,15-19,1963,54
STAT,1795,76,na,1871,433.98819923865966
STAT,1845,46,na,1891,1648.5946705141405
SIM,1825,38,na,1863,1457
STAT,1859,97,na,1956,5.084885593429092
STAT,1936,32,30-34,1968,15.449621331178045
STAT,1862,53,35-39,1915,0.007388431226010347
STAT,1860,24,15-19,1884,2.767633948677177
STAT,1877,20,45-49,1897,0.7312413929194213
STAT,1882,38,na,1920,2293.5319061243385
SIM,1845,15,25-29,1860,10
STAT,1816,39,25-29,1855,10.009257475731685
STAT,1822,54,45-49,1876,0.019917246003208128
SIM,1882,44,na,1926,2053
SIM,1868,28,40-44,1896,1
STAT,1857,31,na,1888,1912.3637201306299
STAT,1894,26,20-24,1920,15.307171553795898
STAT,1773,92,na,1865,11.218639562186485
STAT,1804,51,20-24,1855,0.002039116145992085
STAT,1903,26,40-44,1929,4.323645708365398
STAT,1924,30,45-49,1954,1.8635272844213469
STAT,1913,49,20-24,1962,0.010819304468261093
STAT,1873,95,na,1968,58.29320121958803
SIM,1851,30,45-49,1881,1
STAT,1838,36,40-44,1874,3.57290411330648
STAT,1861,16,15-19,1877,5.7587154922350825
SIM,1888,42,40-44,1930,9
STAT,1852,33,20-24,1885,2.1005819198966824
SIM,1834,42,50-100,1876,2
SIM,1886,33,50-100,1919,1
STAT,1933,32,45-49,1965,2.1428932852030713
SIM,1795,82,na,1877,59
SIM,1837,23,na,1860,1720
STAT,1871,37,40-44,1908,4.3924922944239
SIM,1816,55,na,1871,1186
STAT,1893,34,20-24,1927,3.4368357353091072
STAT,1885,24,20-24,1909,68.84662294240988
SIM,1824,30,50-100,1854,1
SIM,1903,21,20-24,1924,104
STAT,1793,104,na,1897,0.012038315456589156
STAT,1836,41,25-29,1877,0.48813242916978644
STAT,1915,36,na,1951,3853.457316638735
STAT,1841,23,35-39,1864,5.488445728208762
STAT,1881,40,25-29,1921,0.6314902171156613
STAT,1844,98,na,1942,2.5701944572995497
STAT,1846,50,50-100,1896,0.01162595124722695
STAT,1885,42,15-19,1927,0.013866449761772046
SIM,1824,39,25-29,1863,3
STAT,1921,36,na,1957,4246.58425639493
STAT,1850,98,na,1948,2.4874528669410405
STAT,1794,60,na,1854,986.0000000000002
STAT,1880,20,20-24,1900,73.53233926075409
STAT,1839,46,na,1885,1646.131488970333
STAT,1875,31,50-100,1906,0.9542296239796043
STAT,1913,48,45-49,1961,0.2134391735135775
STAT,1925,22,45-49,1947,1.3611189693741756
STAT,1891,80,na,1971,1248.5561927845
SIM,1942,25,20-24,1967,22
STAT,1826,42,50-100,1868,1.1022319005040753
STAT,1833,32,40-44,1865,3.964816888983464
SIM,1843,23,na,1866,2315
STAT,1827,35,20-24,1862,0.9400132417467391
STAT,1944,23,25-29,1967,100.67672267996744
SIM,1898,59,na,1957,2703
STAT,1955,15,50-100,1970,0.5027301497331976
STAT,1828,50,30-34,1878,0.0054483420007702165
SIM,1805,83,na,1888,102
SIM,1833,22,40-44,1855,1
SIM,1888,23,35-39,1911,17
SIM,1838,44,35-39,1882,3
STAT,1824,30,40-44,1854,11.880877799659514
SIM,1841,32,40-44,1873,5
STAT,1859,47,35-39,1906,0.11319677973465676
STAT,1823,51,25-29,1874,0.0047868096206754775
STAT,1899,48,15-19,1947,3.088319085305957E-4
STAT,1890,42,25-29,1932,0.7915493286367978
STAT,1891,21,40-44,1912,2.6136245153225257
STAT,1876,40,15-19,1916,0.014546799502347257
STAT,1911,17,35-39,1928,0.8471441954752761
SIM,1801,56,na,1857,916
STAT,1857,36,45-49,1893,1.5789176079712044
SIM,1872,29,45-49,1901,2
SIM,1928,22,35-39,1950,14
STAT,1930,41,25-29,1971,0.09510107868502622
STAT,1934,25,20-24,1959,24.83368672722432
SIM,1947,8,na,1955,4839
STAT,1837,17,na,1854,2072.984655637495
SIM,1830,50,na,1880,1317
SIM,1904,64,na,1968,2999
STAT,1926,25,30-34,1951,47.793746439709366
SIM,1879,23,25-29,1902,74
SIM,1911,38,40-44,1949,2
STAT,1848,26,na,1874,2123.7821761195487
STAT,1789,76,na,1865,454.43989461590746
STAT,1863,54,30-34,1917,0.00518039006470205
STAT,1953,6,na,1959,4804.675538553511
SIM,1847,16,na,1863,2166
STAT,1932,15,45-49,1947,0.6715702288794035
STAT,1864,26,40-44,1890,2.7394875683875415
SIM,1809,76,na,1885,347
SIM,1949,9,na,1958,4420
STAT,1889,35,45-49,1924,2.5062550501765344
SIM,1822,55,na,1877,1309
STAT,1815,103,na,1918,0.06212455083885187
STAT,1876,47,35-39,1923,0.14531736190066238
STAT,1917,25,20-24,1942,19.454048380414854
STAT,1825,29,25-29,1854,172.08237306741714
SIM,1874,18,na,1892,2451
STAT,1874,18,15-19,1892,6.121370524349025
STAT,1943,14,na,1957,4204.445819787002
STAT,1906,26,50-100,1932,0.9442831473880385
SIM,1796,61,na,1857,1090
STAT,1900,25,50-100,1925,0.9035844609132547
STAT,1838,17,35-39,1855,0.48518912101454
STAT,1847,29,45-49,1876,0.9849131422484274
STAT,1825,40,35-39,1865,2.7189208754793635
STAT,1940,15,50-100,1955,0.3842406118610674
STAT,1797,71,na,1868,619.2623180272748
STAT,1854,20,na,1874,1912.7597223950117
SIM,1872,19,35-39,1891,3
STAT,1840,51,25-29,1891,0.002494787080944078
STAT,1867,95,na,1962,31.115155902138675
STAT,1867,47,25-29,1914,0.054534946754336885
STAT,1823,65,na,1888,944.605837782381
SIM,1885,55,na,1940,2208
SIM,1842,40,45-49,1882,2
SIM,1934,25,30-34,1959,64
STAT,1892,31,35-39,1923,12.887283943117804
STAT,1821,36,30-34,1857,11.089251436348938
STAT,1830,48,40-44,1878,0.14135367513493435
STAT,1840,47,20-24,1887,0.008482681607738327
STAT,1853,35,30-34,1888,4.499923994199718
SIM,1865,36,45-49,1901,1
SIM,1886,0,na,1886,3520
STAT,1872,45,na,1917,2307.3111505934967
STAT,1816,80,na,1896,316.27160439719137
STAT,1912,24,25-29,1936,92.48790763671317
SIM,1872,26,40-44,1898,5
STAT,1785,86,na,1871,69.55665527601312
SIM,1871,35,na,1906,2292
SIM,1871,42,30-34,1913,2
STAT,1916,12,na,1928,4228.5051007188595
STAT,1869,103,na,1972,1.6591146741262195
STAT,1850,20,40-44,1870,1.942924546639973
STAT,1849,45,15-19,1894,3.158587867790199E-4
SIM,1879,30,30-34,1909,30
SIM,1833,40,35-39,1873,4
STAT,1872,40,15-19,1912,0.01416428442611076
SIM,1929,18,15-19,1947,71
STAT,1833,34,50-100,1867,0.8204550518263323
STAT,1842,35,na,1877,2309.5596566206036
SIM,1919,19,35-39,1938,4
SIM,1784,76,na,1860,380
STAT,1931,29,na,1960,4883.1105520697265
SIM,1833,29,25-29,1862,40
SIM,1925,25,20-24,1950,27
SIM,1939,19,20-24,1958,151
STAT,1895,46,25-29,1941,0.042976370755840106
STAT,1863,42,30-34,1905,1.0275596838236407
STAT,1872,54,40-44,1926,0.010396027368937603
STAT,1845,52,20-24,1897,5.363170258485485E-4
SIM,1929,36,45-49,1965,1
STAT,1875,41,45-49,1916,1.5593653405675272
SIM,1846,29,35-39,1875,18
SIM,1865,6,na,1871,2598
STAT,1896,15,30-34,1911,2.1407782224114964
STAT,1907,30,45-49,1937,1.4970980863570043
SIM,1911,12,na,1923,4138
SIM,1874,15,na,1889,2462
STAT,1912,22,na,1934,3689.7821078415996
STAT,1921,36,35-39,1957,2.7301620612116513
SIM,1861,35,30-34,1896,10
STAT,1922,41,35-39,1963,0.23382960054643304
SIM,1803,51,na,1854,1176
STAT,1823,68,na,1891,845.1902107546701
STAT,1833,23,45-49,1856,0.6608553689235358
STAT,1848,28,15-19,1876,0.43904738655735026
STAT,1918,42,20-24,1960,0.01895655281587135
STAT,1879,46,50-100,1925,0.25959731439405986
STAT,1851,19,25-29,1870,5.1555272185213985
STAT,1926,37,30-34,1963,2.2511754187257615
SIM,1858,56,na,1914,1632
STAT,1891,22,50-100,1913,0.5099330127417122
STAT,1808,50,45-49,1858,0.05119449956161468
STAT,1897,23,50-100,1920,0.55046598002931
SIM,1858,53,na,1911,1704
STAT,1891,12,na,1903,3229.371337415125
SIM,1904,30,na,1934,3557
STAT,1916,15,na,1931,4154.547604579434
STAT,1859,66,na,1925,1331.426249711631
SIM,1932,20,35-39,1952,24
SIM,1883,20,na,1903,2701
STAT,1865,60,na,1925,1758.9079013986977
STAT,1867,92,na,1959,64.49439825730421
STAT,1868,16,50-100,1884,0.04843293403175256
SIM,1841,28,na,1869,1812
STAT,1935,23,15-19,1958,7.3213422255870455
SIM,1866,82,na,1948,457
SIM,1902,26,30-34,1928,57
STAT,1835,46,35-39,1881,0.11223003128110551
STAT,1815,100,na,1915,0.4595631933996732
SIM,1907,36,25-29,1943,4
STAT,1870,25,20-24,1895,11.714051901149025
STAT,1808,51,na,1859,1202.1760497526218
STAT,1889,47,45-49,1936,0.16501849742271574
SIM,1915,30,45-49,1945,2
STAT,1838,29,35-39,1867,8.098902010327466
SIM,1833,95,na,1928,6
STAT,1879,18,na,1897,2655.014004349299
SIM,1947,24,50-100,1971,5
STAT,1909,47,40-44,1956,0.1461932790082655
STAT,1900,41,15-19,1941,0.0013515516082176656
STAT,1821,52,35-39,1873,0.012136546109702774
STAT,1924,41,na,1965,4470.4504299162345
SIM,1876,36,20-24,1912,1
SIM,1929,22,na,1951,4448
STAT,1910,15,25-29,1925,8.703472264138194
STAT,1912,31,30-34,1943,15.704794534965226
SIM,1830,41,30-34,1871,3
STAT,1878,33,na,1911,2491.3810262525426
STAT,1873,19,45-49,1892,0.06652565091495898
STAT,1873,24,50-100,1897,0.41492662592764445
SIM,1929,24,45-49,1953,2
STAT,1922,49,30-34,1971,0.1028529146111281
STAT,1855,50,25-29,1905,0.002704460581169893
SIM,1841,90,na,1931,25
SIM,1897,40,na,1937,3204
STAT,1839,41,40-44,1880,1.8707575366039364
STAT,1853,72,na,1925,1044.3844475523763
STAT,1819,50,20-24,1869,0.001437819168545441
STAT,1930,2,na,1932,5344.238236637908
STAT,1886,41,20-24,1927,0.17012340623084266
STAT,1908,4,na,1912,3939.2683010777046
STAT,1879,80,na,1959,799.9170180793922
STAT,1884,25,15-19,1909,0.4549512017088406
SIM,1847,41,40-44,1888,5
STAT,1822,53,30-34,1875,0.008333496477450509
STAT,1951,21,50-100,1972,0.7945245038434917
SIM,1897,35,45-49,1932,3
SIM,1870,37,30-34,1907,8
SIM,1823,36,50-100,1859,1
SIM,1869,23,30-34,1892,27
STAT,1920,16,30-34,1936,13.843521290889472
STAT,1847,22,25-29,1869,52.54452151101041
SIM,1841,35,45-49,1876,1
SIM,1946,21,40-44,1967,6
SIM,1869,28,25-29,1897,61
STAT,1894,36,30-34,1930,6.963594100444751
STAT,1843,18,20-24,1861,15.190633633886549
STAT,1882,23,50-100,1905,0.39772796553786705
STAT,1865,31,40-44,1896,4.015907566557535
SIM,1835,28,na,1863,1658
STAT,1878,30,na,1908,2522.0501526401918
STAT,1912,56,na,1968,3429.3557426510565
STAT,1921,43,40-44,1964,0.28408246357265515
STAT,1859,17,50-100,1876,0.04619696039116555
STAT,1918,30,20-24,1948,2.6377904000283987
SIM,1814,91,na,1905,19
STAT,1856,22,35-39,1878,5.248026666738172
STAT,1868,52,25-29,1920,0.0034008712326558587
STAT,1810,95,na,1905,6.905172883103032
SIM,1920,31,30-34,1951,37
STAT,1883,26,45-49,1909,1.1011577375828627
STAT,1768,106,na,1874,0.022472367133424116
STAT,1831,53,40-44,1884,0.006782476100428422
STAT,1922,40,50-100,1962,0.136600854614101
STAT,1858,53,45-49,1911,0.011314806293673473
SIM,1926,8,na,1934,4907
SIM,1902,5,na,1907,3959
STAT,1813,44,25-29,1857,2.0134069918993154
STAT,1910,27,na,1937,3649.696462087152
SIM,1772,88,na,1860,29
STAT,1920,32,35-39,1952,10.108098882885132
STAT,1918,47,na,1965,3946.907747233625
STAT,1938,21,40-44,1959,3.3605662304724806
STAT,1898,40,35-39,1938,0.17391067146951367
SIM,1873,24,35-39,1897,4
STAT,1833,35,45-49,1868,1.8069441979335414
STAT,1880,35,25-29,1915,3.0829988269447135
SIM,1838,22,25-29,1860,62
SIM,1847,13,na,1860,2272
STAT,1893,47,na,1940,2872.3717129223046
STAT,1841,87,na,1928,131.75055232737728
SIM,1874,27,20-24,1901,7
SIM,1889,40,35-39,1929,5
STAT,1930,41,na,1971,4946.1118172128745
STAT,1884,33,na,1917,2366.723980551846
SIM,1849,48,na,1897,1739
STAT,1931,35,15-19,1966,0.025747681686931145
STAT,1852,46,35-39,1898,0.10647632289965395
STAT,1837,19,40-44,1856,0.18112925961539725
STAT,1827,45,30-34,1872,0.10195582674540721
SIM,1845,49,50-100,1894,3
STAT,1852,36,25-29,1888,2.2183233408730367
STAT,1865,24,35-39,1889,5.369285572062054
STAT,1953,3,na,1956,4807.799948935398
SIM,1809,73,na,1882,448
SIM,1934,37,30-34,1971,3
STAT,1851,30,35-39,1881,8.148588446137078
STAT,1894,48,30-34,1942,0.07011040254705654
SIM,1897,29,15-19,1926,3
STAT,1935,30,20-24,1965,3.4132928907139513
SIM,1900,71,na,1971,2329
STAT,1904,43,40-44,1947,0.22475559923793445
STAT,1812,47,45-49,1859,0.5443461389077976
STAT,1847,78,na,1925,585.0127275721311
SIM,1803,88,na,1891,38
STAT,1904,27,na,1931,3459.0716604201248
STAT,1804,53,50-100,1857,0.04008236254656484
STAT,1849,51,45-49,1900,0.011400861951547403
SIM,1835,90,na,1925,17
SIM,1894,38,50-100,1932,2
SIM,1903,31,30-34,1934,3
SIM,1829,39,45-49,1868,2
SIM,1860,36,25-29,1896,2
STAT,1868,2,na,1870,3234.315787359821
STAT,1862,33,15-19,1895,0.12368669460723755
STAT,1820,88,na,1908,69.88040609070731
SIM,1912,43,40-44,1955,2
SIM,1828,49,na,1877,1439
STAT,1889,29,15-19,1918,0.5610000726424317
SIM,1872,85,na,1957,181
STAT,1925,26,25-29,1951,78.83615551952623
STAT,1893,37,25-29,1930,3.6924018828511587
STAT,1942,22,50-100,1964,0.696568294290918
SIM,1824,50,na,1874,1364
STAT,1842,19,15-19,1861,6.780632590402054
STAT,1927,45,35-39,1972,0.1643484195487494
STAT,1943,17,na,1960,3941.11442839281
SIM,1920,24,25-29,1944,126
STAT,1921,31,40-44,1952,4.416361246453309
STAT,1944,20,20-24,1964,121.31874040843091
STAT,1906,25,45-49,1931,1.644452110628994
STAT,1897,20,30-34,1917,24.262785701577126
STAT,1848,110,na,1958,3.3512391981040747E-4
STAT,1948,23,50-100,1971,0.7629484524373148
STAT,1853,48,45-49,1901,0.19271418794693007
STAT,1860,20,na,1880,2028.77258095301
SIM,1855,29,45-49,1884,4
STAT,1845,40,20-24,1885,0.12123519508258762
SIM,1850,19,15-19,1869,9
STAT,1861,36,35-39,1897,5.9647334331994575
SIM,1790,73,na,1863,514
STAT,1901,21,45-49,1922,0.9902887053203668
STAT,1877,85,na,1962,466.5364613036417
SIM,1930,19,na,1949,5058
STAT,1813,52,50-100,1865,0.04176359731128048
STAT,1930,33,40-44,1963,5.10129154347338
STAT,1874,36,45-49,1910,2.0715660043496342
SIM,1914,25,45-49,1939,5
SIM,1935,25,na,1960,4977
SIM,1889,48,na,1937,2669
SIM,1869,16,25-29,1885,10
STAT,1877,48,30-34,1925,0.09963868271015211
STAT,1870,48,45-49,1918,0.23112102772218246
SIM,1878,47,50-100,1925,2
SIM,1920,47,50-100,1967,1
STAT,1864,25,50-100,1889,0.5892389021839355
STAT,1935,37,40-44,1972,2.114897328551258
STAT,1892,62,na,1954,2316.4284072467253
STAT,1859,40,50-100,1899,0.8668529339470876
STAT,1779,86,na,1865,79.41338970019021
STAT,1872,48,na,1920,2255.8300483361504
SIM,1882,24,45-49,1906,4
SIM,1855,22,25-29,1877,61
STAT,1826,46,25-29,1872,0.0575368036124797
STAT,1862,41,50-100,1903,0.9256281681350493
SIM,1878,18,25-29,1896,7
STAT,1822,51,40-44,1873,0.015336452095337858
SIM,1834,43,na,1877,1824
SIM,1841,17,15-19,1858,7
SIM,1784,73,na,1857,464
SIM,1891,26,45-49,1917,1
STAT,1937,19,45-49,1956,0.4891523430149989
STAT,1917,32,50-100,1949,0.8739122424374214
SIM,1855,42,na,1897,1970
STAT,1819,91,na,1910,29.45852132388832
STAT,1817,65,na,1882,870.1551921021851
STAT,1868,46,30-34,1914,0.09370545053735582
SIM,1824,35,45-49,1859,3
SIM,1908,35,30-34,1943,4
STAT,1840,107,na,1947,0.0033058253758701975
SIM,1933,26,25-29,1959,110
SIM,1884,44,30-34,1928,2
STAT,1943,25,30-34,1968,42.17214163636963
STAT,1861,23,20-24,1884,58.991462289876
STAT,1846,54,30-34,1900,0.004393077060535688
SIM,1833,26,20-24,1859,10
STAT,1847,26,40-44,1873,2.715334939332795
STAT,1875,31,35-39,1906,10.546895817537248
STAT,1822,51,50-100,1873,0.02200135883098227
STAT,1871,60,na,1931,1913.7102538671595
STAT,1855,17,35-39,1872,0.4912518120772818
SIM,1807,47,na,1854,1247
STAT,1802,66,na,1868,780.6503930478882
STAT,1925,29,na,1954,4439.644212707863
STAT,1919,40,15-19,1959,0.0016849622189050015
STAT,1871,43,35-39,1914,1.8038886777131111
SIM,1928,16,40-44,1944,3
STAT,1899,36,15-19,1935,0.07821339229882378
SIM,1868,15,na,1883,2462
STAT,1951,16,25-29,1967,52.15194711251695
STAT,1849,103,na,1952,0.11220763419042963
STAT,1867,40,40-44,1907,2.161149429341011
STAT,1847,41,na,1888,1762.6001311376142
SIM,1880,49,na,1929,2068
STAT,1922,39,20-24,1961,0.3023774072482961
STAT,1907,2,na,1909,3953.781100930136
STAT,1889,32,40-44,1921,5.400921546747035
SIM,1870,31,25-29,1901,10
SIM,1816,40,35-39,1856,1
STAT,1863,52,40-44,1915,0.009370932534217356
SIM,1847,44,45-49,1891,3
SIM,1897,32,40-44,1929,12
STAT,1895,43,20-24,1938,0.014440850865841084
STAT,1824,35,50-100,1859,1.8159241385347893
SIM,1883,31,35-39,1914,15
SIM,1884,70,na,1954,1442
STAT,1896,58,na,1954,2643.8920010723095
STAT,1810,92,na,1902,21.631046106987185
STAT,1838,64,na,1902,1163.7031489519493
STAT,1884,43,45-49,1927,1.479878043212997
STAT,1864,29,45-49,1893,1.0046836726552426
SIM,1879,55,na,1934,2455
STAT,1827,51,25-29,1878,0.003577877608303625
STAT,1863,34,na,1897,2117.202168623937
STAT,1897,23,35-39,1920,7.877167252249614
STAT,1900,47,20-24,1947,0.009452706533131653
SIM,1820,34,30-34,1854,13
STAT,1885,30,15-19,1915,0.14431861005314556
STAT,1885,49,35-39,1934,0.13780858584198524
STAT,1839,44,45-49,1883,1.0900374957804209
STAT,1908,23,20-24,1931,102.87270967890949
STAT,1874,74,na,1948,1147.7317924391389
STAT,1937,14,na,1951,3878.8270522170765
STAT,1845,50,30-34,1895,0.004411948193644093
SIM,1925,6,na,1931,4917
STAT,1817,52,45-49,1869,0.029881701740542513
SIM,1864,56,na,1920,2262
SIM,1901,15,25-29,1916,14
STAT,1792,65,na,1857,763.6208828968162
SIM,1910,27,35-39,1937,19
STAT,1892,17,20-24,1909,22.468771737956764
STAT,1893,30,40-44,1923,5.606289927445035
STAT,1902,27,35-39,1929,13.771530146107482
STAT,1922,15,na,1937,4323.366470931516
SIM,1884,37,25-29,1921,2
STAT,1821,46,40-44,1867,0.2545834664697976
STAT,1867,37,15-19,1904,0.05341545027498381
STAT,1881,59,na,1940,1892.0895623019965
SIM,1827,61,na,1888,1033
STAT,1841,53,na,1894,1584.3171059817216
STAT,1869,53,20-24,1922,7.129718759421573E-4
SIM,1951,18,na,1969,4976
STAT,1911,39,45-49,1950,0.6576120115362739
SIM,1853,16,na,1869,2058
SIM,1916,23,20-24,1939,118
SIM,1818,87,na,1905,119
SIM,1932,11,na,1943,5996
STAT,1920,26,40-44,1946,5.181054033426096
STAT,1894,42,25-29,1936,0.05791407769800607
STAT,1898,30,25-29,1928,14.136992678066374
STAT,1903,48,50-100,1951,0.19677221218809768
SIM,1924,32,45-49,1956,4
STAT,1829,27,35-39,1856,12.768533735041375
STAT,1931,16,50-100,1947,0.49682674638069835
STAT,1850,23,45-49,1873,0.6362718539879149
STAT,1899,32,na,1931,3307.7894982771336
STAT,1921,33,30-34,1954,17.63327505409185
STAT,1826,79,na,1905,383.6133010659549
SIM,1875,40,40-44,1915,3
STAT,1918,45,25-29,1963,0.05725710685600171
STAT,1866,45,na,1911,2125.101591442558
STAT,1802,69,na,1871,698.0338903664812
STAT,1858,19,na,1877,2099.735651322713
STAT,1909,33,na,1942,3626.5741650803234
STAT,1918,49,40-44,1967,0.16839080438233622
SIM,1908,23,na,1931,3427
STAT,1880,42,30-34,1922,1.217963801647885
SIM,1790,76,na,1866,462
STAT,1836,43,15-19,1879,0.010231907797318735
STAT,1873,16,40-44,1889,0.18838578395038866
SIM,1946,0,na,1946,4613
STAT,1813,51,30-34,1864,0.016795708555777684
STAT,1912,34,35-39,1946,8.99442158452146
STAT,1858,35,15-19,1893,0.04491870637578116
SIM,1854,50,50-100,1904,1
SIM,1856,34,50-100,1890,2
SIM,1861,42,na,1903,1992
SIM,1876,41,na,1917,2694
STAT,1848,34,50-100,1882,0.7775582788937013
SIM,1902,22,15-19,1924,5
STAT,1908,33,50-100,1941,0.7844851965196495
STAT,1834,30,35-39,1864,7.887585942114877
SIM,1845,83,na,1928,293
STAT,1804,52,35-39,1856,0.023314246829561423
STAT,1892,4,na,1896,3334.0788969833293
SIM,1837,27,35-39,1864,13
STAT,1773,98,na,1871,0.5904933584148905
STAT,1851,16,20-24,1867,16.417616853486802
STAT,1859,46,20-24,1905,0.009775703738768831
SIM,1911,32,35-39,1943,3
STAT,1828,52,20-24,1880,6.491486785352444E-4
SIM,1911,48,50-100,1959,3
SIM,1864,22,35-39,1886,8
STAT,1846,93,na,1939,22.17870947004378
STAT,1871,40,50-100,1911,1.070765881856467
SIM,1842,30,35-39,1872,16
SIM,1947,10,na,1957,4839
STAT,1795,79,na,1874,326.5775328613836
STAT,1844,45,30-34,1889,0.07779439690124182
SIM,1898,22,na,1920,3204
STAT,1896,18,35-39,1914,0.7316589051072371
SIM,1938,23,40-44,1961,3
STAT,1921,46,45-49,1967,0.24806944602596048
SIM,1891,23,40-44,1914,5
STAT,1879,25,40-44,1904,3.1787441421812446
STAT,1889,16,50-100,1905,0.06116405319342485
SIM,1896,27,40-44,1923,4
SIM,1914,23,na,1937,3941
STAT,1893,27,15-19,1920,0.5818469556289974
STAT,1903,32,35-39,1935,14.566906048524869
STAT,1907,20,35-39,1927,8.706989373478567
STAT,1926,21,15-19,1947,6.555731385687284
SIM,1943,23,15-19,1966,9
SIM,1948,7,na,1955,5011
STAT,1860,18,20-24,1878,16.781890285566824
STAT,1881,48,20-24,1929,0.011535991318176146
SIM,1865,33,50-100,1898,6
SIM,1885,39,50-100,1924,1
SIM,1925,38,35-39,1963,6
SIM,1831,69,na,1900,1010
SIM,1854,97,na,1951,21
STAT,1914,47,15-19,1961,3.686030003671762E-4
SIM,1917,37,na,1954,3791
STAT,1817,68,na,1885,778.0663653985002
STAT,1815,39,na,1854,1383.8752930512485
STAT,1862,47,40-44,1909,0.14862795904850482
STAT,1814,54,na,1868,1280.3128681306612
STAT,1872,50,25-29,1922,0.0036483190072735794
SIM,1830,84,na,1914,138
STAT,1928,39,50-100,1967,0.5351777442660108
SIM,1852,68,na,1920,980
STAT,1857,33,50-100,1890,0.7191775709425426
SIM,1883,23,na,1906,2642
STAT,1870,8,na,1878,2701.8492944589275
SIM,1829,36,40-44,1865,7
SIM,1887,81,na,1968,849
SIM,1935,22,na,1957,4907
SIM,1929,21,40-44,1950,4
STAT,1931,40,30-34,1971,0.17309001975433236
SIM,1824,32,40-44,1856,4
SIM,1866,39,30-34,1905,14
SIM,1882,21,40-44,1903,2
STAT,1888,27,40-44,1915,3.5710467194333364
SIM,1800,77,na,1877,406
SIM,1915,20,35-39,1935,15
SIM,1872,82,na,1954,278
STAT,1788,97,na,1885,0.9128719606629576
STAT,1935,33,25-29,1968,12.911248224864979
SIM,1832,23,35-39,1855,7
STAT,1822,80,na,1902,345.8717790500141
STAT,1869,59,na,1928,1908.4011202745269
SIM,1887,15,30-34,1902,1
STAT,1839,34,35-39,1873,8.653990420925302
STAT,1860,30,45-49,1890,1.451318795603917
STAT,1924,24,50-100,1948,0.7796729883026269
STAT,1917,38,35-39,1955,2.523286020937537
SIM,1932,24,50-100,1956,1
STAT,1767,98,na,1865,0.4391480997695597
STAT,1905,45,15-19,1950,3.3273059091120684E-4
SIM,1821,76,na,1897,500
SIM,1851,83,na,1934,360
SIM,1867,67,na,1934,1384
STAT,1778,100,na,1878,0.23479671408205172
STAT,1881,52,25-29,1933,0.0034300238916249942
STAT,1847,8,na,1855,2294.79669
SIM,1946,24,45-49,1970,2
STAT,1885,36,20-24,1921,0.7786934081847535
SIM,1846,68,na,1914,1050
STAT,1812,49,35-39,1861,0.3127098443571227
STAT,1866,32,50-100,1898,0.8569026852055799
STAT,1889,73,na,1962,1706.9358424904237
STAT,1818,45,20-24,1863,0.02201467596839526
STAT,1916,32,45-49,1948,1.6394961765275873
SIM,1851,24,15-19,1875,5
SIM,1893,36,20-24,1929,1
SIM,1869,26,35-39,1895,9
STAT,1861,33,30-34,1894,14.591755500464282
STAT,1877,39,50-100,1916,1.266946789805365
STAT,1870,38,35-39,1908,6.980046743620814
STAT,1938,24,45-49,1962,1.123437646210117
STAT,1915,25,50-100,1940,1.0313770346040492
SIM,1812,62,na,1874,902
SIM,1847,34,35-39,1881,10
SIM,1887,8,na,1895,2870
STAT,1943,15,20-24,1958,145.24224573107685
STAT,1929,18,40-44,1947,1.7995003230885296
STAT,1820,54,na,1874,1167.678693238062
SIM,1846,24,40-44,1870,1
STAT,1820,35,35-39,1855,19.919835842158662
STAT,1843,24,15-19,1867,2.752975020722103
STAT,1843,42,45-49,1885,1.0393280632582385
STAT,1848,46,45-49,1894,0.19323125990931758
STAT,1948,19,20-24,1967,156.62923393668493
SIM,1879,33,35-39,1912,15
STAT,1868,42,15-19,1910,0.013314090439146962
STAT,1918,40,30-34,1958,0.1376098719078827
STAT,1871,30,20-24,1901,2.7341165505671223
STAT,1850,54,20-24,1904,5.494969769065243E-4
SIM,1869,96,na,1965,25
SIM,1902,38,na,1940,3607
STAT,1913,41,25-29,1954,0.07066650374588852
SIM,1923,25,50-100,1948,2
STAT,1805,106,na,1911,0.004819959942966264
SIM,1815,76,na,1891,393
STAT,1779,83,na,1862,149.81838554536535
STAT,1768,103,na,1871,0.09131289406943888
STAT,1909,33,15-19,1942,0.12322179157969204
STAT,1829,53,na,1882,1313.707607894694
STAT,1831,27,50-100,1858,0.5572092200229657
STAT,1844,35,20-24,1879,0.7230805244038773
STAT,1812,44,40-44,1856,5.420610973617962
STAT,1849,39,20-24,1888,0.6040362442140159
STAT,1942,22,45-49,1964,1.1911317378519406
SIM,1838,32,35-39,1870,16
STAT,1853,41,25-29,1894,0.5334516660081671
SIM,1888,35,35-39,1923,17
SIM,1902,36,40-44,1938,2
STAT,1880,74,na,1954,1177.1643898424345
STAT,1912,44,45-49,1956,0.16069089836417066
STAT,1883,23,40-44,1906,2.0532128286244484
SIM,1855,26,40-44,1881,4
SIM,1820,44,40-44,1864,5
SIM,1843,33,20-24,1876,2
SIM,1837,17,25-29,1854,7
STAT,1838,24,40-44,1862,1.783917801307075
STAT,1834,40,45-49,1874,1.1024112117233176
STAT,1864,19,35-39,1883,0.5112521878782572
SIM,1867,30,na,1897,2207
SIM,1941,20,45-49,1961,1
STAT,1875,59,na,1934,2015.7949992561607
STAT,1927,42,30-34,1969,0.162060186874102
STAT,1912,21,20-24,1933,107.83700428631205
STAT,1852,26,15-19,1878,0.4036675478732662
STAT,1865,34,45-49,1899,1.5944812855494737
SIM,1920,21,20-24,1941,144
STAT,1903,38,40-44,1941,1.3523373033646628
SIM,1906,19,25-29,1925,12
SIM,1875,96,na,1971,12
STAT,1869,18,40-44,1887,0.18101775820073204
SIM,1852,31,na,1883,1888
SIM,1969,1,na,1970,5011
STAT,1871,49,40-44,1920,0.16819945902807937
STAT,1877,44,15-19,1921,0.014201373640675963
STAT,1835,53,na,1888,1614.5781654770453
SIM,1892,37,na,1929,3239
STAT,1869,100,na,1969,7.032982006645257
STAT,1898,15,50-100,1913,0.06739177386190377
STAT,1880,32,20-24,1912,2.8671627841359197
SIM,1851,42,45-49,1893,2
SIM,1923,37,na,1960,4451
STAT,1835,33,20-24,1868,2.5572085989279274
STAT,1813,41,20-24,1854,0.6123423477274457
STAT,1831,50,50-100,1881,0.010325659845780778
STAT,1933,20,45-49,1953,1.51717746133011
STAT,1850,97,na,1947,4.11360013716291
STAT,1861,32,40-44,1893,3.639719932151435
STAT,1864,33,20-24,1897,2.4531369629421462
STAT,1882,29,30-34,1911,24.460567582692565
STAT,1910,46,20-24,1956,0.010428430493966308
STAT,1887,38,20-24,1925,0.8649331707409954
SIM,1816,40,30-34,1856,4
STAT,1879,23,na,1902,2485.05818111055
SIM,1924,21,15-19,1945,7
SIM,1858,36,50-100,1894,1
STAT,1842,27,35-39,1869,10.743102764985315
STAT,1861,49,na,1910,1848.8214799860345
STAT,1884,37,40-44,1921,4.359970925036791
SIM,1841,29,35-39,1870,11
STAT,1940,25,50-100,1965,1.0255747653426768
SIM,1834,31,35-39,1865,13
SIM,1859,44,45-49,1903,5
SIM,1965,1,na,1966,5222
SIM,1927,16,45-49,1943,5
SIM,1832,41,50-100,1873,1
STAT,1875,31,30-34,1906,18.18353116496258
SIM,1846,38,25-29,1884,8
SIM,1949,22,30-34,1971,3
STAT,1840,19,25-29,1859,5.082648768584293
SIM,1843,37,45-49,1880,4
SIM,1936,5,na,1941,3973
SIM,1883,39,40-44,1922,10
STAT,1849,44,35-39,1893,1.3966794871873522
STAT,1861,44,35-39,1905,1.4992658251194424
STAT,1883,50,20-24,1933,7.398192669982873E-4
SIM,1919,7,na,1926,4386
STAT,1880,16,15-19,1896,6.310300539037574
SIM,1860,34,40-44,1894,10
STAT,1866,53,25-29,1919,0.003259418383613984
STAT,1887,42,na,1929,2603.051417566868
SIM,1890,29,30-34,1919,41
SIM,1879,2,na,1881,3394
SIM,1844,14,na,1858,2045
SIM,1904,30,50-100,1934,3
SIM,1823,38,30-34,1861,7
SIM,1848,28,na,1876,1870
SIM,1881,23,20-24,1904,65
STAT,1833,21,25-29,1854,57.60338535664674
SIM,1916,17,na,1933,4137
SIM,1948,3,na,1951,5058
STAT,1811,50,30-34,1861,0.0147566322225519
STAT,1916,21,15-19,1937,5.64610668425069
SIM,1878,26,na,1904,2775
SIM,1832,23,25-29,1855,53
SIM,1835,23,50-100,1858,1
STAT,1889,46,30-34,1935,0.12089643368368988
STAT,1824,36,30-34,1860,7.66419929232312
SIM,1808,63,na,1871,837
STAT,1828,31,na,1859,1886.84877893664
STAT,1893,22,35-39,1915,7.483661682808911
SIM,1886,40,50-100,1926,1
STAT,1844,35,45-49,1879,1.8699532895732907
STAT,1888,17,30-34,1905,1.900070384156277
STAT,1838,38,25-29,1876,2.301691672890163
SIM,1855,6,na,1861,2594
SIM,1894,32,45-49,1926,3
STAT,1871,51,40-44,1922,0.01061424164640871
STAT,1874,52,20-24,1926,7.59085917364265E-4
SIM,1835,53,na,1888,1243
SIM,1841,21,25-29,1862,58
STAT,1854,54,45-49,1908,0.010591866193445593
STAT,1895,61,na,1956,2488.433355823202
SIM,1799,85,na,1884,109
SIM,1852,35,45-49,1887,4
STAT,1863,52,45-49,1915,0.012917874299604388
SIM,1830,28,20-24,1858,12
SIM,1827,34,na,1861,1604
SIM,1895,25,15-19,1920,3
STAT,1891,27,30-34,1918,31.48941642650306
SIM,1910,12,na,1922,3754
STAT,1847,36,25-29,1883,2.260044770408931
STAT,1895,30,45-49,1925,2.318525632310848
SIM,1836,70,na,1906,998
STAT,1856,111,na,1967,6.280160715206134E-4
STAT,1845,28,15-19,1873,0.4006146122476295
STAT,1864,45,15-19,1909,3.6818901574205707E-4
STAT,1901,48,20-24,1949,0.009463515931865505
STAT,1871,23,50-100,1894,0.40792238119222346
STAT,1842,78,na,1920,703.4609772179783
STAT,1900,39,15-19,1939,0.01683400364690739
STAT,1855,35,20-24,1890,0.5857445776232565
STAT,1908,15,30-34,1923,2.3977954258097003
STAT,1887,25,15-19,1912,0.5150868002730326
SIM,1827,41,45-49,1868,4
SIM,1844,48,50-100,1892,4
SIM,1795,71,na,1866,536
SIM,1829,26,30-34,1855,7
SIM,1939,15,25-29,1954,74
STAT,1882,11,na,1893,2530.3617567174697
SIM,1820,87,na,1907,58
STAT,1855,47,15-19,1902,2.996843959173902E-4
STAT,1853,30,na,1883,2074.8624584317754
STAT,1831,26,20-24,1857,10.461220076720474
STAT,1871,18,15-19,1889,5.958029952738034
STAT,1873,26,25-29,1899,43.46146784659186
SIM,1842,30,30-34,1872,32
STAT,1886,32,45-49,1918,1.8595997787246341
STAT,1919,37,na,1956,4080.8810765895155
SIM,1896,17,30-34,1913,5
STAT,1819,70,na,1889,746.0262952617957
SIM,1825,33,35-39,1858,1
SIM,1883,48,50-100,1931,5
STAT,1870,42,35-39,1912,1.7937327152106244
STAT,1873,43,15-19,1916,0.01403787235863809
STAT,1884,24,35-39,1908,5.775724174206302
STAT,1802,52,30-34,1854,0.01736943698875571
STAT,1835,42,40-44,1877,2.0235864014392817
STAT,1812,48,na,1860,1372.7702366282588
STAT,1856,34,25-29,1890,7.863417521636766
STAT,1915,23,na,1938,3797.2291870018457
STAT,1793,107,na,1900,8.511559846541526E-4
STAT,1853,33,45-49,1886,1.469723632581451
STAT,1851,25,35-39,1876,8.678546909328912
STAT,1879,39,25-29,1918,3.004130677983683
STAT,1898,44,30-34,1942,0.10783572481685154
STAT,1866,80,na,1946,578.5313998226088
STAT,1949,19,35-39,1968,4.927029148786044
STAT,1823,44,15-19,1867,0.01946845413820517
SIM,1840,22,20-24,1862,58
SIM,1869,97,na,1966,14
SIM,1912,9,na,1921,3984
SIM,1890,21,20-24,1911,98
STAT,1869,40,45-49,1909,1.4844677122607097
SIM,1894,64,na,1958,2525
STAT,1803,51,35-39,1854,0.03811918036892757
STAT,1890,35,15-19,1925,0.06996194669988459
SIM,1872,4,na,1876,3088
STAT,1919,21,40-44,1940,3.7286877018240894
SIM,1865,83,na,1948,282
STAT,1896,36,20-24,1932,1.0355243825526692
STAT,1847,49,30-34,1896,0.07096446438180962
STAT,1852,34,40-44,1886,3.335305172549572
SIM,1887,39,25-29,1926,4
STAT,1889,2,na,1891,3319.797409406994
STAT,1923,42,na,1965,4385.917469970235
STAT,1889,33,25-29,1922,12.702249297791358
SIM,1864,34,25-29,1898,21
STAT,1847,16,30-34,1863,1.4982920419404475
SIM,1892,24,35-39,1916,10
SIM,1877,40,45-49,1917,4
STAT,1833,34,30-34,1867,15.634360566292766
STAT,1835,37,45-49,1872,1.8504771052657742
STAT,1875,51,25-29,1926,0.0036914156212446837
STAT,1882,21,20-24,1903,67.62391871370266
SIM,1890,50,na,1940,2981
STAT,1883,16,40-44,1899,0.18122012906969115
SIM,1822,46,50-100,1868,2
SIM,1927,21,40-44,1948,7
STAT,1834,30,30-34,1864,13.598708783705126
STAT,1832,22,20-24,1854,105.48716005683058
SIM,1886,45,na,1931,2552
STAT,1829,45,20-24,1874,0.009188986071210778
STAT,1821,84,na,1905,199.2625671424004
STAT,1833,29,35-39,1862,8.901291422575545
STAT,1912,49,35-39,1961,0.1242769846473108
STAT,1866,19,45-49,1885,0.06196920550573381
STAT,1919,16,45-49,1935,0.11210053493774512
STAT,1825,98,na,1923,2.370651887775294
SIM,1843,42,40-44,1885,8
SIM,1897,33,25-29,1930,24
SIM,1874,33,30-34,1907,24
STAT,1948,18,na,1966,4253.83998728343
SIM,1854,43,50-100,1897,4
SIM,1838,19,35-39,1857,1
SIM,1876,41,40-44,1917,5
SIM,1892,37,40-44,1929,6
STAT,1950,20,50-100,1970,0.7891886532376525
SIM,1841,34,30-34,1875,23
STAT,1817,46,40-44,1863,0.3740422466402293
STAT,1865,31,na,1896,2209.7835099249874
SIM,1778,91,na,1869,5
SIM,1824,37,35-39,1861,14
STAT,1852,51,30-34,1903,0.004535965123100214
STAT,1892,43,25-29,1935,0.807977342518939
SIM,1881,14,na,1895,2279
STAT,1878,81,na,1959,709.6981171333248
SIM,1875,32,35-39,1907,14
SIM,1852,33,na,1885,1785
SIM,1827,66,na,1893,898
STAT,1791,69,na,1860,619.6430092264361
STAT,1818,45,45-49,1863,0.4329552776143316
STAT,1868,41,40-44,1909,2.1810296291286906
STAT,1825,52,25-29,1877,0.004583352550058833
SIM,1857,64,na,1921,1469
SIM,1853,50,na,1903,1631
STAT,1850,26,30-34,1876,22.85531243086436
STAT,1885,36,45-49,1921,2.0137733641831574
STAT,1877,19,20-24,1896,18.3815266899088
STAT,1836,50,na,1886,1429.137038669706
STAT,1820,67,na,1887,798.7254193427732
SIM,1882,31,na,1913,2103
STAT,1841,40,15-19,1881,0.011009768885837072
STAT,1803,87,na,1890,73.44337532818668
SIM,1851,23,35-39,1874,8
STAT,1833,51,20-24,1884,5.508351680466159E-4
STAT,1890,15,20-24,1905,21.981516025646183
STAT,1963,3,na,1966,5046.582386921624
SIM,1856,32,25-29,1888,18
SIM,1896,34,20-24,1930,3
STAT,1798,91,na,1889,22.636960327590533
SIM,1953,17,na,1970,4606
STAT,1825,35,35-39,1860,12.699502309164231
STAT,1898,19,40-44,1917,0.24908945314477826
SIM,1876,45,50-100,1921,3
STAT,1854,39,20-24,1893,0.5726892687292893
STAT,1813,53,45-49,1866,0.03933038309235484
SIM,1823,52,na,1875,1354
STAT,1874,47,25-29,1921,0.05929160475892202
SIM,1949,17,35-39,1966,4
STAT,1865,37,30-34,1902,4.915235101425289
SIM,1865,39,50-100,1904,1
STAT,1834,38,40-44,1872,3.2092721698707147
STAT,1837,39,20-24,1876,0.6271136725954455
STAT,1882,41,15-19,1923,0.013571946416592044
SIM,1839,28,40-44,1867,6
STAT,1830,53,45-49,1883,0.01046574049668917
STAT,1827,40,40-44,1867,2.5042198017874027
SIM,1857,25,50-100,1882,1
STAT,1862,98,na,1960,5.933164894372876
STAT,1814,46,15-19,1860,9.81113708208499E-4
STAT,1892,26,35-39,1918,12.270817290447564
SIM,1842,38,40-44,1880,1
STAT,1840,24,20-24,1864,60.55289143942672
STAT,1940,22,na,1962,3755.6066635004977
STAT,1875,26,35-39,1901,10.042382252895017
STAT,1865,32,25-29,1897,9.446303322759924
SIM,1893,33,40-44,1926,9
STAT,1899,40,30-34,1939,0.11178051658822637
STAT,1860,23,35-39,1883,4.93093460857629
SIM,1923,45,50-100,1968,1
STAT,1894,31,40-44,1925,5.662231123125562
STAT,1946,5,na,1951,4446.233122408407
STAT,1857,12,na,1869,2211.676974841862
STAT,1809,52,40-44,1861,0.03381254615981393
SIM,1843,37,50-100,1880,4
SIM,1917,48,50-100,1965,2
SIM,1816,50,na,1866,1243
STAT,1876,43,40-44,1919,2.3286970450130666
STAT,1888,34,20-24,1922,3.1947594488020705
SIM,1867,42,na,1909,2078
STAT,1843,23,35-39,1866,4.904817637720064
STAT,1848,51,na,1899,1766.3831793969812
STAT,1881,37,15-19,1918,0.05467014159874854
STAT,1864,14,na,1878,2450.9019618273355
STAT,1897,35,25-29,1932,3.935627775518224
SIM,1864,39,30-34,1903,4
STAT,1792,86,na,1878,69.0127806610767
STAT,1848,45,30-34,1893,0.07982110469756129
STAT,1870,6,na,1876,2744.883755174722
STAT,1872,27,20-24,1899,11.912360672331749
SIM,1840,32,na,1872,1903
STAT,1855,18,30-34,1873,1.4185647243040436
SIM,1826,42,40-44,1868,6
STAT,1853,8,na,1861,2442.8756430836834
STAT,1838,18,30-34,1856,1.4010577768190218
STAT,1899,48,40-44,1947,0.13218016798435062
STAT,1777,106,na,1883,0.009746301160149972
STAT,1880,44,45-49,1924,1.566073651676843
STAT,1923,10,na,1933,4715.220751055723
SIM,1879,27,50-100,1906,1
SIM,1897,36,50-100,1933,2
SIM,1903,42,na,1945,3130
STAT,1831,46,15-19,1877,3.026387938572204E-4
STAT,1845,102,na,1947,0.21421887304854645
STAT,1871,59,na,1930,1950.1189751328905
SIM,1844,46,na,1890,1505
SIM,1835,40,40-44,1875,5
STAT,1848,28,40-44,1876,2.89880348100225
STAT,1936,17,na,1953,3557.6638270923636
SIM,1842,25,35-39,1867,10
SIM,1856,28,40-44,1884,3
SIM,1907,56,na,1963,3372
STAT,1839,42,25-29,1881,0.4798366323972538
SIM,1889,10,na,1899,3222
STAT,1872,50,45-49,1922,0.014947973840358657
SIM,1873,37,30-34,1910,5
SIM,1926,32,50-100,1958,2
STAT,1868,28,na,1896,2295.580115322534
STAT,1819,41,45-49,1860,3.3226643435348033
STAT,1865,54,20-24,1919,6.618358909189618E-4
STAT,1891,47,25-29,1938,0.04044011576854618
SIM,1766,90,na,1856,17
STAT,1854,26,15-19,1880,0.39509231767437425
SIM,1848,29,45-49,1877,2
SIM,1882,27,30-34,1909,4
SIM,1884,43,40-44,1927,5
SIM,1867,43,40-44,1910,6
STAT,1855,50,45-49,1905,0.01108077608866216
SIM,1865,18,40-44,1883,2
SIM,1817,47,45-49,1864,3
STAT,1870,25,45-49,1895,1.1086563865142904
SIM,1916,15,30-34,1931,3
STAT,1820,43,35-39,1863,3.300028761404322
STAT,1875,21,50-100,1896,0.4242443183303665
STAT,1876,38,45-49,1914,2.0685822298484142
STAT,1908,53,na,1961,3282.5553776594215
STAT,1840,87,na,1927,123.50055469137263
STAT,1875,39,40-44,1914,4.494725131076129
STAT,1877,64,na,1941,1812.1053460968617
STAT,1838,43,20-24,1881,0.11170111358829907
STAT,1863,29,20-24,1892,10.423322004732693
SIM,1836,27,na,1863,2101
STAT,1860,17,50-100,1877,0.046650657351585356
STAT,1881,25,20-24,1906,11.498821832167772
STAT,1849,25,na,1874,2034.0518527591464
STAT,1858,61,na,1919,1480.6817556086085
SIM,1871,41,50-100,1912,1
SIM,1867,38,45-49,1905,3
SIM,1862,11,na,1873,2462
STAT,1808,48,40-44,1856,0.6086098821643166
SIM,1883,26,35-39,1909,15
SIM,1851,36,40-44,1887,5
SIM,1866,25,na,1891,2398
SIM,1868,42,45-49,1910,2
SIM,1888,35,25-29,1923,4
SIM,1846,18,30-34,1864,4
SIM,1861,30,40-44,1891,4
STAT,1873,50,na,1923,2236.3307374955457
STAT,1874,18,40-44,1892,0.18866084939802613
STAT,1845,11,na,1856,2214.724358025
STAT,1832,68,na,1900,1040.5866692985956
SIM,1895,38,na,1933,3188
STAT,1899,35,35-39,1934,9.89725437403886
STAT,1829,28,30-34,1857,28.261587534487017
STAT,1809,47,45-49,1856,0.844242885524846
STAT,1860,36,40-44,1896,3.631577834719302
STAT,1857,18,40-44,1875,0.16845406760538226
SIM,1891,24,na,1915,3021
SIM,1879,75,na,1954,1168
STAT,1841,23,25-29,1864,53.84123137819739
STAT,1864,28,25-29,1892,38.417265999941414
STAT,1872,47,15-19,1919,4.0427443661824664E-4
SIM,1875,61,na,1936,1846
SIM,1883,80,na,1963,1066
STAT,1843,36,40-44,1879,3.4827410882582206
SIM,1852,40,40-44,1892,6
STAT,1819,38,15-19,1857,0.147868138410664
STAT,1834,50,25-29,1884,0.0022503029505771617
STAT,1858,93,na,1951,23.157809837296007
STAT,1850,46,25-29,1896,0.044230338008922156
STAT,1908,21,na,1929,3552.184609741437
STAT,1902,44,20-24,1946,0.015527792081183578
SIM,1816,82,na,1898,176
SIM,1831,24,20-24,1855,68
STAT,1886,29,15-19,1915,0.4803672230899037
SIM,1855,33,20-24,1888,2
STAT,1848,32,25-29,1880,9.752349740322996
STAT,1865,41,15-19,1906,0.01279382652533053
SIM,1884,38,45-49,1922,3
STAT,1849,53,25-29,1902,0.0027248684135636027
SIM,1833,35,35-39,1868,13
SIM,1883,31,30-34,1914,36
STAT,1896,19,30-34,1915,2.1194503920417977
STAT,1844,40,40-44,1884,1.8699033339823248
STAT,1859,43,40-44,1902,1.8139677394727636
STAT,1874,27,30-34,1901,26.04285862241124
STAT,1939,17,25-29,1956,43.790965881608905
SIM,1893,38,50-100,1931,2
STAT,1812,91,na,1903,26.308949364494808
SIM,1820,41,35-39,1861,2
SIM,1922,34,50-100,1956,2
STAT,1890,23,20-24,1913,84.78629885837488
STAT,1948,16,50-100,1964,0.4332482350824207
SIM,1839,36,40-44,1875,12
STAT,1922,21,50-100,1943,0.7645917563155614
SIM,1876,44,45-49,1920,3
SIM,1826,44,50-100,1870,1
STAT,1818,44,50-100,1862,1.9417980194906275
STAT,1847,33,20-24,1880,2.3517460832186057
STAT,1856,39,30-34,1895,4.085402813642615
STAT,1811,53,35-39,1864,0.020097718651998477
SIM,1896,23,na,1919,3092
STAT,1843,52,na,1895,1444.5112249791807
SIM,1866,57,na,1923,2038
STAT,1893,47,35-39,1940,0.10080437493156169
STAT,1898,27,40-44,1925,4.1015523580332705
STAT,1827,35,45-49,1862,2.4309614134551856
STAT,1849,41,30-34,1890,0.902938615060084
SIM,1893,28,45-49,1921,2
SIM,1896,29,25-29,1925,69
SIM,1947,17,25-29,1964,58
STAT,1842,24,30-34,1866,19.93798080386627
SIM,1816,43,35-39,1859,3
STAT,1833,46,25-29,1879,0.04852926574145124
STAT,1837,47,20-24,1884,0.008498144013228731
STAT,1888,29,25-29,1917,50.06759948765474
SIM,1893,41,40-44,1934,4
SIM,1834,79,na,1913,373
SIM,1893,47,na,1940,2905
STAT,1824,40,15-19,1864,0.0178819427824331
STAT,1865,24,25-29,1889,52.67227939144776
STAT,1803,55,na,1858,1335.8687303248564
SIM,1873,24,25-29,1897,71
SIM,1826,37,45-49,1863,6
STAT,1840,16,20-24,1856,16.185537685396095
STAT,1855,38,25-29,1893,2.15648225894399
STAT,1807,69,na,1876,710.5019221408403
SIM,1800,67,na,1867,753
STAT,1936,16,45-49,1952,0.48402078150916467
SIM,1929,26,20-24,1955,28
STAT,1910,49,25-29,1959,0.04963965019197283
STAT,1925,15,30-34,1940,14.94945352851068
STAT,1868,44,45-49,1912,1.425192459330028
STAT,1911,15,50-100,1926,0.07598928511341259
STAT,1857,43,30-34,1900,0.8996731387738063
STAT,1894,26,45-49,1920,1.4487210442461063
STAT,1900,57,na,1957,2863.5204032776555
STAT,1892,18,35-39,1910,0.6936005412626681
SIM,1841,26,30-34,1867,26
STAT,1824,49,na,1873,1257.2687191088917
SIM,1931,38,na,1969,4918
STAT,1860,28,40-44,1888,2.4817688816635113
SIM,1833,27,35-39,1860,10
STAT,1843,44,40-44,1887,1.5224738896890588
STAT,1859,51,40-44,1910,0.008592902210201467
STAT,1927,23,40-44,1950,4.174179992558357
STAT,1820,35,na,1855,1446.6215014436605
SIM,1824,42,30-34,1866,1
STAT,1841,36,30-34,1877,4.744758036446319
SIM,1858,81,na,1939,334
SIM,1883,34,35-39,1917,16
STAT,1826,47,45-49,1873,0.23255469492998268
SIM,1843,34,40-44,1877,7
STAT,1890,43,50-100,1933,1.2944129488284184
STAT,1853,30,40-44,1883,3.770711388223358
STAT,1916,40,na,1956,3851.4971448013207
STAT,1862,66,na,1928,1429.5779253198098
STAT,1854,51,40-44,1905,0.007938662097294713
STAT,1883,33,30-34,1916,17.18386097109177
STAT,1850,30,15-19,1880,0.12798261314278647
STAT,1847,19,35-39,1866,0.5067447432221516
STAT,1867,32,35-39,1899,9.633087211937099
SIM,1859,41,40-44,1900,6
SIM,1855,19,35-39,1874,2
SIM,1891,33,30-34,1924,39
STAT,1823,32,20-24,1855,7.231855674023545
SIM,1908,21,30-34,1929,2
STAT,1818,37,45-49,1855,5.036188805574922
STAT,1875,34,35-39,1909,10.414039154019415
STAT,1882,24,25-29,1906,55.655496883774724
STAT,1861,103,na,1964,0.5362516283080209
STAT,1907,36,na,1943,3538.9764707529616
STAT,1835,34,40-44,1869,4.060337274402546
STAT,1903,22,na,1925,3401.9172790182797
STAT,1851,38,50-100,1889,0.9298811758261908
STAT,1869,45,na,1914,2231.275525953015
SIM,1850,24,30-34,1874,30
STAT,1861,41,30-34,1902,0.969259604769058
SIM,1881,26,25-29,1907,39
STAT,1885,28,45-49,1913,1.1123004867147772
SIM,1878,38,20-24,1916,1
SIM,1823,33,25-29,1856,8
STAT,1896,39,25-29,1935,3.8105186629878833
STAT,1840,44,15-19,1884,0.00984273021499454
STAT,1856,27,na,1883,1914.9462777270128
STAT,1844,52,35-39,1896,0.006775091279417697
STAT,1852,13,na,1865,2179.7435170325944
STAT,1833,26,30-34,1859,23.73836880210078
STAT,1853,50,35-39,1903,0.007221799965561107
STAT,1858,34,35-39,1892,7.955848226920374
STAT,1873,35,15-19,1908,0.05804325097686986
SIM,1840,25,25-29,1865,45
STAT,1774,108,na,1882,0.0032849571538917767
STAT,1842,15,40-44,1857,0.21397624410766028
SIM,1919,19,15-19,1938,57
STAT,1873,23,20-24,1896,70.34213106086516
SIM,1840,17,25-29,1857,6
SIM,1828,51,na,1879,1386
SIM,1868,34,45-49,1902,3
STAT,1885,41,40-44,1926,2.2715136208123137
SIM,1933,15,30-34,1948,21
SIM,1865,43,30-34,1908,2
SIM,1857,96,na,1953,3
STAT,1848,48,35-39,1896,0.11286794683747
SIM,1853,82,na,1935,261
STAT,1899,11,na,1910,3585.0916084040487
SIM,1896,25,50-100,1921,2
SIM,1902,57,na,1959,3046
SIM,1835,35,45-49,1870,1
SIM,1910,44,na,1954,3238
SIM,1829,29,35-39,1858,7
STAT,1835,45,45-49,1880,0.2105791980370667
SIM,1907,24,na,1931,3672
STAT,1818,50,40-44,1868,0.01873798004941138
STAT,1832,25,25-29,1857,39.76982535036559
STAT,1891,31,15-19,1922,0.17880542844829142
STAT,1937,20,50-100,1957,0.6473207031265031
SIM,1903,10,na,1913,3544
SIM,1915,2,na,1917,4633
STAT,1790,109,na,1899,1.3137637111172002E-4
SIM,1824,34,30-34,1858,28
SIM,1900,32,50-100,1932,1
STAT,1881,45,15-19,1926,3.933082637424083E-4
STAT,1897,48,30-34,1945,0.07300701801778485
STAT,1829,48,25-29,1877,0.04241840394039145
SIM,1847,34,25-29,1881,13
STAT,1882,19,50-100,1901,0.04767404072952007
SIM,1881,31,50-100,1912,1
STAT,1856,31,20-24,1887,2.140844910589564
STAT,1895,27,15-19,1922,0.5984170329295085
STAT,1857,52,20-24,1909,5.785642930869059E-4
SIM,1838,16,30-34,1854,1
STAT,1844,27,45-49,1871,1.0753763422388725
STAT,1852,37,45-49,1889,1.5200476081870906
STAT,1880,41,40-44,1921,2.3966258124258037
SIM,1897,30,20-24,1927,5
STAT,1836,18,20-24,1854,27.17091370947782
STAT,1889,30,20-24,1919,3.3934330540014526
STAT,1857,44,na,1901,1797.2304650536635
SIM,1944,24,na,1968,3972
STAT,1771,92,na,1863,8.521676761670225
SIM,1844,18,20-24,1862,24
STAT,1847,54,50-100,1901,0.010997025572551543
STAT,1820,51,35-39,1871,0.014335165823153381
STAT,1834,33,35-39,1867,7.645652745618612
STAT,1947,16,20-24,1963,154.30693114549626
SIM,1829,38,25-29,1867,5
STAT,1879,44,20-24,1923,0.16512947147105442
SIM,1940,10,na,1950,4211
SIM,1860,37,45-49,1897,2
SIM,1864,31,20-24,1895,1
SIM,1955,16,20-24,1971,179
SIM,1842,33,35-39,1875,18
STAT,1897,40,20-24,1937,0.015083649447340723
STAT,1839,34,25-29,1873,8.75272261966983
STAT,1883,25,30-34,1908,25.057923451635
STAT,1886,25,na,1911,2562.237600043997
STAT,1840,27,25-29,1867,36.97268022134224
STAT,1887,74,na,1961,1446.0363777837829
SIM,1853,31,45-49,1884,3
SIM,1871,79,na,1950,542
STAT,1883,60,na,1943,1885.0017178843996
SIM,1848,38,35-39,1886,9
SIM,1854,24,15-19,1878,3
STAT,1910,38,20-24,1948,0.2530994441290662
SIM,1882,22,25-29,1904,1
STAT,1889,38,30-34,1927,6.604503595347822
STAT,1828,36,15-19,1864,0.059163296840279295
SIM,1819,47,na,1866,1429
STAT,1880,48,50-100,1928,0.257237174244784
STAT,1854,79,na,1933,524.6690970937952
SIM,1822,35,na,1857,1752
STAT,1827,43,45-49,1870,1.5825462019615497
STAT,1850,65,na,1915,1294.0276453672013
STAT,1891,47,na,1938,2800.781357191838
SIM,1856,15,na,1871,2453
SIM,1859,29,20-24,1888,10
SIM,1863,27,20-24,1890,8
SIM,1896,37,25-29,1933,5
SIM,1826,49,na,1875,1772
STAT,1842,32,30-34,1874,18.98965423711279
SIM,1876,36,45-49,1912,4
STAT,1870,30,40-44,1900,4.335677322916897
SIM,1891,25,30-34,1916,44
STAT,1861,52,35-39,1913,0.007186947627383702
SIM,1812,68,na,1880,731
STAT,1833,54,25-29,1887,0.0024914919910792002
STAT,1824,44,30-34,1868,1.3702787251146302
STAT,1906,15,20-24,1921,26.201678072087727
STAT,1851,42,25-29,1893,0.4856348343948579
SIM,1871,29,20-24,1900,13
STAT,1884,45,40-44,1929,0.17221429914551045
STAT,1812,107,na,1919,0.0021410951378309814
SIM,1811,83,na,1894,152
STAT,1832,36,na,1868,1848.8200844093421
STAT,1891,9,na,1900,3244.532097863278
STAT,1868,36,45-49,1904,1.9335562566703761
STAT,1888,37,25-29,1925,3.432324589395117
SIM,1881,46,na,1927,2000
STAT,1829,37,20-24,1866,0.6317251604289735
SIM,1909,33,40-44,1942,4
STAT,1876,52,30-34,1928,0.006174528124110688
STAT,1933,17,50-100,1950,0.506804300094964
STAT,1845,31,45-49,1876,1.5308267961503037
STAT,1866,45,25-29,1911,0.054406450444764096
SIM,1849,42,35-39,1891,1
STAT,1917,16,35-39,1933,0.913692907520166
STAT,1817,54,40-44,1871,0.0208268738387245
STAT,1929,15,na,1944,4769.935272988374
STAT,1831,51,na,1882,1430.9026020826695
STAT,1852,21,35-39,1873,5.2954042651681235
STAT,1831,41,45-49,1872,1.1722724145566574
STAT,1894,12,na,1906,3358.127951215772
SIM,1957,8,na,1965,5437
STAT,1860,39,45-49,1899,1.6293105606681584
STAT,1898,26,na,1924,3278.862253886915
SIM,1878,58,na,1936,2290
STAT,1878,48,20-24,1926,0.012423371290790563
STAT,1937,20,45-49,1957,1.106918360169562
SIM,1841,37,35-39,1878,12
SIM,1857,44,35-39,1901,1
SIM,1874,44,na,1918,2201
SIM,1925,16,35-39,1941,8
STAT,1841,53,20-24,1894,5.429666767062662E-4
STAT,1849,16,40-44,1865,0.17706861583112143
STAT,1886,17,50-100,1903,0.05224459649666626
SIM,1870,30,na,1900,2697
STAT,1852,29,45-49,1881,0.8797253921838563
STAT,1858,47,40-44,1905,0.1350241449226072
STAT,1833,37,35-39,1870,6.279297282901895
STAT,1897,32,20-24,1929,3.6601004812447946
STAT,1816,42,30-34,1858,3.298588156338368
SIM,1880,20,50-100,1900,1
STAT,1860,20,30-34,1880,16.90126847596486
STAT,1857,26,40-44,1883,2.4496989643339644
SIM,1849,13,na,1862,2430
SIM,1883,23,30-34,1906,30
SIM,1860,29,45-49,1889,3
STAT,1828,63,na,1891,1158.2938820031447
STAT,1892,35,25-29,1927,3.683689904557672
STAT,1811,45,35-39,1856,0.36041895221368025
SIM,1842,22,30-34,1864,29
SIM,1865,35,30-34,1900,12
SIM,1815,39,35-39,1854,21
SIM,1846,80,na,1926,303
SIM,1884,35,40-44,1919,3
STAT,1870,17,45-49,1887,0.06540324503953246
STAT,1921,47,35-39,1968,0.14679488466216364
STAT,1837,67,na,1904,1081.4032319075673
SIM,1806,72,na,1878,668
SIM,1932,23,na,1955,5444
STAT,1825,44,25-29,1869,0.8797051173765351
STAT,1838,51,20-24,1889,5.011812149568958E-4
SIM,1851,44,40-44,1895,7
STAT,1851,17,35-39,1868,0.5051425990919548
STAT,1854,34,15-19,1888,0.10719701346363478
SIM,1865,26,40-44,1891,3
STAT,1829,80,na,1909,364.74782566138293
SIM,1817,44,40-44,1861,4
STAT,1902,47,25-29,1949,0.046157191955467164
SIM,1860,21,35-39,1881,6
SIM,1855,36,25-29,1891,4
STAT,1826,39,45-49,1865,2.174206361063071
SIM,1834,39,45-49,1873,4
STAT,1876,35,40-44,1911,4.608402726010507
STAT,1896,28,20-24,1924,15.628818188453554
STAT,1850,51,20-24,1901,5.677385467119302E-4
STAT,1826,31,35-39,1857,15.09916652909275
SIM,1888,27,25-29,1915,58
STAT,1922,25,na,1947,4311.41833805859
STAT,1903,48,30-34,1951,0.07755517177936666
STAT,1790,95,na,1885,2.2800825306837647
STAT,1834,22,30-34,1856,14.193031542695175
STAT,1926,39,na,1965,4637.043239146864
STAT,1848,83,na,1931,324.123385805746
SIM,1920,22,na,1942,4393
STAT,1914,49,45-49,1963,0.2162012375787407
SIM,1924,36,na,1960,4510
STAT,1869,37,15-19,1906,0.05514144866677626
STAT,1871,21,45-49,1892,0.701821830853696
SIM,1822,37,25-29,1859,3
SIM,1893,7,na,1900,3433
STAT,1808,49,50-100,1857,0.8503993661065748
SIM,1860,35,50-100,1895,1
SIM,1816,49,50-100,1865,2
STAT,1912,26,50-100,1938,0.9929988355664263
STAT,1832,42,15-19,1874,0.011538323071661893
STAT,1848,37,30-34,1885,4.484181440006864
STAT,1841,28,30-34,1869,23.22155881913118
STAT,1880,52,45-49,1932,0.015311522570260746
SIM,1835,43,45-49,1878,2
SIM,1827,33,45-49,1860,2
STAT,1820,40,30-34,1860,2.3234445152147174
STAT,1846,24,15-19,1870,3.044871392885191
SIM,1880,42,45-49,1922,4
STAT,1796,105,na,1901,0.006142720599645164
STAT,1930,35,50-100,1965,0.5544765340668079
STAT,1841,20,20-24,1861,66.23067774449018
STAT,1849,49,40-44,1898,0.13105846226487555
STAT,1894,34,45-49,1928,2.2481397817675925
STAT,1889,49,35-39,1938,0.09629735518379409
SIM,1850,32,30-34,1882,7
STAT,1860,40,25-29,1900,0.5355316277873694
STAT,1805,51,45-49,1856,0.06087917978819656
STAT,1819,102,na,1921,0.14903929341925373
STAT,1872,42,45-49,1914,1.5178486727010385
STAT,1867,34,50-100,1901,0.8640909699031154
STAT,1876,58,na,1934,2062.323576133313
SIM,1906,16,25-29,1922,13
STAT,1886,24,45-49,1910,0.7389636605316626
SIM,1861,26,na,1887,2116
SIM,1889,39,35-39,1928,19
STAT,1881,28,25-29,1909,41.038237269828656
SIM,1919,22,45-49,1941,1
SIM,1894,24,45-49,1918,2
STAT,1833,29,50-100,1862,0.5901265001277675
STAT,1855,41,50-100,1896,0.7988115080191521
STAT,1834,49,45-49,1883,0.14528463854257184
SIM,1900,29,15-19,1929,1
STAT,1908,37,50-100,1945,0.3968149439623676
SIM,1891,36,35-39,1927,15
SIM,1876,28,45-49,1904,1
STAT,1835,51,30-34,1886,0.004645943449293875
SIM,1879,29,25-29,1908,9
STAT,1872,44,na,1916,2315.2026381761607
SIM,1867,31,na,1898,2163
STAT,1839,39,30-34,1878,4.422579823752814
STAT,1856,43,15-19,1899,0.010616341775618753
STAT,1820,34,45-49,1854,5.518126120005632
SIM,1886,13,na,1899,2903
STAT,1836,48,50-100,1884,0.16007909264375259
STAT,1917,41,25-29,1958,0.07532997355646034
SIM,1870,20,40-44,1890,4
STAT,1830,47,50-100,1877,0.20542612950606745
STAT,1827,32,40-44,1859,5.836574329415237
SIM,1873,21,20-24,1894,59
STAT,1768,93,na,1861,11.51493350570269
STAT,1810,53,50-100,1863,0.054234690572711755
STAT,1823,35,25-29,1858,5.452046389377767
STAT,1865,45,30-34,1910,0.09016440840275994
SIM,1870,32,35-39,1902,14
SIM,1822,67,na,1889,886
SIM,1875,41,25-29,1916,4
STAT,1821,52,na,1873,1440.5756900999795
STAT,1859,38,45-49,1897,1.6113480452201123
STAT,1867,41,25-29,1908,0.6135977273616977
SIM,1891,17,30-34,1908,3
SIM,1908,24,35-39,1932,13
STAT,1868,39,na,1907,2251.3144134861636
STAT,1825,66,na,1891,1196.082263142618
STAT,1938,26,20-24,1964,18.26489918366996
SIM,1763,93,na,1856,7
SIM,1880,19,20-24,1899,14
STAT,1842,40,30-34,1882,1.098703976500413
STAT,1851,46,40-44,1897,0.1299985953490935
STAT,1863,37,20-24,1900,0.689824781459025
STAT,1894,23,40-44,1917,2.701277511497736
STAT,1857,76,na,1933,746.7855589231781
SIM,1847,39,30-34,1886,5
STAT,1853,62,na,1915,1511.4907569881998
SIM,1871,37,20-24,1908,1
STAT,1881,17,20-24,1898,17.259885780895193
SIM,1831,35,25-29,1866,2
STAT,1864,52,50-100,1916,0.013691176959289977
SIM,1879,17,30-34,1896,5
STAT,1844,35,50-100,1879,1.1516613643646356
STAT,1818,54,35-39,1872,0.014148559739462885
STAT,1887,28,50-100,1915,0.7188073899883418
SIM,1863,42,45-49,1905,1
SIM,1866,43,25-29,1909,4
STAT,1797,104,na,1901,0.016653224993488567
STAT,1865,21,20-24,1886,64.79273733429841
STAT,1953,16,45-49,1969,0.6107094070773503
STAT,1872,33,na,1905,2412.8845588265945
STAT,1872,19,20-24,1891,17.905380464203358
STAT,1914,38,na,1952,3771.138685952712
STAT,1898,34,50-100,1932,1.2437906474947005
STAT,1910,24,na,1934,3593.021300378802
STAT,1866,28,35-39,1894,8.992227712833035
STAT,1874,31,15-19,1905,0.1478783992350933
STAT,1872,35,20-24,1907,0.7901697997853409
SIM,1845,18,15-19,1863,8
SIM,1948,22,15-19,1970,9
STAT,1854,21,45-49,1875,0.6193417836448214
SIM,1919,30,45-49,1949,5
STAT,1844,26,na,1870,2110.3729906731432
STAT,1857,22,25-29,1879,52.0925195816124
STAT,1879,52,20-24,1931,7.736264497049714E-4
STAT,1899,32,30-34,1931,24.201819716520262
SIM,1847,26,25-29,1873,40
STAT,1834,41,35-39,1875,1.3168487811220235
SIM,1871,47,na,1918,2139
STAT,1882,75,na,1957,1075.641614515544
STAT,1883,17,30-34,1900,1.5753348693370475
STAT,1819,59,na,1878,1104.8131703843248
SIM,1850,40,30-34,1890,1
STAT,1819,46,15-19,1865,7.912034301669892E-4
STAT,1846,48,25-29,1894,0.04316252899534697
STAT,1846,16,15-19,1862,5.69100250280915
STAT,1826,53,30-34,1879,0.005545818678623158
STAT,1815,105,na,1920,0.012692284816498877
STAT,1894,42,45-49,1936,0.13497716449579172
STAT,1842,41,20-24,1883,0.1498408549133199
STAT,1886,37,15-19,1923,0.05988283157907001
SIM,1860,84,na,1944,247
STAT,1893,44,30-34,1937,0.1010021331354662
SIM,1854,16,15-19,1870,6
STAT,1833,43,20-24,1876,0.13490962869201042
STAT,1824,41,50-100,1865,1.3401912575206467
STAT,1827,51,45-49,1878,0.014659359772624468
SIM,1843,29,na,1872,2460
STAT,1880,49,15-19,1929,4.154251188394429E-4
STAT,1889,37,40-44,1926,5.451716584010638
STAT,1837,18,15-19,1855,6.484926431553155
STAT,1856,47,30-34,1903,0.07460726581383642
SIM,1847,31,20-24,1878,3
STAT,1842,48,40-44,1890,0.1522005665928464
STAT,1890,39,30-34,1929,6.511355956416737
STAT,1833,30,15-19,1863,0.13292745309127058
STAT,1876,46,45-49,1922,0.24680968905085823
STAT,1879,47,25-29,1926,0.06042735431876503
SIM,1882,19,30-34,1901,1
STAT,1847,7,na,1854,2313.0
STAT,1873,45,50-100,1918,0.2539792596753891
SIM,1819,41,50-100,1860,1
STAT,1815,45,na,1860,1348.5040397238142
SIM,1854,99,na,1953,6
SIM,1863,38,25-29,1901,3
STAT,1921,39,35-39,1960,2.7218707459676073
SIM,1945,20,45-49,1965,1
STAT,1876,27,40-44,1903,3.1239026720000487
STAT,1901,30,50-100,1931,1.3077007478596077
STAT,1839,31,20-24,1870,2.382961558706852
SIM,1884,27,40-44,1911,10
SIM,1899,63,na,1962,2711
STAT,1843,47,45-49,1890,0.15843231936073013
SIM,1842,66,na,1908,1114
SIM,1882,38,35-39,1920,10
STAT,1843,20,30-34,1863,15.298692399815476
STAT,1885,45,35-39,1930,0.1421504717118792
STAT,1924,43,50-100,1967,0.14098363801341174
SIM,1851,48,na,1899,1751
STAT,1863,83,na,1946,355.2595996589188
STAT,1892,47,40-44,1939,0.12182154972643283
STAT,1836,21,50-100,1857,0.3419643099456415
STAT,1853,41,45-49,1894,1.2432865399118243
STAT,1874,38,35-39,1912,7.2784606500294196
STAT,1900,25,na,1925,3371.034818195585
STAT,1843,28,40-44,1871,2.468624064574853
SIM,1937,15,15-19,1952,48
STAT,1928,36,50-100,1964,0.5368079933863557
SIM,1880,35,20-24,1915,3
STAT,1850,33,na,1883,1891.7216643628042
SIM,1835,27,45-49,1862,1
STAT,1905,23,50-100,1928,0.5935735625303217
STAT,1938,31,50-100,1969,0.8397571240175649
SIM,1825,86,na,1911,73
SIM,1851,28,40-44,1879,4
STAT,1823,48,30-34,1871,0.13135126493587887
STAT,1824,81,na,1905,268.8415159759102
STAT,1867,97,na,1964,16.979088301448463
SIM,1832,44,30-34,1876,1
STAT,1807,53,20-24,1860,0.0024541827250601964
STAT,1870,50,35-39,1920,0.00866106355648369
SIM,1935,26,45-49,1961,2
STAT,1862,20,40-44,1882,1.887604520532372
STAT,1837,54,45-49,1891,0.009628390613414329
SIM,1889,42,na,1931,2765
STAT,1807,47,35-39,1854,0.504185031056998
STAT,1897,44,15-19,1941,0.0012809916623489257
STAT,1942,0,na,1942,4719.103825204558
STAT,1920,27,25-29,1947,72.91328341293372
STAT,1855,27,20-24,1882,9.204331792923625
STAT,1876,51,40-44,1927,0.011031213813536979
SIM,1814,48,na,1862,1331
STAT,1949,20,15-19,1969,6.279565514479382
SIM,1914,15,20-24,1929,28
STAT,1823,40,20-24,1863,0.24759683243777073
STAT,1838,84,na,1922,222.6935489680676
STAT,1834,70,na,1904,835.1497699298925
SIM,1895,17,15-19,1912,8
STAT,1859,5,na,1864,2371.098555902321
STAT,1861,19,45-49,1880,0.06227359398715504
STAT,1891,35,30-34,1926,6.727814544770507
STAT,1942,15,30-34,1957,12.867649009804575
STAT,1828,29,50-100,1857,0.8882652177260026
STAT,1878,40,50-100,1918,1.1188185308267429
STAT,1874,44,20-24,1918,0.16202581540908254
STAT,1927,26,45-49,1953,2.1301314367816286
STAT,1894,18,45-49,1912,0.08471861761146098
SIM,1835,32,40-44,1867,3
SIM,1858,32,35-39,1890,11
STAT,1808,51,35-39,1859,0.02975074235702087
STAT,1895,22,45-49,1917,0.919741614620852
STAT,1852,43,30-34,1895,0.8656007247884774
STAT,1861,81,na,1942,453.8528973459665
STAT,1912,58,na,1970,3379.0947242282755
SIM,1850,85,na,1935,215
SIM,1946,15,na,1961,4160
STAT,1822,36,20-24,1858,1.4963418209540178
STAT,1861,1,na,1862,3062.3091095084314
SIM,1830,36,20-24,1866,1
STAT,1857,46,35-39,1903,0.11066752243262458
SIM,1851,20,30-34,1871,20
SIM,1916,23,30-34,1939,36
STAT,1865,95,na,1960,23.83695074450775
STAT,1890,26,25-29,1916,52.3859164641502
SIM,1897,61,na,1958,2567
STAT,1853,42,35-39,1895,1.4956568297246295
STAT,1945,4,na,1949,4402.201393188388
STAT,1887,17,15-19,1904,6.6920721323155865
SIM,1950,15,30-34,1965,15
STAT,1908,23,30-34,1931,26.590212129005298
STAT,1888,1,na,1889,3368.416740289581
STAT,1962,2,na,1964,5091.80790439553
STAT,1828,31,45-49,1859,2.121838557718373
SIM,1892,33,25-29,1925,25
STAT,1800,90,na,1890,27.656148291872803
STAT,1841,105,na,1946,0.021926424211345014
STAT,1887,46,20-24,1933,0.013570171042831319
SIM,1924,25,30-34,1949,63
STAT,1877,31,40-44,1908,4.539168822956311
STAT,1943,19,na,1962,3938.4743231306056
STAT,1842,35,35-39,1877,7.626898698462318
SIM,1945,17,15-19,1962,56
STAT,1873,50,50-100,1923,0.01568607176258997
STAT,1833,25,40-44,1858,2.844267594474786
SIM,1907,25,30-34,1932,53
STAT,1898,23,25-29,1921,78.13899548733244
STAT,1865,16,25-29,1881,5.41738580514212
SIM,1927,24,45-49,1951,1
STAT,1929,15,15-19,1944,58.812721817853046
STAT,1860,54,50-100,1914,0.012126335447833548
STAT,1878,22,45-49,1900,0.7311101306466685
STAT,1911,29,25-29,1940,64.29601276413744
SIM,1873,16,25-29,1889,4
STAT,1845,36,15-19,1881,0.0435612564951157
STAT,1884,29,40-44,1913,2.962242565471264
SIM,1813,85,na,1898,109
SIM,1836,31,45-49,1867,5
SIM,1886,22,45-49,1908,5
STAT,1842,19,35-39,1861,0.6269379503199237
STAT,1883,42,20-24,1925,0.15677299701284955
STAT,1946,15,15-19,1961,50.866821464089725
STAT,1869,19,50-100,1888,0.04820129995853841
STAT,1909,48,50-100,1957,0.20914283414462095
SIM,1880,29,na,1909,2268
STAT,1827,27,45-49,1854,3.310277167998353
STAT,1886,57,na,1943,2143.0564299018693
STAT,1838,19,50-100,1857,0.04281163719288689
STAT,1882,43,na,1925,2244.86142234856
STAT,1928,41,na,1969,4792.432457096606
STAT,1863,41,40-44,1904,2.0219616204749893
STAT,1867,48,45-49,1915,0.22166766979931238
STAT,1832,46,30-34,1878,0.07916973411323981
STAT,1866,33,30-34,1899,16.259988467629384
SIM,1875,29,40-44,1904,3
STAT,1780,110,na,1890,0.0017814940933209792
STAT,1816,51,20-24,1867,0.0018695842513991765
SIM,1818,40,40-44,1858,2
SIM,1834,20,30-34,1854,25
STAT,1928,41,50-100,1969,0.1515953894293497
SIM,1850,35,35-39,1885,16
SIM,1925,42,na,1967,4532
STAT,1840,42,50-100,1882,0.772511768272889
STAT,1918,32,50-100,1950,0.8869920225275871
SIM,1892,29,40-44,1921,6
STAT,1937,17,15-19,1954,44.57183683854188
SIM,1881,18,25-29,1899,5
STAT,1887,20,45-49,1907,0.7910235493047174
STAT,1828,95,na,1923,8.630893944645472
STAT,1868,53,35-39,1921,0.008176816340980744
STAT,1906,20,50-100,1926,0.6034812460251834
SIM,1871,41,40-44,1912,8
STAT,1864,49,30-34,1913,0.08638026475423406
STAT,1868,33,40-44,1901,4.168527120931156
SIM,1847,11,na,1858,2288
SIM,1856,47,na,1903,2087
STAT,1878,38,na,1916,2457.883633769813
SIM,1830,43,45-49,1873,2
SIM,1954,15,15-19,1969,52
SIM,1876,33,40-44,1909,4
STAT,1857,51,30-34,1908,0.004714513126898442
STAT,1916,25,30-34,1941,41.16224039132677
STAT,1897,19,25-29,1916,7.631934351731964
STAT,1799,65,na,1864,819.319879719903
STAT,1846,28,na,1874,1971.759188932491
STAT,1842,14,na,1856,2734.996088016
STAT,1817,38,40-44,1855,14.547571000990496
STAT,1849,25,50-100,1874,0.6014816506156136
STAT,1884,21,30-34,1905,17.794506448049482
STAT,1806,52,na,1858,1147.4187559349486
SIM,1864,77,na,1941,1028
SIM,1860,63,na,1923,1542
STAT,1783,93,na,1876,7.1287492582985745
STAT,1884,51,50-100,1935,0.015114234542290252
SIM,1838,28,25-29,1866,49
SIM,1860,30,25-29,1890,12
STAT,1873,18,25-29,1891,5.7870156747494965
SIM,1890,24,25-29,1914,92
STAT,1919,24,45-49,1943,1.236217061999561
STAT,1850,34,30-34,1884,13.698020144992302
SIM,1825,38,40-44,1863,7
SIM,1839,32,25-29,1871,11
SIM,1938,27,25-29,1965,109
STAT,1853,38,15-19,1891,0.04620816970658674
STAT,1866,42,20-24,1908,0.14834425905522625
STAT,1862,36,15-19,1898,0.04921488820030121
STAT,1864,101,na,1965,2.3609803057765277
STAT,1831,34,20-24,1865,2.1848285634503384
STAT,1864,41,20-24,1905,0.14539507540074975
SIM,1876,9,na,1885,3031
STAT,1893,38,45-49,1931,2.5438496478732144
STAT,1892,32,20-24,1924,3.4258003961395453
SIM,1895,20,45-49,1915,2
SIM,1929,35,na,1964,4715
STAT,1822,43,45-49,1865,2.323628922520136
STAT,1835,50,40-44,1885,0.008381146820612024
SIM,1844,30,40-44,1874,4
STAT,1870,34,35-39,1904,9.957913092790822
SIM,1918,26,45-49,1944,3
STAT,1867,54,30-34,1921,0.005506488936141287
STAT,1846,52,45-49,1898,0.010954622441107531
STAT,1847,66,na,1913,1227.1875849800342
SIM,1825,30,30-34,1855,20
SIM,1925,21,na,1946,4436
STAT,1909,48,25-29,1957,0.049049784860529175
SIM,1854,29,20-24,1883,12
STAT,1921,44,30-34,1965,0.14494844388783465
SIM,1827,30,40-44,1857,5
STAT,1865,29,30-34,1894,23.058170785401135
STAT,1871,26,15-19,1897,0.4568184309396155
STAT,1894,39,15-19,1933,0.07228485127989187
SIM,1864,66,na,1930,1854
SIM,1943,25,50-100,1968,1
SIM,1860,52,na,1912,1912
STAT,1834,50,50-100,1884,0.009595041815289074
STAT,1826,29,na,1855,1543.8134737637681
STAT,1819,81,na,1900,274.9046227086666
STAT,1858,43,25-29,1901,0.5051608954699289
SIM,1865,22,25-29,1887,61
STAT,1873,27,15-19,1900,0.46455037221330864
SIM,1894,21,40-44,1915,6
STAT,1849,52,35-39,1901,0.006695185175622166
STAT,1816,45,35-39,1861,0.37299873904206154
STAT,1886,21,40-44,1907,2.228868050617717
STAT,1894,43,35-39,1937,0.1623316024572362
SIM,1910,39,25-29,1949,3
STAT,1913,37,50-100,1950,0.4180526016453425
STAT,1912,15,45-49,1927,0.10238506320865705
SIM,1877,32,45-49,1909,2
SIM,1910,30,25-29,1940,13
SIM,1899,30,30-34,1929,41
STAT,1902,39,25-29,1941,0.8780429702296233
STAT,1856,18,25-29,1874,5.1579747958780855
STAT,1869,32,45-49,1901,1.7123610062409365
SIM,1855,28,25-29,1883,44
STAT,1827,52,35-39,1879,0.00852545252743091
STAT,1848,28,50-100,1876,0.6190295331490788
STAT,1864,36,25-29,1900,2.6366931419776862
STAT,1868,52,45-49,1920,0.013934125310538116
STAT,1897,6,na,1903,3537.2853916076883
STAT,1836,30,40-44,1866,3.530643040801383
STAT,1883,36,35-39,1919,7.024319318019076
STAT,1883,49,40-44,1932,0.16567621382310088
STAT,1827,48,15-19,1875,4.0487297986218463E-4
STAT,1813,106,na,1919,0.005323631810426312
STAT,1877,43,35-39,1920,1.8739986600579959
STAT,1893,27,na,1920,3060.576390063522
STAT,1843,63,na,1906,1203.4557434730293
SIM,1866,39,40-44,1905,5
STAT,1815,46,30-34,1861,0.2184008464190828
STAT,1814,71,na,1885,712.2889056341996
STAT,1879,12,na,1891,2721.9641598823378
STAT,1917,35,50-100,1952,0.44436472283851974
SIM,1864,18,25-29,1882,4
SIM,1885,43,35-39,1928,2
SIM,1879,43,na,1922,2693
STAT,1847,28,25-29,1875,37.79556216676954
SIM,1890,37,30-34,1927,9
STAT,1825,41,20-24,1866,0.23302066164985394
STAT,1902,30,25-29,1932,14.736368497422745
SIM,1843,26,40-44,1869,11
STAT,1764,90,na,1854,15.0
STAT,1843,84,na,1927,224.37060829366993
STAT,1847,98,na,1945,2.432303073656091
STAT,1834,48,na,1882,1402.1212046964597
STAT,1893,31,25-29,1924,13.189220758405103
STAT,1848,54,20-24,1902,5.859126996726255E-4
STAT,1835,26,40-44,1861,2.952562738545365
SIM,1886,19,15-19,1905,9
STAT,1861,35,45-49,1896,1.6889833303868167
STAT,1883,41,30-34,1924,1.1414406095768874
STAT,1830,34,na,1864,1811.2607229884195
SIM,1891,41,30-34,1932,1
STAT,1847,77,na,1924,647.2024068459594
STAT,1846,29,20-24,1875,10.616107612793154
STAT,1816,50,30-34,1866,0.015385065834866901
STAT,1826,40,25-29,1866,0.6972249852076714
STAT,1811,74,na,1885,489.5434828124658
STAT,1924,16,na,1940,4440.109024951984
STAT,1882,37,30-34,1919,5.214179455178513
STAT,1884,48,45-49,1932,0.23210134865298324
SIM,1811,43,35-39,1854,4
SIM,1911,18,na,1929,4113
SIM,1836,59,na,1895,1408
STAT,1876,22,35-39,1898,6.085489204992332
SIM,1874,36,35-39,1910,13
STAT,1928,30,45-49,1958,1.9910108225463874
STAT,1799,103,na,1902,0.04815959216339497
STAT,1818,51,30-34,1869,0.010385696914195284
STAT,1847,52,25-29,1899,0.00263791805295345
STAT,1868,49,15-19,1917,3.7805421612982097E-4
SIM,1870,62,na,1932,2036
SIM,1905,25,20-24,1930,19
STAT,1861,16,40-44,1877,0.17748380887663723
SIM,1882,26,40-44,1908,5
STAT,1844,51,45-49,1895,0.011536929653121352
STAT,1865,48,35-39,1913,0.12749349552093533
STAT,1930,29,35-39,1959,19.276034451261214
SIM,1874,76,na,1950,1057
STAT,1844,32,40-44,1876,4.103072132824685
STAT,1882,33,15-19,1915,0.13873625306407802
STAT,1835,33,na,1868,2049.4090692148634
SIM,1942,28,50-100,1970,1
STAT,1794,66,na,1860,788.3458156093756
STAT,1900,46,50-100,1946,0.19492341318222994
SIM,1865,27,30-34,1892,4
STAT,1932,35,na,1967,5117.223739609291
SIM,1848,43,30-34,1891,3
STAT,1788,92,na,1880,10.617302289865059
SIM,1907,21,15-19,1928,7
STAT,1891,79,na,1970,1330.9698456256397
STAT,1852,49,50-100,1901,0.1823720729836326
STAT,1880,37,20-24,1917,0.8176475065373968
STAT,1864,17,20-24,1881,16.714633514759992
STAT,1854,47,na,1901,1680.6035115015266
STAT,1855,0,na,1855,3012.609958481333
STAT,1934,28,50-100,1962,1.3523036175808028
STAT,1850,43,20-24,1893,0.12072688280746721
STAT,1874,26,40-44,1900,3.108612463082142
STAT,1925,40,50-100,1965,0.14414059948451732
SIM,1885,39,na,1924,2480
STAT,1828,28,15-19,1856,0.7290981062016968
STAT,1869,13,na,1882,2599.823112705671
STAT,1908,49,20-24,1957,0.010029706944969914
STAT,1874,22,25-29,1896,59.2028157387853
STAT,1895,19,15-19,1914,7.785478078423212
STAT,1848,41,15-19,1889,0.011406474909566961
SIM,1872,17,20-24,1889,25
SIM,1948,17,40-44,1965,3
STAT,1866,36,35-39,1902,6.64666405856517
SIM,1899,38,40-44,1937,1
SIM,1923,16,25-29,1939,61
SIM,1883,43,25-29,1926,1
STAT,1813,46,20-24,1859,0.035571473442349705
STAT,1896,43,45-49,1939,0.13794219126459611
STAT,1923,39,45-49,1962,0.7964055808262914
SIM,1802,90,na,1892,8
STAT,1915,16,25-29,1931,9.174417129637582
STAT,1835,54,35-39,1889,0.00633174208533345
STAT,1839,100,na,1939,0.7526775309603551
STAT,1873,61,na,1934,1913.313843873316
SIM,1892,21,30-34,1913,35
STAT,1822,40,40-44,1862,3.759400397325905
STAT,1872,38,25-29,1910,2.909095909525252
SIM,1849,77,na,1926,691
STAT,1829,52,45-49,1881,0.009520190187847551
SIM,1845,63,na,1908,1388
STAT,1877,75,na,1952,1073.135274651177
SIM,1885,28,na,1913,2547
STAT,1834,46,40-44,1880,0.12035440860883899
SIM,1817,67,na,1884,924
SIM,1860,43,30-34,1903,2
SIM,1879,26,20-24,1905,17
STAT,1839,47,na,1886,1625.1762351157406
SIM,1939,31,25-29,1970,12
SIM,1813,53,na,1866,1200
STAT,1851,22,30-34,1873,16.106399191080367
SIM,1822,34,20-24,1856,2
SIM,1931,39,45-49,1970,1
STAT,1902,69,na,1971,2483.1612243514696
SIM,1906,39,na,1945,3345
SIM,1938,24,20-24,1962,127
STAT,1941,31,15-19,1972,0.13629307906552418
SIM,1902,25,na,1927,3663
STAT,1873,39,na,1912,2388.0287659730416
STAT,1854,18,15-19,1872,5.296427328694052
SIM,1839,37,30-34,1876,6
SIM,1916,26,35-39,1942,20
SIM,1885,3,na,1888,3122
STAT,1833,85,na,1918,193.94894682792452
STAT,1856,38,40-44,1894,3.3728899972233233
STAT,1867,65,na,1932,1607.5293943392433
STAT,1808,52,25-29,1860,0.011990900317689098
STAT,1886,40,45-49,1926,1.612110892027323
STAT,1898,47,35-39,1945,0.10762458670922449
SIM,1820,40,45-49,1860,1
SIM,1868,19,20-24,1887,15
STAT,1818,42,40-44,1860,4.415374712298267
SIM,1950,18,35-39,1968,8
STAT,1939,30,20-24,1969,2.5152870240336087
SIM,1869,42,50-100,1911,4
STAT,1860,32,na,1892,1970.2017782538283
SIM,1927,0,na,1927,5702
SIM,1817,39,45-49,1856,1
STAT,1837,99,na,1936,1.2919574090716195
SIM,1869,30,45-49,1899,2
STAT,1942,18,35-39,1960,4.4260819924729216
STAT,1863,51,na,1914,1936.0669690551374
SIM,1881,30,45-49,1911,2
STAT,1823,44,50-100,1867,1.4893366327416124
STAT,1824,53,20-24,1877,8.159929223363091E-4
STAT,1895,33,50-100,1928,1.203394480364111
SIM,1851,70,na,1921,1216
STAT,1912,3,na,1915,4124.423237918093
STAT,1891,38,35-39,1929,8.80066515261342
STAT,1875,47,40-44,1922,0.1767437854337159
SIM,1830,40,40-44,1870,1
SIM,1853,32,50-100,1885,1
STAT,1885,33,40-44,1918,4.341466070639043
STAT,1841,29,na,1870,1980.5427306950473
SIM,1956,15,25-29,1971,69
STAT,1852,30,25-29,1882,8.211515526123845
SIM,1911,27,25-29,1938,72
STAT,1875,43,25-29,1918,0.6612450607972115
STAT,1843,53,30-34,1896,0.003950340938331526
STAT,1903,27,25-29,1930,60.84692475262478
STAT,1839,58,na,1897,1402.0629634728798
STAT,1842,44,25-29,1886,0.5830330451097046
STAT,1918,20,na,1938,3999.984174351295
STAT,1905,48,40-44,1953,0.139231364016843
STAT,1840,31,45-49,1871,1.5044126509174645
SIM,1841,25,40-44,1866,3
STAT,1846,45,20-24,1891,0.009197408026316292
STAT,1888,27,na,1915,2845.0022328624786
STAT,1824,47,35-39,1871,0.16381605071247016
STAT,1891,44,20-24,1935,0.19591161044316743
SIM,1894,40,45-49,1934,3
SIM,1912,39,35-39,1951,1
STAT,1897,39,40-44,1936,1.2665000429388629
STAT,1849,28,35-39,1877,8.878545753666492
STAT,1778,105,na,1883,0.022692719129828308
STAT,1779,88,na,1867,52.01310911093573
SIM,1838,25,20-24,1863,8
STAT,1838,101,na,1939,0.38199054112479386
STAT,1849,19,45-49,1868,0.06212791555425236
STAT,1845,32,50-100,1877,0.7960239614544419
STAT,1878,35,15-19,1913,0.05943466619989145
STAT,1885,42,30-34,1927,1.1543818608459415
STAT,1948,15,25-29,1963,50.124920535429276
SIM,1868,80,na,1948,446
STAT,1862,23,45-49,1885,0.6181555685999855
SIM,1915,43,na,1958,4154
STAT,1816,104,na,1920,0.03410193256164721
SIM,1871,44,45-49,1915,1
SIM,1870,23,45-49,1893,4
STAT,1863,44,45-49,1907,1.3212495676672191
SIM,1873,29,30-34,1902,37
STAT,1904,39,35-39,1943,2.1904531982821127
SIM,1878,1,na,1879,3669
SIM,1857,28,35-39,1885,6
SIM,1791,89,na,1880,8
SIM,1935,4,na,1939,5510
STAT,1954,17,15-19,1971,56.68220969465745
STAT,1832,26,15-19,1858,0.4213608359463241
STAT,1873,30,45-49,1903,1.7998684633078892
SIM,1858,37,40-44,1895,2
SIM,1893,36,45-49,1929,6
STAT,1869,41,35-39,1910,1.7861896449294994
STAT,1892,23,30-34,1915,22.50516043839228
STAT,1832,49,35-39,1881,0.10026460174677976
STAT,1902,48,15-19,1950,3.1799073408555697E-4
STAT,1810,89,na,1899,54.56061358041317
STAT,1915,41,15-19,1956,0.0015623338662199902
STAT,1916,28,35-39,1944,15.610677064851904
STAT,1837,51,40-44,1888,0.007352383596127166
STAT,1889,42,15-19,1931,0.017177507205872723
SIM,1871,24,15-19,1895,3
SIM,1838,29,na,1867,1881
STAT,1842,16,30-34,1858,1.8536672640785594
STAT,1867,45,40-44,1912,0.1644727297762574
STAT,1881,32,45-49,1913,1.6977250497187673
STAT,1848,16,25-29,1864,5.769397486330208
STAT,1825,32,30-34,1857,41.40528550572504
STAT,1931,38,40-44,1969,2.001653997491738
STAT,1892,42,35-39,1934,2.292162192754816
SIM,1917,30,35-39,1947,18
STAT,1841,29,50-100,1870,0.5856586739208708
STAT,1883,28,na,1911,2350.468283761004
SIM,1857,32,na,1889,2074
STAT,1884,30,20-24,1914,2.713873552212571
STAT,1897,16,20-24,1913,24.064431832406306
STAT,1892,64,na,1956,2229.097418115354
STAT,1825,51,35-39,1876,0.011363674771399566
SIM,1833,32,30-34,1865,21
SIM,1833,30,na,1863,1981
SIM,1837,44,na,1881,1479
STAT,1887,49,25-29,1936,0.03587358087128051
SIM,1850,44,25-29,1894,2
SIM,1849,26,35-39,1875,11
STAT,1868,28,45-49,1896,1.0679928554210678
STAT,1866,23,50-100,1889,0.38173221227844817
SIM,1897,37,40-44,1934,12
STAT,1874,35,30-34,1909,5.564140048012885
SIM,1885,40,30-34,1925,1
STAT,1908,26,35-39,1934,14.498169681681048
SIM,1818,43,45-49,1861,3
STAT,1841,32,15-19,1873,0.12920965215803218
STAT,1859,52,30-34,1911,0.004809726042977492
STAT,1916,20,25-29,1936,98.26076743396523
SIM,1792,74,na,1866,316
STAT,1827,42,50-100,1869,1.136420954105616
SIM,1815,44,30-34,1859,1
STAT,1814,41,45-49,1855,5.431828278015085
SIM,1904,16,15-19,1920,14
SIM,1950,20,na,1970,4195
STAT,1841,27,40-44,1868,2.782344810339282
STAT,1839,49,50-100,1888,0.17292147135923402
STAT,1832,41,25-29,1873,0.5435015459297207
STAT,1877,34,45-49,1911,1.8022376312703856
STAT,1904,39,na,1943,3407.1032626050514
SIM,1796,88,na,1884,46
STAT,1838,27,20-24,1865,9.98982236924071
SIM,1885,34,45-49,1919,3
STAT,1818,85,na,1903,141.2359181569866
STAT,1834,42,25-29,1876,0.4610406869114802
SIM,1867,10,na,1877,2516
STAT,1858,31,30-34,1889,13.979251476509136
SIM,1898,29,35-39,1927,14
STAT,1842,104,na,1946,0.06005236401519899
STAT,1923,15,20-24,1938,161.59925771999303
SIM,1846,27,20-24,1873,10
STAT,1850,18,30-34,1868,1.4825836626903306
STAT,1840,40,20-24,1880,0.13092669517456848
STAT,1909,30,35-39,1939,8.870566030732869
SIM,1904,37,35-39,1941,2
SIM,1931,15,20-24,1946,199
STAT,1863,24,15-19,1887,2.9680141160021525
SIM,1924,28,35-39,1952,21
STAT,1853,17,45-49,1870,0.06498275882288382
SIM,1899,33,35-39,1932,17
STAT,1898,20,20-24,1918,94.9185700743287
SIM,1855,84,na,1939,370
SIM,1865,51,na,1916,1952
SIM,1882,35,30-34,1917,8
SIM,1877,41,35-39,1918,2
SIM,1880,38,25-29,1918,4
STAT,1888,38,15-19,1926,0.06661047422998624
SIM,1859,98,na,1957,8
STAT,1858,39,40-44,1897,3.4337638293557533
STAT,1877,40,30-34,1917,1.2105336769864201
STAT,1774,89,na,1863,23.084345287195617
STAT,1854,9,na,1863,2187.2345219034437
SIM,1832,28,30-34,1860,29
SIM,1930,27,35-39,1957,32
STAT,1789,66,na,1855,931.6078000000001
SIM,1924,20,25-29,1944,9
SIM,1918,23,40-44,1941,4
STAT,1840,48,30-34,1888,0.06755588720483212
SIM,1835,85,na,1920,103
STAT,1865,26,50-100,1891,0.591984732949341
STAT,1898,28,30-34,1926,34.35791086531088
STAT,1851,50,25-29,1901,0.0027205099441007497
STAT,1870,22,40-44,1892,2.0666971047919964
SIM,1887,28,20-24,1915,16
SIM,1831,71,na,1902,874
STAT,1882,28,40-44,1910,2.920386579365398
SIM,1872,10,na,1882,2910
STAT,1870,31,30-34,1901,17.38710795905398
STAT,1836,33,45-49,1869,1.3761513361859166
STAT,1848,62,na,1910,1492.2665290126836
STAT,1859,46,45-49,1905,0.19225549956630317
STAT,1899,31,50-100,1930,1.2752457260301457
STAT,1847,37,15-19,1884,0.04362355781495793
STAT,1895,48,20-24,1943,0.008815881148114664
STAT,1893,35,40-44,1928,5.667206980057478
SIM,1935,20,na,1955,4776
STAT,1837,34,15-19,1871,0.11930545634849161
STAT,1879,19,30-34,1898,1.6709289486079477
STAT,1909,21,50-100,1930,0.6189758688709496
STAT,1938,19,na,1957,3663.0161383552263
STAT,1831,37,25-29,1868,2.3015020887077817
STAT,1891,19,30-34,1910,1.9824103979844299
SIM,1866,31,30-34,1897,30
STAT,1861,40,40-44,1901,1.9068207967552309
STAT,1889,17,25-29,1906,7.057310703796626
STAT,1870,39,50-100,1909,1.205405622757075
SIM,1844,33,45-49,1877,3
STAT,1835,29,45-49,1864,1.0709610083023082
STAT,1903,54,na,1957,3051.6973381260973
STAT,1857,27,30-34,1884,20.445283552942936
STAT,1934,16,35-39,1950,5.7489807007754
STAT,1815,42,15-19,1857,0.03581655964383146
STAT,1937,34,na,1971,3772.622946299069
SIM,1921,39,na,1960,4101
STAT,1826,44,40-44,1870,2.2545877486289405
STAT,1793,92,na,1885,11.277154339712514
STAT,1911,26,20-24,1937,18.021203482485372
STAT,1869,29,15-19,1898,0.4423328669459878
STAT,1848,36,40-44,1884,3.721571780762671
SIM,1901,62,na,1963,2723
STAT,1880,20,35-39,1900,6.226686568341709
SIM,1861,46,50-100,1907,3
STAT,1861,28,50-100,1889,0.5368988469043297
SIM,1920,38,30-34,1958,2
STAT,1850,37,35-39,1887,5.501596418194644
SIM,1898,47,50-100,1945,1
STAT,1883,45,25-29,1928,0.057497757900299755
STAT,1877,43,50-100,1920,1.0933147533655334
SIM,1776,89,na,1865,9
SIM,1897,17,25-29,1914,12
STAT,1912,38,30-34,1950,1.785781710045148
SIM,1848,46,50-100,1894,2
STAT,1933,20,na,1953,4924.067258544156
STAT,1935,20,35-39,1955,12.963577696194521
STAT,1818,96,na,1914,4.423904210824126
SIM,1834,44,40-44,1878,7
STAT,1865,100,na,1965,4.210884117195618
STAT,1878,52,40-44,1930,0.010979004670219256
STAT,1821,48,20-24,1869,0.017335363988360202
STAT,1844,103,na,1947,0.11354681669682509
STAT,1851,41,35-39,1892,1.3773301115131116
STAT,1816,54,25-29,1870,0.008452898594109517
STAT,1801,53,na,1854,1207.7810656437284
STAT,1874,24,na,1898,2430.596840039779
STAT,1902,17,50-100,1919,0.06992415152740211
STAT,1835,21,35-39,1856,5.866337448584508
SIM,1864,15,20-24,1879,25
SIM,1866,34,35-39,1900,3
SIM,1942,16,35-39,1958,5
STAT,1805,67,na,1872,904.4800092472427
SIM,1888,32,20-24,1920,4
STAT,1857,39,50-100,1896,0.9580211852309287
STAT,1939,18,50-100,1957,0.3784750196291186
STAT,1860,32,25-29,1892,8.456566149960132
STAT,1856,15,20-24,1871,16.42541108782174
STAT,1830,25,15-19,1855,0.5671869666504051
STAT,1894,36,50-100,1930,1.604161270005556
SIM,1843,21,35-39,1864,9
SIM,1856,36,40-44,1892,2
SIM,1879,49,40-44,1928,3
STAT,1838,46,25-29,1884,0.04018079154146975
STAT,1876,79,na,1955,729.056977166134
STAT,1872,65,na,1937,1716.023234976326
SIM,1837,33,na,1870,1617
STAT,1820,38,50-100,1858,2.802097977488907
STAT,1879,28,20-24,1907,12.321422969687733
STAT,1871,34,15-19,1905,0.14167189484998852
SIM,1926,41,40-44,1967,1
STAT,1867,16,35-39,1883,0.5367449523035226
STAT,1855,32,na,1887,1828.9287113594598
SIM,1884,43,na,1927,2353
STAT,1847,48,40-44,1895,0.12657314546804588
STAT,1912,42,15-19,1954,0.0014942955236976194
SIM,1852,35,50-100,1887,4
STAT,1950,21,na,1971,4378.326515900401
SIM,1831,50,na,1881,1527
SIM,1797,73,na,1870,507
STAT,1932,34,40-44,1966,5.250462167413207
STAT,1847,13,na,1860,2220.7393510828306
STAT,1862,49,20-24,1911,0.01024810849155585
SIM,1848,27,30-34,1875,27
SIM,1892,62,na,1954,2492
STAT,1771,100,na,1871,0.1680962995753485
STAT,1844,16,40-44,1860,0.1850411313823187
STAT,1882,48,35-39,1930,0.13524764356060767
STAT,1810,48,45-49,1858,0.8945457002706582
STAT,1921,48,25-29,1969,0.06022770928687913
SIM,1846,16,na,1862,2109
STAT,1832,54,30-34,1886,0.0040643963012525035
STAT,1915,37,45-49,1952,0.6949098597143094
SIM,1871,15,na,1886,2495
STAT,1791,108,na,1899,3.2570735782628353E-4
SIM,1945,19,na,1964,3904
STAT,1903,44,15-19,1947,0.0013607942238814065
STAT,1875,27,25-29,1902,43.8757734221206
SIM,1939,9,na,1948,4102
STAT,1900,30,15-19,1930,0.2014055720694285
SIM,1890,17,15-19,1907,10
SIM,1806,51,na,1857,1386
SIM,1892,6,na,1898,3599
SIM,1895,28,50-100,1923,1
SIM,1937,19,30-34,1956,18
STAT,1810,68,na,1878,893.1026528345122
SIM,1859,44,na,1903,2115
SIM,1867,63,na,1930,1583
STAT,1891,26,40-44,1917,3.75874222480219
STAT,1850,45,35-39,1895,0.10826867167856567
STAT,1868,82,na,1950,450.38776146010235
SIM,1890,28,40-44,1918,6
STAT,1925,22,na,1947,4417.572448118819
SIM,1829,46,na,1875,1680
STAT,1952,20,35-39,1972,11.446048121166607
STAT,1824,35,40-44,1859,6.474656792273071
SIM,1905,54,na,1959,3263
STAT,1924,19,50-100,1943,0.4484231697077429
STAT,1858,18,35-39,1876,0.5049007268934971
SIM,1883,27,25-29,1910,53
STAT,1885,49,15-19,1934,3.9373848473919093E-4
STAT,1929,19,30-34,1948,15.63823559504305
SIM,1883,21,50-100,1904,1
STAT,1930,26,30-34,1956,50.37935851432531
STAT,1809,71,na,1880,724.0679607712935
STAT,1909,45,20-24,1954,0.010345709782440956
SIM,1846,26,na,1872,1893
SIM,1880,8,na,1888,2548
STAT,1906,44,40-44,1950,0.2266764487627975
SIM,1823,37,40-44,1860,1
STAT,1855,42,na,1897,1737.5764645440217
STAT,1867,29,40-44,1896,2.829080531755506
SIM,1884,33,na,1917,2453
STAT,1794,106,na,1900,0.0023611840028618285
STAT,1869,0,na,1869,3681.334842582996
SIM,1839,29,30-34,1868,4
STAT,1833,53,35-39,1886,0.006176837545923645
STAT,1855,10,na,1865,2164.0394668853623
SIM,1797,83,na,1880,140
SIM,1884,19,40-44,1903,1
STAT,1919,40,45-49,1959,0.18260776765332148
SIM,1912,36,30-34,1948,5
STAT,1864,44,25-29,1908,0.5773538588766135
SIM,1889,28,30-34,1917,38
STAT,1856,52,50-100,1908,0.011632500370712657
STAT,1927,35,na,1962,4735.996599604265
SIM,1914,37,na,1951,3925
STAT,1862,25,50-100,1887,0.5681387477532855
SIM,1869,76,na,1945,913
STAT,1823,86,na,1909,122.71160816167362
STAT,1896,40,40-44,1936,0.21092657397393272
STAT,1831,45,25-29,1876,0.04414286568868477
SIM,1852,2,na,1854,2807
STAT,1904,36,30-34,1940,1.6753530532630867
SIM,1855,62,na,1917,1612
STAT,1830,46,20-24,1876,0.010167932196169436
STAT,1881,49,30-34,1930,0.0922734533066533
SIM,1857,43,na,1900,1995
STAT,1868,60,na,1928,1840.9831312423842
STAT,1917,25,na,1942,3992.444589539159
SIM,1864,0,na,1864,3420
STAT,1918,41,40-44,1959,0.26886964984043377
STAT,1917,35,na,1952,3981.8266138045897
SIM,1878,17,15-19,1895,6
SIM,1859,66,na,1925,1598
SIM,1906,18,na,1924,3598
SIM,1864,38,40-44,1902,6
STAT,1900,43,35-39,1943,0.17514946882910895
STAT,1813,54,20-24,1867,0.00195994616430879
SIM,1855,17,20-24,1872,26
STAT,1899,19,35-39,1918,0.7565152876640417
SIM,1888,16,20-24,1904,29
STAT,1909,5,na,1914,3965.834924844937
STAT,1853,46,15-19,1899,3.317295091542543E-4
SIM,1923,37,45-49,1960,3
SIM,1854,45,na,1899,2100
STAT,1938,1,na,1939,4158.739765713432
SIM,1856,26,na,1882,2172
SIM,1905,28,25-29,1933,78
STAT,1806,51,50-100,1857,0.04446204283436135
SIM,1888,47,40-44,1935,2
STAT,1948,19,40-44,1967,1.6159243680599862
SIM,1821,40,na,1861,1409
STAT,1891,40,50-100,1931,1.3344001184011678
SIM,1914,29,50-100,1943,1
STAT,1847,17,20-24,1864,16.567269283757785
SIM,1891,40,50-100,1931,1
STAT,1840,23,50-100,1863,0.3609137338682661
SIM,1893,17,40-44,1910,1
SIM,1865,19,30-34,1884,6
STAT,1871,48,na,1919,2229.178570851972
STAT,1840,43,25-29,1883,0.46358840482281355
SIM,1904,34,30-34,1938,17
STAT,1903,30,40-44,1933,6.28813237810738
SIM,1895,27,na,1922,3295
STAT,1942,28,50-100,1970,1.0542611094216552
SIM,1839,46,na,1885,1549
STAT,1907,18,40-44,1925,0.2705761410383388
STAT,1954,9,na,1963,4907.98742899039
STAT,1823,43,25-29,1866,0.9287651365083436
STAT,1929,31,15-19,1960,0.1650786888538176
SIM,1921,34,30-34,1955,38
SIM,1880,61,na,1941,1691
STAT,1834,104,na,1938,0.03970176609115314
SIM,1884,32,50-100,1916,1
STAT,1820,42,45-49,1862,2.8238871281131073
STAT,1845,32,na,1877,1882.8849772025283
SIM,1842,26,25-29,1868,42
SIM,1894,43,na,1937,3246
SIM,1789,86,na,1875,51
SIM,1804,70,na,1874,755
STAT,1865,53,30-34,1918,0.005401630282681259
STAT,1877,43,na,1920,2391.886047411579
STAT,1834,26,25-29,1860,33.27385190052135
STAT,1913,34,30-34,1947,15.680334763261229
STAT,1880,45,20-24,1925,0.012855424396406802
SIM,1925,35,50-100,1960,3
STAT,1922,44,25-29,1966,0.08252655133305008
STAT,1857,19,30-34,1876,1.4593105506789974
SIM,1871,25,na,1896,2303
SIM,1853,46,50-100,1899,2
SIM,1837,26,50-100,1863,1
STAT,1885,17,40-44,1902,0.1838793445459395
SIM,1854,13,na,1867,2642
SIM,1911,30,40-44,1941,5
SIM,1830,33,50-100,1863,4
SIM,1862,32,na,1894,2137
SIM,1867,95,na,1962,22
STAT,1884,13,na,1897,2568.1793246976104
STAT,1831,83,na,1914,249.46682895991214
STAT,1910,41,50-100,1951,0.1126626439608551
STAT,1892,10,na,1902,3282.925267628523
SIM,1828,52,50-100,1880,2
SIM,1872,32,na,1904,2569
STAT,1835,38,20-24,1873,0.7081577753811276
STAT,1895,39,30-34,1934,6.958768926345569
STAT,1903,24,20-24,1927,98.50410760263513
SIM,1911,24,20-24,1935,122
STAT,1810,53,40-44,1863,0.03780528922161718
STAT,1850,28,45-49,1878,0.99330190310362
STAT,1881,36,25-29,1917,2.81657832622382
STAT,1890,34,25-29,1924,12.532793668795943
STAT,1802,53,50-100,1855,0.0431917502535458
STAT,1851,49,45-49,1900,0.17496527646346888
STAT,1814,45,25-29,1859,0.14367338802980986
STAT,1830,33,15-19,1863,0.13450384408450713
STAT,1828,48,30-34,1876,0.08703428157408281
SIM,1884,65,na,1949,1805
SIM,1934,35,na,1969,5362
STAT,1839,18,25-29,1857,5.224592620227982
SIM,1875,82,na,1957,441
STAT,1854,47,20-24,1901,0.008963853412469509
STAT,1923,36,40-44,1959,1.7541564071501665
SIM,1818,100,na,1918,2
STAT,1935,25,50-100,1960,1.3720075153355902
SIM,1922,24,na,1946,4495
STAT,1854,38,30-34,1892,3.97993762079707
STAT,1871,47,20-24,1918,0.011984954774099705
STAT,1888,80,na,1968,1143.9983005278805
SIM,1875,50,na,1925,2189
STAT,1775,107,na,1882,0.0059060410749223365
STAT,1894,22,50-100,1916,0.5302642912246442
STAT,1890,47,30-34,1937,0.06707503449190283
STAT,1865,36,40-44,1901,4.056609403703647
STAT,1872,12,na,1884,2672.554187102194
SIM,1932,35,45-49,1967,2
STAT,1858,82,na,1940,369.71365767759283
SIM,1839,24,na,1863,1747
STAT,1885,30,na,1915,2418.332416659674
STAT,1891,46,35-39,1937,0.09903271373918605
SIM,1816,71,na,1887,621
STAT,1880,34,50-100,1914,0.9635505021758518
STAT,1800,68,na,1868,637.8546558197148
STAT,1913,46,25-29,1959,0.05236872678865773
SIM,1830,86,na,1916,100
STAT,1875,18,35-39,1893,0.5676395957420811
STAT,1784,88,na,1872,38.871750890178305
SIM,1880,83,na,1963,537
STAT,1851,54,40-44,1905,0.007752199240239704
SIM,1935,25,50-100,1960,6
STAT,1792,108,na,1900,3.292853035806114E-4
SIM,1873,36,40-44,1909,5
STAT,1905,24,na,1929,3431.5818018025143
STAT,1923,18,25-29,1941,51.279825048930306
STAT,1855,46,25-29,1901,0.04347981799790197
STAT,1935,22,na,1957,5024.227136912263
STAT,1849,50,20-24,1899,5.852353409660274E-4
STAT,1856,28,50-100,1884,0.5096037644105592
STAT,1924,35,45-49,1959,0.8137228007845998
STAT,1908,42,na,1950,3468.5943847129593
SIM,1864,45,na,1909,2484
SIM,1880,34,50-100,1914,4
STAT,1920,44,15-19,1964,0.0017070473804583523
SIM,1872,64,na,1936,1936
STAT,1860,44,40-44,1904,1.8319950198385377
STAT,1898,20,50-100,1918,0.5616816387606492
STAT,1885,62,na,1947,1837.4870655301838
STAT,1904,18,15-19,1922,8.579113166222575
STAT,1922,24,30-34,1946,33.08839423300907
STAT,1872,46,25-29,1918,0.058654301541315984
STAT,1838,19,20-24,1857,15.492107560420685
STAT,1844,48,15-19,1892,3.124969139146869E-4
STAT,1907,35,45-49,1942,0.6442592769613926
STAT,1928,19,na,1947,4662.633657774183
STAT,1900,26,45-49,1926,1.563113512959389
STAT,1861,43,45-49,1904,1.2470265557237294
SIM,1929,17,30-34,1946,19
STAT,1809,48,20-24,1857,0.04124908785873893
STAT,1843,103,na,1946,0.09679625890009727
SIM,1930,24,30-34,1954,48
SIM,1846,19,20-24,1865,22
SIM,1866,14,na,1880,2727
STAT,1839,49,45-49,1888,0.16616232617183233
STAT,1874,19,30-34,1893,1.6395233568969578
STAT,1842,43,35-39,1885,1.6652896273742515
STAT,1891,29,45-49,1920,1.3784866142690162
SIM,1802,69,na,1871,786
SIM,1832,38,45-49,1870,2
STAT,1840,35,25-29,1875,2.437226461946528
STAT,1873,29,na,1902,2426.1192305938825
SIM,1895,59,na,1954,2585
SIM,1923,34,40-44,1957,13
STAT,1900,31,40-44,1931,6.10932657961255
STAT,1921,45,20-24,1966,0.0126416391465953
STAT,1953,18,na,1971,4497.179479464428
STAT,1932,37,45-49,1969,0.9256481557079747
STAT,1813,86,na,1899,97.28358428777837
STAT,1821,43,15-19,1864,0.021392840809047173
STAT,1824,52,30-34,1876,0.00671440129500976
SIM,1809,48,na,1857,1255
STAT,1907,30,25-29,1937,8.793432843174077
STAT,1872,97,na,1969,29.26238330828062
STAT,1917,47,20-24,1964,0.011651355399024536
STAT,1913,53,na,1966,3540.9774442748326
STAT,1875,62,na,1937,1895.754698030217
SIM,1857,37,25-29,1894,2
STAT,1773,94,na,1867,4.204346190331837
SIM,1855,94,na,1949,12
STAT,1824,38,45-49,1862,2.690994162218158
STAT,1873,38,40-44,1911,4.459935471320919
SIM,1898,33,50-100,1931,3
STAT,1856,59,na,1915,1504.914191883981
STAT,1830,49,25-29,1879,0.04694636032248567
STAT,1914,20,15-19,1934,5.2968352048292155
SIM,1934,25,na,1959,5168
SIM,1793,69,na,1862,648
STAT,1829,29,20-24,1858,11.721882942438327
STAT,1852,18,40-44,1870,0.16677900807502294
SIM,1821,72,na,1893,677
SIM,1942,6,na,1948,4441
STAT,1891,43,30-34,1934,1.427249897113096
STAT,1845,40,35-39,1885,1.3823447567917913
STAT,1851,28,na,1879,1904.1024059929705
STAT,1831,73,na,1904,746.3843726025714
STAT,1899,16,30-34,1915,2.2147712820622463
STAT,1844,19,45-49,1863,0.06492522534624937
SIM,1904,59,na,1963,3188
SIM,1847,43,na,1890,1708
STAT,1803,66,na,1869,967.3819948474885
STAT,1878,19,15-19,1897,6.188740190264432
STAT,1880,28,30-34,1908,26.61668371173738
STAT,1947,6,na,1953,4493.892931961135
STAT,1910,45,45-49,1955,0.2055467168422421
STAT,1829,26,na,1855,1653.582549055622
SIM,1842,50,50-100,1892,1
STAT,1838,50,45-49,1888,0.010053716908671972
SIM,1864,13,na,1877,2881
STAT,1849,37,25-29,1886,2.303479466650229
SIM,1885,60,na,1945,2013
STAT,1856,27,15-19,1883,0.36405092371029424
SIM,1800,56,na,1856,1057
SIM,1873,5,na,1878,2666
STAT,1831,42,20-24,1873,0.12278544742790115
STAT,1853,46,50-100,1899,0.20368208972196072
STAT,1873,47,30-34,1920,0.09865236977645976
SIM,1834,28,40-44,1862,6
SIM,1909,36,na,1945,3946
SIM,1914,18,25-29,1932,18
STAT,1923,40,25-29,1963,0.08456405477204954
SIM,1853,40,35-39,1893,4
SIM,1922,20,15-19,1942,6
SIM,1849,5,na,1854,2551
STAT,1844,21,50-100,1865,0.4057469945288187
STAT,1881,45,50-100,1926,0.24149147680051186
SIM,1905,7,na,1912,3912
STAT,1808,97,na,1905,2.025375609691425
STAT,1923,44,40-44,1967,0.2943987986837068
STAT,1876,54,45-49,1930,0.014717988904463986
STAT,1878,60,na,1938,1999.5916296357457
STAT,1906,47,45-49,1953,0.19492566057458796
STAT,1796,89,na,1885,36.83734659292577
STAT,1900,40,30-34,1940,0.11314006516811385
STAT,1921,36,30-34,1957,2.057227855476464
SIM,1898,38,25-29,1936,1
SIM,1860,42,40-44,1902,8
STAT,1848,29,30-34,1877,24.193527448162527
SIM,1817,77,na,1894,393
STAT,1904,40,15-19,1944,0.001403993124028634
SIM,1804,92,na,1896,9
SIM,1856,29,30-34,1885,28
STAT,1882,17,15-19,1899,5.80605330928084
STAT,1836,46,15-19,1882,2.6748165227714497E-4
STAT,1831,44,50-100,1875,0.795821447494678
SIM,1888,19,25-29,1907,9
SIM,1941,20,25-29,1961,159
STAT,1864,25,na,1889,2198.294615967373
STAT,1858,15,30-34,1873,1.4928398393722215
STAT,1875,84,na,1959,461.3574499555569
STAT,1769,99,na,1868,0.280889003895597
STAT,1826,28,40-44,1854,7.411219875060717
SIM,1964,0,na,1964,5265
STAT,1892,32,na,1924,3024.360962803803
STAT,1891,58,na,1949,2472.942520265529
SIM,1881,38,40-44,1919,8
SIM,1904,37,na,1941,3586
STAT,1888,37,na,1925,2808.587905145709
STAT,1819,50,35-39,1869,0.016774556353149603
STAT,1854,15,na,1869,2085.250437697051
STAT,1869,49,30-34,1918,0.09306893562045342
STAT,1933,20,25-29,1953,124.55050168945517
STAT,1920,24,20-24,1944,124.05169396055253
SIM,1883,42,35-39,1925,3
SIM,1850,43,35-39,1893,5
STAT,1877,18,45-49,1895,0.06791529688982875
STAT,1934,32,35-39,1966,12.607093414596045
STAT,1881,58,na,1939,1925.32059578525
STAT,1911,46,15-19,1957,3.52708133811569E-4
STAT,1903,9,na,1912,3732.154652163891
SIM,1919,36,na,1955,3970
STAT,1846,101,na,1947,0.4330376178934522
STAT,1843,52,40-44,1895,0.007062760568655812
STAT,1893,19,40-44,1912,0.23330455794588228
STAT,1915,34,40-44,1949,3.987224921001787
STAT,1875,42,35-39,1917,1.8758953360993538
STAT,1860,16,25-29,1876,5.427897438630724
STAT,1938,29,25-29,1967,65.76502024702337
STAT,1869,16,45-49,1885,0.06541753269995516
STAT,1890,31,20-24,1921,3.3496422632589757
STAT,1805,52,20-24,1857,0.003033726100024052
STAT,1863,48,25-29,1911,0.05089797727054759
SIM,1896,18,20-24,1914,22
SIM,1923,42,40-44,1965,2
STAT,1886,41,35-39,1927,1.9397766337618687
STAT,1919,29,15-19,1948,0.7646535019966102
STAT,1781,81,na,1862,114.21233156437816
SIM,1840,64,na,1904,1186
STAT,1847,101,na,1948,0.42724701242665153
STAT,1829,48,na,1877,1429.6447746013928
SIM,1846,48,na,1894,1551
STAT,1863,61,na,1924,1672.222852215581
SIM,1876,14,na,1890,2965
STAT,1864,46,na,1910,2056.297709979023
STAT,1923,31,20-24,1954,2.836857281242928
STAT,1859,14,na,1873,2230.6556836024106
STAT,1880,31,na,1911,2541.529205617696
STAT,1817,90,na,1907,36.071320158199605
SIM,1834,90,na,1924,7
SIM,1907,28,35-39,1935,17
STAT,1802,54,45-49,1856,0.040676777043464396
SIM,1877,0,na,1877,3626
STAT,1898,37,na,1935,3225.8245971427873
STAT,1809,46,50-100,1855,0.9175490322534995
STAT,1868,50,30-34,1918,0.005828513293944157
STAT,1900,23,40-44,1923,2.9145730969019663
SIM,1826,29,45-49,1855,1
SIM,1918,19,20-24,1937,201
STAT,1913,23,50-100,1936,0.6683308984905411
SIM,1909,58,na,1967,3577
SIM,1829,27,20-24,1856,11
SIM,1821,50,na,1871,1252
STAT,1917,20,40-44,1937,3.628637322244241
STAT,1804,50,na,1854,1117.7935391869657
STAT,1926,30,35-39,1956,11.180349786835205
SIM,1886,4,na,1890,2957
STAT,1850,25,40-44,1875,2.7384621517444523
SIM,1787,73,na,1860,489
STAT,1839,26,na,1865,1946.0906152114687
SIM,1862,38,30-34,1900,12
STAT,1870,38,15-19,1908,0.05541719468360228
STAT,1908,42,35-39,1950,0.18806482592834342
STAT,1841,16,15-19,1857,5.75769430118213
STAT,1855,17,50-100,1872,0.04386176080893
SIM,1806,83,na,1889,101
STAT,1841,47,35-39,1888,0.10516865569750074
STAT,1915,42,40-44,1957,0.25409868099121674
STAT,1888,49,40-44,1937,0.11271979499816193
STAT,1801,85,na,1886,97.4617447277776
STAT,1883,44,35-39,1927,1.7655980801447742
STAT,1888,18,20-24,1906,21.079017289189235
SIM,1843,23,50-100,1866,3
STAT,1866,17,30-34,1883,1.5300194715411888
SIM,1934,30,35-39,1964,18
SIM,1901,30,na,1931,3447
STAT,1922,48,50-100,1970,0.2617662519669086
STAT,1902,36,20-24,1938,0.2386118492039604
SIM,1899,17,35-39,1916,1
SIM,1847,15,20-24,1862,20
STAT,1821,35,15-19,1856,0.1228868946909791
SIM,1811,72,na,1883,687
STAT,1857,54,35-39,1911,0.00659943040936392
SIM,1817,46,50-100,1863,1
STAT,1848,94,na,1942,16.31780199796525
SIM,1839,16,25-29,1855,9
STAT,1940,8,na,1948,4071.530774567142
STAT,1942,24,na,1966,3863.2429449388333
STAT,1859,27,40-44,1886,2.47540606717036
STAT,1938,29,na,1967,3743.0070969888066
STAT,1922,36,na,1958,4328.637051223972
SIM,1842,41,35-39,1883,4
SIM,1869,44,na,1913,2224
SIM,1931,31,20-24,1962,3
STAT,1918,52,na,1970,3880.4952198395367
SIM,1874,17,30-34,1891,4
STAT,1888,59,na,1947,2316.826314896725
STAT,1916,41,30-34,1957,0.13240499959855778
SIM,1840,86,na,1926,125
STAT,1896,47,25-29,1943,0.043235658623968776
SIM,1840,37,40-44,1877,10
STAT,1865,39,45-49,1904,1.8200013445315522
STAT,1786,69,na,1855,694.6114000000001
SIM,1826,71,na,1897,955
STAT,1875,40,20-24,1915,0.16638577484182906
STAT,1797,85,na,1882,91.61097510296818
STAT,1816,53,35-39,1869,0.02095904082995632
STAT,1850,42,30-34,1892,0.8792330350964035
SIM,1847,65,na,1912,1199
STAT,1863,29,na,1892,2120.411156063008
STAT,1882,32,25-29,1914,10.02082701977709
SIM,1903,33,50-100,1936,1
STAT,1849,79,na,1928,546.5974636544497
STAT,1839,15,20-24,1854,16.637553487508892
SIM,1861,15,na,1876,2407
STAT,1851,19,50-100,1870,0.04457227243219371
SIM,1912,24,na,1936,3543
STAT,1839,46,40-44,1885,0.12526118019455257
SIM,1779,86,na,1865,83
STAT,1879,51,45-49,1930,0.015369267767202118
SIM,1839,78,na,1917,391
STAT,1789,87,na,1876,70.7274082818267
SIM,1821,37,30-34,1858,8
SIM,1873,39,45-49,1912,5
STAT,1815,41,25-29,1856,1.7324087226495968
STAT,1927,42,45-49,1969,0.21097024341465193
STAT,1930,23,na,1953,4713.756253469194
STAT,1897,28,15-19,1925,0.6121774404933514
STAT,1832,37,40-44,1869,3.7774752172657347
STAT,1840,34,na,1874,1812.3644000923073
SIM,1849,39,40-44,1888,5
SIM,1834,47,na,1881,1738
SIM,1841,18,30-34,1859,4
STAT,1776,107,na,1883,0.006966757746608134
STAT,1872,43,20-24,1915,0.1600971484075905
STAT,1822,47,25-29,1869,0.08540216813570348
SIM,1870,83,na,1953,310
STAT,1810,45,40-44,1855,0.6870662266956741
SIM,1814,70,na,1884,696
STAT,1835,53,45-49,1888,0.010887002184666416
STAT,1930,30,15-19,1960,0.16780803135899028
SIM,1885,82,na,1967,698
SIM,1897,22,50-100,1919,2
SIM,1915,30,25-29,1945,17
STAT,1945,19,15-19,1964,50.03283482577894
SIM,1858,16,35-39,1874,2
STAT,1877,47,15-19,1924,4.1502504577340055E-4
SIM,1921,37,35-39,1958,6
STAT,1935,35,20-24,1970,0.37306435887372175
STAT,1913,37,35-39,1950,2.408365424048507
SIM,1890,32,25-29,1922,11
SIM,1877,31,na,1908,2564
STAT,1913,43,20-24,1956,0.017349066260799503
STAT,1894,40,30-34,1934,1.5100388923098012
STAT,1806,84,na,1890,112.16135015474727
STAT,1839,27,15-19,1866,0.4052228864240058
SIM,1909,48,50-100,1957,5
STAT,1901,30,30-34,1931,24.919177423963824
STAT,1828,44,15-19,1872,0.01274769856184023
SIM,1881,78,na,1959,743
STAT,1807,52,30-34,1859,0.020203260350473592
STAT,1849,57,na,1906,1571.2358121611942
STAT,1858,23,50-100,1881,0.33495413446861166
STAT,1880,63,na,1943,1892.630245335845
STAT,1825,43,35-39,1868,2.537702141152117
SIM,1908,41,na,1949,3353
SIM,1862,96,na,1958,4
SIM,1859,12,na,1871,2605
STAT,1864,40,45-49,1904,1.3777821047306782
STAT,1890,38,40-44,1928,5.375745887386986
STAT,1840,32,20-24,1872,2.3078664099738995
STAT,1878,59,na,1937,2037.634261294107
STAT,1893,39,20-24,1932,0.9786190830796441
SIM,1790,94,na,1884,4
STAT,1931,18,na,1949,4856.297221974064
STAT,1787,75,na,1862,342.3542159912738
STAT,1884,6,na,1890,2601.8948149572484
SIM,1824,69,na,1893,787
STAT,1826,48,20-24,1874,0.01166499855277295
STAT,1888,45,25-29,1933,0.06935019916604968
SIM,1873,59,na,1932,1841
STAT,1895,47,50-100,1942,0.18187578743992341
STAT,1892,34,35-39,1926,12.724945983578793
SIM,1856,79,na,1935,421
STAT,1830,37,30-34,1867,4.845271098742877
STAT,1911,34,20-24,1945,2.3757436426118774
STAT,1885,44,45-49,1929,1.4843191676128022
SIM,1893,24,50-100,1917,3
SIM,1841,42,30-34,1883,4
STAT,1871,30,35-39,1901,10.24342473118258
STAT,1910,42,40-44,1952,0.2384938968672876
STAT,1872,34,50-100,1906,0.9224093734823827
STAT,1859,47,50-100,1906,0.19857949298868308
STAT,1860,31,35-39,1891,8.395343695368219
SIM,1920,31,45-49,1951,1
SIM,1929,29,25-29,1958,92
STAT,1843,16,25-29,1859,4.913224910275096
STAT,1931,20,15-19,1951,7.019207963371416
STAT,1922,48,40-44,1970,0.18246898358901953
SIM,1809,46,50-100,1855,2
STAT,1900,34,45-49,1934,2.425655156911994
SIM,1833,43,35-39,1876,3
STAT,1838,94,na,1932,13.379209609546212
STAT,1895,35,15-19,1930,0.07476922226038456
SIM,1932,30,25-29,1962,21
STAT,1913,30,15-19,1943,0.13003574276123608
STAT,1907,32,40-44,1939,3.6934491312165347
STAT,1855,64,na,1919,1308.498611142172
STAT,1927,25,50-100,1952,1.2313588552725356
SIM,1873,49,na,1922,2109
STAT,1815,48,45-49,1863,0.5149719238286452
SIM,1915,32,40-44,1947,7
STAT,1783,72,na,1855,550.28985
STAT,1891,26,na,1917,2994.53657778345
STAT,1817,47,na,1864,1326.1471967227735
STAT,1870,31,na,1901,2376.3871389022443
STAT,1823,54,na,1877,1281.7364181083813
STAT,1902,41,50-100,1943,0.10518069225400926
STAT,1924,30,25-29,1954,10.945710355462975
STAT,1823,47,40-44,1870,0.23563966577924803
STAT,1847,17,50-100,1864,0.04578279095254597
SIM,1879,18,20-24,1897,28
SIM,1872,40,45-49,1912,2
STAT,1818,53,45-49,1871,0.024330715589234834
STAT,1925,2,na,1927,4992.96269803916
STAT,1851,71,na,1922,1010.6947318927224
STAT,1912,26,na,1938,3737.302088148223
SIM,1854,67,na,1921,1428
STAT,1773,109,na,1882,0.0032985527439125086
STAT,1836,82,na,1918,294.1914143349613
STAT,1916,8,na,1924,4256.401040072021
STAT,1912,31,45-49,1943,1.5685459627202651
STAT,1865,17,15-19,1882,5.6400071734636406
SIM,1823,84,na,1907,204
STAT,1910,18,50-100,1928,0.0747019217992745
STAT,1920,45,na,1965,4120.288753027326
STAT,1852,38,20-24,1890,0.5817059447123347
SIM,1790,72,na,1862,578
STAT,1917,40,35-39,1957,0.2127053228568759
STAT,1911,29,50-100,1940,0.9722999639354095
SIM,1862,86,na,1948,258
STAT,1851,33,35-39,1884,7.898663288707234
STAT,1914,48,50-100,1962,0.22569325598358406
STAT,1896,44,20-24,1940,0.014544955816500851
STAT,1947,19,25-29,1966,49.27565761683015
STAT,1904,44,30-34,1948,0.11415288228228805
STAT,1861,71,na,1932,1120.271616018009
STAT,1859,54,45-49,1913,0.011464761858907222
STAT,1888,69,na,1957,1807.6127301385718
STAT,1923,47,45-49,1970,0.25688998763970267
STAT,1950,20,25-29,1970,110.78629156891137
SIM,1884,11,na,1895,2617
STAT,1890,30,45-49,1920,2.1694563860134157
STAT,1947,19,50-100,1966,0.42601424499951707
SIM,1894,35,50-100,1929,2
STAT,1804,72,na,1876,522.5810283731887
STAT,1823,64,na,1887,980.4918390931912
STAT,1893,43,40-44,1936,0.19886309047400716
SIM,1841,49,na,1890,1528
STAT,1841,31,25-29,1872,9.390345148190836
SIM,1912,25,50-100,1937,1
SIM,1841,27,na,1868,1821
STAT,1823,32,na,1855,1586.2020306056645
STAT,1886,49,30-34,1935,0.10107154475904985
SIM,1878,40,50-100,1918,2
STAT,1897,43,25-29,1940,0.059944960471123104
STAT,1841,38,45-49,1879,1.738262736322435
STAT,1772,109,na,1881,0.0022913755703265065
STAT,1899,28,25-29,1927,58.42979374145123
SIM,1873,17,15-19,1890,8
SIM,1901,31,35-39,1932,20
STAT,1883,40,50-100,1923,1.05470278098408
STAT,1833,64,na,1897,1229.88120518569
STAT,1864,48,40-44,1912,0.1540689683428169
STAT,1906,29,50-100,1935,0.9343278120717946
STAT,1874,43,30-34,1917,1.1803860314821055
STAT,1905,30,15-19,1935,0.20960032306613438
STAT,1866,15,15-19,1881,5.764520363982907
STAT,1902,26,na,1928,3417.8784360929963
STAT,1876,3,na,1879,3206.105703179725
STAT,1814,46,50-100,1860,0.6024043228841773
STAT,1925,18,35-39,1943,5.109310570387141
STAT,1894,76,na,1970,1674.8799833473072
SIM,1940,30,25-29,1970,14
STAT,1847,44,25-29,1891,0.4743167605531272
SIM,1870,31,45-49,1901,5
STAT,1922,41,20-24,1963,0.020507458142440923
SIM,1933,18,35-39,1951,10
SIM,1820,66,na,1886,846
SIM,1841,17,na,1858,2078
STAT,1906,19,na,1925,3695.5028888212123
STAT,1892,28,50-100,1920,0.8078790405625902
STAT,1959,13,na,1972,5188.888245887956
SIM,1882,43,30-34,1925,3
STAT,1813,50,40-44,1863,0.030309602227088353
STAT,1862,44,50-100,1906,0.909020821823028
STAT,1856,46,40-44,1902,0.1329444647165513
SIM,1874,15,15-19,1889,9
STAT,1915,45,45-49,1960,0.22202679351611562
STAT,1870,33,45-49,1903,1.7222038470798522
STAT,1873,34,25-29,1907,10.397710793837135
STAT,1845,48,30-34,1893,0.0698416791073467
STAT,1868,45,50-100,1913,0.2394389783662276
STAT,1888,39,50-100,1927,1.4488759423814526
STAT,1873,31,20-24,1904,2.7789982374717397
STAT,1876,32,50-100,1908,0.9555002084049737
STAT,1858,42,35-39,1900,1.4330979904021217
STAT,1899,45,50-100,1944,0.19395040414086026
STAT,1866,59,na,1925,1817.5909745946608
STAT,1941,18,na,1959,3826.391958330088
STAT,1969,0,na,1969,4996.606237435228
STAT,1911,41,45-49,1952,0.161181700166237
STAT,1920,30,40-44,1950,4.3633880561080165
STAT,1836,50,35-39,1886,0.005717169244864105
SIM,1906,60,na,1966,2884
SIM,1857,8,na,1865,2561
STAT,1826,52,40-44,1878,0.0100050048977931
STAT,1874,78,na,1952,808.0461515780153
STAT,1870,63,na,1933,1769.651973218383
STAT,1820,99,na,1919,0.9640205110627834
STAT,1846,53,20-24,1899,5.510045326888098E-4
SIM,1928,17,15-19,1945,54
SIM,1869,12,na,1881,2502
SIM,1872,96,na,1968,10
STAT,1912,46,30-34,1958,0.08665018303036572
SIM,1881,31,20-24,1912,3
SIM,1923,45,45-49,1968,1
STAT,1822,33,50-100,1855,2.3812051569463373
STAT,1869,45,15-19,1914,3.966989439051929E-4
STAT,1852,54,35-39,1906,0.006349496833174593
SIM,1864,46,40-44,1910,2
STAT,1906,18,25-29,1924,8.314502717909576
STAT,1843,40,25-29,1883,0.45751424126262674
SIM,1815,87,na,1902,67
STAT,1807,47,na,1854,1255.4954708839039
SIM,1866,42,35-39,1908,1
STAT,1842,27,50-100,1869,0.7122325665166619
STAT,1829,53,20-24,1882,4.745792243874129E-4
STAT,1855,96,na,1951,6.4633560997962345
STAT,1902,42,40-44,1944,0.22265546315044268
SIM,1773,92,na,1865,15
SIM,1939,19,40-44,1958,1
STAT,1802,91,na,1893,20.245998530718158
STAT,1852,45,45-49,1897,0.18076485825130428
STAT,1848,53,30-34,1901,0.004781976657634459
SIM,1874,41,30-34,1915,2
STAT,1859,34,50-100,1893,0.7379264691001539
STAT,1898,40,15-19,1938,0.001326296919889467
SIM,1917,23,na,1940,3789
SIM,1880,47,50-100,1927,3
STAT,1867,49,20-24,1916,0.011176334052260378
STAT,1795,72,na,1867,634.0644576687656
SIM,1833,84,na,1917,181
STAT,1886,47,na,1933,2388.0291914762356
STAT,1906,40,25-29,1946,0.06626241134525578
STAT,1840,106,na,1946,0.008511174727401965
STAT,1845,46,50-100,1891,0.17996600249020425
SIM,1837,29,20-24,1866,7
STAT,1920,31,45-49,1951,1.747669176237986
STAT,1905,56,na,1961,3098.1861864987086
STAT,1925,40,35-39,1965,0.24706452507152019
SIM,1851,40,25-29,1891,1
SIM,1910,42,40-44,1952,1
SIM,1840,33,25-29,1873,19
STAT,1842,50,50-100,1892,0.01379293225694147
STAT,1842,46,na,1888,2052.071136375633
STAT,1916,19,50-100,1935,0.07978730356071496
SIM,1824,47,na,1871,1467
STAT,1882,36,40-44,1918,4.303332185339827
STAT,1837,45,na,1882,1634.546552520512
STAT,1932,32,25-29,1964,12.416732309401654
SIM,1900,21,40-44,1921,5
SIM,1899,26,25-29,1925,81
SIM,1837,65,na,1902,995
STAT,1832,33,25-29,1865,9.019171637656552
STAT,1839,79,na,1918,495.64665689495683
STAT,1867,21,50-100,1888,0.3923139727327136
STAT,1791,91,na,1882,17.071984775531668
STAT,1880,24,15-19,1904,3.4774031323479013
STAT,1866,41,30-34,1907,1.0800722363517152
STAT,1880,21,50-100,1901,0.4338534663419412
STAT,1902,43,45-49,1945,0.1472632637872668
SIM,1892,17,25-29,1909,12
SIM,1805,87,na,1892,67
SIM,1885,42,45-49,1927,3
SIM,1899,4,na,1903,3978
STAT,1815,45,40-44,1860,0.3928129362500263
STAT,1768,117,na,1885,1.3154573507741327E-4
STAT,1853,33,50-100,1886,0.7722276665894167
STAT,1850,54,25-29,1904,0.002637585366115285
SIM,1774,87,na,1861,36
SIM,1890,36,40-44,1926,6
SIM,1938,31,30-34,1969,18
STAT,1920,23,na,1943,4087.0380786291007
SIM,1837,97,na,1934,8
STAT,1855,43,20-24,1898,0.11867833546431077
STAT,1930,34,30-34,1964,20.524153185197264
STAT,1833,45,35-39,1878,0.11947398142877279
STAT,1856,42,25-29,1898,0.496639697782593
STAT,1901,63,na,1964,2735.023280098317
STAT,1914,46,40-44,1960,0.1581544398097808
STAT,1867,53,40-44,1920,0.009853343393172962
STAT,1901,31,35-39,1932,14.397077855733768
STAT,1834,27,na,1861,1688.3878059023516
STAT,1884,17,25-29,1901,5.64403321473987
STAT,1816,84,na,1900,170.08172075852178
STAT,1845,44,15-19,1889,0.010015546699373322
STAT,1843,48,20-24,1891,0.007991917256431402
STAT,1814,50,na,1864,1385.8638749389236
STAT,1910,40,25-29,1950,0.06886063749968718
SIM,1865,15,15-19,1880,6
SIM,1863,19,20-24,1882,32
STAT,1892,31,30-34,1923,22.218511803421144
SIM,1898,18,30-34,1916,3
SIM,1886,30,45-49,1916,3
STAT,1959,4,na,1963,5195.6906594870625
STAT,1881,40,45-49,1921,1.4717796138889134
STAT,1884,41,25-29,1925,0.6424791679363673
STAT,1829,50,50-100,1879,0.011327481988776525
STAT,1894,44,na,1938,2975.058877060947
STAT,1767,107,na,1874,0.006246570045054469
SIM,1851,31,35-39,1882,15
STAT,1862,34,na,1896,2063.568927116726
STAT,1876,45,50-100,1921,0.25867565491752403
STAT,1906,42,25-29,1948,0.0655197138984648
SIM,1810,88,na,1898,112
SIM,1951,0,na,1951,5141
SIM,1877,41,na,1918,2401
SIM,1873,39,50-100,1912,1
SIM,1832,35,na,1867,1695
STAT,1878,30,45-49,1908,1.843014984860948
SIM,1833,40,30-34,1873,4
SIM,1916,30,40-44,1946,6
STAT,1786,90,na,1876,31.261170137286264
STAT,1876,19,40-44,1895,0.1897162684567374
SIM,1845,31,na,1876,2049
STAT,1881,48,na,1929,2162.845221342904
STAT,1911,37,25-29,1948,0.959446861942169
STAT,1877,42,45-49,1919,1.5582118427628813
SIM,1894,11,na,1905,3718
SIM,1838,17,20-24,1855,18
STAT,1867,11,na,1878,2562.6577873180827
STAT,1855,19,20-24,1874,15.685689522549591
SIM,1826,28,na,1854,2204
STAT,1817,41,35-39,1858,4.631608453009416
STAT,1817,50,25-29,1867,0.007590823201130932
STAT,1857,15,15-19,1872,5.563461119366848
STAT,1815,54,30-34,1869,0.012121723966364734
STAT,1870,85,na,1955,271.8833046915235
STAT,1899,21,na,1920,3288.2140445294967
STAT,1875,1,na,1876,3592.4212635663453
STAT,1825,40,30-34,1865,1.7262166837372783
SIM,1912,56,na,1968,3247
STAT,1795,106,na,1901,0.0028111675399976484
STAT,1950,22,40-44,1972,4.029971603667406
SIM,1815,65,na,1880,874
STAT,1882,45,30-34,1927,0.09564820322545085
STAT,1830,33,50-100,1863,0.8653926130467102
SIM,1849,17,30-34,1866,3
STAT,1903,41,45-49,1944,0.15017037604796965
SIM,1923,19,na,1942,4252
STAT,1865,39,50-100,1904,1.1208971065084612
STAT,1822,44,20-24,1866,0.24066615314823553
STAT,1838,54,25-29,1892,0.0023059130509237354
STAT,1860,53,30-34,1913,0.004835674045429214
STAT,1877,51,35-39,1928,0.009017222589606211
STAT,1864,78,na,1942,712.0966068367957
STAT,1832,30,20-24,1862,2.4581164120405816
SIM,1847,42,25-29,1889,3
SIM,1903,46,50-100,1949,2
STAT,1842,52,25-29,1894,0.0031720205798817912
STAT,1858,51,25-29,1909,0.0028200722112486608
STAT,1812,45,15-19,1857,9.52747154458458E-4
STAT,1892,40,20-24,1932,0.20330728221633407
STAT,1864,15,50-100,1879,0.05136152576327628
STAT,1921,32,15-19,1953,0.14443277824742742
STAT,1898,16,15-19,1914,8.145595664796074
STAT,1928,41,15-19,1969,0.001981639222313201
SIM,1825,41,35-39,1866,1
STAT,1852,42,40-44,1894,1.7037325240421906
STAT,1874,46,35-39,1920,0.14519761898887307
SIM,1840,30,20-24,1870,1
STAT,1884,32,35-39,1916,10.086507137493914
SIM,1851,27,na,1878,2160
STAT,1831,49,40-44,1880,0.12463776808761849
STAT,1846,82,na,1928,354.0823531391426
STAT,1911,41,na,1952,3596.8146931157457
STAT,1879,77,na,1956,952.3198185333733
STAT,1770,100,na,1870,0.11008407114164673
SIM,1947,21,na,1968,4493
STAT,1767,87,na,1854,42.0
SIM,1900,24,na,1924,3436
STAT,1881,26,na,1907,2331.41001086418
STAT,1812,49,30-34,1861,0.21621652085751217
SIM,1914,1,na,1915,4504
STAT,1908,18,35-39,1926,0.8195002908535033
SIM,1892,32,35-39,1924,25
SIM,1955,6,na,1961,5061
STAT,1869,77,na,1946,848.797206614147
SIM,1904,27,na,1931,3572
SIM,1881,34,25-29,1915,13
STAT,1863,45,20-24,1908,0.010845737623990107
STAT,1849,15,15-19,1864,5.779283943718799
STAT,1851,30,30-34,1881,14.048693997186556
STAT,1932,5,na,1937,5380.4268163796105
SIM,1923,20,30-34,1943,51
STAT,1841,44,30-34,1885,0.8707754480796077
SIM,1865,2,na,1867,3117
SIM,1810,66,na,1876,988
STAT,1892,0,na,1892,3721.4517687550447
STAT,1841,35,40-44,1876,3.93783299164596
STAT,1899,43,na,1942,3191.570577406162
STAT,1822,46,50-100,1868,0.36928853285865787
STAT,1836,41,45-49,1877,1.1376634802223415
STAT,1850,21,25-29,1871,52.99205683803443
SIM,1942,22,na,1964,4019
STAT,1940,31,20-24,1971,2.550031026399684
SIM,1828,61,na,1889,1102
SIM,1798,68,na,1866,713
STAT,1915,20,30-34,1935,28.93902478235117
SIM,1828,83,na,1911,206
STAT,1871,54,45-49,1925,0.014161659217359818
STAT,1856,49,na,1905,1705.7809019655288
STAT,1893,46,45-49,1939,0.17120801056677779
SIM,1903,20,na,1923,3250
STAT,1886,45,15-19,1931,4.3080942956405733E-4
STAT,1949,13,na,1962,4614.658859487747
SIM,1883,59,na,1942,2102
STAT,1796,90,na,1886,29.812464597654834
STAT,1934,20,40-44,1954,4.580662416244997
SIM,1800,88,na,1888,92
SIM,1830,54,na,1884,1187
STAT,1813,54,na,1867,1203.0136651111372
STAT,1830,50,40-44,1880,0.00885388729687918
STAT,1879,51,50-100,1930,0.01599445829417599
STAT,1930,37,35-39,1967,3.1887683350196125
STAT,1879,55,na,1934,2179.36973238525
SIM,1873,27,na,1900,2312
SIM,1871,3,na,1874,2892
SIM,1906,42,40-44,1948,3
SIM,1860,20,na,1880,2136
STAT,1914,42,25-29,1956,0.07139142213144418
STAT,1876,15,25-29,1891,5.936964202259806
STAT,1862,40,35-39,1902,1.5953655482970266
SIM,1870,40,35-39,1910,5
STAT,1882,4,na,1886,2760.508556781858
STAT,1932,30,25-29,1962,12.430775119869848
SIM,1832,31,25-29,1863,14
STAT,1858,27,25-29,1885,34.313329993953
STAT,1849,17,30-34,1866,1.533938022095144
SIM,1832,98,na,1930,2
SIM,1857,15,15-19,1872,9
STAT,1847,41,20-24,1888,0.12111416370390503
STAT,1897,18,50-100,1915,0.06616407927037453
STAT,1808,65,na,1873,834.9583223065106
STAT,1844,43,45-49,1887,1.1972963501495597
STAT,1925,42,35-39,1967,0.24638062951505044
STAT,1856,49,45-49,1905,0.1789301258290979
STAT,1868,92,na,1960,73.14196900124493
SIM,1927,33,na,1960,5170
STAT,1903,12,na,1915,3714.7153724988266
STAT,1944,23,50-100,1967,0.7171729106462852
STAT,1899,43,35-39,1942,0.17304478370929016
SIM,1833,52,50-100,1885,1
STAT,1845,64,na,1909,1270.1942322839352
SIM,1886,77,na,1963,1268
STAT,1936,36,50-100,1972,0.41650390219027517
STAT,1897,47,40-44,1944,0.13015326674670077
STAT,1862,31,45-49,1893,1.5272128774295348
SIM,1892,30,na,1922,3400
STAT,1885,50,30-34,1935,0.006070319797337609
SIM,1914,44,40-44,1958,2
STAT,1860,40,50-100,1900,0.8810358982411214
SIM,1858,29,40-44,1887,5
STAT,1877,11,na,1888,2712.4683314995373
STAT,1820,47,15-19,1867,6.803056024108189E-4
STAT,1824,31,25-29,1855,23.290105921704686
STAT,1940,32,25-29,1972,9.657137452090312
STAT,1882,39,45-49,1921,1.930693735545202
STAT,1880,48,25-29,1928,0.06032923913669564
STAT,1891,22,25-29,1913,71.58438885107043
STAT,1825,29,50-100,1854,2.602271555176336
STAT,1860,47,45-49,1907,0.19393947678182388
STAT,1833,42,30-34,1875,0.9892211680042264
STAT,1910,31,35-39,1941,8.926168186867455
SIM,1784,87,na,1871,46
SIM,1932,32,40-44,1964,9
STAT,1908,30,40-44,1938,3.758784879321464
STAT,1904,47,35-39,1951,0.11392937542882006
STAT,1820,49,30-34,1869,0.159710207230539
STAT,1781,91,na,1872,10.413051061606051
STAT,1926,45,20-24,1971,0.013846044369572222
STAT,1847,40,50-100,1887,0.8160609204502661
STAT,1894,47,15-19,1941,2.9203088835415666E-4
STAT,1897,41,50-100,1938,0.09978618924778974
STAT,1949,16,30-34,1965,14.325451720824512
SIM,1873,32,25-29,1905,18
SIM,1928,18,na,1946,4736
STAT,1928,19,15-19,1947,57.489705951802385
SIM,1897,18,na,1915,3471
SIM,1936,19,15-19,1955,55
STAT,1918,46,50-100,1964,0.24359839860048965
SIM,1857,17,30-34,1874,2
STAT,1814,42,20-24,1856,0.4813260535637605
SIM,1886,15,35-39,1901,2
STAT,1841,83,na,1924,296.87264842089496
SIM,1866,27,25-29,1893,46
STAT,1822,51,45-49,1873,0.021141370898368667
STAT,1862,12,na,1874,2384.7415029379413
STAT,1914,41,20-24,1955,0.01768140455592288
STAT,1922,35,50-100,1957,0.4834645878439505
STAT,1828,53,na,1881,1468.395598322187
STAT,1881,33,20-24,1914,2.6204992500184727
SIM,1877,63,na,1940,1803
STAT,1890,43,15-19,1933,0.01692043194007505
STAT,1811,44,45-49,1855,3.9359929232870647
STAT,1866,44,35-39,1910,1.6706725263850073
STAT,1847,45,na,1892,1701.3332271600423
STAT,1924,32,40-44,1956,4.613567127606638
STAT,1883,81,na,1964,799.3014069906461
STAT,1825,52,50-100,1877,0.019542906149923902
STAT,1868,17,40-44,1885,0.17975132283216674
STAT,1875,30,na,1905,2495.018945321677
STAT,1920,48,30-34,1968,0.09923513231224228
STAT,1817,79,na,1896,319.8562654495498
STAT,1861,48,15-19,1909,3.3149353438923954E-4
STAT,1902,40,40-44,1942,0.22517936983678988
SIM,1862,64,na,1926,1501
SIM,1868,26,na,1894,2165
SIM,1874,44,35-39,1918,2
STAT,1782,76,na,1858,366.86755104863596
STAT,1834,54,40-44,1888,0.006178993808018953
SIM,1867,34,50-100,1901,1
STAT,1866,50,20-24,1916,7.000436496640187E-4
STAT,1871,38,30-34,1909,5.321302144749138
STAT,1888,42,20-24,1930,0.1890897830407914
STAT,1832,46,na,1878,1659.956206049099
STAT,1843,31,35-39,1874,8.297137564655573
SIM,1871,22,35-39,1893,6
STAT,1831,30,50-100,1861,0.776616585660023
STAT,1914,31,20-24,1945,2.4873523902976347
STAT,1846,19,50-100,1865,0.04615601947834768
STAT,1911,30,40-44,1941,3.8753983837311994
STAT,1830,52,20-24,1882,5.428049987848838E-4
STAT,1811,51,50-100,1862,0.03669800524410533
SIM,1776,90,na,1866,9
STAT,1848,20,45-49,1868,0.7032854617606585
STAT,1894,49,50-100,1943,0.17638563919713166
STAT,1932,22,25-29,1954,122.47888328702528
STAT,1925,45,40-44,1970,0.19398592561485722
STAT,1915,18,40-44,1933,0.294620102453019
STAT,1918,19,20-24,1937,148.17944208697276
SIM,1806,50,na,1856,1426
SIM,1874,23,15-19,1897,3
STAT,1857,25,50-100,1882,0.5269080046509887
SIM,1848,15,15-19,1863,4
SIM,1910,32,40-44,1942,4
STAT,1874,14,na,1888,2679.179269505949
STAT,1833,105,na,1938,0.020744250406364025
SIM,1914,25,35-39,1939,18
STAT,1929,38,35-39,1967,3.135460295616208
SIM,1865,61,na,1926,1632
SIM,1896,22,40-44,1918,6
STAT,1920,41,45-49,1961,0.18588652097452307
STAT,1840,65,na,1905,1184.6428626550476
STAT,1921,29,20-24,1950,20.400219699092855
STAT,1844,79,na,1923,553.1210283534778
STAT,1911,43,45-49,1954,0.15929658025013876
SIM,1931,22,30-34,1953,47
STAT,1868,31,50-100,1899,0.888057865083431
STAT,1888,22,40-44,1910,2.484132858509141
SIM,1795,61,na,1856,944
SIM,1923,18,40-44,1941,1
STAT,1866,23,15-19,1889,3.0882132418078747
STAT,1915,23,35-39,1938,9.790902040714016
STAT,1923,20,na,1943,4318.781746488526
STAT,1839,22,45-49,1861,0.6352223367157228
STAT,1946,17,na,1963,4123.306331498679
STAT,1931,41,20-24,1972,0.02387853271897763
STAT,1885,24,50-100,1909,0.4074006168355436
STAT,1912,39,50-100,1951,0.40926940842742837
SIM,1842,13,na,1855,2293
STAT,1896,30,50-100,1926,1.2347944127019421
SIM,1884,44,na,1928,2348
STAT,1912,36,15-19,1948,0.0190005134639331
SIM,1922,23,na,1945,4568
SIM,1879,25,45-49,1904,2
STAT,1847,12,na,1859,2230.867489485093
STAT,1941,20,25-29,1961,96.43878954694608
STAT,1875,21,15-19,1896,3.4321361401744164
SIM,1876,25,na,1901,2761
SIM,1899,23,20-24,1922,116
SIM,1907,22,40-44,1929,4
SIM,1931,24,25-29,1955,122
STAT,1921,34,15-19,1955,0.14319620245763803
SIM,1894,74,na,1968,1830
STAT,1902,32,40-44,1934,6.18962223227106
SIM,1905,32,30-34,1937,6
SIM,1940,30,50-100,1970,1
SIM,1940,22,25-29,1962,111
STAT,1934,38,45-49,1972,0.9496017121947286
SIM,1829,31,40-44,1860,6
STAT,1862,48,30-34,1910,0.08337004790911895
STAT,1927,17,20-24,1944,170.38312107614541
STAT,1923,42,25-29,1965,0.08432997429740867
STAT,1910,29,45-49,1939,1.6711003514258704
SIM,1888,58,na,1946,2568
SIM,1926,19,20-24,1945,183
SIM,1859,77,na,1936,727
STAT,1921,41,na,1962,4230.912083101637
SIM,1867,96,na,1963,13
STAT,1917,36,na,1953,3963.350938316538
STAT,1897,15,45-49,1912,0.08886146668544333
STAT,1867,15,30-34,1882,1.568353922746686
STAT,1917,46,45-49,1963,0.22971300239737447
SIM,1901,61,na,1962,2777
STAT,1927,40,45-49,1967,0.21155584794169055
SIM,1935,17,20-24,1952,260
STAT,1931,19,35-39,1950,5.5210597111478315
SIM,1855,21,40-44,1876,4
SIM,1901,1,na,1902,3909
SIM,1922,26,25-29,1948,103
STAT,1859,20,20-24,1879,64.75201855323115
STAT,1904,25,50-100,1929,0.9334724853502504
STAT,1930,27,20-24,1957,23.45958947891995
SIM,1907,40,40-44,1947,1
SIM,1808,48,50-100,1856,4
SIM,1916,39,na,1955,3785
STAT,1814,49,na,1863,1401.6386217582974
SIM,1838,24,45-49,1862,4
SIM,1852,43,na,1895,1688
STAT,1914,20,50-100,1934,0.6547386668253966
STAT,1907,19,45-49,1926,0.09636856822645569
SIM,1892,63,na,1955,2492
STAT,1924,16,40-44,1940,1.6872737289318518
SIM,1922,24,30-34,1946,70
SIM,1818,43,50-100,1861,6
SIM,1856,20,45-49,1876,5
SIM,1808,85,na,1893,65
SIM,1905,27,35-39,1932,20
STAT,1846,30,35-39,1876,9.272664960038624
STAT,1923,45,50-100,1968,0.26859800190672783
STAT,1903,31,45-49,1934,2.5185876186141076
SIM,1932,16,40-44,1948,4
STAT,1857,25,15-19,1882,0.37371008976150505
SIM,1922,31,20-24,1953,3
SIM,1884,64,na,1948,1872
STAT,1855,31,na,1886,1848.0187449952602
STAT,1897,62,na,1959,2569.5077361914077
SIM,1833,52,na,1885,1530
SIM,1869,33,35-39,1902,8
STAT,1829,27,50-100,1856,0.8465120134942244
STAT,1942,23,na,1965,3864.595553382517
SIM,1797,72,na,1869,562
SIM,1939,28,45-49,1967,2
SIM,1905,34,25-29,1939,12
SIM,1911,31,45-49,1942,5
STAT,1950,22,na,1972,4376.881668150151
STAT,1944,14,na,1958,4267.15621480628
SIM,1923,23,35-39,1946,20
STAT,1880,46,25-29,1926,0.061270389622713715
STAT,1915,30,25-29,1945,9.574835664474199
SIM,1867,20,20-24,1887,3
STAT,1932,15,35-39,1947,5.64119096776538
SIM,1940,15,35-39,1955,7
STAT,1929,37,na,1966,4881.929267104114
STAT,1867,20,50-100,1887,0.3951511580474946
STAT,1900,37,35-39,1937,2.141876057299112
STAT,1943,18,15-19,1961,48.577911693744
SIM,1829,47,na,1876,1668
SIM,1825,33,na,1858,1498
STAT,1916,47,40-44,1963,0.16319401559292254
STAT,1852,98,na,1950,2.463667474974684
STAT,1920,23,45-49,1943,1.2592764742874982
STAT,1909,26,15-19,1935,0.688948178902553
STAT,1811,47,15-19,1858,9.963815199804233E-4
STAT,1928,39,30-34,1967,2.323183243694204
STAT,1863,22,35-39,1885,5.326182445499414
STAT,1905,29,35-39,1934,13.987675419125024
STAT,1859,16,35-39,1875,0.5204716301456359
SIM,1910,27,45-49,1937,3
SIM,1951,18,15-19,1969,1
SIM,1927,18,25-29,1945,79
SIM,1906,30,25-29,1936,12
STAT,1890,48,35-39,1938,0.09623909323085703
STAT,1895,30,30-34,1925,23.213835963304774
STAT,1877,42,na,1919,2406.3239913597367
SIM,1862,33,na,1895,2154
STAT,1826,50,na,1876,1349.7593552007875
STAT,1889,75,na,1964,1580.0310208050723
STAT,1849,47,na,1896,1750.8437639720087
STAT,1908,15,45-49,1923,0.09827028435710339
STAT,1899,22,15-19,1921,4.572948287552975
STAT,1878,30,30-34,1908,18.45286803831144
STAT,1908,43,na,1951,3447.78281840468
STAT,1800,69,na,1869,614.5091754167133
STAT,1852,48,15-19,1900,2.9954483819503823E-4
SIM,1910,22,na,1932,3618
STAT,1925,15,45-49,1940,0.6126823970956398
STAT,1847,41,50-100,1888,0.8056724649329343
SIM,1876,45,na,1921,2605
SIM,1858,18,35-39,1876,1
SIM,1837,30,35-39,1867,13
SIM,1849,67,na,1916,1171
SIM,1930,25,20-24,1955,28
STAT,1889,23,na,1912,2936.316460198463
STAT,1914,26,25-29,1940,67.1767974191873
SIM,1923,30,25-29,1953,14
SIM,1902,15,15-19,1917,15
SIM,1821,51,na,1872,1222
SIM,1886,30,30-34,1916,35
STAT,1899,18,30-34,1917,2.203556608279049
SIM,1898,24,15-19,1922,4
STAT,1918,42,45-49,1960,0.17864490244735748
STAT,1919,18,25-29,1937,48.22569087806748
SIM,1904,28,30-34,1932,3
STAT,1807,91,na,1898,20.526863586096198
STAT,1847,21,40-44,1868,1.9265159106245575
SIM,1913,29,35-39,1942,24
STAT,1874,1,na,1875,3595.3018090646774
STAT,1940,17,35-39,1957,4.30121509872935
SIM,1934,28,50-100,1962,2
SIM,1888,23,45-49,1911,2
STAT,1897,42,na,1939,3136.4963109543146
STAT,1825,88,na,1913,100.18392374279176
STAT,1832,78,na,1910,532.0283356147955
STAT,1775,108,na,1883,0.0037011387604215813
SIM,1929,36,35-39,1965,4
STAT,1832,41,50-100,1873,0.8941476989735376
SIM,1866,24,20-24,1890,85
STAT,1840,97,na,1937,3.765875528048731
STAT,1822,68,na,1890,854.4512993628388
SIM,1793,90,na,1883,14
STAT,1903,8,na,1911,3739.2217813306056
SIM,1889,16,15-19,1905,7
STAT,1885,61,na,1946,1878.609834814268
SIM,1925,43,40-44,1968,1
SIM,1853,72,na,1925,835
SIM,1817,46,na,1863,1558
STAT,1883,15,15-19,1898,5.892792020154417
STAT,1933,32,40-44,1965,5.32916756496797
STAT,1858,24,20-24,1882,56.19747723168686
STAT,1904,37,20-24,1941,0.24115569231990236
STAT,1913,35,20-24,1948,0.26497071772780834
STAT,1926,41,40-44,1967,0.3120896153158851
STAT,1839,22,50-100,1861,0.37147506486521215
SIM,1915,16,40-44,1931,3
SIM,1901,34,40-44,1935,3
STAT,1903,38,15-19,1941,0.017347769240869726
SIM,1828,40,35-39,1868,1
SIM,1872,21,40-44,1893,2
STAT,1886,41,50-100,1927,1.1316904633538794
SIM,1922,27,35-39,1949,3
SIM,1785,71,na,1856,487
STAT,1920,38,15-19,1958,0.021210778862912977
STAT,1844,49,50-100,1893,0.19025769342251764
SIM,1890,43,50-100,1933,3
STAT,1795,105,na,1900,0.006788619995164569
STAT,1908,23,50-100,1931,0.6087503436993495
STAT,1914,27,35-39,1941,15.270582131865696
SIM,1916,48,45-49,1964,2
STAT,1784,89,na,1873,31.4589079954213
STAT,1780,75,na,1855,343.81746
SIM,1858,25,25-29,1883,46
STAT,1909,17,na,1926,3822.021592688509
SIM,1878,31,35-39,1909,3
STAT,1923,22,30-34,1945,33.789098390592336
STAT,1870,36,15-19,1906,0.05596148965225602
STAT,1913,28,30-34,1941,39.25322299466796
STAT,1935,21,na,1956,5025.885679186393
STAT,1864,21,40-44,1885,1.9436520826856638
SIM,1866,21,15-19,1887,3
SIM,1921,28,30-34,1949,54
SIM,1866,17,30-34,1883,4
STAT,1813,87,na,1900,77.24803010371039
STAT,1923,24,25-29,1947,107.91253853418718
SIM,1836,80,na,1916,525
STAT,1913,32,15-19,1945,0.12899883181882815
SIM,1918,18,na,1936,4170
STAT,1808,96,na,1904,3.2372342518843205
STAT,1835,24,50-100,1859,0.40117975624005586
STAT,1871,53,20-24,1924,7.285575182490391E-4
SIM,1835,31,na,1866,1635
STAT,1860,45,45-49,1905,0.19679041718186524
STAT,1849,31,15-19,1880,0.13027600251739724
STAT,1858,17,30-34,1875,1.4753059758134084
SIM,1883,70,na,1953,1575
STAT,1792,76,na,1868,358.86224772506233
STAT,1854,53,20-24,1907,5.449067534447612E-4
STAT,1922,25,20-24,1947,21.0083168484202
STAT,1858,83,na,1941,314.56716849840313
STAT,1911,28,50-100,1939,0.9758520654536609
STAT,1859,21,30-34,1880,16.616725723466928
SIM,1840,54,na,1894,1453
STAT,1908,48,45-49,1956,0.1978622902421961
STAT,1893,38,50-100,1931,1.5666986830867258
SIM,1930,22,na,1952,4938
STAT,1860,50,40-44,1910,0.008816813370579069
STAT,1810,54,45-49,1864,0.05107318434455758
SIM,1816,40,na,1856,1416
STAT,1923,17,35-39,1940,4.978467484304089
SIM,1901,29,45-49,1930,5
STAT,1940,24,25-29,1964,94.93060206900253
SIM,1906,26,40-44,1932,5
SIM,1931,17,35-39,1948,4
STAT,1892,43,na,1935,2908.0571607678667
STAT,1904,29,20-24,1933,16.882256863372888
SIM,1898,24,na,1922,3193
STAT,1939,2,na,1941,4123.892035550163
STAT,1813,52,20-24,1865,0.0020405667246650113
STAT,1896,57,na,1953,2686.71829062487
SIM,1936,15,na,1951,3583
SIM,1867,21,30-34,1888,20
SIM,1910,35,45-49,1945,1
STAT,1922,18,30-34,1940,14.213245941459473
STAT,1926,17,na,1943,4560.9151761721005
STAT,1867,12,na,1879,2551.0233209636585
SIM,1783,92,na,1875,14
SIM,1872,63,na,1935,2008
STAT,1852,16,50-100,1868,0.04520387111267041
SIM,1847,32,na,1879,1907
STAT,1932,18,40-44,1950,1.8667970463992023
SIM,1948,23,40-44,1971,7
STAT,1910,17,50-100,1927,0.07489815496528356
STAT,1927,39,50-100,1966,0.5264915603410641
SIM,1907,25,45-49,1932,5
STAT,1931,31,20-24,1962,3.232013805549264
SIM,1913,34,30-34,1947,24
STAT,1848,35,15-19,1883,0.04823858977079106
STAT,1947,18,50-100,1965,0.4261634021902837
SIM,1870,20,na,1890,2621
SIM,1930,18,30-34,1948,17
STAT,1837,46,na,1883,1613.7387749069255
STAT,1833,32,na,1865,1973.6928739647494
STAT,1868,21,25-29,1889,55.658292955145484
STAT,1858,21,15-19,1879,3.021004619920457
SIM,1940,18,40-44,1958,1
STAT,1915,22,25-29,1937,96.34570583917333
STAT,1915,48,35-39,1963,0.13072936729229995
STAT,1845,96,na,1941,6.274150823891367
STAT,1841,82,na,1923,348.9171270989785
STAT,1896,4,na,1900,3517.0222198315146
SIM,1883,27,na,1910,2716
SIM,1915,42,40-44,1957,3
SIM,1923,22,25-29,1945,114
STAT,1881,47,na,1928,2180.15565726156
SIM,1906,49,na,1955,3101
STAT,1941,30,25-29,1971,9.80820951515836
STAT,1834,20,15-19,1854,5.018490667436589
STAT,1846,22,35-39,1868,5.464104929336763
STAT,1799,102,na,1901,0.0983812554408297
STAT,1902,35,45-49,1937,0.619948932292628
SIM,1879,10,na,1889,3000
SIM,1875,51,na,1926,2164
SIM,1913,42,na,1955,3612
STAT,1830,99,na,1929,1.249459490389879
SIM,1879,22,40-44,1901,3
STAT,1933,10,na,1943,5376.067946929572
STAT,1779,98,na,1877,0.6719933754971728
STAT,1923,25,35-39,1948,17.534452504219036
STAT,1919,49,30-34,1968,0.09705429459649617
STAT,1854,32,35-39,1886,7.783091262626266
STAT,1938,33,30-34,1971,15.982978565647707
STAT,1901,33,35-39,1934,14.277973355880738
STAT,1805,68,na,1873,871.3760409087938
STAT,1878,15,35-39,1893,0.5779696321352139
STAT,1883,38,na,1921,2317.0305393106873
STAT,1880,43,20-24,1923,0.1672377711890219
STAT,1854,44,50-100,1898,0.7821509196869991
STAT,1876,20,20-24,1896,72.29369487308009
SIM,1931,25,35-39,1956,21
STAT,1911,40,40-44,1951,0.24357944157545844
SIM,1876,77,na,1953,808
STAT,1819,42,50-100,1861,2.267503751338176
SIM,1895,31,35-39,1926,14
SIM,1939,25,40-44,1964,5
STAT,1917,43,40-44,1960,0.263061157595717
SIM,1856,17,15-19,1873,6
STAT,1881,16,na,1897,2464.8818471212426
STAT,1826,39,50-100,1865,1.3390438564182257
SIM,1928,37,30-34,1965,3
STAT,1838,63,na,1901,1194.4605070073899
STAT,1863,3,na,1866,2885.091169993308
SIM,1929,39,40-44,1968,1
STAT,1884,15,30-34,1899,1.5948616931399506
SIM,1919,39,30-34,1958,3
STAT,1874,25,15-19,1899,0.4723977494685091
STAT,1932,4,na,1936,5401.058861229508
STAT,1923,21,20-24,1944,131.1185622736326
SIM,1912,57,na,1969,3202
SIM,1865,1,na,1866,3306
STAT,1887,31,35-39,1918,11.466413250107697
STAT,1914,19,35-39,1933,0.8710725566328169
STAT,1898,68,na,1966,2367.3596703781172
SIM,1818,83,na,1901,198
STAT,1924,19,45-49,1943,0.5978975596103241
STAT,1801,53,40-44,1854,0.03892989259209717
SIM,1858,30,20-24,1888,3
SIM,1866,79,na,1945,646
SIM,1899,10,na,1909,3930
STAT,1848,17,15-19,1865,6.006484378236344
STAT,1905,41,20-24,1946,0.016175246833466023
STAT,1930,19,20-24,1949,176.20750413563212
SIM,1857,9,na,1866,2561
SIM,1934,2,na,1936,5639
STAT,1848,52,50-100,1900,0.012265124412254467
SIM,1904,38,25-29,1942,1
STAT,1961,0,na,1961,5168.101573962387
SIM,1931,21,20-24,1952,6
STAT,1885,47,15-19,1932,4.0025997868973166E-4
SIM,1854,30,50-100,1884,1
STAT,1862,13,na,1875,2373.914776514603
SIM,1933,37,40-44,1970,1
STAT,1902,17,15-19,1919,8.470147269003254
SIM,1938,26,50-100,1964,1
STAT,1910,34,40-44,1944,3.774305128296901
STAT,1875,95,na,1970,67.54162506560718
STAT,1902,27,45-49,1929,1.584691295946089
SIM,1788,91,na,1879,14
STAT,1907,24,40-44,1931,3.0714146191300067
STAT,1781,92,na,1873,6.374661598893992
STAT,1931,16,30-34,1947,16.163433435110342
STAT,1860,65,na,1925,1395.2779332094442
SIM,1858,23,30-34,1881,20
STAT,1916,19,na,1935,4113.157288830843
STAT,1846,30,50-100,1876,0.838943680793144
STAT,1911,1,na,1912,4202.250718000429
STAT,1921,26,15-19,1947,0.797365196213462
SIM,1829,34,45-49,1863,1
STAT,1907,42,40-44,1949,0.23138655497046345
STAT,1838,31,40-44,1869,3.645069838165579
STAT,1953,15,20-24,1968,165.78801340963008
STAT,1867,18,35-39,1885,0.5304407175749469
STAT,1846,50,na,1896,1657.4877713364133
SIM,1910,17,15-19,1927,5
STAT,1899,25,20-24,1924,16.371896860619326
STAT,1836,34,50-100,1870,0.715593325741589
SIM,1896,25,45-49,1921,1
SIM,1879,30,40-44,1909,7
STAT,1769,88,na,1857,35.514313483919004
SIM,1896,45,na,1941,3010
SIM,1857,42,na,1899,2015
STAT,1835,98,na,1933,2.43818540891104
SIM,1817,66,na,1883,965
STAT,1888,25,45-49,1913,1.3325850953922642
SIM,1813,52,na,1865,1234
SIM,1846,31,40-44,1877,14
SIM,1909,47,50-100,1956,1
STAT,1905,34,30-34,1939,14.512684335329736
STAT,1864,79,na,1943,637.1555599332914
SIM,1922,19,35-39,1941,5
SIM,1859,97,na,1956,9
SIM,1905,24,30-34,1929,33
SIM,1915,24,40-44,1939,4
SIM,1824,79,na,1903,322
STAT,1828,42,35-39,1870,1.7290631554590563
SIM,1917,18,15-19,1935,53
SIM,1930,28,25-29,1958,108
SIM,1897,21,45-49,1918,1
STAT,1893,49,15-19,1942,2.833196314652269E-4
SIM,1854,30,35-39,1884,12
STAT,1951,20,40-44,1971,4.061482052797397
SIM,1913,26,30-34,1939,42
STAT,1915,15,35-39,1930,0.890299384223834
STAT,1818,86,na,1904,114.31211507872021
STAT,1931,23,20-24,1954,145.30247173209935
SIM,1836,42,35-39,1878,7
SIM,1838,19,20-24,1857,15
SIM,1906,29,45-49,1935,1
STAT,1881,27,na,1908,2323.4365886270257
STAT,1836,35,50-100,1871,0.9706223066749954
SIM,1893,25,na,1918,3104
STAT,1901,40,25-29,1941,0.06377398281231206
SIM,1931,16,na,1947,4768
SIM,1909,27,20-24,1936,22
STAT,1821,47,30-34,1868,0.14187737212475016
STAT,1938,18,na,1956,3664.2986428802346
SIM,1844,35,50-100,1879,2
STAT,1916,17,45-49,1933,0.10695665804526848
SIM,1847,96,na,1943,2
STAT,1809,82,na,1891,215.44391102379987
STAT,1909,18,15-19,1927,8.957277281706183
SIM,1858,15,30-34,1873,2
SIM,1818,51,na,1869,1237
STAT,1857,97,na,1954,4.234639518969279
STAT,1931,24,30-34,1955,37.43789033427108
SIM,1800,89,na,1889,71
STAT,1853,83,na,1936,328.29892800265395
STAT,1889,36,15-19,1925,0.07027116403988048
STAT,1935,16,15-19,1951,62.83684594372192
STAT,1937,29,30-34,1966,38.52121937500686
STAT,1957,15,40-44,1972,1.8638458095993953
SIM,1871,2,na,1873,3085
SIM,1902,25,45-49,1927,1
SIM,1860,43,45-49,1903,7
SIM,1943,16,15-19,1959,43
SIM,1923,15,35-39,1938,6
STAT,1928,43,15-19,1971,0.0019756591804873736
STAT,1860,53,45-49,1913,0.011789453240160161
STAT,1863,50,na,1913,1954.5373469841372
SIM,1914,28,40-44,1942,6
STAT,1855,11,na,1866,2147.0084762809743
STAT,1779,104,na,1883,0.03883996987029877
STAT,1889,21,45-49,1910,0.8710621346206876
STAT,1905,26,30-34,1931,36.89418432326268
STAT,1844,46,15-19,1890,3.1737194013113824E-4
STAT,1858,25,30-34,1883,20.723130776661257
STAT,1844,102,na,1946,0.23195541897537408
STAT,1909,44,45-49,1953,0.1551548558130826
STAT,1869,23,na,1892,2315.2034044889047
STAT,1860,103,na,1963,0.4574557281287842
SIM,1841,16,na,1857,2126
SIM,1878,0,na,1878,3669
STAT,1857,66,na,1923,1291.9404534330563
STAT,1920,15,45-49,1935,0.11407712832758038
STAT,1906,28,40-44,1934,4.3912725973389435
SIM,1862,32,35-39,1894,15
STAT,1778,93,na,1871,7.286820232758144
STAT,1911,31,na,1942,3730.7141872654975
STAT,1940,16,25-29,1956,44.432728782016696
SIM,1889,43,na,1932,2741
SIM,1870,52,na,1922,2346
STAT,1887,23,35-39,1910,6.560022154071449
STAT,1881,47,30-34,1928,0.09380177931708492
SIM,1922,18,25-29,1940,72
SIM,1935,25,20-24,1960,35
SIM,1824,40,50-100,1864,3
SIM,1948,21,50-100,1969,1
STAT,1915,40,25-29,1955,0.07274527113782008
SIM,1855,24,45-49,1879,3
SIM,1892,5,na,1897,3619
SIM,1905,55,na,1960,3230
STAT,1913,36,30-34,1949,1.8234825901201075
STAT,1915,31,50-100,1946,0.853153216544146
STAT,1917,28,15-19,1945,0.744666128311576
STAT,1875,31,na,1906,2485.238471056015
STAT,1843,30,na,1873,1794.1707558338117
STAT,1879,32,40-44,1911,4.570898422294986
STAT,1903,46,15-19,1949,3.2547514274480364E-4
STAT,1781,110,na,1891,7.27998987989805E-4
STAT,1925,30,40-44,1955,4.701698622913384
STAT,1933,22,40-44,1955,4.506896748572656
STAT,1919,15,20-24,1934,30.4905607216331
STAT,1936,23,50-100,1959,0.6348859043049484
SIM,1877,62,na,1939,1880
STAT,1791,109,na,1900,1.2650799485330682E-4
STAT,1847,24,45-49,1871,0.630898329176055
SIM,1828,32,35-39,1860,2
SIM,1866,25,30-34,1891,29
SIM,1905,35,35-39,1940,3
STAT,1910,26,40-44,1936,4.556616936115123
STAT,1850,51,50-100,1901,0.01161971512931591
STAT,1919,48,20-24,1967,0.012068817214002934
SIM,1921,36,30-34,1957,5
SIM,1923,40,na,1963,4441
STAT,1839,57,na,1896,1424.7738587818624
STAT,1833,52,50-100,1885,0.011052680905940448
STAT,1897,20,40-44,1917,2.8384349670586007
SIM,1899,16,30-34,1915,3
STAT,1923,32,25-29,1955,10.705851483396746
SIM,1876,21,25-29,1897,4
STAT,1949,16,45-49,1965,0.5871085577177624
SIM,1931,32,25-29,1963,3
STAT,1935,34,45-49,1969,2.196690945739515
SIM,1898,2,na,1900,3596
SIM,1912,29,20-24,1941,20
STAT,1914,18,25-29,1932,9.020705217760948
STAT,1927,25,20-24,1952,22.582145249849287
STAT,1903,44,na,1947,3290.969583427081
STAT,1887,32,na,1919,2690.9139870020035
STAT,1821,54,20-24,1875,9.996645260114847E-4
STAT,1817,69,na,1886,749.589136424915
SIM,1897,18,15-19,1915,9
STAT,1912,39,20-24,1951,0.2569633293476287
STAT,1922,28,25-29,1950,74.976750144382
STAT,1889,18,15-19,1907,7.371491034955976
STAT,1905,33,20-24,1938,2.2566473007576198
SIM,1927,15,20-24,1942,190
SIM,1933,30,40-44,1963,6
STAT,1898,47,50-100,1945,0.18880427439660644
STAT,1872,20,35-39,1892,5.960823063664408
SIM,1895,23,35-39,1918,14
STAT,1929,37,25-29,1966,1.2776524630350936
SIM,1858,22,20-24,1880,79
STAT,1895,33,35-39,1928,13.300861650959314
STAT,1939,27,40-44,1966,4.7304229274976874
STAT,1889,22,50-100,1911,0.5078598074184437
SIM,1935,10,na,1945,5420
SIM,1883,21,15-19,1904,8
STAT,1878,41,35-39,1919,1.9071468670871161
STAT,1908,38,15-19,1946,0.018059520620375392
SIM,1765,94,na,1859,1
SIM,1784,77,na,1861,332
STAT,1858,32,20-24,1890,2.141867481605184
STAT,1864,29,50-100,1893,0.5788405756305072
STAT,1911,48,15-19,1959,3.508553207386779E-4
STAT,1851,20,15-19,1871,3.026378989090843
STAT,1838,34,45-49,1872,1.4207518772965442
SIM,1877,43,35-39,1920,1
STAT,1882,64,na,1946,1700.7187232379274
STAT,1893,28,na,1921,3049.803161170499
SIM,1883,79,na,1962,1066
SIM,1902,18,20-24,1920,21
STAT,1842,36,na,1878,2285.701905367714
SIM,1930,36,25-29,1966,1
STAT,1922,22,15-19,1944,6.16692810123797
STAT,1915,45,30-34,1960,0.09106861708721332
STAT,1901,44,40-44,1945,0.21816380741159974
STAT,1823,49,35-39,1872,0.18728460866561833
STAT,1905,18,30-34,1923,2.321106085258905
STAT,1924,42,40-44,1966,0.3006411584064425
STAT,1933,19,na,1952,4952.334312607071
SIM,1924,25,45-49,1949,2
STAT,1953,7,na,1960,4804.0028839781135
STAT,1931,15,20-24,1946,180.17786251201275
SIM,1837,22,35-39,1859,6
SIM,1868,45,50-100,1913,1
STAT,1819,48,na,1867,1352.807450578615
SIM,1917,36,45-49,1953,3
STAT,1876,21,30-34,1897,18.631494548244547
SIM,1871,49,50-100,1920,2
SIM,1904,39,35-39,1943,5
STAT,1872,49,30-34,1921,0.09624046444879188
STAT,1785,74,na,1859,437.1844248600927
SIM,1903,47,50-100,1950,1
STAT,1927,43,20-24,1970,0.02235132188401494
SIM,1858,26,35-39,1884,10
STAT,1789,88,na,1877,57.23969152248233
STAT,1922,36,25-29,1958,1.1328500450318637
SIM,1941,22,40-44,1963,7
SIM,1913,18,30-34,1931,6
STAT,1876,23,25-29,1899,59.51371468224411
SIM,1857,11,na,1868,2538
SIM,1850,52,na,1902,1834
SIM,1900,32,30-34,1932,25
SIM,1930,17,20-24,1947,221
STAT,1905,37,35-39,1942,2.2290242964219202
SIM,1889,20,na,1909,3144
SIM,1906,40,na,1946,3325
SIM,1921,24,15-19,1945,11
STAT,1835,48,15-19,1883,3.125449990337332E-4
STAT,1773,108,na,1881,0.005263619997626357
STAT,1872,43,na,1915,2329.9277817568636
STAT,1876,57,na,1933,2095.7295044339908
SIM,1829,78,na,1907,493
STAT,1931,34,25-29,1965,12.22406736544573
SIM,1859,13,na,1872,2589
STAT,1837,102,na,1939,0.19999799037816612
STAT,1922,17,20-24,1939,158.50852758173147
STAT,1793,70,na,1863,644.146377501676
STAT,1910,30,25-29,1940,9.063534680643325
SIM,1822,33,50-100,1855,5
STAT,1860,42,40-44,1902,1.8547755211716095
STAT,1925,17,50-100,1942,0.4573867124503276
SIM,1906,20,30-34,1926,50
SIM,1923,31,50-100,1954,1
SIM,1930,22,15-19,1952,7
STAT,1911,17,45-49,1928,0.10085048077614574
STAT,1933,36,35-39,1969,3.332178378046768
STAT,1814,49,40-44,1863,0.3992891793437075
SIM,1906,34,40-44,1940,6
SIM,1816,49,na,1865,1271
STAT,1872,21,50-100,1893,0.415329038974019
SIM,1803,86,na,1889,69
SIM,1812,46,na,1858,1311
SIM,1838,51,na,1889,1595
SIM,1876,22,35-39,1898,7
SIM,1852,66,na,1918,1085
SIM,1947,24,35-39,1971,19
STAT,1825,44,na,1869,1944.4747442442442
SIM,1932,24,40-44,1956,9
STAT,1907,46,35-39,1953,0.11746552774735564
STAT,1923,16,25-29,1939,51.54080609539967
STAT,1910,25,na,1935,3673.2386063737185
SIM,1915,20,25-29,1935,114
STAT,1877,15,40-44,1892,0.1915482584338852
STAT,1905,0,na,1905,4287.334941696891
STAT,1934,28,15-19,1962,0.9591228484859982
STAT,1833,63,na,1896,1262.3876881556987
SIM,1884,46,50-100,1930,3
SIM,1899,27,35-39,1926,21
STAT,1829,58,na,1887,1189.8867396902804
STAT,1843,53,45-49,1896,0.009630996493481843
STAT,1857,29,30-34,1886,20.152743284558525
STAT,1924,43,30-34,1967,0.15342337111597326
STAT,1849,34,20-24,1883,2.181218234215775
STAT,1880,22,35-39,1902,6.189754965142612
SIM,1858,33,25-29,1891,14
STAT,1953,8,na,1961,4803.378363603197
SIM,1912,38,30-34,1950,1
STAT,1861,38,15-19,1899,0.04689564532966324
STAT,1941,18,50-100,1959,0.389479399702899
STAT,1927,32,45-49,1959,1.9564830886239244
STAT,1932,30,50-100,1962,1.1119869575711758
STAT,1868,22,35-39,1890,5.632935648956421
STAT,1844,15,na,1859,2336.0344652154436
STAT,1850,32,na,1882,1911.4671197094024
STAT,1886,40,30-34,1926,1.23836891968803
STAT,1914,39,na,1953,3751.7927444937754
SIM,1845,40,35-39,1885,2
STAT,1867,25,25-29,1892,40.51102700181349
SIM,1865,29,30-34,1894,21
STAT,1910,46,na,1956,3466.785606685562
SIM,1898,28,30-34,1926,49
SIM,1846,34,45-49,1880,1
STAT,1840,46,30-34,1886,0.06930926943657831
STAT,1884,76,na,1960,1106.5825387007342
STAT,1939,24,35-39,1963,9.539899149600139
STAT,1806,85,na,1891,92.42768220852108
SIM,1853,45,50-100,1898,1
SIM,1931,16,25-29,1947,71
STAT,1905,44,25-29,1949,0.06423079428132529
SIM,1900,0,na,1900,4023
SIM,1879,33,45-49,1912,1
STAT,1880,62,na,1942,1938.6936054001535
STAT,1869,43,35-39,1912,1.7652990495944696
SIM,1867,32,na,1899,2130
SIM,1894,40,30-34,1934,2
STAT,1837,40,35-39,1877,1.4955701201122433
SIM,1875,39,na,1914,2312
STAT,1815,104,na,1919,0.028873006247864777
STAT,1870,46,15-19,1916,3.978413104831689E-4
STAT,1909,41,40-44,1950,0.23743974746442378
SIM,1913,37,35-39,1950,5
STAT,1802,71,na,1873,611.6729545654609
SIM,1855,41,50-100,1896,1
STAT,1909,36,45-49,1945,0.6542752652096567
SIM,1888,39,50-100,1927,1
STAT,1904,45,20-24,1949,0.009908927927209415
STAT,1779,105,na,1884,0.024339843918620138
STAT,1942,15,45-49,1957,0.5273625571180203
STAT,1826,82,na,1908,256.02328981291123
SIM,1857,34,20-24,1891,2
STAT,1922,29,35-39,1951,17.03989940176103
SIM,1929,33,30-34,1962,26
STAT,1907,20,25-29,1927,85.41489752836888
SIM,1860,85,na,1945,193
STAT,1778,92,na,1870,11.903068105390808
STAT,1840,105,na,1945,0.02055342846510979
SIM,1930,29,35-39,1959,30
STAT,1910,23,35-39,1933,8.893640455159101
SIM,1832,67,na,1899,959
STAT,1943,28,45-49,1971,1.8569161657579156
SIM,1857,27,30-34,1884,23
SIM,1861,47,na,1908,1949
STAT,1823,33,na,1856,1585.6237526269026
SIM,1948,15,40-44,1963,5
STAT,1868,0,na,1868,3634.0481462341804
STAT,1873,48,35-39,1921,0.14154617562675748
STAT,1911,15,15-19,1926,9.204837266057483
STAT,1855,95,na,1950,10.007828840091408
STAT,1908,37,40-44,1945,1.4148391541699752
STAT,1925,41,25-29,1966,0.08749834696379544
SIM,1887,35,45-49,1922,4
STAT,1926,28,45-49,1954,2.085721344577223
STAT,1840,39,40-44,1879,3.554778405098912
STAT,1875,24,20-24,1899,71.02978373833048
STAT,1831,52,na,1883,1402.8426021022187
STAT,1925,37,40-44,1962,1.8157872897289205
SIM,1826,31,50-100,1857,1
STAT,1848,43,15-19,1891,0.011193702861064359
STAT,1879,13,na,1892,2717.74511543452
SIM,1820,34,na,1854,1569
STAT,1838,16,15-19,1854,5.278642681229725
STAT,1932,26,40-44,1958,6.172359241559118
SIM,1868,20,35-39,1888,4
STAT,1921,38,30-34,1959,2.053279868792071
SIM,1906,61,na,1967,2842
SIM,1927,30,45-49,1957,2
SIM,1930,34,50-100,1964,2
STAT,1878,27,na,1905,2502.161679477138
SIM,1940,26,40-44,1966,7
SIM,1824,48,na,1872,1439
SIM,1935,32,45-49,1967,5
STAT,1866,27,30-34,1893,23.55093286532623
SIM,1848,19,30-34,1867,3
SIM,1914,16,25-29,1930,13
SIM,1840,41,50-100,1881,3
SIM,1880,20,35-39,1900,9
SIM,1926,9,na,1935,4907
STAT,1920,27,50-100,1947,1.1026124293721395
STAT,1891,17,50-100,1908,0.06126327584038765
SIM,1943,8,na,1951,4231
STAT,1916,44,35-39,1960,0.2075546176494338
STAT,1936,30,45-49,1966,1.5448051949867223
SIM,1846,16,15-19,1862,10
STAT,1858,28,35-39,1886,7.770652978265366
STAT,1811,52,na,1863,1216.5758530339003
STAT,1937,34,50-100,1971,0.8247319979855213
STAT,1838,62,na,1900,1223.5316182571805
STAT,1866,31,15-19,1897,0.13372857039666788
SIM,1883,58,na,1941,2157
STAT,1941,24,40-44,1965,3.505680565330092
STAT,1924,24,40-44,1948,3.984128680365946
STAT,1879,35,45-49,1914,2.121089365132621
STAT,1932,19,50-100,1951,0.49865970584240277
STAT,1943,25,50-100,1968,1.0712932023799175
STAT,1829,47,na,1876,1448.0786743471872
SIM,1895,60,na,1955,2502
STAT,1912,57,na,1969,3405.693188026765
STAT,1935,26,45-49,1961,2.380369769044541
STAT,1912,32,20-24,1944,2.4214714205516614
STAT,1904,38,30-34,1942,1.6590581647017515
SIM,1858,31,30-34,1889,4
STAT,1924,38,na,1962,4478.398967779262
SIM,1913,25,20-24,1938,1
SIM,1873,28,na,1901,2295
SIM,1920,32,20-24,1952,2
STAT,1847,76,na,1923,709.3561968104951
SIM,1942,23,na,1965,4027
STAT,1919,30,45-49,1949,1.7279131384271076
SIM,1934,28,45-49,1962,2
SIM,1890,38,35-39,1928,19
SIM,1904,27,20-24,1931,17
SIM,1863,0,na,1863,3577
STAT,1862,44,15-19,1906,0.011882625990175009
STAT,1900,33,50-100,1933,1.28007790917712
SIM,1821,82,na,1903,225
STAT,1868,47,15-19,1915,3.8431593140284074E-4
SIM,1834,21,20-24,1855,67
STAT,1849,27,30-34,1876,23.33891835041286
STAT,1905,25,20-24,1930,17.24526126882346
STAT,1906,36,40-44,1942,1.396655518526318
STAT,1909,29,20-24,1938,17.478058914439497
SIM,1933,34,35-39,1967,1
STAT,1930,28,30-34,1958,50.332516592848414
SIM,1943,26,45-49,1969,7
SIM,1899,3,na,1902,3996
SIM,1845,84,na,1929,293
STAT,1848,51,50-100,1899,0.01238976545270872
SIM,1945,20,na,1965,3932
STAT,1846,81,na,1927,410.37800832055655
SIM,1849,21,15-19,1870,4
STAT,1945,20,45-49,1965,1.2462395905259955
SIM,1905,26,25-29,1931,71
STAT,1930,35,20-24,1965,0.3481328760593291
SIM,1838,32,45-49,1870,3
STAT,1877,20,35-39,1897,6.119335383999407
STAT,1878,28,na,1906,2493.354070365379
SIM,1825,85,na,1910,101
SIM,1849,28,35-39,1877,14
SIM,1837,66,na,1903,955
STAT,1917,38,45-49,1955,0.7111823819493227
STAT,1853,29,na,1882,2050.787078795088
STAT,1916,25,45-49,1941,1.8148973862495408
STAT,1947,23,na,1970,4167.531095690366
STAT,1934,27,40-44,1961,6.3356346629347415
SIM,1849,35,25-29,1884,2
SIM,1886,41,35-39,1927,2
SIM,1832,66,na,1898,1029
SIM,1917,29,20-24,1946,20
STAT,1889,44,15-19,1933,0.01696653168816962
STAT,1829,26,50-100,1855,1.0606434065358248
SIM,1914,36,40-44,1950,4
SIM,1914,22,30-34,1936,37
STAT,1875,17,30-34,1892,1.6531892589400625
SIM,1925,38,45-49,1963,1
SIM,1839,39,30-34,1878,8
STAT,1925,34,35-39,1959,10.952823357729237
STAT,1931,33,50-100,1964,1.0942291824928942
SIM,1925,20,na,1945,4788
SIM,1929,34,na,1963,4664
STAT,1799,87,na,1886,59.92592724546715
SIM,1922,15,20-24,1937,167
SIM,1908,38,45-49,1946,2
SIM,1851,26,na,1877,2050
SIM,1887,17,15-19,1904,5
STAT,1832,47,35-39,1879,0.11304288650280252
STAT,1857,41,15-19,1898,0.010934774280589627
STAT,1931,27,35-39,1958,19.58957675168226
STAT,1935,31,40-44,1966,5.473185613781238
SIM,1860,62,na,1922,1578
STAT,1831,48,30-34,1879,0.07138291177069983
STAT,1921,24,50-100,1945,0.7459131624341502
STAT,1862,44,na,1906,1988.6992413045475
SIM,1786,89,na,1875,35
SIM,1860,40,40-44,1900,4
STAT,1916,43,45-49,1959,0.17184491682284128
STAT,1876,16,35-39,1892,0.5736228332778214
STAT,1876,39,20-24,1915,0.7957836842839988
STAT,1906,22,30-34,1928,26.203711700490512
STAT,1914,15,20-24,1929,28.427149778886484
SIM,1845,85,na,1930,232
SIM,1841,71,na,1912,918
SIM,1859,25,40-44,1884,1
STAT,1897,23,45-49,1920,0.9412967899840174
STAT,1809,47,50-100,1856,0.8785849675608918
STAT,1811,50,50-100,1861,0.03744038083157494
STAT,1870,32,na,1902,2366.715243246911
STAT,1943,20,na,1963,3925.7337243927805
SIM,1868,58,na,1926,1850
STAT,1929,35,30-34,1964,2.369113072127869
SIM,1864,44,na,1908,2474
SIM,1894,10,na,1904,3723
STAT,1853,36,15-19,1889,0.046923221568652605
STAT,1901,47,45-49,1948,0.1876053930846329
SIM,1821,71,na,1892,719
SIM,1924,18,50-100,1942,1
STAT,1810,51,40-44,1861,0.03936303732521118
STAT,1863,22,50-100,1885,0.37220007469556216
STAT,1899,29,35-39,1928,13.279287319104723
STAT,1935,19,20-24,1954,186.25102097176475
SIM,1900,35,35-39,1935,4
STAT,1837,77,na,1914,589.6706698112879
STAT,1858,35,25-29,1893,2.3031042987152475
STAT,1803,97,na,1900,2.2394928552093147
SIM,1881,8,na,1889,2297
STAT,1867,43,na,1910,2182.6204444798555
STAT,1822,37,na,1859,1601.7666123515362
STAT,1883,16,50-100,1899,0.04854109419682718
STAT,1901,32,na,1933,3378.676254633241
SIM,1921,17,na,1938,4094
STAT,1890,37,30-34,1927,6.5775561332004315
STAT,1914,34,25-29,1948,9.306508528124715
SIM,1850,18,30-34,1868,2
STAT,1918,42,na,1960,3986.5109333763025
STAT,1904,34,15-19,1938,0.11750496925538234
SIM,1834,78,na,1912,422
SIM,1843,20,30-34,1863,30
SIM,1938,25,25-29,1963,75
SIM,1930,33,20-24,1963,2
STAT,1918,35,20-24,1953,0.2831739711755863
STAT,1892,27,50-100,1919,0.8107328200893043
STAT,1811,85,na,1896,119.50688663025345
STAT,1933,33,30-34,1966,21.442045219328513
STAT,1946,19,30-34,1965,13.64514838595997
STAT,1864,24,na,1888,2158.7993316258767
STAT,1844,70,na,1914,1110.0901413609852
SIM,1867,23,25-29,1890,76
STAT,1840,49,35-39,1889,0.09646101354061502
STAT,1899,30,15-19,1929,0.19898538025601956
STAT,1916,40,40-44,1956,0.2593896048384041
STAT,1810,90,na,1900,40.94664927982849
STAT,1818,63,na,1881,1021.0100918778427
STAT,1833,32,15-19,1865,0.1301953564527041
STAT,1872,98,na,1970,20.732691197749908
STAT,1896,56,na,1952,2726.829959326564
STAT,1924,20,25-29,1944,110.79713590400422
SIM,1936,16,na,1952,3575
STAT,1926,26,15-19,1952,0.8582329438797142
SIM,1834,37,na,1871,1897
SIM,1869,41,35-39,1910,3
STAT,1842,18,30-34,1860,1.8318953713178052
STAT,1856,22,45-49,1878,0.6271227329520496
STAT,1931,18,25-29,1949,57.1753199715541
STAT,1921,18,15-19,1939,52.110295722119666
SIM,1947,21,30-34,1968,46
STAT,1922,33,20-24,1955,2.772401302091182
STAT,1932,24,na,1956,4825.514621775811
STAT,1859,23,25-29,1882,47.90165147472953
SIM,1891,46,na,1937,2882
STAT,1849,23,15-19,1872,3.0961224964624585
STAT,1886,43,35-39,1929,1.9170897433685112
STAT,1823,46,30-34,1869,0.13514711443130673
SIM,1874,65,na,1939,1593
STAT,1953,19,na,1972,4495.605466646617
SIM,1893,30,50-100,1923,2
STAT,1933,25,45-49,1958,2.3200536676397068
STAT,1913,39,35-39,1952,2.3841262972964006
SIM,1849,32,20-24,1881,2
SIM,1908,35,40-44,1943,2
STAT,1911,33,45-49,1944,1.5393733223990747
STAT,1912,21,45-49,1933,1.0911964604232784
STAT,1902,21,35-39,1923,8.353892825373613
STAT,1939,21,30-34,1960,29.14912312097032
STAT,1854,14,na,1868,2123.752763799499
STAT,1882,38,35-39,1920,6.885453421565552
STAT,1819,52,35-39,1871,0.01611894261215405
STAT,1843,38,50-100,1881,0.8706113899705222
STAT,1942,30,40-44,1972,4.2136380797212345
STAT,1835,20,30-34,1855,28.097007249856638
STAT,1846,102,na,1948,0.22248606732129786
STAT,1841,51,na,1892,1617.874166315111
STAT,1888,38,na,1926,2794.6573091361897
SIM,1851,38,50-100,1889,1
SIM,1941,25,45-49,1966,3
SIM,1910,21,35-39,1931,14
SIM,1915,21,na,1936,4412
STAT,1815,47,35-39,1862,0.31062824826311963
STAT,1824,70,na,1894,697.5394883925787
SIM,1843,38,20-24,1881,3
SIM,1791,67,na,1858,620
SIM,1870,51,na,1921,2378
SIM,1921,39,35-39,1960,6
SIM,1920,21,45-49,1941,1
STAT,1907,16,40-44,1923,0.27195319808505164
STAT,1907,43,30-34,1950,0.11755857616285206
SIM,1918,17,20-24,1935,1
SIM,1866,28,35-39,1894,15
STAT,1839,20,15-19,1859,3.0488573443391003
STAT,1869,40,30-34,1909,1.140317757441775
STAT,1820,37,15-19,1857,0.13761385367546428
SIM,1932,20,25-29,1952,215
SIM,1888,20,40-44,1908,3
SIM,1926,26,45-49,1952,3
SIM,1834,24,25-29,1858,57
SIM,1942,7,na,1949,4435
STAT,1929,15,50-100,1944,0.48552044510253783
STAT,1873,83,na,1956,438.2006006958395
STAT,1924,46,35-39,1970,0.15549147839692803
SIM,1915,54,na,1969,3984
SIM,1921,27,20-24,1948,1
SIM,1904,58,na,1962,3219
STAT,1913,27,20-24,1940,18.351433160356816
STAT,1920,7,na,1927,4528.868720687434
SIM,1879,15,15-19,1894,6
SIM,1891,15,15-19,1906,9
SIM,1922,34,25-29,1956,17
STAT,1827,46,15-19,1873,4.1575447239082096E-4
STAT,1901,32,45-49,1933,2.469003623803547
SIM,1899,32,30-34,1931,45
STAT,1910,20,30-34,1930,27.39366647429976
STAT,1850,55,na,1905,1583.2768441423896
STAT,1920,20,40-44,1940,3.7972873336502015
SIM,1831,44,50-100,1875,3
SIM,1901,27,15-19,1928,1
STAT,1773,93,na,1866,6.867826767179322
SIM,1886,5,na,1891,2939
STAT,1802,52,45-49,1854,0.04234697443687356
STAT,1837,45,50-100,1882,0.17844291329879278
SIM,1812,67,na,1879,755
SIM,1881,47,na,1928,1981
SIM,1883,24,20-24,1907,94
SIM,1835,21,35-39,1856,7
STAT,1900,34,30-34,1934,24.28645175683352
STAT,1830,31,35-39,1861,9.879473331096486
STAT,1863,4,na,1867,2721.795009771687
SIM,1877,40,30-34,1917,1
SIM,1839,20,45-49,1859,5
SIM,1847,20,15-19,1867,4
STAT,1902,58,na,1960,2930.865121715699
SIM,1840,85,na,1925,168
SIM,1826,70,na,1896,1031
SIM,1906,23,35-39,1929,8
SIM,1860,49,50-100,1909,4
SIM,1943,19,20-24,1962,4
STAT,1873,28,na,1901,2434.982567138267
SIM,1831,39,40-44,1870,7
STAT,1894,37,15-19,1931,0.07301976271240176
SIM,1796,66,na,1862,921
STAT,1867,76,na,1943,901.1911269327715
SIM,1842,33,na,1875,1879
STAT,1854,25,na,1879,1897.4383662124228
STAT,1851,52,40-44,1903,0.007928971799551151
SIM,1880,33,50-100,1913,5
SIM,1928,39,25-29,1967,3
STAT,1922,34,50-100,1956,0.939120703792327
SIM,1900,55,na,1955,3125
STAT,1893,15,25-29,1908,7.301012295972988
STAT,1947,7,na,1954,4481.849298903479
SIM,1928,29,30-34,1957,59
STAT,1817,104,na,1921,0.030516758360918408
SIM,1891,19,30-34,1910,2
STAT,1820,89,na,1909,53.474583152791965
STAT,1869,24,na,1893,2307.841057662629
STAT,1861,102,na,1963,0.9024766548435222
STAT,1883,19,30-34,1902,1.566886671376441
SIM,1817,45,na,1862,1580
STAT,1865,10,na,1875,2524.373573508578
SIM,1934,25,40-44,1959,9
STAT,1936,29,15-19,1965,0.6813997810518103
STAT,1876,49,15-19,1925,4.0842732715863525E-4
STAT,1823,39,40-44,1862,6.966468858609085
SIM,1803,53,na,1856,1104
SIM,1820,39,30-34,1859,5
SIM,1854,14,na,1868,2642
STAT,1901,29,15-19,1930,0.6377869196020399
SIM,1773,93,na,1866,15
STAT,1856,48,35-39,1904,0.10704632006151119
STAT,1867,47,50-100,1914,0.23253095516237843
STAT,1939,31,25-29,1970,9.525845532131816
STAT,1922,40,45-49,1962,0.19351787792452674
STAT,1801,86,na,1887,78.87579000819039
SIM,1842,23,20-24,1865,63
SIM,1846,70,na,1916,983
SIM,1882,36,35-39,1918,13
STAT,1922,26,30-34,1948,44.94479393758695
STAT,1956,15,25-29,1971,57.958644506837636
SIM,1938,18,35-39,1956,6
SIM,1930,26,30-34,1956,67
STAT,1905,28,25-29,1933,61.54675096802888
STAT,1858,36,50-100,1894,0.9775292583176466
SIM,1913,28,25-29,1941,64
SIM,1925,32,35-39,1957,17
STAT,1879,17,15-19,1896,6.255015465505667
STAT,1845,42,35-39,1887,1.3473742722605102
STAT,1926,44,45-49,1970,0.20667157804790318
STAT,1830,34,50-100,1864,0.8513254723500282
STAT,1850,11,na,1861,2243.9016253935756
SIM,1875,47,50-100,1922,5
STAT,1892,21,15-19,1913,4.193737544682813
STAT,1887,19,15-19,1906,6.656183921344769
SIM,1842,39,50-100,1881,2
STAT,1863,30,35-39,1893,9.135454274817004
SIM,1839,77,na,1916,441
STAT,1884,51,40-44,1935,0.010535655356391747
STAT,1944,25,20-24,1969,19.93970319447093
SIM,1878,23,35-39,1901,10
SIM,1931,31,50-100,1962,1
STAT,1801,75,na,1876,450.92658554068333
STAT,1814,105,na,1919,0.013723840696384843
SIM,1835,42,50-100,1877,2
STAT,1914,24,30-34,1938,29.440767578432432
STAT,1880,47,15-19,1927,4.223058086993856E-4
STAT,1926,25,40-44,1951,5.685401934558714
STAT,1821,35,50-100,1856,2.6867540397978917
STAT,1861,28,20-24,1889,9.846299227357814
STAT,1946,26,20-24,1972,20.546271474535136
STAT,1919,45,15-19,1964,4.053137471236586E-4
STAT,1908,5,na,1913,3924.2202961675875
STAT,1876,46,50-100,1922,0.25684940479380636
STAT,1824,59,na,1883,1039.5157532140008
STAT,1867,22,20-24,1889,65.82111782347711
SIM,1884,31,50-100,1915,2
SIM,1895,19,15-19,1914,7
STAT,1824,48,na,1872,1273.4790813521715
STAT,1843,50,40-44,1893,0.00720259853667118
STAT,1864,47,30-34,1911,0.08781098183136705
STAT,1853,84,na,1937,275.1046526983839
STAT,1940,21,20-24,1961,114.39333297430771
SIM,1875,22,20-24,1897,74
STAT,1907,57,na,1964,3159.7913511072634
STAT,1794,88,na,1882,48.437412501827914
STAT,1903,15,45-49,1918,0.0943973127580307
STAT,1906,32,25-29,1938,8.652006415488906
SIM,1901,26,40-44,1927,4
STAT,1903,43,na,1946,3311.900796460711
SIM,1924,40,40-44,1964,2
STAT,1891,57,na,1948,2512.9997360582984
STAT,1948,17,40-44,1965,1.6170075820351
SIM,1856,25,na,1881,2217
SIM,1826,59,na,1885,1502
STAT,1825,30,15-19,1855,0.45498327482934803
STAT,1932,40,25-29,1972,0.09807806812288915
STAT,1883,50,na,1933,2158.711335934031
SIM,1859,21,25-29,1880,72
SIM,1818,52,na,1870,1237
SIM,1933,31,30-34,1964,4
STAT,1881,32,50-100,1913,0.8920250206169753
STAT,1938,27,25-29,1965,65.83017600604228
SIM,1839,17,15-19,1856,5
SIM,1884,21,30-34,1905,2
SIM,1869,6,na,1875,2606
SIM,1889,64,na,1953,2040
STAT,1937,33,15-19,1970,0.12827009968985845
STAT,1885,30,50-100,1915,0.9285404436968548
SIM,1885,50,na,1935,2342
STAT,1846,18,15-19,1864,5.624159926153986
STAT,1906,25,35-39,1931,14.290872849047132
SIM,1875,25,25-29,1900,48
STAT,1836,29,na,1865,1739.6302038181486
SIM,1904,36,30-34,1940,1
STAT,1874,36,35-39,1910,7.349948020221538
SIM,1924,22,40-44,1946,3
STAT,1872,48,50-100,1920,0.24625380838440541
STAT,1929,42,20-24,1971,0.02311647965089625
SIM,1880,48,50-100,1928,2
STAT,1947,23,30-34,1970,32.80029454517673
SIM,1914,32,25-29,1946,13
STAT,1898,26,15-19,1924,0.6233453366969666
SIM,1854,18,15-19,1872,6
SIM,1902,30,40-44,1932,9
STAT,1871,17,na,1888,2550.6214802802347
STAT,1941,27,45-49,1968,1.80430609217849
STAT,1925,31,30-34,1956,18.91873254340548
STAT,1864,24,45-49,1888,0.636510108586857
STAT,1928,38,20-24,1966,0.3363927242198222
STAT,1800,54,35-39,1854,0.025518234161218442
STAT,1815,89,na,1904,45.47539920361971
STAT,1952,16,15-19,1968,54.96399489161536
STAT,1930,24,15-19,1954,6.849338789601888
STAT,1874,54,35-39,1928,0.00865856179897566
SIM,1873,80,na,1953,555
SIM,1885,61,na,1946,1960
STAT,1916,22,40-44,1938,3.5555949374219558
SIM,1869,43,na,1912,2251
SIM,1820,86,na,1906,88
STAT,1834,23,20-24,1857,54.50097221758981
STAT,1918,53,na,1971,3862.9553814458627
SIM,1849,25,30-34,1874,35
SIM,1835,64,na,1899,969
SIM,1842,31,20-24,1873,1
STAT,1877,19,50-100,1896,0.050796397367536314
STAT,1918,38,25-29,1956,1.0466742633822699
STAT,1919,22,45-49,1941,1.244004747929625
STAT,1836,36,15-19,1872,0.0439357791943334
STAT,1869,24,45-49,1893,0.6804542417139406
STAT,1881,24,45-49,1905,0.6746382375765227
STAT,1884,25,25-29,1909,42.41784113556596
STAT,1888,41,45-49,1929,1.792235151341221
STAT,1942,30,20-24,1972,2.6263444374815177
SIM,1822,33,45-49,1855,1
SIM,1839,21,20-24,1860,4
STAT,1884,23,30-34,1907,17.686125463641407
STAT,1946,16,na,1962,4124.461180629255
STAT,1837,31,50-100,1868,0.7918949557364707
STAT,1861,20,25-29,1881,50.075101999633794
SIM,1956,7,na,1963,5293
STAT,1833,35,35-39,1868,6.411065784226347
SIM,1825,34,25-29,1859,17
SIM,1910,20,25-29,1930,84
SIM,1887,43,45-49,1930,3
SIM,1878,20,30-34,1898,26
SIM,1883,25,30-34,1908,40
SIM,1924,33,30-34,1957,30
SIM,1843,23,35-39,1866,10
SIM,1894,75,na,1969,1730
SIM,1924,35,na,1959,4505
SIM,1945,25,15-19,1970,1
STAT,1841,34,15-19,1875,0.1265539685642984
STAT,1813,49,25-29,1862,0.16157757429946545
STAT,1898,38,30-34,1936,1.5672468020694723
SIM,1943,18,na,1961,3788
STAT,1939,20,20-24,1959,112.81328513554678
SIM,1907,36,35-39,1943,3
SIM,1918,24,45-49,1942,1
SIM,1846,24,15-19,1870,1
STAT,1897,73,na,1970,2022.036526340563
STAT,1849,38,35-39,1887,5.600182487497727
STAT,1811,108,na,1919,7.985264184154991E-4
STAT,1841,52,30-34,1893,0.0044277059774959215
STAT,1873,37,30-34,1910,5.457005693273998
SIM,1927,22,45-49,1949,2
SIM,1881,37,30-34,1918,7
STAT,1925,33,25-29,1958,11.085209719047935
SIM,1841,35,35-39,1876,11
STAT,1840,66,na,1906,1148.925880345998
SIM,1916,16,na,1932,4120
STAT,1823,31,45-49,1854,5.37478506045386
SIM,1857,38,35-39,1895,15
STAT,1911,19,30-34,1930,2.447555721472195
STAT,1835,23,35-39,1858,5.782399266597516
STAT,1946,23,15-19,1969,5.980935557357852
SIM,1868,26,45-49,1894,2
STAT,1858,36,35-39,1894,5.631462781148392
SIM,1948,2,na,1950,5094
SIM,1872,39,30-34,1911,4
SIM,1867,39,20-24,1906,2
STAT,1903,42,20-24,1945,0.01584372664759683
SIM,1808,62,na,1870,879
STAT,1834,31,20-24,1865,2.083560413095014
STAT,1919,38,na,1957,4076.759386702164
SIM,1892,25,25-29,1917,74
STAT,1900,41,40-44,1941,0.2201339528678979
STAT,1828,32,na,1860,1868.8694679699333
STAT,1826,32,25-29,1858,14.364701748384428
STAT,1923,43,na,1966,4378.987720367683
STAT,1894,29,15-19,1923,0.5857488652406987
STAT,1847,22,15-19,1869,3.0281035367629126
SIM,1858,37,na,1895,1946
SIM,1865,84,na,1949,225
STAT,1830,48,15-19,1878,3.302653184319154E-4
SIM,1899,19,na,1918,3795
SIM,1901,2,na,1903,3878
STAT,1780,96,na,1876,1.3579344068662011
STAT,1842,67,na,1909,1427.2266832601524
STAT,1920,19,25-29,1939,48.83437149478722
SIM,1942,24,35-39,1966,11
STAT,1827,38,15-19,1865,0.06380431356552979
STAT,1893,23,25-29,1916,73.18729705473098
STAT,1838,24,15-19,1862,2.8242454796682037
STAT,1866,52,35-39,1918,0.0080086104468374
STAT,1934,24,35-39,1958,12.777148398669864
SIM,1947,20,20-24,1967,141
STAT,1889,54,na,1943,2607.8733581138545
STAT,1896,17,15-19,1913,7.93402675298555
STAT,1901,17,35-39,1918,0.7768939223551957
SIM,1882,29,45-49,1911,2
STAT,1951,21,30-34,1972,34.70482656404897
SIM,1881,13,na,1894,2279
SIM,1816,81,na,1897,232
STAT,1822,105,na,1927,0.016393878860891428
SIM,1938,22,20-24,1960,114
SIM,1859,33,40-44,1892,5
STAT,1836,51,na,1887,1401.1116613413924
STAT,1874,29,45-49,1903,1.1400570757506743
STAT,1931,30,45-49,1961,2.0862139789204925
SIM,1778,92,na,1870,1
STAT,1921,40,15-19,1961,0.0017517841229100664
STAT,1943,22,35-39,1965,10.115259269548398
SIM,1838,18,30-34,1856,1
STAT,1897,63,na,1960,2536.0527454661956
SIM,1833,33,20-24,1866,2
STAT,1819,101,na,1920,0.2900838752369764
STAT,1820,66,na,1886,829.0693578397068
SIM,1851,24,25-29,1875,104
SIM,1892,18,35-39,1910,4
SIM,1835,54,na,1889,1211
STAT,1864,39,30-34,1903,4.808422186891833
STAT,1872,31,40-44,1903,4.421588377145083
SIM,1823,39,35-39,1862,18
SIM,1799,84,na,1883,141
SIM,1921,3,na,1924,4601
STAT,1902,28,20-24,1930,16.684893537429097
STAT,1944,28,25-29,1972,71.80182334902346
STAT,1926,37,20-24,1963,0.32560103958196696
STAT,1913,16,15-19,1929,9.38517441702706
SIM,1831,31,45-49,1862,2
SIM,1834,32,25-29,1866,4
SIM,1905,20,15-19,1925,6
STAT,1916,40,20-24,1956,0.01831453876981306
SIM,1874,27,30-34,1901,22
STAT,1859,24,na,1883,1964.802376370044
SIM,1880,51,na,1931,2040
STAT,1777,105,na,1882,0.015552525508082359
SIM,1873,38,35-39,1911,14
STAT,1945,20,50-100,1965,0.728795109948124
SIM,1899,35,35-39,1934,24
SIM,1827,35,na,1862,1618
STAT,1889,47,35-39,1936,0.097892329116048
STAT,1890,22,45-49,1912,0.8606069700134245
STAT,1863,39,na,1902,2087.120357695327
STAT,1849,24,na,1873,1992.2178610333292
STAT,1828,53,50-100,1881,0.011852778314597206
STAT,1917,32,35-39,1949,9.659164988211309
STAT,1902,20,25-29,1922,82.19186966828839
SIM,1850,31,na,1881,2038
SIM,1848,27,na,1875,1925
STAT,1833,28,30-34,1861,23.398709595986443
STAT,1846,44,45-49,1890,1.1204467413585382
STAT,1937,25,15-19,1962,0.6953296080816379
STAT,1865,38,35-39,1903,6.490689980624989
SIM,1836,81,na,1917,440
SIM,1890,51,na,1941,2981
STAT,1879,25,15-19,1904,0.48144667870918645
SIM,1841,28,30-34,1869,30
STAT,1812,47,na,1859,1390.4637491270266
STAT,1850,96,na,1946,6.574922300268377
STAT,1815,39,35-39,1854,21.2471387493947
STAT,1877,37,15-19,1914,0.058536824646755393
STAT,1843,24,25-29,1867,47.770412550108446
STAT,1860,21,20-24,1881,59.075796475612286
STAT,1916,33,30-34,1949,16.345899228389992
SIM,1921,16,15-19,1937,45
STAT,1879,43,45-49,1922,1.5660632747498953
SIM,1933,33,25-29,1966,8
STAT,1833,28,45-49,1861,1.0316799203261018
SIM,1892,23,30-34,1915,35
STAT,1926,3,na,1929,5025.967083307176
STAT,1838,52,na,1890,1433.7142180128415
STAT,1877,42,50-100,1919,1.0999142387983236
STAT,1851,19,35-39,1870,0.4992095437322136
SIM,1874,34,20-24,1908,2
SIM,1877,42,50-100,1919,4
STAT,1847,40,45-49,1887,1.156086307284124
SIM,1852,12,na,1864,2203
STAT,1866,34,20-24,1900,2.506344952492693
STAT,1850,86,na,1936,169.89365926662057
STAT,1884,18,35-39,1902,0.5450797041861687
SIM,1813,53,50-100,1866,1
SIM,1825,54,na,1879,1103
SIM,1825,32,30-34,1857,8
STAT,1882,53,30-34,1935,0.005730157167102666
SIM,1827,45,na,1872,1495
STAT,1856,112,na,1968,2.3256063144479837E-4
SIM,1910,28,20-24,1938,22
STAT,1832,36,30-34,1868,4.648181610736475
SIM,1909,31,40-44,1940,4
SIM,1840,36,30-34,1876,7
SIM,1928,1,na,1929,5279
SIM,1926,23,40-44,1949,6
STAT,1898,27,na,1925,3267.6485449786214
STAT,1932,29,45-49,1961,2.2844866946619367
STAT,1918,23,40-44,1941,3.6497898389024015
SIM,1888,57,na,1945,2568
SIM,1940,29,45-49,1969,1
SIM,1842,12,na,1854,2292
STAT,1852,77,na,1929,655.5480428164652
SIM,1875,26,35-39,1901,10
STAT,1855,112,na,1967,1.9057933078364783E-4
SIM,1850,21,na,1871,2009
STAT,1867,33,25-29,1900,9.701874375771958
SIM,1933,18,na,1951,4462
STAT,1908,41,25-29,1949,0.06707654638095134
SIM,1833,29,35-39,1862,7
STAT,1838,42,45-49,1880,1.1716864143438197
SIM,1891,13,na,1904,3370
STAT,1850,27,35-39,1877,8.69457333390869
STAT,1905,40,45-49,1945,0.15327868268801179
SIM,1879,74,na,1953,1268
STAT,1922,49,50-100,1971,0.26095739424833075
STAT,1851,26,25-29,1877,37.774037061053065
STAT,1834,24,30-34,1858,13.985066888052831
SIM,1886,76,na,1962,1350
STAT,1874,33,15-19,1907,0.14665502717609258
SIM,1941,25,30-34,1966,57
STAT,1766,108,na,1874,0.0024184715495701734
SIM,1852,28,20-24,1880,2
STAT,1836,20,50-100,1856,0.39395132973701885
STAT,1845,15,45-49,1860,0.061043838821364965
SIM,1902,29,25-29,1931,66
STAT,1878,53,50-100,1931,0.015580309107392883
STAT,1858,40,20-24,1898,0.1271110999471541
SIM,1875,33,25-29,1908,14
SIM,1926,16,na,1942,4521
STAT,1810,108,na,1918,9.513242570375116E-4
STAT,1890,29,30-34,1919,30.856390292687927
STAT,1853,28,15-19,1881,0.39269520450555345
STAT,1899,34,30-34,1933,23.994613397473856
STAT,1798,92,na,1890,13.857894373344372
STAT,1870,28,15-19,1898,0.44839292601180836
STAT,1933,25,30-34,1958,52.61928719039674
SIM,1955,15,30-34,1970,18
STAT,1862,2,na,1864,2991.702390730451
SIM,1884,75,na,1959,1172
STAT,1855,42,45-49,1897,1.1251652871684261
SIM,1843,30,25-29,1873,17
STAT,1897,49,35-39,1946,0.10469960593226674
STAT,1856,45,15-19,1901,3.128262000299148E-4
STAT,1860,46,35-39,1906,0.11591589320023549
STAT,1899,36,25-29,1935,4.010213440110238
SIM,1858,27,na,1885,1982
SIM,1953,18,na,1971,4481
STAT,1840,38,30-34,1878,4.373090839486753
SIM,1847,16,30-34,1863,3
STAT,1947,15,30-34,1962,13.876310376089162
STAT,1826,51,na,1877,1323.2905771581327
SIM,1898,39,35-39,1937,3
STAT,1874,51,30-34,1925,0.006185519162897969
STAT,1942,23,30-34,1965,30.41605918190003
SIM,1862,30,50-100,1892,3
SIM,1930,21,na,1951,5351
STAT,1772,87,na,1859,39.23070795443877
STAT,1917,29,50-100,1946,1.046111212223064
SIM,1856,39,30-34,1895,9
STAT,1882,35,15-19,1917,0.05546043815354489
STAT,1887,45,45-49,1932,0.26877759016742575
STAT,1888,48,30-34,1936,0.06427528773605537
SIM,1876,56,na,1932,2319
STAT,1857,37,30-34,1894,4.2010094684106285
STAT,1868,25,40-44,1893,2.9112079914666733
STAT,1862,38,50-100,1900,1.0655506889525739
SIM,1817,40,25-29,1857,3
STAT,1913,43,na,1956,3648.4609308629783
STAT,1839,16,30-34,1855,1.4869757677419242
STAT,1860,24,25-29,1884,48.02477847449397
STAT,1829,26,15-19,1855,0.7522625186231505
STAT,1843,17,35-39,1860,0.472945266300316
STAT,1840,23,45-49,1863,0.6171624613990785
STAT,1848,39,30-34,1887,4.392016753525185
SIM,1916,34,35-39,1950,11
SIM,1891,23,na,1914,3045
STAT,1833,50,30-34,1883,0.0045322815659705005
STAT,1927,21,40-44,1948,4.199759463744402
STAT,1825,99,na,1924,1.3820663440541179
STAT,1860,17,35-39,1877,0.5224874591422434
STAT,1885,29,20-24,1914,11.709776124386087
SIM,1946,24,20-24,1970,140
SIM,1901,22,25-29,1923,81
STAT,1858,62,na,1920,1448.2696319783363
STAT,1910,15,35-39,1925,0.8427569545666183
SIM,1888,17,30-34,1905,2
STAT,1815,44,15-19,1859,0.032312080016908155
STAT,1813,49,50-100,1862,0.6889488286093723
STAT,1825,36,25-29,1861,4.95874414291336
SIM,1863,28,na,1891,2184
STAT,1938,17,30-34,1955,12.13817924050352
STAT,1817,47,50-100,1864,0.5281192011688943
STAT,1835,30,25-29,1865,9.996543298186106
STAT,1924,35,30-34,1959,2.175484264845862
STAT,1875,32,20-24,1907,2.8036597959073415
SIM,1884,31,25-29,1915,12
SIM,1911,19,25-29,1930,17
SIM,1947,16,35-39,1963,8
STAT,1830,66,na,1896,1081.3202574535942
STAT,1871,49,15-19,1920,3.929890598384285E-4
STAT,1839,23,20-24,1862,62.3248360048484
SIM,1925,31,25-29,1956,18
STAT,1889,44,na,1933,2839.551520323125
SIM,1876,46,na,1922,2586
STAT,1814,48,30-34,1862,0.22958837943036606
STAT,1909,38,na,1947,3575.6300887563916
SIM,1839,48,50-100,1887,3
STAT,1843,22,30-34,1865,15.079791861264198
STAT,1928,27,15-19,1955,0.8790871812051222
SIM,1853,83,na,1936,261
STAT,1818,38,20-24,1856,1.7729551639891292
STAT,1876,31,25-29,1907,10.725078704708256
SIM,1936,27,15-19,1963,1
STAT,1881,39,30-34,1920,5.136470945107765
SIM,1851,22,30-34,1873,24
STAT,1934,31,25-29,1965,12.75832585630175
STAT,1944,21,40-44,1965,3.6671732417622063
SIM,1936,20,45-49,1956,5
SIM,1946,17,30-34,1963,25
SIM,1848,82,na,1930,298
SIM,1893,29,20-24,1922,17
SIM,1883,32,20-24,1915,5
SIM,1901,20,30-34,1921,28
STAT,1841,37,35-39,1878,6.231756952217936
SIM,1932,35,30-34,1967,7
STAT,1903,19,25-29,1922,8.107384683390748
STAT,1859,35,40-44,1894,3.58977304213245
STAT,1939,16,35-39,1955,4.241465504484658
SIM,1808,52,na,1860,1186
STAT,1875,25,30-34,1900,26.296307348937493
STAT,1825,29,35-39,1854,39.25188492346693
STAT,1866,36,50-100,1902,1.1537514922776086
STAT,1938,24,20-24,1962,111.02322511454167
STAT,1805,99,na,1904,0.7518198291338339
SIM,1901,15,35-39,1916,1
SIM,1826,30,25-29,1856,14
SIM,1833,36,25-29,1869,1
STAT,1908,34,35-39,1942,8.632942531248608
STAT,1928,20,45-49,1948,1.4284259198749765
STAT,1878,41,50-100,1919,1.1126538407218873
STAT,1904,60,na,1964,2957.838284289529
SIM,1832,37,35-39,1869,5
STAT,1865,35,15-19,1900,0.052280726947745125
STAT,1917,39,20-24,1956,0.2746946575433873
SIM,1926,38,25-29,1964,1
STAT,1885,21,25-29,1906,57.72492498663662
SIM,1817,47,50-100,1864,1
STAT,1824,37,35-39,1861,9.864199589957298
STAT,1836,49,50-100,1885,0.1580412857943976
STAT,1839,49,30-34,1888,0.06815471690070994
SIM,1836,20,40-44,1856,3
SIM,1866,36,50-100,1902,1
STAT,1892,27,25-29,1919,53.611940432232615
STAT,1831,33,45-49,1864,1.4263195058645974
STAT,1917,31,25-29,1948,9.809288892563933
STAT,1849,45,25-29,1894,0.04548370318347215
STAT,1866,81,na,1947,505.7405790969282
SIM,1845,64,na,1909,1332
SIM,1903,43,na,1946,3102
STAT,1910,22,25-29,1932,87.51635585454626
STAT,1919,37,15-19,1956,0.0208299787633414
SIM,1847,23,20-24,1870,59
STAT,1899,41,20-24,1940,0.015356071950693748
STAT,1823,38,30-34,1861,8.877236081380973
STAT,1876,24,35-39,1900,6.047392984911055
STAT,1907,35,30-34,1942,1.7224242925957944
STAT,1891,28,35-39,1919,12.0233030543021
STAT,1848,46,35-39,1894,0.11462871366533037
STAT,1869,44,na,1913,2238.9069557677703
SIM,1831,38,30-34,1869,11
SIM,1893,21,25-29,1914,141
STAT,1848,47,30-34,1895,0.07866472109201254
STAT,1870,26,50-100,1896,0.6366166185460613
SIM,1843,73,na,1916,1065
STAT,1822,46,15-19,1868,6.014466166795666E-4
STAT,1898,15,25-29,1913,7.794983416608003
STAT,1919,0,na,1919,5026.727598379153
STAT,1851,16,30-34,1867,1.476012719695444
STAT,1926,22,35-39,1948,11.561203989621802
SIM,1938,23,30-34,1961,35
STAT,1855,34,45-49,1889,1.3090394555723537
SIM,1825,31,20-24,1856,1
STAT,1883,26,35-39,1909,9.56945180271742
STAT,1904,48,25-29,1952,0.046501621733778635
STAT,1908,31,30-34,1939,15.073630628871099
SIM,1842,97,na,1939,1
STAT,1918,31,40-44,1949,4.215412235008197
STAT,1916,41,na,1957,3846.3746535987357
STAT,1848,39,45-49,1887,1.6427993672593248
SIM,1892,22,20-24,1914,5
STAT,1837,21,45-49,1858,0.6272625916780619
STAT,1900,44,45-49,1944,0.14384639506028835
STAT,1905,22,15-19,1927,4.816893769796608
STAT,1884,22,20-24,1906,68.63649954641656
STAT,1878,29,15-19,1907,0.47228677190041557
SIM,1935,24,45-49,1959,1
STAT,1920,16,20-24,1936,153.9808061435989
SIM,1947,22,na,1969,4381
SIM,1876,25,40-44,1901,3
STAT,1839,36,50-100,1875,1.0510395085752677
STAT,1786,91,na,1877,19.13746313464391
STAT,1816,51,na,1867,1438.2924900194555
SIM,1843,22,25-29,1865,69
SIM,1913,22,15-19,1935,7
STAT,1818,48,15-19,1866,7.016731735534945E-4
SIM,1856,39,45-49,1895,2
STAT,1870,18,20-24,1888,17.64589415591874
STAT,1899,44,25-29,1943,0.060977907081674415
STAT,1867,35,50-100,1902,1.1789471017683801
STAT,1877,29,15-19,1906,0.46956984435403065
STAT,1891,78,na,1969,1410.4486256828693
STAT,1909,33,40-44,1942,3.752452112402635
STAT,1884,26,35-39,1910,9.643264474135853
SIM,1879,41,45-49,1920,1
STAT,1892,25,30-34,1917,32.13153759400507
STAT,1898,28,50-100,1926,0.8727893564276479
SIM,1901,23,35-39,1924,9
STAT,1920,42,20-24,1962,0.019696578961883558
SIM,1889,38,30-34,1927,7
STAT,1894,45,na,1939,2955.2633440902655
STAT,1932,34,na,1966,5074.3326978477
SIM,1833,34,30-34,1867,23
SIM,1874,75,na,1949,1057
SIM,1930,11,na,1941,5529
SIM,1807,90,na,1897,51
STAT,1943,21,25-29,1964,99.26267381227665
SIM,1824,35,35-39,1859,9
SIM,1893,58,na,1951,2593
SIM,1915,44,na,1959,4136
SIM,1868,27,na,1895,2131
SIM,1918,21,40-44,1939,2
SIM,1834,68,na,1902,1056
SIM,1909,38,25-29,1947,4
SIM,1828,82,na,1910,267
SIM,1889,74,na,1963,1418
SIM,1916,31,30-34,1947,21
STAT,1811,75,na,1886,445.2740656617347
STAT,1845,20,40-44,1865,1.917660859349609
SIM,1832,34,30-34,1866,24
SIM,1926,31,40-44,1957,1
STAT,1912,47,20-24,1959,0.010715119063061876
SIM,1891,26,35-39,1917,23
STAT,1812,92,na,1904,18.909294266237
STAT,1825,34,30-34,1859,33.39675651644574
STAT,1930,16,50-100,1946,0.4907681378700473
STAT,1886,16,45-49,1902,0.06983054683530152
STAT,1909,37,20-24,1946,0.2517857454865922
SIM,1876,31,50-100,1907,1
STAT,1869,78,na,1947,767.2362830305934
SIM,1874,37,25-29,1911,1
SIM,1834,22,30-34,1856,1
SIM,1840,29,40-44,1869,7
STAT,1955,17,30-34,1972,16.346823597952426
STAT,1777,86,na,1863,50.74308500600743
SIM,1884,23,25-29,1907,58
SIM,1840,31,na,1871,1927
SIM,1802,91,na,1893,5
SIM,1850,25,35-39,1875,11
STAT,1897,31,45-49,1928,2.3708872978146047
SIM,1909,34,45-49,1943,2
SIM,1859,36,45-49,1895,2
SIM,1826,81,na,1907,393
STAT,1888,25,50-100,1913,0.7677583946944294
STAT,1870,86,na,1956,242.05226850076957
STAT,1945,27,15-19,1972,0.7821656816336522
SIM,1892,26,35-39,1918,25
STAT,1822,47,na,1869,1457.1819942405043
STAT,1832,29,40-44,1861,2.697394923040113
STAT,1854,48,na,1902,1667.2595196202042
STAT,1948,21,25-29,1969,107.17341534828883
STAT,1938,21,15-19,1959,5.3203482686160894
SIM,1813,43,45-49,1856,8
SIM,1951,1,na,1952,5038
SIM,1851,21,20-24,1872,2
SIM,1900,45,na,1945,3298
SIM,1873,28,40-44,1901,3
SIM,1830,39,25-29,1869,2
SIM,1825,35,35-39,1860,12
SIM,1914,0,na,1914,4607
STAT,1822,39,25-29,1861,4.906094080935136
STAT,1842,25,35-39,1867,10.899051268956898
SIM,1845,30,na,1875,2077
SIM,1940,21,na,1961,4162
STAT,1855,18,50-100,1873,0.043603415037765395
SIM,1845,21,45-49,1866,1
SIM,1943,23,40-44,1966,4
STAT,1912,17,25-29,1929,8.84083023933032
SIM,1946,21,15-19,1967,5
STAT,1838,49,30-34,1887,0.0649799222109017
STAT,1852,67,na,1919,1202.216437862305
SIM,1866,33,30-34,1899,34
SIM,1875,29,na,1904,2315
STAT,1893,20,20-24,1913,88.90354349597938
SIM,1938,17,na,1955,3559
SIM,1868,23,40-44,1891,3
STAT,1817,42,25-29,1859,1.5710044331927953
STAT,1896,46,na,1942,3016.960534016016
STAT,1865,35,30-34,1900,4.961915684779518
STAT,1866,37,25-29,1903,2.6927189817601747
STAT,1928,35,15-19,1963,0.02457270127232385
STAT,1848,21,20-24,1869,69.00284913696763
STAT,1844,38,15-19,1882,0.04646383668442015
STAT,1883,52,35-39,1935,0.008463649821404275
STAT,1851,31,20-24,1882,2.1525072985603053
STAT,1843,21,20-24,1864,58.762898216491536
STAT,1889,15,30-34,1904,1.994218331082329
SIM,1898,57,na,1955,2746
SIM,1934,22,35-39,1956,18
SIM,1920,17,25-29,1937,64
SIM,1854,41,40-44,1895,9
SIM,1938,30,20-24,1968,3
STAT,1767,108,na,1875,0.003914538050134284
STAT,1839,19,35-39,1858,0.5029174102974332
STAT,1855,45,15-19,1900,3.040898030359422E-4
SIM,1887,40,40-44,1927,6
SIM,1860,21,na,1881,2129
STAT,1858,33,30-34,1891,13.776462759443847
SIM,1873,35,30-34,1908,8
SIM,1885,29,na,1914,2561
STAT,1829,44,45-49,1873,1.1284130680682025
SIM,1923,18,na,1941,4419
SIM,1856,21,20-24,1877,68
STAT,1839,101,na,1940,0.4045566461158813
STAT,1883,19,45-49,1902,0.06421665380378391
SIM,1941,28,35-39,1969,25
STAT,1835,34,na,1869,2028.238673529874
SIM,1839,24,25-29,1863,90
STAT,1862,102,na,1964,1.076279058187077
SIM,1815,64,na,1879,874
STAT,1836,28,15-19,1864,0.3676936376476462
SIM,1848,37,30-34,1885,7
STAT,1859,20,50-100,1879,0.38317075220958613
STAT,1896,35,45-49,1931,2.6904457488939073
STAT,1879,40,40-44,1919,2.3946579225769717
STAT,1844,28,20-24,1872,11.280833156069527
STAT,1842,105,na,1947,0.026398418697441327
STAT,1855,49,30-34,1904,0.07134204599332683
STAT,1914,34,50-100,1948,0.8325077080075082
STAT,1846,41,40-44,1887,1.749881804078205
STAT,1854,112,na,1966,1.5907919039155144E-4
SIM,1852,49,50-100,1901,5
SIM,1938,15,30-34,1953,21
SIM,1955,5,na,1960,5061
STAT,1851,24,30-34,1875,15.875941622230112
STAT,1937,33,na,1970,3775.1522983389577
STAT,1842,51,35-39,1893,0.007788120815976522
SIM,1900,27,35-39,1927,16
STAT,1933,28,35-39,1961,20.134883717932205
SIM,1889,20,20-24,1909,4
STAT,1847,25,20-24,1872,10.710901961498363
STAT,1825,34,na,1859,2100.2699555942568
STAT,1859,49,15-19,1908,3.181495836787544E-4
STAT,1855,16,15-19,1871,5.344602074012439
SIM,1875,30,20-24,1905,3
STAT,1894,15,40-44,1909,0.2389403330846947
SIM,1843,15,35-39,1858,1
STAT,1884,33,25-29,1917,10.158532045368565
STAT,1850,24,30-34,1874,16.13614241821097
SIM,1863,16,15-19,1879,7
STAT,1874,29,30-34,1903,25.85672543661374
STAT,1899,37,35-39,1936,2.116138184975378
STAT,1884,50,50-100,1934,0.015258426674362982
STAT,1947,18,35-39,1965,4.773030988860192
SIM,1829,28,30-34,1857,29
STAT,1877,30,50-100,1907,0.9627930861567977
STAT,1837,28,15-19,1865,0.3944197262671819
SIM,1825,64,na,1889,833
SIM,1878,20,45-49,1898,4
SIM,1775,94,na,1869,7
SIM,1866,35,25-29,1901,4
SIM,1928,17,na,1945,4737
STAT,1851,23,20-24,1874,61.86533277256118
SIM,1896,19,30-34,1915,2
STAT,1956,16,na,1972,4921.59971027465
SIM,1908,32,35-39,1940,11
SIM,1858,34,35-39,1892,15
STAT,1863,47,15-19,1910,3.5628679824220377E-4
SIM,1844,78,na,1922,477
STAT,1888,19,30-34,1907,1.889880696200476
SIM,1905,44,na,1949,3518
SIM,1890,20,45-49,1910,1
SIM,1847,19,35-39,1866,2
STAT,1901,22,30-34,1923,25.21965358155519
SIM,1879,23,15-19,1902,3
STAT,1860,96,na,1956,8.216945298114883
SIM,1865,36,35-39,1901,9
STAT,1889,1,na,1890,3389.7967114994576
STAT,1943,25,40-44,1968,5.0166725461951005
SIM,1902,26,na,1928,3601
STAT,1949,14,na,1963,4613.735927715849
SIM,1949,4,na,1953,4467
STAT,1830,38,20-24,1868,0.6909232161388514
SIM,1882,29,30-34,1911,29
SIM,1824,36,50-100,1860,1
SIM,1830,55,na,1885,1164
SIM,1855,25,20-24,1880,13
STAT,1950,17,45-49,1967,0.5967555950087292
STAT,1841,40,50-100,1881,0.842247258220556
STAT,1887,42,40-44,1929,2.533264078714379
STAT,1925,26,35-39,1951,17.982479257469663
STAT,1841,29,35-39,1870,8.833900069900485
STAT,1914,38,40-44,1952,1.5005441698225517
STAT,1879,54,na,1933,2207.0303076510913
STAT,1899,33,20-24,1932,3.7310381942446966
STAT,1835,38,50-100,1873,1.1278936747096298
STAT,1889,48,30-34,1937,0.067148129951095
STAT,1935,23,40-44,1958,4.624482120874377
STAT,1882,20,45-49,1902,0.6862933939372461
STAT,1887,63,na,1950,2012.0634539565674
STAT,1941,17,na,1958,3827.6167957047155
STAT,1951,16,35-39,1967,5.049871452381327
SIM,1818,62,na,1880,874
STAT,1825,33,20-24,1858,5.71143636999635
STAT,1903,20,40-44,1923,3.0152623327412793
SIM,1868,31,40-44,1899,5
STAT,1904,39,50-100,1943,0.3802266255694905
STAT,1934,15,na,1949,5053.886754700584
STAT,1863,18,15-19,1881,5.482197398895063
STAT,1928,35,50-100,1963,0.5372485371868491
SIM,1897,22,20-24,1919,93
STAT,1848,52,na,1900,1748.613364612248
SIM,1869,30,30-34,1899,29
SIM,1902,26,20-24,1928,24
SIM,1798,67,na,1865,770
STAT,1884,45,na,1929,2263.1702833557515
STAT,1839,26,25-29,1865,38.05460278903358
SIM,1835,24,40-44,1859,5
STAT,1782,77,na,1859,333.6917184073078
STAT,1832,47,na,1879,1638.8249716938576
SIM,1851,32,25-29,1883,10
STAT,1899,44,na,1943,3171.399851356956
STAT,1856,81,na,1937,418.7389712717527
STAT,1889,22,20-24,1911,85.82321975976943
STAT,1913,24,15-19,1937,5.389602733959801
STAT,1920,39,50-100,1959,0.4632253033738432
SIM,1855,18,30-34,1873,1
STAT,1859,39,20-24,1898,0.6198856712517765
SIM,1838,40,45-49,1878,4
SIM,1901,30,25-29,1931,22
SIM,1933,26,35-39,1959,30
STAT,1940,28,40-44,1968,4.796100792188219
SIM,1838,22,15-19,1860,3
SIM,1932,27,45-49,1959,3
SIM,1838,82,na,1920,277
STAT,1849,39,50-100,1888,0.9620577261581046
STAT,1892,24,20-24,1916,86.79150787969601
STAT,1873,15,20-24,1888,18.368152565407406
STAT,1930,38,25-29,1968,1.2967512683256672
STAT,1824,34,30-34,1858,27.309424710143333
SIM,1834,39,50-100,1873,1
STAT,1881,35,15-19,1916,0.05518935055808148
STAT,1924,27,45-49,1951,2.0326565829387566
STAT,1897,46,15-19,1943,3.06387943776469E-4
SIM,1905,16,30-34,1921,2
STAT,1843,25,35-39,1868,8.12538417173797
STAT,1815,99,na,1914,0.819814105998668
SIM,1911,20,40-44,1931,7
STAT,1835,22,25-29,1857,57.13512321475358
STAT,1911,42,na,1953,3576.204944924193
SIM,1899,34,25-29,1933,4
STAT,1891,25,30-34,1916,31.70305096716518
STAT,1885,39,15-19,1924,0.055886111970916516
STAT,1906,39,45-49,1945,0.6266107156495189
SIM,1853,28,na,1881,1834
STAT,1853,22,40-44,1875,2.0361054292510907
STAT,1868,38,na,1906,2262.9232095511597
STAT,1862,26,15-19,1888,0.4000598374468049
STAT,1871,39,20-24,1910,0.7657036175742028
STAT,1861,15,50-100,1876,0.0478219657668526
STAT,1884,27,50-100,1911,0.6371304222799654
STAT,1924,31,15-19,1955,0.1515867242842528
SIM,1878,27,na,1905,2741
SIM,1926,20,35-39,1946,13
STAT,1927,24,45-49,1951,1.3923971972324463
SIM,1841,36,30-34,1877,7
STAT,1934,21,30-34,1955,39.040525058731625
STAT,1907,38,35-39,1945,2.253106019642771
SIM,1865,29,na,1894,2178
SIM,1920,11,na,1931,4820
STAT,1843,32,25-29,1875,8.30511119946216
STAT,1833,84,na,1917,235.3577977670613
STAT,1892,17,30-34,1909,2.02003696255795
STAT,1831,30,40-44,1861,3.675833350167184
SIM,1915,38,35-39,1953,6
SIM,1866,46,na,1912,2318
SIM,1905,23,20-24,1928,101
STAT,1844,48,na,1892,1757.6722264234875
SIM,1902,19,30-34,1921,3
SIM,1942,21,30-34,1963,48
STAT,1847,18,30-34,1865,1.4806941405837375
STAT,1918,20,35-39,1938,10.313692244212914
SIM,1925,35,40-44,1960,2
STAT,1852,35,50-100,1887,0.9558074654869083
STAT,1891,18,40-44,1909,0.2281170487543882
SIM,1896,12,na,1908,3451
STAT,1920,49,20-24,1969,0.01226386356380311
STAT,1833,36,30-34,1869,4.780954468335046
STAT,1871,27,na,1898,2394.695192698496
SIM,1833,26,30-34,1859,31
STAT,1832,67,na,1899,1079.4131606885635
SIM,1832,27,40-44,1859,1
SIM,1866,32,20-24,1898,2
SIM,1872,32,45-49,1904,4
STAT,1917,35,40-44,1952,1.5843773481057468
SIM,1851,25,35-39,1876,15
SIM,1838,37,50-100,1875,1
SIM,1857,39,50-100,1896,4
STAT,1845,65,na,1910,1234.8320248571504
STAT,1909,22,35-39,1931,8.830882440450024
SIM,1865,25,50-100,1890,1
SIM,1865,30,na,1895,2189
SIM,1929,27,50-100,1956,1
SIM,1827,76,na,1903,414
STAT,1874,45,na,1919,2349.958730750815
SIM,1897,18,35-39,1915,3
SIM,1909,33,50-100,1942,1
SIM,1931,20,45-49,1951,4
STAT,1793,93,na,1886,6.903648343685207
STAT,1897,38,30-34,1935,7.18076755577942
SIM,1903,21,45-49,1924,1
SIM,1906,22,25-29,1928,4
SIM,1896,26,20-24,1922,22
STAT,1823,53,na,1876,1307.3740156762055
STAT,1838,20,35-39,1858,5.141756248324721
STAT,1901,32,25-29,1933,14.502067535401702
SIM,1835,95,na,1930,1
SIM,1845,31,50-100,1876,4
STAT,1919,43,50-100,1962,0.12833969768611417
SIM,1893,25,40-44,1918,12
SIM,1833,37,35-39,1870,10
STAT,1950,21,15-19,1971,6.382237036915825
SIM,1934,33,40-44,1967,15
SIM,1856,38,35-39,1894,19
STAT,1797,105,na,1902,0.00732059117488764
STAT,1851,34,25-29,1885,7.906253985623312
SIM,1939,22,20-24,1961,108
SIM,1856,24,25-29,1880,59
STAT,1787,76,na,1863,311.3951242391829
SIM,1863,31,40-44,1894,9
STAT,1872,37,15-19,1909,0.05702051489781407
STAT,1897,24,20-24,1921,92.72742221537675
STAT,1899,26,30-34,1925,35.02572510102332
STAT,1900,15,40-44,1915,0.2578073017708272
SIM,1917,22,35-39,1939,8
STAT,1892,28,35-39,1920,12.185805539458729
SIM,1885,42,50-100,1927,1
STAT,1840,34,15-19,1874,0.11908837961498298
SIM,1882,25,30-34,1907,33
SIM,1820,55,na,1875,1239
SIM,1936,21,40-44,1957,4
STAT,1851,48,35-39,1899,0.10467431852056225
STAT,1841,19,40-44,1860,0.17433518528351633
STAT,1952,19,20-24,1971,164.04030045400256
STAT,1850,17,40-44,1867,0.17114057623256962
STAT,1859,24,35-39,1883,4.847919436791585
SIM,1938,26,35-39,1964,20
STAT,1845,23,45-49,1868,0.6279984636606323
STAT,1848,38,35-39,1886,5.889516103691318
STAT,1828,38,15-19,1866,0.0565606299962209
STAT,1916,7,na,1923,4265.914028355252
STAT,1938,32,20-24,1970,2.4759697658815663
SIM,1937,32,na,1969,3641
SIM,1838,33,20-24,1871,2
SIM,1843,28,na,1871,2365
SIM,1881,77,na,1958,812
SIM,1875,23,30-34,1898,24
STAT,1923,20,45-49,1943,1.330680102877705
SIM,1861,18,20-24,1879,21
SIM,1835,20,25-29,1855,54
SIM,1948,20,20-24,1968,129
STAT,1853,18,20-24,1871,17.53244634046983
STAT,1929,34,20-24,1963,3.1275244783495593
STAT,1910,19,15-19,1929,9.024010164830097
STAT,1834,80,na,1914,368.2061489140572
SIM,1888,39,40-44,1927,7
SIM,1897,62,na,1959,2530
STAT,1787,86,na,1873,59.88438055070069
STAT,1855,31,40-44,1886,3.358461327923723
STAT,1902,27,na,1929,3406.1892918415583
SIM,1879,27,30-34,1906,56
STAT,1861,82,na,1943,391.59335688804686
STAT,1859,78,na,1937,634.704352813028
STAT,1876,2,na,1878,3398.458451536703
STAT,1848,24,25-29,1872,56.09482633517811
STAT,1857,36,35-39,1893,5.602023938621374
STAT,1944,24,45-49,1968,1.2259364025064388
SIM,1864,23,20-24,1887,78
STAT,1924,38,35-39,1962,2.8791975429165424
SIM,1844,68,na,1912,1056
SIM,1900,45,50-100,1945,2
STAT,1816,46,25-29,1862,0.15118856834194
SIM,1928,22,45-49,1950,1
SIM,1820,65,na,1885,874
SIM,1841,102,na,1943,4
STAT,1845,49,20-24,1894,0.008585158851110967
SIM,1937,34,20-24,1971,2
STAT,1766,91,na,1857,8.420105102812201
SIM,1932,38,35-39,1970,7
SIM,1849,33,30-34,1882,26
SIM,1900,33,50-100,1933,1
STAT,1895,29,15-19,1924,0.5941400343714931
STAT,1883,37,25-29,1920,2.8457159553897733
STAT,1883,23,15-19,1906,3.2505853385120127
STAT,1943,29,na,1972,4024.4805881214033
SIM,1841,24,15-19,1865,3
STAT,1829,41,40-44,1870,1.772926201188952
STAT,1874,55,na,1929,2138.4078494400765
SIM,1805,53,50-100,1858,1
SIM,1891,37,25-29,1928,3
STAT,1941,19,45-49,1960,0.5191241092173374
SIM,1792,73,na,1865,357
STAT,1804,73,na,1877,475.32402597740077
STAT,1841,26,30-34,1867,23.55864647778551
SIM,1803,63,na,1866,818
SIM,1865,29,45-49,1894,5
SIM,1948,17,na,1965,4660
STAT,1802,92,na,1894,14.551608983968375
STAT,1869,39,15-19,1908,0.054586474512861506
STAT,1839,38,40-44,1877,3.6704465442467957
SIM,1805,88,na,1893,46
STAT,1831,36,15-19,1867,0.04538189054036155
STAT,1867,23,30-34,1890,16.891079013785316
STAT,1889,39,35-39,1928,8.719920935439927
SIM,1867,35,40-44,1902,6
SIM,1833,25,35-39,1858,1
STAT,1882,74,na,1956,1119.7368517369448
SIM,1891,23,15-19,1914,4
STAT,1805,53,50-100,1858,0.06085017614115114
STAT,1865,85,na,1950,252.82212375916896
STAT,1861,27,50-100,1888,0.5407816592175116
STAT,1902,24,40-44,1926,2.9555185029516005
STAT,1907,27,45-49,1934,1.6468325298305875
STAT,1928,21,40-44,1949,4.256063963143886
STAT,1825,65,na,1890,1233.2652091999971
STAT,1929,20,45-49,1949,1.4467400074284993
STAT,1927,39,15-19,1966,0.024080698111163364
SIM,1946,25,30-34,1971,54
SIM,1897,39,35-39,1936,5
STAT,1914,16,30-34,1930,2.5501487074768083
SIM,1852,87,na,1939,67
STAT,1896,46,15-19,1942,3.025101551918446E-4
STAT,1922,20,50-100,1942,0.7668385933942066
STAT,1884,7,na,1891,2594.921736853163
STAT,1857,29,45-49,1886,0.8885609909758444
SIM,1884,20,20-24,1904,77
SIM,1915,27,45-49,1942,2
STAT,1896,32,40-44,1928,5.797848233575248
SIM,1803,76,na,1879,358
SIM,1922,16,30-34,1938,25
STAT,1825,37,35-39,1862,11.67912468641367
STAT,1856,30,45-49,1886,1.3955375203799743
STAT,1889,25,25-29,1914,53.03935552614772
SIM,1905,30,45-49,1935,4
SIM,1865,20,na,1885,2406
STAT,1947,25,25-29,1972,75.2823533938938
STAT,1926,33,40-44,1959,4.779390818064554
STAT,1827,46,na,1873,1521.597188349041
STAT,1888,26,20-24,1914,14.03319365318206
STAT,1839,45,30-34,1884,0.07173847769784647
STAT,1833,24,15-19,1857,3.104054355931373
STAT,1856,19,35-39,1875,0.49650480243744693
SIM,1769,87,na,1856,99
SIM,1846,20,35-39,1866,5
STAT,1867,30,20-24,1897,2.5918764795648292
STAT,1808,86,na,1894,83.64898440448772
SIM,1929,28,35-39,1957,23
SIM,1854,78,na,1932,703
STAT,1877,26,45-49,1903,1.1613777774533296
SIM,1862,97,na,1959,4
STAT,1889,18,35-39,1907,0.6815687797033353
STAT,1912,37,na,1949,3704.632908823693
STAT,1906,21,20-24,1927,101.68347686239784
STAT,1933,6,na,1939,5421.792593026463
STAT,1842,13,na,1855,2747.4696000000004
SIM,1926,27,20-24,1953,28
STAT,1890,62,na,1952,2255.7141773379394
STAT,1938,25,30-34,1963,39.22260823075111
STAT,1817,46,na,1863,1343.2402242012183
SIM,1847,38,40-44,1885,5
STAT,1953,18,25-29,1971,52.94726907249809
STAT,1869,42,50-100,1911,1.0361147004907747
STAT,1891,29,30-34,1920,31.264355672484086
STAT,1910,37,45-49,1947,0.6578013277878545
STAT,1892,74,na,1966,1737.4126786105094
STAT,1892,16,35-39,1908,0.6971305181086831
STAT,1873,22,45-49,1895,0.7139942312813761
STAT,1888,58,na,1946,2357.5170593409493
STAT,1863,102,na,1965,1.2611166615400922
SIM,1914,21,20-24,1935,142
SIM,1885,26,45-49,1911,1
STAT,1810,44,30-34,1854,4.648829622766725
STAT,1910,56,na,1966,3329.32429890177
SIM,1870,38,50-100,1908,2
SIM,1914,17,35-39,1931,1
STAT,1861,24,40-44,1885,1.7710041854150724
SIM,1920,28,15-19,1948,1
SIM,1926,0,na,1926,5161
STAT,1935,27,20-24,1962,25.139644400899574
STAT,1898,48,25-29,1946,0.043928247667199986
SIM,1835,28,20-24,1863,10
SIM,1887,21,35-39,1908,9
SIM,1923,26,40-44,1949,11
STAT,1776,91,na,1867,15.200089444673615
STAT,1937,1,na,1938,4101.414155482044
SIM,1885,19,20-24,1904,32
SIM,1856,46,na,1902,2089
SIM,1944,18,25-29,1962,64
STAT,1887,48,15-19,1935,4.453904400225033E-4
SIM,1889,37,35-39,1926,15
STAT,1918,27,20-24,1945,19.61216035245013
STAT,1806,51,na,1857,1170.3696632880692
SIM,1867,11,na,1878,2504
SIM,1938,33,25-29,1971,11
SIM,1864,30,45-49,1894,1
STAT,1921,37,20-24,1958,0.2972784672853601
STAT,1841,38,30-34,1879,4.647237643324176
SIM,1855,30,na,1885,2154
SIM,1910,24,40-44,1934,4
STAT,1865,28,40-44,1893,2.7529521659197855
STAT,1865,25,50-100,1890,0.5939626285022531
SIM,1918,32,45-49,1950,3
STAT,1833,53,na,1886,1538.9791062178656
SIM,1841,27,35-39,1868,10
STAT,1936,18,25-29,1954,41.776197523486374
STAT,1907,26,50-100,1933,0.9520656405584302
SIM,1889,23,25-29,1912,84
STAT,1833,27,35-39,1860,9.030503914639763
SIM,1844,20,50-100,1864,1
STAT,1898,37,35-39,1935,9.684306091603577
STAT,1911,22,40-44,1933,3.2171626510418436
STAT,1915,45,50-100,1960,0.23105839151695703
SIM,1864,16,30-34,1880,1
STAT,1854,30,50-100,1884,0.7189514279774368
STAT,1894,19,20-24,1913,22.929407689749308
STAT,1902,37,na,1939,3389.1254280601556
STAT,1851,15,35-39,1866,0.511146168219599
STAT,1893,59,na,1952,2492.3790348369657
STAT,1826,36,40-44,1862,5.196925832161693
STAT,1814,52,50-100,1866,0.034783559603239166
STAT,1906,17,35-39,1923,0.8072079300148521
STAT,1851,82,na,1933,353.2905209700264
STAT,1905,55,na,1960,3117.1070261474238
SIM,1854,68,na,1922,1428
STAT,1827,28,20-24,1855,23.550557311798205
STAT,1856,26,na,1882,1928.7950260137934
STAT,1856,37,30-34,1893,4.1269386151417216
STAT,1831,29,25-29,1860,35.638400159353296
STAT,1850,53,35-39,1903,0.006486232716042681
SIM,1934,29,20-24,1963,31
SIM,1829,42,45-49,1871,3
SIM,1943,27,20-24,1970,21
SIM,1897,25,25-29,1922,76
SIM,1880,34,45-49,1914,2
SIM,1902,22,40-44,1924,4
SIM,1816,48,50-100,1864,3
STAT,1925,23,30-34,1948,34.660795644437684
STAT,1898,34,15-19,1932,0.19331644481620458
STAT,1882,33,na,1915,2324.789422703054
SIM,1774,88,na,1862,26
SIM,1891,77,na,1968,1383
STAT,1862,15,45-49,1877,0.06602974972560341
STAT,1879,21,35-39,1900,6.169164143239018
STAT,1888,33,45-49,1921,2.0700581404319953
STAT,1915,26,40-44,1941,4.813669267734902
STAT,1863,41,50-100,1904,0.9496857309501812
STAT,1842,18,45-49,1860,0.07507766388830771
STAT,1893,27,40-44,1920,3.8416353952435616
STAT,1830,35,na,1865,1814.223494432368
STAT,1856,23,20-24,1879,61.53014342699417
STAT,1882,16,25-29,1898,5.5576462201889845
STAT,1956,16,35-39,1972,5.6107307509807125
SIM,1850,29,35-39,1879,14
STAT,1872,34,45-49,1906,1.7555533345615144
STAT,1926,29,20-24,1955,21.957492866867366
SIM,1925,29,50-100,1954,2
STAT,1874,24,50-100,1898,0.4190924773354105
STAT,1930,16,15-19,1946,59.44839246372238
STAT,1882,43,50-100,1925,1.026110802799668
STAT,1842,29,35-39,1871,10.589385642011111
STAT,1854,19,50-100,1873,0.04346640318886307
STAT,1851,27,35-39,1878,8.554370375632637
STAT,1857,44,20-24,1901,0.12349373003715056
SIM,1904,31,50-100,1935,4
STAT,1842,36,25-29,1878,3.0726348742643754
SIM,1887,62,na,1949,1936
SIM,1917,22,na,1939,3808
SIM,1952,17,20-24,1969,246
SIM,1929,35,25-29,1964,1
SIM,1895,20,30-34,1915,36
SIM,1848,22,25-29,1870,56
SIM,1863,41,50-100,1904,1
STAT,1901,42,na,1943,3279.644600822024
STAT,1833,39,35-39,1872,6.150237057942973
STAT,1853,25,45-49,1878,1.0791281160155701
STAT,1927,28,25-29,1955,80.59359892267685
STAT,1838,83,na,1921,265.7536056995688
STAT,1871,37,50-100,1908,1.2319468107238647
STAT,1852,26,40-44,1878,2.6652086512074376
SIM,1929,21,15-19,1950,7
STAT,1867,26,35-39,1893,9.209769687448608
SIM,1844,25,45-49,1869,1
STAT,1944,17,20-24,1961,147.33045510450975
SIM,1844,49,50-100,1893,1
SIM,1875,30,na,1905,2335
STAT,1889,36,50-100,1925,1.5363829832320497
STAT,1917,24,35-39,1941,10.038097845302614
SIM,1907,26,50-100,1933,1
SIM,1824,39,35-39,1863,5
STAT,1951,20,20-24,1971,134.31503508704608
STAT,1816,39,35-39,1855,24.588344503037952
STAT,1847,32,45-49,1879,1.5330161850137936
SIM,1899,24,30-34,1923,29
SIM,1821,49,50-100,1870,3
SIM,1855,32,45-49,1887,1
STAT,1821,49,50-100,1870,0.34970059700288303
SIM,1825,47,50-100,1872,1
STAT,1897,17,30-34,1914,2.15819294875505
STAT,1892,46,30-34,1938,0.06939951747581936
STAT,1887,20,30-34,1907,20.20579310111495
SIM,1935,28,25-29,1963,8
STAT,1836,25,45-49,1861,0.9194855613161822
SIM,1947,23,25-29,1970,4
SIM,1937,27,30-34,1964,68
STAT,1885,38,50-100,1923,1.2281740081372348
STAT,1887,27,15-19,1914,0.5116158304887232
SIM,1850,36,25-29,1886,3
STAT,1851,72,na,1923,956.2486066856617
STAT,1926,28,50-100,1954,1.2016719058538938
SIM,1874,36,50-100,1910,1
SIM,1937,22,na,1959,3455
SIM,1925,24,35-39,1949,20
STAT,1880,39,15-19,1919,0.05896425065578952
STAT,1842,22,15-19,1864,3.7463299818828104
STAT,1866,49,40-44,1915,0.15676880362661383
STAT,1835,65,na,1900,1268.397631003879
STAT,1912,28,15-19,1940,0.6994062681285987
STAT,1873,60,na,1933,1952.7795179306952
STAT,1843,24,50-100,1867,0.34029361404860325
SIM,1850,22,15-19,1872,2
SIM,1908,43,40-44,1951,1
SIM,1839,39,45-49,1878,2
SIM,1838,26,30-34,1864,36
SIM,1918,28,25-29,1946,10
SIM,1833,83,na,1916,246
SIM,1876,29,20-24,1905,4
STAT,1901,39,45-49,1940,0.6030788828620575
STAT,1901,25,35-39,1926,13.754191266891196
SIM,1861,25,45-49,1886,1
SIM,1848,36,35-39,1884,8
SIM,1886,41,50-100,1927,5
STAT,1813,48,15-19,1861,0.0011428544734079513
STAT,1861,27,na,1888,2017.5134490707253
STAT,1929,27,30-34,1956,49.56491352046928
SIM,1841,39,35-39,1880,10
STAT,1844,20,25-29,1864,57.37067861457133
SIM,1882,28,35-39,1910,11
SIM,1931,37,na,1968,4939
SIM,1857,35,30-34,1892,8
STAT,1888,15,15-19,1903,7.107517147893635
STAT,1930,22,na,1952,4728.36690721248
STAT,1936,22,45-49,1958,1.0860132393638937
SIM,1793,68,na,1861,679
SIM,1907,33,30-34,1940,2
STAT,1850,32,50-100,1882,0.7339249621846727
SIM,1913,36,25-29,1949,3
STAT,1908,45,40-44,1953,0.14604999129814847
STAT,1816,43,20-24,1859,0.43943393202229386
STAT,1921,38,50-100,1959,0.4730017279134581
STAT,1901,44,50-100,1945,0.10246834203504238
SIM,1877,21,40-44,1898,2
STAT,1817,49,45-49,1866,0.49159003755650077
STAT,1939,23,25-29,1962,93.61844496547577
STAT,1903,28,50-100,1931,0.9169031151273245
STAT,1929,23,15-19,1952,6.7828977958055825
STAT,1851,27,na,1878,1917.8727322102393
SIM,1864,37,30-34,1901,8
STAT,1891,25,15-19,1916,0.5711941867685592
SIM,1911,28,50-100,1939,1
STAT,1870,96,na,1966,33.10877180939568
STAT,1855,20,35-39,1875,5.206005173750607
STAT,1898,58,na,1956,2730.114354792082
SIM,1811,51,na,1862,1469
SIM,1883,28,35-39,1911,1
STAT,1865,20,45-49,1885,0.6603754883285909
STAT,1867,37,40-44,1904,4.163976646213409
STAT,1900,56,na,1956,2883.41597349477
STAT,1834,34,25-29,1868,7.652996099196014
STAT,1843,46,35-39,1889,0.09519713384187443
STAT,1843,94,na,1937,13.47996568599679
STAT,1883,34,20-24,1917,2.6487523834948457
STAT,1939,14,na,1953,3982.3199462250855
STAT,1886,27,15-19,1913,0.4838252124554022
SIM,1842,34,25-29,1876,17
SIM,1880,82,na,1962,587
STAT,1877,23,40-44,1900,2.1654987929166576
SIM,1779,87,na,1866,63
STAT,1847,47,30-34,1894,0.0721398494231674
STAT,1916,36,35-39,1952,2.511675188181603
STAT,1824,34,15-19,1858,0.22274539494818898
SIM,1809,47,na,1856,1267
SIM,1865,37,30-34,1902,7
SIM,1836,49,na,1885,1691
SIM,1875,37,40-44,1912,6
STAT,1865,41,na,1906,2141.1995231815017
STAT,1926,36,45-49,1962,0.8428014316403417
SIM,1833,22,15-19,1855,2
STAT,1819,36,15-19,1855,0.18168127715166416
STAT,1874,28,35-39,1902,9.943695919180533
STAT,1924,15,na,1939,4449.8096099015675
SIM,1836,20,50-100,1856,1
SIM,1852,20,25-29,1872,75
STAT,1908,22,na,1930,3541.492534066115
STAT,1850,28,30-34,1878,22.528288390565706
STAT,1900,18,45-49,1918,0.09140808474734755
SIM,1911,23,45-49,1934,1
SIM,1864,26,25-29,1890,50
SIM,1866,56,na,1922,2038
SIM,1904,24,15-19,1928,5
SIM,1914,24,25-29,1938,159
SIM,1909,37,na,1946,3907
STAT,1843,53,na,1896,1428.9249488616547
STAT,1905,36,25-29,1941,0.9117434308245296
SIM,1851,16,na,1867,2348
STAT,1911,18,20-24,1929,27.29911442182043
SIM,1826,50,na,1876,1734
STAT,1866,24,50-100,1890,0.37899137499428887
SIM,1918,32,50-100,1950,1
STAT,1847,97,na,1944,4.022396721718717
STAT,1864,32,45-49,1896,1.5892971815765802
STAT,1881,21,40-44,1902,2.0348491999965233
STAT,1889,36,30-34,1925,6.669371514013274
STAT,1879,36,20-24,1915,0.8163850752504437
STAT,1933,21,15-19,1954,7.156726315904288
SIM,1888,24,20-24,1912,95
STAT,1806,49,35-39,1855,0.4090242617697718
STAT,1892,39,40-44,1931,5.492118250957674
SIM,1866,15,na,1881,2709
STAT,1951,17,na,1968,4428.386963280254
SIM,1905,6,na,1911,3920
SIM,1891,27,30-34,1918,2
STAT,1883,5,na,1888,2616.0743435647555
SIM,1863,20,35-39,1883,11
SIM,1929,25,30-34,1954,61
SIM,1872,28,25-29,1900,53
SIM,1941,21,15-19,1962,6
STAT,1909,48,na,1957,3397.0655227078073
STAT,1875,28,35-39,1903,9.972809014274437
STAT,1886,26,na,1912,2553.7053488358497
SIM,1919,20,45-49,1939,1
STAT,1825,48,40-44,1873,0.22671529695749051
STAT,1828,49,20-24,1877,0.010647452673502556
SIM,1847,42,na,1889,1731
STAT,1938,28,35-39,1966,15.00861562382236
STAT,1892,33,na,1925,3011.598159540773
SIM,1834,36,40-44,1870,6
SIM,1909,20,35-39,1929,17
STAT,1846,26,15-19,1872,0.4195398600406009
SIM,1844,22,40-44,1866,3
STAT,1856,26,25-29,1882,34.18813142325836
SIM,1890,27,30-34,1917,9
SIM,1880,27,20-24,1907,11
STAT,1941,22,50-100,1963,0.6865099608634153
STAT,1940,9,na,1949,4063.83558140321
SIM,1904,38,na,1942,3556
STAT,1903,23,45-49,1926,0.9999372145948099
SIM,1901,37,45-49,1938,3
SIM,1849,36,35-39,1885,8
STAT,1889,29,40-44,1918,3.7039941774165905
STAT,1906,24,25-29,1930,83.68702283589823
STAT,1879,29,30-34,1908,26.35201924174889
SIM,1948,23,25-29,1971,126
SIM,1824,36,30-34,1860,13
SIM,1922,5,na,1927,5204
STAT,1883,59,na,1942,1920.8642534971918
STAT,1862,67,na,1929,1382.6591778108136
STAT,1866,16,40-44,1882,0.1766162818302305
STAT,1943,29,20-24,1972,19.61015070127531
SIM,1926,16,15-19,1942,51
STAT,1810,47,35-39,1857,0.5408308778870657
STAT,1838,35,20-24,1873,0.6357315595375025
STAT,1856,16,30-34,1872,1.4680156118582939
STAT,1915,55,na,1970,3618.2214499593615
SIM,1893,48,na,1941,2884
STAT,1914,30,45-49,1944,1.6109787563245028
STAT,1848,35,30-34,1883,4.578280164974953
STAT,1810,54,50-100,1864,0.05315073751873985
STAT,1854,49,15-19,1903,2.939265430278189E-4
STAT,1875,35,50-100,1910,1.2855302416558791
SIM,1840,39,35-39,1879,10
STAT,1857,33,15-19,1890,0.1117783378466499
SIM,1859,22,35-39,1881,8
STAT,1890,52,na,1942,2643.2811958257703
SIM,1898,36,30-34,1934,5
STAT,1832,39,35-39,1871,5.974817122027515
SIM,1849,23,na,1872,2082
SIM,1861,57,na,1918,1725
SIM,1933,23,30-34,1956,51
SIM,1885,23,40-44,1908,4
SIM,1883,48,na,1931,2416
STAT,1875,85,na,1960,415.1755692150057
SIM,1897,29,40-44,1926,7
SIM,1887,29,30-34,1916,37
STAT,1882,27,30-34,1909,24.636650334615
STAT,1941,16,40-44,1957,1.4549296065499697
SIM,1898,47,na,1945,3075
STAT,1918,49,15-19,1967,3.934361280472584E-4
STAT,1931,26,25-29,1957,85.92042149606974
SIM,1822,36,na,1858,1758
SIM,1934,36,45-49,1970,1
STAT,1896,44,50-100,1940,0.09675557380447836
STAT,1839,48,35-39,1887,0.0998418584533952
STAT,1851,45,30-34,1896,0.07402650594687617
SIM,1944,22,45-49,1966,1
STAT,1817,91,na,1908,26.51242031627669
STAT,1916,43,25-29,1959,0.0737327673318823
STAT,1812,108,na,1920,8.316227624849316E-4
SIM,1906,8,na,1914,3739
SIM,1933,30,20-24,1963,3
STAT,1834,27,35-39,1861,7.535209986927522
SIM,1846,35,20-24,1881,4
STAT,1799,64,na,1863,850.4462110441178
STAT,1839,30,45-49,1869,1.5533643975558935
STAT,1829,27,na,1856,1672.0767723473068
SIM,1924,36,35-39,1960,4
STAT,1829,30,35-39,1859,9.511455781771723
SIM,1922,30,45-49,1952,2
SIM,1856,35,30-34,1891,9
STAT,1880,18,15-19,1898,6.278347821123819
STAT,1896,21,35-39,1917,7.825130669290949
STAT,1947,22,20-24,1969,126.94028289579592
SIM,1840,21,45-49,1861,1
STAT,1864,102,na,1966,1.460006611289147
SIM,1905,38,40-44,1943,1
STAT,1925,30,20-24,1955,2.9305507002205604
STAT,1860,86,na,1946,183.18686978256434
STAT,1888,2,na,1890,3177.7643527891905
SIM,1879,37,25-29,1916,3
STAT,1915,29,45-49,1944,1.7653720990244042
STAT,1839,27,na,1866,1932.1176845942507
STAT,1864,25,20-24,1889,10.806174348772034
SIM,1810,55,na,1865,1238
SIM,1846,28,30-34,1874,25
STAT,1898,45,20-24,1943,0.009360573327848105
SIM,1867,31,25-29,1898,10
STAT,1884,47,35-39,1931,0.1387892273837214
STAT,1873,44,50-100,1917,1.067110126930356
STAT,1844,24,40-44,1868,2.0290265598910175
STAT,1929,14,na,1943,5094.458632559894
STAT,1824,38,30-34,1862,7.194360845060488
SIM,1934,18,15-19,1952,2
STAT,1876,26,na,1902,2497.3097163994184
STAT,1888,30,40-44,1918,5.211406391762862
SIM,1900,24,30-34,1924,31
STAT,1864,45,na,1909,2070.9183938395304
SIM,1903,17,25-29,1920,10
STAT,1769,98,na,1867,0.4588340094344753
STAT,1880,29,20-24,1909,12.35473626937583
STAT,1857,47,25-29,1904,0.04519120248264645
SIM,1861,16,na,1877,2396
SIM,1832,38,30-34,1870,8
STAT,1851,38,40-44,1889,3.3154807204268977
STAT,1901,36,40-44,1937,1.3442053077290466
SIM,1850,26,30-34,1876,6
SIM,1847,30,45-49,1877,2
STAT,1840,20,40-44,1860,1.8845719608709732
SIM,1854,44,45-49,1898,2
STAT,1929,41,45-49,1970,0.21816184362771904
SIM,1831,27,25-29,1858,40
SIM,1852,24,40-44,1876,4
STAT,1871,16,15-19,1887,6.02884054117413
SIM,1910,45,na,1955,3201
STAT,1848,17,35-39,1865,0.5553601311550863
STAT,1904,26,15-19,1930,0.6598617198709864
STAT,1907,26,na,1933,3551.9052865145104
STAT,1856,71,na,1927,1033.5978612883785
STAT,1917,9,na,1926,4309.91478107821
STAT,1926,18,15-19,1944,56.08819235704955
SIM,1896,30,40-44,1926,9
STAT,1824,80,na,1904,307.53565166888984
SIM,1923,29,45-49,1952,5
STAT,1890,8,na,1898,3208.2581382145067
STAT,1903,49,20-24,1952,0.009533325629638573
STAT,1819,54,50-100,1873,0.02717205158862499
STAT,1879,46,15-19,1925,4.2279657381391833E-4
STAT,1906,41,na,1947,3427.252832025929
STAT,1841,15,25-29,1856,5.5304276073139
STAT,1887,73,na,1960,1500.660416961169
STAT,1846,37,20-24,1883,0.6108892586360815
SIM,1886,33,35-39,1919,17
STAT,1797,86,na,1883,74.14076215083215
SIM,1882,63,na,1945,1460
STAT,1863,18,50-100,1881,0.04525753678761932
SIM,1830,65,na,1895,885
SIM,1819,42,35-39,1861,4
STAT,1905,42,50-100,1947,0.10698400180294258
STAT,1849,78,na,1927,610.8872364147367
SIM,1860,31,na,1891,2152
SIM,1922,23,20-24,1945,182
SIM,1939,21,25-29,1960,96
SIM,1823,36,30-34,1859,8
STAT,1918,16,15-19,1934,10.029927580809641
STAT,1861,27,45-49,1888,0.9386254633159316
STAT,1878,33,35-39,1911,10.572963694107546
STAT,1868,29,20-24,1897,11.243326231350832
STAT,1890,18,25-29,1908,6.975330901943472
SIM,1837,41,40-44,1878,4
SIM,1897,36,30-34,1933,8
STAT,1872,16,15-19,1888,6.081710071142621
SIM,1880,16,15-19,1896,7
SIM,1944,15,20-24,1959,157
SIM,1885,81,na,1966,755
STAT,1950,21,50-100,1971,0.7889045453224871
STAT,1883,27,30-34,1910,24.889067843003485
STAT,1838,28,30-34,1866,21.28947892947103
STAT,1850,24,15-19,1874,2.9885849654892302
STAT,1936,15,20-24,1951,131.6502640895814
STAT,1836,22,40-44,1858,1.7348908954632893
STAT,1892,49,35-39,1941,0.09799729633554412
SIM,1853,31,50-100,1884,1
STAT,1852,15,35-39,1867,0.5092831278874359
SIM,1940,11,na,1951,4208
STAT,1914,23,20-24,1937,114.26435252203629
SIM,1838,29,35-39,1867,8
SIM,1843,83,na,1926,470
SIM,1926,34,45-49,1960,5
SIM,1918,25,20-24,1943,22
STAT,1917,21,30-34,1938,30.92651093556338
STAT,1913,38,25-29,1951,0.9755184661516317
STAT,1816,61,na,1877,1159.548318951968
SIM,1845,32,35-39,1877,13
SIM,1854,37,20-24,1891,3
STAT,1893,16,35-39,1909,0.7054156326929063
STAT,1854,0,na,1854,3020.936971448639
STAT,1945,21,na,1966,4043.2701882543747
STAT,1849,42,20-24,1891,0.12401555684449814
SIM,1856,7,na,1863,2611
STAT,1842,33,20-24,1875,2.9095494108354685
SIM,1901,19,15-19,1920,6
SIM,1929,32,20-24,1961,4
STAT,1934,35,40-44,1969,2.0909569604853
SIM,1878,42,40-44,1920,8
STAT,1843,39,45-49,1882,1.399009652728358
SIM,1834,25,35-39,1859,8
SIM,1899,20,15-19,1919,7
STAT,1842,26,30-34,1868,28.240255242086704
SIM,1874,34,na,1908,2299
SIM,1850,33,20-24,1883,2
SIM,1888,31,45-49,1919,2
SIM,1921,38,25-29,1959,2
STAT,1866,26,na,1892,2239.613746756674
STAT,1837,32,35-39,1869,8.662230643250039
STAT,1923,28,40-44,1951,5.387953668361992
STAT,1867,8,na,1875,2624.1271167618265
STAT,1864,18,30-34,1882,1.4938647693481588
STAT,1782,87,na,1869,57.09796031508557
SIM,1937,23,15-19,1960,4
STAT,1865,39,30-34,1904,4.865765446426016
SIM,1872,25,20-24,1897,13
STAT,1897,27,25-29,1924,57.278611210858394
STAT,1849,35,30-34,1884,4.353363493934804
STAT,1823,34,15-19,1857,0.29236666009380197
STAT,1948,22,20-24,1970,128.9732064709539
SIM,1896,22,na,1918,3107
STAT,1918,34,45-49,1952,1.673692884659313
SIM,1816,44,25-29,1860,2
STAT,1885,25,40-44,1910,3.031984764129957
STAT,1854,28,15-19,1882,0.35438963250900934
SIM,1874,26,35-39,1900,10
SIM,1846,49,na,1895,1534
SIM,1925,21,30-34,1946,45
SIM,1867,24,35-39,1891,4
SIM,1873,39,30-34,1912,12
STAT,1859,31,25-29,1890,8.354434431610644
STAT,1852,22,25-29,1874,51.574526323117624
STAT,1875,35,25-29,1910,3.014715421726341
STAT,1879,44,na,1923,2403.1642474213877
STAT,1940,20,45-49,1960,1.1579564386385075
STAT,1894,11,na,1905,3363.1390283680403
STAT,1903,16,20-24,1919,25.563585463530156
SIM,1858,82,na,1940,246
STAT,1907,31,15-19,1938,0.12177991529303
SIM,1860,22,25-29,1882,61
SIM,1911,16,20-24,1927,31
STAT,1869,21,40-44,1890,2.052391477778933
STAT,1839,45,15-19,1884,2.9643974069952885E-4
STAT,1833,24,30-34,1857,16.759591492148676
STAT,1845,26,15-19,1871,0.406429994527393
STAT,1911,25,45-49,1936,1.7112845269077976
SIM,1841,24,30-34,1865,18
SIM,1927,22,na,1949,4925
STAT,1850,50,30-34,1900,0.0046234490340204765
SIM,1838,36,25-29,1874,4
STAT,1903,23,na,1926,3391.4053546261166
SIM,1826,34,40-44,1860,6
STAT,1848,93,na,1941,23.86131956535731
STAT,1890,25,15-19,1915,0.5637407322408691
STAT,1933,17,45-49,1950,0.6757390667932853
SIM,1870,31,na,1901,2647
STAT,1942,26,35-39,1968,15.916958223455262
STAT,1841,72,na,1913,944.4111767308626
STAT,1868,39,15-19,1907,0.053659931839538724
SIM,1851,39,45-49,1890,1
STAT,1860,16,45-49,1876,0.0625694102954205
STAT,1810,69,na,1879,860.4150957407693
STAT,1841,35,20-24,1876,0.6934259805927959
STAT,1925,45,na,1970,4520.180297084619
SIM,1889,29,35-39,1918,13
SIM,1901,63,na,1964,2688
SIM,1859,67,na,1926,1544
SIM,1867,86,na,1953,177
STAT,1815,43,25-29,1858,1.5827277934321704
STAT,1910,48,15-19,1958,3.4578799074440965E-4
STAT,1849,39,40-44,1888,3.4302058434304064
SIM,1954,17,15-19,1971,62
STAT,1861,34,35-39,1895,8.426676292246656
SIM,1863,72,na,1935,1015
STAT,1847,14,na,1861,2210.6571944289144
STAT,1877,41,35-39,1918,1.896175609439266
STAT,1855,45,20-24,1900,0.009122702115710818
SIM,1892,7,na,1899,3584
STAT,1814,59,na,1873,1159.7243067171385
STAT,1865,27,50-100,1892,0.5899601451626539
STAT,1886,47,45-49,1933,0.25049545532022666
SIM,1813,41,45-49,1854,1
STAT,1864,35,15-19,1899,0.0516645962840276
STAT,1921,31,na,1952,4268.212123776985
SIM,1866,24,35-39,1890,7
STAT,1835,24,40-44,1859,2.050028405239341
SIM,1843,24,40-44,1867,3
SIM,1907,22,25-29,1929,101
SIM,1892,61,na,1953,2492
STAT,1872,32,45-49,1904,1.7707134764783021
STAT,1890,44,50-100,1934,1.2862322589918231
STAT,1832,40,20-24,1872,0.13616004858003036
STAT,1845,26,20-24,1871,10.509118345660314
SIM,1880,32,45-49,1912,3
STAT,1946,17,15-19,1963,50.83986560939126
SIM,1848,44,40-44,1892,3
SIM,1857,39,40-44,1896,4
STAT,1885,18,45-49,1903,0.06549912002340151
SIM,1862,19,25-29,1881,13
STAT,1856,50,na,1906,1691.2571097688465
STAT,1798,71,na,1869,719.976662020615
SIM,1885,41,35-39,1926,5
STAT,1853,20,50-100,1873,0.40423913772658326
STAT,1839,70,na,1909,994.7415469910567
STAT,1882,34,25-29,1916,9.935032699147904
SIM,1839,35,30-34,1874,5
STAT,1936,31,40-44,1967,3.839667568597988
STAT,1877,52,45-49,1929,0.015047544278763241
STAT,1850,44,30-34,1894,0.8684342246207065
STAT,1945,24,45-49,1969,1.2445331188165492
STAT,1882,23,15-19,1905,3.2176188707789937
STAT,1884,31,25-29,1915,10.243272844944734
SIM,1848,33,30-34,1881,17
SIM,1892,26,50-100,1918,1
SIM,1922,33,na,1955,4797
SIM,1818,101,na,1919,2
STAT,1946,15,na,1961,4125.492553767696
SIM,1933,29,50-100,1962,1
STAT,1892,41,30-34,1933,1.4636584682978082
STAT,1872,13,na,1885,2660.4207910927503
STAT,1896,49,25-29,1945,0.042531213760190804
SIM,1909,30,35-39,1939,9
STAT,1912,27,50-100,1939,0.9896027795487892
STAT,1861,42,40-44,1903,1.8854483337179442
STAT,1824,38,25-29,1862,3.8866087110539964
STAT,1875,44,35-39,1919,1.8528554395097547
SIM,1890,34,25-29,1924,3
STAT,1858,24,35-39,1882,4.758777976753369
SIM,1832,38,25-29,1870,2
STAT,1856,16,25-29,1872,5.219276809015297
STAT,1817,40,25-29,1857,1.7161790594313935
STAT,1826,46,35-39,1872,0.13984639908041582
STAT,1926,15,50-100,1941,0.4664017321100463
STAT,1836,53,40-44,1889,0.0065879969709311806
STAT,1810,45,na,1855,1560.3039927556458
STAT,1852,41,30-34,1893,0.8758442665087428
STAT,1823,95,na,1918,7.353276336422035
SIM,1888,56,na,1944,2620
STAT,1833,27,40-44,1860,2.8035705406388676
SIM,1854,36,na,1890,2173
SIM,1857,37,45-49,1894,3
STAT,1866,35,25-29,1901,2.7182920602159975
SIM,1821,41,na,1862,1395
SIM,1864,16,25-29,1880,7
SIM,1883,44,35-39,1927,4
STAT,1808,53,35-39,1861,0.02855077885987129
SIM,1841,27,40-44,1868,5
SIM,1874,35,25-29,1909,3
SIM,1891,32,20-24,1923,4
STAT,1893,37,35-39,1930,9.070607860706811
SIM,1815,39,50-100,1854,1
STAT,1820,41,40-44,1861,4.393551625464039
STAT,1851,23,40-44,1874,1.8707134207518727
STAT,1874,28,40-44,1902,3.087076115308627
STAT,1893,40,35-39,1933,2.3456951691484766
SIM,1890,23,15-19,1913,4
SIM,1836,29,25-29,1865,42
STAT,1844,57,na,1901,1589.9882930262422
STAT,1832,48,30-34,1880,0.07716527974923286
STAT,1879,37,30-34,1916,5.617374039595805
STAT,1831,28,15-19,1859,0.3880362890595194
STAT,1880,39,20-24,1919,0.8094182480737087
STAT,1869,47,15-19,1916,3.9095189045600034E-4
STAT,1838,45,15-19,1883,2.8263093395190385E-4
SIM,1855,29,35-39,1884,10
STAT,1843,30,25-29,1873,8.479390582453929
STAT,1889,77,na,1966,1443.0141351736972
SIM,1806,52,na,1858,1348
STAT,1883,32,20-24,1915,2.6716257768835137
SIM,1855,23,20-24,1878,5
STAT,1834,26,45-49,1860,0.8733527360215042
STAT,1841,33,25-29,1874,9.197342650830599
STAT,1871,79,na,1950,701.4991333179896
SIM,1935,20,35-39,1955,23
STAT,1833,47,35-39,1880,0.11645153496676132
SIM,1943,19,na,1962,4176
SIM,1869,77,na,1946,913
STAT,1919,34,45-49,1953,1.6994589434185563
STAT,1931,39,45-49,1970,0.9105194677204
SIM,1838,26,25-29,1864,52
STAT,1849,54,35-39,1903,0.006545919287373482
SIM,1921,22,50-100,1943,3
STAT,1927,36,na,1963,4732.11308239259
STAT,1853,20,40-44,1873,2.0656618434981042
STAT,1864,38,25-29,1902,2.6110480274537484
STAT,1847,29,35-39,1876,8.559244986370581
STAT,1889,21,na,1910,2954.3102751323336
STAT,1831,31,15-19,1862,0.11928675802992457
STAT,1813,48,20-24,1861,0.034285664361050544
STAT,1841,22,15-19,1863,3.1252714564977895
STAT,1899,25,35-39,1924,13.46561966910215
STAT,1877,44,na,1921,2376.7693275919373
STAT,1904,20,40-44,1924,3.0383326142244824
SIM,1872,26,30-34,1898,37
SIM,1908,31,30-34,1939,18
STAT,1896,18,20-24,1914,23.63955118820305
STAT,1897,72,na,1969,2090.413967207935
STAT,1881,89,na,1970,302.29939236028514
STAT,1864,26,30-34,1890,23.02922040082864
SIM,1882,28,40-44,1910,3
STAT,1845,46,45-49,1891,0.17293150104821417
SIM,1811,44,45-49,1855,5
STAT,1870,35,45-49,1905,1.9958935926658516
STAT,1882,36,20-24,1918,0.7577879373671763
STAT,1836,23,45-49,1859,0.5763919549638876
STAT,1887,43,15-19,1930,0.01546010541513792
STAT,1898,26,30-34,1924,34.59760172148945
STAT,1828,29,25-29,1857,58.738983744983884
STAT,1866,51,30-34,1917,0.005593654239524928
STAT,1823,104,na,1927,0.03688935493760079
SIM,1853,26,20-24,1879,13
STAT,1881,35,20-24,1916,0.7575991714339192
STAT,1821,40,45-49,1861,2.5284750728433893
SIM,1912,20,40-44,1932,6
STAT,1920,49,40-44,1969,0.17496444671073594
STAT,1847,23,20-24,1870,62.799144294807874
STAT,1880,26,15-19,1906,0.4828985596676928
STAT,1815,45,20-24,1860,0.027533618096890852
STAT,1829,27,20-24,1856,15.52435925775514
STAT,1871,33,40-44,1904,4.333202710806922
SIM,1837,27,20-24,1864,14
SIM,1851,30,25-29,1881,16
SIM,1889,34,30-34,1923,38
STAT,1909,47,50-100,1956,0.2097258720689727
SIM,1873,82,na,1955,369
SIM,1929,23,15-19,1952,7
STAT,1897,17,25-29,1914,7.673083525698157
SIM,1905,53,na,1958,3285
STAT,1868,44,50-100,1912,1.0060182037030274
STAT,1879,15,50-100,1894,0.051877346515997
STAT,1931,41,na,1972,5021.5897732993235
STAT,1889,40,15-19,1929,0.0173722225058175
STAT,1865,39,25-29,1904,2.6286318934098305
STAT,1934,29,50-100,1963,1.3516139427358367
STAT,1884,14,na,1898,2563.8391016388714
SIM,1858,38,45-49,1896,5
SIM,1855,61,na,1916,1612
SIM,1890,36,20-24,1926,1
STAT,1920,38,30-34,1958,2.0130955032716322
STAT,1874,25,30-34,1899,26.219541926540206
STAT,1857,25,30-34,1882,20.742070380092006
SIM,1867,94,na,1961,28
STAT,1878,17,15-19,1895,6.222108080367287
SIM,1785,73,na,1858,396
STAT,1899,42,25-29,1941,0.061736155482199226
STAT,1891,45,30-34,1936,0.06896091179159794
STAT,1847,53,50-100,1900,0.011126425905836424
SIM,1912,47,na,1959,3381
STAT,1772,86,na,1858,48.47486464158998
STAT,1839,48,40-44,1887,0.12209232948430719
SIM,1850,31,20-24,1881,2
STAT,1903,49,40-44,1952,0.1360087736972291
SIM,1877,27,20-24,1904,16
SIM,1812,42,40-44,1854,6
STAT,1867,47,35-39,1914,0.13255021914324838
STAT,1814,44,20-24,1858,0.40354258470941545
STAT,1839,49,25-29,1888,0.040554872475676115
SIM,1830,85,na,1915,138
SIM,1926,15,na,1941,4838
STAT,1874,45,30-34,1919,0.10110760189619764
STAT,1878,50,40-44,1928,0.011196381670188393
STAT,1917,31,30-34,1948,16.72108054389218
STAT,1809,54,35-39,1863,0.026515768138816637
STAT,1843,49,45-49,1892,0.15585095857701298
STAT,1851,52,25-29,1903,0.002667691425810201
STAT,1827,77,na,1904,514.0183215346876
SIM,1789,87,na,1876,51
SIM,1888,48,na,1936,2861
STAT,1867,50,35-39,1917,0.008306807024314815
STAT,1814,45,50-100,1859,0.612607367171032
STAT,1825,33,40-44,1858,9.163278599359568
STAT,1886,18,50-100,1904,0.05210771565384499
STAT,1828,33,50-100,1861,1.035530456390297
STAT,1862,41,45-49,1903,1.3113065752823707
STAT,1871,36,45-49,1907,2.0099404345557397
STAT,1834,43,35-39,1877,1.2835349414438921
SIM,1949,15,40-44,1964,2
SIM,1848,47,50-100,1895,2
SIM,1933,17,na,1950,4690
STAT,1825,51,50-100,1876,0.019935132252723677
SIM,1888,17,25-29,1905,8
SIM,1909,35,na,1944,3932
SIM,1833,33,40-44,1866,4
STAT,1834,28,40-44,1862,2.322542095133357
STAT,1876,45,35-39,1921,0.14745354966781887
SIM,1842,26,45-49,1868,4
STAT,1873,19,35-39,1892,0.5588155712208771
SIM,1922,25,na,1947,4697
SIM,1865,25,30-34,1890,28
SIM,1934,21,30-34,1955,2
STAT,1845,46,15-19,1891,2.9310399236390005E-4
STAT,1935,31,na,1966,5289.584770988428
STAT,1865,36,20-24,1901,0.7143417101773483
SIM,1913,40,na,1953,3678
STAT,1807,54,30-34,1861,0.01939906316602404
STAT,1876,25,40-44,1901,3.1450962534677642
SIM,1843,44,35-39,1887,3
STAT,1849,37,45-49,1886,1.5948736439342177
STAT,1905,49,45-49,1954,0.19031502634126904
STAT,1890,28,25-29,1918,52.022988846505754
SIM,1811,46,50-100,1857,4
SIM,1810,97,na,1907,2
SIM,1856,38,40-44,1894,5
STAT,1868,31,40-44,1899,4.2033002869461935
STAT,1860,18,40-44,1878,0.17313667936037247
SIM,1883,24,40-44,1907,5
STAT,1884,19,40-44,1903,0.18119358882411163
STAT,1927,20,35-39,1947,11.795530623797394
STAT,1938,0,na,1938,4486.428503617666
STAT,1881,57,na,1938,1956.5073225059955
SIM,1821,49,na,1870,1278
STAT,1850,28,50-100,1878,0.5722830588535668
SIM,1892,53,na,1945,2859
SIM,1831,37,25-29,1868,3
SIM,1884,25,40-44,1909,9
STAT,1809,80,na,1889,308.53503078261275
STAT,1886,27,20-24,1913,12.510337536038744
STAT,1928,21,35-39,1949,11.918644347390961
SIM,1833,22,30-34,1855,19
SIM,1927,34,45-49,1961,1
STAT,1851,43,35-39,1894,1.3612213819142973
SIM,1894,27,20-24,1921,21
STAT,1938,23,15-19,1961,5.316837418144726
STAT,1926,21,30-34,1947,35.39608761890051
STAT,1823,37,25-29,1860,5.013464367115832
STAT,1903,38,30-34,1941,1.6464608148666864
SIM,1936,21,35-39,1957,10
STAT,1881,22,15-19,1903,3.2118158362438667
STAT,1897,24,50-100,1921,0.5487154982128171
SIM,1876,79,na,1955,645
STAT,1819,36,20-24,1855,2.493988127117069
SIM,1911,38,30-34,1949,4
STAT,1869,30,50-100,1899,0.906947137249352
STAT,1800,59,na,1859,876.7377797361298
STAT,1881,19,15-19,1900,5.746689158220852
STAT,1877,24,45-49,1901,0.7223537210285368
STAT,1885,46,45-49,1931,0.23793332748298507
STAT,1886,47,15-19,1933,4.245682109872E-4
SIM,1842,28,40-44,1870,3
STAT,1850,28,25-29,1878,37.84379329586491
STAT,1844,17,45-49,1861,0.06569685513790578
SIM,1858,26,na,1884,2002
STAT,1835,44,35-39,1879,1.5879056917150625
SIM,1862,31,na,1893,2184
SIM,1868,30,50-100,1898,5
SIM,1878,28,20-24,1906,6
STAT,1846,100,na,1946,0.805666371269144
STAT,1855,42,50-100,1897,0.7942343180782026
STAT,1861,17,45-49,1878,0.0630137094060502
STAT,1830,35,45-49,1865,1.8636402096128775
STAT,1880,26,45-49,1906,1.181751767773331
STAT,1826,52,na,1878,1297.340851795385
STAT,1883,15,30-34,1898,1.5826541048871003
SIM,1854,44,na,1898,2111
STAT,1882,30,50-100,1912,0.9036120508985952
SIM,1872,33,na,1905,2618
STAT,1847,51,20-24,1898,5.551511068021379E-4
STAT,1858,24,50-100,1882,0.332549163783127
STAT,1879,50,50-100,1929,0.016147047896800756
SIM,1829,69,na,1898,961
STAT,1825,53,35-39,1878,0.01092091058874972
STAT,1782,110,na,1892,8.028467031729302E-4
STAT,1851,59,na,1910,1471.567330636499
SIM,1809,49,na,1858,1226
STAT,1841,54,50-100,1895,0.010983476638245076
STAT,1943,21,30-34,1964,30.88612035049647
SIM,1879,27,25-29,1906,81
STAT,1923,33,50-100,1956,0.9570912633225919
STAT,1856,46,20-24,1902,0.009318537608627084
SIM,1841,44,30-34,1885,1
STAT,1891,29,25-29,1920,52.51893943675581
STAT,1848,50,25-29,1898,0.002933464254474735
STAT,1944,20,35-39,1964,10.273218273534424
SIM,1869,38,50-100,1907,1
SIM,1880,84,na,1964,476
STAT,1840,67,na,1907,1111.2181329530422
STAT,1937,21,50-100,1958,0.6470876676733779
STAT,1885,31,na,1916,2408.852553586366
STAT,1850,27,40-44,1877,2.699279009541634
STAT,1856,44,25-29,1900,0.49053992928325163
STAT,1872,29,15-19,1901,0.4574063329729539
SIM,1842,43,35-39,1885,2
SIM,1898,38,45-49,1936,1
STAT,1901,11,na,1912,3661.921018344322
SIM,1867,62,na,1929,1630
STAT,1871,19,25-29,1890,5.6556389437462835
STAT,1892,44,35-39,1936,0.15721747639675787
STAT,1854,19,25-29,1873,5.027614983559857
STAT,1950,20,na,1970,4379.903281081591
STAT,1838,36,30-34,1874,4.349984728809072
STAT,1870,52,35-39,1922,0.00849290958782582
STAT,1909,21,25-29,1930,86.89182339549836
STAT,1840,37,25-29,1877,2.387133436997518
STAT,1905,25,na,1930,3508.19483145885
SIM,1870,41,45-49,1911,1
STAT,1889,39,40-44,1928,5.396847481516107
STAT,1900,20,50-100,1920,0.5755481724564845
STAT,1830,65,na,1895,1114.93556473021
STAT,1879,49,25-29,1928,0.05944280266079755
STAT,1843,18,40-44,1861,0.15671988196783
SIM,1884,66,na,1950,1735
STAT,1872,32,15-19,1904,0.14460372644798095
STAT,1896,23,na,1919,3152.113404097363
SIM,1813,54,na,1867,1168
SIM,1913,1,na,1914,4237
SIM,1864,44,25-29,1908,4
STAT,1895,37,15-19,1932,0.07406581028529544
SIM,1870,30,35-39,1900,5
STAT,1918,1,na,1919,4588.930051614642
SIM,1846,36,30-34,1882,11
STAT,1866,34,40-44,1900,4.0211140557281295
STAT,1824,54,30-34,1878,0.006452881496880752
STAT,1897,64,na,1961,2499.8379122609394
SIM,1899,39,45-49,1938,2
SIM,1874,34,40-44,1908,3
STAT,1828,46,15-19,1874,3.692981621599356E-4
SIM,1937,17,15-19,1954,39
STAT,1902,42,50-100,1944,0.1045780068873938
STAT,1805,98,na,1903,1.2895930104012663
STAT,1832,43,25-29,1875,0.5296509281622303
STAT,1855,48,25-29,1903,0.042811941522941016
SIM,1863,36,30-34,1899,5
STAT,1883,80,na,1963,857.3527625423916
STAT,1916,22,25-29,1938,97.67796506659366
STAT,1940,29,45-49,1969,1.7767639237190684
SIM,1847,16,25-29,1863,10
SIM,1939,25,25-29,1964,83
STAT,1771,109,na,1880,0.002505580120399589
STAT,1882,31,20-24,1913,2.655338170832818
STAT,1848,109,na,1957,8.004106136053103E-4
STAT,1894,41,35-39,1935,2.3653195043946322
STAT,1813,105,na,1918,0.01285590874287928
STAT,1940,31,50-100,1971,0.8643743289913889
SIM,1912,55,na,1967,3278
SIM,1930,12,na,1942,5516
STAT,1857,33,30-34,1890,13.704445393172279
SIM,1847,36,50-100,1883,1
SIM,1881,16,25-29,1897,5
SIM,1945,10,na,1955,4209
STAT,1918,43,na,1961,3980.212246101569
STAT,1939,13,na,1952,3989.061460092642
STAT,1846,42,45-49,1888,1.149527425355173
STAT,1884,47,50-100,1931,0.24347595815671735
STAT,1961,2,na,1963,5134.5269343850105
STAT,1834,40,25-29,1874,0.4730068883087832
STAT,1762,112,na,1874,5.065216252250531E-4
STAT,1897,32,na,1929,3231.205480590785
STAT,1862,11,na,1873,2395.617606873145
STAT,1839,16,25-29,1855,5.286686379526255
STAT,1839,78,na,1917,553.9436909282454
STAT,1883,18,40-44,1901,0.1803025062673163
SIM,1856,70,na,1926,1134
STAT,1835,52,40-44,1887,0.008055661229917894
STAT,1794,65,na,1859,818.2954282845918
STAT,1918,49,30-34,1967,0.09521162321503196
SIM,1834,30,25-29,1864,10
SIM,1890,31,20-24,1921,4
STAT,1898,43,20-24,1941,0.014990969429041446
SIM,1862,16,20-24,1878,13
STAT,1849,51,30-34,1900,0.004676285754017743
STAT,1818,65,na,1883,947.6398574310605
STAT,1858,41,25-29,1899,0.5111389827797068
STAT,1890,49,30-34,1939,0.06598217121563127
SIM,1873,34,25-29,1907,3
SIM,1843,27,45-49,1870,1
SIM,1843,84,na,1927,384
STAT,1775,106,na,1881,0.009424483499963837
STAT,1878,29,50-100,1907,0.6658950010258409
STAT,1833,44,30-34,1877,0.9641959032258552
STAT,1827,50,35-39,1877,0.008870429209120739
STAT,1830,97,na,1927,3.544282155348028
STAT,1858,5,na,1863,2327.4998142310874
STAT,1888,44,15-19,1932,0.016240641503110397
STAT,1863,52,na,1915,1916.5901353464424
STAT,1855,36,30-34,1891,4.030992740301465
STAT,1919,31,40-44,1950,4.280307390109343
STAT,1874,29,25-29,1903,43.43501626785467
SIM,1895,58,na,1953,2656
STAT,1788,93,na,1881,6.499700115809593
STAT,1815,40,20-24,1855,0.4412392521296732
SIM,1854,42,45-49,1896,2
SIM,1947,3,na,1950,4906
STAT,1860,30,25-29,1890,8.524541230450833
STAT,1822,38,20-24,1860,1.3744315574094896
SIM,1870,26,20-24,1896,11
SIM,1842,40,25-29,1882,2
STAT,1778,104,na,1882,0.03621159323061309
STAT,1862,43,40-44,1905,1.9476919868105276
STAT,1830,48,50-100,1878,0.2027830758632363
STAT,1862,26,20-24,1888,10.344404285325783
STAT,1834,47,na,1881,1420.200355212529
STAT,1854,16,20-24,1870,16.010284300391664
SIM,1870,43,40-44,1913,1
STAT,1882,39,30-34,1921,5.161701058229163
STAT,1835,27,45-49,1862,1.0865072402159588
SIM,1890,39,30-34,1929,1
STAT,1904,23,45-49,1927,1.007587903145434
STAT,1869,27,15-19,1896,0.44551706078017755
STAT,1860,87,na,1947,145.45953395084527
SIM,1886,29,50-100,1915,1
STAT,1847,35,15-19,1882,0.04453898044534839
SIM,1817,44,na,1861,1599
SIM,1882,29,25-29,1911,53
STAT,1848,38,40-44,1886,3.645081232603112
STAT,1868,51,35-39,1919,0.00835000762841516
STAT,1826,30,25-29,1856,16.376113265364417
SIM,1898,26,na,1924,3233
STAT,1876,33,50-100,1909,0.9514679975255047
STAT,1891,28,40-44,1919,3.73270180300446
SIM,1830,29,30-34,1859,36
SIM,1881,19,35-39,1900,1
SIM,1872,23,20-24,1895,69
STAT,1834,23,40-44,1857,1.6480263760367289
STAT,1845,98,na,1943,2.3736637091318986
SIM,1810,65,na,1875,988
STAT,1826,60,na,1886,1107.2962998259707
SIM,1864,46,na,1910,2481
SIM,1906,9,na,1915,3728
STAT,1841,18,30-34,1859,1.5282076973883203
SIM,1832,37,40-44,1869,7
SIM,1872,41,na,1913,2526
STAT,1891,24,25-29,1915,71.13625813549599
STAT,1836,20,40-44,1856,2.0130911484961476
STAT,1931,36,40-44,1967,2.0055027194555435
SIM,1883,27,45-49,1910,1
STAT,1871,31,45-49,1902,1.7569441657619493
SIM,1814,79,na,1893,264
STAT,1824,37,40-44,1861,6.105053143070442
STAT,1875,41,30-34,1916,1.1978515756872863
STAT,1881,38,25-29,1919,2.789183604937645
SIM,1836,26,20-24,1862,5
SIM,1843,52,na,1895,1996
STAT,1838,48,25-29,1886,0.03916430000261752
STAT,1849,24,50-100,1873,0.37996201369764654
STAT,1820,44,45-49,1864,2.6347497215383022
STAT,1833,54,na,1887,1508.7997259449337
SIM,1832,33,na,1865,1686
STAT,1861,45,45-49,1906,0.20004478166329936
SIM,1876,23,na,1899,2648
STAT,1847,26,25-29,1873,38.34420826144189
STAT,1864,23,20-24,1887,63.357736588798936
STAT,1883,51,30-34,1934,0.005911478778949482
STAT,1808,50,30-34,1858,0.02099842187384374
STAT,1875,27,45-49,1902,1.151625813501568
STAT,1815,48,25-29,1863,0.1256880616718559
STAT,1800,67,na,1867,662.0870415400818
STAT,1830,30,45-49,1860,1.7282500119804458
STAT,1842,31,20-24,1873,2.970605122664747
STAT,1852,44,35-39,1896,1.3547695276295315
SIM,1831,25,30-34,1856,27
SIM,1877,64,na,1941,1761
SIM,1840,95,na,1935,6
STAT,1892,9,na,1901,3288.3839850436957
STAT,1844,45,45-49,1889,0.1896640253245696
STAT,1876,28,45-49,1904,1.1537960661556514
SIM,1842,43,na,1885,1708
STAT,1836,36,20-24,1872,0.6031183476040475
SIM,1875,35,50-100,1910,1
STAT,1841,30,20-24,1871,2.5040110296573106
STAT,1814,47,25-29,1861,0.13892776462434234
STAT,1895,17,20-24,1912,23.383283606181735
SIM,1847,74,na,1921,724
STAT,1893,21,25-29,1914,73.63579049764276
SIM,1871,39,20-24,1910,4
SIM,1924,22,25-29,1946,132
STAT,1904,38,50-100,1942,0.38218724614219984
STAT,1861,31,30-34,1892,14.713477519236976
STAT,1888,36,15-19,1924,0.06726470702163187
STAT,1859,28,45-49,1887,0.9109193783906393
STAT,1886,80,na,1966,990.4401176488433
SIM,1855,26,25-29,1881,46
SIM,1926,30,35-39,1956,3
STAT,1832,32,15-19,1864,0.12675411379436388
STAT,1945,21,40-44,1966,3.72280204950268
STAT,1925,39,20-24,1964,0.3190672626058686
STAT,1828,26,20-24,1854,30.490343538799873
SIM,1809,57,na,1866,1049
SIM,1824,38,na,1862,1547
STAT,1846,72,na,1918,958.3918524381012
SIM,1868,41,35-39,1909,3
STAT,1810,51,25-29,1861,0.013243638623138652
STAT,1824,33,25-29,1857,17.670465588197327
STAT,1914,39,45-49,1953,0.6798326663588697
STAT,1860,18,50-100,1878,0.04637588497978453
STAT,1905,33,na,1938,3499.0539607300143
STAT,1921,46,25-29,1967,0.0605457625712987
SIM,1779,77,na,1856,342
SIM,1871,35,50-100,1906,1
STAT,1890,16,30-34,1906,1.9719224444659795
SIM,1849,24,35-39,1873,8
SIM,1918,20,35-39,1938,12
SIM,1832,33,25-29,1865,10
SIM,1842,23,40-44,1865,1
STAT,1936,34,45-49,1970,1.5410701514216887
STAT,1863,39,20-24,1902,0.6828820018677023
STAT,1902,68,na,1970,2541.4363600882953
STAT,1808,55,na,1863,1110.8034603586648
STAT,1826,49,45-49,1875,0.22631128175373777
STAT,1918,30,35-39,1948,9.882536797387914
STAT,1900,41,35-39,1941,0.17722219224517555
SIM,1862,16,15-19,1878,5
SIM,1896,43,na,1939,3066
STAT,1847,46,na,1893,1689.321814576293
SIM,1884,28,45-49,1912,2
STAT,1843,51,30-34,1894,0.004034012211402143
STAT,1892,25,25-29,1917,53.975661439732924
STAT,1860,105,na,1965,0.14187658072730358
STAT,1905,46,40-44,1951,0.14140340642593927
SIM,1917,24,35-39,1941,10
STAT,1838,85,na,1923,183.51284596262582
SIM,1858,44,30-34,1902,1
STAT,1876,53,40-44,1929,0.010802410415103039
SIM,1792,75,na,1867,289
STAT,1854,24,na,1878,1858.414080373934
STAT,1937,30,45-49,1967,1.57345554629786
SIM,1930,20,na,1950,5042
SIM,1833,34,25-29,1867,16
SIM,1874,30,25-29,1904,14
STAT,1843,32,na,1875,1757.294642006053
STAT,1809,51,30-34,1860,0.0195233543321745
STAT,1858,38,na,1896,1857.585148704779
STAT,1913,20,na,1933,3753.2957777406564
STAT,1892,15,50-100,1907,0.06237977263174742
STAT,1909,4,na,1913,3981.0425072225275
SIM,1838,39,30-34,1877,12
STAT,1886,42,45-49,1928,1.5940416636496524
STAT,1854,16,15-19,1870,5.359374836297881
STAT,1819,40,35-39,1859,4.150556041797884
STAT,1847,22,na,1869,1962.5417190137634
STAT,1819,51,45-49,1870,0.027719012638676044
SIM,1839,43,30-34,1882,4
SIM,1885,51,na,1936,2313
STAT,1821,42,40-44,1863,3.586291706240094
STAT,1850,23,25-29,1873,52.23382276955118
SIM,1844,20,40-44,1864,2
STAT,1855,17,20-24,1872,15.872112369351019
SIM,1817,37,45-49,1854,2
SIM,1853,30,35-39,1883,19
STAT,1825,34,25-29,1859,19.59194155452459
STAT,1913,38,50-100,1951,0.41597906074118185
STAT,1853,40,35-39,1893,1.5126108187245413
STAT,1898,34,30-34,1932,23.701324537679916
STAT,1912,27,na,1939,3724.5205150067536
STAT,1816,82,na,1898,238.55101641085773
STAT,1853,23,45-49,1876,0.6764660486417634
SIM,1800,87,na,1887,124
SIM,1840,18,35-39,1858,1
STAT,1849,34,40-44,1883,3.4994892827870303
SIM,1890,38,na,1928,3168
STAT,1816,41,20-24,1857,0.4733317858324432
STAT,1871,49,50-100,1920,0.2412954854388276
SIM,1940,19,na,1959,3906
SIM,1920,42,na,1962,4401
SIM,1891,15,30-34,1906,3
STAT,1861,34,50-100,1895,0.7624029182480335
SIM,1853,41,45-49,1894,2
SIM,1884,42,30-34,1926,1
STAT,1864,51,20-24,1915,6.757480663303204E-4
STAT,1932,23,20-24,1955,146.9849732309528
STAT,1890,41,20-24,1931,0.1968876802925436
SIM,1873,38,40-44,1911,12
STAT,1917,34,35-39,1951,9.57646707352091
SIM,1863,17,20-24,1880,22
STAT,1832,24,15-19,1856,3.1299007171115383
STAT,1927,41,40-44,1968,0.3175209294895144
STAT,1849,88,na,1937,107.33557233227525
STAT,1828,26,15-19,1854,1.179184566203887
SIM,1827,40,35-39,1867,5
STAT,1831,43,50-100,1874,0.8062357922147625
SIM,1937,20,45-49,1957,1
STAT,1898,45,40-44,1943,0.13354417428746512
SIM,1848,28,35-39,1876,14
STAT,1831,31,45-49,1862,1.4607000469312101
STAT,1909,24,35-39,1933,8.775599581565434
SIM,1940,23,20-24,1963,136
STAT,1838,33,20-24,1871,2.2252618205797288
STAT,1872,64,na,1936,1765.1654408495783
STAT,1840,34,20-24,1874,2.260432159829795
SIM,1846,33,20-24,1879,3
SIM,1838,23,20-24,1861,56
STAT,1876,42,30-34,1918,1.197447331718221
STAT,1815,48,30-34,1863,0.2112257723454103
STAT,1865,38,40-44,1903,4.017153840566394
STAT,1947,17,30-34,1964,13.86895690293156
STAT,1810,52,50-100,1862,0.055340762191270126
STAT,1823,50,20-24,1873,0.001017292497909368
STAT,1860,53,50-100,1913,0.012269024199271068
SIM,1783,90,na,1873,54
SIM,1857,34,40-44,1891,7
SIM,1875,31,25-29,1906,9
STAT,1897,47,20-24,1944,0.009122892883510992
STAT,1877,54,40-44,1931,0.010672482214672178
STAT,1895,17,15-19,1912,7.827455115579767
STAT,1888,28,na,1916,2834.987825002801
SIM,1864,29,30-34,1893,36
SIM,1885,21,40-44,1906,3
SIM,1776,88,na,1864,13
STAT,1874,40,25-29,1914,0.6708132517569512
SIM,1927,31,40-44,1958,3
SIM,1865,38,50-100,1903,2
STAT,1866,38,35-39,1904,6.582016998097529
STAT,1937,27,15-19,1964,0.6947248027399032
STAT,1892,42,15-19,1934,0.01748074244351776
SIM,1871,48,na,1919,2119
SIM,1894,31,35-39,1925,20
STAT,1842,50,30-34,1892,0.005436302304238503
STAT,1845,30,35-39,1875,8.98291086953724
SIM,1899,36,40-44,1935,3
STAT,1835,41,30-34,1876,1.0476485706248226
SIM,1948,19,40-44,1967,2
STAT,1886,31,35-39,1917,10.843565613548932
STAT,1881,49,na,1930,2144.634064579197
STAT,1866,18,35-39,1884,0.5236255773426455
SIM,1826,45,50-100,1871,3
STAT,1852,36,35-39,1888,5.449445041928948
STAT,1910,28,20-24,1938,17.7213346691914
SIM,1840,24,15-19,1864,3
SIM,1879,24,20-24,1903,92
STAT,1880,64,na,1944,1843.8950165184467
STAT,1851,24,25-29,1875,51.02254335691735
STAT,1929,17,15-19,1946,58.54073303458363
SIM,1909,27,na,1936,3869
SIM,1905,13,na,1918,3881
SIM,1823,83,na,1906,252
STAT,1864,77,na,1941,787.7959164483142
STAT,1943,24,35-39,1967,10.108382061557554
STAT,1846,39,15-19,1885,0.043587212189972614
STAT,1887,29,50-100,1916,0.7161909310887842
STAT,1929,32,50-100,1961,1.0614939766824882
SIM,1865,33,30-34,1898,26
STAT,1805,90,na,1895,31.297815960765803
STAT,1887,43,45-49,1930,1.67548880673302
STAT,1818,40,40-44,1858,4.725209296600245
STAT,1925,21,na,1946,4430.90948567069
STAT,1854,8,na,1862,2204.5846027269044
SIM,1842,40,30-34,1882,4
SIM,1895,43,45-49,1938,3
SIM,1860,36,35-39,1896,12
STAT,1856,49,30-34,1905,0.07339167879895661
STAT,1879,34,20-24,1913,2.8246312360216206
STAT,1867,42,na,1909,2195.7952157745026
STAT,1875,41,25-29,1916,0.6690702522204863
SIM,1843,41,30-34,1884,1
SIM,1829,39,35-39,1868,13
STAT,1846,42,15-19,1888,0.010606943539202584
STAT,1929,35,na,1964,4890.385985653271
SIM,1825,31,na,1856,1514
SIM,1844,69,na,1913,969
SIM,1859,99,na,1958,2
STAT,1847,43,15-19,1890,0.010265237423778962
SIM,1874,38,35-39,1912,11
STAT,1834,40,30-34,1874,0.8468349094750973
STAT,1896,46,20-24,1942,0.00907531263870253
SIM,1937,32,50-100,1969,4
STAT,1856,29,30-34,1885,19.916840799556226
STAT,1874,48,35-39,1922,0.1429672951648935
STAT,1873,16,25-29,1889,5.83659502928151
STAT,1808,50,25-29,1858,0.012494928597895933
STAT,1891,41,15-19,1932,0.01734702837543565
SIM,1824,32,30-34,1856,19
STAT,1884,5,na,1889,2622.5341587869016
SIM,1923,10,na,1933,4757
STAT,1844,20,50-100,1864,0.4086813264527495
STAT,1879,46,20-24,1925,0.012683908371605709
SIM,1934,21,25-29,1955,5
STAT,1855,39,35-39,1894,5.270352373219312
STAT,1863,42,15-19,1905,0.012343060140014128
SIM,1891,34,40-44,1925,5
SIM,1829,77,na,1906,586
STAT,1807,54,25-29,1861,0.011543244086712602
STAT,1859,25,40-44,1884,2.5113394358946715
STAT,1883,23,30-34,1906,17.550750127725404
STAT,1894,36,45-49,1930,2.6046776740729465
STAT,1885,31,40-44,1916,4.377681864861642
SIM,1908,22,40-44,1930,5
SIM,1830,25,45-49,1855,1
STAT,1892,29,40-44,1921,3.7693809382057655
STAT,1920,45,25-29,1965,0.059492310509852785
STAT,1839,44,25-29,1883,0.4676977506542259
SIM,1908,42,na,1950,3329
SIM,1850,34,30-34,1884,20
STAT,1825,38,40-44,1863,6.9357324890022225
STAT,1825,67,na,1892,1156.8268432662771
SIM,1841,26,na,1867,1839
SIM,1833,38,40-44,1871,9
STAT,1926,21,25-29,1947,113.7569322295672
STAT,1867,7,na,1874,2644.9428167294877
STAT,1863,39,15-19,1902,0.04974637725586314
SIM,1891,23,30-34,1914,31
STAT,1920,34,15-19,1954,0.14092400236360222
STAT,1881,44,50-100,1925,1.0146419073374613
STAT,1852,44,na,1896,1729.1657671170187
STAT,1861,18,na,1879,2201.2685997084595
SIM,1887,34,20-24,1921,3
STAT,1916,18,40-44,1934,0.29869408111826196
STAT,1899,46,40-44,1945,0.13424221005749115
SIM,1824,43,40-44,1867,4
STAT,1897,26,15-19,1923,0.6164481697417122
SIM,1899,15,35-39,1914,1
STAT,1822,54,20-24,1876,0.001012741360630844
STAT,1936,35,50-100,1971,0.4168457156771306
SIM,1826,36,35-39,1862,10
SIM,1941,22,25-29,1963,124
STAT,1827,45,45-49,1872,0.24856999059169596
STAT,1836,81,na,1917,340.96499192758773
SIM,1817,43,30-34,1860,4
STAT,1925,29,50-100,1954,1.179610700330759
STAT,1832,28,30-34,1860,22.893870415070342
STAT,1883,34,40-44,1917,4.249588800145644
STAT,1802,93,na,1895,10.210864024050604
STAT,1885,27,35-39,1912,9.700431769718483
STAT,1834,24,25-29,1858,44.94559747221032
SIM,1790,71,na,1861,664
SIM,1929,12,na,1941,4947
SIM,1924,18,40-44,1942,2
STAT,1861,80,na,1941,519.1755672126639
STAT,1870,54,na,1924,2076.761932934745
SIM,1896,26,50-100,1922,1
STAT,1837,36,15-19,1873,0.04712928435212827
SIM,1833,82,na,1915,302
STAT,1913,22,50-100,1935,0.6433187038673693
SIM,1840,28,30-34,1868,39
STAT,1940,26,40-44,1966,4.800564280046777
STAT,1874,45,25-29,1919,0.060163200548471664
STAT,1891,42,20-24,1933,0.19834773316977725
SIM,1872,29,35-39,1901,10
SIM,1893,30,35-39,1923,22
STAT,1885,30,35-39,1915,10.262958805657302
STAT,1795,95,na,1890,3.0783182754992726
SIM,1801,72,na,1873,357
STAT,1791,81,na,1872,187.24878751764302
SIM,1893,27,35-39,1920,17
STAT,1824,51,20-24,1875,8.490631941313721E-4
STAT,1874,47,na,1921,2315.914429306319
SIM,1848,59,na,1907,1459
SIM,1843,33,30-34,1876,27
STAT,1933,22,25-29,1955,123.81177015765938
STAT,1797,103,na,1900,0.03583188095681334
STAT,1863,26,15-19,1889,0.4089500214726216
SIM,1852,30,40-44,1882,6
SIM,1925,34,35-39,1959,14
STAT,1919,31,35-39,1950,9.995339905180227
STAT,1823,34,20-24,1857,5.549449938564026
STAT,1865,34,25-29,1899,9.365427844674745
STAT,1894,24,45-49,1918,0.9010754789352561
STAT,1920,47,20-24,1967,0.012336170916909958
SIM,1835,33,45-49,1868,1
STAT,1826,32,50-100,1858,1.284985114731171
STAT,1866,39,40-44,1905,4.052779094373382
STAT,1812,52,40-44,1864,0.023240058089903946
STAT,1833,44,25-29,1877,0.5385598760774161
STAT,1849,45,50-100,1894,0.19393745799767936
STAT,1856,49,25-29,1905,0.04367108117848353
STAT,1823,53,25-29,1876,0.004600069107292214
STAT,1838,39,50-100,1877,0.9713450409733697
SIM,1850,22,30-34,1872,24
SIM,1876,44,50-100,1920,4
STAT,1829,51,50-100,1880,0.011105208527989557
SIM,1790,92,na,1882,15
STAT,1827,33,45-49,1860,2.2506310230740123
STAT,1882,42,na,1924,2258.4118937108237
STAT,1891,16,na,1907,3165.9720155284995
STAT,1904,46,25-29,1950,0.047227058097996856
SIM,1861,35,45-49,1896,2
STAT,1850,41,20-24,1891,0.1221555679106342
SIM,1922,36,40-44,1958,2
STAT,1811,43,35-39,1854,5.014984478412138
STAT,1870,65,na,1935,1676.0849520801708
SIM,1911,29,50-100,1940,1
SIM,1811,82,na,1893,220
STAT,1842,34,30-34,1876,18.59935434568907
STAT,1890,25,20-24,1915,14.576724531066063
STAT,1907,32,25-29,1939,8.723313608702066
SIM,1867,25,40-44,1892,3
STAT,1823,63,na,1886,1017.7411657600079
SIM,1882,24,25-29,1906,71
SIM,1820,56,na,1876,1197
SIM,1867,37,35-39,1904,17
STAT,1843,34,40-44,1877,3.4441090904295737
STAT,1873,16,30-34,1889,1.6416474804095136
STAT,1884,54,na,1938,2085.627864607328
STAT,1859,87,na,1946,143.11791838175142
STAT,1914,36,40-44,1950,1.5152821703030914
SIM,1867,40,35-39,1907,2
SIM,1831,34,20-24,1865,1
SIM,1794,85,na,1879,147
STAT,1908,41,30-34,1949,0.12008865512616754
STAT,1858,27,45-49,1885,0.9006363531887343
STAT,1906,33,20-24,1939,2.2736589453254075
STAT,1842,22,30-34,1864,20.22740354761133
STAT,1844,30,40-44,1874,4.189173433879598
SIM,1898,4,na,1902,3573
STAT,1929,33,15-19,1962,0.16488065378948955
STAT,1785,96,na,1881,1.5705496631310347
STAT,1811,54,45-49,1865,0.03320726878384971
SIM,1908,50,na,1958,3164
STAT,1876,34,30-34,1910,18.05185563660627
STAT,1874,79,na,1953,723.0073745859452
SIM,1831,28,35-39,1859,11
SIM,1884,34,30-34,1918,7
SIM,1851,34,40-44,1885,2
SIM,1881,16,30-34,1897,2
STAT,1871,49,20-24,1920,0.011789682165749864
STAT,1939,23,30-34,1962,29.129887874049977
STAT,1836,39,25-29,1875,2.18361422776844
SIM,1819,70,na,1889,665
STAT,1861,29,na,1890,1988.6459636023992
STAT,1769,115,na,1884,1.552377874439307E-4
STAT,1843,46,40-44,1889,0.11641249482960303
SIM,1903,33,45-49,1936,2
SIM,1833,85,na,1918,181
STAT,1944,22,50-100,1966,0.7174096558327098
SIM,1927,31,35-39,1958,18
STAT,1874,26,20-24,1900,12.174180524996231
STAT,1875,24,40-44,1899,2.147832457329511
STAT,1842,33,40-44,1875,4.668004705461671
SIM,1850,33,40-44,1883,3
SIM,1882,26,20-24,1908,14
SIM,1863,100,na,1963,16
SIM,1865,39,na,1904,2119
STAT,1867,49,50-100,1916,0.22874229454642303
STAT,1853,112,na,1965,1.4563922940662594E-4
STAT,1848,39,na,1887,1941.5217523515828
STAT,1938,20,na,1958,3651.1666212681475
SIM,1874,13,na,1887,2533
STAT,1897,7,na,1904,3527.8054667581796
STAT,1875,25,25-29,1900,44.17344107573077
STAT,1927,44,45-49,1971,0.21026829583680423
STAT,1859,6,na,1865,2352.43801026737
STAT,1865,62,na,1927,1685.6360141527766
STAT,1799,88,na,1887,48.498052919756574
STAT,1857,45,30-34,1902,0.07706274991887985
STAT,1795,74,na,1869,524.5726757894514
STAT,1814,70,na,1884,783.1050998100196
SIM,1866,27,45-49,1893,1
STAT,1827,101,na,1928,0.3393262909489261
STAT,1945,21,35-39,1966,10.425302342257242
SIM,1857,7,na,1864,2591
SIM,1881,25,20-24,1906,15
SIM,1833,74,na,1907,665
STAT,1843,54,35-39,1897,0.00564685729853652
STAT,1822,38,15-19,1860,0.10012416578596864
STAT,1846,80,na,1926,469.44337358502423
STAT,1863,35,50-100,1898,1.1091288702543007
SIM,1881,29,30-34,1910,29
STAT,1841,54,30-34,1895,0.004328992432119857
STAT,1861,23,30-34,1884,15.247926306053218
STAT,1826,46,40-44,1872,0.17101216762396337
STAT,1882,39,25-29,1921,2.788505154081055
STAT,1916,17,na,1933,4135.334238608987
SIM,1820,34,45-49,1854,4
SIM,1844,77,na,1921,535
STAT,1828,46,45-49,1874,0.21788609906539838
STAT,1873,29,30-34,1902,25.59970513230002
STAT,1893,37,40-44,1930,5.61389117531099
STAT,1873,33,15-19,1906,0.145197250946603
STAT,1912,25,50-100,1937,0.9963165697436734
STAT,1878,37,15-19,1915,0.05887551826874357
STAT,1884,35,40-44,1919,4.4013780972245815
STAT,1836,73,na,1909,748.9065418224601
STAT,1890,44,25-29,1934,0.7818274564585346
SIM,1895,40,40-44,1935,1
STAT,1882,15,15-19,1897,5.833029079711587
SIM,1805,67,na,1872,728
SIM,1871,42,45-49,1913,3
SIM,1915,32,25-29,1947,17
STAT,1822,41,15-19,1863,0.022518643018398753
STAT,1930,36,25-29,1966,1.2992446238677595
SIM,1825,44,40-44,1869,8
SIM,1822,45,50-100,1867,2
STAT,1873,44,25-29,1917,0.6486355714270793
STAT,1876,4,na,1880,3024.6401203797527
SIM,1875,34,35-39,1909,11
SIM,1871,4,na,1875,2711
SIM,1880,28,na,1908,2243
STAT,1898,49,35-39,1947,0.1058710436908811
STAT,1949,12,na,1961,4615.443484880177
STAT,1867,34,35-39,1901,9.550612564756912
STAT,1835,33,30-34,1868,16.51763564778575
STAT,1817,44,40-44,1861,5.04962696810276
STAT,1847,54,25-29,1901,0.0025791069564754868
STAT,1890,33,15-19,1923,0.17501229101974433
SIM,1832,44,na,1876,1512
SIM,1841,18,na,1859,2073
STAT,1878,37,45-49,1915,2.0900806499786926
STAT,1847,26,30-34,1873,22.82618380954066
STAT,1934,31,30-34,1965,21.748059067784574
SIM,1872,35,20-24,1907,2
STAT,1870,20,40-44,1890,2.079028196707062
STAT,1816,85,na,1901,140.1575428082674
SIM,1908,31,25-29,1939,6
STAT,1957,15,25-29,1972,57.74593474908835
SIM,1892,35,40-44,1927,1
SIM,1911,17,na,1928,4063
STAT,1918,47,50-100,1965,0.24299427457196046
STAT,1823,42,15-19,1865,0.02048805328357335
STAT,1827,37,na,1864,1668.7028858557317
STAT,1887,40,40-44,1927,2.561979844571112
SIM,1874,35,30-34,1909,8
SIM,1870,29,25-29,1899,56
STAT,1863,42,45-49,1905,1.3376790487583932
SIM,1890,19,30-34,1909,2
SIM,1821,36,50-100,1857,5
SIM,1769,86,na,1855,117
STAT,1806,53,25-29,1859,0.010017708075714168
SIM,1891,35,30-34,1926,9
STAT,1830,48,20-24,1878,0.009907968268336268
SIM,1810,57,na,1867,1238
SIM,1960,4,na,1964,5280
STAT,1893,24,35-39,1917,7.4368126600141276
SIM,1855,26,30-34,1881,30
STAT,1857,44,40-44,1901,1.7490470405487593
STAT,1899,28,45-49,1927,1.533631284464213
STAT,1868,46,45-49,1914,0.22845543704553828
STAT,1877,50,25-29,1927,0.003745336399836427
SIM,1886,37,45-49,1923,5
STAT,1864,43,15-19,1907,0.012495182400874855
SIM,1865,44,40-44,1909,11
STAT,1816,43,40-44,1859,6.223721788054202
STAT,1826,33,35-39,1859,13.416955938999124
SIM,1881,69,na,1950,1313
STAT,1837,44,na,1881,1650.20411525269
SIM,1883,25,na,1908,2726
STAT,1921,23,45-49,1944,1.2795805252319956
STAT,1933,16,50-100,1949,0.5080490201944403
SIM,1951,2,na,1953,5038
STAT,1863,84,na,1947,297.69688672618406
STAT,1866,35,30-34,1901,5.031732139084654
STAT,1894,67,na,1961,2216.3255272735614
SIM,1810,89,na,1899,78
STAT,1862,29,25-29,1891,36.632454378340746
STAT,1842,53,35-39,1895,0.007626583877228874
STAT,1882,19,30-34,1901,1.5509957737337177
SIM,1869,10,na,1879,2523
STAT,1873,25,15-19,1898,0.4677020344746228
STAT,1885,39,na,1924,2344.7142976264267
SIM,1834,33,35-39,1867,12
SIM,1816,59,na,1875,1092
STAT,1902,23,35-39,1925,8.303011777860615
STAT,1853,53,40-44,1906,0.00856633298079388
SIM,1909,21,45-49,1930,1
STAT,1941,8,na,1949,4123.652939570442
SIM,1827,40,50-100,1867,1
STAT,1912,35,na,1947,3739.81625646194
STAT,1816,44,30-34,1860,3.072625162687512
STAT,1902,28,na,1930,3394.199505534278
STAT,1883,35,30-34,1918,5.317628957359953
STAT,1851,28,40-44,1879,2.6366839146423513
SIM,1910,23,35-39,1933,11
STAT,1873,45,15-19,1918,4.1364665524832217E-4
STAT,1856,25,15-19,1881,0.36933554195923535
STAT,1893,45,35-39,1938,0.10228621488370628
SIM,1887,31,na,1918,2682
STAT,1857,40,25-29,1897,0.5112841457310902
SIM,1855,21,na,1876,2096
STAT,1846,29,na,1875,1957.6019579559554
SIM,1891,76,na,1967,1474
SIM,1931,33,50-100,1964,2
STAT,1841,38,25-29,1879,2.510576644106308
STAT,1826,54,35-39,1880,0.007863123726887796
STAT,1869,47,45-49,1916,0.2306618095131754
SIM,1876,34,45-49,1910,3
SIM,1874,15,30-34,1889,2
SIM,1948,15,25-29,1963,63
STAT,1833,62,na,1895,1293.1120299882189
STAT,1867,47,40-44,1914,0.16208998189280277
STAT,1868,34,45-49,1902,1.6688839406793199
SIM,1869,21,na,1890,2195
STAT,1823,55,na,1878,1256.675219890173
STAT,1864,54,25-29,1918,0.003139373257736386
STAT,1866,15,30-34,1881,1.5482035995093144
SIM,1820,64,na,1884,906
STAT,1883,18,35-39,1901,0.5409074874840487
STAT,1859,79,na,1938,567.9080667229848
STAT,1852,52,40-44,1904,0.007941581218242014
STAT,1907,30,50-100,1937,0.7866108540776156
SIM,1831,59,na,1890,1297
SIM,1830,34,na,1864,1604
SIM,1816,38,40-44,1854,4
STAT,1903,34,15-19,1937,0.11661274544035133
SIM,1931,33,20-24,1964,3
SIM,1829,36,30-34,1865,11
STAT,1916,18,50-100,1934,0.08000732370089242
SIM,1915,30,50-100,1945,2
STAT,1875,29,40-44,1904,3.0848445822517574
SIM,1830,41,45-49,1871,1
STAT,1818,43,45-49,1861,2.8422681706121615
SIM,1834,48,na,1882,1711
STAT,1888,27,30-34,1915,30.01963685197221
SIM,1822,90,na,1912,29
STAT,1824,35,20-24,1859,1.140143638571917
STAT,1843,16,45-49,1859,0.05663658695847318
STAT,1901,38,20-24,1939,0.23440328445646644
STAT,1838,39,35-39,1877,5.5958360318634
STAT,1811,51,40-44,1862,0.02558101996082719
STAT,1809,46,35-39,1855,0.523032837563272
STAT,1871,24,50-100,1895,0.40662518802003234
SIM,1917,21,25-29,1938,107
SIM,1818,85,na,1903,165
STAT,1837,47,na,1884,1593.1958803023615
STAT,1807,51,20-24,1858,0.0025559248080919673
STAT,1858,45,40-44,1903,0.13700902080310656
STAT,1898,29,35-39,1927,13.116973095817162
SIM,1925,22,40-44,1947,4
SIM,1826,43,45-49,1869,5
SIM,1857,95,na,1952,5
STAT,1854,36,15-19,1890,0.042346081788270054
SIM,1839,19,30-34,1858,2
STAT,1845,95,na,1940,9.71486432016377
STAT,1835,88,na,1923,103.0378953302841
STAT,1874,42,20-24,1916,0.1640405748729177
SIM,1896,27,30-34,1923,47
SIM,1897,35,50-100,1932,2
SIM,1900,22,na,1922,3686
SIM,1876,31,40-44,1907,7
STAT,1824,54,25-29,1878,0.0038397311016330126
SIM,1846,39,35-39,1885,13
STAT,1923,33,20-24,1956,2.823559579119562
STAT,1831,107,na,1938,0.002963507735338854
SIM,1854,27,20-24,1881,11
SIM,1907,25,na,1932,3750
SIM,1919,30,50-100,1949,5
SIM,1849,6,na,1855,2525
SIM,1877,41,50-100,1918,1
STAT,1840,22,20-24,1862,61.431886366470515
SIM,1893,34,45-49,1927,3
STAT,1884,47,40-44,1931,0.1697193976664155
STAT,1833,43,40-44,1876,1.9107309070210128
SIM,1913,16,15-19,1929,11
STAT,1898,30,15-19,1928,0.19655315956030725
STAT,1859,47,na,1906,1819.105215899667
STAT,1816,47,35-39,1863,0.3620249118077427
STAT,1901,43,na,1944,3259.9667332170934
STAT,1822,70,na,1892,784.4918873592283
STAT,1889,35,50-100,1924,1.5435450321813713
STAT,1905,16,15-19,1921,8.68629884519111
STAT,1813,85,na,1898,120.19667678290315
STAT,1771,93,na,1864,5.216800079959278
STAT,1801,54,30-34,1855,0.021572357778399952
SIM,1867,34,30-34,1901,35
STAT,1891,26,20-24,1917,14.720267300960977
STAT,1833,32,30-34,1865,15.962441268347773
STAT,1903,45,25-29,1948,0.04720170362361058
SIM,1841,43,40-44,1884,5
STAT,1837,49,15-19,1886,2.7610503764639773E-4
SIM,1938,17,30-34,1955,14
SIM,1832,89,na,1921,113
SIM,1889,26,30-34,1915,33
STAT,1861,40,na,1901,1959.3506337320628
STAT,1885,34,45-49,1919,1.738120634483284
SIM,1841,32,30-34,1873,25
STAT,1845,29,25-29,1874,37.083528276061095
SIM,1856,34,25-29,1890,18
STAT,1898,41,25-29,1939,0.06133298551324574
STAT,1854,111,na,1965,4.295838362224931E-4
STAT,1886,24,na,1910,2506.2826731743485
STAT,1885,24,30-34,1909,17.79525701343154
STAT,1832,44,15-19,1876,0.011244251506358702
SIM,1884,37,35-39,1921,13
STAT,1850,44,25-29,1894,0.48507137069172845
STAT,1847,18,50-100,1865,0.045513130313835484
STAT,1876,40,35-39,1916,1.9074489514734259
SIM,1868,36,na,1904,2185
STAT,1843,23,50-100,1866,0.3427545920193017
STAT,1848,34,25-29,1882,8.692235139729114
STAT,1866,54,35-39,1920,0.007830062382724476
SIM,1895,28,20-24,1923,19
SIM,1948,20,15-19,1968,6
SIM,1853,29,25-29,1882,39
SIM,1810,86,na,1896,157
STAT,1846,27,20-24,1873,10.770212635935296
STAT,1870,62,na,1932,1812.7222539727761
SIM,1836,26,na,1862,2213
SIM,1891,68,na,1959,1879
STAT,1858,24,40-44,1882,1.6993261032993574
STAT,1874,76,na,1950,979.7949991781401
STAT,1895,37,45-49,1932,2.6293359524356394
STAT,1862,30,35-39,1892,8.904033755482372
SIM,1826,33,30-34,1859,34
SIM,1869,13,na,1882,2502
SIM,1939,24,50-100,1963,1
SIM,1903,30,40-44,1933,9
SIM,1883,28,na,1911,2812
STAT,1812,60,na,1872,1099.3778647405472
STAT,1887,28,20-24,1915,13.182357700094776
SIM,1886,17,15-19,1903,8
STAT,1842,17,35-39,1859,0.6343890449816199
SIM,1893,24,30-34,1917,35
SIM,1848,25,30-34,1873,25
STAT,1864,69,na,1933,1337.5002207448597
STAT,1876,37,35-39,1913,7.375946235764562
STAT,1822,41,45-49,1863,2.4404577657795468
SIM,1783,93,na,1876,8
SIM,1821,39,30-34,1860,6
SIM,1884,40,35-39,1924,6
STAT,1935,23,na,1958,5022.569141957079
SIM,1906,22,30-34,1928,2
STAT,1860,55,na,1915,1707.1592331912614
SIM,1860,29,50-100,1889,4
STAT,1864,35,20-24,1899,0.7092139143049898
STAT,1891,45,25-29,1936,0.041034591744969484
SIM,1859,46,50-100,1905,2
STAT,1917,22,40-44,1939,3.6071152185912467
SIM,1883,25,25-29,1908,52
STAT,1833,41,20-24,1874,0.13841114655562498
STAT,1867,52,30-34,1919,0.005632052806714842
STAT,1801,110,na,1911,1.0997715320734488E-4
STAT,1842,37,35-39,1879,7.47014082932261
STAT,1884,17,45-49,1901,0.06506088847970687
SIM,1831,48,na,1879,1599
STAT,1864,29,35-39,1893,8.731057916875416
STAT,1844,33,45-49,1877,1.6328290772888314
SIM,1878,57,na,1935,2290
STAT,1837,36,na,1873,1797.4637571343849
SIM,1868,28,na,1896,2191
STAT,1889,44,30-34,1933,1.4124636629259262
STAT,1852,23,35-39,1875,5.219635250719148
SIM,1925,31,30-34,1956,33
STAT,1881,23,20-24,1904,66.88351298013315
SIM,1860,23,35-39,1883,7
STAT,1936,16,na,1952,3566.4015107938076
SIM,1839,38,35-39,1877,13
SIM,1850,37,35-39,1887,17
SIM,1883,29,40-44,1912,5
STAT,1883,83,na,1966,678.4361468093357
SIM,1839,47,50-100,1886,3
SIM,1852,33,45-49,1885,2
STAT,1872,33,50-100,1905,0.9264486897697793
STAT,1946,20,45-49,1966,1.2654931570113606
STAT,1903,21,na,1924,3412.187964792307
STAT,1908,44,35-39,1952,0.18575499869110543
STAT,1812,71,na,1883,688.7308491118879
STAT,1833,22,na,1855,2032.6360397651367
STAT,1885,15,40-44,1900,0.18473367479769562
STAT,1872,17,20-24,1889,18.061136135158577
SIM,1841,23,25-29,1864,1
STAT,1849,35,25-29,1884,2.3518170470318163
SIM,1845,16,15-19,1861,6
STAT,1914,47,50-100,1961,0.2263224323455045
STAT,1888,23,15-19,1911,3.920652715240467
SIM,1939,29,40-44,1968,6
STAT,1836,51,45-49,1887,0.009448522209752662
STAT,1857,48,35-39,1905,0.1089676019136718
SIM,1900,44,40-44,1944,3
SIM,1918,41,40-44,1959,2
SIM,1827,39,25-29,1866,4
STAT,1914,22,15-19,1936,5.4870930158444144
STAT,1861,26,35-39,1887,8.215979349657047
SIM,1891,30,25-29,1921,6
STAT,1855,33,20-24,1888,2.0502915172355807
STAT,1922,45,35-39,1967,0.15033551518788457
STAT,1926,2,na,1928,5067.827337111719
SIM,1873,39,25-29,1912,5
STAT,1852,29,50-100,1881,0.5068468476875668
STAT,1847,39,30-34,1886,4.055175518819752
SIM,1810,48,45-49,1858,3
SIM,1896,23,15-19,1919,4
STAT,1853,35,45-49,1888,1.683161223019673
SIM,1939,18,30-34,1957,26
STAT,1917,0,na,1917,4877.514322590247
SIM,1858,58,na,1916,1593
SIM,1922,22,15-19,1944,11
STAT,1898,46,30-34,1944,0.07497553117844129
STAT,1893,42,30-34,1935,1.47256702159785
SIM,1877,61,na,1938,1925
STAT,1819,39,25-29,1858,6.951982437786095
STAT,1883,30,25-29,1913,10.204870607791431
STAT,1870,23,45-49,1893,0.6894583073272205
STAT,1830,108,na,1938,0.0012084609981756153
STAT,1851,40,30-34,1891,0.8792985607525752
STAT,1902,36,na,1938,3405.4374735585006
STAT,1826,51,30-34,1877,0.005770482687470024
STAT,1839,46,20-24,1885,0.008779989607183934
STAT,1833,23,25-29,1856,54.25197107227999
SIM,1809,45,50-100,1854,2
STAT,1916,49,20-24,1965,0.011371785623519644
STAT,1834,39,50-100,1873,0.8907949920047569
STAT,1894,75,na,1969,1748.9844546926345
SIM,1857,35,25-29,1892,5
SIM,1856,43,30-34,1899,2
SIM,1921,2,na,1923,4622
STAT,1878,53,45-49,1931,0.014971306821594085
STAT,1923,31,50-100,1954,0.961598734890983
SIM,1879,20,na,1899,2768
STAT,1916,9,na,1925,4248.356442106285
STAT,1890,19,35-39,1909,0.6735636710700472
STAT,1850,66,na,1916,1255.0127118593807
STAT,1950,12,na,1962,4692.595780647202
SIM,1862,36,45-49,1898,2
STAT,1838,45,20-24,1883,0.008478935476911097
STAT,1854,49,20-24,1903,0.008817804047268625
SIM,1877,72,na,1949,1283
SIM,1891,38,35-39,1929,21
SIM,1891,79,na,1970,1174
STAT,1894,21,40-44,1915,2.717831002337626
SIM,1866,24,40-44,1890,3
STAT,1895,38,na,1933,3092.034656767912
STAT,1854,36,45-49,1890,1.5032857247061502
STAT,1860,34,40-44,1894,3.5498534309337733
STAT,1848,52,20-24,1900,5.992732034786404E-4
STAT,1890,18,50-100,1908,0.06030544231231727
STAT,1827,30,40-44,1857,6.381226248397482
STAT,1786,81,na,1867,209.90334839459604
SIM,1855,39,30-34,1894,8
SIM,1928,27,15-19,1955,3
STAT,1934,38,na,1972,5240.567260547563
STAT,1883,38,35-39,1921,6.955999091256476
STAT,1900,58,na,1958,2841.156308928057
SIM,1897,35,25-29,1932,5
SIM,1892,31,25-29,1923,21
STAT,1921,20,40-44,1941,3.8585132177571486
STAT,1825,50,30-34,1875,0.008014862887718216
SIM,1886,34,40-44,1920,9
SIM,1835,30,40-44,1865,12
STAT,1835,36,35-39,1871,6.634050954838543
STAT,1850,25,20-24,1875,10.72457020363096
STAT,1871,28,na,1899,2386.2658656201984
SIM,1912,0,na,1912,4174
SIM,1844,40,35-39,1884,1
STAT,1829,43,20-24,1872,0.1215192877986397
STAT,1841,52,50-100,1893,0.011233931665948934
STAT,1848,43,30-34,1891,0.9318756971330696
SIM,1963,8,na,1971,5078
STAT,1923,46,35-39,1969,0.15277123843273832
SIM,1825,40,25-29,1865,3
SIM,1855,22,15-19,1877,3
SIM,1779,85,na,1864,108
STAT,1934,34,35-39,1968,12.590835501077816
STAT,1860,95,na,1955,10.977149553289534
SIM,1865,28,35-39,1893,9
STAT,1837,52,45-49,1889,0.009936542015478705
STAT,1888,38,50-100,1926,1.456347002504299
SIM,1928,30,45-49,1958,1
STAT,1889,35,25-29,1924,3.6197896104352463
SIM,1908,10,na,1918,3798
STAT,1934,6,na,1940,5477.848657829545
STAT,1873,49,30-34,1922,0.09704501239136785
SIM,1880,17,20-24,1897,19
SIM,1843,36,35-39,1879,15
STAT,1896,34,20-24,1930,3.5828368318994195
STAT,1878,34,40-44,1912,4.507922785185579
SIM,1822,34,na,1856,1756
SIM,1847,66,na,1913,1150
SIM,1932,24,na,1956,5384
STAT,1884,46,na,1930,2247.19230115526
STAT,1774,107,na,1881,0.005241925022566544
SIM,1910,20,30-34,1930,29
SIM,1860,44,35-39,1904,1
STAT,1931,5,na,1936,5318.838369723878
STAT,1857,28,35-39,1885,7.777754853333975
STAT,1881,50,45-49,1931,0.01433182158967359
STAT,1915,46,na,1961,3744.7413604323315
SIM,1923,23,15-19,1946,7
SIM,1919,17,20-24,1936,161
STAT,1899,25,40-44,1924,4.180477077756523
STAT,1915,23,15-19,1938,5.5351780336458205
STAT,1873,41,20-24,1914,0.1633459556306581
SIM,1898,36,25-29,1934,5
STAT,1828,54,50-100,1882,0.011620055292817788
STAT,1871,16,20-24,1887,18.01020716300576
STAT,1806,50,20-24,1856,0.002216409037447464
STAT,1836,40,35-39,1876,1.3942295001966634
STAT,1902,20,30-34,1922,25.574446878269647
STAT,1915,44,50-100,1959,0.11894933174252555
SIM,1919,13,na,1932,4324
SIM,1819,43,40-44,1862,8
SIM,1890,15,15-19,1905,7
STAT,1846,26,45-49,1872,1.026700041506721
SIM,1920,21,na,1941,4370
SIM,1875,92,na,1967,63
SIM,1845,31,45-49,1876,2
STAT,1821,83,na,1904,237.79200585032925
STAT,1835,43,45-49,1878,1.3293286784335725
SIM,1922,22,na,1944,4685
SIM,1834,70,na,1904,943
SIM,1942,22,40-44,1964,5
STAT,1834,27,50-100,1861,0.4995597701739666
SIM,1860,20,30-34,1880,23
STAT,1831,28,na,1859,1786.8709956259113
STAT,1925,44,35-39,1969,0.24556086326120596
SIM,1841,46,45-49,1887,3
STAT,1850,32,30-34,1882,13.98546753031241
STAT,1875,45,40-44,1920,0.17934194650288338
STAT,1946,18,20-24,1964,151.82745369186352
STAT,1849,26,na,1875,2019.447360456335
STAT,1946,21,20-24,1967,125.01677546429802
STAT,1852,40,40-44,1892,1.723045151041474
STAT,1904,62,na,1966,2891.309442690576
SIM,1848,29,25-29,1877,51
STAT,1845,33,50-100,1878,0.7878010339326175
SIM,1818,42,40-44,1860,6
STAT,1888,26,50-100,1914,0.765201759240097
STAT,1921,46,30-34,1967,0.10175051863520043
STAT,1849,30,25-29,1879,9.467842438494564
SIM,1865,26,20-24,1891,16
SIM,1918,33,50-100,1951,1
STAT,1906,16,50-100,1922,0.07224913363261772
STAT,1813,88,na,1901,60.193210017413215
SIM,1884,3,na,1887,2861
STAT,1929,29,50-100,1958,1.2578445936552676
STAT,1929,24,25-29,1953,117.32450681644133
STAT,1782,85,na,1867,87.17691849408293
STAT,1859,21,50-100,1880,0.3804195862087211
STAT,1873,48,40-44,1921,0.17309075151012485
SIM,1854,26,45-49,1880,2
STAT,1822,45,30-34,1867,0.1476063969686985
STAT,1887,65,na,1952,1905.6793815079075
SIM,1867,97,na,1964,13
STAT,1898,27,20-24,1925,16.062805972897994
STAT,1837,31,45-49,1868,1.507154925060132
STAT,1853,16,35-39,1869,0.5490894118821981
SIM,1849,31,50-100,1880,1
STAT,1874,38,50-100,1912,1.2634209826858753
SIM,1843,43,45-49,1886,1
SIM,1897,32,20-24,1929,3
STAT,1793,108,na,1901,3.305974959995194E-4
STAT,1908,32,40-44,1940,3.7288121572931643
SIM,1938,33,30-34,1971,19
STAT,1889,32,20-24,1921,3.3663736640882975
SIM,1928,15,15-19,1943,56
SIM,1869,98,na,1967,10
STAT,1908,52,na,1960,3297.4598963911085
SIM,1852,32,na,1884,1864
STAT,1863,23,40-44,1886,1.8882862980137651
SIM,1871,23,40-44,1894,3
STAT,1917,22,50-100,1939,0.705893440513222
SIM,1825,34,na,1859,1451
SIM,1922,32,25-29,1954,20
STAT,1903,29,50-100,1932,0.9135655877882614
STAT,1878,80,na,1958,761.2417993685709
STAT,1885,44,50-100,1929,1.0477547035477377
STAT,1852,97,na,1949,4.074265284649464
STAT,1877,33,na,1910,2477.048840509697
STAT,1857,21,na,1878,1959.7302773041245
STAT,1899,32,50-100,1931,1.2700554759252034
SIM,1908,29,20-24,1937,17
STAT,1905,32,15-19,1937,0.11939281616609919
STAT,1846,43,20-24,1889,0.12042704069703908
STAT,1807,70,na,1877,684.4975517904859
STAT,1899,44,50-100,1943,0.1003184916650664
SIM,1861,16,35-39,1877,1
STAT,1827,49,25-29,1876,0.05753378372020887
SIM,1924,37,na,1961,4511
SIM,1859,43,40-44,1902,5
STAT,1837,33,40-44,1870,3.6711112051827217
STAT,1857,26,20-24,1883,9.593694221417628
STAT,1914,32,25-29,1946,9.386875206401347
STAT,1889,16,15-19,1905,7.409007142752885
STAT,1847,11,na,1858,2241.0418193449186
SIM,1937,24,25-29,1961,101
STAT,1861,33,45-49,1894,1.4573790907163346
STAT,1859,34,30-34,1893,14.061719119946588
STAT,1914,43,20-24,1957,0.01762804694289564
SIM,1894,65,na,1959,2461
STAT,1858,25,25-29,1883,34.81142747993081
SIM,1845,33,40-44,1878,7
STAT,1911,39,25-29,1950,0.9497904560386856
SIM,1877,23,35-39,1900,7
STAT,1929,8,na,1937,5144.722793204611
STAT,1845,45,50-100,1890,0.18124559640079393
STAT,1870,27,50-100,1897,0.6344393897106337
STAT,1889,3,na,1892,3292.3758828052923
STAT,1844,46,20-24,1890,0.009521166579069314
SIM,1897,16,15-19,1913,6
SIM,1842,44,40-44,1886,4
STAT,1845,10,na,1855,2232.2925
STAT,1852,20,30-34,1872,16.280644875739924
STAT,1863,21,45-49,1884,0.6410649498180768
STAT,1910,27,15-19,1937,0.6877764630891314
STAT,1831,38,35-39,1869,5.592205461999536
STAT,1912,35,25-29,1947,0.9787494226030904
SIM,1943,21,45-49,1964,1
STAT,1920,40,40-44,1960,0.2797378379194608
STAT,1934,22,40-44,1956,4.565733885810529
SIM,1932,32,na,1964,5745
STAT,1827,36,50-100,1863,1.4623215210899114
STAT,1904,29,40-44,1933,4.3107947990980895
STAT,1887,27,45-49,1914,1.2520288163976454
STAT,1877,53,35-39,1930,0.008830192294680246
STAT,1930,33,20-24,1963,3.179615433430673
STAT,1952,15,40-44,1967,1.6944158106511242
SIM,1876,24,30-34,1900,22
STAT,1927,25,na,1952,4634.406261357601
STAT,1930,39,35-39,1969,3.181979865600761
SIM,1841,20,20-24,1861,4
SIM,1866,25,25-29,1891,53
SIM,1914,27,na,1941,3965
STAT,1925,41,50-100,1966,0.14394889248720294
SIM,1907,21,35-39,1928,17
STAT,1894,13,na,1907,3352.9228528913873
SIM,1928,27,na,1955,4726
STAT,1875,20,25-29,1895,59.7304213206063
SIM,1869,66,na,1935,1516
STAT,1870,50,50-100,1920,0.015193980021524561
STAT,1856,29,50-100,1885,0.5059448093820916
STAT,1841,54,25-29,1895,0.0025759293562696768
STAT,1935,18,45-49,1953,0.6881524912876475
STAT,1843,42,25-29,1885,0.4459400701896682
STAT,1845,101,na,1946,0.4169466951779876
STAT,1903,43,45-49,1946,0.14841404039445552
STAT,1860,102,na,1962,0.7698682735253857
STAT,1935,21,45-49,1956,1.5485492125340736
STAT,1833,46,45-49,1879,0.19883518775325928
STAT,1813,48,50-100,1861,0.701713236140172
SIM,1836,71,na,1907,937
SIM,1912,29,40-44,1941,5
STAT,1877,3,na,1880,3195.6664301552505
STAT,1920,5,na,1925,4555.433875461726
SIM,1932,17,30-34,1949,30
STAT,1857,13,na,1870,2201.63596137608
STAT,1899,23,20-24,1922,95.2280148496049
SIM,1835,23,30-34,1858,22
STAT,1864,15,na,1879,2406.468622792813
SIM,1882,62,na,1944,1503
STAT,1858,41,30-34,1899,0.9151036589743653
STAT,1796,99,na,1895,0.3967677269778471
STAT,1907,42,35-39,1949,0.1862812709883627
SIM,1856,15,15-19,1871,8
SIM,1875,60,na,1935,1900
STAT,1853,39,25-29,1892,2.3570645009090603
STAT,1883,16,20-24,1899,17.56540748511023
SIM,1852,23,30-34,1875,23
STAT,1854,70,na,1924,1052.9883376416917
STAT,1872,10,na,1882,2706.039450433721
SIM,1822,32,20-24,1854,4
STAT,1909,28,45-49,1937,1.6602241777171314
STAT,1832,47,40-44,1879,0.13823530089035493
STAT,1871,32,35-39,1903,10.161743195275962
STAT,1924,42,35-39,1966,0.24203574449913348
STAT,1780,76,na,1856,312.72604709219996
STAT,1858,60,na,1918,1511.2235842462244
STAT,1834,44,40-44,1878,1.5740282390534501
STAT,1871,52,45-49,1923,0.014484585998053842
SIM,1934,19,20-24,1953,193
STAT,1926,19,20-24,1945,167.09382458678846
STAT,1868,27,35-39,1895,9.31402255802075
STAT,1858,50,20-24,1908,5.931200559447607E-4
SIM,1836,28,na,1864,2181
SIM,1816,73,na,1889,512
SIM,1918,49,na,1967,4127
SIM,1820,39,50-100,1859,2
SIM,1861,92,na,1953,22
SIM,1880,46,50-100,1926,3
STAT,1915,42,25-29,1957,0.07254390605851159
STAT,1935,20,na,1955,5027.695649620255
STAT,1909,31,45-49,1940,1.5214725195626035
SIM,1873,15,15-19,1888,7
STAT,1907,17,30-34,1924,2.364071574004632
SIM,1917,28,45-49,1945,3
SIM,1921,49,50-100,1970,3
STAT,1885,84,na,1969,658.2122371813928
STAT,1841,20,na,1861,2054.919853445449
STAT,1865,15,15-19,1880,6.271470467065759
SIM,1828,36,45-49,1864,2
SIM,1880,39,35-39,1919,14
STAT,1904,43,20-24,1947,0.015869159978635645
STAT,1812,49,na,1861,1355.3018412640904
STAT,1915,32,na,1947,3886.748184730557
STAT,1839,25,15-19,1864,0.4111051631084323
STAT,1859,44,45-49,1903,1.1993633935357202
STAT,1932,26,na,1958,4960.817542545634
STAT,1854,78,na,1932,586.3796963362189
SIM,1920,25,50-100,1945,1
SIM,1926,21,45-49,1947,1
STAT,1821,41,35-39,1862,2.9721088740293005
STAT,1848,31,20-24,1879,2.60054246457056
STAT,1878,82,na,1960,656.7333466516646
STAT,1875,50,20-24,1925,7.763817646423219E-4
SIM,1898,31,25-29,1929,15
STAT,1803,64,na,1867,1042.2807480024758
STAT,1929,38,na,1967,4876.998518544341
SIM,1878,27,45-49,1905,2
STAT,1817,105,na,1922,0.013414861807876127
SIM,1879,19,30-34,1898,2
STAT,1865,43,30-34,1908,1.0526291418199296
STAT,1924,17,30-34,1941,14.667361473296967
SIM,1827,65,na,1892,898
SIM,1867,44,45-49,1911,4
SIM,1873,43,30-34,1916,1
STAT,1872,39,35-39,1911,7.109708631777441
SIM,1878,35,na,1913,2748
STAT,1791,68,na,1859,643.1835262885987
SIM,1882,40,na,1922,2096
STAT,1881,43,15-19,1924,0.013347651030077762
SIM,1927,19,15-19,1946,74
STAT,1874,33,30-34,1907,17.980458917954767
SIM,1869,37,45-49,1906,3
STAT,1821,85,na,1906,164.2043110793665
SIM,1887,4,na,1891,2899
STAT,1861,50,35-39,1911,0.007329244416674053
SIM,1887,18,na,1905,2768
STAT,1809,53,45-49,1862,0.04564415401826925
STAT,1954,7,na,1961,4909.21465607066
SIM,1857,30,25-29,1887,23
STAT,1859,15,30-34,1874,1.5208037249611097
SIM,1929,24,20-24,1953,158
SIM,1876,0,na,1876,4111
SIM,1837,30,50-100,1867,1
SIM,1916,32,40-44,1948,15
STAT,1899,21,25-29,1920,79.59067887700829
STAT,1870,94,na,1964,57.65641403048855
SIM,1827,43,na,1870,1514
SIM,1901,33,35-39,1934,19
SIM,1815,42,30-34,1857,2
SIM,1872,3,na,1875,3289
SIM,1931,39,na,1970,4913
STAT,1860,51,30-34,1911,0.004938097357708306
SIM,1829,91,na,1920,22
STAT,1824,42,30-34,1866,1.4285783795796996
SIM,1910,43,na,1953,3265
SIM,1917,31,45-49,1948,3
STAT,1857,35,na,1892,1874.7226122122684
SIM,1892,64,na,1956,2449
STAT,1923,41,na,1964,4392.242298880628
SIM,1903,33,na,1936,3203
SIM,1766,89,na,1855,29
STAT,1933,32,35-39,1965,12.444629875555682
SIM,1816,51,na,1867,1212
SIM,1906,27,30-34,1933,7
SIM,1891,29,50-100,1920,1
STAT,1891,33,30-34,1924,21.74086057971642
STAT,1820,58,na,1878,1078.8306255668176
STAT,1876,44,45-49,1920,1.5396933085674698
STAT,1808,54,40-44,1862,0.03420230388642507
STAT,1904,49,35-39,1953,0.11207310757241301
STAT,1919,19,15-19,1938,50.36605685916985
STAT,1891,0,na,1891,3671.8247532200444
SIM,1863,39,35-39,1902,9
SIM,1901,40,40-44,1941,1
SIM,1882,33,30-34,1915,20
STAT,1868,30,35-39,1898,9.854141763702536
STAT,1819,40,50-100,1859,2.4214874065212197
STAT,1884,15,25-29,1899,5.6702562161823415
SIM,1898,55,na,1953,2803
STAT,1910,33,35-39,1943,8.8523235631074
SIM,1870,42,35-39,1912,2
STAT,1854,56,na,1910,1530.717922118263
STAT,1855,110,na,1965,0.0013054182243126314
STAT,1908,16,35-39,1924,0.8236710157591519
SIM,1849,78,na,1927,593
SIM,1857,87,na,1944,144
SIM,1884,44,45-49,1928,3
SIM,1832,42,30-34,1874,4
STAT,1838,42,50-100,1880,0.8270727606961422
SIM,1907,57,na,1964,3339
STAT,1885,47,20-24,1932,0.0120078099231614
SIM,1831,45,50-100,1876,3
STAT,1862,42,35-39,1904,1.5774840088938686
STAT,1867,31,30-34,1898,16.675937035315734
STAT,1848,15,15-19,1863,6.077870842659815
STAT,1923,43,30-34,1966,0.1507393115787361
STAT,1803,86,na,1889,90.74925902407841
STAT,1938,30,50-100,1968,0.8402192446020963
STAT,1884,40,20-24,1924,0.15977304897662434
STAT,1844,23,30-34,1867,17.469437798641803
SIM,1877,10,na,1887,2759
SIM,1911,30,na,1941,3940
STAT,1883,37,45-49,1920,1.9703051149721353
STAT,1810,91,na,1901,30.095787220673937
SIM,1935,24,50-100,1959,6
SIM,1822,38,35-39,1860,18
STAT,1881,29,35-39,1910,9.326723729114288
STAT,1905,42,25-29,1947,0.06502949170075327
STAT,1936,24,50-100,1960,0.6346636942384416
SIM,1909,38,na,1947,3874
STAT,1850,35,35-39,1885,5.617045182961914
STAT,1927,24,50-100,1951,0.8142673978285176
SIM,1854,23,40-44,1877,2
SIM,1851,17,na,1868,2307
STAT,1863,26,45-49,1889,1.0007845356564742
SIM,1942,25,45-49,1967,1
SIM,1847,63,na,1910,1246
STAT,1834,58,na,1892,1177.1224042199638
STAT,1855,1,na,1856,2842.0962348312896
STAT,1896,17,45-49,1913,0.08733104179954576
STAT,1905,22,na,1927,3453.1994304028976
STAT,1894,23,50-100,1917,0.5286257745647603
SIM,1948,22,35-39,1970,20
STAT,1898,42,15-19,1940,0.0013114312167541535
SIM,1779,88,na,1867,63
STAT,1950,22,25-29,1972,110.70986218914022
SIM,1880,81,na,1961,642
SIM,1866,35,50-100,1901,1
STAT,1829,26,45-49,1855,1.8409405938677563
SIM,1835,42,40-44,1877,7
SIM,1871,26,45-49,1897,1
STAT,1925,38,15-19,1963,0.023269375145495385
STAT,1793,106,na,1899,0.002191385352215835
STAT,1846,23,40-44,1869,1.937183822475805
STAT,1890,31,na,1921,2957.1271320343362
STAT,1820,49,15-19,1869,6.599589779127727E-4
STAT,1864,19,15-19,1883,5.529435959767098
STAT,1868,47,20-24,1915,0.011529488083806853
STAT,1867,22,50-100,1889,0.38949715840849264
SIM,1880,33,20-24,1913,4
SIM,1928,41,na,1969,4910
SIM,1937,21,20-24,1958,134
SIM,1849,44,na,1893,1804
STAT,1825,54,40-44,1879,0.013091958226791782
STAT,1921,29,40-44,1950,5.209087960869835
STAT,1864,22,15-19,1886,3.0550382238519957
STAT,1912,33,45-49,1945,1.555569657093642
SIM,1819,56,na,1875,1191
SIM,1849,46,na,1895,1767
SIM,1933,16,35-39,1949,10
STAT,1869,23,35-39,1892,5.712492879555612
STAT,1898,57,na,1955,2751.6043850392393
SIM,1878,89,na,1967,244
STAT,1816,46,45-49,1862,0.6194531673439068
STAT,1925,16,35-39,1941,5.135313646999124
SIM,1872,19,15-19,1891,8
STAT,1894,33,40-44,1927,5.615388478199282
SIM,1891,37,45-49,1928,3
STAT,1857,29,25-29,1886,33.85327096242447
STAT,1929,21,20-24,1950,142.5545248234639
STAT,1892,45,40-44,1937,0.12361234540905425
STAT,1942,9,na,1951,4169.938617195219
STAT,1868,43,40-44,1911,2.1555211353776604
SIM,1882,21,20-24,1903,60
STAT,1859,40,35-39,1899,1.4858312591900638
SIM,1937,18,20-24,1955,130
STAT,1931,35,35-39,1966,3.243037160952275
STAT,1929,18,20-24,1947,174.4229882569049
STAT,1859,37,35-39,1896,5.74558573362531
STAT,1901,40,30-34,1941,0.11417600101940814
STAT,1934,25,45-49,1959,2.3503417624546996
STAT,1836,59,na,1895,1225.400763938994
STAT,1870,53,40-44,1923,0.010273554341918633
SIM,1824,46,45-49,1870,3
SIM,1865,29,25-29,1894,38
SIM,1900,21,25-29,1921,86
SIM,1898,23,na,1921,3161
SIM,1872,86,na,1958,127
STAT,1865,101,na,1966,2.703429712080758
STAT,1937,35,na,1972,3804.511223630409
SIM,1854,47,na,1901,2087
STAT,1865,64,na,1929,1603.211480918252
STAT,1880,47,50-100,1927,0.2592959843606073
SIM,1903,39,40-44,1942,2
STAT,1931,32,25-29,1963,12.239851689691037
SIM,1874,11,na,1885,2555
STAT,1872,33,20-24,1905,2.733159493569144
SIM,1908,49,50-100,1957,1
STAT,1830,46,50-100,1876,0.2081036707088989
STAT,1918,21,45-49,1939,1.2288427975891125
SIM,1879,76,na,1955,1027
STAT,1816,53,na,1869,1382.4357960484415
SIM,1839,39,25-29,1878,5
SIM,1856,48,na,1904,2063
STAT,1914,46,25-29,1960,0.05321083914792728
SIM,1866,22,20-24,1888,70
SIM,1773,83,na,1856,91
SIM,1872,22,15-19,1894,3
SIM,1920,33,45-49,1953,6
SIM,1962,9,na,1971,5266
SIM,1846,89,na,1935,13
STAT,1837,36,45-49,1873,1.6730893955293078
STAT,1952,18,45-49,1970,0.6046341255238327
SIM,1859,30,35-39,1889,15
STAT,1831,42,na,1873,1610.4638018115052
STAT,1818,62,na,1880,1059.7987252209284
STAT,1842,30,15-19,1872,0.15813661146109492
STAT,1838,29,20-24,1867,9.846883519337124
STAT,1865,31,20-24,1896,2.5030997677821683
SIM,1809,46,na,1855,1289
SIM,1846,29,20-24,1875,16
STAT,1906,16,25-29,1922,8.356818143481366
STAT,1822,48,35-39,1870,0.2046843912506491
SIM,1861,78,na,1939,644
STAT,1832,77,na,1909,588.5855180436056
SIM,1841,40,na,1881,1687
STAT,1908,35,45-49,1943,0.6504277543931613
SIM,1943,15,40-44,1958,2
SIM,1850,36,45-49,1886,2
STAT,1868,15,40-44,1883,0.18188764927612205
STAT,1918,18,45-49,1936,0.5474872121384099
STAT,1884,20,50-100,1904,0.4085805746439882
STAT,1935,15,40-44,1950,1.9408648313341794
SIM,1861,32,40-44,1893,6
STAT,1946,24,25-29,1970,103.74658605512086
STAT,1850,54,40-44,1904,0.007839489899205764
STAT,1840,42,15-19,1882,0.010098193787229419
STAT,1941,17,30-34,1958,12.675121752119146
SIM,1837,26,45-49,1863,5
STAT,1889,74,na,1963,1644.8033778237725
SIM,1785,70,na,1855,545
SIM,1896,14,na,1910,3446
STAT,1851,44,40-44,1895,1.680135231156969
SIM,1830,88,na,1918,80
STAT,1858,22,20-24,1880,62.65192148762382
STAT,1831,35,30-34,1866,4.354490376369753
SIM,1811,50,na,1861,1470
STAT,1915,54,na,1969,3637.975657781112
SIM,1834,45,na,1879,1776
SIM,1844,39,25-29,1883,2
STAT,1924,32,25-29,1956,10.896479545030454
STAT,1926,40,35-39,1966,0.2515871099945134
SIM,1845,62,na,1907,1429
STAT,1848,36,20-24,1884,0.6553438317207969
SIM,1917,19,20-24,1936,163
SIM,1866,16,na,1882,2636
SIM,1864,35,na,1899,2568
STAT,1841,52,na,1893,1601.5983522019815
STAT,1921,36,50-100,1957,0.47391120184922286
STAT,1839,48,na,1887,1604.4877416427173
SIM,1902,20,45-49,1922,1
STAT,1844,49,25-29,1893,0.044620696513952354
STAT,1853,32,40-44,1885,3.6932108594071194
SIM,1932,32,25-29,1964,20
STAT,1870,16,35-39,1886,0.5526424239978186
STAT,1849,77,na,1926,675.8275009843197
STAT,1931,22,15-19,1953,6.977575772569781
SIM,1917,25,40-44,1942,1
STAT,1895,52,na,1947,2824.908232974003
SIM,1841,58,na,1899,1384
STAT,1830,39,30-34,1869,4.709627647758243
STAT,1870,7,na,1877,2723.281520021497
STAT,1948,18,30-34,1966,14.086556369320006
STAT,1844,17,na,1861,2308.597021156476
SIM,1871,70,na,1941,1250
SIM,1838,22,45-49,1860,1
SIM,1872,19,20-24,1891,27
SIM,1852,26,35-39,1878,20
STAT,1832,106,na,1938,0.008267570282769861
STAT,1889,37,20-24,1926,0.9600107282867385
SIM,1897,37,20-24,1934,1
STAT,1831,32,20-24,1863,2.237401222414667
STAT,1940,21,na,1961,3756.846422820029
STAT,1844,26,35-39,1870,9.412987571987967
STAT,1905,45,35-39,1950,0.11645580500014945
STAT,1917,8,na,1925,4318.075944613529
STAT,1902,46,20-24,1948,0.00968855247849162
SIM,1864,40,45-49,1904,6
SIM,1791,88,na,1879,18
SIM,1867,41,40-44,1908,6
STAT,1829,71,na,1900,787.0490483335003
STAT,1806,75,na,1881,419.9759568284776
STAT,1867,19,40-44,1886,0.17577215075980804
STAT,1858,53,25-29,1911,0.0027615798171504694
STAT,1947,17,25-29,1964,49.308688915830594
SIM,1895,24,40-44,1919,6
SIM,1926,40,45-49,1966,1
STAT,1839,53,30-34,1892,0.004152436327575847
SIM,1901,30,30-34,1931,32
SIM,1875,31,30-34,1906,22
STAT,1850,40,15-19,1890,0.010681076602371465
STAT,1891,36,35-39,1927,8.887103266103688
SIM,1885,17,35-39,1902,2
STAT,1892,12,na,1904,3273.0183174050176
STAT,1842,50,25-29,1892,0.003234824480436221
SIM,1823,53,na,1876,1322
SIM,1828,33,40-44,1861,2
SIM,1863,59,na,1922,1731
SIM,1916,35,45-49,1951,2
STAT,1914,48,40-44,1962,0.15732363783635117
SIM,1858,29,na,1887,1948
SIM,1854,98,na,1952,21
STAT,1867,51,40-44,1918,0.010062044818842049
STAT,1875,40,na,1915,2421.4474970294973
SIM,1872,30,na,1902,2677
SIM,1890,30,45-49,1920,6
STAT,1915,22,30-34,1937,29.97848991484857
SIM,1913,11,na,1924,4082
STAT,1899,26,25-29,1925,58.83741710781735
SIM,1935,24,15-19,1959,5
STAT,1840,28,35-39,1868,8.372893791627243
STAT,1887,24,40-44,1911,2.335088444391708
SIM,1844,23,na,1867,1935
STAT,1809,51,na,1860,1381.1030141700012
STAT,1927,24,15-19,1951,6.587422490068023
STAT,1802,53,35-39,1855,0.024620704616682455
STAT,1937,31,20-24,1968,2.437635879845936
SIM,1885,20,35-39,1905,10
STAT,1890,40,45-49,1930,1.8657325346220268
STAT,1824,45,35-39,1869,0.168398727320275
STAT,1840,56,na,1896,1429.7582686577505
SIM,1923,22,30-34,1945,43
STAT,1848,92,na,1940,34.00501576935629
SIM,1899,16,25-29,1915,8
STAT,1827,45,na,1872,1541.2164247439916
STAT,1829,49,35-39,1878,0.1017674780817549
STAT,1937,28,20-24,1965,17.954975799616786
STAT,1918,40,45-49,1958,0.17914077931564124
STAT,1818,36,35-39,1854,22.975480780369672
SIM,1929,27,25-29,1956,109
SIM,1799,76,na,1875,595
SIM,1813,47,50-100,1860,1
STAT,1880,53,na,1933,2247.217308320698
STAT,1857,47,45-49,1904,0.18515840067115455
SIM,1800,98,na,1898,13
SIM,1876,43,40-44,1919,7
SIM,1834,30,30-34,1864,19
SIM,1906,23,15-19,1929,4
STAT,1827,42,40-44,1869,2.4195367783467963
STAT,1893,21,30-34,1914,22.912176350551356
STAT,1836,52,35-39,1888,0.005495140416519703
STAT,1818,45,50-100,1863,0.4505670169806958
STAT,1855,16,45-49,1871,0.058828849669795104
STAT,1872,36,30-34,1908,5.437811715585068
STAT,1833,25,20-24,1858,11.138933388371303
STAT,1865,52,20-24,1917,6.769276630285624E-4
STAT,1824,40,na,1864,1401.0462847123088
SIM,1819,41,45-49,1860,2
STAT,1878,32,45-49,1910,1.8283186993301832
STAT,1956,14,na,1970,5248.97355217196
STAT,1884,43,25-29,1927,0.6349649757302671
STAT,1775,97,na,1872,0.6782451855123213
STAT,1898,35,na,1933,3256.4606442261447
SIM,1841,25,20-24,1866,14
STAT,1914,35,50-100,1949,0.42696696892416974
SIM,1935,21,na,1956,5271
SIM,1844,16,35-39,1860,1
STAT,1816,40,50-100,1856,3.2703799878174755
STAT,1887,44,20-24,1931,0.1766675622705454
STAT,1864,50,45-49,1914,0.01341649736693217
STAT,1865,46,35-39,1911,0.1294824243884418
STAT,1817,52,25-29,1869,0.007293161039348295
SIM,1869,34,40-44,1903,8
STAT,1852,46,na,1898,1711.1055174061305
SIM,1900,31,35-39,1931,3
STAT,1872,75,na,1947,1045.3372946837635
STAT,1933,21,35-39,1954,12.659178415814369
SIM,1886,32,45-49,1918,2
STAT,1910,40,50-100,1950,0.1132868545293116
SIM,1823,75,na,1898,622
SIM,1837,18,15-19,1855,9
STAT,1826,30,30-34,1856,27.91500096542548
SIM,1854,76,na,1930,881
STAT,1909,25,40-44,1934,4.563967553420159
SIM,1873,18,na,1891,2455
STAT,1887,43,na,1930,2587.4331090614673
STAT,1835,32,na,1867,2070.8004377366874
STAT,1945,22,na,1967,4041.935909092251
STAT,1851,42,50-100,1893,0.7989476257565361
STAT,1862,46,15-19,1908,3.4987838491360004E-4
STAT,1822,99,na,1921,1.058905731828631
STAT,1837,98,na,1935,2.21608845618556
STAT,1848,19,30-34,1867,1.59424158020666
SIM,1852,10,na,1862,2223
STAT,1829,89,na,1918,61.943539342355976
STAT,1842,103,na,1945,0.12921155868663178
SIM,1880,36,30-34,1916,9
SIM,1939,17,40-44,1956,1
STAT,1883,31,15-19,1914,0.14132686293929655
STAT,1838,32,15-19,1870,0.11845915205470373
STAT,1862,31,50-100,1893,0.8024338797977105
STAT,1869,18,50-100,1887,0.048486887727251925
STAT,1893,41,40-44,1934,2.8976166038050186
STAT,1838,29,15-19,1867,0.38081870269628254
SIM,1893,31,40-44,1924,6
STAT,1816,40,15-19,1856,0.04275006832412658
SIM,1826,40,40-44,1866,7
SIM,1915,20,na,1935,4122
STAT,1883,51,25-29,1934,0.0035175741155556712
STAT,1864,19,20-24,1883,16.51831499769347
STAT,1826,50,40-44,1876,0.010410312956523594
STAT,1916,39,50-100,1955,0.4295301246586639
SIM,1852,64,na,1916,1189
STAT,1844,49,na,1893,1742.8726262770022
STAT,1856,41,20-24,1897,0.12353271552387611
STAT,1887,11,na,1898,2916.5015363773045
STAT,1910,23,na,1933,3604.4835580935373
STAT,1935,30,35-39,1965,12.787973067299061
SIM,1925,11,na,1936,4859
SIM,1831,81,na,1912,339
STAT,1899,45,35-39,1944,0.11055804829873245
STAT,1810,99,na,1909,0.9835990761705038
STAT,1936,35,20-24,1971,0.2617201792243995
STAT,1904,32,50-100,1936,0.7625511580509925
STAT,1927,45,50-100,1972,0.28831408370436173
STAT,1866,37,45-49,1903,1.864373699313201
STAT,1922,42,25-29,1964,0.08280205322260417
SIM,1861,40,35-39,1901,2
STAT,1928,21,na,1949,4622.436625063713
STAT,1912,30,40-44,1942,3.9161729303498696
SIM,1862,44,50-100,1906,1
SIM,1870,31,50-100,1901,1
STAT,1863,43,20-24,1906,0.14109351283991833
SIM,1891,19,25-29,1910,8
STAT,1863,81,na,1944,483.9246222593675
SIM,1903,19,na,1922,3457
STAT,1872,48,25-29,1920,0.05775333576090259
SIM,1825,87,na,1912,50
SIM,1837,23,40-44,1860,2
STAT,1850,31,na,1881,1931.4186746182083
STAT,1867,96,na,1963,23.291249950545918
STAT,1901,43,35-39,1944,0.17675317670947496
STAT,1800,81,na,1881,185.6974036694046
STAT,1905,23,25-29,1928,83.32584800389806
SIM,1874,37,45-49,1911,1
STAT,1842,54,40-44,1896,0.009217758580123669
STAT,1832,91,na,1923,39.45806992542869
STAT,1872,54,50-100,1926,0.014913927102490634
SIM,1865,31,na,1896,2156
STAT,1892,20,25-29,1912,72.98478271879381
SIM,1792,72,na,1864,396
STAT,1859,18,35-39,1877,0.5143585305963608
STAT,1829,57,na,1886,1213.6871445958047
STAT,1881,26,30-34,1907,24.600360966598338
STAT,1797,106,na,1903,0.003031456805520972
SIM,1901,24,45-49,1925,2
SIM,1925,22,50-100,1947,5
STAT,1911,48,30-34,1959,0.08490705916348287
STAT,1870,47,20-24,1917,0.011845974144535958
SIM,1850,86,na,1936,215
STAT,1841,37,40-44,1878,3.8568975638654788
STAT,1853,52,35-39,1905,0.0070815892030903355
SIM,1822,35,30-34,1857,6
STAT,1910,21,40-44,1931,3.195318096924867
STAT,1868,18,45-49,1886,0.06381876574539898
SIM,1801,74,na,1875,267
STAT,1865,96,na,1961,17.843149479801276
SIM,1882,38,50-100,1920,1
STAT,1918,15,40-44,1933,0.3097980716577815
STAT,1856,0,na,1856,3081.011437751713
STAT,1845,41,45-49,1886,1.1279657665090481
STAT,1876,59,na,1935,2026.7278712092518
SIM,1803,84,na,1887,113
SIM,1852,42,40-44,1894,9
SIM,1835,94,na,1929,4
STAT,1962,1,na,1963,5094.813844563823
STAT,1865,19,na,1884,2372.0635194792317
SIM,1937,21,na,1958,3373
SIM,1856,39,25-29,1895,3
STAT,1849,51,25-29,1900,0.002782583231770933
STAT,1768,95,na,1863,4.315386598193729
STAT,1878,69,na,1947,1538.6528663696904
STAT,1925,35,45-49,1960,0.8283302795747904
SIM,1807,77,na,1884,416
SIM,1832,30,20-24,1862,2
STAT,1933,7,na,1940,5407.262188877152
STAT,1876,56,na,1932,2127.017938306479
STAT,1808,87,na,1895,66.42147606638345
STAT,1860,42,25-29,1902,0.5295291602562513
STAT,1793,91,na,1884,18.421304746500237
STAT,1878,37,na,1915,2470.135505878974
STAT,1866,49,na,1915,2060.1918626118622
SIM,1788,68,na,1856,578
SIM,1914,32,30-34,1946,31
STAT,1860,49,45-49,1909,0.19077959272660555
STAT,1843,33,35-39,1876,8.126604080992463
STAT,1859,41,40-44,1900,1.8354342813625537
SIM,1849,29,40-44,1878,3
SIM,1859,22,na,1881,2263
STAT,1909,40,35-39,1949,0.19221358265954053
SIM,1829,29,20-24,1858,12
SIM,1871,56,na,1927,1900
STAT,1844,42,40-44,1886,1.8225986183571266
STAT,1920,46,15-19,1966,4.122276601171988E-4
STAT,1813,51,45-49,1864,0.04094821503547462
STAT,1860,30,30-34,1890,14.531077846239405
STAT,1891,21,20-24,1912,86.43373623628831
STAT,1841,45,35-39,1886,0.10789826017560523
STAT,1879,33,15-19,1912,0.14946425089741458
SIM,1763,92,na,1855,7
STAT,1880,42,45-49,1922,1.5855474725788539
SIM,1850,54,na,1904,1775
STAT,1821,45,15-19,1866,6.035004233968162E-4
STAT,1821,51,na,1872,1469.3904275900627
STAT,1921,43,20-24,1964,0.020058010019972438
STAT,1853,36,20-24,1889,0.6441277786737047
STAT,1848,39,25-29,1887,2.372698692902798
STAT,1824,30,20-24,1854,7.405305517743416
STAT,1856,53,30-34,1909,0.004535326619850191
STAT,1874,44,na,1918,2357.996081993504
STAT,1922,49,45-49,1971,0.25075710563416437
STAT,1793,94,na,1887,4.226275443037208
STAT,1906,32,30-34,1938,14.74835716678011
STAT,1902,49,25-29,1951,0.0454051461249125
STAT,1844,46,na,1890,1785.0923313979729
SIM,1917,47,50-100,1964,1
STAT,1893,29,na,1922,3038.7018776638397
STAT,1910,43,45-49,1953,0.15773872847795326
STAT,1940,25,35-39,1965,15.46946266601856
STAT,1843,39,50-100,1882,0.8616179743121268
SIM,1803,52,na,1855,1144
STAT,1891,48,na,1939,2778.5431532157345
SIM,1859,24,30-34,1883,22
SIM,1929,26,na,1955,4537
STAT,1776,90,na,1866,24.829444680769736
SIM,1913,23,25-29,1936,116
STAT,1879,14,na,1893,2713.1521261894354
STAT,1892,27,45-49,1919,1.407175069477862
SIM,1942,29,50-100,1971,1
SIM,1833,36,45-49,1869,2
SIM,1803,87,na,1890,55
SIM,1920,30,40-44,1950,8
STAT,1822,42,20-24,1864,0.2526683921514933
STAT,1909,19,20-24,1928,26.684862820267423
STAT,1799,85,na,1884,91.49464615428977
STAT,1846,27,na,1873,1986.0188039448153
SIM,1889,41,25-29,1930,1
STAT,1866,22,50-100,1888,0.38449287109289493
SIM,1841,103,na,1944,4
SIM,1786,87,na,1873,52
STAT,1834,51,50-100,1885,0.009406883039476056
STAT,1912,39,40-44,1951,1.4592454050874246
STAT,1851,40,25-29,1891,0.49113973864606913
STAT,1825,36,45-49,1861,3.4333148851752107
STAT,1880,21,45-49,1901,0.7418893991766095
SIM,1920,39,40-44,1959,1
STAT,1900,33,40-44,1933,6.058785192395295
SIM,1949,5,na,1954,4445
STAT,1910,22,45-49,1932,1.0660562647216092
SIM,1889,41,na,1930,2780
SIM,1940,25,35-39,1965,20
STAT,1847,50,45-49,1897,0.011022130485859993
SIM,1796,65,na,1861,962
STAT,1815,52,30-34,1867,0.012617580205184529
STAT,1851,19,na,1870,2088.368160031179
SIM,1847,12,na,1859,2272
STAT,1842,18,25-29,1860,6.512988656815744
SIM,1850,18,25-29,1868,5
STAT,1817,43,35-39,1860,4.241537787709056
STAT,1913,49,50-100,1962,0.22143508934988237
STAT,1937,34,25-29,1971,9.219584754403702
STAT,1920,43,45-49,1963,0.1853255666101926
STAT,1823,45,50-100,1868,0.3478146294294339
SIM,1934,4,na,1938,5599
STAT,1850,34,na,1884,1872.1801795699375
STAT,1883,52,50-100,1935,0.014847659927322534
SIM,1928,34,25-29,1962,16
STAT,1901,42,50-100,1943,0.10374251591491059
SIM,1902,56,na,1958,3080
STAT,1892,63,na,1955,2261.3900682905432
SIM,1960,10,na,1970,5273
STAT,1854,45,50-100,1899,0.18615708587450558
SIM,1878,19,15-19,1897,9
STAT,1943,10,na,1953,4218.732853256557
STAT,1840,25,30-34,1865,22.329213968028643
SIM,1939,11,na,1950,4089
STAT,1921,18,na,1939,4226.34304225214
STAT,1921,24,20-24,1945,126.05185196028923
SIM,1805,65,na,1870,798
STAT,1847,29,50-100,1876,0.5674499404358925
STAT,1890,45,15-19,1935,4.98585533374087E-4
STAT,1831,47,25-29,1878,0.04302435852216989
STAT,1910,26,na,1936,3662.221258792219
STAT,1842,36,45-49,1878,2.1274183032001353
STAT,1887,47,30-34,1934,0.10864723636404415
STAT,1921,25,25-29,1946,74.5915503885192
STAT,1852,12,na,1864,2189.684685504786
STAT,1893,44,45-49,1937,0.1314847589898317
STAT,1897,42,20-24,1939,0.014914585453058056
STAT,1879,18,20-24,1897,18.636911984722186
SIM,1879,34,na,1913,2809
SIM,1915,23,na,1938,4043
SIM,1857,15,30-34,1872,2
SIM,1860,61,na,1921,1631
STAT,1827,46,20-24,1873,0.012472645143078623
SIM,1861,49,na,1910,1903
STAT,1867,54,45-49,1921,0.0134249110300268
SIM,1851,33,35-39,1884,15
SIM,1868,81,na,1949,354
STAT,1890,63,na,1953,2202.1184084843894
STAT,1906,35,35-39,1941,2.2671566039461606
STAT,1927,37,50-100,1964,0.5276147829909923
STAT,1936,19,15-19,1955,43.630320302673944
STAT,1850,20,20-24,1870,64.25338712839785
SIM,1837,75,na,1912,615
SIM,1935,3,na,1938,5535
STAT,1861,26,na,1887,2032.103955471006
STAT,1936,36,25-29,1972,0.9767492793672778
SIM,1869,17,15-19,1886,5
SIM,1947,24,15-19,1971,6
STAT,1900,31,25-29,1931,14.429215023298765
STAT,1892,41,na,1933,2942.4711856157755
STAT,1915,44,40-44,1959,0.2532532349663688
STAT,1939,4,na,1943,4069.7885267685697
STAT,1877,37,20-24,1914,0.8035508554151782
SIM,1938,18,na,1956,3539
STAT,1826,53,45-49,1879,0.013520797592185758
SIM,1849,22,20-24,1871,60
SIM,1944,19,15-19,1963,44
SIM,1922,32,30-34,1954,34
SIM,1895,69,na,1964,2174
STAT,1912,46,15-19,1958,3.580583058547313E-4
STAT,1779,87,na,1866,64.26925628436393
STAT,1883,29,50-100,1912,0.6277347845734876
STAT,1939,24,15-19,1963,5.393276329032935
SIM,1847,34,na,1881,1848
STAT,1825,64,na,1889,1280.1175100685045
SIM,1897,70,na,1967,2104
STAT,1768,107,na,1875,0.01408275831150289
STAT,1849,15,30-34,1864,1.552168721643597
SIM,1794,87,na,1881,115
STAT,1829,46,30-34,1875,0.07316609544707477
SIM,1890,43,30-34,1933,2
STAT,1812,51,35-39,1863,0.019388884432153895
STAT,1883,19,25-29,1902,5.570795841822186
SIM,1860,93,na,1953,6
SIM,1903,32,20-24,1935,2
STAT,1851,26,45-49,1877,0.9914709819734299
SIM,1812,66,na,1878,755
STAT,1896,37,30-34,1933,7.125225534206842
STAT,1893,26,na,1919,3071.0794818915915
SIM,1902,34,na,1936,3695
SIM,1922,29,30-34,1951,68
SIM,1885,2,na,1887,3309
STAT,1943,18,na,1961,3939.8532717757244
STAT,1932,25,35-39,1957,19.889970278165503
SIM,1885,37,20-24,1922,1
STAT,1855,86,na,1941,167.01082823333036
SIM,1856,57,na,1913,1810
SIM,1900,2,na,1902,3901
STAT,1874,18,50-100,1892,0.0505341438001141
STAT,1914,32,30-34,1946,16.00102699602273
STAT,1882,43,30-34,1925,1.1166499937323682
STAT,1898,48,45-49,1946,0.17998379409064158
SIM,1825,43,35-39,1868,5
STAT,1831,54,30-34,1885,0.0037597435529530964
SIM,1923,44,40-44,1967,2
STAT,1901,19,50-100,1920,0.0689935228879313
SIM,1814,92,na,1906,13
SIM,1887,63,na,1950,1875
STAT,1836,19,45-49,1855,0.07286421014473998
STAT,1855,16,50-100,1871,0.044121637252346316
STAT,1882,34,na,1916,2314.6533408200694
STAT,1897,49,40-44,1946,0.12803266067334249
STAT,1884,34,35-39,1918,10.000150489916338
STAT,1820,106,na,1926,0.0061803906567265265
SIM,1892,34,35-39,1926,25
STAT,1870,40,35-39,1910,1.814065537632237
STAT,1833,28,25-29,1861,39.305956759294055
STAT,1854,52,45-49,1906,0.01083339137060834
SIM,1841,28,25-29,1869,45
SIM,1907,42,40-44,1949,1
STAT,1846,46,30-34,1892,0.07366862350048492
SIM,1812,43,50-100,1855,1
SIM,1866,44,35-39,1910,3
STAT,1907,59,na,1966,3107.7438408419953
SIM,1913,17,20-24,1930,46
STAT,1841,51,20-24,1892,5.544671304099216E-4
SIM,1839,68,na,1907,866
SIM,1873,19,30-34,1892,1
STAT,1830,35,15-19,1865,0.05249691355620495
STAT,1934,36,na,1970,5250.6436705283795
STAT,1820,36,na,1856,1435.210569280856
SIM,1933,18,50-100,1951,2
STAT,1874,41,15-19,1915,0.01434660462999874
SIM,1876,30,35-39,1906,16
STAT,1830,68,na,1898,1008.2127737860225
STAT,1921,23,50-100,1944,0.7482927333261271
SIM,1772,84,na,1856,79
SIM,1903,34,20-24,1937,3
STAT,1839,41,20-24,1880,0.13208725713737654
SIM,1917,33,na,1950,3897
SIM,1876,27,35-39,1903,14
STAT,1799,56,na,1855,1068.6236748050967
STAT,1840,18,15-19,1858,5.354403614459377
STAT,1883,17,50-100,1900,0.048422168516044944
SIM,1913,20,20-24,1933,7
SIM,1909,19,20-24,1928,1
STAT,1830,43,na,1873,1670.3892059120471
STAT,1835,104,na,1939,0.05006156837991996
STAT,1869,55,na,1924,2030.4088903880456
SIM,1887,18,20-24,1905,20
STAT,1816,50,na,1866,1467.061546603535
SIM,1843,40,40-44,1883,8
STAT,1925,18,50-100,1943,0.45618835926370777
STAT,1901,37,15-19,1938,0.017160855947679753
STAT,1858,44,35-39,1902,1.4154965662361638
SIM,1862,31,45-49,1893,1
STAT,1827,90,na,1917,46.88323014907917
SIM,1906,44,40-44,1950,1
STAT,1866,30,25-29,1896,9.656216299438336
STAT,1839,29,30-34,1868,22.169315311684688
STAT,1881,45,30-34,1926,0.09518068002718477
STAT,1925,33,45-49,1958,1.8872773071935318
STAT,1856,16,50-100,1872,0.04512342151830981
STAT,1863,46,25-29,1909,0.051691997827262595
STAT,1865,19,30-34,1884,1.4969711702204938
STAT,1867,15,25-29,1882,5.576012401501699
STAT,1805,54,20-24,1859,0.002913755926286951
SIM,1891,16,20-24,1907,23
SIM,1924,21,35-39,1945,10
SIM,1863,27,na,1890,2208
SIM,1781,80,na,1861,148
STAT,1843,30,30-34,1873,14.454113284380345
STAT,1835,35,na,1870,2028.9909256439448
SIM,1826,80,na,1906,459
STAT,1940,22,30-34,1962,29.558268895949006
STAT,1835,40,40-44,1875,2.0761076632788127
STAT,1872,45,20-24,1917,0.01230653083212821
STAT,1843,83,na,1926,267.7549414581308
STAT,1881,33,50-100,1914,0.8882606750299717
STAT,1814,54,30-34,1868,0.013170361889267148
STAT,1813,107,na,1920,0.002067751831487684
SIM,1857,41,na,1898,2022
STAT,1952,8,na,1960,4758.44943647536
STAT,1915,47,45-49,1962,0.22098670473897492
STAT,1845,42,na,1887,1719.72680191858
STAT,1856,51,50-100,1907,0.01175071253885352
STAT,1931,26,50-100,1957,1.2993095392773766
STAT,1921,49,35-39,1970,0.145934459686615
SIM,1862,42,na,1904,2122
STAT,1894,37,20-24,1931,1.0023620711209185
SIM,1830,32,na,1862,1639
STAT,1829,30,50-100,1859,0.8605482628402394
SIM,1787,83,na,1870,94
STAT,1841,42,30-34,1883,0.8933760275653647
SIM,1841,72,na,1913,839
STAT,1836,47,50-100,1883,0.16214317526487448
STAT,1822,45,25-29,1867,0.08783190478775557
SIM,1844,47,50-100,1891,1
STAT,1860,46,40-44,1906,0.1417485776436852
STAT,1860,33,35-39,1893,8.325890489519724
SIM,1828,28,na,1856,1751
STAT,1834,52,25-29,1886,0.0021629114249067985
STAT,1930,36,30-34,1966,2.40498474248896
STAT,1916,21,35-39,1937,9.987118231951046
SIM,1803,55,na,1858,1052
STAT,1904,48,na,1952,3220.586112477299
STAT,1814,72,na,1886,647.8766198976988
STAT,1816,53,50-100,1869,0.03676814580147963
STAT,1911,36,20-24,1947,0.25810952852614444
SIM,1898,58,na,1956,2727
SIM,1914,35,35-39,1949,4
STAT,1886,48,50-100,1934,0.2586152608340135
STAT,1910,40,40-44,1950,0.2411973398120029
STAT,1867,45,na,1912,2161.4337270421142
STAT,1909,37,na,1946,3593.45361870517
STAT,1827,79,na,1906,415.729029099241
STAT,1821,49,30-34,1870,0.13782987735067073
STAT,1870,32,40-44,1902,4.301104434237073
SIM,1866,29,40-44,1895,3
SIM,1813,62,na,1875,1021
STAT,1858,29,40-44,1887,2.395121419154678
SIM,1890,38,40-44,1928,9
STAT,1894,35,50-100,1929,1.6116392762473433
STAT,1925,32,40-44,1957,4.696387203311354
SIM,1775,95,na,1870,4
STAT,1903,40,40-44,1943,0.226939015416858
SIM,1907,23,na,1930,3651
STAT,1876,88,na,1964,302.1511213012905
SIM,1849,25,25-29,1874,58
STAT,1940,19,30-34,1959,12.48563640360984
SIM,1884,74,na,1958,1238
STAT,1915,46,40-44,1961,0.16070755395757752
SIM,1839,18,25-29,1857,7
SIM,1861,46,na,1907,1950
STAT,1853,93,na,1946,24.168714684260475
STAT,1905,17,20-24,1922,25.885368440870522
SIM,1926,26,50-100,1952,2
SIM,1901,21,40-44,1922,2
STAT,1892,24,40-44,1916,2.6244429848092707
STAT,1777,87,na,1864,41.06637869536182
SIM,1901,22,45-49,1923,4
STAT,1843,61,na,1904,1260.3345056116934
STAT,1861,30,40-44,1891,3.6689765182129945
STAT,1838,31,na,1869,1821.6055916767784
STAT,1925,41,30-34,1966,0.15665026569747426
STAT,1918,34,15-19,1952,0.13668062691461264
STAT,1899,42,30-34,1941,0.1105276327497786
SIM,1838,38,na,1876,1778
STAT,1877,50,30-34,1927,0.006294245954832589
STAT,1831,44,20-24,1875,0.11963329177319268
STAT,1854,31,45-49,1885,1.3541921026774322
STAT,1843,86,na,1929,149.64833945970375
STAT,1818,94,na,1912,10.296962828443503
STAT,1840,21,15-19,1861,2.96217590964383
STAT,1850,47,35-39,1897,0.10670016273098826
SIM,1950,18,na,1968,4248
STAT,1905,20,20-24,1925,101.21924774478406
SIM,1894,33,na,1927,3432
STAT,1921,22,20-24,1943,126.84592952493787
STAT,1830,51,45-49,1881,0.010888779320358232
STAT,1819,79,na,1898,355.3991866423497
SIM,1849,12,na,1861,2446
SIM,1836,79,na,1915,594
STAT,1852,43,45-49,1895,1.126840583926953
STAT,1868,24,30-34,1892,17.08639668661763
STAT,1838,17,20-24,1855,15.676229705017239
STAT,1929,43,30-34,1972,0.16707880629351754
SIM,1855,19,20-24,1874,22
STAT,1873,40,45-49,1913,1.54788691382935
STAT,1891,48,35-39,1939,0.09751151096503596
SIM,1874,96,na,1970,52
STAT,1909,15,na,1924,3839.779262412437
STAT,1797,75,na,1872,423.8568098346416
STAT,1878,54,20-24,1932,7.523995466855849E-4
STAT,1897,45,25-29,1942,0.044433601884379975
STAT,1910,30,30-34,1940,15.449855241013774
SIM,1904,60,na,1964,3188
SIM,1905,45,na,1950,3489
STAT,1892,41,25-29,1933,0.8175389676194078
STAT,1900,36,45-49,1936,0.6065884163554971
SIM,1812,69,na,1881,707
STAT,1817,40,30-34,1857,3.072514109959223
STAT,1937,32,na,1969,3777.494344832754
SIM,1915,52,na,1967,4032
STAT,1805,76,na,1881,457.96856073398806
SIM,1835,26,35-39,1861,8
SIM,1916,37,na,1953,3858
STAT,1882,38,40-44,1920,4.261476936820156
SIM,1940,22,30-34,1962,39
STAT,1855,32,15-19,1887,0.1091448171853344
STAT,1816,39,na,1855,1602.75316228424
SIM,1851,39,50-100,1890,1
SIM,1938,17,25-29,1955,49
STAT,1859,53,40-44,1912,0.00841467293631214
STAT,1884,31,30-34,1915,17.460856964180604
SIM,1885,59,na,1944,2071
STAT,1922,46,40-44,1968,0.18343257427215098
STAT,1815,47,40-44,1862,0.37985397128577086
STAT,1806,50,50-100,1856,0.04536250317040456
STAT,1868,59,na,1927,1876.0082044188841
SIM,1874,67,na,1941,1547
STAT,1839,16,na,1855,2141.497278379136
STAT,1918,26,50-100,1944,1.0730815050010036
STAT,1856,82,na,1938,361.2963591926937
STAT,1833,40,15-19,1873,0.012190943231804457
STAT,1847,19,20-24,1866,16.372681604957837
STAT,1821,34,50-100,1855,2.311203172217028
STAT,1825,50,25-29,1875,0.004769174564909028
STAT,1859,45,na,1904,1845.8463448229377
SIM,1884,41,40-44,1925,6
SIM,1838,20,na,1858,1922
STAT,1829,39,15-19,1868,0.04451236477265566
SIM,1842,57,na,1899,1396
STAT,1858,35,50-100,1893,0.9820861379979569
SIM,1892,31,30-34,1923,33
STAT,1911,44,15-19,1955,0.001460575197011804
SIM,1833,29,50-100,1862,1
SIM,1854,90,na,1944,82
STAT,1840,36,50-100,1876,1.0285425565137378
STAT,1863,30,na,1893,2152.650676286835
SIM,1885,5,na,1890,2829
STAT,1858,111,na,1969,8.875033271813041E-4
SIM,1881,15,na,1896,2276
STAT,1865,30,na,1895,2218.479951334219
SIM,1877,42,45-49,1919,6
STAT,1839,102,na,1941,0.2078531136414175
STAT,1829,42,15-19,1871,0.01072462587808119
STAT,1871,36,15-19,1907,0.0566180471432905
STAT,1869,42,45-49,1911,1.4678291632348512
STAT,1876,70,na,1946,1463.1860322716973
STAT,1926,40,na,1966,4640.1746455534985
SIM,1951,14,na,1965,4983
SIM,1820,38,25-29,1858,1
STAT,1862,103,na,1965,0.6395250163747612
STAT,1849,18,35-39,1867,0.5249666408613302
SIM,1847,29,30-34,1876,2
STAT,1955,9,na,1964,5270.176380175805
SIM,1939,32,35-39,1971,15
SIM,1927,9,na,1936,5451
STAT,1866,51,25-29,1917,0.0033284553831753284
STAT,1896,33,15-19,1929,0.1895844017931883
SIM,1814,47,na,1861,1343
STAT,1859,4,na,1863,2513.3544158387967
STAT,1900,35,40-44,1935,6.200013601613062
SIM,1922,35,35-39,1957,3
SIM,1872,19,na,1891,2738
STAT,1838,18,50-100,1856,0.043065291761361306
STAT,1842,68,na,1910,1375.8893394632844
STAT,1894,22,na,1916,3075.3563481528354
STAT,1828,41,45-49,1869,1.4536043163120294
STAT,1855,29,15-19,1884,0.35087527715808037
STAT,1872,16,45-49,1888,0.06694230974653763
SIM,1845,53,na,1898,1741
SIM,1885,37,na,1922,2503
SIM,1865,82,na,1947,327
STAT,1922,32,15-19,1954,0.1466798993746604
STAT,1928,40,45-49,1968,0.21504614701586594
STAT,1809,50,40-44,1859,0.03526077412774449
STAT,1900,47,50-100,1947,0.19346538605162691
SIM,1851,30,30-34,1881,23
STAT,1876,41,40-44,1917,2.3562549070288097
STAT,1895,32,45-49,1927,2.300037603194032
STAT,1846,49,35-39,1895,0.1040255925457127
SIM,1935,29,na,1964,4978
STAT,1936,33,20-24,1969,2.390379014248352
STAT,1939,28,30-34,1967,39.74672607604412
STAT,1774,98,na,1872,0.36851926676418656
STAT,1918,29,na,1947,3996.12635363758
STAT,1914,35,35-39,1949,2.459720334524128
SIM,1889,44,na,1933,2736
SIM,1883,20,25-29,1903,72
STAT,1930,22,50-100,1952,0.8519762360129127
STAT,1939,1,na,1940,4210.846005565082
STAT,1817,102,na,1919,0.1341341049446331
STAT,1901,18,40-44,1919,0.2582861683806695
STAT,1818,52,40-44,1870,0.01800550621034792
STAT,1875,53,25-29,1928,0.003614850299109737
SIM,1857,18,35-39,1875,2
SIM,1881,40,45-49,1921,4
STAT,1867,74,na,1941,1055.6552220744113
STAT,1894,20,35-39,1914,7.633355932674557
SIM,1928,28,20-24,1956,39
STAT,1842,15,20-24,1857,20.740410787584445
STAT,1882,52,20-24,1934,7.18098369736584E-4
STAT,1856,48,40-44,1904,0.130902356801915
STAT,1910,24,45-49,1934,1.0593825672238728
SIM,1878,24,40-44,1902,2
STAT,1882,46,35-39,1928,0.13735753898265085
STAT,1932,22,30-34,1954,38.10997008554903
STAT,1844,50,35-39,1894,0.006909233586582545
STAT,1944,24,15-19,1968,5.799897504329603
STAT,1860,54,35-39,1914,0.006912406220894126
SIM,1836,41,45-49,1877,3
SIM,1928,31,20-24,1959,3
STAT,1916,48,15-19,1964,3.8023411075283775E-4
SIM,1874,45,na,1919,2199
SIM,1822,76,na,1898,464
STAT,1871,6,na,1877,2768.6488695967573
SIM,1950,9,na,1959,4537
SIM,1850,83,na,1933,260
SIM,1851,3,na,1854,2724
STAT,1904,46,30-34,1950,0.07936769562406801
STAT,1900,16,na,1916,3552.1563544678274
STAT,1837,53,20-24,1890,4.953400065892328E-4
STAT,1907,37,na,1944,3522.0247734580553
SIM,1827,68,na,1895,820
SIM,1873,31,20-24,1904,2
STAT,1857,67,na,1924,1249.5389677513836
STAT,1874,41,50-100,1915,1.0975151739955962
STAT,1894,17,35-39,1911,0.7135059052573517
STAT,1789,97,na,1886,1.2080094303336704
STAT,1836,22,50-100,1858,0.33950900620023183
STAT,1885,43,40-44,1928,2.2449468606784686
STAT,1949,17,35-39,1966,4.930331918974583
STAT,1918,11,na,1929,4360.477665091955
STAT,1919,39,na,1958,4072.193416189055
STAT,1909,35,50-100,1944,0.4048315556988563
SIM,1859,27,40-44,1886,9
SIM,1882,20,45-49,1902,5
STAT,1847,16,15-19,1863,5.578681634441762
SIM,1854,22,na,1876,2529
SIM,1942,25,40-44,1967,8
STAT,1913,15,25-29,1928,8.981206771516218
STAT,1765,109,na,1874,0.0025861222463331077
STAT,1831,39,40-44,1870,3.423439144874682
STAT,1923,37,30-34,1960,2.13372918430495
STAT,1889,43,na,1932,2857.6116257981676
STAT,1927,34,na,1961,4696.300889924029
SIM,1912,32,50-100,1944,2
STAT,1878,91,na,1969,203.29607873120034
SIM,1920,34,20-24,1954,4
SIM,1872,6,na,1878,3026
STAT,1878,16,45-49,1894,0.06865589898649871
STAT,1882,42,50-100,1924,1.0323046305831671
SIM,1869,75,na,1944,1028
STAT,1811,107,na,1918,0.0020558853232808087
STAT,1912,34,20-24,1946,2.400739748900289
SIM,1850,32,na,1882,2067
STAT,1885,53,na,1938,2129.9631309778706
STAT,1937,31,15-19,1968,0.12842416250353392
SIM,1869,30,25-29,1899,15
STAT,1853,20,na,1873,2119.5077436042093
STAT,1916,41,25-29,1957,0.07395594602430734
STAT,1893,15,30-34,1908,2.053541213668611
STAT,1812,46,na,1858,1408.3852811242139
STAT,1946,24,20-24,1970,124.89055100951602
SIM,1928,2,na,1930,5246
SIM,1846,27,na,1873,1899
SIM,1933,32,35-39,1965,1
STAT,1955,17,25-29,1972,58.1183174188837
STAT,1902,27,15-19,1929,0.6475515122538626
STAT,1899,73,na,1972,2103.606272894705
STAT,1906,38,40-44,1944,1.3830713095211578
SIM,1920,44,na,1964,4385
STAT,1865,50,50-100,1915,0.014128761240983917
STAT,1871,36,50-100,1907,1.237876237903422
STAT,1929,25,30-34,1954,49.75290494643876
SIM,1880,30,na,1910,2294
SIM,1882,65,na,1947,1344
SIM,1950,0,na,1950,4772
STAT,1927,28,30-34,1955,47.97711013716059
STAT,1864,45,30-34,1909,0.08910181688890402
SIM,1919,29,30-34,1948,58
SIM,1900,25,35-39,1925,1
STAT,1822,48,30-34,1870,0.14152463617202757
STAT,1932,28,40-44,1960,6.166620280694065
STAT,1908,35,40-44,1943,1.4282760530580678
SIM,1907,54,na,1961,3424
SIM,1929,30,20-24,1959,3
SIM,1914,38,40-44,1952,2
SIM,1938,27,50-100,1965,1
SIM,1912,42,45-49,1954,3
SIM,1905,29,30-34,1934,46
STAT,1914,44,25-29,1958,0.07115388609302865
STAT,1925,32,35-39,1957,10.966966188434558
SIM,1883,36,50-100,1919,4
STAT,1926,27,50-100,1953,1.2059167327531854
SIM,1890,60,na,1950,2626
SIM,1935,28,30-34,1963,8
SIM,1901,26,50-100,1927,3
STAT,1901,34,45-49,1935,2.4478650004027878
SIM,1875,46,50-100,1921,1
SIM,1937,27,25-29,1964,92
SIM,1855,63,na,1918,1612
SIM,1871,14,na,1885,2536
STAT,1805,49,40-44,1854,0.7142188728872962
STAT,1933,27,45-49,1960,2.318035659439004
SIM,1868,30,35-39,1898,11
SIM,1902,20,40-44,1922,4
STAT,1868,81,na,1949,521.9950412138132
STAT,1859,33,25-29,1892,8.285319660925724
STAT,1884,12,na,1896,2572.1661822801448
SIM,1859,45,na,1904,2130
SIM,1903,19,25-29,1922,9
STAT,1859,31,30-34,1890,14.24111090616624
STAT,1938,2,na,1940,4072.861789551449
STAT,1904,42,45-49,1946,0.15045229505980728
STAT,1928,28,20-24,1956,22.719771918378807
STAT,1842,76,na,1918,852.9804222804928
STAT,1902,45,45-49,1947,0.19189631281436656
STAT,1913,22,na,1935,3731.0343022623265
STAT,1869,23,40-44,1892,2.0398909788523754
STAT,1875,31,15-19,1906,0.14831135675252521
STAT,1902,50,na,1952,3117.3778448599965
SIM,1942,23,45-49,1965,2
SIM,1863,50,na,1913,1995
STAT,1930,30,20-24,1960,3.185186262403933
STAT,1900,32,50-100,1932,1.2855027307006772
SIM,1808,61,na,1869,915
STAT,1850,50,25-29,1900,0.0027511432003400377
SIM,1941,27,45-49,1968,1
STAT,1900,31,20-24,1931,3.8079198012623148
SIM,1804,71,na,1875,693
SIM,1937,25,30-34,1962,72
STAT,1937,33,50-100,1970,0.8252849388945805
SIM,1936,28,20-24,1964,2
STAT,1827,99,na,1926,1.1262045289073412
STAT,1904,22,20-24,1926,99.88306451396886
STAT,1929,27,25-29,1956,83.26084563004648
SIM,1910,30,45-49,1940,2
STAT,1899,53,na,1952,2936.776645734441
SIM,1886,55,na,1941,2321
STAT,1934,25,40-44,1959,6.341150265188055
STAT,1853,32,50-100,1885,0.7802880420639373
SIM,1893,9,na,1902,3416
STAT,1865,30,45-49,1895,1.6211778301245636
SIM,1863,19,na,1882,2384
SIM,1838,83,na,1921,218
SIM,1879,73,na,1952,1372
STAT,1912,18,15-19,1930,9.234410044570033
SIM,1943,24,45-49,1967,1
STAT,1794,107,na,1901,9.171074785515628E-4
STAT,1913,33,25-29,1946,9.239025811549483
SIM,1781,89,na,1870,4
STAT,1788,79,na,1867,258.4189614481291
SIM,1867,31,30-34,1898,21
SIM,1920,18,15-19,1938,1
SIM,1905,16,25-29,1921,12
STAT,1945,26,25-29,1971,72.95884970280173
SIM,1880,50,na,1930,2070
STAT,1784,97,na,1881,0.820365036916262
SIM,1900,23,40-44,1923,3
SIM,1925,28,45-49,1953,4
STAT,1917,28,45-49,1945,1.8223506695458092
SIM,1921,33,25-29,1954,5
SIM,1889,34,50-100,1923,1
STAT,1876,17,na,1893,2633.810528041434
STAT,1848,53,na,1901,1729.7458264080838
STAT,1935,24,45-49,1959,1.5469857041222692
STAT,1944,27,20-24,1971,19.922359421295653
STAT,1943,19,50-100,1962,0.400887998883323
STAT,1833,53,50-100,1886,0.010835937833374954
SIM,1877,19,na,1896,2643
STAT,1859,54,50-100,1913,0.011931125033572958
STAT,1919,47,na,1966,4023.2939457409334
STAT,1937,19,30-34,1956,11.935319596138735
SIM,1901,21,35-39,1922,14
SIM,1825,65,na,1890,777
STAT,1902,30,45-49,1932,2.5088937927658996
SIM,1852,20,30-34,1872,27
STAT,1867,20,na,1887,2291.7451589559873
STAT,1913,45,20-24,1958,0.010934316763278799
SIM,1932,21,na,1953,5897
SIM,1872,55,na,1927,2297
SIM,1849,35,30-34,1884,5
SIM,1835,20,30-34,1855,17
STAT,1896,25,na,1921,3212.239551377653
SIM,1932,36,35-39,1968,7
STAT,1868,24,35-39,1892,5.597672492789736
STAT,1904,42,15-19,1946,0.0013882565686066629
SIM,1843,50,na,1893,1996
SIM,1921,17,20-24,1938,200
STAT,1860,20,15-19,1880,3.1302944381527014
STAT,1934,23,45-49,1957,1.5273637517708036
SIM,1805,96,na,1901,2
STAT,1934,38,15-19,1972,0.026749347186636494
STAT,1810,109,na,1919,3.6950385467593997E-4
STAT,1912,1,na,1913,4246.464202870458
SIM,1928,16,na,1944,4617
SIM,1914,36,na,1950,3954
STAT,1770,101,na,1871,0.06898638486233577
STAT,1910,21,35-39,1931,8.948140888817301
SIM,1852,22,25-29,1874,59
STAT,1845,33,na,1878,1863.434775388027
SIM,1915,34,40-44,1949,7
SIM,1921,30,20-24,1951,3
STAT,1909,34,45-49,1943,1.502306902865505
SIM,1894,42,na,1936,3270
STAT,1840,44,30-34,1884,0.8194072323194245
STAT,1907,34,40-44,1941,3.6618272941799526
STAT,1902,8,na,1910,3710.2285072198197
SIM,1912,22,20-24,1934,135
STAT,1877,17,40-44,1894,0.19066241305658463
SIM,1891,14,na,1905,3370
SIM,1867,40,na,1907,2097
SIM,1875,83,na,1958,406
STAT,1864,32,50-100,1896,0.8350544461820805
STAT,1839,22,15-19,1861,3.0052329287877493
STAT,1913,17,20-24,1930,27.968033565996045
STAT,1853,26,50-100,1879,0.6172671249552362
SIM,1840,22,na,1862,1922
STAT,1928,26,25-29,1954,82.24386750195983
STAT,1844,22,25-29,1866,56.54979326583831
STAT,1858,35,30-34,1893,4.263193086981497
STAT,1922,33,50-100,1955,0.9397503365177938
SIM,1886,75,na,1961,1423
STAT,1912,16,20-24,1928,27.72673540222972
STAT,1907,36,35-39,1943,2.2752355099090456
SIM,1888,41,45-49,1929,1
STAT,1947,20,20-24,1967,127.02791706765606
SIM,1837,20,35-39,1857,3
STAT,1915,45,25-29,1960,0.0541895898106158
SIM,1932,34,40-44,1966,10
STAT,1843,104,na,1947,0.044987029286409214
STAT,1924,34,40-44,1958,4.60761754248781
STAT,1933,29,40-44,1962,6.247799467783179
SIM,1874,42,na,1916,2251
SIM,1903,44,na,1947,3068
STAT,1927,45,20-24,1972,0.01408700790486013
SIM,1847,22,15-19,1869,4
SIM,1941,29,40-44,1970,6
STAT,1917,38,15-19,1955,0.02003330891623382
STAT,1930,32,15-19,1962,0.16761846181431658
SIM,1920,16,20-24,1936,179
SIM,1936,26,25-29,1962,8
STAT,1885,20,20-24,1905,69.6936957513328
STAT,1904,40,20-24,1944,0.016145920054274124
SIM,1926,24,45-49,1950,4
SIM,1858,49,50-100,1907,2
SIM,1915,36,35-39,1951,4
STAT,1819,43,50-100,1862,2.1938064569624185
STAT,1869,25,35-39,1894,9.539127675123288
STAT,1918,39,15-19,1957,0.020390998727142184
STAT,1861,51,50-100,1912,0.012736084524067824
SIM,1808,53,na,1861,1158
STAT,1928,44,25-29,1972,0.09170737650193202
STAT,1846,58,na,1904,1500.7688334083596
STAT,1889,31,45-49,1920,2.1806211607529775
SIM,1819,45,na,1864,1465
STAT,1839,16,50-100,1855,0.04570621307657322
STAT,1904,24,15-19,1928,4.751733393396069
STAT,1918,37,20-24,1955,0.2805099343388144
SIM,1856,17,na,1873,2423
STAT,1923,19,30-34,1942,14.383710164637936
SIM,1893,20,20-24,1913,84
STAT,1812,109,na,1921,3.230105971767722E-4
STAT,1953,18,30-34,1971,14.892373109897102
SIM,1836,21,30-34,1857,20
SIM,1916,35,40-44,1951,2
STAT,1919,36,25-29,1955,1.0689824631598794
STAT,1940,24,na,1964,3753.0532847418895
STAT,1928,29,30-34,1957,48.74377598641316
SIM,1897,31,45-49,1928,6
SIM,1848,81,na,1929,361
STAT,1943,18,45-49,1961,0.5347044784118752
SIM,1941,26,35-39,1967,26
SIM,1915,18,35-39,1933,4
STAT,1811,84,na,1895,145.0220695462144
SIM,1931,19,30-34,1950,28
STAT,1851,30,15-19,1881,0.114586152074719
STAT,1943,28,15-19,1971,0.7587906075721196
SIM,1831,44,30-34,1875,3
SIM,1890,80,na,1970,1442
SIM,1945,19,30-34,1964,20
SIM,1879,0,na,1879,3613
STAT,1844,20,30-34,1864,17.85119840344409
STAT,1916,42,50-100,1958,0.12149425480286921
STAT,1946,3,na,1949,4485.260640081255
SIM,1835,63,na,1898,998
SIM,1880,7,na,1887,2578
STAT,1862,96,na,1958,11.487323806880065
SIM,1828,81,na,1909,314
STAT,1908,33,45-49,1941,1.4930524800120322
SIM,1900,22,30-34,1922,2
STAT,1907,18,35-39,1925,0.8117283761169097
SIM,1839,45,na,1884,1549
SIM,1956,6,na,1962,5294
SIM,1930,36,30-34,1966,7
STAT,1839,40,45-49,1879,1.2608291604651904
SIM,1829,39,50-100,1868,1
STAT,1866,100,na,1966,4.812093272243258
STAT,1858,51,na,1909,1714.3044271391313
SIM,1934,36,na,1970,5359
STAT,1860,10,na,1870,2301.6372759121627
STAT,1876,30,20-24,1906,2.8415241771550255
STAT,1868,100,na,1968,6.233604215574907
SIM,1903,64,na,1967,2501
SIM,1916,33,45-49,1949,2
STAT,1868,9,na,1877,2631.1424683220175
SIM,1863,9,na,1872,2641
STAT,1924,36,35-39,1960,2.884733580031569
STAT,1938,18,35-39,1956,4.177380178535021
STAT,1868,32,50-100,1900,0.8844434695725413
SIM,1859,40,50-100,1899,1
SIM,1946,18,35-39,1964,8
STAT,1810,49,20-24,1859,0.04463273827621496
STAT,1865,33,na,1898,2191.5023585434055
SIM,1927,36,25-29,1963,1
STAT,1834,30,15-19,1864,0.11091591239879722
SIM,1847,40,45-49,1887,1
STAT,1890,35,30-34,1925,6.6400239808226
STAT,1922,36,30-34,1958,2.096977754442392
STAT,1938,30,20-24,1968,2.478769985237259
SIM,1912,24,15-19,1936,4
STAT,1771,90,na,1861,22.73876025587066
STAT,1880,45,15-19,1925,4.285137696115811E-4
SIM,1935,29,15-19,1964,1
STAT,1886,27,na,1913,2544.9716765428307
STAT,1849,15,na,1864,2235.386187921984
STAT,1823,44,30-34,1867,1.620748692128325
STAT,1807,79,na,1886,291.67355090167854
STAT,1867,25,30-34,1892,24.116084034170285
SIM,1887,60,na,1947,2076
SIM,1925,25,40-44,1950,10
STAT,1904,0,na,1904,4255.98133827245
STAT,1906,37,30-34,1943,1.6922729171293427
STAT,1888,49,35-39,1937,0.0921774026643396
STAT,1915,32,50-100,1947,0.849680882952811
STAT,1905,23,20-24,1928,100.30798570097473
STAT,1852,15,na,1867,2130.5094865969345
STAT,1920,40,35-39,1960,0.22520720790292068
STAT,1840,47,40-44,1887,0.1210195862339667
STAT,1860,2,na,1862,2851.7165540941396
SIM,1923,32,50-100,1955,2
SIM,1858,83,na,1941,246
STAT,1927,29,15-19,1956,0.8639632277347966
SIM,1946,15,30-34,1961,18
SIM,1915,39,40-44,1954,1
STAT,1916,42,35-39,1958,0.20824750604019351
SIM,1936,29,30-34,1965,45
SIM,1939,0,na,1939,4308
SIM,1902,59,na,1961,2975
SIM,1876,24,35-39,1900,5
SIM,1839,16,30-34,1855,2
SIM,1869,35,na,1904,2285
STAT,1844,71,na,1915,1056.0731550823596
STAT,1859,48,50-100,1907,0.1970027718143529
STAT,1930,15,25-29,1945,56.88954527923054
SIM,1822,39,40-44,1861,3
STAT,1879,27,50-100,1906,0.6742356643066544
SIM,1931,36,na,1967,4950
SIM,1914,37,30-34,1951,4
STAT,1905,47,na,1952,3270.2780180920586
STAT,1942,17,45-49,1959,0.5270830918781269
SIM,1895,20,25-29,1915,90
SIM,1879,65,na,1944,2008
SIM,1851,93,na,1944,19
STAT,1762,110,na,1872,0.0012897934955469288
STAT,1826,38,na,1864,1539.8823875263108
STAT,1860,41,na,1901,1916.8551749148248
SIM,1922,4,na,1926,5229
STAT,1878,51,na,1929,2268.3002163870415
STAT,1937,24,na,1961,3587.6337390204544
STAT,1839,110,na,1949,1.9591620674999728E-4
STAT,1933,26,35-39,1959,20.1536222334269
SIM,1851,24,30-34,1875,32
STAT,1900,55,na,1955,2901.025196437143
STAT,1914,43,15-19,1957,0.0015328737300001538
STAT,1801,54,na,1855,1184.0965558067853
STAT,1893,18,35-39,1911,0.7018437034981
STAT,1922,23,25-29,1945,106.67964422151256
SIM,1930,23,25-29,1953,150
STAT,1903,28,15-19,1931,0.6503145566820592
STAT,1907,34,na,1941,3538.989403266789
STAT,1843,24,30-34,1867,14.864023449598394
SIM,1824,71,na,1895,697
SIM,1908,41,40-44,1949,1
STAT,1919,38,20-24,1957,0.2856499652610333
STAT,1873,20,na,1893,2436.044520262524
STAT,1887,20,25-29,1907,64.93794063332668
STAT,1924,14,na,1938,4752.553165403565
SIM,1826,30,30-34,1856,28
STAT,1889,23,50-100,1912,0.5062905206135203
SIM,1866,55,na,1921,2071
SIM,1843,49,50-100,1892,1
STAT,1852,17,35-39,1869,0.5033014407421229
STAT,1828,61,na,1889,1231.559850423842
STAT,1832,37,35-39,1869,6.10343081640831
SIM,1933,35,40-44,1968,2
STAT,1916,27,45-49,1943,1.8026674980327293
SIM,1822,37,na,1859,1721
STAT,1908,32,35-39,1940,8.70749260691799
STAT,1885,21,30-34,1906,17.961424087088556
STAT,1901,15,35-39,1916,0.7805034848208039
STAT,1953,19,15-19,1972,55.43026866841747
STAT,1862,47,20-24,1909,0.01041784800171939
STAT,1897,10,na,1907,3507.4537224872215
STAT,1907,39,40-44,1946,1.3873165287258253
SIM,1893,49,na,1942,2857
STAT,1881,48,40-44,1929,0.1645801364100162
SIM,1947,17,40-44,1964,1
STAT,1925,35,40-44,1960,1.8189326859881096
STAT,1939,17,40-44,1956,1.4134260465501494
SIM,1924,27,45-49,1951,4
STAT,1866,27,na,1893,2231.954267742768
STAT,1893,37,50-100,1930,1.574508243976851
STAT,1922,38,25-29,1960,1.1306760141478789
SIM,1858,41,30-34,1899,4
STAT,1822,49,40-44,1871,0.2468152764431088
SIM,1869,7,na,1876,2606
SIM,1925,28,50-100,1953,4
SIM,1930,38,25-29,1968,1
STAT,1954,16,25-29,1970,54.13933830385148
SIM,1893,21,30-34,1914,42
STAT,1888,81,na,1969,1066.5381755991375
SIM,1891,22,na,1913,3075
STAT,1917,25,40-44,1942,4.967488130194232
STAT,1871,81,na,1952,542.6161956000911
STAT,1901,30,25-29,1931,14.618637215165283
STAT,1905,36,50-100,1941,0.38878420978284034
STAT,1794,87,na,1881,59.850997778114326
SIM,1913,23,20-24,1936,105
STAT,1859,15,25-29,1874,5.406955858395734
STAT,1959,5,na,1964,5194.59956444857
SIM,1856,8,na,1864,2596
SIM,1901,24,40-44,1925,3
SIM,1879,45,na,1924,2681
SIM,1921,32,45-49,1953,4
STAT,1911,20,40-44,1931,3.236358075598121
STAT,1921,49,na,1970,4158.331562782097
SIM,1916,32,35-39,1948,17
SIM,1899,26,30-34,1925,47
STAT,1904,25,25-29,1929,61.72843881442117
STAT,1921,42,45-49,1963,0.18932407122432754
SIM,1861,24,na,1885,2092
SIM,1903,48,50-100,1951,1
STAT,1831,84,na,1915,209.04571866353777
STAT,1869,26,45-49,1895,1.0940131017463224
STAT,1913,42,na,1955,3654.2346215650514
SIM,1912,25,25-29,1937,93
STAT,1883,6,na,1889,2595.485838480901
SIM,1904,15,25-29,1919,9
SIM,1855,83,na,1938,370
STAT,1899,36,30-34,1935,7.423161089463112
SIM,1835,22,25-29,1857,57
STAT,1798,104,na,1902,0.022192920329038548
SIM,1892,25,30-34,1917,53
STAT,1930,14,na,1944,5160.771994920244
STAT,1852,35,na,1887,1834.1468859802437
SIM,1900,41,40-44,1941,1
SIM,1921,18,30-34,1939,16
STAT,1934,22,35-39,1956,12.78584129398511
SIM,1928,34,20-24,1962,3
SIM,1909,38,30-34,1947,4
STAT,1926,31,40-44,1957,4.785131254837159
STAT,1924,37,45-49,1961,0.8123156675391963
SIM,1932,33,30-34,1965,26
SIM,1835,23,35-39,1858,4
STAT,1916,45,45-49,1961,0.2260225201240271
SIM,1814,61,na,1875,999
SIM,1846,78,na,1924,440
SIM,1930,39,35-39,1969,9
SIM,1909,46,50-100,1955,1
SIM,1896,17,15-19,1913,10
SIM,1879,20,40-44,1899,2
SIM,1838,91,na,1929,17
STAT,1855,94,na,1949,15.043937285929005
STAT,1862,3,na,1865,2822.3720354151073
SIM,1910,46,na,1956,3197
STAT,1790,97,na,1887,0.8544936530302538
STAT,1863,49,30-34,1912,0.08481665876930457
SIM,1904,33,25-29,1937,13
STAT,1931,39,na,1970,5024.884065971686
SIM,1897,39,na,1936,3226
SIM,1898,15,25-29,1913,10
SIM,1840,37,35-39,1877,12
STAT,1900,19,35-39,1919,0.7657165269890993
STAT,1859,25,na,1884,2000.7484818707992
SIM,1932,32,20-24,1964,4
STAT,1872,35,na,1907,2415.0284685457646
STAT,1924,33,30-34,1957,18.562808124638813
STAT,1936,35,15-19,1971,0.019065710819087367
SIM,1861,32,50-100,1893,1
STAT,1936,20,45-49,1956,1.0867629767103824
SIM,1773,94,na,1867,5
STAT,1945,23,20-24,1968,123.03349299302499
SIM,1825,34,30-34,1859,17
STAT,1840,47,35-39,1887,0.09896461513917784
STAT,1783,95,na,1878,2.671601099208245
STAT,1815,43,50-100,1858,2.6038424825048
SIM,1877,25,35-39,1902,12
STAT,1868,21,30-34,1889,17.31838030040252
STAT,1913,18,30-34,1931,2.50785585884346
SIM,1862,65,na,1927,1501
STAT,1850,45,50-100,1895,0.18993418345367694
SIM,1853,37,na,1890,1791
SIM,1921,38,na,1959,4092
STAT,1862,68,na,1930,1332.9249271849587
STAT,1810,46,45-49,1856,0.929208925587648
STAT,1844,48,50-100,1892,0.19187326632497387
STAT,1835,22,50-100,1857,0.4070033422354568
STAT,1943,15,40-44,1958,1.4984462239244412
STAT,1895,63,na,1958,2426.905390841513
STAT,1861,101,na,1962,1.4593972328846236
STAT,1872,66,na,1938,1664.2851344417893
STAT,1877,19,na,1896,2618.63182178653
SIM,1849,38,35-39,1887,12
SIM,1903,18,15-19,1921,10
STAT,1912,17,30-34,1929,2.4866427453527624
STAT,1836,28,na,1864,1752.2110793680092
STAT,1895,20,50-100,1915,0.5410697965743506
STAT,1895,15,35-39,1910,0.7270898054601919
STAT,1806,86,na,1892,74.80819314911066
STAT,1890,7,na,1897,3215.4285438673305
SIM,1938,26,na,1964,3605
SIM,1877,22,30-34,1899,28
SIM,1881,38,35-39,1919,13
STAT,1857,26,50-100,1883,0.5231248051775945
STAT,1918,21,40-44,1939,3.6721558351425636
SIM,1860,30,na,1890,2113
STAT,1879,45,na,1924,2394.9729381576067
SIM,1920,17,30-34,1937,21
SIM,1815,55,na,1870,1224
SIM,1930,20,15-19,1950,10
STAT,1938,33,25-29,1971,9.376287238288807
STAT,1835,63,na,1898,1339.2056099219553
STAT,1928,25,15-19,1953,0.8850511972927833
STAT,1869,22,30-34,1891,17.490922640863577
STAT,1946,25,30-34,1971,44.12169749991598
STAT,1901,16,45-49,1917,0.09271450511076507
SIM,1881,24,na,1905,2056
SIM,1844,12,na,1856,2067
SIM,1926,21,40-44,1947,4
STAT,1817,38,na,1855,1404.5330990478528
STAT,1867,28,35-39,1895,9.14596475670912
STAT,1948,19,35-39,1967,4.847772823499677
STAT,1835,43,na,1878,1866.6108263368028
STAT,1888,17,15-19,1905,7.074647304747973
SIM,1863,39,30-34,1902,1
SIM,1934,31,40-44,1965,10
STAT,1906,40,na,1946,3446.241623370704
STAT,1938,15,30-34,1953,12.194574991489091
SIM,1886,47,na,1933,2506
SIM,1915,0,na,1915,4739
STAT,1848,61,na,1909,1525.6632986194645
STAT,1884,25,30-34,1909,25.251204353017307
STAT,1914,16,na,1930,4040.9026162887676
STAT,1922,39,35-39,1961,2.7744629208511564
SIM,1807,68,na,1875,659
SIM,1938,23,25-29,1961,85
STAT,1790,107,na,1897,8.708361641127293E-4
SIM,1942,22,35-39,1964,17
SIM,1922,29,35-39,1951,32
SIM,1856,48,50-100,1904,3
STAT,1832,40,50-100,1872,0.9057603058966098
STAT,1840,29,40-44,1869,2.5807480165084242
STAT,1919,33,20-24,1952,2.6458281008566287
STAT,1877,10,na,1887,2733.984791811091
STAT,1883,58,na,1941,1954.6006609044025
STAT,1891,25,na,1916,3004.5417016499437
STAT,1881,48,35-39,1929,0.13458656045874984
STAT,1830,39,25-29,1869,2.5442815888454415
STAT,1890,60,na,1950,2353.766445724008
STAT,1902,17,45-49,1919,0.09323220203653615
STAT,1914,47,na,1961,3676.110324701067
SIM,1944,26,na,1970,4263
STAT,1824,71,na,1895,663.5972168873956
STAT,1873,38,35-39,1911,7.20611149755101
SIM,1890,29,na,1919,3195
SIM,1905,17,35-39,1922,2
STAT,1922,20,15-19,1942,6.203723506367073
SIM,1836,24,35-39,1860,8
STAT,1950,22,20-24,1972,133.2729703861598
SIM,1900,21,20-24,1921,89
STAT,1925,0,na,1925,5499.958339723004
STAT,1851,73,na,1924,899.3518145878646
STAT,1903,29,25-29,1932,60.412040390873486
STAT,1766,92,na,1858,5.154619941839574
STAT,1863,45,15-19,1908,3.6152426945727155E-4
STAT,1954,15,15-19,1969,56.7122632243079
STAT,1839,25,20-24,1864,10.630004846572202
STAT,1866,25,50-100,1891,0.6023199580794142
STAT,1878,17,50-100,1895,0.051365769025486334
STAT,1893,30,20-24,1923,3.4943789872973707
STAT,1952,18,15-19,1970,54.931021419454346
SIM,1876,32,50-100,1908,1
STAT,1929,40,20-24,1969,0.023180645643756912
SIM,1822,38,30-34,1860,9
STAT,1953,15,50-100,1968,0.458146591956002
STAT,1904,9,na,1913,3760.7099978893116
STAT,1931,26,30-34,1957,51.148150476604634
STAT,1886,42,50-100,1928,1.1252058769988618
STAT,1886,78,na,1964,1118.864261642492
STAT,1888,46,30-34,1934,0.11572404275355976
STAT,1904,17,na,1921,3660.661017426403
SIM,1950,16,35-39,1966,5
STAT,1905,24,30-34,1929,25.84484161596765
STAT,1905,26,25-29,1931,61.97611914155862
SIM,1880,36,25-29,1916,7
SIM,1846,58,na,1904,1396
SIM,1925,41,40-44,1966,3
SIM,1929,15,30-34,1944,27
STAT,1927,45,15-19,1972,4.695665171152968E-4
STAT,1852,22,50-100,1874,0.3673923045342984
STAT,1804,71,na,1875,574.5363505537657
STAT,1860,24,30-34,1884,14.943170789196506
SIM,1868,50,na,1918,2034
STAT,1894,17,40-44,1911,0.23783531552283166
STAT,1892,48,45-49,1940,0.166598198999481
STAT,1897,23,15-19,1920,4.453269265762829
STAT,1922,20,20-24,1942,129.58804016345033
SIM,1927,23,na,1950,4882
SIM,1830,63,na,1893,947
STAT,1797,84,na,1881,113.19779451744493
STAT,1804,82,na,1886,160.34733339865875
STAT,1858,31,15-19,1889,0.11401975414218607
SIM,1868,32,30-34,1900,22
STAT,1913,25,50-100,1938,1.0074555052250695
STAT,1872,54,25-29,1926,0.003497728807179385
SIM,1911,29,25-29,1940,83
SIM,1893,24,35-39,1917,11
SIM,1938,27,40-44,1965,7
STAT,1916,24,40-44,1940,3.5333362951512948
STAT,1764,110,na,1874,0.0010357899087608078
SIM,1906,28,40-44,1934,6
SIM,1934,27,50-100,1961,1
STAT,1858,20,na,1878,1972.1005275839818
SIM,1941,25,25-29,1966,85
STAT,1859,76,na,1935,769.609693243816
SIM,1826,33,35-39,1859,17
STAT,1876,15,30-34,1891,1.6698781181536047
STAT,1882,30,45-49,1912,1.7197777849070133
SIM,1901,27,45-49,1928,2
SIM,1858,25,30-34,1883,32
SIM,1841,100,na,1941,5
STAT,1911,20,45-49,1931,1.0830083172283764
STAT,1902,19,50-100,1921,0.06954916263721173
SIM,1782,74,na,1856,240
STAT,1840,30,50-100,1870,0.7987047195932944
STAT,1933,25,25-29,1958,88.3916875213227
SIM,1850,63,na,1913,1474
SIM,1848,50,na,1898,1679
STAT,1848,18,25-29,1866,5.7016341364557706
STAT,1863,101,na,1964,2.0393548756287982
STAT,1920,26,20-24,1946,20.290431136646458
STAT,1881,29,30-34,1910,24.341005663053483
STAT,1841,104,na,1945,0.04987926070052779
SIM,1873,15,20-24,1888,21
STAT,1845,24,35-39,1869,5.217621699484691
STAT,1875,36,50-100,1911,1.2795653813345953
STAT,1903,40,35-39,1943,0.1827007115175567
STAT,1920,44,20-24,1964,0.019631043814981316
SIM,1897,19,25-29,1916,9
SIM,1924,24,40-44,1948,5
STAT,1880,61,na,1941,1982.0813665131252
STAT,1840,33,na,1873,1831.2815383838126
STAT,1831,53,25-29,1884,0.0022819545580802496
SIM,1899,42,na,1941,3517
STAT,1903,47,25-29,1950,0.04651788351824959
STAT,1787,77,na,1864,283.2356631542336
STAT,1942,16,35-39,1958,4.428738838961298
STAT,1899,32,15-19,1931,0.19739866176012472
STAT,1921,39,50-100,1960,0.472471965978195
SIM,1903,27,50-100,1930,1
STAT,1859,37,40-44,1896,3.5560012672048673
STAT,1904,27,20-24,1931,17.003786105779657
SIM,1867,34,35-39,1901,18
STAT,1907,35,25-29,1942,0.9305050725013432
STAT,1924,32,20-24,1956,2.875618677563048
STAT,1849,45,30-34,1894,0.07643789080892141
SIM,1847,25,20-24,1872,2
SIM,1857,10,na,1867,2538
SIM,1912,27,20-24,1939,21
STAT,1904,43,25-29,1947,0.06416660257203298
STAT,1891,49,40-44,1940,0.1182386243281283
SIM,1933,38,45-49,1971,3
SIM,1878,80,na,1958,781
SIM,1870,29,na,1899,2593
STAT,1924,39,40-44,1963,1.779968752283667
SIM,1830,32,50-100,1862,1
SIM,1841,53,50-100,1894,1
SIM,1928,35,30-34,1963,2
SIM,1930,20,20-24,1950,139
STAT,1876,25,na,1901,2505.6535426965984
SIM,1933,31,na,1964,4910
STAT,1796,107,na,1903,9.879987501675968E-4
STAT,1889,19,25-29,1908,7.019463793240854
SIM,1913,26,25-29,1939,69
STAT,1871,25,na,1896,2410.9415911896212
SIM,1833,29,na,1862,1955
STAT,1866,35,na,1901,2224.3124168864542
STAT,1922,35,20-24,1957,0.30354741291661813
STAT,1872,36,25-29,1908,2.937668381948767
STAT,1900,16,30-34,1916,2.2417087953535413
STAT,1923,22,25-29,1945,108.59234549030614
SIM,1866,35,30-34,1901,9
STAT,1868,23,25-29,1891,55.087917132515294
SIM,1835,26,40-44,1861,3
SIM,1890,42,50-100,1932,3
STAT,1888,50,na,1938,2603.773944843713
SIM,1932,39,40-44,1971,2
SIM,1821,48,50-100,1869,3
SIM,1889,24,15-19,1913,4
STAT,1841,74,na,1915,829.916035478379
STAT,1909,60,na,1969,3172.215122636733
STAT,1853,51,na,1904,1789.1387343013134
STAT,1859,19,40-44,1878,0.17044299615216219
STAT,1841,16,50-100,1857,0.047531864084306055
STAT,1925,38,45-49,1963,0.8260627194260266
STAT,1828,84,na,1912,215.95069390576728
SIM,1862,88,na,1950,145
SIM,1865,21,20-24,1886,69
STAT,1924,18,40-44,1942,1.6787300817362334
SIM,1843,81,na,1924,470
STAT,1851,81,na,1932,409.460282527093
STAT,1811,53,na,1864,1192.7188311749082
SIM,1923,25,35-39,1948,25
STAT,1856,25,na,1881,1942.7439274126145
STAT,1807,48,na,1855,1239.5412639941603
STAT,1843,20,15-19,1863,2.8334803271277824
STAT,1832,52,30-34,1884,0.004228621711521778
SIM,1876,23,25-29,1899,93
SIM,1848,23,15-19,1871,4
STAT,1872,46,50-100,1918,0.25009542639188026
STAT,1810,100,na,1910,0.5513761341288994
STAT,1831,35,25-29,1866,2.352425822596781
SIM,1827,31,30-34,1858,25
SIM,1851,25,na,1876,2077
STAT,1852,52,50-100,1904,0.011392829122522204
SIM,1887,49,na,1936,2375
SIM,1924,42,40-44,1966,2
STAT,1926,31,45-49,1957,1.9241327111221218
SIM,1838,38,50-100,1876,1
STAT,1921,36,15-19,1957,0.021675774965579535
STAT,1897,41,45-49,1938,0.14136376850613153
STAT,1921,42,15-19,1963,0.001746935035906557
STAT,1911,35,45-49,1946,0.6706067915661623
STAT,1902,30,40-44,1932,6.239375295392029
SIM,1928,37,25-29,1965,1
SIM,1872,95,na,1967,17
STAT,1840,28,30-34,1868,21.851687807793407
SIM,1828,30,na,1858,1767
STAT,1848,48,50-100,1896,0.19800262613651276
STAT,1857,21,20-24,1878,63.16268940836111
STAT,1873,35,30-34,1908,5.508831537587224
STAT,1815,66,na,1881,830.9388222012033
STAT,1830,54,20-24,1884,5.217165393792678E-4
STAT,1930,33,25-29,1963,12.048403636327004
STAT,1906,34,25-29,1940,8.577931390440455
SIM,1859,27,35-39,1886,11
SIM,1932,18,40-44,1950,3
STAT,1923,46,50-100,1969,0.268004400322514
STAT,1851,47,45-49,1898,0.17786322786074463
SIM,1861,26,50-100,1887,1
STAT,1905,42,30-34,1947,0.11642376692338843
STAT,1825,33,na,1858,2113.6018343151877
SIM,1904,30,20-24,1934,6
SIM,1913,36,30-34,1949,2
STAT,1921,27,20-24,1948,20.54707347966417
SIM,1948,16,na,1964,5001
SIM,1910,30,40-44,1940,4
SIM,1925,23,45-49,1948,1
STAT,1821,46,20-24,1867,0.017844636193703137
STAT,1855,66,na,1921,1233.7170990122631
SIM,1876,27,40-44,1903,6
STAT,1880,49,35-39,1929,0.14539891417630582
SIM,1818,44,50-100,1862,1
SIM,1883,50,na,1933,2371
SIM,1934,31,45-49,1965,3
STAT,1916,42,40-44,1958,0.258671592415973
SIM,1894,22,30-34,1916,36
STAT,1946,21,15-19,1967,5.98488492965746
SIM,1852,33,50-100,1885,1
STAT,1917,23,45-49,1940,1.2033478670762827
STAT,1932,27,30-34,1959,51.86395365574511
STAT,1776,93,na,1869,5.696451677155182
STAT,1920,24,na,1944,4074.041297539062
SIM,1904,32,45-49,1936,3
STAT,1886,22,30-34,1908,18.994894040505287
SIM,1860,42,35-39,1902,2
SIM,1859,23,25-29,1882,61
STAT,1884,43,na,1927,2285.3542387123516
STAT,1847,99,na,1946,1.4180083689107645
STAT,1910,57,na,1967,3306.351961239347
SIM,1914,34,25-29,1948,1
SIM,1896,20,40-44,1916,8
STAT,1869,86,na,1955,217.8732023219565
STAT,1921,24,15-19,1945,6.034436789389033
SIM,1805,56,na,1861,1022
SIM,1924,26,35-39,1950,2
SIM,1815,63,na,1878,912
STAT,1865,15,20-24,1880,18.735025674858782
STAT,1877,17,35-39,1894,0.5719872060523752
STAT,1915,46,35-39,1961,0.1314197290066955
SIM,1827,43,50-100,1870,4
SIM,1839,35,50-100,1874,1
STAT,1926,28,15-19,1954,0.8522871390006601
STAT,1931,16,25-29,1947,57.46630526302415
STAT,1867,40,20-24,1907,0.15259075256960802
SIM,1853,21,30-34,1874,21
SIM,1907,26,35-39,1933,25
STAT,1829,49,30-34,1878,0.07036494195606854
STAT,1915,27,30-34,1942,40.32722305641524
STAT,1896,27,50-100,1923,0.855218316873263
STAT,1905,36,30-34,1941,1.6876952961097755
STAT,1887,47,25-29,1934,0.06464959456874445
STAT,1768,116,na,1884,2.0991229048368878E-4
STAT,1926,46,45-49,1972,0.2717037337152375
SIM,1859,14,na,1873,2577
SIM,1864,22,15-19,1886,3
STAT,1832,34,30-34,1866,15.209498271439974
STAT,1850,48,40-44,1898,0.12944305213534946
STAT,1840,19,50-100,1859,0.043942199505148924
STAT,1901,45,50-100,1946,0.19810680981621004
SIM,1839,31,20-24,1870,2
SIM,1881,35,30-34,1916,7
SIM,1905,32,25-29,1937,1
SIM,1855,32,na,1887,2115
SIM,1913,24,30-34,1937,48
SIM,1801,83,na,1884,23
STAT,1822,44,15-19,1866,0.020927492708419454
STAT,1897,19,na,1916,3401.479418648361
SIM,1851,20,15-19,1871,3
SIM,1840,34,30-34,1874,23
STAT,1794,104,na,1898,0.012971099696710474
STAT,1931,16,na,1947,4881.012624761564
STAT,1791,99,na,1890,0.3367573715165298
STAT,1917,41,45-49,1958,0.17556743776900482
STAT,1916,26,35-39,1942,15.719581723399687
STAT,1856,22,15-19,1878,2.9669137536992665
STAT,1931,32,30-34,1963,20.864259192505436
STAT,1850,15,50-100,1865,0.04638603286742899
SIM,1842,88,na,1930,62
SIM,1909,24,45-49,1933,2
STAT,1804,74,na,1878,432.3404743082647
STAT,1857,23,15-19,1880,2.980500231103377
SIM,1934,28,15-19,1962,1
STAT,1853,19,45-49,1872,0.06421951631231759
STAT,1845,21,30-34,1866,16.274364377005302
SIM,1849,20,25-29,1869,61
STAT,1827,48,na,1875,1483.1047758265684
STAT,1888,20,40-44,1908,2.4989546098613267
SIM,1879,17,15-19,1896,7
STAT,1866,58,na,1924,1849.5135789676426
STAT,1882,65,na,1947,1653.370713982984
STAT,1915,25,35-39,1940,15.556982358146515
STAT,1814,81,na,1895,253.11037110214392
STAT,1930,17,20-24,1947,177.15756383316887
STAT,1776,82,na,1858,134.92445837961026
STAT,1917,44,45-49,1961,0.17473130771675047
SIM,1944,18,30-34,1962,27
STAT,1878,30,25-29,1908,10.825228250591442
STAT,1952,18,50-100,1970,0.4534755941428744
SIM,1880,39,na,1919,2231
SIM,1922,26,30-34,1948,76
STAT,1787,85,na,1872,73.99528055195933
SIM,1866,1,na,1867,3310
SIM,1884,30,20-24,1914,2
SIM,1911,39,na,1950,3897
STAT,1900,32,30-34,1932,24.496178256188642
STAT,1933,4,na,1937,5459.836343930624
STAT,1783,92,na,1875,11.644858143517553
STAT,1863,49,35-39,1912,0.12266872141615497
STAT,1912,34,15-19,1946,0.12648033046713691
SIM,1873,29,na,1902,2257
SIM,1923,27,30-34,1950,67
STAT,1906,19,30-34,1925,2.332172489734351
STAT,1909,47,20-24,1956,0.010247192852079907
SIM,1914,19,30-34,1933,4
STAT,1936,18,30-34,1954,11.750308024019969
STAT,1898,22,20-24,1920,94.35559088343227
STAT,1951,16,na,1967,4429.62725891275
SIM,1865,23,15-19,1888,2
SIM,1908,23,45-49,1931,1
SIM,1886,30,25-29,1916,22
STAT,1864,100,na,1964,3.677482135444196
SIM,1856,88,na,1944,38
STAT,1828,100,na,1928,0.6891744809054827
STAT,1904,26,50-100,1930,0.9303640219740337
STAT,1922,36,50-100,1958,0.48306814688191857
SIM,1911,26,20-24,1937,5
SIM,1892,21,15-19,1913,3
STAT,1893,33,25-29,1926,13.080108648460138
STAT,1937,15,15-19,1952,44.77892409285823
STAT,1933,22,20-24,1955,149.04509906704916
STAT,1942,15,50-100,1957,0.39552191783851515
STAT,1875,48,45-49,1923,0.24170761580139996
STAT,1920,29,25-29,1949,72.39215852701483
SIM,1877,20,35-39,1897,10
SIM,1856,5,na,1861,2658
SIM,1872,29,30-34,1901,32
STAT,1934,28,45-49,1962,2.3471702265794754
SIM,1828,31,45-49,1859,2
STAT,1862,65,na,1927,1474.0196167652828
STAT,1855,39,30-34,1894,3.971308467143309
SIM,1835,29,45-49,1864,4
SIM,1929,18,35-39,1947,8
STAT,1826,42,25-29,1868,0.6699841005962796
SIM,1900,47,na,1947,3264
STAT,1927,30,45-49,1957,1.9586957900427162
STAT,1898,40,20-24,1938,0.015252413754932755
SIM,1873,18,25-29,1891,8
STAT,1916,42,na,1958,3840.835874097554
SIM,1895,22,45-49,1917,4
STAT,1887,22,45-49,1909,0.7863318456958355
STAT,1901,31,40-44,1932,6.165264946111471
STAT,1860,41,50-100,1901,0.876181390441813
SIM,1836,48,na,1884,1726
SIM,1942,28,45-49,1970,1
STAT,1896,5,na,1901,3503.587194951758
SIM,1947,23,na,1970,4815
STAT,1830,36,20-24,1866,0.7107423236420531
STAT,1848,84,na,1932,271.60567360364104
STAT,1893,68,na,1961,2118.16002809844
STAT,1862,76,na,1938,826.3447027665271
SIM,1847,88,na,1935,72
SIM,1867,33,50-100,1900,2
STAT,1893,57,na,1950,2577.234148570728
STAT,1884,21,15-19,1905,3.2957315980877437
STAT,1856,28,na,1884,1901.1969634529335
STAT,1939,29,40-44,1968,4.725740966806998
STAT,1876,18,35-39,1894,0.57071824759807
STAT,1880,20,50-100,1900,0.4351283925320604
SIM,1802,68,na,1870,811
SIM,1840,30,na,1870,1940
STAT,1889,16,20-24,1905,22.13323649909998
STAT,1941,15,35-39,1956,4.365880036943077
SIM,1842,96,na,1938,2
STAT,1829,28,50-100,1857,0.7179252805138614
STAT,1855,54,25-29,1909,0.002592829646689307
STAT,1869,41,50-100,1910,1.042085852425171
STAT,1769,89,na,1858,28.74173390253565
STAT,1856,40,45-49,1896,1.1706116202936032
SIM,1900,24,25-29,1924,88
STAT,1931,29,35-39,1960,19.570187866226487
SIM,1843,100,na,1943,7
STAT,1929,24,20-24,1953,141.23570577483912
STAT,1859,34,35-39,1893,8.156143338061774
STAT,1864,48,35-39,1912,0.12599097907556348
SIM,1940,27,30-34,1967,53
STAT,1880,35,50-100,1915,1.3146475446619428
SIM,1897,16,20-24,1913,19
STAT,1914,16,25-29,1930,9.066614755973617
STAT,1869,20,35-39,1889,5.78906465176239
SIM,1910,54,na,1964,3119
STAT,1835,74,na,1909,832.9493616422695
STAT,1873,53,30-34,1926,0.005997012675345967
STAT,1827,29,45-49,1856,1.8356169151474437
SIM,1866,20,25-29,1886,68
SIM,1922,16,25-29,1938,89
STAT,1899,38,50-100,1937,0.36550482156684405
STAT,1814,53,25-29,1867,0.007995699849216768
STAT,1803,89,na,1892,43.793000962063
SIM,1848,73,na,1921,784
STAT,1876,28,na,1904,2480.008450580898
STAT,1845,73,na,1918,867.8742914114472
STAT,1908,38,45-49,1946,0.641112905779323
STAT,1849,41,15-19,1890,0.010846110258974018
SIM,1816,44,30-34,1860,3
SIM,1854,21,45-49,1875,3
STAT,1811,52,50-100,1863,0.03597035592025519
STAT,1773,100,na,1873,0.22129586106285742
STAT,1903,44,20-24,1947,0.01564913272941291
SIM,1858,80,na,1938,425
SIM,1883,35,30-34,1918,3
SIM,1929,28,50-100,1957,2
STAT,1851,25,50-100,1876,0.5753592676235582
STAT,1913,30,20-24,1943,2.468225496183266
SIM,1815,86,na,1901,84
STAT,1862,22,40-44,1884,1.8605958301608114
SIM,1860,22,na,1882,2123
SIM,1941,24,40-44,1965,5
STAT,1918,24,45-49,1942,1.2174743665187353
STAT,1858,20,25-29,1878,52.80044627310399
STAT,1879,53,na,1932,2233.000098800136
STAT,1767,109,na,1876,0.0024531235598776522
SIM,1939,19,35-39,1958,5
STAT,1831,46,50-100,1877,0.1858203755250148
STAT,1835,66,na,1901,1230.1554424291114
STAT,1875,35,30-34,1910,5.580430704892399
STAT,1922,22,45-49,1944,1.3035164234029706
SIM,1870,37,50-100,1907,1
SIM,1930,22,45-49,1952,1
STAT,1935,37,20-24,1972,0.3724192359134948
SIM,1853,29,na,1882,1882
SIM,1918,28,30-34,1946,2
SIM,1870,22,40-44,1892,2
SIM,1900,44,na,1944,3326
STAT,1852,32,25-29,1884,8.042741857143259
SIM,1927,17,20-24,1944,1
STAT,1919,17,20-24,1936,151.27186536264287
STAT,1772,101,na,1873,0.09633520848436358
STAT,1810,49,15-19,1859,0.0014877566338590725
STAT,1911,17,15-19,1928,9.162268032551475
SIM,1931,34,25-29,1965,20
STAT,1915,43,30-34,1958,0.12967178692509765
STAT,1846,46,25-29,1892,0.04383587471830058
SIM,1860,32,25-29,1892,1
SIM,1900,26,45-49,1926,2
STAT,1848,15,20-24,1863,18.156677430545777
STAT,1872,26,15-19,1898,0.46228003293316594
STAT,1814,41,na,1855,1524.266454450547
STAT,1923,38,40-44,1961,1.7507900390935909
SIM,1873,40,na,1913,2250
SIM,1888,23,15-19,1911,6
SIM,1831,28,30-34,1859,30
SIM,1846,47,na,1893,1548
STAT,1903,26,20-24,1929,16.932584554967942
STAT,1911,32,40-44,1943,3.84449578030116
STAT,1846,21,45-49,1867,0.6576654457801866
SIM,1941,22,20-24,1963,144
STAT,1834,47,45-49,1881,0.14905543793328482
STAT,1881,44,25-29,1925,0.6167431240230828
STAT,1923,34,25-29,1957,10.692045382193864
STAT,1897,37,50-100,1934,1.6624358941205926
STAT,1839,28,25-29,1867,37.5101004990879
SIM,1856,15,20-24,1871,20
SIM,1917,24,na,1941,3719
STAT,1871,37,20-24,1908,0.7734884346210076
STAT,1847,22,45-49,1869,0.640056544707033
SIM,1868,35,35-39,1903,3
SIM,1855,22,45-49,1877,3
SIM,1932,35,25-29,1967,2
STAT,1913,48,25-29,1961,0.05209362833669936
STAT,1924,35,25-29,1959,1.1752616078905813
STAT,1868,27,40-44,1895,2.891590492107604
SIM,1931,38,40-44,1969,3
SIM,1918,24,15-19,1942,8
STAT,1874,21,20-24,1895,71.48375004860051
STAT,1770,97,na,1867,0.47982963949418866
STAT,1822,48,na,1870,1438.6337666238726
STAT,1858,91,na,1949,45.91707252551911
STAT,1861,21,50-100,1882,0.35414993560691516
SIM,1886,24,na,1910,2544
STAT,1891,20,45-49,1911,0.8771881801676654
STAT,1869,46,na,1915,2215.5227207397857
STAT,1866,8,na,1874,2590.412144106868
STAT,1890,19,30-34,1909,1.9565421274402404
SIM,1847,28,25-29,1875,45
STAT,1906,32,na,1938,3540.3718067681416
STAT,1933,24,40-44,1957,4.5038325793302025
STAT,1798,69,na,1867,821.6287913536293
STAT,1907,37,45-49,1944,0.6381982310286327
STAT,1863,46,30-34,1909,0.0868712749636247
STAT,1836,32,40-44,1868,3.4580767066136033
STAT,1906,31,20-24,1937,2.2926254334095035
STAT,1921,21,45-49,1942,1.2874218241778363
STAT,1812,106,na,1918,0.005512461414049538
STAT,1842,99,na,1941,1.705114275097964
SIM,1925,21,25-29,1946,120
STAT,1930,19,40-44,1949,1.8179109519420866
STAT,1901,40,na,1941,3316.8209486184614
STAT,1880,49,30-34,1929,0.10053296347062946
STAT,1940,22,25-29,1962,94.99518782477918
STAT,1852,66,na,1918,1243.0120948141039
SIM,1859,20,20-24,1879,95
SIM,1936,23,20-24,1959,105
SIM,1839,22,na,1861,1847
STAT,1833,27,50-100,1860,0.598692865624043
STAT,1886,25,35-39,1911,10.359357430607925
SIM,1852,23,35-39,1875,11
SIM,1927,31,na,1958,5131
SIM,1904,18,30-34,1922,4
STAT,1844,23,35-39,1867,5.7231605483295365
STAT,1887,16,50-100,1903,0.05538117737495582
STAT,1905,20,15-19,1925,4.845634101257248
SIM,1908,20,40-44,1928,3
STAT,1915,57,na,1972,3571.4446597223764
SIM,1829,55,na,1884,1449
STAT,1822,47,50-100,1869,0.3641453583697488
STAT,1823,47,35-39,1870,0.19269598881525937
SIM,1913,39,35-39,1952,2
SIM,1787,74,na,1861,438
STAT,1868,50,na,1918,2108.3010784396442
STAT,1937,35,30-34,1972,1.8430686860714047
SIM,1841,27,50-100,1868,4
SIM,1919,25,15-19,1944,2
SIM,1899,29,35-39,1928,23
STAT,1870,40,na,1910,2315.3901553048304
STAT,1917,21,25-29,1938,99.39248219950967
SIM,1869,32,45-49,1901,1
SIM,1819,48,na,1867,1404
STAT,1788,70,na,1858,606.4559021572436
SIM,1844,32,40-44,1876,4
STAT,1900,35,35-39,1935,10.017631328267635
STAT,1890,38,35-39,1928,8.685826173072108
SIM,1827,34,35-39,1861,11
SIM,1835,55,na,1890,1183
SIM,1915,32,20-24,1947,4
STAT,1855,29,20-24,1884,9.072632093771567
STAT,1955,0,na,1955,5312.176879576707
SIM,1878,21,35-39,1899,8
STAT,1821,49,25-29,1870,0.08201447168268272
STAT,1920,47,25-29,1967,0.059213617639016995
STAT,1893,43,35-39,1936,0.16009776043772528
STAT,1864,91,na,1955,52.812897030677284
STAT,1915,19,45-49,1934,0.10493208061573372
SIM,1848,25,35-39,1873,10
STAT,1875,94,na,1969,88.04341458613446
SIM,1845,22,na,1867,2073
SIM,1862,101,na,1963,2
SIM,1847,49,50-100,1896,2
STAT,1937,33,45-49,1970,1.5707036030759158
SIM,1771,90,na,1861,11
SIM,1829,32,45-49,1861,2
STAT,1857,98,na,1955,2.5606441707255327
STAT,1907,32,20-24,1939,2.3021126630631845
STAT,1839,25,na,1864,1960.1645970180584
STAT,1866,15,35-39,1881,0.5329881148093019
STAT,1868,61,na,1929,1803.776862159975
STAT,1790,74,na,1864,388.54624086834406
SIM,1866,47,na,1913,2297
SIM,1896,38,50-100,1934,3
STAT,1831,31,50-100,1862,0.7674864605990661
STAT,1926,43,40-44,1969,0.31114781474392383
SIM,1822,45,na,1867,1545
SIM,1873,30,45-49,1903,1
STAT,1888,23,45-49,1911,0.8287165215611112
SIM,1853,24,35-39,1877,5
STAT,1842,53,30-34,1895,0.005273237992722831
SIM,1858,28,35-39,1886,11
SIM,1909,49,50-100,1958,5
STAT,1796,104,na,1900,0.013973749629530161
STAT,1865,18,25-29,1883,5.353756940847637
STAT,1874,13,na,1887,2691.3982174130037
SIM,1937,24,20-24,1961,108
STAT,1821,74,na,1895,664.7543982696749
STAT,1885,24,35-39,1909,5.829902144565525
STAT,1786,92,na,1878,11.715572181766305
STAT,1828,33,na,1861,1851.0033073791756
STAT,1857,10,na,1867,2239.3877641176273
STAT,1928,23,20-24,1951,139.8926806584475
SIM,1874,15,35-39,1889,3
SIM,1894,25,35-39,1919,17
STAT,1899,45,na,1944,3150.297899121719
STAT,1850,88,na,1938,105.11994174280512
SIM,1885,43,50-100,1928,1
SIM,1943,16,na,1959,3933
SIM,1769,89,na,1858,58
SIM,1906,6,na,1912,3753
STAT,1929,43,25-29,1972,0.09332329759082356
SIM,1945,15,15-19,1960,59
STAT,1928,41,20-24,1969,0.022788849825756234
STAT,1891,15,50-100,1906,0.06154791395458897
STAT,1894,53,na,1947,2754.961165208845
STAT,1905,39,35-39,1944,2.2065901583484413
STAT,1867,43,25-29,1910,0.6064213215096117
SIM,1909,21,40-44,1930,5
SIM,1901,18,na,1919,3703
STAT,1900,47,na,1947,3142.4198466148646
SIM,1935,30,45-49,1965,6
STAT,1834,34,30-34,1868,13.045427204591336
SIM,1842,34,30-34,1876,25
SIM,1893,57,na,1950,2593
SIM,1838,16,15-19,1854,8
STAT,1917,41,40-44,1958,0.26385740663538426
SIM,1912,26,50-100,1938,2
STAT,1876,1,na,1877,3602.351549222708
SIM,1889,75,na,1964,1303
STAT,1842,26,50-100,1868,0.7173833791791681
STAT,1853,16,40-44,1869,0.18302981455794057
SIM,1798,66,na,1864,799
SIM,1885,33,40-44,1918,10
STAT,1846,36,15-19,1882,0.04496637477360641
STAT,1887,40,45-49,1927,1.7047095348312402
STAT,1910,54,na,1964,3367.944654637491
STAT,1877,33,40-44,1910,4.501617075454206
SIM,1877,39,na,1916,2444
SIM,1903,17,30-34,1920,3
SIM,1832,24,30-34,1856,22
SIM,1886,44,na,1930,2568
STAT,1870,41,45-49,1911,1.4910664643783664
SIM,1833,51,na,1884,1531
SIM,1922,25,20-24,1947,36
STAT,1895,60,na,1955,2515.5001373005557
STAT,1847,19,15-19,1866,5.48068579857646
SIM,1921,5,na,1926,4580
SIM,1882,54,na,1936,1837
SIM,1926,18,15-19,1944,55
STAT,1927,41,35-39,1968,0.2556250613535575
SIM,1862,30,35-39,1892,14
STAT,1829,39,20-24,1868,0.6110332940924637
STAT,1949,18,45-49,1967,0.5867563451880584
STAT,1858,48,45-49,1906,0.18465353146521624
SIM,1868,36,45-49,1904,1
STAT,1859,22,na,1881,1993.323744721222
STAT,1912,37,20-24,1949,0.25957584476586143
STAT,1924,15,35-39,1939,5.072879771624286
SIM,1878,49,na,1927,2528
STAT,1920,22,40-44,1942,3.774764936304502
SIM,1833,103,na,1936,1
SIM,1887,30,40-44,1917,11
STAT,1897,16,50-100,1913,0.0665008115160518
SIM,1899,22,15-19,1921,5
STAT,1879,30,40-44,1909,4.607639953391715
SIM,1863,42,50-100,1905,3
STAT,1879,53,50-100,1932,0.015662709995604665
SIM,1844,15,na,1859,2018
STAT,1868,42,30-34,1910,1.108397950496703
STAT,1844,29,45-49,1873,1.0599893761956685
SIM,1885,35,35-39,1920,17
SIM,1914,26,40-44,1940,6
STAT,1828,40,35-39,1868,1.7889908360669549
SIM,1941,6,na,1947,4290
STAT,1865,19,35-39,1884,0.5153507214377817
SIM,1869,17,20-24,1886,18
STAT,1828,30,na,1858,1904.952168444738
SIM,1919,40,40-44,1959,1
STAT,1856,28,25-29,1884,33.69895233624676
STAT,1850,47,30-34,1897,0.07377554105485003
STAT,1879,22,na,1901,2492.760812019691
SIM,1872,32,50-100,1904,1
STAT,1930,26,15-19,1956,0.907685406881357
SIM,1883,38,35-39,1921,19
SIM,1855,19,15-19,1874,6
STAT,1860,19,na,1879,2160.075542331411
STAT,1922,27,35-39,1949,17.162563455610144
STAT,1877,18,15-19,1895,6.17010597099805
STAT,1891,70,na,1961,1923.95609682414
SIM,1917,43,40-44,1960,1
SIM,1965,0,na,1965,5222
STAT,1877,35,35-39,1912,7.443000339331452
STAT,1930,37,40-44,1967,1.9735610546703515
STAT,1898,25,25-29,1923,58.31242109949423
STAT,1903,25,45-49,1928,1.6079098145490984
STAT,1892,44,30-34,1936,0.0998158619394568
STAT,1936,32,45-49,1968,1.5430600579092437
SIM,1830,27,30-34,1857,6
SIM,1859,42,na,1901,2129
SIM,1901,40,na,1941,3349
STAT,1848,15,50-100,1863,0.05017503808008003
STAT,1865,28,35-39,1893,8.867458460841691
SIM,1863,29,20-24,1892,11
SIM,1880,53,na,1933,1971
STAT,1875,47,35-39,1922,0.14453346973004108
STAT,1829,46,25-29,1875,0.04353684976378145
SIM,1905,26,30-34,1931,44
STAT,1894,32,30-34,1926,22.703488037894267
STAT,1880,27,20-24,1907,12.443673533575982
STAT,1896,37,25-29,1933,3.849259750223143
STAT,1901,37,45-49,1938,0.6092103136926265
STAT,1911,10,na,1921,3999.167256356542
SIM,1903,30,35-39,1933,21
STAT,1818,103,na,1921,0.07393991224043629
STAT,1891,15,30-34,1906,2.0023592077561037
STAT,1798,60,na,1858,1149.2535964897104
STAT,1873,25,20-24,1898,12.093438223021295
SIM,1853,51,na,1904,1631
STAT,1868,84,na,1952,321.116743203389
STAT,1923,2,na,1925,4852.352576455969
SIM,1799,62,na,1861,1043
SIM,1914,13,na,1927,4330
STAT,1927,11,na,1938,4986.977177047025
SIM,1888,36,30-34,1924,9
STAT,1870,23,na,1893,2338.3794113598246
SIM,1826,30,50-100,1856,2
SIM,1818,60,na,1878,958
STAT,1890,49,25-29,1939,0.03926211803089861
SIM,1864,28,25-29,1892,51
SIM,1843,36,40-44,1879,9
STAT,1884,38,45-49,1922,1.9756547029570597
SIM,1836,40,35-39,1876,5
SIM,1923,19,45-49,1942,1
STAT,1921,28,30-34,1949,43.94963870872984
STAT,1919,47,15-19,1966,4.034150470932339E-4
SIM,1835,41,30-34,1876,4
SIM,1865,62,na,1927,1593
SIM,1910,23,na,1933,3375
SIM,1876,42,30-34,1918,1
STAT,1814,50,20-24,1864,0.0017690913626154207
STAT,1866,54,30-34,1920,0.0054139288450303176
STAT,1895,31,35-39,1926,13.411815246057554
STAT,1882,16,30-34,1898,1.5631881034418522
STAT,1840,64,na,1904,1218.5677899266038
STAT,1929,37,30-34,1966,2.365016274345262
STAT,1931,32,50-100,1963,1.0949080254686847
STAT,1881,41,20-24,1922,0.1553144776666224
SIM,1892,38,45-49,1930,3
STAT,1946,6,na,1952,4432.183025741597
SIM,1907,23,30-34,1930,42
SIM,1863,54,50-100,1917,2
SIM,1890,15,20-24,1905,24
SIM,1911,25,45-49,1936,2
STAT,1833,48,40-44,1881,0.1279376957006115
SIM,1919,8,na,1927,4381
STAT,1875,22,20-24,1897,71.47724370667926
STAT,1923,21,na,1944,4306.127715971315
SIM,1869,52,na,1921,2091
STAT,1847,35,20-24,1882,0.6113986546443692
SIM,1859,76,na,1935,811
STAT,1812,69,na,1881,785.9714418181469
STAT,1817,47,45-49,1864,0.5074761061911776
SIM,1918,45,50-100,1963,2
SIM,1940,21,20-24,1961,5
SIM,1855,52,na,1907,1840
SIM,1863,36,25-29,1899,1
STAT,1849,18,40-44,1867,0.1749888904187581
SIM,1818,44,35-39,1862,4
STAT,1914,25,20-24,1939,18.692384078626183
SIM,1910,33,45-49,1943,1
SIM,1921,25,50-100,1946,1
STAT,1906,63,na,1969,2929.161126819128
STAT,1887,46,15-19,1933,4.5233863686856666E-4
STAT,1904,47,40-44,1951,0.13931935020309927
STAT,1906,26,40-44,1932,4.421907402018887
SIM,1901,60,na,1961,2829
STAT,1835,36,40-44,1871,4.105881401098232
SIM,1886,39,30-34,1925,5
STAT,1875,32,na,1907,2475.123550478816
SIM,1923,24,25-29,1947,5
STAT,1913,36,25-29,1949,0.9850997846573167
STAT,1913,11,na,1924,4080.1733710160474
STAT,1845,47,20-24,1892,0.008727354911902524
SIM,1826,39,45-49,1865,7
STAT,1818,39,45-49,1857,4.362084714146092
STAT,1957,15,50-100,1972,0.4992442918817971
STAT,1868,47,50-100,1915,0.23597018010590337
SIM,1865,24,25-29,1889,52
SIM,1834,38,50-100,1872,1
STAT,1889,34,15-19,1923,0.17583525863491414
STAT,1909,20,50-100,1929,0.6207947976279999
SIM,1888,27,30-34,1915,37
STAT,1919,16,na,1935,4334.215267816586
SIM,1873,26,na,1899,2293
STAT,1902,33,45-49,1935,2.478384652912764
SIM,1903,41,na,1944,3148
SIM,1921,36,25-29,1957,1
SIM,1889,37,50-100,1926,1
SIM,1907,27,50-100,1934,1
STAT,1915,24,25-29,1939,95.74256497573644
STAT,1932,21,20-24,1953,147.88570053409876
SIM,1838,38,25-29,1876,5
SIM,1877,40,25-29,1917,1
STAT,1937,30,40-44,1967,3.9130311901905523
STAT,1891,48,30-34,1939,0.06742224469384216
STAT,1895,38,20-24,1933,1.011678511242915
SIM,1788,90,na,1878,24
STAT,1935,36,45-49,1971,0.9639879086420435
SIM,1906,25,35-39,1931,18
STAT,1808,95,na,1903,5.012517615911803
STAT,1876,37,40-44,1913,4.565047912819855
SIM,1857,32,20-24,1889,2
STAT,1873,37,na,1910,2412.30756865717
STAT,1874,48,30-34,1922,0.09885167261207203
SIM,1872,22,45-49,1894,5
STAT,1911,2,na,1913,4115.47424067372
STAT,1943,19,20-24,1962,145.06803303037745
SIM,1835,32,na,1867,1696
SIM,1840,33,na,1873,1859
SIM,1894,40,25-29,1934,1
STAT,1819,35,45-49,1854,7.052480803865307
STAT,1881,26,25-29,1907,41.3245320409463
STAT,1822,45,na,1867,1494.9989368733877
STAT,1813,96,na,1909,3.764896291861919
STAT,1874,24,25-29,1898,58.832195822811116
STAT,1904,21,45-49,1925,1.0137624250352097
STAT,1899,42,na,1941,3210.835590951876
SIM,1912,21,45-49,1933,1
STAT,1834,46,35-39,1880,0.09842066147251528
STAT,1859,21,25-29,1880,53.4032959335422
SIM,1847,38,35-39,1885,14
STAT,1849,46,na,1895,1764.038774001539
STAT,1862,14,na,1876,2363.1372034292267
SIM,1829,38,na,1867,1801
STAT,1815,97,na,1912,2.3255275812799683
SIM,1822,35,25-29,1857,6
SIM,1874,49,50-100,1923,4
SIM,1897,16,na,1913,3508
STAT,1897,29,25-29,1926,56.86923025397837
STAT,1845,49,15-19,1894,2.861717099773123E-4
SIM,1842,37,35-39,1879,7
SIM,1808,84,na,1892,97
STAT,1878,39,30-34,1917,5.531582324866071
STAT,1931,30,na,1961,5014.170389579166
STAT,1822,32,50-100,1854,2.821217098366328
STAT,1874,23,15-19,1897,3.401273802013772
STAT,1949,23,25-29,1972,108.85371641692706
SIM,1768,90,na,1858,10
SIM,1884,37,40-44,1921,5
STAT,1869,40,25-29,1909,0.6369342455014191
SIM,1867,21,25-29,1888,56
STAT,1877,41,na,1918,2420.1916897419583
STAT,1919,36,na,1955,4084.5980608248688
STAT,1859,33,50-100,1892,0.7411579176209815
SIM,1912,58,na,1970,3163
STAT,1831,34,15-19,1865,0.11510528737895119
STAT,1864,22,45-49,1886,0.645749785556199
STAT,1834,37,35-39,1871,5.239486083917569
STAT,1870,19,45-49,1889,0.06463506378888402
STAT,1886,26,45-49,1912,1.1880827200073834
STAT,1828,47,20-24,1875,0.010933199562467067
SIM,1926,36,45-49,1962,1
STAT,1917,28,50-100,1945,1.0499329682274123
SIM,1863,81,na,1944,348
STAT,1831,81,na,1912,339.81668922267784
STAT,1808,47,35-39,1855,0.5113190669325784
STAT,1776,99,na,1875,0.2998328686153029
STAT,1859,22,35-39,1881,4.91829256828638
STAT,1766,110,na,1876,9.497707532858815E-4
STAT,1932,16,40-44,1948,1.876297832453957
SIM,1888,29,25-29,1917,73
SIM,1902,32,40-44,1934,7
STAT,1809,46,40-44,1855,0.6395944398881096
STAT,1827,41,30-34,1868,1.2581522831713334
STAT,1849,32,20-24,1881,2.226990212326574
STAT,1929,39,25-29,1968,1.2749325085692946
STAT,1840,18,20-24,1858,15.995433561754071
STAT,1881,25,15-19,1906,0.44470582027932903
SIM,1880,59,na,1939,1785
STAT,1913,45,na,1958,3634.9604090287453
STAT,1835,97,na,1932,4.032124574428284
STAT,1851,46,35-39,1897,0.10630726279698553
SIM,1851,37,45-49,1888,3
STAT,1889,12,na,1901,3216.241868092197
STAT,1923,16,30-34,1939,14.496780064455487
STAT,1918,36,45-49,1954,0.7289162113954714
STAT,1843,37,45-49,1880,1.5696343897479401
SIM,1951,19,20-24,1970,183
STAT,1850,17,35-39,1867,0.5134216989712032
STAT,1852,50,25-29,1902,0.0027248363624315323
STAT,1893,51,na,1944,2774.5994206429305
SIM,1827,35,45-49,1862,1
SIM,1940,16,40-44,1956,1
SIM,1906,24,25-29,1930,105
STAT,1866,89,na,1955,98.24947540323102
STAT,1938,20,45-49,1958,1.124978074931217
SIM,1831,25,25-29,1856,50
SIM,1888,79,na,1967,1554
STAT,1873,43,50-100,1916,1.0738971569623577
STAT,1869,48,20-24,1917,0.011635442208295804
STAT,1875,38,35-39,1913,7.299770484799491
STAT,1832,69,na,1901,999.285784394135
STAT,1872,35,15-19,1907,0.057562045637171044
SIM,1867,22,35-39,1889,8
STAT,1909,46,45-49,1955,0.20202915073668284
SIM,1883,81,na,1964,984
SIM,1852,48,50-100,1900,1
SIM,1931,16,30-34,1947,21
SIM,1949,21,40-44,1970,4
STAT,1928,40,40-44,1968,0.323189307650506
STAT,1837,38,30-34,1875,4.381062198890931
STAT,1948,19,na,1967,4252.3511432878795
STAT,1818,54,na,1872,1285.831670995856
STAT,1919,44,50-100,1963,0.12811510321516348
SIM,1866,23,30-34,1889,22
SIM,1845,38,30-34,1883,7
STAT,1906,33,50-100,1939,0.7706935346569719
SIM,1932,15,35-39,1947,8
STAT,1848,33,15-19,1881,0.12211360623590511
STAT,1841,17,25-29,1858,5.465471032247336
STAT,1931,20,50-100,1951,0.8676401448015574
SIM,1866,24,na,1890,2310
STAT,1954,13,na,1967,4905.288587021919
SIM,1926,38,na,1964,4592
STAT,1844,41,30-34,1885,0.9435934319318038
STAT,1858,23,30-34,1881,14.630795006838639
STAT,1862,0,na,1862,3361.4499145716354
STAT,1890,16,25-29,1906,7.0108308116354845
STAT,1881,19,20-24,1900,17.167324551728832
STAT,1886,48,20-24,1934,0.012635925296739495
SIM,1868,59,na,1927,1799
SIM,1867,37,40-44,1904,6
STAT,1864,53,50-100,1917,0.013543449159899234
SIM,1929,37,40-44,1966,1
SIM,1904,29,na,1933,3528
STAT,1852,69,na,1921,1112.9730856296053
STAT,1860,37,45-49,1897,1.6458755661560662
SIM,1823,61,na,1884,1123
SIM,1941,15,na,1956,3962
STAT,1892,47,35-39,1939,0.09962042640789384
SIM,1907,8,na,1915,4091
STAT,1839,38,35-39,1877,5.930499939679508
STAT,1940,18,25-29,1958,44.406073125919974
STAT,1922,42,30-34,1964,0.14824238500167772
SIM,1823,100,na,1923,1
STAT,1853,31,30-34,1884,15.024148789489095
STAT,1879,15,15-19,1894,6.2840771795909545
STAT,1838,54,na,1892,1401.7502587446688
STAT,1928,34,50-100,1962,1.0435949954563466
STAT,1824,54,50-100,1878,0.01637218689607342
SIM,1894,73,na,1967,1925
STAT,1855,51,20-24,1906,5.581049070085922E-4
SIM,1793,91,na,1884,5
STAT,1857,110,na,1967,0.0019112603406409878
STAT,1899,49,45-49,1948,0.18067676295042195
STAT,1840,98,na,1938,2.277187273055787
STAT,1861,29,45-49,1890,0.9251951900580498
STAT,1904,36,15-19,1940,0.017652189412930442
SIM,1889,49,50-100,1938,3
STAT,1903,7,na,1910,3747.5788822379964
STAT,1907,15,35-39,1922,0.8176420065922285
STAT,1865,33,15-19,1898,0.1307820927075153
STAT,1839,29,35-39,1868,8.494598869000392
SIM,1847,29,35-39,1876,1
STAT,1880,42,15-19,1922,0.014630196852565754
STAT,1886,40,25-29,1926,0.6917015615747587
STAT,1840,25,25-29,1865,37.509381237284316
STAT,1854,30,35-39,1884,7.946416269413293
STAT,1918,18,15-19,1936,49.739223287797905
STAT,1940,13,na,1953,4038.576940648366
SIM,1846,24,na,1870,1897
SIM,1888,59,na,1947,2511
STAT,1914,26,30-34,1940,39.990131369294446
STAT,1853,31,na,1884,2053.429129236175
SIM,1861,31,30-34,1892,28
SIM,1879,39,25-29,1918,3
SIM,1871,28,30-34,1899,2
SIM,1909,18,15-19,1927,9
STAT,1846,39,20-24,1885,0.5983334738734708
SIM,1840,84,na,1924,216
STAT,1830,38,15-19,1868,0.050332161150641076
STAT,1839,43,15-19,1882,0.01018770631625871
STAT,1865,25,30-34,1890,23.381718506437693
SIM,1843,42,35-39,1885,6
SIM,1943,26,50-100,1969,2
SIM,1891,45,na,1936,2911
STAT,1899,22,na,1921,3278.3165202554624
SIM,1868,33,40-44,1901,11
STAT,1906,29,45-49,1935,1.621696780108645
STAT,1891,18,35-39,1909,0.6843511066400495
SIM,1890,69,na,1959,2216
STAT,1875,2,na,1877,3389.09022004849
STAT,1802,79,na,1881,286.5552042975981
STAT,1914,28,25-29,1942,66.71139914625621
STAT,1935,26,50-100,1961,1.3714312721791495
STAT,1765,100,na,1865,0.1734997720961941
STAT,1832,24,20-24,1856,65.3797190381526
SIM,1879,42,na,1921,2736
STAT,1877,36,45-49,1913,2.0880588296219034
SIM,1832,27,35-39,1859,9
STAT,1886,21,50-100,1907,0.4361777324415507
SIM,1858,31,25-29,1889,3
SIM,1848,28,40-44,1876,6
STAT,1834,21,20-24,1855,55.48092526694123
STAT,1879,76,na,1955,998.5632842258736
STAT,1846,83,na,1929,301.26742934490807
STAT,1767,88,na,1855,33.9906
STAT,1822,79,na,1901,390.88623824647857
SIM,1885,36,45-49,1921,5
STAT,1840,15,15-19,1855,5.4501414978270795
SIM,1873,25,30-34,1898,30
STAT,1858,47,35-39,1905,0.11041694119601854
SIM,1837,67,na,1904,955
SIM,1898,33,20-24,1931,1
STAT,1916,23,30-34,1939,30.299115151458867
STAT,1923,26,40-44,1949,5.42554161231129
SIM,1874,37,50-100,1911,1
STAT,1860,52,40-44,1912,0.008645635529715773
STAT,1881,80,na,1961,796.203560763118
SIM,1857,45,50-100,1902,1
STAT,1917,16,50-100,1933,0.08157970877094838
SIM,1922,28,25-29,1950,88
SIM,1824,60,na,1884,1161
STAT,1839,26,30-34,1865,22.653782603591434
STAT,1912,4,na,1916,4104.213564052295
SIM,1867,48,50-100,1915,4
SIM,1906,38,na,1944,3371
STAT,1895,30,25-29,1925,13.618212212477163
STAT,1891,41,50-100,1932,1.3270475737487772
STAT,1837,78,na,1915,533.0092151491212
SIM,1878,54,50-100,1932,1
STAT,1848,19,35-39,1867,0.5488372554192852
STAT,1865,16,30-34,1881,1.5237373353471495
STAT,1789,106,na,1895,0.003695524218874928
SIM,1924,23,30-34,1947,55
STAT,1866,37,50-100,1903,1.1482250226295991
STAT,1824,103,na,1927,0.071348609879739
STAT,1949,15,40-44,1964,1.6443154402262172
STAT,1920,25,45-49,1945,1.926769257235119
STAT,1872,51,20-24,1923,7.52883866923032E-4
SIM,1920,15,45-49,1935,2
SIM,1844,17,15-19,1861,3
SIM,1840,53,na,1893,1483
SIM,1852,26,40-44,1878,6
STAT,1911,38,15-19,1949,0.018619803811650237
SIM,1845,30,35-39,1875,14
SIM,1873,16,30-34,1889,1
SIM,1864,15,na,1879,2811
SIM,1928,16,25-29,1944,99
STAT,1934,13,na,1947,5406.866405970198
STAT,1863,28,30-34,1891,22.455701115470156
STAT,1896,36,15-19,1932,0.07543556053786543
SIM,1798,69,na,1867,685
SIM,1889,72,na,1961,1583
STAT,1852,36,40-44,1888,3.372716790431648
SIM,1840,24,20-24,1864,64
STAT,1844,26,40-44,1870,2.92231473522128
SIM,1930,8,na,1938,5554
STAT,1837,32,50-100,1869,0.7837146808437128
STAT,1917,29,20-24,1946,19.18485033080677
SIM,1826,36,40-44,1862,10
SIM,1905,22,na,1927,3790
STAT,1876,43,35-39,1919,1.874753031122539
SIM,1955,7,na,1962,5060
STAT,1824,42,50-100,1866,1.3127476972736247
STAT,1854,33,40-44,1887,3.2985260635436844
SIM,1839,48,na,1887,1497
STAT,1860,36,35-39,1896,5.867698077091553
STAT,1915,21,20-24,1936,116.33149992140501
STAT,1898,24,15-19,1922,4.488775091514335
STAT,1903,47,20-24,1950,0.00969122618503743
STAT,1835,49,50-100,1884,0.18945986808836812
SIM,1886,31,35-39,1917,11
SIM,1918,6,na,1924,4535
STAT,1871,50,na,1921,2191.588463565306
STAT,1908,38,50-100,1946,0.3948467418403142
STAT,1885,27,40-44,1912,3.0115533970337665
SIM,1860,36,40-44,1896,7
STAT,1817,78,na,1895,357.4771619758928
STAT,1871,70,na,1941,1407.8786235766138
STAT,1792,75,na,1867,394.54054962791474
STAT,1873,51,na,1924,2215.197412026212
STAT,1850,22,15-19,1872,3.0319677166883574
SIM,1860,39,na,1899,2045
STAT,1913,33,20-24,1946,2.4382108988857403
SIM,1819,40,35-39,1859,4
SIM,1888,39,35-39,1927,13
SIM,1849,23,30-34,1872,20
SIM,1870,24,35-39,1894,10
SIM,1947,20,na,1967,4479
STAT,1944,26,45-49,1970,1.8863664631944808
SIM,1923,16,40-44,1939,1
SIM,1832,58,na,1890,1152
STAT,1862,24,35-39,1886,5.1358436286358815
STAT,1932,24,25-29,1956,122.05768838943017
SIM,1878,40,40-44,1918,10
SIM,1893,27,40-44,1920,5
STAT,1830,29,15-19,1859,0.45636244405834303
SIM,1842,21,20-24,1863,64
SIM,1832,75,na,1907,717
STAT,1868,20,20-24,1888,67.4862244936668
STAT,1921,47,40-44,1968,0.17950917283004844
STAT,1915,49,40-44,1964,0.1593693624846844
SIM,1866,38,35-39,1904,15
STAT,1940,16,30-34,1956,12.497505289774457
STAT,1818,36,40-44,1854,14.21975801204946
STAT,1915,16,40-44,1931,0.2961195276670427
SIM,1884,43,35-39,1927,3
SIM,1925,29,20-24,1954,24
SIM,1928,38,35-39,1966,2
SIM,1854,39,20-24,1893,1
STAT,1901,34,40-44,1935,6.087602613552744
SIM,1869,39,30-34,1908,2
STAT,1884,23,na,1907,2348.2978610296877
SIM,1887,71,na,1958,1409
SIM,1864,43,na,1907,2491
STAT,1860,27,35-39,1887,8.051769149336574
STAT,1875,60,na,1935,1978.1601066200485
STAT,1860,33,na,1893,1961.8875267495976
STAT,1931,17,35-39,1948,5.550827661979356
SIM,1862,33,40-44,1895,4
SIM,1844,35,45-49,1879,5
SIM,1900,46,50-100,1946,5
STAT,1858,29,na,1887,1908.1592375674913
SIM,1908,22,35-39,1930,8
STAT,1890,46,20-24,1936,0.008377752819308349
SIM,1825,48,50-100,1873,4
STAT,1840,24,15-19,1864,2.8988276659439443
SIM,1894,21,50-100,1915,4
STAT,1876,21,25-29,1897,59.87841609727721
STAT,1800,98,na,1898,1.13954199157312
STAT,1836,35,45-49,1871,1.5760000564935652
STAT,1857,24,25-29,1881,46.725912208568936
STAT,1897,41,na,1938,3154.5720085633807
SIM,1931,22,25-29,1953,134
STAT,1873,31,50-100,1904,0.9419864746407953
SIM,1914,29,45-49,1943,5
STAT,1934,21,25-29,1955,125.46952677734409
STAT,1809,52,35-39,1861,0.02765044668978118
STAT,1878,31,35-39,1909,10.661161614173862
STAT,1831,50,20-24,1881,5.045110873583391E-4
STAT,1908,17,45-49,1925,0.09781581780211877
STAT,1809,49,na,1858,1423.912523314955
SIM,1920,13,na,1933,4809
SIM,1853,26,na,1879,1839
SIM,1888,26,20-24,1914,17
SIM,1942,21,25-29,1963,115
STAT,1836,34,35-39,1870,7.909299884073654
SIM,1839,76,na,1915,535
SIM,1842,34,na,1876,1856
STAT,1906,33,15-19,1939,0.11978521824618796
STAT,1820,44,na,1864,1349.943545221156
SIM,1876,20,20-24,1896,86
STAT,1810,45,35-39,1855,0.5618532240608518
STAT,1949,20,20-24,1969,131.17228504207006
STAT,1908,22,25-29,1930,85.72124296260974
SIM,1883,22,20-24,1905,81
STAT,1815,49,35-39,1864,0.30045256435711654
STAT,1880,46,30-34,1926,0.10296829466389858
SIM,1912,20,35-39,1932,13
SIM,1855,35,20-24,1890,1
STAT,1920,47,na,1967,4100.987181254223
STAT,1855,36,25-29,1891,2.1776627328065827
SIM,1888,25,na,1913,2972
STAT,1829,36,15-19,1865,0.0467837328302519
STAT,1848,50,50-100,1898,0.012507965728846313
SIM,1919,23,20-24,1942,131
SIM,1940,24,25-29,1964,139
SIM,1827,32,40-44,1859,3
STAT,1817,48,50-100,1865,0.5197845374008114
STAT,1826,38,50-100,1864,1.3792947964306537
SIM,1824,49,na,1873,1415
SIM,1910,18,20-24,1928,38
STAT,1945,22,45-49,1967,1.2453798332617958
STAT,1855,35,15-19,1890,0.04267014016232324
STAT,1902,18,20-24,1920,25.236930271488493
STAT,1808,64,na,1872,866.6787651095186
STAT,1880,84,na,1964,602.3302878393026
STAT,1838,47,15-19,1885,2.754809515359649E-4
STAT,1870,16,40-44,1886,0.18421415199838592
SIM,1849,24,40-44,1873,3
STAT,1851,43,30-34,1894,0.86422634836922
STAT,1939,25,25-29,1964,66.85813477187834
SIM,1836,43,40-44,1879,4
STAT,1861,32,35-39,1893,8.499445148630727
STAT,1925,3,na,1928,4951.720826153357
SIM,1870,25,45-49,1895,1
SIM,1893,71,na,1964,1983
SIM,1874,39,40-44,1913,14
STAT,1899,27,35-39,1926,13.374880090891876
SIM,1872,72,na,1944,1238
SIM,1784,86,na,1870,65
STAT,1871,39,15-19,1910,0.055779740748541466
SIM,1923,21,20-24,1944,127
SIM,1921,19,40-44,1940,1
STAT,1908,31,25-29,1939,8.842825504623699
SIM,1894,23,40-44,1917,3
SIM,1835,86,na,1921,81
STAT,1838,32,45-49,1870,1.4505657779912977
STAT,1874,49,40-44,1923,0.1733565210600799
SIM,1916,22,25-29,1938,123
STAT,1878,50,45-49,1928,0.015434264465971617
STAT,1862,99,na,1961,4.076914925519378
STAT,1822,90,na,1912,44.08162092871974
STAT,1843,21,na,1864,1823.2192437606197
STAT,1921,40,na,1961,4236.546690199603
STAT,1841,20,15-19,1861,3.1706383694658418
SIM,1858,21,15-19,1879,4
SIM,1887,15,15-19,1902,12
STAT,1898,22,50-100,1920,0.5583502034652877
SIM,1823,43,50-100,1866,4
STAT,1828,43,40-44,1871,2.1116187087568123
STAT,1939,26,35-39,1965,15.24389486397053
STAT,1845,87,na,1932,128.73283993687104
STAT,1935,33,40-44,1968,5.466619759202249
STAT,1895,34,40-44,1929,5.670998126322582
SIM,1868,25,na,1893,2214
STAT,1866,18,40-44,1884,0.17454186921998122
STAT,1913,19,40-44,1932,0.2869953358118419
SIM,1847,35,30-34,1882,4
STAT,1848,27,50-100,1875,0.6235063084437045
STAT,1886,23,40-44,1909,2.2152926859878
STAT,1829,45,15-19,1874,3.062992662757554E-4
SIM,1909,60,na,1969,3489
STAT,1847,45,30-34,1892,0.07320031640279522
SIM,1828,84,na,1912,163
SIM,1920,3,na,1923,4919
STAT,1946,18,na,1964,4121.986873472599
STAT,1900,38,40-44,1938,1.3190536902594665
STAT,1849,48,35-39,1897,0.1080840440492333
STAT,1891,18,50-100,1909,0.06110276605768585
STAT,1929,36,20-24,1965,0.34237809124240176
STAT,1862,25,45-49,1887,0.9861086933112332
SIM,1917,47,na,1964,3704
STAT,1825,53,30-34,1878,0.007551029603656439
SIM,1913,27,35-39,1940,26
STAT,1839,35,30-34,1874,4.61013940096069
STAT,1858,26,35-39,1884,7.883452951732291
STAT,1880,33,na,1913,2520.503580283844
STAT,1932,23,15-19,1955,7.036560876802118
SIM,1886,78,na,1964,1192
STAT,1888,36,20-24,1924,0.9233608620326752
STAT,1793,71,na,1864,585.8962205841995
STAT,1841,46,50-100,1887,0.18687478574305946
STAT,1830,88,na,1918,90.5714511054076
STAT,1855,26,15-19,1881,0.3585429742850281
SIM,1907,20,25-29,1927,115
STAT,1906,19,35-39,1925,0.8028790393638079
SIM,1847,26,30-34,1873,29
STAT,1906,49,na,1955,3241.2460896972802
SIM,1873,57,na,1930,1924
SIM,1896,54,na,1950,2757
STAT,1932,19,45-49,1951,0.6648796077898702
SIM,1920,30,35-39,1950,11
SIM,1928,19,na,1947,5071
SIM,1905,36,40-44,1941,3
STAT,1842,52,50-100,1894,0.013525143401299412
STAT,1785,73,na,1858,480.6495650253337
SIM,1857,33,na,1890,2084
SIM,1903,38,30-34,1941,9
STAT,1883,27,na,1910,2358.7711582380025
SIM,1940,23,15-19,1963,6
SIM,1916,31,25-29,1947,13
STAT,1909,43,40-44,1952,0.23466274240518392
STAT,1896,27,15-19,1923,0.606564544746456
STAT,1891,23,15-19,1914,4.112610243178077
SIM,1914,19,35-39,1933,3
STAT,1896,48,na,1944,2970.618183487956
SIM,1830,29,25-29,1859,47
SIM,1887,33,45-49,1920,4
SIM,1852,44,35-39,1896,7
STAT,1835,42,35-39,1877,1.6291190595019451
SIM,1839,34,25-29,1873,2
STAT,1871,21,50-100,1892,0.4104221389445128
STAT,1940,15,20-24,1955,139.04389736869365
STAT,1891,56,na,1947,2550.517853686019
STAT,1824,32,15-19,1856,0.2779729357407417
STAT,1924,31,50-100,1955,0.9753032140042083
STAT,1928,43,45-49,1971,0.21411204865296168
SIM,1857,15,35-39,1872,3
SIM,1890,21,15-19,1911,4
STAT,1910,27,45-49,1937,1.6831299965934587
STAT,1814,106,na,1920,0.005683042432372966
STAT,1912,30,35-39,1942,9.145015999730035
STAT,1928,44,20-24,1972,0.022680319209613747
SIM,1815,66,na,1881,826
SIM,1873,28,35-39,1901,14
SIM,1902,48,na,1950,3348
STAT,1905,27,35-39,1932,14.088367619846485
SIM,1932,31,50-100,1963,4
STAT,1919,32,45-49,1951,1.714134680268451
SIM,1866,26,35-39,1892,14
SIM,1866,48,45-49,1914,2
STAT,1844,44,35-39,1888,1.4301908323473824
STAT,1849,15,35-39,1864,0.5343531568309132
SIM,1881,55,na,1936,1874
STAT,1904,20,35-39,1924,8.508520114267835
SIM,1927,32,45-49,1959,2
STAT,1879,33,45-49,1912,1.8302319713108712
STAT,1882,21,15-19,1903,3.2373365133673557
SIM,1838,19,15-19,1857,2
SIM,1844,34,35-39,1878,13
SIM,1896,36,20-24,1932,4
STAT,1825,36,na,1861,2105.5836059609815
STAT,1802,70,na,1872,672.4858499790681
STAT,1884,77,na,1961,1055.3367013335032
SIM,1851,15,35-39,1866,2
STAT,1876,33,25-29,1909,10.63635200976301
STAT,1872,29,20-24,1901,11.827220800612679
STAT,1922,23,20-24,1945,128.42137804173277
STAT,1896,33,45-49,1929,2.3215145517431655
STAT,1891,44,15-19,1935,0.01703579313256728
SIM,1877,44,40-44,1921,6
STAT,1832,27,25-29,1859,38.85318629545209
STAT,1923,29,45-49,1952,1.9897710564933042
SIM,1822,68,na,1890,851
STAT,1852,27,45-49,1879,0.9807644248906785
STAT,1799,96,na,1895,2.8814400248462957
STAT,1841,27,35-39,1868,8.962134298900468
SIM,1839,30,45-49,1869,1
SIM,1854,28,30-34,1882,40
STAT,1848,100,na,1948,0.8667890606475808
STAT,1857,28,40-44,1885,2.414647575067016
STAT,1879,48,15-19,1927,4.163021610415824E-4
STAT,1881,16,15-19,1897,5.791863703589547
SIM,1826,42,35-39,1868,1
SIM,1898,34,30-34,1932,38
STAT,1846,31,50-100,1877,0.830277392570551
STAT,1854,15,45-49,1869,0.05934097405315516
STAT,1931,28,25-29,1959,85.84053406288943
SIM,1930,16,15-19,1946,61
SIM,1884,12,na,1896,2612
SIM,1899,65,na,1964,2711
SIM,1880,29,20-24,1909,19
STAT,1925,17,45-49,1942,0.6098489499337699
SIM,1918,27,20-24,1945,30
STAT,1847,68,na,1915,1144.2180893957668
SIM,1866,44,30-34,1910,2
SIM,1933,17,45-49,1950,2
SIM,1828,30,35-39,1858,12
SIM,1837,42,45-49,1879,2
STAT,1931,19,na,1950,4842.942404613636
STAT,1857,75,na,1932,811.4676448979974
STAT,1846,28,30-34,1874,22.95258178810789
STAT,1914,29,35-39,1943,15.161440422716282
STAT,1806,83,na,1889,138.59057229055637
STAT,1869,44,40-44,1913,2.178882264235781
STAT,1835,25,50-100,1860,0.6350694366222979
SIM,1956,14,na,1970,5292
STAT,1829,42,45-49,1871,1.1622812479357227
STAT,1898,21,45-49,1919,0.9576613722763878
SIM,1908,44,45-49,1952,4
STAT,1789,89,na,1878,46.324082349144945
STAT,1845,56,na,1901,1490.332110713942
SIM,1927,18,30-34,1945,22
SIM,1884,33,25-29,1917,9
SIM,1842,68,na,1910,1010
STAT,1853,85,na,1938,226.70274010263026
STAT,1887,21,35-39,1908,6.600222121003645
SIM,1931,7,na,1938,5190
STAT,1914,17,35-39,1931,0.8757691269278602
STAT,1843,27,35-39,1870,8.009122538086787
SIM,1931,29,45-49,1960,4
SIM,1896,39,25-29,1935,4
SIM,1859,11,na,1870,2619
STAT,1863,27,20-24,1890,10.498355718343888
STAT,1919,39,30-34,1958,1.9727454403045024
STAT,1900,27,na,1927,3348.318724539897
STAT,1818,42,35-39,1860,3.554664675316985
STAT,1851,50,na,1901,1653.781141718685
SIM,1871,45,na,1916,2176
SIM,1871,27,20-24,1898,13
SIM,1826,58,na,1884,1502
SIM,1831,70,na,1901,947
STAT,1851,21,20-24,1872,62.76337929642297
STAT,1895,32,50-100,1927,1.20849432642161
STAT,1928,10,na,1938,5061.579807329059
SIM,1889,22,20-24,1911,85
SIM,1922,17,35-39,1939,5
SIM,1884,21,25-29,1905,2
STAT,1884,26,50-100,1910,0.6393168860301891
STAT,1910,24,40-44,1934,3.165757152592453
SIM,1902,17,15-19,1919,11
STAT,1863,92,na,1955,37.27163425306465
STAT,1885,33,35-39,1918,10.138157171402558
STAT,1826,83,na,1909,217.8348559044173
SIM,1893,33,35-39,1926,16
STAT,1908,39,20-24,1947,0.24663616598914556
STAT,1827,68,na,1895,908.7559866272629
STAT,1913,3,na,1916,4170.53477087891
STAT,1906,18,na,1924,3705.693546072913
STAT,1889,17,30-34,1906,1.9849957513295247
STAT,1862,21,30-34,1883,16.019289133973885
STAT,1905,38,25-29,1943,0.902875593939117
SIM,1843,32,25-29,1875,3
SIM,1886,17,20-24,1903,22
SIM,1863,32,45-49,1895,2
SIM,1937,21,15-19,1958,7
STAT,1940,19,35-39,1959,4.298333766349292
STAT,1911,23,45-49,1934,1.0732581521697662
SIM,1945,16,25-29,1961,69
SIM,1831,28,na,1859,1842
SIM,1897,17,30-34,1914,2
STAT,1880,23,40-44,1903,2.203488026309434
STAT,1902,16,50-100,1918,0.0700958864492027
STAT,1855,54,50-100,1909,0.011055537599292694
SIM,1845,37,20-24,1882,4
STAT,1860,33,30-34,1893,14.35437419799968
STAT,1908,17,50-100,1925,0.07336186335158908
STAT,1936,17,20-24,1953,131.04142651090712
STAT,1823,36,15-19,1859,0.10204733609325808
STAT,1929,21,15-19,1950,6.824463549806374
STAT,1939,17,50-100,1956,0.3785961704036476
STAT,1922,16,15-19,1938,53.19037444768295
STAT,1899,39,35-39,1938,2.094840195401865
STAT,1841,39,35-39,1880,6.103673837514549
STAT,1826,37,45-49,1863,2.3044367305279683
STAT,1832,38,na,1870,1810.8309403213832
STAT,1909,21,30-34,1930,27.036863020060267
STAT,1837,49,20-24,1886,0.008283158415533887
STAT,1875,15,50-100,1890,0.05105132826843986
STAT,1873,46,20-24,1919,0.012321800134533769
STAT,1890,27,15-19,1917,0.5599419025159462
SIM,1927,39,30-34,1966,3
STAT,1867,31,25-29,1898,9.782805812353425
STAT,1869,27,20-24,1896,11.519798193521524
STAT,1821,48,15-19,1869,5.778449579865603E-4
STAT,1859,43,35-39,1902,1.4603623623853497
STAT,1934,29,20-24,1963,24.78752822208491
SIM,1857,33,30-34,1890,22
SIM,1897,30,na,1927,3285
SIM,1930,23,20-24,1953,179
SIM,1917,21,30-34,1938,37
STAT,1872,18,30-34,1890,1.614207989836491
SIM,1836,25,45-49,1861,1
SIM,1845,16,20-24,1861,22
STAT,1920,28,15-19,1948,0.7792763524481964
STAT,1937,16,25-29,1953,42.664868429064676
SIM,1929,27,30-34,1956,73
STAT,1897,32,15-19,1929,0.19282836410020032
STAT,1897,4,na,1901,3562.1058918400913
STAT,1903,52,na,1955,3080.741697148468
STAT,1944,23,40-44,1967,3.6647533067778095
STAT,1843,15,35-39,1858,0.47856617335691787
STAT,1858,44,30-34,1902,0.8986851402870993
STAT,1895,16,45-49,1911,0.08636959705542029
STAT,1944,25,50-100,1969,1.0872718171087712
SIM,1845,93,na,1938,6
SIM,1925,22,na,1947,4386
STAT,1875,18,na,1893,2612.7394825705874
STAT,1880,30,na,1910,2551.5312079528717
SIM,1942,29,20-24,1971,29
SIM,1859,21,30-34,1880,30
STAT,1930,29,50-100,1959,1.2779380212420526
STAT,1862,46,45-49,1908,0.20642842084632682
SIM,1913,38,25-29,1951,1
STAT,1855,63,na,1918,1343.0829983496762
STAT,1845,22,40-44,1867,1.8902221094290352
STAT,1930,18,30-34,1948,15.885479876483553
STAT,1884,50,35-39,1934,0.008697800247952643
STAT,1857,20,45-49,1877,0.6437618408832616
SIM,1843,20,25-29,1863,61
SIM,1834,37,45-49,1871,4
STAT,1859,56,na,1915,1656.8672724648789
STAT,1910,40,45-49,1950,0.16048971104309537
SIM,1899,30,50-100,1929,1
SIM,1880,18,30-34,1898,2
STAT,1899,20,15-19,1919,4.60023310133914
SIM,1877,33,na,1910,2468
STAT,1825,31,20-24,1856,7.345559103714768
STAT,1855,32,45-49,1887,1.3365091165016152
SIM,1901,20,25-29,1921,99
STAT,1837,37,20-24,1874,0.6402733981308144
STAT,1835,32,25-29,1867,9.791081433784733
SIM,1865,28,40-44,1893,2
SIM,1853,22,40-44,1875,7
STAT,1892,22,20-24,1914,87.33826057025546
SIM,1944,17,20-24,1961,176
SIM,1919,26,25-29,1945,80
SIM,1825,37,35-39,1862,8
STAT,1913,32,45-49,1945,1.5796271338396497
SIM,1914,22,25-29,1936,111
STAT,1872,89,na,1961,193.41319699851817
STAT,1941,18,40-44,1959,1.4540567791477326
SIM,1844,31,30-34,1875,33
STAT,1853,82,na,1935,385.8527196683912
STAT,1846,20,35-39,1866,5.54342270260159
SIM,1938,20,20-24,1958,112
SIM,1881,28,25-29,1909,51
STAT,1838,36,25-29,1874,2.3499917371463246
STAT,1916,45,40-44,1961,0.1639620991946723
SIM,1855,38,25-29,1893,1
STAT,1862,45,na,1907,1981.9206573872586
SIM,1831,73,na,1904,808
STAT,1877,95,na,1972,75.89712180893622
STAT,1878,38,20-24,1916,0.8041915215852679
SIM,1794,76,na,1870,434
SIM,1848,21,20-24,1869,66
STAT,1863,20,35-39,1883,5.403498115136545
STAT,1860,30,na,1890,1986.038540136234
SIM,1887,40,na,1927,2567
STAT,1849,33,30-34,1882,14.236080655371815
SIM,1836,33,50-100,1869,3
STAT,1866,32,20-24,1898,2.5279885815549243
SIM,1918,40,na,1958,4209
STAT,1909,49,15-19,1958,3.3957069648451983E-4
STAT,1820,37,50-100,1857,3.0087388750807995
STAT,1886,58,na,1944,2108.8961104092336
STAT,1904,37,na,1941,3441.742873742035
STAT,1817,50,50-100,1867,0.03236642693315454
STAT,1951,21,25-29,1972,111.53533819871467
STAT,1835,20,25-29,1855,90.29894444799899
STAT,1900,24,na,1924,3297.4171307789584
SIM,1949,20,30-34,1969,51
SIM,1837,64,na,1901,1031
SIM,1943,7,na,1950,4231
STAT,1873,28,25-29,1901,43.16036846627105
SIM,1886,38,20-24,1924,1
STAT,1820,98,na,1918,1.6535798402421706
STAT,1893,28,45-49,1921,1.4188866530206237
STAT,1877,21,40-44,1898,2.1787690194223606
SIM,1915,12,na,1927,4548
STAT,1906,22,25-29,1928,84.21421848001435
STAT,1921,40,20-24,1961,0.02014551632538893
STAT,1857,38,50-100,1895,0.9629611760641379
SIM,1841,80,na,1921,333
SIM,1895,29,30-34,1924,40
SIM,1838,60,na,1898,1369
STAT,1926,34,45-49,1960,1.9205368214095613
SIM,1828,39,na,1867,1657
SIM,1859,24,35-39,1883,10
SIM,1829,36,25-29,1865,4
SIM,1867,43,35-39,1910,4
STAT,1835,37,50-100,1872,1.1396664289203766
STAT,1831,53,na,1884,1375.332858720463
STAT,1861,22,25-29,1883,49.3586050266074
SIM,1904,33,20-24,1937,2
STAT,1832,48,25-29,1880,0.04591652965618017
SIM,1846,36,25-29,1882,4
STAT,1873,82,na,1955,477.73821540255494
SIM,1839,38,40-44,1877,5
STAT,1842,45,na,1887,2078.530833891064
STAT,1837,110,na,1947,1.885121995338975E-4
SIM,1905,39,45-49,1944,4
STAT,1816,103,na,1919,0.07337536053371037
SIM,1860,20,25-29,1880,63
STAT,1840,19,30-34,1859,1.429586514550431
STAT,1898,29,40-44,1927,4.072237795519804
STAT,1866,49,50-100,1915,0.2248973022346822
SIM,1942,8,na,1950,4421
SIM,1837,98,na,1935,3
SIM,1896,27,25-29,1923,62
SIM,1849,27,45-49,1876,1
STAT,1877,39,15-19,1916,0.057947677543865414
STAT,1888,27,25-29,1915,50.42801797222721
SIM,1899,32,25-29,1931,27
STAT,1797,61,na,1858,952.3108853411529
SIM,1952,1,na,1953,4859
SIM,1828,38,30-34,1866,8
STAT,1857,42,20-24,1899,0.12502935052261746
SIM,1917,28,15-19,1945,1
STAT,1900,34,25-29,1934,14.247453735585163
STAT,1852,20,25-29,1872,52.32318994470629
STAT,1821,45,45-49,1866,0.356065549498459
STAT,1936,31,35-39,1967,8.966361285107004
SIM,1930,33,50-100,1963,2
SIM,1821,80,na,1901,333
STAT,1882,15,20-24,1897,17.425251405468934
SIM,1870,21,30-34,1891,29
SIM,1875,35,40-44,1910,5
STAT,1846,49,30-34,1895,0.07192626681329752
SIM,1964,1,na,1965,5258
STAT,1919,18,30-34,1937,13.56434419791044
STAT,1888,39,25-29,1927,3.3977797691008322
STAT,1852,39,45-49,1891,1.4966282238954145
STAT,1855,97,na,1952,4.043798743837516
STAT,1875,48,50-100,1923,0.25153978959037837
SIM,1907,24,40-44,1931,4
STAT,1888,36,na,1924,2822.1057918888573
STAT,1875,23,30-34,1898,18.418123131945215
STAT,1878,29,na,1907,2484.2782615492492
STAT,1897,39,35-39,1936,2.0463391409489473
SIM,1875,38,na,1913,2302
SIM,1773,91,na,1864,24
STAT,1856,31,15-19,1887,0.11278805705378539
STAT,1781,83,na,1864,74.80524991943697
STAT,1929,28,35-39,1957,18.982632348743515
SIM,1894,8,na,1902,3740
SIM,1921,15,na,1936,4500
STAT,1882,25,30-34,1907,24.80379345998771
STAT,1909,28,15-19,1937,0.6784164712151785
SIM,1929,1,na,1930,5158
STAT,1887,29,30-34,1916,28.193313760847055
SIM,1777,84,na,1861,72
STAT,1837,30,35-39,1867,8.844004032622095
SIM,1860,39,45-49,1899,6
SIM,1824,46,na,1870,1484
STAT,1939,22,20-24,1961,112.73545737102157
SIM,1834,27,35-39,1861,11
SIM,1942,14,na,1956,4384
STAT,1914,47,30-34,1961,0.08920200125260062
STAT,1791,90,na,1881,27.88719784300642
SIM,1871,20,35-39,1891,6
STAT,1869,15,na,1884,2544.265976409821
SIM,1877,26,45-49,1903,1
STAT,1884,16,35-39,1900,0.5478538063105804
STAT,1902,59,na,1961,2905.27866920312
SIM,1830,26,20-24,1856,12
STAT,1833,31,na,1864,1994.2939302643797
STAT,1868,30,na,1898,2322.0000115741973
SIM,1834,20,15-19,1854,2
STAT,1817,37,35-39,1854,26.789085097747073
SIM,1828,53,na,1881,1321
STAT,1864,37,15-19,1901,0.051178547417720356
STAT,1867,35,40-44,1902,4.20352243698591
STAT,1853,50,40-44,1903,0.008831229651806036
STAT,1856,38,35-39,1894,5.449724899667022
SIM,1945,21,50-100,1966,2
STAT,1836,38,15-19,1874,0.04303275433484695
STAT,1836,31,30-34,1867,14.067612422749576
STAT,1879,37,25-29,1916,3.0346733150772445
SIM,1840,27,25-29,1867,43
SIM,1947,22,20-24,1969,180
SIM,1892,16,35-39,1908,3
STAT,1893,37,na,1930,3021.40284201402
STAT,1847,48,35-39,1895,0.1035060771401363
SIM,1889,29,40-44,1918,5
STAT,1831,28,20-24,1859,10.033509679518739
STAT,1836,103,na,1939,0.09048966303950501
STAT,1857,45,25-29,1902,0.0458555201709383
STAT,1838,103,na,1941,0.09607275473925217
STAT,1924,37,na,1961,4482.926723770269
STAT,1800,92,na,1892,14.610021317125971
STAT,1855,19,50-100,1874,0.043346590923192964
SIM,1823,34,30-34,1857,17
SIM,1893,6,na,1899,3439
SIM,1948,21,25-29,1969,160
STAT,1859,110,na,1969,0.0026890432398110954
SIM,1892,28,35-39,1920,16
STAT,1906,16,30-34,1922,2.3505056253963725
STAT,1884,28,35-39,1912,9.576456308160399
SIM,1914,16,30-34,1930,6
STAT,1861,104,na,1965,0.3054221149028333
SIM,1890,25,30-34,1915,35
SIM,1890,30,50-100,1920,5
SIM,1936,34,50-100,1970,1
STAT,1842,17,40-44,1859,0.21146302723733032
STAT,1854,16,na,1870,2072.9683126190157
STAT,1896,48,15-19,1944,2.978634150399154E-4
STAT,1927,27,20-24,1954,22.429972948432194
SIM,1837,28,30-34,1865,22
SIM,1942,5,na,1947,4441
STAT,1775,83,na,1858,92.56908642073276
STAT,1860,64,na,1924,1435.2348720472394
SIM,1879,11,na,1890,2986
STAT,1864,23,na,1887,2174.411606963876
STAT,1928,22,50-100,1950,0.8303822934104879
STAT,1852,24,40-44,1876,1.850512224358931
STAT,1871,15,45-49,1886,0.06675354515258228
SIM,1875,52,na,1927,2135
STAT,1895,69,na,1964,2171.096235273844
SIM,1850,38,40-44,1888,9
SIM,1856,30,45-49,1886,2
STAT,1896,30,40-44,1926,5.844452161619017
STAT,1933,11,na,1944,5367.84256297077
STAT,1842,38,40-44,1880,4.57558673868141
STAT,1935,18,15-19,1953,62.51866648450137
STAT,1856,25,20-24,1881,9.549961794088484
SIM,1828,50,na,1878,1413
SIM,1943,18,15-19,1961,71
SIM,1883,44,30-34,1927,1
STAT,1820,50,45-49,1870,0.024652080228099414
STAT,1924,1,na,1925,5025.279179726704
STAT,1841,24,30-34,1865,16.632705236287784
SIM,1872,16,15-19,1888,4
SIM,1929,33,25-29,1962,13
STAT,1893,25,50-100,1918,0.8259336983755629
STAT,1860,15,35-39,1875,0.5286971701920075
STAT,1864,16,15-19,1880,6.184948890637734
SIM,1857,19,na,1876,2414
SIM,1936,14,na,1950,3917
STAT,1881,18,na,1899,2452.4007182329133
STAT,1854,37,20-24,1891,0.5785117319897478
STAT,1882,18,25-29,1900,5.529504628383716
STAT,1931,25,20-24,1956,23.838319020796366
SIM,1899,11,na,1910,3930
SIM,1918,41,35-39,1959,2
SIM,1931,19,35-39,1950,5
STAT,1850,29,35-39,1879,8.570167486956102
STAT,1929,15,20-24,1944,175.693700393256
STAT,1953,17,na,1970,4498.619037556446
STAT,1801,77,na,1878,373.05949371672136
SIM,1835,44,35-39,1879,3
SIM,1935,27,20-24,1962,29
STAT,1867,17,45-49,1884,0.06352183638977746
STAT,1913,26,15-19,1939,0.7121595256467298
SIM,1824,91,na,1915,10
STAT,1837,19,25-29,1856,5.611772364984159
STAT,1834,25,35-39,1859,7.6446899643913415
SIM,1875,38,45-49,1913,1
SIM,1933,31,25-29,1964,4
STAT,1830,32,40-44,1862,4.16322912644338
STAT,1922,26,25-29,1948,75.49980992837298
SIM,1901,40,45-49,1941,1
STAT,1938,27,30-34,1965,39.18849197466331
SIM,1930,26,25-29,1956,98
STAT,1839,31,15-19,1870,0.12554370609050314
SIM,1885,24,45-49,1909,4
SIM,1890,18,25-29,1908,11
STAT,1824,39,35-39,1863,9.233456904246902
SIM,1791,65,na,1856,680
SIM,1860,24,40-44,1884,3
SIM,1813,51,na,1864,1275
SIM,1937,15,20-24,1952,149
STAT,1849,54,30-34,1903,0.004526035619504288
STAT,1844,36,50-100,1880,1.1397647024707498
SIM,1819,79,na,1898,299
STAT,1848,30,na,1878,2106.8207618802417
STAT,1848,30,45-49,1878,1.695197332930669
STAT,1870,50,40-44,1920,0.010591243410361148
SIM,1877,30,na,1907,2507
SIM,1852,36,50-100,1888,1
STAT,1840,36,15-19,1876,0.04704353243924109
STAT,1877,32,30-34,1909,18.20041655542395
SIM,1870,60,na,1930,2126
SIM,1908,34,35-39,1942,11
STAT,1873,49,25-29,1922,0.05774579194079723
SIM,1901,28,20-24,1929,20
STAT,1935,21,40-44,1956,4.6275357905575
STAT,1837,75,na,1912,702.2780052712326
STAT,1923,19,35-39,1942,4.9517689837716
STAT,1808,53,30-34,1861,0.019740824231307793
STAT,1826,34,40-44,1860,5.440670621388143
STAT,1845,25,45-49,1870,1.0018105126066064
STAT,1883,35,25-29,1918,2.872742064643327
STAT,1953,17,20-24,1970,165.70015736768386
STAT,1835,39,45-49,1874,1.8124437106473614
SIM,1826,32,25-29,1858,16
STAT,1948,10,na,1958,4542.425708260368
SIM,1903,16,20-24,1919,34
STAT,1796,68,na,1864,687.5874089329611
STAT,1925,31,25-29,1956,11.098523956766838
SIM,1860,53,na,1913,1887
SIM,1893,23,25-29,1916,78
STAT,1885,23,25-29,1908,57.37333983797294
STAT,1875,63,na,1938,1850.7115664050195
STAT,1832,45,20-24,1877,0.009941083437983366
STAT,1814,95,na,1909,6.223113041503805
STAT,1875,44,30-34,1919,1.176360077661768
STAT,1905,35,20-24,1940,0.24523943159040434
SIM,1839,79,na,1918,329
SIM,1878,29,30-34,1907,30
SIM,1923,41,na,1964,4432
STAT,1816,44,25-29,1860,1.7162410888834836
SIM,1843,39,45-49,1882,2
STAT,1897,36,30-34,1933,7.251295406819115
STAT,1781,111,na,1892,2.8276208692512014E-4
SIM,1862,37,20-24,1899,1
SIM,1885,32,30-34,1917,27
STAT,1901,19,15-19,1920,8.35741709699708
STAT,1918,15,45-49,1933,0.11064214154379946
STAT,1860,15,50-100,1875,0.04720509573544715
STAT,1911,27,50-100,1938,0.9792991986328485
SIM,1911,22,40-44,1933,4
STAT,1878,17,20-24,1895,18.58756335529198
STAT,1881,22,45-49,1903,0.6788881956721988
SIM,1891,35,25-29,1926,3
STAT,1918,51,na,1969,3896.6272566822017
STAT,1885,70,na,1955,1410.5634293526157
STAT,1853,47,50-100,1900,0.2021585476908405
STAT,1831,38,30-34,1869,4.213830751449014
STAT,1867,34,na,1901,2250.477313772043
SIM,1864,25,20-24,1889,21
STAT,1862,28,15-19,1890,0.39433560222583275
SIM,1861,47,50-100,1908,4
STAT,1830,57,na,1887,1335.2656855222654
SIM,1891,39,40-44,1930,8
STAT,1908,44,na,1952,3425.992830992365
STAT,1870,22,35-39,1892,5.787560520496258
STAT,1899,24,30-34,1923,24.535962356256725
SIM,1888,70,na,1958,1992
STAT,1915,28,40-44,1943,4.780320351892935
STAT,1862,42,na,1904,2013.4283291170293
SIM,1923,28,40-44,1951,8
SIM,1898,37,35-39,1935,2
STAT,1816,48,40-44,1864,0.43614081602293114
STAT,1921,43,25-29,1964,0.08110412643581413
STAT,1847,38,25-29,1885,2.2135934123436827
STAT,1903,22,40-44,1925,2.9973782669878877
SIM,1936,22,50-100,1958,1
STAT,1819,50,na,1869,1320.265175337707
SIM,1900,13,na,1913,3792
STAT,1883,39,40-44,1922,4.28305300725794
SIM,1907,34,na,1941,3763
SIM,1818,41,30-34,1859,3
SIM,1902,23,45-49,1925,1
STAT,1893,25,40-44,1918,3.867698311175005
STAT,1868,45,35-39,1913,0.1364880173984417
STAT,1928,37,15-19,1965,0.024530208835272408
STAT,1774,87,na,1861,35.24507839659952
SIM,1926,33,40-44,1959,6
SIM,1875,25,30-34,1900,30
STAT,1809,49,45-49,1858,0.7820630998572137
SIM,1837,24,15-19,1861,3
STAT,1834,43,30-34,1877,0.8149039753463084
SIM,1833,31,20-24,1864,2
STAT,1858,38,35-39,1896,5.576689813577535
SIM,1865,93,na,1958,100
STAT,1853,34,35-39,1887,8.447097823568381
STAT,1928,22,45-49,1950,1.4199536676276343
STAT,1947,23,25-29,1970,105.41450015207685
STAT,1853,9,na,1862,2423.6502117726145
SIM,1904,36,25-29,1940,3
STAT,1842,90,na,1932,70.98290136291517
STAT,1916,48,45-49,1964,0.22433831416593064
STAT,1896,15,15-19,1911,7.970889398379773
STAT,1917,22,35-39,1939,10.101333951450535
SIM,1890,28,35-39,1918,13
SIM,1842,65,na,1907,1167
STAT,1857,49,40-44,1906,0.13212982979237664
SIM,1915,33,30-34,1948,29
STAT,1849,36,35-39,1885,5.717700040860005
STAT,1918,33,40-44,1951,4.180538868971279
SIM,1861,34,35-39,1895,13
STAT,1845,43,40-44,1888,1.6523160382964084
STAT,1846,43,50-100,1889,0.8011016032787414
STAT,1792,107,na,1899,8.477776153564824E-4
STAT,1874,20,45-49,1894,0.725465580306203
STAT,1888,24,20-24,1912,81.63710703078068
SIM,1873,71,na,1944,1232
STAT,1839,56,na,1895,1446.0451834301196
STAT,1930,32,45-49,1962,2.052535411996765
SIM,1893,26,na,1919,3031
STAT,1790,101,na,1891,0.10536991772833265
STAT,1804,51,na,1855,1095.873669901169
SIM,1934,24,35-39,1958,21
STAT,1919,20,45-49,1939,1.2514271887188095
SIM,1862,34,na,1896,2138
SIM,1934,33,na,1967,5267
STAT,1919,35,15-19,1954,0.020946141405152517
STAT,1879,27,15-19,1906,0.4782023966315445
STAT,1824,57,na,1881,1081.516948313184
SIM,1924,26,na,1950,4607
STAT,1921,20,35-39,1941,10.805346712454897
SIM,1853,25,45-49,1878,1
SIM,1853,43,40-44,1896,3
STAT,1859,30,20-24,1889,2.2277771086329317
STAT,1907,33,30-34,1940,14.80715760573844
STAT,1917,49,50-100,1966,0.2370666601674946
STAT,1937,34,20-24,1971,2.4330803365964297
SIM,1943,21,40-44,1964,7
STAT,1898,6,na,1904,3576.8625192752465
STAT,1829,49,na,1878,1411.445536061854
STAT,1882,28,35-39,1910,9.406776842223126
SIM,1936,22,45-49,1958,2
SIM,1891,48,na,1939,2822
STAT,1867,38,45-49,1905,1.886842867885745
SIM,1925,22,35-39,1947,16
STAT,1915,42,20-24,1957,0.017940966243698113
SIM,1855,86,na,1941,239
SIM,1908,19,na,1927,3662
STAT,1842,34,25-29,1876,10.911163277583281
STAT,1910,20,25-29,1930,88.03852827430319
SIM,1850,34,25-29,1884,15
STAT,1839,47,30-34,1886,0.06992364148401183
STAT,1861,51,45-49,1912,0.012238257136060249
STAT,1815,43,na,1858,1364.6214354194883
STAT,1833,22,15-19,1855,3.1491132782598172
SIM,1848,24,25-29,1872,56
SIM,1857,36,35-39,1893,15
STAT,1850,43,15-19,1893,0.010497990376350524
SIM,1841,22,15-19,1863,2
SIM,1939,25,na,1964,3840
SIM,1869,31,35-39,1900,13
SIM,1872,26,25-29,1898,61
SIM,1907,27,45-49,1934,5
STAT,1897,26,20-24,1923,15.939588261231835
SIM,1864,38,35-39,1902,14
STAT,1864,26,25-29,1890,38.68527610729817
STAT,1904,28,30-34,1932,36.37064211451637
SIM,1867,30,20-24,1897,2
SIM,1920,19,25-29,1939,60
SIM,1882,23,15-19,1905,3
STAT,1876,48,na,1924,2316.750104511047
STAT,1846,45,15-19,1891,3.065799978656644E-4
STAT,1838,26,15-19,1864,0.38914075518229096
SIM,1821,39,25-29,1860,5
STAT,1827,44,35-39,1871,1.882300289151749
SIM,1832,39,35-39,1871,10
SIM,1901,49,na,1950,3200
SIM,1927,20,45-49,1947,1
SIM,1831,29,40-44,1860,2
STAT,1831,50,na,1881,1459.5238650285576
STAT,1872,39,30-34,1911,5.3572975939467975
SIM,1822,65,na,1887,977
STAT,1912,19,25-29,1931,8.793418679126987
SIM,1919,5,na,1924,4405
STAT,1769,106,na,1875,0.010414712908652726
SIM,1850,94,na,1944,11
SIM,1927,23,50-100,1950,1
SIM,1859,42,30-34,1901,1
SIM,1906,21,20-24,1927,145
STAT,1840,21,45-49,1861,0.6261212849966985
SIM,1875,21,15-19,1896,3
SIM,1879,36,20-24,1915,1
STAT,1948,16,35-39,1964,4.852381131953817
SIM,1874,32,20-24,1906,4
STAT,1886,55,na,1941,2204.9952723315364
SIM,1839,90,na,1929,17
STAT,1789,86,na,1875,87.39331308763957
SIM,1853,20,na,1873,2062
STAT,1894,35,35-39,1929,9.284516574413008
SIM,1867,33,25-29,1900,15
SIM,1840,87,na,1927,91
STAT,1863,2,na,1865,3058.184407455277
SIM,1917,31,40-44,1948,6
STAT,1921,49,30-34,1970,0.1009032549375897
STAT,1926,24,35-39,1950,11.488828843309511
SIM,1912,28,30-34,1940,6
STAT,1813,65,na,1878,886.6527879875558
STAT,1911,19,na,1930,3878.3363061973437
STAT,1926,18,na,1944,4548.965578410528
STAT,1955,15,30-34,1970,16.355490863225565
SIM,1826,72,na,1898,893
SIM,1834,24,30-34,1858,21
SIM,1823,37,35-39,1860,6
STAT,1900,17,40-44,1917,0.2566150309124271
SIM,1842,43,30-34,1885,1
STAT,1844,32,35-39,1876,9.581461536576198
STAT,1867,21,15-19,1888,3.1738196740276026
SIM,1896,24,20-24,1920,87
SIM,1851,79,na,1930,519
SIM,1866,78,na,1944,720
STAT,1848,16,30-34,1864,1.6227469610960648
SIM,1905,29,35-39,1934,20
STAT,1861,26,40-44,1887,2.550696825440071
SIM,1864,35,30-34,1899,13
SIM,1882,85,na,1967,385
SIM,1868,18,15-19,1886,7
STAT,1933,23,30-34,1956,38.51199192558412
SIM,1864,12,na,1876,2893
STAT,1779,103,na,1882,0.06197834565289349
STAT,1828,64,na,1892,1128.467814541564
STAT,1947,5,na,1952,4508.138650095437
SIM,1916,48,na,1964,3740
SIM,1941,23,30-34,1964,51
STAT,1886,44,40-44,1930,2.366235251604284
SIM,1877,23,40-44,1900,2
STAT,1856,35,30-34,1891,4.166132651245107
STAT,1919,23,50-100,1942,0.7252402459135666
SIM,1829,33,20-24,1862,2
SIM,1880,39,30-34,1919,8
STAT,1920,26,50-100,1946,1.1063963047343315
SIM,1889,25,25-29,1914,71
STAT,1862,49,15-19,1911,3.4160331589927907E-4
STAT,1898,46,25-29,1944,0.04461353878363912
SIM,1811,73,na,1884,610
STAT,1816,106,na,1922,0.006207718660250123
STAT,1909,31,40-44,1940,3.78375444929109
SIM,1845,44,50-100,1889,1
SIM,1795,72,na,1867,471
STAT,1819,53,40-44,1872,0.01932213199043983
STAT,1945,25,15-19,1970,0.78284661022654
STAT,1942,25,na,1967,3973.233425127978
STAT,1923,33,15-19,1956,0.14875612769950633
STAT,1837,44,50-100,1881,0.7543413333622241
STAT,1821,43,na,1864,1626.2139221974073
STAT,1778,94,na,1872,4.46084561008988
SIM,1860,23,30-34,1883,26
STAT,1883,52,na,1935,2116.8000999805313
SIM,1856,23,na,1879,2171
STAT,1819,43,40-44,1862,4.670800364969285
STAT,1928,43,50-100,1971,0.1511379162631031
SIM,1841,18,25-29,1859,6
STAT,1908,26,40-44,1934,4.5010380148166975
STAT,1938,4,na,1942,4019.4277734090224
SIM,1881,34,30-34,1915,17
STAT,1925,30,25-29,1955,11.10463150409409
STAT,1859,52,25-29,1911,0.002861985716998242
STAT,1845,39,25-29,1884,2.1650003984559625
SIM,1819,39,na,1858,1569
STAT,1886,47,50-100,1933,0.2606851005322394
STAT,1881,53,20-24,1934,7.068779358560493E-4
STAT,1854,87,na,1941,132.221310833967
STAT,1858,45,45-49,1903,0.18886757557840314
STAT,1929,18,25-29,1947,55.75237377622364
SIM,1823,44,na,1867,1513
STAT,1846,41,50-100,1887,0.8218938299096109
STAT,1879,47,na,1926,2360.2765072836905
STAT,1926,17,45-49,1943,0.6189930441893708
STAT,1841,51,25-29,1892,0.002661442101818741
SIM,1885,36,40-44,1921,8
SIM,1888,37,20-24,1925,1
STAT,1903,49,50-100,1952,0.19511539016147386
STAT,1875,33,na,1908,2464.678529095798
SIM,1843,26,35-39,1869,19
SIM,1883,42,40-44,1925,8
STAT,1909,8,na,1917,3933.915795829169
SIM,1924,32,25-29,1956,16
STAT,1905,30,50-100,1935,1.3485605003205237
STAT,1835,35,50-100,1870,1.1635818657253105
SIM,1897,22,15-19,1919,4
STAT,1835,26,35-39,1861,9.510418583074967
STAT,1874,40,50-100,1914,1.1035959878888637
SIM,1912,27,na,1939,3597
STAT,1890,38,na,1928,2893.2327675903757
SIM,1808,87,na,1895,40
STAT,1866,30,20-24,1896,2.5483089130303145
STAT,1873,52,50-100,1925,0.015381527730286094
STAT,1875,42,40-44,1917,2.3301159424250732
SIM,1937,18,25-29,1955,55
STAT,1813,89,na,1902,46.06165010162511
STAT,1862,48,15-19,1910,3.445040399153665E-4
SIM,1864,37,35-39,1901,12
STAT,1882,18,20-24,1900,17.29922253596288
STAT,1862,36,20-24,1898,0.6755861075683814
SIM,1814,43,30-34,1857,1
STAT,1894,40,25-29,1934,0.8434451505068763
STAT,1903,45,20-24,1948,0.009833688713633116
SIM,1931,22,15-19,1953,7
SIM,1827,43,40-44,1870,10
SIM,1834,28,35-39,1862,12
SIM,1836,36,45-49,1872,3
STAT,1874,3,na,1877,3199.831409342004
STAT,1852,23,30-34,1875,15.93247167784781
STAT,1837,29,50-100,1866,0.5521144547994308
SIM,1889,16,30-34,1905,3
STAT,1873,34,30-34,1907,17.724114516358622
SIM,1916,26,40-44,1942,7
SIM,1890,74,na,1964,1823
SIM,1891,16,na,1907,3317
SIM,1853,39,25-29,1892,3
SIM,1886,69,na,1955,1675
SIM,1921,6,na,1927,4563
SIM,1878,18,20-24,1896,21
SIM,1882,55,na,1937,1808
SIM,1920,46,na,1966,4353
STAT,1815,49,40-44,1864,0.3674105635665545
STAT,1895,27,45-49,1922,1.464449152668348
STAT,1927,32,na,1959,4702.364987395355
STAT,1854,37,25-29,1891,2.1607987936329525
SIM,1821,33,20-24,1854,1
SIM,1950,2,na,1952,4602
SIM,1811,59,na,1870,1245
STAT,1831,27,na,1858,1798.8898498056055
SIM,1827,30,35-39,1857,10
STAT,1848,35,50-100,1883,1.0546708521420571
SIM,1872,36,30-34,1908,1
STAT,1916,32,25-29,1948,9.629829639297336
SIM,1853,33,40-44,1886,6
STAT,1895,6,na,1901,3445.603598417403
SIM,1928,26,na,1954,4641
STAT,1944,28,na,1972,4086.5909166095867
STAT,1899,47,50-100,1946,0.19114060755275436
STAT,1932,20,15-19,1952,7.100485506542948
STAT,1940,14,na,1954,4031.75174561867
STAT,1838,49,35-39,1887,0.09397922638067005
STAT,1886,21,35-39,1907,6.241702620688989
SIM,1924,12,na,1936,4804
SIM,1894,21,35-39,1915,14
STAT,1863,41,35-39,1904,1.627811004834962
STAT,1849,52,40-44,1901,0.008187254995880069
STAT,1865,39,na,1904,2150.9456785414914
STAT,1917,24,40-44,1941,3.5845340504062397
STAT,1880,24,20-24,1904,72.63861071769442
STAT,1847,47,35-39,1894,0.10433449301467276
SIM,1834,20,25-29,1854,66
STAT,1917,37,50-100,1954,0.4401842397747364
STAT,1923,22,15-19,1945,6.258099912008374
STAT,1866,44,40-44,1910,2.075201432290943
STAT,1956,13,na,1969,5250.023556883337
SIM,1943,15,na,1958,3942
STAT,1934,16,40-44,1950,1.9163270112115147
SIM,1787,76,na,1863,349
STAT,1841,21,na,1862,2040.165528897712
STAT,1864,36,30-34,1900,4.880687332154811
STAT,1833,93,na,1926,20.676842093195877
SIM,1877,37,45-49,1914,2
SIM,1920,38,25-29,1958,1
SIM,1898,54,na,1952,2849
SIM,1873,19,na,1892,2449
SIM,1894,29,45-49,1923,1
STAT,1890,46,25-29,1936,0.04021321165684543
STAT,1849,49,na,1898,1722.3170123030975
SIM,1899,38,35-39,1937,5
SIM,1871,41,35-39,1912,3
STAT,1866,72,na,1938,1181.1004503808929
STAT,1796,60,na,1856,926.5626282243999
STAT,1858,31,25-29,1889,8.20081668017371
STAT,1850,54,30-34,1904,0.00443260878299792
STAT,1825,41,15-19,1866,0.02026266732482627
SIM,1825,44,45-49,1869,2
STAT,1870,53,45-49,1923,0.014162142680514321
STAT,1912,38,25-29,1950,0.9647326426596585
STAT,1901,43,45-49,1944,0.1460867532461436
STAT,1907,19,50-100,1926,0.07227642616984177
SIM,1874,44,40-44,1918,5
STAT,1856,23,15-19,1879,2.9456113129477073
SIM,1869,73,na,1942,1120
SIM,1942,16,40-44,1958,1
SIM,1844,38,na,1882,1654
STAT,1914,46,35-39,1960,0.12933190201186007
SIM,1890,18,20-24,1908,26
STAT,1786,98,na,1884,0.6166494185873426
SIM,1894,40,na,1934,3281
STAT,1857,36,na,1893,1866.0238992916022
SIM,1861,18,na,1879,2355
SIM,1832,96,na,1928,7
STAT,1874,16,na,1890,2618.370581600372
SIM,1820,95,na,1915,3
SIM,1842,41,40-44,1883,6
STAT,1845,35,na,1880,1844.8607808634654
STAT,1858,39,35-39,1897,5.548081394833883
STAT,1929,31,50-100,1960,1.0621100004827682
SIM,1938,27,30-34,1965,71
SIM,1927,8,na,1935,5459
STAT,1850,15,20-24,1865,16.78556246858078
STAT,1896,47,30-34,1943,0.07265992699890009
STAT,1845,44,20-24,1889,0.11517878082188718
SIM,1825,35,30-34,1860,5
STAT,1819,110,na,1929,1.4048003665595178E-4
STAT,1869,37,45-49,1906,1.9575211948734135
SIM,1919,27,20-24,1946,29
STAT,1817,44,45-49,1861,3.3599590012804272
SIM,1887,3,na,1890,2908
SIM,1835,61,na,1896,1070
STAT,1889,22,15-19,1911,4.108585369022007
SIM,1933,30,25-29,1963,10
STAT,1851,36,45-49,1887,1.5415322168225367
SIM,1799,77,na,1876,530
STAT,1892,32,15-19,1924,0.18048452207977111
STAT,1884,35,45-49,1919,2.004359357481044
STAT,1801,54,35-39,1855,0.031199691015957046
STAT,1886,34,40-44,1920,4.585049760148485
STAT,1875,23,25-29,1898,59.19267709682539
STAT,1912,43,20-24,1955,0.0170812912088121
STAT,1859,40,30-34,1899,0.9433399596007194
STAT,1884,26,30-34,1910,25.16711784252177
STAT,1909,23,50-100,1932,0.6152058731034962
SIM,1949,20,35-39,1969,16
STAT,1854,71,na,1925,1001.749925132047
SIM,1894,34,40-44,1928,2
STAT,1858,85,na,1943,217.22044442477525
STAT,1862,90,na,1952,68.76634327834006
STAT,1882,27,35-39,1909,9.440005662153908
STAT,1872,41,50-100,1913,1.0775972215037684
SIM,1877,92,na,1969,187
STAT,1826,39,15-19,1865,0.061245256890968415
STAT,1828,47,25-29,1875,0.052479355451825756
STAT,1874,50,25-29,1924,0.0037157533354361
STAT,1927,32,50-100,1959,1.027982633439745
STAT,1942,22,25-29,1964,97.7842469381452
SIM,1823,36,35-39,1859,17
SIM,1892,26,30-34,1918,59
STAT,1832,33,30-34,1865,15.37423324403942
SIM,1840,33,30-34,1873,33
SIM,1791,81,na,1872,104
STAT,1867,17,40-44,1884,0.17786118514276872
SIM,1858,7,na,1865,2378
SIM,1875,29,35-39,1904,11
SIM,1839,17,30-34,1856,1
SIM,1863,19,15-19,1882,8
SIM,1866,31,25-29,1897,17
STAT,1875,51,50-100,1926,0.015739786162734064
STAT,1908,49,15-19,1957,3.343232707501904E-4
STAT,1875,37,45-49,1912,2.0676792701715363
STAT,1848,17,30-34,1865,1.6131889814952083
STAT,1948,18,35-39,1966,4.849470138047992
STAT,1865,21,15-19,1886,3.101800344658844
SIM,1870,54,na,1924,2312
STAT,1888,18,50-100,1906,0.058250772985393245
SIM,1866,49,na,1915,2238
STAT,1892,37,45-49,1929,2.5265035626588115
STAT,1925,25,na,1950,4501.940427815447
STAT,1881,48,25-29,1929,0.05537275574426025
STAT,1848,21,15-19,1869,3.303349573443454
SIM,1868,44,40-44,1912,12
STAT,1895,35,20-24,1930,1.0263773764399056
STAT,1834,41,40-44,1875,1.6357044444898279
STAT,1810,65,na,1875,998.8067149595419
STAT,1871,26,45-49,1897,1.1179283464540166
STAT,1916,26,50-100,1942,1.0421568405652937
STAT,1922,45,30-34,1967,0.10394627045423135
STAT,1825,46,45-49,1871,0.32131178452658216
STAT,1879,79,na,1958,852.7172715326967
STAT,1899,37,30-34,1936,1.5945494525833075
STAT,1844,37,50-100,1881,1.0264717541510853
STAT,1890,26,30-34,1916,31.18516752487953
SIM,1847,23,15-19,1870,3
SIM,1856,21,15-19,1877,2
STAT,1829,40,45-49,1869,1.1973584335400962
STAT,1810,51,50-100,1861,0.05646940397203
SIM,1863,30,45-49,1893,2
STAT,1854,26,45-49,1880,0.9668718936885062
STAT,1818,51,25-29,1869,0.006179918765414541
STAT,1886,17,na,1903,2693.2886974776166
SIM,1841,89,na,1930,39
STAT,1877,45,50-100,1922,0.2585715679119654
SIM,1898,34,25-29,1932,20
STAT,1845,30,50-100,1875,0.8127282007496283
STAT,1849,46,30-34,1895,0.0758982392998104
STAT,1882,52,25-29,1934,0.0034468720139485976
SIM,1856,17,30-34,1873,1
STAT,1949,22,35-39,1971,11.09994922290151
STAT,1840,35,30-34,1875,4.511461773474574
STAT,1886,29,45-49,1915,1.175557068253643
STAT,1839,39,25-29,1878,2.389209776728238
STAT,1828,44,20-24,1872,0.1465985255432489
STAT,1854,55,na,1909,1551.7912472559997
SIM,1876,1,na,1877,3865
STAT,1879,31,45-49,1910,1.845499464681576
STAT,1938,33,15-19,1971,0.1303628659644128
STAT,1819,38,45-49,1857,5.249318289306252
SIM,1837,40,45-49,1877,4
STAT,1897,24,15-19,1921,4.439107869497702
SIM,1857,88,na,1945,144
SIM,1853,74,na,1927,693
STAT,1830,28,25-29,1858,44.29895576354232
STAT,1888,45,30-34,1933,0.11654686361065093
SIM,1925,24,40-44,1949,5
STAT,1857,37,50-100,1894,0.9677612719731246
STAT,1843,34,45-49,1877,1.384898889632259
STAT,1844,100,na,1944,0.8399567800001934
STAT,1883,84,na,1967,616.4813578827075
STAT,1844,41,25-29,1885,0.527052189361583
SIM,1847,39,25-29,1886,3
SIM,1906,19,35-39,1925,4
STAT,1820,54,45-49,1874,0.022760724764117276
SIM,1827,38,45-49,1865,5
STAT,1795,59,na,1854,1135.0
STAT,1834,24,50-100,1858,0.3201709799627323
SIM,1862,37,25-29,1899,3
STAT,1829,29,15-19,1858,0.45333249312139223
STAT,1869,45,20-24,1914,0.011900978785653014
STAT,1819,49,25-29,1868,0.10897120810901967
STAT,1828,36,45-49,1864,2.100296788053263
STAT,1866,40,na,1906,2183.357493038584
STAT,1859,18,45-49,1877,0.06123314705928215
STAT,1937,17,20-24,1954,133.1513098771551
STAT,1891,1,na,1892,3403.634673244853
STAT,1907,12,na,1919,3830.4494961198975
STAT,1838,54,30-34,1892,0.0038752150257067076
STAT,1881,36,30-34,1917,5.213666292055281
STAT,1915,31,na,1946,3902.6318965495134
SIM,1932,31,na,1963,5738
STAT,1881,40,15-19,1921,0.013580435683686002
STAT,1960,2,na,1962,5176.419142736716
SIM,1888,24,15-19,1912,3
STAT,1838,30,45-49,1868,1.4810053112745696
STAT,1860,25,30-34,1885,21.318649289496445
STAT,1845,36,45-49,1881,1.546424421668924
STAT,1874,91,na,1965,160.20043433089123
SIM,1832,25,20-24,1857,13
SIM,1929,21,20-24,1950,143
STAT,1855,30,45-49,1885,1.3645552171007094
STAT,1899,24,25-29,1923,78.85435918792116
STAT,1819,54,20-24,1873,0.001327624723018125
STAT,1843,25,30-34,1868,21.205733962223963
STAT,1808,51,40-44,1859,0.03638090771268698
STAT,1865,29,25-29,1894,38.73390795853353
STAT,1927,2,na,1929,5139.87645139631
STAT,1918,40,35-39,1958,0.2167458795452863
STAT,1885,42,25-29,1927,0.6447898708584101
SIM,1851,25,30-34,1876,47
STAT,1815,96,na,1911,3.716978472436615
STAT,1866,42,15-19,1908,0.01289950148412422
SIM,1861,93,na,1954,22
STAT,1886,45,20-24,1931,0.012924294255561308
STAT,1954,17,20-24,1971,169.3291325397869
STAT,1891,16,20-24,1907,22.223589669523818
STAT,1814,45,30-34,1859,0.2414511127660572
STAT,1929,43,15-19,1972,0.0020069527704014156
STAT,1845,19,na,1864,2094.9958027895004
SIM,1906,24,30-34,1930,35
STAT,1807,61,na,1868,957.4412209771726
STAT,1820,59,na,1879,1057.6747569994525
STAT,1896,31,45-49,1927,2.3408802434064717
SIM,1904,8,na,1912,3930
SIM,1945,17,20-24,1962,180
STAT,1835,51,25-29,1886,0.0027645283068199996
SIM,1883,37,45-49,1920,3
SIM,1886,85,na,1971,588
SIM,1882,71,na,1953,1072
STAT,1823,35,30-34,1858,10.092085925098385
STAT,1790,71,na,1861,516.338285484495
STAT,1853,39,50-100,1892,1.0050957631407145
STAT,1788,107,na,1895,0.0013230239583879528
STAT,1846,52,na,1898,1625.3077573075977
SIM,1873,21,15-19,1894,5
SIM,1884,27,35-39,1911,19
STAT,1860,34,45-49,1894,1.4274193835841194
STAT,1808,46,45-49,1854,0.886126577983276
STAT,1849,33,25-29,1882,8.351483474995423
STAT,1938,21,20-24,1959,111.13543413231719
SIM,1896,47,na,1943,2961
SIM,1892,33,na,1925,3267
SIM,1926,40,35-39,1966,1
STAT,1929,39,na,1968,4871.5362802035725
STAT,1939,28,35-39,1967,15.229721334428328
STAT,1866,39,50-100,1905,1.1366686485073223
STAT,1848,29,25-29,1877,40.641119110918204
STAT,1817,106,na,1923,0.005555094274641502
SIM,1856,29,25-29,1885,38
SIM,1883,20,20-24,1903,76
STAT,1899,46,45-49,1945,0.18505351403307152
STAT,1881,43,50-100,1924,1.0210952291859168
SIM,1831,35,30-34,1866,5
SIM,1812,76,na,1888,308
SIM,1846,30,45-49,1876,1
SIM,1878,34,na,1912,2730
STAT,1918,25,50-100,1943,1.0766668054631963
STAT,1936,34,50-100,1970,0.809714820324914
SIM,1799,61,na,1860,1091
STAT,1884,48,50-100,1932,0.24154275904895295
STAT,1890,22,na,1912,2918.8503475338416
SIM,1881,38,na,1919,2053
SIM,1946,21,20-24,1967,132
STAT,1876,27,35-39,1903,10.062316927478333
SIM,1857,33,25-29,1890,11
STAT,1875,45,45-49,1920,0.24722371152617745
STAT,1943,17,45-49,1960,0.5348756386162321
STAT,1836,43,40-44,1879,1.6665218665041863
STAT,1864,20,45-49,1884,0.6551235870733622
STAT,1885,17,35-39,1902,0.5516380016986343
SIM,1855,44,30-34,1899,4
SIM,1815,41,na,1856,1571
STAT,1871,18,45-49,1889,0.06558094383154378
SIM,1869,9,na,1878,2551
STAT,1902,15,50-100,1917,0.07024902933314892
SIM,1899,12,na,1911,3930
SIM,1843,23,30-34,1866,37
STAT,1876,52,25-29,1928,0.003674099344225672
SIM,1819,55,na,1874,1218
SIM,1866,42,40-44,1908,1
SIM,1931,34,50-100,1965,1
SIM,1929,37,30-34,1966,2
STAT,1913,21,50-100,1934,0.6452609392946462
STAT,1925,26,40-44,1951,5.582761446142685
STAT,1873,37,35-39,1910,7.24203197615273
STAT,1942,30,25-29,1972,9.951913535863596
SIM,1893,30,30-34,1923,33
SIM,1868,31,35-39,1899,12
STAT,1909,17,45-49,1926,0.09885311148835292
STAT,1899,45,30-34,1944,0.07644299336048148
SIM,1938,22,25-29,1960,98
STAT,1847,42,na,1889,1740.1622314682322
STAT,1857,54,40-44,1911,0.008070160596268592
SIM,1888,28,na,1916,2936
STAT,1894,68,na,1962,2169.738364690271
STAT,1847,44,30-34,1891,0.8491800033223122
STAT,1830,33,20-24,1863,2.5530351136887965
STAT,1890,34,30-34,1924,21.363613068301014
STAT,1898,16,30-34,1914,2.1876998834420527
STAT,1828,39,na,1867,1766.4787457162458
STAT,1885,30,30-34,1915,17.69400537522069
STAT,1813,50,35-39,1863,0.0247858897288435
STAT,1888,83,na,1971,905.2630759187506
SIM,1875,21,25-29,1896,76
SIM,1893,17,35-39,1910,2
SIM,1874,20,na,1894,2324
STAT,1910,38,15-19,1948,0.01843771017021626
STAT,1835,23,30-34,1858,17.6502587096253
STAT,1843,26,50-100,1869,0.5348186195667085
STAT,1808,54,45-49,1862,0.04714803577428697
STAT,1902,28,15-19,1930,0.6452721309307288
SIM,1821,36,25-29,1857,2
SIM,1942,20,25-29,1962,1
STAT,1823,43,30-34,1866,1.6627891892035795
STAT,1867,29,35-39,1896,9.112673444994702
SIM,1838,69,na,1907,1200
SIM,1912,1,na,1913,4097
STAT,1854,34,20-24,1888,2.034720578567864
SIM,1877,34,40-44,1911,8
STAT,1861,52,40-44,1913,0.008788610221218815
SIM,1881,37,35-39,1918,15
SIM,1866,23,25-29,1889,79
STAT,1869,34,40-44,1903,4.222016215950099
SIM,1831,43,30-34,1874,1
STAT,1828,32,50-100,1860,1.074290371860381
SIM,1839,25,30-34,1864,30
STAT,1928,27,20-24,1955,22.730682646048898
SIM,1875,35,45-49,1910,3
SIM,1951,17,45-49,1968,1
SIM,1903,38,25-29,1941,1
STAT,1923,34,50-100,1957,0.9564500121761659
SIM,1928,17,20-24,1945,183
SIM,1899,26,40-44,1925,9
SIM,1911,53,na,1964,3695
SIM,1936,27,20-24,1963,26
STAT,1868,20,50-100,1888,0.3993504446778816
STAT,1903,48,25-29,1951,0.0461485315231147
STAT,1841,25,20-24,1866,11.054600929993878
SIM,1833,22,na,1855,1977
STAT,1774,81,na,1855,125.44149999999999
STAT,1858,23,25-29,1881,47.02085648496688
STAT,1867,21,25-29,1888,55.07302973936208
SIM,1841,15,20-24,1856,22
STAT,1853,53,45-49,1906,0.011808730054387562
STAT,1866,33,25-29,1899,9.538792893799908
STAT,1834,22,25-29,1856,45.61396007146165
STAT,1829,43,50-100,1872,0.8083674208161007
STAT,1774,97,na,1871,0.6019786121143889
STAT,1877,40,na,1917,2433.6008303170065
STAT,1894,43,50-100,1937,0.09470633020541885
SIM,1899,35,30-34,1934,9
STAT,1926,15,na,1941,4582.105853245264
SIM,1849,39,35-39,1888,4
STAT,1930,39,30-34,1969,2.397680968496789
SIM,1873,27,35-39,1900,12
SIM,1900,3,na,1903,3875
STAT,1820,40,25-29,1860,1.2977798246189818
STAT,1875,20,20-24,1895,71.9037176490576
STAT,1825,90,na,1915,57.53460657137593
STAT,1874,75,na,1949,1064.6589653023939
SIM,1898,70,na,1968,2244
STAT,1904,31,na,1935,3472.8988089658105
STAT,1862,25,40-44,1887,2.660491126007168
STAT,1812,52,45-49,1864,0.03203652870455295
STAT,1895,24,40-44,1919,2.731261652294924
STAT,1871,38,15-19,1909,0.05606736633785467
STAT,1870,61,na,1931,1853.2907893516847
STAT,1901,35,45-49,1936,0.6149960578618802
STAT,1892,39,50-100,1931,1.5403550216752364
STAT,1810,44,35-39,1854,7.322255674485775
SIM,1857,44,40-44,1901,3
STAT,1845,28,45-49,1873,0.9803860805574839
SIM,1890,24,30-34,1914,27
SIM,1836,33,40-44,1869,7
STAT,1846,29,15-19,1875,0.41056770102427026
SIM,1893,23,na,1916,3087
SIM,1840,28,35-39,1868,16
SIM,1870,25,40-44,1895,4
STAT,1841,80,na,1921,462.5953024622283
SIM,1906,16,30-34,1922,3
SIM,1862,34,20-24,1896,2
STAT,1828,33,40-44,1861,4.901308389490968
STAT,1917,1,na,1918,4521.260676468255
SIM,1840,36,35-39,1876,15
STAT,1832,28,35-39,1860,8.772226070166333
STAT,1803,110,na,1913,1.1519532041172518E-4
STAT,1903,46,na,1949,3245.992386078991
STAT,1871,34,20-24,1905,2.689092825834777
SIM,1858,25,40-44,1883,3
SIM,1803,56,na,1859,1034
SIM,1933,26,40-44,1959,8
STAT,1882,24,30-34,1906,17.31751028760166
STAT,1870,37,50-100,1907,1.2176608374706772
STAT,1834,44,45-49,1878,1.0473388199731277
STAT,1889,27,20-24,1916,14.610281320517075
SIM,1844,43,40-44,1887,5
STAT,1821,35,20-24,1856,1.6869017057918683
SIM,1916,30,25-29,1946,12
STAT,1916,32,na,1948,3940.4937677709686
STAT,1845,94,na,1939,14.603548073122134
SIM,1842,22,25-29,1864,80
STAT,1856,28,20-24,1884,9.345729052512626
STAT,1916,40,25-29,1956,0.07405443842741578
STAT,1839,23,15-19,1862,2.983655356359054
STAT,1868,7,na,1875,2673.050726278107
SIM,1908,24,40-44,1932,4
STAT,1852,26,35-39,1878,8.584830240289218
SIM,1930,23,50-100,1953,1
SIM,1860,26,35-39,1886,2
SIM,1842,44,45-49,1886,5
STAT,1821,104,na,1925,0.03995278620445384
SIM,1897,27,20-24,1924,13
SIM,1939,26,na,1965,3833
STAT,1895,38,25-29,1933,3.77871974889666
STAT,1824,73,na,1897,590.4922053422581
SIM,1845,87,na,1932,166
STAT,1844,16,35-39,1860,0.5551233620059737
SIM,1853,58,na,1911,1482
SIM,1845,23,na,1868,2029
SIM,1774,85,na,1859,80
STAT,1807,77,na,1884,352.5533074906584
STAT,1897,37,20-24,1934,1.0437747199861338
SIM,1852,16,35-39,1868,1
STAT,1873,46,25-29,1919,0.059144637886829006
SIM,1841,73,na,1914,784
SIM,1864,28,20-24,1892,13
STAT,1890,45,50-100,1935,0.30613177465484476
STAT,1908,30,25-29,1938,8.87762579775088
STAT,1906,26,30-34,1932,37.1723096422326
STAT,1923,30,15-19,1953,0.15004487841856637
SIM,1850,43,40-44,1893,7
STAT,1873,29,35-39,1902,9.809018600992331
STAT,1872,19,15-19,1891,5.993750247885576
STAT,1843,87,na,1930,118.82826394797777
STAT,1900,44,50-100,1944,0.10153863151629033
STAT,1852,18,35-39,1870,0.5003369952561519
STAT,1812,49,15-19,1861,8.934559449102898E-4
STAT,1817,43,30-34,1860,2.6929115002490063
STAT,1922,48,35-39,1970,0.1492152906622311
SIM,1883,34,40-44,1917,6
STAT,1851,31,15-19,1882,0.11340247712378719
SIM,1898,31,20-24,1929,3
STAT,1832,30,50-100,1862,0.8332183813622643
STAT,1901,21,25-29,1922,81.29632703409635
STAT,1881,45,20-24,1926,0.011799258291292743
SIM,1932,17,35-39,1949,9
STAT,1894,52,na,1946,2785.0114386316814
SIM,1862,23,40-44,1885,2
SIM,1867,66,na,1933,1433
STAT,1767,115,na,1882,1.485774331603214E-4
STAT,1854,51,35-39,1905,0.006491896589861598
SIM,1829,28,50-100,1857,3
STAT,1836,35,40-44,1871,3.4607427575227527
STAT,1933,28,na,1961,5024.012228181523
STAT,1810,81,na,1891,280.8515383394551
STAT,1924,17,35-39,1941,5.049419432532526
STAT,1859,41,50-100,1900,0.8620765742810392
STAT,1899,24,50-100,1923,0.5617208108344766
STAT,1849,49,35-39,1898,0.10717397639833873
STAT,1856,36,20-24,1892,0.5997768829577286
STAT,1805,51,15-19,1856,1.0318496363936079E-4
SIM,1853,28,45-49,1881,1
SIM,1838,38,20-24,1876,1
STAT,1845,20,35-39,1865,5.370200720530717
SIM,1869,38,25-29,1907,2
STAT,1875,34,40-44,1909,4.459607094375608
STAT,1884,34,30-34,1918,17.24090682543308
STAT,1870,100,na,1970,7.813486151077794
STAT,1820,51,40-44,1871,0.017529859880458847
SIM,1866,36,30-34,1902,8
STAT,1840,38,35-39,1878,5.803560684061298
STAT,1872,42,15-19,1914,0.014005525068198453
SIM,1919,22,15-19,1941,5
STAT,1826,33,50-100,1859,1.2138981025425162
STAT,1840,52,20-24,1892,5.145186746070702E-4
STAT,1842,43,40-44,1885,2.0685151430507838
SIM,1877,37,20-24,1914,1
SIM,1823,33,30-34,1856,17
SIM,1832,26,35-39,1858,13
SIM,1844,35,40-44,1879,8
STAT,1816,53,40-44,1869,0.025629912727241064
STAT,1913,16,20-24,1929,28.03672353866578
SIM,1892,34,30-34,1926,42
STAT,1863,34,50-100,1897,0.8129187813499317
STAT,1832,36,35-39,1868,6.168635648925369
STAT,1838,48,20-24,1886,0.008159229547817363
STAT,1858,27,40-44,1885,2.4298893637902688
STAT,1938,24,25-29,1962,92.22699784217636
STAT,1877,47,20-24,1924,0.012450762325307148
STAT,1849,41,25-29,1890,0.5043440933583431
STAT,1873,23,15-19,1896,3.3674645545980106
SIM,1879,51,na,1930,2550
SIM,1838,40,50-100,1878,3
SIM,1856,26,20-24,1882,14
STAT,1861,35,50-100,1896,1.0402061150448705
STAT,1910,3,na,1913,4041.5653072466416
STAT,1857,15,30-34,1872,1.4942041985922658
SIM,1849,31,25-29,1880,12
SIM,1860,18,35-39,1878,4
STAT,1915,47,na,1962,3735.45440185846
STAT,1897,29,20-24,1926,15.771541265600959
STAT,1903,26,50-100,1929,0.9232996999941756
STAT,1911,33,na,1944,3699.850643161519
STAT,1881,20,45-49,1901,0.6829388292756795
SIM,1816,43,40-44,1859,7
SIM,1825,43,30-34,1868,4
SIM,1866,27,40-44,1893,4
STAT,1867,35,45-49,1902,1.9142571587446877
SIM,1880,19,15-19,1899,4
SIM,1867,40,30-34,1907,5
SIM,1840,30,50-100,1870,1
SIM,1897,4,na,1901,3625
SIM,1807,49,50-100,1856,3
SIM,1808,55,na,1863,1114
STAT,1891,17,35-39,1908,0.6861488165393824
STAT,1869,21,na,1890,2329.391024304183
STAT,1923,49,40-44,1972,0.18526179485411062
STAT,1826,28,35-39,1854,23.872076383974534
STAT,1897,25,50-100,1922,0.872057565653174
SIM,1862,35,na,1897,2163
STAT,1876,24,30-34,1900,18.459128431174587
STAT,1919,36,50-100,1955,0.4558338323704502
STAT,1939,25,30-34,1964,39.80043252061529
SIM,1921,16,20-24,1937,159
STAT,1860,28,35-39,1888,7.993957446844341
SIM,1864,3,na,1867,2974
SIM,1891,7,na,1898,3403
STAT,1860,31,40-44,1891,3.5951405357579507
STAT,1862,33,40-44,1895,3.766609724667566
SIM,1928,10,na,1938,5135
SIM,1857,72,na,1929,1120
STAT,1860,24,na,1884,1984.0985564311704
STAT,1883,44,40-44,1927,2.1931118198816963
STAT,1951,16,40-44,1967,1.6832905815876265
SIM,1921,31,na,1952,4134
SIM,1933,4,na,1937,5187
STAT,1931,6,na,1937,5302.03084047555
STAT,1855,72,na,1927,950.6073183771579
SIM,1865,15,30-34,1880,4
STAT,1843,33,30-34,1876,14.010791528473037
STAT,1859,86,na,1945,180.23791748851005
SIM,1857,30,20-24,1887,2
SIM,1833,38,na,1871,1833
SIM,1850,93,na,1943,19
SIM,1903,50,na,1953,2901
SIM,1884,24,30-34,1908,1
STAT,1830,37,15-19,1867,0.05105171296606451
SIM,1821,96,na,1917,5
STAT,1880,41,35-39,1921,1.9294401201452058
SIM,1907,64,na,1971,3025
SIM,1798,76,na,1874,266
SIM,1794,62,na,1856,863
STAT,1934,20,25-29,1954,125.83823279944643
SIM,1828,75,na,1903,558
SIM,1869,14,na,1883,2493
STAT,1852,29,15-19,1881,0.359481691818517
SIM,1946,24,25-29,1970,125
STAT,1816,38,na,1854,1607.4507812735708
STAT,1893,19,35-39,1912,0.69991363331348
SIM,1842,33,40-44,1875,5
SIM,1851,33,30-34,1884,28
STAT,1861,41,25-29,1902,0.5413882499239305
STAT,1917,27,45-49,1944,1.8287880033174873
SIM,1883,23,25-29,1906,86
STAT,1804,96,na,1900,2.662032527637776
STAT,1869,48,25-29,1917,0.05585011999456687
STAT,1939,0,na,1939,4542.640465138822
STAT,1848,26,20-24,1874,11.517305668900665
SIM,1918,21,45-49,1939,2
STAT,1880,27,25-29,1907,44.869561158853834
STAT,1959,7,na,1966,5193.0413009382655
SIM,1888,38,35-39,1926,17
STAT,1857,40,20-24,1897,0.1264466183017622
STAT,1870,18,na,1888,2513.8336298221284
STAT,1849,107,na,1956,0.004689359727495094
STAT,1888,48,35-39,1936,0.09296012693311646
STAT,1921,36,25-29,1957,1.1113759618003332
SIM,1882,19,25-29,1901,4
STAT,1904,49,30-34,1953,0.07749054862923727
STAT,1938,28,50-100,1966,0.9950221141379616
STAT,1915,20,15-19,1935,5.359814764825546
STAT,1841,39,40-44,1880,3.7776256254924707
SIM,1872,44,30-34,1916,1
STAT,1831,41,15-19,1872,0.010816816580017926
SIM,1940,16,30-34,1956,18
STAT,1849,30,20-24,1879,2.4985963989420727
STAT,1899,28,40-44,1927,4.137690348498152
STAT,1881,39,35-39,1920,6.816647978743843
STAT,1864,44,30-34,1908,1.0336496463402491
SIM,1885,6,na,1891,2818
STAT,1932,16,30-34,1948,16.350594745286337
STAT,1940,30,na,1970,3956.137205579938
STAT,1952,9,na,1961,4757.878422542983
STAT,1868,50,25-29,1918,0.003468206224127476
SIM,1906,27,35-39,1933,1
STAT,1861,41,na,1902,1948.554611740199
STAT,1836,46,20-24,1882,0.0080244566268936
STAT,1850,41,na,1891,1777.7559075985378
STAT,1865,55,na,1920,1906.9612477460385
SIM,1954,7,na,1961,4839
STAT,1857,20,na,1877,1973.902900127036
STAT,1877,36,40-44,1913,4.585173992933132
STAT,1786,82,na,1868,169.87477985574654
STAT,1814,48,35-39,1862,0.3320493092439813
STAT,1876,15,40-44,1891,0.19162536546000314
STAT,1814,54,20-24,1868,0.0016326895508298215
SIM,1862,102,na,1964,2
STAT,1841,17,20-24,1858,17.09889149298752
STAT,1854,23,40-44,1877,1.8242997128072658
SIM,1881,29,35-39,1910,15
SIM,1923,20,15-19,1943,7
STAT,1854,18,45-49,1872,0.05829858290512866
STAT,1850,16,35-39,1866,0.5164636699874291
STAT,1851,35,30-34,1886,4.164296664754217
STAT,1897,3,na,1900,3579.646158014362
SIM,1898,22,50-100,1920,1
STAT,1857,19,25-29,1876,5.188327462450346
STAT,1874,16,20-24,1890,18.379692910370036
SIM,1819,71,na,1890,590
STAT,1948,5,na,1953,4570.7156454064625
SIM,1854,27,25-29,1881,51
STAT,1920,48,25-29,1968,0.05904900378198053
STAT,1872,46,30-34,1918,0.09857181326251029
STAT,1894,39,45-49,1933,2.5661119152626983
STAT,1853,31,25-29,1884,8.813797377155531
STAT,1899,48,35-39,1947,0.1080912591149781
STAT,1887,41,45-49,1928,1.69531658529432
SIM,1864,40,50-100,1904,2
SIM,1869,102,na,1971,1
STAT,1858,21,na,1879,1957.94084579593
STAT,1895,27,20-24,1922,15.473354584540262
SIM,1858,29,35-39,1887,14
STAT,1931,25,50-100,1956,1.2998554785783798
STAT,1806,60,na,1866,979.4389472858442
STAT,1839,28,20-24,1867,10.402674614306358
STAT,1886,49,15-19,1935,4.1765065947828127E-4
SIM,1921,39,30-34,1960,2
SIM,1902,26,15-19,1928,4
STAT,1942,26,40-44,1968,4.941508867463775
STAT,1879,49,20-24,1928,0.012383917798674834
SIM,1849,36,50-100,1885,1
STAT,1884,53,na,1937,2110.169131607929
STAT,1919,24,15-19,1943,5.848535240524659
SIM,1870,43,45-49,1913,1
SIM,1871,34,50-100,1905,1
SIM,1849,35,40-44,1884,5
SIM,1824,45,na,1869,1487
STAT,1859,27,35-39,1886,7.973462360184084
STAT,1800,82,na,1882,150.28490878964914
STAT,1888,67,na,1955,1889.7566957318716
STAT,1899,43,40-44,1942,0.21494504598158454
SIM,1947,16,40-44,1963,3
STAT,1812,45,20-24,1857,0.028582439775819524
SIM,1811,47,50-100,1858,4
SIM,1889,34,na,1923,2847
SIM,1885,20,na,1905,2499
STAT,1827,48,45-49,1875,0.23887525917594554
STAT,1842,52,30-34,1894,0.005330756859233964
STAT,1840,31,15-19,1871,0.12285650859269136
SIM,1865,19,25-29,1884,11
STAT,1846,27,25-29,1873,38.8353739157511
STAT,1873,90,na,1963,177.81501725523307
SIM,1960,3,na,1963,5280
SIM,1872,18,na,1890,2798
STAT,1855,49,35-39,1904,0.10318064507843
STAT,1872,68,na,1940,1551.7637075604414
SIM,1901,33,45-49,1934,3
STAT,1849,42,15-19,1891,0.010783962047190097
SIM,1873,18,20-24,1891,16
SIM,1805,63,na,1868,848
STAT,1814,41,15-19,1855,0.050120679671255754
SIM,1788,77,na,1865,352
STAT,1834,38,35-39,1872,5.185360467833491
STAT,1859,101,na,1960,1.0568252571872723
STAT,1844,45,40-44,1889,0.13758678434725635
STAT,1864,2,na,1866,3102.8114863599735
SIM,1809,77,na,1886,308
STAT,1902,16,45-49,1918,0.09346118193227024
STAT,1843,16,40-44,1859,0.15858248204701847
SIM,1855,22,na,1877,2183
STAT,1943,29,15-19,1972,0.7584036243622579
SIM,1882,40,50-100,1922,2
SIM,1892,17,na,1909,3461
STAT,1833,54,30-34,1887,0.004187090747584899
SIM,1842,38,35-39,1880,3
SIM,1859,36,na,1895,2209
SIM,1882,16,20-24,1898,15
SIM,1891,75,na,1966,1568
STAT,1827,40,35-39,1867,2.0160603003520694
STAT,1886,48,25-29,1934,0.06065243859508177
STAT,1836,46,45-49,1882,0.15781430767314328
STAT,1920,19,50-100,1939,0.4221990919766443
STAT,1910,30,40-44,1940,3.837498660896344
STAT,1899,21,20-24,1920,95.81157431907971
STAT,1900,17,na,1917,3543.4535713993837
SIM,1847,37,35-39,1884,17
STAT,1865,18,20-24,1883,16.749390577913466
STAT,1793,95,na,1888,2.5872413007185187
STAT,1894,31,35-39,1925,13.222397257755036
STAT,1847,20,45-49,1867,0.6493477022792761
SIM,1863,101,na,1964,12
STAT,1901,32,40-44,1933,6.140172317780795
SIM,1881,54,na,1935,1897
STAT,1939,16,40-44,1955,1.4138219166868222
STAT,1882,19,35-39,1901,0.5339493550987288
STAT,1843,31,40-44,1874,3.553085695099102
STAT,1816,81,na,1897,276.4783111319368
SIM,1803,83,na,1886,125
SIM,1913,17,na,1930,3935
STAT,1898,41,20-24,1939,0.015168372955143072
STAT,1850,29,40-44,1879,2.660656517275827
SIM,1845,29,25-29,1874,46
STAT,1853,30,35-39,1883,8.80533535902515
SIM,1943,5,na,1948,4260
STAT,1921,5,na,1926,4628.88379958105
SIM,1887,54,na,1941,2255
SIM,1888,36,50-100,1924,1
SIM,1933,32,na,1965,4906
STAT,1917,39,15-19,1956,0.02001087161024763
STAT,1882,17,50-100,1899,0.04793108531418757
SIM,1927,24,15-19,1951,7
STAT,1843,36,35-39,1879,5.627216079800763
SIM,1828,37,25-29,1865,4
STAT,1888,47,20-24,1935,0.014238648491479428
STAT,1823,37,20-24,1860,1.3422572998630324
STAT,1818,88,na,1906,70.72943704575805
SIM,1884,40,30-34,1924,2
STAT,1876,40,30-34,1916,1.2110209727342969
STAT,1940,32,50-100,1972,0.8638729918805739
STAT,1904,7,na,1911,3776.2522413533657
SIM,1894,30,25-29,1924,23
STAT,1841,18,35-39,1859,0.5261042797770376
SIM,1883,40,na,1923,2595
STAT,1821,39,15-19,1860,0.0980047176104953
SIM,1847,28,20-24,1875,10
SIM,1921,47,na,1968,4071
STAT,1884,17,40-44,1901,0.18217053204249645
STAT,1916,16,na,1932,4145.490690801449
STAT,1919,37,20-24,1956,0.2859387634120795
SIM,1880,41,50-100,1921,1
STAT,1837,29,25-29,1866,36.510088809801914
SIM,1903,18,na,1921,3442
SIM,1860,92,na,1952,12
STAT,1890,28,20-24,1918,14.427533337241995
SIM,1862,26,20-24,1888,2
STAT,1847,46,20-24,1893,0.009010354321358997
STAT,1874,15,30-34,1889,1.6622019687888163
SIM,1861,31,25-29,1892,12
SIM,1914,50,na,1964,3796
STAT,1939,17,30-34,1956,12.316997914637211
STAT,1854,26,20-24,1880,10.215958417954242
SIM,1914,26,30-34,1940,50
SIM,1916,34,40-44,1950,4
STAT,1827,100,na,1927,0.6313164727695882
SIM,1851,31,40-44,1882,5
STAT,1853,38,45-49,1891,1.6403898295013617
STAT,1892,36,30-34,1928,6.787106202274874
STAT,1925,44,45-49,1969,0.20295640455228547
STAT,1823,46,35-39,1869,0.1954607027784844
STAT,1906,49,40-44,1955,0.1390997884002531
STAT,1840,36,na,1876,1794.299455245063
SIM,1884,16,30-34,1900,2
STAT,1895,19,45-49,1914,0.08569594389637966
SIM,1858,21,25-29,1879,85
SIM,1831,37,20-24,1868,5
STAT,1862,43,45-49,1905,1.295970031874367
SIM,1879,35,na,1914,2765
STAT,1896,43,15-19,1939,0.0012728230768094834
SIM,1947,17,30-34,1964,28
SIM,1837,95,na,1932,14
STAT,1884,22,15-19,1906,3.2858114459774996
SIM,1833,81,na,1914,372
SIM,1820,34,40-44,1854,6
STAT,1910,49,30-34,1959,0.08342219070996534
STAT,1814,108,na,1922,8.573570120388725E-4
STAT,1920,21,na,1941,4112.083542158451
SIM,1908,25,50-100,1933,1
STAT,1887,28,25-29,1915,47.53311821033549
STAT,1825,45,30-34,1870,0.13363251388957348
SIM,1895,28,25-29,1923,63
SIM,1862,62,na,1924,1621
STAT,1920,16,15-19,1936,51.5444224621719
SIM,1861,30,35-39,1891,15
STAT,1808,48,35-39,1856,0.4976949982447299
STAT,1845,48,15-19,1893,2.8860173659947996E-4
STAT,1890,37,35-39,1927,8.729122621273627
STAT,1828,28,45-49,1856,1.7842525280608907
STAT,1947,23,15-19,1970,6.074962937281876
STAT,1875,39,35-39,1914,7.262322662212469
SIM,1885,32,25-29,1917,12
STAT,1847,39,35-39,1886,5.381652947953009
STAT,1821,42,45-49,1863,2.38627391205614
STAT,1882,17,30-34,1899,1.55935829258842
STAT,1908,34,40-44,1942,3.6968875561442323
STAT,1887,17,45-49,1904,0.07366065798718292
STAT,1893,15,40-44,1908,0.23565227981520798
STAT,1817,41,40-44,1858,5.753084667222809
STAT,1832,35,20-24,1867,0.6794574194026403
STAT,1882,26,20-24,1908,11.516824364538284
SIM,1924,36,40-44,1960,2
STAT,1866,53,30-34,1919,0.005477633725255035
SIM,1876,41,35-39,1917,2
STAT,1838,19,15-19,1857,5.185917368032473
STAT,1825,74,na,1899,809.8781041760055
SIM,1834,24,40-44,1858,1
SIM,1883,39,35-39,1922,19
STAT,1911,18,15-19,1929,9.138262890306194
STAT,1817,46,35-39,1863,0.30587566968688046
STAT,1824,89,na,1913,52.22744427272905
STAT,1941,17,35-39,1958,4.363566426135102
STAT,1806,52,20-24,1858,0.0021292895742029304
SIM,1836,20,35-39,1856,8
SIM,1875,69,na,1944,1493
STAT,1901,48,15-19,1949,3.154502535813925E-4
SIM,1823,35,20-24,1858,1
SIM,1928,16,30-34,1944,31
STAT,1868,36,na,1904,2285.1491220037956
STAT,1845,47,25-29,1892,0.041891301623019246
SIM,1852,37,50-100,1889,1
STAT,1868,41,35-39,1909,1.7558711284207167
STAT,1873,30,15-19,1903,0.14698464227434319
SIM,1843,15,30-34,1858,2
STAT,1894,32,25-29,1926,13.31882066161827
SIM,1896,21,45-49,1917,2
STAT,1837,43,na,1880,1670.8685317829677
STAT,1865,27,35-39,1892,8.898782174094501
SIM,1867,45,50-100,1912,3
SIM,1846,19,15-19,1865,6
SIM,1856,87,na,1943,64
SIM,1852,73,na,1925,777
STAT,1877,13,na,1890,2687.895027361783
SIM,1825,41,40-44,1866,6
STAT,1873,43,20-24,1916,0.1614355234050651
SIM,1880,17,25-29,1897,5
SIM,1835,88,na,1923,39
SIM,1831,74,na,1905,729
SIM,1947,21,15-19,1968,9
STAT,1921,28,25-29,1949,73.82811396438055
SIM,1881,38,25-29,1919,3
STAT,1867,37,35-39,1904,6.727917966249252
STAT,1884,32,40-44,1916,4.319347961206463
SIM,1839,29,25-29,1868,8
SIM,1834,44,na,1878,1781
STAT,1868,20,na,1888,2316.099623343266
STAT,1880,16,20-24,1896,18.85102437072587
STAT,1842,46,45-49,1888,0.21525469432730937
STAT,1868,42,25-29,1910,0.6191051640717644
SIM,1875,37,35-39,1912,12
STAT,1916,36,40-44,1952,1.5545012407891192
SIM,1813,46,50-100,1859,4
SIM,1838,39,35-39,1877,16
STAT,1806,92,na,1898,14.042595024323319
STAT,1872,17,25-29,1889,5.773041860442714
SIM,1851,36,35-39,1887,14
STAT,1864,38,20-24,1902,0.6990571825204703
SIM,1830,30,na,1860,1684
SIM,1898,49,50-100,1947,1
SIM,1828,26,45-49,1854,5
SIM,1892,32,40-44,1924,7
STAT,1909,37,15-19,1946,0.018342010257068338
SIM,1902,33,na,1935,3723
STAT,1868,49,45-49,1917,0.22305217525582943
STAT,1873,38,25-29,1911,2.9334152760429606
SIM,1868,72,na,1940,1040
SIM,1843,37,na,1880,2264
STAT,1856,35,na,1891,1841.668103629687
STAT,1852,21,na,1873,1940.243274558534
STAT,1893,20,15-19,1913,4.256048643761275
SIM,1847,73,na,1920,801
SIM,1923,24,30-34,1947,2
STAT,1875,17,na,1892,2619.6028420166713
SIM,1875,27,45-49,1902,1
SIM,1892,37,35-39,1929,16
STAT,1939,21,15-19,1960,5.398727208692109
STAT,1892,43,30-34,1935,1.446540075042815
STAT,1871,24,na,1895,2358.2907127466174
STAT,1887,2,na,1889,3159.944587132244
SIM,1942,24,40-44,1966,3
SIM,1864,29,35-39,1893,11
STAT,1856,29,35-39,1885,7.631520006429754
STAT,1870,45,45-49,1915,0.23639552314384107
SIM,1850,77,na,1927,710
STAT,1827,41,25-29,1868,0.7027517286106445
STAT,1934,24,40-44,1958,4.56262971411044
SIM,1871,76,na,1947,799
STAT,1883,47,45-49,1930,0.2321681851020403
SIM,1875,32,40-44,1907,6
STAT,1846,16,45-49,1862,0.06264173198900867
STAT,1893,27,35-39,1920,12.374186050428458
STAT,1873,15,50-100,1888,0.0507594386668758
STAT,1915,24,30-34,1939,29.79081935772007
SIM,1822,38,na,1860,1677
SIM,1929,0,na,1929,5279
STAT,1773,96,na,1869,1.5756390772851177
SIM,1890,26,20-24,1916,16
STAT,1862,36,45-49,1898,1.7471283233344077
STAT,1910,15,40-44,1925,0.2809190011204145
SIM,1899,27,30-34,1926,47
SIM,1856,35,50-100,1891,1
SIM,1877,29,45-49,1906,1
SIM,1937,30,45-49,1967,2
STAT,1826,36,35-39,1862,8.396898841222157
SIM,1868,51,na,1919,2009
STAT,1864,47,35-39,1911,0.12699935394589384
STAT,1877,32,25-29,1909,10.67712959629101
SIM,1918,30,35-39,1948,1
STAT,1884,37,35-39,1921,7.044594437280144
STAT,1883,30,20-24,1913,2.693100684547486
SIM,1876,49,45-49,1925,1
SIM,1855,39,35-39,1894,12
STAT,1803,54,45-49,1857,0.06038078096136077
SIM,1792,82,na,1874,81
SIM,1853,30,50-100,1883,1
STAT,1935,27,15-19,1962,0.9722514487142956
SIM,1939,18,35-39,1957,8
SIM,1822,59,na,1881,1257
SIM,1926,25,50-100,1951,1
STAT,1900,39,20-24,1939,0.23108493007887196
STAT,1888,21,45-49,1909,0.8337949155025473
STAT,1904,47,na,1951,3246.3622285721617
STAT,1858,42,40-44,1900,1.780101698763677
STAT,1867,28,45-49,1895,1.052427042544958
SIM,1834,36,35-39,1870,14
STAT,1945,27,20-24,1972,20.224569605794944
SIM,1871,55,na,1926,1940
SIM,1892,48,50-100,1940,3
SIM,1870,36,20-24,1906,1
STAT,1821,60,na,1881,1229.5668394862203
STAT,1836,74,na,1910,699.7483164172339
SIM,1907,36,40-44,1943,3
SIM,1819,39,25-29,1858,3
STAT,1831,45,30-34,1876,0.07418453888624177
STAT,1847,53,20-24,1900,5.436364664345639E-4
STAT,1846,8,na,1854,2341.0
SIM,1889,50,na,1939,2621
STAT,1900,33,na,1933,3333.892373376918
SIM,1902,65,na,1967,2792
STAT,1876,19,35-39,1895,0.5691487724171752
STAT,1877,54,45-49,1931,0.014712066617755561
STAT,1933,19,50-100,1952,0.5040864125284362
STAT,1846,40,45-49,1886,1.1793628852376175
STAT,1869,54,50-100,1923,0.014422450362221425
SIM,1927,22,50-100,1949,4
SIM,1877,65,na,1942,1700
STAT,1912,28,50-100,1940,0.9861193777647772
STAT,1912,49,40-44,1961,0.15197299801824432
STAT,1834,35,30-34,1869,4.030901202492593
STAT,1906,22,15-19,1928,4.853205729004883
SIM,1849,38,45-49,1887,1
STAT,1830,26,50-100,1856,0.7453925054380927
STAT,1860,16,40-44,1876,0.17519439143007173
SIM,1823,60,na,1883,1123
SIM,1875,21,na,1896,2296
STAT,1857,16,20-24,1873,16.522068215045284
STAT,1828,39,25-29,1867,2.835219535686929
STAT,1860,40,na,1900,1927.4755652795152
SIM,1830,89,na,1919,62
STAT,1852,51,25-29,1903,0.0026990866588065547
SIM,1864,27,30-34,1891,32
SIM,1837,27,25-29,1864,55
STAT,1819,46,45-49,1865,0.4668104167049388
STAT,1930,18,25-29,1948,56.47808923125614
STAT,1894,36,40-44,1930,5.719618701210349
SIM,1886,27,20-24,1913,15
SIM,1860,55,na,1915,1849
STAT,1841,32,50-100,1873,0.8313299837114146
SIM,1829,92,na,1921,22
STAT,1838,22,na,1860,1856.9900848476454
STAT,1814,74,na,1888,535.9997204869392
STAT,1878,27,20-24,1905,12.299896092566106
STAT,1864,53,20-24,1917,6.617320698429883E-4
STAT,1922,41,15-19,1963,0.0017832573260927443
SIM,1833,59,na,1892,1413
STAT,1862,10,na,1872,2414.6206715583094
STAT,1893,17,45-49,1910,0.08377228976384433
STAT,1844,40,35-39,1884,1.5053941648600477
STAT,1935,31,45-49,1966,2.200803888686198
STAT,1874,19,25-29,1893,5.829043073771626
SIM,1836,39,25-29,1875,2
SIM,1905,36,30-34,1941,6
STAT,1910,33,45-49,1943,1.5243189159919264
STAT,1942,29,45-49,1971,1.8289297199790764
STAT,1930,28,50-100,1958,1.278590102194172
STAT,1775,82,na,1857,114.38167109938558
SIM,1842,35,30-34,1877,6
STAT,1848,108,na,1956,0.0018045962339480325
SIM,1879,37,30-34,1916,12
STAT,1875,32,15-19,1907,0.1477077295305424
STAT,1851,33,40-44,1884,3.382446937008824
SIM,1884,19,35-39,1903,4
STAT,1829,27,25-29,1856,55.97793812963262
SIM,1872,40,na,1912,2537
SIM,1923,27,35-39,1950,26
STAT,1872,49,35-39,1921,0.1391907544311653
SIM,1912,54,na,1966,3300
STAT,1856,27,30-34,1883,20.205956671802582
SIM,1893,45,50-100,1938,1
STAT,1862,40,40-44,1902,1.9816599713992435
STAT,1868,46,40-44,1914,0.16572699485815892
SIM,1870,40,40-44,1910,5
STAT,1866,47,45-49,1913,0.2196859028748166
STAT,1810,60,na,1870,1203.5059550737221
STAT,1920,45,20-24,1965,0.012394231934375796
STAT,1880,17,na,1897,2678.936934078402
STAT,1847,49,25-29,1896,0.042226788316084576
SIM,1920,28,50-100,1948,1
SIM,1838,37,30-34,1875,9
STAT,1896,18,25-29,1914,7.556120365313681
STAT,1900,21,50-100,1921,0.5738618163111872
STAT,1905,32,na,1937,3513.8825450702134
STAT,1921,33,20-24,1954,2.72992839635797
SIM,1884,38,50-100,1922,4
STAT,1850,25,na,1875,1977.6023750516902
SIM,1884,20,15-19,1904,4
STAT,1912,46,25-29,1958,0.051560438992211174
SIM,1898,38,40-44,1936,4
STAT,1835,29,15-19,1864,0.4376261939881786
STAT,1888,41,15-19,1929,0.0165373497316751
STAT,1855,42,15-19,1897,0.010382148707394871
STAT,1841,15,30-34,1856,1.5555323783105972
SIM,1894,37,45-49,1931,4
STAT,1886,19,50-100,1905,0.051964419435796896
STAT,1834,26,40-44,1860,2.356278998268542
STAT,1908,13,na,1921,3861.1301932365177
SIM,1900,69,na,1969,2514
SIM,1827,30,50-100,1857,3
SIM,1852,40,35-39,1892,4
SIM,1878,28,25-29,1906,6
SIM,1911,16,15-19,1927,9
STAT,1868,17,35-39,1885,0.5392539372743389
SIM,1858,73,na,1931,794
STAT,1828,48,15-19,1876,3.5964548858227844E-4
STAT,1925,41,40-44,1966,0.30647942412253976
STAT,1942,21,35-39,1963,9.971181614560761
SIM,1839,26,20-24,1865,18
STAT,1812,48,25-29,1860,0.13074044834449317
SIM,1861,77,na,1938,737
STAT,1858,48,50-100,1906,0.19216486124311766
STAT,1895,39,15-19,1934,0.07332037084924634
SIM,1832,37,na,1869,1646
STAT,1897,28,30-34,1925,33.97774880501944
STAT,1903,16,15-19,1919,8.557301924703625
STAT,1825,48,35-39,1873,0.18539802364045044
STAT,1852,17,45-49,1869,0.05991682708242236
STAT,1930,16,20-24,1946,177.59266586453688
STAT,1805,97,na,1902,2.1326514584353404
SIM,1858,26,30-34,1884,30
STAT,1860,106,na,1966,0.073677927137496
STAT,1904,28,25-29,1932,61.09665494143977
STAT,1886,37,45-49,1923,2.1258402682425883
SIM,1866,48,50-100,1914,5
STAT,1954,6,na,1960,4909.90204235659
SIM,1914,22,15-19,1936,6
STAT,1832,37,25-29,1869,2.4845434599795078
STAT,1844,48,45-49,1892,0.18437333439357562
STAT,1869,29,45-49,1898,1.0824792018791327
SIM,1896,20,na,1916,3084
SIM,1861,35,40-44,1896,5
STAT,1864,54,na,1918,1908.4055552594268
STAT,1911,17,na,1928,3899.2471694212804
SIM,1863,36,na,1899,2165
SIM,1901,30,40-44,1931,9
STAT,1826,37,na,1863,1555.4618853347138
SIM,1862,29,25-29,1891,49
STAT,1854,29,25-29,1883,32.804639561592786
STAT,1823,52,20-24,1875,9.77606402557096E-4
STAT,1879,20,na,1899,2507.6340426561565
SIM,1811,75,na,1886,559
STAT,1785,81,na,1866,200.35075725163335
STAT,1836,58,na,1894,1246.9226488582876
STAT,1832,44,na,1876,1696.8607239056485
SIM,1865,100,na,1965,6
SIM,1842,26,40-44,1868,3
STAT,1855,46,30-34,1901,0.07307025039515916
SIM,1912,46,50-100,1958,3
STAT,1890,43,20-24,1933,0.19458495680116047
STAT,1936,20,35-39,1956,9.094489455600591
SIM,1806,49,40-44,1855,3
SIM,1882,39,na,1921,2087
SIM,1840,37,25-29,1877,2
STAT,1853,35,40-44,1888,3.696058250954928
STAT,1861,25,na,1886,2046.7999793225415
SIM,1797,81,na,1878,201
STAT,1834,31,15-19,1865,0.10977008637325936
STAT,1876,16,30-34,1892,1.6662377838560298
STAT,1897,27,30-34,1924,34.09777296585927
SIM,1812,60,na,1872,981
SIM,1912,28,25-29,1940,5
STAT,1871,51,35-39,1922,0.008679870525257549
STAT,1852,16,45-49,1868,0.060271828150227226
SIM,1888,29,20-24,1917,20
SIM,1944,6,na,1950,4324
SIM,1889,13,na,1902,3206
STAT,1880,39,na,1919,2473.858292976372
SIM,1833,43,40-44,1876,3
STAT,1931,20,20-24,1951,146.62249253040213
STAT,1867,25,40-44,1892,2.8687776338022086
STAT,1940,30,15-19,1970,0.13441950778244724
SIM,1883,36,30-34,1919,12
STAT,1855,19,15-19,1874,5.2507181096763595
SIM,1856,27,35-39,1883,3
STAT,1914,32,50-100,1946,0.839696857292663
SIM,1924,39,45-49,1963,2
STAT,1923,26,30-34,1949,45.609257375578046
SIM,1826,41,na,1867,1942
SIM,1899,22,25-29,1921,93
STAT,1908,37,45-49,1945,0.6443086768163321
STAT,1825,40,25-29,1865,0.9641931065730204
STAT,1869,21,35-39,1890,5.747499167562736
STAT,1916,31,35-39,1947,9.560113184962905
STAT,1832,38,25-29,1870,2.4582375637705227
STAT,1816,52,50-100,1868,0.03750869279799879
SIM,1922,32,50-100,1954,1
STAT,1855,43,50-100,1898,0.7894689121697337
STAT,1831,54,20-24,1885,4.660839287725817E-4
SIM,1864,23,15-19,1887,3
STAT,1892,39,35-39,1931,8.873854056550776
STAT,1867,34,30-34,1901,16.465874340673235
STAT,1871,23,40-44,1894,2.0844832162381994
STAT,1824,39,40-44,1863,5.714680099545914
SIM,1838,36,30-34,1874,14
STAT,1811,82,na,1893,203.40317547335368
STAT,1899,67,na,1966,2467.5188105528514
STAT,1925,22,25-29,1947,111.73910423501967
SIM,1914,45,50-100,1959,1
STAT,1916,39,45-49,1955,0.6974283365140194
STAT,1841,16,30-34,1857,1.5463702926023475
SIM,1897,26,30-34,1923,1
SIM,1824,52,50-100,1876,1
SIM,1909,50,na,1959,3719
STAT,1849,37,40-44,1886,3.5021873188821178
SIM,1898,27,na,1925,3216
SIM,1875,34,30-34,1909,27
SIM,1877,21,35-39,1898,8
SIM,1933,22,25-29,1955,144
STAT,1880,28,15-19,1908,0.4795530569896198
STAT,1914,46,na,1960,3685.2497440663496
SIM,1869,27,45-49,1896,1
STAT,1830,25,45-49,1855,1.3880227784451449
STAT,1910,32,na,1942,3679.193899686365
SIM,1840,38,25-29,1878,2
STAT,1914,43,30-34,1957,0.12761172897750458
STAT,1895,53,na,1948,2794.4274731402134
STAT,1875,36,30-34,1911,5.554537506421699
SIM,1814,56,na,1870,1166
STAT,1834,106,na,1940,0.007227079983323746
SIM,1832,39,40-44,1871,3
STAT,1889,26,30-34,1915,31.46901575098648
SIM,1877,30,25-29,1907,20
STAT,1888,49,25-29,1937,0.037924416713488944
STAT,1900,16,35-39,1916,0.7717358008763155
STAT,1894,47,20-24,1941,0.008760934357034289
STAT,1813,109,na,1922,3.1194585523127094E-4
SIM,1878,50,na,1928,2501
STAT,1831,59,na,1890,1221.2738563527482
SIM,1781,82,na,1863,75
SIM,1809,56,na,1865,1076
STAT,1944,20,30-34,1964,31.35808372067467
SIM,1839,37,50-100,1876,2
STAT,1917,20,25-29,1937,99.68455795431584
SIM,1924,31,35-39,1955,6
STAT,1848,50,20-24,1898,6.111384148568114E-4
SIM,1880,91,na,1971,221
STAT,1871,37,25-29,1908,2.8890561487311963
STAT,1909,41,45-49,1950,0.15798945581411666
SIM,1825,30,na,1855,1511
SIM,1904,26,25-29,1930,85
STAT,1837,26,20-24,1863,10.346611068301808
SIM,1931,26,30-34,1957,3
STAT,1811,50,25-29,1861,0.008780805865981256
STAT,1840,37,20-24,1877,0.639108418237416
STAT,1898,17,20-24,1915,24.274060645557373
SIM,1857,37,40-44,1894,3
SIM,1909,28,na,1937,3837
STAT,1915,27,35-39,1942,15.452149899478304
SIM,1929,24,25-29,1953,133
STAT,1867,30,15-19,1897,0.13655015868151668
SIM,1905,14,na,1919,3874
STAT,1881,32,15-19,1913,0.13864319209998727
STAT,1893,24,30-34,1917,22.700208230605824
STAT,1858,20,20-24,1878,63.56138625219672
SIM,1906,20,15-19,1926,7
SIM,1864,26,30-34,1890,32
STAT,1860,21,15-19,1881,2.8281152087095114
SIM,1834,33,30-34,1867,25
SIM,1929,27,na,1956,4498
STAT,1851,30,25-29,1881,8.241554582545783
STAT,1840,63,na,1903,1250.7752526831964
STAT,1810,97,na,1907,2.7901285960060305
STAT,1831,48,35-39,1879,0.10323974847548385
STAT,1889,28,35-39,1917,11.974420602543528
STAT,1824,102,na,1926,0.1457521855690043
SIM,1845,26,20-24,1871,10
STAT,1922,16,25-29,1938,50.78992824327925
STAT,1914,40,15-19,1954,0.0015460321598888926
STAT,1829,88,na,1917,80.94760966291958
STAT,1845,33,40-44,1878,3.728770885526005
STAT,1853,46,20-24,1899,0.009951894028645002
STAT,1905,30,20-24,1935,3.9784512351345827
STAT,1846,36,na,1882,1886.5742869887117
STAT,1885,50,25-29,1935,0.003612091084264111
SIM,1813,82,na,1895,210
SIM,1902,0,na,1902,4155
STAT,1806,48,25-29,1854,0.17110929489036986
STAT,1877,51,40-44,1928,0.011026775027003728
STAT,1913,39,30-34,1952,1.7964834760012027
STAT,1926,31,na,1957,4624.61155145817
SIM,1930,16,25-29,1946,77
STAT,1827,45,40-44,1872,0.18031856928172488
SIM,1897,28,35-39,1925,14
SIM,1910,47,na,1957,3196
SIM,1849,37,45-49,1886,2
STAT,1847,48,25-29,1895,0.0425853570222116
STAT,1830,50,35-39,1880,0.007240328413677664
SIM,1866,20,20-24,1886,76
STAT,1880,19,25-29,1899,5.978523883806696
STAT,1856,26,30-34,1882,20.352084639514285
SIM,1867,87,na,1954,129
STAT,1861,19,15-19,1880,5.657557158572886
STAT,1825,43,40-44,1868,3.152169581337245
STAT,1872,30,45-49,1902,1.784946723041405
SIM,1863,73,na,1936,909
STAT,1852,42,35-39,1894,1.3716158228956008
STAT,1879,9,na,1888,2769.445479510525
STAT,1932,39,40-44,1971,2.0283060620515476
SIM,1834,27,45-49,1861,1
STAT,1888,30,35-39,1918,12.169634916890393
STAT,1847,40,15-19,1887,0.010667463791930955
SIM,1846,88,na,1934,19
SIM,1856,25,30-34,1881,31
STAT,1883,68,na,1951,1510.4266478990992
SIM,1879,38,30-34,1917,1
SIM,1912,26,20-24,1938,15
STAT,1864,17,na,1881,2381.1662627173923
STAT,1892,34,40-44,1926,5.449207415550358
STAT,1851,38,35-39,1889,5.356966237069985
SIM,1865,16,20-24,1881,22
STAT,1869,49,15-19,1918,3.845820545385864E-4
SIM,1928,42,na,1970,4907
SIM,1899,71,na,1970,2476
SIM,1842,74,na,1916,659
STAT,1803,51,40-44,1854,0.04661431188650486
STAT,1863,91,na,1954,51.856908274292024
STAT,1830,36,25-29,1866,2.6546931904517477
STAT,1853,49,25-29,1902,0.04663928936684878
STAT,1934,27,45-49,1961,2.3482974093359568
SIM,1844,22,na,1866,1764
SIM,1848,36,na,1884,1854
SIM,1907,32,25-29,1939,8
STAT,1870,42,40-44,1912,2.2280588451446115
SIM,1880,30,45-49,1910,3
STAT,1826,33,30-34,1859,23.131700613753477
STAT,1893,18,45-49,1911,0.08355280636466307
STAT,1848,25,30-34,1873,24.901019279940083
STAT,1856,17,50-100,1873,0.044857644565566984
STAT,1904,26,20-24,1930,17.062138619859574
SIM,1913,30,20-24,1943,2
SIM,1868,8,na,1876,2580
STAT,1896,49,20-24,1945,0.008860669946698712
SIM,1843,18,35-39,1861,1
SIM,1896,30,35-39,1926,23
SIM,1917,29,15-19,1946,3
STAT,1841,32,20-24,1873,2.4525453620471533
STAT,1866,45,30-34,1911,0.09143306343422503
STAT,1868,53,40-44,1921,0.009999078245340293
SIM,1941,29,na,1970,3989
STAT,1923,34,30-34,1957,18.225842257550653
SIM,1944,21,35-39,1965,12
STAT,1880,46,50-100,1926,0.2612501353731988
STAT,1883,89,na,1972,325.5162774034439
STAT,1921,26,20-24,1947,20.617585622493106
SIM,1893,18,na,1911,3312
STAT,1906,37,35-39,1943,2.2458277060867635
STAT,1884,36,35-39,1920,7.078500454456991
STAT,1886,44,45-49,1930,1.5744635164133745
STAT,1860,19,45-49,1879,0.06147030802300479
SIM,1871,40,45-49,1911,3
STAT,1864,32,15-19,1896,0.12978852758624898
SIM,1923,15,40-44,1938,2
STAT,1869,17,50-100,1886,0.04877416757426434
SIM,1881,22,15-19,1903,1
STAT,1901,28,45-49,1929,1.5664973865116807
SIM,1793,83,na,1876,125
SIM,1802,61,na,1863,1032
STAT,1913,18,25-29,1931,8.916249812797155
STAT,1835,21,40-44,1856,2.0948277910505375
SIM,1876,48,na,1924,2542
STAT,1886,22,25-29,1908,61.04631950678539
STAT,1885,15,45-49,1900,0.06597629638395934
SIM,1840,34,20-24,1874,2
STAT,1908,50,na,1958,3323.665113285446
STAT,1936,21,35-39,1957,9.091215439396574
STAT,1856,51,na,1907,1675.274730081531
STAT,1891,26,25-29,1917,53.078532810506545
STAT,1941,29,40-44,1970,4.863144618387333
STAT,1824,35,25-29,1859,4.258549762372228
SIM,1843,21,40-44,1864,2
STAT,1812,45,na,1857,1426.5377727070377
STAT,1863,40,45-49,1903,1.3528422836845748
STAT,1855,104,na,1959,0.10736977209531756
SIM,1861,72,na,1933,1022
STAT,1819,53,45-49,1872,0.02663564926345006
STAT,1796,81,na,1877,200.17600478362402
STAT,1817,45,35-39,1862,0.3107870782175251
STAT,1882,20,15-19,1902,3.2468497832322276
STAT,1869,40,50-100,1909,1.047859558593019
SIM,1919,26,30-34,1945,56
SIM,1876,40,35-39,1916,4
SIM,1952,17,15-19,1969,77
SIM,1834,23,40-44,1857,3
SIM,1921,18,25-29,1939,58
STAT,1814,53,50-100,1867,0.03409277598647704
STAT,1854,1,na,1855,2849.951938864646
STAT,1935,37,50-100,1972,0.5931577893089646
STAT,1801,83,na,1884,148.80416970306007
STAT,1826,53,na,1879,1271.9000004906316
STAT,1889,68,na,1957,1960.1397336856126
SIM,1931,21,25-29,1952,1
STAT,1826,52,35-39,1878,0.008181662902577162
STAT,1836,50,40-44,1886,0.0069912812318825525
STAT,1864,70,na,1934,1278.7438360475378
STAT,1851,20,na,1871,1961.4240238254156
STAT,1910,26,45-49,1936,1.6889060553025936
SIM,1888,33,na,1921,2929
STAT,1944,17,15-19,1961,49.31824562841197
STAT,1818,105,na,1923,0.015106208621079397
STAT,1850,62,na,1912,1399.5189844654824
STAT,1875,30,25-29,1905,10.709203995956512
SIM,1883,30,25-29,1913,24
SIM,1892,36,35-39,1928,13
STAT,1912,24,50-100,1936,0.6588397015093206
SIM,1842,42,30-34,1884,1
SIM,1909,33,35-39,1942,14
STAT,1877,46,45-49,1923,0.24671037672289925
STAT,1866,41,25-29,1907,0.6032835939440645
STAT,1938,28,40-44,1966,4.659508817720182
SIM,1886,28,20-24,1914,15
STAT,1927,23,35-39,1950,11.689337191386606
STAT,1859,51,35-39,1910,0.007026906029220067
STAT,1839,37,50-100,1876,1.0401822704516852
SIM,1918,27,na,1945,4087
STAT,1815,42,20-24,1857,0.4118904136575027
SIM,1890,20,15-19,1910,5
SIM,1922,32,na,1954,4785
SIM,1851,78,na,1929,581
SIM,1853,29,20-24,1882,8
STAT,1924,41,50-100,1965,0.14141037561086997
STAT,1845,21,25-29,1866,52.30300550295063
STAT,1827,30,50-100,1857,1.348202072634541
STAT,1932,27,35-39,1959,19.872669763227883
STAT,1869,26,40-44,1895,2.9516139231651883
SIM,1793,61,na,1854,896
SIM,1953,14,na,1967,4913
STAT,1838,42,15-19,1880,0.010811409426578667
STAT,1929,12,na,1941,5111.004900159073
STAT,1834,42,30-34,1876,0.825411548996612
STAT,1867,32,40-44,1899,4.125179811189093
STAT,1901,18,50-100,1919,0.06918377827819634
SIM,1922,23,25-29,1945,175
STAT,1832,34,20-24,1866,2.3546868688994005
SIM,1851,35,35-39,1886,6
STAT,1914,36,30-34,1950,1.8448450032864638
STAT,1895,20,25-29,1915,75.95537010890928
SIM,1834,21,15-19,1855,3
SIM,1935,23,35-39,1958,1
STAT,1770,108,na,1878,0.002618398353671462
SIM,1940,27,35-39,1967,26
STAT,1934,29,na,1963,5087.004565997785
STAT,1851,41,50-100,1892,0.8035519785938788
STAT,1922,42,15-19,1964,0.0017806894355431706
STAT,1878,28,20-24,1906,12.256600458320275
STAT,1909,29,15-19,1938,0.6759470352599556
SIM,1900,35,40-44,1935,3
SIM,1837,24,20-24,1861,63
STAT,1845,29,20-24,1874,10.28437335740204
SIM,1848,90,na,1938,52
STAT,1860,112,na,1972,4.6246055132762146E-4
SIM,1901,64,na,1965,2643
SIM,1905,31,25-29,1936,3
STAT,1892,31,25-29,1923,13.034313211427655
SIM,1826,89,na,1915,100
STAT,1826,43,na,1869,1467.6941970045577
SIM,1853,21,25-29,1874,56
SIM,1901,54,na,1955,2976
SIM,1922,36,30-34,1958,6
SIM,1869,24,40-44,1893,3
STAT,1882,33,20-24,1915,2.6333710238918333
STAT,1896,15,20-24,1911,23.811770830194824
STAT,1891,6,na,1897,3266.695828705527
STAT,1870,30,35-39,1900,10.124639333585149
STAT,1851,42,na,1893,1747.8879460622752
SIM,1903,23,15-19,1926,5
STAT,1845,43,45-49,1888,1.099430548217291
STAT,1855,20,40-44,1875,1.8590277858900008
STAT,1880,29,15-19,1909,0.47780748386217736
STAT,1801,53,50-100,1854,0.055848023444138
STAT,1865,24,30-34,1889,16.389265954047122
SIM,1873,24,30-34,1897,25
STAT,1933,39,45-49,1972,0.9363146535372623
STAT,1864,92,na,1956,43.14972126097426
SIM,1890,33,20-24,1923,4
STAT,1902,39,30-34,1941,1.6253135921129391
STAT,1871,30,40-44,1901,4.386544829174474
STAT,1821,34,45-49,1855,4.3987415484695775
STAT,1916,44,40-44,1960,0.2578109312401807
SIM,1910,39,30-34,1949,1
STAT,1831,33,50-100,1864,0.7494221086247294
STAT,1865,36,25-29,1901,2.668137256757083
SIM,1929,26,15-19,1955,4
SIM,1827,39,20-24,1866,3
SIM,1868,32,25-29,1900,24
STAT,1841,19,35-39,1860,0.523005525569151
STAT,1937,16,30-34,1953,12.000262722904644
STAT,1899,35,40-44,1934,6.12551108409346
STAT,1901,12,na,1913,3656.4647560269896
SIM,1897,29,35-39,1926,24
STAT,1855,40,na,1895,1757.2727288747965
STAT,1946,24,na,1970,4101.590605018054
SIM,1884,35,na,1919,2437
STAT,1918,49,20-24,1967,0.01180309422381246
STAT,1894,30,35-39,1924,13.274433035253226
STAT,1867,35,na,1902,2262.3407260607187
SIM,1905,20,na,1925,3434
STAT,1826,59,na,1885,1129.444710600854
STAT,1909,15,40-44,1924,0.27807478051186396
SIM,1851,56,na,1907,1615
STAT,1912,0,na,1912,4581.065205478617
STAT,1871,33,45-49,1904,1.742409274846607
STAT,1801,61,na,1862,1013.1305807440984
STAT,1889,46,na,1935,2809.893860832518
STAT,1871,40,na,1911,2342.5550281589885
STAT,1888,46,20-24,1934,0.014345956244185942
STAT,1867,53,35-39,1920,0.008057640643840108
STAT,1914,23,25-29,1937,94.91940251794429
STAT,1843,35,35-39,1878,5.685951963584594
SIM,1955,16,15-19,1971,58
SIM,1813,45,na,1858,1419
STAT,1849,53,30-34,1902,0.004579292794706728
SIM,1950,21,35-39,1971,21
STAT,1839,34,30-34,1873,14.920039719983427
SIM,1804,78,na,1882,338
SIM,1863,20,40-44,1883,2
SIM,1842,29,45-49,1871,2
SIM,1870,35,45-49,1905,5
STAT,1940,29,35-39,1969,15.440709493772463
SIM,1898,33,na,1931,3227
STAT,1819,39,20-24,1858,1.861257703723575
STAT,1874,70,na,1944,1451.0447397892717
SIM,1890,40,50-100,1930,1
STAT,1937,27,25-29,1964,64.77337834227328
SIM,1783,83,na,1866,182
STAT,1851,37,35-39,1888,5.412881300908369
SIM,1845,27,20-24,1872,13
STAT,1843,55,na,1898,1394.606200453179
STAT,1835,50,35-39,1885,0.006853741574717218
SIM,1821,74,na,1895,564
STAT,1835,95,na,1930,9.978936925162197
SIM,1818,76,na,1894,373
STAT,1889,29,35-39,1918,11.930833711550271
STAT,1834,29,45-49,1863,0.8546646095418537
SIM,1902,18,15-19,1920,7
STAT,1924,46,40-44,1970,0.19014386457260693
STAT,1860,35,35-39,1895,5.895051114261723
SIM,1856,24,30-34,1880,28
SIM,1905,20,45-49,1925,1
STAT,1894,43,40-44,1937,0.20163782465152516
STAT,1928,29,25-29,1957,81.88147057200567
STAT,1938,26,15-19,1964,0.7063773221592679
STAT,1874,40,20-24,1914,0.16590005362944957
STAT,1782,79,na,1861,276.06902657386473
SIM,1813,55,na,1868,1169
STAT,1866,18,na,1884,2410.1511421493087
SIM,1936,29,25-29,1965,78
STAT,1819,105,na,1924,0.014905541927521445
STAT,1954,16,30-34,1970,15.227664052699748
STAT,1827,52,40-44,1879,0.010425410495216185
STAT,1923,21,25-29,1944,108.92019527809323
SIM,1878,25,20-24,1903,16
STAT,1850,25,25-29,1875,38.67079583499445
SIM,1862,36,50-100,1898,1
STAT,1794,96,na,1890,1.6698399163082445
STAT,1880,23,45-49,1903,0.7373707740807448
STAT,1946,14,na,1960,4398.811144450991
STAT,1876,51,35-39,1927,0.009020852438415137
SIM,1866,43,30-34,1909,2
STAT,1944,23,35-39,1967,10.262743150162803
SIM,1901,26,45-49,1927,3
STAT,1919,39,25-29,1958,1.0657360366131416
SIM,1826,37,50-100,1863,1
SIM,1883,43,30-34,1926,3
STAT,1928,26,30-34,1954,48.95950971284048
SIM,1838,74,na,1912,780
SIM,1897,25,30-34,1922,48
STAT,1830,32,45-49,1862,1.6740617800166675
SIM,1934,25,50-100,1959,1
STAT,1887,31,50-100,1918,1.0374228961142742
SIM,1847,34,30-34,1881,21
STAT,1904,21,15-19,1925,4.796103735009174
SIM,1933,16,na,1949,4620
STAT,1901,18,na,1919,3566.529374905856
STAT,1843,50,50-100,1893,0.010332699762351351
STAT,1900,54,na,1954,2937.9255412350544
STAT,1891,40,20-24,1931,0.20059610005413606
STAT,1899,47,35-39,1946,0.1089563727143299
SIM,1926,27,15-19,1953,1
STAT,1829,30,40-44,1859,4.0730935475557155
SIM,1916,23,25-29,1939,103
STAT,1931,39,50-100,1970,0.5607680674819012
STAT,1947,16,15-19,1963,51.65359142481256
SIM,1894,22,25-29,1916,98
STAT,1841,26,na,1867,2023.82364216008
STAT,1794,64,na,1858,849.3828402372758
STAT,1853,42,40-44,1895,1.8578082456268348
STAT,1837,27,20-24,1864,10.272322400831401
STAT,1908,23,25-29,1931,85.45636432185525
STAT,1838,26,50-100,1864,0.5486642840505953
STAT,1923,30,50-100,1953,0.9653830363936461
STAT,1896,21,40-44,1917,2.794299055978765
SIM,1812,49,50-100,1861,4
STAT,1844,72,na,1916,999.1824942180729
STAT,1819,89,na,1908,53.40531506346291
SIM,1882,39,50-100,1921,1
STAT,1828,49,15-19,1877,3.5491477692162134E-4
STAT,1808,52,30-34,1860,0.02015137433922132
STAT,1917,27,na,1944,3965.5410569142246
SIM,1900,29,20-24,1929,25
STAT,1840,35,50-100,1875,1.0392783013668578
SIM,1931,34,30-34,1965,30
STAT,1907,46,40-44,1953,0.14364355931407924
STAT,1828,60,na,1888,1278.3473639441995
STAT,1844,52,40-44,1896,0.00828496874543898
SIM,1856,28,35-39,1884,8
SIM,1861,40,na,1901,2026
STAT,1858,34,40-44,1892,3.406935260163277
SIM,1827,31,25-29,1858,14
STAT,1814,58,na,1872,1182.9213952785512
SIM,1945,16,30-34,1961,22
STAT,1918,27,15-19,1945,0.7584813456790347
STAT,1921,32,na,1953,4250.8405004332135
STAT,1850,94,na,1944,15.30361583329934
SIM,1893,41,35-39,1934,1
STAT,1885,41,35-39,1926,1.8287166443456904
STAT,1859,24,30-34,1883,14.79784226542037
SIM,1912,21,15-19,1933,5
STAT,1825,47,35-39,1872,0.18798488532394245
STAT,1894,15,na,1909,3299.3935453034987
SIM,1837,30,40-44,1867,4
STAT,1847,45,20-24,1892,0.00907441972461478
STAT,1875,43,30-34,1918,1.183841958841647
SIM,1927,39,25-29,1966,1
STAT,1892,38,35-39,1930,8.919611664389091
SIM,1896,68,na,1964,2226
STAT,1889,25,30-34,1914,31.574157696114543
STAT,1818,50,35-39,1868,0.015323114561724662
SIM,1877,44,45-49,1921,4
STAT,1777,84,na,1861,77.47432239778774
SIM,1927,21,35-39,1948,23
STAT,1863,17,20-24,1880,18.103550089652405
SIM,1922,39,35-39,1961,9
STAT,1875,86,na,1961,369.6225057607352
SIM,1813,77,na,1890,384
STAT,1899,46,na,1945,3128.056795953921
STAT,1897,33,na,1930,3217.569793462691
STAT,1836,31,25-29,1867,8.252652926414953
SIM,1864,39,25-29,1903,2
SIM,1894,41,40-44,1935,2
SIM,1913,33,25-29,1946,5
STAT,1824,32,20-24,1856,5.276240767924765
STAT,1817,76,na,1893,433.4583302455804
STAT,1899,33,15-19,1932,0.19656563940749697
SIM,1934,29,15-19,1963,1
STAT,1852,21,40-44,1873,1.8909515718701724
STAT,1929,30,45-49,1959,2.0225475758541203
STAT,1913,15,20-24,1928,28.09797712880658
SIM,1921,37,40-44,1958,1
STAT,1918,39,50-100,1957,0.44582132491370247
STAT,1818,40,na,1858,1564.1825545608351
STAT,1836,21,na,1857,1791.97247248846
STAT,1866,48,35-39,1914,0.1292873881159956
STAT,1896,32,na,1928,3190.3098383772895
SIM,1891,41,25-29,1932,3
STAT,1883,41,25-29,1924,0.6375614241740477
STAT,1807,50,50-100,1857,0.05338461538749823
STAT,1835,89,na,1924,78.8476886435933
STAT,1901,25,40-44,1926,4.270065747234302
SIM,1831,58,na,1889,1297
SIM,1832,32,20-24,1864,2
STAT,1926,29,15-19,1955,0.8491848138146977
STAT,1956,16,40-44,1972,1.8702436919451164
STAT,1848,28,35-39,1876,9.337256118048991
STAT,1825,52,30-34,1877,0.0077025786653074375
STAT,1862,110,na,1972,0.004428503923637789
SIM,1909,30,30-34,1939,20
SIM,1892,33,30-34,1925,34
STAT,1885,38,na,1923,2356.8047057670087
STAT,1816,75,na,1891,526.3362029636522
STAT,1904,37,15-19,1941,0.017567635425642505
STAT,1843,19,45-49,1862,0.05564170142041206
SIM,1861,56,na,1917,1750
SIM,1854,24,20-24,1878,77
STAT,1914,39,35-39,1953,2.412056748225614
SIM,1872,31,50-100,1903,1
STAT,1906,33,na,1939,3525.431437743579
STAT,1854,39,15-19,1893,0.04171909105039048
STAT,1873,26,30-34,1899,25.872471976330814
STAT,1905,33,25-29,1938,8.551033328901608
SIM,1844,31,25-29,1875,20
SIM,1901,48,na,1949,3234
SIM,1949,2,na,1951,4488
SIM,1868,35,na,1903,2221
SIM,1914,21,25-29,1935,138
SIM,1830,57,na,1887,1107
SIM,1870,32,50-100,1902,1
STAT,1837,50,45-49,1887,0.010338023800158726
SIM,1891,69,na,1960,1837
SIM,1911,20,45-49,1931,1
STAT,1874,54,50-100,1928,0.015189591224080947
SIM,1945,11,na,1956,4209
SIM,1818,86,na,1904,165
STAT,1851,26,na,1877,1931.7426443970096
STAT,1884,33,30-34,1917,17.31640635715025
SIM,1836,21,25-29,1857,61
STAT,1816,107,na,1923,0.0024111400048277497
SIM,1828,34,20-24,1862,2
SIM,1860,21,40-44,1881,4
STAT,1849,40,25-29,1889,0.5108471779334357
SIM,1843,43,na,1886,2130
SIM,1888,71,na,1959,1926
SIM,1871,17,20-24,1888,26
SIM,1940,24,30-34,1964,55
SIM,1834,23,na,1857,1989
SIM,1878,31,40-44,1909,1
STAT,1870,39,na,1909,2313.1133090665835
STAT,1854,15,40-44,1869,0.16615476775351842
STAT,1924,16,35-39,1940,5.061820893722144
STAT,1900,28,40-44,1928,4.188015675388861
SIM,1927,3,na,1930,5530
STAT,1912,23,15-19,1935,5.131000784336451
SIM,1868,29,na,1897,2261
SIM,1905,27,40-44,1932,9
SIM,1848,74,na,1922,713
STAT,1897,47,25-29,1944,0.04378988379817629
SIM,1932,16,35-39,1948,7
STAT,1891,23,20-24,1914,85.90729435678428
STAT,1864,103,na,1967,0.8675359284280113
STAT,1897,20,35-39,1917,7.9487284891695875
STAT,1856,30,15-19,1886,0.11396531879695795
STAT,1906,32,50-100,1938,0.7739596443561544
STAT,1908,20,20-24,1928,103.80727131943196
STAT,1852,91,na,1943,43.947157583672805
STAT,1863,109,na,1972,0.012393524195363586
STAT,1862,21,25-29,1883,51.483237582626245
STAT,1878,51,45-49,1929,0.015288410666768186
SIM,1873,41,na,1914,2242
STAT,1790,66,na,1856,658.9790876000003
STAT,1904,33,50-100,1937,0.7593331921640175
STAT,1868,31,30-34,1899,16.922580750207185
STAT,1869,30,25-29,1899,10.138658400617796
SIM,1849,34,40-44,1883,8
STAT,1906,21,25-29,1927,84.46846857041129
STAT,1854,92,na,1946,31.257325433023183
STAT,1832,42,20-24,1874,0.13269070815737138
STAT,1893,40,30-34,1933,1.4892592765253385
STAT,1834,78,na,1912,465.0715026754575
SIM,1916,20,20-24,1936,174
STAT,1846,24,20-24,1870,63.603562594106386
STAT,1825,101,na,1926,0.4164176526871443
STAT,1817,92,na,1909,19.05553697812072
SIM,1895,25,20-24,1920,19
SIM,1829,60,na,1889,1283
STAT,1821,38,na,1859,1695.5205271520663
SIM,1908,27,na,1935,3584
SIM,1883,24,na,1907,2628
STAT,1933,36,40-44,1969,2.062318984388458
SIM,1833,75,na,1908,606
SIM,1836,43,45-49,1879,1
STAT,1887,25,20-24,1912,13.31867287169908
SIM,1864,8,na,1872,2925
STAT,1816,50,25-29,1866,0.00915474983003575
STAT,1903,20,45-49,1923,1.0090212852546376
STAT,1923,17,40-44,1940,1.6594892575171452
SIM,1898,30,45-49,1928,5
STAT,1876,25,50-100,1901,0.6716245093026902
STAT,1913,37,40-44,1950,1.4905617802704212
SIM,1926,19,15-19,1945,53
SIM,1947,24,na,1971,4457
SIM,1876,86,na,1962,296
SIM,1906,26,35-39,1932,27
STAT,1836,53,45-49,1889,0.009081584617743818
SIM,1836,89,na,1925,49
SIM,1903,13,na,1916,3531
STAT,1895,16,40-44,1911,0.2418349305633836
SIM,1931,17,40-44,1948,2
STAT,1907,6,na,1913,3874.7211403250167
SIM,1851,32,30-34,1883,18
STAT,1895,34,45-49,1929,2.2803455994104955
STAT,1893,67,na,1960,2163.6397353351854
STAT,1836,37,na,1873,1657.5699746074013
STAT,1903,38,20-24,1941,0.23813752961775395
SIM,1848,52,na,1900,1627
STAT,1885,16,na,1901,2545.323163112528
SIM,1886,20,25-29,1906,78
STAT,1765,99,na,1864,0.2834130028687545
STAT,1850,42,25-29,1892,0.4911031387298595
STAT,1923,37,25-29,1960,1.1527042656532243
STAT,1869,8,na,1877,2686.522157908096
STAT,1927,20,30-34,1947,36.00480657397388
SIM,1843,21,na,1864,2395
STAT,1862,35,45-49,1897,1.7552727890757187
SIM,1834,31,40-44,1865,5
SIM,1870,21,25-29,1891,99
SIM,1937,24,na,1961,3452
STAT,1938,32,25-29,1970,9.38210414285738
STAT,1931,23,25-29,1954,120.70276947074566
STAT,1865,19,50-100,1884,0.04601344874603231
STAT,1893,22,40-44,1915,2.6723628855941177
STAT,1901,41,50-100,1942,0.10434038632857329
STAT,1851,42,30-34,1893,0.8694430064076658
SIM,1928,27,25-29,1955,92
SIM,1825,29,45-49,1854,1
STAT,1849,32,50-100,1881,0.754874411535282
STAT,1826,31,40-44,1857,6.465920588200544
STAT,1835,73,na,1908,891.4651329704498
SIM,1935,20,30-34,1955,70
STAT,1906,11,na,1917,3804.8073231600683
STAT,1874,18,35-39,1892,0.5659825154243641
SIM,1938,26,40-44,1964,5
SIM,1857,32,50-100,1889,5
SIM,1881,70,na,1951,1219
STAT,1834,49,15-19,1883,2.4624494281178693E-4
STAT,1843,32,30-34,1875,14.157033686454106
STAT,1848,22,na,1870,2125.559317814499
STAT,1884,69,na,1953,1461.6658785667596
SIM,1892,38,na,1930,3203
STAT,1914,20,20-24,1934,110.64427558031984
STAT,1867,50,30-34,1917,0.0057435637113519705
SIM,1873,36,25-29,1909,5
STAT,1823,88,na,1911,75.9265363804866
SIM,1894,67,na,1961,2404
STAT,1845,40,40-44,1885,1.7170593122886617
STAT,1940,26,30-34,1966,40.35544973055454
STAT,1922,29,30-34,1951,44.470952489070385
SIM,1891,53,na,1944,2716
STAT,1910,37,15-19,1947,0.018529617070887863
STAT,1870,88,na,1958,185.63110693196472
SIM,1925,17,40-44,1942,6
SIM,1936,26,20-24,1962,1
STAT,1897,31,15-19,1928,0.19361638277810725
STAT,1901,33,40-44,1934,6.1142607905997615
STAT,1927,34,15-19,1961,0.15956839240344725
STAT,1769,97,na,1866,0.7495083299592853
SIM,1930,29,30-34,1959,81
STAT,1877,30,35-39,1907,10.641545932300613
STAT,1847,36,30-34,1883,4.183487151168441
SIM,1885,30,35-39,1915,4
STAT,1860,39,15-19,1899,0.04589607758966281
SIM,1908,21,25-29,1929,3
STAT,1851,54,50-100,1905,0.011121145630913565
SIM,1928,33,50-100,1961,1
STAT,1925,37,45-49,1962,0.8268978862911807
SIM,1817,75,na,1892,520
STAT,1872,20,40-44,1892,2.1285679388103014
STAT,1876,20,15-19,1896,3.4608910952011596
STAT,1851,10,na,1861,2225.2305110440393
SIM,1897,32,na,1929,3246
STAT,1858,32,15-19,1890,0.11284193008189729
STAT,1919,32,15-19,1951,0.13998326984753912
SIM,1948,6,na,1954,5011
STAT,1905,42,15-19,1947,0.0013984837858907345
SIM,1825,40,na,1865,1427
SIM,1888,65,na,1953,2135
SIM,1904,15,30-34,1919,2
STAT,1862,37,50-100,1899,1.0708621652924246
STAT,1917,17,40-44,1934,0.30381813755628817
SIM,1840,88,na,1928,91
SIM,1858,22,15-19,1880,3
SIM,1879,48,50-100,1927,1
SIM,1853,40,40-44,1893,4
STAT,1879,43,15-19,1922,0.014450411854209094
SIM,1862,33,45-49,1895,1
SIM,1922,20,20-24,1942,130
STAT,1839,43,20-24,1882,0.11715861630913653
STAT,1825,44,30-34,1869,1.5749559295043882
STAT,1869,91,na,1960,101.00175632551304
SIM,1886,2,na,1888,3156
STAT,1839,37,35-39,1876,5.9924014466231235
STAT,1882,73,na,1955,1162.0349229316569
STAT,1851,34,30-34,1885,13.477134901622971
SIM,1836,25,40-44,1861,7
SIM,1867,41,50-100,1908,1
SIM,1870,39,25-29,1909,3
STAT,1842,43,na,1885,2125.499398432028
SIM,1818,92,na,1910,30
STAT,1918,19,15-19,1937,49.602440423756455
SIM,1855,36,30-34,1891,6
STAT,1899,38,45-49,1937,0.5934704111749797
STAT,1921,39,40-44,1960,1.6845934027550384
STAT,1915,39,40-44,1954,1.5105963750516158
STAT,1821,44,na,1865,1605.7163762488526
SIM,1863,41,na,1904,2100
SIM,1923,39,40-44,1962,2
STAT,1938,21,45-49,1959,1.1245730828242415
STAT,1762,103,na,1865,0.03398191507108707
STAT,1842,40,25-29,1882,0.6136905119075386
SIM,1871,39,na,1910,2238
SIM,1883,18,na,1901,2861
STAT,1919,48,15-19,1967,4.0229355326231467E-4
SIM,1946,21,45-49,1967,1
STAT,1821,38,50-100,1859,2.27732007009523
STAT,1812,94,na,1906,9.07390021079693
STAT,1845,34,50-100,1879,0.7796630492520938
STAT,1854,33,45-49,1887,1.3263589981857817
STAT,1833,23,na,1856,2018.0417129996245
STAT,1899,44,30-34,1943,0.1091701235221352
SIM,1849,42,40-44,1891,4
SIM,1878,71,na,1949,1411
SIM,1888,28,30-34,1916,39
STAT,1905,16,25-29,1921,8.294291958423207
SIM,1901,23,40-44,1924,3
SIM,1847,37,50-100,1884,1
SIM,1861,42,40-44,1903,5
STAT,1891,43,25-29,1934,0.7972026484960921
STAT,1825,95,na,1920,9.7025376221048
STAT,1889,38,50-100,1927,1.5214397511470068
STAT,1913,48,50-100,1961,0.2221214446137389
SIM,1907,28,50-100,1935,1
STAT,1862,39,25-29,1901,2.4860191751339302
STAT,1847,74,na,1921,830.9397985558572
SIM,1842,95,na,1937,5
STAT,1875,4,na,1879,3016.3023610043397
SIM,1833,44,30-34,1877,4
STAT,1858,46,35-39,1904,0.11124908434693358
SIM,1913,33,na,1946,3808
STAT,1947,24,15-19,1971,6.072836700253828
STAT,1843,21,15-19,1864,2.8131359383790056
STAT,1878,52,50-100,1930,0.015750254351849333
STAT,1884,47,na,1931,2230.3833027426167
STAT,1850,22,20-24,1872,63.33402090554865
SIM,1899,23,15-19,1922,5
SIM,1914,15,15-19,1929,7
STAT,1819,50,40-44,1869,0.02051288600740358
STAT,1830,58,na,1888,1309.0811254291743
SIM,1825,62,na,1887,871
STAT,1907,49,45-49,1956,0.19436925022018378
STAT,1858,37,45-49,1895,1.5796121190004464
SIM,1871,92,na,1963,92
SIM,1926,31,45-49,1957,1
STAT,1943,18,20-24,1961,145.11882461899404
SIM,1879,30,35-39,1909,15
STAT,1794,80,na,1874,263.21134971578795
STAT,1843,52,35-39,1895,0.005775621973668627
SIM,1907,31,35-39,1938,20
STAT,1892,35,30-34,1927,6.818745179909654
STAT,1928,26,20-24,1954,22.808688360240918
SIM,1859,68,na,1927,1473
SIM,1898,17,na,1915,3433
SIM,1808,46,50-100,1854,2
STAT,1827,35,50-100,1862,1.4971734073509633
STAT,1882,29,25-29,1911,41.089702308969194
STAT,1844,56,na,1900,1613.726205509284
STAT,1952,19,15-19,1971,54.91179556195753
SIM,1870,4,na,1874,3133
STAT,1828,36,20-24,1864,0.8121506089897481
SIM,1820,41,40-44,1861,7
SIM,1839,91,na,1930,15
STAT,1886,41,40-44,1927,2.4094651615642073
SIM,1823,38,25-29,1861,5
STAT,1873,35,20-24,1908,0.7967754358901131
STAT,1806,55,na,1861,1081.3916348603627
SIM,1908,49,na,1957,3175
STAT,1824,52,25-29,1876,0.003995346186623199
SIM,1849,20,20-24,1869,69
STAT,1871,19,20-24,1890,17.69383755801707
STAT,1928,29,35-39,1957,18.677113773863713
SIM,1904,39,30-34,1943,2
STAT,1836,45,45-49,1881,0.15984918783427354
SIM,1913,16,25-29,1929,12
SIM,1845,60,na,1905,1523
SIM,1877,26,40-44,1903,4
STAT,1915,15,40-44,1930,0.2967664785903698
STAT,1864,21,45-49,1885,0.6504197997181754
SIM,1921,48,50-100,1969,3
STAT,1906,15,15-19,1921,8.770900721912207
STAT,1918,31,45-49,1949,1.695044950761691
STAT,1890,22,15-19,1912,4.071526228754195
STAT,1919,21,35-39,1940,10.441784471609326
SIM,1890,29,25-29,1919,60
STAT,1945,22,15-19,1967,5.891884254444082
STAT,1825,36,50-100,1861,2.1144999326996934
SIM,1914,37,35-39,1951,10
STAT,1913,2,na,1915,4205.270303586535
STAT,1860,38,50-100,1898,1.0086292923796185
SIM,1836,73,na,1909,801
SIM,1936,29,35-39,1965,20
STAT,1823,31,15-19,1854,0.43892699689863635
STAT,1930,27,15-19,1957,0.9072769484482603
STAT,1853,86,na,1939,183.48639675686587
SIM,1877,49,na,1926,2304
STAT,1882,50,20-24,1932,7.323162404803214E-4
STAT,1852,24,45-49,1876,0.6192516660082857
SIM,1843,27,na,1870,2379
STAT,1897,17,na,1914,3419.8192079979176
SIM,1843,35,50-100,1878,2
STAT,1907,29,40-44,1936,4.374217845643811
SIM,1836,36,20-24,1872,3
STAT,1846,17,20-24,1863,16.900833769843448
STAT,1897,35,30-34,1932,7.285098262758313
STAT,1899,31,25-29,1930,14.255826235121313
SIM,1899,29,45-49,1928,2
STAT,1851,52,35-39,1903,0.006483972280940875
STAT,1916,26,na,1942,3922.315713694588
SIM,1858,67,na,1925,1197
STAT,1876,34,na,1910,2467.2416867241413
SIM,1937,31,20-24,1968,2
SIM,1908,25,40-44,1933,4
STAT,1773,106,na,1879,0.013403145093662675
SIM,1846,31,45-49,1877,1
SIM,1904,15,20-24,1919,24
STAT,1834,33,40-44,1867,3.2741001566460537
STAT,1871,15,40-44,1886,0.18690997187906092
SIM,1904,37,40-44,1941,3
STAT,1861,19,na,1880,2188.3031276561783
SIM,1838,44,30-34,1882,4
SIM,1877,41,40-44,1918,3
STAT,1839,30,15-19,1869,0.12685410903685385
STAT,1931,39,35-39,1970,3.2305370647582876
SIM,1923,11,na,1934,4747
STAT,1811,44,na,1855,1344.465286594761
SIM,1900,31,25-29,1931,8
STAT,1827,54,na,1881,1336.3090930388287
SIM,1938,15,25-29,1953,68
STAT,1864,49,na,1913,2007.6636525528465
STAT,1840,44,20-24,1884,0.11319139135887182
SIM,1877,40,50-100,1917,1
STAT,1924,42,25-29,1966,0.08583155122128693
SIM,1828,40,40-44,1868,5
SIM,1889,47,50-100,1936,3
STAT,1865,71,na,1936,1231.0278786126999
STAT,1902,48,20-24,1950,0.009539730414031238
SIM,1915,29,40-44,1944,6
SIM,1840,25,30-34,1865,30
STAT,1929,31,20-24,1960,3.1333802541785394
STAT,1883,48,35-39,1931,0.136633338155421
STAT,1920,38,20-24,1958,0.2911661095757885
SIM,1871,24,20-24,1895,70
SIM,1920,24,50-100,1944,4
SIM,1883,56,na,1939,2199
STAT,1853,20,30-34,1873,17.657163620928756
STAT,1842,19,50-100,1861,0.055976592336004174
SIM,1854,30,40-44,1884,7
STAT,1837,39,15-19,1876,0.045683783221580246
STAT,1859,111,na,1970,0.0010601284068631265
STAT,1913,27,15-19,1940,0.7097239400690181
STAT,1917,28,20-24,1945,19.25493830624149
STAT,1941,15,na,1956,3829.64624013675
STAT,1797,82,na,1879,172.82990236255438
STAT,1944,21,45-49,1965,1.2271754326232325
SIM,1923,3,na,1926,4820
STAT,1838,31,45-49,1869,1.4657065264091034
STAT,1862,32,40-44,1894,3.7825721792640605
STAT,1876,0,na,1876,3818.4773682665973
STAT,1919,36,30-34,1955,1.9787547830942176
SIM,1854,41,50-100,1895,1
SIM,1861,20,30-34,1881,2
STAT,1865,53,25-29,1918,0.0032141931950803388
STAT,1878,20,25-29,1898,60.37754482440455
STAT,1832,25,30-34,1857,23.674849075802477
SIM,1849,36,30-34,1885,9
SIM,1808,92,na,1900,11
STAT,1932,18,45-49,1950,0.6667130687288747
SIM,1849,15,na,1864,2363
SIM,1925,28,20-24,1953,33
SIM,1911,16,na,1927,4055
SIM,1918,20,30-34,1938,34
STAT,1907,16,35-39,1923,0.8158595470178575
SIM,1945,19,25-29,1964,59
STAT,1892,46,35-39,1938,0.1003712030063816
STAT,1826,75,na,1901,564.8868248723047
STAT,1924,30,na,1954,4478.94771300183
STAT,1815,69,na,1884,743.0002775673578
STAT,1817,49,15-19,1866,8.332027521923711E-4
STAT,1949,21,20-24,1970,131.12506301945496
STAT,1841,23,30-34,1864,16.75299171681451
STAT,1867,46,50-100,1913,0.23428339495665418
STAT,1869,37,20-24,1906,0.7569416091905515
STAT,1857,18,35-39,1875,0.5053621735562779
STAT,1880,20,40-44,1900,2.2235059240703365
STAT,1867,26,30-34,1893,24.035777474336502
STAT,1841,28,25-29,1869,39.00837279440126
STAT,1867,19,na,1886,2427.1394124802614
STAT,1945,13,na,1958,4332.752953207181
STAT,1916,11,na,1927,4234.814975031657
STAT,1940,15,15-19,1955,46.544355535293775
STAT,1856,46,25-29,1902,0.044728978434927374
SIM,1866,71,na,1937,1311
STAT,1826,34,45-49,1860,2.18772939665378
STAT,1823,47,25-29,1870,0.07928063459825471
SIM,1845,17,na,1862,2339
SIM,1835,30,30-34,1865,24
SIM,1929,11,na,1940,4962
SIM,1858,57,na,1915,1593
STAT,1947,22,25-29,1969,105.4492984205556
SIM,1927,36,30-34,1963,4
SIM,1858,52,na,1910,1741
SIM,1811,81,na,1892,294
SIM,1833,91,na,1924,50
SIM,1906,63,na,1969,2808
SIM,1911,48,na,1959,3779
STAT,1837,19,20-24,1856,17.556599639089946
STAT,1863,16,45-49,1879,0.06709951403634831
SIM,1931,30,na,1961,4888
STAT,1890,38,25-29,1928,3.5357675481155892
STAT,1939,27,35-39,1966,15.23703511128174
STAT,1937,31,50-100,1968,0.8262761731734767
STAT,1808,62,na,1870,933.780653751596
SIM,1872,93,na,1965,25
STAT,1845,57,na,1902,1468.4093253653398
STAT,1937,19,25-29,1956,42.4339743209256
SIM,1933,21,35-39,1954,12
STAT,1936,28,30-34,1964,37.83910158847046
STAT,1833,50,25-29,1883,0.002696894790122395
STAT,1851,45,35-39,1896,0.10706312848408317
STAT,1929,36,15-19,1965,0.024941453493434653
STAT,1821,38,25-29,1859,5.340575984178833
SIM,1803,62,na,1865,854
STAT,1864,31,50-100,1895,0.8384670069001641
STAT,1930,29,40-44,1959,5.984352904192457
STAT,1954,16,20-24,1970,169.3765579760201
SIM,1845,19,20-24,1864,1
SIM,1934,15,40-44,1949,2
SIM,1896,37,30-34,1933,12
SIM,1866,86,na,1952,165
STAT,1914,27,40-44,1941,4.740837788010945
STAT,1910,20,50-100,1930,0.6271444470059273
SIM,1886,24,40-44,1910,9
SIM,1915,16,35-39,1931,1
STAT,1891,23,na,1914,2948.3032069879528
STAT,1827,30,30-34,1857,25.6909592705553
SIM,1853,25,40-44,1878,3
SIM,1883,34,na,1917,2637
SIM,1929,21,45-49,1950,1
STAT,1865,20,15-19,1885,3.1242323328084067
STAT,1843,26,45-49,1869,0.928275517529854
SIM,1845,34,20-24,1879,5
STAT,1905,49,35-39,1954,0.11289874459712715
SIM,1851,26,45-49,1877,1
STAT,1820,81,na,1901,275.26118118866276
STAT,1839,27,30-34,1866,22.491128444497647
STAT,1863,29,15-19,1892,0.4031119039676762
SIM,1935,32,50-100,1967,2
STAT,1837,34,20-24,1871,2.264552521792567
SIM,1847,27,30-34,1874,29
STAT,1894,21,30-34,1915,23.231869656381313
SIM,1782,77,na,1859,160
STAT,1860,23,40-44,1883,1.7608020241643134
STAT,1925,21,35-39,1946,11.424804400528044
SIM,1798,60,na,1858,992
STAT,1878,24,40-44,1902,2.1711022222939698
STAT,1888,37,30-34,1925,6.3534519343950135
STAT,1845,25,40-44,1870,2.7028541547289153
STAT,1930,15,30-34,1945,16.001209301099735
STAT,1925,34,40-44,1959,4.690330814698326
SIM,1860,15,30-34,1875,2
SIM,1828,38,na,1866,1634
SIM,1828,54,na,1882,1296
STAT,1883,41,15-19,1924,0.013710999285059505
STAT,1901,36,45-49,1937,0.612142476153401
STAT,1860,56,na,1916,1683.9760108045239
STAT,1913,18,35-39,1931,0.8633601981303213
SIM,1849,37,na,1886,1915
STAT,1927,30,35-39,1957,11.374922080443595
SIM,1866,39,35-39,1905,15
STAT,1949,15,35-39,1964,4.932946035066944
SIM,1881,28,20-24,1909,11
SIM,1919,29,25-29,1948,92
STAT,1878,35,20-24,1913,0.8158757697302863
SIM,1844,42,40-44,1886,3
SIM,1874,39,50-100,1913,1
STAT,1922,23,50-100,1945,0.7599348579935027
SIM,1803,77,na,1880,323
SIM,1868,19,na,1887,2364
SIM,1914,28,45-49,1942,4
STAT,1907,43,50-100,1950,0.1080267994801614
SIM,1881,26,30-34,1907,22
SIM,1890,36,25-29,1926,4
SIM,1908,48,50-100,1956,2
STAT,1894,47,50-100,1941,0.17930711607473046
STAT,1828,43,45-49,1871,1.4050448345148392
STAT,1865,17,30-34,1882,1.514762522441955
STAT,1830,109,na,1939,4.6937833630139093E-4
STAT,1862,32,50-100,1894,0.7991679739069341
STAT,1867,99,na,1966,8.26619377617885
SIM,1954,17,25-29,1971,88
STAT,1931,15,na,1946,4891.676479486849
STAT,1882,40,50-100,1922,1.0440062997118318
STAT,1906,37,25-29,1943,0.9142163984881916
STAT,1872,41,na,1913,2357.5002083435716
SIM,1933,34,40-44,1967,3
STAT,1893,25,45-49,1918,1.4335589735564382
STAT,1856,34,30-34,1890,13.404115137154868
SIM,1926,1,na,1927,5045
STAT,1896,54,na,1950,2799.53223016823
SIM,1839,75,na,1914,589
SIM,1858,34,30-34,1892,31
STAT,1879,32,45-49,1911,1.8379882818603221
STAT,1954,1,na,1955,4917.864105595489
STAT,1832,45,25-29,1877,0.04771719827644536
STAT,1882,36,25-29,1918,2.830413231657013
SIM,1905,23,25-29,1928,90
STAT,1931,32,15-19,1963,0.1701763293611181
SIM,1859,15,na,1874,2497
SIM,1873,17,30-34,1890,3
SIM,1828,27,20-24,1855,12
SIM,1784,84,na,1868,65
SIM,1859,40,35-39,1899,3
STAT,1812,44,45-49,1856,3.6068071460118425
STAT,1815,107,na,1922,0.002041434464103158
STAT,1849,44,40-44,1893,1.734864987894484
SIM,1895,18,20-24,1913,27
SIM,1858,28,45-49,1886,1
STAT,1950,1,na,1951,4878.39278440415
SIM,1937,17,25-29,1954,53
STAT,1840,48,50-100,1888,0.17140212659758455
STAT,1929,17,25-29,1946,55.89882870743714
STAT,1932,24,30-34,1956,37.978913004387394
SIM,1866,37,45-49,1903,1
SIM,1864,34,30-34,1898,36
SIM,1798,82,na,1880,93
SIM,1935,30,35-39,1965,15
STAT,1887,18,20-24,1905,19.93912884998682
STAT,1926,18,45-49,1944,0.6173712824135946
STAT,1846,30,40-44,1876,3.970836082712049
SIM,1820,44,45-49,1864,1
STAT,1902,17,20-24,1919,25.303224720255564
SIM,1914,37,25-29,1951,2
SIM,1892,20,25-29,1912,122
STAT,1866,31,20-24,1897,2.5383195420912363
STAT,1785,97,na,1882,0.9614590927755566
STAT,1940,17,40-44,1957,1.4337384492548628
SIM,1929,32,25-29,1961,17
STAT,1879,16,50-100,1895,0.051764253900592125
STAT,1893,16,30-34,1909,2.049064493822813
STAT,1817,42,30-34,1859,2.812604699530955
STAT,1892,31,15-19,1923,0.181222096010534
STAT,1921,17,30-34,1938,14.032264994750877
STAT,1874,51,25-29,1925,0.003680639466416229
SIM,1910,17,20-24,1927,22
STAT,1764,98,na,1862,0.2958859581451704
STAT,1916,48,na,1964,3792.1084173207037
STAT,1926,25,50-100,1951,1.2140980678338082
STAT,1928,11,na,1939,5053.835590223845
STAT,1945,26,30-34,1971,43.43216849057917
STAT,1842,47,35-39,1889,0.12606792513165357
SIM,1848,89,na,1937,87
STAT,1906,28,45-49,1934,1.6276213217197046
STAT,1884,27,45-49,1911,1.1058563610876297
STAT,1876,18,45-49,1894,0.06794263593542443
STAT,1836,49,25-29,1885,0.03706505699323279
STAT,1927,17,15-19,1944,57.03502789160654
STAT,1873,22,15-19,1895,3.3779022726204087
SIM,1862,19,na,1881,2321
SIM,1895,31,40-44,1926,9
STAT,1863,27,25-29,1890,37.85510867836669
STAT,1827,38,na,1865,1651.8199454684482
SIM,1815,62,na,1877,963
STAT,1856,39,25-29,1895,2.207056680312286
SIM,1860,24,45-49,1884,4
STAT,1880,60,na,1940,2022.9654992530286
STAT,1912,39,25-29,1951,0.9597835642028141
STAT,1852,15,30-34,1867,1.4793462553040218
STAT,1910,16,na,1926,3870.597178848218
STAT,1835,57,na,1892,1508.324105744556
SIM,1848,6,na,1854,2336
STAT,1884,20,25-29,1904,57.35653507713484
SIM,1938,28,30-34,1966,63
SIM,1854,17,20-24,1871,29
STAT,1842,40,15-19,1882,0.013197646298805933
STAT,1887,31,40-44,1918,4.910265567561875
SIM,1876,31,30-34,1907,32
SIM,1935,17,15-19,1952,84
SIM,1931,30,50-100,1961,2
STAT,1946,17,25-29,1963,48.54549630476281
SIM,1835,39,na,1874,1561
STAT,1865,93,na,1958,39.594896526828215
STAT,1915,9,na,1924,4190.411827192285
SIM,1839,28,35-39,1867,13
SIM,1949,22,25-29,1971,4
SIM,1809,72,na,1881,505
STAT,1869,44,45-49,1913,1.4498011680256675
STAT,1857,51,25-29,1908,0.0028053300980592265
STAT,1929,38,40-44,1967,1.9405681685732363
SIM,1849,23,25-29,1872,52
STAT,1836,42,40-44,1878,1.6880102368188912
SIM,1871,27,25-29,1898,47
SIM,1919,15,15-19,1934,8
STAT,1837,26,45-49,1863,0.9792372900897833
STAT,1848,37,na,1885,1982.263797212687
STAT,1892,16,50-100,1908,0.062243784727410226
STAT,1818,37,50-100,1855,3.101673236099835
STAT,1898,19,35-39,1917,0.7472683161683881
SIM,1923,33,na,1956,4456
STAT,1841,35,25-29,1876,2.5900149287987366
SIM,1942,9,na,1951,4409
STAT,1864,48,25-29,1912,0.051836288010864484
STAT,1839,23,na,1862,1933.7344449830782
SIM,1923,17,30-34,1940,20
STAT,1906,34,30-34,1940,14.622087620262322
STAT,1924,29,40-44,1953,5.444849858298572
SIM,1903,26,50-100,1929,1
SIM,1842,42,na,1884,1730
STAT,1871,29,25-29,1900,42.14289831414555
STAT,1865,50,20-24,1915,6.903303811259876E-4
STAT,1881,23,na,1904,2295.4148107025594
SIM,1868,36,40-44,1904,3
STAT,1776,83,na,1859,109.19436416661858
SIM,1858,43,50-100,1901,3
STAT,1874,85,na,1959,388.16105806374827
SIM,1908,28,45-49,1936,4
STAT,1884,37,na,1921,2346.5414865785865
SIM,1933,26,na,1959,4680
SIM,1870,86,na,1956,216
STAT,1832,27,20-24,1859,10.775152542458342
STAT,1835,24,45-49,1859,0.6860173570312701
SIM,1835,24,na,1859,1646
STAT,1837,40,40-44,1877,1.8577005405506002
STAT,1883,45,30-34,1928,0.09662817740262554
SIM,1886,27,45-49,1913,1
SIM,1818,54,na,1872,1169
STAT,1900,16,25-29,1916,7.970009742160533
SIM,1885,39,45-49,1924,5
STAT,1816,54,30-34,1870,0.01420556582978969
STAT,1882,53,25-29,1935,0.0034096802649180914
SIM,1937,34,25-29,1971,14
STAT,1850,18,25-29,1868,5.27107100605654
STAT,1877,39,45-49,1916,2.0571423081626934
STAT,1932,15,40-44,1947,1.8803970981278757
SIM,1837,68,na,1905,912
STAT,1817,38,35-39,1855,23.505142468043136
SIM,1789,83,na,1872,94
SIM,1940,15,40-44,1955,2
SIM,1867,24,30-34,1891,18
STAT,1927,38,30-34,1965,2.288039502405363
SIM,1897,18,30-34,1915,3
SIM,1936,26,30-34,1962,10
STAT,1914,52,na,1966,3614.254362191172
STAT,1940,22,15-19,1962,5.4745053519498645
STAT,1855,31,45-49,1886,1.3504593617080587
STAT,1905,25,15-19,1930,0.6669438113241635
STAT,1897,38,35-39,1935,9.529648890850721
STAT,1951,15,50-100,1966,0.450994044650481
SIM,1914,34,30-34,1948,5
SIM,1837,17,20-24,1854,14
SIM,1824,61,na,1885,1112
STAT,1876,22,40-44,1898,2.173085339956358
SIM,1851,23,40-44,1874,2
STAT,1825,40,15-19,1865,0.02073533701009025
STAT,1916,47,45-49,1963,0.2249637132888737
SIM,1939,1,na,1940,4209
STAT,1832,49,40-44,1881,0.12260928413902533
STAT,1837,37,25-29,1874,2.391484752639128
STAT,1861,49,50-100,1910,0.20182341786131341
STAT,1834,36,45-49,1870,1.492151581040891
SIM,1871,48,50-100,1919,2
STAT,1933,32,25-29,1965,12.586608963862103
SIM,1863,31,45-49,1894,2
STAT,1823,44,20-24,1867,0.2238872104970169
SIM,1872,39,35-39,1911,7
STAT,1911,29,30-34,1940,38.27520953276779
STAT,1860,26,45-49,1886,0.9332183567660542
STAT,1854,32,50-100,1886,0.7041746099914558
STAT,1886,70,na,1956,1526.2134887497289
STAT,1937,16,20-24,1953,133.47833179004064
STAT,1765,101,na,1866,0.10872710217952197
STAT,1884,29,35-39,1913,9.541598007198692
SIM,1931,37,35-39,1968,2
SIM,1871,6,na,1877,2653
STAT,1845,36,20-24,1881,0.5979771730161721
STAT,1879,47,30-34,1926,0.10155152698666353
STAT,1820,50,50-100,1870,0.025654876669820435
STAT,1931,36,30-34,1967,2.441684950549454
STAT,1768,114,na,1882,5.345151982028902E-4
STAT,1890,35,20-24,1925,0.9603866020484497
STAT,1923,37,35-39,1960,2.831687531539991
SIM,1945,16,20-24,1961,155
STAT,1858,43,30-34,1901,0.9044009543183915
STAT,1863,48,50-100,1911,0.21702332128182095
STAT,1847,32,15-19,1879,0.12519239052664335
SIM,1867,34,na,1901,2100
STAT,1896,22,na,1918,3161.8836244970607
SIM,1862,19,20-24,1881,22
SIM,1849,75,na,1924,846
STAT,1854,19,20-24,1873,15.729045596470717
SIM,1902,49,na,1951,3304
SIM,1907,44,40-44,1951,3
SIM,1840,27,20-24,1867,12
SIM,1888,35,30-34,1923,7
SIM,1880,20,40-44,1900,2
SIM,1919,33,na,1952,4058
STAT,1906,25,40-44,1931,4.436681551585666
STAT,1885,48,na,1933,2233.4295846840855
STAT,1832,44,50-100,1876,0.8601851773796735
STAT,1834,28,50-100,1862,0.4959708922290926
SIM,1918,34,50-100,1952,1
STAT,1843,23,40-44,1866,1.7514758377921191
STAT,1863,30,40-44,1893,3.9120783100372347
SIM,1892,29,35-39,1921,21
STAT,1908,21,35-39,1929,8.764598933584642
SIM,1849,20,30-34,1869,21
SIM,1845,37,25-29,1882,4
SIM,1851,94,na,1945,11
SIM,1864,42,na,1906,2506
STAT,1901,40,40-44,1941,0.22338037465331245
STAT,1902,67,na,1969,2596.0043719874725
SIM,1932,15,na,1947,5585
SIM,1929,36,40-44,1965,7
STAT,1877,43,40-44,1920,2.327760014033687
SIM,1834,25,30-34,1859,31
SIM,1909,31,45-49,1940,1
SIM,1885,43,40-44,1928,6
SIM,1894,20,35-39,1914,9
STAT,1854,50,45-49,1904,0.011047885323964795
SIM,1844,42,50-100,1886,1
STAT,1878,27,45-49,1905,1.1641026069850346
STAT,1932,27,25-29,1959,87.12285228363277
STAT,1881,52,20-24,1933,7.145883440887673E-4
STAT,1908,48,15-19,1956,3.35359531703153E-4
STAT,1928,38,15-19,1966,0.024505433324348774
SIM,1838,90,na,1928,24
STAT,1937,10,na,1947,3903.2038533783034
SIM,1843,53,na,1896,1960
SIM,1875,26,30-34,1901,28
STAT,1926,16,45-49,1942,0.6205133017787285
SIM,1876,33,50-100,1909,1
STAT,1862,21,35-39,1883,5.248077507735897
STAT,1858,15,na,1873,2149.942536001304
SIM,1907,48,na,1955,3508
SIM,1870,21,35-39,1891,12
STAT,1841,42,na,1883,1796.001783181094
STAT,1854,30,40-44,1884,3.4028962101856135
STAT,1844,30,30-34,1874,16.865705724526016
STAT,1886,20,35-39,1906,6.260044551224073
SIM,1825,38,35-39,1863,12
SIM,1881,60,na,1941,1756
STAT,1867,22,15-19,1889,3.1510316487680843
STAT,1838,46,30-34,1884,0.06752605310244303
SIM,1862,32,50-100,1894,1
SIM,1914,34,na,1948,3995
STAT,1815,45,25-29,1860,0.13216136070011567
SIM,1836,29,20-24,1865,9
STAT,1950,19,40-44,1969,1.6697967457235663
STAT,1915,17,30-34,1932,2.5741479151364786
STAT,1873,28,20-24,1901,11.969663195093387
STAT,1876,25,45-49,1901,1.1657271571131704
SIM,1889,18,na,1907,3119
STAT,1908,38,20-24,1946,0.24790793368896988
SIM,1875,22,15-19,1897,2
SIM,1880,5,na,1885,2639
STAT,1871,26,20-24,1897,11.81201933387253
SIM,1837,41,45-49,1878,1
STAT,1905,46,30-34,1951,0.07995239350113126
STAT,1834,45,35-39,1879,0.09968971256329003
SIM,1897,69,na,1966,2187
STAT,1889,18,30-34,1907,1.9797950624610414
STAT,1936,24,15-19,1960,5.1344286952974985
SIM,1903,27,30-34,1930,65
STAT,1856,43,20-24,1899,0.12208792382554079
SIM,1918,23,35-39,1941,14
STAT,1836,38,45-49,1874,1.527662597210623
SIM,1904,18,25-29,1922,10
SIM,1862,30,40-44,1892,5
STAT,1948,17,35-39,1965,4.851022465236872
SIM,1852,30,30-34,1882,27
STAT,1828,29,20-24,1857,16.29007992364499
SIM,1823,39,na,1862,1629
SIM,1905,20,50-100,1925,6
SIM,1819,36,45-49,1855,1
STAT,1888,33,15-19,1921,0.16904943970143918
SIM,1859,20,15-19,1879,4
STAT,1856,37,35-39,1893,5.476890275433169
STAT,1931,19,30-34,1950,16.037364212076703
STAT,1914,32,15-19,1946,0.13051007539100273
SIM,1868,20,40-44,1888,2
STAT,1836,42,50-100,1878,0.792833661812112
SIM,1841,94,na,1935,10
STAT,1879,84,na,1963,575.1820616250557
STAT,1896,32,45-49,1928,2.331352860815807
STAT,1866,56,na,1922,1907.5321666939492
STAT,1829,41,45-49,1870,1.179683051029189
STAT,1858,36,30-34,1894,4.243411871057901
STAT,1885,5,na,1890,2634.6267646389133
SIM,1832,23,30-34,1855,17
SIM,1944,24,15-19,1968,6
SIM,1908,12,na,1920,3782
STAT,1811,76,na,1887,405.00793190394387
STAT,1921,48,30-34,1969,0.10121601241595499
STAT,1840,47,25-29,1887,0.04071686981781509
STAT,1931,15,15-19,1946,60.313776088360754
STAT,1880,16,45-49,1896,0.06945843986913897
STAT,1795,75,na,1870,477.13556871781134
STAT,1849,47,45-49,1896,0.1836570538652529
STAT,1802,62,na,1864,906.2124298746085
STAT,1892,8,na,1900,3294.6107994546646
SIM,1845,23,40-44,1868,3
SIM,1942,17,40-44,1959,3
STAT,1878,38,25-29,1916,3.003735228868428
SIM,1869,41,40-44,1910,2
STAT,1866,41,15-19,1907,0.01297384159647201
STAT,1889,0,na,1889,3593.170141508859
SIM,1831,38,35-39,1869,12
SIM,1886,48,na,1934,2485
STAT,1922,27,40-44,1949,5.328213991246935
STAT,1819,35,40-44,1854,15.486561541658663
STAT,1823,61,na,1884,1096.5389361918888
STAT,1819,44,50-100,1863,2.1239999009814565
STAT,1905,29,30-34,1934,36.505218389502915
SIM,1919,26,20-24,1945,19
STAT,1911,17,50-100,1928,0.07563786058210928
STAT,1839,36,20-24,1875,0.6599042240590202
STAT,1843,39,15-19,1882,0.039408727298727304
STAT,1854,7,na,1861,2222.0723118209353
STAT,1764,101,na,1865,0.06948987557117602
SIM,1884,25,45-49,1909,3
SIM,1884,19,na,1903,2505
STAT,1871,89,na,1960,176.25526030395616
STAT,1893,23,50-100,1916,0.5213513655775736
STAT,1909,27,50-100,1936,0.9599039302329774
SIM,1851,72,na,1923,1048
SIM,1940,27,25-29,1967,86
STAT,1823,38,35-39,1861,11.781044619480076
SIM,1858,32,40-44,1890,4
STAT,1792,100,na,1892,0.1908498142149015
SIM,1875,85,na,1960,287
STAT,1864,45,20-24,1909,0.011045680188409809
SIM,1866,34,40-44,1900,3
STAT,1798,101,na,1899,0.18986201094659733
SIM,1862,1,na,1863,3119
STAT,1865,42,50-100,1907,0.9731195481902598
STAT,1926,15,40-44,1941,1.741233556635292
STAT,1860,32,30-34,1892,14.415206368876333
STAT,1830,25,20-24,1855,14.66583430579815
STAT,1856,56,na,1912,1579.382968587369
STAT,1930,18,35-39,1948,5.4687716621325
STAT,1867,1,na,1868,3392.3108031291504
SIM,1913,29,30-34,1942,67
SIM,1873,56,na,1929,1966
STAT,1906,30,15-19,1936,0.12125978514665528
SIM,1858,37,35-39,1895,8
SIM,1869,28,20-24,1897,13
STAT,1884,50,30-34,1934,0.006013907597287614
SIM,1849,27,40-44,1876,5
SIM,1886,38,25-29,1924,4
STAT,1847,38,20-24,1885,0.5926464614241029
SIM,1936,22,15-19,1958,8
STAT,1861,40,35-39,1901,1.5351151306606765
STAT,1810,51,35-39,1861,0.03218939975606406
SIM,1930,27,40-44,1957,4
STAT,1935,19,15-19,1954,62.346740151668996
SIM,1908,59,na,1967,2993
STAT,1838,41,50-100,1879,0.8377371546751569
STAT,1913,15,30-34,1928,2.526126173484313
SIM,1832,28,25-29,1860,42
STAT,1861,16,35-39,1877,0.5324513958016092
STAT,1820,43,na,1863,1367.013164225473
STAT,1821,47,15-19,1868,5.862696387416381E-4
STAT,1851,20,20-24,1871,63.2172793622439
STAT,1813,95,na,1908,5.829546926996143
SIM,1846,41,50-100,1887,1
SIM,1870,28,45-49,1898,1
STAT,1848,6,na,1854,2525.0
SIM,1836,40,40-44,1876,6
STAT,1900,2,na,1902,3739.9506270031698
STAT,1911,25,15-19,1936,0.6992812329635458
STAT,1825,30,20-24,1855,8.636097240838955
SIM,1916,21,35-39,1937,12
SIM,1817,91,na,1908,8
STAT,1862,28,45-49,1890,0.9650200558622953
STAT,1886,26,40-44,1912,3.205410879127572
STAT,1837,23,40-44,1860,1.8476308172181528
STAT,1834,94,na,1928,11.896283285900257
STAT,1856,41,na,1897,1797.7978291167383
STAT,1866,34,na,1900,2212.6484199666397
SIM,1914,25,40-44,1939,9
STAT,1954,18,20-24,1972,169.27494721737418
STAT,1851,26,50-100,1877,0.5712281880820206
STAT,1895,31,40-44,1926,5.743345644776867
STAT,1841,52,25-29,1893,0.0026346679942744443
STAT,1919,17,15-19,1936,50.637616013137034
STAT,1876,18,na,1894,2626.9099444579656
STAT,1934,17,40-44,1951,1.9116320100340471
STAT,1870,52,45-49,1922,0.01431661899951913
STAT,1828,40,40-44,1868,2.222168789352538
STAT,1853,45,45-49,1898,0.1971121871771715
STAT,1890,29,35-39,1919,11.823218461940996
STAT,1891,19,25-29,1910,7.048118925011597
SIM,1866,30,25-29,1896,13
SIM,1850,44,30-34,1894,2
STAT,1875,46,35-39,1921,0.14562272773348758
STAT,1897,44,20-24,1941,0.014731403321356756
STAT,1849,71,na,1920,1043.617722725006
STAT,1865,26,20-24,1891,10.85653070826089
SIM,1871,49,na,1920,2091
STAT,1892,21,20-24,1913,87.60194241693047
SIM,1887,70,na,1957,1471
SIM,1891,37,50-100,1928,1
SIM,1942,28,20-24,1970,27
STAT,1825,49,50-100,1874,0.3207666691386463
SIM,1858,89,na,1947,43
STAT,1888,39,20-24,1927,0.9096892616444818
SIM,1927,39,35-39,1966,9
STAT,1906,48,na,1954,3268.769125735976
STAT,1908,27,40-44,1935,4.485644464806023
STAT,1923,15,15-19,1938,54.09466684909273
SIM,1840,21,15-19,1861,2
STAT,1854,49,na,1903,1653.2211944650019
STAT,1899,20,45-49,1919,0.9723608416763927
STAT,1859,15,40-44,1874,0.1745184671985743
STAT,1762,113,na,1875,3.17421906879784E-4
STAT,1894,46,45-49,1940,0.17359687376533386
SIM,1873,29,25-29,1902,57
SIM,1901,27,50-100,1928,1
SIM,1931,15,15-19,1946,61
SIM,1940,20,15-19,1960,5
STAT,1819,46,20-24,1865,0.023736123784094534
STAT,1904,39,40-44,1943,1.3556936942492264
STAT,1928,22,15-19,1950,6.717791980317617
SIM,1834,76,na,1910,554
STAT,1816,91,na,1907,29.62715629814698
STAT,1892,66,na,1958,2156.142576244525
STAT,1927,21,45-49,1948,1.4053990081901468
SIM,1833,49,50-100,1882,1
STAT,1863,24,20-24,1887,61.9981100181896
STAT,1886,37,20-24,1923,0.8220278573431622
STAT,1883,37,50-100,1920,1.2134657531692825
STAT,1864,39,35-39,1903,6.381292083904821
SIM,1899,33,40-44,1932,11
STAT,1910,23,40-44,1933,3.175856375867713
STAT,1919,39,35-39,1958,2.618044833103926
SIM,1923,48,na,1971,4382
STAT,1853,25,50-100,1878,0.6217311546455914
STAT,1855,93,na,1948,21.99856298939696
SIM,1916,27,40-44,1943,8
STAT,1841,26,35-39,1867,9.026947783989513
SIM,1852,57,na,1909,1460
SIM,1932,29,40-44,1961,9
SIM,1938,24,15-19,1962,6
SIM,1888,20,35-39,1908,6
STAT,1858,30,25-29,1888,8.286415350746928
STAT,1884,24,40-44,1908,2.0624704288856046
SIM,1832,80,na,1912,407
SIM,1938,25,na,1963,3622
STAT,1869,41,40-44,1910,2.2186893307699824
SIM,1830,26,25-29,1856,41
STAT,1934,28,20-24,1962,24.800176312004034
SIM,1827,35,40-44,1862,8
STAT,1848,49,50-100,1897,0.19633544402444333
SIM,1905,20,20-24,1925,147
SIM,1917,26,na,1943,3857
STAT,1834,72,na,1906,751.7110539700248
STAT,1836,31,35-39,1867,8.159561598801146
STAT,1859,20,15-19,1879,3.0998510285110035
SIM,1917,27,50-100,1944,1
STAT,1870,20,30-34,1890,17.771418471677237
STAT,1929,34,25-29,1963,11.851017233550026
SIM,1820,35,50-100,1855,3
STAT,1880,40,45-49,1920,1.6035204152183022
SIM,1870,32,40-44,1902,7
STAT,1838,60,na,1898,1276.7165704188833
SIM,1848,15,30-34,1863,4
SIM,1873,26,20-24,1899,20
SIM,1888,55,na,1943,2663
STAT,1869,48,na,1917,2181.4909429389927
STAT,1843,28,35-39,1871,7.951617038263323
STAT,1912,36,20-24,1948,0.2608251974617029
SIM,1892,24,40-44,1916,3
SIM,1844,31,35-39,1875,17
SIM,1849,53,na,1902,1647
STAT,1840,103,na,1943,0.10060225799011328
STAT,1907,42,25-29,1949,0.0660597073605437
SIM,1851,28,35-39,1879,11
STAT,1842,44,30-34,1886,1.04381722165144
STAT,1951,20,25-29,1971,111.57550538065166
SIM,1861,71,na,1932,1119
STAT,1870,23,35-39,1893,5.769676958487923
SIM,1928,38,40-44,1966,3
STAT,1831,28,30-34,1859,21.53721892507318
SIM,1870,37,20-24,1907,2
STAT,1911,32,35-39,1943,8.977636086823088
STAT,1914,33,15-19,1947,0.12995932287285267
SIM,1916,22,35-39,1938,15
STAT,1873,24,15-19,1897,3.3567560173143893
SIM,1898,64,na,1962,2571
STAT,1860,18,na,1878,2172.873768829819
STAT,1801,82,na,1883,183.86774954041763
STAT,1828,32,40-44,1860,5.084764412147901
STAT,1871,37,15-19,1908,0.056346846697474154
STAT,1849,22,30-34,1871,16.837659730308555
STAT,1833,49,45-49,1882,0.17411761420614078
STAT,1881,21,45-49,1902,0.6809378185059017
STAT,1857,41,20-24,1898,0.12574989743491952
STAT,1863,38,na,1901,2097.882494894132
STAT,1946,26,15-19,1972,0.794607190469217
SIM,1939,17,35-39,1956,4
STAT,1889,26,20-24,1915,14.660419956769227
STAT,1958,5,na,1963,5216.1135444213305
SIM,1897,26,20-24,1923,1
STAT,1923,48,40-44,1971,0.18583602818119047
STAT,1929,9,na,1938,5134.999267125454
STAT,1793,109,na,1902,1.2840737342117333E-4
SIM,1876,49,na,1925,2508
STAT,1927,42,40-44,1969,0.3170636993510493
STAT,1889,4,na,1893,3276.243240979546
SIM,1848,26,25-29,1874,5
SIM,1869,51,na,1920,2129
STAT,1838,36,15-19,1874,0.045833177804961746
SIM,1817,38,na,1855,1674
SIM,1922,47,na,1969,4749
STAT,1860,93,na,1953,24.129261176479595
STAT,1782,112,na,1894,1.2111932274807793E-4
STAT,1932,33,35-39,1965,12.269057923565084
SIM,1940,17,30-34,1957,20
STAT,1861,22,50-100,1883,0.3516071390692575
STAT,1813,44,15-19,1857,0.04329907798645176
STAT,1898,24,20-24,1922,93.76490848550027
SIM,1849,46,50-100,1895,5
SIM,1869,25,50-100,1894,5
SIM,1875,91,na,1966,98
STAT,1936,35,45-49,1971,0.6768326535856466
SIM,1862,22,40-44,1884,2
SIM,1839,53,na,1892,1411
STAT,1887,40,na,1927,2632.55825645033
SIM,1876,20,15-19,1896,4
STAT,1863,20,40-44,1883,1.9295511244769075
STAT,1920,30,35-39,1950,10.189349218185269
SIM,1859,30,40-44,1889,7
STAT,1932,17,30-34,1949,16.31053578816038
SIM,1886,79,na,1965,1114
STAT,1859,21,na,1880,1994.6170064647606
SIM,1826,74,na,1900,786
STAT,1883,52,30-34,1935,0.005852009302433252
STAT,1856,88,na,1944,106.30503448439137
STAT,1846,23,45-49,1869,0.6482552742109106
STAT,1854,40,40-44,1894,1.7050843412237948
STAT,1906,27,30-34,1933,37.04518034325617
SIM,1914,28,na,1942,3968
STAT,1905,35,15-19,1940,0.017865126403306807
STAT,1875,53,35-39,1928,0.008786094565663594
STAT,1868,20,15-19,1888,3.230744725510622
SIM,1903,40,na,1943,3169
STAT,1850,16,50-100,1866,0.046112819133839834
SIM,1833,30,20-24,1863,2
SIM,1871,20,40-44,1891,2
STAT,1839,17,na,1856,2128.8838594094827
SIM,1889,27,25-29,1916,9
STAT,1857,23,20-24,1880,62.25892937668651
STAT,1844,49,20-24,1893,0.009295978874038316
STAT,1846,41,45-49,1887,1.1643495957085424
STAT,1854,22,40-44,1876,1.8374929119148147
STAT,1950,15,25-29,1965,51.796006573127656
SIM,1822,40,50-100,1862,1
STAT,1837,25,45-49,1862,0.9863190609473859
STAT,1847,36,na,1883,1849.339781811536
SIM,1912,19,20-24,1931,32
SIM,1922,15,15-19,1937,53
SIM,1899,18,na,1917,3819
STAT,1843,22,na,1865,1810.128529590418
STAT,1851,41,na,1892,1757.9610629529961
STAT,1916,21,30-34,1937,30.48478882733319
STAT,1940,23,15-19,1963,5.4726987651837185
STAT,1906,64,na,1970,2887.3327059281514
SIM,1845,30,40-44,1875,6
SIM,1864,20,na,1884,2513
SIM,1953,15,na,1968,4598
STAT,1839,72,na,1911,895.3582263205211
SIM,1793,82,na,1875,170
SIM,1906,32,20-24,1938,2
SIM,1905,38,45-49,1943,3
SIM,1865,23,20-24,1888,80
STAT,1880,35,15-19,1915,0.0601294171269876
STAT,1904,19,20-24,1923,25.558264052823024
STAT,1914,15,15-19,1929,9.515867946761453
STAT,1937,28,15-19,1965,0.6943913348345881
SIM,1907,24,35-39,1931,9
STAT,1850,46,40-44,1896,0.13146239454994238
STAT,1899,16,35-39,1915,0.7624622308940933
STAT,1900,48,45-49,1948,0.18442714985168981
STAT,1927,10,na,1937,4994.618944031394
SIM,1854,41,45-49,1895,3
STAT,1945,23,50-100,1968,0.7280519914349107
SIM,1930,19,40-44,1949,6
STAT,1833,54,40-44,1887,0.007405267920023685
STAT,1874,17,50-100,1891,0.050666891054677345
STAT,1887,24,45-49,1911,0.781409271677305
SIM,1857,22,30-34,1879,3
STAT,1822,44,na,1866,1502.759200667559
SIM,1843,58,na,1901,1799
SIM,1895,24,45-49,1919,1
STAT,1922,37,40-44,1959,1.7208066045336203
SIM,1893,17,na,1910,3310
STAT,1901,17,na,1918,3575.8982282639076
SIM,1874,31,20-24,1905,2
SIM,1940,24,20-24,1964,166
STAT,1914,42,30-34,1956,0.12781367458334628
SIM,1873,18,30-34,1891,5
SIM,1948,22,50-100,1970,1
SIM,1924,21,30-34,1945,47
STAT,1866,0,na,1866,3549.635522148917
SIM,1858,20,na,1878,1952
STAT,1922,19,40-44,1941,1.626542960019489
STAT,1913,46,na,1959,3626.927146524791
STAT,1865,18,30-34,1883,1.5058405711847715
STAT,1915,49,45-49,1964,0.2196914111021481
SIM,1880,54,na,1934,1938
STAT,1837,30,40-44,1867,3.7872704858561397
SIM,1855,87,na,1942,164
SIM,1899,21,25-29,1920,104
SIM,1856,0,na,1856,3463
SIM,1789,77,na,1866,299
SIM,1884,68,na,1952,1563
STAT,1872,29,30-34,1901,25.3874717615454
SIM,1819,92,na,1911,9
STAT,1894,48,20-24,1942,0.008691372538239435
STAT,1942,27,na,1969,3969.777462989235
STAT,1798,61,na,1859,1107.1909148581872
STAT,1868,85,na,1953,264.6194634041848
STAT,1932,24,20-24,1956,146.93352849032195
SIM,1925,1,na,1926,5059
STAT,1923,3,na,1926,4812.2721441744425
SIM,1905,30,50-100,1935,1
SIM,1898,23,30-34,1921,31
SIM,1877,33,40-44,1910,7
STAT,1860,52,35-39,1912,0.0070700290709784135
STAT,1945,15,15-19,1960,50.092919429509806
SIM,1880,29,30-34,1909,32
SIM,1886,41,40-44,1927,5
STAT,1924,25,25-29,1949,77.96754357271027
SIM,1821,75,na,1896,500
STAT,1880,15,45-49,1895,0.06961019008352104
SIM,1927,43,45-49,1970,1
STAT,1866,48,45-49,1914,0.2179415968059906
STAT,1839,28,30-34,1867,22.329642142266156
STAT,1889,19,30-34,1908,1.974350626039273
STAT,1891,7,na,1898,3257.9410838845965
STAT,1866,50,na,1916,2042.6504547655252
STAT,1898,5,na,1903,3588.201235178411
STAT,1904,24,45-49,1928,1.0043837736134316
SIM,1900,9,na,1909,3826
STAT,1863,15,45-49,1878,0.06749707178918667
SIM,1842,80,na,1922,305
STAT,1842,51,30-34,1893,0.005384929247463447
SIM,1829,39,na,1868,1785
STAT,1895,41,40-44,1936,0.2069467662263259
STAT,1841,27,na,1868,2009.2925884093715
STAT,1865,25,20-24,1890,10.892803744730841
SIM,1832,74,na,1906,777
SIM,1847,28,30-34,1875,24
SIM,1873,72,na,1945,1135
SIM,1912,24,45-49,1936,2
SIM,1904,17,20-24,1921,26
STAT,1854,105,na,1959,0.048803322862520274
STAT,1869,33,40-44,1902,4.2405048169520105
SIM,1953,15,15-19,1968,54
STAT,1922,41,25-29,1963,0.08292146012518443
STAT,1936,21,50-100,1957,0.6353051365103157
SIM,1852,33,35-39,1885,17
STAT,1878,41,40-44,1919,2.3689345743489603
STAT,1914,38,45-49,1952,0.6833381912801368
SIM,1830,48,50-100,1878,1
SIM,1799,83,na,1882,169
STAT,1816,44,na,1860,1561.522708279335
STAT,1869,18,15-19,1887,5.873379521873889
SIM,1929,38,30-34,1967,1
SIM,1877,86,na,1963,480
STAT,1887,42,45-49,1929,1.6856024212605838
STAT,1872,19,na,1891,2550.800042659046
STAT,1874,18,25-29,1892,5.845117145922914
STAT,1821,39,25-29,1860,5.024968540607937
SIM,1936,15,15-19,1951,53
STAT,1788,95,na,1883,2.4358559046955865
SIM,1846,23,na,1869,1870
STAT,1778,102,na,1880,0.09220825940350366
SIM,1935,22,50-100,1957,6
STAT,1848,25,20-24,1873,11.600597962269761
SIM,1952,9,na,1961,4781
SIM,1869,67,na,1936,1516
STAT,1877,20,40-44,1897,2.1851715721286986
SIM,1873,25,na,1898,2332
SIM,1896,69,na,1965,2150
STAT,1919,43,45-49,1962,0.18181457224300815
STAT,1928,15,15-19,1943,58.06821946697962
STAT,1844,33,35-39,1877,9.482485038903368
STAT,1881,55,na,1936,2013.0545030049882
SIM,1820,89,na,1909,36
STAT,1830,36,15-19,1866,0.05177593737557045
STAT,1840,20,45-49,1860,0.6306493473103866
STAT,1940,28,45-49,1968,1.7776705356922706
SIM,1823,38,na,1861,1631
STAT,1874,23,20-24,1897,71.0483640365149
STAT,1905,9,na,1914,3788.4149619143686
SIM,1869,34,45-49,1903,4
SIM,1911,30,35-39,1941,12
STAT,1891,47,40-44,1938,0.12019701169223604
SIM,1921,22,45-49,1943,4
STAT,1858,15,35-39,1873,0.5139284600238617
SIM,1877,18,15-19,1895,8
SIM,1878,42,45-49,1920,6
STAT,1881,30,50-100,1911,0.899195244499921
STAT,1765,98,na,1863,0.46295697812531367
STAT,1874,47,40-44,1921,0.1762278266276039
SIM,1941,14,na,1955,4239
STAT,1919,25,15-19,1944,0.7753829696658435
STAT,1846,54,50-100,1900,0.011146071521491673
SIM,1907,7,na,1914,4097
STAT,1875,15,35-39,1890,0.5717749825428188
SIM,1939,32,30-34,1971,30
STAT,1923,35,35-39,1958,2.836592720280589
SIM,1856,25,20-24,1881,11
SIM,1931,35,35-39,1966,6
STAT,1913,43,25-29,1956,0.0701505713756311
STAT,1828,50,40-44,1878,0.009635910628135548
STAT,1903,49,25-29,1952,0.04575996088769006
SIM,1867,72,na,1939,1050
STAT,1913,22,45-49,1935,1.1000749416971967
STAT,1954,12,na,1966,4906.122627868656
SIM,1919,9,na,1928,4373
STAT,1850,44,50-100,1894,0.7980206370894728
SIM,1884,4,na,1888,2699
STAT,1890,32,na,1922,2945.0916246069573
SIM,1883,15,35-39,1898,1
STAT,1923,40,30-34,1963,0.15139693614987473
STAT,1839,35,20-24,1874,0.6667921873543912
STAT,1786,76,na,1862,378.9355189807961
SIM,1885,35,50-100,1920,4
SIM,1897,19,30-34,1916,3
STAT,1859,32,40-44,1891,3.5228690942289544
STAT,1870,24,na,1894,2330.9433648317
STAT,1895,46,15-19,1941,2.984467705355549E-4
SIM,1905,51,na,1956,3312
SIM,1932,25,25-29,1957,149
SIM,1837,58,na,1895,1247
STAT,1920,49,25-29,1969,0.05886654236029421
SIM,1909,13,na,1922,4237
SIM,1838,75,na,1913,715
STAT,1875,55,na,1930,2144.668667507754
STAT,1831,30,45-49,1861,1.4780767366706187
STAT,1923,28,45-49,1951,1.9970402831238745
SIM,1836,32,40-44,1868,5
STAT,1834,52,35-39,1886,0.005257076433031128
SIM,1867,32,40-44,1899,8
STAT,1859,92,na,1951,33.83330056206066
SIM,1869,54,50-100,1923,2
STAT,1794,95,na,1889,2.7276943322360165
STAT,1908,22,35-39,1930,8.738217490794558
STAT,1930,22,45-49,1952,1.4568793080708085
SIM,1852,35,na,1887,1791
STAT,1895,23,40-44,1918,2.739974772070106
STAT,1866,19,na,1885,2395.95535192205
STAT,1850,63,na,1913,1366.266413394583
STAT,1864,26,15-19,1890,0.41491769458999306
SIM,1901,27,20-24,1928,27
STAT,1900,38,45-49,1938,0.6006885908662619
SIM,1917,32,na,1949,3847
SIM,1857,66,na,1923,1420
SIM,1836,46,50-100,1882,4
SIM,1889,71,na,1960,1636
SIM,1927,25,15-19,1952,1
SIM,1884,48,50-100,1932,2
STAT,1807,71,na,1878,622.5984381820717
STAT,1870,23,50-100,1893,0.4031920079517872
SIM,1845,40,40-44,1885,5
STAT,1864,108,na,1972,0.03234905405998932
SIM,1853,52,na,1905,1608
STAT,1882,48,30-34,1930,0.09351408493381325
STAT,1856,29,na,1885,1887.546369255341
STAT,1914,29,30-34,1943,39.56852565894877
STAT,1910,27,20-24,1937,17.783934117284243
STAT,1889,29,25-29,1918,52.30541620509193
STAT,1875,50,30-34,1925,0.006262812669665335
STAT,1853,23,35-39,1876,5.660952275966083
SIM,1840,23,15-19,1863,3
SIM,1923,33,35-39,1956,2
STAT,1917,46,15-19,1963,3.8934374415565106E-4
STAT,1837,52,50-100,1889,0.010340740317769461
STAT,1929,26,15-19,1955,0.8934135793814398
SIM,1914,32,50-100,1946,1
STAT,1904,32,45-49,1936,1.4513070517010873
STAT,1845,47,15-19,1892,2.909115745010179E-4
STAT,1949,23,35-39,1972,11.096286239657951
SIM,1888,29,30-34,1917,50
STAT,1931,27,40-44,1958,6.081693868219897
SIM,1818,55,na,1873,1134
SIM,1912,32,45-49,1944,1
STAT,1849,25,35-39,1874,9.07256911238889
STAT,1883,31,20-24,1914,2.68254372986406
SIM,1902,32,35-39,1934,26
STAT,1797,102,na,1899,0.07319799182222043
SIM,1902,1,na,1903,4046
STAT,1921,44,15-19,1965,0.0017411225725123623
SIM,1858,48,50-100,1906,1
STAT,1885,23,50-100,1908,0.40870028373783
STAT,1816,40,20-24,1856,0.4916257591743212
SIM,1861,23,35-39,1884,5
STAT,1828,35,45-49,1863,2.1456884069872326
STAT,1905,19,40-44,1924,0.265623966403314
SIM,1853,80,na,1933,371
STAT,1907,31,30-34,1938,14.930676473361913
STAT,1906,40,30-34,1946,0.118631090794031
STAT,1892,67,na,1959,2114.9602530382545
STAT,1840,49,50-100,1889,0.1692201775259972
SIM,1903,34,45-49,1937,3
STAT,1824,52,50-100,1876,0.017035712332587483
SIM,1924,24,35-39,1948,15
STAT,1868,14,na,1882,2554.7768348984573
STAT,1845,72,na,1917,922.7796825214749
STAT,1855,36,15-19,1891,0.04247215071197005
STAT,1854,43,45-49,1897,1.1150945368715284
STAT,1881,19,30-34,1900,1.5434145910226953
STAT,1836,47,20-24,1883,0.007922305294033245
STAT,1915,33,35-39,1948,9.351709498781316
STAT,1833,56,na,1889,1450.2447083963766
STAT,1873,84,na,1957,398.18412184029546
STAT,1870,4,na,1874,2932.6450588376892
STAT,1887,16,45-49,1903,0.07384156983327446
SIM,1881,7,na,1888,2326
STAT,1833,46,40-44,1879,0.14423976318776358
STAT,1878,23,40-44,1901,2.1780283524547763
STAT,1930,40,20-24,1970,0.02355094466718732
SIM,1920,31,40-44,1951,9
SIM,1915,31,30-34,1946,23
SIM,1886,23,40-44,1909,2
STAT,1830,36,50-100,1866,1.1320101240897282
STAT,1913,25,25-29,1938,66.62076974791981
SIM,1919,28,20-24,1947,18
SIM,1893,5,na,1898,3439
STAT,1824,79,na,1903,347.5607473315967
STAT,1860,28,50-100,1888,0.5299732259424873
SIM,1950,8,na,1958,4537
STAT,1892,38,45-49,1930,2.513972104988024
SIM,1817,42,na,1859,1632
STAT,1842,44,40-44,1886,2.042182945279748
SIM,1841,95,na,1936,5
SIM,1894,34,na,1928,3412
SIM,1921,25,25-29,1946,90
STAT,1955,16,15-19,1971,60.882166779510236
STAT,1910,53,na,1963,3384.630884900048
SIM,1850,44,40-44,1894,9
STAT,1868,69,na,1937,1416.6062359144535
STAT,1864,55,na,1919,1884.487625670511
SIM,1892,9,na,1901,3572
STAT,1825,47,45-49,1872,0.31688880624715954
STAT,1877,48,20-24,1925,0.012351903272444212
SIM,1856,28,25-29,1884,47
SIM,1931,32,30-34,1963,6
STAT,1854,18,na,1872,2048.62066152036
SIM,1834,38,na,1872,1853
STAT,1902,42,35-39,1944,0.179252172510462
STAT,1874,15,20-24,1889,18.488590709649863
SIM,1941,30,na,1971,4139
STAT,1916,24,35-39,1940,9.894724098678351
STAT,1933,21,30-34,1954,38.64101453200127
STAT,1852,51,50-100,1903,0.011508605695822174
STAT,1773,97,na,1870,0.964574730332403
SIM,1849,30,25-29,1879,20
SIM,1904,22,45-49,1926,1
STAT,1827,33,35-39,1860,13.070305582643657
STAT,1830,29,25-29,1859,42.54941976105397
SIM,1900,48,na,1948,3232
SIM,1930,14,na,1944,5487
SIM,1871,77,na,1948,706
SIM,1891,31,20-24,1922,4
SIM,1941,21,30-34,1962,49
SIM,1888,36,20-24,1924,1
SIM,1907,21,30-34,1928,61
SIM,1913,27,40-44,1940,8
STAT,1848,18,30-34,1866,1.6036872983942019
STAT,1815,90,na,1905,34.12837759433254
SIM,1830,24,na,1854,1688
SIM,1882,49,na,1931,1975
STAT,1894,24,35-39,1918,7.540578412675193
STAT,1939,33,20-24,1972,2.5108878358307254
STAT,1827,91,na,1918,34.45917415957318
STAT,1918,45,na,1963,3965.4841337956873
SIM,1936,33,45-49,1969,1
SIM,1805,57,na,1862,999
STAT,1905,45,40-44,1950,0.14240881264320024
STAT,1816,54,40-44,1870,0.025123893239190703
SIM,1885,20,40-44,1905,3
STAT,1880,38,na,1918,2486.614626007791
STAT,1822,38,30-34,1860,9.502692438370739
STAT,1829,46,15-19,1875,3.023389826263199E-4
SIM,1829,38,50-100,1867,2
SIM,1835,23,na,1858,1662
SIM,1835,33,35-39,1868,14
STAT,1925,15,50-100,1940,0.45951179782172996
SIM,1899,46,50-100,1945,3
STAT,1835,105,na,1940,0.022006564844129023
SIM,1849,15,35-39,1864,1
STAT,1841,47,30-34,1888,0.0727166133350328
STAT,1941,23,35-39,1964,9.820714484518254
SIM,1862,25,45-49,1887,1
SIM,1875,20,na,1895,2335
STAT,1870,39,20-24,1909,0.7568243207528517
SIM,1921,18,35-39,1939,10
SIM,1857,25,35-39,1882,12
SIM,1787,82,na,1869,120
STAT,1897,66,na,1963,2418.022161136928
STAT,1885,85,na,1970,592.3251922395352
STAT,1928,33,45-49,1961,1.9875285832477843
SIM,1918,27,15-19,1945,1
STAT,1845,41,na,1886,1741.901204248664
STAT,1883,45,40-44,1928,0.1708961150896363
STAT,1854,25,45-49,1879,0.9738642389239798
STAT,1819,104,na,1923,0.033907827583706286
STAT,1911,48,20-24,1959,0.010525668880889173
STAT,1832,23,15-19,1855,3.3197711594257995
SIM,1868,32,35-39,1900,18
STAT,1888,27,15-19,1915,0.5408640977964206
STAT,1893,52,na,1945,2746.6869504712627
STAT,1886,48,15-19,1934,4.211971393919615E-4
SIM,1905,35,40-44,1940,1
SIM,1837,39,30-34,1876,1
SIM,1864,52,na,1916,2386
STAT,1821,36,20-24,1857,1.6039051269957425
STAT,1900,22,35-39,1922,8.187243625750755
STAT,1835,48,50-100,1883,0.19190279061286986
STAT,1875,23,na,1898,2445.4897848510086
STAT,1896,37,15-19,1933,0.07507422420288906
SIM,1921,29,40-44,1950,5
STAT,1825,54,35-39,1879,0.01070604063071068
STAT,1921,24,45-49,1945,1.2755114591617585
STAT,1875,28,50-100,1903,0.6611646109136786
STAT,1844,21,40-44,1865,2.0733669911969486
SIM,1860,4,na,1864,2577
STAT,1904,53,na,1957,3108.761856635669
STAT,1922,17,15-19,1939,53.060058030286115
STAT,1914,25,15-19,1939,0.7229098872901333
SIM,1851,41,na,1892,1852
STAT,1886,22,35-39,1908,6.222915095800714
SIM,1913,37,40-44,1950,3
SIM,1944,17,15-19,1961,47
STAT,1911,38,20-24,1949,0.25559909289243715
STAT,1892,45,35-39,1937,0.10108486213304083
SIM,1842,64,na,1906,1167
SIM,1830,38,30-34,1868,3
STAT,1906,34,20-24,1940,2.2637457923237894
SIM,1928,32,na,1960,4847
STAT,1937,18,20-24,1955,132.80245344527688
SIM,1945,18,20-24,1963,1
STAT,1931,35,40-44,1966,2.0071485812922014
SIM,1852,21,40-44,1873,2
STAT,1905,27,40-44,1932,4.373812668489135
SIM,1848,18,25-29,1866,7
STAT,1870,24,50-100,1894,0.40190985736650053
STAT,1804,59,na,1863,935.4403326505627
SIM,1827,31,35-39,1858,11
SIM,1922,25,15-19,1947,1
STAT,1874,38,na,1912,2424.4418931117243
SIM,1832,24,20-24,1856,59
STAT,1878,31,40-44,1909,4.565432419226527
SIM,1894,22,35-39,1916,10
SIM,1835,35,50-100,1870,3
STAT,1829,39,30-34,1868,4.224627579352992
STAT,1955,8,na,1963,5270.808877241074
SIM,1852,67,na,1919,1033
SIM,1908,23,40-44,1931,3
STAT,1848,28,25-29,1876,40.93503264531154
STAT,1857,42,na,1899,1819.5786759175785
SIM,1833,60,na,1893,1386
SIM,1849,23,35-39,1872,5
STAT,1797,76,na,1873,385.5274385212949
STAT,1876,49,na,1925,2297.2430686310636
STAT,1913,29,40-44,1942,4.652449879781349
STAT,1850,108,na,1958,0.0026993106045124227
SIM,1877,36,45-49,1913,3
STAT,1924,22,20-24,1946,132.5869416273554
STAT,1903,46,20-24,1949,0.009764262871314865
STAT,1913,47,40-44,1960,0.15526547901555485
SIM,1916,47,na,1963,3755
SIM,1863,35,na,1898,2178
STAT,1927,26,na,1953,4618.973688507278
STAT,1879,85,na,1964,517.6063372563879
SIM,1898,26,35-39,1924,17
STAT,1898,42,20-24,1940,0.015081458178110107
SIM,1912,33,na,1945,3610
STAT,1869,36,45-49,1905,1.9669428511303273
SIM,1861,87,na,1948,102
STAT,1904,21,40-44,1925,3.029430299664804
SIM,1841,17,25-29,1858,10
STAT,1909,43,35-39,1952,0.18891881559165105
SIM,1912,21,40-44,1933,6
STAT,1785,82,na,1867,162.14386784374688
STAT,1925,38,20-24,1963,0.31942501862673045
STAT,1888,35,15-19,1923,0.06757827019533821
SIM,1914,27,30-34,1941,47
STAT,1912,31,40-44,1943,3.9008215324628956
STAT,1945,22,50-100,1967,0.7282923279031185
SIM,1778,77,na,1855,240
STAT,1868,34,35-39,1902,9.691869908045756
STAT,1923,32,30-34,1955,18.24937637227995
SIM,1932,22,20-24,1954,184
STAT,1905,37,40-44,1942,1.3795657379748871
SIM,1934,32,na,1966,5277
STAT,1949,21,50-100,1970,0.7759339423432814
STAT,1840,25,15-19,1865,0.40230567167995623
SIM,1853,21,35-39,1874,7
STAT,1886,23,na,1909,2514.2780774606745
SIM,1889,19,25-29,1908,10
STAT,1919,40,40-44,1959,0.27443820230421156
STAT,1868,15,45-49,1883,0.06495985894485526
STAT,1851,44,35-39,1895,1.3526184627805984
STAT,1931,17,40-44,1948,1.850275994455225
SIM,1836,35,45-49,1871,2
STAT,1837,49,30-34,1886,0.06681747541243427
SIM,1904,66,na,1970,2869
STAT,1810,59,na,1869,1227.5787748485006
SIM,1830,79,na,1909,299
STAT,1923,25,40-44,1948,5.443669030181793
STAT,1834,73,na,1907,706.9842462588083
STAT,1866,26,50-100,1892,0.6003142326190097
SIM,1876,34,35-39,1910,20
SIM,1901,17,na,1918,3646
STAT,1876,40,na,1916,2434.5804671162023
STAT,1936,17,15-19,1953,43.86556232096099
STAT,1847,34,15-19,1881,0.11158353885351319
STAT,1885,22,40-44,1907,2.094931636714495
STAT,1851,37,45-49,1888,1.525608189022759
STAT,1923,43,35-39,1966,0.23742573274143533
STAT,1860,42,35-39,1902,1.4932152887018635
STAT,1867,20,25-29,1887,55.471313772246795
SIM,1850,30,20-24,1880,2
STAT,1922,35,15-19,1957,0.02211272822638663
SIM,1931,25,40-44,1956,11
STAT,1903,28,20-24,1931,16.815276259382376
STAT,1934,5,na,1939,5495.213532592537
STAT,1895,26,45-49,1921,1.4694747563350141
STAT,1928,36,25-29,1964,1.2588761304310283
SIM,1911,28,20-24,1939,24
STAT,1939,11,na,1950,4001.215915668116
SIM,1927,40,40-44,1967,3
SIM,1882,33,na,1915,2119
STAT,1897,70,na,1967,2212.54219779161
STAT,1905,35,50-100,1940,0.39059657790431623
SIM,1874,16,25-29,1890,9
STAT,1899,34,50-100,1933,1.2591817679464783
SIM,1869,16,15-19,1885,9
SIM,1889,12,na,1901,3213
SIM,1886,31,40-44,1917,7
SIM,1819,40,40-44,1859,3
SIM,1871,61,na,1932,1681
SIM,1826,31,40-44,1857,5
SIM,1847,24,15-19,1871,4
SIM,1871,30,40-44,1901,5
STAT,1852,50,35-39,1902,0.0066228662255193044
STAT,1920,22,35-39,1942,10.570818756582266
SIM,1888,34,na,1922,2886
SIM,1875,20,25-29,1895,52
STAT,1842,30,20-24,1872,3.001611772272321
STAT,1828,53,45-49,1881,0.011389477552275935
STAT,1895,44,45-49,1939,0.13522923612290413
STAT,1908,6,na,1914,3911.8197600316976
SIM,1865,37,na,1902,2149
SIM,1930,17,15-19,1947,72
STAT,1840,73,na,1913,832.5999523063182
STAT,1840,18,30-34,1858,1.438056668326876
STAT,1911,11,na,1922,3993.0485304543163
SIM,1897,29,25-29,1926,87
STAT,1866,16,25-29,1882,5.471950648314185
STAT,1915,25,na,1940,3881.744275052562
SIM,1843,48,50-100,1891,3
SIM,1931,6,na,1937,5212
STAT,1901,19,20-24,1920,24.96646116887507
STAT,1811,45,na,1856,1347.1508511232453
STAT,1833,40,20-24,1873,0.14019583959365217
SIM,1875,36,na,1911,2328
STAT,1894,20,40-44,1914,2.725817648046402
STAT,1909,25,35-39,1934,14.700870286665838
STAT,1924,31,30-34,1955,18.585103565714437
STAT,1813,42,45-49,1855,5.440657755355965
SIM,1915,39,45-49,1954,4
SIM,1869,26,45-49,1895,1
STAT,1828,47,15-19,1875,3.644396648420227E-4
STAT,1865,48,30-34,1913,0.08815264543452667
STAT,1942,22,35-39,1964,9.96789112462796
STAT,1858,50,30-34,1908,0.004784501607549698
STAT,1828,46,50-100,1874,0.22674926204481305
STAT,1859,22,40-44,1881,1.7562876406043848
SIM,1858,15,25-29,1873,8
STAT,1814,89,na,1903,49.17137799048685
SIM,1930,33,25-29,1963,21
STAT,1822,45,50-100,1867,0.3745054855564463
SIM,1904,25,25-29,1929,69
STAT,1886,54,na,1940,2233.04228341118
STAT,1882,40,na,1922,2284.012077952482
SIM,1858,24,40-44,1882,1
STAT,1865,33,20-24,1898,2.4823920624470044
SIM,1884,13,na,1897,2606
STAT,1795,81,na,1876,240.39862092883493
STAT,1928,30,40-44,1958,4.951450625320763
SIM,1853,21,na,1874,1880
STAT,1931,29,30-34,1960,51.074532441852114
STAT,1878,52,45-49,1930,0.0151346092554605
SIM,1864,35,20-24,1899,1
STAT,1869,26,15-19,1895,0.4470459579563883
STAT,1910,41,35-39,1951,0.19310966322490064
STAT,1935,33,35-39,1968,12.765607150519424
STAT,1825,44,40-44,1869,3.0813327008654214
STAT,1821,37,50-100,1858,2.4198928151855195
SIM,1836,40,na,1876,1910
STAT,1848,36,25-29,1884,2.447774319332542
SIM,1857,35,na,1892,2080
STAT,1922,33,25-29,1955,10.505361616462109
STAT,1910,22,na,1932,3615.655934932482
STAT,1892,35,40-44,1927,5.600645569980637
SIM,1839,85,na,1924,133
STAT,1856,35,20-24,1891,0.602572820846456
SIM,1852,63,na,1915,1250
SIM,1784,78,na,1862,305
SIM,1821,42,45-49,1863,1
SIM,1917,25,35-39,1942,1
STAT,1841,17,30-34,1858,1.5372621715789199
STAT,1916,41,50-100,1957,0.12166945882357517
SIM,1920,34,45-49,1954,2
STAT,1842,37,na,1879,2262.090604685266
SIM,1900,43,40-44,1943,2
STAT,1829,55,na,1884,1262.7256612242727
STAT,1905,48,45-49,1953,0.1919310860861142
SIM,1788,67,na,1855,615
SIM,1923,35,25-29,1958,1
SIM,1773,90,na,1863,50
STAT,1851,41,30-34,1892,0.8744536256828283
STAT,1895,38,15-19,1933,0.07369844386628031
STAT,1826,101,na,1927,0.31311279583103285
SIM,1853,35,45-49,1888,2
STAT,1852,48,20-24,1900,0.008986353050546524
SIM,1892,40,30-34,1932,9
SIM,1943,15,35-39,1958,3
STAT,1836,23,35-39,1859,4.823490189718759
SIM,1869,20,na,1889,2222
STAT,1861,48,50-100,1909,0.20353720109452939
SIM,1845,15,15-19,1860,5
STAT,1855,62,na,1917,1375.7713250324473
STAT,1915,35,25-29,1950,1.013191698060898
STAT,1861,49,20-24,1910,0.009861079439024303
SIM,1948,22,30-34,1970,64
STAT,1918,20,50-100,1938,0.7207332949938299
STAT,1845,35,45-49,1880,1.717105184559762
STAT,1845,21,35-39,1866,5.331642679357304
STAT,1893,36,50-100,1929,1.5820864380149422
SIM,1900,20,30-34,1920,1
SIM,1840,78,na,1918,576
STAT,1853,76,na,1929,783.4805877152168
STAT,1915,19,50-100,1934,0.0786990604618003
SIM,1833,39,45-49,1872,2
STAT,1807,50,20-24,1857,0.0026083689332802047
STAT,1831,23,50-100,1854,0.9595514131587778
STAT,1857,15,20-24,1872,16.619959778138522
STAT,1909,24,45-49,1933,1.0486566365533956
SIM,1886,1,na,1887,3324
SIM,1870,92,na,1962,95
SIM,1922,19,30-34,1941,19
STAT,1768,108,na,1876,0.008825242151069519
SIM,1856,36,25-29,1892,1
SIM,1935,27,15-19,1962,1
SIM,1866,87,na,1953,119
SIM,1910,29,50-100,1939,1
SIM,1809,78,na,1887,273
STAT,1900,27,40-44,1927,4.202809565057862
STAT,1859,40,40-44,1899,1.8456035569614107
STAT,1940,27,30-34,1967,40.33728977817579
SIM,1868,43,40-44,1911,4
SIM,1796,63,na,1859,1043
STAT,1891,17,na,1908,3158.2153840904552
STAT,1916,48,20-24,1964,0.01140703335659151
STAT,1924,46,na,1970,4430.654170030142
STAT,1871,25,45-49,1896,1.1216634858619363
STAT,1884,75,na,1959,1155.5428909920684
STAT,1924,36,40-44,1960,1.7853908620850212
STAT,1854,22,na,1876,1885.391100135732
SIM,1899,25,40-44,1924,8
STAT,1844,23,50-100,1867,0.3999413849187457
SIM,1801,82,na,1883,41
STAT,1814,40,50-100,1854,3.944300572226666
STAT,1943,16,45-49,1959,0.5350254457410395
STAT,1870,53,35-39,1923,0.008401271093373179
STAT,1869,54,45-49,1923,0.013858706396882196
STAT,1885,20,15-19,1905,3.3364222348975927
STAT,1914,19,30-34,1933,2.530258424421385
SIM,1885,53,na,1938,2251
STAT,1912,34,45-49,1946,1.548787373388714
SIM,1879,39,30-34,1918,2
STAT,1820,96,na,1916,4.370799990374319
STAT,1844,47,50-100,1891,0.19340893325501876
SIM,1928,24,20-24,1952,156
STAT,1943,12,na,1955,4206.001897485007
SIM,1892,39,na,1931,3170
STAT,1878,68,na,1946,1602.2460105275284
STAT,1887,12,na,1899,2912.1559490881023
STAT,1820,48,20-24,1868,0.020101620272916638
STAT,1902,35,15-19,1937,0.017463352282245555
SIM,1814,43,50-100,1857,1
STAT,1825,39,45-49,1864,3.0340490977011645
STAT,1861,53,40-44,1914,0.008693781116931858
SIM,1833,44,40-44,1877,3
STAT,1909,18,45-49,1927,0.09859411633625347
SIM,1913,18,na,1931,3936
SIM,1932,31,30-34,1963,43
STAT,1907,39,45-49,1946,0.6317750497039024
SIM,1874,14,na,1888,2513
SIM,1882,23,20-24,1905,58
SIM,1917,24,45-49,1941,3
SIM,1932,36,40-44,1968,3
STAT,1888,41,50-100,1929,1.2651071620272996
STAT,1891,38,30-34,1929,6.631464760242961
SIM,1867,22,40-44,1889,1
SIM,1951,16,45-49,1967,3
STAT,1874,41,20-24,1915,0.1649859443339513
SIM,1858,88,na,1946,63
SIM,1930,15,25-29,1945,98
SIM,1885,24,35-39,1909,9
STAT,1799,95,na,1894,4.461607582252754
STAT,1924,45,na,1969,4440.467603433733
SIM,1893,20,15-19,1913,4
STAT,1880,33,45-49,1913,1.8418848106552783
STAT,1858,102,na,1960,0.5471131584026917
STAT,1877,24,35-39,1901,6.044959609310106
STAT,1839,52,50-100,1891,0.010650438473047013
STAT,1857,27,50-100,1884,0.5193687690764192
STAT,1825,51,30-34,1876,0.00785716940980702
STAT,1874,69,na,1943,1517.7180957349062
STAT,1895,16,na,1911,3339.3634244534223
STAT,1837,51,45-49,1888,0.010135295153437614
STAT,1870,55,na,1925,2050.734003206716
STAT,1845,88,na,1933,100.31120353560866
STAT,1791,82,na,1873,151.54044373802847
SIM,1910,29,15-19,1939,1
SIM,1903,28,na,1931,3243
SIM,1824,55,na,1879,1333
STAT,1922,15,25-29,1937,50.90089218824962
STAT,1846,15,45-49,1861,0.06301287783948323
SIM,1808,93,na,1901,11
STAT,1902,29,15-19,1931,0.6429233403741408
STAT,1841,24,20-24,1865,64.3489208978913
SIM,1862,43,45-49,1905,3
STAT,1861,21,40-44,1882,1.809706039288356
STAT,1808,89,na,1897,39.605965170835695
STAT,1941,25,25-29,1966,68.80207370548291
STAT,1856,28,30-34,1884,20.060877902899037
STAT,1888,34,na,1922,2820.393673079609
STAT,1885,17,na,1902,2539.087121362902
STAT,1897,40,50-100,1937,0.10033905745436329
STAT,1889,37,25-29,1926,3.5857354464048075
STAT,1941,20,30-34,1961,30.007453416339338
SIM,1844,39,20-24,1883,3
SIM,1859,34,35-39,1893,2
STAT,1832,49,30-34,1881,0.06932581031921384
SIM,1928,18,20-24,1946,182
STAT,1830,39,50-100,1869,1.0849285813770542
STAT,1911,40,35-39,1951,0.19609734009438906
STAT,1836,39,20-24,1875,0.5846201194789999
STAT,1916,16,50-100,1932,0.08041450908120029
SIM,1803,93,na,1896,14
STAT,1790,102,na,1892,0.05413695633046274
STAT,1811,47,20-24,1858,0.02989147189294673
STAT,1896,53,na,1949,2832.4739016443536
STAT,1902,0,na,1902,4190.915795870044
STAT,1814,96,na,1910,4.019073095594402
STAT,1843,42,35-39,1885,1.2575030435146537
SIM,1885,21,30-34,1906,32
STAT,1877,35,50-100,1912,1.2919823648165825
STAT,1886,33,40-44,1919,4.605128118746218
SIM,1864,28,30-34,1892,39
SIM,1923,29,50-100,1952,1
STAT,1916,10,na,1926,4241.304170412388
STAT,1800,60,na,1860,859.5449518755047
SIM,1865,15,20-24,1880,18
STAT,1869,48,15-19,1917,3.878477324457798E-4
SIM,1876,30,40-44,1906,6
SIM,1891,54,na,1945,2669
STAT,1851,29,45-49,1880,0.9702676681584274
STAT,1887,3,na,1890,2981.0917235005586
STAT,1946,18,15-19,1964,50.823596852396264
STAT,1801,53,35-39,1854,0.03183519261368198
SIM,1830,40,45-49,1870,3
SIM,1848,15,20-24,1863,23
STAT,1908,28,na,1936,3562.25141211395
STAT,1934,16,50-100,1950,0.5133017531809051
STAT,1872,31,50-100,1903,0.9341769720045315
STAT,1850,37,30-34,1887,4.145555152896892
STAT,1826,81,na,1907,296.7285063082814
SIM,1913,39,30-34,1952,1
STAT,1905,39,30-34,1944,1.6627066956457572
STAT,1917,26,45-49,1943,1.8350639219304894
STAT,1932,38,40-44,1970,2.0305803120009873
SIM,1809,71,na,1880,559
STAT,1886,34,50-100,1920,0.9687124933576949
STAT,1831,24,15-19,1855,3.594754872064841
SIM,1827,42,40-44,1869,1
STAT,1906,23,15-19,1929,4.838209323302258
SIM,1923,32,na,1955,4392
STAT,1872,31,45-49,1903,1.7779497318870825
STAT,1877,22,30-34,1899,18.567939295999878
SIM,1819,77,na,1896,400
STAT,1878,34,45-49,1912,1.8126653644913422
STAT,1819,42,40-44,1861,4.8277081671024575
STAT,1900,48,50-100,1948,0.191929270886377
SIM,1897,37,25-29,1934,4
STAT,1935,15,35-39,1950,5.822594156881263
STAT,1907,42,50-100,1949,0.10867887271646016
STAT,1836,36,na,1872,1674.8713961294186
SIM,1923,38,40-44,1961,10
STAT,1950,21,30-34,1971,34.45934680247443
STAT,1820,52,40-44,1872,0.01718349769214882
STAT,1851,34,40-44,1885,3.347506260149522
STAT,1904,17,30-34,1921,2.3101843445745573
STAT,1916,32,35-39,1948,9.521203524300109
STAT,1897,36,20-24,1933,1.0487984646317194
STAT,1833,25,25-29,1858,40.164912038663566
STAT,1912,16,15-19,1928,9.281407201729975
STAT,1873,91,na,1964,147.88697170100482
STAT,1853,22,45-49,1875,0.6813582005215074
SIM,1914,23,15-19,1937,5
STAT,1884,43,35-39,1927,1.7905329502379361
STAT,1870,47,50-100,1917,0.24244759455903456
STAT,1893,8,na,1901,3333.7659178648532
SIM,1886,34,45-49,1920,2
SIM,1839,18,30-34,1857,2
STAT,1835,21,50-100,1856,0.40994675997205604
STAT,1876,48,50-100,1924,0.2529040415662558
STAT,1915,30,30-34,1945,16.321427587026378
STAT,1936,30,na,1966,3712.9060319970613
SIM,1912,17,30-34,1929,4
STAT,1932,35,25-29,1967,1.3392315121951195
STAT,1815,42,50-100,1857,2.739966612534075
STAT,1922,43,15-19,1965,0.0017778759462350126
SIM,1819,43,45-49,1862,1
SIM,1849,17,25-29,1866,12
STAT,1806,82,na,1888,171.2474635988587
SIM,1919,27,na,1946,3890
STAT,1852,9,na,1861,2234.707071191897
SIM,1925,26,45-49,1951,3
STAT,1847,38,30-34,1885,4.097502721937365
STAT,1880,27,15-19,1907,0.4812470465936292
SIM,1920,16,15-19,1936,52
STAT,1871,34,50-100,1905,0.9115115788250714
STAT,1822,40,45-49,1862,2.5014582828002956
STAT,1857,73,na,1930,936.2392982104548
STAT,1869,54,na,1923,2056.1788536478107
SIM,1915,13,na,1928,4533
STAT,1823,42,50-100,1865,1.5673359616625915
SIM,1931,31,na,1962,4896
STAT,1915,38,40-44,1953,1.5183856936600924
SIM,1869,36,na,1905,2300
SIM,1889,16,20-24,1905,26
STAT,1867,24,40-44,1891,1.969755956414535
SIM,1918,42,na,1960,4188
STAT,1868,1,na,1869,3428.361021157326
SIM,1838,38,30-34,1876,5
STAT,1898,16,20-24,1914,24.333678157042122
SIM,1853,32,40-44,1885,6
SIM,1964,2,na,1966,5257
STAT,1865,61,na,1926,1723.3603727114303
STAT,1817,52,35-39,1869,0.017726433260627325
STAT,1897,29,30-34,1926,33.85406979936915
SIM,1924,32,35-39,1956,18
STAT,1825,102,na,1927,0.21394706159760102
STAT,1931,38,45-49,1969,0.9115403929605158
STAT,1906,48,40-44,1954,0.14028095403321267
STAT,1874,39,50-100,1913,1.2569396330446978
STAT,1936,31,na,1967,3710.863933679461
SIM,1903,16,15-19,1919,10
STAT,1796,59,na,1855,945.0959599999999
SIM,1947,4,na,1951,4887
SIM,1895,31,50-100,1926,1
STAT,1936,32,40-44,1968,3.8374405614082026
SIM,1952,0,na,1952,4986
SIM,1848,58,na,1906,1491
SIM,1923,30,30-34,1953,22
SIM,1863,1,na,1864,3394
STAT,1812,49,25-29,1861,0.12865776323721229
STAT,1901,37,20-24,1938,0.23557172018860192
SIM,1841,25,25-29,1866,49
SIM,1839,25,20-24,1864,9
STAT,1845,50,40-44,1895,0.007802949683391493
STAT,1887,36,15-19,1923,0.06362723849791561
STAT,1900,21,20-24,1921,96.97689806044461
SIM,1932,39,45-49,1971,1
STAT,1835,58,na,1893,1484.281419498988
STAT,1837,22,na,1859,1909.3835654303534
STAT,1868,30,40-44,1898,4.2198420678521735
STAT,1914,45,35-39,1959,0.1296183585843314
STAT,1930,23,50-100,1953,0.8493436294436331
SIM,1913,43,na,1956,3611
STAT,1827,32,45-49,1859,2.346924878344991
SIM,1844,20,30-34,1864,20
SIM,1894,18,15-19,1912,9
STAT,1856,24,15-19,1880,2.92446182372074
STAT,1877,50,na,1927,2276.766795458055
STAT,1945,19,30-34,1964,13.437547285791085
SIM,1890,25,20-24,1915,11
SIM,1862,25,na,1887,2186
STAT,1908,16,50-100,1924,0.07354204135290371
STAT,1848,53,25-29,1901,0.002845473686209464
STAT,1863,23,45-49,1886,0.6318923055754081
STAT,1919,22,50-100,1941,0.7274881844033729
STAT,1830,42,45-49,1872,1.30037295836239
STAT,1858,53,35-39,1911,0.006712173234417923
SIM,1919,34,20-24,1953,2
STAT,1870,3,na,1873,3108.5913280026384
SIM,1903,20,35-39,1923,8
SIM,1889,33,50-100,1922,2
STAT,1850,49,45-49,1899,0.1769354056881407
STAT,1937,26,25-29,1963,64.80253948504155
SIM,1919,29,35-39,1948,24
STAT,1862,51,35-39,1913,0.007544923907610659
STAT,1833,43,25-29,1876,0.5455041438283509
SIM,1899,49,na,1948,3292
SIM,1940,30,30-34,1970,23
STAT,1859,25,45-49,1884,0.9308257506980283
STAT,1796,66,na,1862,740.8232970189969
SIM,1832,59,na,1891,1134
SIM,1855,38,30-34,1893,11
SIM,1864,9,na,1873,2899
SIM,1928,28,15-19,1956,1
SIM,1871,23,45-49,1894,3
STAT,1845,32,40-44,1877,3.7676911349500384
STAT,1960,12,na,1972,5167.108955084774
STAT,1815,52,20-24,1867,0.0015641628932421292
SIM,1915,36,40-44,1951,1
STAT,1901,21,35-39,1922,8.287152195594663
SIM,1843,31,40-44,1874,3
STAT,1924,39,45-49,1963,0.8105863540588212
SIM,1884,72,na,1956,1303
STAT,1882,49,45-49,1931,0.22606921813363334
STAT,1862,29,20-24,1891,10.159277052072074
STAT,1874,26,25-29,1900,43.89781973557352
SIM,1890,68,na,1958,2297
STAT,1836,20,30-34,1856,17.207792216680172
STAT,1846,20,40-44,1866,1.9795172092857147
SIM,1887,17,na,1904,2784
STAT,1861,105,na,1966,0.16631455844918885
STAT,1882,25,20-24,1907,11.555303525277454
SIM,1821,46,50-100,1867,5
STAT,1886,18,15-19,1904,6.311982566802426
SIM,1881,39,na,1920,2034
STAT,1885,45,50-100,1930,0.24937254104592382
SIM,1859,32,30-34,1891,27
SIM,1823,34,20-24,1857,1
STAT,1846,35,15-19,1881,0.04543572582134086
SIM,1892,32,na,1924,3281
STAT,1894,23,45-49,1917,0.903950040062655
STAT,1909,49,20-24,1958,0.010187129855474234
STAT,1878,16,15-19,1894,6.237389685095768
SIM,1870,29,20-24,1899,14
STAT,1880,30,40-44,1910,4.636976173595149
STAT,1932,30,30-34,1962,21.18971051611322
STAT,1825,37,na,1862,2085.0948848576572
STAT,1839,88,na,1927,97.33034111924016
SIM,1845,88,na,1933,129
SIM,1864,24,15-19,1888,3
STAT,1813,46,50-100,1859,0.7280294609621657
STAT,1808,56,na,1864,1089.0206045010314
STAT,1903,47,na,1950,3221.7123630311207
SIM,1866,17,25-29,1883,7
SIM,1844,44,na,1888,1520
STAT,1887,21,40-44,1908,2.3568928394191033
STAT,1871,22,40-44,1893,2.090944233921015
SIM,1849,43,na,1892,1820
STAT,1835,31,40-44,1866,4.1888122321810535
STAT,1915,32,20-24,1947,2.5066832058705577
STAT,1864,76,na,1940,863.4515404199067
STAT,1860,62,na,1922,1509.023368336357
SIM,1796,59,na,1855,1135
SIM,1849,47,na,1896,1764
SIM,1918,42,40-44,1960,4
STAT,1859,30,15-19,1889,0.11736798419574081
STAT,1837,33,45-49,1870,1.476177931152572
STAT,1830,24,45-49,1854,1.4687674358543215
SIM,1931,27,30-34,1958,53
STAT,1870,50,30-34,1920,0.005988506799197735
SIM,1788,92,na,1880,9
STAT,1869,9,na,1878,2665.379228525359
SIM,1879,13,na,1892,2982
STAT,1858,17,25-29,1875,5.245196443120581
SIM,1814,93,na,1907,13
SIM,1905,47,na,1952,3425
STAT,1846,51,na,1897,1641.8245118972843
SIM,1820,36,50-100,1856,2
STAT,1923,27,30-34,1950,45.45327371535357
SIM,1882,26,25-29,1908,46
STAT,1907,36,40-44,1943,1.4081663265550197
SIM,1931,23,15-19,1954,6
STAT,1902,15,45-49,1917,0.09366537244419856
STAT,1923,23,15-19,1946,6.2387623832802666
STAT,1918,15,35-39,1933,0.9293941611625279
SIM,1893,24,na,1917,3015
SIM,1927,28,30-34,1955,61
STAT,1793,105,na,1898,0.0052919230915620275
SIM,1917,21,40-44,1938,5
SIM,1897,38,na,1935,3248
STAT,1848,51,20-24,1899,6.053631568364148E-4
SIM,1870,21,na,1891,2539
SIM,1919,0,na,1919,4571
STAT,1909,21,40-44,1930,3.162966459812743
SIM,1926,33,35-39,1959,14
STAT,1818,55,na,1873,1260.711588454342
SIM,1899,43,40-44,1942,3
SIM,1874,10,na,1884,2568
STAT,1887,49,na,1936,2484.514562100823
SIM,1856,33,20-24,1889,2
STAT,1890,48,40-44,1938,0.11768666230804906
STAT,1807,53,25-29,1860,0.01178007653078109
STAT,1926,16,na,1942,4572.11686248519
STAT,1857,69,na,1926,1156.7827528839468
STAT,1929,28,40-44,1957,5.893264577455056
STAT,1841,42,50-100,1883,0.820940131636972
STAT,1839,46,25-29,1885,0.042143948148584735
SIM,1822,60,na,1882,1197
SIM,1923,32,20-24,1955,3
STAT,1847,43,na,1890,1718.0099662616415
STAT,1919,28,30-34,1947,42.59569198708231
SIM,1845,33,45-49,1878,2
SIM,1945,24,20-24,1969,125
STAT,1857,18,25-29,1875,5.21906777162522
STAT,1848,33,20-24,1881,2.317854383281102
STAT,1778,96,na,1874,1.6717659162217164
STAT,1815,108,na,1923,7.929135602023082E-4
STAT,1859,18,50-100,1877,0.04592486029446161
STAT,1918,33,35-39,1951,9.762361245068943
STAT,1841,42,20-24,1883,0.12340930318682558
SIM,1867,25,45-49,1892,2
STAT,1853,47,20-24,1900,0.009877453861310736
STAT,1779,101,na,1880,0.15782004776665437
STAT,1947,3,na,1950,4547.709553373433
SIM,1898,17,25-29,1915,14
STAT,1869,51,40-44,1920,0.010387176837500671
SIM,1876,76,na,1952,896
STAT,1830,44,15-19,1874,0.011664679870498972
SIM,1872,87,na,1959,93
SIM,1778,78,na,1856,210
SIM,1865,18,25-29,1883,8
STAT,1774,82,na,1856,101.51980594999999
STAT,1904,46,50-100,1950,0.2013709296995513
STAT,1883,48,45-49,1931,0.23032476971233007
STAT,1849,16,25-29,1865,5.485964924369487
STAT,1871,45,15-19,1916,4.0537082571687574E-4
STAT,1905,17,15-19,1922,8.665017413020388
STAT,1882,18,30-34,1900,1.555272773861838
STAT,1892,42,30-34,1934,1.455271705274462
SIM,1908,17,40-44,1925,1
STAT,1870,17,na,1887,2528.727836780767
STAT,1931,25,15-19,1956,0.9219239474227998
STAT,1890,31,50-100,1921,1.135415512082427
STAT,1879,37,15-19,1916,0.059186898162802995
STAT,1849,108,na,1957,0.002197809117082401
SIM,1854,39,30-34,1893,7
STAT,1941,22,20-24,1963,116.01330599077424
SIM,1843,22,na,1865,2424
STAT,1917,23,40-44,1940,3.595969232565799
STAT,1866,87,na,1953,164.77000751987336
STAT,1925,4,na,1929,4927.457394105206
STAT,1886,36,45-49,1922,2.1360720533782716
STAT,1879,29,50-100,1908,0.6694167757969383
STAT,1921,21,40-44,1942,3.84720777402912
STAT,1937,24,20-24,1961,109.24092568829711
STAT,1900,45,40-44,1945,0.13684105042663472
STAT,1889,34,20-24,1923,3.3375521166327404
SIM,1876,33,45-49,1909,5
SIM,1864,21,na,1885,2557
SIM,1897,34,20-24,1931,3
SIM,1890,18,30-34,1908,4
STAT,1900,24,25-29,1924,79.81343806252322
SIM,1911,47,na,1958,3790
STAT,1846,39,30-34,1885,4.136822199075525
SIM,1859,31,30-34,1890,7
SIM,1894,36,45-49,1930,3
SIM,1930,37,40-44,1967,4
SIM,1904,29,40-44,1933,6
SIM,1858,20,25-29,1878,80
SIM,1862,40,40-44,1902,7
STAT,1824,47,30-34,1871,0.11326709786986379
STAT,1848,21,na,1869,2140.9312038581998
STAT,1931,31,na,1962,5011.412595864893
SIM,1858,51,na,1909,1760
STAT,1833,42,25-29,1875,0.5525379519567608
STAT,1868,33,45-49,1901,1.6761921384027556
STAT,1884,68,na,1952,1522.0771194372228
STAT,1888,28,50-100,1916,0.7599004708358291
STAT,1872,25,15-19,1897,0.4638245687470939
STAT,1927,27,15-19,1954,0.8674575242979697
SIM,1913,17,15-19,1930,16
STAT,1945,26,20-24,1971,20.233674759436678
STAT,1845,53,45-49,1898,0.010433759518448852
STAT,1863,69,na,1932,1313.2895592476846
STAT,1860,25,na,1885,2020.3976859981533
SIM,1818,82,na,1900,198
SIM,1919,36,25-29,1955,1
SIM,1945,19,35-39,1964,8
SIM,1867,65,na,1932,1488
SIM,1857,16,25-29,1873,9
STAT,1817,70,na,1887,722.154174031763
STAT,1836,21,30-34,1857,14.936999438466579
SIM,1931,34,20-24,1965,3
STAT,1884,40,30-34,1924,1.156617921994562
SIM,1953,18,30-34,1971,29
STAT,1945,18,30-34,1963,13.442252074016997
STAT,1784,96,na,1880,1.3400716078869972
STAT,1898,19,25-29,1917,7.717324702452756
STAT,1923,34,20-24,1957,2.8216677942015522
STAT,1856,53,20-24,1909,5.622305935164987E-4
STAT,1866,45,40-44,1911,0.16170806230304385
STAT,1780,82,na,1862,140.19342538232098
STAT,1800,97,na,1897,1.8845060966331846
SIM,1828,30,40-44,1858,5
SIM,1816,39,45-49,1855,5
STAT,1937,19,35-39,1956,4.108880442603718
STAT,1889,15,50-100,1904,0.06129768214049109
SIM,1844,21,30-34,1865,20
STAT,1842,54,35-39,1896,0.0075378867067367
SIM,1918,31,35-39,1949,3
STAT,1914,35,40-44,1949,1.5223458550706197
STAT,1938,16,15-19,1954,45.305818227908105
STAT,1856,40,50-100,1896,0.826314082545222
STAT,1913,35,50-100,1948,0.42202289786004415
STAT,1854,37,15-19,1891,0.04214324405650426
SIM,1884,32,40-44,1916,5
STAT,1920,28,20-24,1948,20.149859808884322
SIM,1911,22,35-39,1933,10
STAT,1914,17,40-44,1931,0.2919230592112837
STAT,1868,40,35-39,1908,1.7655995821181885
STAT,1901,47,15-19,1948,3.1797497488195517E-4
STAT,1940,25,40-44,1965,4.80258136421975
STAT,1783,96,na,1879,1.6355007609133034
STAT,1848,54,25-29,1902,0.002812380827238847
SIM,1836,21,35-39,1857,7
SIM,1843,59,na,1902,1748
STAT,1842,92,na,1934,37.4984141363025
SIM,1908,28,na,1936,3412
STAT,1843,77,na,1920,583.0046612163891
SIM,1905,19,30-34,1924,3
STAT,1874,43,25-29,1917,0.6593147229848851
SIM,1922,17,40-44,1939,1
SIM,1869,31,40-44,1900,4
STAT,1882,43,20-24,1925,0.154251953688115
STAT,1812,46,20-24,1858,0.028126868801939583
STAT,1925,31,na,1956,4541.478522592811
STAT,1890,16,15-19,1906,7.342178438883486
STAT,1940,32,30-34,1972,16.46172061282141
STAT,1833,22,20-24,1855,65.78104545819224
SIM,1841,22,20-24,1863,74
STAT,1866,52,30-34,1918,0.005537382077875309
SIM,1839,28,25-29,1867,44
SIM,1817,41,40-44,1858,9
SIM,1926,13,na,1939,4864
SIM,1948,5,na,1953,5022
STAT,1903,22,35-39,1925,8.393831917986132
SIM,1857,73,na,1930,1026
STAT,1919,29,30-34,1948,42.44064366824935
SIM,1896,53,na,1949,2757
STAT,1865,65,na,1930,1558.578073289488
STAT,1826,74,na,1900,608.9636110393307
SIM,1925,23,40-44,1948,5
STAT,1876,32,40-44,1908,4.522514194261941
STAT,1897,25,15-19,1922,0.6185078007181036
STAT,1831,37,na,1868,1692.611131692278
SIM,1864,2,na,1866,3189
STAT,1819,45,45-49,1864,0.4737967017587306
SIM,1879,50,na,1929,2567
STAT,1807,52,25-29,1859,0.012021774638136685
STAT,1825,96,na,1921,6.266189872483943
STAT,1953,17,15-19,1970,55.46742563123874
STAT,1920,46,20-24,1966,0.012366840681800826
STAT,1919,36,20-24,1955,0.2861992046883459
SIM,1927,29,30-34,1956,5
SIM,1946,16,15-19,1962,51
STAT,1842,47,45-49,1889,0.2125145020685227
STAT,1895,31,na,1926,3160.3193766998747
STAT,1927,45,45-49,1972,0.27704447828166645
STAT,1900,31,50-100,1931,1.2907561080604835
SIM,1945,26,25-29,1971,83
SIM,1878,72,na,1950,1287
STAT,1845,17,15-19,1862,5.480696352680097
STAT,1938,34,15-19,1972,0.1302755228442167
SIM,1853,17,15-19,1870,4
STAT,1878,35,na,1913,2493.5946820931467
STAT,1906,17,na,1923,3715.427967347363
STAT,1832,43,50-100,1875,0.8713611989186424
STAT,1906,43,35-39,1949,0.18364999620884281
SIM,1828,85,na,1913,118
SIM,1920,4,na,1924,4900
SIM,1887,18,25-29,1905,7
SIM,1877,30,50-100,1907,1
SIM,1918,17,na,1935,4463
STAT,1930,15,20-24,1945,177.9806637114278
SIM,1853,89,na,1942,68
SIM,1832,81,na,1913,346
SIM,1851,88,na,1939,69
SIM,1936,34,20-24,1970,7
STAT,1812,45,45-49,1857,0.5621212942584556
STAT,1934,31,40-44,1965,5.401872460796055
SIM,1834,34,35-39,1868,5
SIM,1877,93,na,1970,150
SIM,1916,36,45-49,1952,1
STAT,1877,21,30-34,1898,18.62399752856085
STAT,1858,52,na,1910,1697.0585246021133
SIM,1839,54,na,1893,1386
STAT,1855,48,20-24,1903,0.008919154899999822
SIM,1881,39,25-29,1920,3
STAT,1882,46,40-44,1928,0.16796864728285812
STAT,1911,48,na,1959,3499.1111460269353
STAT,1950,18,40-44,1968,1.6703813792062887
STAT,1952,17,50-100,1969,0.4536207527837655
STAT,1881,88,na,1969,351.7604258372626
STAT,1910,45,15-19,1955,3.4838397260517735E-4
SIM,1823,37,25-29,1860,3
SIM,1889,40,45-49,1929,3
SIM,1885,22,30-34,1907,26
STAT,1880,17,20-24,1897,18.80483936101759
STAT,1867,23,50-100,1890,0.3867005688111198
STAT,1824,42,na,1866,1365.7700610230013
STAT,1826,41,40-44,1867,2.3937591173327064
SIM,1912,26,na,1938,3624
SIM,1938,31,na,1969,3740
SIM,1879,19,na,1898,2919
STAT,1882,28,25-29,1910,41.23981523642978
STAT,1896,28,50-100,1924,0.8522079483978694
STAT,1900,41,25-29,1941,0.06284714558470929
STAT,1918,30,30-34,1948,17.03813320554382
SIM,1892,25,40-44,1917,6
STAT,1829,42,20-24,1871,0.1233331909366009
SIM,1928,26,25-29,1954,147
STAT,1873,39,25-29,1912,2.918366855676861
SIM,1904,7,na,1911,3936
SIM,1858,21,50-100,1879,2
STAT,1893,25,35-39,1918,12.45813659168797
STAT,1844,32,45-49,1876,1.6498722577109854
SIM,1890,28,25-29,1918,66
SIM,1903,18,20-24,1921,28
STAT,1858,38,45-49,1896,1.5717772428902042
STAT,1883,53,na,1936,2094.017213223191
STAT,1832,52,20-24,1884,5.242093224818664E-4
STAT,1871,20,50-100,1891,0.4116282095986368
STAT,1846,67,na,1913,1202.9978491319987
SIM,1854,21,na,1875,2347
STAT,1787,108,na,1895,5.965164033057857E-4
SIM,1832,39,50-100,1871,1
STAT,1920,44,45-49,1964,0.1850012468686247
STAT,1923,45,25-29,1968,0.06299366775522798
STAT,1854,51,45-49,1905,0.010943482807653329
STAT,1885,54,na,1939,2105.191659764597
SIM,1823,45,na,1868,1527
SIM,1949,19,na,1968,4142
STAT,1826,34,35-39,1860,12.705010929486871
STAT,1854,86,na,1940,166.51509455823563
SIM,1928,11,na,1939,5125
STAT,1861,45,40-44,1906,0.1451172313115347
STAT,1896,16,na,1912,3384.8292141362854
STAT,1935,37,15-19,1972,0.027129881526270227
SIM,1831,64,na,1895,1152
STAT,1842,19,40-44,1861,0.2089793288729618
STAT,1835,32,35-39,1867,9.680636371139672
SIM,1851,31,30-34,1882,25
STAT,1914,47,25-29,1961,0.05307887626684042
SIM,1926,30,30-34,1956,2
SIM,1865,43,25-29,1908,3
STAT,1855,32,20-24,1887,2.0716920965933903
SIM,1804,62,na,1866,1065
SIM,1863,32,20-24,1895,2
STAT,1867,27,45-49,1894,1.0561446717896577
STAT,1871,49,30-34,1920,0.09510343261733115
SIM,1827,69,na,1896,783
SIM,1866,35,40-44,1901,5
SIM,1843,32,35-39,1875,2
STAT,1873,69,na,1942,1502.631716456738
STAT,1920,20,45-49,1940,1.270716549029912
SIM,1910,20,40-44,1930,4
STAT,1808,93,na,1901,11.01819248420424
STAT,1857,43,25-29,1900,0.50252013362341
STAT,1867,35,35-39,1902,6.7918138184197465
SIM,1890,75,na,1965,1744
STAT,1922,37,50-100,1959,0.4826285548682558
STAT,1851,26,40-44,1877,2.674958416983945
STAT,1855,34,na,1889,1791.3382071537415
STAT,1873,46,15-19,1919,4.107263098622691E-4
STAT,1884,25,40-44,1909,3.003808171005875
STAT,1911,19,15-19,1930,9.113132667357853
SIM,1842,36,na,1878,1879
STAT,1902,29,50-100,1931,0.9064819594147923
STAT,1852,31,40-44,1883,3.440839063520439
STAT,1899,39,45-49,1938,0.5904259079656522
SIM,1797,75,na,1872,420
SIM,1835,30,na,1865,1663
STAT,1853,50,30-34,1903,0.004993358831067951
STAT,1912,24,15-19,1936,5.330012571602681
SIM,1909,15,35-39,1924,1
STAT,1870,43,40-44,1913,2.214690492073743
SIM,1942,26,45-49,1968,2
STAT,1837,19,30-34,1856,1.5784120565825959
STAT,1919,20,35-39,1939,10.472468805208592
SIM,1943,27,50-100,1970,2
STAT,1909,47,15-19,1956,3.4157279461026176E-4
STAT,1821,52,45-49,1873,0.020458749127834738
STAT,1861,22,35-39,1883,5.0314975711778915
SIM,1804,72,na,1876,613
STAT,1904,25,20-24,1929,17.119145373954847
SIM,1920,24,15-19,1944,6
STAT,1873,59,na,1932,1989.9315397783573
STAT,1803,52,40-44,1855,0.04565718622171445
STAT,1863,16,20-24,1879,18.210811770983494
SIM,1825,34,40-44,1859,7
SIM,1875,35,35-39,1910,13
STAT,1870,38,45-49,1908,1.9673101773065889
STAT,1849,45,40-44,1894,0.13518767440330035
STAT,1841,43,15-19,1884,0.010594635594595645
STAT,1930,15,na,1945,4832.024391579204
SIM,1898,32,50-100,1930,1
SIM,1856,22,na,1878,2151
STAT,1928,34,20-24,1962,3.078758274224075
STAT,1796,91,na,1887,18.25059457739233
SIM,1826,42,45-49,1868,1
SIM,1872,56,na,1928,2264
STAT,1830,48,30-34,1878,0.07992427440663245
SIM,1896,28,50-100,1924,5
STAT,1896,33,20-24,1929,3.598526407034089
SIM,1848,21,15-19,1869,3
STAT,1847,15,50-100,1862,0.04632691483129664
STAT,1881,38,20-24,1919,0.7467495089706981
SIM,1907,29,45-49,1936,1
STAT,1846,19,25-29,1865,5.3387139971654785
SIM,1929,18,40-44,1947,4
STAT,1889,78,na,1967,1369.2472525836176
SIM,1875,49,50-100,1924,3
STAT,1847,15,na,1862,2170.579344666238
STAT,1895,17,50-100,1912,0.06461849365697586
SIM,1871,16,20-24,1887,16
STAT,1885,33,45-49,1918,1.7457320261171556
SIM,1892,32,30-34,1924,36
STAT,1895,5,na,1900,3456.5262212766374
STAT,1818,42,45-49,1860,2.937935436087573
STAT,1884,32,30-34,1916,17.389791276336393
SIM,1880,75,na,1955,890
SIM,1925,34,45-49,1959,6
STAT,1893,73,na,1966,1844.5436363322303
STAT,1904,18,30-34,1922,2.304131661591772
SIM,1905,39,35-39,1944,3
SIM,1854,19,25-29,1873,9
STAT,1864,46,20-24,1910,0.010967697686279637
SIM,1951,13,na,1964,4983
STAT,1882,50,50-100,1932,0.01498807179508026
STAT,1917,34,45-49,1951,1.64901224006069
SIM,1858,42,40-44,1900,3
SIM,1893,33,45-49,1926,6
STAT,1820,44,40-44,1864,3.9597219022645547
STAT,1817,41,30-34,1858,2.9405636097129397
STAT,1900,49,20-24,1949,0.009298692213054351
SIM,1822,43,50-100,1865,1
SIM,1868,24,35-39,1892,5
STAT,1916,26,40-44,1942,4.880232227067979
SIM,1909,34,na,1943,3893
STAT,1933,26,40-44,1959,6.2568049485258515
STAT,1839,16,15-19,1855,5.536547064361653
STAT,1859,19,35-39,1878,0.5113289588511483
STAT,1903,26,15-19,1929,0.6548513416305841
STAT,1813,50,45-49,1863,0.041781928341802665
STAT,1790,72,na,1862,469.6458143281321
SIM,1888,37,50-100,1925,3
SIM,1884,33,35-39,1917,2
STAT,1894,47,45-49,1941,0.1722983691495692
STAT,1910,22,40-44,1932,3.185700189453124
STAT,1913,23,20-24,1936,112.94122656597301
STAT,1882,44,15-19,1926,0.013328442575602993
STAT,1860,24,40-44,1884,1.7481594656308141
SIM,1889,22,15-19,1911,4
STAT,1830,50,45-49,1880,0.012205125023184424
SIM,1811,44,na,1855,1565
STAT,1905,15,25-29,1920,8.312413018804198
SIM,1817,42,35-39,1859,4
SIM,1904,23,20-24,1927,101
STAT,1876,30,15-19,1906,0.14970257276806304
SIM,1893,30,40-44,1923,6
STAT,1804,50,35-39,1854,0.02427476362698244
STAT,1840,21,20-24,1861,61.8761571749869
STAT,1825,36,40-44,1861,7.53922537896412
SIM,1915,28,40-44,1943,6
STAT,1770,102,na,1872,0.04323169780167996
STAT,1938,15,20-24,1953,135.6396575923071
SIM,1841,88,na,1929,62
STAT,1805,75,na,1880,503.50007226930103
SIM,1916,41,40-44,1957,1
STAT,1838,17,25-29,1855,5.01073296960593
SIM,1880,85,na,1965,422
STAT,1814,47,20-24,1861,0.028943285646861817
SIM,1929,15,20-24,1944,192
SIM,1837,19,25-29,1856,9
SIM,1935,29,20-24,1964,37
STAT,1871,44,50-100,1915,1.045760452299349
STAT,1934,26,45-49,1960,2.3493546189144685
SIM,1949,18,40-44,1967,6
STAT,1920,26,15-19,1946,0.7847128126814819
STAT,1913,49,30-34,1962,0.08727571948062043
STAT,1932,32,50-100,1964,1.110730767032959
STAT,1926,35,50-100,1961,0.5194880616344423
STAT,1875,27,40-44,1902,3.107051259241551
STAT,1902,20,40-44,1922,2.9918825140406127
SIM,1941,26,40-44,1967,11
STAT,1876,40,40-44,1916,2.3693098040491214
STAT,1915,29,50-100,1944,1.0171052141224328
SIM,1867,93,na,1960,41
STAT,1880,41,45-49,1921,1.594685017730449
STAT,1918,45,15-19,1963,3.976184664001846E-4
STAT,1924,28,40-44,1952,5.46474151742199
SIM,1822,81,na,1903,213
SIM,1912,25,20-24,1937,29
SIM,1913,15,25-29,1928,12
SIM,1847,16,15-19,1863,8
SIM,1814,62,na,1876,999
SIM,1833,36,40-44,1869,4
STAT,1927,29,20-24,1956,22.339620423737447
STAT,1810,66,na,1876,962.2503891920223
STAT,1929,42,25-29,1971,0.09347098174197593
STAT,1828,37,20-24,1865,0.794235304687953
STAT,1804,52,45-49,1856,0.03930115888647126
SIM,1852,36,na,1888,1791
STAT,1838,32,na,1870,1802.7884059147577
SIM,1817,69,na,1886,827
SIM,1927,20,35-39,1947,17
STAT,1875,54,na,1929,2171.8888166253446
STAT,1911,4,na,1915,4061.48116937087
STAT,1925,24,na,1949,4389.917676819504
STAT,1824,53,25-29,1877,0.003916765844508033
STAT,1810,48,15-19,1858,0.0015161778768588224
STAT,1895,28,20-24,1923,15.418888376402682
SIM,1921,23,20-24,1944,121
STAT,1821,50,35-39,1871,0.012629588472877226
SIM,1867,33,35-39,1900,16
STAT,1871,43,45-49,1914,1.4909165710652894
SIM,1932,28,40-44,1960,11
SIM,1918,11,na,1929,4497
SIM,1833,69,na,1902,993
STAT,1865,51,20-24,1916,6.838067590243475E-4
STAT,1891,44,25-29,1935,0.7921643277575975
STAT,1778,78,na,1856,318.51727018649996
SIM,1901,22,40-44,1923,2
SIM,1883,27,40-44,1910,3
SIM,1861,19,na,1880,2340
SIM,1909,44,na,1953,3765
STAT,1874,17,na,1891,2611.9555736754514
SIM,1828,29,25-29,1857,33
STAT,1869,22,35-39,1891,5.730199195068372
STAT,1870,22,45-49,1892,0.6915953369182981
STAT,1885,49,45-49,1934,0.23230590152406225
SIM,1884,40,40-44,1924,10
SIM,1810,96,na,1906,11
STAT,1951,18,50-100,1969,0.450610807760599
SIM,1844,37,na,1881,1652
SIM,1906,38,40-44,1944,4
STAT,1834,34,40-44,1868,3.240276924766519
STAT,1908,41,40-44,1949,0.23494822497011275
STAT,1788,108,na,1896,5.138757356774647E-4
STAT,1807,51,50-100,1858,0.052311259001142654
STAT,1907,28,40-44,1935,4.427464124311178
SIM,1888,27,na,1915,2954
STAT,1843,31,30-34,1874,14.3048022941527
STAT,1786,97,na,1883,1.007300824246696
STAT,1848,86,na,1934,181.15268462177573
STAT,1865,18,50-100,1883,0.04628607372024452
STAT,1881,22,20-24,1903,67.09082362513482
SIM,1893,23,35-39,1916,14
STAT,1823,45,20-24,1868,0.01699420080783346
STAT,1871,41,35-39,1912,1.8252359437212153
STAT,1881,54,25-29,1935,0.0033535531817838675
STAT,1943,24,45-49,1967,1.207919964344897
SIM,1931,29,35-39,1960,21
SIM,1869,29,na,1898,2373
STAT,1858,21,50-100,1879,0.3734245942778691
SIM,1902,30,45-49,1932,4
STAT,1908,36,45-49,1944,0.6474097696127773
STAT,1846,57,na,1903,1525.07858607032
SIM,1859,74,na,1933,975
STAT,1890,36,20-24,1926,0.9559304082149453
SIM,1826,32,35-39,1858,14
SIM,1862,27,20-24,1889,11
SIM,1831,29,30-34,1860,24
SIM,1930,39,30-34,1969,4
STAT,1899,43,30-34,1942,0.10986446695327988
STAT,1866,71,na,1937,1248.3490116378225
STAT,1922,39,30-34,1961,2.090609376583491
STAT,1923,29,35-39,1952,17.291817124539755
STAT,1850,43,25-29,1893,0.4881565198974805
STAT,1909,7,na,1916,3942.708034746654
SIM,1877,22,35-39,1899,10
SIM,1950,16,40-44,1966,2
STAT,1953,19,20-24,1972,165.58915682066512
STAT,1841,58,na,1899,1478.8761573405943
STAT,1866,37,40-44,1903,4.093983214422815
STAT,1942,16,40-44,1958,1.4762463651266695
STAT,1854,27,20-24,1881,9.229773051915451
SIM,1851,24,40-44,1875,4
SIM,1857,46,50-100,1903,1
SIM,1924,11,na,1935,4815
SIM,1853,73,na,1926,762
SIM,1863,17,25-29,1880,8
STAT,1855,17,25-29,1872,5.07334469084381
STAT,1862,53,45-49,1915,0.012454784049340039
STAT,1865,44,15-19,1909,0.01256428348085926
SIM,1874,41,na,1915,2256
SIM,1946,15,20-24,1961,157
STAT,1840,45,20-24,1885,0.008702845738859455
STAT,1843,24,40-44,1867,1.738900241276772
STAT,1940,21,25-29,1961,95.02654658515227
SIM,1864,38,25-29,1902,4
STAT,1823,94,na,1917,11.053569142598207
SIM,1914,46,50-100,1960,2
STAT,1876,33,35-39,1909,10.516372151360468
SIM,1867,40,40-44,1907,6
STAT,1860,31,30-34,1891,14.474116021082141
STAT,1853,39,na,1892,1928.7286725024321
STAT,1927,35,15-19,1962,0.02417387489161007
SIM,1858,27,45-49,1885,2
SIM,1892,28,45-49,1920,1
STAT,1872,48,20-24,1920,0.012031945511444856
STAT,1815,75,na,1890,445.63188462046844
SIM,1882,70,na,1952,1072
STAT,1935,24,na,1959,5020.811242757399
STAT,1944,26,50-100,1970,1.086815162945586
STAT,1850,40,20-24,1890,0.1228323742929886
SIM,1838,37,na,1875,1797
STAT,1911,30,45-49,1941,1.5583231476104533
STAT,1914,31,25-29,1945,9.425235916581833
SIM,1835,31,30-34,1866,29
STAT,1856,38,25-29,1894,2.218437263473909
SIM,1881,36,20-24,1917,1
SIM,1851,34,35-39,1885,2
STAT,1891,19,50-100,1910,0.06093473345102719
STAT,1851,49,15-19,1900,2.965510664375616E-4
SIM,1865,37,50-100,1902,1
STAT,1894,22,30-34,1916,23.16194172871561
STAT,1934,34,45-49,1968,2.1680690482690097
SIM,1868,21,30-34,1889,1
SIM,1887,15,20-24,1902,25
STAT,1924,34,35-39,1958,10.759671979787504
STAT,1932,10,na,1942,5318.192266992399
SIM,1862,56,na,1918,1853
SIM,1930,30,20-24,1960,2
SIM,1907,49,na,1956,3487
STAT,1846,42,20-24,1888,0.12197984411259237
STAT,1898,40,45-49,1938,0.1437374186015186
STAT,1932,7,na,1939,5349.050689530576
SIM,1916,33,40-44,1949,7
STAT,1936,19,20-24,1955,130.33867820402153
STAT,1840,46,35-39,1886,0.10024067898262666
SIM,1869,23,40-44,1892,2
SIM,1834,31,30-34,1865,20
SIM,1848,21,na,1869,1924
STAT,1812,61,na,1873,1059.140634891043
STAT,1869,38,20-24,1907,0.7531871788089667
STAT,1831,108,na,1939,0.0011510560394829648
SIM,1865,21,15-19,1886,3
STAT,1884,28,45-49,1912,1.1019637466966012
STAT,1912,51,na,1963,3516.7129733107886
STAT,1916,43,40-44,1959,0.2582628912999556
STAT,1834,41,30-34,1875,0.8360546113837026
SIM,1934,24,45-49,1958,1
STAT,1881,24,na,1905,2288.1153916045278
SIM,1792,66,na,1858,707
STAT,1908,12,na,1920,3867.124235802011
STAT,1893,22,30-34,1915,22.843210699736193
STAT,1877,54,35-39,1931,0.008727497158293115
STAT,1831,53,30-34,1884,0.003834951447067795
STAT,1881,46,20-24,1927,0.01171595552775621
STAT,1925,36,45-49,1961,0.8276510487455391
SIM,1811,44,40-44,1855,7
SIM,1944,19,20-24,1963,153
STAT,1921,18,30-34,1939,13.995500460464628
SIM,1893,40,35-39,1933,6
STAT,1898,44,25-29,1942,0.06023256726125921
STAT,1903,44,45-49,1947,0.14747606365916255
STAT,1812,42,40-44,1854,7.401017535090554
SIM,1909,25,45-49,1934,2
STAT,1811,54,40-44,1865,0.024089340722924343
STAT,1800,76,na,1876,335.2368724512629
STAT,1840,102,na,1942,0.2055120485171459
STAT,1899,36,40-44,1935,6.097088712663268
STAT,1920,41,40-44,1961,0.2793657865950278
STAT,1855,53,50-100,1908,0.011185626434728594
STAT,1922,30,20-24,1952,2.806529813561389
SIM,1908,34,45-49,1942,2
SIM,1870,36,45-49,1906,5
STAT,1865,34,na,1899,2181.9474082601578
SIM,1842,34,40-44,1876,6
STAT,1922,47,30-34,1969,0.1034593321545201
SIM,1825,37,45-49,1862,1
SIM,1820,42,40-44,1862,5
STAT,1866,9,na,1875,2570.0256005327465
STAT,1827,60,na,1887,1186.633951700376
STAT,1873,36,20-24,1909,0.7930783978675828
STAT,1857,21,15-19,1878,3.023765623075838
SIM,1842,41,30-34,1883,3
SIM,1847,89,na,1936,72
SIM,1889,19,na,1908,3119
STAT,1884,35,35-39,1919,7.111497804268799
SIM,1866,38,45-49,1904,3
SIM,1825,44,35-39,1869,3
SIM,1922,16,na,1938,4710
STAT,1912,42,45-49,1954,0.16194426601096257
STAT,1926,24,45-49,1950,1.3728790267585835
STAT,1864,49,25-29,1913,0.05139982646581301
SIM,1802,67,na,1869,851
SIM,1875,40,30-34,1915,4
STAT,1881,47,35-39,1928,0.13566373047875105
STAT,1824,50,20-24,1874,8.660976124808621E-4
SIM,1875,32,30-34,1907,24
STAT,1826,31,30-34,1857,26.031940572522704
STAT,1885,30,40-44,1915,4.394909911715566
SIM,1932,34,35-39,1966,18
STAT,1844,53,40-44,1897,0.008195573932675695
SIM,1837,89,na,1926,126
SIM,1850,32,25-29,1882,6
STAT,1817,44,35-39,1861,4.065279115959731
STAT,1846,16,20-24,1862,17.000969480081114
SIM,1827,90,na,1917,18
STAT,1879,78,na,1957,903.6372294099475
SIM,1845,54,na,1899,1721
STAT,1938,18,40-44,1956,1.3924601401334546
STAT,1928,18,30-34,1946,15.482851110369033
SIM,1789,84,na,1873,94
SIM,1850,53,50-100,1903,1
STAT,1830,42,na,1872,1691.917653271281
SIM,1861,21,30-34,1882,20
STAT,1858,35,40-44,1893,3.5016169172773424
STAT,1865,54,25-29,1919,0.0031768121282215542
STAT,1867,40,30-34,1907,1.1046243423599416
SIM,1816,44,40-44,1860,6
SIM,1883,31,25-29,1914,17
STAT,1870,35,40-44,1905,4.382788101526072
SIM,1892,35,35-39,1927,7
SIM,1922,31,25-29,1953,19
STAT,1885,40,35-39,1925,1.8388487006864724
STAT,1875,35,40-44,1910,4.583543405907659
STAT,1891,41,20-24,1932,0.19949081554283773
STAT,1906,45,25-29,1951,0.04827443706530127
SIM,1901,25,45-49,1926,2
STAT,1876,17,45-49,1893,0.06812111325214508
STAT,1892,27,40-44,1919,3.796515344077561
STAT,1891,54,na,1945,2618.5193215263457
STAT,1858,112,na,1970,3.2865135708850873E-4
STAT,1918,37,15-19,1955,0.020434501098975353
STAT,1853,21,30-34,1874,17.530385186130488
STAT,1928,37,25-29,1965,1.257730553152336
SIM,1772,83,na,1855,100
SIM,1870,85,na,1955,246
STAT,1842,32,25-29,1874,11.140129604230761
STAT,1875,31,25-29,1906,10.667223916292365
SIM,1861,43,40-44,1904,4
STAT,1831,47,20-24,1878,0.00896340844357016
STAT,1857,112,na,1969,2.7902683591266735E-4
STAT,1863,41,45-49,1904,1.3453881227014726
SIM,1918,29,20-24,1947,24
STAT,1840,53,25-29,1893,0.0024430415729575833
SIM,1871,41,45-49,1912,1
SIM,1885,84,na,1969,543
STAT,1921,25,20-24,1946,20.686471572830634
STAT,1941,28,40-44,1969,4.865626087692053
SIM,1882,18,na,1900,2242
SIM,1883,35,40-44,1918,1
SIM,1875,25,40-44,1900,6
STAT,1882,36,na,1918,2316.0584501704184
STAT,1920,25,na,1945,4178.003455242228
STAT,1933,18,40-44,1951,1.8871126241257974
SIM,1888,17,15-19,1905,8
STAT,1862,20,na,1882,2142.3637133411016
SIM,1897,48,na,1945,3028
STAT,1819,47,50-100,1866,0.4786387292437928
STAT,1935,30,30-34,1965,22.047293424410793
STAT,1934,35,na,1969,5254.952731768429
SIM,1941,18,40-44,1959,1
STAT,1871,51,45-49,1922,0.014631781722178962
STAT,1875,42,30-34,1917,1.1909878861585983
SIM,1871,19,25-29,1890,9
STAT,1853,22,50-100,1875,0.39845510320655303
STAT,1872,54,30-34,1926,0.005878127635384568
STAT,1841,45,50-100,1886,0.1892843758475994
STAT,1913,26,25-29,1939,66.39892258465926
SIM,1813,41,50-100,1854,1
SIM,1905,9,na,1914,3901
SIM,1875,42,40-44,1917,10
STAT,1859,16,30-34,1875,1.5118461910210887
SIM,1866,22,na,1888,2374
STAT,1873,53,20-24,1926,7.434313509039181E-4
STAT,1861,72,na,1933,1059.9225840631186
STAT,1883,33,25-29,1916,10.08077534897498
STAT,1873,53,na,1926,2169.2509999050276
STAT,1886,30,25-29,1916,11.010439299679252
SIM,1891,33,25-29,1924,20
STAT,1948,24,50-100,1972,0.7626814204789621
SIM,1867,16,30-34,1883,1
SIM,1829,54,na,1883,1449
SIM,1870,43,35-39,1913,1
SIM,1936,18,30-34,1954,17
STAT,1862,43,35-39,1905,1.5680191048405054
STAT,1877,47,45-49,1924,0.244864983105012
SIM,1779,84,na,1863,108
SIM,1782,83,na,1865,30
STAT,1906,27,na,1933,3510.82264296055
STAT,1843,27,45-49,1870,0.9216104993139898
STAT,1864,86,na,1950,202.2151083383338
SIM,1854,16,20-24,1870,25
STAT,1903,13,na,1916,3708.957563671453
SIM,1939,15,30-34,1954,25
STAT,1908,44,45-49,1952,0.15352677198344566
SIM,1944,7,na,1951,4318
STAT,1802,61,na,1863,940.6398483232389
STAT,1863,19,25-29,1882,5.203956568269162
STAT,1870,46,45-49,1916,0.23472657075044553
STAT,1939,25,50-100,1964,1.011044996926228
SIM,1842,30,25-29,1872,14
SIM,1883,42,30-34,1925,3
STAT,1817,60,na,1877,1048.488100698962
STAT,1896,26,na,1922,3201.5427936715637
SIM,1942,23,40-44,1965,4
STAT,1808,51,30-34,1859,0.020570513277532374
STAT,1927,15,45-49,1942,0.6307100644380225
SIM,1815,39,40-44,1854,7
SIM,1868,7,na,1875,2609
STAT,1871,5,na,1876,2790.610977993567
SIM,1921,38,50-100,1959,1
STAT,1825,58,na,1883,1546.0570825195703
STAT,1873,28,50-100,1901,0.6526816034010924
STAT,1934,23,40-44,1957,4.564227193628212
STAT,1936,29,30-34,1965,37.81980364666035
STAT,1946,16,25-29,1962,48.55909285076101
SIM,1876,32,30-34,1908,35
SIM,1848,37,na,1885,1820
STAT,1899,46,35-39,1945,0.10977750847774337
STAT,1921,26,50-100,1947,1.124235379309945
STAT,1867,42,40-44,1909,2.1369263422133464
STAT,1868,32,30-34,1900,16.85370584655385
SIM,1899,28,45-49,1927,3
STAT,1914,37,30-34,1951,1.836008195720722
STAT,1841,27,25-29,1868,39.29047842952527
STAT,1834,30,25-29,1864,7.977574336482452
STAT,1925,19,45-49,1944,0.6065784550343096
SIM,1954,16,25-29,1970,61
STAT,1831,58,na,1889,1245.7020740243668
STAT,1833,29,40-44,1862,2.763455798465233
SIM,1906,34,25-29,1940,11
STAT,1841,17,50-100,1858,0.0472519014048495
STAT,1888,52,na,1940,2553.2218481574264
SIM,1836,32,50-100,1868,2
SIM,1895,17,20-24,1912,25
STAT,1918,12,na,1930,4353.980553370968
STAT,1885,46,40-44,1931,0.17260248147430737
STAT,1817,37,45-49,1854,7.550442237610486
STAT,1821,75,na,1896,616.6394749229163
STAT,1858,86,na,1944,175.81171110408033
STAT,1886,20,50-100,1906,0.43745948874356927
STAT,1801,105,na,1906,0.011669053534035209
STAT,1900,70,na,1970,2347.5306180138523
SIM,1924,43,40-44,1967,2
STAT,1849,52,30-34,1901,0.004629242319332322
STAT,1821,35,45-49,1856,4.362484242723693
STAT,1890,46,15-19,1936,2.7925818166526676E-4
STAT,1936,36,20-24,1972,0.2615055686774355
SIM,1851,19,na,1870,2317
SIM,1918,39,30-34,1957,6
STAT,1926,10,na,1936,4924.6060021816465
STAT,1894,21,na,1915,3084.641117917769
STAT,1859,43,45-49,1902,1.2069915803233635
SIM,1892,60,na,1952,2564
SIM,1935,31,35-39,1966,21
STAT,1816,42,25-29,1858,1.8424546534210853
STAT,1856,57,na,1913,1556.1502451194485
STAT,1887,17,20-24,1904,19.99150659727166
STAT,1944,27,15-19,1971,0.7704779948465971
SIM,1941,29,45-49,1970,2
STAT,1827,31,30-34,1858,24.536340988963403
SIM,1867,43,45-49,1910,3
STAT,1908,33,40-44,1941,3.713076569989387
SIM,1820,96,na,1916,1
SIM,1921,26,25-29,1947,11
STAT,1893,30,30-34,1923,22.571048350007235
SIM,1895,29,50-100,1924,4
SIM,1841,29,40-44,1870,2
STAT,1893,32,40-44,1925,5.561585115916767
STAT,1914,44,20-24,1958,0.017597197860745564
STAT,1890,39,25-29,1929,3.517629060593755
STAT,1926,41,45-49,1967,0.20766054974170428
STAT,1871,40,40-44,1911,2.279751550506771
STAT,1764,102,na,1866,0.04354722032418888
STAT,1901,15,40-44,1916,0.2601678433370091
SIM,1936,30,na,1966,3864
SIM,1887,26,50-100,1913,1
SIM,1904,35,na,1939,3631
STAT,1933,29,45-49,1962,2.3157413715912893
SIM,1849,74,na,1923,924
STAT,1885,20,30-34,1905,18.01420570981832
SIM,1828,26,20-24,1854,7
SIM,1834,41,40-44,1875,6
SIM,1867,35,na,1902,2141
SIM,1923,4,na,1927,4820
SIM,1919,34,na,1953,3985
STAT,1927,31,35-39,1958,11.368665873299353
STAT,1859,50,35-39,1909,0.007093943798112229
SIM,1893,20,30-34,1913,26
STAT,1876,71,na,1947,1391.9873999413564
SIM,1854,37,na,1891,2179
SIM,1859,32,50-100,1891,1
STAT,1821,42,35-39,1863,2.8871987711589653
SIM,1929,18,25-29,1947,81
SIM,1866,18,na,1884,2640
STAT,1926,41,na,1967,4634.0032132749075
STAT,1823,48,25-29,1871,0.07815942962177909
SIM,1850,62,na,1912,1527
STAT,1843,34,35-39,1877,8.04265626083581
STAT,1897,39,25-29,1936,0.8330099385867544
SIM,1852,31,30-34,1883,4
SIM,1873,35,na,1908,2278
SIM,1899,40,na,1939,3534
SIM,1840,19,30-34,1859,4
STAT,1869,52,35-39,1921,0.008408735167710188
STAT,1921,32,45-49,1953,1.768620167474895
STAT,1840,35,na,1875,1813.028034845012
STAT,1903,41,40-44,1944,0.2256885814419111
STAT,1906,42,20-24,1948,0.016203800418480428
STAT,1941,14,na,1955,4083.3646748516117
STAT,1838,93,na,1931,19.564252346308034
STAT,1783,86,na,1869,72.43321577218568
SIM,1920,20,35-39,1940,22
SIM,1837,20,40-44,1857,1
SIM,1883,55,na,1938,2234
STAT,1876,50,35-39,1926,0.009106912764035269
SIM,1919,31,50-100,1950,5
SIM,1913,30,50-100,1943,4
STAT,1949,20,30-34,1969,33.90499672460815
STAT,1931,31,25-29,1962,12.246954923546694
SIM,1908,31,40-44,1939,3
STAT,1839,38,25-29,1877,2.4141479247913327
STAT,1883,37,40-44,1920,4.326598294622391
STAT,1808,47,45-49,1855,0.8619378544847262
STAT,1802,95,na,1897,4.645238850892177
STAT,1874,21,15-19,1895,3.422116886252968
SIM,1891,37,40-44,1928,4
SIM,1847,38,25-29,1885,8
STAT,1860,20,25-29,1880,54.317767356509265
STAT,1860,34,35-39,1894,8.289589606985414
SIM,1870,33,40-44,1903,10
STAT,1879,26,50-100,1905,0.6765494634717278
SIM,1891,16,25-29,1907,7
STAT,1913,45,30-34,1958,0.08820348529276056
STAT,1839,24,15-19,1863,2.9622327109003956
STAT,1897,17,15-19,1914,8.035730705215917
SIM,1906,64,na,1970,2757
STAT,1816,46,40-44,1862,0.44936602607015447
STAT,1814,53,30-34,1867,0.013437217931661923
STAT,1892,23,25-29,1915,72.32771142307541
STAT,1844,31,30-34,1875,16.691482984391662
STAT,1869,85,na,1954,269.188631061142
STAT,1913,45,15-19,1958,3.644769048363226E-4
SIM,1889,1,na,1890,3341
STAT,1840,48,25-29,1888,0.04019854406503429
STAT,1945,14,na,1959,4331.88640261654
STAT,1872,32,20-24,1904,2.744742306100889
STAT,1922,45,40-44,1967,0.18383885814865955
STAT,1824,39,50-100,1863,1.6027761578272937
STAT,1891,42,50-100,1933,1.3194435911511972
SIM,1944,25,15-19,1969,3
SIM,1887,55,na,1942,2206
SIM,1941,24,35-39,1965,17
STAT,1841,102,na,1943,0.21924052057683746
STAT,1936,25,15-19,1961,0.6826686609100148
STAT,1924,24,25-29,1948,109.4504826648693
STAT,1933,3,na,1936,5486.721278193773
SIM,1932,24,25-29,1956,183
STAT,1825,32,25-29,1857,24.29008138191801
STAT,1834,44,35-39,1878,1.2671954123690539
STAT,1830,26,20-24,1856,13.66990764217678
SIM,1871,39,30-34,1910,7
STAT,1846,26,na,1872,2000.3815434266191
SIM,1902,64,na,1966,2836
STAT,1861,50,50-100,1911,0.012857588737638507
STAT,1856,20,na,1876,1950.7969342186639
SIM,1782,76,na,1858,175
STAT,1853,43,40-44,1896,1.8466613961530731
SIM,1833,32,25-29,1865,17
SIM,1906,30,na,1936,3433
STAT,1932,32,20-24,1964,3.27681864547713
SIM,1798,61,na,1859,952
SIM,1927,25,na,1952,4972
STAT,1827,53,na,1880,1363.0331162030957
SIM,1906,5,na,1911,3765
STAT,1867,43,35-39,1910,1.7100429147938518
SIM,1851,44,45-49,1895,5
STAT,1798,102,na,1900,0.09754730398414276
STAT,1864,48,na,1912,2024.7117252797009
SIM,1851,23,na,1874,2068
SIM,1930,37,50-100,1967,1
STAT,1858,52,40-44,1910,0.008297559633317323
SIM,1769,94,na,1863,7
SIM,1879,27,15-19,1906,4
STAT,1851,75,na,1926,779.4961184745166
STAT,1912,28,30-34,1940,38.819219590937706
SIM,1884,43,45-49,1927,3
STAT,1814,80,na,1894,289.5403362032348
STAT,1926,40,30-34,1966,0.15973023363881675
STAT,1848,90,na,1938,64.37004699523543
SIM,1930,38,35-39,1968,6
STAT,1840,50,20-24,1890,5.247058026094437E-4
SIM,1862,94,na,1956,13
SIM,1883,38,45-49,1921,3
SIM,1913,49,na,1962,3555
STAT,1848,31,15-19,1879,0.13700671656033309
STAT,1926,21,40-44,1947,4.140888603241731
STAT,1922,38,35-39,1960,2.777573803511089
SIM,1813,83,na,1896,173
STAT,1773,105,na,1878,0.021387883724548286
SIM,1937,18,15-19,1955,47
STAT,1919,47,25-29,1966,0.05809181517110122
SIM,1794,61,na,1855,901
STAT,1851,22,25-29,1873,51.76319431031511
STAT,1876,43,45-49,1919,1.5494860604696377
STAT,1912,20,35-39,1932,9.158424896056747
SIM,1880,32,20-24,1912,2
STAT,1827,53,40-44,1880,0.010220674769170714
STAT,1904,33,20-24,1937,2.24014426903769
SIM,1882,18,25-29,1900,8
SIM,1920,27,50-100,1947,1
STAT,1904,47,30-34,1951,0.07877402526079995
STAT,1843,44,45-49,1887,1.0130351968943858
STAT,1875,38,45-49,1913,2.0574235809914856
STAT,1894,44,40-44,1938,0.2003634735997275
SIM,1912,33,20-24,1945,2
SIM,1837,80,na,1917,261
STAT,1837,52,20-24,1889,5.052479182664379E-4
STAT,1870,21,30-34,1891,17.719348215555218
STAT,1880,36,50-100,1916,1.308547580054711
STAT,1840,43,30-34,1883,0.8299727858837241
STAT,1882,27,50-100,1909,0.6258414917710121
SIM,1807,76,na,1883,457
SIM,1895,74,na,1969,1940
STAT,1834,25,50-100,1859,0.5068179345085191
STAT,1846,51,50-100,1897,0.011516086007940652
SIM,1915,34,35-39,1949,18
STAT,1840,32,na,1872,1850.396130410958
STAT,1852,20,na,1872,1954.2749688347685
STAT,1882,67,na,1949,1550.8940084724882
STAT,1916,47,na,1963,3802.6798673519415
SIM,1919,18,30-34,1937,20
STAT,1891,15,20-24,1906,22.272142941135495
STAT,1842,36,40-44,1878,4.671603566691415
STAT,1837,53,na,1890,1445.2631109253389
STAT,1853,39,20-24,1892,0.631058047075196
SIM,1920,28,30-34,1948,69
STAT,1895,37,na,1932,3107.447596848279
SIM,1921,37,na,1958,4106
STAT,1795,71,na,1866,697.1035298753978
STAT,1907,34,35-39,1941,8.55107008528657
STAT,1833,60,na,1893,1349.3215307713776
STAT,1874,48,na,1922,2297.5260687376253
SIM,1894,38,20-24,1932,1
SIM,1779,94,na,1873,4
SIM,1782,73,na,1855,274
SIM,1850,36,40-44,1886,14
STAT,1935,27,50-100,1962,1.3708141281066692
STAT,1886,38,20-24,1924,0.8179505991707402
STAT,1905,41,25-29,1946,0.06540425809966435
STAT,1865,28,25-29,1893,38.875414467194126
STAT,1863,35,15-19,1898,0.050729393408827865
SIM,1868,88,na,1956,63
STAT,1819,47,20-24,1866,0.023386258055098662
STAT,1839,15,50-100,1854,0.045977017710890376
STAT,1862,40,30-34,1902,1.012882225064552
STAT,1918,39,20-24,1957,0.27991276549151045
SIM,1849,16,na,1865,2333
SIM,1868,82,na,1950,287
STAT,1930,23,20-24,1953,143.53056472776083
STAT,1873,16,15-19,1889,6.112445633314094
SIM,1878,17,20-24,1895,21
STAT,1887,43,20-24,1930,0.17779120267142876
STAT,1808,54,35-39,1862,0.02796917380339913
SIM,1834,42,35-39,1876,8
STAT,1937,18,50-100,1955,0.36699270470789686
SIM,1858,40,30-34,1898,4
STAT,1954,0,na,1954,5305.368198838664
SIM,1887,48,na,1935,2404
STAT,1884,45,45-49,1929,0.23739821632831437
STAT,1879,15,20-24,1894,18.77268623374612
STAT,1893,33,35-39,1926,12.932562799837264
SIM,1889,40,na,1929,2811
STAT,1929,18,15-19,1947,58.38735631403301
SIM,1946,18,40-44,1964,1
STAT,1850,35,na,1885,1871.0274482309962
STAT,1845,37,20-24,1882,0.5918000688189152
STAT,1895,40,50-100,1935,1.4074814708149979
STAT,1898,22,15-19,1920,4.517052626016949
STAT,1910,25,45-49,1935,1.708932988955077
SIM,1843,42,45-49,1885,4
SIM,1890,37,na,1927,3189
SIM,1848,68,na,1916,1133
SIM,1837,90,na,1927,102
SIM,1821,40,35-39,1861,4
SIM,1881,16,15-19,1897,9
SIM,1843,80,na,1923,553
STAT,1840,42,na,1882,1690.0532205435238
STAT,1846,20,na,1866,2031.1175649997997
STAT,1833,54,50-100,1887,0.01062344509246247
STAT,1815,68,na,1883,771.2271928247433
STAT,1912,35,20-24,1947,0.26204106801730315
SIM,1909,45,50-100,1954,2
SIM,1879,29,na,1908,2862
STAT,1878,46,15-19,1924,4.2057225802023124E-4
SIM,1899,43,na,1942,3486
STAT,1880,31,35-39,1911,10.785783360857156
STAT,1862,47,15-19,1909,3.472612945944463E-4
STAT,1920,22,na,1942,4099.706170696554
STAT,1927,22,50-100,1949,0.8193969652421264
SIM,1866,0,na,1866,3510
STAT,1890,30,15-19,1920,0.17716670819484415
STAT,1842,53,50-100,1895,0.01337920710399939
STAT,1820,80,na,1900,314.8792939539488
SIM,1914,29,35-39,1943,27
SIM,1907,32,35-39,1939,13
STAT,1820,105,na,1925,0.014924874804942102
STAT,1863,39,30-34,1902,4.721382887685201
SIM,1905,17,25-29,1922,14
STAT,1858,45,35-39,1903,0.11204008736372142
STAT,1906,29,35-39,1935,14.093120945539301
SIM,1919,37,na,1956,3965
STAT,1822,48,50-100,1870,0.35907490241797707
SIM,1885,44,40-44,1929,7
SIM,1874,30,20-24,1904,3
STAT,1812,50,45-49,1862,0.03334480141444935
STAT,1871,27,20-24,1898,11.771622227750692
SIM,1868,41,na,1909,2114
STAT,1842,15,25-29,1857,6.629442288872457
STAT,1877,44,40-44,1921,2.3130485707449946
SIM,1903,28,30-34,1931,36
STAT,1832,51,25-29,1883,0.0025665359457656056
SIM,1877,55,na,1932,2168
STAT,1915,19,35-39,1934,0.881429640480092
STAT,1909,40,30-34,1949,0.12203455283313985
STAT,1877,51,30-34,1928,0.006234765330559421
STAT,1844,93,na,1937,23.122669699706794
STAT,1900,45,50-100,1945,0.19630935724437526
SIM,1831,95,na,1926,2
SIM,1862,41,35-39,1903,7
SIM,1856,56,na,1912,1844
STAT,1852,33,30-34,1885,13.568172270234706
STAT,1878,53,20-24,1931,7.612529181233596E-4
STAT,1906,46,50-100,1952,0.20438362920105993
STAT,1925,16,40-44,1941,1.711771314775892
STAT,1865,92,na,1957,49.408391183743305
STAT,1827,49,20-24,1876,0.011986205500833349
STAT,1889,32,15-19,1921,0.17735369013021599
STAT,1921,47,30-34,1968,0.10149817734898517
STAT,1864,40,15-19,1904,0.012713099898148726
STAT,1857,47,40-44,1904,0.13431829731352266
SIM,1933,16,40-44,1949,3
STAT,1837,22,40-44,1859,1.8609927451281727
STAT,1847,26,15-19,1873,0.4112595822914288
SIM,1845,22,40-44,1867,2
STAT,1806,61,na,1867,943.5914818151825
SIM,1900,23,35-39,1923,9
STAT,1853,51,45-49,1904,0.012058848080254763
SIM,1939,10,na,1949,4098
STAT,1852,42,45-49,1894,1.133642438558303
SIM,1860,33,30-34,1893,26
STAT,1932,19,35-39,1951,5.584989740200548
STAT,1902,40,45-49,1942,0.14983155297707934
STAT,1838,16,50-100,1854,0.04357711843477245
STAT,1826,42,35-39,1868,1.8892831165584931
SIM,1940,19,35-39,1959,4
SIM,1844,75,na,1919,711
STAT,1837,45,15-19,1882,2.906233931587622E-4
STAT,1841,53,25-29,1894,0.0026062399266162236
SIM,1923,19,35-39,1942,8
SIM,1843,90,na,1933,87
SIM,1864,16,15-19,1880,9
STAT,1870,51,45-49,1921,0.014462107804027647
STAT,1862,37,20-24,1899,0.6723500501131292
SIM,1899,33,na,1932,3584
STAT,1868,54,40-44,1922,0.009882788965346986
STAT,1817,54,45-49,1871,0.02870994293470621
STAT,1876,33,na,1909,2478.045967140875
STAT,1909,62,na,1971,3100.864434354464
STAT,1930,37,30-34,1967,2.4027962063732953
SIM,1874,37,40-44,1911,8
STAT,1950,2,na,1952,4777.653973406204
STAT,1861,32,45-49,1893,1.4635552940572554
SIM,1869,27,20-24,1896,11
SIM,1876,70,na,1946,1410
STAT,1916,46,45-49,1962,0.22552301035455302
STAT,1905,43,15-19,1948,0.0013900928831753903
STAT,1831,31,20-24,1862,2.2641976065543195
STAT,1856,16,15-19,1872,5.465951565985264
STAT,1907,33,na,1940,3554.4869664404673
STAT,1820,40,50-100,1860,2.13505711740403
STAT,1931,33,15-19,1964,0.17007082003691418
STAT,1826,43,30-34,1869,1.1757333657041402
STAT,1854,49,30-34,1903,0.07113028334881354
SIM,1949,1,na,1950,4529
STAT,1826,46,50-100,1872,0.24533053935614438
STAT,1912,18,20-24,1930,27.586338831654967
SIM,1834,46,50-100,1880,2
SIM,1838,68,na,1906,1274
STAT,1821,46,15-19,1867,5.948206832322313E-4
SIM,1873,28,25-29,1901,45
SIM,1927,2,na,1929,5557
STAT,1923,42,20-24,1965,0.02085580036152771
SIM,1966,0,na,1966,5085
STAT,1925,22,35-39,1947,11.39041573928245
SIM,1825,61,na,1886,922
SIM,1851,20,25-29,1871,53
SIM,1920,18,20-24,1938,5
STAT,1922,48,45-49,1970,0.25153434676567044
STAT,1920,15,na,1935,4410.637572609752
SIM,1878,21,40-44,1899,3
STAT,1853,46,45-49,1899,0.1957205751357006
STAT,1893,34,30-34,1927,22.19936241451909
STAT,1868,43,50-100,1911,1.012416677102314
SIM,1903,12,na,1915,3531
SIM,1933,22,35-39,1955,13
STAT,1917,31,40-44,1948,4.1532508360069045
STAT,1923,29,na,1952,4314.616458589024
STAT,1800,66,na,1866,687.240026510361
STAT,1877,40,25-29,1917,0.6761539484706067
STAT,1790,65,na,1855,684.014
STAT,1867,40,15-19,1907,0.01326876180966671
STAT,1943,18,50-100,1961,0.4010283588089062
STAT,1903,30,35-39,1933,14.683996909471249
SIM,1822,91,na,1913,18
STAT,1919,44,20-24,1963,0.019259133530194088
STAT,1892,20,20-24,1912,87.85937037212078
SIM,1922,2,na,1924,5288
SIM,1876,43,50-100,1919,1
SIM,1925,31,40-44,1956,13
STAT,1904,1,na,1905,3945.12446132503
STAT,1823,39,na,1862,1555.869766027955
SIM,1865,26,25-29,1891,50
STAT,1833,87,na,1920,124.64715734368382
SIM,1813,76,na,1889,435
SIM,1912,36,25-29,1948,1
STAT,1860,89,na,1949,86.73497754951127
SIM,1938,23,15-19,1961,5
STAT,1821,105,na,1926,0.017562845287615873
SIM,1903,24,15-19,1927,6
STAT,1816,49,45-49,1865,0.5923079814609283
STAT,1843,41,40-44,1884,1.582129513614261
STAT,1901,18,45-49,1919,0.0922450377042618
STAT,1836,32,50-100,1868,0.7306097608365641
SIM,1829,61,na,1890,1205
STAT,1904,36,25-29,1940,0.9050757824267125
STAT,1913,48,35-39,1961,0.12661645904050164
SIM,1852,94,na,1946,1
STAT,1852,23,50-100,1875,0.36475442778774225
STAT,1815,65,na,1880,862.5065623844748
STAT,1853,53,35-39,1906,0.007005178855588992
STAT,1905,48,na,1953,3244.3120106284073
STAT,1943,21,40-44,1964,3.6132802340965666
SIM,1814,40,50-100,1854,4
STAT,1806,54,na,1860,1102.8583148208288
STAT,1895,47,na,1942,2954.1722978673165
STAT,1926,0,na,1926,5582.424887325929
STAT,1772,84,na,1856,74.01121337
STAT,1830,40,35-39,1870,1.618429993603767
STAT,1835,42,45-49,1877,1.3464692317537987
STAT,1854,45,15-19,1899,3.0318718158790515E-4
SIM,1839,16,na,1855,2029
SIM,1937,25,na,1962,3434
STAT,1884,21,25-29,1905,57.18848042935883
STAT,1861,48,45-49,1909,0.19558134990715845
SIM,1860,32,35-39,1892,1
SIM,1817,76,na,1893,466
SIM,1839,36,25-29,1875,3
SIM,1873,25,20-24,1898,12
STAT,1882,51,20-24,1933,7.25395852007782E-4
STAT,1820,47,45-49,1867,0.40138064325766715
SIM,1918,48,na,1966,4124
STAT,1896,7,na,1903,3483.155916912476
STAT,1842,39,45-49,1881,1.8765731697816488
STAT,1816,54,na,1870,1355.3262492401334
STAT,1872,74,na,1946,1126.9024974491317
SIM,1850,39,45-49,1889,1
STAT,1828,38,na,1866,1784.6270636016231
SIM,1903,49,na,1952,2925
SIM,1893,55,na,1948,2642
STAT,1777,83,na,1860,95.73004126750001
STAT,1898,35,50-100,1933,1.6970011609251132
SIM,1832,27,25-29,1859,38
SIM,1848,23,20-24,1871,83
STAT,1813,48,30-34,1861,0.2765710156100897
STAT,1873,52,25-29,1925,0.00360739410022096
STAT,1893,30,15-19,1923,0.1840975096502004
SIM,1858,43,35-39,1901,1
SIM,1825,30,25-29,1855,11
SIM,1907,26,40-44,1933,9
STAT,1852,32,35-39,1884,7.952018362066889
STAT,1926,43,35-39,1969,0.2504942882405095
STAT,1849,48,45-49,1897,0.18219881685756287
STAT,1822,34,15-19,1856,0.31811071736302965
SIM,1834,43,30-34,1877,1
STAT,1875,45,35-39,1920,0.1466581341606618
SIM,1900,38,na,1938,3470
SIM,1902,19,15-19,1921,12
STAT,1787,83,na,1870,112.97567384242716
SIM,1820,62,na,1882,976
STAT,1801,55,na,1856,1161.0860803133846
STAT,1880,39,30-34,1919,5.596242769590102
SIM,1832,43,na,1875,1546
SIM,1860,23,50-100,1883,1
STAT,1951,14,na,1965,4724.27619001048
STAT,1938,28,na,1966,3744.9170046611816
STAT,1865,102,na,1967,1.67177389965362
STAT,1898,27,25-29,1925,57.919476353911556
STAT,1918,41,35-39,1959,0.21645760752549106
SIM,1823,76,na,1899,554
SIM,1791,87,na,1878,22
STAT,1858,42,30-34,1900,0.9098601150084421
SIM,1853,42,na,1895,1763
STAT,1860,27,45-49,1887,0.926517848964474
STAT,1883,16,25-29,1899,5.61458769528204
SIM,1943,25,na,1968,3991
STAT,1886,33,na,1919,2534.0065749124064
STAT,1938,18,25-29,1956,43.14139720073495
SIM,1922,26,na,1948,4731
SIM,1884,30,30-34,1914,22
SIM,1870,82,na,1952,427
SIM,1802,77,na,1879,361
SIM,1874,33,25-29,1907,17
STAT,1887,18,na,1905,2840.527785645884
STAT,1931,37,30-34,1968,2.439463017244454
STAT,1855,54,30-34,1909,0.004357394309348802
STAT,1859,42,30-34,1901,0.9327666018670141
STAT,1849,46,50-100,1895,0.1925682595442158
SIM,1892,42,40-44,1934,5
STAT,1774,105,na,1879,0.013347901573298137
SIM,1892,21,25-29,1913,80
STAT,1817,39,na,1856,1398.7822130840855
STAT,1889,47,na,1936,2789.394381502969
STAT,1948,15,30-34,1963,14.098536747862093
SIM,1912,23,na,1935,3829
STAT,1884,42,40-44,1926,2.2375093600652036
SIM,1892,34,50-100,1926,1
STAT,1831,47,50-100,1878,0.18345108554842732
SIM,1770,88,na,1858,26
SIM,1820,58,na,1878,1137
STAT,1891,18,25-29,1909,7.067554700437805
STAT,1930,26,25-29,1956,84.62897832898894
SIM,1866,42,30-34,1908,3
SIM,1955,10,na,1965,5055
SIM,1946,18,25-29,1964,62
STAT,1893,33,50-100,1926,1.1700726688758485
STAT,1809,52,45-49,1861,0.04661075292636574
STAT,1876,30,30-34,1906,18.354099490474827
STAT,1879,18,25-29,1897,5.957082225173266
STAT,1812,52,35-39,1864,0.019004720444449463
SIM,1888,39,25-29,1927,3
SIM,1855,16,na,1871,2409
STAT,1870,31,25-29,1901,10.200008577726642
STAT,1922,35,30-34,1957,2.098698687366032
SIM,1792,76,na,1868,289
STAT,1845,31,50-100,1876,0.8043327184358845
SIM,1851,57,na,1908,1615
STAT,1834,79,na,1913,416.1273777338924
STAT,1859,17,45-49,1876,0.06159594718822074
SIM,1876,15,na,1891,2899
SIM,1871,71,na,1942,1189
STAT,1838,38,na,1876,1712.2050805185859
STAT,1933,29,na,1962,5021.449981945149
STAT,1898,48,40-44,1946,0.13056451491616725
SIM,1833,28,na,1861,1953
STAT,1907,17,35-39,1924,0.8138606911276639
STAT,1852,28,50-100,1880,0.5610025610730262
STAT,1884,34,50-100,1918,0.9047628806444903
STAT,1916,29,45-49,1945,1.7897834959649335
SIM,1819,42,50-100,1861,3
STAT,1841,50,20-24,1891,5.597568324768277E-4
STAT,1866,23,30-34,1889,16.674061223974395
SIM,1892,70,na,1962,2118
STAT,1935,14,na,1949,5454.926892991588
SIM,1875,44,30-34,1919,1
STAT,1924,44,50-100,1968,0.1407369166468882
SIM,1842,44,35-39,1886,6
STAT,1875,92,na,1967,139.99789940398085
STAT,1867,44,30-34,1911,1.0788282214263263
STAT,1850,17,25-29,1867,5.30230156225824
STAT,1885,32,30-34,1917,17.55291256951204
STAT,1856,19,na,1875,2077.053280994847
SIM,1819,61,na,1880,1049
STAT,1830,80,na,1910,408.1126051190447
SIM,1923,16,30-34,1939,19
STAT,1881,44,30-34,1925,1.1041691368784619
SIM,1884,41,na,1925,2362
STAT,1845,54,20-24,1899,5.243600993190688E-4
SIM,1844,32,50-100,1876,4
STAT,1871,34,na,1905,2373.981676508393
SIM,1886,26,45-49,1912,2
STAT,1915,16,30-34,1931,2.5804700668001397
STAT,1899,32,25-29,1931,14.197805022344367
STAT,1905,47,30-34,1952,0.07935434959774279
SIM,1776,80,na,1856,137
SIM,1886,70,na,1956,1633
SIM,1937,16,25-29,1953,81
STAT,1796,97,na,1893,1.1254920910695367
STAT,1881,49,25-29,1930,0.05490651714089358
STAT,1910,2,na,1912,4075.2266796203057
SIM,1945,6,na,1951,4250
SIM,1830,31,50-100,1861,4
STAT,1825,68,na,1893,1115.2157817139887
STAT,1902,23,45-49,1925,0.9921838756778534
STAT,1902,34,na,1936,3405.4499180795565
STAT,1857,26,25-29,1883,34.593068393006675
SIM,1910,23,45-49,1933,6
SIM,1819,35,45-49,1854,1
STAT,1914,15,na,1929,4049.7310299340234
SIM,1851,41,40-44,1892,5
STAT,1907,24,25-29,1931,84.3767457071285
STAT,1854,93,na,1947,21.933265256352364
SIM,1881,23,na,1904,2052
STAT,1904,63,na,1967,2853.664593746745
STAT,1835,45,50-100,1880,0.21914513115663103
STAT,1864,45,50-100,1909,0.22606824557215408
STAT,1775,98,na,1873,0.41520813766693276
STAT,1928,19,50-100,1947,0.4745984671306282
STAT,1942,19,45-49,1961,0.5267300052398749
SIM,1826,41,30-34,1867,2
STAT,1862,50,40-44,1912,0.009314385009800884
SIM,1889,24,20-24,1913,90
STAT,1933,24,35-39,1957,12.612493416000476
STAT,1894,20,50-100,1914,0.5334281499725984
STAT,1817,51,40-44,1868,0.022114830274823045
SIM,1841,57,na,1898,1404
STAT,1881,51,20-24,1932,7.218501566648154E-4
STAT,1913,40,20-24,1953,0.017573492383050934
STAT,1929,16,25-29,1945,56.03611719456379
STAT,1798,105,na,1903,0.009755785847442057
SIM,1843,45,50-100,1888,2
STAT,1917,33,na,1950,3980.721366785015
STAT,1781,98,na,1879,0.3355304638698738
SIM,1893,32,30-34,1925,38
STAT,1845,51,35-39,1896,0.006320617148008792
SIM,1934,11,na,1945,5544
SIM,1949,10,na,1959,4420
SIM,1915,24,25-29,1939,102
STAT,1818,41,30-34,1859,2.3344206071938536
STAT,1927,39,30-34,1966,2.2854768981626683
STAT,1833,94,na,1927,14.140065233852944
SIM,1913,12,na,1925,4071
STAT,1863,60,na,1923,1706.7155739654224
STAT,1925,33,40-44,1958,4.6934754432453
STAT,1793,79,na,1872,274.47937649289696
SIM,1933,33,40-44,1966,1
STAT,1834,37,45-49,1871,1.4767371445137758
SIM,1863,42,na,1905,2094
STAT,1843,20,25-29,1863,49.16736372856972
SIM,1956,15,30-34,1971,15
STAT,1866,29,50-100,1895,0.5939852734531421
STAT,1928,42,50-100,1970,0.15137709206857142
STAT,1878,26,45-49,1904,1.1680975004365275
STAT,1910,43,50-100,1953,0.11134498448889361
STAT,1877,18,na,1895,2625.8529173091324
STAT,1889,15,15-19,1904,7.4251940658163615
STAT,1946,20,15-19,1966,5.987040264152556
STAT,1824,49,35-39,1873,0.15936997086341456
STAT,1917,26,na,1943,3979.1497490559964
SIM,1855,53,na,1908,1819
STAT,1903,2,na,1905,3834.3206064975034
SIM,1902,24,45-49,1926,4
SIM,1864,27,50-100,1891,1
SIM,1860,44,40-44,1904,3
STAT,1777,102,na,1879,0.06319521685454871
STAT,1882,45,35-39,1927,0.13833417828131694
SIM,1903,17,15-19,1920,8
STAT,1845,51,40-44,1896,0.007729211808883445
SIM,1844,28,20-24,1872,12
STAT,1863,31,35-39,1894,9.099643294059717
SIM,1859,43,na,1902,2133
STAT,1780,97,na,1877,0.831300285195351
STAT,1889,48,25-29,1937,0.03995591165192589
STAT,1913,12,na,1925,4074.0939126932335
STAT,1784,87,na,1871,48.03132446580786
SIM,1857,15,25-29,1872,15
SIM,1896,75,na,1971,1812
STAT,1829,47,15-19,1876,2.9843011863241436E-4
STAT,1771,101,na,1872,0.10534090805488366
STAT,1849,28,30-34,1877,23.171344916656885
STAT,1841,46,30-34,1887,0.0736542317046328
SIM,1837,40,na,1877,1563
STAT,1937,35,20-24,1972,0.2665741084475321
STAT,1840,28,40-44,1868,2.599411793183483
STAT,1851,39,50-100,1890,0.920275503279906
STAT,1850,20,15-19,1870,3.075980218462869
STAT,1955,15,15-19,1970,60.897391127292046
STAT,1839,94,na,1933,14.169586899669088
STAT,1840,17,30-34,1857,1.4465770068975026
STAT,1878,45,15-19,1923,4.235626100471643E-4
STAT,1815,54,35-39,1869,0.017531418967563234
STAT,1836,28,20-24,1864,9.507506840086364
STAT,1798,95,na,1893,4.423787734094552
STAT,1828,54,45-49,1882,0.01116585119547568
STAT,1804,53,20-24,1857,0.0019584217003353645
STAT,1809,72,na,1881,658.5904950787459
SIM,1842,27,na,1869,2074
STAT,1882,8,na,1890,2543.259735443386
STAT,1850,31,25-29,1881,8.290100011813584
SIM,1855,18,25-29,1873,9
STAT,1911,21,40-44,1932,3.2268755464366174
SIM,1847,58,na,1905,1423
SIM,1900,27,45-49,1927,2
STAT,1824,41,25-29,1865,0.8146260636135964
STAT,1857,34,15-19,1891,0.11129098429363846
STAT,1939,32,20-24,1971,2.512445552073011
SIM,1880,21,35-39,1901,7
STAT,1893,48,45-49,1941,0.16857815129303522
STAT,1792,82,na,1874,160.87603900209422
STAT,1866,15,50-100,1881,0.047588215719579705
STAT,1905,17,na,1922,3687.62892557477
STAT,1871,55,na,1926,2074.7938482946706
STAT,1929,11,na,1940,5118.631661334462
SIM,1806,76,na,1882,421
SIM,1857,26,35-39,1883,17
STAT,1915,0,na,1915,4742.273279837048
STAT,1884,42,35-39,1926,1.8013409962152278
SIM,1848,22,20-24,1870,58
STAT,1843,54,40-44,1897,0.006905299766285959
STAT,1849,15,25-29,1864,5.518468705042184
SIM,1878,39,30-34,1917,8
STAT,1842,25,40-44,1867,3.3836715367593233
SIM,1874,23,30-34,1897,23
SIM,1850,25,40-44,1875,4
SIM,1892,42,35-39,1934,7
STAT,1876,48,15-19,1924,4.1189548716052694E-4
STAT,1875,18,30-34,1893,1.6488579030816397
STAT,1953,18,15-19,1971,55.449676055036726
SIM,1825,55,na,1880,1073
STAT,1843,43,30-34,1886,0.7882132402213695
STAT,1892,19,45-49,1911,0.08234440614522899
SIM,1873,31,45-49,1904,1
SIM,1850,22,na,1872,2004
STAT,1817,51,35-39,1868,0.018084557509434183
STAT,1824,30,15-19,1854,0.39014036799421564
STAT,1910,33,50-100,1943,0.8009133237975059
STAT,1921,43,15-19,1964,0.0017441748785498245
STAT,1860,50,25-29,1910,0.0029664044754193716
STAT,1909,48,20-24,1957,0.010218705655951128
STAT,1834,63,na,1897,1062.0687604027978
SIM,1821,65,na,1886,892
STAT,1847,18,25-29,1865,5.26435313546211
STAT,1853,17,40-44,1870,0.18195176895019433
SIM,1884,31,20-24,1915,3
STAT,1885,63,na,1948,1793.8283728531865
STAT,1897,42,45-49,1939,0.14055375411259144
SIM,1814,71,na,1885,617
STAT,1882,47,30-34,1929,0.0942625294173873
SIM,1772,90,na,1862,8
SIM,1872,15,20-24,1887,24
STAT,1829,38,30-34,1867,4.295191228654994
STAT,1801,92,na,1893,16.57565201207859
STAT,1850,33,20-24,1883,2.1428198905040103
SIM,1872,49,na,1921,2417
STAT,1833,36,25-29,1869,2.5828144687156422
STAT,1855,37,15-19,1892,0.04226870911005971
STAT,1948,17,50-100,1965,0.43312692557659754
STAT,1939,30,25-29,1969,9.531087630328498
STAT,1831,39,25-29,1870,2.251684749421845
STAT,1851,18,45-49,1869,0.05978181144567329
SIM,1867,34,25-29,1901,14
STAT,1880,49,50-100,1929,0.2550712372376429
SIM,1897,17,na,1914,3484
SIM,1857,28,30-34,1885,28
STAT,1896,29,30-34,1925,33.42559691694122
STAT,1843,41,35-39,1884,1.2737174668678815
STAT,1895,45,45-49,1940,0.1773357330983534
SIM,1893,37,50-100,1930,1
STAT,1927,28,15-19,1955,0.8644040738124409
STAT,1877,21,50-100,1898,0.42637361603445656
STAT,1932,35,50-100,1967,0.5710730097766553
STAT,1895,30,50-100,1925,1.2182083755586164
STAT,1949,17,40-44,1966,1.6434440681449787
STAT,1864,15,20-24,1879,18.586027859831503
STAT,1817,53,30-34,1870,0.012013849114582227
STAT,1829,49,40-44,1878,0.12444708719584252
SIM,1868,20,na,1888,2221
STAT,1862,18,20-24,1880,17.605684273293665
SIM,1797,82,na,1879,140
STAT,1884,44,30-34,1928,1.1296076030602378
STAT,1832,51,30-34,1883,0.004313206283759481
SIM,1818,61,na,1879,909
SIM,1827,33,50-100,1860,4
STAT,1830,43,20-24,1873,0.13605101930008998
STAT,1853,15,45-49,1868,0.06575507239413976
STAT,1855,41,na,1896,1747.590156138695
STAT,1900,46,35-39,1946,0.1111126951481029
STAT,1839,54,20-24,1893,5.087781378071766E-4
SIM,1862,41,40-44,1903,4
SIM,1939,24,40-44,1963,4
STAT,1805,82,na,1887,205.3048725672032
SIM,1956,8,na,1964,5292
STAT,1901,27,na,1928,3378.9766829134996
STAT,1826,68,na,1894,838.5531427739538
SIM,1843,68,na,1911,1384
SIM,1851,63,na,1914,1463
SIM,1836,18,15-19,1854,7
STAT,1889,53,na,1942,2638.5598086889067
STAT,1898,37,40-44,1935,5.9937152329311845
SIM,1869,42,35-39,1911,3
SIM,1870,18,20-24,1888,22
SIM,1851,41,35-39,1892,7
STAT,1837,44,15-19,1881,0.009860671744896835
STAT,1861,23,25-29,1884,49.00421024251638
SIM,1869,30,40-44,1899,11
STAT,1933,25,35-39,1958,20.162090311357673
STAT,1950,22,30-34,1972,34.44797521802962
SIM,1833,23,15-19,1856,2
STAT,1856,66,na,1922,1269.1613731957993
STAT,1893,26,50-100,1919,0.8231833391599723
STAT,1917,42,40-44,1959,0.2634774519698294
SIM,1936,1,na,1937,4075
SIM,1941,22,30-34,1963,44
SIM,1937,25,15-19,1962,1
STAT,1841,30,45-49,1871,1.6154106946976656
SIM,1922,28,35-39,1950,27
SIM,1904,28,na,1932,3700
SIM,1826,32,40-44,1858,3
STAT,1824,43,20-24,1867,0.19329527768341384
SIM,1898,29,30-34,1927,33
STAT,1851,35,na,1886,1840.8564929485065
SIM,1922,17,25-29,1939,58
STAT,1868,91,na,1959,89.52176664411948
STAT,1918,22,35-39,1940,10.252519871828301
SIM,1863,88,na,1951,53
SIM,1866,31,50-100,1897,1
STAT,1805,49,25-29,1854,0.2402979366708208
STAT,1846,88,na,1934,104.1824413754906
STAT,1842,74,na,1916,999.1812060693006
STAT,1885,23,40-44,1908,2.0884582979570463
STAT,1914,17,25-29,1931,9.04440154982148
SIM,1867,19,na,1886,2405
STAT,1864,61,na,1925,1703.050495013582
SIM,1771,89,na,1860,18
STAT,1839,52,25-29,1891,0.0024978226861553446
STAT,1891,21,45-49,1912,0.8746180187997745
STAT,1834,54,45-49,1888,0.008517771845925368
STAT,1855,25,na,1880,1892.2082028460748
STAT,1857,36,40-44,1893,3.4671494166496584
SIM,1872,29,40-44,1901,5
STAT,1854,44,15-19,1898,0.010224195775706244
STAT,1859,36,45-49,1895,1.627174335936752
SIM,1926,31,na,1957,4605
STAT,1874,34,20-24,1908,2.7715414769349116
SIM,1808,83,na,1891,97
SIM,1874,29,45-49,1903,2
SIM,1800,63,na,1863,912
STAT,1843,56,na,1899,1375.6674482510248
SIM,1888,40,na,1928,2926
STAT,1935,22,35-39,1957,12.954634367657174
STAT,1933,22,30-34,1955,38.52470507825995
SIM,1848,83,na,1931,298
SIM,1887,26,20-24,1913,12
STAT,1824,30,45-49,1854,4.777379008791148
SIM,1843,33,25-29,1876,14
STAT,1840,26,15-19,1866,0.39941711695729426
STAT,1902,52,na,1954,3056.854162866355
SIM,1842,15,35-39,1857,2
STAT,1808,48,50-100,1856,0.873099222841082
STAT,1833,38,na,1871,1874.600484461224
STAT,1929,25,15-19,1954,0.8963985866750679
SIM,1859,39,20-24,1898,1
STAT,1928,32,45-49,1960,1.988761615449362
SIM,1880,20,na,1900,2285
SIM,1943,22,35-39,1965,13
STAT,1903,27,20-24,1930,16.874675115789966
STAT,1859,45,35-39,1904,0.11486078996019314
SIM,1884,34,na,1918,2450
STAT,1873,38,na,1911,2400.342523116631
STAT,1860,71,na,1931,1102.046835914203
STAT,1869,52,40-44,1921,0.010282681838515412
SIM,1916,13,na,1929,4218
STAT,1868,28,40-44,1896,2.881412093575385
SIM,1882,34,20-24,1916,3
SIM,1917,54,na,1971,3602
SIM,1863,29,na,1892,2184
STAT,1811,46,45-49,1857,0.5976203855094521
STAT,1879,26,20-24,1905,12.407380827618049
STAT,1827,109,na,1936,4.2307574769684717E-4
STAT,1839,41,15-19,1880,0.011485849067089047
SIM,1888,42,45-49,1930,4
SIM,1834,91,na,1925,2
SIM,1911,27,20-24,1938,21
STAT,1819,74,na,1893,564.1753595529169
SIM,1934,32,40-44,1966,11
SIM,1881,30,50-100,1911,1
STAT,1891,21,15-19,1912,4.13781241352108
STAT,1930,36,50-100,1966,0.5540218633088732
STAT,1864,16,50-100,1880,0.0510590063765306
STAT,1810,50,40-44,1860,0.040165832022807706
STAT,1905,38,35-39,1943,2.217968335911667
SIM,1936,32,45-49,1968,2
SIM,1900,14,na,1914,3783
STAT,1849,26,35-39,1875,9.007428066161943
STAT,1890,17,15-19,1907,7.324190101708223
SIM,1893,23,40-44,1916,2
STAT,1820,49,20-24,1869,0.019798786753055287
STAT,1850,39,35-39,1889,5.388520505496774
STAT,1891,32,25-29,1923,12.808153327579616
SIM,1852,22,40-44,1874,1
STAT,1913,49,25-29,1962,0.05193265902513894
SIM,1821,40,40-44,1861,5
STAT,1892,17,na,1909,3200.900646722253
STAT,1905,27,25-29,1932,61.7641608140945
STAT,1867,10,na,1877,2582.9858862428136
STAT,1907,21,20-24,1928,102.52152100880906
SIM,1833,28,45-49,1861,1
SIM,1872,65,na,1937,1878
STAT,1868,20,30-34,1888,17.443625531720272
SIM,1854,12,na,1866,2650
STAT,1791,107,na,1898,8.385658397731355E-4
STAT,1863,34,15-19,1897,0.12634808683553786
STAT,1818,44,35-39,1862,3.3283433479947617
STAT,1868,26,45-49,1894,1.075443486599198
STAT,1871,44,20-24,1915,0.15720582262346056
SIM,1810,81,na,1891,324
SIM,1835,22,40-44,1857,3
SIM,1822,39,25-29,1861,2
SIM,1884,34,25-29,1918,1
STAT,1871,47,50-100,1918,0.24529206466481923
STAT,1924,38,45-49,1962,0.8114952287149821
STAT,1815,40,45-49,1855,4.1582002760889205
STAT,1818,92,na,1910,21.458060552601314
STAT,1926,32,40-44,1958,4.782355878709356
STAT,1838,53,na,1891,1418.244441600482
STAT,1880,31,40-44,1911,4.618799226994656
STAT,1876,34,25-29,1910,10.589977515000442
STAT,1835,33,25-29,1868,9.68993956257374
STAT,1924,32,30-34,1956,18.574324205646317
STAT,1907,38,45-49,1945,0.6350327678027305
SIM,1936,21,50-100,1957,3
STAT,1833,33,20-24,1866,2.4457270789611982
STAT,1851,51,40-44,1902,0.00800954785093152
SIM,1939,26,50-100,1965,1
STAT,1792,109,na,1901,1.2789770476374527E-4
SIM,1898,27,35-39,1925,17
STAT,1790,99,na,1889,0.32023376050779334
STAT,1862,1,na,1863,3171.191849406881
SIM,1836,40,50-100,1876,3
SIM,1841,33,20-24,1874,2
STAT,1924,21,20-24,1945,132.98723319928524
SIM,1915,38,45-49,1953,1
STAT,1896,38,15-19,1934,0.07470185605084273
SIM,1932,32,30-34,1964,34
STAT,1913,48,40-44,1961,0.1548338409838916
STAT,1926,38,50-100,1964,0.5180659592975274
STAT,1844,22,40-44,1866,2.0584802162001545
STAT,1848,47,25-29,1895,0.04680875920692097
STAT,1885,24,25-29,1909,57.190892617288185
SIM,1932,21,20-24,1953,2
STAT,1860,41,40-44,1901,1.865464633521689
STAT,1809,56,na,1865,1251.0690841999804
STAT,1882,31,45-49,1913,1.7130362559901784
STAT,1881,29,40-44,1910,2.895533641841666
STAT,1879,38,15-19,1917,0.058893331147915506
SIM,1822,38,40-44,1860,6
SIM,1876,20,30-34,1896,27
SIM,1934,22,50-100,1956,1
SIM,1826,44,35-39,1870,4
SIM,1826,33,25-29,1859,14
STAT,1813,61,na,1874,1029.2645524973295
STAT,1922,29,na,1951,4251.758498371014
SIM,1930,38,40-44,1968,8
SIM,1893,35,35-39,1928,20
SIM,1915,21,20-24,1936,5
STAT,1922,38,40-44,1960,1.7190685898630416
SIM,1846,25,20-24,1871,24
STAT,1885,35,35-39,1920,7.178205719264113
SIM,1832,30,45-49,1862,1
STAT,1830,40,40-44,1870,2.010309134643168
STAT,1887,70,na,1957,1642.0447671591262
STAT,1918,9,na,1927,4374.420957792965
SIM,1932,38,45-49,1970,1
STAT,1812,46,50-100,1858,0.5756632253543498
STAT,1820,36,15-19,1856,0.14814966016199038
STAT,1869,50,45-49,1919,0.014455375116615253
STAT,1874,20,na,1894,2460.502337283617
STAT,1907,32,30-34,1939,14.869908620115325
STAT,1937,22,45-49,1959,1.1061547180029465
SIM,1915,32,30-34,1947,31
SIM,1945,22,45-49,1967,4
STAT,1889,13,na,1902,3211.256693196654
SIM,1917,32,35-39,1949,14
STAT,1883,4,na,1887,2773.0277120677924
STAT,1854,44,45-49,1898,1.1080471393985005
STAT,1859,38,40-44,1897,3.5383635009195307
STAT,1880,91,na,1971,223.70756980630216
SIM,1930,7,na,1937,5566
STAT,1838,25,20-24,1863,10.134836141100227
STAT,1909,32,35-39,1941,8.799831732705997
SIM,1893,24,25-29,1917,101
STAT,1891,34,20-24,1925,3.351176803433735
STAT,1935,25,45-49,1960,2.3813699444211975
STAT,1834,51,35-39,1885,0.005362229761911689
STAT,1855,25,20-24,1880,10.261476203364031
STAT,1828,51,40-44,1879,0.009446691177490803
SIM,1890,31,45-49,1921,3
STAT,1846,31,35-39,1877,9.17687833100143
STAT,1865,45,35-39,1910,0.13040307006308718
SIM,1859,83,na,1942,247
STAT,1936,18,15-19,1954,43.750634547680065
STAT,1807,49,35-39,1856,0.48339097939029413
STAT,1948,24,40-44,1972,3.8973017751040056
SIM,1860,24,na,1884,2076
STAT,1918,38,20-24,1956,0.28022661930513215
STAT,1795,107,na,1902,0.0010918855842104867
SIM,1841,31,25-29,1872,19
SIM,1899,5,na,1904,3956
SIM,1937,15,na,1952,3487
STAT,1844,34,35-39,1878,9.3845309684515
STAT,1940,18,35-39,1958,4.299838709897756
SIM,1852,34,35-39,1886,17
SIM,1934,26,na,1960,5388
STAT,1862,35,na,1897,2074.447050090313
SIM,1847,41,45-49,1888,6
SIM,1874,15,25-29,1889,15
SIM,1930,36,na,1966,5247
STAT,1889,45,20-24,1934,0.015093723442627712
STAT,1866,25,na,1891,2247.0965783626216
SIM,1819,86,na,1905,53
STAT,1822,38,na,1860,1586.6699570771725
SIM,1867,33,40-44,1900,8
STAT,1844,23,25-29,1867,56.14376575018957
SIM,1823,40,45-49,1863,4
SIM,1943,25,45-49,1968,2
SIM,1877,40,na,1917,2413
STAT,1798,79,na,1877,337.2930876458107
SIM,1863,25,20-24,1888,15
STAT,1861,20,20-24,1881,60.28060602658544
STAT,1867,42,35-39,1909,1.7203651054264097
STAT,1900,49,15-19,1949,3.0995613445383496E-4
STAT,1839,41,45-49,1880,1.2447788052524682
SIM,1873,50,na,1923,2090
STAT,1793,64,na,1857,805.6468565457042
STAT,1799,104,na,1903,0.02238265205385944
STAT,1902,46,15-19,1948,3.2295146520394143E-4
SIM,1854,31,35-39,1885,3
STAT,1867,66,na,1933,1559.062383099915
STAT,1822,49,30-34,1871,0.139554432266138
STAT,1942,15,35-39,1957,4.429846300536431
STAT,1821,53,20-24,1874,0.0010197678231972918
STAT,1873,18,50-100,1891,0.05003182570691322
SIM,1878,2,na,1880,3446
STAT,1847,51,45-49,1898,0.010917971352768615
SIM,1891,44,na,1935,2932
STAT,1915,42,50-100,1957,0.11934642534606194
STAT,1872,35,25-29,1907,2.9513627048994993
SIM,1852,23,25-29,1875,60
SIM,1862,44,45-49,1906,2
STAT,1881,18,30-34,1899,1.5476706854075655
STAT,1887,41,50-100,1928,1.1966940567784745
STAT,1804,50,40-44,1854,0.029684568023968197
STAT,1895,45,15-19,1940,3.0056878616588605E-4
SIM,1876,23,35-39,1899,12
SIM,1871,31,40-44,1902,7
STAT,1889,37,na,1926,2934.120285983673
STAT,1882,42,30-34,1924,1.1233903357468502
SIM,1827,81,na,1908,202
SIM,1890,22,na,1912,3390
SIM,1890,42,30-34,1932,2
SIM,1957,4,na,1961,5439
SIM,1942,21,na,1963,4044
STAT,1830,33,na,1863,1829.896769222235
STAT,1805,66,na,1871,938.841612255805
STAT,1861,22,40-44,1883,1.7967123499262658
SIM,1898,24,30-34,1922,28
STAT,1933,28,45-49,1961,2.3169230023224725
STAT,1844,41,na,1885,1896.9565267672178
SIM,1865,55,na,1920,1853
STAT,1815,51,30-34,1866,0.012873065510282776
SIM,1941,28,45-49,1969,2
STAT,1846,47,15-19,1893,3.021385148184888E-4
STAT,1868,23,35-39,1891,5.615529877801144
STAT,1923,14,na,1937,4685.772635354492
STAT,1871,41,40-44,1912,2.267190119463479
SIM,1786,82,na,1868,105
SIM,1939,27,45-49,1966,2
STAT,1885,23,na,1908,2370.325577047993
STAT,1863,47,20-24,1910,0.010688613349326328
SIM,1883,49,na,1932,2390
SIM,1950,15,35-39,1965,8
STAT,1938,17,35-39,1955,4.178717368092812
SIM,1864,41,45-49,1905,3
STAT,1881,33,na,1914,2313.425978858371
STAT,1893,32,35-39,1925,12.987369499123561
STAT,1866,26,35-39,1892,9.054960128895553
STAT,1875,52,40-44,1927,0.010861332247614599
STAT,1849,22,50-100,1871,0.3854775997344202
STAT,1838,37,15-19,1875,0.045359721078236534
SIM,1814,55,na,1869,1189
STAT,1874,32,25-29,1906,10.592794791953668
SIM,1875,33,50-100,1908,5
SIM,1935,5,na,1940,5484
STAT,1801,76,na,1877,410.14929441023924
STAT,1888,12,na,1900,3078.639295702429
SIM,1878,23,45-49,1901,1
STAT,1881,27,15-19,1908,0.44170912056914813
STAT,1847,15,15-19,1862,5.6117347521318175
SIM,1839,23,na,1862,1818
STAT,1891,35,35-39,1926,8.928531652973488
STAT,1908,16,40-44,1924,0.27455702114957475
STAT,1865,44,20-24,1909,0.14448925222589146
STAT,1867,33,50-100,1900,0.8678749044866776
STAT,1917,36,50-100,1953,0.44230287052454903
SIM,1882,32,25-29,1914,22
STAT,1866,15,25-29,1881,5.504371395835658
STAT,1926,19,na,1945,4536.4559230699
SIM,1834,41,35-39,1875,3
SIM,1916,16,40-44,1932,1
STAT,1872,21,35-39,1893,5.943357852087872
SIM,1946,11,na,1957,4456
STAT,1777,93,na,1870,4.994044869387987
STAT,1914,28,35-39,1942,15.216829682761531
SIM,1915,47,na,1962,4106
STAT,1823,79,na,1902,386.64956368022314
SIM,1944,18,15-19,1962,66
STAT,1873,3,na,1876,3178.987107962737
STAT,1824,44,35-39,1868,2.1582918680135093
STAT,1842,98,na,1940,2.924774481720037
SIM,1894,7,na,1901,3745
STAT,1895,42,40-44,1937,0.20576096125584908
SIM,1882,21,15-19,1903,3
SIM,1921,16,na,1937,4200
STAT,1826,41,35-39,1867,1.9271322435896867
STAT,1893,48,15-19,1941,2.857254396672251E-4
STAT,1944,28,15-19,1972,0.7701081654090706
STAT,1909,47,na,1956,3406.5356919313767
STAT,1931,25,30-34,1956,51.16964172612962
SIM,1825,71,na,1896,672
SIM,1874,24,15-19,1898,4
SIM,1876,55,na,1931,2378
STAT,1832,54,35-39,1886,0.005878259116045605
SIM,1832,44,35-39,1876,2
STAT,1850,20,45-49,1870,0.6501763385281091
STAT,1881,15,20-24,1896,17.340077727417988
STAT,1866,24,15-19,1890,3.066039870731694
STAT,1848,31,na,1879,2085.057303410019
STAT,1885,38,15-19,1923,0.0561742860583961
SIM,1865,36,40-44,1901,4
STAT,1821,48,50-100,1869,0.35479710224775984
SIM,1855,15,15-19,1870,8
SIM,1894,12,na,1906,3710
STAT,1861,5,na,1866,2425.6744509208047
SIM,1871,24,na,1895,2255
SIM,1895,32,35-39,1927,19
STAT,1850,10,na,1860,2261.7012139473413
SIM,1805,94,na,1899,7
STAT,1768,97,na,1865,1.6172530638277116
STAT,1906,42,na,1948,3407.6146732984243
STAT,1927,16,20-24,1943,170.8015849592957
SIM,1839,32,20-24,1871,2
STAT,1948,20,25-29,1968,107.21201167249093
STAT,1921,47,na,1968,4182.848954636723
SIM,1905,0,na,1905,4089
SIM,1924,25,35-39,1949,27
SIM,1945,26,na,1971,4011
STAT,1803,59,na,1862,1234.1253559196011
SIM,1901,39,na,1940,3360
SIM,1866,77,na,1943,805
STAT,1813,43,15-19,1856,0.046531193599749436
STAT,1898,23,20-24,1921,94.06403210760244
STAT,1806,54,50-100,1860,0.04186650368363389
STAT,1928,26,na,1954,4680.8984257489965
SIM,1904,44,na,1948,3429
SIM,1824,35,40-44,1859,2
STAT,1855,28,30-34,1883,19.615506714980924
SIM,1888,80,na,1968,1443
SIM,1863,28,30-34,1891,27
STAT,1865,31,45-49,1896,1.6148228130304756
SIM,1827,38,na,1865,1577
STAT,1916,25,35-39,1941,15.772102825809624
STAT,1900,30,25-29,1930,14.486000143862704
SIM,1927,32,na,1959,5133
STAT,1834,105,na,1939,0.017452499356010013
STAT,1844,27,40-44,1871,2.9013325154223906
STAT,1852,107,na,1959,0.008659419218835163
SIM,1889,65,na,1954,1969
STAT,1887,46,25-29,1933,0.06513681796713866
SIM,1963,0,na,1963,5094
SIM,1891,26,40-44,1917,6
SIM,1900,21,30-34,1921,35
STAT,1864,27,15-19,1891,0.41349867607449525
STAT,1868,51,na,1919,2088.3776332483885
STAT,1905,35,30-34,1940,1.6955627070705834
SIM,1828,41,35-39,1869,2
SIM,1885,29,20-24,1914,10
STAT,1902,39,50-100,1941,0.37441371201039186
STAT,1876,31,20-24,1907,2.8303854023805775
SIM,1946,17,35-39,1963,7
SIM,1843,38,50-100,1881,1
STAT,1924,5,na,1929,4838.385815243719
SIM,1917,35,45-49,1952,2
STAT,1887,35,15-19,1922,0.06392384513936224
STAT,1920,39,15-19,1959,0.02118702279058651
SIM,1898,25,50-100,1923,1
STAT,1859,55,na,1914,1679.6772900639476
SIM,1893,27,na,1920,3102
STAT,1918,38,15-19,1956,0.020413862252865386
SIM,1875,14,na,1889,2531
STAT,1863,20,na,1883,2189.97161065813
SIM,1929,19,30-34,1948,16
STAT,1860,44,45-49,1904,1.2189867085409924
STAT,1848,44,20-24,1892,0.12791401766955077
SIM,1832,68,na,1900,911
SIM,1900,54,na,1954,3168
SIM,1862,63,na,1925,1569
STAT,1852,47,15-19,1899,3.019422597373529E-4
STAT,1865,31,15-19,1896,0.1318730553640079
SIM,1876,26,45-49,1902,1
SIM,1880,24,15-19,1904,3
STAT,1901,31,50-100,1932,1.3025745609279986
STAT,1889,45,15-19,1934,5.031236721895325E-4
SIM,1841,36,25-29,1877,4
STAT,1917,45,45-49,1962,0.23022179255892977
SIM,1848,39,45-49,1887,4
STAT,1880,34,15-19,1914,0.14976005637017614
STAT,1900,49,45-49,1949,0.18287427324993855
STAT,1854,41,35-39,1895,1.36514052418829
STAT,1870,24,35-39,1894,5.751329385759935
SIM,1838,27,50-100,1865,1
STAT,1897,48,na,1945,3008.697663080637
STAT,1852,76,na,1928,718.5033021509298
SIM,1880,35,25-29,1915,3
STAT,1968,0,na,1968,4995.714111519742
SIM,1932,35,40-44,1967,8
STAT,1909,35,45-49,1944,0.6573252543900265
STAT,1835,30,20-24,1865,2.6381223862749277
STAT,1931,22,50-100,1953,0.8624940143201651
STAT,1880,34,45-49,1914,1.833854192880821
STAT,1939,15,50-100,1954,0.37952958150930405
STAT,1929,39,35-39,1968,3.131948580085119
STAT,1834,23,na,1857,1689.7583487611244
SIM,1843,12,na,1855,2760
STAT,1873,51,50-100,1924,0.015537838384433492
SIM,1882,37,25-29,1919,6
STAT,1937,30,15-19,1967,0.1284948346625984
SIM,1913,24,20-24,1937,140
STAT,1866,29,45-49,1895,1.0309700652653755
STAT,1818,37,40-44,1855,11.058980526427236
STAT,1813,43,45-49,1856,5.042817752327198
STAT,1877,29,20-24,1906,12.141734449515884
SIM,1876,23,40-44,1899,4
STAT,1842,42,50-100,1884,0.9840785580683155
SIM,1822,66,na,1888,939
STAT,1848,44,15-19,1892,0.011122958658982435
STAT,1944,28,20-24,1972,19.91279668877343
STAT,1856,52,30-34,1908,0.004584796574893291
STAT,1895,42,35-39,1937,0.16565099639181524
STAT,1849,23,30-34,1872,16.716765333444943
STAT,1852,47,45-49,1899,0.17814608318757671
STAT,1901,70,na,1971,2386.1311362621286
STAT,1831,34,25-29,1865,8.278893142817587
SIM,1926,33,50-100,1959,1
STAT,1802,53,40-44,1855,0.030107604433254383
STAT,1854,41,40-44,1895,1.695689326503652
STAT,1894,16,45-49,1910,0.08514978042175875
SIM,1775,79,na,1854,218
STAT,1868,23,40-44,1891,2.005266173757342
STAT,1905,24,20-24,1929,99.98900630644567
SIM,1829,28,25-29,1857,51
STAT,1874,37,25-29,1911,2.9776357545101417
STAT,1887,32,35-39,1919,11.419744948179758
STAT,1794,89,na,1883,39.200397937729335
STAT,1828,51,35-39,1879,0.007725097943333144
STAT,1876,27,na,1903,2488.768917169333
SIM,1846,17,na,1863,2140
STAT,1822,46,20-24,1868,0.018043414371975097
STAT,1884,78,na,1962,1001.3878891613346
STAT,1855,39,40-44,1894,3.2618745218790313
STAT,1875,52,35-39,1927,0.008881930596803098
STAT,1806,101,na,1907,0.19239252792654069
STAT,1831,23,15-19,1854,7.762770038780136
STAT,1790,75,na,1865,353.4100043066196
STAT,1885,28,40-44,1913,3.000952729076207
STAT,1834,51,40-44,1885,0.006557240950873116
STAT,1924,35,40-44,1959,1.7868560840739611
SIM,1843,30,20-24,1873,1
STAT,1883,26,40-44,1909,2.97088993236235
SIM,1845,91,na,1936,34
SIM,1856,6,na,1862,2636
SIM,1875,42,35-39,1917,3
STAT,1822,34,50-100,1856,2.0467122468558894
STAT,1840,43,50-100,1883,0.762677693462775
STAT,1939,29,na,1968,3798.1487745909185
SIM,1937,20,15-19,1957,3
SIM,1935,16,20-24,1951,193
STAT,1889,28,50-100,1917,0.7938649108055165
SIM,1895,34,na,1929,3164
SIM,1939,22,15-19,1961,5
SIM,1826,40,na,1866,1970
SIM,1874,27,25-29,1901,45
STAT,1850,34,35-39,1884,7.945188977052995
STAT,1859,34,25-29,1893,8.249195667204088
SIM,1857,23,30-34,1880,1
SIM,1821,43,45-49,1864,6
STAT,1858,54,30-34,1912,0.00458701365405784
SIM,1908,18,na,1926,3691
STAT,1857,22,20-24,1879,62.70918129840908
STAT,1881,73,na,1954,1156.3549596354796
STAT,1867,100,na,1967,5.496605551470128
SIM,1937,28,25-29,1965,4
STAT,1929,28,25-29,1957,83.22088042414406
SIM,1896,19,25-29,1915,8
SIM,1835,25,45-49,1860,2
STAT,1888,19,25-29,1907,6.71914549805004
SIM,1829,45,na,1874,1704
STAT,1929,20,15-19,1949,6.844517987509775
STAT,1843,40,20-24,1883,0.11314868476868932
SIM,1865,22,20-24,1887,58
SIM,1826,37,40-44,1863,4
SIM,1850,23,20-24,1873,71
STAT,1874,37,30-34,1911,5.511793873711175
STAT,1877,16,45-49,1893,0.06826094169724908
STAT,1894,25,35-39,1919,12.631964813439671
STAT,1919,19,20-24,1938,150.46062535943545
SIM,1937,31,na,1968,3652
STAT,1851,108,na,1959,0.003306526172823747
STAT,1940,15,30-34,1955,12.500630447386307
SIM,1893,28,40-44,1921,10
STAT,1856,27,50-100,1883,0.5132891807281877
STAT,1857,51,na,1908,1705.342787857262
SIM,1835,34,35-39,1869,17
SIM,1915,23,40-44,1938,5
STAT,1871,31,50-100,1902,0.9231401491933542
SIM,1941,25,40-44,1966,10
STAT,1918,27,na,1945,4024.8930174935804
SIM,1882,6,na,1888,2367
SIM,1934,32,35-39,1966,30
STAT,1821,53,na,1874,1412.3260094370996
SIM,1899,64,na,1963,2711
STAT,1871,44,45-49,1915,1.481493978336156
STAT,1907,23,40-44,1930,3.081212876075929
STAT,1915,16,50-100,1931,0.07931771133701238
SIM,1852,88,na,1940,45
SIM,1763,94,na,1857,5
SIM,1875,44,25-29,1919,4
STAT,1892,18,30-34,1910,2.0147444657160496
STAT,1884,40,15-19,1924,0.013893309357052649
STAT,1910,47,na,1957,3458.1879783809795
STAT,1804,53,45-49,1857,0.03851562531158331
STAT,1874,48,40-44,1922,0.17482857768418075
STAT,1930,21,45-49,1951,1.4612777541106818
STAT,1867,44,25-29,1911,0.6025887387576712
SIM,1869,33,45-49,1902,1
STAT,1795,104,na,1899,0.015443071942411266
STAT,1907,35,40-44,1942,1.4147306768958157
SIM,1886,40,45-49,1926,5
SIM,1927,19,20-24,1946,227
SIM,1937,25,20-24,1962,36
STAT,1842,23,20-24,1865,77.69427770614695
STAT,1925,1,na,1926,5098.2413825896365
SIM,1840,33,50-100,1873,1
STAT,1766,93,na,1859,3.1555552359953496
SIM,1835,23,25-29,1858,60
SIM,1893,38,45-49,1931,3
SIM,1865,39,45-49,1904,3
STAT,1874,34,15-19,1908,0.14601561125760484
STAT,1808,71,na,1879,630.2808840034761
SIM,1835,22,35-39,1857,6
STAT,1887,35,45-49,1922,2.269296232572541
STAT,1844,37,15-19,1881,0.04694881797409253
SIM,1826,56,na,1882,1573
SIM,1895,50,na,1945,2997
STAT,1882,44,20-24,1926,0.15327708134080606
STAT,1874,22,20-24,1896,71.26858396095422
STAT,1926,32,35-39,1958,11.167719558107665
STAT,1845,66,na,1911,1197.6018393077072
SIM,1837,96,na,1933,14
STAT,1856,52,25-29,1908,0.002728143390171976
SIM,1880,28,30-34,1908,47
SIM,1925,46,na,1971,4480
SIM,1863,28,25-29,1891,43
STAT,1846,45,25-29,1891,0.0441475564669573
STAT,1855,28,25-29,1883,32.950802504208696
STAT,1827,34,35-39,1861,12.550322215871676
STAT,1941,21,20-24,1962,116.0516030197708
SIM,1854,52,na,1906,1986
STAT,1924,47,35-39,1971,0.15510585953050354
STAT,1943,29,50-100,1972,1.0693019840267581
STAT,1922,32,na,1954,4316.976135383462
SIM,1929,15,15-19,1944,62
STAT,1870,33,na,1903,2356.727704920412
SIM,1864,73,na,1937,1387
STAT,1909,20,40-44,1929,3.1722611850850426
SIM,1915,35,40-44,1950,1
STAT,1881,18,25-29,1899,5.502476711480815
SIM,1933,15,35-39,1948,6
SIM,1882,35,35-39,1917,14
SIM,1824,30,na,1854,1670
STAT,1846,34,15-19,1880,0.12508808459872262
SIM,1883,65,na,1948,1825
SIM,1884,10,na,1894,2620
SIM,1895,53,na,1948,2912
STAT,1860,54,40-44,1914,0.008452885302057208
SIM,1861,24,35-39,1885,7
STAT,1941,24,na,1965,3807.4583420935437
STAT,1953,12,na,1965,4800.9771225395925
STAT,1860,43,30-34,1903,0.9423398407849575
STAT,1884,51,25-29,1935,0.0035447064474524457
SIM,1894,19,15-19,1913,13
SIM,1850,78,na,1928,629
STAT,1829,33,na,1862,1662.8077955619317
STAT,1919,42,45-49,1961,0.1821022938673185
STAT,1856,54,20-24,1910,5.55691851713902E-4
SIM,1899,67,na,1966,2645
STAT,1880,46,15-19,1926,4.254884623981235E-4
STAT,1839,54,na,1893,1484.5587058255167
STAT,1914,25,30-34,1939,40.12374343493276
STAT,1944,15,45-49,1959,0.5431412737299913
STAT,1876,33,40-44,1909,4.5034291843621554
SIM,1878,38,50-100,1916,4
STAT,1853,24,35-39,1877,5.620306638624645
STAT,1888,68,na,1956,1850.0340099875873
SIM,1815,44,35-39,1859,5
STAT,1882,31,15-19,1913,0.13989356801493377
SIM,1915,27,50-100,1942,1
SIM,1828,44,45-49,1872,1
STAT,1898,35,20-24,1933,1.0654768209860759
STAT,1885,37,50-100,1922,1.2342961168769442
STAT,1925,15,35-39,1940,5.146533089133435
SIM,1900,36,35-39,1936,6
STAT,1874,35,35-39,1909,7.384210758139303
STAT,1920,46,na,1966,4111.182914883132
STAT,1781,82,na,1863,92.43203993505125
SIM,1890,42,25-29,1932,1
STAT,1831,23,45-49,1854,1.6408328539810808
STAT,1899,15,na,1914,3517.1392001090976
SIM,1837,99,na,1936,2
SIM,1833,27,30-34,1860,30
SIM,1862,87,na,1949,189
SIM,1882,37,30-34,1919,9
SIM,1874,91,na,1965,137
SIM,1831,27,na,1858,1888
STAT,1818,47,15-19,1865,7.122081309945916E-4
STAT,1819,58,na,1877,1126.9119129982203
STAT,1815,44,na,1859,1348.0521651125825
STAT,1877,12,na,1889,2700.1537252745293
STAT,1809,54,40-44,1863,0.032424996392120035
STAT,1833,33,15-19,1866,0.12885043842054766
SIM,1817,42,40-44,1859,4
SIM,1887,79,na,1966,903
STAT,1880,33,50-100,1913,0.9677699792855371
STAT,1938,19,30-34,1957,12.130048019888463
SIM,1946,19,30-34,1965,17
STAT,1859,48,45-49,1907,0.18930233804781663
STAT,1870,28,20-24,1898,11.594159851057462
STAT,1917,15,50-100,1932,0.08175794108250824
STAT,1844,25,na,1869,2125.635050334547
STAT,1766,90,na,1856,13.754296290000003
STAT,1896,63,na,1959,2482.4084377152926
STAT,1876,45,40-44,1921,0.1803146260351065
SIM,1927,16,na,1943,4957
STAT,1841,43,20-24,1884,0.1218383027572573
STAT,1883,29,45-49,1912,1.0895485136503626
SIM,1876,24,25-29,1900,58
STAT,1846,34,45-49,1880,1.5317389294631742
STAT,1869,76,na,1945,930.3110618537747
STAT,1946,24,30-34,1970,32.28131401045632
STAT,1822,49,25-29,1871,0.08304065311009536
SIM,1856,38,50-100,1894,4
STAT,1862,54,20-24,1916,6.259289175260197E-4
SIM,1948,15,na,1963,4676
SIM,1848,38,30-34,1886,8
STAT,1868,35,na,1903,2295.8016416209175
STAT,1911,21,35-39,1932,9.036514094788448
STAT,1852,32,40-44,1884,3.4052951959942748
STAT,1854,40,na,1894,1752.056664280398
STAT,1928,42,na,1970,4785.531354358389
SIM,1874,72,na,1946,1160
STAT,1858,16,35-39,1874,0.5109014213943212
SIM,1905,29,na,1934,3556
STAT,1815,40,15-19,1855,0.03836863269229466
STAT,1867,50,na,1917,2077.572951461159
SIM,1871,31,35-39,1902,14
STAT,1835,32,40-44,1867,4.145541801822622
STAT,1820,90,na,1910,40.13160516450733
SIM,1904,47,50-100,1951,4
STAT,1906,40,50-100,1946,0.10901235346340635
SIM,1876,35,35-39,1911,12
STAT,1840,22,50-100,1862,0.363523835003592
SIM,1885,35,na,1920,2540
SIM,1923,42,na,1965,4429
STAT,1807,49,na,1856,1223.7891158879042
STAT,1907,43,na,1950,3415.084997068916
STAT,1815,51,25-29,1866,0.007660005849648014
STAT,1869,17,na,1886,2514.382789137394
STAT,1846,47,20-24,1893,0.009064163417694632
STAT,1882,42,25-29,1924,0.6274792892007037
SIM,1883,49,50-100,1932,3
STAT,1794,105,na,1899,0.0057019657156769585
SIM,1885,75,na,1960,1078
SIM,1848,36,40-44,1884,4
STAT,1858,31,50-100,1889,0.7335987580701078
SIM,1843,32,40-44,1875,3
STAT,1777,77,na,1854,240.0
SIM,1859,26,45-49,1885,1
STAT,1907,21,15-19,1928,4.907977379615
STAT,1835,44,40-44,1879,1.9723938197033912
SIM,1932,30,50-100,1962,1
SIM,1840,63,na,1903,1218
SIM,1935,19,25-29,1954,64
STAT,1861,34,40-44,1895,3.6085581030685523
STAT,1831,27,30-34,1858,21.93489709044759
STAT,1852,33,25-29,1885,7.959660333758962
STAT,1799,80,na,1879,263.54087281427576
STAT,1847,51,50-100,1898,0.01136209220269546
STAT,1809,96,na,1905,3.9648794305320085
SIM,1813,86,na,1899,91
STAT,1847,15,20-24,1862,16.764169617604374
STAT,1898,38,25-29,1936,0.846673555090983
SIM,1818,45,na,1863,1349
STAT,1887,23,45-49,1910,0.7839020802926353
SIM,1860,33,25-29,1893,16
STAT,1863,22,45-49,1885,0.6364621034783832
STAT,1937,35,15-19,1972,0.01941930835665139
SIM,1897,60,na,1957,2594
SIM,1909,23,40-44,1932,3
STAT,1927,19,25-29,1946,54.16901145472697
SIM,1836,58,na,1894,1443
STAT,1844,22,na,1866,2112.1389118094053
SIM,1871,22,45-49,1893,1
STAT,1955,15,20-24,1970,181.92132009441406
STAT,1826,42,40-44,1868,2.346745378023752
STAT,1962,3,na,1965,5089.87301739186
STAT,1862,101,na,1963,1.7404535296286758
STAT,1929,25,20-24,1954,23.178306126754165
SIM,1895,23,45-49,1918,1
SIM,1939,24,35-39,1963,18
STAT,1933,13,na,1946,5351.536718611738
STAT,1862,18,15-19,1880,5.893428217747963
STAT,1878,40,45-49,1918,1.5849929232132203
SIM,1824,33,20-24,1857,1
STAT,1883,24,20-24,1907,67.68474600192063
SIM,1880,39,40-44,1919,7
STAT,1815,53,20-24,1868,0.0015331198823259934
STAT,1831,38,40-44,1869,3.461072661915161
STAT,1900,46,40-44,1946,0.13587495261062263
STAT,1911,47,25-29,1958,0.050664054342573046
STAT,1841,30,15-19,1871,0.1319210641926046
SIM,1950,13,na,1963,4534
STAT,1946,25,20-24,1971,20.554904534439597
SIM,1834,43,25-29,1877,3
STAT,1870,17,40-44,1887,0.18312913064311542
SIM,1817,60,na,1877,1204
SIM,1843,44,40-44,1887,6
STAT,1851,51,na,1902,1638.1529099294437
SIM,1842,67,na,1909,1072
STAT,1832,53,20-24,1885,5.13929262046416E-4
STAT,1850,31,50-100,1881,0.7415855408213573
STAT,1872,28,30-34,1900,25.480219761477173
STAT,1855,65,na,1920,1272.070009807974
SIM,1820,46,50-100,1866,1
SIM,1845,32,45-49,1877,1
SIM,1910,34,45-49,1944,2
STAT,1891,32,na,1923,2984.0299259367803
STAT,1818,89,na,1907,54.1242871105254
STAT,1833,78,na,1911,552.7895753820168
STAT,1928,21,50-100,1949,0.8328892901739113
SIM,1867,30,30-34,1897,9
SIM,1923,31,20-24,1954,4
STAT,1902,34,45-49,1936,1.4168838853933512
STAT,1857,37,25-29,1894,2.269510849786656
STAT,1873,30,50-100,1903,0.945693593527423
STAT,1796,69,na,1865,662.4217097660149
SIM,1851,47,na,1898,1773
STAT,1896,43,50-100,1939,0.09737095826068591
SIM,1870,18,15-19,1888,5
STAT,1890,53,na,1943,2614.7601917228108
SIM,1889,39,30-34,1928,17
STAT,1868,35,35-39,1903,6.892267435357652
SIM,1848,43,na,1891,1737
SIM,1857,17,na,1874,2428
STAT,1872,39,40-44,1911,4.400270760228586
SIM,1894,49,na,1943,3131
STAT,1846,22,45-49,1868,0.6529434078794849
STAT,1859,48,15-19,1907,3.208511503648262E-4
STAT,1843,43,25-29,1886,0.4402632530961537
STAT,1899,48,50-100,1947,0.18962295112878552
SIM,1899,44,40-44,1943,2
SIM,1855,15,20-24,1870,23
STAT,1899,17,35-39,1916,0.7605941984284027
STAT,1902,46,45-49,1948,0.1905415248458971
SIM,1812,45,na,1857,1335
SIM,1885,25,35-39,1910,14
SIM,1918,19,25-29,1937,83
STAT,1907,64,na,1971,2926.7772953894796
STAT,1826,43,25-29,1869,0.6567159366838565
STAT,1903,50,na,1953,3141.738336454259
STAT,1866,26,40-44,1892,2.8111631093893155
SIM,1896,16,na,1912,3379
STAT,1776,92,na,1868,9.305190756240293
STAT,1911,36,15-19,1947,0.01880268325168438
STAT,1929,36,30-34,1965,2.3671703994087245
STAT,1837,32,45-49,1869,1.4915860146842608
SIM,1887,39,na,1926,2555
SIM,1861,22,na,1883,2289
STAT,1842,15,na,1857,2685.4122979135595
STAT,1859,30,30-34,1889,14.389757096978018
STAT,1915,31,20-24,1946,2.5169270991641564
STAT,1893,34,25-29,1927,13.023079374752852
STAT,1872,24,15-19,1896,3.328926960664179
STAT,1841,41,25-29,1882,0.5054370417913527
SIM,1860,32,40-44,1892,2
SIM,1907,22,30-34,1929,43
SIM,1794,77,na,1871,390
SIM,1872,25,na,1897,2602
STAT,1816,38,45-49,1854,8.014208382015159
STAT,1881,40,50-100,1921,1.0389032538856517
SIM,1824,38,45-49,1862,3
STAT,1853,36,50-100,1889,1.0259121237210624
STAT,1926,22,50-100,1948,0.8079109254216286
STAT,1827,69,na,1896,872.6874615180269
SIM,1931,21,na,1952,5044
STAT,1841,49,35-39,1890,0.10250810460908727
SIM,1891,24,20-24,1915,97
STAT,1915,42,30-34,1957,0.12987699257336363
STAT,1897,17,50-100,1914,0.06633788452783745
SIM,1854,34,45-49,1888,2
SIM,1891,29,45-49,1920,3
STAT,1851,17,30-34,1868,1.4673190047764382
SIM,1861,28,20-24,1889,11
STAT,1833,21,20-24,1854,69.3431833350434
STAT,1930,34,20-24,1964,3.1774850910902743
STAT,1859,45,40-44,1904,0.14045833711312317
STAT,1913,21,45-49,1934,1.1033961641512924
SIM,1878,20,35-39,1898,8
SIM,1928,23,20-24,1951,136
SIM,1920,17,15-19,1937,56
STAT,1908,19,15-19,1927,8.838911998599597
SIM,1938,16,na,1954,3820
STAT,1891,37,30-34,1928,6.664520783328268
STAT,1861,10,na,1871,2331.7147714993544
STAT,1831,74,na,1905,697.3917023849385
STAT,1822,110,na,1932,1.5450714335042058E-4
SIM,1863,24,15-19,1887,6
SIM,1913,9,na,1922,4091
STAT,1857,91,na,1948,45.67703800519774
STAT,1897,42,15-19,1939,0.0012969205442267628
SIM,1840,60,na,1900,1357
STAT,1878,50,na,1928,2289.940150812215
SIM,1879,35,50-100,1914,1
SIM,1916,32,na,1948,3860
STAT,1876,48,45-49,1924,0.2430185419692984
STAT,1865,24,na,1889,2176.1056859432365
SIM,1878,65,na,1943,1932
STAT,1915,45,35-39,1960,0.13171080989656692
STAT,1879,75,na,1954,1085.052846630816
STAT,1875,61,na,1936,1938.1814908652575
SIM,1874,51,na,1925,2053
STAT,1838,28,25-29,1866,35.76279857643201
STAT,1840,19,20-24,1859,15.901220458075336
STAT,1917,42,na,1959,3912.194764371993
STAT,1909,23,45-49,1932,1.0520020029226902
STAT,1855,24,15-19,1879,2.85953589960336
SIM,1876,28,40-44,1904,4
SIM,1863,35,25-29,1898,8
STAT,1868,24,25-29,1892,54.91273755603389
STAT,1888,16,20-24,1904,21.186295814134063
SIM,1816,97,na,1913,2
STAT,1876,86,na,1962,393.98765406184634
STAT,1892,16,40-44,1908,0.23237685282390372
STAT,1904,36,50-100,1940,0.3859410015667844
STAT,1912,17,15-19,1929,9.258667754085735
SIM,1900,24,40-44,1924,4
STAT,1905,57,na,1962,3076.808701811868
STAT,1824,43,15-19,1867,0.01680828592377912
STAT,1887,27,na,1914,2691.153260196745
STAT,1831,36,20-24,1867,0.6229695099473898
SIM,1921,21,45-49,1942,1
STAT,1891,48,40-44,1939,0.11924264741939962
SIM,1854,38,30-34,1892,9
STAT,1833,40,50-100,1873,0.9326070890841491
SIM,1889,37,40-44,1926,4
STAT,1885,23,35-39,1908,5.848500375760442
SIM,1913,27,25-29,1940,98
STAT,1845,54,45-49,1899,0.010312414895249295
SIM,1841,21,20-24,1862,61
SIM,1896,16,20-24,1912,32
STAT,1787,92,na,1879,9.627421744170459
STAT,1850,33,15-19,1883,0.11289210669613393
STAT,1824,46,30-34,1870,0.1148390958987966
STAT,1853,28,20-24,1881,10.153975920800283
SIM,1886,42,35-39,1928,7
SIM,1829,25,20-24,1854,15
SIM,1873,87,na,1960,215
STAT,1856,8,na,1864,2248.4250551032683
SIM,1913,38,35-39,1951,5
SIM,1928,34,30-34,1962,27
SIM,1841,40,50-100,1881,1
SIM,1906,31,20-24,1937,3
SIM,1861,25,na,1886,2106
SIM,1863,39,40-44,1902,3
STAT,1889,33,20-24,1922,3.352167567225846
SIM,1826,44,40-44,1870,3
STAT,1851,15,40-44,1866,0.17038206593811808
STAT,1940,24,50-100,1964,0.6762402905351785
STAT,1896,36,25-29,1932,3.8677864473057366
STAT,1846,38,30-34,1884,4.180001615766391
STAT,1911,49,15-19,1960,3.497711777975953E-4
STAT,1864,21,na,1885,2205.97569459689
STAT,1845,18,15-19,1863,5.448415051162808
STAT,1878,53,na,1931,2221.25237496628
STAT,1765,110,na,1875,0.0016206452281095688
STAT,1862,45,50-100,1907,0.21635296070167856
SIM,1893,35,40-44,1928,10
STAT,1885,35,40-44,1920,4.442664302191931
SIM,1815,93,na,1908,16
STAT,1834,53,30-34,1887,0.003563612595415197
STAT,1820,36,45-49,1856,5.259312310289796
SIM,1946,15,15-19,1961,50
STAT,1803,56,na,1859,1309.6723445231853
STAT,1877,48,50-100,1925,0.2528022769669212
SIM,1906,33,40-44,1939,3
SIM,1895,20,40-44,1915,2
STAT,1784,111,na,1895,1.0076970689022566E-4
STAT,1865,47,30-34,1912,0.08885817937879427
STAT,1922,24,15-19,1946,6.128322059512117
STAT,1899,12,na,1911,3579.7498219075264
STAT,1839,29,50-100,1868,0.5631641143484819
STAT,1848,45,35-39,1893,0.11544374651573144
STAT,1872,24,45-49,1896,0.7036422176972684
SIM,1850,28,45-49,1878,2
SIM,1895,39,30-34,1934,8
SIM,1853,18,15-19,1871,7
STAT,1823,52,50-100,1875,0.020008343580152545
STAT,1842,28,45-49,1870,1.2273338796373592
STAT,1860,51,50-100,1911,0.012528891610745892
STAT,1870,34,50-100,1904,0.9009414552436683
STAT,1877,28,na,1905,2479.0105342773204
SIM,1886,17,na,1903,2851
STAT,1891,34,15-19,1925,0.1765530602583056
STAT,1895,40,45-49,1935,1.9939320893684491
SIM,1852,22,35-39,1874,7
STAT,1810,53,45-49,1863,0.0521147678997592
STAT,1856,41,15-19,1897,0.01074197584312917
SIM,1930,26,50-100,1956,1
STAT,1890,21,50-100,1911,0.5047983921692093
SIM,1884,50,na,1934,2269
SIM,1839,47,na,1886,1518
SIM,1916,19,15-19,1935,41
SIM,1835,33,na,1868,1621
STAT,1887,39,30-34,1926,5.949390053292129
STAT,1887,48,20-24,1935,0.01336172495409329
STAT,1920,27,20-24,1947,20.221037862159125
STAT,1941,24,25-29,1965,96.30673623448008
STAT,1829,45,25-29,1874,0.044107131084336615
SIM,1906,14,na,1920,3687
SIM,1830,30,35-39,1860,14
SIM,1883,18,30-34,1901,3
STAT,1830,89,na,1919,69.30799152939106
STAT,1866,28,30-34,1894,23.46803358164028
SIM,1897,33,20-24,1930,4
SIM,1878,35,45-49,1913,3
STAT,1842,26,25-29,1868,47.438951573948586
STAT,1938,15,15-19,1953,45.40480069341978
SIM,1862,66,na,1928,1459
SIM,1850,26,25-29,1876,8
STAT,1863,76,na,1939,847.8218361102664
STAT,1831,36,50-100,1867,0.9922130268617879
STAT,1871,44,15-19,1915,0.013670072270807273
SIM,1864,14,na,1878,2861
STAT,1896,25,15-19,1921,0.6106796777849256
SIM,1911,54,na,1965,3658
STAT,1892,57,na,1949,2546.9645043472674
STAT,1867,41,20-24,1908,0.1517499775229495
SIM,1870,45,50-100,1915,2
STAT,1865,42,25-29,1907,0.5915040428141725
SIM,1905,18,30-34,1923,4
STAT,1864,18,25-29,1882,5.311179038889172
STAT,1829,34,15-19,1863,0.12066431583284883
STAT,1844,22,35-39,1866,5.764550017454862
STAT,1897,46,30-34,1943,0.07414594487105554
SIM,1887,29,25-29,1916,59
STAT,1857,39,45-49,1896,1.5555396075927337
STAT,1852,35,45-49,1887,1.5519451894368304
SIM,1915,1,na,1916,4633
STAT,1948,22,15-19,1970,6.174289785278029
STAT,1840,24,25-29,1864,50.30128950370479
STAT,1842,16,50-100,1858,0.056977465795358985
STAT,1830,43,15-19,1873,0.011830524056375982
SIM,1827,41,na,1868,1558
STAT,1875,16,35-39,1891,0.5705285130808753
SIM,1856,32,20-24,1888,3
SIM,1829,85,na,1914,122
SIM,1871,42,50-100,1913,5
STAT,1932,31,na,1963,5083.833552266576
SIM,1874,26,40-44,1900,5
SIM,1879,16,15-19,1895,8
SIM,1913,23,30-34,1936,31
SIM,1826,96,na,1922,23
SIM,1796,81,na,1877,193
SIM,1804,93,na,1897,1
SIM,1888,24,na,1912,2877
SIM,1902,21,35-39,1923,8
SIM,1880,37,20-24,1917,1
STAT,1850,47,40-44,1897,0.13047905583870884
SIM,1883,16,35-39,1899,3
STAT,1826,40,20-24,1866,0.1724319877921169
STAT,1887,20,40-44,1907,2.363818828586862
SIM,1918,16,20-24,1934,28
SIM,1849,84,na,1933,233
STAT,1849,24,15-19,1873,3.073892336937858
SIM,1866,40,na,1906,2391
SIM,1860,30,20-24,1890,2
SIM,1891,27,25-29,1918,5
STAT,1835,47,15-19,1882,3.1657499876805044E-4
STAT,1832,37,na,1869,1829.7267431612545
STAT,1863,42,50-100,1905,0.9442440317118366
SIM,1907,25,35-39,1932,21
STAT,1886,19,15-19,1905,6.294624614743717
STAT,1868,39,20-24,1907,0.736604426211757
STAT,1790,96,na,1886,1.395820923633987
STAT,1931,17,25-29,1948,57.325512815129734
SIM,1860,35,45-49,1895,1
SIM,1888,26,50-100,1914,1
SIM,1835,27,40-44,1862,2
SIM,1840,19,25-29,1859,7
SIM,1854,44,50-100,1898,1
SIM,1838,22,na,1860,1909
STAT,1861,37,45-49,1898,1.673093756249177
STAT,1935,4,na,1939,5574.740147260808
STAT,1894,18,40-44,1912,0.23721218699616195
SIM,1900,33,30-34,1933,41
STAT,1931,28,35-39,1959,19.580173754841457
STAT,1848,32,20-24,1880,2.573678860911546
SIM,1859,23,40-44,1882,3
STAT,1879,29,25-29,1908,44.267027828489084
SIM,1797,66,na,1863,702
SIM,1922,25,30-34,1947,77
STAT,1766,109,na,1875,0.0015155835659691407
STAT,1910,40,35-39,1950,0.1941795927811247
STAT,1879,52,50-100,1931,0.01583355404373658
STAT,1819,55,na,1874,1195.895830264131
STAT,1815,41,na,1856,1398.5889087208052
STAT,1833,34,35-39,1867,9.06831410085148
SIM,1876,39,na,1915,2721
STAT,1849,19,40-44,1868,0.17395820585419153
SIM,1841,34,35-39,1875,9
STAT,1875,22,50-100,1897,0.42296734293219224
STAT,1846,44,50-100,1890,0.7909035798690025
SIM,1857,24,15-19,1881,6
STAT,1846,49,40-44,1895,0.12720843859111428
STAT,1878,42,35-39,1920,1.8962189155387064
SIM,1930,4,na,1934,5588
STAT,1914,19,50-100,1933,0.07777432100391153
SIM,1916,19,45-49,1935,1
STAT,1862,50,35-39,1912,0.007616903647075521
STAT,1827,27,40-44,1854,8.931026660469906
SIM,1865,37,25-29,1902,3
STAT,1875,54,30-34,1929,0.006004305063505598
STAT,1905,23,30-34,1928,25.927290399437855
STAT,1841,34,30-34,1875,15.515993392727383
STAT,1930,24,na,1954,4698.766508583166
SIM,1875,54,na,1929,2077
SIM,1923,34,25-29,1957,24
SIM,1871,40,na,1911,2241
SIM,1910,31,40-44,1941,6
SIM,1858,43,40-44,1901,10
STAT,1830,43,45-49,1873,1.2821329545938838
STAT,1894,29,20-24,1923,15.145791965498864
STAT,1873,52,30-34,1925,0.006062426254633461
STAT,1866,65,na,1931,1580.5079894242135
STAT,1857,34,20-24,1891,2.1124287760886
STAT,1921,29,50-100,1950,1.1123828537127511
STAT,1852,30,20-24,1882,2.1670473771310776
STAT,1911,44,20-24,1955,0.01679661385843604
STAT,1908,19,45-49,1927,0.09729125162348869
SIM,1917,23,45-49,1940,1
STAT,1827,38,20-24,1865,0.875859103293563
STAT,1851,54,45-49,1905,0.010686442887646811
SIM,1939,21,30-34,1960,38
SIM,1873,10,na,1883,2579
SIM,1815,56,na,1871,1194
SIM,1848,22,15-19,1870,2
SIM,1849,33,50-100,1882,1
STAT,1837,41,35-39,1878,1.4765315124832148
STAT,1877,68,na,1945,1593.0287582539345
STAT,1883,27,25-29,1910,41.809511776838995
STAT,1899,21,50-100,1920,0.5669660007903257
SIM,1889,23,15-19,1912,4
STAT,1826,45,45-49,1871,0.23897136565729848
STAT,1845,47,50-100,1892,0.1786198567915775
STAT,1933,25,40-44,1958,6.259433910768376
STAT,1822,78,na,1900,436.86154750601116
STAT,1856,10,na,1866,2213.174105213738
SIM,1929,17,35-39,1946,6
STAT,1904,44,20-24,1948,0.015768866887570662
STAT,1893,31,20-24,1924,3.480681021667165
STAT,1913,45,50-100,1958,0.22378900756138037
STAT,1856,41,45-49,1897,1.164161550265785
STAT,1858,52,35-39,1910,0.006785387566257843
SIM,1822,34,25-29,1856,17
STAT,1893,36,45-49,1929,2.5688347553340702
SIM,1906,54,na,1960,3022
STAT,1902,31,40-44,1933,6.214916944234092
SIM,1902,40,na,1942,3585
STAT,1850,36,30-34,1886,4.18882572261147
STAT,1915,34,25-29,1949,9.417163247317987
SIM,1923,45,35-39,1968,3
SIM,1846,28,25-29,1874,43
SIM,1926,25,45-49,1951,3
SIM,1824,36,25-29,1860,2
STAT,1908,46,na,1954,3379.1702907754443
SIM,1948,23,30-34,1971,45
STAT,1904,32,na,1936,3488.185257292041
SIM,1899,27,na,1926,3620
SIM,1948,17,45-49,1965,2
STAT,1859,33,35-39,1892,8.191859846994669
STAT,1880,32,na,1912,2531.1851817508314
STAT,1788,77,na,1865,312.3576316576964
SIM,1845,41,35-39,1886,1
STAT,1911,32,na,1943,3715.530180523327
STAT,1924,23,40-44,1947,3.9968386272004417
SIM,1932,23,40-44,1955,7
STAT,1872,37,20-24,1909,0.7827360605712673
STAT,1856,110,na,1966,0.0015929790775177895
SIM,1898,25,15-19,1923,3
STAT,1835,47,45-49,1882,0.1867794064822102
STAT,1841,45,40-44,1886,0.1319441578533189
SIM,1930,34,25-29,1964,15
SIM,1838,81,na,1919,351
STAT,1889,46,35-39,1935,0.17485021408457446
STAT,1817,48,na,1865,1309.2716401128935
STAT,1922,34,25-29,1956,10.49832302417908
STAT,1918,25,45-49,1943,1.8687521329348586
STAT,1861,37,15-19,1898,0.04712940718932229
STAT,1913,46,20-24,1959,0.010910151923231953
STAT,1940,7,na,1947,4080.6305807622416
SIM,1836,55,na,1891,1543
SIM,1873,4,na,1877,2690
STAT,1859,22,25-29,1881,48.248072636257874
STAT,1881,25,25-29,1906,41.46260250729563
STAT,1852,36,na,1888,1815.200148648068
STAT,1941,21,50-100,1962,0.6867365839361141
SIM,1867,22,25-29,1889,57
SIM,1915,28,na,1943,4179
STAT,1849,27,25-29,1876,39.205517369529474
STAT,1842,24,35-39,1866,6.531879644055324
SIM,1899,33,25-29,1932,23
STAT,1864,42,50-100,1906,0.9616512915667003
SIM,1885,32,50-100,1917,1
SIM,1893,8,na,1901,3425
SIM,1799,86,na,1885,86
SIM,1945,23,20-24,1968,119
STAT,1924,26,45-49,1950,2.039632124805592
SIM,1957,14,na,1971,5429
STAT,1817,52,40-44,1869,0.021676895480149148
STAT,1898,49,40-44,1947,0.1294651617005731
STAT,1854,62,na,1916,1371.6876606241997
STAT,1880,38,30-34,1918,5.6250995301799245
STAT,1896,26,15-19,1922,0.6086461144579017
STAT,1943,20,40-44,1963,3.6145814834306016
SIM,1846,35,25-29,1881,3
SIM,1860,37,40-44,1897,4
SIM,1874,24,20-24,1898,105
SIM,1914,15,30-34,1929,2
STAT,1930,37,25-29,1967,1.2980623112600398
STAT,1828,108,na,1936,0.001189076495036237
SIM,1919,6,na,1925,4385
STAT,1833,106,na,1939,0.008590194093275341
STAT,1833,24,25-29,1857,53.86244191998105
SIM,1872,5,na,1877,3056
SIM,1897,36,25-29,1933,7
STAT,1878,90,na,1968,244.4373248821079
STAT,1850,72,na,1922,967.0160764611657
SIM,1781,88,na,1869,5
SIM,1928,37,35-39,1965,6
SIM,1874,35,na,1909,2325
SIM,1879,1,na,1880,3612
STAT,1889,49,30-34,1938,0.0665827426969068
STAT,1897,30,45-49,1927,2.3802177514000946
SIM,1932,26,45-49,1958,3
STAT,1911,33,40-44,1944,3.8282720081082893
STAT,1925,19,15-19,1944,55.107663791225804
STAT,1815,44,30-34,1859,2.6899804707441315
SIM,1885,13,na,1898,2795
STAT,1866,24,20-24,1890,64.04574567247157
STAT,1906,15,30-34,1921,2.355640922607657
STAT,1848,68,na,1916,1247.7097968802686
STAT,1845,50,35-39,1895,0.006380916811881069
SIM,1851,42,40-44,1893,6
SIM,1838,29,40-44,1867,4
STAT,1887,67,na,1954,1787.5644644329825
STAT,1820,37,20-24,1857,1.8890626627802174
SIM,1939,29,35-39,1968,26
STAT,1882,35,30-34,1917,5.263699149284455
SIM,1910,31,35-39,1941,2
STAT,1829,73,na,1902,700.3439984918377
SIM,1824,76,na,1900,491
STAT,1836,27,15-19,1863,0.3703527705401243
STAT,1865,49,45-49,1914,0.21310800018948778
STAT,1908,27,50-100,1935,0.9578939783670927
STAT,1829,35,15-19,1864,0.04752379107823878
STAT,1891,72,na,1963,1817.7572844081174
STAT,1844,21,35-39,1865,5.806238812125923
STAT,1939,31,30-34,1970,16.237918174904372
STAT,1919,33,50-100,1952,0.8968462993697135
SIM,1902,18,na,1920,3842
STAT,1809,45,50-100,1854,0.9296150219116747
SIM,1862,40,35-39,1902,3
STAT,1866,101,na,1967,3.0894120017128945
STAT,1849,16,na,1865,2222.2197632751236
STAT,1944,15,50-100,1959,0.4073559552974934
SIM,1852,21,35-39,1873,6
STAT,1909,36,20-24,1945,0.2529976040097989
SIM,1829,29,30-34,1858,28
SIM,1894,15,35-39,1909,4
STAT,1900,30,30-34,1930,24.69308201820637
STAT,1855,24,45-49,1879,0.6044260525260714
SIM,1830,45,50-100,1875,3
STAT,1813,47,30-34,1860,0.2817049032187629
SIM,1836,95,na,1931,2
SIM,1877,18,na,1895,2666
STAT,1932,34,25-29,1966,12.400719882633133
SIM,1907,25,40-44,1932,6
STAT,1838,35,25-29,1873,2.3745205342652858
SIM,1882,30,na,1912,2130
STAT,1835,21,25-29,1856,57.548320153455386
STAT,1931,16,35-39,1947,5.564460590425898
STAT,1871,58,na,1929,1984.369187305789
SIM,1928,20,40-44,1948,6
STAT,1822,75,na,1897,575.5965327473589
STAT,1900,23,25-29,1923,80.06805447575616
SIM,1922,29,25-29,1951,119
STAT,1813,80,na,1893,271.2290401761885
STAT,1902,31,35-39,1933,14.513024808364733
SIM,1833,53,na,1886,1531
SIM,1907,18,35-39,1925,3
STAT,1875,17,25-29,1892,5.877629836086478
STAT,1840,29,30-34,1869,21.69479268933345
SIM,1831,40,na,1871,1730
STAT,1950,16,45-49,1966,0.5969227333740742
SIM,1839,44,na,1883,1539
STAT,1879,36,25-29,1915,3.0492793632271025
SIM,1889,22,45-49,1911,4
STAT,1898,30,20-24,1928,3.730801312627628
STAT,1886,15,35-39,1901,0.5878582330432655
SIM,1909,26,45-49,1935,4
STAT,1901,26,35-39,1927,13.708389809972445
STAT,1942,16,50-100,1958,0.3954230373590557
STAT,1862,91,na,1953,50.54326230957994
STAT,1856,17,15-19,1873,5.433757111261611
STAT,1873,35,na,1908,2435.2175459443356
STAT,1831,29,20-24,1860,9.8835960367851
STAT,1833,37,30-34,1870,4.731567208677145
SIM,1864,17,15-19,1881,7
SIM,1952,19,25-29,1971,1
STAT,1913,47,35-39,1960,0.12696943406720843
STAT,1889,36,25-29,1925,3.602993786642827
STAT,1880,30,35-39,1910,10.828230022545531
SIM,1808,86,na,1894,40
STAT,1854,48,30-34,1902,0.07173428603724716
STAT,1857,22,15-19,1879,3.0020549859021552
SIM,1841,24,25-29,1865,59
SIM,1844,13,na,1857,2054
STAT,1852,37,40-44,1889,3.337876625986489
SIM,1874,38,40-44,1912,2
SIM,1824,37,50-100,1861,1
SIM,1827,59,na,1886,1151
SIM,1848,80,na,1928,424
STAT,1792,106,na,1898,0.0021826874059794605
STAT,1847,19,30-34,1866,1.4719728520956992
SIM,1873,49,45-49,1922,3
SIM,1890,35,30-34,1925,12
SIM,1865,22,15-19,1887,3
STAT,1811,49,50-100,1860,0.5920472135866668
STAT,1844,78,na,1922,618.178090609189
STAT,1857,11,na,1868,2221.7637824140215
SIM,1887,36,25-29,1923,5
SIM,1800,82,na,1882,240
STAT,1898,21,50-100,1919,0.5600359115590805
STAT,1820,74,na,1894,564.9071097383868
STAT,1876,49,20-24,1925,0.012252830592756848
STAT,1947,19,35-39,1966,4.771360428014087
SIM,1852,47,50-100,1899,1
STAT,1869,30,na,1899,2362.093839956477
SIM,1823,44,30-34,1867,3
STAT,1855,25,15-19,1880,0.39685267403030366
STAT,1907,27,50-100,1934,0.9488095760677204
SIM,1825,58,na,1883,1012
SIM,1884,41,25-29,1925,2
STAT,1863,0,na,1863,3436.1485109736823
STAT,1915,44,35-39,1959,0.2038853748329142
SIM,1806,73,na,1879,593
STAT,1874,25,50-100,1899,0.6660514725008354
SIM,1855,19,30-34,1874,3
SIM,1924,15,30-34,1939,13
STAT,1913,15,na,1928,4002.837102628503
SIM,1855,56,na,1911,1792
STAT,1851,53,30-34,1904,0.004434829921553512
STAT,1929,26,20-24,1955,23.101122367352062
SIM,1933,19,15-19,1952,45
STAT,1940,29,na,1969,3852.732123773004
SIM,1824,34,35-39,1858,16
SIM,1841,37,30-34,1878,12
STAT,1842,77,na,1919,778.242277680276
STAT,1884,43,40-44,1927,2.224084303904812
STAT,1875,38,50-100,1913,1.2671200192927394
SIM,1894,71,na,1965,2129
STAT,1885,22,35-39,1907,5.866628257074804
STAT,1890,41,15-19,1931,0.017120668776227674
SIM,1848,32,25-29,1880,3
STAT,1819,71,na,1890,678.5631373812707
SIM,1907,55,na,1962,3393
STAT,1877,28,15-19,1905,0.471285322929494
SIM,1962,1,na,1963,5272
STAT,1867,46,45-49,1913,0.22512573819452972
STAT,1920,26,45-49,1946,1.9203531156085263
STAT,1967,1,na,1968,4966.600824822255
SIM,1900,17,na,1917,3687
SIM,1886,20,na,1906,2653
STAT,1919,12,na,1931,4421.0089310399035
STAT,1920,15,20-24,1935,30.960538853120926
SIM,1867,41,na,1908,2080
STAT,1922,31,20-24,1953,2.795528216692229
STAT,1881,46,50-100,1927,0.23978654697430027
STAT,1891,33,15-19,1924,0.17732620250121084
STAT,1924,20,30-34,1944,34.47513090865532
STAT,1825,89,na,1914,76.66374396569651
SIM,1821,43,50-100,1864,1
STAT,1859,32,35-39,1891,8.226575997704984
STAT,1876,41,25-29,1917,0.6726990236966772
STAT,1794,86,na,1880,73.95403160523207
STAT,1862,97,na,1959,8.374144181977497
STAT,1807,92,na,1899,14.753477933870782
SIM,1890,81,na,1971,1323
SIM,1920,37,na,1957,4450
SIM,1929,26,30-34,1955,60
STAT,1794,108,na,1902,3.562137157442125E-4
STAT,1920,37,25-29,1957,1.08863386657752
STAT,1875,49,50-100,1924,0.24942182456202744
SIM,1913,26,35-39,1939,13
SIM,1925,30,40-44,1955,9
STAT,1944,19,25-29,1963,47.06099928952609
SIM,1856,35,25-29,1891,4
SIM,1867,32,35-39,1899,11
STAT,1908,18,45-49,1926,0.09755954035947725
STAT,1896,25,45-49,1921,1.49445835842253
STAT,1887,30,45-49,1917,1.9822203440252595
STAT,1897,18,15-19,1915,8.01467709076825
STAT,1866,28,na,1894,2224.0977887203126
STAT,1916,15,30-34,1931,2.6218682334145136
SIM,1849,68,na,1917,1171
SIM,1852,26,na,1878,1839
STAT,1798,76,na,1874,448.2280775425681
STAT,1829,34,45-49,1863,1.4775686313458958
STAT,1874,44,25-29,1918,0.6551478539356206
STAT,1946,4,na,1950,4463.282862944857
STAT,1832,53,na,1885,1486.7237910976592
STAT,1907,20,30-34,1927,26.57730951088127
STAT,1905,26,35-39,1931,14.136715185781856
SIM,1884,22,25-29,1906,3
STAT,1864,25,25-29,1889,38.96504513134121
STAT,1895,49,30-34,1944,0.07051598558295151
STAT,1902,9,na,1911,3703.216175341174
STAT,1903,37,na,1940,3415.6094686901006
STAT,1850,38,45-49,1888,1.534594516018328
SIM,1932,20,30-34,1952,79
STAT,1914,29,25-29,1943,66.46856965336383
STAT,1938,26,30-34,1964,39.206134735294214
SIM,1856,32,na,1888,2151
SIM,1861,62,na,1923,1555
STAT,1918,26,45-49,1944,1.862529188332185
SIM,1819,46,na,1865,1449
SIM,1888,18,15-19,1906,12
STAT,1915,22,na,1937,3808.9989938929766
STAT,1807,100,na,1907,0.3760666769373695
STAT,1903,15,20-24,1918,25.619435833647508
STAT,1927,16,45-49,1943,0.6293351164975474
STAT,1948,24,35-39,1972,10.913969849646678
SIM,1822,39,30-34,1861,3
STAT,1921,10,na,1931,4575.3422298758915
STAT,1848,48,30-34,1896,0.07804012320654195
STAT,1824,42,15-19,1866,0.017160101871905014
STAT,1925,18,45-49,1943,0.6082511456849435
SIM,1837,34,45-49,1871,1
STAT,1887,15,50-100,1902,0.055502172110155956
SIM,1941,15,30-34,1956,18
SIM,1836,18,na,1854,2312
SIM,1879,40,45-49,1919,2
STAT,1917,30,40-44,1947,4.169595650958663
STAT,1933,34,30-34,1967,21.42767904903158
SIM,1936,12,na,1948,3929
SIM,1869,82,na,1951,436
SIM,1903,34,50-100,1937,1
STAT,1926,44,40-44,1970,0.3106033060681219
SIM,1878,30,45-49,1908,2
STAT,1856,45,30-34,1901,0.07570400419724754
STAT,1933,15,30-34,1948,16.564642404520775
STAT,1770,98,na,1868,0.2937421087055524
STAT,1879,25,45-49,1904,1.1781987174380972
SIM,1889,33,25-29,1922,15
SIM,1899,32,50-100,1931,6
STAT,1837,74,na,1911,757.0751010879807
SIM,1851,8,na,1859,2426
STAT,1906,41,20-24,1947,0.016297183278667186
SIM,1933,18,45-49,1951,1
STAT,1820,68,na,1888,769.492068994828
STAT,1894,37,na,1931,3063.5604375225853
SIM,1898,28,25-29,1926,71
SIM,1874,29,na,1903,2283
SIM,1906,36,45-49,1942,3
SIM,1843,21,25-29,1864,72
STAT,1874,2,na,1876,3391.807726671617
SIM,1895,37,na,1932,3167
STAT,1899,52,na,1951,2968.8101067866683
STAT,1843,42,40-44,1885,1.5619890049059513
SIM,1920,15,na,1935,4436
STAT,1814,40,na,1854,1543.4282934197374
SIM,1887,33,20-24,1920,3
SIM,1840,23,na,1863,1890
SIM,1865,35,35-39,1900,15
STAT,1841,48,45-49,1889,0.17502747586793338
SIM,1802,83,na,1885,99
STAT,1833,28,50-100,1861,0.5943942508488622
SIM,1956,5,na,1961,5294
STAT,1862,75,na,1937,897.9177245939073
SIM,1946,19,25-29,1965,75
SIM,1902,36,45-49,1938,1
STAT,1938,19,25-29,1957,43.12629771171468
STAT,1940,23,na,1963,3754.3673133015445
SIM,1902,25,20-24,1927,21
SIM,1804,56,na,1860,1302
STAT,1892,29,50-100,1921,0.8049383608549422
STAT,1869,51,35-39,1920,0.008494186685769027
STAT,1782,83,na,1865,133.10134155731066
SIM,1841,43,25-29,1884,3
SIM,1862,10,na,1872,2465
SIM,1870,45,na,1915,2510
STAT,1855,35,25-29,1890,2.187814190651204
STAT,1907,44,30-34,1951,0.11681560596150288
STAT,1944,16,45-49,1960,0.543005488411559
SIM,1846,73,na,1919,835
SIM,1876,21,20-24,1897,5
STAT,1923,41,20-24,1964,0.020885876023000835
STAT,1886,44,50-100,1930,1.1113860084010914
SIM,1915,20,30-34,1935,45
STAT,1829,95,na,1924,7.839553481557877
STAT,1854,45,20-24,1899,0.009095623448450411
SIM,1872,25,25-29,1897,48
STAT,1856,104,na,1960,0.13102145911572083
STAT,1937,23,20-24,1960,109.27917339898673
STAT,1879,38,na,1917,2470.8828491992263
STAT,1883,43,na,1926,2267.861396744858
STAT,1838,24,45-49,1862,0.5969666430406537
STAT,1918,29,25-29,1947,70.21235165919461
SIM,1857,27,25-29,1884,39
STAT,1860,53,40-44,1913,0.008552349122350138
STAT,1899,18,25-29,1917,7.834366208397945
STAT,1848,35,25-29,1883,2.4733237537083506
STAT,1891,39,45-49,1930,2.4677226085886934
SIM,1844,47,na,1891,1493
SIM,1865,15,na,1880,2411
STAT,1878,13,na,1891,2703.447167537388
STAT,1850,32,15-19,1882,0.11407045449102624
STAT,1903,37,25-29,1940,0.89390108124744
STAT,1868,21,20-24,1889,67.00167340180228
SIM,1833,21,25-29,1854,77
SIM,1869,40,45-49,1909,1
SIM,1824,70,na,1894,741
STAT,1824,48,45-49,1872,0.27237197531186974
SIM,1926,29,25-29,1955,86
SIM,1787,67,na,1854,721
SIM,1846,24,45-49,1870,1
SIM,1951,20,40-44,1971,6
STAT,1904,47,25-29,1951,0.046873799703423834
STAT,1881,17,na,1898,2458.8428865957944
STAT,1913,24,50-100,1937,0.666205606233341
STAT,1917,42,35-39,1959,0.21211653648579668
STAT,1876,9,na,1885,2764.6738743359792
STAT,1851,18,50-100,1869,0.04483635858425495
SIM,1837,37,na,1874,1604
STAT,1821,53,45-49,1874,0.02005543309510407
STAT,1877,25,35-39,1902,10.126506602612062
STAT,1895,46,20-24,1941,0.00895341099178509
STAT,1924,45,45-49,1969,0.26269476149803506
STAT,1933,35,na,1968,5187.233853973457
STAT,1871,40,35-39,1911,1.8353487151416463
STAT,1941,31,30-34,1972,16.710045036483507
STAT,1858,92,na,1950,33.002436706991595
STAT,1834,52,40-44,1886,0.006428653451852849
STAT,1923,15,30-34,1938,14.528452090011713
STAT,1851,27,40-44,1878,2.655752215549999
STAT,1854,46,na,1900,1693.2691648546395
SIM,1919,30,40-44,1949,8
STAT,1910,16,35-39,1926,0.8409197444056631
STAT,1926,42,45-49,1968,0.20736151855007617
STAT,1905,39,25-29,1944,0.8982438421422096
SIM,1909,29,25-29,1938,98
STAT,1850,56,na,1906,1561.7759445989366
STAT,1936,24,na,1960,3522.3081140032914
STAT,1932,31,20-24,1963,3.2787203032530168
SIM,1833,23,20-24,1856,73
STAT,1869,14,na,1883,2588.019915773987
STAT,1832,99,na,1931,1.2895798618439902
STAT,1924,2,na,1926,4921.507164665347
SIM,1906,30,30-34,1936,20
STAT,1900,33,35-39,1933,14.14842717847812
SIM,1870,61,na,1931,2088
STAT,1909,39,25-29,1948,0.9309796157518521
STAT,1874,60,na,1934,1972.3853682075749
STAT,1912,29,15-19,1941,0.6968604293126113
STAT,1837,42,50-100,1879,0.85046137286445
SIM,1902,24,na,1926,3518
STAT,1835,40,25-29,1875,0.5927183828925907
STAT,1874,25,25-29,1899,44.044487880214625
SIM,1834,42,40-44,1876,7
STAT,1918,22,40-44,1940,3.6611026460787865
STAT,1947,16,30-34,1963,13.872841298495137
STAT,1922,36,20-24,1958,0.3032985040380267
SIM,1908,6,na,1914,3828
SIM,1846,21,35-39,1867,7
STAT,1893,33,40-44,1926,5.5381152267276
SIM,1955,16,30-34,1971,17
STAT,1857,32,25-29,1889,8.123519837259119
STAT,1862,41,na,1903,2025.0317611081784
STAT,1832,44,30-34,1876,0.9360838715555521
STAT,1911,36,45-49,1947,0.6674951760532951
STAT,1828,50,35-39,1878,0.00787983347575928
STAT,1801,79,na,1880,308.6386793657345
STAT,1895,41,35-39,1936,0.16660564674767944
STAT,1879,33,20-24,1912,2.837000558456491
STAT,1893,49,20-24,1942,0.008499596420484845
STAT,1857,29,na,1886,1909.9031719001814
SIM,1917,22,30-34,1939,38
SIM,1865,32,25-29,1897,14
STAT,1909,22,30-34,1931,26.955482062369892
STAT,1925,25,50-100,1950,1.196162765859044
STAT,1903,26,45-49,1929,1.6025554748666497
STAT,1813,64,na,1877,920.337126829516
STAT,1893,21,na,1914,3042.1934315768913
STAT,1920,23,40-44,1943,3.76310091265132
STAT,1913,44,30-34,1957,0.1253723652000289
SIM,1831,24,na,1855,1854
STAT,1838,21,35-39,1859,5.104838438461748
STAT,1884,46,45-49,1930,0.23572218492103658
SIM,1891,47,na,1938,2861
SIM,1871,30,35-39,1901,12
SIM,1929,19,25-29,1948,63
STAT,1915,41,30-34,1956,0.13006428514397095
STAT,1828,91,na,1919,37.617240303696185
SIM,1806,57,na,1863,1191
STAT,1877,65,na,1942,1761.6563332615253
SIM,1839,31,45-49,1870,2
SIM,1933,25,50-100,1958,1
STAT,1875,64,na,1939,1803.05574357009
STAT,1918,48,25-29,1966,0.056830455739744226
STAT,1900,20,20-24,1920,97.2618753552354
SIM,1891,24,50-100,1915,1
STAT,1838,32,20-24,1870,2.2484887089431105
SIM,1889,35,20-24,1924,1
STAT,1896,20,45-49,1916,0.937826412856311
STAT,1836,43,na,1879,1556.9154512103685
SIM,1886,14,na,1900,2897
STAT,1865,43,15-19,1908,0.012644194791944344
STAT,1873,54,20-24,1927,7.347852442929051E-4
SIM,1875,43,40-44,1918,2
SIM,1778,84,na,1862,43
STAT,1873,19,40-44,1892,0.18627186785854466
SIM,1849,22,na,1871,2103
STAT,1880,69,na,1949,1556.6386745476004
STAT,1867,43,40-44,1910,2.1241047841600675
SIM,1859,16,35-39,1875,3
SIM,1846,32,20-24,1878,5
SIM,1868,57,na,1925,1884
SIM,1910,3,na,1913,3862
STAT,1930,21,na,1951,4742.6422604163345
STAT,1924,30,50-100,1954,0.9791414484822589
STAT,1806,54,30-34,1860,0.016501130158977372
STAT,1857,35,35-39,1892,5.628138501267251
SIM,1820,80,na,1900,286
STAT,1893,47,50-100,1940,0.17683967434297904
STAT,1873,45,30-34,1918,0.10010257491892252
STAT,1880,22,50-100,1902,0.432547567408252
STAT,1933,37,35-39,1970,3.329146095722746
SIM,1928,23,45-49,1951,2
STAT,1809,50,25-29,1859,0.011863437931931991
STAT,1937,20,40-44,1957,3.3078085523208096
STAT,1836,24,35-39,1860,4.788857530156583
STAT,1859,49,20-24,1908,0.009544495906019052
STAT,1895,68,na,1963,2222.0477911243233
STAT,1913,34,15-19,1947,0.12789439531712898
STAT,1945,20,na,1965,4044.726289718672
STAT,1866,19,40-44,1885,0.17351381761027548
STAT,1835,67,na,1902,1189.7817408085882
STAT,1854,40,35-39,1894,1.3727041239110396
STAT,1898,33,25-29,1931,13.965081261185555
SIM,1948,19,35-39,1967,10
STAT,1901,23,30-34,1924,25.141724851988172
STAT,1888,15,50-100,1903,0.0586751434478196
STAT,1838,105,na,1943,0.01962803351961855
STAT,1924,39,na,1963,4473.383160935343
STAT,1895,46,50-100,1941,0.18324647104332756
STAT,1906,18,35-39,1924,0.8050930452382131
SIM,1914,18,35-39,1932,1
SIM,1945,20,40-44,1965,4
SIM,1931,15,30-34,1946,17
SIM,1940,8,na,1948,4229
STAT,1931,29,25-29,1960,85.79675539051733
SIM,1850,25,na,1875,2044
STAT,1865,46,40-44,1911,0.1583385071727192
SIM,1917,44,40-44,1961,1
SIM,1937,26,20-24,1963,30
STAT,1945,8,na,1953,4350.089094920824
STAT,1863,46,15-19,1909,3.5897190811490324E-4
SIM,1924,27,na,1951,4437
STAT,1813,44,20-24,1857,0.4979393699500569
STAT,1903,53,na,1956,3066.816744677357
SIM,1769,88,na,1857,85
STAT,1824,58,na,1882,1060.3084009567626
STAT,1908,15,40-44,1923,0.275156863111157
STAT,1864,22,20-24,1886,63.8159350021141
SIM,1865,44,25-29,1909,3
SIM,1908,33,45-49,1941,1
STAT,1889,50,na,1939,2720.1519801764316
SIM,1944,18,20-24,1962,198
SIM,1891,25,35-39,1916,18
STAT,1878,21,45-49,1899,0.7333174160690362
STAT,1879,22,40-44,1901,2.196334146285615
STAT,1878,30,35-39,1908,10.703117836091337
STAT,1911,37,15-19,1948,0.018712618398908816
SIM,1826,31,35-39,1857,14
STAT,1870,92,na,1962,91.67950708610738
SIM,1861,49,50-100,1910,2
STAT,1927,41,na,1968,4714.6490473486565
SIM,1929,29,35-39,1958,21
STAT,1867,48,40-44,1915,0.16080298743657398
STAT,1900,48,na,1948,3117.469033032743
STAT,1924,18,50-100,1942,0.4496597339761774
STAT,1865,86,na,1951,204.6266423069586
STAT,1930,15,50-100,1945,0.49184034983268266
SIM,1887,22,40-44,1909,3
STAT,1906,44,25-29,1950,0.06471499553078675
SIM,1829,39,40-44,1868,7
SIM,1933,27,35-39,1960,32
STAT,1772,100,na,1872,0.15372557882835236
STAT,1857,44,25-29,1901,0.49934420637890986
STAT,1853,49,50-100,1902,0.19886474911989252
STAT,1889,40,20-24,1929,0.19978054802658024
SIM,1905,25,30-34,1930,46
STAT,1907,27,na,1934,3539.7577704346286
STAT,1942,15,40-44,1957,1.4766155190064212
SIM,1845,78,na,1923,604
SIM,1874,19,40-44,1893,1
SIM,1831,24,25-29,1855,64
STAT,1875,53,40-44,1928,0.010744138472662836
STAT,1850,35,40-44,1885,3.4764462170780903
SIM,1939,23,20-24,1962,115
STAT,1862,54,45-49,1916,0.012309934910846214
STAT,1936,18,20-24,1954,130.69809797344854
SIM,1848,34,20-24,1882,1
SIM,1886,30,35-39,1916,17
STAT,1883,25,35-39,1908,9.601424546457123
STAT,1886,85,na,1971,640.8890797184188
SIM,1859,46,na,1905,2112
SIM,1915,23,35-39,1938,15
STAT,1866,38,40-44,1904,4.0736770576792765
SIM,1870,17,15-19,1887,5
SIM,1950,15,40-44,1965,1
STAT,1877,71,na,1948,1391.42728615608
SIM,1829,51,50-100,1880,2
STAT,1822,45,15-19,1867,6.099432751735993E-4
SIM,1922,26,20-24,1948,35
SIM,1864,11,na,1875,2892
SIM,1882,86,na,1968,327
SIM,1850,42,50-100,1892,1
STAT,1914,26,20-24,1940,18.630138439644362
STAT,1885,39,20-24,1924,0.7671638041703642
STAT,1890,15,25-29,1905,7.026147813869717
STAT,1807,47,30-34,1854,0.3486079356014293
STAT,1907,23,35-39,1930,8.628601625014879
SIM,1874,28,30-34,1902,4
STAT,1862,17,15-19,1879,5.928346176728897
SIM,1858,32,25-29,1890,16
STAT,1841,73,na,1914,888.2187117153761
STAT,1843,50,25-29,1893,0.0024233041616970445
STAT,1898,22,45-49,1920,0.954778811545836
STAT,1818,48,20-24,1866,0.02105021372307376
SIM,1857,63,na,1920,1519
SIM,1907,33,na,1940,3824
STAT,1874,38,30-34,1912,5.484455376097568
STAT,1857,21,45-49,1878,0.6391396308657198
STAT,1810,52,30-34,1862,0.02181183140860499
STAT,1882,18,na,1900,2464.446799715951
STAT,1804,81,na,1885,198.13089509286874
SIM,1891,15,25-29,1906,9
STAT,1891,36,40-44,1927,5.500318321088713
STAT,1898,36,35-39,1934,9.730917184919344
STAT,1844,38,20-24,1882,0.6378216778744665
STAT,1876,22,25-29,1898,59.698182064824415
STAT,1893,38,40-44,1931,5.58604627508145
STAT,1900,26,na,1926,3359.809272250992
STAT,1904,31,45-49,1935,2.537857757955089
SIM,1882,64,na,1946,1403
SIM,1907,37,35-39,1944,13
STAT,1868,46,50-100,1914,0.23774853917896197
SIM,1882,38,30-34,1920,8
STAT,1935,26,20-24,1961,25.150962333949856
SIM,1846,21,40-44,1867,2
STAT,1769,107,na,1876,0.006526588138465404
STAT,1842,21,na,1863,2445.590213618842
STAT,1915,56,na,1971,3596.258845758107
STAT,1810,50,na,1860,1466.8741844117874
STAT,1881,15,15-19,1896,5.804517551852586
STAT,1939,9,na,1948,4014.0104141054626
STAT,1955,16,20-24,1971,181.87583976439043
SIM,1819,40,na,1859,1573
STAT,1933,18,35-39,1951,5.661337544592682
SIM,1889,30,20-24,1919,5
STAT,1807,86,na,1893,78.5952329314098
SIM,1941,18,35-39,1959,4
SIM,1837,43,na,1880,1504
SIM,1848,33,50-100,1881,1
STAT,1824,45,40-44,1869,0.2059275860767578
STAT,1855,40,50-100,1895,0.80323734579448
STAT,1861,30,25-29,1891,8.665513360080809
STAT,1845,26,na,1871,1937.8732206014897
SIM,1850,24,35-39,1874,6
STAT,1826,84,na,1910,182.53907420222467
SIM,1904,22,20-24,1926,108
SIM,1943,26,20-24,1969,27
STAT,1826,47,40-44,1873,0.16870069379534888
SIM,1916,15,40-44,1931,1
STAT,1774,88,na,1862,28.523841946367995
STAT,1918,33,50-100,1951,0.8832489161925203
STAT,1918,37,45-49,1955,0.725424702742887
SIM,1859,35,35-39,1894,4
STAT,1900,34,50-100,1934,1.274496769493108
SIM,1855,29,40-44,1884,3
STAT,1879,22,35-39,1901,6.150594959167868
SIM,1924,25,40-44,1949,8
SIM,1865,92,na,1957,100
SIM,1872,22,20-24,1894,90
STAT,1838,21,40-44,1859,1.8229018571533078
SIM,1887,22,35-39,1909,6
STAT,1898,23,15-19,1921,4.503094933402557
STAT,1926,23,45-49,1949,1.3772587094546496
SIM,1902,33,40-44,1935,3
STAT,1907,47,35-39,1954,0.11658688559980539
SIM,1833,37,40-44,1870,8
STAT,1948,21,30-34,1969,33.34759056643101
STAT,1870,70,na,1940,1391.552499603508
SIM,1824,92,na,1916,10
STAT,1843,45,45-49,1888,0.162544357929022
SIM,1835,20,20-24,1855,59
STAT,1833,47,40-44,1880,0.14240359100238337
STAT,1848,39,40-44,1887,3.6074275434703216
STAT,1892,28,40-44,1920,3.7831516100664078
STAT,1890,47,na,1937,2764.234247694921
STAT,1916,25,40-44,1941,4.896537697600987
SIM,1852,38,20-24,1890,1
SIM,1921,34,20-24,1955,4
SIM,1848,29,40-44,1877,4
STAT,1911,31,45-49,1942,1.55221452087182
STAT,1880,35,20-24,1915,0.8254128039841511
SIM,1912,31,45-49,1943,2
STAT,1920,34,20-24,1954,2.6748969804148603
STAT,1847,29,40-44,1876,2.657265565767349
STAT,1882,12,na,1894,2526.5915176999606
SIM,1885,69,na,1954,1436
STAT,1912,41,45-49,1953,0.16287755439766113
STAT,1825,37,40-44,1862,7.2283286874784345
SIM,1897,63,na,1960,2489
SIM,1934,23,45-49,1957,2
SIM,1791,66,na,1857,655
STAT,1863,100,na,1963,3.1765157483976862
STAT,1907,45,45-49,1952,0.19942123182330895
STAT,1854,49,50-100,1903,0.1804710490221101
STAT,1865,32,15-19,1897,0.13133633202867634
SIM,1878,19,na,1897,2926
STAT,1877,32,50-100,1909,0.9551157301844185
STAT,1855,9,na,1864,2181.205554600065
STAT,1892,17,25-29,1909,7.181893698450757
SIM,1897,32,45-49,1929,4
SIM,1878,81,na,1959,781
SIM,1869,0,na,1869,3427
SIM,1943,22,40-44,1965,4
STAT,1899,15,20-24,1914,24.68861316854498
STAT,1837,48,30-34,1885,0.06767902945742729
SIM,1946,22,15-19,1968,5
STAT,1829,31,35-39,1860,9.258021131695763
STAT,1859,52,na,1911,1739.7833876341213
STAT,1876,44,35-39,1920,1.862904591965845
STAT,1913,34,20-24,1947,2.4275802993665985
SIM,1930,39,25-29,1969,4
SIM,1810,59,na,1869,1185
SIM,1891,22,25-29,1913,83
STAT,1926,22,30-34,1948,35.28954539516762
SIM,1833,26,25-29,1859,52
SIM,1871,46,na,1917,2160
STAT,1837,19,50-100,1856,0.04851675417034589
SIM,1884,44,35-39,1928,5
STAT,1922,39,25-29,1961,1.129409657012033
STAT,1928,19,30-34,1947,15.44027326981552
SIM,1924,28,45-49,1952,1
STAT,1785,75,na,1860,397.6498373199945
SIM,1956,13,na,1969,5292
STAT,1864,29,40-44,1893,2.7106058527565695
SIM,1934,22,30-34,1956,50
STAT,1923,18,35-39,1941,4.965423899495212
SIM,1930,34,30-34,1964,38
STAT,1901,18,15-19,1919,8.380463371268066
SIM,1852,20,20-24,1872,80
STAT,1879,91,na,1970,213.6246238984564
STAT,1922,34,30-34,1956,17.895619833989095
STAT,1896,22,35-39,1918,7.801577025976384
SIM,1894,4,na,1898,3773
STAT,1880,88,na,1968,370.0813231382014
STAT,1821,50,40-44,1871,0.015444182439788097
SIM,1833,21,30-34,1854,24
SIM,1921,22,20-24,1943,178
STAT,1853,61,na,1914,1545.3177628162473
STAT,1859,21,35-39,1880,5.443803641485945
STAT,1881,26,15-19,1907,0.4432249498977986
SIM,1829,32,20-24,1861,3
STAT,1916,28,45-49,1944,1.7963221084396546
SIM,1867,21,35-39,1888,9
STAT,1883,22,25-29,1905,56.579921535627236
SIM,1909,5,na,1914,4284
SIM,1909,26,20-24,1935,32
STAT,1922,47,50-100,1969,0.262495990821392
SIM,1822,69,na,1891,812
STAT,1789,65,na,1854,966.9999999999999
STAT,1809,53,35-39,1862,0.02707704055706016
SIM,1893,73,na,1966,1906
SIM,1824,43,25-29,1867,3
STAT,1860,49,na,1909,1818.7445196826877
SIM,1830,61,na,1891,1016
SIM,1932,35,35-39,1967,9
STAT,1848,15,na,1863,2350.8774903544645
STAT,1857,25,25-29,1882,34.84324287686254
SIM,1809,87,na,1896,23
SIM,1875,32,25-29,1907,14
STAT,1888,28,15-19,1916,0.5389602561721771
STAT,1913,44,25-29,1957,0.07002780787572375
SIM,1822,44,na,1866,1553
STAT,1822,94,na,1916,11.174687539337238
SIM,1948,18,na,1966,4667
STAT,1883,34,25-29,1917,10.03682316845345
SIM,1902,28,25-29,1930,12
STAT,1805,49,30-34,1854,0.4038340363527792
STAT,1870,27,15-19,1897,0.4499768445044642
SIM,1882,36,40-44,1918,5
STAT,1861,2,na,1863,2888.9824139102543
STAT,1833,51,50-100,1884,0.01127375932632977
STAT,1842,12,na,1854,2760.0
SIM,1824,31,25-29,1855,20
STAT,1848,49,45-49,1897,0.1886610947307266
SIM,1874,25,35-39,1899,13
SIM,1889,59,na,1948,2314
STAT,1844,20,20-24,1864,69.06305003768368
SIM,1916,27,50-100,1943,2
SIM,1911,38,na,1949,3889
STAT,1892,73,na,1965,1803.0434605754556
SIM,1891,34,25-29,1925,2
STAT,1863,103,na,1966,0.7493555202871232
STAT,1912,11,na,1923,4035.060919203589
SIM,1817,41,35-39,1858,2
STAT,1866,25,35-39,1891,9.085213891153098
STAT,1816,43,25-29,1859,1.776841528518293
SIM,1884,32,35-39,1916,14
STAT,1902,22,45-49,1924,0.9952592266883202
STAT,1904,44,15-19,1948,0.0013712058903705103
SIM,1936,19,30-34,1955,20
STAT,1874,36,40-44,1910,4.548957353614549
STAT,1942,29,50-100,1971,1.0537234362558507
STAT,1873,15,25-29,1888,5.871176257437816
STAT,1884,3,na,1887,2946.655807519356
STAT,1912,17,20-24,1929,27.658804900494264
STAT,1924,35,35-39,1959,2.887101002853909
STAT,1903,27,15-19,1930,0.6526117500422077
STAT,1855,21,35-39,1876,5.168626056603079
STAT,1937,23,45-49,1960,1.1057896869460055
SIM,1863,29,30-34,1892,26
SIM,1867,38,40-44,1905,10
STAT,1918,45,20-24,1963,0.011928564484768067
STAT,1889,20,45-49,1909,0.8736218466313171
SIM,1889,38,25-29,1927,3
SIM,1796,87,na,1883,63
SIM,1841,21,15-19,1862,3
SIM,1855,37,na,1892,2021
STAT,1876,32,35-39,1908,10.560939315270911
STAT,1922,27,25-29,1949,75.241600578418
STAT,1848,42,25-29,1890,0.5236490425312391
SIM,1817,45,50-100,1862,1
SIM,1932,23,35-39,1955,16
STAT,1955,13,na,1968,5267.278374954347
SIM,1857,5,na,1862,2641
SIM,1942,15,na,1957,4076
STAT,1857,50,50-100,1907,0.012075731582620559
STAT,1909,32,40-44,1941,3.7683545686824753
SIM,1945,23,45-49,1968,1
SIM,1917,32,40-44,1949,7
SIM,1897,54,na,1951,2843
SIM,1963,3,na,1966,5084
STAT,1919,46,50-100,1965,0.2483128628908197
SIM,1930,27,25-29,1957,106
STAT,1836,27,na,1863,1764.8829388690908
STAT,1930,34,15-19,1964,0.16740230362728512
STAT,1833,21,15-19,1854,3.3196422750072685
STAT,1912,33,na,1945,3738.7781849505145
STAT,1855,29,30-34,1884,19.47466737676737
STAT,1892,70,na,1962,1972.9167544738543
SIM,1837,27,50-100,1864,4
SIM,1929,36,na,1965,4701
SIM,1920,17,20-24,1937,177
STAT,1822,39,20-24,1861,1.3135109999272592
STAT,1885,31,50-100,1916,0.9249005651575637
STAT,1942,18,45-49,1960,0.5269144252887259
STAT,1888,23,20-24,1911,81.89754121183431
STAT,1823,54,30-34,1877,0.007578379314588102
STAT,1883,15,25-29,1898,5.626854237519833
SIM,1885,23,45-49,1908,1
SIM,1891,60,na,1951,2333
STAT,1823,57,na,1880,1207.8716748609077
STAT,1909,44,40-44,1953,0.23317967387318328
SIM,1950,10,na,1960,4537
SIM,1939,20,25-29,1959,161
STAT,1877,23,45-49,1900,0.7246581338943212
STAT,1830,36,na,1866,1795.5580024665537
STAT,1835,43,35-39,1878,1.6083803738744848
STAT,1889,32,45-49,1921,2.171746032628713
STAT,1862,51,40-44,1913,0.009226364071458262
STAT,1882,43,15-19,1925,0.013413214088643217
SIM,1896,23,20-24,1919,101
STAT,1859,77,na,1936,702.1764919217928
STAT,1903,39,15-19,1942,0.017258775184664076
STAT,1955,17,35-39,1972,5.627594907642801
SIM,1858,42,na,1900,1904
STAT,1884,44,na,1928,2270.910799923686
SIM,1843,43,35-39,1886,1
STAT,1942,24,30-34,1966,30.405413561186375
SIM,1883,38,50-100,1921,1
SIM,1843,31,35-39,1874,12
STAT,1868,38,15-19,1906,0.05393662673468767
SIM,1869,41,50-100,1910,1
STAT,1898,26,25-29,1924,58.11824073723288
STAT,1929,24,30-34,1953,36.5061578378224
STAT,1930,30,na,1960,4938.8039519448075
STAT,1898,45,25-29,1943,0.04493074987777621
SIM,1841,38,45-49,1879,5
STAT,1847,27,15-19,1874,0.40830673849057625
STAT,1893,22,25-29,1915,73.4141467682448
STAT,1861,27,40-44,1888,2.532382822233411
STAT,1919,43,20-24,1962,0.019292896098366236
STAT,1904,38,na,1942,3424.6718290882736
SIM,1924,22,30-34,1946,47
STAT,1929,29,25-29,1958,83.17843777512772
SIM,1929,33,na,1962,4673
STAT,1773,87,na,1860,56.47461771197335
STAT,1901,17,45-49,1918,0.0924873545732437
STAT,1847,25,25-29,1872,38.62151070832767
STAT,1847,25,50-100,1872,0.5840438909733345
STAT,1948,23,20-24,1971,128.93064531281848
STAT,1936,3,na,1939,3920.4196082957656
STAT,1791,97,na,1888,0.8985843220144274
STAT,1833,38,45-49,1871,1.7515234565228535
SIM,1848,32,30-34,1880,5
SIM,1777,83,na,1860,90
SIM,1855,31,na,1886,2140
STAT,1846,46,15-19,1892,3.044155430807327E-4
STAT,1841,42,15-19,1883,0.010731244334979937
SIM,1860,40,25-29,1900,3
STAT,1900,23,na,1923,3307.9363684305667
SIM,1846,54,na,1900,1480
SIM,1889,26,25-29,1915,60
SIM,1937,29,25-29,1966,6
STAT,1920,18,25-29,1938,48.969036344735244
STAT,1838,25,15-19,1863,0.3919549920250307
STAT,1916,34,30-34,1950,16.27463110775421
SIM,1848,37,25-29,1885,2
SIM,1903,29,20-24,1932,15
STAT,1857,38,30-34,1895,4.180172461447311
STAT,1883,19,40-44,1902,0.17980667437508116
STAT,1889,43,25-29,1932,0.7939615075358322
STAT,1811,54,na,1865,1169.32964488387
STAT,1835,31,35-39,1866,9.781681137287853
STAT,1851,16,25-29,1867,5.247709149336798
STAT,1945,5,na,1950,4385.384983866407
STAT,1910,19,45-49,1929,0.09932865535243536
STAT,1859,31,20-24,1890,2.204764171100754
STAT,1878,49,30-34,1927,0.09937137945880656
SIM,1933,24,30-34,1957,49
STAT,1916,22,30-34,1938,30.393029612962906
STAT,1872,37,na,1909,2392.308425544111
SIM,1903,17,20-24,1920,24
STAT,1852,31,35-39,1883,8.035020119905512
SIM,1898,46,50-100,1944,3
STAT,1861,96,na,1957,9.632298875906862
SIM,1839,23,25-29,1862,69
STAT,1836,104,na,1940,0.04205597579424034
STAT,1842,21,25-29,1863,65.47752149247962
SIM,1867,31,20-24,1898,2
STAT,1838,102,na,1940,0.1962591002190966
STAT,1891,16,50-100,1907,0.06141373950216795
STAT,1924,36,na,1960,4487.0099027818005
STAT,1832,40,15-19,1872,0.01184000486383938
SIM,1908,34,na,1942,3424
SIM,1877,34,na,1911,2465
SIM,1907,21,25-29,1928,142
SIM,1878,20,40-44,1898,2
SIM,1849,16,35-39,1865,1
SIM,1905,28,35-39,1933,22
STAT,1888,16,15-19,1904,7.092022760511226
SIM,1860,31,35-39,1891,1
STAT,1893,36,na,1929,3035.9450186533695
STAT,1800,91,na,1891,20.327268994526506
SIM,1839,35,25-29,1874,5
SIM,1917,39,25-29,1956,2
STAT,1842,33,25-29,1875,11.02505206541906
SIM,1830,37,30-34,1867,4
STAT,1893,58,na,1951,2536.153036242511
STAT,1884,22,na,1906,2355.576592701134
SIM,1865,25,25-29,1890,43
STAT,1936,31,50-100,1967,0.811230878314564
SIM,1900,34,45-49,1934,2
SIM,1896,16,15-19,1912,8
STAT,1797,60,na,1857,988.4896048797516
STAT,1872,59,na,1931,1973.434088886813
STAT,1916,16,45-49,1932,0.10721934544160043
STAT,1898,39,30-34,1937,1.5592068259748564
STAT,1952,15,35-39,1967,5.083247137639409
SIM,1848,25,25-29,1873,40
SIM,1834,54,na,1888,1485
SIM,1879,44,na,1923,2690
SIM,1892,23,na,1915,3215
STAT,1888,15,45-49,1903,0.0782335245970928
SIM,1850,21,25-29,1871,74
STAT,1904,16,na,1920,3669.6516640032105
STAT,1836,22,45-49,1858,0.5805603784813838
SIM,1900,60,na,1960,3069
STAT,1807,48,45-49,1855,0.832144731366336
STAT,1817,54,na,1871,1180.6667447614693
SIM,1907,34,30-34,1941,18
STAT,1930,41,20-24,1971,0.02351962191077997
SIM,1850,9,na,1859,2324
STAT,1827,43,50-100,1870,1.1170914334775728
SIM,1809,62,na,1871,893
STAT,1949,10,na,1959,4616.689908054933
SIM,1869,30,35-39,1899,10
SIM,1924,34,30-34,1958,30
STAT,1861,33,35-39,1894,8.463577490103507
STAT,1901,24,45-49,1925,0.9811272170418869
SIM,1840,16,15-19,1856,4
SIM,1889,33,30-34,1922,32
STAT,1874,39,45-49,1913,2.0408936813676024
SIM,1855,25,25-29,1880,48
STAT,1891,29,50-100,1920,0.794204192841734
STAT,1897,11,na,1908,3502.087318291816
STAT,1943,28,na,1971,4026.5341205228674
SIM,1937,24,30-34,1961,33
STAT,1861,21,35-39,1882,5.06788498537287
STAT,1822,37,30-34,1859,9.931158994424402
STAT,1802,77,na,1879,346.3666305754094
STAT,1847,67,na,1914,1186.9112884409897
STAT,1898,73,na,1971,2061.5525536215923
STAT,1937,2,na,1939,4016.71995317134
SIM,1879,19,25-29,1898,10
STAT,1859,71,na,1930,1084.3060254031554
STAT,1860,31,na,1891,1978.2532690588985
SIM,1921,24,50-100,1945,1
SIM,1850,33,25-29,1883,15
STAT,1826,31,25-29,1857,15.271430864747952
STAT,1935,34,40-44,1969,5.462957123963583
SIM,1859,20,30-34,1879,31
SIM,1882,21,45-49,1903,2
SIM,1895,6,na,1901,3465
STAT,1877,74,na,1951,1156.8694882076468
STAT,1831,39,30-34,1870,4.168012218618038
SIM,1834,69,na,1903,1015
SIM,1810,44,45-49,1854,5
SIM,1841,28,50-100,1869,1
STAT,1873,81,na,1954,553.693951696246
STAT,1841,76,na,1917,708.4822313507383
STAT,1935,22,40-44,1957,4.626008703746616
SIM,1860,83,na,1943,302
SIM,1910,53,na,1963,3148
SIM,1935,14,na,1949,5388
SIM,1834,31,25-29,1865,9
STAT,1852,44,40-44,1896,1.682807144883303
SIM,1821,81,na,1902,294
SIM,1908,32,30-34,1940,28
STAT,1833,31,25-29,1864,9.461981464723154
STAT,1907,26,45-49,1933,1.6524840251967603
STAT,1937,25,na,1962,3689.777343065499
STAT,1851,57,na,1908,1521.6680622919548
STAT,1902,41,45-49,1943,0.1490059811201756
STAT,1914,1,na,1915,4344.244418000756
SIM,1879,66,na,1945,1934
STAT,1890,19,40-44,1909,0.22452123668952753
SIM,1907,28,45-49,1935,6
STAT,1926,20,40-44,1946,4.153057060428789
SIM,1929,22,15-19,1951,6
SIM,1896,26,25-29,1922,79
STAT,1860,34,na,1894,1953.333697132969
STAT,1863,23,na,1886,2143.1375064322
STAT,1879,26,15-19,1905,0.47984346126908495
STAT,1862,24,50-100,1886,0.3588989678373218
SIM,1839,39,40-44,1878,4
STAT,1848,32,15-19,1880,0.1355914371782648
STAT,1926,25,35-39,1951,18.31309171005675
SIM,1955,9,na,1964,5058
STAT,1779,97,na,1876,1.0977055367656128
STAT,1842,27,30-34,1869,28.03749020944853
STAT,1893,45,40-44,1938,0.12508142819790866
STAT,1922,37,35-39,1959,2.780381989320303
SIM,1879,41,na,1920,2731
STAT,1892,15,35-39,1907,0.6986535829194476
SIM,1919,19,30-34,1938,16
SIM,1939,26,30-34,1965,63
STAT,1808,108,na,1916,6.905735276394511E-4
STAT,1873,41,15-19,1914,0.01420399690896653
SIM,1843,37,40-44,1880,10
SIM,1856,19,na,1875,2431
SIM,1857,24,20-24,1881,63
SIM,1828,28,50-100,1856,2
SIM,1926,26,20-24,1952,37
STAT,1809,47,40-44,1856,0.6124338214831987
SIM,1891,24,15-19,1915,3
STAT,1853,106,na,1959,0.023202836440379328
STAT,1863,38,30-34,1901,4.7457284747607265
STAT,1826,54,40-44,1880,0.009615476992419837
STAT,1866,22,30-34,1888,16.794646787911596
STAT,1888,26,25-29,1914,50.60107364409001
STAT,1911,24,45-49,1935,1.069845191245866
SIM,1904,34,20-24,1938,2
SIM,1905,23,na,1928,3525
SIM,1950,19,15-19,1969,53
STAT,1826,36,50-100,1862,1.4575634458431674
STAT,1928,29,na,1957,4660.272654242347
STAT,1938,16,20-24,1954,135.34396313875578
STAT,1871,45,20-24,1916,0.01216113546884598
SIM,1834,36,50-100,1870,1
SIM,1934,20,40-44,1954,4
STAT,1827,37,15-19,1864,0.06531936517565164
STAT,1935,29,25-29,1964,90.55913917133302
SIM,1910,41,45-49,1951,1
SIM,1899,30,20-24,1929,4
STAT,1943,23,45-49,1966,1.2083428843544215
SIM,1882,39,45-49,1921,1
STAT,1889,47,40-44,1936,0.11970833361442043
STAT,1802,55,na,1857,1078.008950903506
STAT,1864,19,30-34,1883,1.4850659058566988
STAT,1900,45,35-39,1945,0.11190272841068233
SIM,1936,32,50-100,1968,1
STAT,1913,37,25-29,1950,0.9803811566888075
STAT,1928,33,20-24,1961,3.080822425248991
SIM,1872,19,30-34,1891,2
STAT,1847,52,na,1899,1603.5740427391447
SIM,1831,28,40-44,1859,4
SIM,1880,38,na,1918,2242
STAT,1804,54,20-24,1858,0.0019192730746387873
SIM,1930,24,20-24,1954,165
STAT,1905,49,50-100,1954,0.1980566542061472
STAT,1942,19,15-19,1961,47.85343065946479
STAT,1835,37,40-44,1872,4.063467646224887
SIM,1918,7,na,1925,4518
STAT,1934,11,na,1945,5423.340836908738
STAT,1861,38,20-24,1899,0.6437492321679327
SIM,1930,37,35-39,1967,11
STAT,1866,27,25-29,1893,39.561666640126724
SIM,1876,52,na,1928,2488
SIM,1833,24,35-39,1857,9
STAT,1867,51,25-29,1918,0.0033853608472743466
STAT,1887,47,15-19,1934,4.4895514386478967E-4
SIM,1850,27,30-34,1877,2
STAT,1918,34,40-44,1952,4.162311719502563
STAT,1871,74,na,1945,1113.5887211920144
SIM,1924,18,35-39,1942,6
STAT,1811,51,na,1862,1240.910068208512
STAT,1848,46,40-44,1894,0.1401745409589168
SIM,1922,16,35-39,1938,12
STAT,1792,79,na,1871,270.04500976002964
SIM,1936,33,20-24,1969,1
SIM,1839,20,20-24,1859,89
STAT,1896,47,na,1943,2994.3936692215766
SIM,1926,34,40-44,1960,4
SIM,1880,23,na,1903,2257
STAT,1894,28,15-19,1922,0.5878887804013597
STAT,1874,22,15-19,1896,3.4118163144253466
STAT,1879,29,na,1908,2497.417072461531
STAT,1913,41,20-24,1954,0.017476662440020323
SIM,1859,33,45-49,1892,2
STAT,1776,98,na,1874,0.48977893530547045
SIM,1946,16,20-24,1962,166
STAT,1802,104,na,1906,0.02330387937302447
SIM,1852,34,50-100,1886,6
STAT,1916,29,15-19,1945,0.7313582225029942
STAT,1933,16,45-49,1949,0.677398693592587
STAT,1865,89,na,1954,96.88624106952888
SIM,1874,34,25-29,1908,14
STAT,1942,27,35-39,1969,15.909795592254707
SIM,1864,67,na,1931,1854
STAT,1852,21,25-29,1873,51.9475094409033
SIM,1826,43,35-39,1869,3
SIM,1860,21,25-29,1881,54
STAT,1868,33,50-100,1901,0.8807111181309454
SIM,1846,29,30-34,1875,31
STAT,1922,26,na,1948,4297.061314992851
SIM,1800,66,na,1866,802
SIM,1893,34,35-39,1927,19
STAT,1842,18,40-44,1860,0.2102175100069024
SIM,1907,15,30-34,1922,3
SIM,1874,22,30-34,1896,25
SIM,1934,25,35-39,1959,26
STAT,1866,34,25-29,1900,9.497203756782936
STAT,1883,28,30-34,1911,24.80145832419611
SIM,1888,30,45-49,1918,5
SIM,1823,91,na,1914,31
STAT,1883,24,15-19,1907,3.2402484771355446
SIM,1932,22,na,1954,5450
SIM,1871,38,30-34,1909,8
SIM,1856,16,na,1872,2476
STAT,1902,18,50-100,1920,0.06974095025040032
STAT,1935,24,50-100,1959,0.9046700368812007
STAT,1838,56,na,1894,1365.3850144663056
STAT,1871,71,na,1942,1339.371249753376
SIM,1868,41,50-100,1909,5
SIM,1877,19,15-19,1896,8
STAT,1838,29,30-34,1867,21.13662047075743
STAT,1885,34,35-39,1919,10.093954806135237
STAT,1882,53,50-100,1935,0.014538497898811342
STAT,1914,16,35-39,1930,0.8779200310038194
SIM,1941,25,35-39,1966,19
STAT,1921,19,20-24,1940,155.24316699543527
STAT,1934,14,na,1948,5397.728801744109
SIM,1790,65,na,1855,967
STAT,1844,34,50-100,1878,0.8490647496830458
SIM,1889,23,20-24,1912,86
STAT,1805,69,na,1874,839.4836778115322
SIM,1793,76,na,1869,381
STAT,1807,95,na,1902,4.709680486858934
SIM,1829,35,25-29,1864,1
SIM,1900,24,35-39,1924,10
SIM,1827,44,50-100,1871,1
STAT,1857,48,40-44,1905,0.13325181003285327
SIM,1839,60,na,1899,1227
SIM,1908,30,40-44,1938,5
STAT,1869,19,15-19,1888,5.838785316490052
STAT,1842,23,15-19,1865,3.7194313326128907
SIM,1893,70,na,1963,2062
STAT,1836,19,50-100,1855,0.05464815760855497
SIM,1902,27,na,1929,3604
SIM,1848,35,35-39,1883,11
STAT,1849,93,na,1942,22.849958621899244
STAT,1835,48,20-24,1883,0.009376358218768902
SIM,1768,91,na,1859,2
SIM,1872,71,na,1943,1354
SIM,1915,22,20-24,1937,122
STAT,1925,15,40-44,1940,1.7155111290371934
STAT,1816,47,40-44,1863,0.4427047482753975
STAT,1903,18,25-29,1921,8.12974147243996
SIM,1849,49,50-100,1898,1
STAT,1848,31,45-49,1879,1.677685944481496
STAT,1847,22,20-24,1869,63.25330301042272
STAT,1929,16,50-100,1945,0.48446201053221416
STAT,1796,106,na,1902,0.002543700600313063
SIM,1891,28,30-34,1919,43
SIM,1846,79,na,1925,381
STAT,1919,46,25-29,1965,0.0582362410489025
SIM,1911,34,20-24,1945,2
STAT,1822,91,na,1913,32.399991382609
STAT,1931,26,20-24,1957,23.82830692680763
SIM,1908,35,35-39,1943,5
STAT,1924,23,35-39,1947,11.192711980843393
STAT,1826,50,25-29,1876,0.003502535173058749
SIM,1956,10,na,1966,5292
STAT,1929,27,35-39,1956,18.991748387969754
SIM,1852,42,na,1894,1702
SIM,1853,27,na,1880,1830
SIM,1898,25,20-24,1923,27
SIM,1893,21,20-24,1914,131
STAT,1835,42,na,1877,1890.6791721988955
STAT,1899,4,na,1903,3646.5327047617643
SIM,1923,26,na,1949,4296
SIM,1948,22,25-29,1970,176
STAT,1830,44,20-24,1874,0.13414381126551442
STAT,1907,22,20-24,1929,102.21293123057256
SIM,1824,37,30-34,1861,9
STAT,1893,41,25-29,1934,0.8272550879840287
STAT,1828,94,na,1922,12.974105502744079
STAT,1818,43,35-39,1861,3.4389150080531965
STAT,1903,34,20-24,1937,2.213441822717114
SIM,1920,12,na,1932,4820
STAT,1890,45,30-34,1935,0.12065780074568351
STAT,1923,47,50-100,1970,0.2673397494097142
STAT,1953,18,20-24,1971,165.6471333173262
STAT,1857,29,40-44,1886,2.397310405478036
SIM,1850,23,15-19,1873,3
STAT,1916,18,35-39,1934,0.8960821914726927
STAT,1916,37,35-39,1953,2.4996442640302137
STAT,1883,38,40-44,1921,4.305138367081064
STAT,1889,33,15-19,1922,0.17660525755786652
SIM,1869,21,45-49,1890,1
SIM,1933,15,40-44,1948,1
SIM,1881,85,na,1966,424
SIM,1914,12,na,1926,4330
SIM,1917,48,na,1965,3703
STAT,1911,40,50-100,1951,0.11440569280572435
SIM,1872,15,15-19,1887,8
STAT,1917,33,45-49,1950,1.6562334177621325
STAT,1814,65,na,1879,943.5976320084472
STAT,1829,79,na,1908,412.2189612374925
STAT,1779,94,na,1873,4.784630932655928
STAT,1887,33,na,1920,2679.5583299768564
STAT,1838,39,40-44,1877,3.4633196584156254
STAT,1872,36,15-19,1908,0.057294957745414585
STAT,1858,53,40-44,1911,0.008208028964873833
SIM,1826,30,20-24,1856,3
SIM,1831,43,na,1874,1682
STAT,1855,19,na,1874,2030.9406586259026
STAT,1857,45,na,1902,1791.1045123338934
SIM,1944,25,na,1969,4075
STAT,1909,44,na,1953,3462.323976736715
STAT,1909,47,45-49,1956,0.20152811844285573
SIM,1790,87,na,1877,68
SIM,1855,22,20-24,1877,73
STAT,1922,24,20-24,1946,128.01299805956006
STAT,1938,29,35-39,1967,15.000961229854216
STAT,1920,16,50-100,1936,0.4255179859536811
SIM,1952,16,20-24,1968,156
STAT,1926,36,15-19,1962,0.02374088822169137
STAT,1874,21,45-49,1895,0.723339966155906
SIM,1840,57,na,1897,1430
SIM,1846,39,40-44,1885,7
SIM,1860,86,na,1946,150
STAT,1938,15,50-100,1953,0.3748331714817741
STAT,1944,16,20-24,1960,147.37171918588172
SIM,1935,11,na,1946,5405
STAT,1864,15,15-19,1879,6.221594079767563
STAT,1907,35,35-39,1942,2.2858418159349845
STAT,1898,35,15-19,1933,0.07761752652608306
SIM,1865,29,40-44,1894,2
SIM,1924,37,35-39,1961,5
SIM,1865,38,30-34,1903,9
STAT,1790,108,na,1898,3.382414745030253E-4
STAT,1799,101,na,1900,0.1914851793390746
STAT,1872,34,na,1906,2402.3643821501096
STAT,1785,72,na,1857,528.4360357370335
STAT,1895,62,na,1957,2458.9205362231387
STAT,1918,26,20-24,1944,19.679464119739638
STAT,1875,48,na,1923,2304.2527522025607
STAT,1789,107,na,1896,0.0014353785618532108
STAT,1920,27,15-19,1947,0.7820290948621108
STAT,1873,17,15-19,1890,6.076443328533875
STAT,1860,25,50-100,1885,0.5415547605972864
STAT,1903,23,40-44,1926,2.988116368142895
STAT,1880,47,20-24,1927,0.012669185405218917
SIM,1867,56,na,1923,1805
SIM,1781,73,na,1854,405
SIM,1881,17,15-19,1898,9
SIM,1892,48,na,1940,3033
STAT,1837,90,na,1927,53.78342476661829
STAT,1926,35,45-49,1961,0.8434930959790446
SIM,1891,38,40-44,1929,9
STAT,1842,37,40-44,1879,4.623345901847492
STAT,1853,2,na,1855,2979.2572
STAT,1921,31,45-49,1952,1.775847868298872
STAT,1835,64,na,1899,1304.721065466465
STAT,1897,38,50-100,1935,1.6541902120857546
SIM,1884,38,40-44,1922,8
STAT,1772,106,na,1878,0.009310640640759399
STAT,1933,35,45-49,1968,0.9399375877436935
STAT,1802,52,50-100,1854,0.044069563155149066
STAT,1876,38,40-44,1914,4.542405275172269
STAT,1894,30,50-100,1924,1.2010033533003932
STAT,1946,7,na,1953,4420.304775232609
STAT,1913,22,20-24,1935,108.71441624457675
SIM,1868,25,35-39,1893,7
STAT,1885,21,20-24,1906,69.48949322278139
SIM,1846,57,na,1903,1433
STAT,1822,33,15-19,1855,0.37009935413655626
SIM,1850,37,40-44,1887,6
STAT,1862,4,na,1866,2662.625778210612
SIM,1905,18,25-29,1923,9
SIM,1937,27,35-39,1964,24
SIM,1838,18,25-29,1856,6
SIM,1911,23,40-44,1934,8
STAT,1880,85,na,1965,542.0370260265886
SIM,1858,42,35-39,1900,1
STAT,1905,63,na,1968,2891.200418603042
STAT,1853,27,15-19,1880,0.4346540112734638
STAT,1905,36,20-24,1941,0.2441015206278249
STAT,1909,48,15-19,1957,3.4062322224124534E-4
SIM,1915,35,35-39,1950,5
SIM,1833,50,na,1883,1583
SIM,1934,35,45-49,1969,1
SIM,1812,51,na,1863,1208
STAT,1833,35,40-44,1868,3.9678736180754677
STAT,1852,40,25-29,1892,0.491920796613845
SIM,1837,31,35-39,1868,10
STAT,1935,37,45-49,1972,0.9631106796451795
SIM,1879,16,20-24,1895,22
STAT,1814,43,na,1857,1493.201709673522
SIM,1832,28,na,1860,1757
SIM,1810,52,50-100,1862,1
SIM,1902,21,40-44,1923,3
STAT,1923,44,25-29,1967,0.08404938865537724
SIM,1906,33,35-39,1939,13
SIM,1895,20,35-39,1915,11
STAT,1811,43,40-44,1854,6.229289587371472
SIM,1859,23,35-39,1882,6
STAT,1859,44,35-39,1903,1.4511328722550747
STAT,1887,20,35-39,1907,6.619617600573325
STAT,1927,28,20-24,1955,22.351019443653726
STAT,1849,24,20-24,1873,64.20977388956763
SIM,1935,28,20-24,1963,4
SIM,1889,36,35-39,1925,6
STAT,1820,65,na,1885,860.5660762297136
STAT,1831,35,15-19,1866,0.045880651108582284
SIM,1841,35,40-44,1876,2
STAT,1884,24,50-100,1908,0.40361459470413974
STAT,1867,32,25-29,1899,9.742989792697143
SIM,1867,44,35-39,1911,2
STAT,1901,21,40-44,1922,2.9592836893803343
STAT,1840,94,na,1934,14.009993785401969
STAT,1899,37,50-100,1936,0.3673267623078912
STAT,1890,42,20-24,1932,0.19575951388446736
STAT,1858,28,40-44,1886,2.412442758158254
STAT,1878,45,50-100,1923,0.2600676610363832
STAT,1898,24,50-100,1922,0.5548548341503295
SIM,1885,21,25-29,1906,83
STAT,1887,18,50-100,1905,0.05510075029744238
SIM,1910,21,30-34,1931,55
STAT,1819,80,na,1899,314.47141630861694
STAT,1873,45,25-29,1918,0.05956516797271637
STAT,1879,18,30-34,1897,1.6755366744627211
STAT,1837,93,na,1930,19.936966735019215
SIM,1858,36,na,1894,1924
STAT,1808,51,25-29,1859,0.012240305303371276
SIM,1832,38,40-44,1870,9
STAT,1854,43,50-100,1897,0.7871255531831165
STAT,1844,15,35-39,1859,0.5584124111073959
SIM,1888,31,20-24,1919,3
STAT,1941,28,35-39,1969,15.672534289814513
STAT,1898,48,35-39,1946,0.10677004749075328
SIM,1840,26,na,1866,1919
SIM,1856,25,50-100,1881,1
SIM,1928,27,30-34,1955,63
SIM,1897,37,30-34,1934,9
SIM,1911,39,50-100,1950,1
STAT,1869,39,na,1908,2290.187718085192
STAT,1902,21,30-34,1923,25.499513748916314
STAT,1782,86,na,1868,70.5522801372613
SIM,1867,41,30-34,1908,4
SIM,1909,32,45-49,1941,3
SIM,1941,7,na,1948,4280
STAT,1843,37,50-100,1880,0.9667018384524817
STAT,1805,60,na,1865,1174.2281259762613
SIM,1922,45,50-100,1967,1
STAT,1824,38,40-44,1862,5.909161309392709
STAT,1900,42,30-34,1942,0.11187194292770375
STAT,1809,48,50-100,1857,0.8442312980835304
STAT,1868,31,25-29,1899,9.927497385757112
STAT,1902,38,25-29,1940,0.8825705571879973
STAT,1904,17,25-29,1921,8.21346277028019
SIM,1883,24,25-29,1907,89
STAT,1869,18,45-49,1887,0.06464918363633589
SIM,1846,18,15-19,1864,10
STAT,1875,42,25-29,1917,0.6652364796752629
SIM,1907,37,40-44,1944,2
STAT,1930,38,30-34,1968,2.400369382204858
STAT,1823,51,20-24,1874,9.972520508264278E-4
STAT,1833,25,30-34,1858,23.910042910195983
SIM,1827,44,na,1871,1501
STAT,1873,44,na,1917,2334.5571948053243
SIM,1836,30,45-49,1866,1
SIM,1899,34,30-34,1933,8
SIM,1910,38,25-29,1948,1
SIM,1912,17,25-29,1929,22
SIM,1931,23,50-100,1954,2
STAT,1918,48,30-34,1966,0.09550673903866146
STAT,1900,24,30-34,1924,24.834384959728
STAT,1794,71,na,1865,617.702647109952
STAT,1838,18,15-19,1856,5.2166433976446
STAT,1903,28,na,1931,3420.723197123395
STAT,1934,30,35-39,1964,12.621351515597537
STAT,1943,25,35-39,1968,16.159065880524338
STAT,1806,54,25-29,1860,0.009818854214841431
STAT,1836,39,15-19,1875,0.04258822598256799
STAT,1919,15,na,1934,4343.684500026645
SIM,1845,69,na,1914,1065
STAT,1867,39,50-100,1906,1.1561018839044588
STAT,1891,29,40-44,1920,3.719114768441526
STAT,1913,40,45-49,1953,0.16561106140569204
STAT,1832,62,na,1894,1244.5463368274704
STAT,1861,30,30-34,1891,14.771381334066517
SIM,1804,87,na,1891,50
STAT,1883,19,35-39,1902,0.5394199918934678
STAT,1927,38,50-100,1965,0.5270818920601715
STAT,1947,17,50-100,1964,0.4262998181320858
SIM,1870,36,na,1906,2606
SIM,1905,21,20-24,1926,3
STAT,1924,40,20-24,1964,0.021286079774008843
SIM,1897,24,25-29,1921,132
SIM,1863,82,na,1945,296
STAT,1899,40,15-19,1939,0.0013427090031367214
STAT,1831,80,na,1911,388.72622254304355
SIM,1924,32,40-44,1956,9
SIM,1871,18,na,1889,2458
STAT,1809,50,na,1859,1408.72794266254
STAT,1946,17,30-34,1963,13.65429523448601
STAT,1811,54,35-39,1865,0.019699227272119143
STAT,1872,47,50-100,1919,0.24822471260246892
STAT,1827,75,na,1902,612.1785939188275
STAT,1857,7,na,1864,2293.102959687652
SIM,1841,25,30-34,1866,34
STAT,1934,32,30-34,1966,21.73544519352527
STAT,1823,85,na,1908,151.61373433865066
STAT,1876,80,na,1956,683.913769140007
STAT,1917,35,35-39,1952,2.559947312704665
STAT,1872,90,na,1962,163.57534309755675
STAT,1907,43,25-29,1950,0.06566334911638042
SIM,1891,19,35-39,1910,1
STAT,1852,15,50-100,1867,0.04547169942226756
SIM,1923,38,35-39,1961,11
STAT,1909,40,25-29,1949,0.06816344420370724
STAT,1930,25,25-29,1955,84.66453743471156
STAT,1872,48,15-19,1920,4.010644975914979E-4
STAT,1856,72,na,1928,977.9179445007733
STAT,1916,32,40-44,1948,4.07726782624728
STAT,1833,109,na,1942,5.033547657787407E-4
SIM,1893,31,50-100,1924,2
STAT,1830,49,20-24,1879,0.009780492190083956
SIM,1800,97,na,1897,13
STAT,1786,109,na,1895,3.8016879117921054E-4
STAT,1902,26,50-100,1928,0.9161405950108892
SIM,1925,17,35-39,1942,6
STAT,1932,35,30-34,1967,2.4790030255437916
STAT,1940,1,na,1941,4263.114456577331
STAT,1910,16,40-44,1926,0.280306597697972
STAT,1872,18,50-100,1890,0.04961703878027054
SIM,1877,15,na,1892,2739
STAT,1833,43,30-34,1876,0.9766283825355327
STAT,1835,22,30-34,1857,17.777904060781715
STAT,1904,49,50-100,1953,0.19660825097290377
STAT,1900,40,35-39,1940,0.17820409681864624
STAT,1849,35,50-100,1884,1.0028581520540174
STAT,1822,104,na,1926,0.0372935664161865
STAT,1869,31,45-49,1900,1.7193587965428663
STAT,1885,16,35-39,1901,0.5529928341422827
STAT,1913,22,15-19,1935,5.204447715134714
SIM,1913,3,na,1916,4168
STAT,1877,34,na,1911,2466.248907565073
SIM,1907,35,45-49,1942,1
SIM,1843,22,30-34,1865,26
STAT,1816,46,35-39,1862,0.36747221842816663
STAT,1864,52,20-24,1916,6.689500407830375E-4
SIM,1954,17,30-34,1971,23
STAT,1915,38,35-39,1953,2.453321729688685
STAT,1917,17,35-39,1934,0.9114543598967413
STAT,1881,79,na,1960,848.758699431944
STAT,1907,25,25-29,1932,63.1683128887845
STAT,1835,40,30-34,1875,1.0611571005143705
STAT,1912,27,30-34,1939,38.956345928606396
STAT,1944,22,45-49,1966,1.226770464730467
STAT,1825,80,na,1905,451.426157036335
STAT,1892,11,na,1903,3277.902391969051
SIM,1906,17,na,1923,3591
STAT,1917,49,25-29,1966,0.05559869515194125
STAT,1851,23,25-29,1874,51.39153457516706
STAT,1927,22,45-49,1949,1.4011687571754947
SIM,1864,36,na,1900,2581
SIM,1872,31,na,1903,2569
STAT,1820,53,50-100,1873,0.024164026527836006
SIM,1821,59,na,1880,1042
SIM,1872,2,na,1874,3516
STAT,1871,20,45-49,1891,0.7038842115936654
SIM,1795,65,na,1860,784
SIM,1867,26,35-39,1893,12
SIM,1842,23,25-29,1865,56
STAT,1922,30,15-19,1952,0.14785893325076938
STAT,1807,109,na,1916,2.5202049588719436E-4
STAT,1839,17,20-24,1856,16.442140299095378
STAT,1860,47,40-44,1907,0.14068829828291043
STAT,1871,49,na,1920,2210.4088872853995
STAT,1839,33,25-29,1872,8.84408198659132
STAT,1852,39,50-100,1891,0.9217390144923512
STAT,1834,23,25-29,1857,45.273959947771445
STAT,1944,10,na,1954,4275.918062827295
SIM,1862,20,45-49,1882,1
STAT,1814,49,35-39,1863,0.32652152591724287
STAT,1927,35,20-24,1962,0.3318413317612276
STAT,1860,31,25-29,1891,8.491125028827463
STAT,1866,37,35-39,1903,6.614826537724645
STAT,1877,2,na,1879,3387.3928663931
SIM,1929,25,25-29,1954,110
SIM,1895,28,na,1923,3155
STAT,1818,39,na,1857,1546.841065378226
STAT,1920,6,na,1926,4541.038704415267
SIM,1873,23,25-29,1896,2
SIM,1856,49,50-100,1905,5
SIM,1915,25,25-29,1940,90
STAT,1899,29,40-44,1928,4.1226291556296175
SIM,1920,27,30-34,1947,57
SIM,1882,61,na,1943,1548
STAT,1889,24,25-29,1913,70.84704354189478
SIM,1906,38,35-39,1944,4
STAT,1869,30,30-34,1899,17.282529404578273
STAT,1910,32,45-49,1942,1.5307788025386395
SIM,1826,40,30-34,1866,1
SIM,1916,0,na,1916,4387
STAT,1904,48,30-34,1952,0.0781485595002292
STAT,1822,60,na,1882,1151.4210867473507
SIM,1802,92,na,1894,1
SIM,1874,37,35-39,1911,13
SIM,1884,23,30-34,1907,23
STAT,1830,47,25-29,1877,0.04817811472343466
STAT,1854,20,45-49,1874,0.6238208171116832
STAT,1784,81,na,1865,170.94929737931713
STAT,1891,40,15-19,1931,0.01744314007726136
SIM,1856,36,30-34,1892,4
SIM,1925,32,30-34,1957,33
SIM,1911,19,30-34,1930,3
SIM,1922,21,50-100,1943,1
SIM,1893,31,30-34,1924,29
SIM,1907,58,na,1965,3307
STAT,1855,111,na,1966,5.146480807530118E-4
SIM,1802,52,na,1854,1234
SIM,1935,22,45-49,1957,1
STAT,1922,43,20-24,1965,0.020445572277419524
SIM,1878,56,na,1934,2335
STAT,1885,69,na,1954,1475.376729060232
STAT,1885,31,30-34,1916,17.62464487414984
SIM,1847,33,25-29,1880,12
SIM,1886,23,na,1909,2661
SIM,1946,25,25-29,1971,74
STAT,1848,77,na,1925,705.7402702072513
STAT,1818,40,30-34,1858,2.4151875575589945
STAT,1892,26,50-100,1918,0.8135150415313417
STAT,1848,36,30-34,1884,4.53098653087076
STAT,1903,19,30-34,1922,2.2803479719643174
SIM,1856,41,na,1897,2116
SIM,1858,36,35-39,1894,16
STAT,1865,23,25-29,1888,53.05320137733704
STAT,1917,32,30-34,1949,16.65302574607853
STAT,1834,41,25-29,1875,0.46698546052138545
STAT,1848,23,25-29,1871,56.500499924637
STAT,1883,74,na,1957,1163.4315624712854
STAT,1908,24,30-34,1932,26.50565525443506
SIM,1831,39,35-39,1870,13
SIM,1859,42,50-100,1901,3
SIM,1870,76,na,1946,1062
STAT,1809,50,30-34,1859,0.01993716671664836
STAT,1851,41,25-29,1892,0.48843355868612914
STAT,1825,33,25-29,1858,21.642142633163413
STAT,1865,39,40-44,1904,3.9965458413642887
STAT,1925,15,na,1940,4514.416550102795
STAT,1854,77,na,1931,648.7146909938147
STAT,1855,47,30-34,1902,0.07252368492220335
SIM,1879,50,50-100,1929,1
STAT,1932,25,na,1957,4962.901961369403
SIM,1944,25,20-24,1969,23
STAT,1810,75,na,1885,516.0541822759948
SIM,1912,35,25-29,1947,3
SIM,1961,2,na,1963,5233
SIM,1816,72,na,1888,563
STAT,1828,57,na,1885,1356.6014029460573
STAT,1928,33,15-19,1961,0.16230973750259783
STAT,1936,25,20-24,1961,17.65186094771177
STAT,1828,30,45-49,1858,2.202191945690481
STAT,1855,18,15-19,1873,5.281828077050183
STAT,1933,15,25-29,1948,58.892734691088684
STAT,1878,16,50-100,1894,0.05149192423987403
SIM,1815,59,na,1874,1107
STAT,1938,25,25-29,1963,65.88748566583675
SIM,1833,33,25-29,1866,13
SIM,1941,15,25-29,1956,64
SIM,1847,17,20-24,1864,19
SIM,1938,10,na,1948,3857
STAT,1895,21,45-49,1916,0.9225183949897711
SIM,1926,37,na,1963,4610
STAT,1894,46,na,1940,2934.3991848809883
SIM,1873,39,40-44,1912,9
STAT,1904,35,25-29,1939,0.909294910812884
STAT,1908,40,35-39,1948,0.19019663111700197
SIM,1874,38,na,1912,2310
STAT,1771,107,na,1878,0.006380144066755708
STAT,1865,49,na,1914,2031.6062211150534
SIM,1864,50,50-100,1914,1
SIM,1866,28,40-44,1894,9
SIM,1842,41,25-29,1883,5
STAT,1857,14,na,1871,2191.6405341114328
STAT,1859,41,30-34,1900,0.9381421564233194
SIM,1833,44,na,1877,1692
STAT,1923,46,45-49,1969,0.25752865871331176
STAT,1876,41,30-34,1917,1.2043482471745306
SIM,1955,15,25-29,1970,84
STAT,1790,81,na,1871,178.06108625704198
SIM,1916,24,30-34,1940,31
STAT,1840,39,35-39,1879,5.743609902194944
STAT,1942,22,40-44,1964,3.5594637248620993
STAT,1838,29,50-100,1867,0.5369307071680391
SIM,1847,15,25-29,1862,10
SIM,1853,30,45-49,1883,3
STAT,1941,19,50-100,1960,0.3893430819130031
SIM,1844,16,na,1860,2019
STAT,1900,27,35-39,1927,13.537554229362025
STAT,1870,95,na,1965,44.230541459348984
STAT,1889,37,30-34,1926,6.63742522446115
STAT,1871,48,25-29,1919,0.05707100965712402
SIM,1925,30,35-39,1955,14
STAT,1892,24,25-29,1916,72.09770930075001
STAT,1840,51,20-24,1891,5.197473327747847E-4
STAT,1803,65,na,1868,1004.1332726255852
STAT,1879,69,na,1948,1546.7904689014858
SIM,1843,101,na,1944,3
SIM,1912,17,na,1929,3839
SIM,1841,79,na,1920,396
SIM,1856,23,25-29,1879,72
STAT,1818,102,na,1920,0.1510457432595937
STAT,1845,30,45-49,1875,1.5468052948460635
STAT,1908,42,30-34,1950,0.11940054713229459
STAT,1839,15,25-29,1854,5.318009455217485
STAT,1933,33,25-29,1966,12.578805266304514
SIM,1901,32,45-49,1933,5
STAT,1858,37,50-100,1895,0.9728468931703051
SIM,1818,42,50-100,1860,1
STAT,1902,35,20-24,1937,0.2397241693497433
SIM,1888,18,20-24,1906,37
STAT,1919,43,na,1962,4057.243000860162
STAT,1947,15,25-29,1962,49.33483292384193
SIM,1884,41,30-34,1925,2
STAT,1930,40,45-49,1970,0.22194205104053902
STAT,1943,22,30-34,1965,30.875927930780797
SIM,1898,48,na,1946,3049
STAT,1882,80,na,1962,825.1533774088102
SIM,1932,25,na,1957,5498
SIM,1814,77,na,1891,325
STAT,1842,52,na,1894,1928.251660144565
SIM,1882,29,40-44,1911,2
STAT,1884,18,40-44,1902,0.1816932452485451
SIM,1810,87,na,1897,157
STAT,1874,29,40-44,1903,3.0758391582489044
STAT,1775,104,na,1879,0.023998259722359985
STAT,1859,49,na,1908,1789.466270482936
STAT,1853,39,15-19,1892,0.04597112179599195
SIM,1857,94,na,1951,10
SIM,1850,16,na,1866,2242
SIM,1876,21,na,1897,2911
SIM,1931,12,na,1943,5159
SIM,1944,10,na,1954,4297
STAT,1920,15,15-19,1935,10.363909205758452
STAT,1819,40,na,1859,1481.197191814032
SIM,1899,37,35-39,1936,2
STAT,1840,36,30-34,1876,4.4648583733545815
SIM,1771,83,na,1854,68
STAT,1791,101,na,1892,0.10146525510537635
STAT,1842,33,30-34,1875,18.793491108843423
SIM,1854,8,na,1862,2704
STAT,1894,21,25-29,1915,74.66322974790964
STAT,1820,37,na,1857,1424.186768445656
STAT,1807,55,na,1862,1097.2639613527151
STAT,1879,19,15-19,1898,6.221471099842327
STAT,1857,103,na,1960,0.2760071621751672
STAT,1901,33,na,1934,3364.4182408386887
STAT,1924,43,25-29,1967,0.0856959373703573
STAT,1930,22,20-24,1952,143.97544886475293
SIM,1910,24,35-39,1934,16
SIM,1950,19,na,1969,4202
STAT,1833,28,35-39,1861,8.965664896532648
STAT,1843,35,40-44,1878,3.5190933222773437
STAT,1883,24,50-100,1907,0.40052519779519
SIM,1851,35,40-44,1886,2
STAT,1902,24,35-39,1926,8.27660820040702
SIM,1835,30,25-29,1865,14
STAT,1825,36,35-39,1861,12.181453977380295
STAT,1829,70,na,1899,827.3057459304774
STAT,1854,48,25-29,1902,0.042684864007467224
STAT,1921,35,25-29,1956,1.1122880379914861
STAT,1939,24,30-34,1963,29.119692413294068
SIM,1863,107,na,1970,1
STAT,1903,68,na,1971,2577.5307019668835
STAT,1962,9,na,1971,5084.58179511604
SIM,1856,20,15-19,1876,4
STAT,1813,49,20-24,1862,0.03366199621596051
SIM,1879,23,20-24,1902,76
STAT,1901,22,25-29,1923,81.05162508972373
STAT,1929,42,50-100,1971,0.15377483996373498
SIM,1831,49,na,1880,1567
STAT,1835,25,35-39,1860,9.579197219108163
STAT,1925,24,30-34,1949,34.550574314288376
SIM,1924,35,45-49,1959,3
STAT,1909,34,50-100,1943,0.7893476898533228
SIM,1876,31,25-29,1907,16
STAT,1918,32,45-49,1950,1.6881461178120911
STAT,1848,20,15-19,1868,3.3272391505443633
STAT,1922,49,35-39,1971,0.14875421541408476
STAT,1938,22,20-24,1960,111.09875943905347
SIM,1833,36,35-39,1869,18
SIM,1850,33,30-34,1883,31
STAT,1883,34,na,1917,2338.3683759866826
STAT,1893,20,50-100,1913,0.5260876555909655
STAT,1961,4,na,1965,5131.138692921982
STAT,1914,31,na,1945,3856.77470736355
SIM,1901,31,30-34,1932,35
STAT,1843,93,na,1936,19.711586707801
STAT,1898,48,50-100,1946,0.1873051684578974
SIM,1907,32,40-44,1939,5
SIM,1919,43,na,1962,3956
STAT,1890,56,na,1946,2517.2364070521553
SIM,1856,39,35-39,1895,11
SIM,1913,16,30-34,1929,7
STAT,1896,19,15-19,1915,7.891478193984778
STAT,1905,43,20-24,1948,0.0159860672930956
SIM,1843,25,35-39,1868,14
STAT,1843,17,40-44,1860,0.15764843122776145
SIM,1856,72,na,1928,1030
SIM,1883,21,20-24,1904,94
SIM,1889,28,na,1917,2915
STAT,1908,43,45-49,1951,0.15450323241229136
STAT,1795,65,na,1860,923.4809567467356
SIM,1888,47,50-100,1935,1
STAT,1905,16,30-34,1921,2.3329190096306087
SIM,1839,69,na,1908,866
SIM,1841,28,40-44,1869,5
STAT,1830,67,na,1897,1045.8313266039668
STAT,1921,17,25-29,1938,49.88930272502446
STAT,1869,15,35-39,1884,0.5527631514523125
SIM,1897,21,20-24,1918,100
STAT,1841,38,40-44,1879,3.8170558120307483
SIM,1915,53,na,1968,4013
SIM,1838,22,20-24,1860,55
STAT,1829,28,15-19,1857,0.5091893056371423
STAT,1867,44,na,1911,2168.826283270741
SIM,1926,32,45-49,1958,4
STAT,1827,49,15-19,1876,3.9953983191226225E-4
STAT,1881,37,30-34,1918,5.18869283051634
STAT,1897,31,20-24,1928,3.6750579671711816
SIM,1918,22,45-49,1940,1
STAT,1889,21,20-24,1910,86.08232756574229
SIM,1869,20,25-29,1889,79
STAT,1859,26,35-39,1885,8.031125843742151
SIM,1897,23,na,1920,3238
SIM,1891,78,na,1969,1243
STAT,1899,47,40-44,1946,0.1332380783262611
STAT,1951,17,40-44,1968,1.6828192602247816
SIM,1891,16,30-34,1907,3
STAT,1838,17,30-34,1855,1.4093589007444065
STAT,1816,60,na,1876,1203.600081951389
SIM,1868,44,50-100,1912,2
SIM,1862,41,na,1903,2135
STAT,1814,46,30-34,1860,0.23742971745042668
SIM,1937,3,na,1940,3867
STAT,1876,23,30-34,1899,18.51801572116791
SIM,1868,66,na,1934,1493
STAT,1906,45,30-34,1951,0.08112787418330782
SIM,1916,25,45-49,1941,2
STAT,1856,30,20-24,1886,2.1631906702128627
SIM,1842,20,20-24,1862,4
SIM,1904,22,15-19,1926,5
SIM,1943,26,15-19,1969,1
STAT,1947,19,40-44,1966,1.5904535680900609
SIM,1825,49,na,1874,1257
SIM,1903,68,na,1971,2407
STAT,1904,13,na,1917,3737.3354245540786
SIM,1824,43,30-34,1867,4
STAT,1853,52,45-49,1905,0.011937536068567399
SIM,1859,35,40-44,1894,1
SIM,1925,35,35-39,1960,8
STAT,1833,46,35-39,1879,0.11795307764518446
STAT,1853,20,25-29,1873,56.74708422633195
STAT,1788,71,na,1859,551.6140949251641
STAT,1883,34,30-34,1917,17.10893933725781
STAT,1871,18,na,1889,2535.5983197613855
STAT,1964,1,na,1965,5007.775572770215
SIM,1886,51,na,1937,2436
SIM,1912,49,50-100,1961,1
SIM,1892,36,40-44,1928,8
STAT,1848,39,35-39,1887,5.828677402340189
STAT,1816,43,30-34,1859,3.1811194977188295
SIM,1832,90,na,1922,73
STAT,1942,25,45-49,1967,1.832335491668892
SIM,1891,34,30-34,1925,7
STAT,1834,35,50-100,1869,0.928574454367531
STAT,1853,24,na,1877,2059.2879429955915
STAT,1869,43,50-100,1912,1.0298980122878305
STAT,1935,30,25-29,1965,12.93386931134474
STAT,1840,54,30-34,1894,0.004057918218764553
SIM,1933,19,na,1952,4654
SIM,1864,30,20-24,1894,2
SIM,1887,18,30-34,1905,1
STAT,1908,25,45-49,1933,1.6738797967834609
SIM,1879,69,na,1948,1690
STAT,1920,33,15-19,1953,0.14154112165401372
STAT,1876,26,35-39,1902,10.096848148144987
SIM,1946,22,20-24,1968,123
SIM,1838,28,na,1866,1867
STAT,1917,46,20-24,1963,0.011680322599070229
STAT,1862,72,na,1934,1101.5225768431508
STAT,1849,52,25-29,1901,0.0027545904444593178
SIM,1862,46,50-100,1908,2
STAT,1936,15,na,1951,3574.193252083349
STAT,1923,43,40-44,1966,0.29491489975828383
STAT,1884,16,na,1900,2521.6691738231375
STAT,1919,30,50-100,1949,0.9078865586539532
STAT,1916,35,45-49,1951,0.7112099093268975
SIM,1927,30,50-100,1957,2
SIM,1910,50,na,1960,3163
SIM,1869,23,35-39,1892,8
STAT,1789,96,na,1885,1.9732912384162675
STAT,1808,49,40-44,1857,0.5927865292498795
SIM,1837,34,na,1871,1633
STAT,1853,52,na,1905,1771.1399986342421
STAT,1812,70,na,1882,757.204887047603
STAT,1894,74,na,1968,1820.6829492334475
STAT,1921,16,50-100,1937,0.43237886125867897
SIM,1874,66,na,1940,1547
SIM,1898,32,20-24,1930,6
STAT,1817,45,40-44,1862,0.3800481976295675
SIM,1819,49,na,1868,1375
SIM,1842,39,40-44,1881,2
STAT,1861,59,na,1920,1631.1108186783736
SIM,1841,28,35-39,1869,9
STAT,1892,27,35-39,1919,12.228851095314239
STAT,1936,28,25-29,1964,63.563423647177096
SIM,1886,20,30-34,1906,29
STAT,1831,47,15-19,1878,2.9878001863525405E-4
STAT,1871,50,45-49,1921,0.014771371179828335
STAT,1925,27,40-44,1952,5.5636684019968765
SIM,1830,64,na,1894,917
STAT,1869,15,40-44,1884,0.18425439448554717
SIM,1897,21,15-19,1918,4
STAT,1838,87,na,1925,117.94008144620258
STAT,1922,46,25-29,1968,0.06171563198494553
STAT,1851,53,25-29,1904,0.002638907035325709
SIM,1858,33,30-34,1891,21
STAT,1850,87,na,1937,134.90406014066008
STAT,1933,19,40-44,1952,1.8819230644094513
STAT,1889,21,15-19,1910,4.120989547560163
SIM,1942,15,45-49,1957,1
SIM,1905,24,25-29,1929,97
STAT,1863,45,50-100,1908,0.22197608791571666
STAT,1827,30,25-29,1857,15.071396896298314
SIM,1885,38,na,1923,2506
STAT,1909,36,15-19,1945,0.018430291352647503
STAT,1785,110,na,1895,2.009229688050855E-4
SIM,1912,32,20-24,1944,3
STAT,1832,44,25-29,1876,0.5228576601252536
SIM,1861,20,25-29,1881,2
SIM,1763,91,na,1854,18
STAT,1846,18,50-100,1864,0.04642948916955637
SIM,1906,35,30-34,1941,3
STAT,1896,48,30-34,1944,0.07208300717852881
SIM,1856,20,20-24,1876,87
STAT,1890,16,na,1906,3124.6595704786287
STAT,1834,39,40-44,1873,3.1761193780705628
STAT,1855,6,na,1861,2233.5251594586416
SIM,1865,44,30-34,1909,1
STAT,1834,20,20-24,1854,104.83000564164618
STAT,1918,21,na,1939,3988.264220720447
STAT,1907,58,na,1965,3135.1133806551156
STAT,1813,55,na,1868,1179.5762240114327
STAT,1812,51,45-49,1863,0.032684119425780485
STAT,1851,26,35-39,1877,8.616234942519926
STAT,1874,15,15-19,1889,6.188977406571365
STAT,1920,33,45-49,1953,1.7332110156841425
STAT,1904,32,20-24,1936,2.2496377403017624
SIM,1891,38,na,1929,3012
STAT,1884,36,40-44,1920,4.38095570285346
STAT,1912,42,20-24,1954,0.01718439759437838
SIM,1866,31,na,1897,2426
STAT,1848,20,20-24,1868,69.50187258210717
STAT,1913,32,50-100,1945,0.8299735736737016
SIM,1853,44,50-100,1897,1
STAT,1912,24,20-24,1936,111.3373093581058
STAT,1914,36,25-29,1950,0.9966403986033772
STAT,1857,44,30-34,1901,0.8939872045367556
SIM,1856,39,40-44,1895,9
STAT,1923,44,50-100,1967,0.13827479982192356
SIM,1816,44,na,1860,1357
SIM,1933,27,40-44,1960,4
STAT,1903,36,50-100,1939,0.38301052334976177
SIM,1808,77,na,1885,283
STAT,1844,87,na,1931,139.3914522959876
STAT,1934,33,45-49,1967,2.1695226284300593
STAT,1836,52,na,1888,1373.635861662488
STAT,1897,26,na,1923,3242.582427830667
STAT,1903,21,45-49,1924,1.0060648528888412
SIM,1833,36,50-100,1869,1
STAT,1962,0,na,1962,5125.103204502432
SIM,1920,24,20-24,1944,138
STAT,1912,36,na,1948,3722.463509031958
SIM,1879,26,25-29,1905,57
SIM,1817,82,na,1899,204
STAT,1840,54,25-29,1894,0.002414628999464087
SIM,1932,25,30-34,1957,99
SIM,1814,49,na,1863,1315
SIM,1835,70,na,1905,753
STAT,1855,87,na,1942,132.61494815867596
SIM,1854,77,na,1931,790
SIM,1838,43,25-29,1881,3
STAT,1903,15,15-19,1918,8.575997599470467
SIM,1886,45,50-100,1931,3
STAT,1815,59,na,1874,1060.0597025357554
STAT,1951,17,35-39,1968,5.048457488374658
STAT,1821,39,30-34,1860,9.301537562397606
STAT,1933,37,40-44,1970,2.0604422741126647
STAT,1834,27,40-44,1861,2.3393481622471013
SIM,1898,20,20-24,1918,7
SIM,1917,17,na,1934,4056
STAT,1860,35,40-44,1895,3.648506906766699
STAT,1859,31,50-100,1890,0.7473405347817007
STAT,1920,31,na,1951,4200.485243995521
STAT,1897,34,25-29,1931,13.750346933648077
STAT,1900,25,45-49,1925,1.5683360720794133
SIM,1852,30,25-29,1882,14
SIM,1838,27,20-24,1865,9
STAT,1923,23,50-100,1946,0.7711697282455021
STAT,1868,16,35-39,1884,0.5424489616585074
STAT,1830,27,na,1857,1873.126462096804
SIM,1908,30,35-39,1938,6
STAT,1909,42,45-49,1951,0.15708417623230175
STAT,1941,9,na,1950,4115.859235514654
STAT,1847,52,20-24,1899,5.495662866677085E-4
STAT,1914,45,50-100,1959,0.22738763408320992
STAT,1906,41,15-19,1947,0.001417146448599323
SIM,1921,32,50-100,1953,1
STAT,1818,40,25-29,1858,1.3490236863182408
SIM,1951,18,20-24,1969,1
STAT,1924,21,na,1945,4367.49763587777
SIM,1827,75,na,1902,491
STAT,1805,52,15-19,1857,1.0112411438191844E-4
STAT,1912,27,25-29,1939,65.44020909736626
STAT,1883,16,30-34,1899,1.5792039189384475
SIM,1899,19,40-44,1918,1
STAT,1920,37,30-34,1957,2.0151307853648506
SIM,1930,28,30-34,1958,68
SIM,1929,29,40-44,1958,6
SIM,1908,40,na,1948,3379
STAT,1922,28,30-34,1950,44.63341813106745
SIM,1866,62,na,1928,1799
SIM,1881,79,na,1960,692
STAT,1826,50,30-34,1876,0.005886205000343016
STAT,1774,114,na,1888,1.9895879276102062E-4
STAT,1836,52,45-49,1888,0.009263236689219412
SIM,1904,38,30-34,1942,6
SIM,1906,17,30-34,1923,5
SIM,1786,88,na,1874,52
STAT,1868,54,50-100,1922,0.014177645841802559
STAT,1935,32,45-49,1967,2.1995274224307595
STAT,1895,49,25-29,1944,0.041959924901154216
SIM,1906,23,30-34,1929,34
STAT,1893,41,30-34,1934,1.4810534579116836
SIM,1890,28,na,1918,3196
STAT,1828,85,na,1913,177.95632881998662
SIM,1853,36,na,1889,1804
SIM,1841,48,na,1889,1558
STAT,1828,88,na,1916,89.11862591622787
SIM,1877,3,na,1880,3157
STAT,1844,47,na,1891,1771.7398407591156
SIM,1887,20,45-49,1907,1
SIM,1833,33,30-34,1866,29
SIM,1904,50,na,1954,3311
STAT,1764,111,na,1875,6.490984621231355E-4
STAT,1898,64,na,1962,2548.6914625565078
STAT,1904,32,15-19,1936,0.11851968750675596
STAT,1899,43,25-29,1942,0.061365738549306034
STAT,1911,25,20-24,1936,18.081414593080332
STAT,1930,40,15-19,1970,0.002047908342538635
SIM,1898,39,40-44,1937,2
STAT,1872,43,15-19,1915,0.013921491917789268
SIM,1913,19,35-39,1932,3
STAT,1849,31,20-24,1880,2.4727858981410002
STAT,1858,36,na,1894,1875.82992374362
SIM,1917,8,na,1925,4210
STAT,1876,24,na,1900,2450.9343157443986
SIM,1879,28,20-24,1907,13
STAT,1892,24,30-34,1916,22.433594028198197
STAT,1909,53,na,1962,3334.0772640194145
SIM,1893,31,25-29,1924,19
SIM,1790,93,na,1883,8
STAT,1841,22,25-29,1863,54.23060713744423
STAT,1857,32,30-34,1889,13.847489964505625
STAT,1848,25,15-19,1873,0.4486419137402474
SIM,1865,26,30-34,1891,33
SIM,1908,43,na,1951,3298
STAT,1893,39,50-100,1932,1.558661518842491
STAT,1861,42,30-34,1903,0.9637057472337314
STAT,1885,31,25-29,1916,10.339357719470637
SIM,1857,35,50-100,1892,1
STAT,1832,93,na,1925,19.900277383144783
STAT,1841,67,na,1908,1185.448949104902
STAT,1845,17,45-49,1862,0.06032686013901008
STAT,1867,72,na,1939,1201.2933211089257
STAT,1825,40,na,1865,2046.2098591776835
STAT,1831,42,15-19,1873,0.010676996005186946
STAT,1873,13,na,1886,2673.8659451152853
STAT,1874,54,na,1928,2165.5485362127433
STAT,1908,40,40-44,1948,0.2362499622621774
STAT,1924,25,30-34,1949,46.413827836385
STAT,1860,17,40-44,1877,0.17416249646454868
SIM,1901,34,35-39,1935,10
STAT,1847,109,na,1956,6.083059222105049E-4
STAT,1840,26,na,1866,1904.435561409396
STAT,1922,46,30-34,1968,0.10371654919652751
SIM,1823,85,na,1908,163
SIM,1929,22,20-24,1951,138
STAT,1825,33,30-34,1858,36.891564115912225
STAT,1899,25,25-29,1924,59.03400032891261
STAT,1925,27,35-39,1952,17.920979178409123
STAT,1903,33,15-19,1936,0.11712340347952202
STAT,1858,46,40-44,1904,0.1360417371162366
SIM,1939,32,25-29,1971,19
STAT,1928,20,na,1948,4636.020164144655
STAT,1935,26,15-19,1961,0.9726891588357719
SIM,1854,74,na,1928,998
STAT,1857,26,30-34,1883,20.593142314762947
STAT,1907,28,35-39,1935,14.261182847715396
STAT,1842,101,na,1943,0.5137522428314285
SIM,1915,28,35-39,1943,22
SIM,1900,51,na,1951,3205
STAT,1932,31,15-19,1963,0.17273576932056564
STAT,1795,96,na,1891,1.9880702918656952
SIM,1837,74,na,1911,673
SIM,1828,69,na,1897,831
SIM,1902,29,30-34,1931,42
SIM,1939,26,25-29,1965,86
SIM,1832,26,50-100,1858,1
STAT,1860,29,40-44,1889,2.463949781093168
SIM,1925,43,na,1968,4527
STAT,1916,33,25-29,1949,9.589191758219501
SIM,1860,39,50-100,1899,1
STAT,1877,50,40-44,1927,0.011131972163953086
STAT,1859,41,25-29,1900,0.5240073327588006
SIM,1842,89,na,1931,62
STAT,1826,32,30-34,1858,24.486314711946807
STAT,1845,20,50-100,1865,0.37527612502284
SIM,1847,95,na,1942,2
STAT,1827,47,na,1874,1502.2276984515065
STAT,1912,29,20-24,1941,18.018819527750914
STAT,1804,75,na,1879,393.2439252165683
STAT,1813,43,50-100,1856,3.559636050265664
STAT,1912,45,25-29,1957,0.05167463994649294
SIM,1922,33,20-24,1955,2
STAT,1852,11,na,1863,2199.671192719734
STAT,1875,21,20-24,1896,71.69303975634584
STAT,1843,62,na,1905,1232.7457832838538
STAT,1920,19,30-34,1939,13.735546584884178
SIM,1887,64,na,1951,1812
STAT,1930,22,15-19,1952,6.892486955859804
STAT,1771,86,na,1857,53.006438035700015
STAT,1797,91,na,1888,19.470376284438206
STAT,1833,28,40-44,1861,2.7834409041570796
STAT,1893,23,30-34,1916,22.772625178674016
STAT,1796,103,na,1899,0.030066592713508398
SIM,1920,29,20-24,1949,24
SIM,1933,10,na,1943,5100
STAT,1906,18,40-44,1924,0.26836436395071434
SIM,1869,20,30-34,1889,33
SIM,1851,31,25-29,1882,21
SIM,1916,22,40-44,1938,5
STAT,1813,47,25-29,1860,0.1676260564980883
SIM,1839,24,30-34,1863,31
SIM,1850,56,na,1906,1707
SIM,1876,61,na,1937,2150
SIM,1865,32,30-34,1897,24
SIM,1903,39,25-29,1942,1
SIM,1902,55,na,1957,3113
SIM,1924,21,25-29,1945,134
STAT,1898,27,30-34,1925,34.479277923601956
STAT,1848,46,na,1894,1842.1168111784202
SIM,1830,37,25-29,1867,1
STAT,1898,15,30-34,1913,2.192479488727479
STAT,1905,43,50-100,1948,0.1063420977921249
STAT,1901,26,40-44,1927,4.255846428296012
STAT,1925,40,40-44,1965,0.30688758461007126
STAT,1926,20,35-39,1946,11.630184716751232
STAT,1914,33,20-24,1947,2.466774960254312
SIM,1895,68,na,1963,2174
STAT,1852,43,35-39,1895,1.3633861279582273
SIM,1810,56,na,1866,1238
SIM,1834,32,30-34,1866,6
SIM,1913,31,20-24,1944,3
SIM,1878,87,na,1965,362
SIM,1924,33,25-29,1957,17
STAT,1880,38,25-29,1918,3.038846855944605
SIM,1934,6,na,1940,5584
STAT,1897,16,25-29,1913,7.691928751138449
STAT,1921,47,25-29,1968,0.06039560908012187
SIM,1868,21,25-29,1889,4
SIM,1864,17,20-24,1881,26
STAT,1856,17,20-24,1873,16.2324895772112
STAT,1925,22,40-44,1947,4.067437247072403
STAT,1817,45,na,1862,1360.5535241101024
STAT,1831,49,35-39,1880,0.10192340871791268
STAT,1849,38,40-44,1887,3.466009723878065
SIM,1856,9,na,1865,2572
STAT,1843,31,25-29,1874,8.391798477737183
STAT,1786,100,na,1886,0.2310982200147218
STAT,1820,41,30-34,1861,2.245667980664593
STAT,1879,60,na,1939,2010.1670376849138
STAT,1905,31,20-24,1936,2.275471880507289
STAT,1905,19,35-39,1924,0.7968718530720093
SIM,1838,25,25-29,1863,39
SIM,1848,26,30-34,1874,3
STAT,1861,28,na,1889,2003.0277025063965
STAT,1834,26,na,1860,1700.5976969182668
SIM,1857,38,40-44,1895,9
SIM,1907,15,25-29,1922,11
SIM,1841,70,na,1911,968
STAT,1889,26,15-19,1915,0.5669775719348998
SIM,1933,22,40-44,1955,5
SIM,1859,38,45-49,1897,1
SIM,1867,41,25-29,1908,3
SIM,1911,32,na,1943,3970
STAT,1880,57,na,1937,2131.6366965246293
STAT,1832,22,na,1854,1868.4997525216183
STAT,1856,15,25-29,1871,5.250200489900815
STAT,1906,17,50-100,1923,0.07207212325521778
SIM,1893,64,na,1957,2339
SIM,1839,42,30-34,1881,1
SIM,1871,38,25-29,1909,3
STAT,1846,11,na,1857,2286.162831743693
STAT,1852,25,35-39,1877,8.646915090640007
SIM,1920,27,25-29,1947,91
SIM,1903,27,25-29,1930,90
SIM,1822,41,na,1863,1632
SIM,1934,20,35-39,1954,13
SIM,1924,15,25-29,1939,71
STAT,1861,87,na,1948,147.86502882988736
STAT,1878,23,35-39,1901,6.099331574017689
STAT,1942,23,25-29,1965,97.75197813665562
SIM,1886,23,35-39,1909,10
STAT,1898,33,30-34,1931,23.805114838375225
STAT,1931,21,20-24,1952,146.19288862728806
SIM,1868,28,45-49,1896,5
STAT,1884,32,25-29,1916,10.20158272446581
STAT,1916,21,25-29,1937,97.97286338538366
SIM,1913,58,na,1971,3394
SIM,1947,24,30-34,1971,46
SIM,1889,68,na,1957,1829
STAT,1867,51,30-34,1918,0.005689287034279694
STAT,1817,41,25-29,1858,1.6424769779111965
STAT,1934,30,40-44,1964,5.404845125615144
STAT,1842,15,30-34,1857,1.8646500528900813
SIM,1864,15,25-29,1879,12
STAT,1865,40,na,1905,2153.0628997591725
STAT,1839,32,na,1871,1890.8691986151505
STAT,1867,33,30-34,1900,16.537979933181916
SIM,1826,34,na,1860,2078
STAT,1898,45,30-34,1943,0.07550862205011512
STAT,1847,27,20-24,1874,10.55764558203353
STAT,1856,50,50-100,1906,0.011862816151485054
SIM,1828,29,na,1857,1765
SIM,1938,19,na,1957,3804
STAT,1864,39,na,1903,2125.596689231055
STAT,1919,43,15-19,1962,0.0016776432295993319
SIM,1944,19,na,1963,4002
STAT,1837,20,45-49,1857,0.6625266319268358
SIM,1840,29,35-39,1869,10
STAT,1858,34,50-100,1892,0.7198047836397168
SIM,1848,44,30-34,1892,4
SIM,1769,85,na,1854,117
STAT,1886,15,40-44,1901,0.19595275569318601
STAT,1933,32,50-100,1965,1.1259269734106214
SIM,1923,36,45-49,1959,1
SIM,1847,33,na,1880,1889
STAT,1950,15,30-34,1965,14.568559795473252
SIM,1839,36,30-34,1875,7
SIM,1889,27,30-34,1916,3
SIM,1900,17,35-39,1917,2
STAT,1886,79,na,1965,1055.8162604989375
STAT,1851,23,30-34,1874,15.990755244888412
STAT,1863,14,na,1877,2415.651159218487
STAT,1910,45,20-24,1955,0.010451528371667696
SIM,1933,23,25-29,1956,149
STAT,1832,29,35-39,1861,8.688504554728395
STAT,1783,71,na,1854,605.0
STAT,1925,23,25-29,1948,111.39383040293347
STAT,1897,18,20-24,1915,23.942579632603938
STAT,1916,15,25-29,1931,9.321601184902933
STAT,1856,33,25-29,1889,7.945494479611149
STAT,1848,25,50-100,1873,0.6325572202841417
STAT,1915,36,45-49,1951,0.6982544987633857
SIM,1875,33,30-34,1908,22
SIM,1942,24,na,1966,4112
SIM,1864,76,na,1940,1028
STAT,1868,30,50-100,1898,0.8915527518707643
STAT,1926,39,25-29,1965,1.2135632024858403
SIM,1846,29,50-100,1875,1
STAT,1863,38,25-29,1901,2.563784334360416
SIM,1864,33,25-29,1897,16
STAT,1876,53,30-34,1929,0.0061079049656515335
STAT,1832,41,20-24,1873,0.1344143625387094
STAT,1931,33,20-24,1964,3.2281365512147686
SIM,1915,25,30-34,1940,65
STAT,1915,18,45-49,1933,0.1052214395745638
STAT,1923,41,15-19,1964,0.0018161632305274036
STAT,1883,7,na,1890,2575.059364932056
STAT,1916,37,40-44,1953,1.547055179845739
STAT,1941,26,45-49,1967,1.8051183954564458
STAT,1805,54,50-100,1859,0.05963486893023911
STAT,1823,54,25-29,1877,0.00450944880488853
STAT,1830,47,30-34,1877,0.08096599913499962
STAT,1838,47,na,1885,1549.4719975240173
SIM,1875,76,na,1951,839
STAT,1924,28,35-39,1952,17.602328512956973
SIM,1835,48,na,1883,1386
STAT,1834,88,na,1922,81.71510704344014
STAT,1842,21,30-34,1863,20.373686617525152
STAT,1915,53,na,1968,3655.9997364819687
SIM,1919,18,25-29,1937,73
STAT,1853,40,45-49,1893,1.250175004184883
SIM,1831,89,na,1920,34
STAT,1873,42,20-24,1915,0.16240998330489448
SIM,1857,34,25-29,1891,17
SIM,1892,32,25-29,1924,23
STAT,1893,44,35-39,1937,0.15908594259175887
STAT,1799,55,na,1854,1089.9985462979996
STAT,1867,36,35-39,1903,6.760299802302279
STAT,1917,30,35-39,1947,9.736806729067279
SIM,1875,36,35-39,1911,9
SIM,1832,34,na,1866,1660
STAT,1934,17,35-39,1951,5.734895698058501
STAT,1860,3,na,1863,2690.3093971324115
SIM,1813,54,50-100,1867,1
SIM,1932,28,35-39,1960,22
STAT,1926,36,20-24,1962,0.3258976064037945
SIM,1940,20,na,1960,3880
SIM,1858,32,50-100,1890,4
STAT,1892,42,na,1934,2925.610825722197
SIM,1843,74,na,1917,992
SIM,1942,17,35-39,1959,8
SIM,1886,21,45-49,1907,3
SIM,1793,67,na,1860,706
STAT,1863,53,20-24,1916,6.49753775636897E-4
SIM,1871,21,na,1892,2426
STAT,1852,14,na,1866,2169.8474814652664
STAT,1899,40,20-24,1939,0.015441152702082225
STAT,1806,51,20-24,1857,0.002172412602348372
STAT,1843,47,40-44,1890,0.11493056377042216
STAT,1951,15,45-49,1966,0.6013253928673081
SIM,1929,42,na,1971,4668
STAT,1863,54,na,1917,1873.860692999903
STAT,1876,38,50-100,1914,1.2739923753236049
STAT,1926,40,25-29,1966,0.08921868942455702
STAT,1843,29,40-44,1872,2.4508993437912063
STAT,1857,47,35-39,1904,0.10983972936482854
STAT,1846,73,na,1919,901.3675372180343
STAT,1921,29,25-29,1950,73.55937962955018
STAT,1887,44,50-100,1931,1.175223326614224
STAT,1939,18,30-34,1957,12.313056475304526
SIM,1947,18,30-34,1965,20
SIM,1850,21,30-34,1871,22
SIM,1902,31,45-49,1933,3
STAT,1867,13,na,1880,2539.4416750864834
STAT,1843,100,na,1943,0.7160453838074362
STAT,1849,34,25-29,1883,8.265212650698725
SIM,1923,17,na,1940,4396
STAT,1862,42,45-49,1904,1.3037927886060023
STAT,1896,17,50-100,1913,0.06549828134965933
SIM,1816,41,na,1857,1389
STAT,1827,49,50-100,1876,0.24531766287095433
STAT,1865,25,15-19,1890,0.4212686564888762
STAT,1879,20,45-49,1899,0.7393621043902483
SIM,1914,43,na,1957,3862
SIM,1851,29,40-44,1880,4
STAT,1821,59,na,1880,1254.1609354300028
STAT,1841,53,30-34,1894,0.004379931029998741
STAT,1857,29,35-39,1886,7.721910573487039
STAT,1911,28,25-29,1939,64.53090525928127
STAT,1913,40,15-19,1953,0.0015281298549748286
STAT,1851,29,na,1880,1890.430950717941
STAT,1944,6,na,1950,4312.285691006873
SIM,1812,42,na,1854,1396
STAT,1857,24,50-100,1881,0.3328530922460199
STAT,1917,23,50-100,1940,0.7037122297820361
SIM,1847,17,15-19,1864,4
SIM,1896,13,na,1909,3449
STAT,1852,22,30-34,1874,16.047694121641193
STAT,1932,22,50-100,1954,0.8724810947500237
STAT,1849,87,na,1936,137.7474555738755
STAT,1861,45,35-39,1906,0.11867063335553059
SIM,1901,33,na,1934,3399
STAT,1901,29,45-49,1930,1.5607953360247788
STAT,1848,24,30-34,1872,17.454210033723985
STAT,1799,58,na,1857,1027.123195757496
STAT,1827,50,45-49,1877,0.014953009217386239
STAT,1851,50,20-24,1901,5.667729314593714E-4
STAT,1961,1,na,1962,5137.55809366027
STAT,1871,48,30-34,1919,0.09591100326482095
STAT,1919,49,50-100,1968,0.2462451930921872
STAT,1835,52,30-34,1887,0.004554836498253224
SIM,1860,22,30-34,1882,20
STAT,1929,17,30-34,1946,15.722552420551215
SIM,1934,3,na,1937,5599
SIM,1908,28,20-24,1936,16
SIM,1937,17,30-34,1954,14
STAT,1868,54,na,1922,2021.2775805963752
SIM,1896,5,na,1901,3504
STAT,1847,28,50-100,1875,0.5715536959729781
SIM,1952,16,15-19,1968,47
SIM,1888,16,25-29,1904,10
STAT,1903,37,30-34,1940,1.6546679679879073
STAT,1878,20,30-34,1898,18.78680116395792
STAT,1908,22,40-44,1930,3.120355929810544
STAT,1826,53,35-39,1879,0.0080208121421394
SIM,1951,20,35-39,1971,16
STAT,1872,47,30-34,1919,0.09783449609930671
STAT,1944,16,15-19,1960,49.33205860482132
STAT,1858,42,25-29,1900,0.5082101564083792
SIM,1896,22,45-49,1918,1
STAT,1913,38,30-34,1951,1.805746957895206
STAT,1939,3,na,1942,4089.8286873365187
SIM,1865,29,35-39,1894,8
STAT,1907,25,30-34,1932,37.60389342522704
SIM,1811,97,na,1908,1
STAT,1893,26,35-39,1919,12.416650996837646
SIM,1872,62,na,1934,2072
SIM,1887,61,na,1948,2017
STAT,1817,85,na,1902,125.42262402894677
STAT,1922,26,50-100,1948,1.1417265132719483
STAT,1858,39,na,1897,1848.055736891923
STAT,1873,17,20-24,1890,18.152412957972537
SIM,1824,31,30-34,1855,29
SIM,1834,35,35-39,1869,11
SIM,1829,31,45-49,1860,7
SIM,1881,17,20-24,1898,16
STAT,1934,35,35-39,1969,3.3784500001688977
STAT,1943,20,35-39,1963,10.122242414291863
SIM,1891,22,30-34,1913,26
STAT,1899,22,20-24,1921,95.5231814803793
STAT,1888,40,45-49,1928,1.8021650809371856
STAT,1837,22,35-39,1859,5.2115078284380605
SIM,1845,22,35-39,1867,8
STAT,1902,43,na,1945,3286.22089480338
STAT,1883,37,35-39,1920,6.990672828485767
STAT,1814,42,15-19,1856,0.04185444170092167
STAT,1888,22,45-49,1910,0.8312851928068843
SIM,1921,38,30-34,1959,7
STAT,1826,35,35-39,1861,8.609198722127463
SIM,1888,34,25-29,1922,25
SIM,1820,49,na,1869,1383
SIM,1907,30,20-24,1937,3
STAT,1853,55,na,1908,1709.9505917661181
STAT,1912,38,50-100,1950,0.41137978673337056
STAT,1918,44,45-49,1962,0.17805050887536303
SIM,1891,37,35-39,1928,10
STAT,1905,54,na,1959,3134.1253266712492
SIM,1921,22,15-19,1943,7
STAT,1839,17,15-19,1856,5.5039368021525625
STAT,1881,33,15-19,1914,0.13805811782932528
STAT,1883,22,30-34,1905,17.605150041353195
STAT,1866,34,30-34,1900,16.18909491791052
SIM,1829,70,na,1899,912
SIM,1837,31,40-44,1868,5
STAT,1871,80,na,1951,620.7144931250899
STAT,1875,24,25-29,1899,59.0044443836575
SIM,1806,82,na,1888,147
SIM,1933,25,45-49,1958,2
SIM,1807,67,na,1874,690
STAT,1884,48,40-44,1932,0.16837182564894412
SIM,1823,82,na,1905,322
SIM,1926,26,15-19,1952,1
STAT,1923,45,30-34,1968,0.10586435933117466
STAT,1945,23,na,1968,4040.602070242248
STAT,1901,36,na,1937,3378.2308710309026
STAT,1822,52,20-24,1874,0.0010538232605081718
SIM,1847,36,na,1883,1850
STAT,1852,40,30-34,1892,0.8806969064633555
STAT,1832,107,na,1939,0.003211206973530641
STAT,1870,20,25-29,1890,57.11427964785514
STAT,1914,42,50-100,1956,0.11745040341344987
STAT,1931,36,25-29,1967,1.3190711729410296
STAT,1908,24,50-100,1932,0.6068145176063859
STAT,1920,21,45-49,1941,1.2669933495412544
STAT,1934,20,na,1954,4974.977327235225
STAT,1877,53,45-49,1930,0.014885181275995389
SIM,1865,21,na,1886,2212
STAT,1850,28,40-44,1878,2.679898186253124
STAT,1820,44,35-39,1864,3.187834439250177
STAT,1875,79,na,1954,725.1241913732839
STAT,1875,46,40-44,1921,0.178075792360573
STAT,1917,7,na,1924,4327.726775322498
STAT,1908,45,35-39,1953,0.11943340437438028
STAT,1880,54,na,1934,2221.0821710249265
STAT,1844,49,15-19,1893,3.0986568989952525E-4
STAT,1918,26,15-19,1944,0.7610842538271231
STAT,1875,39,na,1914,2419.066358968554
SIM,1847,30,20-24,1877,2
SIM,1907,25,50-100,1932,1
SIM,1839,39,35-39,1878,15
SIM,1863,51,na,1914,1963
STAT,1831,46,30-34,1877,0.07323864982608881
SIM,1870,42,45-49,1912,5
STAT,1939,20,15-19,1959,5.400671450414258
SIM,1881,17,na,1898,2227
STAT,1908,27,35-39,1935,14.4485859413697
SIM,1874,34,30-34,1908,23
STAT,1861,38,50-100,1899,1.0253092069357261
STAT,1942,27,40-44,1969,4.93928518847342
SIM,1916,24,50-100,1940,4
STAT,1829,31,40-44,1860,3.9645651517312066
STAT,1896,22,40-44,1918,2.7858882158202687
SIM,1878,8,na,1886,3128
STAT,1927,38,25-29,1965,1.236067310606182
SIM,1832,22,25-29,1854,3
STAT,1839,30,20-24,1869,2.407834488977995
STAT,1868,51,45-49,1919,0.014075727125419834
SIM,1862,43,50-100,1905,1
SIM,1916,27,35-39,1943,22
STAT,1820,34,na,1854,1378.3350154732905
STAT,1905,46,25-29,1951,0.04757497749256559
SIM,1881,76,na,1957,873
STAT,1887,64,na,1951,1960.2528200171857
STAT,1900,42,25-29,1942,0.062487031440508906
STAT,1834,45,40-44,1879,0.12190627679626481
STAT,1941,16,35-39,1957,4.364788566933842
STAT,1856,19,40-44,1875,0.16550161039482816
SIM,1920,43,na,1963,4401
SIM,1855,21,45-49,1876,1
SIM,1933,20,20-24,1953,229
STAT,1839,49,40-44,1888,0.12053809412997198
SIM,1911,2,na,1913,4215
STAT,1909,13,na,1922,3902.0757791465035
SIM,1868,25,40-44,1893,3
SIM,1852,11,na,1863,2203
STAT,1809,59,na,1868,1178.902559311831
STAT,1925,43,45-49,1968,0.20331220090386717
SIM,1874,22,25-29,1896,85
STAT,1776,106,na,1882,0.01111710748337743
STAT,1822,34,20-24,1856,6.038101267635772
STAT,1822,63,na,1885,1029.5657925620883
SIM,1897,25,50-100,1922,1
STAT,1921,19,15-19,1940,51.96699240888384
SIM,1906,28,50-100,1934,1
SIM,1903,24,20-24,1927,129
SIM,1947,20,15-19,1967,6
STAT,1842,36,35-39,1878,7.548112834907201
STAT,1865,20,20-24,1885,65.2613135657001
SIM,1825,89,na,1914,27
SIM,1850,36,35-39,1886,10
SIM,1902,58,na,1960,3005
STAT,1881,17,50-100,1898,0.0476968007845594
STAT,1938,29,40-44,1967,4.657132468223146
STAT,1821,41,45-49,1862,2.4564522334704764
SIM,1825,39,40-44,1864,8
SIM,1878,28,na,1906,2855
STAT,1847,21,45-49,1868,0.6446853857769108
STAT,1940,20,na,1960,3758.1993745948816
STAT,1918,44,15-19,1962,0.0016429113852448945
SIM,1860,77,na,1937,732
STAT,1803,93,na,1896,12.18300606940544
SIM,1812,82,na,1894,144
SIM,1830,34,20-24,1864,2
SIM,1799,55,na,1854,1266
STAT,1875,28,40-44,1903,3.0961144388090216
STAT,1811,60,na,1871,1038.4374510837351
STAT,1866,22,25-29,1888,53.97510360585224
STAT,1869,79,na,1948,686.4923366044538
STAT,1921,32,20-24,1953,2.7414975158749617
STAT,1827,44,na,1871,1553.1965782468
SIM,1821,56,na,1877,1116
STAT,1815,50,50-100,1865,0.033322757384135496
STAT,1855,21,40-44,1876,1.8456799663873102
STAT,1925,20,20-24,1945,135.31455108944726
SIM,1839,20,15-19,1859,3
STAT,1925,25,45-49,1950,2.076159224649523
STAT,1817,39,40-44,1856,12.780168331210058
SIM,1859,21,na,1880,2240
SIM,1934,18,20-24,1952,3
STAT,1950,18,35-39,1968,5.011143847479599
STAT,1903,39,50-100,1942,0.3773395370268377
STAT,1886,18,45-49,1904,0.06947695420512667
SIM,1884,28,na,1912,2384
STAT,1898,67,na,1965,2418.190024697254
STAT,1903,33,45-49,1936,1.4342091593801465
SIM,1873,20,20-24,1893,2
SIM,1957,7,na,1964,5439
STAT,1862,69,na,1931,1280.0211368249875
STAT,1916,2,na,1918,4364.65317434526
SIM,1924,19,40-44,1943,7
STAT,1844,30,25-29,1874,9.894132104355934
STAT,1889,25,50-100,1914,0.8020740516897991
STAT,1916,19,40-44,1935,0.2978726723951867
STAT,1919,47,30-34,1966,0.097626523659011
STAT,1926,18,20-24,1944,167.55459973606273
SIM,1882,25,25-29,1907,49
SIM,1800,57,na,1857,1057
STAT,1842,18,35-39,1860,0.630652493506678
STAT,1890,45,25-29,1935,0.07179637661125349
SIM,1827,27,45-49,1854,2
STAT,1922,35,na,1957,4332.189446570158
STAT,1867,54,35-39,1921,0.007963930283152247
STAT,1886,33,35-39,1919,10.75385869718945
STAT,1889,43,30-34,1932,1.4214472092886299
STAT,1857,40,15-19,1897,0.010995358707065559
STAT,1872,44,50-100,1916,1.0582632914674321
SIM,1855,7,na,1862,2561
STAT,1849,38,50-100,1887,0.972099514139162
STAT,1883,50,50-100,1933,0.015141633731734706
STAT,1884,21,50-100,1905,0.4073834335602813
STAT,1913,29,35-39,1942,14.985878273088424
SIM,1939,18,40-44,1957,2
SIM,1838,84,na,1922,168
SIM,1893,34,50-100,1927,1
STAT,1941,23,40-44,1964,3.5069079831241865
SIM,1836,42,45-49,1878,3
SIM,1876,24,na,1900,2729
SIM,1857,16,30-34,1873,1
STAT,1878,46,20-24,1924,0.01261717883909758
STAT,1850,53,40-44,1903,0.007931735988754981
SIM,1940,16,25-29,1956,57
STAT,1852,50,40-44,1902,0.008098819251386799
STAT,1915,26,35-39,1941,15.505177606893886
SIM,1834,29,40-44,1863,4
STAT,1870,24,40-44,1894,2.053759221724042
STAT,1855,43,15-19,1898,0.010319855815150505
SIM,1797,97,na,1894,1
SIM,1919,15,20-24,1934,27
SIM,1827,42,35-39,1869,3
SIM,1949,21,25-29,1970,134
STAT,1798,70,na,1868,791.5571775900863
SIM,1848,16,20-24,1864,20
STAT,1850,21,20-24,1871,63.792047808815965
STAT,1904,29,25-29,1933,60.87426311745295
SIM,1881,33,25-29,1914,4
SIM,1878,25,na,1903,2763
STAT,1819,42,35-39,1861,3.8866200045354478
SIM,1860,43,35-39,1903,4
STAT,1932,23,30-34,1955,37.992210277984675
SIM,1814,42,25-29,1856,1
SIM,1899,22,30-34,1921,44
STAT,1860,40,20-24,1900,0.1324433074890732
SIM,1865,86,na,1951,225
SIM,1917,18,20-24,1935,156
SIM,1879,22,45-49,1901,1
STAT,1853,27,45-49,1880,1.0636874679138748
SIM,1921,29,35-39,1950,28
STAT,1923,45,na,1968,4362.784005856021
STAT,1929,39,40-44,1968,1.938394732224434
STAT,1832,33,50-100,1865,0.8068041721017757
STAT,1828,42,45-49,1870,1.4290731699477586
STAT,1874,17,35-39,1891,0.5674692849509352
SIM,1882,17,35-39,1899,2
SIM,1903,65,na,1968,2457
SIM,1872,34,na,1906,2547
SIM,1864,39,na,1903,2547
STAT,1921,37,15-19,1958,0.021656050010360844
SIM,1783,77,na,1860,366
SIM,1778,90,na,1868,7
STAT,1895,33,45-49,1928,2.2903314445085536
SIM,1829,48,na,1877,1648
SIM,1895,39,25-29,1934,3
SIM,1900,39,45-49,1939,1
SIM,1913,0,na,1913,4326
STAT,1929,36,na,1965,4886.3758691450375
STAT,1810,44,40-44,1854,9.095232742093728
STAT,1901,20,35-39,1921,8.311504904966215
SIM,1872,27,20-24,1899,18
SIM,1873,81,na,1954,458
STAT,1918,0,na,1918,4950.515719787954
SIM,1832,24,15-19,1856,2
STAT,1841,36,na,1877,1906.7831604407206
STAT,1821,81,na,1902,323.91357395521135
STAT,1864,27,20-24,1891,10.691894252769883
STAT,1931,40,na,1971,5028.277382217678
SIM,1890,17,30-34,1907,2
STAT,1872,21,40-44,1893,2.1223312347495877
STAT,1899,17,40-44,1916,0.2535314141553007
SIM,1935,34,45-49,1969,2
STAT,1920,3,na,1923,4595.419920094889
SIM,1853,32,35-39,1885,11
STAT,1930,19,25-29,1949,56.32277448587016
SIM,1879,72,na,1951,1511
STAT,1949,16,35-39,1965,4.931712798558179
SIM,1935,16,15-19,1951,58
STAT,1892,20,15-19,1912,4.206061304304424
SIM,1855,37,30-34,1892,11
SIM,1924,33,na,1957,4454
STAT,1886,40,40-44,1926,2.4228148715062066
STAT,1866,49,35-39,1915,0.12819878830805898
SIM,1915,31,25-29,1946,15
STAT,1929,31,45-49,1960,2.0214351746874
STAT,1950,18,50-100,1968,0.44742347491374473
SIM,1861,27,45-49,1888,1
STAT,1839,42,20-24,1881,0.11866927619510015
STAT,1851,48,45-49,1899,0.17645099383153032
STAT,1932,16,25-29,1948,58.13172508407762
STAT,1838,53,25-29,1891,0.002333046380326938
STAT,1937,31,na,1968,3779.686563039317
SIM,1899,15,25-29,1914,11
SIM,1915,50,na,1965,4061
STAT,1883,46,30-34,1929,0.09594598247016298
STAT,1915,16,na,1931,4088.949092896131
SIM,1844,45,50-100,1889,1
SIM,1911,60,na,1971,3520
STAT,1869,43,45-49,1912,1.4590221882554424
SIM,1857,57,na,1914,1748
STAT,1875,54,25-29,1929,0.0035728095901310913
SIM,1894,40,40-44,1934,7
STAT,1833,31,30-34,1864,16.1290544003029
STAT,1849,16,30-34,1865,1.5430264478731166
STAT,1813,100,na,1913,0.46548770070557793
STAT,1848,27,35-39,1875,9.404782456083671
STAT,1843,53,35-39,1896,0.005713303012572742
SIM,1830,39,na,1869,1534
SIM,1889,17,20-24,1906,21
STAT,1927,16,15-19,1943,57.17510690352017
SIM,1785,78,na,1863,263
STAT,1864,40,20-24,1904,0.14620064093228666
SIM,1937,31,45-49,1968,1
STAT,1909,16,na,1925,3831.4085436203773
SIM,1929,37,25-29,1966,1
STAT,1913,21,na,1934,3742.2986211118764
SIM,1841,31,30-34,1872,26
STAT,1843,37,na,1880,1686.4179037948443
STAT,1927,35,50-100,1962,0.5285287433288033
STAT,1949,23,40-44,1972,3.9624056740711175
SIM,1923,26,35-39,1949,33
SIM,1940,23,30-34,1963,52
STAT,1766,100,na,1866,0.1016786440243603
STAT,1868,35,40-44,1903,4.265694199045949
STAT,1923,11,na,1934,4708.006463306608
STAT,1940,18,40-44,1958,1.4332796529511005
SIM,1910,13,na,1923,3742
STAT,1852,73,na,1925,900.7820509245826
SIM,1849,21,20-24,1870,88
SIM,1876,35,40-44,1911,5
STAT,1822,69,na,1891,820.5381272911275
SIM,1877,71,na,1948,1382
STAT,1831,27,25-29,1858,36.84699419084997
STAT,1852,19,40-44,1871,0.16579667971746107
STAT,1935,30,na,1965,5292.495643592403
SIM,1840,16,20-24,1856,14
STAT,1845,32,35-39,1877,8.79828248751029
SIM,1865,52,na,1917,1917
STAT,1847,37,30-34,1884,4.140271728896868
STAT,1812,79,na,1891,317.40151186658613
STAT,1898,27,50-100,1925,0.8758724273719974
STAT,1809,81,na,1890,249.6974004123686
STAT,1881,51,45-49,1932,0.014196385875651179
STAT,1878,19,50-100,1897,0.051090304936185306
STAT,1878,1,na,1879,3600.5825467040727
STAT,1879,38,20-24,1917,0.8084447167699236
STAT,1889,18,25-29,1907,7.038820549752677
STAT,1890,49,40-44,1939,0.11669574061141529
STAT,1847,21,na,1868,1976.7346739728898
SIM,1853,47,50-100,1900,4
STAT,1923,18,40-44,1941,1.6551413956624497
STAT,1830,64,na,1894,1146.8642658926613
STAT,1870,46,20-24,1916,0.011935249813138229
SIM,1922,20,45-49,1942,1
STAT,1792,85,na,1877,85.27465792793363
STAT,1864,51,45-49,1915,0.013289711466814666
STAT,1905,26,na,1931,3496.5125426700956
STAT,1861,56,na,1917,1711.824275957009
SIM,1880,28,25-29,1908,64
STAT,1827,78,na,1905,464.6263010184195
STAT,1882,5,na,1887,2604.263772468005
STAT,1892,48,na,1940,2816.0969074106715
STAT,1854,38,15-19,1892,0.04193421356598399
STAT,1942,18,na,1960,3882.453965198561
STAT,1956,16,50-100,1972,0.5009580099505245
STAT,1776,103,na,1879,0.04517260028554602
SIM,1930,24,15-19,1954,7
STAT,1823,32,15-19,1855,0.381002353945333
SIM,1882,22,20-24,1904,1
SIM,1905,60,na,1965,3063
STAT,1889,22,na,1911,2945.4178012041853
SIM,1888,49,na,1937,2840
SIM,1880,69,na,1949,1309
STAT,1839,35,15-19,1874,0.04857427141537108
STAT,1894,41,45-49,1935,1.954939951969001
STAT,1879,51,20-24,1930,7.814882212103476E-4
STAT,1910,44,45-49,1954,0.15674181971397255
STAT,1885,32,na,1917,2399.0485236932695
STAT,1909,20,35-39,1929,8.883572514293853
STAT,1818,44,40-44,1862,4.134252987244638
STAT,1878,84,na,1962,547.3725619780782
STAT,1950,21,25-29,1971,110.74640850394657
STAT,1919,46,na,1965,4033.2965211132937
STAT,1963,2,na,1965,5048.500817232172
SIM,1874,69,na,1943,1381
SIM,1835,34,40-44,1869,6
SIM,1901,70,na,1971,2325
SIM,1823,51,na,1874,1392
STAT,1867,36,50-100,1903,1.1734767872161753
STAT,1848,42,30-34,1890,0.9375007013411164
STAT,1927,34,45-49,1961,1.9539600381626756
STAT,1872,28,25-29,1900,42.80254909158417
SIM,1859,52,na,1911,2001
STAT,1890,23,15-19,1913,4.058945212707341
STAT,1915,31,15-19,1946,0.13260153309403822
STAT,1840,32,15-19,1872,0.12158740085892887
STAT,1858,21,20-24,1879,63.10501549890598
STAT,1818,47,50-100,1865,0.4372961597772588
SIM,1779,78,na,1857,300
SIM,1858,24,35-39,1882,11
STAT,1851,51,35-39,1902,0.006549863911894533
SIM,1813,92,na,1905,2
SIM,1877,40,40-44,1917,11
SIM,1873,1,na,1874,3186
SIM,1897,18,25-29,1915,13
STAT,1929,30,na,1959,4861.149560320025
SIM,1896,28,20-24,1924,15
STAT,1907,31,25-29,1938,8.758962586428837
SIM,1868,43,35-39,1911,5
STAT,1837,45,20-24,1882,0.008718709464030033
STAT,1881,70,na,1951,1365.9845797233404
SIM,1866,21,20-24,1887,72
STAT,1815,81,na,1896,234.08526746338518
SIM,1886,54,na,1940,2371
SIM,1840,94,na,1934,8
STAT,1820,48,15-19,1868,6.700534196954026E-4
SIM,1931,20,50-100,1951,1
SIM,1932,31,25-29,1963,17
SIM,1800,94,na,1894,22
STAT,1901,29,50-100,1930,0.8992399252973755
STAT,1839,45,25-29,1884,0.04268735821870892
STAT,1914,28,40-44,1942,4.724150038997147
STAT,1811,52,45-49,1863,0.034564348579486995
STAT,1921,37,50-100,1958,0.4734799426555402
SIM,1799,92,na,1891,5
SIM,1856,17,25-29,1873,8
SIM,1875,2,na,1877,3090
SIM,1856,42,30-34,1898,1
STAT,1823,103,na,1926,0.07937291276702121
SIM,1862,32,45-49,1894,2
SIM,1877,19,20-24,1896,25
STAT,1888,28,20-24,1916,13.935972226427454
STAT,1809,87,na,1896,81.35127819307051
STAT,1824,31,20-24,1855,6.146339587396389
STAT,1835,36,na,1871,2008.0314493820408
STAT,1890,41,45-49,1931,1.8554523483562597
STAT,1812,49,50-100,1861,0.5485824110064796
STAT,1840,88,na,1928,96.23410222661138
STAT,1870,39,15-19,1909,0.05513290447487542
STAT,1890,30,20-24,1920,3.3628245354378934
STAT,1911,26,na,1937,3698.3899152356644
STAT,1827,34,40-44,1861,5.374428227399074
STAT,1891,15,15-19,1906,7.4555054856977785
STAT,1879,44,15-19,1923,0.01435908525129049
SIM,1811,66,na,1877,961
STAT,1869,19,20-24,1888,17.4424472520254
STAT,1853,21,na,1874,2104.289678005129
SIM,1898,17,30-34,1915,2
STAT,1903,39,20-24,1942,0.23691588409081496
SIM,1791,72,na,1863,495
SIM,1905,28,40-44,1933,7
STAT,1824,64,na,1888,877.9231798644206
STAT,1803,96,na,1899,3.5794659237741775
STAT,1863,35,20-24,1898,0.6963761309969893
STAT,1928,15,20-24,1943,173.46961742390224
STAT,1863,28,15-19,1891,0.4045845918821271
STAT,1863,19,50-100,1882,0.044990969895940244
STAT,1894,25,40-44,1919,3.9216642566240387
SIM,1912,48,na,1960,3364
SIM,1916,9,na,1925,4248
SIM,1877,33,35-39,1910,15
STAT,1925,46,na,1971,4510.190698628063
SIM,1922,28,40-44,1950,7
STAT,1891,22,20-24,1913,86.17357069021703
STAT,1924,31,25-29,1955,10.902803170869559
STAT,1889,49,50-100,1938,0.16893307400947452
SIM,1859,45,50-100,1904,2
STAT,1848,17,25-29,1865,5.735415735135722
STAT,1845,42,45-49,1887,1.113606762301388
STAT,1840,50,45-49,1890,0.010319213726368652
STAT,1854,32,45-49,1886,1.3402032982567742
SIM,1920,20,40-44,1940,8
SIM,1785,72,na,1857,444
SIM,1912,29,25-29,1941,69
STAT,1838,37,20-24,1875,0.6226651837328718
STAT,1933,21,25-29,1954,124.1855687195051
STAT,1916,29,50-100,1945,1.0311696479751868
SIM,1854,43,na,1897,2121
STAT,1858,16,40-44,1874,0.17030048365830194
STAT,1830,29,30-34,1859,25.329532685429808
STAT,1834,53,25-29,1887,0.0021204967305538188
STAT,1839,52,30-34,1891,0.00419772983246818
STAT,1902,47,20-24,1949,0.009616082105952497
SIM,1852,34,40-44,1886,3
STAT,1896,44,15-19,1940,0.0012647788349640478
STAT,1923,23,20-24,1946,130.31995856439926
STAT,1900,15,35-39,1915,0.7734218605322758
SIM,1931,23,20-24,1954,170
STAT,1884,51,30-34,1935,0.005957076170493246
STAT,1844,34,40-44,1878,4.018740496874441
STAT,1810,44,na,1854,1549.6387974882145
STAT,1936,18,na,1954,3548.3427478653807
SIM,1871,86,na,1957,294
STAT,1892,49,45-49,1941,0.16519544216390533
SIM,1899,25,35-39,1924,14
SIM,1941,21,25-29,1962,117
SIM,1892,54,na,1946,2828
SIM,1832,31,20-24,1863,2
SIM,1909,32,50-100,1941,1
STAT,1912,20,40-44,1932,3.270409035051
STAT,1869,33,35-39,1902,9.90239325169276
STAT,1914,20,45-49,1934,1.119603077611345
SIM,1819,42,45-49,1861,6
STAT,1883,30,15-19,1913,0.14188304447363315
STAT,1859,18,na,1877,2151.7416716577636
STAT,1915,23,30-34,1938,29.88585638101168
SIM,1874,16,30-34,1890,3
STAT,1878,49,25-29,1927,0.05913007646345227
SIM,1853,42,45-49,1895,2
STAT,1938,13,na,1951,3939.69964706318
SIM,1900,36,40-44,1936,2
STAT,1836,110,na,1946,1.742377923384181E-4
STAT,1878,33,45-49,1911,1.8206031944190095
STAT,1941,30,na,1971,4013.4862105715906
SIM,1921,26,30-34,1947,5
SIM,1883,71,na,1954,1456
SIM,1886,33,45-49,1919,6
STAT,1843,16,50-100,1859,0.04247744021885489
STAT,1892,30,25-29,1922,13.08560879791548
STAT,1884,44,25-29,1928,0.6309519970836518
STAT,1898,33,na,1931,3253.569764173926
STAT,1857,17,35-39,1874,0.5083563927093356
STAT,1836,42,35-39,1878,1.358958356055429
STAT,1897,57,na,1954,2721.158541104656
STAT,1920,42,50-100,1962,0.1310250662487566
STAT,1939,19,45-49,1958,0.5044567378296646
SIM,1841,42,na,1883,1650
STAT,1831,24,20-24,1855,75.08994207443233
STAT,1866,16,30-34,1882,1.5390846803082048
STAT,1836,89,na,1925,66.23876543102546
STAT,1913,26,30-34,1939,39.52706498303111
SIM,1845,32,na,1877,2041
SIM,1900,23,na,1923,3441
SIM,1939,29,50-100,1968,1
STAT,1823,50,45-49,1873,0.02000675169962237
STAT,1849,26,40-44,1875,2.7964065141787495
STAT,1858,19,45-49,1877,0.0597531867401186
STAT,1897,36,15-19,1933,0.07640254677124647
STAT,1900,22,40-44,1922,2.9236070426637975
SIM,1810,50,na,1860,1390
SIM,1863,57,na,1920,1807
STAT,1864,43,25-29,1907,0.5810259428353327
STAT,1876,36,45-49,1912,2.088899369797148
STAT,1894,43,na,1937,2993.980835944115
SIM,1912,19,15-19,1931,9
STAT,1929,29,30-34,1958,49.51585638957485
SIM,1881,30,20-24,1911,3
STAT,1836,27,45-49,1863,0.9063291503431328
STAT,1852,53,45-49,1905,0.010829383230833047
SIM,1867,16,na,1883,2414
SIM,1860,36,50-100,1896,1
STAT,1921,16,na,1937,4247.852386889196
STAT,1940,23,20-24,1963,114.31784583197864
STAT,1938,18,50-100,1956,0.3729803039791001
STAT,1852,36,50-100,1888,0.9459339743684284
STAT,1932,26,35-39,1958,19.881616490648675
SIM,1828,60,na,1888,1102
SIM,1807,92,na,1899,24
SIM,1860,40,30-34,1900,1
SIM,1871,45,50-100,1916,2
STAT,1766,99,na,1865,0.16609272440190848
SIM,1844,42,35-39,1886,2
STAT,1818,95,na,1913,6.849951551993755
STAT,1811,91,na,1902,25.261924103100075
SIM,1848,39,50-100,1887,1
SIM,1940,26,35-39,1966,26
STAT,1791,66,na,1857,692.9814803806001
STAT,1904,19,15-19,1923,8.555520605015461
SIM,1937,29,30-34,1966,5
STAT,1817,103,na,1920,0.0656613270524968
STAT,1873,30,20-24,1903,2.7899347818164606
STAT,1817,53,25-29,1870,0.007148736594323985
STAT,1860,50,30-34,1910,0.004985207569237599
STAT,1886,43,45-49,1929,1.5844774136677537
SIM,1882,24,na,1906,2040
SIM,1916,15,35-39,1931,2
STAT,1872,99,na,1971,14.246261429621871
STAT,1853,92,na,1945,34.44308776437291
STAT,1883,49,35-39,1932,0.1354828854481524
SIM,1949,16,45-49,1965,1
SIM,1872,43,25-29,1915,1
STAT,1887,32,40-44,1919,4.890280786701899
STAT,1822,37,25-29,1859,5.365108852594341
STAT,1862,17,45-49,1879,0.06525420998451621
STAT,1920,39,20-24,1959,0.29084000353306383
STAT,1844,19,na,1863,2281.4818383259717
STAT,1866,40,25-29,1906,0.6066261037758693
STAT,1859,46,na,1905,1832.814669628487
SIM,1836,32,35-39,1868,12
STAT,1809,45,45-49,1854,0.8932782798512442
STAT,1810,47,45-49,1857,0.9116863357386507
STAT,1802,52,35-39,1854,0.025121086565369814
SIM,1878,39,25-29,1917,3
SIM,1838,59,na,1897,1398
STAT,1858,54,25-29,1912,0.0027294626438770096
STAT,1923,33,30-34,1956,18.238061758929142
STAT,1895,23,35-39,1918,7.673001419133786
STAT,1862,32,35-39,1894,8.83303258429222
SIM,1904,13,na,1917,3886
STAT,1831,77,na,1908,543.1844630409676
SIM,1822,32,50-100,1854,1
STAT,1829,53,50-100,1882,0.009713054407897133
SIM,1907,27,na,1934,3756
STAT,1843,50,30-34,1893,0.004072497310991007
STAT,1861,50,na,1911,1833.079775437027
SIM,1868,40,30-34,1908,1
STAT,1912,35,50-100,1947,0.41735680014500426
STAT,1857,21,50-100,1878,0.37376588024489443
STAT,1887,36,20-24,1923,0.8734283458530507
STAT,1906,36,35-39,1942,2.25663699730385
STAT,1908,15,35-39,1923,0.8254705415397082
SIM,1898,23,25-29,1921,99
SIM,1923,23,30-34,1946,43
SIM,1895,32,40-44,1927,7
SIM,1899,2,na,1901,4020
SIM,1817,51,na,1868,1455
STAT,1870,27,45-49,1897,1.1011855819494425
SIM,1863,26,na,1889,2301
SIM,1860,15,na,1875,2364
STAT,1873,27,30-34,1900,25.78398812217175
SIM,1881,27,30-34,1908,37
SIM,1915,22,na,1937,4126
STAT,1850,24,25-29,1874,51.858783922065804
STAT,1923,48,35-39,1971,0.15196871498460834
SIM,1935,31,40-44,1966,11
STAT,1903,49,30-34,1952,0.07690215723298435
STAT,1933,31,35-39,1964,12.451851949686505
SIM,1908,20,25-29,1928,105
STAT,1837,38,15-19,1875,0.0461606224515043
STAT,1885,60,na,1945,1917.3596738222147
SIM,1874,40,25-29,1914,1
STAT,1838,50,20-24,1888,5.112059639091542E-4
SIM,1807,98,na,1905,2
STAT,1819,52,45-49,1871,0.027171931794036656
STAT,1903,45,15-19,1948,3.277893354531026E-4
SIM,1844,84,na,1928,95
STAT,1924,21,15-19,1945,6.366451900997395
SIM,1828,41,40-44,1869,4
SIM,1834,33,50-100,1867,1
STAT,1847,92,na,1939,31.184458333799174
STAT,1914,18,30-34,1932,2.5372358229344543
SIM,1887,40,35-39,1927,3
SIM,1875,21,30-34,1896,30
SIM,1852,37,45-49,1889,3
STAT,1856,35,15-19,1891,0.0438960388295089
STAT,1901,41,30-34,1942,0.11354689125379117
SIM,1854,31,40-44,1885,2
STAT,1867,75,na,1942,979.2468971006654
STAT,1845,63,na,1908,1303.7662122493564
SIM,1885,41,45-49,1926,5
SIM,1877,9,na,1886,2783
STAT,1835,35,45-49,1870,1.889308615211963
STAT,1858,24,25-29,1882,46.683246735404815
STAT,1830,31,45-49,1861,1.7011881650360576
SIM,1847,67,na,1914,1150
SIM,1818,37,45-49,1855,1
STAT,1888,38,30-34,1926,6.321938812800415
STAT,1950,13,na,1963,4691.798039364492
STAT,1877,28,45-49,1905,1.1533317968080397
SIM,1885,28,45-49,1913,1
SIM,1910,43,40-44,1953,3
STAT,1898,18,35-39,1916,0.7493289708381932
STAT,1927,31,40-44,1958,4.868407179224355
SIM,1862,22,35-39,1884,10
STAT,1850,19,na,1869,2122.59573975346
SIM,1813,61,na,1874,1071
SIM,1896,38,30-34,1934,12
SIM,1832,34,25-29,1866,17
STAT,1912,47,15-19,1959,3.571703212562116E-4
SIM,1876,30,50-100,1906,1
STAT,1849,22,na,1871,2021.1371967047899
STAT,1882,23,25-29,1905,55.833045969959215
SIM,1890,53,na,1943,2898
SIM,1931,33,30-34,1964,34
STAT,1867,21,30-34,1888,17.136272470488624
SIM,1914,2,na,1916,4456
STAT,1905,34,25-29,1939,8.513750823587598
SIM,1886,42,50-100,1928,1
STAT,1879,40,35-39,1919,1.9278558404438528
SIM,1922,18,30-34,1940,25
SIM,1854,15,na,1869,2595
STAT,1842,48,35-39,1890,0.12446308044472765
STAT,1899,15,15-19,1914,8.264408656088364
STAT,1910,48,25-29,1958,0.049793512144499306
STAT,1844,37,45-49,1881,1.666682839870935
STAT,1824,34,25-29,1858,16.02085677228392
STAT,1854,22,35-39,1876,5.145699100768911
SIM,1923,33,40-44,1956,3
STAT,1854,46,50-100,1900,0.1848428168482316
SIM,1913,34,25-29,1947,17
STAT,1849,22,25-29,1871,54.11333979810961
STAT,1878,42,50-100,1920,1.1062783342145512
STAT,1874,32,30-34,1906,18.056658014777128
STAT,1925,45,35-39,1970,0.1586333507518081
STAT,1818,47,45-49,1865,0.4202031509646784
SIM,1901,41,40-44,1942,3
STAT,1907,47,40-44,1954,0.14256910549040988
SIM,1822,75,na,1897,519
STAT,1837,37,na,1874,1778.895956523186
STAT,1891,25,25-29,1916,53.25587487383643
STAT,1839,63,na,1902,1265.0233045297264
STAT,1874,23,na,1897,2438.350795569691
SIM,1849,30,50-100,1879,4
STAT,1816,69,na,1885,860.4823892893535
STAT,1916,30,20-24,1946,2.5617730773996374
SIM,1850,84,na,1934,260
SIM,1801,76,na,1877,202
STAT,1841,46,25-29,1887,0.04382731100514877
STAT,1879,54,25-29,1933,0.0036306181921125546
STAT,1870,49,25-29,1919,0.055934234036088555
STAT,1918,6,na,1924,4404.303075082872
STAT,1932,28,na,1960,4956.205053767648
STAT,1840,17,25-29,1857,5.143055539441838
STAT,1882,58,na,1940,1934.7776835300738
STAT,1888,74,na,1962,1552.4108492994308
SIM,1869,42,na,1911,2251
SIM,1919,12,na,1931,4337
STAT,1851,45,40-44,1896,0.1309229111014698
STAT,1823,31,50-100,1854,2.8240395906023665
STAT,1865,29,50-100,1894,0.5857435895646372
SIM,1882,32,30-34,1914,33
STAT,1910,34,35-39,1944,8.813727432372254
STAT,1909,18,20-24,1927,26.758448553790352
STAT,1931,24,25-29,1955,120.31893466382876
STAT,1878,39,15-19,1917,0.05828296236519919
STAT,1885,38,45-49,1923,1.9941869179154668
STAT,1915,33,40-44,1948,4.004685349123967
STAT,1865,35,25-29,1900,2.6805751253386547
SIM,1857,22,25-29,1879,4
STAT,1939,32,15-19,1971,0.13236542771970441
STAT,1832,26,30-34,1858,23.386834752550314
STAT,1873,75,na,1948,1054.0760718140764
STAT,1823,42,25-29,1865,0.9526944140579559
STAT,1944,13,na,1957,4268.009816769634
STAT,1928,37,30-34,1965,2.328139547338581
STAT,1910,30,50-100,1940,0.8107726394518618
SIM,1895,65,na,1960,2299
STAT,1839,19,40-44,1858,0.1676391464719177
SIM,1914,26,25-29,1940,80
SIM,1815,40,50-100,1855,2
SIM,1836,18,20-24,1854,22
STAT,1889,28,na,1917,2961.7001741755757
SIM,1873,35,25-29,1908,2
STAT,1876,89,na,1965,259.66565213511603
STAT,1771,83,na,1854,100.0
SIM,1916,38,na,1954,3816
SIM,1844,27,45-49,1871,4
STAT,1866,46,30-34,1912,0.0907875460063794
STAT,1826,29,40-44,1855,5.436205638113084
SIM,1853,67,na,1920,1129
STAT,1912,23,45-49,1935,1.0845503111238555
SIM,1832,99,na,1931,2
SIM,1866,24,25-29,1890,77
SIM,1795,62,na,1857,909
STAT,1907,41,35-39,1948,0.18735481407300097
SIM,1840,26,30-34,1866,41
SIM,1816,75,na,1891,418
STAT,1828,54,na,1882,1439.6003617723186
STAT,1847,47,40-44,1894,0.12758617973514294
STAT,1890,33,25-29,1923,12.587675935876366
SIM,1814,46,na,1860,1366
STAT,1892,46,40-44,1938,0.12273964225046635
SIM,1808,46,na,1854,1257
SIM,1870,39,na,1909,2575
STAT,1834,54,na,1888,1263.0667938544548
SIM,1830,33,na,1863,1618
SIM,1900,20,25-29,1920,2
STAT,1898,41,15-19,1939,0.001318989023860876
STAT,1871,32,45-49,1903,1.7497934030072981
SIM,1843,35,45-49,1878,4
STAT,1837,48,25-29,1885,0.04027181879314508
STAT,1846,31,40-44,1877,3.9298173459776344
STAT,1882,47,25-29,1929,0.05609009960860084
SIM,1874,97,na,1971,30
SIM,1851,32,na,1883,2016
STAT,1829,38,25-29,1867,2.3203906510186845
STAT,1942,20,20-24,1962,117.79432766866637
SIM,1890,23,25-29,1913,83
STAT,1902,43,40-44,1945,0.22131953037154006
STAT,1844,19,15-19,1863,5.898457916294287
STAT,1894,33,50-100,1927,1.1863986779747269
STAT,1943,7,na,1950,4243.21174277875
SIM,1849,31,30-34,1880,33
SIM,1834,60,na,1894,1358
STAT,1835,32,50-100,1867,0.875854864229891
SIM,1894,30,30-34,1924,34
SIM,1777,77,na,1854,281
STAT,1886,30,30-34,1916,18.76858194003614
SIM,1823,32,25-29,1855,4
STAT,1865,54,30-34,1919,0.005338809322493677
STAT,1896,29,25-29,1925,56.14946677641759
STAT,1921,44,20-24,1965,0.020022908502437486
STAT,1862,104,na,1966,0.3642414730762451
STAT,1928,18,25-29,1946,55.04661196040898
STAT,1845,44,50-100,1889,0.7661892665139052
SIM,1880,25,20-24,1905,10
SIM,1950,20,20-24,1970,131
STAT,1906,26,25-29,1932,62.4433236135083
SIM,1847,19,40-44,1866,1
STAT,1865,32,20-24,1897,2.492912151727294
STAT,1874,28,50-100,1902,0.659234507954452
SIM,1856,78,na,1934,544
STAT,1860,41,35-39,1901,1.5018207214356902
SIM,1886,30,40-44,1916,9
STAT,1816,110,na,1926,1.4128421304704996E-4
STAT,1872,25,20-24,1897,11.993178038584793
SIM,1857,38,50-100,1895,1
STAT,1836,80,na,1916,390.03979950077536
STAT,1823,36,30-34,1859,9.685218762493575
STAT,1914,37,na,1951,3789.9367723435353
SIM,1880,44,50-100,1924,2
SIM,1831,29,25-29,1860,45
STAT,1888,34,15-19,1922,0.16831238414434085
STAT,1920,49,30-34,1969,0.09892849575339746
STAT,1836,40,45-49,1876,1.15233267517735
STAT,1836,24,40-44,1860,1.7100672999938369
STAT,1832,36,40-44,1868,3.8178311492469685
SIM,1936,18,25-29,1954,56
SIM,1913,27,na,1940,3659
SIM,1838,53,na,1891,1522
STAT,1919,18,15-19,1937,50.504945459182615
SIM,1914,8,na,1922,4367
STAT,1884,41,20-24,1925,0.158892699476763
SIM,1818,39,na,1857,1421
STAT,1819,49,na,1868,1335.5898926272168
STAT,1919,8,na,1927,4450.174840523873
STAT,1882,89,na,1971,313.29094328043743
STAT,1905,38,40-44,1943,1.3727230919145315
SIM,1862,72,na,1934,1083
SIM,1877,30,30-34,1907,25
SIM,1829,76,na,1905,586
STAT,1863,82,na,1945,417.53984257782747
STAT,1934,15,45-49,1949,0.6858975943301805
STAT,1874,54,40-44,1928,0.010588184118329812
SIM,1904,26,30-34,1930,60
STAT,1878,42,40-44,1920,2.3553605792379395
STAT,1865,42,30-34,1907,1.0589830400602915
SIM,1939,32,na,1971,3935
STAT,1896,72,na,1968,2046.1961131494306
STAT,1832,90,na,1922,53.684448878134326
STAT,1862,38,na,1900,2044.7386618819364
STAT,1880,53,20-24,1933,7.701514482983605E-4
SIM,1927,18,15-19,1945,65
SIM,1794,83,na,1877,233
STAT,1875,19,45-49,1894,0.06739029547296481
SIM,1868,29,20-24,1897,2
STAT,1810,52,25-29,1862,0.01297894087837826
STAT,1874,47,35-39,1921,0.14411154079883629
SIM,1844,40,45-49,1884,2
SIM,1831,36,30-34,1867,6
STAT,1852,42,na,1894,1750.6676067161138
STAT,1929,19,50-100,1948,0.48068337343123535
SIM,1940,29,na,1969,3986
STAT,1825,43,na,1868,1969.4284565965902
STAT,1888,43,na,1931,2735.3525648420377
STAT,1911,37,20-24,1948,0.25687318388450425
STAT,1924,41,35-39,1965,0.24238477858028912
STAT,1846,28,15-19,1874,0.4135368959370987
STAT,1940,26,25-29,1966,67.79047176102064
STAT,1947,24,20-24,1971,126.85397816502947
STAT,1919,25,20-24,1944,20.049188054890678
SIM,1921,22,na,1943,3950
STAT,1869,70,na,1939,1377.7606272771527
STAT,1900,37,45-49,1937,0.603682857841154
STAT,1881,27,20-24,1908,11.421335740282952
SIM,1849,90,na,1939,30
SIM,1831,80,na,1911,394
STAT,1832,48,40-44,1880,0.1364741308738642
SIM,1876,92,na,1968,153
SIM,1949,18,35-39,1967,6
STAT,1915,41,25-29,1956,0.07264851992720676
SIM,1874,19,35-39,1893,2
STAT,1866,19,35-39,1885,0.5205414226920972
STAT,1806,50,45-49,1856,0.04358937608223763
STAT,1813,58,na,1871,1111.5336850320414
SIM,1829,25,50-100,1854,1
SIM,1913,30,45-49,1943,3
STAT,1873,41,45-49,1914,1.5393580569341498
STAT,1890,27,30-34,1917,31.078514251944455
STAT,1959,12,na,1971,5189.770506874125
STAT,1865,47,25-29,1912,0.05287428804638199
SIM,1842,58,na,1900,1366
SIM,1840,36,40-44,1876,9
SIM,1853,9,na,1862,2187
SIM,1884,26,35-39,1910,10
SIM,1878,36,20-24,1914,3
STAT,1883,40,25-29,1923,0.6410938512946815
STAT,1859,23,30-34,1882,14.904859154147145
STAT,1861,25,45-49,1886,0.9522506924509297
STAT,1888,48,40-44,1936,0.11367695495891604
SIM,1829,79,na,1908,411
STAT,1931,28,40-44,1959,6.078774655163152
STAT,1858,51,20-24,1909,5.875150714160827E-4
SIM,1887,30,na,1917,2594
STAT,1847,40,20-24,1887,0.122675826981378
STAT,1907,52,na,1959,3249.287184252476
STAT,1847,45,15-19,1892,3.024803914151008E-4
STAT,1860,53,35-39,1913,0.006993743457302556
STAT,1891,44,30-34,1935,1.4182296777633412
STAT,1819,41,50-100,1860,2.345410118127023
SIM,1886,42,40-44,1928,3
SIM,1794,86,na,1880,147
SIM,1845,41,40-44,1886,3
SIM,1927,25,20-24,1952,36
STAT,1910,31,30-34,1941,15.389291808469002
SIM,1849,18,30-34,1867,1
STAT,1824,53,30-34,1877,0.0065823426632378905
SIM,1807,61,na,1868,941
STAT,1865,52,50-100,1917,0.013854452288117228
SIM,1848,29,35-39,1877,11
SIM,1918,31,40-44,1949,2
SIM,1850,53,na,1903,1805
STAT,1817,50,20-24,1867,0.0015814215740045314
STAT,1852,45,na,1897,1723.2718164301264
STAT,1836,45,50-100,1881,0.16635152740517478
STAT,1888,41,20-24,1929,0.19017951164250296
SIM,1832,41,30-34,1873,1
SIM,1845,38,na,1883,1969
SIM,1958,6,na,1964,5244
STAT,1878,30,40-44,1908,4.583399344657585
STAT,1897,46,25-29,1943,0.04411990065507627
SIM,1874,3,na,1877,2881
SIM,1900,30,35-39,1930,31
STAT,1891,32,30-34,1923,21.832995822085625
STAT,1847,33,15-19,1880,0.12389915313250316
STAT,1941,6,na,1947,4143.975091215575
STAT,1890,42,50-100,1932,1.3022263066684285
STAT,1849,56,na,1905,1594.693757331541
SIM,1887,33,na,1920,2626
SIM,1914,43,40-44,1957,1
STAT,1877,41,45-49,1918,1.567191852075272
STAT,1824,95,na,1919,6.609887761146622
SIM,1925,12,na,1937,4859
SIM,1913,24,15-19,1937,10
STAT,1923,36,35-39,1959,2.8342667142499587
STAT,1942,30,30-34,1972,16.96420093460321
SIM,1849,93,na,1942,7
STAT,1841,53,50-100,1894,0.011112717543273346
SIM,1848,17,35-39,1865,3
SIM,1834,23,35-39,1857,7
STAT,1870,30,na,1900,2385.7392367101493
SIM,1931,36,35-39,1967,2
STAT,1885,34,50-100,1919,0.9132498192605322
SIM,1867,36,45-49,1903,3
STAT,1840,57,na,1897,1408.726524525795
STAT,1865,18,na,1883,2386.1177530446657
STAT,1905,24,15-19,1929,4.786739177621545
SIM,1898,27,40-44,1925,6
STAT,1840,26,20-24,1866,10.32778536994455
STAT,1882,20,20-24,1902,67.82263904610777
STAT,1915,48,45-49,1963,0.22037236169980054
SIM,1885,25,40-44,1910,3
STAT,1850,52,50-100,1902,0.011502820795114992
SIM,1872,37,30-34,1909,9
SIM,1914,36,35-39,1950,10
STAT,1827,46,50-100,1873,0.25527346048806465
SIM,1805,66,na,1871,768
STAT,1926,25,na,1951,4569.4426635895925
STAT,1937,23,15-19,1960,5.2314841394049125
STAT,1863,34,45-49,1897,1.5471680127650096
STAT,1882,25,15-19,1907,0.44689019516848855
STAT,1801,54,40-44,1855,0.03815276492581424
STAT,1856,49,40-44,1905,0.12980015895764285
STAT,1839,23,50-100,1862,0.36880787389948
SIM,1830,30,40-44,1860,3
SIM,1826,65,na,1891,1290
SIM,1880,21,40-44,1901,2
STAT,1850,43,30-34,1893,0.8739576368858248
STAT,1837,106,na,1943,0.008282812874087098
STAT,1906,48,35-39,1954,0.11471573370292253
STAT,1856,53,50-100,1909,0.011506985691712667
SIM,1881,37,40-44,1918,6
STAT,1841,41,30-34,1882,0.904895345311176
STAT,1863,85,na,1948,245.32009647557928
STAT,1903,15,50-100,1918,0.07079798456852304
SIM,1929,34,20-24,1963,3
STAT,1921,19,na,1940,4214.720598885942
STAT,1870,64,na,1934,1724.0834349080094
STAT,1883,52,25-29,1935,0.003482187319953182
STAT,1815,41,20-24,1856,0.4284451734412479
SIM,1869,11,na,1880,2502
SIM,1859,41,35-39,1900,2
SIM,1944,24,45-49,1968,1
STAT,1873,49,40-44,1922,0.17163332738240963
STAT,1947,24,na,1971,4166.072459806874
STAT,1864,37,30-34,1901,4.857308839833788
SIM,1891,40,25-29,1931,1
STAT,1896,26,20-24,1922,15.737849404796568
SIM,1838,50,na,1888,1596
STAT,1906,46,45-49,1952,0.19639469287731018
STAT,1929,35,25-29,1964,1.2798656756181461
STAT,1836,83,na,1919,250.30982297275858
STAT,1877,25,40-44,1902,3.1438307163173063
STAT,1931,20,45-49,1951,1.4836645910787944
STAT,1811,46,15-19,1857,0.001012915055088989
STAT,1876,55,na,1931,2156.300499084041
STAT,1828,32,35-39,1860,11.87390156945804
STAT,1819,43,na,1862,1426.454592111573
STAT,1828,40,50-100,1868,1.0437201031121397
SIM,1840,22,15-19,1862,2
STAT,1905,30,45-49,1935,2.5666151616149593
STAT,1855,56,na,1911,1535.2750370337503
STAT,1830,95,na,1925,8.771596070592821
STAT,1914,21,50-100,1935,0.6528202825315981
SIM,1903,20,40-44,1923,3
STAT,1841,31,20-24,1872,2.4781445957209507
STAT,1894,77,na,1971,1597.3162913184935
STAT,1925,42,30-34,1967,0.15642468931486977
STAT,1900,20,15-19,1920,4.65618417913847
STAT,1832,34,15-19,1866,0.12405408518830399
STAT,1901,64,na,1965,2695.967147658513
STAT,1829,47,20-24,1876,0.008952911434251448
SIM,1945,23,15-19,1968,6
SIM,1857,26,na,1883,2107
STAT,1849,53,na,1902,1656.4306283048477
STAT,1896,38,20-24,1934,1.0254526222252704
SIM,1875,36,50-100,1911,3
SIM,1832,65,na,1897,1029
STAT,1879,50,45-49,1929,0.015515892955632847
STAT,1882,39,40-44,1921,4.23961556013427
STAT,1923,20,50-100,1943,0.7781755284096064
SIM,1930,19,35-39,1949,6
STAT,1832,22,15-19,1854,5.049950393871602
STAT,1859,8,na,1867,2315.5563387035595
STAT,1850,31,30-34,1881,14.131445360890405
SIM,1940,26,na,1966,3942
STAT,1837,44,45-49,1881,1.0686502253255057
STAT,1799,86,na,1885,74.04661713266668
STAT,1829,35,20-24,1864,0.6523719590862306
SIM,1890,32,20-24,1922,3
SIM,1857,26,40-44,1883,5
STAT,1867,18,40-44,1885,0.17681358276227782
SIM,1869,42,40-44,1911,8
STAT,1855,37,20-24,1892,0.5802340247809538
STAT,1932,36,45-49,1968,0.926491262757084
STAT,1922,19,35-39,1941,4.8796285975337765
STAT,1916,40,30-34,1956,0.1325813327711434
SIM,1930,30,45-49,1960,4
SIM,1818,36,na,1854,1521
STAT,1832,40,45-49,1872,1.2831604370305922
STAT,1914,21,20-24,1935,110.32008785286955
STAT,1826,28,na,1854,1494.1957795457715
STAT,1826,90,na,1916,43.26142612915744
SIM,1826,47,50-100,1873,3
STAT,1874,40,15-19,1914,0.014426092399117879
SIM,1913,38,40-44,1951,4
SIM,1839,17,25-29,1856,6
STAT,1832,54,50-100,1886,0.010312145960836504
STAT,1821,50,na,1871,1498.7815243082637
SIM,1922,21,20-24,1943,168
STAT,1882,32,20-24,1914,2.6445309444775282
STAT,1845,23,50-100,1868,0.36725057753752743
STAT,1862,30,45-49,1892,1.5332231120286874
STAT,1876,35,50-100,1911,1.2925024474253333
SIM,1881,48,na,1929,1982
STAT,1936,24,45-49,1960,1.0852748757956552
STAT,1768,94,na,1862,7.049211993521072
SIM,1906,48,na,1954,3127
SIM,1897,49,50-100,1946,1
STAT,1877,31,35-39,1908,10.599831072245998
STAT,1873,37,40-44,1910,4.482167019738824
STAT,1901,42,45-49,1943,0.14696856463394728
STAT,1911,49,20-24,1960,0.010493144564047222
STAT,1945,15,20-24,1960,149.64467050732873
SIM,1928,23,15-19,1951,10
SIM,1898,6,na,1904,3551
SIM,1849,34,35-39,1883,15
SIM,1890,20,20-24,1910,101
SIM,1828,91,na,1919,12
STAT,1841,24,15-19,1865,3.0805536736267163
STAT,1877,21,25-29,1898,59.854321966613284
STAT,1815,48,40-44,1863,0.37357285287736086
SIM,1880,18,15-19,1898,8
STAT,1941,31,25-29,1972,9.802814999925028
SIM,1863,20,na,1883,2216
SIM,1890,39,40-44,1929,4
STAT,1831,43,na,1874,1589.9638691269988
STAT,1846,42,na,1888,1775.1985618678636
STAT,1872,18,15-19,1890,6.010278513798523
STAT,1769,113,na,1882,3.95293465346749E-4
STAT,1922,30,45-49,1952,1.810574403274644
SIM,1850,87,na,1937,155
SIM,1894,18,na,1912,3611
STAT,1846,35,20-24,1881,0.623708521438763
SIM,1840,40,45-49,1880,1
STAT,1884,84,na,1968,637.4021917515287
STAT,1842,51,25-29,1893,0.0032042553890960987
STAT,1888,46,15-19,1934,4.781981208335041E-4
STAT,1886,48,na,1934,2369.068239695916
SIM,1801,73,na,1874,312
SIM,1953,15,20-24,1968,173
SIM,1848,19,25-29,1867,9
STAT,1789,93,na,1882,8.601095632882272
STAT,1863,16,15-19,1879,6.095992083761973
SIM,1935,2,na,1937,5556
STAT,1848,22,50-100,1870,0.4053933128637295
STAT,1818,64,na,1882,983.6411225151134
STAT,1937,27,30-34,1964,38.559383725558035
SIM,1918,33,na,1951,4126
SIM,1827,28,20-24,1855,10
SIM,1840,38,30-34,1878,5
STAT,1852,52,30-34,1904,0.004490333313961827
SIM,1835,79,na,1914,360
SIM,1871,16,15-19,1887,9
SIM,1839,38,na,1877,1675
STAT,1854,22,50-100,1876,0.35958768015643744
STAT,1830,98,na,1928,2.1431919765173997
STAT,1861,15,35-39,1876,0.5356061158238116
SIM,1936,15,20-24,1951,171
STAT,1825,51,25-29,1876,0.004675340430196812
STAT,1880,23,na,1903,2500.8802103395765
SIM,1953,18,25-29,1971,81
SIM,1814,40,na,1854,1448
STAT,1900,34,40-44,1934,6.032368888956452
SIM,1836,24,na,1860,2060
STAT,1834,57,na,1891,1196.1896675202368
STAT,1945,18,25-29,1963,47.791613348065034
STAT,1849,19,35-39,1868,0.521874587346657
STAT,1913,52,na,1965,3557.0553343862593
STAT,1872,96,na,1968,40.14099412650464
STAT,1886,31,45-49,1917,1.8671992797933938
STAT,1810,50,35-39,1860,0.03284589074860314
STAT,1815,50,na,1865,1266.7643595391492
SIM,1855,93,na,1948,19
STAT,1906,23,20-24,1929,101.06415340138719
STAT,1856,45,25-29,1901,0.045047010327841946
STAT,1941,0,na,1941,4657.902392670017
STAT,1925,28,50-100,1953,1.1839201697486437
STAT,1819,40,45-49,1859,3.430440502402098
STAT,1895,30,40-44,1925,5.765948161570225
STAT,1870,15,45-49,1885,0.0661805560473012
STAT,1846,15,50-100,1861,0.04725965837961242
SIM,1831,26,20-24,1857,14
STAT,1847,43,25-29,1890,0.477333508325746
SIM,1921,19,25-29,1940,52
STAT,1892,42,25-29,1934,0.8128544693349485
SIM,1908,17,35-39,1925,1
STAT,1899,19,30-34,1918,2.197496827606282
STAT,1875,16,40-44,1891,0.19017618203793257
STAT,1834,50,20-24,1884,4.6881313657240497E-4
SIM,1844,30,35-39,1874,9
STAT,1823,39,35-39,1862,11.256026384723834
SIM,1849,28,40-44,1877,8
STAT,1845,97,na,1942,3.925422462967635
STAT,1848,54,30-34,1902,0.004726362269106171
SIM,1840,54,50-100,1894,1
SIM,1914,23,20-24,1937,123
SIM,1882,44,30-34,1926,5
STAT,1923,26,25-29,1949,76.6159984538415
SIM,1861,24,40-44,1885,2
STAT,1832,38,30-34,1870,4.550354664298448
SIM,1824,39,na,1863,1541
STAT,1844,25,45-49,1869,1.0909866678074949
STAT,1867,41,na,1908,2208.449632166817
STAT,1883,42,15-19,1925,0.013632435259156118
SIM,1835,19,15-19,1854,7
SIM,1888,18,na,1906,3083
SIM,1918,16,15-19,1934,11
STAT,1869,40,40-44,1909,2.230982041820414
STAT,1874,51,50-100,1925,0.015693837835571923
STAT,1838,43,15-19,1881,0.009713140836641154
STAT,1874,44,30-34,1918,1.1729259917631385
SIM,1893,33,na,1926,3083
STAT,1941,25,30-34,1966,40.95765311336905
STAT,1853,24,40-44,1877,2.006971921408576
STAT,1803,103,na,1906,0.059826204108110764
STAT,1888,44,25-29,1932,0.7551897794572948
STAT,1858,18,30-34,1876,1.4666164236158674
STAT,1913,19,25-29,1932,8.89173012581196
SIM,1890,59,na,1949,2626
STAT,1836,30,35-39,1866,8.244729656149165
STAT,1875,51,20-24,1926,7.690449569664521E-4
STAT,1850,36,25-29,1886,2.2629288262301377
SIM,1923,35,30-34,1958,2
SIM,1873,32,20-24,1905,4
STAT,1908,37,na,1945,3555.7464925020936
STAT,1895,22,na,1917,3119.4124902747794
STAT,1868,38,45-49,1906,1.9147500213708082
STAT,1905,23,na,1928,3442.5290441629513
SIM,1894,31,45-49,1925,7
STAT,1842,45,30-34,1887,0.08942934415485868
SIM,1873,29,50-100,1902,1
SIM,1903,34,na,1937,3172
STAT,1915,35,30-34,1950,1.8754825152164383
STAT,1818,61,na,1879,1100.0609562185268
STAT,1842,41,15-19,1883,0.013029640261422141
STAT,1932,38,35-39,1970,3.2808968262218454
STAT,1840,29,25-29,1869,36.44365856376362
STAT,1938,10,na,1948,3957.759071230015
STAT,1837,26,15-19,1863,0.40014518264545684
SIM,1876,38,45-49,1914,4
SIM,1854,46,na,1900,2089
SIM,1900,20,na,1920,3702
STAT,1890,17,20-24,1907,21.87985900972454
STAT,1780,111,na,1891,6.919501207868016E-4
STAT,1883,27,50-100,1910,0.6322536195502912
STAT,1864,33,15-19,1897,0.12924081999983497
STAT,1891,47,35-39,1938,0.09829194904041692
STAT,1837,68,na,1905,1042.5051576558521
STAT,1911,47,30-34,1958,0.08514375881298297
SIM,1887,38,20-24,1925,1
SIM,1855,90,na,1945,82
SIM,1937,32,20-24,1969,2
STAT,1946,25,15-19,1971,0.7949410657168181
STAT,1811,51,30-34,1862,0.014464034677549049
STAT,1861,49,15-19,1910,3.287023588296822E-4
STAT,1872,20,50-100,1892,0.4165495290942651
STAT,1799,89,na,1888,39.24947422795899
SIM,1827,40,45-49,1867,2
STAT,1834,38,50-100,1872,0.9000932385097391
STAT,1897,43,20-24,1940,0.014825097940339703
SIM,1847,64,na,1911,1246
SIM,1881,39,30-34,1920,10
STAT,1842,83,na,1925,357.4211826467415
STAT,1857,82,na,1939,367.780955185996
SIM,1933,28,50-100,1961,2
STAT,1942,8,na,1950,4177.834724825138
STAT,1901,44,35-39,1945,0.17563609663267113
STAT,1929,32,20-24,1961,3.131562893631116
STAT,1806,48,30-34,1854,0.28755867890665376
SIM,1874,60,na,1934,1773
SIM,1913,28,30-34,1941,40
STAT,1875,70,na,1945,1455.2931001412317
STAT,1905,28,30-34,1933,36.638582831007795
STAT,1911,43,15-19,1954,0.0014698647421823973
STAT,1866,52,25-29,1918,0.003294971122020586
SIM,1859,31,25-29,1890,9
SIM,1881,23,15-19,1904,3
STAT,1868,29,na,1897,2287.224203702759
SIM,1918,34,45-49,1952,4
STAT,1873,39,30-34,1912,5.402083358247326
SIM,1841,43,30-34,1884,2
SIM,1904,29,35-39,1933,20
STAT,1907,40,20-24,1947,0.016522538872753987
SIM,1869,45,na,1914,2218
STAT,1867,24,35-39,1891,5.516087375321733
STAT,1878,45,45-49,1923,0.24990215026623083
STAT,1806,76,na,1882,381.99753105247856
SIM,1835,37,45-49,1872,3
STAT,1835,19,40-44,1854,0.3920613107875231
STAT,1850,46,35-39,1896,0.10750429485651501
SIM,1906,45,na,1951,3168
SIM,1830,33,45-49,1863,1
SIM,1898,3,na,1901,3597
STAT,1890,19,50-100,1909,0.060139602345958415
STAT,1832,32,25-29,1864,9.11672945189115
STAT,1836,20,25-29,1856,55.3028818916164
STAT,1931,18,30-34,1949,16.081588580673554
SIM,1923,45,40-44,1968,1
STAT,1859,33,40-44,1892,3.5080025866513074
STAT,1894,28,45-49,1922,1.438684360482457
SIM,1925,15,na,1940,4516
STAT,1805,91,na,1896,23.003894731162863
STAT,1902,12,na,1914,3685.9121168117344
SIM,1858,21,30-34,1879,33
SIM,1866,37,50-100,1903,1
SIM,1854,38,25-29,1892,5
STAT,1824,41,30-34,1865,1.4584434305022904
STAT,1793,61,na,1854,900.9999999999999
STAT,1824,46,25-29,1870,0.06833400681837663
STAT,1938,34,20-24,1972,2.472776793401419
STAT,1920,45,15-19,1965,4.131407010665561E-4
SIM,1884,59,na,1943,2022
STAT,1941,21,15-19,1962,5.55569832445379
SIM,1909,59,na,1968,3538
STAT,1861,111,na,1972,0.0014639586373968272
STAT,1906,43,40-44,1949,0.22811815550559292
STAT,1933,30,20-24,1963,3.3254063310831765
STAT,1887,29,15-19,1916,0.5079592163737366
STAT,1857,50,25-29,1907,0.0028320933805049994
SIM,1881,45,na,1926,1998
STAT,1871,22,35-39,1893,5.855461969120296
STAT,1841,34,25-29,1875,9.102334101247514
STAT,1879,0,na,1879,3825.0677536782155
SIM,1877,43,45-49,1920,3
SIM,1826,35,45-49,1861,1
SIM,1849,24,25-29,1873,81
STAT,1841,44,35-39,1885,1.3715367056427288
STAT,1781,76,na,1857,206.18589206111312
STAT,1891,37,25-29,1928,3.6003732769768066
SIM,1875,45,na,1920,2263
SIM,1914,33,30-34,1947,6
STAT,1847,100,na,1947,0.7948929513603074
STAT,1943,26,50-100,1969,1.0708432592349189
SIM,1941,30,20-24,1971,3
STAT,1922,16,30-34,1938,14.285582143776637
STAT,1838,47,30-34,1885,0.06666644644644892
STAT,1845,18,20-24,1863,16.276277853315126
STAT,1880,22,45-49,1902,0.739656312085088
SIM,1838,24,50-100,1862,1
SIM,1870,20,35-39,1890,10
SIM,1896,44,na,1940,3031
STAT,1858,30,na,1888,1930.5602262058076
SIM,1840,32,25-29,1872,13
STAT,1844,16,na,1860,2322.275222215325
SIM,1880,60,na,1940,1738
STAT,1856,42,20-24,1898,0.1228248730639243
STAT,1858,67,na,1925,1256.105341138226
STAT,1796,75,na,1871,397.3029941563927
STAT,1917,11,na,1928,4296.177099248131
SIM,1820,40,na,1860,1514
SIM,1946,14,na,1960,4456
SIM,1860,46,na,1906,2008
SIM,1910,16,na,1926,3666
STAT,1909,37,50-100,1946,0.4010229917528407
STAT,1915,45,40-44,1960,0.1610635043020852
STAT,1803,62,na,1865,1122.9784753517843
STAT,1812,76,na,1888,428.7757100005042
STAT,1837,41,40-44,1878,1.8340520126693913
SIM,1852,25,45-49,1877,1
STAT,1881,6,na,1887,2586.6362734749055
STAT,1878,27,15-19,1905,0.47568659302932637
STAT,1887,39,25-29,1926,3.2140382870090507
STAT,1936,21,40-44,1957,3.2464090113791415
SIM,1930,16,30-34,1946,21
SIM,1853,18,20-24,1871,20
STAT,1906,33,30-34,1939,14.686119099536299
SIM,1944,21,40-44,1965,4
STAT,1895,20,30-34,1915,23.633926151202758
STAT,1865,15,na,1880,2425.760456929291
SIM,1927,28,25-29,1955,89
STAT,1877,37,na,1914,2455.925539395641
STAT,1822,33,45-49,1855,4.531971133131653
STAT,1905,22,50-100,1927,0.5954133899051284
SIM,1868,41,45-49,1909,2
SIM,1905,36,25-29,1941,1
STAT,1862,20,35-39,1882,5.286031211836887
SIM,1867,23,30-34,1890,24
STAT,1807,53,30-34,1860,0.019797073249475113
STAT,1879,48,30-34,1927,0.10074520786238943
SIM,1952,14,na,1966,4779
STAT,1882,35,25-29,1917,2.843607570785459
SIM,1823,54,na,1877,1289
STAT,1919,28,25-29,1947,71.55370771658495
STAT,1914,24,25-29,1938,94.61755881793724
SIM,1928,39,30-34,1967,1
STAT,1858,6,na,1864,2309.1823906930886
STAT,1934,27,50-100,1961,1.3529530350376209
SIM,1926,36,50-100,1962,3
SIM,1934,29,na,1963,5141
SIM,1936,4,na,1940,3989
SIM,1833,39,50-100,1872,1
STAT,1924,47,40-44,1971,0.18967230778846686
SIM,1893,26,45-49,1919,3
STAT,1898,36,na,1934,3241.3506668369355
SIM,1825,80,na,1905,307
STAT,1900,37,50-100,1937,0.37179443335909984
SIM,1931,26,25-29,1957,5
SIM,1931,15,na,1946,4755
STAT,1918,36,50-100,1954,0.4489227849722223
SIM,1844,53,na,1897,1400
SIM,1844,20,25-29,1864,58
STAT,1827,37,45-49,1864,2.3188371879691814
SIM,1871,34,45-49,1905,2
STAT,1866,96,na,1962,20.39070588923399
SIM,1903,23,45-49,1926,1
SIM,1949,15,30-34,1964,30
STAT,1846,38,25-29,1884,2.2581617800296545
SIM,1919,37,30-34,1956,7
STAT,1864,30,na,1894,2192.335067652211
STAT,1873,33,25-29,1906,10.44324333477676
SIM,1773,84,na,1857,91
SIM,1883,74,na,1957,1306
STAT,1850,29,50-100,1879,0.568174066490998
STAT,1885,26,45-49,1911,1.1200602209149633
SIM,1788,83,na,1871,156
STAT,1843,31,na,1874,1775.6369719260492
STAT,1859,15,na,1874,2190.2152735809136
STAT,1833,53,40-44,1886,0.007553389895881929
STAT,1863,31,40-44,1894,3.8967429630618895
SIM,1878,59,na,1937,2248
STAT,1837,103,na,1940,0.09790301624991986
STAT,1901,67,na,1968,2557.9247073084202
SIM,1894,19,20-24,1913,35
STAT,1860,43,25-29,1903,0.5263519852947138
STAT,1838,16,na,1854,2041.741685563137
STAT,1849,29,45-49,1878,1.0143196284877194
STAT,1825,39,50-100,1864,1.8686012869365147
STAT,1917,15,45-49,1932,0.10901058811001099
SIM,1899,58,na,1957,2918
SIM,1857,29,45-49,1886,1
STAT,1883,37,na,1920,2328.5802975867177
SIM,1922,24,25-29,1946,192
SIM,1904,16,20-24,1920,36
STAT,1863,21,50-100,1884,0.37489179780379334
STAT,1910,41,40-44,1951,0.2398683424696388
SIM,1890,35,25-29,1925,4
STAT,1896,40,35-39,1936,0.1698096516027073
SIM,1808,49,50-100,1857,5
STAT,1851,97,na,1948,4.067796281132405
STAT,1815,44,25-29,1859,1.5025116204370328
STAT,1886,19,20-24,1905,18.80419502732629
SIM,1900,32,25-29,1932,17
STAT,1932,33,40-44,1965,5.2539823355780415
SIM,1870,46,na,1916,2484
STAT,1953,16,20-24,1969,165.7465664062776
STAT,1928,42,15-19,1970,0.0019787856618330704
SIM,1952,18,20-24,1970,160
SIM,1882,79,na,1961,675
STAT,1950,15,40-44,1965,1.6718020103888058
STAT,1837,23,35-39,1860,5.174089202229877
SIM,1838,33,45-49,1871,1
STAT,1900,33,30-34,1933,24.39280438394753
SIM,1905,23,30-34,1928,42
SIM,1823,68,na,1891,893
SIM,1873,40,50-100,1913,3
SIM,1903,15,20-24,1918,24
STAT,1932,39,35-39,1971,3.2772222217764777
SIM,1937,29,35-39,1966,1
STAT,1920,32,45-49,1952,1.7405561626906976
SIM,1914,29,40-44,1943,8
STAT,1803,71,na,1874,757.9851470663311
STAT,1839,31,45-49,1870,1.5373181433291407
STAT,1906,29,40-44,1935,4.37528836508463
STAT,1897,24,45-49,1921,0.9383034661918683
STAT,1883,76,na,1959,1070.262253402247
SIM,1901,43,40-44,1944,2
STAT,1824,65,na,1889,845.7911914813825
SIM,1855,30,40-44,1885,4
STAT,1932,19,na,1951,4899.020307194994
STAT,1894,28,na,1922,3092.3570259718144
STAT,1921,25,15-19,1946,0.8000292937616885
STAT,1807,85,na,1892,97.10667918431598
STAT,1890,14,na,1904,3176.913319663362
STAT,1898,17,15-19,1915,8.125638955417324
STAT,1902,41,40-44,1943,0.22393863150898918
SIM,1834,35,50-100,1869,4
SIM,1885,12,na,1897,2800
SIM,1885,47,50-100,1932,1
SIM,1919,38,30-34,1957,5
STAT,1915,27,40-44,1942,4.797206518839247
STAT,1918,28,20-24,1946,19.543125548009506
STAT,1932,31,25-29,1963,12.423938193553917
SIM,1845,23,35-39,1868,12
STAT,1942,19,50-100,1961,0.395047503929906
STAT,1888,31,40-44,1919,5.19097767870715
SIM,1922,35,25-29,1957,4
STAT,1906,21,30-34,1927,26.282822997713637
STAT,1930,23,15-19,1953,6.871189171166196
STAT,1940,30,20-24,1970,2.5514343152730845
SIM,1876,22,25-29,1898,70
STAT,1831,48,40-44,1879,0.1262474635588791
SIM,1862,20,30-34,1882,21
STAT,1854,63,na,1917,1339.0963618077685
STAT,1933,18,45-49,1951,0.6739686304382873
STAT,1858,77,na,1935,684.9327392483918
STAT,1877,20,25-29,1897,60.03021048332945
STAT,1925,41,35-39,1966,0.2467359292531751
STAT,1941,17,40-44,1958,1.4545222262601356
SIM,1888,34,50-100,1922,2
STAT,1923,33,25-29,1956,10.699213855477035
SIM,1907,31,40-44,1938,7
STAT,1854,20,30-34,1874,15.934790277490892
SIM,1861,85,na,1946,174
SIM,1843,15,25-29,1858,13
SIM,1829,40,40-44,1869,3
STAT,1816,46,na,1862,1541.8454174837373
SIM,1931,33,25-29,1964,20
STAT,1845,27,na,1872,1923.9592908775717
STAT,1781,104,na,1885,0.019393038060280834
SIM,1849,33,20-24,1882,2
SIM,1787,68,na,1855,721
SIM,1896,31,40-44,1927,7
STAT,1914,35,25-29,1949,1.0012863673478714
STAT,1865,21,45-49,1886,0.6556339923223916
STAT,1922,17,30-34,1939,14.250582467524382
SIM,1783,86,na,1869,109
SIM,1914,21,30-34,1935,52
STAT,1919,44,15-19,1963,0.0016747073539475326
STAT,1847,30,40-44,1877,3.8924653990346783
STAT,1947,25,35-39,1972,17.17185914810235
STAT,1824,110,na,1934,1.373817058688075E-4
STAT,1860,16,na,1876,2198.6981556470546
STAT,1896,19,na,1915,3358.428710131931
STAT,1912,27,15-19,1939,0.7018768747276405
STAT,1931,32,20-24,1963,3.230139237542046
SIM,1936,21,na,1957,3602
STAT,1909,17,15-19,1926,8.980806996035795
SIM,1865,16,15-19,1881,8
STAT,1796,84,na,1880,106.10616993797157
STAT,1846,21,35-39,1867,5.5036209275969075
SIM,1928,34,na,1962,4864
STAT,1929,34,30-34,1963,20.20144537077132
SIM,1924,20,na,1944,4673
SIM,1920,27,15-19,1947,4
STAT,1924,25,40-44,1949,5.521250921480656
STAT,1841,45,na,1886,1733.956463532235
SIM,1899,32,20-24,1931,5
SIM,1836,86,na,1922,134
SIM,1887,20,35-39,1907,10
SIM,1854,21,35-39,1875,8
STAT,1786,74,na,1860,458.0290880999454
SIM,1907,26,45-49,1933,3
STAT,1858,20,15-19,1878,3.042852299430367
SIM,1930,17,30-34,1947,25
STAT,1944,18,20-24,1962,147.2833093588762
SIM,1832,72,na,1904,854
SIM,1840,91,na,1931,32
STAT,1903,40,45-49,1943,0.15100239926793596
STAT,1870,26,na,1896,2375.04835440805
SIM,1910,36,45-49,1946,3
STAT,1873,66,na,1939,1678.1981718366521
SIM,1907,40,na,1947,3709
SIM,1953,17,25-29,1970,63
SIM,1802,74,na,1876,452
STAT,1915,47,35-39,1962,0.13109380807875884
SIM,1870,48,50-100,1918,1
STAT,1835,20,20-24,1855,108.70222680577179
STAT,1914,40,20-24,1954,0.017779368878443107
SIM,1820,47,50-100,1867,1
SIM,1910,41,40-44,1951,1
STAT,1857,16,15-19,1873,5.530692333373777
STAT,1875,57,na,1932,2084.4244137773844
STAT,1930,36,20-24,1966,0.34784740710096035
STAT,1794,93,na,1887,7.278425268486173
SIM,1937,34,30-34,1971,20
STAT,1850,52,35-39,1902,0.006556982557841794
SIM,1808,79,na,1887,243
STAT,1860,39,20-24,1899,0.6300278949179237
STAT,1913,39,25-29,1952,0.9705140564202737
SIM,1848,24,15-19,1872,3
SIM,1804,65,na,1869,993
SIM,1899,27,25-29,1926,78
STAT,1929,29,35-39,1958,18.97295120624566
STAT,1945,17,25-29,1962,47.80691155976416
STAT,1946,26,30-34,1972,44.10316638696603
SIM,1917,17,15-19,1934,12
STAT,1900,20,25-29,1920,80.79544400965548
STAT,1902,36,45-49,1938,0.6170723692467898
SIM,1884,16,25-29,1900,18
STAT,1887,58,na,1945,2230.029785892797
STAT,1883,44,na,1927,2253.5285127174316
STAT,1872,49,40-44,1921,0.17021040788330027
SIM,1856,31,na,1887,2194
STAT,1873,20,40-44,1893,2.1463622726761176
SIM,1888,32,45-49,1920,2
SIM,1849,34,50-100,1883,5
STAT,1855,49,40-44,1904,0.12617518854779136
STAT,1891,63,na,1954,2231.23354685125
SIM,1823,36,na,1859,1643
SIM,1870,78,na,1948,799
STAT,1879,39,na,1918,2458.2072201828346
STAT,1895,77,na,1972,1635.8254039342753
STAT,1933,23,40-44,1956,4.505409472645626
STAT,1931,23,50-100,1954,0.8598289078159158
STAT,1800,104,na,1904,0.02339742462752529
STAT,1916,23,40-44,1939,3.5446081490653225
STAT,1938,32,30-34,1970,15.992894160026928
SIM,1875,23,20-24,1898,72
STAT,1920,29,15-19,1949,0.7764397865252852
STAT,1903,29,15-19,1932,0.6479474116957368
SIM,1935,26,20-24,1961,31
STAT,1919,27,25-29,1946,71.8064664785896
STAT,1859,24,25-29,1883,47.557717617141
SIM,1871,95,na,1966,26
STAT,1910,30,35-39,1940,8.96129646902604
SIM,1811,67,na,1878,923
STAT,1914,18,35-39,1932,0.873474611815309
STAT,1832,52,na,1884,1516.4616031093951
STAT,1865,47,na,1912,2065.255732642123
SIM,1862,59,na,1921,1768
SIM,1919,41,na,1960,3973
STAT,1922,34,20-24,1956,2.7705437932187813
STAT,1887,22,35-39,1909,6.5803554524194245
STAT,1903,38,na,1941,3398.6680457253974
SIM,1915,25,40-44,1940,6
SIM,1843,20,20-24,1863,69
SIM,1924,23,40-44,1947,8
SIM,1905,18,35-39,1923,4
STAT,1803,54,15-19,1857,1.0234022057606925E-4
STAT,1910,38,45-49,1948,0.6545386332020267
SIM,1929,32,30-34,1961,31
SIM,1959,5,na,1964,5506
SIM,1890,66,na,1956,2351
STAT,1904,46,20-24,1950,0.009838970896043324
STAT,1918,48,15-19,1966,3.946556138941915E-4
SIM,1922,18,35-39,1940,5
STAT,1765,103,na,1868,0.042698795343690796
SIM,1836,30,30-34,1866,32
SIM,1886,21,30-34,1907,30
SIM,1930,34,20-24,1964,4
SIM,1932,25,40-44,1957,13
SIM,1895,22,35-39,1917,10
STAT,1858,33,20-24,1891,2.132828800832811
STAT,1875,25,na,1900,2492.137179829014
SIM,1848,12,na,1860,2221
SIM,1830,42,50-100,1872,1
STAT,1927,26,20-24,1953,22.506946706167287
STAT,1925,24,45-49,1949,1.3525981280634167
STAT,1870,45,15-19,1915,4.006700409724342E-4
SIM,1867,24,25-29,1891,59
SIM,1828,31,35-39,1859,13
SIM,1941,23,40-44,1964,4
STAT,1782,92,na,1874,11.342466092960656
STAT,1890,20,50-100,1910,0.5062817978368714
STAT,1932,19,40-44,1951,1.8616633545216041
STAT,1907,45,35-39,1952,0.11830073090756298
SIM,1940,19,40-44,1959,1
SIM,1904,0,na,1904,4160
SIM,1943,23,na,1966,3893
STAT,1906,7,na,1913,3832.7485452740466
SIM,1926,28,20-24,1954,25
STAT,1896,20,35-39,1916,7.848125677526099
STAT,1860,54,45-49,1914,0.011652341898977094
STAT,1837,83,na,1920,270.8164208249725
SIM,1900,31,30-34,1931,7
STAT,1880,52,20-24,1932,7.78552024644272E-4
SIM,1921,19,30-34,1940,13
STAT,1779,110,na,1889,0.0023524061819540087
STAT,1825,82,na,1907,340.4926876085417
STAT,1868,22,25-29,1890,55.25866641172754
STAT,1907,25,40-44,1932,4.473247325283872
STAT,1829,96,na,1925,5.063018824994525
STAT,1915,39,na,1954,3796.4016943871384
STAT,1778,87,na,1865,59.920030153862484
STAT,1864,30,40-44,1894,3.9841979755350794
STAT,1911,25,na,1936,3710.7467017525014
STAT,1828,107,na,1935,0.0030613951624217624
SIM,1824,85,na,1909,104
SIM,1902,19,20-24,1921,35
STAT,1852,29,na,1881,1890.9116357762266
STAT,1908,24,45-49,1932,1.037652785569378
STAT,1895,21,30-34,1916,23.564678747579734
SIM,1795,87,na,1882,3
SIM,1791,73,na,1864,495
SIM,1939,18,na,1957,3671
SIM,1877,28,50-100,1905,1
SIM,1927,27,25-29,1954,17
SIM,1921,23,15-19,1944,9
SIM,1901,30,35-39,1931,17
SIM,1928,31,50-100,1959,1
SIM,1816,98,na,1914,1
SIM,1878,22,35-39,1900,7
STAT,1834,49,20-24,1883,0.00738735478251686
STAT,1867,23,20-24,1890,65.34852219750458
STAT,1828,30,30-34,1858,22.04906509315481
STAT,1933,35,35-39,1968,3.3349130067122723
SIM,1925,3,na,1928,4978
STAT,1927,38,15-19,1965,0.024107698733745155
SIM,1847,31,45-49,1878,7
STAT,1817,49,20-24,1866,0.02499610455317702
STAT,1913,19,30-34,1932,2.5009592552316393
STAT,1878,0,na,1878,3816.6022330973847
STAT,1889,22,45-49,1911,0.8684402375954794
SIM,1799,69,na,1868,827
STAT,1898,10,na,1908,3546.697076753256
STAT,1820,51,na,1871,1239.158104509715
SIM,1882,47,na,1929,2025
SIM,1884,21,20-24,1905,3
STAT,1911,57,na,1968,3354.8047037094584
STAT,1938,27,35-39,1965,15.01582321896747
SIM,1840,32,50-100,1872,2
STAT,1924,45,35-39,1969,0.1558358756821856
SIM,1815,49,na,1864,1417
STAT,1914,23,30-34,1937,29.534687885909626
SIM,1897,22,45-49,1919,3
STAT,1824,33,na,1857,1436.3767563972401
SIM,1845,20,30-34,1865,23
SIM,1869,81,na,1950,518
SIM,1908,5,na,1913,3841
STAT,1937,28,30-34,1965,38.54087522136975
SIM,1874,28,na,1902,2402
SIM,1909,28,20-24,1937,20
STAT,1923,46,30-34,1969,0.10563039909705278
SIM,1901,38,45-49,1939,1
STAT,1849,22,15-19,1871,3.118513422838438
STAT,1923,5,na,1928,4770.399207187235
STAT,1828,47,na,1875,1618.5189826615374
STAT,1904,33,15-19,1937,0.11801953442547745
STAT,1806,68,na,1874,726.8260854237707
STAT,1802,54,na,1856,1099.406153067182
SIM,1931,30,20-24,1961,4
SIM,1812,52,na,1864,1209
SIM,1868,20,25-29,1888,55
SIM,1889,17,15-19,1906,8
STAT,1836,34,na,1870,1691.7241790930518
STAT,1852,15,25-29,1867,5.259560961370224
STAT,1925,17,na,1942,4493.538912974612
STAT,1938,24,30-34,1962,28.696931540505574
STAT,1928,38,30-34,1966,2.3257881263957683
SIM,1888,24,45-49,1912,1
SIM,1920,15,20-24,1935,184
STAT,1887,26,na,1913,2700.388589171713
STAT,1877,16,40-44,1893,0.1911306832304994
STAT,1787,91,na,1878,15.726455853132185
STAT,1891,31,50-100,1922,1.1504273205350481
STAT,1891,31,na,1922,2996.2245598955565
STAT,1950,18,45-49,1968,0.5965646332183263
STAT,1832,39,45-49,1871,1.6839885123194716
STAT,1895,45,na,1940,2997.5990890107614
SIM,1923,39,35-39,1962,6
STAT,1808,109,na,1917,2.682256638704392E-4
STAT,1915,39,35-39,1954,2.440736189215382
SIM,1844,30,na,1874,1764
STAT,1935,21,50-100,1956,0.9055843693206037
SIM,1848,44,na,1892,1733
STAT,1915,31,25-29,1946,9.537302308669462
SIM,1878,42,na,1920,2653
STAT,1956,15,35-39,1971,5.612133784426817
STAT,1814,48,40-44,1862,0.4060488686533876
STAT,1899,34,20-24,1933,3.714770867717791
STAT,1901,24,35-39,1925,8.210485010263739
STAT,1912,15,20-24,1927,27.787311741826905
STAT,1795,67,na,1862,857.1192088632944
STAT,1816,50,50-100,1866,0.039034836356222236
STAT,1854,23,35-39,1877,5.108752981225388
SIM,1907,34,45-49,1941,1
STAT,1803,102,na,1905,0.12221401394858389
STAT,1923,30,20-24,1953,2.8480215256233707
STAT,1831,67,na,1898,996.1516892852493
STAT,1914,0,na,1914,4686.550032364672
SIM,1932,39,na,1971,5780
STAT,1901,15,45-49,1916,0.092917064310963
SIM,1948,22,na,1970,4506
STAT,1847,33,45-49,1880,1.5171801278226014
STAT,1922,29,25-29,1951,74.70383477385643
STAT,1930,19,30-34,1949,15.841794806823215
STAT,1913,23,15-19,1936,5.406796346341169
STAT,1944,20,na,1964,3984.287056543853
STAT,1868,12,na,1880,2578.1331444004945
STAT,1930,28,20-24,1958,23.44832887597007
STAT,1906,46,30-34,1952,0.08055511139157366
STAT,1852,49,15-19,1901,2.970226706574361E-4
SIM,1862,23,35-39,1885,9
STAT,1903,37,15-19,1940,0.01743424308657917
STAT,1910,43,40-44,1953,0.23706293348608393
SIM,1841,97,na,1938,5
SIM,1817,83,na,1900,163
SIM,1855,33,45-49,1888,1
SIM,1930,29,25-29,1959,126
STAT,1861,65,na,1926,1418.3519375872522
SIM,1899,15,30-34,1914,5
STAT,1865,79,na,1944,644.7540143153768
SIM,1852,17,na,1869,2122
STAT,1902,44,45-49,1946,0.14633255996013136
SIM,1935,34,50-100,1969,1
SIM,1946,24,30-34,1970,41
SIM,1894,31,50-100,1925,1
SIM,1902,34,45-49,1936,1
STAT,1848,26,15-19,1874,0.4454206647995924
SIM,1816,66,na,1882,831
STAT,1893,6,na,1899,3350.195354950139
STAT,1928,17,25-29,1945,55.191212938307324
SIM,1817,37,50-100,1854,1
SIM,1865,24,na,1889,2195
STAT,1908,49,45-49,1957,0.19725089576534774
STAT,1874,51,na,1925,2237.4379304232593
STAT,1907,20,na,1927,3528.8361605615632
SIM,1912,16,25-29,1928,14
STAT,1844,85,na,1929,216.8908296486843
STAT,1888,34,45-49,1922,2.0610326869397126
STAT,1848,99,na,1947,1.5462637327141668
SIM,1866,32,50-100,1898,5
STAT,1840,71,na,1911,935.6787543212484
STAT,1905,25,30-34,1930,37.0174524398875
STAT,1907,33,40-44,1940,3.6778627758828026
SIM,1866,33,20-24,1899,3
SIM,1866,8,na,1874,2821
STAT,1816,78,na,1894,399.4743454023944
STAT,1913,44,20-24,1957,0.017318705394843106
STAT,1923,16,35-39,1939,4.9906946862854875
SIM,1846,40,40-44,1886,3
SIM,1873,11,na,1884,2579
SIM,1899,24,20-24,1923,107
SIM,1931,16,35-39,1947,8
SIM,1842,82,na,1924,207
STAT,1881,39,40-44,1920,4.218892550613426
STAT,1931,40,20-24,1971,0.02391033346248273
STAT,1889,81,na,1970,1130.0137425573382
STAT,1900,41,na,1941,3268.617073042431
STAT,1922,21,15-19,1943,6.185546596493415
STAT,1847,61,na,1908,1399.1166447297874
STAT,1871,49,25-29,1920,0.056590471755811035
STAT,1925,46,40-44,1971,0.19355721671924841
SIM,1898,23,15-19,1921,4
SIM,1849,36,25-29,1885,5
SIM,1849,61,na,1910,1465
SIM,1829,43,45-49,1872,3
SIM,1860,15,25-29,1875,4
STAT,1924,28,45-49,1952,2.0255016317668124
SIM,1878,30,35-39,1908,21
SIM,1913,25,30-34,1938,6
SIM,1792,90,na,1882,8
SIM,1896,34,45-49,1930,2
SIM,1889,45,50-100,1934,2
STAT,1874,16,15-19,1890,6.152524329646662
STAT,1936,33,na,1969,3706.4122313857188
STAT,1935,16,50-100,1951,0.5187410558199049
SIM,1920,38,na,1958,4434
STAT,1897,21,40-44,1918,2.8301183526051177
STAT,1908,41,35-39,1949,0.1891486476795472
SIM,1882,16,15-19,1898,4
STAT,1941,21,25-29,1962,96.40407158270916
SIM,1915,33,40-44,1948,10
SIM,1907,23,40-44,1930,3
SIM,1852,49,na,1901,1639
SIM,1871,63,na,1934,1572
SIM,1839,39,50-100,1878,1
STAT,1846,44,na,1890,1730.2896825577334
STAT,1904,16,25-29,1920,8.233635176462524
STAT,1842,30,na,1872,2406.6257840597877
SIM,1875,77,na,1952,755
STAT,1936,36,15-19,1972,0.019050076936215715
SIM,1878,10,na,1888,3074
STAT,1869,17,45-49,1886,0.06503222343235246
STAT,1916,18,45-49,1934,0.1066764316011899
STAT,1838,40,40-44,1878,1.8066117564457418
STAT,1904,55,na,1959,3076.638305044949
SIM,1924,18,45-49,1942,3
STAT,1941,29,35-39,1970,15.664541297326704
SIM,1834,20,na,1854,2045
SIM,1902,26,50-100,1928,1
STAT,1919,49,20-24,1968,0.012031524568811664
STAT,1852,26,50-100,1878,0.5691461590667746
SIM,1841,43,50-100,1884,5
SIM,1932,28,45-49,1960,2
STAT,1841,30,50-100,1871,0.8487751055338857
STAT,1924,42,30-34,1966,0.1536661636545475
STAT,1931,15,30-34,1946,16.198746702922715
SIM,1849,20,15-19,1869,2
STAT,1940,25,25-29,1965,67.81895572242405
STAT,1916,26,45-49,1942,1.8088537779533305
STAT,1839,23,45-49,1862,0.6306614403381041
SIM,1863,33,na,1896,2234
SIM,1939,27,50-100,1966,1
SIM,1904,39,25-29,1943,3
STAT,1852,52,45-49,1904,0.010947506829523604
STAT,1873,23,45-49,1896,0.7117879891067164
STAT,1920,24,45-49,1944,1.2552719750992636
SIM,1896,39,na,1935,3136
SIM,1892,25,na,1917,3277
STAT,1920,18,na,1938,4159.280530165804
STAT,1882,27,na,1909,2334.8492041344266
SIM,1887,41,40-44,1928,4
STAT,1899,3,na,1902,3664.4886993887694
STAT,1900,28,35-39,1928,13.48990203847467
STAT,1892,80,na,1972,1280.3293358475141
STAT,1879,41,40-44,1920,2.3814633574235726
SIM,1918,29,25-29,1947,81
STAT,1912,48,20-24,1960,0.010685331032066564
SIM,1914,37,40-44,1951,3
STAT,1876,21,20-24,1897,72.08187434710197
STAT,1901,32,35-39,1933,14.338481748860932
SIM,1841,15,15-19,1856,5
STAT,1956,6,na,1962,5254.961237665205
STAT,1853,37,50-100,1890,1.0153144514830237
SIM,1938,25,35-39,1963,22
STAT,1807,53,na,1860,1141.4021956148752
STAT,1913,27,30-34,1940,39.39188242078917
STAT,1775,90,na,1865,21.04906263226014
STAT,1887,5,na,1892,2955.1524037465133
SIM,1825,32,20-24,1857,2
SIM,1859,26,40-44,1885,3
SIM,1913,17,30-34,1930,6
SIM,1925,19,15-19,1944,58
STAT,1857,105,na,1962,0.08560162222875245
SIM,1883,64,na,1947,1871
STAT,1906,37,40-44,1943,1.389965538592577
STAT,1880,7,na,1887,2813.4911030337516
STAT,1884,23,20-24,1907,68.42441276281812
STAT,1849,30,15-19,1879,0.13163580033485628
SIM,1921,27,30-34,1948,7
STAT,1862,21,50-100,1883,0.36674200712706606
SIM,1897,30,45-49,1927,4
SIM,1789,91,na,1880,4
STAT,1889,30,45-49,1919,2.1892028358695863
STAT,1901,1,na,1902,3853.7749068748362
SIM,1887,78,na,1965,961
STAT,1858,16,30-34,1874,1.4840470127183192
STAT,1917,19,15-19,1936,48.8709918918638
SIM,1866,16,30-34,1882,3
STAT,1905,17,30-34,1922,2.3272033580570137
SIM,1848,16,15-19,1864,7
STAT,1866,51,50-100,1917,0.014192164025603814
SIM,1847,23,45-49,1870,1
STAT,1836,98,na,1934,2.0482831412881244
SIM,1857,48,na,1905,1924
STAT,1928,34,15-19,1962,0.1622009899784711
SIM,1892,23,20-24,1915,107
STAT,1911,43,50-100,1954,0.11244464456022632
STAT,1832,84,na,1916,226.51841314742512
SIM,1895,4,na,1899,3485
STAT,1936,32,50-100,1968,0.8107603644051415
STAT,1923,49,35-39,1972,0.15149913165530596
SIM,1906,55,na,1961,3008
SIM,1902,41,na,1943,3558
STAT,1943,17,15-19,1960,48.59346160145647
SIM,1928,36,30-34,1964,3
STAT,1830,48,25-29,1878,0.04755824546955401
STAT,1821,38,30-34,1859,9.88574708881023
STAT,1912,42,na,1954,3613.8315630950824
STAT,1916,43,35-39,1959,0.20791847498065003
SIM,1870,39,30-34,1909,6
STAT,1935,3,na,1938,5602.190882585477
SIM,1835,21,25-29,1856,64
SIM,1879,31,40-44,1910,6
SIM,1933,21,40-44,1954,5
STAT,1878,20,40-44,1898,2.197814958217644
STAT,1899,17,30-34,1916,2.209345092421193
SIM,1937,1,na,1938,3867
SIM,1865,99,na,1964,14
STAT,1908,16,45-49,1924,0.09805605513720493
STAT,1811,48,15-19,1859,9.801604673645341E-4
SIM,1923,31,25-29,1954,20
STAT,1889,27,15-19,1916,0.5650385086388827
SIM,1832,29,na,1861,1709
STAT,1877,80,na,1957,720.9928242560659
STAT,1942,16,45-49,1958,0.5272307164787409
STAT,1916,56,na,1972,3660.979264998362
SIM,1882,5,na,1887,2390
STAT,1873,17,50-100,1890,0.050163253430902215
STAT,1890,20,40-44,1910,2.587099798725087
SIM,1951,17,15-19,1968,52
STAT,1862,50,na,1912,1905.0247519569932
SIM,1898,30,na,1928,3240
STAT,1904,38,20-24,1942,0.2399595600859957
STAT,1853,46,na,1899,1865.8480098933405
STAT,1866,64,na,1930,1625.7694097928465
STAT,1862,39,30-34,1901,4.60178020050875
STAT,1856,11,na,1867,2195.7564250057058
STAT,1868,30,25-29,1898,9.966566325754064
STAT,1925,21,40-44,1946,4.079717195831858
STAT,1919,21,na,1940,4049.662492291268
STAT,1843,22,20-24,1865,58.340980607297105
STAT,1861,33,na,1894,1994.331673040124
SIM,1851,22,20-24,1873,68
SIM,1853,98,na,1951,1
STAT,1895,24,35-39,1919,7.64860127462094
SIM,1890,28,50-100,1918,5
SIM,1879,19,20-24,1898,23
STAT,1934,31,35-39,1965,12.61440977226396
SIM,1932,17,40-44,1949,4
STAT,1867,26,25-29,1893,40.37612528189744
SIM,1840,16,na,1856,2136
SIM,1935,34,20-24,1969,7
STAT,1806,49,45-49,1855,0.6894980403078202
STAT,1924,17,40-44,1941,1.6831399082959688
SIM,1927,24,20-24,1951,164
STAT,1837,41,50-100,1878,0.8614273429400767
STAT,1923,41,25-29,1964,0.08445158457920271
STAT,1924,43,na,1967,4456.959840786702
SIM,1905,26,35-39,1931,19
STAT,1890,78,na,1968,1374.8469254926222
STAT,1932,27,40-44,1959,6.169581679900416
SIM,1861,2,na,1863,2988
STAT,1927,34,20-24,1961,3.028788594212364
STAT,1824,97,na,1921,2.670814644466636
STAT,1879,20,35-39,1899,6.1872929114696245
STAT,1922,37,25-29,1959,1.1318191514908846
SIM,1845,41,50-100,1886,3
SIM,1944,19,25-29,1963,63
STAT,1910,35,40-44,1945,1.458185987485957
STAT,1932,34,50-100,1966,1.1092983857410479
STAT,1820,83,na,1903,202.0752252161984
STAT,1936,19,25-29,1955,41.66131298029678
SIM,1903,26,na,1929,3271
SIM,1829,84,na,1913,157
SIM,1930,37,25-29,1967,2
SIM,1836,33,35-39,1869,12
STAT,1914,27,25-29,1941,66.94705277201366
STAT,1905,42,20-24,1947,0.01608256266911027
SIM,1922,27,25-29,1949,12
STAT,1828,33,35-39,1861,11.445496518842829
SIM,1790,88,na,1878,61
SIM,1828,67,na,1895,909
SIM,1940,27,40-44,1967,8
STAT,1919,24,20-24,1943,122.16860065871862
SIM,1914,42,na,1956,3866
SIM,1824,53,na,1877,1333
SIM,1868,0,na,1868,3517
STAT,1840,38,40-44,1878,3.5918825518596216
STAT,1866,2,na,1868,3159.1882514149947
STAT,1896,40,50-100,1936,0.09906911958803404
STAT,1919,16,20-24,1935,30.424091299259935
SIM,1849,24,30-34,1873,33
STAT,1860,48,na,1908,1834.1883858918995
SIM,1777,90,na,1867,10
SIM,1849,29,na,1878,1983
SIM,1938,2,na,1940,3984
STAT,1914,26,35-39,1940,15.322986746538868
SIM,1914,30,20-24,1944,2
STAT,1882,52,50-100,1934,0.01469707938537959
STAT,1940,17,25-29,1957,44.42028761795773
STAT,1851,52,50-100,1903,0.011374739909740576
STAT,1926,42,40-44,1968,0.31164020626983024
STAT,1894,60,na,1954,2479.9731808937963
SIM,1906,39,35-39,1945,5
STAT,1871,46,50-100,1917,0.24714067692824251
STAT,1874,53,35-39,1927,0.008760445783437033
STAT,1834,22,50-100,1856,0.32493207605239993
SIM,1826,33,na,1859,2115
SIM,1955,0,na,1955,5073
STAT,1898,74,na,1972,1986.5120406697665
SIM,1834,52,na,1886,1558
STAT,1870,49,30-34,1919,0.09400058866105739
SIM,1809,64,na,1873,819
SIM,1805,50,na,1855,1117
SIM,1834,39,20-24,1873,4
SIM,1888,21,40-44,1909,2
STAT,1829,32,na,1861,1679.5341995361075
SIM,1946,6,na,1952,4477
SIM,1921,28,20-24,1949,28
SIM,1925,44,40-44,1969,2
STAT,1827,30,na,1857,1754.0209010236078
STAT,1830,28,30-34,1858,26.371025838761273
SIM,1845,15,na,1860,2327
SIM,1918,37,25-29,1955,1
SIM,1877,25,na,1902,2538
STAT,1906,43,50-100,1949,0.10714375340291772
SIM,1942,17,na,1959,4088
STAT,1887,30,35-39,1917,11.51153848095303
STAT,1905,61,na,1966,2964.4993938256275
SIM,1922,26,35-39,1948,24
STAT,1854,54,20-24,1908,5.385694879021988E-4
STAT,1888,16,50-100,1904,0.05854723163510334
STAT,1914,30,50-100,1944,0.8464464599623611
STAT,1826,35,50-100,1861,1.4944152112169886
STAT,1851,109,na,1960,0.0014665766186942447
STAT,1920,37,15-19,1957,0.02123222340855562
STAT,1855,40,40-44,1895,1.7101605640675188
STAT,1876,24,25-29,1900,59.32446106955457
SIM,1930,25,30-34,1955,67
SIM,1831,38,40-44,1869,8
STAT,1926,34,na,1960,4615.968907940725
SIM,1872,80,na,1952,465
STAT,1901,41,25-29,1942,0.0634225881670162
STAT,1901,21,30-34,1922,25.295793921258173
STAT,1913,47,25-29,1960,0.052238852346221866
SIM,1823,39,45-49,1862,1
STAT,1902,28,45-49,1930,1.579113182584358
SIM,1889,3,na,1892,3292
SIM,1904,35,30-34,1939,1
STAT,1842,41,50-100,1883,0.9967674071614813
SIM,1834,63,na,1897,1283
SIM,1879,27,na,1906,2713
SIM,1910,28,45-49,1938,5
SIM,1927,16,20-24,1943,228
STAT,1825,109,na,1934,5.191941045066174E-4
STAT,1936,28,15-19,1964,0.6817474722626645
STAT,1823,38,40-44,1861,7.291407967457929
STAT,1856,43,na,1899,1776.771468870564
STAT,1859,15,35-39,1874,0.5235553712824899
STAT,1924,21,25-29,1945,110.47250029580553
SIM,1875,26,25-29,1901,41
SIM,1884,24,25-29,1908,1
SIM,1918,18,20-24,1936,151
STAT,1881,10,na,1891,2521.8519199588345
SIM,1798,84,na,1882,70
STAT,1815,39,45-49,1854,5.988457360766371
SIM,1794,70,na,1864,715
STAT,1851,53,40-44,1904,0.007843418193833994
STAT,1929,43,20-24,1972,0.02307995561304782
STAT,1921,16,25-29,1937,50.0118317127206
SIM,1876,94,na,1970,92
SIM,1932,21,25-29,1953,6
STAT,1851,98,na,1949,2.4597557332379534
SIM,1870,14,na,1884,2955
STAT,1907,41,40-44,1948,0.2327200408042719
SIM,1932,29,35-39,1961,35
STAT,1919,48,30-34,1967,0.09735512192323899
STAT,1785,89,na,1874,36.86950537858535
STAT,1922,25,30-34,1947,45.09496015490279
STAT,1848,24,na,1872,2095.145863694861
STAT,1907,17,50-100,1924,0.07266611967309403
SIM,1917,39,na,1956,3739
SIM,1920,22,45-49,1942,1
SIM,1780,89,na,1869,14
STAT,1900,24,40-44,1924,2.905304754453818
STAT,1940,16,35-39,1956,4.302419776266703
SIM,1913,25,na,1938,3904
STAT,1781,75,na,1856,226.6850182626
STAT,1859,62,na,1921,1484.73102724707
SIM,1839,62,na,1901,1146
SIM,1872,39,40-44,1911,1
STAT,1834,49,50-100,1883,0.15119452189599167
SIM,1925,31,35-39,1956,25
STAT,1830,29,na,1859,1853.6217456048278
STAT,1929,30,15-19,1959,0.1651695320964707
SIM,1876,83,na,1959,457
STAT,1909,54,na,1963,3317.6402631077995
STAT,1939,28,40-44,1967,4.728152324492488
SIM,1847,81,na,1928,329
STAT,1907,36,45-49,1943,0.6412699139162917
STAT,1905,40,na,1945,3420.4566490182237
SIM,1902,31,40-44,1933,8
STAT,1841,29,45-49,1870,1.016517729076435
STAT,1929,38,25-29,1967,1.276362034047428
STAT,1822,51,20-24,1873,0.001074985001729982
STAT,1921,46,20-24,1967,0.012613701124081323
SIM,1901,22,35-39,1923,8
SIM,1913,21,15-19,1934,5
STAT,1819,49,30-34,1868,0.18313217094821524
STAT,1854,49,25-29,1903,0.042325457452524376
SIM,1860,29,20-24,1889,13
SIM,1898,19,na,1917,3463
STAT,1865,26,15-19,1891,0.41986583186276827
STAT,1876,36,50-100,1912,1.28650523606928
STAT,1910,46,45-49,1956,0.20509245859802064
STAT,1912,22,45-49,1934,1.0879119590774045
SIM,1892,14,na,1906,3544
STAT,1810,52,40-44,1862,0.03857629679993756
STAT,1905,29,25-29,1934,61.32272079450528
SIM,1903,30,45-49,1933,3
STAT,1926,37,50-100,1963,0.5185897349298063
STAT,1899,37,25-29,1936,0.8614232627588699
STAT,1876,31,na,1907,2498.717418065495
SIM,1929,19,35-39,1948,6
STAT,1852,29,20-24,1881,9.295169385349984
SIM,1809,53,na,1862,1141
STAT,1811,51,45-49,1862,0.03526355558563791
STAT,1938,16,30-34,1954,12.167990818007638
STAT,1940,22,20-24,1962,114.35558317442626
SIM,1843,23,25-29,1866,102
SIM,1923,35,na,1958,4461
SIM,1946,16,30-34,1962,19
STAT,1917,27,15-19,1944,0.7472966123871789
STAT,1906,30,20-24,1936,2.3016478931506548
STAT,1884,61,na,1945,1861.1516913629257
STAT,1864,39,40-44,1903,3.949446373059679
SIM,1913,29,25-29,1942,79
STAT,1918,36,20-24,1954,0.2818600439493317
STAT,1905,21,15-19,1926,4.831436393340565
STAT,1888,75,na,1963,1491.2769100540188
STAT,1903,24,50-100,1927,0.5828990948723448
SIM,1877,57,na,1934,2063
SIM,1873,43,na,1916,2209
SIM,1952,16,na,1968,4490
SIM,1933,30,30-34,1963,16
STAT,1902,33,40-44,1935,6.163502026450876
SIM,1853,39,30-34,1892,3
STAT,1838,52,50-100,1890,0.010056358719095673
STAT,1856,19,50-100,1875,0.04433077771847563
SIM,1939,29,45-49,1968,2
STAT,1835,23,25-29,1858,56.724893030071634
STAT,1926,38,20-24,1964,0.32527218253198936
SIM,1903,23,20-24,1926,101
STAT,1846,33,na,1879,1923.5420008067097
STAT,1866,32,na,1898,2231.7558224011163
STAT,1884,23,50-100,1907,0.4049021836481409
STAT,1836,40,30-34,1876,0.8851828848361915
STAT,1873,54,30-34,1927,0.005927267417931691
STAT,1845,59,na,1904,1420.062130997806
STAT,1876,42,na,1918,2407.2926479706944
STAT,1830,101,na,1931,0.37646310566365654
STAT,1858,13,na,1871,2199.6256455665584
SIM,1847,20,40-44,1867,2
STAT,1901,16,35-39,1917,0.7788019872238942
SIM,1897,56,na,1953,2763
SIM,1893,42,na,1935,3051
STAT,1856,20,40-44,1876,1.9012371167732172
SIM,1885,76,na,1961,1032
SIM,1881,62,na,1943,1705
STAT,1898,25,15-19,1923,0.6254280119768495
SIM,1868,24,40-44,1892,1
STAT,1921,17,15-19,1938,52.247183342476966
SIM,1927,17,na,1944,5387
STAT,1889,27,50-100,1916,0.7966691863414382
STAT,1929,37,35-39,1966,3.138630312231563
STAT,1946,18,30-34,1964,13.64992586001097
STAT,1915,35,40-44,1950,1.5404466017253713
SIM,1913,36,na,1949,3758
STAT,1893,16,25-29,1909,7.285096089167768
STAT,1935,36,20-24,1971,0.37275844609944514
SIM,1876,30,25-29,1906,16
STAT,1925,30,30-34,1955,18.929143572370283
STAT,1841,51,30-34,1892,0.00447270135310819
SIM,1908,57,na,1965,3053
STAT,1875,39,50-100,1914,1.2606196935937677
SIM,1910,33,40-44,1943,6
STAT,1920,40,45-49,1960,0.1861340792999921
STAT,1941,28,45-49,1969,1.8034400252542446
STAT,1895,13,na,1908,3400.95528523687
STAT,1922,39,50-100,1961,0.4816011019958078
SIM,1864,20,40-44,1884,4
SIM,1904,43,na,1947,3456
STAT,1936,27,25-29,1963,63.59394874257354
STAT,1911,31,40-44,1942,3.8602068220669725
STAT,1941,23,na,1964,3808.7914190902225
SIM,1825,70,na,1895,713
SIM,1944,27,25-29,1971,78
STAT,1843,25,25-29,1868,35.62212090154064
STAT,1847,50,na,1897,1635.3237436555262
STAT,1881,8,na,1889,2546.082826762617
STAT,1949,17,45-49,1966,0.5869441673216016
STAT,1839,20,40-44,1859,1.9257925450769622
SIM,1844,40,30-34,1884,4
SIM,1851,25,25-29,1876,57
STAT,1802,86,na,1888,73.2321307438849
STAT,1880,79,na,1959,892.9649825252134
SIM,1845,47,na,1892,1879
STAT,1926,23,na,1949,4469.954695889625
SIM,1841,33,na,1874,1789
SIM,1897,45,na,1942,3121
SIM,1899,35,25-29,1934,4
STAT,1836,49,30-34,1885,0.06228988804730161
SIM,1893,31,na,1924,3127
STAT,1888,42,45-49,1930,1.781965643924036
STAT,1937,32,15-19,1969,0.12834967648928194
SIM,1864,37,40-44,1901,4
STAT,1950,19,35-39,1969,5.00938994713298
STAT,1827,62,na,1889,1101.3619138122494
SIM,1940,23,25-29,1963,115
SIM,1910,16,15-19,1926,9
STAT,1905,46,50-100,1951,0.20285441935074727
STAT,1902,20,35-39,1922,8.378441659435763
STAT,1882,52,30-34,1934,0.005792659968159102
SIM,1825,35,25-29,1860,2
STAT,1949,19,na,1968,4321.872908790296
STAT,1949,22,40-44,1971,3.9637136995919837
STAT,1863,52,20-24,1915,6.568410910088831E-4
SIM,1870,7,na,1877,3066
STAT,1822,85,na,1907,153.27502692114734
STAT,1808,70,na,1878,692.9437910259538
STAT,1826,99,na,1925,1.03920343966753
SIM,1913,57,na,1970,3394
SIM,1928,28,30-34,1956,92
STAT,1862,30,30-34,1892,15.35113061584205
STAT,1921,20,45-49,1941,1.2912050549889542
SIM,1880,13,na,1893,2511
STAT,1894,20,25-29,1914,74.8826358710117
SIM,1765,89,na,1854,27
STAT,1826,39,20-24,1865,0.8407302388170765
STAT,1919,6,na,1925,4472.106154647971
STAT,1931,19,25-29,1950,57.01808784163231
STAT,1939,32,25-29,1971,9.520320541723175
STAT,1822,42,50-100,1864,1.6807940548803983
STAT,1919,34,50-100,1953,0.8929360495044614
STAT,1847,41,45-49,1888,1.1413693285923971
STAT,1884,26,25-29,1910,42.27658972458454
STAT,1910,32,50-100,1942,0.8043075014536404
SIM,1862,70,na,1932,1267
SIM,1862,3,na,1865,2751
STAT,1867,17,35-39,1884,0.5335835245344548
STAT,1813,49,na,1862,1316.4627916643472
STAT,1944,26,20-24,1970,19.931328519129256
SIM,1892,26,25-29,1918,96
SIM,1920,19,15-19,1939,56
SIM,1919,17,25-29,1936,58
STAT,1914,54,na,1968,3580.18019706697
STAT,1927,37,25-29,1964,1.237317000776967
SIM,1923,35,40-44,1958,3
STAT,1912,19,15-19,1931,9.209015416947464
SIM,1910,20,35-39,1930,8
STAT,1901,40,35-39,1941,0.17983577355904454
STAT,1932,23,25-29,1955,122.10042353766833
STAT,1802,53,45-49,1855,0.04150347343883362
STAT,1902,16,15-19,1918,8.49095009674027
STAT,1910,40,na,1950,3581.372762406337
STAT,1863,32,50-100,1895,0.819938769777207
STAT,1845,39,30-34,1884,4.007553951055696
STAT,1929,18,30-34,1947,15.681359333209365
SIM,1866,84,na,1950,298
SIM,1834,25,25-29,1859,47
SIM,1938,17,35-39,1955,5
STAT,1898,42,na,1940,3171.5891861919113
SIM,1827,82,na,1909,172
SIM,1938,22,30-34,1960,39
SIM,1858,65,na,1923,1301
SIM,1922,23,30-34,1945,55
STAT,1879,82,na,1961,690.0989682419544
SIM,1855,41,45-49,1896,2
SIM,1854,51,na,1905,2020
SIM,1779,92,na,1871,16
STAT,1862,48,20-24,1910,0.010335130288585737
STAT,1846,29,50-100,1875,0.5788749462421543
STAT,1899,59,na,1958,2761.4860142428342
SIM,1937,18,30-34,1955,12
STAT,1920,21,40-44,1941,3.786161281762605
STAT,1879,37,50-100,1916,1.2940406553677102
STAT,1901,48,45-49,1949,0.18611580626354088
STAT,1859,43,50-100,1902,0.8519940542573462
STAT,1923,17,25-29,1940,51.41453112046593
SIM,1864,16,20-24,1880,21
SIM,1914,33,25-29,1947,2
STAT,1880,25,50-100,1905,0.6831317912383078
SIM,1789,70,na,1859,613
SIM,1858,34,25-29,1892,22
STAT,1821,47,20-24,1868,0.017588104633331623
STAT,1905,26,20-24,1931,17.187834548798268
SIM,1885,41,30-34,1926,2
SIM,1867,58,na,1925,1727
SIM,1863,44,na,1907,2068
STAT,1768,101,na,1869,0.23251677907729876
SIM,1867,43,50-100,1910,2
STAT,1882,27,40-44,1909,2.9307026527029136
STAT,1872,28,na,1900,2414.795437822453
SIM,1823,36,40-44,1859,5
STAT,1837,20,30-34,1857,16.923486109179425
SIM,1930,28,35-39,1958,28
STAT,1934,27,15-19,1961,0.9595834485412978
STAT,1919,19,25-29,1938,48.093070228152804
STAT,1873,98,na,1971,22.53752780378783
SIM,1801,68,na,1869,578
STAT,1905,45,25-29,1950,0.0479132450022817
SIM,1892,46,na,1938,3096
SIM,1820,71,na,1891,677
STAT,1900,36,35-39,1936,2.1521850235619744
STAT,1856,16,20-24,1872,16.328665416514472
SIM,1924,27,35-39,1951,21
STAT,1906,33,25-29,1939,8.615494948415547
STAT,1948,18,40-44,1966,1.6164901396088487
STAT,1911,27,20-24,1938,17.95957096657527
SIM,1935,18,20-24,1953,198
STAT,1951,20,30-34,1971,34.71732480097733
SIM,1952,7,na,1959,4781
STAT,1849,84,na,1933,260.093679493175
STAT,1845,16,45-49,1861,0.06068429061070713
SIM,1912,20,45-49,1932,1
STAT,1861,42,45-49,1903,1.2545538789977158
STAT,1950,16,na,1966,4398.294906873039
SIM,1924,28,50-100,1952,2
STAT,1879,16,15-19,1895,6.270377891339444
STAT,1845,70,na,1915,1025.206740653464
STAT,1922,28,35-39,1950,17.102151232246396
SIM,1886,20,40-44,1906,3
STAT,1825,38,50-100,1863,1.9452404118516131
STAT,1843,39,20-24,1882,0.5409742794012498
STAT,1881,30,40-44,1911,4.256015038921011
STAT,1910,22,35-39,1932,8.921206984741962
STAT,1904,21,50-100,1925,0.592843546001439
SIM,1886,61,na,1947,2099
SIM,1865,24,15-19,1889,1
STAT,1853,15,40-44,1868,0.18411424747557165
SIM,1931,17,25-29,1948,70
SIM,1933,24,45-49,1957,3
STAT,1947,22,30-34,1969,32.811122215507844
SIM,1898,27,30-34,1925,40
SIM,1856,21,45-49,1877,1
STAT,1924,15,50-100,1939,0.45293560997682414
STAT,1857,24,15-19,1881,2.6927812062689043
SIM,1893,10,na,1903,3408
STAT,1957,7,na,1964,5234.942396428637
STAT,1897,27,50-100,1924,0.8661811085998078
STAT,1902,21,na,1923,3385.730453907368
SIM,1897,24,na,1921,3111
SIM,1892,57,na,1949,2741
SIM,1918,34,20-24,1952,3
STAT,1872,43,50-100,1915,1.0649940538880045
STAT,1903,32,45-49,1935,2.5083369670063487
STAT,1915,40,15-19,1955,0.0015644145375549381
STAT,1906,35,na,1941,3526.410273545001
SIM,1923,38,45-49,1961,1
STAT,1871,54,20-24,1925,7.200843943118029E-4
STAT,1873,49,35-39,1922,0.14035435682798023
STAT,1876,20,30-34,1896,18.686245246817727
STAT,1897,17,20-24,1914,24.005473974416912
STAT,1919,53,na,1972,3937.7168138099246
SIM,1923,19,40-44,1942,2
STAT,1931,35,25-29,1966,1.3201536989741889
STAT,1865,52,30-34,1917,0.005460549613005589
STAT,1921,49,25-29,1970,0.06004160566518268
SIM,1835,26,na,1861,1691
STAT,1885,20,50-100,1905,0.4124131791096366
STAT,1900,27,45-49,1927,1.5577676647450676
STAT,1806,100,na,1906,0.3579462463051232
STAT,1912,35,15-19,1947,0.0190890868268095
STAT,1928,39,20-24,1967,0.33601596436869585
STAT,1832,100,na,1932,0.7228997831538855
SIM,1838,66,na,1904,1331
STAT,1889,60,na,1949,2375.190490656774
SIM,1857,80,na,1937,496
STAT,1843,28,50-100,1871,0.527166195373134
STAT,1820,41,45-49,1861,2.9234146254400635
SIM,1933,24,na,1957,4562
STAT,1827,108,na,1935,0.0010892503995696481
STAT,1848,21,45-49,1869,0.6982358721452168
SIM,1914,24,35-39,1938,18
SIM,1880,43,50-100,1923,2
STAT,1832,48,35-39,1880,0.11160267737384628
STAT,1902,49,15-19,1951,3.1531325210455653E-4
SIM,1904,38,35-39,1942,8
STAT,1908,37,15-19,1945,0.018149542350433548
STAT,1836,66,na,1902,1033.4352115644692
STAT,1901,58,na,1959,2887.873529614096
STAT,1916,27,35-39,1943,15.665820753905654
SIM,1843,99,na,1942,8
STAT,1838,25,na,1863,1868.8558742068542
STAT,1838,49,40-44,1887,0.1149231679947648
STAT,1851,15,50-100,1866,0.04563804227824845
STAT,1847,26,50-100,1873,0.5798504558361461
SIM,1854,29,na,1883,2265
SIM,1850,15,na,1865,2262
SIM,1946,19,35-39,1965,7
STAT,1915,19,40-44,1934,0.29380989717127326
STAT,1916,28,50-100,1944,1.0349368179926792
STAT,1925,38,na,1963,4558.7925832374585
SIM,1913,26,20-24,1939,20
STAT,1926,45,45-49,1971,0.272305528934182
SIM,1859,22,25-29,1881,59
STAT,1921,41,15-19,1962,0.0017494542500265952
STAT,1936,31,45-49,1967,1.543955552129479
STAT,1817,52,na,1869,1228.371038317522
STAT,1842,51,na,1893,1947.8470009743685
STAT,1930,27,30-34,1957,50.356687802993854
STAT,1927,18,20-24,1945,169.93671729892588
SIM,1788,85,na,1873,93
STAT,1921,24,na,1945,4139.729447634952
SIM,1838,77,na,1915,650
SIM,1867,47,na,1914,1986
STAT,1855,80,na,1935,465.63032162505607
STAT,1906,24,35-39,1930,8.530853979988834
STAT,1941,25,40-44,1966,4.872200603471861
STAT,1859,94,na,1953,16.23540195522759
STAT,1811,90,na,1901,34.36996476612255
STAT,1817,63,na,1880,937.526240237174
SIM,1871,84,na,1955,329
SIM,1784,71,na,1855,605
SIM,1842,15,30-34,1857,3
STAT,1822,54,25-29,1876,0.004861158304268515
SIM,1851,28,50-100,1879,3
STAT,1866,30,15-19,1896,0.13425484940634078
STAT,1931,39,40-44,1970,1.999412145014547
STAT,1832,30,45-49,1862,1.585802735607618
SIM,1837,21,35-39,1858,14
STAT,1854,48,50-100,1902,0.18200351864913586
STAT,1891,16,15-19,1907,7.439252483738954
STAT,1877,41,30-34,1918,1.203863636426225
SIM,1849,27,35-39,1876,12
STAT,1841,26,40-44,1867,2.8024665199525423
STAT,1880,30,50-100,1910,0.9796833155019263
STAT,1772,115,na,1887,1.387809021174455E-4
STAT,1955,15,na,1970,4939.0098773300315
STAT,1850,15,15-19,1865,5.618895918357755
SIM,1883,16,30-34,1899,5
STAT,1936,24,20-24,1960,107.25180632239723
SIM,1912,17,15-19,1929,9
STAT,1859,40,25-29,1899,0.5269106102211187
STAT,1830,24,50-100,1854,0.8589283577886351
SIM,1819,63,na,1882,937
STAT,1920,17,50-100,1937,0.4244754668880941
SIM,1788,74,na,1862,432
STAT,1850,81,na,1931,414.07085260850806
SIM,1858,38,40-44,1896,5
SIM,1830,37,50-100,1867,3
STAT,1789,109,na,1898,2.1654455154600526E-4
STAT,1841,54,35-39,1895,0.006260939470779246
STAT,1942,17,35-39,1959,4.427498792086388
SIM,1886,24,35-39,1910,10
STAT,1859,21,20-24,1880,64.28709906001893
STAT,1896,41,40-44,1937,0.20976436855133634
STAT,1925,33,35-39,1958,10.960166669397731
STAT,1867,25,50-100,1892,0.6126176165440178
SIM,1933,33,35-39,1966,2
STAT,1875,16,30-34,1891,1.6572495202647104
SIM,1855,14,na,1869,2448
STAT,1904,17,15-19,1921,8.601649487880822
SIM,1859,28,na,1887,2227
SIM,1881,31,45-49,1912,3
STAT,1905,49,40-44,1954,0.13805903593182117
STAT,1923,37,40-44,1960,1.7525601248196594
STAT,1941,30,15-19,1971,0.13636808151035487
STAT,1932,20,20-24,1952,148.32027895142633
SIM,1903,26,25-29,1929,55
SIM,1939,30,25-29,1969,1
STAT,1854,95,na,1949,9.978122875375842
SIM,1944,24,20-24,1968,123
SIM,1848,15,25-29,1863,6
STAT,1820,38,15-19,1858,0.12816250165548745
SIM,1821,34,na,1855,1475
SIM,1774,93,na,1867,1
SIM,1953,8,na,1961,4919
STAT,1822,37,50-100,1859,2.287781337528771
STAT,1878,24,35-39,1902,6.079935699612312
STAT,1889,15,20-24,1904,22.181592370467587
SIM,1825,48,na,1873,1271
STAT,1907,42,30-34,1949,0.11826818527449906
SIM,1863,45,50-100,1908,2
SIM,1905,27,25-29,1932,84
STAT,1829,50,40-44,1879,0.007896029795988633
STAT,1833,52,35-39,1885,0.006300388157696065
STAT,1924,29,35-39,1953,17.538256037169802
SIM,1914,10,na,1924,4346
SIM,1918,24,na,1942,4073
STAT,1901,45,40-44,1946,0.13809399782290033
SIM,1868,43,na,1911,2098
SIM,1867,21,20-24,1888,67
SIM,1805,71,na,1876,520
SIM,1839,51,na,1890,1430
STAT,1855,45,50-100,1900,0.1867112959091593
STAT,1915,44,30-34,1959,0.12944486129797872
SIM,1809,85,na,1894,60
STAT,1938,19,35-39,1957,4.175918095472534
SIM,1904,15,15-19,1919,8
STAT,1917,39,45-49,1956,0.7103858576815394
STAT,1890,46,na,1936,2785.066545454922
STAT,1795,99,na,1894,0.438487357695123
STAT,1915,38,45-49,1953,0.6914631068101265
SIM,1813,90,na,1903,18
SIM,1869,40,35-39,1909,3
SIM,1940,20,20-24,1960,120
SIM,1868,27,45-49,1895,2
SIM,1838,26,20-24,1864,15
STAT,1935,16,na,1951,5096.307034361927
STAT,1917,31,35-39,1948,9.698638446689337
STAT,1897,38,40-44,1935,5.8979963232574635
SIM,1914,21,na,1935,3914
STAT,1854,107,na,1961,0.012519455595221373
STAT,1868,26,40-44,1894,2.901513668855089
SIM,1903,58,na,1961,2720
SIM,1918,35,na,1953,4204
STAT,1813,48,25-29,1861,0.1645711812562542
STAT,1911,34,45-49,1945,1.5326616547134146
STAT,1924,41,40-44,1965,0.3010747059830582
SIM,1889,16,25-29,1905,7
SIM,1960,0,na,1960,5285
STAT,1933,32,30-34,1965,21.455347534800094
STAT,1931,16,20-24,1947,179.7850747717366
STAT,1874,83,na,1957,474.68634828401173
SIM,1887,46,na,1933,2433
SIM,1916,21,40-44,1937,3
STAT,1823,48,na,1871,1422.1957065961967
STAT,1903,25,20-24,1928,16.989158452615147
SIM,1906,31,25-29,1937,12
STAT,1829,41,50-100,1870,0.832717445399051
STAT,1880,39,25-29,1919,3.023257571573611
SIM,1814,86,na,1900,80
SIM,1900,34,35-39,1934,18
SIM,1870,30,30-34,1900,6
STAT,1914,32,20-24,1946,2.4772288660691233
STAT,1830,53,20-24,1883,5.321563166373042E-4
SIM,1840,48,na,1888,1605
SIM,1899,39,40-44,1938,2
STAT,1858,36,25-29,1894,2.292417894769208
STAT,1918,43,45-49,1961,0.17836264350149073
STAT,1943,29,45-49,1972,1.8559691385133796
SIM,1793,85,na,1878,94
STAT,1849,26,30-34,1875,23.507703662711126
STAT,1873,31,45-49,1904,1.7928129789317224
STAT,1907,17,40-44,1924,0.2712869127497433
SIM,1853,66,na,1919,1188
SIM,1927,19,25-29,1946,79
STAT,1937,19,50-100,1956,0.36686425726124916
SIM,1911,25,20-24,1936,25
STAT,1839,95,na,1934,9.426175989135865
STAT,1835,81,na,1916,405.86960440659806
STAT,1890,29,40-44,1919,3.670584420178243
SIM,1922,32,20-24,1954,4
STAT,1892,37,50-100,1929,1.5560156268436671
SIM,1852,81,na,1933,242
SIM,1908,19,15-19,1927,11
STAT,1913,28,20-24,1941,18.286836115632358
STAT,1804,101,na,1905,0.1769045239761187
STAT,1837,51,na,1888,1503.6583566962147
STAT,1908,21,40-44,1929,3.1297765572478595
SIM,1858,30,30-34,1888,33
SIM,1879,27,20-24,1906,20
STAT,1851,66,na,1917,1241.0384752652258
STAT,1871,29,30-34,1900,25.08753177602562
STAT,1904,37,30-34,1941,1.667328112137956
STAT,1943,21,35-39,1964,10.118598407022718
SIM,1834,22,20-24,1856,3
SIM,1864,23,45-49,1887,3
STAT,1965,0,na,1965,4993.229098809922
SIM,1868,40,50-100,1908,1
STAT,1868,48,15-19,1916,3.8126446290750223E-4
SIM,1814,40,45-49,1854,4
STAT,1839,36,15-19,1875,0.04807249919165031
SIM,1813,44,50-100,1857,2
SIM,1941,26,45-49,1967,2
STAT,1923,42,15-19,1965,0.0018135479554754444
STAT,1772,93,na,1865,4.770810624323479
STAT,1861,17,40-44,1878,0.17643842924235378
STAT,1861,39,15-19,1900,0.0466550706691221
STAT,1869,30,40-44,1899,4.292705815839021
STAT,1889,38,na,1927,2919.5670493651937
SIM,1857,26,30-34,1883,51
SIM,1883,32,na,1915,2675
STAT,1893,75,na,1968,1707.4081474446891
STAT,1916,24,na,1940,3837.494746509783
SIM,1859,39,na,1898,2157
SIM,1888,40,45-49,1928,5
STAT,1878,21,30-34,1899,18.731755836547528
STAT,1869,61,na,1930,1834.922563964836
STAT,1857,28,na,1885,1923.7154488227297
STAT,1856,23,45-49,1879,0.6226199917294539
STAT,1912,10,na,1922,4041.244022558103
STAT,1933,26,45-49,1959,2.319079245099298
SIM,1929,35,35-39,1964,5
STAT,1868,22,50-100,1890,0.3936363597661715
STAT,1878,15,45-49,1893,0.06880589583942866
STAT,1885,24,na,1909,2362.787941712982
SIM,1950,17,35-39,1967,9
STAT,1852,31,25-29,1883,8.126690570738985
STAT,1853,14,na,1867,2353.3067826928514
SIM,1881,16,20-24,1897,16
STAT,1900,21,15-19,1921,4.642541559493594
STAT,1835,27,40-44,1862,2.931363338082609
SIM,1855,39,40-44,1894,4
SIM,1894,22,40-44,1916,3
SIM,1909,42,na,1951,3811
SIM,1933,22,30-34,1955,47
STAT,1864,94,na,1958,27.136470007264062
STAT,1850,23,15-19,1873,3.0101981884825344
STAT,1875,36,25-29,1911,3.0007271421695307
SIM,1802,85,na,1887,54
SIM,1897,23,20-24,1920,102
STAT,1822,38,25-29,1860,5.133638415537121
STAT,1805,83,na,1888,166.15323336863747
SIM,1847,59,na,1906,1383
SIM,1866,30,na,1896,2438
SIM,1830,38,25-29,1868,2
STAT,1858,27,35-39,1885,7.826849759538852
STAT,1822,53,na,1875,1322.5586565070341
STAT,1905,18,na,1923,3677.967337789763
STAT,1913,37,na,1950,3746.0511369319183
STAT,1854,29,30-34,1883,19.528496385505726
STAT,1856,37,40-44,1893,3.3897029237249994
STAT,1898,21,20-24,1919,94.64045866401091
SIM,1920,49,50-100,1969,2
STAT,1814,42,45-49,1856,4.535974800876112
SIM,1855,78,na,1933,728
SIM,1858,11,na,1869,2279
SIM,1866,27,35-39,1893,8
SIM,1890,39,35-39,1929,6
STAT,1849,21,25-29,1870,54.50468342510184
SIM,1935,30,40-44,1965,13
SIM,1909,35,45-49,1944,1
STAT,1889,23,20-24,1912,85.55802601071171
SIM,1885,44,35-39,1929,2
STAT,1856,75,na,1931,797.1601073145496
SIM,1857,21,25-29,1878,73
STAT,1881,64,na,1945,1692.4057029194482
STAT,1864,48,30-34,1912,0.08711376263562604
SIM,1848,23,25-29,1871,75
STAT,1861,37,50-100,1898,1.030420090585028
STAT,1877,44,35-39,1921,1.8621549885264286
SIM,1848,36,30-34,1884,3
SIM,1929,33,20-24,1962,3
SIM,1837,54,50-100,1891,3
STAT,1942,29,15-19,1971,0.7473545219868334
STAT,1873,16,20-24,1889,18.25996414679716
SIM,1922,30,50-100,1952,1
STAT,1817,43,25-29,1860,1.5041487720590678
STAT,1945,21,45-49,1966,1.2457909442734068
SIM,1846,15,15-19,1861,6
STAT,1867,25,35-39,1892,9.240540687939445
STAT,1883,65,na,1948,1670.310505326278
SIM,1918,33,45-49,1951,3
SIM,1845,22,45-49,1867,4
SIM,1883,36,25-29,1919,4
STAT,1882,26,15-19,1908,0.4454020508185777
SIM,1826,48,50-100,1874,3
SIM,1839,30,20-24,1869,2
SIM,1872,48,na,1920,2415
SIM,1865,48,50-100,1913,3
STAT,1892,33,20-24,1925,3.411343518467837
SIM,1830,92,na,1922,16
STAT,1871,38,20-24,1909,0.7696519319852874
STAT,1869,52,50-100,1921,0.014751323935134564
SIM,1901,31,25-29,1932,19
SIM,1863,97,na,1960,36
STAT,1894,38,15-19,1932,0.07265758468934826
STAT,1871,32,na,1903,2394.482277894397
STAT,1818,49,15-19,1867,6.913016796946768E-4
STAT,1845,48,na,1893,1623.2712527106073
STAT,1864,19,50-100,1883,0.04564750831744626
STAT,1884,34,25-29,1918,10.114240845650759
SIM,1926,22,na,1948,4709
STAT,1848,42,15-19,1890,0.011261270483968166
STAT,1856,65,na,1921,1308.6161501219765
STAT,1827,47,15-19,1874,4.102775453971356E-4
SIM,1832,83,na,1915,224
STAT,1825,42,20-24,1867,0.22772057873359358
SIM,1938,31,20-24,1969,2
SIM,1910,39,na,1949,3339
STAT,1865,17,25-29,1882,5.385477402749832
STAT,1875,24,30-34,1899,18.359553500385637
STAT,1890,25,na,1915,2965.335744256559
SIM,1879,80,na,1959,780
SIM,1889,24,25-29,1913,82
SIM,1909,52,na,1961,3669
STAT,1880,19,30-34,1899,1.6815675271593333
STAT,1944,27,50-100,1971,1.0863260961222603
SIM,1887,16,15-19,1903,8
SIM,1832,26,40-44,1858,6
SIM,1925,23,35-39,1948,19
SIM,1927,31,45-49,1958,5
STAT,1916,24,30-34,1940,30.202763965277217
STAT,1918,32,40-44,1950,4.198255507211712
STAT,1870,15,na,1885,2558.7815135057194
STAT,1930,39,50-100,1969,0.5523393368442177
STAT,1790,90,na,1880,26.51886191852051
STAT,1837,22,45-49,1859,0.6227588462698133
STAT,1912,39,30-34,1951,1.7766206498726163
SIM,1879,36,50-100,1915,1
STAT,1855,106,na,1961,0.030362568238697017
SIM,1811,49,50-100,1860,3
STAT,1861,19,20-24,1880,16.90105680628931
STAT,1950,16,30-34,1966,14.564917655524393
SIM,1902,23,40-44,1925,5
SIM,1905,24,20-24,1929,105
STAT,1815,48,35-39,1863,0.30549181964626615
STAT,1778,111,na,1889,0.0013744215802591574
STAT,1830,37,20-24,1867,0.7008006989078298
SIM,1942,20,30-34,1962,1
STAT,1889,43,15-19,1932,0.01707444216263749
STAT,1788,86,na,1874,66.0416243978402
STAT,1858,46,50-100,1904,0.19516267880459495
STAT,1900,62,na,1962,2726.274820861484
SIM,1942,15,35-39,1957,4
STAT,1835,28,na,1863,2100.7618680754804
SIM,1825,37,50-100,1862,1
SIM,1855,26,20-24,1881,17
STAT,1899,28,35-39,1927,13.327800512971944
STAT,1837,29,na,1866,1866.9910124920295
STAT,1856,97,na,1953,4.159975711421386
STAT,1925,42,25-29,1967,0.0873723493441676
SIM,1865,20,20-24,1885,3
STAT,1939,24,25-29,1963,93.58567850973786
STAT,1863,39,25-29,1902,2.5506321207251452
STAT,1849,34,30-34,1883,14.089021942201828
STAT,1853,37,15-19,1890,0.046438504689848406
STAT,1866,43,20-24,1909,0.1474541935008949
STAT,1876,23,35-39,1899,6.066685043348905
SIM,1926,32,40-44,1958,9
STAT,1919,31,45-49,1950,1.7211397189244728
STAT,1934,15,35-39,1949,5.761540859849872
SIM,1907,32,30-34,1939,18
STAT,1891,17,40-44,1908,0.22871628542219433
STAT,1841,25,15-19,1866,0.42752600624535303
SIM,1888,25,20-24,1913,14
STAT,1886,22,40-44,1908,2.222159157785357
STAT,1847,39,40-44,1886,3.3307595761002897
SIM,1906,20,20-24,1926,157
STAT,1850,49,40-44,1899,0.12835314163636988
STAT,1870,15,40-44,1885,0.18530560199413135
STAT,1915,15,25-29,1930,9.194461054736907
SIM,1849,50,na,1899,1711
STAT,1836,26,45-49,1862,0.9128836549859318
STAT,1935,27,45-49,1962,2.379298602648471
STAT,1777,111,na,1888,9.419640970985365E-4
SIM,1785,88,na,1873,26
STAT,1853,23,40-44,1876,2.0214861922690686
SIM,1876,26,40-44,1902,5
SIM,1843,27,40-44,1870,9
STAT,1843,47,na,1890,1510.3707291737037
STAT,1917,23,35-39,1940,10.070120829540551
STAT,1882,39,35-39,1921,6.850131045512922
STAT,1859,30,na,1889,1966.7234929302422
STAT,1847,26,20-24,1873,10.633997685414807
STAT,1765,91,na,1856,14.367680945999998
STAT,1873,45,na,1918,2326.599736218315
SIM,1860,47,na,1907,1985
SIM,1947,24,25-29,1971,132
STAT,1843,33,25-29,1876,8.219319400771711
SIM,1877,25,45-49,1902,2
STAT,1848,78,na,1926,637.9256876430364
SIM,1861,23,40-44,1884,1
STAT,1934,20,30-34,1954,39.15524994105892
SIM,1827,31,40-44,1858,3
SIM,1851,33,25-29,1884,20
SIM,1889,37,30-34,1926,4
SIM,1923,15,25-29,1938,78
SIM,1830,70,na,1900,731
SIM,1804,86,na,1890,63
STAT,1798,86,na,1884,86.19871886128462
SIM,1924,24,30-34,1948,41
STAT,1805,51,na,1856,1403.0915521553536
STAT,1900,23,50-100,1923,0.5703665966630562
STAT,1944,25,45-49,1969,1.8871590700038825
STAT,1871,64,na,1935,1744.3109145800354
STAT,1927,25,45-49,1952,2.1372484742007174
SIM,1868,11,na,1879,2517
STAT,1938,20,15-19,1958,5.322264283758243
SIM,1849,32,30-34,1881,19
STAT,1813,70,na,1883,735.8457635760689
STAT,1880,21,35-39,1901,6.208442376696466
SIM,1925,36,40-44,1961,1
SIM,1933,7,na,1940,5123
STAT,1868,21,35-39,1889,5.673672618356221
SIM,1881,4,na,1885,2366
STAT,1886,17,45-49,1903,0.06965946199555502
SIM,1911,21,40-44,1932,5
SIM,1933,26,50-100,1959,1
SIM,1866,32,30-34,1898,23
SIM,1890,77,na,1967,1565
SIM,1843,77,na,1920,823
SIM,1916,30,30-34,1946,25
STAT,1767,102,na,1869,0.06463192500075068
STAT,1924,30,15-19,1954,0.15218328275264317
SIM,1867,23,35-39,1890,12
SIM,1882,24,15-19,1906,3
STAT,1896,44,45-49,1940,0.1370703966158039
SIM,1819,39,30-34,1858,10
STAT,1850,19,45-49,1869,0.060403727265083036
SIM,1943,27,45-49,1970,4
STAT,1839,27,25-29,1866,37.781370741008345
STAT,1865,22,20-24,1887,64.32752548023814
SIM,1847,27,25-29,1874,49
STAT,1930,39,na,1969,4949.356594395341
STAT,1820,72,na,1892,642.8416435454678
STAT,1829,53,45-49,1882,0.009333391058747623
STAT,1835,29,20-24,1864,11.315762925250079
STAT,1909,37,45-49,1946,0.6511412866893025
STAT,1947,23,20-24,1970,126.8983926024403
STAT,1808,48,na,1856,1254.8503617400002
STAT,1868,76,na,1944,914.5201007051729
STAT,1873,77,na,1950,885.0593904882454
STAT,1844,39,15-19,1883,0.04598386525147013
STAT,1915,18,na,1933,4068.2443679593757
SIM,1946,20,15-19,1966,9
SIM,1893,26,40-44,1919,11
SIM,1935,25,45-49,1960,5
SIM,1856,22,20-24,1878,92
STAT,1796,73,na,1869,480.23032679090926
STAT,1851,35,25-29,1886,2.2496774961960866
STAT,1847,29,na,1876,1918.9656101900239
STAT,1917,36,40-44,1953,1.577025837210537
SIM,1826,29,20-24,1855,13
STAT,1903,21,40-44,1924,3.0064276141063466
SIM,1817,37,40-44,1854,7
SIM,1897,27,50-100,1924,1
STAT,1860,27,na,1887,1991.488931576886
SIM,1932,26,30-34,1958,76
STAT,1859,39,45-49,1898,1.6030818297481335
SIM,1870,67,na,1937,1765
SIM,1855,46,na,1901,1931
SIM,1772,91,na,1863,2
SIM,1826,35,40-44,1861,6
STAT,1876,28,40-44,1904,3.1129065345946083
SIM,1878,25,50-100,1903,5
STAT,1828,39,30-34,1867,5.248172360825346
SIM,1889,80,na,1969,944
STAT,1839,44,15-19,1883,0.010058016814852737
STAT,1858,32,30-34,1890,13.834845808756798
SIM,1843,29,20-24,1872,1
SIM,1892,23,50-100,1915,3
SIM,1898,22,25-29,1920,79
SIM,1903,22,45-49,1925,2
SIM,1857,34,30-34,1891,30
STAT,1834,48,45-49,1882,0.14715796078556279
STAT,1924,26,30-34,1950,46.259269789689824
SIM,1927,34,50-100,1961,2
STAT,1848,22,20-24,1870,68.50740868016422
SIM,1919,52,na,1971,3808
STAT,1857,20,20-24,1877,63.61947725505237
STAT,1899,45,25-29,1944,0.04548673941247037
STAT,1891,24,15-19,1915,4.0995321426047715
SIM,1884,28,40-44,1912,4
SIM,1833,25,30-34,1858,6
STAT,1929,22,15-19,1951,6.803921914521458
SIM,1858,4,na,1862,2438
STAT,1865,58,na,1923,1823.8511476808676
STAT,1874,15,25-29,1889,5.909672974538147
STAT,1876,95,na,1971,71.99390187660539
SIM,1836,39,30-34,1875,13
STAT,1812,53,na,1865,1262.7313616699103
STAT,1885,26,40-44,1911,3.0218882548654054
STAT,1824,33,15-19,1857,0.24568067065993
SIM,1862,48,na,1910,2011
SIM,1937,22,15-19,1959,4
STAT,1923,37,na,1960,4404.500326669558
SIM,1850,47,na,1897,1876
SIM,1883,10,na,1893,2934
SIM,1877,42,35-39,1919,4
SIM,1886,31,50-100,1917,1
SIM,1946,20,na,1966,4103
STAT,1894,16,40-44,1910,0.23841944315857017
STAT,1845,81,na,1926,395.12907718119015
SIM,1858,33,35-39,1891,10
STAT,1828,30,50-100,1858,1.1570838965252346
SIM,1869,60,na,1929,1801
STAT,1899,25,30-34,1924,35.14275046005531
STAT,1860,70,na,1930,1158.4153256608606
STAT,1814,42,50-100,1856,3.201864556148962
STAT,1904,20,45-49,1924,1.0167414775644739
STAT,1954,16,15-19,1970,56.69808515850184
STAT,1868,98,na,1966,13.642846841608153
STAT,1877,27,45-49,1904,1.1574058654544397
SIM,1886,44,50-100,1930,1
STAT,1880,25,na,1905,2548.584170375335
STAT,1938,33,20-24,1971,2.474434664626719
SIM,1916,22,na,1938,3786
STAT,1855,15,15-19,1870,5.376268294265665
STAT,1915,1,na,1916,4395.89763947775
STAT,1886,4,na,1890,2805.3469947400777
SIM,1873,17,25-29,1890,14
SIM,1852,25,40-44,1877,4
STAT,1805,73,na,1878,608.5934609139974
STAT,1903,59,na,1962,2946.540423062321
STAT,1800,54,50-100,1854,0.044766273506893745
STAT,1835,49,15-19,1884,3.085663011960338E-4
STAT,1855,26,na,1881,1885.9738824853646
STAT,1875,49,45-49,1924,0.23967243767635216
SIM,1862,29,30-34,1891,30
STAT,1840,32,45-49,1872,1.488872068233487
SIM,1836,43,50-100,1879,3
STAT,1850,41,50-100,1891,0.8126000666978133
STAT,1953,15,45-49,1968,0.6108621226080024
STAT,1881,33,45-49,1914,1.6905606500089534
STAT,1929,20,na,1949,4695.459353818188
SIM,1835,25,40-44,1860,3
STAT,1844,25,40-44,1869,2.943448696864769
STAT,1932,20,50-100,1952,0.8776868138409212
STAT,1917,40,25-29,1957,0.07543029584994078
STAT,1908,30,30-34,1938,15.13295179992681
SIM,1868,32,40-44,1900,6
SIM,1842,28,na,1870,1975
STAT,1895,15,45-49,1910,0.08655829413663817
SIM,1910,1,na,1911,3928
SIM,1911,28,25-29,1939,86
STAT,1890,38,30-34,1928,6.544931454779757
STAT,1856,49,35-39,1905,0.10614499004659331
SIM,1863,37,25-29,1900,4
SIM,1863,15,15-19,1878,6
SIM,1879,22,15-19,1901,6
STAT,1949,21,15-19,1970,6.27730487089417
STAT,1930,17,na,1947,4809.677926488467
SIM,1856,10,na,1866,2542
SIM,1916,25,35-39,1941,27
SIM,1845,29,30-34,1874,30
STAT,1834,35,25-29,1869,2.1776132813468903
STAT,1927,30,40-44,1957,4.871086276676526
STAT,1884,31,20-24,1915,2.703235167887898
STAT,1948,22,25-29,1970,107.13804812122386
STAT,1869,42,35-39,1911,1.775954778264053
SIM,1873,27,40-44,1900,4
STAT,1869,6,na,1875,2729.3124913673714
STAT,1823,47,30-34,1870,0.13323551220617166
STAT,1880,48,15-19,1928,4.1895270057831237E-4
STAT,1903,28,25-29,1931,60.63274357749556
SIM,1842,18,na,1860,2198
STAT,1845,24,45-49,1869,0.6234894346915488
STAT,1855,16,na,1871,2067.254312564349
STAT,1867,22,30-34,1889,17.013234034150514
STAT,1943,26,40-44,1969,5.014565543725703
STAT,1910,31,25-29,1941,9.028005624695206
STAT,1837,29,30-34,1866,21.734338401067657
SIM,1842,35,25-29,1877,2
STAT,1908,25,35-39,1933,14.546609892623486
STAT,1839,32,20-24,1871,2.358345565805411
SIM,1892,31,20-24,1923,6
SIM,1918,22,50-100,1940,4
SIM,1904,34,50-100,1938,5
SIM,1870,33,35-39,1903,15
SIM,1875,22,30-34,1897,23
SIM,1847,32,20-24,1879,2
SIM,1918,30,40-44,1948,3
STAT,1849,46,25-29,1895,0.04516258823899685
STAT,1927,33,45-49,1960,1.9552700691089788
STAT,1902,25,40-44,1927,4.304454747272148
SIM,1882,26,na,1908,2103
STAT,1860,38,45-49,1898,1.6377120233479325
SIM,1837,20,45-49,1857,1
STAT,1892,36,25-29,1928,3.6665975834005247
STAT,1817,40,20-24,1857,0.4244313857123442
SIM,1933,29,15-19,1962,1
STAT,1880,47,na,1927,2375.304068477503
SIM,1827,34,45-49,1861,2
SIM,1906,36,30-34,1942,3
STAT,1886,25,45-49,1911,1.1920522540132474
STAT,1839,37,40-44,1876,3.708758014536962
STAT,1852,27,40-44,1879,2.6460724530917674
STAT,1849,17,40-44,1866,0.1760256816838761
SIM,1916,22,30-34,1938,41
SIM,1922,18,na,1940,4735
SIM,1870,99,na,1969,23
SIM,1846,32,na,1878,1839
SIM,1908,25,na,1933,3451
STAT,1870,18,45-49,1888,0.06501801992624964
STAT,1966,1,na,1967,4966.048958390959
SIM,1933,25,35-39,1958,24
STAT,1874,50,30-34,1924,0.006244529971125103
STAT,1920,16,45-49,1936,0.5673573146049082
STAT,1942,22,30-34,1964,30.426099794832336
SIM,1894,25,45-49,1919,1
STAT,1815,51,na,1866,1241.923141252881
STAT,1825,45,25-29,1870,0.07951686700263026
STAT,1835,31,25-29,1866,9.893279005915845
STAT,1917,41,na,1958,3917.836448858352
STAT,1898,33,15-19,1931,0.194162995476482
STAT,1877,38,15-19,1915,0.05824648199650749
STAT,1897,45,15-19,1942,3.0856642272087835E-4
STAT,1845,48,20-24,1893,0.008658059713902025
STAT,1893,43,na,1936,2952.7807239775957
STAT,1868,34,40-44,1902,4.150352342683896
SIM,1929,36,25-29,1965,2
SIM,1881,29,40-44,1910,3
STAT,1925,25,35-39,1950,18.042560985551564
STAT,1929,2,na,1931,5275.567424000762
STAT,1873,29,40-44,1902,3.045264787243913
STAT,1878,76,na,1954,993.3098828937299
SIM,1917,42,40-44,1959,2
STAT,1825,71,na,1896,974.0826463983856
SIM,1851,30,20-24,1881,2
STAT,1895,32,35-39,1927,13.3572291580061
SIM,1871,19,30-34,1890,3
STAT,1768,88,na,1856,76.63107933
STAT,1844,39,50-100,1883,1.0053743813820903
STAT,1932,15,25-29,1947,58.25872911354512
SIM,1885,27,45-49,1912,1
SIM,1892,0,na,1892,3704
SIM,1948,20,25-29,1968,130
STAT,1925,29,15-19,1954,0.8366402043867917
STAT,1812,49,20-24,1861,0.026803701924737425
STAT,1832,31,na,1863,1926.2322978224004
SIM,1814,64,na,1878,908
STAT,1863,77,na,1940,773.5356868302849
SIM,1909,32,40-44,1941,10
SIM,1843,31,25-29,1874,10
STAT,1908,22,30-34,1930,26.672630557427755
STAT,1886,31,50-100,1917,0.9810708019709158
SIM,1876,34,40-44,1910,10
SIM,1961,1,na,1962,5238
STAT,1885,2,na,1887,3137.844976422846
SIM,1865,23,25-29,1888,74
STAT,1838,46,na,1884,1569.4511101563075
SIM,1822,73,na,1895,608
STAT,1856,36,15-19,1892,0.043692361209339954
SIM,1842,71,na,1913,843
SIM,1792,68,na,1860,656
SIM,1827,29,na,1856,1642
STAT,1889,39,30-34,1928,6.570622491903687
SIM,1842,23,30-34,1865,23
STAT,1900,30,na,1930,3374.9328908587895
STAT,1940,21,50-100,1961,0.676923753465596
STAT,1909,42,40-44,1951,0.23607921771145263
STAT,1884,17,35-39,1901,0.5465115644851202
STAT,1834,23,30-34,1857,14.087238656646802
STAT,1868,44,na,1912,2200.9040831765183
SIM,1872,43,50-100,1915,5
STAT,1855,43,45-49,1898,1.118414295445416
SIM,1822,36,25-29,1858,4
SIM,1892,17,35-39,1909,1
SIM,1836,41,35-39,1877,2
STAT,1865,27,40-44,1892,2.7626767882143
SIM,1848,76,na,1924,563
SIM,1860,27,40-44,1887,3
STAT,1856,6,na,1862,2284.2374743616956
STAT,1843,30,20-24,1873,2.2377405319296257
STAT,1935,24,40-44,1959,4.622863552132073
SIM,1940,15,25-29,1955,80
STAT,1935,32,40-44,1967,5.4700111661252455
SIM,1775,88,na,1863,52
STAT,1863,19,30-34,1882,1.463706518201121
SIM,1929,19,na,1948,4526
SIM,1850,21,15-19,1871,2
STAT,1844,19,20-24,1863,17.620709701843005
SIM,1883,24,30-34,1907,31
STAT,1828,41,35-39,1869,1.7587438619698263
SIM,1866,49,45-49,1915,1
STAT,1826,37,40-44,1863,5.060318806769434
SIM,1840,70,na,1910,917
SIM,1942,23,35-39,1965,16
STAT,1863,13,na,1876,2426.66823299629
STAT,1857,15,25-29,1872,5.312385821138461
STAT,1793,87,na,1880,56.76918102983072
SIM,1916,28,50-100,1944,2
STAT,1892,16,30-34,1908,2.0249982081679625
STAT,1857,16,50-100,1873,0.04565788013928812
SIM,1834,49,50-100,1883,4
SIM,1839,33,25-29,1872,2
STAT,1840,26,25-29,1866,37.24006388000062
STAT,1934,21,na,1955,4960.400643666426
SIM,1883,20,15-19,1903,2
STAT,1780,90,na,1870,25.79906520984037
SIM,1926,39,25-29,1965,1
STAT,1881,27,25-29,1908,41.183202141366266
STAT,1918,39,25-29,1957,1.0455019882072816
SIM,1865,46,na,1911,2030
SIM,1876,62,na,1938,2087
STAT,1842,21,15-19,1863,3.7734231601728503
STAT,1898,38,50-100,1936,0.36103721500070485
SIM,1873,22,20-24,1895,66
STAT,1876,15,35-39,1891,0.5748760630953693
SIM,1873,97,na,1970,30
SIM,1923,20,20-24,1943,148
STAT,1839,26,50-100,1865,0.5754709713506768
SIM,1879,7,na,1886,3063
STAT,1910,62,na,1972,3147.881918534661
STAT,1934,23,35-39,1957,12.781621966358095
SIM,1862,31,35-39,1893,8
STAT,1882,17,25-29,1899,5.544029986949522
STAT,1893,28,40-44,1921,3.8281128386523036
SIM,1869,27,na,1896,2314
STAT,1868,41,50-100,1909,1.0243976426597587
SIM,1833,99,na,1932,3
STAT,1909,39,50-100,1948,0.396986873715875
SIM,1888,28,25-29,1916,64
SIM,1832,29,45-49,1861,2
STAT,1946,22,15-19,1968,5.982909917630673
SIM,1917,39,50-100,1956,3
STAT,1764,104,na,1868,0.01710165921040579
STAT,1848,38,30-34,1886,4.4378598457315945
SIM,1863,65,na,1928,1496
SIM,1864,29,na,1893,2539
STAT,1838,78,na,1916,523.0448004795228
STAT,1860,25,25-29,1885,35.8117999499953
STAT,1858,24,30-34,1882,14.525745898689536
SIM,1817,41,25-29,1858,3
STAT,1837,49,25-29,1886,0.03975915853990835
STAT,1836,37,15-19,1873,0.04348192259525596
STAT,1951,19,15-19,1970,54.56489582538069
STAT,1826,49,50-100,1875,0.2355171640145493
STAT,1908,28,50-100,1936,0.9464879800435655
STAT,1884,82,na,1966,764.7501969030963
STAT,1930,26,50-100,1956,1.2797800211813857
STAT,1951,15,35-39,1966,5.051134235940313
SIM,1908,31,35-39,1939,12
SIM,1848,98,na,1946,1
SIM,1856,38,30-34,1894,10
STAT,1866,46,25-29,1912,0.054022340904624065
SIM,1884,32,25-29,1916,15
STAT,1876,32,25-29,1908,10.681427634380093
SIM,1866,36,25-29,1902,3
STAT,1898,24,25-29,1922,77.89051348168267
STAT,1929,35,20-24,1964,0.3426590716811805
SIM,1866,24,30-34,1890,34
SIM,1903,39,30-34,1942,2
SIM,1848,20,20-24,1868,1
SIM,1902,26,45-49,1928,4
STAT,1780,105,na,1885,0.01843273857466171
STAT,1928,26,15-19,1954,0.8821039768057979
SIM,1865,15,25-29,1880,7
STAT,1833,47,na,1880,1696.4299786634756
SIM,1931,22,20-24,1953,152
STAT,1899,42,20-24,1941,0.015268081658416277
SIM,1861,37,50-100,1898,4
STAT,1854,31,35-39,1885,7.864329789350252
SIM,1888,38,40-44,1926,8
STAT,1833,27,30-34,1860,23.567927314101706
STAT,1883,22,15-19,1905,3.260660780323212
STAT,1807,64,na,1871,856.1148834711871
STAT,1833,43,50-100,1876,0.8974422954957365
STAT,1858,44,25-29,1902,0.5019682786105588
STAT,1886,49,20-24,1935,0.012529530805740952
SIM,1939,26,40-44,1965,7
STAT,1841,38,35-39,1879,6.1673829029015215
STAT,1859,36,40-44,1895,3.5731164952169556
SIM,1847,24,20-24,1871,91
STAT,1915,20,20-24,1935,111.95983997352734
SIM,1934,21,35-39,1955,1
STAT,1843,16,35-39,1859,0.4757474185958455
STAT,1810,52,na,1862,1409.9076347917724
STAT,1830,40,na,1870,1735.810480716372
SIM,1871,39,25-29,1910,7
SIM,1867,9,na,1876,2518
STAT,1896,38,25-29,1934,3.8301674218620354
STAT,1927,22,40-44,1949,4.187118187758532
SIM,1804,54,na,1858,1379
SIM,1899,26,35-39,1925,19
SIM,1935,22,40-44,1957,4
STAT,1910,18,15-19,1928,9.048894625048984
SIM,1857,59,na,1916,1685
STAT,1831,49,30-34,1880,0.07047275685302018
STAT,1845,21,40-44,1866,1.9038920543794782
STAT,1897,37,15-19,1934,0.07603657857221219
STAT,1818,38,45-49,1856,4.585026465621743
STAT,1829,47,25-29,1876,0.042973972879790455
STAT,1932,32,15-19,1964,0.17263558257435965
STAT,1872,3,na,1875,3163.002024125497
STAT,1888,27,20-24,1915,13.985200130888172
STAT,1923,22,20-24,1945,130.7238954011889
SIM,1859,92,na,1951,46
SIM,1922,39,40-44,1961,4
STAT,1850,16,40-44,1866,0.17215456663002043
SIM,1853,21,40-44,1874,1
SIM,1943,24,40-44,1967,3
STAT,1869,93,na,1962,66.13105159816662
STAT,1876,10,na,1886,2742.9158909449548
STAT,1846,65,na,1911,1282.4870054778157
SIM,1852,71,na,1923,882
STAT,1879,24,15-19,1903,3.455403048627914
SIM,1858,33,na,1891,1932
STAT,1906,42,15-19,1948,0.001409026199448849
SIM,1867,20,30-34,1887,2
STAT,1827,33,40-44,1860,5.597100859709917
SIM,1822,83,na,1905,126
STAT,1862,33,35-39,1895,8.795757186786505
STAT,1869,25,45-49,1894,1.097668337309563
STAT,1939,20,na,1959,3704.9553124153117
STAT,1851,15,30-34,1866,1.4847579439855187
STAT,1866,48,40-44,1914,0.15810000567439222
STAT,1847,34,20-24,1881,2.117981792577561
SIM,1900,39,na,1939,3463
SIM,1924,32,30-34,1956,29
SIM,1850,69,na,1919,1160
SIM,1909,20,na,1929,3823
SIM,1930,27,na,1957,5045
SIM,1899,57,na,1956,2955
SIM,1797,89,na,1886,28
SIM,1866,44,25-29,1910,2
SIM,1859,50,na,1909,2063
SIM,1928,24,15-19,1952,6
SIM,1916,33,35-39,1949,11
STAT,1839,24,20-24,1863,61.877343682333596
STAT,1866,26,30-34,1892,23.63175346216684
STAT,1894,24,40-44,1918,2.6926874490111743
STAT,1908,33,35-39,1941,8.670746988116797
STAT,1898,16,25-29,1914,7.777990352759795
STAT,1800,74,na,1874,405.2094124069465
SIM,1890,9,na,1899,3520
SIM,1908,23,35-39,1931,13
SIM,1915,38,na,1953,4187
STAT,1844,28,45-49,1872,1.0676551401015972
SIM,1858,25,35-39,1883,13
STAT,1838,23,15-19,1861,2.8446702117888476
STAT,1950,20,15-19,1970,6.384535469684912
SIM,1892,34,25-29,1926,27
SIM,1891,51,na,1942,2745
SIM,1835,33,40-44,1868,8
SIM,1797,67,na,1864,671
SIM,1844,43,35-39,1887,3
STAT,1865,54,50-100,1919,0.013545574031170033
STAT,1861,21,25-29,1882,49.71556276727645
STAT,1916,32,30-34,1948,16.415171251069506
SIM,1852,28,na,1880,1958
SIM,1854,52,50-100,1906,1
STAT,1857,23,25-29,1880,51.71849529101641
STAT,1919,23,45-49,1942,1.240160773258523
STAT,1879,1,na,1880,3608.5689188200286
SIM,1889,21,20-24,1910,78
STAT,1922,4,na,1926,4718.927429090022
SIM,1846,10,na,1856,2225
SIM,1917,34,40-44,1951,4
STAT,1893,65,na,1958,2244.647231257725
SIM,1839,25,25-29,1864,38
SIM,1893,29,45-49,1922,4
SIM,1924,2,na,1926,4910
STAT,1850,17,na,1867,2147.8225772376877
STAT,1907,21,25-29,1928,85.16463187861075
STAT,1881,42,na,1923,2247.3728996059294
SIM,1847,37,40-44,1884,11
SIM,1932,22,15-19,1954,7
STAT,1908,20,15-19,1928,4.969529660329092
SIM,1837,82,na,1919,261
STAT,1873,24,20-24,1897,70.11844308409161
STAT,1917,44,40-44,1961,0.2626008005699246
STAT,1878,23,45-49,1901,0.72885100034297
STAT,1836,43,35-39,1879,1.341658816182843
SIM,1915,21,25-29,1936,2
SIM,1891,22,15-19,1913,4
STAT,1885,29,45-49,1914,1.1082517129431355
SIM,1910,25,40-44,1935,7
STAT,1863,99,na,1962,4.777074589664917
SIM,1834,21,30-34,1855,25
STAT,1887,42,50-100,1929,1.189836999833134
STAT,1913,15,15-19,1928,9.405678796804091
STAT,1862,16,45-49,1878,0.06564083449971958
SIM,1941,21,na,1962,3906
STAT,1851,32,20-24,1883,2.1302718981661783
SIM,1808,90,na,1898,27
SIM,1945,5,na,1950,4250
STAT,1855,48,na,1903,1672.2231338270174
SIM,1896,27,20-24,1923,22
SIM,1811,89,na,1900,78
SIM,1916,20,15-19,1936,8
STAT,1926,21,35-39,1947,11.596108275531149
STAT,1815,53,50-100,1868,0.03137785234927409
SIM,1841,27,30-34,1868,33
STAT,1909,34,40-44,1943,3.73609142119256
SIM,1935,33,45-49,1968,7
STAT,1835,71,na,1906,1001.8316513567825
SIM,1927,23,45-49,1950,2
STAT,1919,20,50-100,1939,0.7318287932174081
SIM,1829,36,20-24,1865,3
STAT,1775,113,na,1888,3.577090193920567E-4
STAT,1858,35,35-39,1893,5.657714576784672
SIM,1886,23,45-49,1909,4
STAT,1920,40,na,1960,4153.634008236019
SIM,1840,28,40-44,1868,3
SIM,1846,23,15-19,1869,7
SIM,1880,77,na,1957,843
STAT,1832,28,40-44,1860,2.7233867366219573
STAT,1858,41,20-24,1899,0.1264107177864453
SIM,1892,36,50-100,1928,2
SIM,1853,34,na,1887,1827
STAT,1843,79,na,1922,471.52397417309845
STAT,1886,41,na,1927,2475.8420399545125
STAT,1866,17,40-44,1883,0.17557601193025038
SIM,1824,32,na,1856,1671
STAT,1945,26,15-19,1971,0.7825178146502446
STAT,1883,26,30-34,1909,24.97448056654105
STAT,1912,49,50-100,1961,0.2180173381192888
SIM,1824,35,30-34,1859,5
SIM,1868,41,30-34,1909,3
STAT,1888,49,30-34,1937,0.06373408981331777
STAT,1942,25,35-39,1967,15.923646154840295
SIM,1887,56,na,1943,2157
SIM,1925,32,25-29,1957,20
STAT,1878,22,na,1900,2479.646497506582
STAT,1900,42,50-100,1942,0.10280124462689745
SIM,1826,31,25-29,1857,17
SIM,1924,15,40-44,1939,7
SIM,1880,26,20-24,1906,9
STAT,1842,110,na,1952,2.4879677936623504E-4
STAT,1926,30,25-29,1956,11.307904875701269
SIM,1872,16,na,1888,2805
STAT,1825,47,40-44,1872,0.22987865923743742
STAT,1874,24,15-19,1898,3.3904577513233667
SIM,1882,28,30-34,1910,23
SIM,1947,15,35-39,1962,6
SIM,1929,8,na,1937,4982
SIM,1832,51,na,1883,1350
SIM,1842,26,35-39,1868,7
STAT,1843,38,45-49,1881,1.4136122674511282
STAT,1812,47,50-100,1859,0.5664890317635134
SIM,1886,32,35-39,1918,18
STAT,1922,26,20-24,1948,20.938359153314952
STAT,1882,21,45-49,1903,0.6842825542930098
SIM,1944,18,na,1962,3923
STAT,1899,49,40-44,1948,0.13106721096992238
SIM,1851,38,45-49,1889,3
STAT,1911,39,15-19,1950,0.01852428421809647
SIM,1913,28,35-39,1941,18
SIM,1958,4,na,1962,5244
STAT,1816,49,40-44,1865,0.42967426412554616
STAT,1909,45,45-49,1954,0.20346561799976115
STAT,1783,87,na,1870,58.62020152442987
STAT,1878,32,35-39,1910,10.617770686404171
SIM,1874,1,na,1875,3279
STAT,1916,15,40-44,1931,0.3008701371400413
STAT,1849,48,50-100,1897,0.18961029384206024
STAT,1903,60,na,1963,2917.929515554386
SIM,1834,30,20-24,1864,4
SIM,1941,27,35-39,1968,32
STAT,1839,49,35-39,1888,0.0985708715952835
SIM,1911,3,na,1914,4186
SIM,1854,39,25-29,1893,8
SIM,1890,21,45-49,1911,1
STAT,1854,31,na,1885,1853.1267663672531
STAT,1889,28,40-44,1917,3.7175259719545037
STAT,1839,35,25-29,1874,2.4905350650084657
STAT,1811,69,na,1880,742.4036874335874
STAT,1905,28,35-39,1933,14.038776565824623
SIM,1904,53,na,1957,3296
STAT,1857,39,35-39,1896,5.5190784339945855
STAT,1933,27,35-39,1960,20.14455310342186
STAT,1823,39,30-34,1862,8.481625083587577
SIM,1796,72,na,1868,575
STAT,1854,38,20-24,1892,0.5756423137990786
STAT,1893,21,20-24,1914,88.64305611353616
SIM,1858,22,30-34,1880,21
SIM,1835,36,45-49,1871,3
STAT,1863,48,15-19,1911,3.534578810641606E-4
STAT,1935,35,45-49,1970,0.9647790274445484
STAT,1943,25,na,1968,4031.974841128234
STAT,1890,16,20-24,1906,21.93359632071028
SIM,1897,28,40-44,1925,5
SIM,1920,18,25-29,1938,1
STAT,1867,81,na,1948,514.3870529276097
STAT,1846,25,15-19,1871,0.4225739409365251
STAT,1855,37,25-29,1892,2.1672317283164397
STAT,1885,22,25-29,1907,57.55117296242684
SIM,1888,16,30-34,1904,2
STAT,1837,27,15-19,1864,0.3972721402340624
STAT,1846,39,25-29,1885,2.2348349688419487
STAT,1912,18,25-29,1930,8.817667264103276
STAT,1897,28,25-29,1925,57.07699049939617
STAT,1940,29,40-44,1969,4.793654780784204
SIM,1885,66,na,1951,1694
SIM,1846,43,45-49,1889,3
STAT,1914,39,40-44,1953,1.4928463782313628
STAT,1933,20,15-19,1953,7.177757144337196
SIM,1868,64,na,1932,1579
STAT,1911,26,45-49,1937,1.7055859494331955
SIM,1850,25,30-34,1875,35
STAT,1875,27,35-39,1902,10.008037305590115
STAT,1809,45,40-44,1854,0.6480052600468557
SIM,1894,31,30-34,1925,40
STAT,1860,51,40-44,1911,0.008733494484227097
STAT,1900,19,45-49,1919,0.09115671251429233
STAT,1853,29,15-19,1882,0.38987565293720366
SIM,1915,37,35-39,1952,3
STAT,1886,63,na,1949,1902.7695588589588
STAT,1919,36,15-19,1955,0.020848951309032627
SIM,1919,20,40-44,1939,3
STAT,1904,49,25-29,1953,0.04611007807878023
STAT,1861,28,45-49,1889,0.9318861324893231
SIM,1900,23,30-34,1923,35
STAT,1858,18,45-49,1876,0.06010721825564434
STAT,1952,20,25-29,1972,112.28485363174784
SIM,1921,23,na,1944,4073
SIM,1847,15,30-34,1862,2
SIM,1909,39,25-29,1948,1
STAT,1886,28,15-19,1914,0.48212214770755935
SIM,1849,82,na,1931,386
STAT,1869,34,35-39,1903,9.859218817115382
SIM,1877,22,40-44,1899,2
SIM,1879,38,25-29,1917,3
STAT,1800,84,na,1884,98.43157920992665
SIM,1877,34,35-39,1911,12
STAT,1843,37,40-44,1880,3.4467643728165114
STAT,1857,48,50-100,1905,0.19116030677668294
SIM,1861,31,na,1892,2071
SIM,1871,17,15-19,1888,9
SIM,1884,37,45-49,1921,1
SIM,1838,37,25-29,1875,4
STAT,1838,43,45-49,1881,1.0526615642658261
STAT,1827,36,45-49,1863,2.374372383573438
STAT,1874,28,30-34,1902,25.951187760060357
STAT,1878,44,na,1922,2390.5212968360856
SIM,1864,38,30-34,1902,9
STAT,1859,20,30-34,1879,16.736896641351834
STAT,1894,27,45-49,1921,1.4437664182747842
STAT,1892,38,40-44,1930,5.520438098402478
SIM,1831,25,20-24,1856,12
SIM,1827,40,30-34,1867,4
SIM,1831,39,30-34,1870,5
STAT,1863,17,15-19,1880,6.060086690388618
SIM,1929,24,30-34,1953,59
SIM,1865,37,35-39,1902,16
SIM,1883,27,35-39,1910,13
SIM,1911,23,na,1934,3786
STAT,1917,32,25-29,1949,9.769365086771197
STAT,1919,40,35-39,1959,0.22094065551698008
STAT,1839,48,30-34,1887,0.06903351352792035
STAT,1865,25,25-29,1890,39.27741454296553
SIM,1941,20,15-19,1961,8
STAT,1882,48,25-29,1930,0.055644744217708556
STAT,1857,35,50-100,1892,0.9769522180400246
STAT,1846,12,na,1858,2275.7836524875765
STAT,1842,39,40-44,1881,4.12077206439483
STAT,1890,17,25-29,1907,6.9936542761469775
STAT,1842,25,30-34,1867,28.44448665627878
STAT,1899,49,50-100,1948,0.18802632588028115
STAT,1932,40,na,1972,5100.942055123206
STAT,1862,48,50-100,1910,0.21152565819820046
SIM,1882,29,35-39,1911,13
SIM,1932,34,30-34,1966,40
STAT,1907,41,na,1948,3455.4992026534546
SIM,1831,26,25-29,1857,56
SIM,1902,27,20-24,1929,24
SIM,1930,26,20-24,1956,28
SIM,1874,81,na,1955,583
SIM,1878,21,45-49,1899,1
SIM,1845,31,35-39,1876,14
SIM,1851,37,40-44,1888,5
STAT,1875,15,40-44,1890,0.1905916718826368
SIM,1807,47,50-100,1854,1
STAT,1876,36,40-44,1912,4.5870197373618184
SIM,1879,42,45-49,1921,3
STAT,1908,46,40-44,1954,0.14501887835958352
STAT,1923,25,25-29,1948,76.87198215441569
SIM,1850,39,40-44,1889,3
STAT,1939,15,35-39,1954,4.250732100463668
STAT,1785,101,na,1886,0.13823153374503047
STAT,1871,23,35-39,1894,5.837368591635713
STAT,1874,29,35-39,1903,9.907500866034717
SIM,1919,19,na,1938,3947
SIM,1860,20,20-24,1880,73
STAT,1871,11,na,1882,2661.403909285154
STAT,1907,37,35-39,1944,2.264337131816582
STAT,1924,34,30-34,1958,18.550371043195305
STAT,1848,37,50-100,1885,1.0329938951032962
SIM,1836,32,na,1868,2015
SIM,1867,39,45-49,1906,2
STAT,1848,34,15-19,1882,0.12085217268348825
STAT,1849,43,20-24,1892,0.12327146350343113
STAT,1841,16,25-29,1857,5.497853388706819
SIM,1873,25,25-29,1898,43
SIM,1902,63,na,1965,2888
STAT,1833,69,na,1902,1038.2807220261852
SIM,1892,39,45-49,1931,4
STAT,1841,98,na,1939,2.4293063438275597
STAT,1852,23,25-29,1875,51.20422122411763
STAT,1827,39,15-19,1866,0.06234633466778033
STAT,1891,26,30-34,1917,31.597479807444515
STAT,1832,22,45-49,1854,1.0674185214613592
STAT,1907,30,15-19,1937,0.12225917124430762
STAT,1944,8,na,1952,4291.138140208233
STAT,1905,34,20-24,1939,2.246808318526316
SIM,1822,51,na,1873,1438
SIM,1914,25,25-29,1939,75
SIM,1912,29,30-34,1941,46
STAT,1819,40,30-34,1859,2.6351480658203683
SIM,1875,25,35-39,1900,11
STAT,1846,107,na,1953,0.003578866019949914
SIM,1838,45,na,1883,1751
STAT,1931,18,35-39,1949,5.536284493504971
STAT,1861,24,50-100,1885,0.3465761867440991
STAT,1925,26,50-100,1951,1.192179543848733
STAT,1833,79,na,1912,494.6140004688133
SIM,1843,35,40-44,1878,9
STAT,1941,26,30-34,1967,40.94045089906145
STAT,1921,29,30-34,1950,43.78966202383005
STAT,1906,25,25-29,1931,62.65195462240089
SIM,1854,61,na,1915,1694
STAT,1838,39,25-29,1877,2.2779151979092065
SIM,1834,37,40-44,1871,5
STAT,1809,108,na,1917,8.457963069598178E-4
STAT,1885,14,na,1899,2587.8886570997656
STAT,1839,15,30-34,1854,1.495785946969575
STAT,1835,35,40-44,1870,4.14873786322535
STAT,1936,20,40-44,1956,3.2475781395093652
SIM,1838,41,45-49,1879,1
STAT,1845,27,15-19,1872,0.4035118271666863
STAT,1873,36,15-19,1909,0.05777393029233716
SIM,1932,18,na,1950,5562
SIM,1848,27,40-44,1875,2
STAT,1873,38,30-34,1911,5.429938945035359
SIM,1860,23,25-29,1883,66
STAT,1886,31,30-34,1917,18.6950090988312
STAT,1862,27,15-19,1889,0.39718740781393674
STAT,1910,30,na,1940,3708.7677831086835
STAT,1856,15,30-34,1871,1.47671345410296
STAT,1926,37,45-49,1963,0.8420344823375492
STAT,1937,18,na,1955,3605.474217972235
SIM,1887,44,45-49,1931,7
SIM,1913,34,20-24,1947,2
STAT,1869,22,40-44,1891,2.046213779430818
SIM,1807,84,na,1891,153
STAT,1915,23,25-29,1938,96.04799760813027
SIM,1907,35,35-39,1942,6
STAT,1930,39,25-29,1969,1.2952989069051426
SIM,1859,21,35-39,1880,7
STAT,1842,26,35-39,1868,10.820796080845788
STAT,1875,20,15-19,1895,3.442221850195488
STAT,1900,19,na,1919,3524.45075630395
STAT,1911,19,20-24,1930,27.224041857160426
STAT,1887,37,20-24,1924,0.8692446240764147
STAT,1841,20,45-49,1861,0.6701844288472684
STAT,1856,29,40-44,1885,2.3692481474524767
STAT,1934,36,40-44,1970,2.0892423757777028
STAT,1955,16,30-34,1971,16.351401990509764
SIM,1855,17,30-34,1872,2
STAT,1899,19,45-49,1918,0.09006132708330583
STAT,1847,17,30-34,1864,1.4894671018134176
SIM,1928,39,35-39,1967,2
SIM,1865,36,30-34,1901,3
SIM,1872,26,na,1898,2578
STAT,1817,37,50-100,1854,4.6501442883138155
STAT,1858,49,45-49,1907,0.18309874873027912
STAT,1817,47,40-44,1864,0.36813520890124213
STAT,1870,35,50-100,1905,1.2292251099922993
STAT,1904,29,30-34,1933,36.23825297721955
SIM,1907,49,50-100,1956,1
STAT,1893,48,50-100,1941,0.1754355673286959
SIM,1853,12,na,1865,2163
STAT,1826,30,20-24,1856,4.321712987865596
STAT,1879,44,45-49,1923,1.556165754853476
STAT,1950,9,na,1959,4694.379420914547
SIM,1794,91,na,1885,43
SIM,1864,29,40-44,1893,3
STAT,1884,38,40-44,1922,4.338345469248612
STAT,1917,51,na,1968,3823.986690885699
SIM,1864,15,30-34,1879,4
SIM,1935,36,na,1971,5199
STAT,1814,87,na,1901,82.46322220045775
STAT,1878,31,50-100,1909,0.9645678135326843
STAT,1878,28,15-19,1906,0.4740121762218632
SIM,1803,91,na,1894,23
SIM,1934,37,45-49,1971,3
STAT,1920,17,20-24,1937,153.60355316854702
STAT,1845,30,30-34,1875,15.487119866748857
STAT,1840,17,na,1857,2083.3162116294084
STAT,1851,37,40-44,1888,3.3500871203804277
SIM,1836,30,50-100,1866,2
STAT,1830,72,na,1902,833.1820569462993
SIM,1923,23,25-29,1946,135
STAT,1931,24,20-24,1955,144.8404098719913
STAT,1864,43,50-100,1907,0.9558813838173001
SIM,1875,38,40-44,1913,10
STAT,1866,22,15-19,1888,3.110546969045621
SIM,1892,38,40-44,1930,6
STAT,1817,48,45-49,1865,0.49946722731292864
SIM,1881,38,30-34,1919,7
STAT,1916,35,35-39,1951,2.523383688496226
SIM,1854,83,na,1937,315
STAT,1832,37,30-34,1869,4.599048557548329
STAT,1883,27,35-39,1910,9.536724277552128
STAT,1841,47,25-29,1888,0.043269389336053246
STAT,1889,35,15-19,1924,0.07059874220370571
SIM,1900,26,35-39,1926,20
STAT,1914,24,20-24,1938,113.90099188101622
SIM,1891,27,35-39,1918,2
STAT,1822,47,15-19,1869,5.9307011803391E-4
SIM,1922,24,20-24,1946,207
SIM,1875,31,20-24,1906,1
SIM,1927,20,40-44,1947,7
STAT,1860,5,na,1865,2394.3849409492996
SIM,1874,22,15-19,1896,4
SIM,1912,41,na,1953,3466
SIM,1829,27,30-34,1856,26
STAT,1900,40,40-44,1940,0.22135361126597344
SIM,1840,37,30-34,1877,9
SIM,1917,30,25-29,1947,17
STAT,1872,15,15-19,1887,6.117743580833732
SIM,1908,20,30-34,1928,45
STAT,1947,17,35-39,1964,4.77455884769145
STAT,1867,38,40-44,1905,4.1433233220481895
STAT,1828,43,50-100,1871,0.9917963509330607
SIM,1824,36,35-39,1860,13
STAT,1847,37,25-29,1884,2.2366985079306057
STAT,1840,49,na,1889,1550.1565793128111
STAT,1951,0,na,1951,5281.139481558857
SIM,1874,26,30-34,1900,34
STAT,1915,36,30-34,1951,1.8667802763458337
SIM,1910,21,25-29,1931,142
SIM,1924,35,35-39,1959,7
SIM,1893,63,na,1956,2339
SIM,1905,35,25-29,1940,2
STAT,1884,39,45-49,1923,1.965519594330891
SIM,1903,18,25-29,1921,13
STAT,1873,5,na,1878,2829.30984328094
SIM,1891,26,30-34,1917,52
SIM,1853,30,30-34,1883,38
STAT,1897,32,45-49,1929,2.3612377865124996
STAT,1858,104,na,1962,0.18515765148461605
SIM,1819,41,35-39,1860,1
STAT,1836,30,50-100,1866,0.7459413097187282
STAT,1831,25,20-24,1856,10.803277954134142
STAT,1890,23,45-49,1913,0.8579476944760829
SIM,1823,37,30-34,1860,4
STAT,1855,32,50-100,1887,0.7022335992507265
STAT,1867,39,45-49,1906,1.8771633639734913
SIM,1896,18,30-34,1914,2
SIM,1905,38,na,1943,3553
STAT,1846,38,20-24,1884,0.6045787725943705
SIM,1859,34,40-44,1893,2
STAT,1834,97,na,1931,3.197711775417576
STAT,1856,27,25-29,1883,33.942660639639385
STAT,1783,103,na,1886,0.056530654349695744
STAT,1877,20,50-100,1897,0.42762656186070863
SIM,1934,30,25-29,1964,26
SIM,1885,20,25-29,1905,94
STAT,1868,37,45-49,1905,1.9242945222009256
SIM,1904,23,15-19,1927,4
STAT,1774,113,na,1887,3.1748574650297706E-4
STAT,1871,17,15-19,1888,5.993330670386611
STAT,1888,18,30-34,1906,1.8950921997497876
STAT,1909,38,20-24,1947,0.2505368881889786
STAT,1882,28,30-34,1910,24.549929325437162
STAT,1919,20,40-44,1939,3.739644861267604
SIM,1876,37,45-49,1913,2
SIM,1885,44,na,1929,2439
SIM,1890,28,30-34,1918,36
STAT,1823,32,45-49,1855,4.665481445553555
SIM,1923,36,30-34,1959,4
STAT,1902,21,25-29,1923,81.9510474901603
STAT,1857,32,15-19,1889,0.11294506031975296
SIM,1889,37,na,1926,2864
SIM,1839,22,20-24,1861,73
STAT,1878,44,50-100,1922,1.0926909352114613
STAT,1918,36,na,1954,4022.670119552342
SIM,1857,27,na,1884,2166
SIM,1864,27,25-29,1891,45
STAT,1928,0,na,1928,5737.695375650863
STAT,1816,38,35-39,1854,28.434534505468477
STAT,1849,30,na,1879,2003.31920776708
SIM,1884,39,45-49,1923,2
SIM,1939,22,25-29,1961,105
SIM,1872,27,25-29,1899,58
STAT,1856,31,45-49,1887,1.381121617794449
STAT,1857,36,30-34,1893,4.221229156068197
SIM,1799,90,na,1889,5
SIM,1883,33,20-24,1916,6
STAT,1872,29,25-29,1901,42.64674781289081
STAT,1909,30,25-29,1939,8.971769111129758
SIM,1869,32,35-39,1901,8
STAT,1889,26,25-29,1915,52.862734472245656
STAT,1933,15,40-44,1948,1.900860679574807
SIM,1912,25,15-19,1937,1
STAT,1907,34,30-34,1941,14.742598398577421
STAT,1833,23,15-19,1856,3.126502644921912
SIM,1797,57,na,1854,992
STAT,1808,47,40-44,1855,0.6252701718356087
STAT,1923,29,40-44,1952,5.368341517009156
SIM,1867,36,40-44,1903,5
STAT,1829,25,15-19,1854,1.1885702672060592
STAT,1917,47,45-49,1964,0.22914331415142908
STAT,1917,20,30-34,1937,31.017391893812253
STAT,1819,64,na,1883,933.0701229885262
STAT,1859,32,25-29,1891,8.320431883473985
STAT,1864,27,25-29,1891,38.5529724630112
STAT,1927,18,na,1945,4613.638054214005
STAT,1854,27,15-19,1881,0.35695255183115704
SIM,1869,59,na,1928,1852
SIM,1838,39,40-44,1877,7
STAT,1878,26,15-19,1904,0.47731902409172017
SIM,1910,29,20-24,1939,24
SIM,1930,37,na,1967,5236
STAT,1846,36,20-24,1882,0.6172656124123005
STAT,1936,16,20-24,1952,131.36326651386614
STAT,1871,96,na,1967,36.58003423975696
STAT,1875,33,20-24,1908,2.7918283515686113
SIM,1929,40,na,1969,4681
SIM,1808,47,na,1855,1260
SIM,1860,79,na,1939,577
STAT,1902,29,20-24,1931,16.62416052495286
STAT,1924,37,35-39,1961,2.8821084724737402
STAT,1831,27,20-24,1858,10.218775369369359
STAT,1832,32,50-100,1864,0.8155311433478911
STAT,1840,39,30-34,1879,4.327916811114856
STAT,1871,20,30-34,1891,17.979918245296425
STAT,1928,20,40-44,1948,4.268570875810009
SIM,1915,34,30-34,1949,32
STAT,1903,38,50-100,1941,0.37928527046431953
STAT,1932,36,30-34,1968,2.4769702430628464
SIM,1834,33,25-29,1867,17
SIM,1842,37,40-44,1879,1
STAT,1893,15,35-39,1908,0.7069567985136663
STAT,1840,50,na,1890,1531.0338817196462
SIM,1864,31,45-49,1895,2
SIM,1944,16,20-24,1960,159
SIM,1859,82,na,1941,324
SIM,1933,20,15-19,1953,11
SIM,1941,24,30-34,1965,61
STAT,1876,39,45-49,1915,2.057970403009291
SIM,1934,17,15-19,1951,69
STAT,1865,39,35-39,1904,6.457392741024385
STAT,1888,47,15-19,1935,4.746211988896696E-4
SIM,1932,5,na,1937,6059
STAT,1953,19,25-29,1972,52.92873752832272
STAT,1941,22,15-19,1963,5.5538649440067225
SIM,1863,12,na,1875,2597
SIM,1834,24,35-39,1858,7
SIM,1880,29,25-29,1909,44
SIM,1814,54,na,1868,1219
SIM,1879,35,20-24,1914,1
STAT,1937,5,na,1942,3948.8799253941816
SIM,1824,38,35-39,1862,12
STAT,1863,67,na,1930,1418.595216889142
SIM,1881,20,40-44,1901,6
STAT,1841,18,40-44,1859,0.1753681034126166
STAT,1861,25,40-44,1886,2.569143274148458
STAT,1880,15,na,1895,2691.3836657707607
SIM,1891,29,35-39,1920,17
SIM,1846,64,na,1910,1254
STAT,1833,49,40-44,1882,0.12630904883434269
SIM,1937,26,30-34,1963,58
STAT,1850,27,na,1877,1949.3059550946266
SIM,1883,6,na,1889,2971
STAT,1910,19,na,1929,3840.4078517493344
SIM,1873,39,35-39,1912,12
STAT,1883,29,35-39,1912,9.468563523865678
STAT,1934,32,25-29,1966,12.750926027305093
SIM,1832,37,30-34,1869,1
SIM,1874,27,35-39,1901,9
STAT,1851,39,40-44,1890,3.2812318045848876
STAT,1904,25,15-19,1929,0.6620664009862706
SIM,1890,45,na,1935,3120
STAT,1928,32,50-100,1960,1.0449425372602819
SIM,1929,27,35-39,1956,26
STAT,1895,19,50-100,1914,0.06427195792228471
STAT,1849,37,35-39,1886,5.658636199437921
SIM,1876,30,na,1906,2783
STAT,1897,25,20-24,1922,15.992844433194369
SIM,1936,20,40-44,1956,7
SIM,1861,53,na,1914,1816
SIM,1827,43,35-39,1870,3
STAT,1925,20,15-19,1945,6.477866786844698
STAT,1933,24,30-34,1957,38.49851272841017
STAT,1875,18,45-49,1893,0.06757612982999732
SIM,1883,38,40-44,1921,9
STAT,1842,28,35-39,1870,10.665967287132721
STAT,1926,17,15-19,1943,56.23552944419332
SIM,1873,38,30-34,1911,13
STAT,1898,20,45-49,1918,0.9604755656838414
SIM,1831,87,na,1918,90
SIM,1943,28,20-24,1971,18
STAT,1880,28,20-24,1908,12.399871802737799
SIM,1895,39,20-24,1934,1
STAT,1848,24,50-100,1872,0.3995927638892285
STAT,1904,23,na,1927,3417.3535699124877
SIM,1924,41,na,1965,4490
SIM,1947,21,20-24,1968,138
STAT,1900,16,40-44,1916,0.25724528185296686
SIM,1856,25,25-29,1881,51
STAT,1809,48,45-49,1857,0.8112320304353808
SIM,1850,28,35-39,1878,16
STAT,1918,35,45-49,1953,0.7323141490470495
STAT,1836,23,40-44,1859,1.7224343788338634
SIM,1932,37,35-39,1969,5
STAT,1943,16,50-100,1959,0.4012690843057796
SIM,1872,26,20-24,1898,14
STAT,1867,38,50-100,1905,1.1620632684717187
STAT,1929,26,30-34,1955,49.587227772967104
STAT,1913,36,20-24,1949,0.2637412535975514
SIM,1841,87,na,1928,104
STAT,1894,7,na,1901,3387.836787442415
STAT,1864,26,20-24,1890,10.728586016947848
STAT,1876,63,na,1939,1860.749091344349
STAT,1844,31,na,1875,2071.8926199682855
SIM,1911,17,20-24,1928,27
STAT,1896,16,15-19,1912,7.9535128594913065
STAT,1801,69,na,1870,751.828111456996
STAT,1826,33,25-29,1859,13.570028163011855
STAT,1935,28,20-24,1963,25.12757737158714
SIM,1786,72,na,1858,534
STAT,1903,17,20-24,1920,25.50095467914451
STAT,1908,42,25-29,1950,0.06669219777018849
STAT,1875,25,50-100,1900,0.6680015341292237
SIM,1827,72,na,1899,680
SIM,1906,23,25-29,1929,85
STAT,1804,99,na,1903,0.5871359850395136
STAT,1887,39,20-24,1926,0.8604960635750942
SIM,1889,28,40-44,1917,2
SIM,1857,37,35-39,1894,12
STAT,1814,49,30-34,1863,0.2257663121033246
STAT,1869,31,30-34,1900,17.214781889312338
STAT,1893,24,25-29,1917,72.95456145009693
STAT,1875,38,40-44,1913,4.517901968172855
STAT,1865,38,30-34,1903,4.89085553532222
SIM,1833,46,na,1879,1657
SIM,1867,32,25-29,1899,19
STAT,1858,15,40-44,1873,0.1713094965932361
STAT,1909,22,na,1931,3579.048503315013
STAT,1865,48,25-29,1913,0.052454466199293726
STAT,1939,21,20-24,1960,112.77267235289803
SIM,1854,36,20-24,1890,3
SIM,1800,101,na,1901,2
SIM,1868,44,35-39,1912,5
SIM,1832,38,35-39,1870,13
STAT,1898,38,35-39,1936,2.079904638747155
STAT,1928,21,45-49,1949,1.4242406319297427
STAT,1952,17,na,1969,4456.540710259603
SIM,1899,25,na,1924,3661
STAT,1846,97,na,1943,4.076913457398465
STAT,1810,84,na,1894,172.7720077675731
STAT,1831,35,na,1866,1728.1082521807098
STAT,1832,35,15-19,1867,0.04949690432966965
STAT,1921,28,50-100,1949,1.1164467197727248
SIM,1878,74,na,1952,1174
SIM,1875,38,50-100,1913,1
STAT,1844,26,50-100,1870,0.6240502807845562
SIM,1926,35,45-49,1961,1
STAT,1911,23,40-44,1934,3.207221618450125
SIM,1899,23,30-34,1922,47
SIM,1844,20,na,1864,1843
SIM,1936,21,45-49,1957,2
SIM,1931,25,25-29,1956,81
STAT,1859,23,35-39,1882,4.882979227646086
STAT,1786,101,na,1887,0.14482232153662575
SIM,1918,26,20-24,1944,18
SIM,1848,37,50-100,1885,1
SIM,1931,29,40-44,1960,5
STAT,1837,31,35-39,1868,8.752645470965108
STAT,1870,29,15-19,1899,0.4467607757611256
SIM,1884,81,na,1965,711
SIM,1838,34,20-24,1872,2
SIM,1877,31,30-34,1908,4
SIM,1866,20,15-19,1886,2
SIM,1935,29,25-29,1964,114
STAT,1874,26,30-34,1900,26.13223085192483
SIM,1913,32,50-100,1945,1
STAT,1824,38,35-39,1862,9.547688643998857
STAT,1830,49,15-19,1879,3.260161195612449E-4
STAT,1899,16,40-44,1915,0.2541540916799166
STAT,1905,32,50-100,1937,0.7681688346101861
SIM,1902,31,na,1933,3656
STAT,1893,11,na,1904,3316.858937706057
SIM,1929,29,na,1958,4526
STAT,1917,39,50-100,1956,0.43751036490839473
SIM,1921,39,25-29,1960,1
STAT,1850,27,30-34,1877,22.691211287610752
STAT,1764,95,na,1859,1.2896947865010249
STAT,1874,17,40-44,1891,0.18915643926891065
SIM,1914,22,20-24,1936,114
SIM,1911,24,45-49,1935,2
STAT,1829,64,na,1893,1025.0020265633927
SIM,1861,26,45-49,1887,4
STAT,1863,45,na,1908,2033.4318174308944
STAT,1900,25,30-34,1925,35.57017983629726
STAT,1944,22,40-44,1966,3.6659630745924234
SIM,1887,1,na,1888,3432
STAT,1837,25,15-19,1862,0.4030390026847333
STAT,1869,49,20-24,1918,0.011537471784901951
SIM,1850,79,na,1929,532
SIM,1894,26,na,1920,3543
SIM,1880,45,na,1925,2147
STAT,1834,32,20-24,1866,2.062036041660952
STAT,1825,49,40-44,1874,0.22359631024691148
STAT,1905,37,25-29,1942,0.9073761797908801
STAT,1852,20,20-24,1872,62.98686319468909
SIM,1928,21,45-49,1949,1
STAT,1843,90,na,1933,53.175423063104525
SIM,1847,49,na,1896,1631
SIM,1852,8,na,1860,2280
STAT,1934,19,15-19,1953,61.692998203860355
SIM,1860,90,na,1950,50
SIM,1865,39,35-39,1904,14
STAT,1926,34,40-44,1960,4.776188626216452
SIM,1864,24,20-24,1888,95
STAT,1877,26,na,1903,2496.3048383392274
STAT,1882,19,40-44,1901,0.17798312867125377
STAT,1848,25,25-29,1873,41.82958821146094
SIM,1890,17,25-29,1907,9
STAT,1891,29,35-39,1920,11.979538231184446
SIM,1841,65,na,1906,1165
SIM,1853,33,35-39,1886,7
STAT,1819,43,35-39,1862,3.760298988117322
STAT,1881,41,50-100,1922,1.0331788969567417
STAT,1927,29,25-29,1956,80.5524961872263
SIM,1857,48,50-100,1905,1
STAT,1831,28,25-29,1859,36.178960737628934
SIM,1865,78,na,1943,541
SIM,1871,15,15-19,1886,5
STAT,1898,37,30-34,1935,7.2973046309805865
STAT,1906,22,20-24,1928,101.37740959704205
SIM,1871,31,na,1902,2291
SIM,1879,59,na,1938,2251
STAT,1819,37,15-19,1856,0.16294244609631184
SIM,1905,39,40-44,1944,1
STAT,1907,28,45-49,1935,1.641035679325583
STAT,1865,34,15-19,1899,0.13021188278331056
SIM,1901,35,40-44,1936,4
SIM,1868,28,20-24,1896,9
SIM,1949,17,na,1966,4148
STAT,1822,101,na,1923,0.31904911161614613
SIM,1887,38,25-29,1925,3
SIM,1846,36,20-24,1882,3
SIM,1836,21,40-44,1857,3
SIM,1867,37,45-49,1904,1
STAT,1880,17,15-19,1897,6.294840302716933
SIM,1876,3,na,1879,3402
SIM,1882,26,30-34,1908,31
STAT,1864,0,na,1864,3486.2910956895203
STAT,1863,9,na,1872,2487.8581435562833
STAT,1867,36,40-44,1903,4.184018092878297
STAT,1914,15,30-34,1929,2.5557201774636793
STAT,1780,80,na,1860,214.04671463775338
SIM,1913,37,25-29,1950,5
STAT,1830,50,na,1880,1533.7745489202757
STAT,1860,16,35-39,1876,0.5255831438595763
SIM,1875,36,40-44,1911,3
SIM,1922,15,30-34,1937,15
SIM,1917,21,35-39,1938,9
SIM,1915,28,45-49,1943,3
STAT,1815,83,na,1898,171.84709060024147
STAT,1860,22,20-24,1882,58.651632256917416
STAT,1853,26,45-49,1879,1.0713799761425788
STAT,1936,23,45-49,1959,1.0856548549949028
STAT,1909,21,35-39,1930,8.857543646826972
SIM,1844,83,na,1927,147
SIM,1812,73,na,1885,471
SIM,1849,35,35-39,1884,11
STAT,1879,38,25-29,1917,3.019621335434461
STAT,1838,36,20-24,1874,0.6291644525274801
STAT,1847,48,30-34,1895,0.07156705901874749
SIM,1875,34,25-29,1909,14
SIM,1833,21,15-19,1854,4
STAT,1848,27,40-44,1875,2.9197674110133245
STAT,1925,16,45-49,1941,0.6113467494699713
STAT,1841,13,na,1854,2292.0
STAT,1862,29,15-19,1891,0.39290022063373065
STAT,1811,47,na,1858,1313.088296934703
SIM,1898,62,na,1960,2656
STAT,1913,59,na,1972,3402.1051941939145
STAT,1824,37,30-34,1861,7.432857725461781
STAT,1906,49,35-39,1955,0.11374982722514394
STAT,1931,27,25-29,1958,85.8817573063965
STAT,1877,24,40-44,1901,2.158612506755183
STAT,1898,25,50-100,1923,0.8818146335140824
SIM,1826,98,na,1924,6
STAT,1863,21,35-39,1884,5.364700998669865
STAT,1886,34,35-39,1920,10.7069718732697
SIM,1945,24,15-19,1969,6
SIM,1885,24,40-44,1909,2
STAT,1906,16,35-39,1922,0.809190446609044
SIM,1894,34,35-39,1928,1
STAT,1850,49,na,1899,1686.7647888015495
STAT,1928,36,na,1964,4810.184617975579
SIM,1923,27,40-44,1950,6
STAT,1867,31,20-24,1898,2.581716323764936
SIM,1859,30,25-29,1889,19
STAT,1856,18,35-39,1874,0.49944654257320314
STAT,1857,8,na,1865,2275.05623939491
STAT,1809,98,na,1907,1.5000102291931015
STAT,1841,110,na,1951,2.0664964024262673E-4
STAT,1845,33,35-39,1878,8.707396229414307
STAT,1838,37,25-29,1875,2.325716322501604
SIM,1914,16,35-39,1930,1
STAT,1824,87,na,1911,87.58842070395761
SIM,1931,22,50-100,1953,5
STAT,1891,28,30-34,1919,31.378573680681765
SIM,1859,60,na,1919,1799
SIM,1880,67,na,1947,1375
STAT,1846,53,50-100,1899,0.011277225655869435
SIM,1934,34,40-44,1968,1
SIM,1917,20,30-34,1937,2
STAT,1899,21,15-19,1920,4.586754418352216
SIM,1910,60,na,1970,2898
STAT,1921,38,20-24,1959,0.29697821603340196
SIM,1911,45,na,1956,3794
SIM,1842,32,20-24,1874,2
STAT,1857,37,35-39,1894,5.575190243955377
STAT,1865,26,na,1891,2208.5385848661945
SIM,1898,38,35-39,1936,8
SIM,1865,35,50-100,1900,1
SIM,1935,20,50-100,1955,1
STAT,1930,15,15-19,1945,59.57827309907839
STAT,1873,54,50-100,1927,0.01503860407111044
STAT,1823,53,50-100,1876,0.019614183693074647
STAT,1864,33,45-49,1897,1.582590347470327
STAT,1946,22,50-100,1968,0.739543956291963
SIM,1827,50,na,1877,1369
STAT,1834,26,35-39,1860,7.589745436902283
STAT,1915,32,15-19,1947,0.13206184485434547
STAT,1856,24,20-24,1880,61.088356997188335
SIM,1829,94,na,1923,14
STAT,1879,37,20-24,1916,0.8124745907399941
SIM,1895,44,na,1939,3094
SIM,1869,20,40-44,1889,3
SIM,1879,37,na,1916,2712
STAT,1908,29,15-19,1937,0.6688541316442058
STAT,1862,82,na,1944,406.96266882100326
SIM,1847,27,na,1874,1952
STAT,1937,24,15-19,1961,5.229653119956119
STAT,1782,103,na,1885,0.05506267420966769
STAT,1821,39,20-24,1860,1.345337317933961
SIM,1846,37,25-29,1883,2
STAT,1872,28,20-24,1900,11.870429162765143
STAT,1828,48,20-24,1876,0.010789374148161127
STAT,1829,42,na,1871,1537.9781058638841
SIM,1904,27,30-34,1931,50
STAT,1844,21,25-29,1865,56.9587571421187
STAT,1867,34,25-29,1901,9.659574203493593
STAT,1909,20,30-34,1929,27.116313819551554
STAT,1835,38,45-49,1873,1.8313616767683787
STAT,1960,5,na,1965,5171.916926189563
SIM,1843,38,45-49,1881,3
SIM,1907,19,na,1926,3935
STAT,1903,24,45-49,1927,0.9967574142523985
SIM,1852,21,25-29,1873,62
STAT,1882,59,na,1941,1901.3834207123446
STAT,1895,39,20-24,1934,1.0064886004802385
STAT,1925,22,30-34,1947,34.76822947351082
STAT,1847,46,15-19,1893,3.003448798517101E-4
SIM,1897,26,25-29,1923,8
STAT,1850,28,35-39,1878,8.632146297371223
SIM,1880,28,20-24,1908,16
STAT,1872,26,20-24,1898,11.953240755716303
STAT,1824,32,25-29,1856,19.993071421788834
STAT,1833,91,na,1924,40.997834625229814
STAT,1893,26,40-44,1919,3.854818875798793
STAT,1939,23,20-24,1962,112.69825467008907
STAT,1834,54,30-34,1888,0.0034937301502600843
STAT,1884,20,30-34,1904,17.84679756491468
SIM,1783,76,na,1859,402
SIM,1855,27,25-29,1882,8
SIM,1821,67,na,1888,831
STAT,1919,25,45-49,1944,1.8975210771688902
STAT,1835,46,45-49,1881,0.1891877667529756
STAT,1838,47,25-29,1885,0.039669290065146835
STAT,1829,86,na,1915,130.8266099325606
STAT,1852,43,40-44,1895,1.6935101288979373
STAT,1855,44,20-24,1899,0.11792828838417631
STAT,1870,48,50-100,1918,0.2405225606582358
STAT,1878,49,20-24,1927,0.012318766504522108
SIM,1834,35,40-44,1869,6
SIM,1902,19,na,1921,3796
STAT,1868,50,40-44,1918,0.010308279690850209
STAT,1931,8,na,1939,5276.02955610593
STAT,1936,22,40-44,1958,3.2453376964053855
STAT,1875,48,40-44,1923,0.1753404397773723
SIM,1872,34,20-24,1906,7
SIM,1883,22,30-34,1905,27
STAT,1876,29,45-49,1905,1.1495962484748452
STAT,1916,30,15-19,1946,0.1349641940821541
STAT,1881,54,50-100,1935,0.014299178250981278
STAT,1841,31,15-19,1872,0.13055831959949496
SIM,1944,22,40-44,1966,7
STAT,1827,33,50-100,1860,1.1825349370272706
STAT,1889,42,25-29,1931,0.7987540317261895
SIM,1823,34,25-29,1857,9
SIM,1853,17,20-24,1870,14
STAT,1885,77,na,1962,1089.791563558254
STAT,1898,35,30-34,1933,7.36660801730058
STAT,1845,17,20-24,1862,16.37271313367246
STAT,1891,23,25-29,1914,71.36319308952066
STAT,1826,35,40-44,1861,5.328320381042674
SIM,1861,95,na,1956,7
SIM,1950,20,15-19,1970,5
SIM,1813,48,na,1861,1350
SIM,1857,35,35-39,1892,18
STAT,1868,52,35-39,1920,0.008266006551673302
SIM,1840,31,20-24,1871,1
SIM,1852,26,45-49,1878,1
SIM,1892,28,40-44,1920,5
STAT,1858,33,35-39,1891,7.990687624965223
SIM,1890,25,25-29,1915,57
STAT,1850,37,25-29,1887,2.239552771455181
STAT,1893,39,45-49,1932,2.5307996991796253
STAT,1806,49,30-34,1855,0.2828110608669361
SIM,1883,11,na,1894,2934
SIM,1909,41,na,1950,3846
SIM,1927,25,45-49,1952,5
STAT,1870,31,40-44,1901,4.3186814678110625
STAT,1842,16,40-44,1858,0.21271592402986625
SIM,1947,23,20-24,1970,2
STAT,1849,35,35-39,1884,5.77738038018734
STAT,1866,32,30-34,1898,16.328896410481608
STAT,1884,28,40-44,1912,2.9730645203252486
STAT,1829,49,25-29,1878,0.041870047702552905
STAT,1873,34,15-19,1907,0.14456419093247574
STAT,1855,31,50-100,1886,0.7095633890597134
STAT,1912,45,30-34,1957,0.08684210408038344
STAT,1919,48,50-100,1967,0.24700844920021592
SIM,1832,32,25-29,1864,13
STAT,1843,52,30-34,1895,0.003993430048555438
STAT,1874,5,na,1879,2847.8613457142005
STAT,1846,46,20-24,1892,0.009132474325650496
STAT,1844,44,45-49,1888,1.182054767612156
STAT,1911,35,na,1946,3700.8779064435844
SIM,1928,24,na,1952,4632
STAT,1867,44,50-100,1911,0.9913556607568688
STAT,1943,6,na,1949,4254.614108589771
STAT,1815,41,15-19,1856,0.03725610405060381
STAT,1819,50,45-49,1869,0.02827710924160272
STAT,1960,4,na,1964,5173.003256873507
SIM,1853,76,na,1929,626
STAT,1886,41,45-49,1927,1.603228161012252
SIM,1880,78,na,1958,843
STAT,1847,27,25-29,1874,38.06889684612473
SIM,1885,43,45-49,1928,1
STAT,1824,55,na,1879,1125.2151839664002
SIM,1800,73,na,1873,514
STAT,1824,47,25-29,1871,0.06739860304158059
SIM,1938,25,20-24,1963,20
SIM,1866,38,40-44,1904,6
SIM,1846,29,25-29,1875,52
STAT,1798,85,na,1883,106.5102173004876
STAT,1877,43,45-49,1920,1.5488625717063038
STAT,1895,8,na,1903,3428.706277054519
STAT,1817,37,40-44,1854,16.580036391649102
STAT,1885,27,45-49,1912,1.1162296149594342
STAT,1910,45,50-100,1955,0.21390793887095713
STAT,1883,66,na,1949,1619.9506435906906
SIM,1823,46,na,1869,1501
SIM,1870,68,na,1938,1681
STAT,1832,31,20-24,1863,2.431914959924825
STAT,1829,54,20-24,1883,4.65267333225971E-4
STAT,1942,20,15-19,1962,5.639127179893246
SIM,1865,34,30-34,1899,4
STAT,1835,28,45-49,1863,1.0787061182312085
STAT,1876,51,30-34,1927,0.006237275111734743
SIM,1860,42,30-34,1902,4
STAT,1861,36,45-49,1897,1.6811464477338218
STAT,1833,30,25-29,1863,9.560743949723795
STAT,1851,29,40-44,1880,2.617752524135218
STAT,1849,40,30-34,1889,0.9145812341710818
STAT,1901,20,50-100,1921,0.5808180208086895
SIM,1881,17,25-29,1898,7
SIM,1947,18,25-29,1965,70
STAT,1878,50,50-100,1928,0.01606209892634367
SIM,1837,29,30-34,1866,22
STAT,1886,18,20-24,1904,18.85604916252324
STAT,1835,47,50-100,1882,0.19437721252835588
SIM,1920,22,50-100,1942,3
STAT,1880,53,45-49,1933,0.015146311241727634
SIM,1889,36,40-44,1925,1
STAT,1859,54,35-39,1913,0.006801129925782294
STAT,1886,19,na,1905,2678.8451423172296
SIM,1866,33,35-39,1899,15
SIM,1893,27,45-49,1920,1
SIM,1825,37,40-44,1862,6
STAT,1873,17,25-29,1890,5.802217484559043
SIM,1868,10,na,1878,2528
STAT,1877,50,35-39,1927,0.009103248285908042
SIM,1892,20,30-34,1912,40
STAT,1786,84,na,1870,111.26228830164104
STAT,1849,48,40-44,1897,0.13217134498968872
STAT,1832,39,30-34,1871,4.502135748438942
STAT,1852,25,40-44,1877,2.6844832408769332
STAT,1898,28,40-44,1926,4.087114893732991
STAT,1807,63,na,1870,888.6390735636157
STAT,1865,29,40-44,1894,2.742931420035838
SIM,1909,21,na,1930,3884
STAT,1875,47,na,1922,2322.6949501064055
STAT,1870,33,35-39,1903,10.00151971876464
SIM,1802,84,na,1886,76
STAT,1882,25,25-29,1907,41.66626493676246
STAT,1818,36,45-49,1854,6.475586601055662
STAT,1882,30,20-24,1912,2.6657880600281274
SIM,1840,39,30-34,1879,2
SIM,1875,49,45-49,1924,3
STAT,1892,15,40-44,1907,0.232884541123553
STAT,1855,39,25-29,1894,2.1454195049556075
STAT,1827,51,35-39,1878,0.008696230385714128
STAT,1816,68,na,1884,893.1725028953218
STAT,1867,49,45-49,1916,0.2198012280196021
STAT,1835,51,40-44,1886,0.008216792531459823
STAT,1856,42,50-100,1898,0.8170524008935218
STAT,1858,99,na,1957,2.072449319228763
STAT,1884,46,40-44,1930,0.1709984661935432
STAT,1829,36,20-24,1865,0.642212978960207
STAT,1767,93,na,1860,5.107581704982072
STAT,1884,36,50-100,1920,1.2287111836039561
STAT,1863,46,50-100,1909,0.2204089367350317
STAT,1796,74,na,1870,436.8030983392073
SIM,1862,49,na,1911,2012
STAT,1894,42,35-39,1936,0.16331147128494589
STAT,1894,38,na,1932,3048.3651777524738
STAT,1896,27,20-24,1923,15.684025959832168
SIM,1910,38,na,1948,3356
SIM,1919,30,35-39,1949,21
SIM,1839,37,40-44,1876,5
SIM,1890,30,20-24,1920,5
STAT,1925,39,50-100,1964,0.5081832888248563
SIM,1826,36,45-49,1862,2
SIM,1873,33,25-29,1906,2
STAT,1812,54,na,1866,1237.9692256604137
STAT,1815,82,na,1897,201.97345047275806
STAT,1890,24,na,1914,2900.5778370620897
STAT,1771,115,na,1886,1.5175455038435437E-4
STAT,1849,28,45-49,1877,1.0216551121932664
SIM,1910,2,na,1912,3887
STAT,1885,42,40-44,1927,2.258497847765059
STAT,1918,37,50-100,1955,0.44677244483220546
SIM,1820,93,na,1913,8
STAT,1834,24,35-39,1858,4.581646187015615
STAT,1843,27,40-44,1870,2.4864769692138102
SIM,1814,85,na,1899,105
STAT,1891,30,15-19,1921,0.1795091041365066
STAT,1923,36,na,1959,4408.512072655672
STAT,1838,52,20-24,1890,4.913530513315911E-4
STAT,1866,27,50-100,1893,0.5982611579434527
STAT,1956,15,20-24,1971,181.32537299270152
STAT,1810,50,25-29,1860,0.013513737771629177
STAT,1850,52,20-24,1902,5.620270969320083E-4
STAT,1929,43,50-100,1972,0.15353187571659221
STAT,1801,90,na,1891,31.37700350533804
STAT,1834,21,30-34,1855,14.340533816656201
SIM,1888,26,25-29,1914,71
STAT,1840,32,50-100,1872,0.7822887089885496
STAT,1860,27,40-44,1887,2.499716848636722
STAT,1874,30,15-19,1904,0.1484603638614301
SIM,1847,39,40-44,1886,2
STAT,1848,41,25-29,1889,0.5304010478706324
STAT,1852,82,na,1934,353.8523577643857
SIM,1873,96,na,1969,41
STAT,1942,19,na,1961,3881.095106310741
SIM,1849,46,40-44,1895,3
SIM,1842,21,30-34,1863,23
SIM,1951,20,na,1971,4569
SIM,1878,37,20-24,1915,1
STAT,1871,30,45-49,1901,1.7638584910468524
SIM,1872,19,25-29,1891,12
STAT,1864,19,25-29,1883,5.279896194350115
SIM,1873,30,20-24,1903,2
STAT,1888,43,20-24,1931,0.18795524434254665
SIM,1833,24,40-44,1857,1
STAT,1817,38,50-100,1855,4.080105893685982
STAT,1820,73,na,1893,604.5925657545125
STAT,1844,51,35-39,1895,0.006843941329189344
SIM,1906,17,25-29,1923,14
STAT,1930,38,na,1968,4954.906089215257
STAT,1821,90,na,1911,47.224863314400295
SIM,1945,20,35-39,1965,15
STAT,1874,52,50-100,1926,0.015535957826946068
STAT,1885,47,50-100,1932,0.24575983336376175
SIM,1968,0,na,1968,5203
STAT,1834,47,40-44,1881,0.10812835148688597
STAT,1915,17,na,1932,4078.9311676185353
SIM,1829,31,na,1860,1852
SIM,1870,32,45-49,1902,3
STAT,1881,29,25-29,1910,40.88885808616648
SIM,1847,7,na,1854,2341
SIM,1857,28,45-49,1885,4
SIM,1898,36,35-39,1934,11
STAT,1820,35,45-49,1855,5.614360078372017
STAT,1856,44,na,1900,1765.5422731873023
STAT,1859,47,45-49,1906,0.1908174284295473
STAT,1903,37,50-100,1940,0.3811759029429165
SIM,1893,42,40-44,1935,3
STAT,1813,71,na,1884,669.3032311758851
STAT,1835,53,35-39,1888,0.006458391135500617
STAT,1896,45,20-24,1941,0.009139839908456229
STAT,1818,51,40-44,1869,0.018368092029087287
SIM,1894,18,20-24,1912,29
SIM,1851,85,na,1936,218
STAT,1870,16,45-49,1886,0.06579075257218263
STAT,1879,45,20-24,1924,0.012774093471514604
STAT,1899,31,30-34,1930,24.300723661823895
STAT,1825,39,40-44,1864,6.662476563737755
STAT,1922,19,na,1941,4280.29427141418
STAT,1835,27,na,1862,2115.9544208169477
STAT,1840,35,15-19,1875,0.047534564490427214
STAT,1915,2,na,1917,4305.122353222534
STAT,1900,63,na,1963,2690.7787226938663
SIM,1875,12,na,1887,2551
STAT,1860,41,25-29,1901,0.532580848518261
STAT,1767,101,na,1868,0.10313550194001733
STAT,1857,34,30-34,1891,13.64469401125805
STAT,1894,40,40-44,1934,2.954325344149147
SIM,1907,20,15-19,1927,6
SIM,1933,6,na,1939,5135
SIM,1806,66,na,1872,921
SIM,1827,27,20-24,1854,8
STAT,1903,47,30-34,1950,0.07817588833272852
STAT,1848,37,40-44,1885,3.6831279442673934
SIM,1857,40,30-34,1897,1
SIM,1811,57,na,1868,1270
STAT,1820,34,35-39,1854,32.04594351211412
STAT,1928,30,35-39,1958,11.562588270683506
STAT,1837,17,50-100,1854,0.06614291792125544
STAT,1840,15,20-24,1855,16.28143533954602
SIM,1791,63,na,1854,710
SIM,1833,39,40-44,1872,7
STAT,1882,32,15-19,1914,0.13932420119311295
SIM,1896,25,20-24,1921,21
SIM,1947,15,na,1962,4500
SIM,1852,44,45-49,1896,3
STAT,1837,48,20-24,1885,0.008389962639940329
STAT,1839,39,40-44,1878,3.6325308314447264
STAT,1844,63,na,1907,1411.713327143226
STAT,1848,19,40-44,1867,0.18294576239876983
STAT,1948,16,25-29,1964,50.112389305295444
STAT,1843,46,na,1889,1529.8456644825665
STAT,1855,29,25-29,1884,32.7142157422285
SIM,1863,66,na,1929,1430
STAT,1880,20,45-49,1900,0.7440695228786441
STAT,1850,22,25-29,1872,52.61157386993732
STAT,1834,37,40-44,1871,3.2427710624652173
STAT,1891,38,25-29,1929,3.582515425523003
STAT,1887,36,na,1923,2669.4949883467925
STAT,1937,20,35-39,1957,9.26315817754947
SIM,1830,48,na,1878,1374
SIM,1855,47,na,1902,1903
STAT,1847,28,na,1875,1932.8434259886221
STAT,1838,79,na,1917,467.9995656770578
STAT,1888,25,20-24,1913,14.080080320649826
STAT,1838,29,25-29,1867,35.50602168265325
STAT,1853,41,35-39,1894,1.5042763331133686
STAT,1839,46,30-34,1885,0.07082524687675287
STAT,1859,52,40-44,1911,0.00850645761396684
STAT,1855,27,na,1882,1872.43259000912
STAT,1851,13,na,1864,2187.7173725633047
SIM,1944,4,na,1948,4365
SIM,1816,39,40-44,1855,4
SIM,1831,33,20-24,1864,2
SIM,1819,84,na,1903,128
SIM,1888,62,na,1950,2284
STAT,1857,27,40-44,1884,2.4321101257700444
STAT,1928,23,45-49,1951,1.415566010794665
SIM,1842,49,na,1891,1583
STAT,1876,52,40-44,1928,0.010920239802572796
STAT,1864,83,na,1947,361.8088559523221
SIM,1893,37,45-49,1930,2
STAT,1864,63,na,1927,1626.192007378192
SIM,1842,29,na,1871,1943
STAT,1843,45,40-44,1888,0.11791353411893711
SIM,1879,8,na,1887,3063
SIM,1843,66,na,1909,1532
STAT,1805,52,na,1857,1375.57701652136
SIM,1850,48,na,1898,1864
STAT,1847,42,20-24,1889,0.11957238039995431
SIM,1891,26,50-100,1917,2
STAT,1797,68,na,1865,733.5424346640369
STAT,1876,47,45-49,1923,0.2449635525767578
STAT,1840,33,20-24,1873,2.28402614995887
STAT,1844,26,45-49,1870,1.0831533835326366
STAT,1949,4,na,1953,4651.409667082036
SIM,1863,29,25-29,1892,45
SIM,1875,3,na,1878,2904
STAT,1948,23,15-19,1971,6.1722522696488875
SIM,1817,38,45-49,1855,4
SIM,1799,79,na,1878,403
STAT,1818,53,35-39,1871,0.014433475369667676
STAT,1852,50,na,1902,1656.4111446202176
STAT,1811,44,35-39,1855,4.762233653894739
STAT,1823,33,20-24,1856,6.260857507569967
STAT,1914,43,50-100,1957,0.11726483177605662
STAT,1861,40,30-34,1901,0.9746298150499835
STAT,1896,47,15-19,1943,3.002473792310095E-4
SIM,1924,42,na,1966,4481
STAT,1929,21,na,1950,4681.701657911505
SIM,1884,29,45-49,1913,1
SIM,1916,23,na,1939,3811
SIM,1792,69,na,1861,618
STAT,1845,36,50-100,1881,0.9524073511763642
STAT,1890,24,20-24,1914,84.51667842800522
STAT,1892,59,na,1951,2463.1060148840174
SIM,1919,51,na,1970,3835
STAT,1948,12,na,1960,4541.199335082801
STAT,1885,44,35-39,1929,1.79590635219523
STAT,1850,18,40-44,1868,0.17013255823855977
STAT,1856,64,na,1920,1346.0913328279057
SIM,1939,21,20-24,1960,112
SIM,1898,29,45-49,1927,1
STAT,1857,49,50-100,1906,0.18955073699362332
STAT,1840,28,25-29,1868,36.707216377353
SIM,1858,5,na,1863,2420
STAT,1826,38,45-49,1864,2.2395618379537803
STAT,1829,39,25-29,1868,2.2822700590762848
STAT,1891,22,15-19,1913,4.125357598156378
SIM,1908,30,30-34,1938,16
STAT,1818,46,45-49,1864,0.4265187359948764
STAT,1819,39,15-19,1858,0.13558832660192524
SIM,1883,25,35-39,1908,14
STAT,1885,50,40-44,1935,0.010735937472918932
SIM,1938,28,25-29,1966,90
STAT,1860,19,40-44,1879,0.1721169043189399
STAT,1876,26,40-44,1902,3.1346230829437167
SIM,1870,17,20-24,1887,16
SIM,1857,70,na,1927,1261
SIM,1929,41,na,1970,4677
STAT,1820,42,35-39,1862,3.4166754306736826
SIM,1841,37,25-29,1878,3
STAT,1936,25,45-49,1961,1.670630157582216
STAT,1939,26,25-29,1965,66.83005435527414
STAT,1868,53,45-49,1921,0.013783776098437403
SIM,1861,34,45-49,1895,3
SIM,1835,26,45-49,1861,5
STAT,1835,43,40-44,1878,1.9978261465489593
SIM,1843,43,40-44,1886,4
SIM,1878,29,20-24,1907,11
SIM,1912,3,na,1915,4042
STAT,1872,51,45-49,1923,0.014806715487567262
STAT,1839,25,25-29,1864,38.32981083079872
SIM,1855,24,20-24,1879,69
SIM,1898,26,40-44,1924,4
STAT,1774,95,na,1869,1.6062856786119155
STAT,1858,48,40-44,1906,0.13395205321192175
STAT,1917,26,50-100,1943,1.0572576083392946
STAT,1856,38,50-100,1894,0.9459825530659646
STAT,1862,17,20-24,1879,17.70999615062082
SIM,1848,38,45-49,1886,9
SIM,1860,78,na,1938,656
STAT,1882,49,na,1931,2155.1684101700916
STAT,1830,39,20-24,1869,0.6811817708199955
SIM,1918,34,na,1952,4143
STAT,1850,25,30-34,1875,23.020600341315006
STAT,1840,25,20-24,1865,10.402475141460231
STAT,1891,19,40-44,1910,0.22748972687031355
STAT,1846,49,25-29,1895,0.042799100501206146
STAT,1914,44,50-100,1958,0.1170596183204485
SIM,1938,20,15-19,1958,4
STAT,1878,39,20-24,1917,0.8000660190795359
SIM,1799,91,na,1890,5
STAT,1844,43,35-39,1887,1.4486319166462898
STAT,1898,36,40-44,1934,6.0225633111917976
SIM,1877,78,na,1955,795
STAT,1885,37,45-49,1922,2.0041273897687204
SIM,1831,33,na,1864,1784
STAT,1882,22,20-24,1904,67.42037071837443
SIM,1925,26,50-100,1951,1
STAT,1847,83,na,1930,297.23886288497783
STAT,1865,33,25-29,1898,9.406439922737876
STAT,1847,44,15-19,1891,0.010200361123260676
SIM,1855,37,25-29,1892,3
SIM,1875,23,35-39,1898,6
SIM,1835,47,na,1882,1403
SIM,1882,23,25-29,1905,57
STAT,1849,34,50-100,1883,0.7393592580110562
STAT,1902,48,25-29,1950,0.04579070385134079
SIM,1834,38,45-49,1872,2
STAT,1873,35,25-29,1908,2.9760354120151837
STAT,1873,41,50-100,1914,1.0866056841338272
SIM,1894,40,35-39,1934,3
STAT,1886,40,35-39,1926,1.9505240211182309
STAT,1783,102,na,1885,0.09020801115371047
SIM,1826,28,45-49,1854,1
STAT,1823,41,20-24,1864,0.24159744402217306
STAT,1876,54,35-39,1930,0.00873101037922674
SIM,1904,22,na,1926,3513
SIM,1871,85,na,1956,294
SIM,1895,12,na,1907,3431
STAT,1866,54,25-29,1920,0.0032215113478125533
STAT,1894,17,45-49,1911,0.08494116345972542
SIM,1911,55,na,1966,3658
STAT,1919,22,40-44,1941,3.717464351841599
STAT,1893,29,45-49,1922,1.4137219056036285
SIM,1890,22,20-24,1912,5
STAT,1935,37,na,1972,5315.119203362634
SIM,1927,22,40-44,1949,5
STAT,1849,31,na,1880,1982.6249203508455
STAT,1890,32,20-24,1922,3.336009219247513
STAT,1875,25,35-39,1900,10.075935116834078
SIM,1939,23,15-19,1962,5
STAT,1859,37,45-49,1896,1.6193801708676152
STAT,1894,35,45-49,1929,2.6168197175624353
STAT,1859,30,50-100,1889,0.7551411427866871
SIM,1863,11,na,1874,2614
SIM,1901,57,na,1958,2934
STAT,1856,105,na,1961,0.0713464253468746
SIM,1843,25,40-44,1868,4
STAT,1880,15,15-19,1895,6.324087048803968
STAT,1880,50,40-44,1930,0.011327259776230478
SIM,1835,44,45-49,1879,3
STAT,1836,27,20-24,1863,9.576264418612002
STAT,1852,28,45-49,1880,0.9737225363199635
SIM,1852,43,35-39,1895,3
SIM,1859,61,na,1920,1799
SIM,1885,40,40-44,1925,5
SIM,1838,51,50-100,1889,1
STAT,1846,98,na,1944,2.465268798554278
STAT,1842,84,na,1926,299.50822842248994
STAT,1810,83,na,1893,206.17922809596178
STAT,1815,42,25-29,1857,1.6654699122053673
STAT,1885,19,45-49,1904,0.06531899744333716
SIM,1867,25,na,1892,2180
SIM,1867,48,na,1915,1964
STAT,1857,81,na,1938,426.25455504739796
STAT,1817,53,na,1870,1204.2827056723067
SIM,1849,33,35-39,1882,17
SIM,1860,28,45-49,1888,1
STAT,1827,44,45-49,1871,1.555723880020743
STAT,1910,47,20-24,1957,0.010402567986341272
STAT,1913,33,50-100,1946,0.8264710851927985
SIM,1878,64,na,1942,1932
SIM,1829,29,25-29,1858,53
SIM,1898,33,30-34,1931,36
STAT,1807,47,25-29,1854,0.20743612497020608
SIM,1919,23,45-49,1942,1
STAT,1928,15,45-49,1943,0.6391657426145855
STAT,1840,18,25-29,1858,5.112762942314526
SIM,1930,38,na,1968,5242
STAT,1791,75,na,1866,371.6454627682718
STAT,1831,49,50-100,1880,0.1788027793222168
STAT,1877,40,40-44,1917,2.36835643113576
STAT,1852,109,na,1961,0.0018001055817349846
STAT,1874,38,25-29,1912,2.9628666811677715
STAT,1821,35,na,1856,1742.654596193045
SIM,1844,52,na,1896,1418
SIM,1876,27,45-49,1903,4
STAT,1832,41,15-19,1873,0.011688206069438772
SIM,1832,24,25-29,1856,54
SIM,1944,25,45-49,1969,2
SIM,1947,15,20-24,1962,175
SIM,1837,39,25-29,1876,4
STAT,1842,24,40-44,1866,2.3324882221812864
SIM,1888,19,35-39,1907,2
STAT,1831,45,na,1876,1555.3860926438758
STAT,1861,11,na,1872,2313.3641762476545
SIM,1894,58,na,1952,2749
STAT,1910,18,na,1928,3850.998096514751
STAT,1933,26,na,1959,5028.687821659098
SIM,1868,43,45-49,1911,3
SIM,1844,27,20-24,1871,10
STAT,1888,38,25-29,1926,3.415300259431717
SIM,1842,29,40-44,1871,5
SIM,1822,38,25-29,1860,3
SIM,1832,28,40-44,1860,2
STAT,1824,31,15-19,1855,0.3238131340697141
STAT,1814,45,15-19,1859,9.97731030221336E-4
STAT,1918,21,35-39,1939,10.28347312593737
SIM,1882,38,25-29,1920,3
STAT,1849,43,35-39,1892,1.405562643091692
STAT,1849,105,na,1954,0.02292445148496419
STAT,1839,43,25-29,1882,0.4737283120668368
STAT,1832,34,25-29,1866,8.922531176372075
SIM,1852,36,45-49,1888,3
SIM,1847,25,25-29,1872,9
SIM,1926,21,35-39,1947,14
STAT,1881,36,15-19,1917,0.054933271971491976
STAT,1947,25,20-24,1972,20.878051941634805
STAT,1861,33,40-44,1894,3.6243603140377556
STAT,1856,40,20-24,1896,0.12421715203157009
STAT,1879,53,20-24,1932,7.652790203126551E-4
SIM,1813,91,na,1904,8
SIM,1896,38,25-29,1934,6
STAT,1834,29,40-44,1863,2.3058590040041587
STAT,1881,26,20-24,1907,11.46053075546665
STAT,1916,20,15-19,1936,5.662698390534959
SIM,1871,28,20-24,1899,1
STAT,1866,28,45-49,1894,1.0347365061477536
STAT,1844,36,45-49,1880,1.850636672091998
SIM,1812,74,na,1886,415
SIM,1840,34,25-29,1874,22
SIM,1890,44,na,1934,3106
STAT,1824,35,30-34,1859,7.882847475748045
STAT,1852,46,45-49,1898,0.17948865835205008
STAT,1863,28,20-24,1891,10.461401506215319
STAT,1865,57,na,1922,1853.394252058683
STAT,1896,48,25-29,1944,0.04289236749449447
SIM,1865,77,na,1942,615
STAT,1845,17,na,1862,2119.894617791007
STAT,1888,45,15-19,1933,4.815982041548373E-4
SIM,1850,24,40-44,1874,2
SIM,1873,29,40-44,1902,9
STAT,1851,65,na,1916,1279.61898774576
STAT,1855,36,20-24,1891,0.5830267227830851
STAT,1837,30,na,1867,1892.556438173727
STAT,1834,65,na,1899,1005.9138713857697
STAT,1881,31,na,1912,2332.7241969801653
SIM,1898,72,na,1970,2081
STAT,1859,104,na,1963,0.22117200023387024
STAT,1839,50,50-100,1889,0.010973868256807953
STAT,1874,93,na,1967,104.89147490308314
STAT,1916,34,na,1950,3906.7568331764255
STAT,1866,36,25-29,1902,2.705679185056595
STAT,1893,76,na,1969,1635.0652642374578
STAT,1930,25,50-100,1955,1.2803177546383346
STAT,1829,28,20-24,1857,13.166180511622313
STAT,1842,49,40-44,1891,0.15091903782213464
STAT,1871,19,15-19,1890,5.922937156316408
STAT,1892,44,25-29,1936,0.055753004194296206
STAT,1845,40,45-49,1885,1.14250991776216
STAT,1857,17,40-44,1874,0.16945214071418874
STAT,1910,46,50-100,1956,0.2134352023260522
SIM,1832,35,30-34,1867,1
STAT,1864,42,20-24,1906,0.1445619616187035
STAT,1875,22,30-34,1897,18.47521153559019
STAT,1829,29,30-34,1858,25.16136100020029
STAT,1857,38,na,1895,1847.8745000157185
SIM,1871,46,50-100,1917,2
STAT,1955,14,na,1969,5266.224919279356
STAT,1870,48,na,1918,2203.3284406657026
SIM,1857,25,40-44,1882,5
STAT,1898,43,30-34,1941,0.10852158121009936
SIM,1850,23,30-34,1873,23
SIM,1872,79,na,1951,578
STAT,1844,18,45-49,1862,0.06530990066114352
STAT,1891,15,25-29,1906,7.119043484238158
SIM,1917,40,na,1957,3760
STAT,1912,20,na,1932,3711.7974492348094
STAT,1911,49,30-34,1960,0.08464469635066771
STAT,1808,49,na,1857,1238.9213823409182
SIM,1837,28,20-24,1865,8
STAT,1926,20,30-34,1946,35.500102920457444
STAT,1870,26,45-49,1896,1.1049645607471978
STAT,1854,25,15-19,1879,0.39794959577201716
SIM,1874,36,25-29,1910,3
SIM,1840,16,25-29,1856,9
STAT,1863,38,20-24,1901,0.6864032505429883
STAT,1881,16,20-24,1897,17.302276357972218
STAT,1853,42,45-49,1895,1.2361625080381298
SIM,1888,36,25-29,1924,4
SIM,1836,64,na,1900,1228
STAT,1825,53,25-29,1878,0.004493174596887693
STAT,1835,25,40-44,1860,2.9739154514870423
STAT,1883,24,30-34,1907,17.494938742319246
SIM,1939,24,25-29,1963,139
SIM,1860,38,45-49,1898,1
STAT,1863,46,na,1909,2019.075788799833
STAT,1832,26,25-29,1858,39.28600898906724
STAT,1876,44,40-44,1920,2.3139796796885843
SIM,1820,40,35-39,1860,4
STAT,1815,39,30-34,1854,16.010113943576478
STAT,1855,26,20-24,1881,9.270896832178668
STAT,1888,46,25-29,1934,0.06886058675993738
STAT,1852,38,45-49,1890,1.5043455163945176
SIM,1884,44,40-44,1928,4
SIM,1841,30,25-29,1871,19
STAT,1850,48,na,1898,1701.08794933495
STAT,1868,45,45-49,1913,0.23007980043662085
STAT,1860,37,40-44,1897,3.6141825768909945
STAT,1896,19,20-24,1915,23.574542422435485
STAT,1849,25,40-44,1874,2.8166299169826856
STAT,1880,38,50-100,1918,1.295820330146004
SIM,1962,2,na,1964,5271
STAT,1893,46,35-39,1939,0.10156407420662733
STAT,1777,112,na,1889,5.903006407287399E-4
STAT,1965,1,na,1966,4963.719114835955
SIM,1816,39,50-100,1855,1
SIM,1834,48,50-100,1882,2
STAT,1831,50,45-49,1881,0.009922051008169362
STAT,1861,43,35-39,1904,1.5088014502852451
STAT,1839,18,35-39,1857,0.5058971444784109
STAT,1850,21,15-19,1871,3.0538946804943072
SIM,1823,39,30-34,1862,4
SIM,1840,26,25-29,1866,53
SIM,1824,33,30-34,1857,18
SIM,1907,18,na,1925,3963
STAT,1840,36,25-29,1876,2.4120499125946195
STAT,1900,43,45-49,1943,0.14476128639027483
SIM,1897,6,na,1903,3625
STAT,1809,53,40-44,1862,0.03311135237627498
STAT,1921,25,na,1946,4245.367847997617
SIM,1863,26,20-24,1889,1
STAT,1888,28,25-29,1916,50.250511348964956
SIM,1848,65,na,1913,1289
STAT,1862,29,na,1891,2066.6966240674005
STAT,1804,102,na,1906,0.09089000632845035
STAT,1832,33,15-19,1865,0.12539772229977397
STAT,1887,19,50-100,1906,0.05494922323412442
SIM,1818,99,na,1917,2
STAT,1843,53,40-44,1896,0.006986553382120018
STAT,1860,22,35-39,1882,4.96659475894552
STAT,1881,19,25-29,1900,5.487344900524243
SIM,1859,81,na,1940,403
SIM,1891,24,30-34,1915,34
STAT,1855,46,15-19,1901,3.019429290265084E-4
STAT,1829,46,20-24,1875,0.009070177457219712
STAT,1822,37,20-24,1859,1.4364032522479784
SIM,1805,72,na,1877,480
STAT,1845,29,15-19,1874,0.39773819933169163
STAT,1857,35,40-44,1892,3.483311984256609
STAT,1865,15,25-29,1880,5.988443178105706
STAT,1813,44,50-100,1857,3.312379223916316
SIM,1899,26,na,1925,3620
STAT,1894,43,45-49,1937,0.13416730150881703
STAT,1904,48,50-100,1952,0.19827774962474412
SIM,1871,38,20-24,1909,4
SIM,1934,20,30-34,1954,48
STAT,1903,39,30-34,1942,1.6380144708864208
STAT,1873,27,25-29,1900,43.31282962655652
STAT,1897,41,20-24,1938,0.01500053853888587
STAT,1827,107,na,1934,0.002804382996240179
SIM,1881,27,25-29,1908,51
STAT,1842,23,30-34,1865,20.08217079013947
SIM,1801,67,na,1868,606
STAT,1826,48,45-49,1874,0.22941162949829869
SIM,1789,69,na,1858,613
STAT,1837,38,20-24,1875,0.6336593739281231
STAT,1839,96,na,1935,6.087707239063614
SIM,1829,37,25-29,1866,4
SIM,1892,37,50-100,1929,2
STAT,1835,82,na,1917,350.19241207410096
STAT,1811,68,na,1879,770.6079379630345
STAT,1865,36,30-34,1901,4.938892396002138
SIM,1810,44,40-44,1854,5
STAT,1847,45,25-29,1892,0.04355721264632795
SIM,1911,39,30-34,1950,2
STAT,1884,37,50-100,1921,1.2228256570344933
SIM,1873,15,25-29,1888,4
SIM,1896,28,25-29,1924,58
STAT,1896,37,20-24,1933,1.030564220760241
SIM,1884,26,40-44,1910,3
SIM,1873,36,30-34,1909,4
STAT,1886,15,45-49,1901,0.0699831100151345
STAT,1819,42,45-49,1861,3.2122969902676672
STAT,1893,12,na,1905,3311.916817888875
STAT,1857,42,30-34,1899,0.9051037613418574
STAT,1849,32,30-34,1881,14.384674341317625
SIM,1887,25,na,1912,2733
STAT,1827,52,45-49,1879,0.014371477097634103
STAT,1921,38,35-39,1959,2.724922659346075
STAT,1938,22,15-19,1960,5.318592553687446
SIM,1874,29,35-39,1903,12
SIM,1863,19,30-34,1882,6
STAT,1880,14,na,1894,2730.426398707348
SIM,1857,32,30-34,1889,28
SIM,1948,17,30-34,1965,23
STAT,1852,45,35-39,1897,0.10723339063755508
STAT,1898,18,40-44,1916,0.24977633807448307
STAT,1839,42,15-19,1881,0.010319068052567899
STAT,1874,31,25-29,1905,10.636083652419012
SIM,1882,31,25-29,1913,19
STAT,1850,28,na,1878,1935.3099383370477
SIM,1949,21,30-34,1970,46
STAT,1883,17,40-44,1900,0.18077613975347043
STAT,1886,33,45-49,1919,1.8517522676584168
STAT,1855,19,30-34,1874,1.410209378077893
STAT,1896,61,na,1957,2545.3435401722677
STAT,1876,22,50-100,1898,0.42526134991322134
STAT,1835,50,30-34,1885,0.00473887274379979
SIM,1874,2,na,1876,3107
STAT,1848,14,na,1862,2394.284387734377
STAT,1885,34,40-44,1919,4.322537278571055
STAT,1949,23,30-34,1972,33.8704253747012
STAT,1862,31,35-39,1893,8.869129943160884
STAT,1883,28,25-29,1911,41.66234229538454
SIM,1839,84,na,1923,197
STAT,1841,28,40-44,1869,2.762367574601045
SIM,1844,34,45-49,1878,1
STAT,1781,85,na,1866,48.994931973306414
STAT,1888,42,na,1930,2751.863747325995
STAT,1919,49,35-39,1968,0.14036778150482476
SIM,1891,61,na,1952,2263
STAT,1860,47,35-39,1907,0.11504884231909773
SIM,1815,43,30-34,1858,4
STAT,1858,105,na,1963,0.10082574753943283
SIM,1943,21,35-39,1964,12
STAT,1848,47,35-39,1895,0.11377129088711375
STAT,1868,27,45-49,1895,1.0717654698750283
SIM,1847,28,na,1875,1943
SIM,1843,14,na,1857,2728
SIM,1851,33,na,1884,1985
STAT,1844,40,30-34,1884,0.9557602600421405
STAT,1947,20,15-19,1967,6.081163617286722
SIM,1888,18,25-29,1906,17
STAT,1874,34,30-34,1908,17.902064117072488
SIM,1880,39,25-29,1919,3
SIM,1833,34,35-39,1867,13
SIM,1882,34,30-34,1916,34
SIM,1919,29,50-100,1948,1
STAT,1924,22,15-19,1946,6.347288880775391
SIM,1942,16,na,1958,4112
SIM,1877,40,35-39,1917,4
STAT,1911,43,20-24,1954,0.016903443622127895
SIM,1864,32,20-24,1896,5
SIM,1838,24,20-24,1862,93
SIM,1870,40,45-49,1910,2
STAT,1905,62,na,1967,2929.340431014856
STAT,1848,33,25-29,1881,8.782963149058892
SIM,1798,74,na,1872,355
SIM,1925,30,30-34,1955,27
STAT,1888,35,20-24,1923,0.9276652286938142
STAT,1840,41,20-24,1881,0.11762660901364182
SIM,1891,0,na,1891,3571
STAT,1818,48,50-100,1866,0.430827690474647
SIM,1849,38,40-44,1887,4
STAT,1854,48,20-24,1902,0.0088926804163745
STAT,1829,54,50-100,1883,0.009522471043005326
SIM,1858,36,40-44,1894,7
SIM,1931,5,na,1936,5212
SIM,1828,45,na,1873,1533
SIM,1824,31,na,1855,1663
SIM,1856,15,25-29,1871,11
SIM,1918,23,50-100,1941,4
STAT,1935,21,35-39,1956,12.958910808223887
STAT,1852,17,40-44,1869,0.16776715662755928
STAT,1902,45,20-24,1947,0.009757440004926399
SIM,1896,35,20-24,1931,1
STAT,1836,34,45-49,1870,1.3619356928831163
STAT,1865,41,25-29,1906,0.5949128936950449
STAT,1892,26,25-29,1918,53.795922487138604
STAT,1856,32,20-24,1888,2.1187299826631736
SIM,1891,28,25-29,1919,67
STAT,1857,38,45-49,1895,1.5635606738495815
SIM,1849,30,30-34,1879,22
STAT,1870,79,na,1949,693.3643682709279
STAT,1928,35,na,1963,4814.132206384816
STAT,1802,52,40-44,1854,0.030719500071952375
SIM,1818,90,na,1908,65
STAT,1895,26,15-19,1921,0.6004706425269508
SIM,1923,1,na,1924,4903
STAT,1845,32,45-49,1877,1.5150133553460714
SIM,1833,35,25-29,1868,4
STAT,1947,18,na,1965,4186.789381721836
SIM,1824,37,25-29,1861,2
STAT,1830,29,20-24,1859,11.800228816037016
STAT,1828,35,15-19,1863,0.06044193414541015
SIM,1807,52,na,1859,1133
STAT,1928,1,na,1929,5318.614105413324
SIM,1863,31,50-100,1894,1
STAT,1883,20,15-19,1903,3.280115739491047
SIM,1853,32,45-49,1885,4
STAT,1825,35,25-29,1860,5.169627764503169
STAT,1853,27,20-24,1880,11.238910772814375
SIM,1897,16,25-29,1913,8
SIM,1829,26,20-24,1855,3
SIM,1917,31,35-39,1948,17
SIM,1815,71,na,1886,651
SIM,1852,33,40-44,1885,6
STAT,1877,35,45-49,1912,2.0977925872266363
SIM,1954,9,na,1963,4838
STAT,1872,46,15-19,1918,4.073211991881743E-4
STAT,1843,15,50-100,1858,0.042729114704464194
STAT,1836,41,35-39,1877,1.3764809586591595
STAT,1951,16,50-100,1967,0.45088129613931843
STAT,1839,54,30-34,1893,0.0041041434930861416
SIM,1891,20,15-19,1911,3
STAT,1850,26,40-44,1876,2.718799993494927
STAT,1848,48,25-29,1896,0.04643709765881801
STAT,1869,36,15-19,1905,0.05540684746613903
STAT,1843,69,na,1912,989.8107451326977
SIM,1855,34,20-24,1889,3
SIM,1932,15,25-29,1947,82
SIM,1834,62,na,1896,1320
SIM,1889,32,25-29,1921,14
STAT,1841,29,30-34,1870,23.054828026809826
SIM,1835,19,20-24,1854,14
STAT,1859,44,40-44,1903,1.8025034633592958
STAT,1825,34,35-39,1859,19.37094112398363
STAT,1902,47,15-19,1949,3.2053578824421593E-4
SIM,1849,48,50-100,1897,4
SIM,1861,27,20-24,1888,8
SIM,1879,25,20-24,1904,15
SIM,1847,80,na,1927,376
SIM,1875,20,30-34,1895,25
STAT,1869,40,35-39,1909,1.7960860792260351
SIM,1818,44,45-49,1862,1
SIM,1946,5,na,1951,4497
STAT,1909,31,35-39,1940,8.835793411892395
STAT,1871,22,45-49,1893,0.6997093471428266
SIM,1927,39,na,1966,5119
SIM,1927,38,na,1965,5126
STAT,1860,58,na,1918,1632.7570003900412
SIM,1812,47,50-100,1859,3
SIM,1923,25,na,1948,4316
STAT,1851,88,na,1939,103.94945882833228
STAT,1924,15,25-29,1939,52.38956279434601
STAT,1849,54,25-29,1903,0.0026931781939138564
STAT,1851,25,25-29,1876,38.047216072453274
SIM,1856,33,25-29,1889,17
STAT,1844,33,40-44,1877,4.060687397692608
SIM,1833,28,35-39,1861,10
STAT,1839,47,40-44,1886,0.1236666053706759
STAT,1831,45,15-19,1876,3.0654742304368375E-4
STAT,1851,43,25-29,1894,0.48272102538848877
SIM,1885,35,45-49,1920,3
SIM,1877,58,na,1935,2020
STAT,1889,16,25-29,1905,7.074643580569018
SIM,1865,38,25-29,1903,5
STAT,1857,50,na,1907,1721.6120214600592
SIM,1870,6,na,1876,3066
STAT,1862,35,50-100,1897,1.0810322730362683
SIM,1838,44,na,1882,1733
STAT,1862,40,45-49,1902,1.318571906487115
STAT,1892,25,35-39,1917,12.311815636517169
STAT,1810,53,30-34,1863,0.021375887870522612
STAT,1872,39,25-29,1911,2.8941722475093874
STAT,1912,37,30-34,1949,1.7946833394086141
SIM,1833,27,45-49,1860,1
SIM,1907,17,40-44,1924,1
STAT,1773,115,na,1888,1.9978223186560502E-4
SIM,1896,17,20-24,1913,23
STAT,1882,29,40-44,1911,2.9097563722165076
STAT,1892,19,35-39,1911,0.6916931397741957
STAT,1888,17,20-24,1905,21.134389389389437
SIM,1798,85,na,1883,49
STAT,1841,99,na,1940,1.4162613053880289
STAT,1848,40,15-19,1888,0.011553551621711343
SIM,1794,92,na,1886,17
SIM,1853,8,na,1861,2212
STAT,1895,24,na,1919,3099.8844259317702
SIM,1912,34,50-100,1946,1
STAT,1860,40,15-19,1900,0.011516809968908812
STAT,1915,17,25-29,1932,9.151939807669965
SIM,1899,37,40-44,1936,2
SIM,1917,49,na,1966,3684
STAT,1841,21,20-24,1862,65.75514147828478
STAT,1852,2,na,1854,2747.0
SIM,1913,35,na,1948,3793
STAT,1827,37,20-24,1864,0.8966566273249434
STAT,1831,38,25-29,1869,2.2764372900107497
STAT,1850,18,50-100,1868,0.045571209874975885
STAT,1892,18,45-49,1910,0.08257147770892859
STAT,1950,19,50-100,1969,0.4472668766975249
STAT,1852,35,40-44,1887,3.407920610336423
SIM,1921,13,na,1934,4524
STAT,1857,53,20-24,1910,5.723215843644981E-4
STAT,1932,17,25-29,1949,57.98930235762162
SIM,1901,28,50-100,1929,1
SIM,1948,18,40-44,1966,1
STAT,1826,77,na,1903,474.30958949280404
STAT,1834,96,na,1930,5.111023376356709
STAT,1814,97,na,1911,2.5145330822586374
STAT,1858,8,na,1866,2272.9788834623937
SIM,1825,38,50-100,1863,2
SIM,1903,37,30-34,1940,1
STAT,1889,34,25-29,1923,12.646867490852985
STAT,1853,16,45-49,1869,0.0653677750177383
STAT,1839,29,40-44,1868,2.6371958164002156
STAT,1872,43,45-49,1915,1.5087415806648325
STAT,1841,35,30-34,1876,4.794282979625854
STAT,1893,18,40-44,1911,0.23394791471133844
SIM,1880,43,45-49,1923,5
SIM,1890,13,na,1903,3498
STAT,1877,28,20-24,1905,12.18609182375435
SIM,1838,17,30-34,1855,1
STAT,1803,51,45-49,1854,0.06425804681803919
SIM,1920,37,30-34,1957,1
STAT,1856,39,40-44,1895,3.3555870715375677
STAT,1891,10,na,1901,3239.146174580825
STAT,1898,31,15-19,1929,0.19578267117483092
STAT,1844,32,na,1876,2050.4899692040135
STAT,1821,49,20-24,1870,0.017086349064256264
SIM,1844,51,na,1895,1439
SIM,1894,27,na,1921,3385
STAT,1810,46,40-44,1856,0.6740702030318654
STAT,1762,94,na,1856,2.623350466799999
SIM,1856,44,30-34,1900,3
SIM,1880,14,na,1894,2503
SIM,1928,20,35-39,1948,22
STAT,1811,50,40-44,1861,0.02609850652706344
STAT,1870,23,40-44,1893,2.0603110107381895
STAT,1899,37,na,1936,3291.5112360342505
SIM,1919,16,20-24,1935,190
SIM,1923,17,25-29,1940,66
STAT,1873,40,20-24,1913,0.1642509785223161
STAT,1889,48,35-39,1937,0.09711506402286664
STAT,1861,15,40-44,1876,0.17853538227825616
STAT,1862,24,45-49,1886,0.6137172116174374
STAT,1902,11,na,1913,3691.412321170278
STAT,1842,27,25-29,1869,47.09833990164766
STAT,1917,15,35-39,1932,0.9156891097794851
SIM,1912,35,30-34,1947,1
STAT,1851,18,35-39,1869,0.5021673091833032
STAT,1893,7,na,1900,3341.2168313988727
STAT,1894,28,20-24,1922,15.201124057066586
STAT,1861,98,na,1959,4.975050630017868
SIM,1826,66,na,1892,1235
SIM,1841,29,45-49,1870,2
STAT,1895,23,na,1918,3109.7735056798333
STAT,1898,46,35-39,1944,0.10843568563779521
STAT,1884,83,na,1967,701.4594706073962
SIM,1834,27,40-44,1861,2
SIM,1862,80,na,1942,559
SIM,1792,89,na,1881,10
STAT,1883,46,25-29,1929,0.05709182372952366
STAT,1889,49,25-29,1938,0.03961948287581667
SIM,1865,35,20-24,1900,1
STAT,1851,24,35-39,1875,5.201115445569424
STAT,1939,33,15-19,1972,0.1322833611545183
SIM,1897,34,25-29,1931,22
SIM,1820,41,45-49,1861,4
STAT,1833,29,45-49,1862,1.0242724584981606
STAT,1842,27,45-49,1869,1.236209866478676
STAT,1904,35,30-34,1939,1.6831629292548285
STAT,1874,15,50-100,1889,0.051092263243221095
SIM,1841,36,35-39,1877,12
SIM,1868,25,45-49,1893,4
SIM,1881,24,20-24,1905,63
STAT,1876,64,na,1940,1812.834802242232
STAT,1872,50,na,1922,2217.7905235326098
SIM,1929,38,25-29,1967,1
STAT,1805,101,na,1906,0.22652389289301872
STAT,1897,33,20-24,1930,3.6446548572139417
STAT,1906,24,na,1930,3457.4506426700946
SIM,1849,39,na,1888,1869
STAT,1930,25,30-34,1955,50.400526735554244
STAT,1909,21,na,1930,3589.8539637458857
SIM,1889,39,45-49,1928,11
STAT,1847,49,40-44,1896,0.12550739958320498
STAT,1902,10,na,1912,3697.068836490108
STAT,1877,51,45-49,1928,0.015200460915573914
STAT,1833,22,25-29,1855,54.64431727028061
STAT,1879,61,na,1940,1969.5415618533018
STAT,1919,7,na,1926,4460.120910153515
STAT,1870,42,45-49,1912,1.4825226535374783
SIM,1916,54,na,1970,3646
STAT,1832,42,25-29,1874,0.5365319869985762
STAT,1897,47,30-34,1944,0.07359133320342001
SIM,1912,40,na,1952,3489
SIM,1815,39,45-49,1854,2
SIM,1885,28,20-24,1913,21
STAT,1936,5,na,1941,3886.3069317256545
SIM,1850,27,25-29,1877,4
SIM,1870,24,45-49,1894,1
SIM,1925,15,35-39,1940,5
STAT,1832,23,20-24,1855,69.34587556966464
STAT,1802,54,35-39,1856,0.02413029150010176
SIM,1874,32,30-34,1906,36
STAT,1889,41,15-19,1930,0.017276501559810434
STAT,1910,39,20-24,1949,0.2518010439806841
SIM,1873,32,na,1905,2268
STAT,1851,17,45-49,1868,0.06013601255964963
STAT,1852,42,30-34,1894,0.8708256788616473
STAT,1883,26,50-100,1909,0.6344233473983936
STAT,1868,38,20-24,1906,0.740402692021829
STAT,1922,10,na,1932,4646.526543532602
STAT,1833,36,35-39,1869,6.34483947467529
STAT,1926,24,na,1950,4455.74023995669
SIM,1840,23,20-24,1863,72
SIM,1848,31,25-29,1879,5
STAT,1949,16,40-44,1965,1.6439043613661612
STAT,1859,61,na,1920,1517.959153108617
SIM,1859,42,40-44,1901,9
SIM,1865,49,50-100,1914,1
SIM,1767,90,na,1857,12
STAT,1867,28,na,1895,2262.1224284701752
STAT,1942,6,na,1948,4198.423894687489
SIM,1846,63,na,1909,1298
STAT,1833,37,25-29,1870,2.556133995253809
SIM,1841,22,25-29,1863,59
SIM,1862,81,na,1943,559
SIM,1848,39,35-39,1887,9
SIM,1908,35,na,1943,3436
SIM,1858,44,na,1902,1860
SIM,1904,21,na,1925,3791
STAT,1842,45,25-29,1887,0.05321415468671498
SIM,1860,35,40-44,1895,4
STAT,1867,80,na,1947,588.4223534370608
STAT,1831,42,45-49,1873,1.157119360823214
STAT,1897,15,20-24,1912,24.117006907464578
SIM,1893,32,na,1925,3076
STAT,1790,89,na,1879,32.767653427061056
STAT,1853,34,45-49,1887,1.4545413874568847
SIM,1940,17,25-29,1957,68
STAT,1865,19,40-44,1884,0.17178358375865857
STAT,1898,39,45-49,1937,0.5832090656489395
STAT,1892,48,40-44,1940,0.12085428662160501
STAT,1907,10,na,1917,3842.0437094152876
STAT,1895,49,20-24,1944,0.008741651428847535
STAT,1848,44,30-34,1892,0.9259862427271889
STAT,1858,30,30-34,1888,14.125164425019593
STAT,1879,27,20-24,1906,12.364947585187593
STAT,1850,19,30-34,1869,1.4738512449170846
STAT,1866,21,25-29,1887,54.36544751903895
SIM,1939,20,30-34,1959,52
STAT,1860,44,30-34,1904,0.9363842529911965
STAT,1855,47,na,1902,1685.6068522337523
SIM,1831,34,na,1865,1787
SIM,1864,35,25-29,1899,4
STAT,1890,79,na,1969,1297.3743012411132
SIM,1838,27,25-29,1865,36
STAT,1920,39,na,1959,4150.8309421581835
STAT,1878,75,na,1953,1079.3444271846154
STAT,1885,3,na,1888,2960.242950757313
SIM,1824,34,20-24,1858,3
STAT,1889,38,40-44,1927,5.424676069753945
SIM,1844,31,40-44,1875,9
STAT,1828,32,45-49,1860,2.0446171719685386
STAT,1856,35,25-29,1891,2.2506693509615836
SIM,1790,78,na,1868,374
STAT,1820,40,40-44,1860,4.545718028840615
SIM,1895,18,15-19,1913,8
STAT,1823,43,15-19,1866,0.019973445129857416
SIM,1903,36,na,1939,3202
STAT,1812,85,na,1897,124.46006156268695
SIM,1869,91,na,1960,93
SIM,1819,85,na,1904,86
SIM,1891,25,20-24,1916,22
STAT,1897,18,25-29,1915,7.652980046860829
STAT,1887,18,15-19,1905,6.674538903328922
STAT,1847,53,25-29,1900,0.0026094549171620826
SIM,1833,31,30-34,1864,18
SIM,1883,19,35-39,1902,3
SIM,1886,39,na,1925,2651
SIM,1882,25,na,1907,2113
SIM,1882,37,35-39,1919,9
STAT,1839,51,25-29,1890,0.0025232061399229695
STAT,1840,18,na,1858,2071.0454791429115
SIM,1872,37,25-29,1909,4
SIM,1919,20,na,1939,3976
SIM,1887,27,20-24,1914,2
SIM,1902,20,35-39,1922,18
STAT,1834,43,25-29,1877,0.45517159169540533
SIM,1825,32,35-39,1857,6
STAT,1883,25,20-24,1908,11.673694657387857
STAT,1892,22,30-34,1914,22.574916931711265
SIM,1907,24,30-34,1931,43
STAT,1860,33,25-29,1893,8.420879440807303
STAT,1895,23,45-49,1918,0.9168996130316734
STAT,1855,58,na,1913,1488.5788444476348
STAT,1936,23,na,1959,3523.5413534770078
STAT,1861,29,20-24,1890,9.775602798905387
STAT,1919,46,30-34,1965,0.09786923937265521
STAT,1911,46,25-29,1957,0.05079001357624212
STAT,1884,23,35-39,1907,5.79414956983839
STAT,1836,31,40-44,1867,3.494171498189907
SIM,1892,23,35-39,1915,10
SIM,1903,9,na,1912,3544
STAT,1899,39,40-44,1938,1.2965178373102861
SIM,1818,41,40-44,1859,6
SIM,1874,21,25-29,1895,55
STAT,1870,30,30-34,1900,17.455533650965766
STAT,1822,53,20-24,1875,0.0010330781139505703
STAT,1866,10,na,1876,2549.7994990565535
STAT,1864,37,25-29,1901,2.6240633818276127
STAT,1933,30,15-19,1963,0.17519537129569074
SIM,1890,36,30-34,1926,8
SIM,1903,25,na,1928,3418
SIM,1833,38,50-100,1871,2
SIM,1880,36,20-24,1916,4
STAT,1884,50,25-29,1934,0.0035785234944752365
STAT,1819,96,na,1915,4.365138291931386
STAT,1893,36,40-44,1929,5.640911139670011
SIM,1870,35,50-100,1905,2
STAT,1874,37,35-39,1911,7.3147417692046774
SIM,1939,28,40-44,1967,10
STAT,1836,44,na,1880,1537.0959175164624
STAT,1832,30,na,1862,1946.3235504944817
STAT,1806,78,na,1884,316.03327482809937
STAT,1825,31,30-34,1856,47.44676244061689
STAT,1925,32,30-34,1957,18.90775967853031
SIM,1846,26,20-24,1872,13
SIM,1864,17,25-29,1881,7
SIM,1885,42,35-39,1927,2
SIM,1877,79,na,1956,737
SIM,1842,43,25-29,1885,3
STAT,1872,18,20-24,1890,17.95475604332249
STAT,1872,36,20-24,1908,0.7865034119143371
STAT,1850,59,na,1909,1488.1373487724377
STAT,1855,52,20-24,1907,5.524903716440858E-4
STAT,1882,36,30-34,1918,5.2392755852317725
STAT,1884,49,45-49,1933,0.23014705529732513
SIM,1860,14,na,1874,2394
STAT,1839,39,50-100,1878,1.018803101450033
STAT,1883,43,20-24,1926,0.15583235903077247
STAT,1895,43,50-100,1938,0.09606304958068215
STAT,1846,43,na,1889,1752.6002841752845
STAT,1886,36,15-19,1922,0.06017105091294304
SIM,1880,18,20-24,1898,25
STAT,1893,43,30-34,1936,0.10164452654321934
STAT,1850,29,45-49,1879,0.9861699954393361
SIM,1885,32,40-44,1917,6
STAT,1802,64,na,1866,841.0916059303498
STAT,1826,45,40-44,1871,0.17335549899668196
STAT,1880,6,na,1886,2835.808919228077
SIM,1917,0,na,1917,4501
SIM,1896,38,na,1934,3115
SIM,1888,33,20-24,1921,2
SIM,1856,37,40-44,1893,1
STAT,1899,36,50-100,1935,1.710028951855255
STAT,1917,20,na,1937,3940.9995250693655
SIM,1854,17,15-19,1871,9
SIM,1939,19,na,1958,3755
STAT,1866,29,35-39,1895,8.959496003958321
STAT,1849,62,na,1911,1429.0168801179802
SIM,1778,85,na,1863,32
STAT,1867,46,40-44,1913,0.163311552304037
STAT,1877,32,40-44,1909,4.5206944058468785
STAT,1836,50,45-49,1886,0.0096375138564782
SIM,1803,90,na,1893,29
SIM,1889,43,30-34,1932,2
SIM,1886,83,na,1969,779
STAT,1856,17,25-29,1873,5.1885352686102
STAT,1864,44,15-19,1908,0.012416212848101328
STAT,1816,52,20-24,1868,0.001832672359107463
SIM,1866,30,30-34,1896,24
SIM,1773,86,na,1859,74
SIM,1832,29,30-34,1861,40
SIM,1920,28,na,1948,4393
STAT,1846,17,15-19,1863,5.657482498067606
STAT,1858,38,40-44,1896,3.451469869787765
STAT,1826,52,30-34,1878,0.005657035490075434
STAT,1873,76,na,1949,970.0556681297766
STAT,1819,45,15-19,1864,8.030445813086063E-4
SIM,1852,59,na,1911,1397
SIM,1842,25,25-29,1867,49
SIM,1933,32,30-34,1965,8
STAT,1826,108,na,1934,0.001005104075536124
STAT,1851,47,40-44,1898,0.12902620585588226
STAT,1907,40,50-100,1947,0.10991079997138867
STAT,1865,16,50-100,1881,0.046836179064213244
SIM,1806,67,na,1873,921
STAT,1906,57,na,1963,3117.206398427667
STAT,1844,15,40-44,1859,0.18613748114627018
STAT,1853,24,50-100,1877,0.3927538292413694
STAT,1873,43,25-29,1916,0.6527610210803065
SIM,1802,53,na,1855,1208
STAT,1861,41,40-44,1902,1.8963142141651093
SIM,1849,51,na,1900,1711
SIM,1873,65,na,1938,1550
STAT,1806,52,25-29,1858,0.010220589479411946
STAT,1823,70,na,1893,775.989063515856
STAT,1859,51,30-34,1910,0.004858603595144644
STAT,1838,44,20-24,1882,0.11027915841232006
STAT,1834,25,25-29,1859,33.51473166198557
STAT,1850,30,25-29,1880,9.20508868423578
STAT,1931,24,na,1955,4756.773507330099
STAT,1851,51,25-29,1902,0.002694801125128999
STAT,1854,22,45-49,1876,0.6148949096382516
STAT,1802,102,na,1904,0.10243044049663806
SIM,1890,29,40-44,1919,7
STAT,1824,40,25-29,1864,0.8315102838485342
STAT,1828,44,50-100,1872,0.9751988687195545
STAT,1851,21,30-34,1872,16.22287946564369
STAT,1846,28,20-24,1874,10.69288250920928
SIM,1836,44,50-100,1880,2
STAT,1850,109,na,1959,0.0011972522255254401
STAT,1860,26,50-100,1886,0.5376663974161976
SIM,1887,24,na,1911,2739
STAT,1848,23,50-100,1871,0.402482588877368
SIM,1843,39,20-24,1882,1
SIM,1893,41,30-34,1934,4
STAT,1881,42,20-24,1923,0.15442452570959275
STAT,1808,50,50-100,1858,0.05327698759187657
SIM,1863,43,45-49,1906,4
STAT,1867,53,30-34,1920,0.0055712829569303885
STAT,1899,34,35-39,1933,13.917466601474654
STAT,1863,54,20-24,1917,6.421971392262401E-4
STAT,1829,107,na,1936,0.002780705134127771
SIM,1823,38,40-44,1861,5
STAT,1891,31,25-29,1922,12.860495544445499
STAT,1846,53,45-49,1899,0.010836422064967977
STAT,1883,18,30-34,1901,1.571207491979384
SIM,1874,25,40-44,1899,4
SIM,1909,10,na,1919,4247
STAT,1854,19,15-19,1873,5.265231371728043
STAT,1900,40,na,1940,3286.7269384734213
SIM,1862,19,15-19,1881,7
STAT,1885,41,30-34,1926,1.1610345890411478
SIM,1857,58,na,1915,1713
STAT,1866,25,40-44,1891,2.8205555594021234
STAT,1831,35,20-24,1866,0.629816131431552
SIM,1867,44,40-44,1911,5
SIM,1864,42,50-100,1906,2
STAT,1877,42,35-39,1919,1.8853105231971792
SIM,1834,85,na,1919,116
STAT,1875,24,na,1899,2437.713127335183
STAT,1883,40,30-34,1923,1.147764793589566
STAT,1871,65,na,1936,1695.7492987181272
STAT,1904,38,35-39,1942,2.2017481663756193
STAT,1943,20,30-34,1963,30.89724335810539
STAT,1879,48,25-29,1927,0.05994756112547403
STAT,1894,46,50-100,1940,0.18065844121501884
SIM,1854,28,20-24,1882,15
STAT,1930,7,na,1937,5223.338477052332
SIM,1846,19,30-34,1865,6
STAT,1838,26,20-24,1864,10.062068017607128
STAT,1847,50,20-24,1897,5.604473341094725E-4
STAT,1889,45,30-34,1934,0.12175603126441664
SIM,1839,29,na,1868,1864
STAT,1907,15,25-29,1922,8.44410062451431
STAT,1861,18,45-49,1879,0.06264255865764859
SIM,1870,31,35-39,1901,13
STAT,1811,53,45-49,1864,0.033879011394709835
STAT,1893,32,25-29,1925,13.13554062991839
STAT,1902,27,50-100,1929,0.913007394175952
STAT,1941,31,50-100,1972,0.8769044828086187
STAT,1810,49,45-49,1859,0.8777771527870033
STAT,1869,33,45-49,1902,1.7051348427946
STAT,1898,36,20-24,1934,1.0605330085367008
SIM,1808,78,na,1886,263
SIM,1922,39,na,1961,4808
STAT,1939,28,50-100,1967,1.0096806993885508
STAT,1871,10,na,1881,2682.515304733406
STAT,1871,25,15-19,1896,0.45834471885339756
STAT,1874,27,40-44,1901,3.0979810084584005
SIM,1867,80,na,1947,456
SIM,1879,28,25-29,1907,65
SIM,1948,21,15-19,1969,6
STAT,1841,24,25-29,1865,53.45465133690192
SIM,1848,42,30-34,1890,6
SIM,1836,33,na,1869,2000
SIM,1877,33,45-49,1910,2
STAT,1815,45,30-34,1860,0.22210451109497217
SIM,1824,52,na,1876,1332
STAT,1930,28,35-39,1958,19.2858702450862
STAT,1945,15,45-49,1960,0.5513803994817168
SIM,1951,20,30-34,1971,56
STAT,1854,21,50-100,1875,0.3621881913704775
SIM,1831,36,25-29,1867,3
SIM,1883,26,25-29,1909,63
STAT,1848,15,25-29,1863,5.80358057592239
STAT,1939,22,30-34,1961,29.139503910340398
SIM,1850,17,30-34,1867,2
STAT,1838,19,30-34,1857,1.3928055465135578
SIM,1852,70,na,1922,882
SIM,1859,6,na,1865,2725
STAT,1926,9,na,1935,4932.794440953629
SIM,1874,35,35-39,1909,14
STAT,1885,16,40-44,1901,0.18433095538663669
STAT,1773,89,na,1862,36.98898213690302
STAT,1807,53,50-100,1860,0.05022893778420359
SIM,1885,33,50-100,1918,1
SIM,1912,38,35-39,1950,7
STAT,1856,42,15-19,1898,0.010680424321548036
SIM,1864,39,40-44,1903,5
STAT,1828,29,15-19,1857,0.6300030960210705
STAT,1843,22,35-39,1865,4.940288912109007
STAT,1866,35,35-39,1901,6.677648346894762
STAT,1819,45,50-100,1864,0.4930697871221817
STAT,1897,43,15-19,1940,0.0012891390209614027
STAT,1877,33,50-100,1910,0.9510851418030404
STAT,1920,39,30-34,1959,2.010840836307969
SIM,1947,22,30-34,1969,58
SIM,1936,20,na,1956,3438
STAT,1929,32,15-19,1961,0.1649829432142824
STAT,1833,26,40-44,1859,2.823845753146457
STAT,1850,70,na,1920,1074.3533030541998
STAT,1864,34,20-24,1898,2.442441285783719
SIM,1841,26,40-44,1867,6
SIM,1841,33,30-34,1874,21
STAT,1879,2,na,1881,3404.323918014815
STAT,1818,50,30-34,1868,0.010594839206448301
SIM,1909,24,50-100,1933,3
STAT,1791,74,na,1865,408.594679648924
STAT,1890,27,25-29,1917,52.206756629842815
SIM,1909,7,na,1916,4264
STAT,1795,88,na,1883,54.66366607142706
SIM,1852,40,30-34,1892,3
SIM,1910,27,50-100,1937,3
STAT,1887,47,20-24,1934,0.013468666163430934
STAT,1907,40,15-19,1947,0.0014367425882739707
STAT,1949,19,45-49,1968,0.5865509804672426
SIM,1827,45,50-100,1872,1
STAT,1875,26,25-29,1901,44.026343516948586
STAT,1845,35,15-19,1880,0.048369165880720044
STAT,1814,51,20-24,1865,0.001733958065137759
STAT,1844,25,50-100,1869,0.6285633657506456
STAT,1890,34,15-19,1924,0.1742492374308982
SIM,1893,34,40-44,1927,8
STAT,1842,42,20-24,1884,0.14793338083027324
SIM,1848,35,40-44,1883,10
SIM,1868,65,na,1933,1531
STAT,1842,29,na,1871,2374.1190855521936
STAT,1852,108,na,1960,0.004058496599483664
SIM,1879,18,30-34,1897,2
SIM,1832,40,25-29,1872,3
STAT,1787,70,na,1857,549.91433604396
STAT,1910,49,15-19,1959,3.447195058530095E-4
STAT,1823,36,25-29,1859,5.232244590096688
SIM,1836,32,45-49,1868,4
SIM,1915,22,15-19,1937,6
STAT,1835,39,20-24,1874,0.7008425055614407
SIM,1864,51,na,1915,2386
STAT,1808,53,25-29,1861,0.011746606040954528
STAT,1889,82,na,1971,1045.6808169502842
STAT,1917,30,30-34,1947,16.78688513361595
STAT,1919,18,20-24,1937,150.87553307539278
STAT,1833,33,30-34,1866,15.79754925004574
SIM,1860,31,25-29,1891,1
STAT,1866,43,na,1909,2145.932175503999
STAT,1766,102,na,1868,0.039930758062986925
STAT,1901,25,na,1926,3401.900770225411
STAT,1844,52,45-49,1896,0.01142086814081095
STAT,1856,46,30-34,1902,0.07516953392761498
STAT,1813,47,20-24,1860,0.03492209673278714
SIM,1851,22,35-39,1873,5
STAT,1875,44,25-29,1919,0.6570659920129731
STAT,1818,70,na,1888,786.4598001988833
STAT,1842,24,20-24,1866,77.13643279221682
STAT,1862,21,40-44,1883,1.874051520074949
SIM,1895,29,20-24,1924,16
SIM,1797,88,na,1885,43
SIM,1850,24,20-24,1874,85
SIM,1892,79,na,1971,1353
SIM,1826,43,40-44,1869,7
STAT,1887,29,20-24,1916,13.134373918066432
STAT,1907,22,15-19,1929,4.893204367702357
STAT,1832,85,na,1917,186.66476353826707
SIM,1915,8,na,1923,4568
SIM,1872,16,20-24,1888,16
SIM,1927,18,20-24,1945,200
STAT,1874,23,25-29,1897,59.01987903815247
SIM,1870,21,40-44,1891,2
STAT,1857,50,30-34,1907,0.004759490310331072
STAT,1880,38,20-24,1918,0.8135919749049714
STAT,1818,43,40-44,1861,4.271597956830361
STAT,1843,48,45-49,1891,0.15717436674500596
STAT,1864,16,20-24,1880,18.476556155737104
STAT,1895,30,35-39,1925,13.464596464197205
STAT,1897,36,25-29,1933,3.917366462639818
STAT,1910,21,30-34,1931,27.31340303153007
SIM,1859,24,40-44,1883,3
STAT,1818,48,na,1866,1426.3866988033624
STAT,1824,66,na,1890,814.8352338731637
STAT,1860,80,na,1940,510.72952572376926
SIM,1890,37,40-44,1927,11
STAT,1934,33,35-39,1967,12.599277016678995
STAT,1879,52,45-49,1931,0.01521465293346406
STAT,1909,49,25-29,1958,0.04889822102531012
STAT,1824,44,40-44,1868,2.6808906623340065
STAT,1916,42,30-34,1958,0.13221433639913585
SIM,1893,38,20-24,1931,1
STAT,1807,47,45-49,1854,0.849911908311227
STAT,1834,40,20-24,1874,0.11698019967852104
STAT,1858,76,na,1934,750.7099445936909
STAT,1826,67,na,1893,869.8413356160639
STAT,1862,81,na,1943,471.6657806043013
SIM,1892,16,25-29,1908,8
STAT,1891,37,35-39,1928,8.844534041459056
SIM,1851,64,na,1915,1463
STAT,1915,38,na,1953,3815.9776597818204
STAT,1921,31,15-19,1952,0.1450230219467508
SIM,1857,79,na,1936,584
STAT,1885,78,na,1963,1034.081418829156
STAT,1857,35,20-24,1892,0.613387879455031
SIM,1806,49,45-49,1855,1
STAT,1841,43,30-34,1884,0.8820033507344579
SIM,1832,44,40-44,1876,9
STAT,1906,48,45-49,1954,0.19337795082962564
STAT,1885,38,20-24,1923,0.7711196479644215
SIM,1850,41,50-100,1891,1
STAT,1923,45,40-44,1968,0.18723118061895122
STAT,1858,33,50-100,1891,0.7229568756174086
STAT,1807,84,na,1891,117.83933109763358
STAT,1913,47,50-100,1960,0.2227406636587101
STAT,1850,41,30-34,1891,0.8843000745234224
STAT,1922,25,50-100,1947,1.1455411653525727
STAT,1873,46,30-34,1919,0.09939585073999496
STAT,1824,46,35-39,1870,0.16608960158179184
SIM,1839,38,30-34,1877,8
STAT,1874,38,45-49,1912,2.051417452900982
STAT,1912,33,15-19,1945,0.1270341995772939
SIM,1857,29,35-39,1886,19
STAT,1884,16,25-29,1900,5.657895057631067
STAT,1933,31,50-100,1964,1.1265803900368427
SIM,1839,30,na,1869,1808
SIM,1783,75,na,1858,449
SIM,1841,19,30-34,1860,1
STAT,1842,17,30-34,1859,1.8427491638931368
STAT,1847,39,na,1886,1792.6187264820533
STAT,1882,37,40-44,1919,4.282719224172049
STAT,1836,45,15-19,1881,2.709305987998673E-4
STAT,1900,0,na,1900,4119.712860906504
STAT,1846,20,45-49,1866,0.6624216331058875
STAT,1815,46,40-44,1861,0.3862626532816652
STAT,1891,35,40-44,1926,5.525958769780494
STAT,1892,18,50-100,1910,0.06192860828169642
SIM,1891,29,na,1920,3012
SIM,1881,39,40-44,1920,6
STAT,1869,15,45-49,1884,0.06580512488553093
STAT,1914,21,15-19,1935,5.281315477679068
STAT,1827,84,na,1911,197.82106584911625
STAT,1841,34,na,1875,1925.9805873408552
SIM,1922,21,15-19,1943,8
STAT,1907,19,na,1926,3725.9600944517138
SIM,1888,31,na,1919,2966
STAT,1923,4,na,1927,4788.692010667987
SIM,1900,33,45-49,1933,4
STAT,1859,48,20-24,1907,0.009625542977892906
SIM,1841,44,35-39,1885,4
STAT,1848,52,30-34,1900,0.004834136995819351
STAT,1914,47,40-44,1961,0.1577622167990526
SIM,1891,40,30-34,1931,1
STAT,1833,37,45-49,1870,1.7698055478319576
STAT,1823,40,45-49,1863,2.3333309809411746
STAT,1826,41,25-29,1867,0.6834062886792076
STAT,1847,39,50-100,1886,0.9341663825509104
STAT,1879,19,20-24,1898,18.58566047676419
STAT,1882,44,30-34,1926,1.1095927657719802
STAT,1832,45,30-34,1877,0.08019140343189941
SIM,1874,43,35-39,1917,1
STAT,1860,30,20-24,1890,2.2496559442559096
STAT,1911,58,na,1969,3328.6036789734876
STAT,1850,34,40-44,1884,3.4023706464119505
STAT,1784,72,na,1856,450.8880837705
STAT,1792,91,na,1883,18.12369833982725
SIM,1900,15,30-34,1915,2
STAT,1932,38,45-49,1970,0.9247132510707098
STAT,1937,16,15-19,1953,44.68130603833581
STAT,1958,8,na,1966,5213.870935851412
SIM,1945,16,15-19,1961,56
STAT,1769,95,na,1864,1.9999456329275076
STAT,1856,47,40-44,1903,0.1319500401204715
SIM,1828,30,45-49,1858,1
STAT,1866,43,35-39,1909,1.68129833184225
STAT,1832,51,na,1883,1546.7942380926474
STAT,1833,44,35-39,1877,1.5186809361943627
STAT,1851,17,25-29,1868,5.216800142447207
SIM,1774,92,na,1866,1
SIM,1852,37,20-24,1889,1
STAT,1809,49,20-24,1858,0.03976592184085065
STAT,1892,26,na,1918,3035.0096186428896
STAT,1911,19,50-100,1930,0.07523223024156883
STAT,1841,14,na,1855,2281.59432
SIM,1867,89,na,1956,87
SIM,1907,27,35-39,1934,21
STAT,1948,20,30-34,1968,33.35960002243908
SIM,1834,41,25-29,1875,4
STAT,1917,29,na,1946,3937.198592631173
STAT,1904,22,50-100,1926,0.5910590869279745
STAT,1915,46,45-49,1961,0.22153611430244496
SIM,1867,40,25-29,1907,3
STAT,1865,47,35-39,1912,0.12851389585401626
STAT,1898,29,30-34,1927,34.23284806976116
STAT,1933,19,35-39,1952,5.645768866345051
STAT,1880,49,25-29,1929,0.05982126694316466
STAT,1902,37,20-24,1939,0.2374688984462735
SIM,1781,74,na,1855,378
STAT,1815,53,30-34,1868,0.012367166593062024
SIM,1829,40,50-100,1869,1
STAT,1926,46,20-24,1972,0.01381544461151547
STAT,1886,32,50-100,1918,0.9770778438068941
STAT,1877,59,na,1936,2025.9123478649196
SIM,1919,19,25-29,1938,68
STAT,1900,34,35-39,1934,14.086740035979952
SIM,1848,38,25-29,1886,3
SIM,1841,37,45-49,1878,2
STAT,1816,47,na,1863,1522.2229989056852
STAT,1794,72,na,1866,561.843796731799
STAT,1872,40,40-44,1912,2.307007665343112
STAT,1887,21,45-49,1908,0.7887058503052545
SIM,1800,72,na,1872,596
STAT,1822,43,50-100,1865,1.6402086464904553
STAT,1888,11,na,1899,3083.2333133393045
SIM,1920,26,25-29,1946,99
STAT,1809,65,na,1874,959.2018179598815
STAT,1928,18,15-19,1946,57.64823860797429
STAT,1860,15,25-29,1875,5.4600571753937945
STAT,1875,78,na,1953,810.4119444021682
STAT,1881,45,25-29,1926,0.05663643715627265
SIM,1863,40,40-44,1903,7
STAT,1848,38,50-100,1886,1.0223230681668793
STAT,1923,36,50-100,1959,0.49198205630157205
SIM,1882,46,na,1928,2042
STAT,1912,26,25-29,1938,65.66478265404305
STAT,1891,42,30-34,1933,1.4358650876389296
STAT,1843,15,25-29,1858,4.9423352649858625
SIM,1880,40,40-44,1920,8
SIM,1800,102,na,1902,2
SIM,1843,33,50-100,1876,5
STAT,1830,24,15-19,1854,6.948729614550567
SIM,1875,13,na,1888,2551
STAT,1844,37,20-24,1881,0.6444791474678089
STAT,1907,26,30-34,1933,37.47867246012104
STAT,1889,49,45-49,1938,0.16232982708352162
STAT,1874,42,30-34,1916,1.1875110980705283
STAT,1864,62,na,1926,1665.770719677735
SIM,1840,38,40-44,1878,4
SIM,1842,81,na,1923,261
STAT,1854,47,50-100,1901,0.18346019257820687
STAT,1814,54,25-29,1868,0.007836909478413076
STAT,1840,47,30-34,1887,0.06842696243665067
SIM,1799,70,na,1869,827
SIM,1829,30,na,1859,1947
SIM,1879,17,20-24,1896,21
SIM,1882,42,30-34,1924,2
SIM,1915,44,45-49,1959,1
SIM,1888,41,na,1929,2943
STAT,1877,46,15-19,1923,4.1815282893382537E-4
STAT,1945,18,15-19,1963,50.05035244913616
STAT,1854,35,50-100,1889,0.9355029622253703
STAT,1915,40,50-100,1955,0.11967770337768055
STAT,1794,62,na,1856,915.1456061600002
SIM,1836,87,na,1923,106
SIM,1851,15,25-29,1866,10
STAT,1875,41,20-24,1916,0.16546898922245062
SIM,1791,74,na,1865,425
SIM,1877,30,40-44,1907,5
STAT,1867,42,25-29,1909,0.6100818123839151
STAT,1865,45,40-44,1910,0.15946432530940358
STAT,1906,8,na,1914,3824.201516018086
SIM,1936,18,15-19,1954,39
STAT,1837,84,na,1921,226.93603615870222
STAT,1929,40,15-19,1969,0.0020157084257185843
SIM,1878,36,45-49,1914,2
STAT,1841,39,45-49,1880,1.7203064822562242
STAT,1846,16,50-100,1862,0.0469812989917565
SIM,1953,18,15-19,1971,70
STAT,1856,54,30-34,1910,0.004482580771261333
SIM,1898,37,25-29,1935,3
STAT,1843,15,na,1858,2002.0097200759033
STAT,1851,34,na,1885,1841.990636101735
STAT,1828,48,na,1876,1597.9156075200913
STAT,1824,32,na,1856,1441.4178500999897
STAT,1865,53,50-100,1918,0.013704962747928442
SIM,1901,8,na,1909,3793
SIM,1849,30,na,1879,2029
SIM,1889,39,25-29,1928,7
STAT,1857,28,30-34,1885,20.298486417032812
STAT,1868,16,40-44,1884,0.18081633102188568
SIM,1865,28,30-34,1893,31
SIM,1874,27,na,1901,2336
STAT,1915,17,50-100,1932,0.07912338294423671
STAT,1816,67,na,1883,927.1045286436806
STAT,1872,81,na,1953,549.1035732865089
STAT,1850,36,35-39,1886,5.559021106221916
STAT,1920,28,25-29,1948,72.65662865532016
SIM,1837,17,15-19,1854,8
STAT,1849,29,35-39,1878,8.814797795155167
STAT,1853,108,na,1961,0.0053718869650335715
SIM,1888,2,na,1890,3253
STAT,1797,69,na,1866,706.6947815553332
STAT,1898,11,na,1909,3541.2706302258234
STAT,1852,51,na,1903,1640.758059303556
SIM,1861,36,50-100,1897,1
STAT,1765,102,na,1867,0.06813601312284104
STAT,1899,27,25-29,1926,58.6361931413086
SIM,1869,31,45-49,1900,4
SIM,1902,38,25-29,1940,1
STAT,1903,33,20-24,1936,2.223134689965362
SIM,1833,27,25-29,1860,51
SIM,1883,18,25-29,1901,5
SIM,1906,21,30-34,1927,45
STAT,1927,44,15-19,1971,0.001940192023984313
STAT,1849,95,na,1944,10.39515512905815
STAT,1920,35,15-19,1955,0.021269002912664547
SIM,1897,14,na,1911,3567
SIM,1851,54,na,1905,1637
STAT,1818,47,20-24,1865,0.021366262724313904
SIM,1841,41,30-34,1882,1
STAT,1908,43,35-39,1951,0.1869364369727734
STAT,1859,26,40-44,1885,2.4933080187449477
STAT,1808,50,20-24,1858,0.002603110245989509
STAT,1821,34,15-19,1855,0.35921927970827067
SIM,1828,78,na,1906,428
STAT,1907,44,45-49,1951,0.15207076642132797
STAT,1874,20,20-24,1894,71.69381292045743
STAT,1807,51,30-34,1858,0.020617792688890434
STAT,1882,15,50-100,1897,0.04815378012683515
STAT,1860,48,45-49,1908,0.19239959733617615
STAT,1824,51,30-34,1875,0.006849109512511862
SIM,1896,60,na,1956,2544
STAT,1924,44,30-34,1968,0.15315488021652027
STAT,1838,51,45-49,1889,0.009856563520092915
SIM,1869,51,50-100,1920,2
SIM,1882,35,40-44,1917,6
SIM,1860,1,na,1861,2991
STAT,1851,44,na,1895,1726.4202464777034
STAT,1849,36,25-29,1885,2.327522776935977
STAT,1800,105,na,1905,0.010285273892013846
STAT,1918,47,25-29,1965,0.05698888483959831
SIM,1823,69,na,1892,893
SIM,1893,30,25-29,1923,23
STAT,1909,38,50-100,1947,0.3990339177137466
STAT,1824,39,45-49,1863,2.602428666548412
SIM,1866,9,na,1875,2802
SIM,1815,44,40-44,1859,5
STAT,1924,44,45-49,1968,0.19937729915443295
STAT,1864,52,na,1916,1951.9227203570767
STAT,1842,18,50-100,1860,0.05630824791623076
STAT,1919,28,15-19,1947,0.7674470091097702
SIM,1927,28,15-19,1955,3
STAT,1895,20,40-44,1915,2.764866459340407
SIM,1867,26,40-44,1893,2
SIM,1857,36,25-29,1893,5
SIM,1915,26,30-34,1941,9
STAT,1892,18,25-29,1910,7.163077136960821
STAT,1900,35,45-49,1935,2.8234464307302134
STAT,1904,34,50-100,1938,0.7560224994461823
STAT,1885,30,25-29,1915,10.380047505692946
STAT,1917,48,20-24,1965,0.011618964631015246
SIM,1832,39,45-49,1871,3
SIM,1900,30,40-44,1930,21
SIM,1876,38,20-24,1914,1
STAT,1857,38,25-29,1895,2.2582540759717142
STAT,1848,30,20-24,1878,2.6276864657618795
STAT,1844,47,15-19,1891,3.149979980189573E-4
STAT,1831,99,na,1930,1.19010699945947
STAT,1849,85,na,1934,214.33279752314579
SIM,1901,32,35-39,1933,21
SIM,1823,90,na,1913,46
STAT,1858,45,50-100,1903,0.19655032409268938
SIM,1873,37,40-44,1910,9
SIM,1900,32,35-39,1932,16
STAT,1891,34,30-34,1925,21.646070427588846
SIM,1877,89,na,1966,324
STAT,1869,51,50-100,1920,0.014901230312074035
STAT,1904,31,15-19,1935,0.20725187551240776
SIM,1886,60,na,1946,2099
SIM,1884,27,na,1911,2335
STAT,1841,46,35-39,1887,0.1065247153235698
SIM,1904,11,na,1915,3902
STAT,1824,47,45-49,1871,0.2761470565303324
STAT,1934,30,30-34,1964,21.76002708268005
SIM,1863,25,45-49,1888,1
STAT,1819,65,na,1884,898.9197564871461
SIM,1860,37,na,1897,2077
STAT,1873,97,na,1970,31.809752584702867
SIM,1871,20,45-49,1891,1
STAT,1851,40,20-24,1891,0.12146466809880281
SIM,1891,28,45-49,1919,2
STAT,1905,31,15-19,1936,0.11988073074021185
STAT,1857,59,na,1916,1531.9245956443735
STAT,1911,42,50-100,1953,0.11312338486944298
SIM,1874,28,25-29,1902,5
SIM,1808,48,na,1856,1255
STAT,1810,54,40-44,1864,0.037049699795821095
STAT,1844,96,na,1940,6.793627761922752
SIM,1811,88,na,1899,78
SIM,1848,35,20-24,1883,4
STAT,1848,48,45-49,1896,0.19026311011791952
STAT,1857,53,35-39,1910,0.006677084906830358
STAT,1897,40,45-49,1937,0.14214699846768847
SIM,1831,88,na,1919,54
STAT,1874,62,na,1936,1890.2205213785367
SIM,1861,54,na,1915,1781
SIM,1844,44,50-100,1888,5
STAT,1927,34,50-100,1961,1.0266569628665945
STAT,1881,48,30-34,1929,0.09305699318930725
SIM,1902,10,na,1912,3933
STAT,1871,48,20-24,1919,0.01188979423319336
SIM,1818,78,na,1896,337
STAT,1887,25,na,1912,2709.4109275604906
STAT,1834,32,na,1866,1652.3630396463861
SIM,1824,37,45-49,1861,5
STAT,1900,42,35-39,1942,0.1762067090836106
STAT,1816,44,35-39,1860,4.839615313685451
STAT,1869,28,50-100,1897,0.625940278956508
STAT,1909,46,20-24,1955,0.010272669071376923
SIM,1932,36,45-49,1968,1
STAT,1908,40,30-34,1948,0.12075400971972322
SIM,1857,28,25-29,1885,35
STAT,1918,40,40-44,1958,0.2692277227116403
SIM,1893,33,50-100,1926,1
STAT,1832,53,30-34,1885,0.004145695893744847
STAT,1836,44,50-100,1880,0.7727765977764901
SIM,1919,10,na,1929,4362
SIM,1869,21,30-34,1890,34
SIM,1844,62,na,1906,1212
STAT,1863,49,25-29,1912,0.05046941630192957
SIM,1912,48,50-100,1960,2
STAT,1907,19,40-44,1926,0.26983205665048354
STAT,1824,43,30-34,1867,1.3992897039741752
SIM,1857,34,50-100,1891,1
STAT,1853,15,na,1868,2310.642783986975
SIM,1889,29,30-34,1918,41
STAT,1883,35,35-39,1918,7.057064095421833
STAT,1924,36,45-49,1960,0.8130555480879568
STAT,1817,84,na,1901,152.20083977980585
STAT,1850,37,45-49,1887,1.5506123415060862
SIM,1881,84,na,1965,477
STAT,1920,33,20-24,1953,2.6866106026423813
SIM,1833,45,na,1878,1682
SIM,1934,31,35-39,1965,16
STAT,1924,43,35-39,1967,0.24165332802282485
STAT,1950,15,na,1965,4399.394755561927
SIM,1842,40,na,1882,1755
SIM,1954,0,na,1954,4990
STAT,1884,22,50-100,1906,0.40615720942526495
STAT,1920,49,na,1969,4076.949614800342
STAT,1822,48,25-29,1870,0.08421300583618521
STAT,1865,44,30-34,1909,1.0459765256436278
STAT,1831,34,na,1865,1727.1860583390583
STAT,1896,26,45-49,1922,1.4894818120889826
STAT,1933,16,30-34,1949,16.528531484078915
SIM,1923,43,40-44,1966,1
SIM,1875,23,na,1898,2306
STAT,1927,19,na,1946,4600.950549564921
STAT,1928,44,15-19,1972,0.001972201776921521
SIM,1926,40,40-44,1966,1
STAT,1883,28,45-49,1911,1.0935289590613457
STAT,1871,32,50-100,1903,0.9193829687861373
SIM,1938,32,30-34,1970,7
STAT,1837,30,45-49,1867,1.5228863409622726
STAT,1897,35,na,1932,3220.4286866190505
SIM,1820,72,na,1892,638
STAT,1938,30,15-19,1968,0.13059126755761064
SIM,1941,16,30-34,1957,17
SIM,1873,44,30-34,1917,3
STAT,1805,52,45-49,1857,0.0596632777029014
STAT,1912,41,15-19,1953,0.0015029071818496176
SIM,1856,30,20-24,1886,2
STAT,1865,37,40-44,1902,4.037178244659908
STAT,1887,59,na,1946,2191.5394717882873
STAT,1900,31,30-34,1931,24.59628513669501
SIM,1903,59,na,1962,2687
STAT,1891,38,45-49,1929,2.480447303254388
SIM,1867,79,na,1946,570
SIM,1898,29,25-29,1927,57
STAT,1832,38,40-44,1870,3.7374799937576646
STAT,1944,7,na,1951,4300.728765354975
SIM,1819,64,na,1883,907
STAT,1829,35,45-49,1864,1.6870943826406948
STAT,1926,31,35-39,1957,11.174200594452445
SIM,1845,30,45-49,1875,4
STAT,1846,50,40-44,1896,0.008104083285744459
SIM,1810,72,na,1882,724
STAT,1898,39,25-29,1937,0.8423301197533665
STAT,1814,66,na,1880,909.0619586769388
STAT,1931,21,15-19,1952,6.998641684038739
SIM,1848,28,30-34,1876,37
STAT,1842,34,35-39,1876,10.788083501373372
STAT,1915,43,40-44,1958,0.2536972050752507
SIM,1784,92,na,1876,8
STAT,1878,21,na,1899,2487.1327671356603
SIM,1891,43,35-39,1934,4
STAT,1883,43,35-39,1926,1.776827630771249
STAT,1873,47,40-44,1920,0.17447609167804856
STAT,1890,45,na,1935,2804.3475166843427
STAT,1957,6,na,1963,5235.675390983375
SIM,1883,5,na,1888,2994
STAT,1840,44,25-29,1884,0.45768692442941933
SIM,1892,56,na,1948,2787
STAT,1850,44,35-39,1894,1.3678491029237079
STAT,1804,66,na,1870,733.254633104915
STAT,1929,18,50-100,1947,0.48200889790046153
SIM,1928,16,15-19,1944,81
STAT,1816,52,35-39,1868,0.021381176741306032
STAT,1849,51,20-24,1900,5.797048669938986E-4
SIM,1850,34,35-39,1884,9
STAT,1861,51,35-39,1912,0.007259983056936483
STAT,1948,23,35-39,1971,10.917791076523455
STAT,1950,8,na,1958,4694.942814052233
SIM,1859,27,45-49,1886,2
SIM,1865,13,na,1878,2460
STAT,1925,17,35-39,1942,5.122732128563978
STAT,1857,45,35-39,1902,0.1114543904290537
STAT,1891,45,35-39,1936,0.09973685594213748
SIM,1871,30,na,1901,2306
SIM,1897,31,20-24,1928,3
STAT,1875,19,35-39,1894,0.5660785868537902
SIM,1914,11,na,1925,4333
STAT,1824,36,40-44,1860,6.295067887339193
STAT,1861,44,45-49,1905,1.2391453478915553
STAT,1910,31,50-100,1941,0.8075944107052104
SIM,1899,25,25-29,1924,65
SIM,1895,43,na,1938,3113
STAT,1820,50,35-39,1870,0.014624115409937863
SIM,1833,90,na,1923,50
STAT,1888,21,na,1909,2827.914092827526
STAT,1824,54,35-39,1878,0.009332679855089945
STAT,1764,96,na,1860,0.7895253544001973
STAT,1821,99,na,1920,1.1344110628169337
SIM,1860,39,20-24,1899,1
SIM,1859,29,na,1888,2226
STAT,1875,18,25-29,1893,5.862230445915933
SIM,1808,68,na,1876,663
STAT,1830,47,20-24,1877,0.010037107702252059
SIM,1786,73,na,1859,481
SIM,1841,64,na,1905,1204
SIM,1933,17,35-39,1950,7
SIM,1831,40,45-49,1871,3
STAT,1917,19,na,1936,3963.623189773328
STAT,1847,16,20-24,1863,16.665428658556678
STAT,1866,40,30-34,1906,1.08605640715514
SIM,1872,70,na,1942,1435
SIM,1826,97,na,1923,12
STAT,1889,31,20-24,1920,3.3801307964297664
SIM,1945,13,na,1958,4209
STAT,1789,108,na,1897,5.575153872094056E-4
STAT,1907,29,35-39,1936,14.089672724828997
STAT,1882,71,na,1953,1305.898932800395
SIM,1833,24,20-24,1857,51
STAT,1922,49,40-44,1971,0.18190515442972946
STAT,1846,54,20-24,1900,5.445963499736389E-4
SIM,1915,41,40-44,1956,3
SIM,1898,61,na,1959,2656
SIM,1870,21,50-100,1891,3
STAT,1890,31,45-49,1921,2.1609521169802437
SIM,1907,19,35-39,1926,1
STAT,1901,31,30-34,1932,24.8214942484619
STAT,1839,17,25-29,1856,5.255547796750843
STAT,1837,39,na,1876,1742.3337900921513
STAT,1919,42,15-19,1961,0.001680298100598277
SIM,1891,35,35-39,1926,16
STAT,1787,69,na,1856,570.8058294
STAT,1883,12,na,1895,2552.477988748228
SIM,1793,75,na,1868,413
STAT,1881,15,45-49,1896,0.0638912094361523
STAT,1849,28,25-29,1877,38.924021754816216
SIM,1843,45,na,1888,2076
SIM,1850,42,35-39,1892,5
STAT,1873,39,40-44,1912,4.437056002353043
STAT,1867,28,40-44,1895,2.839416006017409
STAT,1826,49,20-24,1875,0.011507353746219395
STAT,1859,95,na,1954,10.800438796695603
SIM,1847,17,25-29,1864,8
STAT,1806,48,40-44,1854,0.5085748526611451
STAT,1881,44,15-19,1925,0.013263293875567673
SIM,1911,24,na,1935,3799
STAT,1920,25,20-24,1945,20.358224022641853
SIM,1813,79,na,1892,337
SIM,1922,40,na,1962,4825
SIM,1872,41,45-49,1913,1
SIM,1874,40,30-34,1914,2
STAT,1859,18,40-44,1877,0.1714528534590359
STAT,1900,32,40-44,1932,6.084461620433523
SIM,1878,18,15-19,1896,7
STAT,1911,20,35-39,1931,9.063068886626267
STAT,1843,41,25-29,1884,0.45169008497135366
STAT,1870,27,20-24,1897,11.635115457467748
STAT,1824,86,na,1910,110.30592620610483
STAT,1836,67,na,1903,999.5178679209235
SIM,1840,46,50-100,1886,2
STAT,1842,42,35-39,1884,1.6867621090221028
STAT,1885,33,50-100,1918,0.9172490250095741
STAT,1896,30,na,1926,3215.9540022386436
STAT,1832,46,40-44,1878,0.140019198916035
STAT,1853,31,40-44,1884,3.7317599395830108
STAT,1851,54,30-34,1905,0.004383252849565845
STAT,1877,17,45-49,1894,0.06809370239009081
SIM,1915,29,35-39,1944,20
STAT,1855,25,45-49,1880,0.9711798465574526
STAT,1881,35,50-100,1916,1.206639739238463
STAT,1852,39,20-24,1891,0.5787217932159606
STAT,1854,108,na,1962,0.005867618448368351
STAT,1850,33,30-34,1883,13.840997650724283
STAT,1904,22,na,1926,3427.9459228139826
STAT,1892,15,20-24,1907,22.573164928300926
STAT,1919,52,na,1971,3955.596108219075
STAT,1862,35,15-19,1897,0.0494443097977628
STAT,1864,41,45-49,1905,1.370190525333612
STAT,1924,40,15-19,1964,0.001850963558581609
SIM,1898,41,na,1939,3195
STAT,1823,49,na,1872,1404.0929915169168
STAT,1948,2,na,1950,4649.238538531635
STAT,1885,48,15-19,1933,3.970819144589351E-4
STAT,1840,43,15-19,1883,0.009969643780317986
STAT,1891,27,40-44,1918,3.745887326393365
STAT,1863,20,45-49,1883,0.6457010835983126
STAT,1850,80,na,1930,473.6677258785468
STAT,1832,46,50-100,1878,0.2008686637188302
STAT,1795,98,na,1893,0.7521352985387793
SIM,1865,38,45-49,1903,3
STAT,1930,21,15-19,1951,6.913295976749823
STAT,1839,85,na,1924,194.35387395513038
STAT,1865,48,45-49,1913,0.21491760643567615
STAT,1837,19,15-19,1856,5.876997344412758
SIM,1856,63,na,1919,1540
STAT,1820,43,45-49,1863,2.7274784891976838
SIM,1893,62,na,1955,2375
STAT,1837,50,na,1887,1533.734898046914
STAT,1846,13,na,1859,2265.451594705283
STAT,1911,45,15-19,1956,3.534893452646038E-4
STAT,1843,19,40-44,1862,0.15579680186303943
SIM,1835,33,50-100,1868,2
SIM,1854,0,na,1854,3369
STAT,1916,34,45-49,1950,1.6254594647510312
STAT,1877,47,50-100,1924,0.25482559216874107
SIM,1915,22,35-39,1937,13
SIM,1846,25,45-49,1871,2
STAT,1865,30,20-24,1895,2.5129505338749567
STAT,1816,41,30-34,1857,3.426510478770374
STAT,1881,37,25-29,1918,2.8030869160412086
SIM,1845,16,na,1861,2308
STAT,1830,28,na,1858,1863.8209126441182
STAT,1856,33,na,1889,1851.1328446132536
SIM,1879,26,na,1905,2768
STAT,1829,31,na,1860,1696.3885680830822
SIM,1883,42,na,1925,2546
STAT,1799,71,na,1870,618.4759697285982
STAT,1910,32,35-39,1942,8.889838682346909
STAT,1851,29,50-100,1880,0.5590120660249023
STAT,1879,92,na,1971,174.53772646375577
SIM,1832,50,na,1882,1397
STAT,1858,52,25-29,1910,0.0027917022848034994
STAT,1831,43,20-24,1874,0.12119884689167654
STAT,1933,31,40-44,1964,5.332260275928011
STAT,1814,46,25-29,1860,0.14128049166671197
SIM,1850,31,30-34,1881,23
SIM,1899,18,35-39,1917,1
STAT,1951,21,na,1972,4409.516618120841
SIM,1866,33,50-100,1899,1
STAT,1863,46,20-24,1909,0.010769166716364735
STAT,1834,32,35-39,1866,7.725461074934187
SIM,1842,32,35-39,1874,12
SIM,1853,45,na,1898,1722
SIM,1868,75,na,1943,771
STAT,1823,44,25-29,1867,0.9052830569648278
SIM,1853,35,na,1888,1819
STAT,1886,30,na,1916,2565.2004256699583
SIM,1938,3,na,1941,3951
SIM,1851,10,na,1861,2426
SIM,1891,25,40-44,1916,4
SIM,1960,1,na,1961,5282
SIM,1875,44,50-100,1919,1
SIM,1930,25,50-100,1955,1
STAT,1826,98,na,1924,1.782540763422236
SIM,1917,18,na,1935,3808
STAT,1831,35,50-100,1866,1.0031177451796243
STAT,1920,41,50-100,1961,0.1312140144295351
SIM,1867,29,45-49,1896,1
STAT,1833,52,20-24,1885,5.400332904012217E-4
SIM,1895,5,na,1900,3474
STAT,1922,45,25-29,1967,0.061852325624575856
STAT,1860,45,40-44,1905,0.14275643809664745
SIM,1861,31,40-44,1892,11
SIM,1864,38,50-100,1902,1
STAT,1855,51,45-49,1906,0.0109760627546243
STAT,1785,102,na,1887,0.08662555525199826
STAT,1913,33,15-19,1946,0.12845445674855271
SIM,1813,70,na,1883,693
STAT,1893,21,50-100,1914,0.524546218760084
SIM,1779,91,na,1870,31
SIM,1898,26,20-24,1924,21
STAT,1838,25,45-49,1863,0.9591942146853967
STAT,1859,44,50-100,1903,0.84660945183444
SIM,1906,43,40-44,1949,1
STAT,1881,49,40-44,1930,0.16319437166144393
STAT,1859,29,45-49,1888,0.9043789772537949
STAT,1922,31,15-19,1953,0.1472793262324264
SIM,1868,40,40-44,1908,8
SIM,1857,25,20-24,1882,13
STAT,1839,41,na,1880,1748.6455226834776
STAT,1872,44,20-24,1916,0.1590853344296545
STAT,1883,25,40-44,1908,2.9808160498082117
STAT,1945,25,50-100,1970,1.1037650752365264
SIM,1855,39,50-100,1894,1
SIM,1826,43,na,1869,1896
STAT,1939,33,35-39,1972,9.407093691539595
STAT,1822,45,20-24,1867,0.018298314351014592
STAT,1842,31,30-34,1873,19.187864881337
STAT,1942,24,45-49,1966,1.1903219058459167
STAT,1912,22,50-100,1934,0.6362058482631373
STAT,1866,51,20-24,1917,6.934282371746934E-4
STAT,1918,23,50-100,1941,0.7142446388333584
SIM,1892,42,25-29,1934,1
STAT,1920,43,15-19,1963,0.001710039950371503
SIM,1835,41,40-44,1876,5
SIM,1925,37,na,1962,4553
SIM,1831,44,25-29,1875,4
STAT,1863,50,40-44,1913,0.009556470774011238
SIM,1892,15,na,1907,3534
SIM,1855,13,na,1868,2465
STAT,1890,34,50-100,1924,1.121112960957306
STAT,1839,40,20-24,1879,0.1337904090445132
SIM,1921,44,na,1965,4085
STAT,1843,52,50-100,1895,0.010132091088756187
STAT,1879,26,45-49,1905,1.1742753157090282
SIM,1817,73,na,1890,607
STAT,1890,35,25-29,1925,3.58713937224754
STAT,1811,52,35-39,1863,0.020504274609636462
STAT,1924,33,40-44,1957,4.610706715987524
SIM,1885,77,na,1962,993
STAT,1873,12,na,1885,2686.0606605140188
STAT,1888,65,na,1953,2014.6240556784994
SIM,1890,8,na,1898,3527
SIM,1882,20,20-24,1902,80
SIM,1816,42,35-39,1858,1
SIM,1932,33,40-44,1965,10
STAT,1907,22,35-39,1929,8.65534664615149
STAT,1867,50,25-29,1917,0.0034176577126589745
STAT,1894,32,50-100,1926,1.1914264977954234
SIM,1792,80,na,1872,138
STAT,1840,48,40-44,1888,0.1194790069012083
STAT,1855,47,25-29,1902,0.043154588959277665
SIM,1839,61,na,1900,1185
STAT,1875,33,35-39,1908,10.459643198364285
STAT,1867,16,25-29,1883,5.543169688456853
STAT,1892,30,30-34,1922,22.30595113185803
SIM,1917,9,na,1926,4202
STAT,1805,53,20-24,1858,0.002973135759790011
STAT,1890,49,35-39,1939,0.09542876006585321
STAT,1855,18,20-24,1873,15.778625627495538
STAT,1817,51,25-29,1868,0.007440503585941994
STAT,1811,45,45-49,1856,0.6075633757417757
STAT,1949,23,50-100,1972,0.7754219104405409
STAT,1924,40,30-34,1964,0.1540927053299622
SIM,1863,18,20-24,1881,1
STAT,1894,32,40-44,1926,5.639185842454441
STAT,1894,46,15-19,1940,2.9423174178269126E-4
SIM,1858,24,25-29,1882,81
STAT,1870,37,15-19,1907,0.05569343411682171
SIM,1888,10,na,1898,3205
STAT,1882,40,15-19,1922,0.013647142169948456
STAT,1884,42,25-29,1926,0.6387977623040918
STAT,1800,73,na,1873,445.4955774783102
STAT,1827,41,40-44,1868,2.4615201607731847
STAT,1899,22,50-100,1921,0.5652594331279468
STAT,1920,36,25-29,1956,1.0896254257149194
STAT,1935,17,na,1952,5083.821082127742
SIM,1883,33,35-39,1916,15
SIM,1838,19,25-29,1857,9
SIM,1839,16,20-24,1855,25
STAT,1839,31,na,1870,1910.6057560754095
STAT,1939,15,20-24,1954,137.3391321759705
SIM,1890,33,25-29,1923,22
STAT,1790,68,na,1858,611.6245604142656
STAT,1868,42,40-44,1910,2.168532329353784
SIM,1842,50,na,1892,1561
SIM,1807,83,na,1890,189
SIM,1894,30,40-44,1924,7
STAT,1835,54,45-49,1889,0.010673508071825108
SIM,1865,42,30-34,1907,1
SIM,1954,17,na,1971,4448
STAT,1869,16,40-44,1885,0.18316913610202726
SIM,1855,19,25-29,1874,5
SIM,1866,53,na,1919,2143
STAT,1828,40,45-49,1868,1.4786034836459927
SIM,1830,43,50-100,1873,1
SIM,1862,35,50-100,1897,4
STAT,1808,80,na,1888,268.57110448659785
STAT,1864,45,25-29,1909,0.053019262431165746
SIM,1858,75,na,1933,665
STAT,1921,3,na,1924,4669.514562593281
STAT,1858,19,35-39,1877,0.5019268616120945
STAT,1797,90,na,1887,31.80498592642394
STAT,1949,18,35-39,1967,4.92875421276051
STAT,1927,41,45-49,1968,0.21127447866392804
STAT,1820,36,20-24,1856,2.0336905336260607
STAT,1912,23,20-24,1935,107.18020154135873
STAT,1921,35,30-34,1956,2.0589161667331854
SIM,1834,31,na,1865,2004
STAT,1901,20,40-44,1921,2.9679798704006073
SIM,1920,23,20-24,1943,5
STAT,1874,53,20-24,1927,7.508953803159048E-4
STAT,1835,33,50-100,1868,0.8668072834823962
STAT,1901,49,20-24,1950,0.009383833127719201
STAT,1893,47,45-49,1940,0.16992737464773827
SIM,1837,28,na,1865,1735
SIM,1876,42,40-44,1918,7
SIM,1897,55,na,1952,2803
SIM,1899,48,50-100,1947,3
SIM,1924,16,30-34,1940,20
STAT,1789,71,na,1860,729.9545361111126
SIM,1889,26,na,1915,2951
STAT,1849,25,20-24,1874,11.030696649608803
STAT,1890,42,15-19,1932,0.017022567344139886
STAT,1842,50,20-24,1892,6.739217981941246E-4
STAT,1882,33,25-29,1915,9.978539129753639
SIM,1827,83,na,1910,172
SIM,1803,70,na,1873,597
SIM,1819,40,45-49,1859,1
STAT,1886,30,40-44,1916,4.661817663547632
STAT,1866,25,20-24,1891,11.046070543929309
SIM,1862,47,50-100,1909,1
STAT,1822,52,45-49,1874,0.02072519000346723
SIM,1822,50,na,1872,1471
STAT,1878,31,45-49,1909,1.8357903661202926
STAT,1932,35,40-44,1967,2.036154299164525
STAT,1910,5,na,1915,4006.3985077868715
SIM,1825,29,40-44,1854,2
STAT,1866,33,na,1899,2222.337812830583
SIM,1839,41,25-29,1880,3
STAT,1762,105,na,1867,0.013345217594517223
STAT,1932,21,30-34,1953,38.22502741807743
SIM,1821,88,na,1909,77
SIM,1834,21,na,1855,2037
STAT,1898,32,25-29,1930,14.024263653804613
SIM,1874,25,20-24,1899,15
STAT,1934,19,50-100,1953,0.5092981760037474
SIM,1857,18,30-34,1875,3
SIM,1886,31,45-49,1917,4
STAT,1884,62,na,1946,1820.4110808389912
STAT,1882,47,35-39,1929,0.13633010459106065
SIM,1889,36,na,1925,2899
STAT,1916,16,30-34,1932,2.61615256066567
STAT,1873,22,na,1895,2421.595900019603
STAT,1857,31,25-29,1888,8.208311697090055
SIM,1923,21,30-34,1944,41
STAT,1901,16,50-100,1917,0.06953587883307379
SIM,1891,32,30-34,1923,31
STAT,1866,18,30-34,1884,1.5210076568538113
SIM,1904,42,na,1946,3480
STAT,1849,18,30-34,1867,1.5249031271450035
STAT,1883,51,20-24,1934,7.328279749251529E-4
SIM,1869,24,35-39,1893,8
STAT,1810,102,na,1912,0.15226340836829894
STAT,1834,86,na,1920,132.06703050635826
SIM,1824,34,40-44,1858,7
STAT,1938,17,50-100,1955,0.3730996958817822
SIM,1866,63,na,1929,1731
SIM,1874,82,na,1956,544
SIM,1881,35,25-29,1916,2
SIM,1929,9,na,1938,4974
STAT,1934,22,na,1956,4958.763711454017
STAT,1876,48,20-24,1924,0.01235687548433495
STAT,1830,102,na,1932,0.19341921442787346
SIM,1865,35,40-44,1900,7
SIM,1857,43,35-39,1900,1
STAT,1880,24,50-100,1904,0.42983974445950923
STAT,1917,40,na,1957,3923.05411082575
STAT,1922,41,na,1963,4312.662059113927
STAT,1915,21,30-34,1936,30.068997597617397
STAT,1852,50,30-34,1902,0.004579238930998148
STAT,1887,80,na,1967,1065.6091197975538
SIM,1873,42,na,1915,2227
STAT,1886,40,na,1926,2489.559512870426
SIM,1865,31,25-29,1896,18
SIM,1924,34,45-49,1958,4
STAT,1793,86,na,1879,70.14602870360892
STAT,1883,32,30-34,1915,17.2566841783243
STAT,1830,73,na,1903,783.6077245579947
SIM,1826,34,50-100,1860,1
SIM,1874,18,30-34,1892,4
SIM,1903,19,15-19,1922,8
STAT,1840,28,na,1868,1877.1860449713954
STAT,1916,41,35-39,1957,0.20854781489364035
STAT,1873,42,15-19,1915,0.014122608006678156
STAT,1893,40,25-29,1933,0.8318385182194178
SIM,1907,16,30-34,1923,8
STAT,1821,102,na,1923,0.17560945216389032
SIM,1780,88,na,1868,51
STAT,1821,68,na,1889,912.4420212073015
STAT,1911,38,25-29,1949,0.9546880055069362
STAT,1869,41,45-49,1910,1.4762882951661533
SIM,1901,24,na,1925,3287
STAT,1906,45,40-44,1951,0.14348235572775475
SIM,1854,82,na,1936,385
STAT,1812,44,15-19,1856,0.033280806452024914
STAT,1906,31,30-34,1937,14.80862828389557
SIM,1881,30,na,1911,2098
STAT,1914,22,na,1936,3764.2420216490564
SIM,1883,15,20-24,1898,20
SIM,1912,30,na,1942,3662
STAT,1892,41,20-24,1933,0.20218705909132204
SIM,1849,26,25-29,1875,54
STAT,1868,45,na,1913,2193.402188112723
STAT,1847,19,25-29,1866,5.233346095494238
STAT,1856,7,na,1863,2266.260525438469
SIM,1919,18,15-19,1937,56
STAT,1825,50,20-24,1875,9.935780807037037E-4
STAT,1925,43,35-39,1968,0.24599134812041668
STAT,1841,32,25-29,1873,9.293342882810022
STAT,1875,15,20-24,1890,18.473777703797364
STAT,1832,49,45-49,1881,0.16901747128037428
SIM,1824,41,30-34,1865,1
SIM,1860,43,40-44,1903,4
STAT,1931,36,50-100,1967,0.5624762693989735
SIM,1877,41,45-49,1918,9
SIM,1932,22,35-39,1954,18
STAT,1864,49,40-44,1913,0.1527717076293704
STAT,1922,42,20-24,1964,0.020477927402715805
SIM,1833,35,na,1868,1897
SIM,1850,20,25-29,1870,4
STAT,1845,108,na,1953,0.0013384148721627505
STAT,1895,44,na,1939,3017.67820369205
STAT,1817,94,na,1911,9.1440769056807
STAT,1874,35,40-44,1909,4.5701629095146945
STAT,1881,34,20-24,1915,2.609073873288392
SIM,1878,41,na,1919,2693
STAT,1930,33,15-19,1963,0.16751453836799174
SIM,1823,49,45-49,1872,3
STAT,1901,30,35-39,1931,14.453736502824839
STAT,1810,73,na,1883,623.7679359110583
STAT,1831,46,25-29,1877,0.04358002261699359
STAT,1879,51,na,1930,2280.296766087881
SIM,1899,36,na,1935,3604
SIM,1866,26,25-29,1892,64
STAT,1912,48,35-39,1960,0.12466219081693507
STAT,1922,5,na,1927,4700.901126310898
SIM,1924,31,40-44,1955,4
STAT,1853,49,30-34,1902,0.07837991760803523
STAT,1847,60,na,1907,1427.976040508463
STAT,1908,59,na,1967,3153.818084501052
SIM,1782,80,na,1862,61
STAT,1865,1,na,1866,3315.333540983149
SIM,1844,31,na,1875,1700
STAT,1820,46,15-19,1866,6.907180200911852E-4
SIM,1849,23,20-24,1872,66
STAT,1830,46,25-29,1876,0.048806072264945564
STAT,1861,34,na,1895,1985.6363869456693
SIM,1943,22,na,1965,3862
STAT,1880,48,na,1928,2356.444154173791
STAT,1787,90,na,1877,25.689267622483886
STAT,1815,49,45-49,1864,0.5064771792102061
STAT,1870,21,50-100,1891,0.4056627778678502
STAT,1918,44,20-24,1962,0.018893479909863026
STAT,1844,41,40-44,1885,1.8460994645407298
STAT,1890,46,30-34,1936,0.0675805369079745
STAT,1847,50,50-100,1897,0.011470488317293887
STAT,1903,23,50-100,1926,0.5847586273071815
STAT,1880,46,20-24,1926,0.012764665100168174
STAT,1882,81,na,1963,769.2822422244598
STAT,1834,108,na,1942,0.0010902941116491297
SIM,1818,68,na,1886,750
SIM,1797,68,na,1865,671
SIM,1884,40,25-29,1924,1
STAT,1900,43,30-34,1943,0.11120071127013754
STAT,1875,52,25-29,1927,0.0036542799800949625
STAT,1891,41,na,1932,2903.2321809709033
STAT,1876,40,25-29,1916,0.6764261316822465
SIM,1803,69,na,1872,597
STAT,1939,30,30-34,1969,16.246853944573886
STAT,1776,112,na,1888,6.733257635542823E-4
STAT,1833,41,30-34,1874,1.0019763266423842
STAT,1835,47,20-24,1882,0.009497258317146172
STAT,1897,44,25-29,1941,0.0595661083209456
STAT,1902,30,35-39,1932,14.570139756209072
SIM,1940,9,na,1949,4222
SIM,1950,21,40-44,1971,4
STAT,1911,42,45-49,1953,0.1602581290242845
STAT,1912,30,45-49,1942,1.5747188606540294
SIM,1899,29,40-44,1928,6
STAT,1858,26,25-29,1884,34.561481430624895
STAT,1923,48,45-49,1971,0.25617583347406436
STAT,1814,43,20-24,1857,0.4230182295152576
STAT,1891,20,20-24,1911,86.68773128896495
STAT,1924,22,35-39,1946,11.227404661246647
STAT,1933,34,45-49,1967,2.1401298430230296
STAT,1863,53,45-49,1916,0.012778490435911652
STAT,1903,36,25-29,1939,0.8982034758969863
SIM,1906,32,35-39,1938,14
STAT,1820,52,50-100,1872,0.02465109246559368
STAT,1914,43,25-29,1957,0.0712786236844765
SIM,1852,41,40-44,1893,9
STAT,1875,88,na,1963,283.46536603978836
STAT,1897,48,40-44,1945,0.12911984980873192
STAT,1904,43,15-19,1947,0.0013799270291950225
STAT,1904,56,na,1960,3057.9631105333256
SIM,1846,18,20-24,1864,21
SIM,1920,30,45-49,1950,2
SIM,1910,30,35-39,1940,9
STAT,1931,24,50-100,1955,0.8570946518890613
STAT,1871,47,25-29,1918,0.057527780232167404
STAT,1825,42,35-39,1867,2.5965096011231386
STAT,1838,45,na,1883,1589.6878363125663
STAT,1825,72,na,1897,921.608814236904
SIM,1884,37,na,1921,2406
STAT,1861,47,15-19,1908,3.3414665886059256E-4
SIM,1871,64,na,1935,1572
STAT,1840,40,45-49,1880,1.2338417704105449
STAT,1882,26,na,1908,2342.861791461225
STAT,1868,11,na,1879,2589.891250678575
STAT,1920,47,30-34,1967,0.09951177504687261
STAT,1824,50,50-100,1874,0.01772613043361773
STAT,1900,9,na,1909,3640.299172630551
STAT,1926,23,50-100,1949,0.805414480662076
SIM,1841,34,40-44,1875,6
STAT,1916,19,35-39,1935,0.8936179654461427
STAT,1875,30,30-34,1905,18.255091122161453
STAT,1833,34,40-44,1867,3.883326853305991
STAT,1848,45,na,1893,1855.2146264410942
SIM,1804,55,na,1859,1336
STAT,1838,18,20-24,1856,15.583896712054688
SIM,1836,40,45-49,1876,1
STAT,1815,72,na,1887,592.1992778721117
SIM,1934,23,50-100,1957,1
STAT,1865,40,15-19,1905,0.012864711083400064
STAT,1867,54,40-44,1921,0.009738749009510356
SIM,1898,15,15-19,1913,8
SIM,1927,18,na,1945,4987
SIM,1865,23,na,1888,2172
SIM,1904,1,na,1905,4046
STAT,1838,28,50-100,1866,0.5408137498922654
SIM,1913,56,na,1969,3424
SIM,1837,40,50-100,1877,2
STAT,1823,48,40-44,1871,0.232307195406558
STAT,1842,20,25-29,1862,65.9510500317073
STAT,1829,40,50-100,1869,0.8451941859592313
SIM,1922,19,na,1941,4781
SIM,1908,46,50-100,1954,2
STAT,1862,32,45-49,1894,1.5209971210183968
SIM,1875,67,na,1942,1581
STAT,1895,31,45-49,1926,2.3094370118321894
SIM,1858,28,40-44,1886,4
STAT,1863,12,na,1875,2437.735552404205
STAT,1878,11,na,1889,2719.9927829966236
STAT,1885,45,45-49,1930,0.2396250805516798
STAT,1892,41,50-100,1933,1.3449834544033106
SIM,1827,28,na,1855,1648
STAT,1865,78,na,1943,720.5887772311869
STAT,1890,39,40-44,1929,5.348168310984692
SIM,1848,34,na,1882,1878
STAT,1933,36,na,1969,5182.980322213195
STAT,1782,91,na,1873,18.52799191897915
SIM,1860,68,na,1928,1252
SIM,1928,30,50-100,1958,2
STAT,1901,23,45-49,1924,0.9842571547941319
SIM,1912,19,na,1931,3828
STAT,1820,39,25-29,1859,6.106714652252222
STAT,1940,23,30-34,1963,29.54851466721333
STAT,1818,54,45-49,1872,0.023850429241844884
SIM,1849,16,30-34,1865,3
STAT,1843,29,50-100,1872,0.5233811420903548
STAT,1949,15,30-34,1964,14.329033979319336
STAT,1869,92,na,1961,82.52146497063391
SIM,1813,69,na,1882,769
STAT,1897,25,na,1922,3253.4163041233955
STAT,1908,15,na,1923,3799.487371489991
STAT,1867,59,na,1926,1848.6657062778067
STAT,1841,36,40-44,1877,3.8971551768422574
SIM,1922,30,na,1952,4830
SIM,1844,42,45-49,1886,3
STAT,1908,17,35-39,1925,0.8216530217705421
STAT,1860,52,30-34,1912,0.004888420098289759
STAT,1885,21,50-100,1906,0.41120480849484525
SIM,1840,17,na,1857,2112
STAT,1874,45,35-39,1919,0.14623000280870246
STAT,1868,19,45-49,1887,0.06344287321515858
STAT,1814,50,45-49,1864,0.034792128811065505
STAT,1909,55,na,1964,3299.6254764791247
SIM,1843,35,na,1878,2327
SIM,1838,16,20-24,1854,17
STAT,1842,20,na,1862,2463.276539170082
STAT,1936,26,50-100,1962,0.9621161330776374
STAT,1911,35,20-24,1946,0.2593127396380651
STAT,1917,41,35-39,1958,0.21242242477747622
STAT,1939,18,25-29,1957,43.776952772526805
SIM,1883,30,30-34,1913,29
STAT,1889,46,40-44,1935,0.21381683273033641
SIM,1924,19,35-39,1943,6
STAT,1787,79,na,1866,234.32584479831044
SIM,1914,52,na,1966,3766
SIM,1916,17,35-39,1933,3
STAT,1864,15,45-49,1879,0.06848203435103506
STAT,1861,37,20-24,1898,0.646958144564975
SIM,1812,84,na,1896,80
STAT,1834,51,25-29,1885,0.002206174508352519
STAT,1869,19,45-49,1888,0.0642683999447179
STAT,1872,4,na,1876,2983.9761095599933
STAT,1856,43,25-29,1899,0.4936598595958976
SIM,1833,42,35-39,1875,2
SIM,1961,10,na,1971,5231
SIM,1891,21,25-29,1912,102
SIM,1915,37,na,1952,4202
SIM,1862,30,45-49,1892,4
STAT,1842,61,na,1903,1682.397520184211
STAT,1857,60,na,1917,1503.3235634436935
STAT,1892,33,35-39,1925,12.780669703485993
STAT,1870,41,35-39,1911,1.8040700365198834
STAT,1866,74,na,1940,1037.9104223172267
SIM,1904,48,50-100,1952,2
SIM,1835,57,na,1892,1158
STAT,1842,53,25-29,1895,0.003137794477824867
SIM,1861,3,na,1864,2767
STAT,1872,47,25-29,1919,0.05821556736578693
STAT,1784,102,na,1886,0.07391326096573364
STAT,1775,112,na,1887,5.708092287680226E-4
STAT,1942,21,40-44,1963,3.5606387356448623
SIM,1809,54,na,1863,1121
SIM,1839,19,25-29,1858,8
STAT,1818,79,na,1897,360.1837681103357
SIM,1893,21,50-100,1914,4
SIM,1828,68,na,1896,868
STAT,1844,86,na,1930,175.54493079275562
SIM,1861,64,na,1925,1529
STAT,1876,18,40-44,1894,0.19023942688065917
STAT,1883,21,25-29,1904,56.75074126684043
SIM,1882,38,45-49,1920,3
SIM,1940,31,25-29,1971,2
STAT,1854,30,45-49,1884,1.368326919758538
STAT,1924,22,na,1946,4354.351467993776
SIM,1867,44,50-100,1911,4
STAT,1881,41,na,1922,2260.3245593308948
STAT,1840,46,50-100,1886,0.17585079059556422
SIM,1811,43,45-49,1854,1
SIM,1852,50,na,1902,1632
SIM,1822,84,na,1906,126
SIM,1785,87,na,1872,39
SIM,1939,27,30-34,1966,57
STAT,1839,18,20-24,1857,16.345296092733708
STAT,1866,28,25-29,1894,39.42240957355347
STAT,1870,34,45-49,1904,1.7146950383065833
STAT,1843,49,20-24,1892,0.007924625313132249
STAT,1903,43,15-19,1946,0.0013694491424617648
SIM,1889,4,na,1893,3277
STAT,1836,42,45-49,1878,1.1231810241191111
STAT,1853,45,15-19,1898,3.340881716460756E-4
SIM,1906,23,na,1929,3364
STAT,1881,41,45-49,1922,1.4636701082163852
SIM,1824,30,25-29,1854,13
STAT,1956,7,na,1963,5254.225543091931
SIM,1864,82,na,1946,479
SIM,1876,63,na,1939,2030
STAT,1925,40,30-34,1965,0.1568588880185389
SIM,1891,30,na,1921,3141
SIM,1887,19,20-24,1906,2
STAT,1874,52,na,1926,2214.929304843202
STAT,1828,79,na,1907,453.8291810601579
STAT,1912,41,na,1953,3634.6581543193333
STAT,1858,45,na,1903,1800.516832642722
SIM,1839,20,na,1859,1836
STAT,1873,32,20-24,1905,2.767687714645231
STAT,1906,41,25-29,1947,0.0658973054587434
SIM,1879,81,na,1960,702
STAT,1905,6,na,1911,3814.2940122680125
SIM,1949,16,35-39,1965,12
STAT,1927,40,na,1967,4720.92788143096
STAT,1896,16,50-100,1912,0.06565914625799145
SIM,1826,87,na,1913,132
STAT,1847,27,50-100,1874,0.5756871295632427
STAT,1916,31,40-44,1947,4.09393012184318
STAT,1807,54,35-39,1861,0.028056496327212105
STAT,1896,40,na,1936,3131.9030611478397
SIM,1878,39,50-100,1917,1
STAT,1893,44,40-44,1937,0.1976062757422114
STAT,1848,45,40-44,1893,0.14117120969939453
STAT,1852,53,35-39,1905,0.0064242104001280866
STAT,1812,48,30-34,1860,0.21971658891875911
STAT,1851,32,35-39,1883,7.981108135749526
SIM,1882,15,na,1897,2294
STAT,1831,68,na,1899,960.3201130216586
SIM,1848,75,na,1923,624
STAT,1826,53,40-44,1879,0.009808307396911386
STAT,1867,19,35-39,1886,0.5273164217484303
STAT,1929,16,30-34,1945,15.76116728038816
SIM,1839,24,20-24,1863,95
SIM,1896,51,na,1947,2830
STAT,1839,19,na,1858,2103.8794629973772
SIM,1938,32,na,1970,3782
STAT,1954,10,na,1964,4907.447550373201
STAT,1831,90,na,1921,49.543452299754506
STAT,1908,42,45-49,1950,0.155435847497275
STAT,1898,15,20-24,1913,24.386841471449884
STAT,1950,17,35-39,1967,5.012747926816179
STAT,1909,35,15-19,1944,0.01851620655104436
SIM,1935,19,30-34,1954,24
SIM,1781,75,na,1856,329
STAT,1843,24,na,1867,1784.228400375508
STAT,1901,25,45-49,1926,1.5826961094501804
STAT,1905,44,15-19,1949,0.001381307496153722
SIM,1924,30,30-34,1954,5
STAT,1903,22,45-49,1925,1.0030365976816462
SIM,1855,77,na,1932,728
STAT,1904,15,15-19,1919,8.641614005867583
STAT,1913,36,na,1949,3764.0810853306525
STAT,1835,80,na,1915,464.28607884714586
SIM,1931,28,30-34,1959,3
STAT,1860,49,20-24,1909,0.00970065762542771
STAT,1923,31,30-34,1954,18.323954868595134
STAT,1932,37,40-44,1969,2.0326332716053086
SIM,1889,18,25-29,1907,11
STAT,1927,19,30-34,1946,15.23601016085462
STAT,1864,54,30-34,1918,0.0052758912200997045
SIM,1876,32,25-29,1908,20
SIM,1945,22,15-19,1967,8
SIM,1903,28,25-29,1931,54
STAT,1868,32,25-29,1900,9.88709247139708
SIM,1875,19,35-39,1894,3
SIM,1909,43,na,1952,3792
STAT,1853,48,20-24,1901,0.00979902687765193
SIM,1920,25,20-24,1945,26
STAT,1911,41,35-39,1952,0.195016843750469
STAT,1855,105,na,1960,0.05846713569678423
SIM,1883,22,15-19,1905,7
STAT,1903,47,15-19,1950,3.2304058867707244E-4
SIM,1851,87,na,1938,98
STAT,1943,27,45-49,1970,1.8578079135564225
STAT,1900,61,na,1961,2758.996519583747
STAT,1835,29,na,1864,2085.6783978627004
STAT,1801,102,na,1903,0.11667791094350675
SIM,1937,16,30-34,1953,16
SIM,1804,85,na,1889,83
SIM,1859,36,40-44,1895,6
STAT,1873,46,na,1919,2310.173942080613
STAT,1866,32,15-19,1898,0.13318429511515348
STAT,1844,65,na,1909,1337.0716389915829
SIM,1910,18,15-19,1928,12
SIM,1928,29,40-44,1957,7
SIM,1880,76,na,1956,843
STAT,1848,79,na,1927,570.7903882754833
STAT,1902,18,15-19,1920,8.447955483158465
SIM,1943,25,15-19,1968,3
STAT,1935,22,50-100,1957,0.905285526478728
SIM,1947,17,na,1964,4509
SIM,1848,17,25-29,1865,7
STAT,1830,25,50-100,1855,0.799698378634989
STAT,1906,47,40-44,1953,0.14140369940650033
SIM,1905,38,30-34,1943,5
STAT,1886,16,40-44,1902,0.19552557868577483
STAT,1787,109,na,1896,2.3169293620800026E-4
STAT,1832,109,na,1941,4.844501600377879E-4
STAT,1912,25,20-24,1937,18.27165606228052
STAT,1934,32,45-49,1966,2.1708685669415626
STAT,1896,39,na,1935,3118.054936373552
STAT,1841,31,50-100,1872,0.8400072586937205
STAT,1900,1,na,1901,3818.809033545893
SIM,1910,23,40-44,1933,2
STAT,1838,51,50-100,1889,0.010257508459996201
STAT,1766,101,na,1867,0.06371895585074588
STAT,1927,39,25-29,1966,1.2346829152183036
STAT,1929,36,25-29,1965,1.2788161857641385
SIM,1867,22,30-34,1889,26
STAT,1930,41,45-49,1971,0.22164686811265524
STAT,1937,22,15-19,1959,5.2332110990676055
SIM,1941,9,na,1950,4262
SIM,1884,58,na,1942,2054
STAT,1826,44,na,1870,1449.0729949700624
STAT,1913,24,25-29,1937,93.52193323385826
SIM,1813,46,na,1859,1399
STAT,1885,79,na,1964,975.8109308781331
STAT,1922,45,50-100,1967,0.2637314458430878
SIM,1921,24,25-29,1945,173
STAT,1829,105,na,1934,0.017288579267988168
STAT,1936,33,50-100,1969,0.8102576929792106
STAT,1849,20,20-24,1869,66.08746165727692
STAT,1930,21,20-24,1951,144.41012333599429
SIM,1880,68,na,1948,1309
STAT,1923,40,15-19,1963,0.0018185819445136063
STAT,1942,17,na,1959,3883.6967481579695
SIM,1955,12,na,1967,5053
STAT,1951,9,na,1960,4727.8210049234385
SIM,1911,22,45-49,1933,1
SIM,1906,34,30-34,1940,28
SIM,1850,46,na,1896,1892
STAT,1928,37,20-24,1965,0.3367328243724383
STAT,1900,40,20-24,1940,0.015628958214784182
STAT,1818,49,na,1867,1408.2322487577628
STAT,1813,46,25-29,1859,0.17074306455858873
SIM,1923,21,25-29,1944,109
STAT,1933,36,45-49,1969,0.9391668389217436
SIM,1845,21,40-44,1866,5
STAT,1805,50,na,1855,1431.1564383470788
SIM,1900,32,40-44,1932,4
SIM,1835,31,25-29,1866,18
STAT,1914,22,20-24,1936,114.6185237604561
STAT,1822,54,na,1876,1296.6232874976488
SIM,1880,44,na,1924,2153
SIM,1904,26,20-24,1930,19
SIM,1909,18,20-24,1927,33
SIM,1888,19,20-24,1907,27
STAT,1917,10,na,1927,4302.76032254162
STAT,1916,38,40-44,1954,1.539381786153704
STAT,1838,20,45-49,1858,0.6144237511328846
SIM,1909,29,30-34,1938,66
STAT,1887,15,45-49,1902,0.07400289614687462
STAT,1894,22,25-29,1916,74.43849342636844
STAT,1845,19,50-100,1864,0.04471372694402788
SIM,1905,36,35-39,1941,6
STAT,1948,16,40-44,1964,1.6174604709669718
SIM,1922,22,20-24,1944,143
STAT,1852,52,na,1904,1624.252033226963
STAT,1827,85,na,1912,163.01642752362278
STAT,1880,37,25-29,1917,3.0539946695053524
SIM,1905,25,25-29,1930,71
STAT,1917,37,45-49,1954,0.714727430002133
STAT,1837,21,40-44,1858,1.874451305501675
STAT,1872,80,na,1952,628.1355936838052
STAT,1934,34,40-44,1968,5.391777243611679
SIM,1891,38,50-100,1929,2
STAT,1915,21,25-29,1936,96.63658195084538
STAT,1916,30,30-34,1946,16.54711873037412
SIM,1830,26,na,1856,1731
STAT,1844,31,25-29,1875,9.79192571971794
STAT,1917,18,na,1935,4184.263327228744
SIM,1925,29,15-19,1954,4
STAT,1924,44,25-29,1968,0.08554596947995914
SIM,1901,55,na,1956,2958
STAT,1812,47,20-24,1859,0.027678618283011245
STAT,1856,25,50-100,1881,0.5207401640791294
SIM,1916,44,40-44,1960,2
STAT,1838,69,na,1907,982.4123993630353
SIM,1942,29,15-19,1971,1
STAT,1913,26,20-24,1939,18.414410444075543
STAT,1814,67,na,1881,875.7902909893627
STAT,1946,19,40-44,1965,1.5658367624498886
SIM,1921,37,30-34,1958,1
STAT,1845,18,45-49,1863,0.0599715349327913
STAT,1921,23,na,1944,4152.935783426251
STAT,1935,33,45-49,1968,2.198163715428853
STAT,1906,66,na,1972,2792.834861519201
STAT,1913,37,30-34,1950,1.8147481085134307
STAT,1896,30,35-39,1926,13.647918383136291
STAT,1918,46,20-24,1964,0.011902202357256732
SIM,1867,8,na,1875,2536
STAT,1867,31,50-100,1898,0.8751145738611346
STAT,1907,15,40-44,1922,0.2725473513109094
STAT,1929,43,na,1972,4853.65120372629
STAT,1942,28,40-44,1970,4.9369143315829485
STAT,1851,11,na,1862,2207.717946922123
STAT,1942,20,30-34,1962,30.447104679945458
SIM,1867,0,na,1867,3475
SIM,1889,81,na,1970,863
STAT,1864,85,na,1949,249.8426039244521
STAT,1922,47,25-29,1969,0.061562577217622864
SIM,1904,37,30-34,1941,1
SIM,1905,61,na,1966,3017
STAT,1946,23,na,1969,4103.0266643505765
STAT,1889,40,45-49,1929,1.8827144818865391
STAT,1940,26,35-39,1966,15.462965491698831
STAT,1868,75,na,1943,993.7303466354878
SIM,1850,38,na,1888,1966
SIM,1915,27,35-39,1942,18
STAT,1875,77,na,1952,896.5626493812083
STAT,1859,39,na,1898,1894.5820806152442
STAT,1924,43,40-44,1967,0.3001661453761604
STAT,1917,29,15-19,1946,0.7419555436045219
STAT,1955,6,na,1961,5272.2322840031275
SIM,1843,76,na,1919,823
STAT,1809,88,na,1897,63.39054299360442
STAT,1948,19,45-49,1967,0.5771157053955691
SIM,1849,26,30-34,1875,40
SIM,1906,21,25-29,1927,133
STAT,1784,71,na,1855,495.71565
SIM,1884,6,na,1890,2652
SIM,1833,66,na,1899,1130
SIM,1857,20,20-24,1877,72
STAT,1859,25,35-39,1884,8.089206345301415
STAT,1904,31,20-24,1935,3.9338750439622796
STAT,1859,31,na,1890,1946.4072392482738
STAT,1863,44,na,1907,2040.3865803085941
SIM,1866,26,30-34,1892,40
SIM,1855,69,na,1924,1296
STAT,1930,41,15-19,1971,0.0020451846244430596
SIM,1861,21,25-29,1882,51
SIM,1950,20,30-34,1970,45
SIM,1860,48,na,1908,1963
STAT,1928,35,25-29,1963,1.259909256020966
STAT,1902,23,40-44,1925,2.9649470345213778
SIM,1921,26,20-24,1947,6
SIM,1926,33,45-49,1959,2
SIM,1858,16,25-29,1874,11
STAT,1869,32,50-100,1901,0.8997150994201363
SIM,1912,31,20-24,1943,7
STAT,1794,73,na,1867,511.03626219334234
STAT,1918,33,45-49,1951,1.6810221411949235
STAT,1819,98,na,1917,1.6514378821504294
SIM,1902,24,15-19,1926,4
STAT,1890,44,30-34,1934,1.399723343739125
STAT,1909,43,45-49,1952,0.15614167117490796
STAT,1870,21,25-29,1891,56.946934808486915
STAT,1888,17,50-100,1905,0.058403790917597335
STAT,1899,23,50-100,1922,0.5635127814795815
SIM,1818,77,na,1895,337
STAT,1859,42,50-100,1901,0.857136875510409
STAT,1853,21,25-29,1874,56.33964016158687
SIM,1838,29,50-100,1867,1
STAT,1851,21,15-19,1872,3.0046495879491695
STAT,1920,18,50-100,1938,0.4233633411648478
STAT,1898,3,na,1901,3619.6972416324775
STAT,1801,60,na,1861,1051.6198679095892
STAT,1892,49,na,1941,2792.3853714502725
SIM,1930,24,50-100,1954,6
STAT,1840,53,30-34,1893,0.004105667127456876
STAT,1885,35,50-100,1920,1.2460183766628428
SIM,1912,15,15-19,1927,14
SIM,1896,4,na,1900,3525
STAT,1852,60,na,1912,1446.389705356784
SIM,1931,15,25-29,1946,87
STAT,1908,44,40-44,1952,0.23073285353718118
SIM,1951,19,15-19,1970,53
STAT,1903,25,50-100,1928,0.9263845605809099
SIM,1873,74,na,1947,1045
STAT,1808,47,na,1855,1270.981184129142
STAT,1907,27,35-39,1934,14.311559537286646
STAT,1858,26,30-34,1884,20.57433869768483
SIM,1889,46,50-100,1935,2
STAT,1907,43,40-44,1950,0.2299982356406406
STAT,1817,83,na,1900,181.63041610058337
STAT,1940,15,25-29,1955,44.443839741952196
STAT,1919,45,25-29,1964,0.05836522820323166
STAT,1895,48,25-29,1943,0.042316227537015895
STAT,1900,29,45-49,1929,1.5466340076310285
SIM,1800,95,na,1895,22
SIM,1932,27,35-39,1959,42
STAT,1923,28,30-34,1951,45.293278191875515
STAT,1920,47,15-19,1967,4.112053355201081E-4
STAT,1869,16,35-39,1885,0.5495073764902582
STAT,1823,53,30-34,1876,0.007730671768706519
STAT,1922,27,30-34,1949,44.79108274232041
SIM,1916,42,45-49,1958,2
STAT,1913,41,15-19,1954,0.0015197098594739167
STAT,1923,15,25-29,1938,51.653410530355856
STAT,1848,55,na,1903,1688.2022086873612
STAT,1922,16,20-24,1938,158.89782725851487
STAT,1944,19,30-34,1963,13.236753710273243
SIM,1930,16,20-24,1946,185
STAT,1826,34,50-100,1860,1.1494849301291303
STAT,1879,18,15-19,1897,6.238627324986041
SIM,1831,67,na,1898,1057
SIM,1897,25,na,1922,3270
STAT,1871,31,na,1902,2404.26764721858
SIM,1893,11,na,1904,3403
SIM,1931,31,30-34,1962,30
SIM,1898,21,20-24,1919,108
STAT,1834,21,15-19,1855,2.656019180469053
STAT,1924,27,35-39,1951,17.66450757963729
STAT,1923,26,35-39,1949,17.47606277737999
SIM,1842,21,15-19,1863,3
SIM,1878,40,35-39,1918,5
STAT,1812,52,na,1864,1287.988795426934
STAT,1868,15,35-39,1883,0.5456629162351322
SIM,1930,27,30-34,1957,70
STAT,1923,38,na,1961,4400.051781339625
STAT,1934,29,15-19,1963,0.9586336958332703
SIM,1941,30,30-34,1971,24
STAT,1852,39,15-19,1891,0.04215854653186228
SIM,1852,80,na,1932,325
SIM,1899,17,25-29,1916,9
STAT,1933,17,35-39,1950,5.676209212730032
SIM,1924,33,35-39,1957,17
STAT,1922,44,15-19,1966,0.0017747646633291011
SIM,1863,13,na,1876,2579
STAT,1909,23,na,1932,3567.9892434397702
STAT,1772,94,na,1866,2.9205948479983475
STAT,1917,34,40-44,1951,4.100933352420218
STAT,1867,16,30-34,1883,1.5591163181417085
STAT,1842,82,na,1924,420.08037074742776
STAT,1910,17,40-44,1927,0.27961984653361194
SIM,1858,21,20-24,1879,86
SIM,1905,22,20-24,1927,2
STAT,1877,26,40-44,1903,3.1333617600319683
SIM,1901,23,na,1924,3388
STAT,1872,29,na,1901,2406.0055824287783
SIM,1914,31,30-34,1945,6
STAT,1894,49,20-24,1943,0.00861819118146746
STAT,1848,36,50-100,1884,1.0437761022394292
STAT,1916,33,35-39,1949,9.481024045427565
STAT,1876,62,na,1938,1906.0365190366601
STAT,1946,16,30-34,1962,13.658119507948232
SIM,1914,28,30-34,1942,46
STAT,1880,34,20-24,1914,2.8426152809495306
STAT,1907,48,40-44,1955,0.14143710679281604
STAT,1936,29,25-29,1965,63.53100630111704
SIM,1858,32,30-34,1890,26
STAT,1914,53,na,1967,3597.9179324740676
STAT,1934,3,na,1937,5543.448642483302
SIM,1801,69,na,1870,544
SIM,1925,34,40-44,1959,3
STAT,1931,22,20-24,1953,145.7528480325199
STAT,1887,40,35-39,1927,2.062560902703251
STAT,1933,30,30-34,1963,21.479612645092615
SIM,1911,19,15-19,1930,12
SIM,1820,48,50-100,1868,2
SIM,1954,16,30-34,1970,16
STAT,1797,78,na,1875,318.9536293501209
STAT,1863,36,na,1899,2118.4874153221167
SIM,1862,79,na,1941,559
STAT,1906,19,40-44,1925,0.2676263619498498
SIM,1928,8,na,1936,5155
STAT,1920,38,na,1958,4155.485085453892
STAT,1921,15,15-19,1936,52.48993137602445
STAT,1813,43,20-24,1856,0.5351086974954332
STAT,1907,40,30-34,1947,0.11960881199603961
SIM,1835,49,na,1884,1368
SIM,1888,3,na,1891,3240
SIM,1931,34,35-39,1965,13
STAT,1843,15,30-34,1858,1.3901208143443728
STAT,1919,47,20-24,1966,0.012102462058525639
SIM,1869,69,na,1938,1383
SIM,1941,17,35-39,1958,4
STAT,1942,26,45-49,1968,1.831565910762391
STAT,1906,58,na,1964,3092.861016455947
SIM,1916,45,na,1961,3779
STAT,1842,50,na,1892,1966.4297622274175
STAT,1927,28,na,1955,4586.973616161892
SIM,1907,30,30-34,1937,25
SIM,1895,10,na,1905,3435
STAT,1842,53,40-44,1895,0.009326222548361109
SIM,1851,15,30-34,1866,2
STAT,1789,94,na,1883,5.265418724537867
STAT,1901,42,35-39,1943,0.1778200972932344
SIM,1879,29,20-24,1908,1
SIM,1894,36,na,1930,3333
STAT,1923,34,35-39,1957,10.571437293084776
STAT,1879,23,40-44,1902,2.1895474737735925
STAT,1902,44,na,1946,3265.451978748224
STAT,1868,67,na,1935,1530.1963046403605
SIM,1849,35,50-100,1884,4
STAT,1903,19,15-19,1922,8.49055791209995
SIM,1913,32,20-24,1945,3
STAT,1851,67,na,1918,1200.3075925070214
STAT,1846,40,50-100,1886,0.8324914460174128
STAT,1943,24,40-44,1967,3.609632049076359
STAT,1896,41,50-100,1937,0.098523248739104
SIM,1907,38,40-44,1945,2
SIM,1844,25,40-44,1869,3
SIM,1818,69,na,1887,750
STAT,1838,22,40-44,1860,1.8098134218189479
STAT,1933,38,40-44,1971,2.0583612274158107
SIM,1904,24,25-29,1928,110
STAT,1855,57,na,1912,1512.6911412389838
SIM,1924,40,na,1964,4496
STAT,1837,40,50-100,1877,0.8725347097957773
SIM,1885,26,40-44,1911,3
STAT,1939,26,40-44,1965,4.73255257615696
STAT,1860,4,na,1864,2538.037885254717
SIM,1921,41,45-49,1962,1
STAT,1870,48,20-24,1918,0.011751917109828341
STAT,1871,95,na,1966,48.86785684290555
SIM,1854,28,na,1882,2283
STAT,1905,32,20-24,1937,2.266210709953624
STAT,1860,79,na,1939,577.1998618097839
SIM,1869,25,45-49,1894,1
SIM,1845,40,50-100,1885,1
SIM,1916,23,35-39,1939,14
SIM,1933,20,30-34,1953,70
SIM,1870,38,20-24,1908,1
SIM,1906,37,35-39,1943,3
STAT,1877,0,na,1877,3806.0441762649803
STAT,1916,36,45-49,1952,0.7079098953476209
STAT,1817,110,na,1927,1.264308461690617E-4
SIM,1863,51,50-100,1914,1
STAT,1906,42,50-100,1948,0.10779049638120491
STAT,1897,24,na,1921,3182.3672057218187
SIM,1875,1,na,1876,3309
SIM,1941,30,50-100,1971,3
STAT,1884,38,na,1922,2334.902640805157
STAT,1902,21,45-49,1923,0.9982640013323307
STAT,1913,41,45-49,1954,0.16469854445734666
STAT,1830,49,35-39,1879,0.11410573804637508
SIM,1933,25,na,1958,4716
STAT,1937,27,20-24,1964,17.963598326813656
SIM,1905,33,30-34,1938,3
STAT,1942,18,50-100,1960,0.3951858189665444
STAT,1899,27,30-34,1926,34.90593712117783
SIM,1846,22,40-44,1868,1
STAT,1880,24,na,1904,2492.9274112706967
SIM,1838,28,20-24,1866,11
STAT,1849,23,25-29,1872,53.724806018359175
STAT,1908,8,na,1916,3892.636103609556
SIM,1901,33,40-44,1934,12
STAT,1880,16,na,1896,2685.5164493793804
SIM,1910,21,45-49,1931,1
SIM,1903,8,na,1911,3554
STAT,1850,26,na,1876,1963.40318999882
STAT,1827,31,25-29,1858,14.39404926586017
STAT,1919,35,50-100,1954,0.45795876102159033
SIM,1928,26,30-34,1954,89
STAT,1885,47,na,1932,2251.3049459549684
SIM,1863,3,na,1866,2972
SIM,1886,22,40-44,1908,4
SIM,1926,30,40-44,1956,1
SIM,1924,36,45-49,1960,3
STAT,1930,6,na,1936,5237.374641090454
STAT,1804,100,na,1904,0.32913081913360004
STAT,1924,12,na,1936,4767.9889598865175
STAT,1798,63,na,1861,1027.6276885524753
SIM,1859,59,na,1918,1799
SIM,1934,10,na,1944,5544
SIM,1907,5,na,1912,4109
SIM,1941,12,na,1953,4246
SIM,1908,58,na,1966,3022
STAT,1904,34,25-29,1938,8.451489122412552
STAT,1923,23,30-34,1946,33.6846900765654
STAT,1921,18,25-29,1939,49.75859275188488
SIM,1814,87,na,1901,80
STAT,1911,29,20-24,1940,17.831210550845476
STAT,1924,41,20-24,1965,0.021257769287909414
STAT,1857,9,na,1866,2257.1515467908716
SIM,1852,9,na,1861,2249
STAT,1843,110,na,1953,1.86381138915369E-4
STAT,1862,38,20-24,1900,0.669015193864568
STAT,1875,50,50-100,1925,0.015889946153888303
STAT,1878,22,40-44,1900,2.1847793205552932
SIM,1857,23,25-29,1880,1
STAT,1827,93,na,1920,17.379135002436403
STAT,1830,100,na,1930,0.7004095065278544
SIM,1801,80,na,1881,61
SIM,1912,34,25-29,1946,15
STAT,1791,73,na,1864,449.21741003872603
STAT,1862,22,50-100,1884,0.3641087995158938
STAT,1897,19,20-24,1916,23.87673753861428
SIM,1868,95,na,1963,1
STAT,1809,107,na,1916,0.0021775863313504232
STAT,1936,26,15-19,1962,0.6823819400724328
STAT,1891,27,50-100,1918,0.7999213806948424
STAT,1932,34,30-34,1966,21.13847784796519
SIM,1794,93,na,1887,9
SIM,1876,31,na,1907,2771
STAT,1905,18,40-44,1923,0.26635644663155067
STAT,1908,23,35-39,1931,8.711216398748
STAT,1918,30,40-44,1948,4.232001681600069
STAT,1940,24,15-19,1964,5.470783320615904
STAT,1842,39,na,1881,2217.804378077351
STAT,1886,30,50-100,1916,0.9849317343696449
STAT,1855,48,30-34,1903,0.07194784686392104
STAT,1876,22,30-34,1898,18.575413749654338
STAT,1901,35,na,1936,3393.978933281326
SIM,1849,29,35-39,1878,11
STAT,1822,62,na,1884,1068.679460828408
STAT,1830,49,na,1879,1552.8194102672976
SIM,1802,54,na,1856,1208
STAT,1853,38,50-100,1891,1.010278491803668
STAT,1898,37,50-100,1935,1.6810361568465915
SIM,1883,33,na,1916,2646
SIM,1918,39,25-29,1957,1
STAT,1836,25,40-44,1861,2.4807439514188854
STAT,1893,74,na,1967,1777.402247969737
STAT,1832,46,35-39,1878,0.1145016816206247
SIM,1904,29,25-29,1933,71
SIM,1931,23,30-34,1954,56
SIM,1873,66,na,1939,1497
SIM,1825,79,na,1904,307
SIM,1820,48,na,1868,1403
SIM,1900,37,40-44,1937,3
SIM,1928,32,50-100,1960,1
STAT,1893,34,na,1927,3034.1031675841355
STAT,1918,49,25-29,1967,0.056654849631508415
STAT,1829,30,45-49,1859,1.6378176716448503
STAT,1877,46,50-100,1923,0.2567460526425069
STAT,1884,16,30-34,1900,1.5913848946489053
SIM,1865,79,na,1944,455
SIM,1902,27,50-100,1929,1
STAT,1935,25,15-19,1960,0.9730978599369449
SIM,1821,57,na,1878,1085
STAT,1827,45,50-100,1872,0.25868131181804277
SIM,1828,36,na,1864,1670
SIM,1911,19,20-24,1930,40
SIM,1939,28,50-100,1967,1
SIM,1874,49,45-49,1923,5
SIM,1835,45,50-100,1880,2
SIM,1882,17,25-29,1899,3
SIM,1885,46,50-100,1931,5
STAT,1856,18,20-24,1874,16.13688021360143
SIM,1936,16,15-19,1952,56
SIM,1868,44,na,1912,2077
SIM,1887,23,40-44,1910,1
STAT,1882,82,na,1964,711.8707084872482
SIM,1847,26,na,1873,1988
SIM,1932,24,30-34,1956,63
SIM,1935,33,50-100,1968,1
STAT,1870,46,na,1916,2237.70088862732
STAT,1919,42,20-24,1961,0.019323427113205095
STAT,1924,24,30-34,1948,34.05611243557884
STAT,1895,45,20-24,1940,0.009017071516692943
STAT,1902,26,45-49,1928,1.5901295389693642
STAT,1873,47,35-39,1920,0.14267904726201788
SIM,1898,24,25-29,1922,74
STAT,1926,40,40-44,1966,0.312505247294787
STAT,1911,39,50-100,1950,0.40500816285162883
STAT,1928,16,15-19,1944,57.94163074854164
STAT,1854,47,25-29,1901,0.04302649437278717
STAT,1828,54,20-24,1882,5.677551670791296E-4
SIM,1930,19,25-29,1949,74
STAT,1804,57,na,1861,973.2364043251143
STAT,1826,49,15-19,1875,3.8357812079892846E-4
STAT,1927,33,50-100,1960,1.0273452842070125
STAT,1914,34,15-19,1948,0.12939270022512697
STAT,1922,19,25-29,1941,50.39378426698422
SIM,1909,51,na,1960,3694
SIM,1891,20,na,1911,3106
STAT,1870,36,50-100,1906,1.2235215054819346
STAT,1909,24,50-100,1933,0.6132495184270265
SIM,1805,59,na,1864,950
SIM,1864,18,20-24,1882,15
STAT,1903,19,20-24,1922,25.36419828689597
STAT,1862,15,40-44,1877,0.18488334419069485
SIM,1870,49,50-100,1919,4
SIM,1839,39,na,1878,1641
SIM,1894,30,50-100,1924,1
STAT,1866,49,45-49,1915,0.2161065285608841
SIM,1925,14,na,1939,4852
SIM,1892,16,30-34,1908,2
STAT,1918,49,50-100,1967,0.24156998554964046
SIM,1846,41,na,1887,1675
STAT,1856,42,na,1898,1787.4964475558995
STAT,1874,17,25-29,1891,5.860471581466354
STAT,1885,87,na,1972,464.4083541217103
STAT,1780,81,na,1861,173.22800615633383
STAT,1920,31,35-39,1951,10.149406969249977
SIM,1938,32,25-29,1970,3
STAT,1935,15,na,1950,5107.441256300662
STAT,1877,36,na,1913,2467.7460429413295
STAT,1942,23,35-39,1965,9.964601720556832
STAT,1903,61,na,1964,2886.5325939670206
SIM,1911,14,na,1925,4133
SIM,1896,29,20-24,1925,20
SIM,1871,34,20-24,1905,3
SIM,1929,37,35-39,1966,7
STAT,1924,20,na,1944,4380.332008663155
STAT,1910,33,40-44,1943,3.790833160878331
STAT,1867,21,20-24,1888,66.29713122567752
STAT,1821,77,na,1898,517.7639189617544
SIM,1866,61,na,1927,1867
SIM,1856,54,na,1910,1907
SIM,1946,23,20-24,1969,3
STAT,1894,44,50-100,1938,0.09410778619852063
SIM,1944,26,20-24,1970,1
STAT,1814,43,50-100,1857,2.813990777481086
STAT,1825,108,na,1933,0.00133671662549012
SIM,1938,1,na,1939,4038
STAT,1914,13,na,1927,4115.433800753262
STAT,1843,18,35-39,1861,0.47015961868180717
STAT,1912,40,45-49,1952,0.1637799820990268
STAT,1925,26,45-49,1951,2.0692456144314386
SIM,1821,97,na,1918,1
STAT,1860,39,50-100,1899,1.0034550241097118
STAT,1938,23,20-24,1961,111.06209684843861
STAT,1938,29,50-100,1967,0.9945146528597513
SIM,1877,24,na,1901,2656
STAT,1867,32,30-34,1899,16.608065971581993
STAT,1883,46,40-44,1929,0.1696895885171035
SIM,1829,38,20-24,1867,1
STAT,1829,32,40-44,1861,3.8627222787237123
SIM,1841,39,50-100,1880,3
STAT,1873,14,na,1887,2661.726593724462
SIM,1828,47,na,1875,1485
SIM,1863,22,40-44,1885,3
STAT,1785,88,na,1873,45.557278362270296
SIM,1940,27,na,1967,3957
STAT,1897,48,35-39,1945,0.10558866247026637
STAT,1860,47,na,1907,1848.868400995805
SIM,1822,42,na,1864,1608
SIM,1926,3,na,1929,4957
SIM,1929,26,25-29,1955,93
STAT,1781,74,na,1855,249.22218
STAT,1854,24,45-49,1878,0.6060967180441863
STAT,1854,33,50-100,1887,0.696900486270244
STAT,1871,21,40-44,1892,2.097256977423058
SIM,1852,45,50-100,1897,1
SIM,1837,30,45-49,1867,4
STAT,1836,20,35-39,1856,5.637442868711707
STAT,1836,106,na,1942,0.007655626707987449
SIM,1921,21,15-19,1942,6
STAT,1839,18,15-19,1857,5.471518614387884
STAT,1931,37,25-29,1968,1.3178708181736534
STAT,1890,47,40-44,1937,0.11862857317909105
STAT,1882,50,na,1932,2136.818328924545
STAT,1824,96,na,1920,4.268863812781324
SIM,1858,66,na,1924,1250
STAT,1933,33,35-39,1966,12.436914205032842
SIM,1920,40,45-49,1960,1
STAT,1907,24,30-34,1931,26.25428293038076
STAT,1928,39,40-44,1967,1.908170139629941
SIM,1849,92,na,1941,10
STAT,1886,64,na,1950,1853.7732427183403
SIM,1779,93,na,1872,12
STAT,1896,21,45-49,1917,0.9350785814666422
STAT,1785,100,na,1885,0.2205810613959986
STAT,1854,44,20-24,1898,0.11757824507011863
STAT,1840,45,50-100,1885,0.17811823573648983
STAT,1855,22,40-44,1877,1.832427984228649
STAT,1837,47,25-29,1884,0.040791089360706884
SIM,1844,20,35-39,1864,7
STAT,1855,17,15-19,1872,5.313122367796505
STAT,1926,24,40-44,1950,4.102579873477094
STAT,1937,19,na,1956,3604.2123019959436
SIM,1859,33,30-34,1892,27
SIM,1842,59,na,1901,1366
STAT,1856,44,30-34,1900,0.8782247085106341
STAT,1902,39,20-24,1941,0.23507887960957785
SIM,1828,44,na,1872,1525
STAT,1816,41,15-19,1857,0.04115928794760906
STAT,1907,43,35-39,1950,0.18516358336243247
STAT,1937,25,25-29,1962,64.82976798759631
STAT,1900,18,na,1918,3534.169723042317
SIM,1915,24,30-34,1939,42
SIM,1810,49,na,1859,1417
SIM,1875,46,na,1921,2247
STAT,1842,45,40-44,1887,0.15816429432792095
STAT,1864,1,na,1865,3288.9670196734933
STAT,1947,16,25-29,1963,49.322499215610954
STAT,1859,102,na,1961,0.6535301707920373
SIM,1847,18,na,1865,2180
STAT,1835,41,25-29,1876,0.5851730778783678
SIM,1879,28,na,1907,2750
STAT,1856,21,45-49,1877,0.6316580376624661
SIM,1864,21,45-49,1885,4
SIM,1843,36,na,1879,2310
SIM,1955,16,25-29,1971,75
STAT,1841,19,50-100,1860,0.046696913273989116
SIM,1818,37,na,1855,1468
SIM,1862,2,na,1864,2889
SIM,1864,44,30-34,1908,1
SIM,1909,25,15-19,1934,1
STAT,1866,23,25-29,1889,53.58756236196226
STAT,1841,89,na,1930,78.56055143221072
SIM,1837,32,40-44,1869,6
SIM,1902,7,na,1909,3950
STAT,1800,83,na,1883,121.62557668346305
STAT,1896,23,40-44,1919,2.777279821233384
STAT,1938,34,30-34,1972,15.972269970008725
STAT,1877,29,45-49,1906,1.1491336690676588
STAT,1901,33,50-100,1934,1.2917985900570192
SIM,1818,38,45-49,1856,1
STAT,1896,15,50-100,1911,0.06580259591709069
SIM,1830,33,20-24,1863,2
STAT,1841,36,35-39,1877,6.296802926448142
SIM,1933,26,45-49,1959,3
STAT,1957,15,na,1972,4904.763500087342
STAT,1802,85,na,1887,90.48823766697745
SIM,1875,21,20-24,1896,72
SIM,1885,21,35-39,1906,14
STAT,1905,47,25-29,1952,0.047219116660921184
STAT,1851,99,na,1950,1.4340129949203946
STAT,1888,29,20-24,1917,13.885245287523254
STAT,1910,31,45-49,1941,1.5370345330883084
STAT,1828,34,45-49,1862,1.9008976136983142
STAT,1883,13,na,1896,2548.5216478656685
STAT,1864,44,50-100,1908,0.9498402134715747
STAT,1774,115,na,1889,1.246815066595488E-4
STAT,1832,31,50-100,1863,0.8243369746826239
STAT,1883,38,50-100,1921,1.2074469630335631
SIM,1844,31,50-100,1875,2
SIM,1899,56,na,1955,2979
STAT,1922,32,20-24,1954,2.7841504168502915
STAT,1834,95,na,1929,7.913883493112287
STAT,1762,104,na,1866,0.021295446717598133
SIM,1845,48,na,1893,1851
SIM,1857,25,na,1882,2174
STAT,1822,33,20-24,1855,7.024904403999923
STAT,1920,19,15-19,1939,51.142393690400624
SIM,1853,11,na,1864,2177
SIM,1930,32,20-24,1962,6
STAT,1845,31,40-44,1876,3.807017627037335
SIM,1900,30,na,1930,3428
SIM,1934,24,40-44,1958,6
STAT,1906,44,30-34,1950,0.11586071733107463
STAT,1936,26,20-24,1962,17.644447166113736
STAT,1939,29,45-49,1968,1.7515917283660423
SIM,1885,29,45-49,1914,1
SIM,1884,22,30-34,1906,2
STAT,1921,34,25-29,1955,10.299318872304443
SIM,1911,22,na,1933,3821
STAT,1867,45,45-49,1912,0.22672642676750834
STAT,1862,18,45-49,1880,0.06486986268770743
STAT,1895,25,45-49,1920,1.4743844565754105
SIM,1823,43,30-34,1866,1
STAT,1906,26,35-39,1932,14.24328424245981
STAT,1861,31,25-29,1892,8.631544547709295
STAT,1909,31,na,1940,3656.8264488845875
STAT,1921,15,20-24,1936,156.80536441424061
STAT,1886,61,na,1947,1992.6998930071002
SIM,1859,20,25-29,1879,86
SIM,1890,34,30-34,1924,7
SIM,1898,30,50-100,1928,2
STAT,1952,17,45-49,1969,0.604827670378354
SIM,1859,31,35-39,1890,1
STAT,1906,31,25-29,1937,8.687363986915658
STAT,1900,43,25-29,1943,0.06211210925186586
SIM,1881,21,na,1902,2225
STAT,1892,6,na,1898,3310.8472726155665
SIM,1864,25,50-100,1889,4
SIM,1874,23,25-29,1897,73
STAT,1858,14,na,1872,2189.639345135686
STAT,1895,18,50-100,1913,0.06444919320359459
STAT,1908,29,50-100,1937,0.9430427637962066
STAT,1928,13,na,1941,5038.48360186286
SIM,1928,29,35-39,1957,22
STAT,1855,20,45-49,1875,0.622101296286701
SIM,1849,31,20-24,1880,3
SIM,1881,61,na,1942,1756
STAT,1911,32,45-49,1943,1.5458970077718723
STAT,1835,21,30-34,1856,17.906472533572774
STAT,1848,47,na,1895,1828.3377774308058
STAT,1867,90,na,1957,94.91230311398496
SIM,1916,53,na,1969,3667
STAT,1953,1,na,1954,4911.040595728004
SIM,1928,25,25-29,1953,91
SIM,1843,21,30-34,1864,35
SIM,1853,43,na,1896,1754
SIM,1842,51,na,1893,1531
SIM,1945,25,25-29,1970,106
SIM,1932,16,na,1948,5593
STAT,1883,32,15-19,1915,0.14075166260713362
STAT,1835,40,na,1875,1939.750887539037
STAT,1822,36,25-29,1858,5.588985361557505
STAT,1886,72,na,1958,1441.9693314812316
SIM,1849,42,30-34,1891,1
STAT,1925,44,40-44,1969,0.30501983309493896
SIM,1921,24,na,1945,3912
STAT,1905,44,20-24,1949,0.01588503534780325
SIM,1943,18,20-24,1961,216
STAT,1914,21,na,1935,3786.1402951532023
SIM,1901,15,na,1916,3664
SIM,1914,15,25-29,1929,12
STAT,1925,39,15-19,1964,0.02324331344533243
STAT,1935,18,20-24,1953,186.7646236869037
STAT,1879,30,35-39,1909,10.759724313552738
SIM,1887,30,35-39,1917,20
STAT,1922,24,50-100,1946,0.7575182651450835
SIM,1859,15,35-39,1874,3
SIM,1914,26,35-39,1940,17
SIM,1853,14,na,1867,2137
STAT,1857,83,na,1940,312.9227479104528
SIM,1835,92,na,1927,7
STAT,1906,15,25-29,1921,8.375075808744429
SIM,1857,28,na,1885,2145
STAT,1853,77,na,1930,714.8320186196095
STAT,1920,34,45-49,1954,1.72565421565576
SIM,1862,28,na,1890,2125
STAT,1783,78,na,1861,311.6077632037093
STAT,1937,27,na,1964,3686.56793414495
SIM,1893,35,50-100,1928,2
STAT,1836,28,45-49,1864,0.8998217070436692
STAT,1898,43,15-19,1941,0.0013035626294536282
STAT,1926,43,45-49,1969,0.20703388735076714
SIM,1807,85,na,1892,153
SIM,1918,23,45-49,1941,2
SIM,1845,21,35-39,1866,6
STAT,1845,49,50-100,1894,0.17570957752926913
STAT,1836,22,30-34,1858,14.829751782498391
STAT,1901,34,35-39,1935,14.215721392049087
STAT,1914,41,30-34,1955,0.12799799169138185
SIM,1840,17,20-24,1857,18
STAT,1935,29,30-34,1964,53.909564184097974
STAT,1951,16,45-49,1967,0.6011750615190913
SIM,1834,44,45-49,1878,4
STAT,1932,16,35-39,1948,5.628893171455652
STAT,1801,68,na,1869,780.3904001006806
STAT,1847,23,15-19,1870,3.0063617533689553
STAT,1844,54,na,1898,1656.70569264294
STAT,1911,18,50-100,1929,0.07543968938738417
STAT,1901,23,25-29,1924,80.8011755681965
STAT,1872,22,40-44,1894,2.1159430177329916
STAT,1895,46,na,1941,2976.436039442344
SIM,1937,19,35-39,1956,6
STAT,1914,38,30-34,1952,1.8269015950699476
STAT,1884,19,35-39,1903,0.5435807349996568
STAT,1894,6,na,1900,3396.940588218841
SIM,1940,16,35-39,1956,8
STAT,1941,27,40-44,1968,4.867962709792755
STAT,1837,21,35-39,1858,5.249197063352937
SIM,1894,28,na,1922,3348
SIM,1908,34,40-44,1942,3
STAT,1783,89,na,1872,38.39426763554848
STAT,1948,19,50-100,1967,0.4328367790466769
SIM,1890,35,na,1925,3203
STAT,1869,35,45-49,1904,1.976112010860721
SIM,1899,33,30-34,1932,33
SIM,1890,46,na,1936,3087
STAT,1875,24,50-100,1899,0.4203194938537126
SIM,1899,20,25-29,1919,87
STAT,1828,70,na,1898,910.8156695045373
STAT,1861,36,50-100,1897,1.0353795586710621
STAT,1921,27,50-100,1948,1.1203904943127052
SIM,1807,74,na,1881,517
STAT,1815,43,30-34,1858,2.8335932960026717
STAT,1866,46,40-44,1912,0.16056640338318431
SIM,1844,22,30-34,1866,26
SIM,1892,19,35-39,1911,4
STAT,1878,48,25-29,1926,0.05963217941411916
SIM,1877,35,45-49,1912,2
STAT,1946,19,35-39,1965,4.697510015369421
STAT,1898,30,45-49,1928,2.4068489590621165
STAT,1912,37,15-19,1949,0.018909501004440867
STAT,1832,29,na,1861,1919.364292549464
STAT,1901,22,35-39,1923,8.262207867485929
SIM,1899,22,20-24,1921,110
STAT,1903,69,na,1972,2518.4279229707836
STAT,1852,21,30-34,1873,16.163749845532113
SIM,1860,21,30-34,1881,28
SIM,1919,35,25-29,1954,1
SIM,1935,35,na,1970,5213
STAT,1840,59,na,1899,1362.3443789513626
STAT,1842,31,15-19,1873,0.15650306026470184
SIM,1821,89,na,1910,58
STAT,1882,34,30-34,1916,16.935425573467164
STAT,1831,47,30-34,1878,0.07230482543551009
STAT,1925,42,45-49,1967,0.20363394253306952
SIM,1854,9,na,1863,2679
STAT,1925,23,40-44,1948,4.05486886597895
STAT,1838,77,na,1915,578.6469897219001
SIM,1941,20,na,1961,3822
SIM,1792,67,na,1859,682
STAT,1932,30,15-19,1962,0.17283082627501692
STAT,1863,37,25-29,1900,2.576564092258015
SIM,1852,18,na,1870,2068
STAT,1898,18,25-29,1916,7.73860586859138
SIM,1929,34,30-34,1963,24
SIM,1920,28,25-29,1948,95
STAT,1854,21,40-44,1875,1.8507815232517622
STAT,1821,37,na,1858,1710.924021039456
STAT,1929,19,35-39,1948,5.383654779892902
STAT,1894,9,na,1903,3373.8931785938603
STAT,1837,44,20-24,1881,0.11339771894160428
STAT,1931,34,20-24,1965,3.225973699725455
SIM,1923,37,40-44,1960,1
STAT,1825,31,15-19,1856,0.3869926939516494
SIM,1889,34,25-29,1923,26
STAT,1872,72,na,1944,1282.3698641555027
SIM,1929,23,20-24,1952,144
SIM,1931,13,na,1944,5148
SIM,1934,27,45-49,1961,2
STAT,1804,97,na,1901,1.6655006509165753
STAT,1942,24,25-29,1966,97.7177649443078
SIM,1935,27,na,1962,5010
STAT,1795,66,na,1861,889.6815537298052
STAT,1892,22,15-19,1914,4.181114394673317
STAT,1951,1,na,1952,4895.405053825799
STAT,1802,53,na,1855,1121.3966900591374
STAT,1857,29,50-100,1886,0.5119374082590131
STAT,1774,96,na,1870,0.9833359667326422
STAT,1823,54,50-100,1877,0.019227788789821922
STAT,1840,70,na,1910,983.5376987420361
STAT,1912,28,25-29,1940,65.20985956134352
SIM,1920,50,na,1970,4310
SIM,1827,28,45-49,1855,4
STAT,1927,36,20-24,1963,0.33156922186918325
STAT,1920,22,45-49,1942,1.263179699559136
STAT,1813,93,na,1906,12.814133547072004
SIM,1875,24,25-29,1899,1
STAT,1841,33,30-34,1874,15.677946580908168
STAT,1940,28,30-34,1968,40.317927879082255
STAT,1885,32,25-29,1917,10.297276533552388
SIM,1854,92,na,1946,69
SIM,1880,36,na,1916,2276
SIM,1846,33,na,1879,1803
STAT,1826,44,45-49,1870,1.5001746560753522
STAT,1867,24,25-29,1891,54.11239381499342
SIM,1871,37,25-29,1908,3
STAT,1886,19,45-49,1905,0.06928589258106253
STAT,1900,36,50-100,1936,0.3735839002412554
STAT,1881,54,30-34,1935,0.005635832484815231
SIM,1844,85,na,1929,77
SIM,1908,37,45-49,1945,4
STAT,1845,22,50-100,1867,0.3699065062524197
SIM,1826,41,25-29,1867,3
SIM,1893,32,25-29,1925,21
STAT,1856,47,35-39,1903,0.10790307044081127
STAT,1883,49,45-49,1932,0.22838543515135235
STAT,1865,41,50-100,1906,0.9787276576687012
STAT,1877,21,35-39,1898,6.101405731324286
STAT,1893,35,45-49,1928,2.5808097123996037
SIM,1890,43,na,1933,3120
STAT,1835,34,50-100,1869,0.857853164244023
STAT,1925,40,25-29,1965,0.08761487474720923
STAT,1940,31,30-34,1971,16.4712739517134
STAT,1827,29,na,1856,1681.8488911161417
STAT,1866,20,20-24,1886,65.91863675957998
SIM,1925,4,na,1929,4959
SIM,1873,41,50-100,1914,1
STAT,1937,29,40-44,1966,4.582369692078828
SIM,1859,39,45-49,1898,2
SIM,1901,31,45-49,1932,2
SIM,1924,34,25-29,1958,14
STAT,1818,41,25-29,1859,1.3039106147585375
STAT,1922,35,25-29,1957,1.13377974442229
SIM,1896,24,15-19,1920,4
SIM,1920,39,na,1959,4431
STAT,1827,47,50-100,1874,0.25191062448902274
SIM,1817,52,na,1869,1412
STAT,1874,29,50-100,1903,0.656834894345498
STAT,1918,29,30-34,1947,41.797187041791226
STAT,1842,48,45-49,1890,0.2098091924571904
STAT,1793,88,na,1881,45.943298207442
STAT,1923,44,30-34,1967,0.15047551778347332
STAT,1926,27,45-49,1953,2.0930890179203034
STAT,1828,31,40-44,1859,5.276806501738424
SIM,1833,22,25-29,1855,55
STAT,1896,31,na,1927,3203.3474625498675
STAT,1908,39,15-19,1947,0.017966875279592877
STAT,1909,26,50-100,1935,0.9713741218096205
SIM,1885,23,30-34,1908,39
STAT,1932,21,25-29,1953,122.84865774684324
SIM,1917,26,50-100,1943,1
STAT,1857,42,15-19,1899,0.010872118023961852
STAT,1874,27,50-100,1901,0.6615632104552547
STAT,1918,18,20-24,1936,148.58805924990997
SIM,1835,47,50-100,1882,1
SIM,1830,36,25-29,1866,7
SIM,1862,21,40-44,1883,2
STAT,1897,56,na,1953,2761.7843894738153
STAT,1918,25,15-19,1943,0.7636271321772734
SIM,1926,29,30-34,1955,59
STAT,1872,2,na,1874,3352.7687344980886
STAT,1893,42,na,1935,2960.380528511447
SIM,1852,31,25-29,1883,5
STAT,1916,45,35-39,1961,0.1340811561927002
STAT,1863,34,20-24,1897,2.398229615176366
STAT,1912,43,na,1955,3592.148573716513
SIM,1874,20,20-24,1894,61
SIM,1868,26,40-44,1894,2
STAT,1877,23,30-34,1900,18.510564363575256
STAT,1911,45,20-24,1956,0.010604689686176281
SIM,1849,22,15-19,1871,3
SIM,1933,23,40-44,1956,4
SIM,1926,18,20-24,1944,172
STAT,1852,34,45-49,1886,1.3411481195192076
STAT,1928,32,15-19,1960,0.1624104319704195
STAT,1800,103,na,1903,0.05034302570687085
SIM,1854,84,na,1938,246
SIM,1926,25,15-19,1951,3
STAT,1897,45,30-34,1942,0.0746731372198275
SIM,1822,74,na,1896,560
SIM,1864,34,20-24,1898,4
STAT,1839,62,na,1901,1295.811792724869
STAT,1906,40,15-19,1946,0.0014249981886186114
STAT,1921,31,20-24,1952,2.752701008981518
STAT,1916,34,25-29,1950,9.547382882153668
STAT,1915,37,40-44,1952,1.5259544276210928
STAT,1825,59,na,1884,1515.738903131362
SIM,1847,21,45-49,1868,1
SIM,1910,51,na,1961,3148
STAT,1888,24,15-19,1912,3.9081850396060034
SIM,1903,25,20-24,1928,2
SIM,1860,34,45-49,1894,1
SIM,1839,27,25-29,1866,2
STAT,1839,21,45-49,1860,0.6398162171548951
STAT,1856,34,20-24,1890,2.0751831085672006
STAT,1938,26,25-29,1964,65.85981292185714
SIM,1907,17,na,1924,3969
STAT,1907,18,45-49,1925,0.09663431258606733
STAT,1946,18,50-100,1964,0.4195673079356925
STAT,1882,37,35-39,1919,6.919775508085657
SIM,1952,15,15-19,1967,54
SIM,1853,34,45-49,1887,1
SIM,1822,82,na,1904,171
SIM,1849,34,25-29,1883,16
SIM,1902,32,45-49,1934,5
SIM,1811,90,na,1901,55
SIM,1859,51,na,1910,2017
SIM,1905,29,40-44,1934,5
SIM,1807,82,na,1889,239
SIM,1914,23,30-34,1937,34
STAT,1815,46,35-39,1861,0.3158689928980163
SIM,1879,90,na,1969,165
STAT,1836,31,50-100,1867,0.7382357359893342
STAT,1900,26,40-44,1926,4.217232500208576
SIM,1845,70,na,1915,1000
STAT,1906,23,30-34,1929,26.122742231336
SIM,1846,20,45-49,1866,1
STAT,1893,49,50-100,1942,0.17395839985178824
SIM,1875,37,50-100,1912,1
STAT,1779,81,na,1860,228.74206212498802
STAT,1850,18,na,1868,2135.171902257758
SIM,1929,20,na,1949,4807
SIM,1940,21,25-29,1961,1
STAT,1907,7,na,1914,3864.3368876689456
STAT,1911,16,45-49,1927,0.10109817129582051
STAT,1845,34,45-49,1879,1.483874844833256
SIM,1888,64,na,1952,2223
SIM,1924,3,na,1927,4909
SIM,1930,18,40-44,1948,1
STAT,1895,22,40-44,1917,2.7484675367586906
STAT,1922,18,40-44,1940,1.6310282878109696
STAT,1935,30,40-44,1965,5.476197522418568
STAT,1923,35,na,1958,4412.130019271479
SIM,1855,28,20-24,1883,10
STAT,1904,19,30-34,1923,2.297795299522394
STAT,1897,35,20-24,1932,1.0536875749796255
STAT,1881,42,50-100,1923,1.0272587818771801
STAT,1913,28,na,1941,3752.904201839393
STAT,1852,24,35-39,1876,5.182158269618987
SIM,1836,31,40-44,1867,12
STAT,1839,104,na,1943,0.04728851954674665
STAT,1775,114,na,1889,2.2416551118242022E-4
SIM,1934,24,50-100,1958,4
STAT,1843,49,15-19,1892,2.641539447455981E-4
STAT,1919,26,15-19,1945,0.7728009443768564
SIM,1887,18,15-19,1905,6
STAT,1902,65,na,1967,2693.1997646141895
STAT,1847,28,20-24,1875,10.481841686754525
STAT,1830,46,30-34,1876,0.08202131668020982
STAT,1878,45,20-24,1923,0.012706889478818036
SIM,1856,62,na,1918,1616
STAT,1816,39,50-100,1855,4.268131940030681
SIM,1858,23,40-44,1881,1
STAT,1815,40,50-100,1855,2.935200186475104
SIM,1930,23,15-19,1953,7
STAT,1913,21,15-19,1934,5.220160397932492
STAT,1834,55,na,1889,1238.3320089782305
SIM,1879,68,na,1947,1776
SIM,1953,16,15-19,1969,68
SIM,1848,33,25-29,1881,11
SIM,1931,19,40-44,1950,2
STAT,1869,32,40-44,1901,4.258475583916137
STAT,1943,8,na,1951,4233.749380592353
SIM,1806,89,na,1895,24
SIM,1865,17,25-29,1882,10
SIM,1823,40,50-100,1863,1
SIM,1888,19,15-19,1907,6
STAT,1858,26,50-100,1884,0.5226471394396383
SIM,1955,15,50-100,1970,1
STAT,1860,45,35-39,1905,0.1167400781519885
SIM,1928,19,20-24,1947,1
STAT,1815,52,na,1867,1217.569058633627
SIM,1891,39,na,1930,3018
SIM,1933,27,50-100,1960,1
STAT,1862,51,na,1913,1887.022268051
SIM,1832,52,na,1884,1350
SIM,1881,18,20-24,1899,14
STAT,1811,67,na,1878,799.8836806757674
STAT,1871,98,na,1969,18.893467149963648
STAT,1857,17,25-29,1874,5.249990213985595
STAT,1874,39,na,1913,2412.00450620006
STAT,1873,18,20-24,1891,18.104853636022646
STAT,1896,71,na,1967,2107.8507475142214
SIM,1958,5,na,1963,5244
SIM,1860,24,35-39,1884,6
SIM,1912,19,30-34,1931,4
SIM,1888,22,45-49,1910,3
SIM,1921,29,25-29,1950,90
SIM,1911,25,na,1936,3845
SIM,1851,48,50-100,1899,2
STAT,1871,24,45-49,1895,0.6953290450202279
STAT,1922,23,15-19,1945,6.147872293405144
STAT,1838,17,15-19,1855,5.247551475837282
STAT,1938,12,na,1950,3945.8156613382544
SIM,1922,17,na,1939,4770
STAT,1903,18,30-34,1921,2.2866362215736453
STAT,1923,19,40-44,1942,1.650589756824378
SIM,1890,37,35-39,1927,13
STAT,1845,15,40-44,1860,0.17092279026396975
STAT,1879,16,na,1895,2668.5263034373856
STAT,1857,80,na,1937,487.6050184714795
STAT,1879,21,45-49,1900,0.7371957734243847
STAT,1923,24,15-19,1947,6.218923118901434
SIM,1919,39,40-44,1958,2
STAT,1841,23,20-24,1864,64.81428748201215
STAT,1871,47,30-34,1918,0.09667863159972273
STAT,1913,29,25-29,1942,65.69889575394001
SIM,1887,21,45-49,1908,4
STAT,1859,42,25-29,1901,0.5210047707420924
STAT,1872,25,45-49,1897,1.1350738018990452
SIM,1899,24,40-44,1923,3
STAT,1909,40,40-44,1949,0.23875528910740565
SIM,1878,33,40-44,1911,4
STAT,1914,44,35-39,1958,0.20064630720855003
STAT,1945,16,15-19,1961,50.08039619965245
SIM,1866,26,50-100,1892,4
STAT,1863,47,na,1910,2003.9731018996101
SIM,1843,44,na,1887,2084
STAT,1849,32,na,1881,1966.0288060846788
SIM,1895,13,na,1908,3424
SIM,1877,32,40-44,1909,6
SIM,1928,22,20-24,1950,160
STAT,1910,15,45-49,1925,0.10032819028854972
STAT,1858,29,35-39,1887,7.714859689881423
SIM,1832,41,na,1873,1567
STAT,1925,27,50-100,1952,1.18810228980877
SIM,1866,29,35-39,1895,13
SIM,1931,24,15-19,1955,5
STAT,1872,48,30-34,1920,0.09705769020027823
STAT,1871,87,na,1958,235.51761599288554
STAT,1901,27,40-44,1928,4.241291433511241
STAT,1930,38,50-100,1968,0.5529586505328146
STAT,1794,70,na,1864,679.1150182063523
STAT,1944,15,15-19,1959,49.34439470349721
STAT,1843,48,50-100,1891,0.16356790003888144
STAT,1811,78,na,1889,335.0701840881145
STAT,1800,75,na,1875,368.5663252429862
STAT,1908,23,40-44,1931,3.1107140299874283
SIM,1903,29,30-34,1932,42
SIM,1879,82,na,1961,634
STAT,1790,80,na,1870,220.01864111830218
SIM,1876,33,30-34,1909,26
STAT,1820,52,na,1872,1214.8582286628132
STAT,1887,35,20-24,1922,0.8774999456006375
STAT,1856,17,30-34,1873,1.459368999904449
STAT,1930,17,15-19,1947,59.30274390218631
STAT,1937,34,15-19,1971,0.1281841587230663
STAT,1823,101,na,1924,0.31559105368442075
SIM,1840,25,na,1865,1951
STAT,1850,54,50-100,1904,0.011246371015413606
STAT,1881,50,20-24,1931,7.287367186561153E-4
SIM,1874,20,15-19,1894,3
SIM,1935,32,35-39,1967,20
STAT,1864,53,25-29,1917,0.003176313787080128
STAT,1840,16,25-29,1856,5.173527617106593
STAT,1866,95,na,1961,27.240272378911207
STAT,1784,74,na,1858,373.027640525199
SIM,1836,31,35-39,1867,18
SIM,1866,39,45-49,1905,3
STAT,1911,24,na,1935,3628.5065274647895
SIM,1834,20,50-100,1854,1
STAT,1828,56,na,1884,1383.736475225224
SIM,1843,34,45-49,1877,1
SIM,1937,15,25-29,1952,48
STAT,1868,33,30-34,1901,16.782583207881395
SIM,1872,28,20-24,1900,13
STAT,1906,35,40-44,1941,1.40316620973951
SIM,1853,65,na,1918,1239
SIM,1905,17,30-34,1922,2
STAT,1824,33,30-34,1857,30.121375930961413
SIM,1950,21,20-24,1971,170
STAT,1871,28,20-24,1899,11.730186117509007
STAT,1886,10,na,1896,2762.305517674134
SIM,1832,26,25-29,1858,49
STAT,1905,45,50-100,1950,0.20429675443707299
SIM,1896,32,45-49,1928,4
STAT,1808,100,na,1908,0.40024813746190724
STAT,1921,39,25-29,1960,1.1080007891009331
STAT,1836,43,50-100,1879,0.7827408892972437
STAT,1890,15,na,1905,3131.486210417338
SIM,1848,38,50-100,1886,1
SIM,1923,28,45-49,1951,5
STAT,1888,32,45-49,1920,2.0788308064351524
STAT,1916,31,20-24,1947,2.551730926936232
SIM,1828,76,na,1904,498
STAT,1825,37,50-100,1862,2.0273038349338317
STAT,1855,38,20-24,1893,0.5773560640180406
SIM,1881,28,30-34,1909,29
STAT,1863,32,40-44,1895,3.8808832192022265
SIM,1878,19,25-29,1897,15
SIM,1914,35,40-44,1949,3
SIM,1933,35,35-39,1968,9
STAT,1849,49,45-49,1898,0.1806647028196221
STAT,1923,47,35-39,1970,0.15239236576142515
STAT,1942,21,20-24,1963,117.75192171070562
SIM,1931,27,25-29,1958,75
STAT,1843,20,20-24,1863,59.18786710228595
SIM,1870,69,na,1939,1599
SIM,1869,43,40-44,1912,5
STAT,1844,38,45-49,1882,1.6494660061350686
SIM,1869,26,20-24,1895,17
SIM,1939,23,35-39,1962,13
SIM,1940,25,40-44,1965,4
STAT,1891,24,30-34,1915,22.134433273599527
STAT,1915,28,45-49,1943,1.7718215293913882
STAT,1813,47,15-19,1860,0.0011640688671382673
STAT,1846,35,45-49,1881,1.6129680748362496
STAT,1923,27,25-29,1950,76.35397173912934
STAT,1843,13,na,1856,2048.2742441772
SIM,1919,50,na,1969,3863
STAT,1833,39,40-44,1872,3.806444074737703
STAT,1876,16,45-49,1892,0.06828841988085312
STAT,1931,21,45-49,1952,1.4793174538269336
SIM,1834,23,25-29,1857,70
STAT,1899,50,na,1949,3027.590574950769
SIM,1915,29,50-100,1944,1
STAT,1828,31,35-39,1859,12.322356735550517
SIM,1867,30,25-29,1897,7
SIM,1852,38,45-49,1890,3
STAT,1925,35,35-39,1960,2.9389285620960273
STAT,1767,94,na,1861,3.126759368155925
STAT,1871,3,na,1874,3135.505410780117
STAT,1876,49,50-100,1925,0.250774589536268
SIM,1851,20,20-24,1871,63
STAT,1895,22,35-39,1917,7.696784483186832
STAT,1952,0,na,1952,5290.153797235667
SIM,1910,37,na,1947,3380
STAT,1873,28,30-34,1901,25.693228483981706
SIM,1930,18,35-39,1948,8
STAT,1839,25,50-100,1864,0.5796327343835508
STAT,1887,28,15-19,1915,0.5098149427654026
STAT,1932,25,40-44,1957,6.174952721702231
SIM,1916,23,40-44,1939,3
STAT,1922,18,35-39,1940,4.893084580129133
STAT,1900,47,40-44,1947,0.1348586079650951
STAT,1958,11,na,1969,5212.046293741539
STAT,1866,97,na,1963,14.864620686192682
STAT,1903,34,45-49,1937,1.4279560074452484
SIM,1845,56,na,1901,1663
SIM,1854,35,45-49,1889,5
STAT,1943,20,25-29,1963,99.29842124392442
STAT,1882,46,25-29,1928,0.056512815468303744
SIM,1839,23,30-34,1862,23
SIM,1934,28,20-24,1962,35
STAT,1884,21,20-24,1905,68.84371914103103
STAT,1856,37,25-29,1893,2.229495561458744
STAT,1831,23,20-24,1854,162.1545761239392
STAT,1952,2,na,1954,4802.4982999813365
STAT,1896,39,20-24,1935,1.0201920502732553
STAT,1850,51,30-34,1901,0.004579757440648982
SIM,1909,20,30-34,1929,40
STAT,1851,28,35-39,1879,8.492949996335593
SIM,1919,39,35-39,1958,9
STAT,1883,67,na,1950,1566.7838634680445
STAT,1898,47,30-34,1945,0.07441471420522655
SIM,1924,31,20-24,1955,2
STAT,1850,19,50-100,1869,0.04530279544881228
STAT,1896,28,25-29,1924,56.35459751135892
STAT,1835,34,45-49,1869,1.6326882904139364
STAT,1859,30,25-29,1889,8.441636537038246
SIM,1915,20,15-19,1935,4
STAT,1929,28,30-34,1957,49.54112236197946
SIM,1825,30,20-24,1855,2
SIM,1937,28,30-34,1965,2
STAT,1870,50,45-49,1920,0.014600078546290085
SIM,1858,26,45-49,1884,2
STAT,1912,44,25-29,1956,0.06894696008757187
STAT,1807,108,na,1915,6.488517182544079E-4
STAT,1881,86,na,1967,458.67532898951174
STAT,1890,43,25-29,1933,0.7868000326649769
SIM,1886,30,na,1916,2686
SIM,1880,22,40-44,1902,2
SIM,1904,33,50-100,1937,4
SIM,1861,94,na,1955,9
STAT,1903,15,na,1918,3649.7441731560743
STAT,1880,38,15-19,1918,0.059268297019499566
STAT,1869,20,40-44,1889,2.0672342194747606
STAT,1881,47,20-24,1928,0.01162832018040859
STAT,1919,38,15-19,1957,0.020808940484790425
SIM,1841,39,40-44,1880,5
SIM,1938,24,30-34,1962,38
STAT,1917,16,45-49,1933,0.1087729450279312
STAT,1837,42,40-44,1879,1.8107045305481104
STAT,1905,33,50-100,1938,0.7649271621281312
SIM,1951,20,25-29,1971,158
STAT,1921,34,na,1955,4214.446501004034
STAT,1927,32,35-39,1959,11.362072047092836
STAT,1829,48,20-24,1877,0.008837167899810866
STAT,1928,36,30-34,1964,2.3302600840150336
SIM,1873,27,25-29,1900,46
SIM,1787,69,na,1856,686
STAT,1841,45,25-29,1886,0.044392426595712194
STAT,1939,31,15-19,1970,0.1324422442213529
SIM,1863,75,na,1938,777
SIM,1892,21,20-24,1913,95
STAT,1926,28,20-24,1954,22.037710131746927
STAT,1854,106,na,1960,0.0253440535957354
STAT,1866,36,30-34,1902,5.008384901959299
STAT,1887,43,50-100,1930,1.1826979778341355
STAT,1874,92,na,1966,130.88856086136803
STAT,1900,45,45-49,1945,0.18863602762931714
SIM,1922,34,20-24,1956,5
STAT,1912,46,20-24,1958,0.010741758624450507
SIM,1892,29,45-49,1921,1
SIM,1855,31,45-49,1886,1
SIM,1933,5,na,1938,5156
SIM,1848,13,na,1861,2221
STAT,1885,39,45-49,1924,1.9839567390265611
STAT,1814,56,na,1870,1230.7168347959212
STAT,1803,80,na,1883,322.98759695672146
STAT,1833,26,35-39,1859,9.095811843677364
STAT,1929,15,25-29,1944,56.15854281790685
STAT,1884,29,45-49,1913,1.0979525986586256
SIM,1841,26,35-39,1867,12
STAT,1823,92,na,1915,23.034768594973283
STAT,1849,27,40-44,1876,2.776328315406947
STAT,1905,31,45-49,1936,1.4679734105477729
STAT,1870,47,45-49,1917,0.23297081600123226
STAT,1928,16,20-24,1944,173.09145365791812
SIM,1889,17,35-39,1906,3
STAT,1852,54,45-49,1906,0.010703437503858455
SIM,1936,16,20-24,1952,172
STAT,1850,23,30-34,1873,16.252837793568784
STAT,1818,48,45-49,1866,0.41398752084284046
STAT,1914,34,20-24,1948,2.456019821427603
SIM,1857,27,40-44,1884,4
STAT,1845,38,20-24,1883,0.5856867741080157
STAT,1858,34,25-29,1892,8.04661541640354
SIM,1896,62,na,1958,2477
STAT,1781,105,na,1886,0.01215303516123619
SIM,1831,33,50-100,1864,5
SIM,1874,36,30-34,1910,5
STAT,1845,28,na,1873,1910.1452631690706
SIM,1925,2,na,1927,5005
STAT,1839,47,35-39,1886,0.10112923359708612
STAT,1907,16,50-100,1923,0.07284458891593806
SIM,1840,92,na,1932,20
STAT,1865,24,15-19,1889,3.0354661328714463
STAT,1834,38,45-49,1872,1.4614819636695344
STAT,1918,22,50-100,1940,0.7164584955847152
SIM,1959,6,na,1965,5504
STAT,1840,49,25-29,1889,0.0396868165990864
STAT,1864,31,45-49,1895,1.5957920552414127
SIM,1840,27,30-34,1867,26
STAT,1844,109,na,1953,5.628957235546671E-4
STAT,1923,42,50-100,1965,0.1387364084559124
STAT,1937,30,50-100,1967,0.826730875154812
SIM,1875,4,na,1879,2695
SIM,1873,34,30-34,1907,3
SIM,1893,36,40-44,1929,9
STAT,1840,27,20-24,1867,10.253631870988345
STAT,1911,56,na,1967,3378.1136881577468
SIM,1901,24,35-39,1925,16
STAT,1819,48,20-24,1867,0.023041687120722243
STAT,1890,18,20-24,1908,21.822533779119055
STAT,1943,15,50-100,1958,0.4013694266624453
SIM,1842,35,40-44,1877,6
SIM,1886,52,na,1938,2412
STAT,1858,68,na,1926,1210.923232017484
STAT,1835,26,na,1861,2131.2568449637897
STAT,1879,24,50-100,1903,0.4271203271229572
STAT,1900,64,na,1964,2652.3544025337987
STAT,1778,88,na,1866,48.49328040352091
STAT,1900,17,45-49,1917,0.09164820303931054
STAT,1879,30,na,1909,2535.3887309225447
STAT,1844,32,30-34,1876,16.519059965162896
SIM,1873,12,na,1885,2565
SIM,1815,58,na,1873,1132
STAT,1879,49,30-34,1928,0.0998969332121881
SIM,1919,42,na,1961,3972
STAT,1927,1,na,1928,5248.252873228478
SIM,1941,17,40-44,1958,2
STAT,1947,24,30-34,1971,32.78881444208591
SIM,1913,31,45-49,1944,2
STAT,1881,34,15-19,1915,0.1374561844355894
STAT,1910,24,35-39,1934,8.8653586785117
SIM,1811,68,na,1879,879
STAT,1823,49,25-29,1872,0.0770542382162976
SIM,1868,22,25-29,1890,4
STAT,1889,26,50-100,1915,0.7994031450976723
SIM,1795,64,na,1859,830
SIM,1924,17,40-44,1941,1
STAT,1887,36,45-49,1923,2.258766698053403
STAT,1833,70,na,1903,992.6690499075745
STAT,1886,18,na,1904,2686.2322810902265
STAT,1922,48,30-34,1970,0.10317171521113054
STAT,1814,43,15-19,1857,0.03678419585763825
STAT,1937,29,35-39,1966,14.760144909075363
SIM,1816,38,35-39,1854,15
STAT,1823,52,25-29,1875,0.004692510513381478
STAT,1886,39,20-24,1925,0.8137545125969947
SIM,1943,24,na,1967,3881
STAT,1933,17,40-44,1950,1.8920698471252648
STAT,1857,22,50-100,1879,0.37108224122473626
STAT,1897,38,25-29,1935,3.879265209988446
STAT,1918,45,45-49,1963,0.23459509263082198
SIM,1842,28,35-39,1870,12
STAT,1849,41,20-24,1890,0.12473026124141143
STAT,1885,36,40-44,1921,4.42205033982976
SIM,1835,32,30-34,1867,7
STAT,1840,52,25-29,1892,0.00246968952290978
SIM,1866,31,20-24,1897,3
SIM,1836,19,20-24,1855,25
STAT,1829,37,25-29,1866,2.359556235562568
STAT,1891,62,na,1953,2285.53792802103
SIM,1877,20,40-44,1897,3
STAT,1883,21,na,1904,2344.603502621851
STAT,1891,64,na,1955,2173.7792830198296
STAT,1916,17,40-44,1933,0.29947871535248544
SIM,1936,22,na,1958,3476
SIM,1836,38,20-24,1874,3
STAT,1894,23,30-34,1917,23.090371328773873
STAT,1928,19,25-29,1947,54.895233777517845
STAT,1964,0,na,1964,5037.547478367366
STAT,1860,40,35-39,1900,1.5101416016608413
STAT,1907,20,15-19,1927,4.92240001164913
STAT,1824,34,na,1858,1428.3671081780535
STAT,1889,38,35-39,1927,8.764884794435385
SIM,1887,39,20-24,1926,1
SIM,1897,38,35-39,1935,2
SIM,1904,25,30-34,1929,40
SIM,1906,16,35-39,1922,1
STAT,1870,22,30-34,1892,17.6660129774264
SIM,1837,42,50-100,1879,1
STAT,1850,16,25-29,1866,5.3337171563089
SIM,1906,33,25-29,1939,12
STAT,1827,32,30-34,1859,23.49817849104343
STAT,1825,45,40-44,1870,0.23634180098660793
STAT,1943,28,20-24,1971,19.620156981335782
SIM,1912,18,na,1930,3890
SIM,1869,80,na,1949,630
STAT,1820,50,na,1870,1263.9440321007214
STAT,1865,46,25-29,1911,0.05327276835366741
SIM,1894,39,20-24,1933,1
SIM,1851,28,45-49,1879,1
SIM,1898,28,40-44,1926,6
STAT,1834,28,35-39,1862,7.481076426647713
STAT,1870,28,45-49,1898,1.0973094087009803
SIM,1817,44,45-49,1861,1
SIM,1896,39,30-34,1935,1
STAT,1893,22,50-100,1915,0.522967334641616
STAT,1873,21,45-49,1894,0.7161498423067192
STAT,1871,42,na,1913,2316.2986694925976
STAT,1871,21,35-39,1892,5.873140120884156
STAT,1876,35,45-49,1911,2.0986370456891454
STAT,1913,25,30-34,1938,39.65912988555
STAT,1830,42,15-19,1872,0.011998828601235021
SIM,1831,56,na,1887,1364
SIM,1899,27,45-49,1926,3
STAT,1848,37,35-39,1885,5.950989828620973
SIM,1867,35,45-49,1902,1
STAT,1881,28,20-24,1909,11.381132638477157
STAT,1903,35,15-19,1938,0.01759981820573978
STAT,1873,99,na,1972,15.486436855094766
STAT,1924,20,15-19,1944,6.385160421031014
SIM,1921,25,30-34,1946,63
SIM,1795,86,na,1881,10
SIM,1883,29,35-39,1912,10
SIM,1832,33,30-34,1865,29
STAT,1875,36,40-44,1911,4.562275764504246
STAT,1923,27,na,1950,4345.675817164811
STAT,1831,24,45-49,1855,0.7598308164001001
STAT,1871,43,15-19,1914,0.013757016615819254
STAT,1865,48,na,1913,2048.857602124946
SIM,1852,32,30-34,1884,3
SIM,1882,48,na,1930,1992
SIM,1888,38,25-29,1926,3
STAT,1853,22,30-34,1875,17.404517020494065
SIM,1873,24,15-19,1897,3
SIM,1883,36,40-44,1919,8
STAT,1830,27,20-24,1857,12.894785678580332
STAT,1892,29,35-39,1921,12.141449207295103
STAT,1895,49,15-19,1944,2.9138812464666187E-4
SIM,1861,22,30-34,1883,1
STAT,1841,26,25-29,1867,39.5746242315075
STAT,1870,19,15-19,1889,5.872096733473304
SIM,1848,11,na,1859,2242
SIM,1824,86,na,1910,64
SIM,1878,38,25-29,1916,3
STAT,1875,29,35-39,1904,9.936507989462479
STAT,1952,18,20-24,1970,164.097734661134
STAT,1869,39,20-24,1908,0.7493233285816765
SIM,1922,17,30-34,1939,19
STAT,1934,38,50-100,1972,0.584837925934894
SIM,1870,77,na,1947,921
STAT,1842,85,na,1927,246.81275071383706
STAT,1934,25,50-100,1959,1.3541308729663661
STAT,1914,17,30-34,1931,2.54390084314349
STAT,1891,17,25-29,1908,7.086120335717382
STAT,1860,20,20-24,1880,65.38794337923471
STAT,1940,27,25-29,1967,67.75996604872819
SIM,1831,27,20-24,1858,9
SIM,1856,37,35-39,1893,3
STAT,1854,21,35-39,1875,5.182912411886253
STAT,1929,21,45-49,1950,1.442501059206734
STAT,1776,113,na,1889,4.219530562465622E-4
SIM,1951,11,na,1962,4987
STAT,1838,48,30-34,1886,0.06581778258318563
SIM,1928,25,na,1953,4790
STAT,1899,32,20-24,1931,3.7468499008261844
STAT,1825,38,35-39,1863,11.206364297045376
SIM,1833,38,35-39,1871,11
STAT,1859,46,40-44,1905,0.13946670125310445
STAT,1904,27,15-19,1931,0.6576049927890276
SIM,1873,63,na,1936,1663
SIM,1882,24,30-34,1906,21
SIM,1862,21,35-39,1883,8
STAT,1844,62,na,1906,1446.0719978112202
SIM,1804,88,na,1892,50
STAT,1781,103,na,1884,0.03094617272293366
STAT,1860,28,45-49,1888,0.9198654508089094
STAT,1782,93,na,1875,6.943630892788654
STAT,1906,55,na,1961,3158.0338292623283
SIM,1937,21,45-49,1958,1
SIM,1834,20,20-24,1854,78
STAT,1803,101,na,1904,0.2378722681859626
SIM,1891,17,35-39,1908,2
STAT,1844,35,40-44,1879,4.106235451662902
STAT,1905,18,35-39,1923,0.7990692936294908
SIM,1874,39,35-39,1913,11
STAT,1896,45,15-19,1941,3.0466106229162337E-4
SIM,1773,85,na,1858,74
STAT,1866,12,na,1878,2518.247591099403
STAT,1843,23,25-29,1866,48.115884601547535
SIM,1857,20,15-19,1877,2
SIM,1879,32,45-49,1911,3
STAT,1876,25,35-39,1901,10.130582989500025
STAT,1942,7,na,1949,4187.172118649727
SIM,1886,84,na,1970,696
STAT,1839,17,30-34,1856,1.4782174804699242
STAT,1908,26,45-49,1934,1.6683057770601728
STAT,1818,39,15-19,1857,0.12287564036351109
STAT,1887,16,20-24,1903,20.04060608217299
STAT,1870,44,40-44,1914,2.200693648163837
STAT,1860,18,35-39,1878,0.5194100080078958
SIM,1820,70,na,1890,723
SIM,1903,35,na,1938,3232
STAT,1864,50,20-24,1914,6.82194807258917E-4
STAT,1836,65,na,1901,1065.5619029380516
SIM,1954,15,25-29,1969,58
SIM,1884,25,35-39,1909,12
SIM,1924,0,na,1924,5071
STAT,1917,38,20-24,1955,0.2750026605231733
STAT,1883,17,35-39,1900,0.5423283878602424
STAT,1845,31,35-39,1876,8.890117400254923
STAT,1910,36,45-49,1946,0.6609673614491961
STAT,1946,15,25-29,1961,48.57123565967595
SIM,1829,36,50-100,1865,1
SIM,1914,27,25-29,1941,87
SIM,1851,23,25-29,1874,74
STAT,1909,19,15-19,1928,8.932644769181495
SIM,1939,17,na,1956,3765
SIM,1895,16,20-24,1911,29
SIM,1847,17,30-34,1864,2
SIM,1833,77,na,1910,504
STAT,1914,37,25-29,1951,0.9918664910940668
STAT,1832,75,na,1907,700.9856258841613
SIM,1862,26,na,1888,2280
STAT,1904,39,25-29,1943,0.8916749172534477
STAT,1906,47,35-39,1953,0.11563386660375641
STAT,1824,36,35-39,1860,10.171214667234592
STAT,1932,28,45-49,1960,2.2856523773743986
STAT,1940,19,40-44,1959,1.4327780050725678
STAT,1866,39,35-39,1905,6.548251250897289
STAT,1888,39,30-34,1927,6.289507266690751
STAT,1844,94,na,1938,15.812668900841489
STAT,1929,0,na,1929,5811.259327412749
SIM,1852,35,40-44,1887,6
STAT,1803,53,40-44,1856,0.04471976830446861
SIM,1906,24,na,1930,3291
SIM,1868,33,na,1901,2182
SIM,1917,19,15-19,1936,58
STAT,1864,47,20-24,1911,0.01088565930758627
SIM,1853,31,35-39,1884,14
STAT,1849,49,50-100,1898,0.18801377516791
STAT,1857,30,15-19,1887,0.11531516650517883
STAT,1866,27,40-44,1893,2.801548931555204
STAT,1933,37,na,1970,5178.263810119979
STAT,1810,74,na,1884,567.3606014666213
SIM,1920,24,45-49,1944,1
STAT,1843,28,45-49,1871,0.9149933359289153
STAT,1911,29,15-19,1940,0.6896048334625128
STAT,1879,39,20-24,1918,0.804297395372894
STAT,1921,36,20-24,1957,0.2975492370911131
SIM,1842,73,na,1915,717
STAT,1851,25,30-34,1876,22.649385314977163
STAT,1859,93,na,1952,23.740827004397964
STAT,1912,24,45-49,1936,1.1266158466536487
STAT,1949,20,na,1969,4307.892051227407
SIM,1832,23,20-24,1855,61
SIM,1949,20,25-29,1969,137
SIM,1848,37,40-44,1885,5
STAT,1900,32,na,1932,3348.021022090141
SIM,1899,59,na,1958,2879
STAT,1839,34,15-19,1873,0.12169315814389904
SIM,1832,36,35-39,1868,7
STAT,1934,16,45-49,1950,0.68440233757454
STAT,1849,20,15-19,1869,3.1637822351681524
SIM,1846,41,45-49,1887,2
SIM,1881,17,30-34,1898,1
STAT,1812,48,50-100,1860,0.5574627489571159
STAT,1808,58,na,1866,1046.728001552905
STAT,1873,17,30-34,1890,1.6319781767499022
STAT,1790,88,na,1878,40.48888351298783
STAT,1918,20,30-34,1938,31.48162691106068
SIM,1863,38,20-24,1901,1
SIM,1886,38,na,1924,2636
SIM,1914,38,45-49,1952,1
SIM,1880,25,45-49,1905,1
STAT,1898,17,35-39,1915,0.7512973699474551
STAT,1912,41,20-24,1953,0.01728343165777744
STAT,1848,45,20-24,1893,0.009895178634507002
STAT,1840,33,15-19,1873,0.12033140300805617
STAT,1852,51,40-44,1903,0.008022285409461193
STAT,1858,31,20-24,1889,2.1642239146434523
STAT,1858,46,na,1904,1787.8051838042657
STAT,1855,28,50-100,1883,0.49829006044298385
SIM,1828,90,na,1918,21
SIM,1837,59,na,1896,1212
STAT,1819,41,35-39,1860,4.020155591174944
STAT,1892,36,40-44,1928,5.574658574535927
STAT,1915,25,40-44,1940,4.829752343037217
SIM,1788,84,na,1872,124
STAT,1838,41,45-49,1879,1.186794305857384
STAT,1818,45,40-44,1863,0.31407603161005365
STAT,1890,69,na,1959,1923.0261049523551
STAT,1849,40,na,1889,1838.6317482814354
SIM,1926,20,30-34,1946,55
SIM,1932,23,25-29,1955,164
STAT,1964,8,na,1972,4998.318122761354
STAT,1912,49,25-29,1961,0.051131101738928
STAT,1875,51,35-39,1926,0.00897219083661949
STAT,1891,27,35-39,1918,12.06577458082661
STAT,1779,111,na,1890,0.001474182382045119
STAT,1885,20,25-29,1905,57.894556035821594
STAT,1861,74,na,1935,931.4234843393251
STAT,1893,45,na,1938,2914.5960227750074
STAT,1872,24,20-24,1896,69.53712882867757
STAT,1928,39,35-39,1967,3.083113392759086
STAT,1906,27,25-29,1933,62.229767446750095
STAT,1850,26,35-39,1876,8.75745183810629
SIM,1893,20,25-29,1913,73
SIM,1898,21,15-19,1919,3
SIM,1909,23,35-39,1932,12
STAT,1834,30,20-24,1864,2.105309487237005
SIM,1880,24,20-24,1904,68
STAT,1899,68,na,1967,2415.651565155031
SIM,1839,26,35-39,1865,11
SIM,1917,28,20-24,1945,27
SIM,1916,26,45-49,1942,6
STAT,1868,78,na,1946,754.2133288447192
STAT,1877,22,25-29,1899,59.67416045749377
STAT,1884,24,25-29,1908,56.65941088599959
STAT,1778,86,na,1864,74.03933047554983
SIM,1936,19,25-29,1955,69
STAT,1924,23,25-29,1947,109.79964553767908
STAT,1855,51,50-100,1906,0.011422546644527343
SIM,1886,22,35-39,1908,5
STAT,1851,50,35-39,1901,0.006612350625303653
SIM,1906,46,na,1952,3149
SIM,1923,25,40-44,1948,11
STAT,1832,27,30-34,1859,23.12917679560312
STAT,1899,18,40-44,1917,0.2528671618502138
STAT,1854,42,40-44,1896,1.6859730266627855
STAT,1846,48,20-24,1894,0.008992193960158136
STAT,1868,24,40-44,1892,1.998889427324794
STAT,1949,21,30-34,1970,33.8927909257873
STAT,1822,37,15-19,1859,0.10463866067994587
SIM,1805,81,na,1886,166
SIM,1934,20,25-29,1954,128
SIM,1941,23,na,1964,3879
STAT,1870,25,35-39,1895,9.634617724987843
STAT,1878,38,15-19,1916,0.058583495698130594
SIM,1825,33,25-29,1858,10
STAT,1909,28,20-24,1937,17.541911472198294
STAT,1838,38,20-24,1876,0.6162330523849108
STAT,1880,54,20-24,1934,7.611945869546504E-4
SIM,1827,41,35-39,1868,4
SIM,1901,26,na,1927,3441
SIM,1836,42,50-100,1878,2
STAT,1908,38,na,1946,3538.1099898992843
STAT,1846,32,40-44,1878,3.889222332793686
SIM,1888,18,30-34,1906,3
STAT,1842,49,35-39,1891,0.12341510130738306
STAT,1823,47,na,1870,1440.5318112897846
STAT,1828,42,50-100,1870,1.0087575288371047
SIM,1893,39,45-49,1932,3
SIM,1854,32,40-44,1886,4
SIM,1906,28,45-49,1934,5
SIM,1842,30,20-24,1872,6
SIM,1888,19,na,1907,3093
STAT,1819,52,50-100,1871,0.028277230668031374
STAT,1886,32,35-39,1918,10.799432301501787
SIM,1846,38,20-24,1884,2
STAT,1878,22,35-39,1900,6.118236926119399
STAT,1894,59,na,1953,2527.1551678780806
SIM,1888,0,na,1888,3733
SIM,1894,32,35-39,1926,14
STAT,1784,101,na,1885,0.11794606565773633
SIM,1879,20,35-39,1899,8
SIM,1801,58,na,1859,889
STAT,1844,29,15-19,1873,0.4331428621362759
STAT,1918,46,15-19,1964,3.967397295894403E-4
STAT,1881,7,na,1888,2566.279446002658
STAT,1890,40,20-24,1930,0.19797854205929027
STAT,1837,45,45-49,1882,0.17146794628533363
STAT,1876,73,na,1949,1238.639476903478
SIM,1959,4,na,1963,5508
STAT,1926,20,25-29,1946,114.09121950271019
SIM,1947,6,na,1953,4866
STAT,1830,47,15-19,1877,3.345699624425969E-4
STAT,1906,38,45-49,1944,0.6298418041045755
STAT,1900,10,na,1910,3634.256276003984
STAT,1849,5,na,1854,2420.0
STAT,1865,37,35-39,1902,6.523044280255058
STAT,1912,36,50-100,1948,0.4154202645923313
STAT,1896,18,15-19,1914,7.91323960289273
SIM,1863,27,25-29,1890,43
STAT,1792,69,na,1861,657.8158969365048
STAT,1931,38,50-100,1969,0.5613968319336669
STAT,1858,17,40-44,1875,0.16929741380955451
STAT,1890,21,45-49,1911,0.8632052177187577
STAT,1864,31,na,1895,2183.7411141870134
STAT,1902,27,20-24,1929,16.743831825454716
STAT,1817,86,na,1903,101.51330921030869
SIM,1855,15,na,1870,2381
STAT,1892,26,30-34,1918,32.024539573817016
STAT,1944,11,na,1955,4269.375908191169
STAT,1887,33,40-44,1920,4.869643801782018
STAT,1817,38,45-49,1855,6.62487053380894
STAT,1863,27,15-19,1890,0.40601376031844794
SIM,1875,44,na,1919,2261
SIM,1901,21,30-34,1922,45
SIM,1895,33,40-44,1928,11
STAT,1900,42,40-44,1942,0.21887258531796486
STAT,1871,48,15-19,1919,3.9632612581781457E-4
STAT,1890,37,20-24,1927,0.9513515015595955
STAT,1934,30,25-29,1964,12.765346797040118
SIM,1833,35,30-34,1868,10
STAT,1864,28,20-24,1892,10.654258785000135
STAT,1930,29,25-29,1959,84.50717101025622
SIM,1892,24,25-29,1916,93
STAT,1829,108,na,1937,0.001080053681146568
STAT,1862,49,50-100,1911,0.2097446121561716
SIM,1847,44,30-34,1891,4
STAT,1840,19,35-39,1859,0.49215272564185164
SIM,1825,38,45-49,1863,1
STAT,1851,35,40-44,1886,3.4203873369923836
SIM,1832,23,15-19,1855,5
STAT,1818,36,50-100,1854,3.9881653416780853
STAT,1878,43,50-100,1921,1.0996406642092638
STAT,1829,27,15-19,1856,0.6003895893679994
STAT,1869,53,50-100,1922,0.014592157149874468
STAT,1924,18,45-49,1942,0.5995463119682365
SIM,1831,30,45-49,1861,1
STAT,1825,35,30-34,1860,9.569311020865062
STAT,1897,22,45-49,1919,0.9442144125187005
STAT,1828,78,na,1906,507.20772169090935
STAT,1855,27,25-29,1882,33.18910024396033
SIM,1909,31,50-100,1940,4
SIM,1828,42,40-44,1870,3
STAT,1924,23,na,1947,4340.896521957676
STAT,1846,15,20-24,1861,17.101698484152774
STAT,1886,32,na,1918,2544.7454005025256
STAT,1806,77,na,1883,347.4534943194031
SIM,1910,27,20-24,1937,20
STAT,1846,34,20-24,1880,2.374313347386316
SIM,1855,27,30-34,1882,3
SIM,1952,15,na,1967,4461
STAT,1807,49,40-44,1856,0.5911181105769447
STAT,1849,39,35-39,1888,5.542332602401877
SIM,1932,18,45-49,1950,4
STAT,1905,23,15-19,1928,4.802009568047937
STAT,1921,19,30-34,1940,13.957012834198352
SIM,1886,43,50-100,1929,1
STAT,1927,15,15-19,1942,57.3000209491894
SIM,1883,31,20-24,1914,3
STAT,1833,25,na,1858,2045.8556300889322
SIM,1899,36,35-39,1935,4
SIM,1847,34,20-24,1881,1
STAT,1839,44,30-34,1883,0.8373298404872801
STAT,1939,17,35-39,1956,4.240277894143403
STAT,1914,29,40-44,1943,4.706954132855198
SIM,1947,17,35-39,1964,6
SIM,1922,29,40-44,1951,7
SIM,1808,70,na,1878,602
STAT,1875,31,20-24,1906,2.8151173234136353
SIM,1826,36,50-100,1862,1
STAT,1820,103,na,1923,0.07305234297751045
STAT,1867,20,30-34,1887,17.2602007115979
SIM,1913,23,15-19,1936,5
SIM,1915,9,na,1924,4556
SIM,1857,39,35-39,1896,12
SIM,1854,34,20-24,1888,4
STAT,1884,60,na,1944,1899.5414235325184
STAT,1834,50,35-39,1884,0.0054694863934011415
STAT,1861,24,45-49,1885,0.5926452567509285
SIM,1810,44,35-39,1854,4
SIM,1854,15,20-24,1869,25
SIM,1935,15,15-19,1950,58
STAT,1812,55,na,1867,1213.8153478331215
STAT,1895,43,40-44,1938,0.20452639548831397
SIM,1891,31,na,1922,3047
STAT,1901,20,20-24,1921,98.1524269338905
STAT,1940,24,20-24,1964,114.2778345859375
SIM,1887,42,45-49,1929,12
STAT,1850,54,35-39,1904,0.0064107978295551045
STAT,1861,25,50-100,1886,0.5486317275427548
SIM,1852,35,35-39,1887,15
SIM,1868,42,35-39,1910,2
STAT,1870,25,40-44,1895,2.9911210580733694
STAT,1899,35,25-29,1934,4.028907571240796
SIM,1883,73,na,1956,1306
STAT,1877,89,na,1966,273.7436798949202
STAT,1858,22,15-19,1880,2.9993138067494285
SIM,1863,17,15-19,1880,9
STAT,1863,38,15-19,1901,0.05000289209229665
SIM,1884,29,na,1913,2331
STAT,1892,24,50-100,1916,0.5135896625728873
SIM,1840,47,na,1887,1637
STAT,1852,25,50-100,1877,0.5732621815301606
SIM,1846,30,na,1876,1876
SIM,1902,17,20-24,1919,36
STAT,1838,53,50-100,1891,0.009947850608516634
STAT,1859,49,45-49,1908,0.18770841236145405
STAT,1908,40,25-29,1948,0.0674481858851787
STAT,1847,27,30-34,1874,22.662291809788158
STAT,1848,44,na,1892,1861.5598491840137
STAT,1862,59,na,1921,1695.128888772078
STAT,1828,52,40-44,1880,0.0092611874538584
STAT,1837,37,15-19,1874,0.04664243884477079
STAT,1861,110,na,1971,0.003713369108656724
STAT,1869,38,na,1907,2301.9969625028316
SIM,1812,83,na,1895,108
STAT,1865,34,30-34,1899,15.964467458750216
SIM,1918,20,40-44,1938,4
STAT,1863,35,45-49,1898,1.8008932518431393
SIM,1865,68,na,1933,1259
SIM,1908,30,25-29,1938,6
STAT,1870,15,50-100,1885,0.04963541703547591
SIM,1819,62,na,1881,992
STAT,1844,35,35-39,1879,6.634623009717179
SIM,1920,21,35-39,1941,16
SIM,1921,28,35-39,1949,25
SIM,1913,18,35-39,1931,1
SIM,1873,37,35-39,1910,19
STAT,1889,46,20-24,1935,0.014987161755122765
STAT,1855,44,15-19,1899,0.010254634326398752
SIM,1892,16,na,1908,3479
STAT,1908,36,na,1944,3572.8604942696456
STAT,1879,42,45-49,1921,1.5755163729878225
STAT,1835,24,35-39,1859,5.740881639863347
STAT,1913,28,35-39,1941,15.040626152282735
SIM,1843,24,35-39,1867,7
SIM,1848,49,50-100,1897,3
SIM,1860,45,na,1905,2023
SIM,1888,35,20-24,1923,3
STAT,1881,17,25-29,1898,5.516931070886538
SIM,1811,48,50-100,1859,3
STAT,1804,68,na,1872,680.5626325379569
STAT,1865,43,20-24,1908,0.14540823225373503
STAT,1791,84,na,1875,99.25391252813901
SIM,1848,96,na,1944,9
STAT,1857,16,35-39,1873,0.5113683523044088
STAT,1865,16,na,1881,2414.4765232272907
STAT,1912,21,35-39,1933,9.1315907111113
STAT,1876,24,50-100,1900,0.4225991399523419
STAT,1819,95,na,1914,6.758958691809586
STAT,1827,35,40-44,1862,5.338154697881297
SIM,1873,24,20-24,1897,55
SIM,1927,29,25-29,1956,8
STAT,1924,48,40-44,1972,0.18914501877281495
SIM,1876,25,45-49,1901,1
STAT,1844,54,40-44,1898,0.008100259407838675
STAT,1915,30,15-19,1945,0.13312337673082308
STAT,1814,47,30-34,1861,0.23347582891055949
SIM,1865,8,na,1873,2551
STAT,1860,23,25-29,1883,48.37209008127754
STAT,1885,36,35-39,1921,7.144898844726728
SIM,1960,2,na,1962,5281
STAT,1826,97,na,1923,2.9478588424188197
SIM,1843,42,30-34,1885,2
STAT,1835,39,15-19,1874,0.05105475848426039
STAT,1889,39,50-100,1928,1.5136347652236222
SIM,1780,87,na,1867,66
STAT,1842,46,30-34,1888,0.08829090860376732
STAT,1839,22,20-24,1861,62.775564558377546
SIM,1898,37,30-34,1935,1
SIM,1913,15,30-34,1928,3
STAT,1848,27,25-29,1875,41.23107174040766
STAT,1879,45,15-19,1924,4.258027411665541E-4
STAT,1843,27,50-100,1870,0.5309786218782193
STAT,1920,30,na,1950,4217.01594650583
STAT,1887,30,50-100,1917,1.0415055980586645
SIM,1856,27,25-29,1883,5
SIM,1919,46,50-100,1965,2
STAT,1822,34,45-49,1856,3.8953555906426067
STAT,1931,25,25-29,1956,85.95652323582875
SIM,1862,71,na,1933,1176
SIM,1827,31,50-100,1858,4
SIM,1861,44,40-44,1905,5
SIM,1903,24,45-49,1927,1
STAT,1845,79,na,1924,510.8264505168327
SIM,1884,49,50-100,1933,6
SIM,1946,7,na,1953,4466
STAT,1887,19,25-29,1906,6.3557947701926105
SIM,1862,4,na,1866,2551
SIM,1838,23,15-19,1861,5
SIM,1858,23,35-39,1881,6
STAT,1888,41,na,1929,2767.7227989640596
SIM,1906,25,40-44,1931,4
STAT,1905,27,30-34,1932,36.76800621287713
SIM,1840,79,na,1919,576
STAT,1865,24,20-24,1889,63.4070984526665
STAT,1894,48,45-49,1942,0.17093032009852166
STAT,1891,33,20-24,1924,3.3658519177953217
SIM,1866,22,15-19,1888,3
STAT,1822,84,na,1906,185.99983850829716
STAT,1859,35,45-49,1894,1.634759620576226
STAT,1932,33,50-100,1965,1.1100421139573993
SIM,1893,36,35-39,1929,16
STAT,1833,34,20-24,1867,2.420462718235529
STAT,1907,51,na,1958,3262.79515619914
STAT,1818,45,35-39,1863,0.25683787690893034
STAT,1843,25,40-44,1868,2.5225710448259777
SIM,1925,36,na,1961,4550
STAT,1874,24,30-34,1898,18.30595742467884
STAT,1900,26,35-39,1926,13.584011548859117
STAT,1931,17,30-34,1948,16.123833023194322
STAT,1881,38,30-34,1919,5.162956914076975
SIM,1855,24,na,1879,2141
SIM,1911,31,35-39,1942,14
STAT,1874,36,25-29,1910,2.9919672777706636
SIM,1813,43,50-100,1856,1
STAT,1918,14,na,1932,4339.885061630105
SIM,1882,36,25-29,1918,2
SIM,1841,34,20-24,1875,2
STAT,1835,42,30-34,1877,1.0343120043207692
STAT,1821,37,20-24,1858,1.519350583381652
STAT,1867,46,35-39,1913,0.13354916691174828
STAT,1908,32,30-34,1940,15.012280952211592
SIM,1899,24,35-39,1923,17
SIM,1932,27,40-44,1959,12
STAT,1906,24,20-24,1930,100.74276939357075
SIM,1851,31,na,1882,2017
SIM,1879,24,15-19,1903,4
SIM,1915,23,25-29,1938,136
SIM,1826,35,na,1861,2098
SIM,1839,82,na,1921,247
STAT,1855,89,na,1944,79.07597555729362
SIM,1938,4,na,1942,3927
STAT,1888,44,na,1932,2718.0651366322363
STAT,1825,48,45-49,1873,0.31252809655820907
STAT,1898,51,na,1949,2962.322975893511
STAT,1927,36,15-19,1963,0.024154052314198933
STAT,1876,43,30-34,1919,1.1902626477279121
SIM,1946,4,na,1950,4497
SIM,1820,43,40-44,1863,5
STAT,1840,37,30-34,1877,4.41873638635783
STAT,1861,29,15-19,1890,0.3780619897293054
STAT,1897,35,15-19,1932,0.07675870717252704
STAT,1823,33,15-19,1856,0.32984638461034366
STAT,1824,42,20-24,1866,0.1973411608683398
STAT,1837,52,na,1889,1474.1716163214014
STAT,1836,21,25-29,1857,48.00494481563575
STAT,1904,36,20-24,1940,0.24231638781754847
SIM,1883,41,na,1924,2592
STAT,1933,34,25-29,1967,12.570377466776092
SIM,1841,35,25-29,1876,5
SIM,1916,32,30-34,1948,27
STAT,1859,34,40-44,1893,3.492707695373508
STAT,1890,24,15-19,1914,4.046037766930933
STAT,1809,52,30-34,1861,0.019118308845413327
STAT,1839,34,20-24,1873,2.309873802877017
STAT,1924,27,40-44,1951,5.484045357078908
STAT,1929,24,15-19,1953,6.761328180814922
SIM,1851,25,40-44,1876,4
STAT,1927,35,45-49,1962,0.858172456594465
SIM,1841,24,na,1865,1828
SIM,1877,27,na,1904,2511
STAT,1884,51,na,1935,2154.8050902872874
SIM,1798,75,na,1873,313
SIM,1884,43,30-34,1927,1
SIM,1881,63,na,1944,1660
SIM,1857,36,30-34,1893,10
SIM,1836,42,na,1878,1875
SIM,1844,21,25-29,1865,60
STAT,1859,46,35-39,1905,0.11404987278307419
STAT,1889,28,25-29,1917,52.496503477750935
SIM,1873,34,na,1907,2325
STAT,1892,39,45-49,1931,2.501075428089436
STAT,1899,23,15-19,1922,4.558817877344437
SIM,1835,35,40-44,1870,5
STAT,1860,15,30-34,1875,1.5357394268247737
STAT,1851,64,na,1915,1316.263771134135
STAT,1874,53,50-100,1927,0.015368324841993321
STAT,1919,29,25-29,1948,71.29325222049658
SIM,1833,37,50-100,1870,1
STAT,1868,20,25-29,1888,56.06080956784258
STAT,1812,43,40-44,1855,5.6523843521818735
STAT,1856,34,na,1890,1832.010642328398
SIM,1847,22,20-24,1869,61
STAT,1907,23,25-29,1930,84.64591973187589
STAT,1823,33,50-100,1856,2.122219083215293
SIM,1854,1,na,1855,3158
SIM,1895,19,25-29,1914,9
SIM,1827,29,20-24,1856,7
SIM,1928,38,30-34,1966,1
SIM,1835,23,40-44,1858,3
STAT,1921,4,na,1925,4646.633941236574
STAT,1894,26,40-44,1920,3.908605114649481
STAT,1925,47,45-49,1972,0.2661578155344545
SIM,1826,32,na,1858,2150
SIM,1851,34,na,1885,2007
STAT,1927,23,45-49,1950,1.3968391457158222
STAT,1905,20,50-100,1925,0.5989659652783444
SIM,1876,93,na,1969,123
STAT,1823,46,20-24,1869,0.01675377513632426
SIM,1858,35,35-39,1893,5
STAT,1855,24,20-24,1879,59.73213548706832
SIM,1859,37,na,1896,2211
STAT,1823,41,50-100,1864,1.607148183945763
SIM,1863,24,20-24,1887,59
SIM,1879,49,50-100,1928,5
STAT,1929,19,40-44,1948,1.7945516972000368
SIM,1937,24,15-19,1961,4
STAT,1965,2,na,1967,4960.790520558202
SIM,1819,44,50-100,1863,1
SIM,1903,0,na,1903,3645
SIM,1916,20,30-34,1936,65
STAT,1944,20,40-44,1964,3.6684938995660494
SIM,1900,30,20-24,1930,5
STAT,1874,35,20-24,1909,0.8047750383833382
STAT,1905,35,25-29,1940,0.9159936413202556
SIM,1880,27,25-29,1907,39
STAT,1894,15,45-49,1909,0.0853358124929934
SIM,1828,28,25-29,1856,46
SIM,1914,24,20-24,1938,159
STAT,1924,46,50-100,1970,0.27277647841663094
STAT,1907,44,25-29,1951,0.0652483567499649
STAT,1884,26,40-44,1910,2.9938054897964252
SIM,1876,20,25-29,1896,78
STAT,1891,19,na,1910,3141.2785224197323
STAT,1821,69,na,1890,879.0466432311141
STAT,1789,72,na,1861,663.9447474105848
STAT,1922,11,na,1933,4639.417357920996
STAT,1952,15,50-100,1967,0.4538612674852437
STAT,1840,27,na,1867,1890.761714078479
STAT,1930,26,20-24,1956,23.470151046891047
STAT,1867,29,na,1896,2253.888302830542
STAT,1896,49,30-34,1945,0.0714760682580856
STAT,1908,20,30-34,1928,26.831774661446474
SIM,1935,35,45-49,1970,3
STAT,1941,15,40-44,1956,1.4552934299074465
STAT,1851,38,45-49,1889,1.509848656430155
SIM,1868,42,na,1910,2102
SIM,1871,35,45-49,1906,2
STAT,1849,36,30-34,1885,4.3083932490424575
STAT,1878,25,45-49,1903,1.1720002613066787
STAT,1881,18,50-100,1899,0.04757183516650385
STAT,1925,20,30-34,1945,34.97567653112165
SIM,1918,35,45-49,1953,3
STAT,1836,48,20-24,1884,0.0078214543476402
SIM,1858,74,na,1932,713
SIM,1847,82,na,1929,283
SIM,1905,16,na,1921,3814
STAT,1839,30,na,1869,1930.5483202233172
SIM,1817,50,na,1867,1493
STAT,1915,37,35-39,1952,2.4655508619640263
SIM,1874,24,30-34,1898,29
STAT,1944,28,50-100,1972,1.0858046595961217
STAT,1850,32,20-24,1882,2.1651862646175077
SIM,1938,22,15-19,1960,4
SIM,1876,36,40-44,1912,8
STAT,1841,49,40-44,1890,0.12535276763289172
STAT,1893,36,35-39,1929,9.114265190971567
SIM,1816,57,na,1873,1128
SIM,1848,67,na,1915,1185
STAT,1921,15,50-100,1936,0.43332350650285517
SIM,1870,19,20-24,1889,20
STAT,1880,56,na,1936,2163.4612109375194
SIM,1849,60,na,1909,1501
STAT,1771,99,na,1870,0.2745863954643218
STAT,1805,102,na,1907,0.11638344569057517
STAT,1899,39,na,1938,3258.383639507766
SIM,1881,24,15-19,1905,3
SIM,1885,22,na,1907,2579
STAT,1945,19,25-29,1964,47.7748862833932
SIM,1816,43,25-29,1859,4
SIM,1866,64,na,1930,1691
STAT,1872,19,50-100,1891,0.04948059192362479
STAT,1881,21,50-100,1902,0.39820926576115917
SIM,1826,64,na,1890,1333
SIM,1892,26,40-44,1918,8
STAT,1868,36,40-44,1904,4.245901377962376
SIM,1897,28,25-29,1925,58
SIM,1932,15,40-44,1947,3
SIM,1844,29,20-24,1873,14
STAT,1904,15,20-24,1919,25.815454465162652
STAT,1934,22,30-34,1956,39.027641685462235
STAT,1836,29,20-24,1865,9.439242940974548
SIM,1876,24,40-44,1900,3
SIM,1923,37,35-39,1960,7
STAT,1893,28,50-100,1921,0.8174803565965122
SIM,1912,15,20-24,1927,37
STAT,1813,79,na,1892,306.5289093804401
STAT,1924,15,40-44,1939,1.69096002177933
STAT,1905,48,30-34,1953,0.07872427606193674
SIM,1877,32,50-100,1909,1
SIM,1886,25,45-49,1911,2
SIM,1825,35,40-44,1860,6
SIM,1888,11,na,1899,3205
STAT,1829,42,50-100,1871,0.8204338197212158
STAT,1853,79,na,1932,578.1436353912658
STAT,1931,25,na,1956,4892.203717047473
STAT,1946,24,15-19,1970,5.978842229912779
STAT,1888,76,na,1964,1428.09150737503
SIM,1942,22,30-34,1964,58
STAT,1843,45,35-39,1888,0.09642461924486152
SIM,1866,34,25-29,1900,4
STAT,1915,16,35-39,1931,0.8883585315662259
STAT,1921,27,15-19,1948,0.7946382072424122
STAT,1941,27,35-39,1968,15.680060718959608
STAT,1821,46,50-100,1867,0.36522020630443386
SIM,1838,35,na,1873,1847
SIM,1908,56,na,1964,3072
STAT,1819,42,na,1861,1444.478803906668
STAT,1931,41,30-34,1972,0.1728598100280591
STAT,1918,38,50-100,1956,0.44632120466292485
SIM,1917,19,na,1936,3800
SIM,1913,27,30-34,1940,68
SIM,1859,32,25-29,1891,20
SIM,1830,34,45-49,1864,3
STAT,1846,18,25-29,1864,5.370345331166045
SIM,1889,30,45-49,1919,3
STAT,1867,23,35-39,1890,5.533684492006314
SIM,1854,18,25-29,1872,10
STAT,1878,46,45-49,1924,0.24813784108535125
SIM,1899,21,30-34,1920,34
STAT,1858,12,na,1870,2209.6574905737634
STAT,1862,19,20-24,1881,15.926807892351924
SIM,1907,20,20-24,1927,135
STAT,1856,34,15-19,1890,0.10932873730758609
STAT,1931,38,30-34,1969,2.4369991595970366
SIM,1877,23,45-49,1900,2
STAT,1884,46,35-39,1930,0.13983519463962585
SIM,1815,72,na,1887,590
STAT,1900,23,30-34,1923,24.913610240292122
STAT,1839,53,20-24,1892,5.147648530481263E-4
STAT,1831,26,25-29,1857,37.72120449496789
SIM,1942,25,50-100,1967,1
SIM,1837,27,na,1864,1691
SIM,1877,56,na,1933,2123
STAT,1873,11,na,1884,2698.3109924196037
STAT,1866,24,30-34,1890,16.554341464386262
SIM,1911,25,50-100,1936,1
STAT,1880,70,na,1950,1488.2555375747243
STAT,1912,25,15-19,1937,0.7066386379087328
STAT,1883,47,30-34,1930,0.09522830652128617
STAT,1826,45,35-39,1871,0.14176267474009546
STAT,1835,107,na,1942,0.003539548675343887
SIM,1913,26,na,1939,3750
STAT,1861,32,30-34,1893,14.653593665733679
SIM,1871,31,50-100,1902,1
STAT,1950,17,40-44,1967,1.6709160723494405
SIM,1853,19,20-24,1872,21
STAT,1834,87,na,1921,104.8678255735738
SIM,1866,36,40-44,1902,7
SIM,1867,49,na,1916,1944
SIM,1860,13,na,1873,2406
SIM,1895,38,25-29,1933,1
SIM,1787,80,na,1867,198
STAT,1905,15,30-34,1920,2.3380158842582905
STAT,1926,19,15-19,1945,55.93394982806764
SIM,1934,19,15-19,1953,62
STAT,1802,87,na,1889,59.26676341102603
STAT,1932,37,35-39,1969,3.2842138822429097
SIM,1923,16,35-39,1939,4
STAT,1853,28,45-49,1881,0.9610056663658237
SIM,1861,28,45-49,1889,1
STAT,1845,19,20-24,1864,16.1804105767591
STAT,1941,20,15-19,1961,5.557699096128399
STAT,1880,78,na,1958,946.2883299159787
STAT,1877,49,20-24,1926,0.01224790024689023
STAT,1827,54,40-44,1881,0.009118174540930066
SIM,1893,25,45-49,1918,1
SIM,1918,19,30-34,1937,26
STAT,1853,90,na,1943,65.19929862969364
STAT,1865,27,25-29,1892,39.01273930956376
STAT,1881,53,25-29,1934,0.003393013933834361
SIM,1893,33,30-34,1926,31
SIM,1814,95,na,1909,7
STAT,1904,45,na,1949,3294.0842570327054
SIM,1922,25,25-29,1947,122
SIM,1903,21,40-44,1924,4
SIM,1912,2,na,1914,4043
STAT,1849,32,15-19,1881,0.11732652743020966
SIM,1928,22,15-19,1950,7
STAT,1850,39,40-44,1889,3.3350099770968855
STAT,1808,46,50-100,1854,0.9221724033697747
STAT,1831,98,na,1929,2.0413849284884305
SIM,1826,34,45-49,1860,2
STAT,1897,58,na,1955,2677.7832739594483
STAT,1922,15,30-34,1937,14.316792751975939
STAT,1827,38,45-49,1865,2.2650528622061294
STAT,1927,20,40-44,1947,4.212100919438356
SIM,1930,15,30-34,1945,31
STAT,1835,45,35-39,1880,0.12491986341647748
SIM,1904,12,na,1916,3901
STAT,1859,16,45-49,1875,0.061960896870789685
STAT,1891,30,na,1921,3008.0159825471387
STAT,1912,29,30-34,1941,38.677917631626684
STAT,1901,41,45-49,1942,0.14781554772239658
STAT,1885,33,30-34,1918,17.478839278468698
SIM,1848,45,na,1893,1742
STAT,1894,45,40-44,1939,0.12682668777808634
SIM,1920,29,30-34,1949,65
STAT,1887,38,25-29,1925,3.230611323096535
SIM,1882,33,20-24,1915,2
STAT,1934,37,45-49,1971,0.9505617795921167
SIM,1797,90,na,1887,28
SIM,1841,23,30-34,1864,1
SIM,1905,34,20-24,1939,2
STAT,1837,24,45-49,1861,0.6138481339505256
STAT,1930,9,na,1939,5201.840337331556
SIM,1887,15,na,1902,2779
STAT,1919,44,na,1963,4050.1428256086565
SIM,1830,31,40-44,1861,5
STAT,1920,19,20-24,1939,152.7798088016325
STAT,1860,25,40-44,1885,2.536003116340315
SIM,1937,2,na,1939,3867
STAT,1943,19,15-19,1962,48.56090942465118
STAT,1875,39,45-49,1914,2.046868998020999
STAT,1895,46,45-49,1941,0.176083742822679
SIM,1815,40,na,1855,1560
STAT,1901,29,20-24,1930,16.491347360339145
STAT,1879,62,na,1941,1926.428297064333
STAT,1874,33,20-24,1907,2.7836783143856336
STAT,1894,29,45-49,1923,1.4334475494103014
STAT,1850,42,50-100,1892,0.8079438683156349
SIM,1889,35,30-34,1924,11
SIM,1784,91,na,1875,8
SIM,1935,20,40-44,1955,6
STAT,1844,23,40-44,1867,2.043700328247838
STAT,1890,40,50-100,1930,1.316987667723904
STAT,1853,47,45-49,1900,0.1942565852336855
SIM,1852,23,40-44,1875,2
SIM,1875,78,na,1953,658
SIM,1927,26,20-24,1953,24
SIM,1927,40,na,1967,5134
SIM,1932,20,15-19,1952,11
SIM,1867,25,35-39,1892,15
STAT,1914,25,25-29,1939,67.40124356024292
SIM,1883,39,45-49,1922,7
SIM,1878,35,20-24,1913,1
STAT,1853,50,45-49,1903,0.012173891353545768
STAT,1885,25,45-49,1910,1.123802483183966
SIM,1897,47,na,1944,3061
SIM,1897,22,na,1919,3269
STAT,1888,20,35-39,1908,6.998050662097945
STAT,1899,36,na,1935,3281.4603256772057
SIM,1880,17,15-19,1897,7
STAT,1808,48,45-49,1856,0.8389715673000843
STAT,1948,24,25-29,1972,107.06520662294604
SIM,1915,27,40-44,1942,6
STAT,1833,23,30-34,1856,16.88079560458963
STAT,1891,35,20-24,1926,0.9730842792925919
STAT,1804,65,na,1869,761.1113069388781
STAT,1914,55,na,1969,3560.7398185968973
SIM,1917,30,na,1947,3896
STAT,1822,32,45-49,1854,5.3694132203585685
SIM,1900,33,25-29,1933,25
SIM,1893,24,40-44,1917,5
STAT,1867,43,30-34,1910,1.0856897808412427
STAT,1890,28,30-34,1918,30.96911788177759
STAT,1905,39,40-44,1944,1.3656810224530103
SIM,1837,18,25-29,1855,6
SIM,1919,36,30-34,1955,4
STAT,1923,24,20-24,1947,129.90554109616443
STAT,1908,35,35-39,1943,2.307727668662929
STAT,1868,18,50-100,1886,0.04786407430904924
STAT,1853,44,40-44,1897,1.834990496129386
SIM,1826,33,40-44,1859,6
STAT,1889,29,na,1918,2950.9195855415783
STAT,1870,49,na,1919,2184.776415195298
STAT,1919,26,20-24,1945,19.98242425866789
STAT,1832,52,50-100,1884,0.010728817042013592
SIM,1831,37,30-34,1868,7
STAT,1812,46,45-49,1858,0.5531617321121676
SIM,1931,24,20-24,1955,125
STAT,1944,23,45-49,1967,1.2263656304771056
STAT,1823,37,30-34,1860,9.280242602837877
STAT,1918,42,35-39,1960,0.21614590857065435
SIM,1835,38,45-49,1873,1
STAT,1922,31,45-49,1953,1.8034769516138083
STAT,1824,44,20-24,1868,0.18928775501059147
SIM,1845,24,45-49,1869,5
SIM,1879,28,30-34,1907,37
SIM,1854,37,25-29,1891,3
SIM,1883,34,25-29,1917,18
SIM,1897,35,30-34,1932,11
STAT,1872,17,15-19,1889,6.045888798823594
SIM,1841,32,20-24,1873,1
STAT,1824,49,40-44,1873,0.19488670677783015
STAT,1818,42,30-34,1860,2.2568223749953327
STAT,1866,41,na,1907,2171.3271932519415
STAT,1933,31,20-24,1964,3.3235773576010796
STAT,1818,49,50-100,1867,0.42445958789586824
SIM,1826,49,50-100,1875,3
SIM,1896,20,35-39,1916,11
SIM,1830,32,45-49,1862,2
SIM,1869,29,25-29,1898,9
STAT,1848,24,20-24,1872,67.52717401285231
STAT,1824,45,25-29,1869,0.06928404711262275
SIM,1884,26,na,1910,2404
SIM,1866,7,na,1873,2850
SIM,1871,53,na,1924,1996
STAT,1867,26,na,1893,2277.9036575380987
STAT,1875,34,25-29,1909,10.532851509184702
SIM,1847,37,25-29,1884,4
STAT,1846,37,25-29,1883,2.281732072336895
STAT,1814,54,50-100,1868,0.03341571148396822
SIM,1817,84,na,1901,130
STAT,1891,36,25-29,1927,3.6177020698915885
STAT,1923,19,50-100,1942,0.4421221487791687
SIM,1878,16,20-24,1894,20
SIM,1846,86,na,1932,40
SIM,1858,20,30-34,1878,33
STAT,1914,31,50-100,1945,0.8431283898393087
SIM,1826,42,30-34,1868,1
STAT,1869,23,45-49,1892,0.6826249891795315
STAT,1885,24,40-44,1909,2.081817000569542
STAT,1876,46,35-39,1922,0.14641252760716403
SIM,1937,19,40-44,1956,4
SIM,1938,27,35-39,1965,31
STAT,1875,26,na,1901,2483.8383630201824
SIM,1848,34,30-34,1882,13
STAT,1890,1,na,1891,3359.220992479962
SIM,1913,39,40-44,1952,4
SIM,1947,14,na,1961,4831
SIM,1856,24,20-24,1880,67
STAT,1806,91,na,1897,19.537795342298082
SIM,1916,35,35-39,1951,6
SIM,1922,31,50-100,1953,1
STAT,1907,27,40-44,1934,4.443103849862693
STAT,1847,31,45-49,1878,1.549017536162351
STAT,1834,35,40-44,1869,3.310821619978603
STAT,1893,5,na,1898,3360.8155320313585
STAT,1839,37,25-29,1876,2.4393463728225884
STAT,1833,32,20-24,1865,2.471255144604967
SIM,1888,23,20-24,1911,124
STAT,1889,35,30-34,1924,6.700461656097567
STAT,1932,21,50-100,1953,0.8751151914763676
STAT,1934,25,35-39,1959,20.425304611757923
SIM,1853,97,na,1950,1
STAT,1775,91,na,1866,12.88581516221701
STAT,1878,44,45-49,1922,1.5479788293188357
STAT,1915,34,30-34,1949,16.052656505279792
SIM,1902,29,20-24,1931,18
STAT,1917,30,25-29,1947,9.847892631680118
SIM,1860,16,na,1876,2327
SIM,1909,30,40-44,1939,8
STAT,1941,18,45-49,1959,0.5193058662705321
STAT,1916,33,na,1949,3923.864884070976
SIM,1845,42,40-44,1887,4
STAT,1841,23,15-19,1864,3.1028320074401363
STAT,1843,16,na,1859,1990.2178828246565
STAT,1854,45,45-49,1899,0.1788805876976226
STAT,1880,8,na,1888,2791.348928052876
SIM,1832,49,40-44,1881,3
STAT,1840,46,20-24,1886,0.008592058512603773
STAT,1855,71,na,1926,1004.7322443820171
STAT,1872,42,50-100,1914,1.0714225894245515
STAT,1945,16,20-24,1961,149.60725933970195
STAT,1836,68,na,1904,963.5652102118079
SIM,1866,47,50-100,1913,2
STAT,1931,29,40-44,1960,6.075674480089021
SIM,1945,26,30-34,1971,53
SIM,1834,42,30-34,1876,2
STAT,1905,41,na,1946,3401.6099328821315
STAT,1904,18,25-29,1922,8.191943497822058
STAT,1906,26,na,1932,3522.8708613062176
SIM,1918,15,15-19,1933,10
STAT,1868,39,45-49,1907,1.9049273537611757
STAT,1838,44,15-19,1882,0.009589492553790713
STAT,1875,17,40-44,1892,0.18971025039193967
STAT,1919,22,na,1941,4037.4730081894704
STAT,1844,24,45-49,1868,0.6789893420038619
SIM,1870,23,na,1893,2599
STAT,1829,34,20-24,1863,2.2903452119699086
STAT,1849,36,50-100,1885,0.9924986273432994
STAT,1869,52,na,1921,2103.065677257126
SIM,1884,37,50-100,1921,3
STAT,1891,44,50-100,1935,1.3032380794091905
STAT,1850,100,na,1950,0.8129162735465878
STAT,1853,23,na,1876,2074.1805594121743
SIM,1897,25,20-24,1922,25
SIM,1883,26,30-34,1909,39
STAT,1872,27,25-29,1899,42.953746278484445
SIM,1842,33,25-29,1875,18
STAT,1854,53,na,1907,1589.9780367452104
SIM,1903,67,na,1970,2457
STAT,1846,75,na,1921,781.2432078122506
STAT,1861,35,35-39,1896,5.992538813293137
SIM,1923,34,30-34,1957,28
SIM,1953,16,20-24,1969,199
STAT,1859,22,30-34,1881,15.0126499810108
STAT,1868,22,na,1890,2282.959833246276
STAT,1939,22,25-29,1961,93.64934925072858
STAT,1925,23,35-39,1948,11.355219354648067
STAT,1908,47,45-49,1955,0.19841388083090605
SIM,1867,43,30-34,1910,1
SIM,1886,44,45-49,1930,1
STAT,1849,44,25-29,1893,0.49529530108174236
STAT,1869,32,35-39,1901,9.944358444327822
SIM,1885,22,25-29,1907,55
STAT,1866,63,na,1929,1668.7394506470068
STAT,1950,14,na,1964,4690.85967975662
STAT,1826,46,na,1872,1419.8362537569446
STAT,1907,41,20-24,1948,0.016431499683565103
SIM,1877,32,35-39,1909,15
STAT,1876,37,50-100,1913,1.2803428759885078
STAT,1850,35,25-29,1885,2.2865488761204626
STAT,1877,81,na,1958,672.1744001256878
SIM,1924,27,50-100,1951,1
SIM,1834,61,na,1895,1320
SIM,1895,66,na,1961,2235
SIM,1838,27,30-34,1865,27
SIM,1947,22,25-29,1969,163
STAT,1923,22,50-100,1945,0.7735600287342911
SIM,1896,29,na,1925,3125
STAT,1937,26,30-34,1963,38.57674326002503
STAT,1864,34,15-19,1898,0.12867733002463572
STAT,1866,34,50-100,1900,0.8495662264904019
STAT,1840,72,na,1912,885.2737398259629
STAT,1916,27,50-100,1943,1.03859266417056
STAT,1935,29,50-100,1964,1.3694573576951419
STAT,1897,18,30-34,1915,2.152538483229312
STAT,1786,83,na,1869,137.4796593372557
SIM,1925,30,25-29,1955,16
SIM,1824,54,na,1878,1333
STAT,1875,26,30-34,1901,26.208740645465525
SIM,1914,41,na,1955,3868
SIM,1835,21,40-44,1856,3
STAT,1834,33,25-29,1867,7.732880957078938
STAT,1863,31,50-100,1894,0.8232895582794042
SIM,1840,20,45-49,1860,5
STAT,1875,22,15-19,1897,3.421805410392491
STAT,1809,49,15-19,1858,0.0013255295620473884
STAT,1807,54,na,1861,1119.0193956041396
SIM,1933,23,35-39,1956,20
STAT,1929,33,20-24,1962,3.129621324637065
STAT,1859,43,30-34,1902,0.9271700022558118
STAT,1889,25,20-24,1914,14.709402266316054
STAT,1817,61,na,1878,1010.1134362133794
STAT,1911,17,20-24,1928,27.370825985903494
STAT,1941,24,30-34,1965,29.966364310587267
STAT,1857,104,na,1961,0.15719987921686643
STAT,1868,19,15-19,1887,5.763786197933079
SIM,1837,34,20-24,1871,1
SIM,1842,25,30-34,1867,30
SIM,1864,38,na,1902,2543
STAT,1811,101,na,1912,0.24875915390319384
STAT,1818,46,na,1864,1463.4006513051968
STAT,1849,46,40-44,1895,0.1342332494220131
SIM,1835,46,na,1881,1421
SIM,1861,25,40-44,1886,4
STAT,1903,31,35-39,1934,14.62643564158612
SIM,1845,43,45-49,1888,3
STAT,1874,27,35-39,1901,9.978821370404356
STAT,1904,20,50-100,1924,0.5945856820498449
SIM,1926,23,35-39,1949,11
STAT,1831,76,na,1907,595.3489368913913
STAT,1896,25,20-24,1921,15.790431541830868
STAT,1853,25,40-44,1878,2.9114546864440998
STAT,1853,45,na,1898,1879.1145586776038
SIM,1948,21,20-24,1969,184
STAT,1882,15,25-29,1897,5.569788358811191
STAT,1907,9,na,1916,3848.43210671243
STAT,1918,23,35-39,1941,10.220839585424352
STAT,1834,25,30-34,1859,19.95121192822219
SIM,1856,34,30-34,1890,22
STAT,1885,15,35-39,1900,0.5542009923055088
STAT,1946,21,na,1967,4105.736002997904
STAT,1866,20,15-19,1886,3.1557001391276436
STAT,1850,34,20-24,1884,2.1206845610351035
STAT,1921,48,50-100,1969,0.25680426224320685
SIM,1837,72,na,1909,756
SIM,1942,25,35-39,1967,21
SIM,1864,17,30-34,1881,3
STAT,1902,39,15-19,1941,0.017124953649326497
SIM,1937,33,20-24,1970,3
STAT,1934,17,50-100,1951,0.512044163885612
SIM,1902,9,na,1911,3942
STAT,1842,53,na,1895,1907.4458247316065
STAT,1847,107,na,1954,0.0035310092050134145
STAT,1848,34,30-34,1882,14.816931733761058
SIM,1829,41,45-49,1870,8
SIM,1890,24,15-19,1914,4
SIM,1833,23,30-34,1856,24
STAT,1767,91,na,1858,13.628782119411829
STAT,1878,66,na,1944,1718.4280081094523
SIM,1839,31,na,1870,1778
SIM,1872,89,na,1961,77
STAT,1846,27,15-19,1873,0.4165275638455095
STAT,1826,42,30-34,1868,1.1994876590630603
STAT,1839,64,na,1903,1232.4489544380858
STAT,1882,24,15-19,1906,3.207386842769915
SIM,1816,46,50-100,1862,2
STAT,1787,68,na,1855,592.491
STAT,1858,47,50-100,1905,0.1937028619671367
SIM,1872,38,30-34,1910,1
STAT,1864,38,30-34,1902,4.833216587988214
SIM,1880,42,50-100,1922,2
STAT,1931,34,15-19,1965,0.1699568725874895
STAT,1852,38,50-100,1890,0.9264919180318544
STAT,1893,33,30-34,1926,22.296575483627706
SIM,1926,44,na,1970,4562
SIM,1907,23,25-29,1930,118
SIM,1876,19,15-19,1895,6
STAT,1878,43,40-44,1921,2.3412284157625125
STAT,1888,73,na,1961,1611.0531852422482
SIM,1897,5,na,1902,3626
STAT,1854,48,15-19,1902,2.9642241980255645E-4
STAT,1931,22,na,1953,4786.739327455263
SIM,1886,43,40-44,1929,4
SIM,1918,32,40-44,1950,7
STAT,1845,25,na,1870,1951.887774824732
STAT,1892,27,na,1919,3024.629885747131
SIM,1868,33,45-49,1901,2
STAT,1796,82,na,1878,162.00244067138692
SIM,1866,39,50-100,1905,1
SIM,1825,31,25-29,1856,9
STAT,1870,44,45-49,1914,1.4643141917049187
SIM,1872,47,na,1919,2444
STAT,1826,40,35-39,1866,1.9660994817985273
STAT,1889,31,15-19,1920,0.1780784695010854
STAT,1898,37,25-29,1935,3.9422220203837113
STAT,1896,17,na,1913,3376.53638256165
SIM,1874,44,25-29,1918,2
STAT,1884,22,25-29,1906,57.01634310326647
SIM,1909,21,35-39,1930,11
STAT,1805,50,45-49,1855,0.062119869356968394
SIM,1832,27,30-34,1859,25
SIM,1832,29,25-29,1861,56
SIM,1898,40,na,1938,3212
STAT,1828,109,na,1937,4.618492014370248E-4
STAT,1876,19,45-49,1895,0.06775579368660206
SIM,1853,19,15-19,1872,5
STAT,1866,44,25-29,1910,0.5924596584655493
STAT,1850,35,30-34,1885,4.232547942861227
STAT,1877,45,40-44,1922,0.18024207027222103
SIM,1826,33,50-100,1859,4
STAT,1887,34,15-19,1921,0.15921056795297941
SIM,1866,36,45-49,1902,4
STAT,1813,45,50-100,1858,0.7415879973591718
STAT,1830,37,50-100,1867,1.1161759469559216
STAT,1871,25,20-24,1896,11.851484778183885
STAT,1833,38,35-39,1871,6.214432141969518
STAT,1850,9,na,1859,2279.6419964594775
SIM,1918,48,50-100,1966,4
STAT,1871,27,15-19,1898,0.4552561119058021
STAT,1845,19,15-19,1864,5.416323886511459
STAT,1859,19,50-100,1878,0.04565436286732722
STAT,1881,63,na,1944,1737.1369801585306
SIM,1858,12,na,1870,2267
SIM,1841,38,35-39,1879,18
STAT,1854,28,25-29,1882,33.04188026187304
SIM,1869,29,20-24,1898,2
SIM,1948,15,35-39,1963,5
STAT,1809,74,na,1883,544.8634978266433
STAT,1820,41,na,1861,1401.7761251776315
STAT,1864,47,25-29,1911,0.052251162239042484
STAT,1854,61,na,1915,1402.3858877060857
STAT,1815,52,25-29,1867,0.007507981537335737
STAT,1820,52,35-39,1872,0.014051925715237331
STAT,1872,27,na,1899,2423.325543736404
STAT,1872,41,45-49,1913,1.5265960681716628
STAT,1822,76,na,1898,529.7157331220668
STAT,1837,43,45-49,1880,1.189482919491454
STAT,1908,17,40-44,1925,0.27388435644775816
STAT,1893,31,35-39,1924,13.040444106637578
STAT,1879,28,30-34,1907,26.448291021065568
SIM,1957,13,na,1970,5431
STAT,1778,110,na,1888,0.002193214259912166
STAT,1910,37,20-24,1947,0.2543610750613705
STAT,1801,104,na,1905,0.026545311617723794
SIM,1841,36,40-44,1877,8
STAT,1816,39,45-49,1855,6.9301685448103765
STAT,1788,87,na,1875,53.44748662517207
STAT,1792,92,na,1884,11.094965649675443
STAT,1905,19,na,1924,3667.8529276108416
SIM,1928,18,15-19,1946,58
SIM,1862,28,25-29,1890,54
SIM,1885,32,35-39,1917,14
SIM,1894,38,45-49,1932,5
STAT,1816,50,20-24,1866,0.0019072396368915413
STAT,1877,58,na,1935,2061.4937296384805
STAT,1841,43,50-100,1884,0.8104895637612334
STAT,1886,38,45-49,1924,2.1152961005121047
SIM,1864,25,25-29,1889,66
STAT,1849,46,45-49,1895,0.18504116175518165
STAT,1841,44,20-24,1885,0.12028730116315739
STAT,1765,90,na,1855,23.4697
STAT,1886,3,na,1889,2973.655919800803
STAT,1915,49,na,1964,3713.5593728199524
SIM,1844,44,40-44,1888,4
STAT,1845,37,15-19,1882,0.04311126871552114
STAT,1856,25,25-29,1881,34.43537743322897
STAT,1873,22,20-24,1895,70.56016196132568
SIM,1816,44,35-39,1860,4
SIM,1892,22,25-29,1914,3
STAT,1948,21,20-24,1969,129.01578167890798
STAT,1888,10,na,1898,3087.957888909336
SIM,1887,28,30-34,1915,27
STAT,1833,36,40-44,1869,3.9268854836007496
STAT,1883,41,20-24,1924,0.15767648326194045
SIM,1857,43,40-44,1900,4
STAT,1891,18,30-34,1909,1.9878770598991526
STAT,1877,32,35-39,1909,10.556689759781957
SIM,1821,43,na,1864,1362
STAT,1845,35,20-24,1880,0.6639766480966025
STAT,1831,40,45-49,1871,1.187629210875736
SIM,1837,18,20-24,1855,21
STAT,1863,15,15-19,1878,6.13211021291605
STAT,1846,66,na,1912,1243.8200222626594
SIM,1823,36,20-24,1859,5
SIM,1880,41,45-49,1921,3
SIM,1874,26,25-29,1900,46
SIM,1859,42,35-39,1901,4
STAT,1882,43,25-29,1925,0.6237144134654995
SIM,1843,33,40-44,1876,4
SIM,1888,39,30-34,1927,6
SIM,1855,55,na,1910,1792
STAT,1906,19,50-100,1925,0.07168561523298532
STAT,1913,14,na,1927,4060.9045205051116
STAT,1890,32,50-100,1922,1.1307943709482517
SIM,1889,38,35-39,1927,16
SIM,1891,23,20-24,1914,92
SIM,1888,42,na,1930,2927
STAT,1882,27,20-24,1909,11.47743682521156
STAT,1821,33,40-44,1854,14.943890166556612
STAT,1847,32,20-24,1879,2.3762931918908383
SIM,1894,23,45-49,1917,1
STAT,1931,35,50-100,1966,0.5629378784593102
SIM,1818,41,35-39,1859,1
STAT,1871,42,40-44,1913,2.2541991200789533
STAT,1850,71,na,1921,1022.0752713275823
SIM,1848,37,35-39,1885,9
STAT,1876,21,50-100,1897,0.42654525111908964
STAT,1814,53,20-24,1867,0.0016657708796237423
SIM,1885,14,na,1899,2794
STAT,1841,42,25-29,1883,0.4990028282493487
STAT,1881,44,20-24,1925,0.1525278713308654
SIM,1939,22,30-34,1961,36
STAT,1843,21,25-29,1864,48.81434205699859
STAT,1850,17,30-34,1867,1.4913678191450954
STAT,1895,29,25-29,1924,55.39525447034326
STAT,1827,39,20-24,1866,0.8558450318516337
STAT,1867,41,35-39,1908,1.730279607577831
STAT,1892,34,25-29,1926,12.870123160205457
SIM,1892,26,45-49,1918,2
STAT,1887,49,15-19,1936,2.491218818686504E-4
SIM,1836,38,25-29,1874,4
STAT,1858,43,na,1901,1818.165785232771
STAT,1920,29,30-34,1949,43.09481905690307
STAT,1835,33,40-44,1868,4.102718355009795
SIM,1838,17,25-29,1855,6
STAT,1857,36,25-29,1893,2.2804341292658385
STAT,1927,42,na,1969,4707.859952720476
STAT,1871,33,na,1904,2384.3775626816855
SIM,1872,29,25-29,1901,45
STAT,1820,50,40-44,1870,0.017883203945769005
STAT,1803,53,45-49,1856,0.06164640963481283
STAT,1825,43,25-29,1868,0.8999286934391102
SIM,1874,42,30-34,1916,3
STAT,1867,26,40-44,1893,2.859224604281648
STAT,1863,33,45-49,1896,1.553943205139417
STAT,1824,31,na,1855,1442.089160224318
STAT,1866,42,30-34,1908,1.0738834224374192
SIM,1831,65,na,1896,1105
SIM,1869,83,na,1952,436
STAT,1935,5,na,1940,5553.444639898272
SIM,1894,50,na,1944,3097
STAT,1828,38,25-29,1866,2.900017400157677
STAT,1841,35,na,1876,1926.685825013107
STAT,1877,34,50-100,1911,0.9469384105847791
STAT,1884,26,45-49,1910,1.1096513687688194
SIM,1926,21,na,1947,4381
STAT,1802,54,40-44,1856,0.029507899252075843
STAT,1851,16,35-39,1867,0.5081355172887856
STAT,1852,48,45-49,1900,0.17673160328706736
STAT,1910,39,15-19,1949,0.018343124717043052
SIM,1842,32,40-44,1874,6
SIM,1861,63,na,1924,1529
STAT,1840,46,25-29,1886,0.04124187893667901
STAT,1856,53,25-29,1909,0.0026987067229920204
STAT,1876,34,40-44,1910,4.483794233118336
SIM,1875,41,35-39,1916,1
SIM,1783,84,na,1867,143
SIM,1916,8,na,1924,4248
STAT,1882,45,20-24,1927,0.011857215714710356
SIM,1810,71,na,1881,804
SIM,1921,34,50-100,1955,1
STAT,1864,17,30-34,1881,1.5027157652052179
STAT,1829,94,na,1923,11.784549157533935
STAT,1906,30,50-100,1936,0.78018084196624
STAT,1949,22,50-100,1971,0.7756778841423082
STAT,1823,46,25-29,1869,0.08041811690307467
STAT,1842,40,20-24,1882,0.1517729242388808
STAT,1819,45,20-24,1864,0.024091358630819446
SIM,1821,44,45-49,1865,4
SIM,1872,17,30-34,1889,2
SIM,1838,35,25-29,1873,2
STAT,1824,100,na,1924,0.5277976992705182
STAT,1834,41,na,1875,1528.0939774017877
STAT,1901,49,na,1950,3119.5238479595114
STAT,1815,54,20-24,1869,0.001502693109295297
SIM,1934,30,30-34,1964,35
STAT,1888,40,50-100,1928,1.2721165240749523
STAT,1856,96,na,1952,6.649046130298707
STAT,1880,48,20-24,1928,0.01256859207310148
STAT,1886,23,45-49,1909,0.7413210615072554
STAT,1886,38,15-19,1924,0.05958581273443782
STAT,1897,26,25-29,1923,57.47517631385176
SIM,1842,35,45-49,1877,5
STAT,1917,22,30-34,1939,30.83342213764734
SIM,1833,26,35-39,1859,14
SIM,1882,36,30-34,1918,8
STAT,1834,35,45-49,1869,1.5077269319668836
SIM,1925,22,30-34,1947,45
SIM,1842,34,35-39,1876,16
SIM,1817,43,40-44,1860,4
STAT,1840,45,15-19,1885,2.90094602784885E-4
STAT,1854,20,50-100,1874,0.36480750928715944
STAT,1870,29,20-24,1899,11.551957109199616
STAT,1804,51,40-44,1855,0.029091389218928614
STAT,1830,44,45-49,1874,1.2641595922113342
STAT,1947,22,15-19,1969,6.076968336833032
SIM,1836,88,na,1924,76
STAT,1819,47,15-19,1866,7.795412494589113E-4
STAT,1862,34,40-44,1896,3.750187306268015
STAT,1851,34,35-39,1885,7.817070096934887
STAT,1899,33,25-29,1932,14.137890285150073
SIM,1864,37,20-24,1901,3
STAT,1865,46,30-34,1911,0.08952784767943645
STAT,1900,48,15-19,1948,3.125881264787863E-4
STAT,1886,36,20-24,1922,0.8259843222467242
SIM,1876,22,40-44,1898,2
STAT,1813,44,45-49,1857,4.692537247328517
STAT,1831,37,15-19,1868,0.04488745759520366
STAT,1855,107,na,1962,0.014998501458551555
STAT,1892,17,35-39,1909,0.6954225483393168
STAT,1848,47,40-44,1895,0.1391260353925442
SIM,1880,22,na,1902,2282
SIM,1882,57,na,1939,1729
STAT,1834,34,35-39,1868,7.5666690025096734
SIM,1827,32,45-49,1859,1
STAT,1899,35,50-100,1934,1.718000474054869
STAT,1825,42,40-44,1867,3.2252164072315566
SIM,1768,87,na,1855,42
SIM,1873,28,30-34,1901,34
SIM,1836,35,20-24,1871,4
STAT,1868,22,40-44,1890,2.0114816520622147
STAT,1902,42,na,1944,3306.057238232775
STAT,1890,37,25-29,1927,3.553392374292078
STAT,1917,25,50-100,1942,1.0607900391697302
STAT,1949,20,25-29,1969,108.96482278412768
STAT,1926,30,30-34,1956,19.275646816009964
STAT,1865,45,20-24,1910,0.011177406414010858
SIM,1892,55,na,1947,2828
SIM,1910,28,50-100,1938,2
STAT,1881,28,15-19,1909,0.4401543044647448
STAT,1878,12,na,1890,2707.644015761819
SIM,1892,38,50-100,1930,1
SIM,1890,43,25-29,1933,1
STAT,1850,19,25-29,1869,5.240024397830866
SIM,1900,16,na,1916,3714
STAT,1819,47,45-49,1866,0.4599297242958108
STAT,1909,16,45-49,1925,0.0990958964346177
STAT,1874,20,15-19,1894,3.4321731535929954
STAT,1871,40,45-49,1911,1.5169183369769195
STAT,1880,35,45-49,1915,2.1345940541526227
STAT,1894,31,50-100,1925,1.1962954201554559
STAT,1880,18,25-29,1898,5.995010161751514
STAT,1833,48,na,1881,1674.9053474208147
STAT,1889,44,20-24,1933,0.19511510387561434
SIM,1816,88,na,1904,54
STAT,1869,38,15-19,1907,0.054867947081389035
STAT,1925,47,na,1972,4499.005425695466
SIM,1834,47,50-100,1881,4
SIM,1833,44,35-39,1877,1
SIM,1851,25,45-49,1876,1
STAT,1838,27,30-34,1865,21.44344284912777
SIM,1816,42,40-44,1858,7
SIM,1894,36,20-24,1930,1
STAT,1892,35,35-39,1927,9.049206360735154
STAT,1824,45,30-34,1869,0.11643569140868147
SIM,1831,28,25-29,1859,52
STAT,1875,35,35-39,1910,7.405830207461006
SIM,1902,39,30-34,1941,5
SIM,1785,79,na,1864,236
SIM,1902,22,35-39,1924,11
STAT,1881,46,15-19,1927,3.905315074003869E-4
STAT,1800,106,na,1906,0.004259131918682931
STAT,1861,53,35-39,1914,0.007109400462484231
STAT,1895,55,na,1950,2727.2384624103497
SIM,1898,36,50-100,1934,1
STAT,1802,56,na,1858,1056.8691953762884
STAT,1839,51,50-100,1890,0.01075867070029195
STAT,1875,33,40-44,1908,4.479136127893222
STAT,1851,33,na,1884,1861.217007792229
STAT,1828,37,15-19,1865,0.057858208283232564
STAT,1865,43,25-29,1908,0.5879550185572874
STAT,1891,36,30-34,1927,6.696597485282774
SIM,1862,57,na,1919,1816
SIM,1883,35,35-39,1918,7
STAT,1865,15,50-100,1880,0.05177327351125716
STAT,1929,29,na,1958,4734.089364518008
STAT,1928,31,50-100,1959,1.0455489556545619
STAT,1963,9,na,1972,5041.336167801578
SIM,1926,38,50-100,1964,1
STAT,1895,28,15-19,1923,0.5963106049735969
STAT,1860,111,na,1971,0.0012488470506538342
SIM,1861,29,20-24,1890,12
SIM,1863,41,45-49,1904,1
SIM,1883,33,40-44,1916,8
STAT,1890,19,25-29,1909,6.956148741963127
STAT,1918,20,25-29,1938,101.17652938246664
STAT,1861,51,40-44,1912,0.008877922117723104
STAT,1798,77,na,1875,407.69481249039364
SIM,1882,18,30-34,1900,4
STAT,1809,66,na,1875,924.0950314225498
STAT,1871,73,na,1944,1191.8197709576764
SIM,1916,26,50-100,1942,1
STAT,1848,30,15-19,1878,0.13843676837767438
STAT,1830,24,20-24,1854,145.15028779911825
STAT,1933,34,na,1967,5143.7560083331
STAT,1861,26,45-49,1887,0.9454135324791315
STAT,1853,29,20-24,1882,10.081070373688943
STAT,1847,20,na,1867,1991.0302713209749
STAT,1865,30,15-19,1895,0.13239203212995732
SIM,1920,36,na,1956,4445
SIM,1880,23,15-19,1903,8
STAT,1805,84,na,1889,134.4678117652384
STAT,1869,36,20-24,1905,0.7605848104325231
STAT,1874,36,30-34,1910,5.538322438190105
SIM,1926,20,25-29,1946,125
SIM,1846,27,30-34,1873,36
SIM,1851,65,na,1916,1463
STAT,1952,20,30-34,1972,34.93804236390741
STAT,1848,43,20-24,1891,0.12872757594955192
STAT,1873,40,50-100,1913,1.0926260536896573
SIM,1932,29,50-100,1961,1
STAT,1830,26,45-49,1856,1.2937650044962858
SIM,1837,50,na,1887,1407
STAT,1841,29,25-29,1870,38.728292677737464
SIM,1863,98,na,1961,21
SIM,1779,79,na,1858,236
STAT,1855,54,20-24,1909,5.40172868257835E-4
SIM,1867,34,40-44,1901,6
STAT,1824,51,50-100,1875,0.01737749268520168
STAT,1872,38,15-19,1910,0.0567376931439209
SIM,1879,36,25-29,1915,4
STAT,1889,48,40-44,1937,0.11875784944552191
SIM,1877,36,20-24,1913,5
SIM,1837,19,30-34,1856,2
STAT,1938,26,na,1964,3748.402209060734
STAT,1825,44,35-39,1869,2.4806738314094607
STAT,1876,96,na,1972,53.891035249732965
STAT,1860,25,45-49,1885,0.9399673221390124
STAT,1848,49,35-39,1897,0.11191759872509854
STAT,1873,68,na,1941,1564.7360919460773
SIM,1933,17,40-44,1950,3
STAT,1856,22,20-24,1878,61.97512482322494
STAT,1893,30,25-29,1923,13.241125972216187
STAT,1912,40,na,1952,3654.796080724123
STAT,1862,52,40-44,1914,0.009133546848899395
STAT,1885,25,na,1910,2415.539224679634
SIM,1810,63,na,1873,1040
STAT,1957,15,35-39,1972,5.591537105054837
STAT,1889,83,na,1972,959.1402725394788
STAT,1851,15,25-29,1866,5.27880128892859
SIM,1862,25,20-24,1887,13
STAT,1858,32,25-29,1890,8.116102243867518
STAT,1883,42,30-34,1925,1.1349001548840119
STAT,1898,34,20-24,1932,3.669364805359504
SIM,1814,53,na,1867,1249
STAT,1871,28,25-29,1899,42.29685888047045
STAT,1847,17,25-29,1864,5.295543888968131
SIM,1859,40,40-44,1899,6
STAT,1907,20,20-24,1927,102.82279178875014
SIM,1843,98,na,1941,11
STAT,1901,57,na,1958,2910.6053574558264
STAT,1859,19,45-49,1878,0.06087248382310297
SIM,1850,91,na,1941,42
STAT,1812,86,na,1898,100.73424002699194
STAT,1820,53,45-49,1873,0.023219504356413068
SIM,1823,52,50-100,1875,1
STAT,1876,16,40-44,1892,0.19120762216330037
SIM,1891,42,30-34,1933,4
SIM,1889,37,25-29,1926,2
STAT,1844,54,45-49,1898,0.011166245455568961
STAT,1850,36,40-44,1886,3.440534527655674
STAT,1861,35,na,1896,1996.103687802058
STAT,1789,80,na,1869,311.0433791726459
STAT,1872,40,35-39,1912,1.8572916656063627
STAT,1841,27,30-34,1868,23.389495396075002
SIM,1816,96,na,1912,6
STAT,1853,107,na,1960,0.01146173714481858
SIM,1861,44,45-49,1905,1
STAT,1855,30,50-100,1885,0.7169696859152176
STAT,1914,2,na,1916,4254.53577076904
SIM,1863,27,30-34,1890,20
STAT,1833,39,45-49,1872,1.7334302192169726
STAT,1816,51,30-34,1867,0.015081312403136874
STAT,1860,22,40-44,1882,1.7735360127357562
SIM,1854,33,45-49,1887,1
SIM,1943,20,25-29,1963,2
SIM,1866,32,25-29,1898,12
SIM,1833,29,45-49,1862,3
SIM,1840,61,na,1901,1322
STAT,1799,79,na,1878,289.74226592156253
STAT,1875,36,45-49,1911,2.077631123251912
SIM,1929,17,20-24,1946,162
STAT,1849,86,na,1935,173.47453633130843
SIM,1880,40,35-39,1920,5
STAT,1825,110,na,1935,2.0166018213141527E-4
STAT,1909,15,35-39,1924,0.8342242932349978
SIM,1835,41,35-39,1876,4
STAT,1861,63,na,1924,1497.531077976852
STAT,1874,19,40-44,1893,0.18814203206218155
STAT,1822,47,20-24,1869,0.017792119191557817
STAT,1835,36,45-49,1871,1.8697920572168238
SIM,1915,20,20-24,1935,121
SIM,1841,35,30-34,1876,3
SIM,1890,15,25-29,1905,10
STAT,1848,46,25-29,1894,0.04716152743211317
SIM,1829,63,na,1892,1183
SIM,1883,36,45-49,1919,5
STAT,1833,35,30-34,1868,4.830857223453317
STAT,1823,49,30-34,1872,0.129493929361544
STAT,1832,86,na,1918,151.08085966496725
SIM,1893,48,50-100,1941,2
STAT,1782,90,na,1872,30.26559495406442
STAT,1844,39,20-24,1883,0.6312329799420233
STAT,1855,27,30-34,1882,19.757364592756918
STAT,1901,49,15-19,1950,3.12794162446237E-4
STAT,1846,51,45-49,1897,0.011065945856423147
STAT,1854,25,20-24,1879,10.289839465315204
SIM,1845,45,na,1890,1890
STAT,1867,29,45-49,1896,1.0485962081100948
SIM,1898,44,40-44,1942,1
STAT,1873,29,50-100,1902,0.6503058423647123
STAT,1839,33,na,1872,1871.3365197934559
STAT,1853,48,na,1901,1837.187448533111
STAT,1885,48,50-100,1933,0.2438085002868535
STAT,1938,32,15-19,1970,0.13044374108388485
SIM,1819,53,na,1872,1250
STAT,1893,49,45-49,1942,0.16715872325914785
STAT,1935,20,25-29,1955,127.17170229864745
STAT,1862,35,20-24,1897,0.6787354400100278
STAT,1857,52,30-34,1909,0.004667085124841842
STAT,1872,30,50-100,1902,0.9378533571646169
STAT,1845,22,45-49,1867,0.6325401015900488
SIM,1872,41,50-100,1913,1
SIM,1883,32,30-34,1915,31
SIM,1870,34,40-44,1904,6
STAT,1815,39,25-29,1854,8.649141968017066
SIM,1908,36,na,1944,3429
STAT,1842,22,20-24,1864,78.25615691278075
SIM,1843,36,45-49,1879,4
STAT,1826,109,na,1935,3.9039247397898604E-4
STAT,1948,22,30-34,1970,33.33658586154407
STAT,1882,25,na,1907,2350.6895877885613
SIM,1816,41,30-34,1857,1
SIM,1855,17,25-29,1872,7
STAT,1895,26,20-24,1921,15.52645506084837
SIM,1850,22,20-24,1872,78
STAT,1838,24,20-24,1862,58.99496266638273
STAT,1861,50,30-34,1911,0.005067648994375237
SIM,1874,50,na,1924,2084
SIM,1834,21,25-29,1855,64
STAT,1795,89,na,1884,44.23930495160592
STAT,1868,53,na,1921,2045.0616475574693
STAT,1818,49,20-24,1867,0.02073906863361567
SIM,1846,39,25-29,1885,2
STAT,1846,33,45-49,1879,1.5477269488447405
SIM,1841,17,30-34,1858,4
SIM,1833,25,25-29,1858,4
STAT,1865,25,na,1890,2215.9175904423682
STAT,1812,43,45-49,1855,3.7610262704109614
SIM,1823,39,25-29,1862,2
SIM,1856,29,40-44,1885,2
STAT,1828,35,20-24,1863,0.8297028097882017
STAT,1872,23,15-19,1895,3.3395467192313335
STAT,1897,39,30-34,1936,1.5419545756355733
STAT,1925,17,40-44,1942,1.7075774750546913
STAT,1868,42,35-39,1910,1.745809986854866
STAT,1883,27,40-44,1910,2.9607294887936715
STAT,1847,35,25-29,1882,2.283634717035911
STAT,1851,28,50-100,1879,0.563054799485206
STAT,1881,47,25-29,1928,0.05581593426230294
SIM,1909,29,na,1938,3786
STAT,1821,51,40-44,1872,0.015139721083744472
STAT,1866,66,na,1932,1532.8556735430734
STAT,1891,37,40-44,1928,5.4739717963307
STAT,1832,52,25-29,1884,0.002516204630539001
STAT,1849,94,na,1943,15.626172703172017
STAT,1864,32,20-24,1896,2.463533072508131
SIM,1916,31,na,1947,3874
STAT,1848,29,40-44,1877,2.877990072008655
SIM,1864,22,20-24,1886,77
STAT,1836,76,na,1912,597.3607297676081
STAT,1889,47,30-34,1936,0.06768555324385121
STAT,1894,30,na,1924,3127.9470501465107
STAT,1914,48,45-49,1962,0.21687137011238794
STAT,1824,42,25-29,1866,0.7979446837507448
SIM,1890,0,na,1890,3666
STAT,1873,37,25-29,1910,2.9480375422525342
SIM,1914,44,na,1958,3855
STAT,1861,43,na,1904,1925.7650574520378
SIM,1930,5,na,1935,5588
SIM,1824,36,40-44,1860,4
SIM,1881,37,25-29,1918,5
STAT,1889,15,na,1904,3159.989081379832
STAT,1891,33,25-29,1924,12.754102920537221
SIM,1878,19,20-24,1897,24
SIM,1833,68,na,1901,1054
STAT,1856,37,20-24,1893,0.596903951688361
SIM,1876,42,35-39,1918,5
SIM,1880,30,50-100,1910,1
STAT,1834,32,40-44,1866,3.308276501322905
STAT,1807,49,45-49,1856,0.8148590784076505
STAT,1824,46,40-44,1870,0.20310385518021043
SIM,1882,39,35-39,1921,13
SIM,1865,22,na,1887,2207
SIM,1898,32,na,1930,3229
STAT,1858,36,40-44,1894,3.485369414781176
SIM,1865,37,40-44,1902,5
STAT,1874,53,na,1927,2191.030217643943
STAT,1909,33,35-39,1942,8.762696442793978
STAT,1917,25,35-39,1942,16.000639311691188
STAT,1885,45,na,1930,2284.399477969493
SIM,1769,92,na,1861,16
SIM,1854,30,na,1884,2283
STAT,1902,45,15-19,1947,3.2524771406524197E-4
STAT,1840,43,20-24,1883,0.11465089728126229
SIM,1945,21,45-49,1966,1
STAT,1866,27,35-39,1893,9.023992165254734
STAT,1910,19,20-24,1929,26.9578024828648
STAT,1883,23,20-24,1906,67.9006701329434
STAT,1859,84,na,1943,270.2341458013353
SIM,1869,44,45-49,1913,2
STAT,1876,37,45-49,1913,2.0788935418158205
SIM,1838,32,20-24,1870,2
SIM,1857,50,na,1907,1884
SIM,1861,31,35-39,1892,15
SIM,1908,22,30-34,1930,27
STAT,1853,32,45-49,1885,1.485064347288946
STAT,1845,37,45-49,1882,1.5304498573930843
STAT,1912,29,na,1941,3697.9006696557612
STAT,1863,48,20-24,1911,0.010603745759332676
STAT,1881,17,30-34,1898,1.551736234341541
STAT,1833,35,25-29,1868,2.60977342822925
SIM,1849,83,na,1932,296
SIM,1896,6,na,1902,3487
STAT,1841,43,na,1884,1773.1386804812
SIM,1897,29,30-34,1926,54
STAT,1880,32,40-44,1912,4.600000714140786
STAT,1883,25,50-100,1908,0.6365430357072989
SIM,1850,71,na,1921,1017
STAT,1809,46,45-49,1855,0.8816839249489393
SIM,1813,68,na,1881,819
SIM,1939,25,35-39,1964,22
SIM,1821,35,na,1856,1505
STAT,1868,25,45-49,1893,1.0790366787394
SIM,1953,9,na,1962,4918
SIM,1875,26,45-49,1901,2
SIM,1907,62,na,1969,3140
SIM,1925,25,35-39,1950,23
SIM,1935,32,40-44,1967,8
STAT,1937,21,45-49,1958,1.1065198695599008
STAT,1869,39,25-29,1908,2.798797076891449
SIM,1859,5,na,1864,2748
STAT,1816,99,na,1915,0.9682831470976861
STAT,1889,29,30-34,1918,31.13724597966333
STAT,1845,50,45-49,1895,0.010756402610746958
SIM,1922,31,na,1953,4820
SIM,1824,32,20-24,1856,2
STAT,1880,50,35-39,1930,0.009262946100054568
STAT,1821,110,na,1931,1.655242836378609E-4
STAT,1900,32,35-39,1932,14.208386569802684
STAT,1897,38,20-24,1935,1.0385975973750028
SIM,1891,25,50-100,1916,1
STAT,1838,42,20-24,1880,0.12433120169041843
STAT,1850,32,25-29,1882,8.20446327869155
STAT,1887,16,15-19,1903,6.7085079768588916
STAT,1856,50,20-24,1906,5.796164472881916E-4
STAT,1892,16,25-29,1908,7.199532553206115
SIM,1909,42,40-44,1951,3
STAT,1916,15,50-100,1931,0.08059019570784341
SIM,1846,24,20-24,1870,66
STAT,1840,33,50-100,1873,0.7742076666246981
STAT,1861,54,45-49,1915,0.011845039125521982
STAT,1853,31,35-39,1884,8.714376244766424
STAT,1884,43,30-34,1927,1.1367921293175252
SIM,1832,27,na,1859,1794
STAT,1897,23,20-24,1920,93.02323610619443
STAT,1818,71,na,1889,715.3402404668977
STAT,1889,47,50-100,1936,0.1717311139849897
STAT,1875,32,30-34,1907,18.10952419312118
STAT,1836,44,40-44,1880,1.6453070431435883
STAT,1851,19,45-49,1870,0.05942969657625828
SIM,1895,16,15-19,1911,8
SIM,1858,26,40-44,1884,5
STAT,1834,36,50-100,1870,0.9189819527805102
STAT,1782,104,na,1886,0.034506126046972445
STAT,1864,29,25-29,1893,38.27742715170163
SIM,1917,15,35-39,1932,1
STAT,1817,52,30-34,1869,0.012256562420365087
STAT,1927,32,40-44,1959,4.865583503060403
SIM,1882,20,15-19,1902,4
SIM,1877,39,25-29,1916,2
STAT,1817,39,50-100,1856,3.5844087048565525
STAT,1837,18,50-100,1855,0.05353543026381633
STAT,1846,15,15-19,1861,5.724721110147922
STAT,1925,39,na,1964,4553.686735544238
SIM,1871,22,na,1893,2233
SIM,1895,34,45-49,1929,2
SIM,1850,41,30-34,1891,1
SIM,1848,36,25-29,1884,5
SIM,1867,88,na,1955,96
SIM,1841,39,45-49,1880,1
SIM,1825,39,50-100,1864,2
STAT,1839,53,25-29,1892,0.0024708711793717283
STAT,1846,48,15-19,1894,2.997395350108301E-4
STAT,1849,43,40-44,1892,1.7458990700169914
STAT,1865,47,40-44,1912,0.15715413513906723
SIM,1932,6,na,1938,6042
SIM,1949,18,na,1967,4095
STAT,1912,16,50-100,1928,0.07662139782814663
SIM,1887,25,20-24,1912,2
STAT,1807,48,35-39,1855,0.4936451803122841
STAT,1834,31,30-34,1865,13.458226195579668
STAT,1935,23,35-39,1958,12.950359338315844
STAT,1772,92,na,1864,7.793150093638275
SIM,1809,86,na,1895,37
STAT,1852,100,na,1952,0.8051430479875792
STAT,1894,32,35-39,1926,13.168582100915975
SIM,1815,94,na,1909,8
STAT,1889,47,25-29,1936,0.040275700715607814
SIM,1919,31,45-49,1950,1
STAT,1848,46,30-34,1894,0.07925756769839651
STAT,1899,5,na,1904,3632.6029498295743
STAT,1882,40,20-24,1922,0.15694212647782665
SIM,1892,47,na,1939,3065
STAT,1851,33,25-29,1884,7.988778063014251
STAT,1920,16,na,1936,4180.448570116919
STAT,1943,15,35-39,1958,4.495338411498578
STAT,1795,80,na,1875,297.04512656472866
STAT,1863,18,20-24,1881,16.37719727172657
SIM,1864,83,na,1947,395
STAT,1843,42,30-34,1885,0.7983765740084974
STAT,1811,47,45-49,1858,0.5878655915849533
SIM,1879,33,20-24,1912,2
STAT,1880,15,20-24,1895,18.892209387189958
STAT,1825,29,45-49,1854,4.516718166229116
STAT,1857,51,20-24,1908,5.844437976916843E-4
SIM,1928,16,20-24,1944,254
SIM,1854,15,15-19,1869,7
STAT,1827,41,35-39,1868,1.9816843038734022
STAT,1852,30,35-39,1882,8.118888235376955
SIM,1856,28,30-34,1884,35
STAT,1842,41,30-34,1883,1.0847174748795632
STAT,1854,43,15-19,1897,0.010289223669296192
STAT,1874,39,35-39,1913,7.241122146894773
SIM,1834,23,50-100,1857,1
STAT,1875,50,25-29,1925,0.0037266322964460987
STAT,1871,27,45-49,1898,1.114105031509144
STAT,1841,26,20-24,1867,10.975228895316523
STAT,1920,29,50-100,1949,1.0947318519303713
SIM,1891,62,na,1953,2181
SIM,1899,27,40-44,1926,7
STAT,1923,21,15-19,1944,6.276993662933805
SIM,1802,76,na,1878,361
SIM,1878,40,na,1918,2696
STAT,1873,25,25-29,1898,43.60667808461365
SIM,1875,75,na,1950,962
STAT,1837,61,na,1898,1274.745026154233
SIM,1860,30,35-39,1890,14
SIM,1933,23,na,1956,4541
STAT,1856,38,30-34,1894,4.106468999610618
SIM,1909,24,40-44,1933,3
STAT,1861,23,40-44,1884,1.7838119552537952
STAT,1899,37,40-44,1936,1.309699379005695
SIM,1885,30,40-44,1915,6
STAT,1819,56,na,1875,1172.4443130326513
STAT,1877,30,40-44,1907,4.5570323899248155
SIM,1880,90,na,1970,258
STAT,1887,34,45-49,1921,1.9495783766922516
SIM,1809,55,na,1864,1096
STAT,1830,51,na,1881,1503.7016092204803
STAT,1846,33,15-19,1879,0.12639373184871985
SIM,1804,63,na,1867,1037
STAT,1867,40,25-29,1907,0.6169973829417064
SIM,1878,12,na,1890,3053
SIM,1873,88,na,1961,215
STAT,1937,18,15-19,1955,44.45505862602492
STAT,1879,25,20-24,1904,12.448835449665431
SIM,1842,31,30-34,1873,20
STAT,1914,47,35-39,1961,0.1290111588948706
SIM,1943,23,35-39,1966,12
STAT,1848,28,30-34,1876,24.36849322955069
STAT,1858,53,30-34,1911,0.004640988348551493
SIM,1920,21,40-44,1941,6
STAT,1869,18,20-24,1887,17.545791966709313
SIM,1803,61,na,1864,900
SIM,1929,18,30-34,1947,27
STAT,1785,99,na,1884,0.360320594263123
STAT,1832,24,25-29,1856,54.31093539602127
SIM,1895,75,na,1970,1831
SIM,1861,43,35-39,1904,4
STAT,1863,36,20-24,1899,0.6931449457491634
STAT,1876,30,25-29,1906,10.767286467661492
SIM,1889,2,na,1891,3308
STAT,1818,51,35-39,1869,0.015020636039734058
STAT,1945,16,na,1961,4061.710475801193
STAT,1837,28,20-24,1865,10.19856712599343
STAT,1820,37,45-49,1857,4.8852912244983795
STAT,1922,25,15-19,1947,0.812476348718544
STAT,1846,37,30-34,1883,4.223631731553336
STAT,1869,53,40-44,1922,0.010171731701477836
STAT,1888,48,25-29,1936,0.03824645183796461
STAT,1954,18,15-19,1972,56.66407138755517
SIM,1860,70,na,1930,1148
SIM,1861,41,40-44,1902,5
STAT,1856,40,15-19,1896,0.010801492064404034
SIM,1921,46,na,1967,4068
STAT,1843,24,35-39,1867,4.869601047081234
SIM,1809,63,na,1872,858
SIM,1929,7,na,1936,4993
SIM,1939,21,15-19,1960,4
STAT,1820,51,50-100,1871,0.025147976539114828
STAT,1860,21,30-34,1881,15.269724739237821
STAT,1841,66,na,1907,1225.6756230535188
SIM,1837,33,45-49,1870,5
SIM,1884,30,25-29,1914,10
STAT,1912,21,40-44,1933,3.2608267365782995
SIM,1951,8,na,1959,4990
STAT,1849,33,50-100,1882,0.7470765588641222
SIM,1828,29,30-34,1857,21
STAT,1877,48,15-19,1925,4.117297469099598E-4
STAT,1848,13,na,1861,2405.2040139577452
STAT,1896,24,45-49,1920,0.9264278603006434
SIM,1868,73,na,1941,964
STAT,1885,42,35-39,1927,1.818238097973589
SIM,1854,19,30-34,1873,1
STAT,1869,83,na,1952,389.824750101684
SIM,1796,74,na,1870,474
SIM,1896,36,25-29,1932,3
STAT,1891,30,20-24,1921,3.4072858601675344
SIM,1872,31,45-49,1903,3
STAT,1854,33,na,1887,1815.0389124929054
STAT,1936,20,50-100,1956,0.6355339287246569
SIM,1870,91,na,1961,95
STAT,1871,24,40-44,1895,2.077854559610562
STAT,1864,17,25-29,1881,5.342647231080236
SIM,1876,17,na,1893,2905
STAT,1872,58,na,1930,2008.0937876618575
SIM,1917,16,na,1933,4082
STAT,1953,11,na,1964,4801.697377146164
SIM,1872,17,25-29,1889,9
STAT,1833,51,30-34,1884,0.00444340352446182
SIM,1833,26,40-44,1859,2
STAT,1784,104,na,1888,0.029026867633699188
SIM,1887,57,na,1944,2119
STAT,1893,16,45-49,1909,0.08397803595192656
SIM,1889,34,20-24,1923,4
STAT,1883,10,na,1893,2560.2039682353125
STAT,1908,48,20-24,1956,0.010060794800904709
SIM,1930,39,40-44,1969,3
STAT,1821,34,20-24,1855,6.8183882836315775
SIM,1930,25,15-19,1955,3
STAT,1844,51,40-44,1895,0.008369162520394147
SIM,1858,43,na,1901,1879
STAT,1838,27,50-100,1865,0.5447248744911117
STAT,1875,17,35-39,1892,0.5691307182238274
SIM,1902,62,na,1964,2947
SIM,1837,19,na,1856,1905
STAT,1851,30,20-24,1881,2.1749747881216015
SIM,1889,35,na,1924,2878
STAT,1869,94,na,1963,51.897004052177245
STAT,1855,7,na,1862,2215.947316453702
STAT,1893,19,45-49,1912,0.08332303614716027
STAT,1922,39,40-44,1961,1.717143233042395
SIM,1837,81,na,1918,261
STAT,1872,27,30-34,1899,25.57022696037771
STAT,1838,91,na,1929,38.791802860657576
SIM,1857,42,30-34,1899,4
STAT,1869,51,45-49,1920,0.014318771821763242
SIM,1880,38,20-24,1918,1
STAT,1837,53,50-100,1890,0.010137958400137998
STAT,1894,50,na,1944,2840.1528152495116
SIM,1932,20,20-24,1952,231
STAT,1837,46,20-24,1883,0.008607720292552933
STAT,1825,45,45-49,1870,0.3257982773581137
STAT,1895,44,15-19,1939,0.0012477900402958703
STAT,1876,49,45-49,1925,0.24097232584591688
SIM,1820,40,40-44,1860,6
SIM,1925,25,50-100,1950,1
STAT,1813,41,40-44,1854,8.672631159275658
STAT,1821,54,45-49,1875,0.019660068265454064
STAT,1879,39,15-19,1918,0.058591208359126686
STAT,1913,20,45-49,1933,1.1066386152941041
STAT,1849,42,30-34,1891,0.8977647767957897
SIM,1956,11,na,1967,5292
STAT,1867,22,25-29,1889,54.677605385833445
STAT,1899,36,35-39,1935,9.85133111374332
STAT,1841,48,35-39,1889,0.10382985871047157
STAT,1826,28,45-49,1854,2.7469621211653976
SIM,1834,30,na,1864,2010
SIM,1851,24,35-39,1875,11
SIM,1834,28,45-49,1862,1
STAT,1831,101,na,1932,0.3585801544864531
STAT,1923,38,45-49,1961,0.7972985552081246
STAT,1935,35,50-100,1970,0.594185286473503
STAT,1956,8,na,1964,5253.54249377133
SIM,1894,5,na,1899,3761
SIM,1898,25,30-34,1923,70
SIM,1770,89,na,1859,18
SIM,1834,25,45-49,1859,1
SIM,1874,27,40-44,1901,2
SIM,1923,24,na,1947,4572
STAT,1857,19,40-44,1876,0.1674618731471865
STAT,1872,38,20-24,1910,0.7788536897108341
SIM,1875,22,25-29,1897,61
STAT,1866,28,50-100,1894,0.5961552786674919
SIM,1881,19,25-29,1900,13
STAT,1872,5,na,1877,2815.0830617588977
SIM,1877,47,na,1924,2336
STAT,1821,36,15-19,1857,0.11684078554116155
STAT,1799,70,na,1869,679.9652250278683
STAT,1838,27,25-29,1865,36.02143246150562
STAT,1890,18,15-19,1908,7.305000723641745
SIM,1863,23,45-49,1886,4
STAT,1845,34,40-44,1879,3.6902526822785218
SIM,1856,65,na,1921,1419
SIM,1877,18,20-24,1895,24
STAT,1840,49,30-34,1889,0.06669590076071455
STAT,1894,61,na,1955,2429.852922907933
SIM,1870,37,45-49,1907,6
SIM,1847,29,na,1876,2015
STAT,1909,30,30-34,1939,15.293430091770215
STAT,1837,25,20-24,1862,10.421436985860288
SIM,1823,78,na,1901,501
STAT,1880,30,45-49,1910,1.86455857972321
STAT,1948,4,na,1952,4588.242732645167
STAT,1934,38,20-24,1972,0.3671955379084736
STAT,1855,41,45-49,1896,1.1316496396033535
STAT,1892,36,45-49,1928,2.5386637620791705
STAT,1912,48,40-44,1960,0.1524440501331557
SIM,1821,41,40-44,1862,2
SIM,1921,20,45-49,1941,1
STAT,1847,47,25-29,1894,0.04292619097858153
SIM,1790,86,na,1876,76
SIM,1929,36,30-34,1965,3
SIM,1881,32,na,1913,2143
STAT,1821,66,na,1887,983.0870922119741
STAT,1775,89,na,1864,26.008973967947785
STAT,1897,41,15-19,1938,0.0013043947260067818
STAT,1775,111,na,1886,9.108609455822402E-4
STAT,1924,20,20-24,1944,133.37803082961602
STAT,1846,46,50-100,1892,0.1869113004646727
SIM,1833,22,20-24,1855,54
SIM,1845,25,20-24,1870,23
SIM,1850,60,na,1910,1554
STAT,1914,24,na,1938,3740.6772123682704
STAT,1857,37,40-44,1894,3.4505417709439064
STAT,1874,52,30-34,1926,0.006123292840119217
SIM,1885,42,na,1927,2471
SIM,1845,28,20-24,1873,18
STAT,1826,46,45-49,1872,0.23574107240691344
STAT,1884,20,na,1904,2369.631304158475
STAT,1830,82,na,1912,307.82300847649446
STAT,1836,47,15-19,1883,2.6407661084365693E-4
STAT,1855,23,45-49,1878,0.6087972165408349
STAT,1887,49,20-24,1936,0.007473663030142376
SIM,1878,38,30-34,1916,12
STAT,1793,85,na,1878,86.67493970543546
STAT,1939,31,20-24,1970,2.51390361617039
SIM,1855,35,25-29,1890,2
STAT,1932,15,30-34,1947,16.386316916163562
SIM,1834,43,40-44,1877,5
SIM,1862,17,na,1879,2385
SIM,1862,40,45-49,1902,2
SIM,1881,25,25-29,1906,52
SIM,1883,87,na,1970,536
SIM,1896,18,25-29,1914,9
STAT,1898,38,40-44,1936,1.2872740698594352
SIM,1780,79,na,1859,286
SIM,1846,27,25-29,1873,43
SIM,1857,24,30-34,1881,18
STAT,1893,34,40-44,1927,5.513969044339067
STAT,1907,42,na,1949,3435.69919222225
SIM,1895,38,30-34,1933,2
STAT,1812,42,35-39,1854,5.958301912657869
STAT,1851,35,45-49,1886,1.557622456801293
STAT,1926,46,15-19,1972,4.6051441529967836E-4
SIM,1803,78,na,1881,269
SIM,1925,39,na,1964,4528
SIM,1861,32,na,1893,2061
STAT,1836,45,20-24,1881,0.008127925113589597
STAT,1858,39,45-49,1897,1.563714025634177
STAT,1888,18,25-29,1906,6.737674101830071
STAT,1878,43,na,1921,2405.7254818815777
STAT,1826,43,40-44,1869,2.3002711373535205
SIM,1914,30,50-100,1944,6
STAT,1827,51,na,1878,1418.1058903342648
SIM,1864,80,na,1944,694
STAT,1873,37,20-24,1910,0.7892795523417971
SIM,1875,26,40-44,1901,1
SIM,1878,16,15-19,1894,5
SIM,1893,32,50-100,1925,1
STAT,1851,16,40-44,1867,0.16937851556974257
STAT,1835,48,45-49,1883,0.1844017046376916
SIM,1849,36,45-49,1885,5
SIM,1884,80,na,1964,779
STAT,1840,16,30-34,1856,1.4551478276020786
SIM,1940,15,30-34,1955,21
STAT,1904,14,na,1918,3731.0193276865825
SIM,1863,10,na,1873,2614
SIM,1890,27,25-29,1917,4
STAT,1884,38,50-100,1922,1.2167604417756024
SIM,1886,26,20-24,1912,16
STAT,1841,46,40-44,1887,0.13026450872384615
SIM,1948,23,50-100,1971,4
SIM,1886,29,20-24,1915,20
SIM,1849,39,45-49,1888,2
SIM,1874,73,na,1947,1160
STAT,1764,97,na,1861,0.48333163145671276
STAT,1821,36,45-49,1857,4.147847393430741
STAT,1936,22,35-39,1958,9.088215338301575
SIM,1829,39,25-29,1868,7
SIM,1892,24,na,1916,3222
STAT,1825,73,na,1898,866.7730897898088
STAT,1859,52,35-39,1911,0.006956215354566115
STAT,1911,39,30-34,1950,1.7581227687013048
SIM,1905,46,50-100,1951,1
STAT,1880,51,45-49,1931,0.015467121815726957
SIM,1944,22,35-39,1966,11
STAT,1878,29,20-24,1907,12.211986432651987
SIM,1872,24,na,1896,2532
SIM,1829,27,25-29,1856,46
STAT,1860,51,25-29,1911,0.0029383719531266583
STAT,1890,36,15-19,1926,0.06963732326719713
STAT,1857,33,20-24,1890,2.121679297827127
STAT,1858,51,35-39,1909,0.0068543422492856575
STAT,1887,38,30-34,1925,5.980067801111832
STAT,1849,24,30-34,1873,16.596738958350812
STAT,1945,7,na,1952,4359.811474508979
STAT,1823,45,15-19,1868,5.664728619722857E-4
STAT,1836,96,na,1932,5.4140935419936405
STAT,1872,23,45-49,1895,0.7058869381606192
SIM,1859,43,45-49,1902,3
SIM,1865,33,20-24,1898,2
STAT,1878,26,20-24,1904,12.342106095412419
STAT,1928,9,na,1937,5069.996000690205
SIM,1889,27,na,1916,3046
STAT,1888,36,25-29,1924,3.4488445548126694
SIM,1947,15,15-19,1962,58
STAT,1826,47,50-100,1873,0.24201454652966575
STAT,1907,65,na,1972,2880.885427397772
SIM,1943,20,30-34,1963,2
STAT,1846,19,30-34,1865,1.501609472321502
STAT,1882,27,25-29,1909,41.38549216886419
SIM,1792,81,na,1873,109
SIM,1841,19,25-29,1860,9
STAT,1840,41,na,1881,1711.8450074888567
STAT,1870,31,35-39,1901,10.084950747397496
STAT,1832,39,25-29,1871,2.4321882645411406
STAT,1831,37,20-24,1868,0.6161822949177975
STAT,1873,4,na,1877,2999.056437652046
STAT,1910,17,na,1927,3861.114215760042
STAT,1892,17,40-44,1909,0.23180752953448508
STAT,1813,42,15-19,1855,0.050202151209532885
STAT,1879,28,25-29,1907,44.42874847293057
STAT,1842,26,40-44,1868,3.3593767751253925
SIM,1862,42,40-44,1904,7
SIM,1905,39,na,1944,3558
SIM,1899,34,na,1933,3643
STAT,1829,66,na,1895,966.42252114403
SIM,1868,42,50-100,1910,1
STAT,1863,18,25-29,1881,5.234789478296326
STAT,1915,43,35-39,1958,0.2042427997324461
STAT,1836,29,15-19,1865,0.3650535973293362
STAT,1852,36,45-49,1888,1.5359135956299477
SIM,1840,39,25-29,1879,3
STAT,1832,36,25-29,1868,2.5110866035101562
STAT,1879,93,na,1972,139.8710432335246
SIM,1840,36,25-29,1876,4
SIM,1899,23,25-29,1922,100
SIM,1909,20,25-29,1929,130
SIM,1936,31,50-100,1967,1
SIM,1819,38,20-24,1857,4
SIM,1919,28,na,1947,3952
STAT,1865,0,na,1865,3514.2394964841524
SIM,1860,36,45-49,1896,1
SIM,1837,37,30-34,1874,6
STAT,1842,29,40-44,1871,3.2875341077343228
STAT,1884,35,50-100,1919,1.2344389804733522
STAT,1864,46,15-19,1910,3.6558960129091825E-4
SIM,1887,28,25-29,1915,46
SIM,1830,29,20-24,1859,15
SIM,1868,30,40-44,1898,5
STAT,1914,44,30-34,1958,0.12738840845179392
SIM,1820,42,35-39,1862,6
SIM,1888,21,50-100,1909,1
STAT,1922,42,na,1964,4306.451825748802
SIM,1845,14,na,1859,2383
SIM,1850,29,40-44,1879,3
STAT,1813,48,na,1861,1333.4222866837945
STAT,1762,93,na,1855,4.285259999999999
STAT,1797,92,na,1889,11.919374953807381
STAT,1939,15,15-19,1954,45.9736926098732
STAT,1896,28,30-34,1924,33.54771058346503
SIM,1875,44,40-44,1919,6
SIM,1849,32,25-29,1881,17
STAT,1839,50,20-24,1889,5.361825093465201E-4
STAT,1909,20,na,1929,3600.4031449606214
SIM,1840,24,25-29,1864,62
STAT,1919,47,50-100,1966,0.24769704699085043
STAT,1939,26,50-100,1965,1.0106203580275193
STAT,1876,65,na,1941,1762.3654813478088
STAT,1878,47,20-24,1925,0.012522802341381128
STAT,1935,20,30-34,1955,39.57016622181444
SIM,1844,43,50-100,1887,2
SIM,1914,25,30-34,1939,51
STAT,1884,25,35-39,1909,9.675483835307427
SIM,1874,43,40-44,1917,6
STAT,1863,47,50-100,1910,0.21876027788825372
SIM,1954,16,na,1970,4543
STAT,1852,15,45-49,1867,0.06062893256302342
SIM,1938,23,20-24,1961,107
SIM,1817,81,na,1898,253
STAT,1877,48,45-49,1925,0.24292075513915823
STAT,1880,33,15-19,1913,0.15041586956146416
SIM,1925,28,na,1953,4355
SIM,1825,34,35-39,1859,11
STAT,1847,51,na,1898,1619.8699342779817
SIM,1845,25,na,1870,2100
SIM,1854,37,30-34,1891,8
SIM,1848,33,20-24,1881,3
STAT,1785,103,na,1888,0.05428563670976975
STAT,1861,38,45-49,1899,1.6647952112181814
STAT,1906,25,30-34,1931,37.296507010577805
STAT,1867,44,40-44,1911,2.1106804419241754
SIM,1834,22,na,1856,2186
SIM,1889,38,40-44,1927,9
STAT,1853,99,na,1952,1.5661835834446105
SIM,1859,22,40-44,1881,5
SIM,1840,18,25-29,1858,9
STAT,1866,43,40-44,1909,2.0884001210560177
SIM,1892,25,35-39,1917,18
STAT,1877,46,20-24,1923,0.012544595902659036
SIM,1839,32,50-100,1871,3
SIM,1879,37,50-100,1916,1
SIM,1904,17,15-19,1921,9
STAT,1852,18,45-49,1870,0.059563916970906905
SIM,1881,40,50-100,1921,1
STAT,1857,54,25-29,1911,0.0027151941981677584
SIM,1861,55,na,1916,1781
STAT,1843,21,30-34,1864,15.188847788384804
SIM,1865,14,na,1879,2460
STAT,1875,53,30-34,1928,0.006074956811220089
STAT,1894,44,35-39,1938,0.16130566672970656
SIM,1946,18,30-34,1964,19
STAT,1874,61,na,1935,1932.5234599160992
SIM,1885,33,45-49,1918,2
STAT,1830,74,na,1904,732.1717135180077
STAT,1902,49,30-34,1951,0.0763058713064585
STAT,1868,13,na,1881,2566.4284199249164
STAT,1949,3,na,1952,4674.31380472519
STAT,1850,38,35-39,1888,5.444764927194694
SIM,1895,35,na,1930,3233
STAT,1837,28,25-29,1865,36.7741270419632
STAT,1913,17,15-19,1930,9.362180739705346
SIM,1902,11,na,1913,3933
SIM,1854,81,na,1935,454
STAT,1833,54,35-39,1887,0.0060557097616480825
STAT,1829,37,30-34,1866,4.367689225974621
STAT,1854,28,20-24,1882,9.163503281402699
STAT,1870,41,40-44,1911,2.240899197546553
STAT,1873,19,25-29,1892,5.771101381643937
STAT,1843,40,35-39,1883,1.290140961305298
SIM,1810,94,na,1904,25
STAT,1834,33,na,1867,1635.2941497656982
SIM,1818,42,45-49,1860,1
SIM,1871,62,na,1933,1641
STAT,1868,36,35-39,1904,6.860287314457592
STAT,1793,77,na,1870,331.7702675521807
STAT,1878,20,na,1898,2494.4414806740347
STAT,1894,46,20-24,1940,0.008826960017968693
STAT,1883,44,25-29,1927,0.626122486022698
SIM,1865,36,25-29,1901,2
STAT,1877,33,45-49,1910,1.8101297971861163
SIM,1862,28,20-24,1890,12
STAT,1840,81,na,1921,379.06924317444907
STAT,1865,28,30-34,1893,23.14240915472433
STAT,1854,40,45-49,1894,1.1345419209034555
STAT,1910,44,50-100,1954,0.11064128418692382
SIM,1879,9,na,1888,3035
SIM,1918,32,35-39,1950,16
STAT,1815,74,na,1889,489.9368763486797
STAT,1898,20,na,1918,3257.5665040806166
STAT,1822,35,20-24,1857,1.553999411207936
STAT,1938,18,30-34,1956,12.134295023146557
SIM,1881,83,na,1964,535
SIM,1858,44,40-44,1902,5
STAT,1893,20,na,1913,3051.133252005269
STAT,1832,36,20-24,1868,0.6722944609435382
SIM,1845,28,25-29,1873,51
STAT,1867,68,na,1935,1453.6550101005296
SIM,1891,8,na,1899,3395
STAT,1925,16,na,1941,4504.57512202357
STAT,1776,110,na,1886,0.0017145392160317343
STAT,1776,85,na,1861,71.51864942599195
STAT,1846,52,50-100,1898,0.011400234182700777
STAT,1839,40,15-19,1879,0.011633949240926039
STAT,1872,54,20-24,1926,7.28693535487233E-4
STAT,1867,47,45-49,1914,0.22344179767283465
STAT,1888,13,na,1901,3073.86740479409
SIM,1840,21,20-24,1861,74
STAT,1949,18,40-44,1967,1.6429181660431726
STAT,1887,71,na,1958,1598.1529105329632
SIM,1921,17,15-19,1938,64
SIM,1883,4,na,1887,3027
SIM,1918,9,na,1927,4502
STAT,1842,47,40-44,1889,0.1541630623769044
STAT,1896,39,15-19,1935,0.07431863552930192
SIM,1940,7,na,1947,4239
SIM,1843,46,50-100,1889,4
STAT,1911,35,15-19,1946,0.018890334403315775
SIM,1812,75,na,1887,362
SIM,1833,42,40-44,1875,7
STAT,1889,20,50-100,1909,0.5108899882566145
STAT,1911,22,35-39,1933,9.009314187363136
SIM,1790,89,na,1879,47
STAT,1852,33,40-44,1885,3.3701184966196522
STAT,1827,53,35-39,1880,0.008358028452007638
STAT,1835,46,50-100,1881,0.1968835399924599
STAT,1872,83,na,1955,403.1088864754922
SIM,1860,33,40-44,1893,11
SIM,1915,46,na,1961,4115
STAT,1899,33,30-34,1932,24.099688037316543
STAT,1828,38,20-24,1866,0.776423095898214
STAT,1895,41,50-100,1936,0.09719986223341656
SIM,1825,93,na,1918,6
STAT,1901,28,15-19,1929,0.6401169452828697
STAT,1836,47,45-49,1883,0.1558053315364641
STAT,1956,16,25-29,1972,57.944154845710926
STAT,1892,33,40-44,1925,5.473070000753643
SIM,1891,26,25-29,1917,88
STAT,1847,29,25-29,1876,37.52419003041218
STAT,1833,50,50-100,1883,0.011499259811227954
STAT,1845,42,50-100,1887,0.786075359371909
SIM,1862,48,50-100,1910,1
SIM,1823,36,25-29,1859,4
STAT,1871,45,45-49,1916,0.23916898847744028
SIM,1911,31,40-44,1942,3
STAT,1838,45,25-29,1883,0.04069888839068315
STAT,1877,15,45-49,1892,0.06841007566219265
STAT,1868,54,35-39,1922,0.008081719966935139
STAT,1817,50,35-39,1867,0.018449917688927488
STAT,1845,52,40-44,1897,0.007651455938086077
SIM,1850,43,25-29,1893,1
STAT,1862,37,15-19,1899,0.04897914888582175
STAT,1865,3,na,1868,2950.6586540624085
STAT,1830,26,15-19,1856,0.5286704655385427
STAT,1878,29,25-29,1907,44.034140773018656
SIM,1866,35,35-39,1901,17
SIM,1878,43,na,1921,2648
STAT,1857,58,na,1915,1558.8300014697413
STAT,1948,21,15-19,1969,6.176327973509289
STAT,1816,53,25-29,1869,0.008623148140165569
STAT,1895,29,20-24,1924,15.362763622712581
STAT,1927,21,50-100,1948,0.821870796339107
STAT,1867,26,45-49,1893,1.0597690820502692
SIM,1841,63,na,1904,1236
STAT,1861,32,na,1893,2002.7834190685946
STAT,1898,12,na,1910,3535.994136986787
STAT,1882,47,40-44,1929,0.16671224180118227
SIM,1841,55,na,1896,1444
SIM,1870,35,20-24,1905,1
SIM,1898,28,35-39,1926,18
SIM,1844,32,45-49,1876,1
STAT,1856,106,na,1962,0.037050912146885454
SIM,1855,29,25-29,1884,41
STAT,1920,40,50-100,1960,0.1313887614823065
SIM,1882,17,na,1899,2254
STAT,1830,71,na,1901,880.6211164917079
STAT,1883,26,25-29,1909,41.952991006079785
STAT,1919,32,50-100,1951,0.9006470298356196
SIM,1822,40,45-49,1862,2
STAT,1892,31,20-24,1923,3.4398003837012103
STAT,1893,16,40-44,1909,0.23513855784521082
SIM,1908,25,35-39,1933,19
SIM,1860,3,na,1863,2821
STAT,1879,15,45-49,1894,0.06916979535466267
STAT,1905,8,na,1913,3795.5886244145117
SIM,1881,22,20-24,1903,58
STAT,1860,24,35-39,1884,4.895530498086714
SIM,1824,35,25-29,1859,1
SIM,1905,36,na,1941,3588
STAT,1881,31,45-49,1912,1.7046630282437192
STAT,1903,31,40-44,1934,6.263482899185199
SIM,1834,25,40-44,1859,5
SIM,1912,32,na,1944,3584
STAT,1816,39,40-44,1855,15.217975723443413
SIM,1824,39,40-44,1863,4
STAT,1893,37,45-49,1930,2.5565300368560204
STAT,1913,49,40-44,1962,0.1543554044152514
STAT,1840,27,15-19,1867,0.39654930205754096
STAT,1804,54,45-49,1858,0.037745702368769424
SIM,1864,91,na,1955,50
STAT,1853,45,20-24,1898,0.010022653965642437
SIM,1876,36,35-39,1912,14
SIM,1927,32,50-100,1959,5
STAT,1862,19,15-19,1881,5.3314314623840415
STAT,1836,32,45-49,1868,1.3905153598532
STAT,1922,50,na,1972,4225.241364156684
SIM,1878,32,na,1910,2812
STAT,1814,40,45-49,1854,5.587759160000218
SIM,1870,19,15-19,1889,6
SIM,1917,30,30-34,1947,24
STAT,1831,53,20-24,1884,4.754072217764775E-4
STAT,1806,49,25-29,1855,0.16828426600140128
STAT,1892,35,na,1927,3014.2740416259144
STAT,1906,45,50-100,1951,0.20583683727220167
STAT,1926,24,50-100,1950,0.8028532626135703
SIM,1835,20,35-39,1855,4
STAT,1882,28,na,1910,2326.6305349358727
STAT,1926,33,35-39,1959,11.160795571981634
SIM,1853,34,40-44,1887,4
STAT,1855,38,15-19,1893,0.04205905631287384
STAT,1938,16,50-100,1954,0.3740160351679438
STAT,1825,40,20-24,1865,0.2384563627368028
STAT,1863,98,na,1961,6.952112509335677
SIM,1847,40,na,1887,1782
STAT,1824,109,na,1933,3.5370280340054966E-4
SIM,1776,82,na,1858,107
STAT,1832,54,20-24,1886,5.038507997942026E-4
STAT,1847,47,20-24,1894,0.008942956871035234
STAT,1883,48,40-44,1931,0.16708305313045924
SIM,1906,30,20-24,1936,2
STAT,1862,73,na,1935,1035.9819835209832
SIM,1892,41,35-39,1933,4
STAT,1876,50,40-44,1926,0.011136453297195476
STAT,1886,86,na,1972,570.5707298917139
SIM,1827,37,na,1864,1587
STAT,1829,33,15-19,1862,0.12367090613325031
STAT,1849,27,35-39,1876,8.942754732646897
SIM,1886,29,25-29,1915,62
STAT,1840,30,45-49,1870,1.5201154434482855
STAT,1851,32,40-44,1883,3.4177523184585015
SIM,1846,55,na,1901,1459
SIM,1857,27,35-39,1884,8
SIM,1906,21,na,1927,3283
STAT,1884,41,35-39,1925,1.8117221642161865
SIM,1855,32,20-24,1887,2
STAT,1938,34,na,1972,3834.174454310012
STAT,1956,5,na,1961,5255.802166011767
SIM,1914,21,15-19,1935,6
SIM,1850,25,25-29,1875,48
STAT,1864,35,25-29,1899,2.648984429731642
SIM,1775,89,na,1864,52
SIM,1863,23,15-19,1886,4
STAT,1888,15,20-24,1903,21.232582844735585
SIM,1875,29,45-49,1904,1
STAT,1881,32,na,1913,2323.230009498455
SIM,1825,31,30-34,1856,16
STAT,1822,103,na,1925,0.0802426336521786
SIM,1864,37,25-29,1901,3
STAT,1928,28,15-19,1956,0.8786652193581439
STAT,1842,43,25-29,1885,0.5905507562365965
STAT,1823,110,na,1933,1.52832496303561E-4
STAT,1928,31,45-49,1959,1.989915766593987
SIM,1903,21,35-39,1924,9
SIM,1934,33,35-39,1967,24
SIM,1939,3,na,1942,4146
STAT,1863,50,35-39,1913,0.007814870978077908
STAT,1928,27,na,1955,4664.889753132936
SIM,1894,20,40-44,1914,3
SIM,1819,38,25-29,1857,3
SIM,1901,19,20-24,1920,26
STAT,1853,25,35-39,1878,9.378006567738588
STAT,1824,48,35-39,1872,0.1615765957492432
STAT,1839,38,30-34,1877,4.468741927867686
STAT,1833,31,15-19,1864,0.13155431250083774
STAT,1904,54,na,1958,3093.4356606824554
SIM,1910,30,50-100,1940,4
SIM,1861,25,35-39,1886,12
STAT,1862,37,45-49,1899,1.7387595786656358
STAT,1940,16,na,1956,3773.98040721397
STAT,1850,40,na,1890,1787.6056145346233
STAT,1854,41,50-100,1895,0.7964404176607176
STAT,1886,20,40-44,1906,2.23541782484451
STAT,1830,41,40-44,1871,1.982116828053725
STAT,1891,39,35-39,1930,8.755517740380508
SIM,1830,71,na,1901,686
STAT,1897,27,na,1924,3231.4927959274846
SIM,1847,38,30-34,1885,8
SIM,1940,13,na,1953,4198
SIM,1906,32,na,1938,3407
STAT,1829,48,15-19,1877,2.945720042114573E-4
STAT,1862,22,45-49,1884,0.6226260234483443
STAT,1823,78,na,1901,432.12656319037853
STAT,1855,23,15-19,1878,2.880215849402066
STAT,1809,63,na,1872,1033.4672276655044
STAT,1849,45,35-39,1894,0.11055066857539848
SIM,1835,35,35-39,1870,9
STAT,1844,41,35-39,1885,1.4862304971413791
STAT,1888,4,na,1892,3136.0735907408994
SIM,1871,15,20-24,1886,14
STAT,1842,25,25-29,1867,47.78202652439373
STAT,1918,24,40-44,1942,3.6381835072146917
SIM,1934,15,35-39,1949,9
STAT,1854,84,na,1938,249.6592557658792
STAT,1894,26,35-39,1920,12.58990037061092
SIM,1878,34,45-49,1912,3
STAT,1829,33,45-49,1862,1.5143851788439657
SIM,1855,0,na,1855,3507
STAT,1888,33,20-24,1921,3.2087495970451876
SIM,1833,37,na,1870,1862
STAT,1906,21,15-19,1927,4.867857981529288
STAT,1852,15,40-44,1867,0.16976105245810783
STAT,1874,32,15-19,1906,0.14727653415020642
STAT,1922,3,na,1925,4742.164032850992
STAT,1819,44,40-44,1863,4.522176275493049
SIM,1859,25,45-49,1884,6
STAT,1880,18,20-24,1898,18.755570681891736
STAT,1902,30,50-100,1932,1.3182323236548428
STAT,1891,20,15-19,1911,4.149971830985867
SIM,1894,35,40-44,1929,15
SIM,1936,31,45-49,1967,3
SIM,1782,82,na,1864,46
SIM,1947,19,30-34,1966,16
STAT,1853,43,35-39,1896,1.486682888746281
STAT,1886,35,40-44,1921,4.712472231105712
SIM,1824,63,na,1887,1054
STAT,1896,42,45-49,1938,0.13877484030643472
STAT,1896,24,15-19,1920,4.382924451801566
STAT,1828,92,na,1920,27.03701529587859
STAT,1865,49,35-39,1914,0.12642000028864914
SIM,1851,40,35-39,1891,6
SIM,1852,41,35-39,1893,3
STAT,1866,46,45-49,1912,0.2213415375758843
STAT,1827,35,35-39,1862,8.625088455083697
SIM,1938,26,25-29,1964,85
STAT,1863,15,20-24,1878,18.31870896679795
SIM,1850,29,45-49,1879,1
STAT,1834,52,30-34,1886,0.003634892846334275
STAT,1866,41,20-24,1907,0.14919917030105131
STAT,1905,39,na,1944,3432.203223349992
STAT,1888,48,20-24,1936,0.007968011171261535
SIM,1926,24,40-44,1950,6
SIM,1872,58,na,1930,2228
SIM,1898,49,na,1947,3015
STAT,1939,19,30-34,1958,12.308746905538168
SIM,1849,36,40-44,1885,6
STAT,1884,22,30-34,1906,17.74094498364086
STAT,1826,66,na,1892,899.35827417447
SIM,1937,16,na,1953,3385
STAT,1905,10,na,1915,3782.126193077591
STAT,1829,51,45-49,1880,0.010671128733346144
STAT,1810,82,na,1892,242.32432431004858
STAT,1842,29,45-49,1871,1.2185216223815627
STAT,1895,41,45-49,1936,0.13769980522526998
STAT,1947,15,50-100,1962,0.4265258469741729
SIM,1793,74,na,1867,467
SIM,1827,44,40-44,1871,7
STAT,1926,15,35-39,1941,5.22370036745984
SIM,1962,3,na,1965,5269
STAT,1836,99,na,1935,1.1941285885395636
STAT,1916,39,15-19,1955,0.01964587097057197
STAT,1918,42,40-44,1960,0.26848247754466364
STAT,1844,40,na,1884,1921.4161544128938
STAT,1865,40,20-24,1905,0.1479441694685076
SIM,1884,83,na,1967,576
STAT,1828,50,45-49,1878,0.013283147840619137
STAT,1799,62,na,1861,916.291307574604
STAT,1827,32,50-100,1859,1.2331300132132594
SIM,1926,42,40-44,1968,1
STAT,1786,75,na,1861,416.60951766306727
STAT,1898,34,25-29,1932,13.904193506886788
STAT,1871,56,na,1927,2046.6181478348287
STAT,1904,38,40-44,1942,1.362684264526246
STAT,1877,42,40-44,1919,2.3418108793095453
STAT,1910,49,20-24,1959,0.010341594272400964
STAT,1822,36,30-34,1858,10.345568704779991
STAT,1842,29,50-100,1871,0.7020416241596446
STAT,1875,46,na,1921,2340.199643439331
STAT,1958,6,na,1964,5215.278966254223
SIM,1907,30,35-39,1937,13
STAT,1894,49,25-29,1943,0.0413673157413734
STAT,1900,72,na,1972,2217.9512766999574
SIM,1806,75,na,1881,473
SIM,1931,25,30-34,1956,62
STAT,1837,92,na,1929,28.412379556818017
STAT,1894,41,30-34,1935,1.501718578013174
STAT,1853,35,50-100,1888,1.0366204125830452
STAT,1896,46,25-29,1942,0.043561498633749224
STAT,1856,99,na,1955,1.4665088456865394
STAT,1861,41,35-39,1902,1.526656646290736
STAT,1819,46,50-100,1865,0.4857993142137355
STAT,1858,16,25-29,1874,5.276273695185222
STAT,1844,45,50-100,1889,0.1973791717932709
STAT,1861,35,40-44,1896,3.708843032161847
STAT,1957,15,30-34,1972,16.2420842647366
SIM,1894,35,45-49,1929,4
STAT,1914,41,25-29,1955,0.07149437403004746
STAT,1847,37,na,1884,1830.2361018654224
STAT,1835,52,45-49,1887,0.011104766658846393
SIM,1920,28,20-24,1948,25
STAT,1921,37,30-34,1958,2.0553557781279794
SIM,1821,66,na,1887,857
SIM,1889,19,30-34,1908,3
STAT,1884,47,45-49,1931,0.2339589829778272
STAT,1935,2,na,1937,5648.850386780283
SIM,1898,63,na,1961,2656
STAT,1846,17,45-49,1863,0.06227277218759344
SIM,1846,27,50-100,1873,1
STAT,1811,48,20-24,1859,0.029404839886412324
SIM,1948,18,35-39,1966,7
STAT,1846,52,20-24,1898,5.570147215341636E-4
STAT,1905,41,15-19,1946,0.0014065432788787097
SIM,1827,44,45-49,1871,3
STAT,1837,40,45-49,1877,1.2360908424195283
SIM,1814,41,50-100,1855,1
STAT,1856,19,25-29,1875,5.127594324330362
SIM,1830,94,na,1924,3
SIM,1864,19,25-29,1883,9
SIM,1926,24,na,1950,4242
STAT,1941,23,25-29,1964,96.340455393868
SIM,1885,26,35-39,1911,18
STAT,1886,35,45-49,1921,2.1460296308654847
SIM,1789,78,na,1867,299
STAT,1894,39,na,1933,3032.7270643906045
STAT,1903,16,45-49,1919,0.09419152661621821
STAT,1771,114,na,1885,2.421602284844565E-4
STAT,1889,41,20-24,1930,0.19867975720695366
SIM,1830,36,30-34,1866,10
STAT,1873,40,15-19,1913,0.01428269455596993
STAT,1906,17,40-44,1923,0.26906932558374363
SIM,1834,84,na,1918,153
SIM,1905,35,30-34,1940,2
STAT,1831,29,35-39,1860,8.129097460571163
STAT,1826,69,na,1895,805.2709685372557
STAT,1914,16,20-24,1930,28.365178592368526
SIM,1872,35,25-29,1907,4
STAT,1858,54,na,1912,1659.223432451551
STAT,1879,18,50-100,1897,0.05150214140806193
STAT,1878,48,30-34,1926,0.10021519137014312
SIM,1847,57,na,1904,1423
STAT,1849,23,20-24,1872,64.67413417292929
STAT,1868,51,30-34,1919,0.005773433843316386
SIM,1828,27,45-49,1855,1
SIM,1844,29,na,1873,1723
SIM,1875,23,40-44,1898,2
STAT,1905,16,na,1921,3696.685805798977
STAT,1842,17,50-100,1859,0.05664186852182431
STAT,1863,30,45-49,1893,1.573072386928737
SIM,1912,30,45-49,1942,1
SIM,1890,24,20-24,1914,85
STAT,1767,100,na,1867,0.16457705321782964
STAT,1812,100,na,1912,0.4819985829652365
STAT,1867,37,na,1904,2241.0571348940066
STAT,1854,64,na,1918,1304.6146304912188
STAT,1880,36,20-24,1916,0.8215828885736647
STAT,1805,81,na,1886,253.6820370285471
STAT,1882,24,20-24,1906,66.99830748001698
STAT,1912,28,20-24,1940,18.084647645179352
STAT,1850,53,25-29,1903,0.002668621433385559
STAT,1901,46,45-49,1947,0.18901925712794998
STAT,1925,30,na,1955,4543.977710333492
SIM,1865,33,25-29,1898,16
SIM,1922,16,20-24,1938,212
STAT,1813,45,20-24,1858,0.03623394267364402
SIM,1841,66,na,1907,1129
SIM,1867,71,na,1938,1164
STAT,1920,31,40-44,1951,4.346283574928073
SIM,1838,29,25-29,1867,43
STAT,1834,53,40-44,1887,0.0063025875537667505
SIM,1916,14,na,1930,4212
STAT,1827,50,30-34,1877,0.006133268193241178
STAT,1852,83,na,1935,301.0717400802499
STAT,1877,9,na,1886,2755.6719298993994
SIM,1829,32,na,1861,1861
STAT,1807,62,na,1869,922.3988722894079
STAT,1940,22,50-100,1962,0.6767003686269529
STAT,1881,32,20-24,1913,2.631604621521293
STAT,1843,51,25-29,1894,0.0024004039373690072
SIM,1905,19,25-29,1924,18
STAT,1857,33,25-29,1890,8.03960387734023
SIM,1880,20,45-49,1900,2
STAT,1895,40,35-39,1935,2.4124968425098308
SIM,1894,45,50-100,1939,4
SIM,1866,16,25-29,1882,9
SIM,1938,23,na,1961,3550
SIM,1939,25,30-34,1964,57
STAT,1889,25,15-19,1914,0.5688719154132262
STAT,1903,1,na,1904,3915.1688431076773
STAT,1870,32,45-49,1902,1.729502346984125
STAT,1893,34,50-100,1927,1.16497115203955
SIM,1845,24,40-44,1869,3
SIM,1823,67,na,1890,921
STAT,1960,3,na,1963,5174.452103462476
SIM,1912,38,40-44,1950,3
STAT,1862,38,25-29,1900,2.498838215177792
STAT,1932,30,20-24,1962,3.2805245917784953
STAT,1829,97,na,1926,3.1676777278578236
STAT,1902,42,45-49,1944,0.148152176848357
SIM,1906,31,30-34,1937,24
STAT,1867,23,40-44,1890,1.976039762860432
SIM,1870,38,25-29,1908,7
SIM,1840,39,na,1879,1804
STAT,1782,101,na,1883,0.14021016182970328
STAT,1835,45,40-44,1880,0.15275914691129808
STAT,1837,24,40-44,1861,1.834364827950527
SIM,1823,33,20-24,1856,4
SIM,1881,18,15-19,1899,5
STAT,1862,28,na,1890,2074.2468827205057
STAT,1873,18,15-19,1891,6.060523047013116
STAT,1887,18,45-49,1905,0.07346766706325651
STAT,1930,42,20-24,1972,0.023485753655228443
STAT,1876,53,45-49,1929,0.014891173249353969
SIM,1850,49,na,1899,1849
STAT,1859,53,45-49,1912,0.011599665974187018
SIM,1851,96,na,1947,5
STAT,1848,24,15-19,1872,3.2327050877047347
SIM,1854,39,na,1893,2149
STAT,1884,29,na,1913,2359.976604949973
STAT,1814,41,20-24,1855,0.5763877850882365
STAT,1843,46,45-49,1889,0.16047516825258554
SIM,1917,22,45-49,1939,1
SIM,1941,28,50-100,1969,1
STAT,1788,84,na,1872,100.83206607690751
SIM,1924,43,na,1967,4474
STAT,1886,6,na,1892,2785.7995366214345
STAT,1852,49,20-24,1901,0.008910687957860923
SIM,1872,44,50-100,1916,2
STAT,1915,33,25-29,1948,9.45840187951266
STAT,1859,45,50-100,1904,0.20149864234690298
STAT,1904,45,15-19,1949,3.3029730703288204E-4
STAT,1947,25,15-19,1972,0.8074384793549587
STAT,1810,51,30-34,1861,0.022256670678392376
SIM,1883,39,50-100,1922,1
SIM,1917,41,na,1958,3756
STAT,1913,42,20-24,1955,0.017376521164239007
SIM,1910,29,na,1939,3323
SIM,1800,64,na,1864,869
STAT,1904,30,45-49,1934,2.5478453115764688
STAT,1819,87,na,1906,89.56377760281258
STAT,1899,15,30-34,1914,2.219610031931857
SIM,1923,33,25-29,1956,6
SIM,1865,76,na,1941,749
STAT,1890,25,25-29,1915,52.560944409032295
STAT,1862,31,40-44,1893,3.7980301620234953
SIM,1793,77,na,1870,331
SIM,1858,46,50-100,1904,2
SIM,1882,88,na,1970,248
SIM,1856,24,15-19,1880,2
SIM,1834,39,na,1873,1840
STAT,1838,20,40-44,1858,1.836084947073295
STAT,1834,30,na,1864,1687.0371631090034
STAT,1899,2,na,1901,3695.00947767436
STAT,1909,22,45-49,1931,1.0552627648661264
SIM,1902,41,40-44,1943,3
SIM,1823,47,na,1870,1465
STAT,1879,41,50-100,1920,1.1185384264586509
STAT,1918,27,45-49,1945,1.8561593385080897
SIM,1877,16,na,1893,2688
STAT,1913,43,30-34,1956,0.1255921514650928
STAT,1892,58,na,1950,2506.365890147972
STAT,1930,35,15-19,1965,0.02536067628118743
STAT,1823,34,25-29,1857,21.02833321175201
STAT,1946,20,50-100,1966,0.7400545059826157
SIM,1831,34,25-29,1865,12
SIM,1908,4,na,1912,3854
STAT,1820,40,35-39,1860,3.6595995479306724
STAT,1831,43,15-19,1874,0.010539030733715784
SIM,1819,93,na,1912,7
SIM,1846,20,40-44,1866,3
STAT,1890,23,na,1913,2909.83109995996
STAT,1819,44,45-49,1863,3.008999868346403
SIM,1857,23,20-24,1880,3
SIM,1858,6,na,1864,2400
STAT,1777,92,na,1869,8.15780468062986
SIM,1926,27,45-49,1953,2
STAT,1895,47,20-24,1942,0.008886439477566534
SIM,1898,24,20-24,1922,92
STAT,1907,24,35-39,1931,8.601162671847336
STAT,1805,53,na,1858,1348.602039108454
STAT,1869,31,25-29,1900,10.098914859687381
STAT,1910,42,35-39,1952,0.19200314485462192
SIM,1799,68,na,1867,861
SIM,1924,29,na,1953,4561
SIM,1929,28,40-44,1957,5
SIM,1953,6,na,1959,4919
SIM,1877,87,na,1964,399
STAT,1853,23,50-100,1876,0.39559419556553005
SIM,1909,12,na,1921,4236
SIM,1843,67,na,1910,1461
STAT,1924,24,35-39,1948,11.157119156744313
SIM,1883,7,na,1890,2943
SIM,1858,22,25-29,1880,73
STAT,1828,106,na,1934,0.007881864942771197
STAT,1899,30,25-29,1929,14.311928996788728
SIM,1901,29,50-100,1930,2
STAT,1881,66,na,1947,1595.6836609364436
STAT,1840,34,25-29,1874,8.565375160724644
STAT,1879,21,40-44,1900,2.202965071149777
STAT,1885,43,45-49,1928,1.493759729100718
STAT,1876,46,40-44,1922,0.17904160477529865
STAT,1923,25,30-34,1948,45.761643648928974
SIM,1829,52,na,1881,1513
STAT,1848,40,20-24,1888,0.13286583647348119
SIM,1882,17,20-24,1899,16
STAT,1883,75,na,1958,1117.6156275411658
STAT,1930,37,na,1967,4959.915603975274
STAT,1837,47,30-34,1884,0.0685516925029904
STAT,1874,17,20-24,1891,18.334662662739618
STAT,1913,35,15-19,1948,0.019302505044492376
SIM,1915,24,35-39,1939,9
STAT,1812,63,na,1875,983.0303228458927
SIM,1874,59,na,1933,1803
SIM,1930,33,30-34,1963,26
STAT,1887,57,na,1944,2266.152252802468
STAT,1860,42,30-34,1902,0.9480280088379857
STAT,1872,44,15-19,1916,0.013833508088868839
STAT,1865,9,na,1874,2544.3979856556884
SIM,1887,21,40-44,1908,2
SIM,1814,84,na,1898,127
STAT,1825,81,na,1906,394.6277179580232
STAT,1868,35,50-100,1903,1.1963841964410737
STAT,1818,52,45-49,1870,0.02482067447148111
SIM,1863,67,na,1930,1374
STAT,1801,91,na,1892,23.062097576423447
STAT,1778,113,na,1891,3.345409400163879E-4
SIM,1906,18,30-34,1924,2
STAT,1846,89,na,1935,79.72352961376666
STAT,1861,66,na,1927,1375.5886266689968
STAT,1879,46,25-29,1925,0.06088275734369586
STAT,1898,29,na,1927,3244.29404912385
STAT,1875,54,40-44,1929,0.010619184142225764
STAT,1909,32,50-100,1941,0.7961641292996664
SIM,1932,24,35-39,1956,20
STAT,1816,45,na,1861,1561.720788800175
STAT,1780,107,na,1887,0.00723881825456645
STAT,1853,40,30-34,1893,0.9603420440925677
STAT,1922,33,30-34,1955,17.907617938007565
STAT,1923,49,50-100,1972,0.2657727615825944
STAT,1952,18,na,1970,4455.114617232316
STAT,1862,15,35-39,1877,0.5546500004585092
STAT,1813,62,na,1875,991.5934698759272
SIM,1861,40,30-34,1901,2
SIM,1864,18,15-19,1882,5
STAT,1840,19,na,1859,2058.8470212707603
STAT,1931,26,35-39,1957,19.59839602989572
SIM,1938,29,30-34,1967,2
STAT,1797,67,na,1864,761.410042208882
STAT,1882,30,15-19,1912,0.1404441089219076
STAT,1919,30,na,1949,4153.002032394203
STAT,1921,38,40-44,1959,1.686482262889475
SIM,1836,30,25-29,1866,16
STAT,1919,41,45-49,1960,0.1823648993223426
STAT,1927,17,na,1944,4625.757538966096
SIM,1917,1,na,1918,4352
STAT,1822,39,35-39,1861,12.052115925565202
STAT,1835,51,35-39,1886,0.006719339702437013
STAT,1854,24,40-44,1878,1.81120124086931
SIM,1869,58,na,1927,1894
STAT,1820,34,40-44,1854,13.723043952396273
STAT,1827,51,40-44,1878,0.010634247418578059
STAT,1877,49,25-29,1926,0.0587899184426867
STAT,1944,17,45-49,1961,0.5428534468748034
STAT,1815,52,50-100,1867,0.03201319928086925
STAT,1894,42,40-44,1936,0.20285495437779186
SIM,1882,30,20-24,1912,2
SIM,1932,38,na,1970,5781
SIM,1778,86,na,1864,19
STAT,1900,20,30-34,1920,25.139941446402826
STAT,1941,20,20-24,1961,116.0933966425621
STAT,1832,33,20-24,1865,2.380190621219543
STAT,1850,50,20-24,1900,5.73154860140256E-4
STAT,1836,45,na,1881,1523.073240847928
STAT,1908,26,50-100,1934,0.961181218133108
SIM,1952,17,45-49,1969,4
STAT,1856,18,15-19,1874,5.4017522818762815
SIM,1844,60,na,1904,1268
SIM,1818,47,50-100,1865,3
STAT,1887,15,40-44,1902,0.2072081595990911
STAT,1907,11,na,1918,3836.165382539882
SIM,1867,31,35-39,1898,12
SIM,1868,42,40-44,1910,11
STAT,1831,34,50-100,1865,0.7405830375954053
STAT,1874,30,20-24,1904,2.817945646899948
STAT,1929,27,20-24,1956,23.090726862286765
SIM,1892,44,40-44,1936,1
STAT,1940,25,30-34,1965,40.37240614113382
SIM,1901,46,na,1947,3259
STAT,1926,36,50-100,1962,0.5190620814239019
STAT,1900,22,25-29,1922,80.31623163149747
SIM,1922,19,25-29,1941,66
STAT,1885,4,na,1889,2792.693199744449
SIM,1867,57,na,1924,1762
STAT,1878,74,na,1952,1163.5631262635727
SIM,1871,30,45-49,1901,1
STAT,1859,31,35-39,1890,8.260194991319656
STAT,1864,28,15-19,1892,0.41204316073471303
STAT,1937,22,20-24,1959,109.31524743063888
STAT,1927,39,20-24,1966,0.33056226884511275
STAT,1895,21,25-29,1916,75.73282087449017
SIM,1934,36,50-100,1970,3
STAT,1914,19,25-29,1933,8.995898278412108
SIM,1948,19,45-49,1967,5
STAT,1805,51,20-24,1856,0.003095551632131116
STAT,1884,44,40-44,1928,2.2100280911041335
STAT,1872,42,20-24,1914,0.161063529585101
STAT,1828,30,25-29,1858,12.93490864672061
SIM,1849,52,na,1901,1680
SIM,1845,27,45-49,1872,2
SIM,1906,15,25-29,1921,14
SIM,1895,15,40-44,1910,2
STAT,1875,27,50-100,1902,0.6635001313761227
STAT,1895,48,30-34,1943,0.07111477196287895
SIM,1827,51,na,1878,1337
STAT,1849,63,na,1912,1395.0634390463774
STAT,1836,44,45-49,1880,1.0947668499872227
SIM,1823,92,na,1915,19
SIM,1867,36,50-100,1903,1
SIM,1921,28,40-44,1949,9
SIM,1840,33,20-24,1873,3
STAT,1860,43,40-44,1903,1.8436468680445792
STAT,1913,28,40-44,1941,4.669446665644297
STAT,1857,52,50-100,1909,0.011841282063017995
STAT,1809,97,na,1906,2.4806268157123523
STAT,1936,22,na,1958,3524.704505963979
SIM,1862,24,40-44,1886,2
STAT,1852,45,40-44,1897,0.13113111739152106
SIM,1844,44,45-49,1888,2
SIM,1895,21,na,1916,3359
SIM,1931,31,25-29,1962,14
SIM,1816,99,na,1915,1
SIM,1859,36,35-39,1895,10
STAT,1837,27,45-49,1864,0.9722063663469388
SIM,1865,52,50-100,1917,2
STAT,1933,30,50-100,1963,1.127200350229469
SIM,1824,32,25-29,1856,18
SIM,1863,30,50-100,1893,1
STAT,1837,21,na,1858,1923.1920845977638
SIM,1830,39,35-39,1869,11
STAT,1864,18,50-100,1882,0.04591796513207415
STAT,1915,40,na,1955,3783.408665771298
STAT,1883,23,25-29,1906,56.40508957808216
SIM,1830,49,na,1879,1354
SIM,1857,81,na,1938,496
STAT,1931,41,25-29,1972,0.09655232671702231
SIM,1874,23,20-24,1897,66
STAT,1947,18,40-44,1965,1.5910104217376695
STAT,1802,103,na,1905,0.050141749231914244
STAT,1878,40,35-39,1918,1.917713468297435
STAT,1955,17,20-24,1972,181.82491452925646
STAT,1853,41,40-44,1894,1.8685148356350227
STAT,1855,18,na,1873,2042.9737741556796
STAT,1918,34,na,1952,4022.684819632254
STAT,1885,18,40-44,1903,0.1833975806632291
STAT,1923,35,40-44,1958,1.755595995866777
SIM,1931,35,40-44,1966,2
SIM,1824,94,na,1918,3
SIM,1862,20,25-29,1882,50
SIM,1865,90,na,1955,120
STAT,1848,27,20-24,1875,11.43461141419796
STAT,1923,31,25-29,1954,10.749602365022385
SIM,1903,28,20-24,1931,13
SIM,1891,23,25-29,1914,87
SIM,1795,78,na,1873,251
STAT,1876,52,35-39,1928,0.008930102662884678
STAT,1839,87,na,1926,124.90739601042088
STAT,1836,48,25-29,1884,0.037542979117397256
STAT,1901,43,40-44,1944,0.21955137208316539
STAT,1864,41,50-100,1905,0.9671933092285799
SIM,1851,43,40-44,1894,7
STAT,1866,23,20-24,1889,64.50891971603268
STAT,1853,37,na,1890,1948.3378261014798
STAT,1831,26,30-34,1857,22.4553116718084
STAT,1913,45,25-29,1958,0.05248471801547192
SIM,1953,0,na,1953,4982
STAT,1842,28,na,1870,2391.288537249645
SIM,1836,34,40-44,1870,2
STAT,1769,100,na,1869,0.17195463040480657
STAT,1838,23,45-49,1861,0.6012838611638098
SIM,1881,86,na,1967,345
SIM,1923,30,20-24,1953,2
STAT,1899,18,35-39,1917,0.7586014416285202
SIM,1853,31,40-44,1884,6
SIM,1892,78,na,1970,1462
STAT,1895,25,40-44,1920,3.9778442170205492
STAT,1932,33,25-29,1965,12.409033935369829
SIM,1933,34,na,1967,4893
SIM,1886,41,45-49,1927,5
STAT,1838,38,15-19,1876,0.04489115515949832
STAT,1831,36,na,1867,1710.2673697186042
STAT,1847,44,20-24,1891,0.11730414658179894
STAT,1907,49,15-19,1956,3.2943912986928915E-4
SIM,1831,42,na,1873,1702
STAT,1951,17,50-100,1968,0.4507550493763994
STAT,1783,111,na,1894,1.9842721724311265E-4
SIM,1914,24,15-19,1938,7
STAT,1824,88,na,1912,68.25064918093784
STAT,1886,45,50-100,1931,0.2645172119575595
STAT,1831,41,20-24,1872,0.1243933839516114
STAT,1911,48,25-29,1959,0.05052320827150068
STAT,1859,50,40-44,1909,0.0086748798245434
STAT,1867,51,na,1918,2057.93988706985
SIM,1927,23,15-19,1950,7
STAT,1854,20,25-29,1874,51.21167280422743
SIM,1852,20,35-39,1872,11
STAT,1925,20,35-39,1945,11.458377446446127
STAT,1816,90,na,1906,40.30905618795507
SIM,1865,48,na,1913,2013
STAT,1877,27,na,1904,2487.767475792108
STAT,1878,41,45-49,1919,1.5762596122063153
STAT,1915,18,50-100,1933,0.07891607968092282
STAT,1850,31,15-19,1881,0.11526110167129067
STAT,1900,29,40-44,1929,4.172771298330443
SIM,1886,40,35-39,1926,6
STAT,1924,40,50-100,1964,0.14159870188437615
STAT,1876,93,na,1969,119.58706992015814
SIM,1856,85,na,1941,95
SIM,1897,28,20-24,1925,20
STAT,1888,19,na,1907,2994.658243795607
STAT,1899,17,25-29,1916,7.8549461673564185
STAT,1915,30,20-24,1945,2.5268322817084536
STAT,1915,40,30-34,1955,0.13023750102032794
SIM,1777,81,na,1858,139
STAT,1828,34,40-44,1862,4.7273478232426696
SIM,1923,31,30-34,1954,36
STAT,1932,32,na,1964,5080.884928806262
STAT,1844,20,35-39,1864,5.848229097042692
SIM,1850,22,25-29,1872,61
STAT,1773,88,na,1861,45.70490811430003
STAT,1911,47,15-19,1958,3.518334176397162E-4
STAT,1849,18,na,1867,2196.119107933994
STAT,1919,23,15-19,1942,5.867192913991152
STAT,1773,114,na,1887,3.1879973808480544E-4
STAT,1841,49,45-49,1890,0.17279937610013463
STAT,1804,88,na,1892,42.56061006398709
STAT,1858,32,50-100,1890,0.7260206828992436
STAT,1880,23,50-100,1903,0.4312109954249606
STAT,1854,46,20-24,1900,0.00903140834690435
STAT,1877,26,35-39,1903,10.092785335625363
SIM,1947,16,25-29,1963,67
STAT,1862,34,45-49,1896,1.507974950850288
STAT,1882,16,50-100,1898,0.04804880488615864
STAT,1930,20,45-49,1950,1.4655718797182564
STAT,1857,27,na,1884,1937.6276150991418
STAT,1868,52,40-44,1920,0.010108145131307094
STAT,1913,9,na,1922,4093.220347965016
STAT,1915,31,30-34,1946,16.257447590885235
STAT,1923,40,20-24,1963,0.02091369123233984
STAT,1871,33,50-100,1904,0.9155031726578595
SIM,1859,90,na,1949,61
SIM,1945,22,20-24,1967,169
STAT,1810,54,35-39,1864,0.03029765177206
STAT,1827,82,na,1909,277.4573076714446
STAT,1854,47,30-34,1901,0.07230841485116542
SIM,1830,44,50-100,1874,4
STAT,1824,41,15-19,1865,0.01751884124775364
STAT,1882,51,50-100,1933,0.01484643451661675
STAT,1842,22,25-29,1864,65.00739288816364
SIM,1827,41,40-44,1868,4
STAT,1813,46,30-34,1859,0.28694320848203453
STAT,1885,21,35-39,1906,5.8843401208385275
STAT,1869,35,40-44,1904,4.339349672902685
STAT,1822,44,50-100,1866,1.6009530752067953
STAT,1889,28,20-24,1917,14.558853130268853
SIM,1907,31,na,1938,3784
STAT,1814,64,na,1878,979.4453311277222
SIM,1838,43,na,1881,1729
STAT,1787,100,na,1887,0.1899079271494349
SIM,1933,20,35-39,1953,21
STAT,1941,21,30-34,1962,29.996650733109448
STAT,1901,26,na,1927,3390.5724406605596
SIM,1852,58,na,1910,1436
SIM,1893,40,40-44,1933,4
STAT,1844,17,40-44,1861,0.1839512391184768
STAT,1933,39,15-19,1972,0.026375063799661227
STAT,1803,72,na,1875,689.440550217123
SIM,1841,86,na,1927,136
SIM,1894,32,40-44,1926,7
STAT,1836,25,35-39,1861,7.99065607223929
STAT,1870,47,15-19,1917,3.9486545748075477E-4
STAT,1886,32,40-44,1918,4.624644116919618
STAT,1821,37,25-29,1858,5.6749253751258015
SIM,1845,40,45-49,1885,3
STAT,1846,35,na,1881,1906.266014922864
STAT,1819,41,40-44,1860,4.993577442067857
SIM,1937,27,20-24,1964,26
STAT,1845,50,na,1895,1595.8984162126183
SIM,1888,17,20-24,1905,28
STAT,1890,40,15-19,1930,0.017215526326285507
SIM,1894,25,na,1919,3418
STAT,1880,37,30-34,1917,5.6531391001165
STAT,1885,76,na,1961,1142.7104861729222
STAT,1906,24,15-19,1930,4.822823817654157
STAT,1798,94,na,1892,6.649912413707161
STAT,1885,56,na,1941,2050.5210213727605
STAT,1904,23,50-100,1927,0.5892327143493671
STAT,1876,42,25-29,1918,0.6688444582908953
SIM,1878,31,45-49,1909,1
SIM,1880,27,30-34,1907,32
SIM,1857,33,50-100,1890,5
STAT,1941,30,30-34,1971,16.719240618823857
SIM,1889,25,50-100,1914,6
STAT,1858,17,35-39,1875,0.5078922120223089
STAT,1888,45,20-24,1933,0.014447958833550805
STAT,1863,17,45-49,1880,0.06670429789867427
SIM,1877,35,40-44,1912,10
SIM,1844,25,35-39,1869,12
STAT,1931,31,15-19,1962,0.17027508891268744
STAT,1829,63,na,1892,1052.0934324489538
STAT,1874,84,na,1958,431.3379909587158
STAT,1891,32,15-19,1923,0.17807769035450693
STAT,1879,24,45-49,1903,0.7303757315508502
STAT,1913,46,35-39,1959,0.12728510111798103
SIM,1810,74,na,1884,586
STAT,1809,51,25-29,1860,0.011617202465857915
STAT,1833,39,50-100,1872,1.0675799349778707
SIM,1849,33,40-44,1882,3
STAT,1843,78,na,1921,526.9837433201064
SIM,1913,36,35-39,1949,4
SIM,1836,34,na,1870,2024
STAT,1844,53,35-39,1897,0.0067019880445127805
STAT,1915,41,50-100,1956,0.11951853203218823
SIM,1796,71,na,1867,641
STAT,1905,36,35-39,1941,2.2397527119119793
SIM,1934,19,na,1953,5067
STAT,1777,103,na,1880,0.03960254654624004
SIM,1848,18,30-34,1866,1
STAT,1870,57,na,1927,1993.1283965717996
STAT,1882,49,35-39,1931,0.13410885840182735
STAT,1931,40,15-19,1971,0.002079159543817445
STAT,1912,18,na,1930,3929.9491239111835
STAT,1897,19,15-19,1916,7.992636728768641
STAT,1910,18,45-49,1928,0.0996025623990327
STAT,1885,40,40-44,1925,2.284099006337232
STAT,1882,28,50-100,1910,0.623638529719978
SIM,1864,60,na,1924,2073
STAT,1879,43,20-24,1922,0.16617972734789313
SIM,1882,33,25-29,1915,15
STAT,1816,54,35-39,1870,0.02054523984578331
STAT,1904,47,50-100,1951,0.19986467514539857
STAT,1845,15,35-39,1860,0.512768341103232
STAT,1865,70,na,1935,1293.9936075563942
STAT,1883,45,35-39,1928,0.13975149630679867
STAT,1875,15,na,1890,2631.7738988640167
STAT,1872,45,25-29,1917,0.059071345238701216
SIM,1913,17,25-29,1930,17
STAT,1916,17,35-39,1933,0.8984360940390752
STAT,1827,54,45-49,1881,0.01256944622442796
STAT,1929,42,15-19,1971,0.002010128773864122
SIM,1847,16,20-24,1863,23
SIM,1886,21,25-29,1907,74
STAT,1931,23,30-34,1954,37.55732262020333
STAT,1865,27,20-24,1892,10.819401373238636
STAT,1859,28,40-44,1887,2.457632651608076
SIM,1841,41,50-100,1882,1
SIM,1870,46,50-100,1916,3
SIM,1842,15,25-29,1857,9
SIM,1946,17,20-24,1963,224
SIM,1850,29,50-100,1879,3
STAT,1827,31,na,1858,1738.3298014964937
STAT,1905,17,25-29,1922,8.273970943125072
STAT,1894,33,45-49,1927,2.2579845946000496
SIM,1915,15,na,1930,4514
STAT,1851,107,na,1958,0.0070549760451133975
STAT,1926,32,na,1958,4621.929276758323
SIM,1858,16,30-34,1874,2
STAT,1830,27,25-29,1857,46.496187245206784
STAT,1942,23,40-44,1965,3.558289101832894
STAT,1870,40,30-34,1910,1.1517327424622112
STAT,1805,54,25-29,1859,0.01398602779376802
SIM,1909,6,na,1915,4273
STAT,1820,49,50-100,1869,0.40521515283567
SIM,1833,29,40-44,1862,2
SIM,1893,21,35-39,1914,12
STAT,1874,33,25-29,1907,10.548093197931623
STAT,1859,53,na,1912,1721.0111248815488
SIM,1805,73,na,1878,433
SIM,1823,98,na,1921,6
STAT,1869,60,na,1929,1872.771271359001
SIM,1895,52,na,1947,2946
STAT,1843,22,40-44,1865,1.764142380081102
STAT,1880,17,45-49,1897,0.06928826669145959
STAT,1865,42,15-19,1907,0.01272051789934039
STAT,1920,35,20-24,1955,0.2919653668854556
SIM,1861,35,50-100,1896,1
SIM,1938,18,40-44,1956,2
STAT,1858,40,15-19,1898,0.011053139722829132
SIM,1826,30,35-39,1856,20
SIM,1879,15,20-24,1894,18
SIM,1827,46,50-100,1873,1
STAT,1900,23,35-39,1923,8.161945042947181
SIM,1885,45,na,1930,2455
STAT,1894,45,45-49,1939,0.17483118190961575
STAT,1916,25,na,1941,3935.420664507397
STAT,1854,27,45-49,1881,0.8735360681712402
STAT,1907,21,30-34,1928,26.499437994014382
STAT,1895,15,na,1910,3346.6591413816336
SIM,1881,52,na,1933,1897
SIM,1815,80,na,1895,213
STAT,1896,62,na,1958,2515.1557657858248
STAT,1918,37,na,1955,4003.4015296796824
STAT,1825,29,40-44,1854,12.185967613344271
STAT,1874,18,30-34,1892,1.644044479214799
STAT,1811,44,40-44,1855,5.915338849110303
STAT,1853,44,45-49,1897,1.2209798612214047
SIM,1915,21,30-34,1936,2
SIM,1894,39,25-29,1933,8
SIM,1904,21,20-24,1925,2
STAT,1860,46,45-49,1906,0.19540107683656135
STAT,1939,16,25-29,1955,43.80323078622906
STAT,1826,100,na,1926,0.582546272174427
STAT,1928,44,na,1972,4769.608766942569
STAT,1827,42,45-49,1869,1.6099296895964157
SIM,1845,20,25-29,1865,68
SIM,1859,100,na,1959,1
STAT,1949,21,35-39,1970,11.103613415328569
SIM,1851,22,40-44,1873,3
SIM,1900,61,na,1961,3016
STAT,1890,22,20-24,1912,85.04910057916449
STAT,1938,17,20-24,1955,135.01237042906587
STAT,1893,46,40-44,1939,0.12419835331483144
STAT,1839,37,20-24,1876,0.6530874134244904
STAT,1901,71,na,1972,2322.349850989842
STAT,1924,46,45-49,1970,0.2621142060751245
STAT,1904,35,50-100,1939,0.38774011570364947
SIM,1841,32,25-29,1873,17
SIM,1861,32,45-49,1893,2
STAT,1874,30,na,1904,2487.7353681758327
STAT,1903,38,25-29,1941,0.8894673318844524
SIM,1893,40,na,1933,3077
STAT,1886,39,25-29,1925,3.0394539503722937
SIM,1927,22,35-39,1949,15
STAT,1866,26,25-29,1892,39.69743185707793
SIM,1963,2,na,1965,5086
SIM,1911,38,25-29,1949,4
STAT,1823,31,20-24,1854,8.331330922587867
STAT,1917,43,35-39,1960,0.21178139235814905
SIM,1902,42,na,1944,3535
STAT,1859,16,40-44,1875,0.17349055342677475
STAT,1936,29,20-24,1965,17.619051340212692
SIM,1878,18,na,1896,2948
STAT,1804,103,na,1907,0.04449247589790297
STAT,1839,16,20-24,1855,16.539558297467465
STAT,1805,110,na,1915,1.0969959895586727E-4
STAT,1833,53,25-29,1886,0.0025413274218211127
SIM,1887,23,na,1910,2553
SIM,1870,34,50-100,1904,2
SIM,1839,93,na,1932,5
STAT,1922,44,20-24,1966,0.020409792525934035
SIM,1829,86,na,1915,94
STAT,1925,29,45-49,1954,2.0474300880182934
SIM,1899,17,30-34,1916,1
SIM,1831,31,20-24,1862,2
STAT,1898,40,na,1938,3207.540673930469
SIM,1935,17,45-49,1952,2
STAT,1828,37,45-49,1865,2.053966149787948
SIM,1855,38,na,1893,2010
STAT,1835,49,20-24,1884,0.009256997178643976
STAT,1837,20,25-29,1857,54.3891710049323
SIM,1858,41,35-39,1899,1
SIM,1872,27,na,1899,2573
STAT,1871,46,20-24,1917,0.012075277852435926
SIM,1908,33,na,1941,3453
SIM,1870,34,45-49,1904,1
STAT,1843,43,40-44,1886,1.5421048848734986
STAT,1943,22,45-49,1965,1.2087417691382374
STAT,1823,43,20-24,1866,0.2296946065873551
SIM,1854,53,na,1907,1966
SIM,1885,34,50-100,1919,1
SIM,1821,45,50-100,1866,3
SIM,1807,51,na,1858,1133
STAT,1869,63,na,1932,1752.1127038888637
STAT,1912,12,na,1924,4029.0486784339755
SIM,1933,29,45-49,1962,4
STAT,1927,17,45-49,1944,0.6277932454621282
SIM,1870,15,na,1885,2885
STAT,1913,0,na,1913,4632.282048909242
STAT,1867,82,na,1949,443.82343700700034
STAT,1933,28,50-100,1961,1.3348769178377118
STAT,1902,28,50-100,1930,0.9097936081484526
SIM,1868,26,35-39,1894,13
STAT,1822,32,15-19,1854,0.43848831039967323
SIM,1934,22,45-49,1956,1
STAT,1895,28,45-49,1923,1.4592942916509557
STAT,1910,31,na,1941,3694.229413398899
STAT,1921,18,20-24,1939,155.6712629685989
STAT,1904,18,20-24,1922,25.62874309633796
SIM,1819,37,45-49,1856,1
STAT,1911,41,40-44,1952,0.24223731885237762
STAT,1858,36,45-49,1894,1.5872148782673465
STAT,1861,97,na,1958,7.021849557547343
SIM,1825,32,40-44,1857,6
STAT,1851,19,40-44,1870,0.1664031908786175
STAT,1873,34,20-24,1907,2.7439918772933733
SIM,1767,91,na,1858,12
STAT,1769,109,na,1878,0.0025630909463287554
STAT,1857,30,20-24,1887,2.1888123066848655
STAT,1878,28,45-49,1906,1.160004965808447
SIM,1892,23,40-44,1915,3
STAT,1884,23,40-44,1907,2.069050007910762
SIM,1805,70,na,1875,587
STAT,1880,44,50-100,1924,1.1054637509569818
STAT,1915,18,30-34,1933,2.567403647598822
STAT,1899,41,15-19,1940,0.0013353106765294383
SIM,1903,22,15-19,1925,5
STAT,1936,4,na,1940,3901.209552215116
STAT,1921,33,15-19,1954,0.14382327192322336
STAT,1863,51,45-49,1914,0.013049148735887414
SIM,1909,27,45-49,1936,4
SIM,1869,38,na,1907,2274
SIM,1908,33,50-100,1941,4
STAT,1915,34,35-39,1949,9.31093604536663
SIM,1876,35,50-100,1911,1
SIM,1881,34,20-24,1915,2
STAT,1926,22,45-49,1948,1.3815276298308274
SIM,1853,38,25-29,1891,1
STAT,1939,29,50-100,1968,1.0091657622318624
STAT,1849,21,50-100,1870,0.3882653449108804
STAT,1919,22,35-39,1941,10.410354700349783
SIM,1836,37,45-49,1873,5
SIM,1836,31,na,1867,2034
STAT,1831,44,25-29,1875,0.4837346083806073
SIM,1839,24,15-19,1863,3
SIM,1887,41,50-100,1928,1
STAT,1806,53,30-34,1859,0.01683531512283154
STAT,1813,49,35-39,1862,0.39272327482973945
SIM,1849,38,na,1887,1902
SIM,1924,33,40-44,1957,8
STAT,1848,106,na,1954,0.00991318526611654
STAT,1821,33,45-49,1854,6.009036402464635
SIM,1913,33,30-34,1946,5
SIM,1940,18,30-34,1958,16
STAT,1852,51,35-39,1903,0.006560280139688148
SIM,1807,54,na,1861,1111
SIM,1923,34,35-39,1957,23
STAT,1932,18,30-34,1950,16.267802184395407
SIM,1928,28,25-29,1956,137
STAT,1814,98,na,1912,1.5205130095109753
SIM,1854,50,na,1904,2040
STAT,1821,46,na,1867,1576.2556850837118
STAT,1901,3,na,1904,3743.019608849175
STAT,1863,75,na,1938,921.255078410356
STAT,1905,45,30-34,1950,0.08052087084932752
SIM,1847,71,na,1918,929
STAT,1898,15,15-19,1913,8.163391859048799
STAT,1860,49,15-19,1909,3.233549697468748E-4
STAT,1898,43,na,1941,3152.5596510747596
SIM,1904,20,na,1924,3795
STAT,1895,44,50-100,1939,0.09545593110733226
SIM,1872,32,20-24,1904,4
STAT,1914,44,na,1958,3700.6423240576814
STAT,1916,33,40-44,1949,4.060061756020518
SIM,1930,29,na,1959,5007
SIM,1931,22,na,1953,4673
STAT,1913,34,50-100,1947,0.8228676712613578
SIM,1886,28,45-49,1914,1
SIM,1865,30,20-24,1895,2
STAT,1859,70,na,1929,1139.7670921049842
SIM,1816,68,na,1884,799
STAT,1872,20,45-49,1892,0.7122996676105368
SIM,1931,4,na,1935,5240
STAT,1770,91,na,1861,9.11616650725641
STAT,1899,28,na,1927,3296.4391690284983
STAT,1841,45,30-34,1886,0.07460393985903836
STAT,1941,24,35-39,1965,9.817277234448664
SIM,1847,51,50-100,1898,1
STAT,1906,43,25-29,1949,0.06512659561507403
STAT,1817,53,40-44,1870,0.02124763393187402
STAT,1848,16,na,1864,2337.030821936276
SIM,1922,35,30-34,1957,1
STAT,1905,33,30-34,1938,14.576236727461469
STAT,1858,103,na,1961,0.3250946387228795
STAT,1868,43,45-49,1911,1.434256963338326
SIM,1788,76,na,1864,396
STAT,1912,43,15-19,1955,0.0014853297505554334
STAT,1830,45,20-24,1875,0.010300463736410248
STAT,1930,24,25-29,1954,118.85169215553563
STAT,1873,44,30-34,1917,1.1612669053842593
STAT,1874,54,25-29,1928,0.0035623796756304718
SIM,1876,43,45-49,1919,5
STAT,1917,32,45-49,1949,1.6632523426481076
SIM,1896,37,na,1933,3120
SIM,1925,32,45-49,1957,5
STAT,1951,19,45-49,1970,0.600604125303844
STAT,1812,83,na,1895,180.23648400401652
STAT,1842,44,35-39,1886,1.6440904904177776
SIM,1923,18,30-34,1941,21
SIM,1850,44,35-39,1894,2
STAT,1860,27,50-100,1887,0.5338059526827496
STAT,1869,38,45-49,1907,1.9478118897468406
SIM,1890,15,na,1905,3437
SIM,1830,40,na,1870,1553
STAT,1931,35,30-34,1966,2.4436887753452363
SIM,1803,92,na,1895,23
STAT,1902,2,na,1904,3804.5899526679113
STAT,1853,68,na,1921,1263.783505642189
STAT,1832,43,30-34,1875,0.9482460126687654
STAT,1841,97,na,1938,4.017440909933288
SIM,1917,32,50-100,1949,1
STAT,1882,46,30-34,1928,0.09497292691067918
STAT,1899,37,45-49,1936,0.5964286975146523
STAT,1914,35,30-34,1949,1.8534449880309274
STAT,1926,37,15-19,1963,0.02371928401340963
STAT,1956,15,15-19,1971,60.69790035993545
SIM,1877,38,45-49,1915,2
STAT,1906,28,30-34,1934,36.91478130844789
STAT,1921,45,15-19,1966,4.2138760088628524E-4
SIM,1831,25,na,1856,1894
STAT,1877,45,45-49,1922,0.2484645363495269
SIM,1838,46,na,1884,1716
SIM,1908,32,45-49,1940,3
SIM,1834,53,na,1887,1526
STAT,1870,43,35-39,1913,1.7829703189193604
SIM,1818,46,na,1864,1347
STAT,1902,32,35-39,1934,14.453956797394689
STAT,1854,30,na,1884,1872.469375011118
SIM,1939,28,na,1967,3832
STAT,1858,23,na,1881,1942.6224636002967
SIM,1889,58,na,1947,2372
SIM,1849,47,50-100,1896,2
STAT,1844,23,na,1867,2096.973754422613
STAT,1898,31,20-24,1929,3.716176571482128
STAT,1900,41,30-34,1941,0.11251666340903753
SIM,1841,32,na,1873,1791
STAT,1803,52,35-39,1855,0.03733648414591544
SIM,1798,83,na,1881,70
SIM,1924,17,35-39,1941,7
SIM,1794,90,na,1884,68
SIM,1910,32,35-39,1942,10
STAT,1924,29,50-100,1953,1.1627289976497641
SIM,1859,8,na,1867,2675
STAT,1811,50,35-39,1861,0.021342236695180736
STAT,1911,26,15-19,1937,0.6969526264577774
SIM,1894,59,na,1953,2678
SIM,1836,19,15-19,1855,7
SIM,1856,43,25-29,1899,2
STAT,1946,18,25-29,1964,48.529961745945286
STAT,1855,45,25-29,1900,0.043788968112778166
STAT,1850,57,na,1907,1538.8022204538856
STAT,1863,78,na,1941,699.2066426827629
SIM,1852,42,45-49,1894,1
SIM,1847,19,25-29,1866,9
STAT,1936,27,30-34,1963,37.857273079548655
STAT,1887,19,20-24,1906,19.884296245649356
STAT,1896,43,20-24,1939,0.014637464592726884
STAT,1898,19,30-34,1917,2.1706365765868885
SIM,1806,58,na,1864,1168
SIM,1944,27,30-34,1971,46
SIM,1878,66,na,1944,1842
STAT,1816,76,na,1892,484.38194422541943
STAT,1849,60,na,1909,1491.1339462184865
STAT,1901,22,40-44,1923,2.9503762454753
STAT,1908,29,45-49,1937,1.63682317254573
STAT,1847,54,30-34,1901,0.00433433256585053
STAT,1866,45,35-39,1911,0.13223790172099628
STAT,1936,25,na,1961,3622.591830651479
SIM,1828,28,20-24,1856,11
STAT,1838,23,na,1861,1843.6568960384402
STAT,1876,31,35-39,1907,10.604097994106928
SIM,1865,45,na,1910,2062
STAT,1785,90,na,1875,29.838490702889125
STAT,1791,76,na,1867,338.03756357013697
STAT,1839,19,25-29,1858,5.193819769694841
STAT,1894,48,15-19,1942,2.8971216310062466E-4
STAT,1824,30,50-100,1854,2.510148277259598
SIM,1921,46,50-100,1967,5
STAT,1868,40,40-44,1908,2.193113685535996
SIM,1946,21,na,1967,4125
STAT,1806,69,na,1875,700.2242506972611
STAT,1837,43,15-19,1880,0.010975621711672923
STAT,1913,46,50-100,1959,0.22329443385466968
SIM,1883,16,25-29,1899,10
STAT,1843,25,45-49,1868,0.9349887366590659
STAT,1844,50,30-34,1894,0.004777241506272146
STAT,1920,38,25-29,1958,1.0875343463722766
SIM,1854,30,45-49,1884,2
STAT,1882,42,15-19,1924,0.01349417916362497
STAT,1858,54,40-44,1912,0.008112569588012349
STAT,1891,17,20-24,1908,22.169141874833485
SIM,1948,15,30-34,1963,18
STAT,1894,30,40-44,1924,5.684514419650592
SIM,1867,26,na,1893,2181
STAT,1851,52,30-34,1903,0.004483203689361724
STAT,1881,48,50-100,1929,0.2361032796307251
STAT,1893,42,25-29,1935,0.8225149163298804
STAT,1848,43,25-29,1891,0.5205071482760516
STAT,1875,16,25-29,1891,5.89206539630743
STAT,1931,38,35-39,1969,3.2341593232002728
STAT,1934,19,45-49,1953,0.6790642346716628
STAT,1884,30,15-19,1914,0.14297744013573424
SIM,1832,26,20-24,1858,8
STAT,1870,71,na,1941,1323.8395549728016
SIM,1839,28,30-34,1867,30
STAT,1864,44,20-24,1908,0.14278644004114563
SIM,1888,73,na,1961,1842
SIM,1881,44,30-34,1925,4
STAT,1826,51,25-29,1877,0.0034336756156492223
STAT,1865,56,na,1921,1881.0647140016472
STAT,1844,24,50-100,1868,0.39706980577502904
SIM,1846,72,na,1918,905
SIM,1919,16,15-19,1935,71
SIM,1856,39,50-100,1895,1
STAT,1868,18,40-44,1886,0.17869258754068534
SIM,1879,18,25-29,1897,8
STAT,1917,40,30-34,1957,0.13504456137235987
STAT,1851,51,50-100,1902,0.011490332656262576
SIM,1836,45,50-100,1881,1
SIM,1904,46,35-39,1950,1
STAT,1828,45,50-100,1873,0.22977240802486665
STAT,1846,30,45-49,1876,1.5966992733013936
STAT,1878,44,15-19,1922,0.014283542680499929
SIM,1836,65,na,1901,1187
STAT,1924,4,na,1928,4856.9393234593335
SIM,1887,26,na,1913,2612
SIM,1881,6,na,1887,2326
STAT,1923,47,40-44,1970,0.1863540925585031
SIM,1878,42,50-100,1920,2
STAT,1890,77,na,1967,1448.9154850904456
SIM,1854,18,20-24,1872,16
SIM,1870,31,40-44,1901,7
SIM,1921,21,20-24,1942,123
SIM,1910,20,na,1930,3419
SIM,1884,31,35-39,1915,11
STAT,1933,33,40-44,1966,5.325863481077692
STAT,1861,39,20-24,1900,0.6404467986069116
STAT,1845,38,25-29,1883,2.187598288779051
SIM,1916,20,35-39,1936,18
STAT,1881,35,25-29,1916,2.829708172142563
SIM,1852,27,na,1879,1966
SIM,1878,63,na,1941,2005
SIM,1905,16,20-24,1921,23
STAT,1852,41,25-29,1893,0.48921031302450285
SIM,1906,34,35-39,1940,13
STAT,1878,21,25-29,1899,60.20063861806904
SIM,1873,27,20-24,1900,16
STAT,1833,50,20-24,1883,5.618531074843847E-4
STAT,1923,43,25-29,1966,0.08419673293801874
STAT,1847,82,na,1929,349.347542293472
SIM,1850,40,50-100,1890,1
SIM,1895,19,20-24,1914,24
STAT,1855,42,20-24,1897,0.11939470368642933
STAT,1913,21,20-24,1934,109.04263457464646
SIM,1840,17,15-19,1857,8
SIM,1920,6,na,1926,4876
STAT,1842,40,50-100,1882,1.0096198680821669
STAT,1835,49,na,1884,1734.8149179685558
STAT,1901,47,20-24,1948,0.009539257637507317
STAT,1921,30,45-49,1951,1.7828365877227446
SIM,1817,40,35-39,1857,3
STAT,1814,44,25-29,1858,1.631715647759591
SIM,1900,35,45-49,1935,1
STAT,1911,44,45-49,1955,0.15828982586295792
STAT,1852,38,na,1890,1777.8918115881404
STAT,1885,22,na,1907,2377.6725853366856
SIM,1908,7,na,1915,3815
STAT,1822,50,45-49,1872,0.021565909355320764
SIM,1794,79,na,1873,312
STAT,1849,26,25-29,1875,39.48904873947892
SIM,1918,37,30-34,1955,5
STAT,1903,35,20-24,1938,0.24159747406383633
STAT,1844,42,45-49,1886,1.2127344598231082
STAT,1939,32,30-34,1971,16.22850018236292
STAT,1832,83,na,1915,270.3180461680312
STAT,1905,48,35-39,1953,0.11385742410811747
SIM,1852,72,na,1924,882
STAT,1784,94,na,1878,3.5757712794857532
STAT,1890,34,20-24,1924,3.307447640047196
SIM,1882,37,40-44,1919,8
STAT,1821,91,na,1912,34.71027453608424
STAT,1876,11,na,1887,2721.3291428832176
SIM,1870,5,na,1875,3101
SIM,1832,49,45-49,1881,1
STAT,1825,50,na,1875,1811.404713050845
SIM,1863,64,na,1927,1573
STAT,1789,100,na,1889,0.277145438970413
SIM,1868,23,30-34,1891,23
STAT,1888,29,15-19,1917,0.5369984408397105
STAT,1867,52,25-29,1919,0.003351304117150767
STAT,1928,32,20-24,1960,3.0827337201554865
SIM,1939,28,35-39,1967,18
SIM,1886,25,40-44,1911,3
SIM,1871,37,30-34,1908,11
STAT,1861,20,35-39,1881,5.104535550626364
SIM,1914,19,na,1933,4233
SIM,1869,41,45-49,1910,2
STAT,1819,48,25-29,1867,0.1106000930202796
STAT,1800,54,40-44,1854,0.03120515484518444
SIM,1857,26,25-29,1883,70
SIM,1892,40,25-29,1932,1
SIM,1928,33,na,1961,4859
SIM,1890,12,na,1902,3503
STAT,1833,32,25-29,1865,9.36423919619256
SIM,1930,36,35-39,1966,8
SIM,1825,35,45-49,1860,1
STAT,1878,25,40-44,1903,3.162020896919904
STAT,1936,23,15-19,1959,5.13622637452858
STAT,1824,49,45-49,1873,0.2686522362238016
STAT,1825,41,30-34,1866,1.6868669352281291
SIM,1845,79,na,1924,538
SIM,1876,85,na,1961,351
STAT,1883,20,20-24,1903,68.51752334765975
STAT,1850,16,20-24,1866,16.68669550564083
STAT,1900,44,35-39,1944,0.17404252418610902
STAT,1836,42,na,1878,1576.9905407946867
STAT,1940,31,25-29,1971,9.662741842358884
SIM,1940,30,20-24,1970,1
STAT,1874,37,40-44,1911,4.527167847890734
STAT,1897,28,50-100,1925,0.8631321510975363
STAT,1921,16,30-34,1937,14.06672847952571
SIM,1918,26,na,1944,4159
STAT,1869,50,35-39,1919,0.008575222538760308
STAT,1940,21,15-19,1961,5.476312535086439
STAT,1834,64,na,1898,1034.7204898224263
SIM,1954,8,na,1962,4838
STAT,1836,41,40-44,1877,1.70977568124109
STAT,1775,80,na,1855,174.63743999999997
STAT,1914,45,40-44,1959,0.158504735274738
SIM,1913,34,na,1947,3730
STAT,1803,58,na,1861,1258.810632421385
SIM,1929,18,na,1947,4408
STAT,1888,29,50-100,1917,0.7571344331219866
SIM,1891,20,20-24,1911,79
STAT,1907,46,45-49,1953,0.19801331792663643
STAT,1840,21,50-100,1861,0.3661528121951531
STAT,1863,33,15-19,1896,0.126901376838554
STAT,1858,50,25-29,1908,0.0028469761357313213
STAT,1932,40,30-34,1972,0.17559137930803154
SIM,1870,12,na,1882,2965
STAT,1905,30,na,1935,3512.251508149309
STAT,1908,20,35-39,1928,8.790354672775875
STAT,1851,31,30-34,1882,13.903570988195622
SIM,1829,83,na,1912,208
SIM,1847,37,20-24,1884,1
SIM,1903,27,na,1930,3174
STAT,1858,33,40-44,1891,3.4218545459837664
STAT,1812,46,15-19,1858,9.375614686869731E-4
SIM,1896,29,50-100,1925,4
STAT,1780,104,na,1884,0.02941378807771508
STAT,1858,20,50-100,1878,0.3761251730201538
STAT,1846,18,20-24,1864,16.801287858939066
SIM,1841,35,na,1876,1782
SIM,1866,33,40-44,1899,4
STAT,1890,47,50-100,1937,0.17018211186627924
STAT,1768,87,na,1855,94.6881
STAT,1878,77,na,1955,906.2760709545809
STAT,1848,39,50-100,1887,1.011762470872715
SIM,1876,40,40-44,1916,7
SIM,1862,27,45-49,1889,2
SIM,1898,18,na,1916,3426
SIM,1844,41,40-44,1885,1
STAT,1836,90,na,1926,49.71086868067601
STAT,1871,45,50-100,1916,0.2488978960745287
STAT,1840,31,20-24,1871,2.331955510396292
STAT,1861,12,na,1873,2302.86150288749
SIM,1895,31,45-49,1926,2
STAT,1841,41,15-19,1882,0.010869614527920365
SIM,1833,41,30-34,1874,2
SIM,1790,80,na,1870,275
STAT,1889,69,na,1958,1915.1937295922019
STAT,1857,18,30-34,1875,1.4679568163271652
STAT,1855,49,na,1904,1658.1430150401925
STAT,1906,40,20-24,1946,0.016387478284012096
STAT,1922,36,35-39,1958,2.782914441462033
SIM,1898,27,25-29,1925,58
STAT,1892,32,30-34,1924,22.12808246038121
STAT,1924,21,30-34,1945,34.37411877509296
STAT,1838,54,20-24,1892,4.803985746850365E-4
STAT,1890,47,35-39,1937,0.09700934744960689
SIM,1843,30,35-39,1873,15
SIM,1872,78,na,1950,640
SIM,1871,93,na,1964,69
STAT,1799,93,na,1892,9.80721762935963
STAT,1884,40,25-29,1924,0.6460388419555421
SIM,1922,48,na,1970,4721
SIM,1801,66,na,1867,624
SIM,1941,0,na,1941,4356
STAT,1806,109,na,1915,2.398771176149718E-4
STAT,1810,51,na,1861,1438.1088665326056
STAT,1853,47,15-19,1900,3.2924817242578044E-4
STAT,1889,44,25-29,1933,0.7889436708082059
SIM,1885,11,na,1896,2802
STAT,1847,28,15-19,1875,0.4053750961082138
STAT,1886,33,50-100,1919,0.972954575306029
SIM,1800,81,na,1881,290
SIM,1932,21,30-34,1953,2
STAT,1932,18,na,1950,4912.529764046118
STAT,1931,33,na,1964,5005.400702853826
SIM,1865,18,30-34,1883,3
STAT,1930,28,40-44,1958,5.987406481498021
SIM,1885,42,40-44,1927,8
STAT,1862,34,50-100,1896,0.792325816742198
STAT,1921,26,na,1947,4231.230773063778
STAT,1887,31,45-49,1918,1.9744500402766805
STAT,1818,57,na,1875,1211.751289243997
STAT,1914,31,15-19,1945,0.13104342211902714
STAT,1886,16,35-39,1902,0.5865767020952312
STAT,1919,49,40-44,1968,0.17164974384434173
STAT,1850,39,45-49,1889,1.5187421546678594
STAT,1899,34,40-44,1933,5.95988087558867
SIM,1843,13,na,1856,2741
SIM,1936,32,20-24,1968,2
STAT,1863,37,30-34,1900,4.7693846224882686
SIM,1888,38,20-24,1926,1
SIM,1903,26,30-34,1929,41
STAT,1874,51,20-24,1925,7.667999246057993E-4
STAT,1829,52,20-24,1881,4.840774855495656E-4
SIM,1887,77,na,1964,1047
STAT,1901,0,na,1901,4157.433877270687
STAT,1826,35,na,1861,1587.226283964604
STAT,1860,50,50-100,1910,0.012648419171920543
STAT,1835,30,35-39,1865,9.88378059079072
SIM,1911,56,na,1967,3632
SIM,1818,91,na,1909,48
STAT,1912,47,30-34,1959,0.08643529057645044
SIM,1918,0,na,1918,4754
SIM,1861,86,na,1947,138
SIM,1875,31,50-100,1906,5
STAT,1823,72,na,1895,698.4610159848138
SIM,1883,19,na,1902,2844
STAT,1947,17,na,1964,4188.129583188456
SIM,1816,65,na,1881,865
STAT,1869,15,50-100,1884,0.0493538436641482
STAT,1820,38,20-24,1858,1.759321392284037
STAT,1851,16,50-100,1867,0.045369234209229566
SIM,1828,40,45-49,1868,1
STAT,1838,17,50-100,1855,0.04332044920719165
STAT,1887,66,na,1953,1848.2231481554443
SIM,1865,32,20-24,1897,2
STAT,1906,18,30-34,1924,2.338603649771222
STAT,1846,68,na,1914,1159.7260164987208
STAT,1860,52,50-100,1912,0.01240285096114179
STAT,1898,20,15-19,1918,4.544003934453703
SIM,1859,21,40-44,1880,3
SIM,1862,31,40-44,1893,7
STAT,1842,38,45-49,1880,2.0836928555229943
SIM,1876,30,30-34,1906,34
STAT,1827,48,20-24,1875,0.012146200080067582
SIM,1845,34,45-49,1879,2
STAT,1824,47,40-44,1871,0.20032362726642286
STAT,1850,73,na,1923,909.4786199117262
STAT,1891,71,na,1962,1872.5287503560307
SIM,1954,15,20-24,1969,169
STAT,1845,48,50-100,1893,0.17720161512865243
STAT,1849,23,50-100,1872,0.3827098705683272
STAT,1838,27,15-19,1865,0.38634672456008196
STAT,1951,19,20-24,1970,163.003992381518
STAT,1902,30,30-34,1932,25.119864168408174
STAT,1822,35,50-100,1857,2.4750785309962846
STAT,1824,41,na,1865,1383.2951058294002
STAT,1857,5,na,1862,2329.6269987738924
STAT,1948,23,30-34,1971,33.325584788209774
STAT,1900,22,20-24,1922,96.68499759728266
STAT,1887,40,50-100,1927,1.2033243740796538
SIM,1827,58,na,1885,1169
STAT,1821,47,50-100,1868,0.3599698605767053
SIM,1874,36,na,1910,2309
STAT,1803,95,na,1898,5.542427455792047
STAT,1930,34,25-29,1964,12.040331205890665
STAT,1911,49,na,1960,3488.2988925857117
STAT,1857,32,20-24,1889,2.1438250101823093
STAT,1828,55,na,1883,1411.4143098412098
STAT,1920,21,35-39,1941,10.60273298286067
SIM,1914,18,30-34,1932,3
STAT,1878,28,50-100,1906,0.6683277139044534
STAT,1915,43,50-100,1958,0.11915785799401515
STAT,1847,25,15-19,1872,0.41423378083784435
STAT,1926,45,15-19,1971,4.6153440633768473E-4
STAT,1836,23,50-100,1859,0.3370713315357143
STAT,1846,32,45-49,1878,1.563881848338072
STAT,1854,31,40-44,1885,3.367744292334395
STAT,1923,44,35-39,1967,0.23701023770913782
SIM,1939,26,35-39,1965,19
STAT,1889,35,20-24,1924,0.9691280665010888
STAT,1898,28,25-29,1926,57.71559979714579
SIM,1840,24,na,1864,1906
STAT,1844,24,35-39,1868,5.682068255592528
SIM,1907,20,30-34,1927,43
STAT,1861,21,30-34,1882,15.469267509625068
STAT,1830,45,15-19,1875,3.433484891926451E-4
STAT,1940,19,45-49,1959,0.5117063059488538
SIM,1921,31,45-49,1952,3
STAT,1873,54,25-29,1927,0.0035269690080826366
STAT,1914,24,15-19,1938,5.452742859908465
STAT,1941,26,25-29,1967,68.7731768345266
SIM,1922,24,15-19,1946,10
STAT,1862,46,50-100,1908,0.21482550879912485
STAT,1891,38,40-44,1929,5.446820896220899
SIM,1962,0,na,1962,5272
STAT,1837,34,45-49,1871,1.460929013123766
STAT,1918,39,30-34,1957,1.9352909249646506
SIM,1886,21,na,1907,2669
SIM,1926,39,30-34,1965,1
STAT,1876,34,50-100,1910,0.9473195970562932
SIM,1852,24,35-39,1876,6
STAT,1832,60,na,1892,1298.644765016417
SIM,1830,39,30-34,1869,3
SIM,1897,35,20-24,1932,1
STAT,1967,0,na,1967,4996.127940953289
STAT,1832,53,50-100,1885,0.010518418480098277
STAT,1822,39,30-34,1861,9.081493348603873
STAT,1919,13,na,1932,4414.1563671967915
STAT,1831,37,30-34,1868,4.260227293972674
STAT,1900,44,40-44,1944,0.21618437471528282
SIM,1907,28,40-44,1935,9
STAT,1829,72,na,1901,744.6507160997749
SIM,1915,34,25-29,1949,21
SIM,1824,77,na,1901,423
STAT,1922,28,40-44,1950,5.309458677997747
SIM,1912,19,35-39,1931,1
STAT,1879,16,20-24,1895,18.731761777756553
SIM,1932,31,20-24,1963,5
SIM,1909,23,45-49,1932,3
STAT,1850,37,40-44,1887,3.4049938059849896
SIM,1854,32,45-49,1886,4
SIM,1903,66,na,1969,2457
SIM,1912,33,45-49,1945,1
STAT,1837,91,na,1928,39.53081720346443
STAT,1833,45,40-44,1878,0.14609961123883394
STAT,1807,107,na,1914,0.0016705329889920646
STAT,1843,49,50-100,1892,0.16219065832055404
STAT,1909,42,35-39,1951,0.19005917061534308
SIM,1849,69,na,1918,1101
STAT,1883,39,45-49,1922,1.9504748703816561
STAT,1782,84,na,1866,107.71891572233154
STAT,1907,28,na,1935,3527.2978230826984
STAT,1903,14,na,1917,3702.6894253888486
SIM,1795,63,na,1858,864
STAT,1917,19,45-49,1936,0.5379304568247899
STAT,1863,24,45-49,1887,0.627355318821377
STAT,1879,28,15-19,1907,0.47651912419540166
STAT,1816,48,45-49,1864,0.6012221534771353
STAT,1853,22,na,1875,2089.180878117055
SIM,1920,30,na,1950,4505
STAT,1808,94,na,1902,7.534901112247915
STAT,1882,19,na,1901,2457.6695710167323
STAT,1918,48,50-100,1966,0.24231875048865034
STAT,1858,53,na,1911,1678.747263121656
SIM,1879,83,na,1962,572
STAT,1851,50,30-34,1901,0.00457196814456662
STAT,1929,23,20-24,1952,141.68626810742072
STAT,1935,15,45-49,1950,0.6931658426301406
STAT,1833,23,20-24,1856,65.30873755180242
STAT,1875,40,15-19,1915,0.014468329028562554
STAT,1889,34,50-100,1923,1.131317361013177
STAT,1900,31,35-39,1931,14.266451025476377
SIM,1865,27,25-29,1892,2
SIM,1925,19,45-49,1944,1
SIM,1866,33,na,1899,2411
SIM,1924,44,na,1968,4461
STAT,1894,39,20-24,1933,0.9922737427257357
SIM,1930,28,40-44,1958,6
STAT,1946,15,20-24,1961,151.9565803797935
SIM,1836,19,na,1855,2296
SIM,1882,87,na,1969,288
STAT,1778,79,na,1857,289.71375344353476
SIM,1910,30,30-34,1940,20
STAT,1849,17,na,1866,2209.130888869434
SIM,1936,19,20-24,1955,169
STAT,1847,52,50-100,1899,0.011247789555136344
STAT,1928,19,20-24,1947,171.74139983649323
SIM,1848,35,25-29,1883,6
STAT,1873,15,15-19,1888,6.1486612480651965
SIM,1907,15,35-39,1922,4
STAT,1835,31,30-34,1866,16.864251518427608
STAT,1908,61,na,1969,3089.588937963256
SIM,1841,23,20-24,1864,5
SIM,1926,20,40-44,1946,4
STAT,1811,98,na,1909,1.4161776139808613
SIM,1899,30,25-29,1929,21
STAT,1915,36,25-29,1951,1.008490488581895
STAT,1913,42,25-29,1955,0.07026158467942459
STAT,1859,35,35-39,1894,5.800152257549991
STAT,1879,31,na,1910,2525.450007097328
STAT,1910,41,45-49,1951,0.15960541273524784
SIM,1929,29,30-34,1958,65
SIM,1874,68,na,1942,1475
STAT,1779,80,na,1859,282.6418659643989
STAT,1858,25,50-100,1883,0.5264268844701337
SIM,1843,31,30-34,1874,27
STAT,1847,19,50-100,1866,0.04524505797628701
STAT,1914,29,45-49,1943,1.7446284049034797
STAT,1776,104,na,1880,0.02830831342094313
STAT,1869,42,40-44,1911,2.2059762409046706
STAT,1856,103,na,1959,0.23004382251904273
SIM,1856,39,na,1895,2113
STAT,1861,57,na,1918,1686.6433408576813
STAT,1872,38,30-34,1910,5.384922245063978
SIM,1852,25,na,1877,1894
STAT,1839,39,na,1878,1777.3089099297347
STAT,1885,22,30-34,1907,17.907360200586417
SIM,1837,20,na,1857,1790
SIM,1895,33,45-49,1928,3
SIM,1778,83,na,1861,67
STAT,1938,29,30-34,1967,39.14970496095123
SIM,1923,36,25-29,1959,1
STAT,1887,33,45-49,1920,1.9581157614120088
STAT,1912,18,30-34,1930,2.4801277413599374
SIM,1922,29,45-49,1951,4
STAT,1781,112,na,1893,1.0982762218258592E-4
STAT,1830,49,50-100,1879,0.20017406556496992
SIM,1920,14,na,1934,4795
STAT,1918,23,45-49,1941,1.2213582858677952
STAT,1900,65,na,1965,2610.7654855020687
STAT,1904,33,45-49,1937,1.4451825359429098
SIM,1804,89,na,1893,38
SIM,1924,28,na,1952,4380
STAT,1866,88,na,1954,128.39208525963568
SIM,1845,55,na,1900,1695
STAT,1920,4,na,1924,4572.902362486424
SIM,1827,42,na,1869,1535
STAT,1904,19,35-39,1923,0.7910442691763993
SIM,1799,93,na,1892,2
STAT,1865,48,40-44,1913,0.15590633130606307
SIM,1878,33,45-49,1911,3
STAT,1860,43,35-39,1903,1.4842559969696518
STAT,1917,41,30-34,1958,0.1348649521057346
STAT,1857,49,45-49,1906,0.18214158796401966
STAT,1858,69,na,1927,1162.8616889387097
SIM,1863,38,30-34,1901,11
STAT,1839,28,50-100,1867,0.5672368751117847
STAT,1862,74,na,1936,967.980126122666
STAT,1894,20,30-34,1914,23.300139063838355
STAT,1907,34,25-29,1941,8.648628079931152
STAT,1909,25,45-49,1934,1.6916305551345396
STAT,1820,36,50-100,1856,3.239089887785501
SIM,1826,31,30-34,1857,30
SIM,1894,72,na,1966,2011
STAT,1835,25,na,1860,2146.669935097791
STAT,1917,47,15-19,1964,3.8837817167014515E-4
STAT,1839,19,30-34,1858,1.4608553610186432
STAT,1887,50,na,1937,2462.9698562420103
SIM,1905,29,45-49,1934,2
SIM,1847,19,30-34,1866,2
SIM,1889,36,25-29,1925,4
STAT,1878,14,na,1892,2698.8783418242497
SIM,1828,42,45-49,1870,3
SIM,1886,32,40-44,1918,10
STAT,1851,3,na,1854,2601.0
STAT,1881,17,15-19,1898,5.777673637515756
STAT,1844,61,na,1905,1478.4349386175584
STAT,1878,32,40-44,1910,4.546851109280276
STAT,1848,75,na,1923,840.5130093367948
SIM,1872,17,15-19,1889,7
STAT,1919,45,na,1964,4042.2298490797616
SIM,1861,61,na,1922,1555
STAT,1895,32,40-44,1927,5.719970228002626
SIM,1813,93,na,1906,2
STAT,1810,52,35-39,1862,0.03154603717550146
SIM,1932,34,25-29,1966,24
SIM,1817,41,30-34,1858,4
SIM,1869,89,na,1958,159
SIM,1936,13,na,1949,3929
SIM,1927,16,15-19,1943,77
STAT,1878,73,na,1951,1245.3049427025692
STAT,1871,46,15-19,1917,4.025089076873147E-4
STAT,1913,31,45-49,1944,1.5860824895722088
STAT,1876,32,30-34,1908,18.207743064190844
SIM,1884,32,30-34,1916,31
STAT,1859,23,40-44,1882,1.7436774953448453
STAT,1938,16,25-29,1954,43.261196799090115
STAT,1923,19,45-49,1942,0.5894961983722251
SIM,1946,16,25-29,1962,67
SIM,1836,41,40-44,1877,5
STAT,1924,34,25-29,1958,10.882427612814972
SIM,1857,56,na,1913,1748
STAT,1848,34,20-24,1882,2.2939109475018085
STAT,1853,38,20-24,1891,0.6343120679839539
SIM,1819,43,50-100,1862,3
STAT,1901,32,50-100,1933,1.2972730824650216
STAT,1919,16,15-19,1935,10.184335659954156
STAT,1924,45,50-100,1969,0.2733806496523626
STAT,1904,37,50-100,1941,0.3840923441692795
SIM,1902,31,35-39,1933,23
SIM,1869,43,45-49,1912,1
STAT,1895,31,50-100,1926,1.2134329987264263
STAT,1874,38,40-44,1912,4.504713095365196
SIM,1900,20,20-24,1920,4
STAT,1833,107,na,1940,0.0033365172877690757
STAT,1831,42,50-100,1873,0.8167901347110629
STAT,1898,36,50-100,1934,1.6891270755384207
STAT,1865,52,25-29,1917,0.0032492526309684903
SIM,1856,34,20-24,1890,3
STAT,1828,41,40-44,1869,2.184597953071026
STAT,1933,24,25-29,1957,123.72759245421162
SIM,1909,39,30-34,1948,3
SIM,1802,82,na,1884,133
SIM,1886,53,na,1939,2412
STAT,1899,51,na,1950,2998.979844017485
STAT,1858,19,40-44,1877,0.1673089635576876
STAT,1892,15,25-29,1907,7.215261823982395
SIM,1867,23,40-44,1890,3
STAT,1904,44,25-29,1948,0.06376106964377773
SIM,1833,24,25-29,1857,53
STAT,1864,17,15-19,1881,5.59515275158196
STAT,1833,41,50-100,1874,0.920735000840108
STAT,1952,15,na,1967,4458.903617053386
STAT,1767,95,na,1862,1.914139549997694
SIM,1941,24,25-29,1965,153
STAT,1836,46,50-100,1882,0.1642338724613069
STAT,1922,46,50-100,1968,0.2631485993477746
STAT,1930,31,45-49,1961,2.053726573409342
STAT,1770,99,na,1869,0.17982304410736505
SIM,1882,38,40-44,1920,5
STAT,1841,37,na,1878,1887.0860903933687
STAT,1815,80,na,1895,267.77696522842587
STAT,1894,36,na,1930,3078.3055209680224
SIM,1877,17,na,1894,2678
SIM,1865,75,na,1940,814
STAT,1803,79,na,1882,355.0992193637888
STAT,1807,47,40-44,1854,0.6165462651278741
STAT,1824,51,25-29,1875,0.004075503141719685
SIM,1850,35,40-44,1885,7
STAT,1883,36,na,1919,2339.7878815392905
STAT,1921,27,na,1948,4216.759963819905
STAT,1841,47,40-44,1888,0.12860624152779157
STAT,1887,25,45-49,1912,1.2605229909947249
STAT,1915,42,35-39,1957,0.2045660140346208
STAT,1855,27,15-19,1882,0.35596863572966153
SIM,1891,22,20-24,1913,85
STAT,1839,44,20-24,1883,0.11566718712352118
SIM,1903,29,35-39,1932,14
SIM,1863,68,na,1931,1306
STAT,1868,33,35-39,1901,9.734311506212846
STAT,1825,38,45-49,1863,3.158488093554842
STAT,1844,48,20-24,1892,0.009374915663928597
STAT,1939,16,50-100,1955,0.37870220702161383
STAT,1888,18,15-19,1906,7.056111728809536
SIM,1876,33,35-39,1909,16
STAT,1865,23,na,1888,2191.8431195415446
SIM,1862,34,45-49,1896,2
SIM,1915,22,30-34,1937,40
STAT,1784,110,na,1894,2.5944158721512224E-4
STAT,1926,16,50-100,1942,0.46538497633404646
STAT,1854,34,45-49,1888,1.312657709734523
STAT,1890,54,na,1944,2584.3505306930742
STAT,1791,77,na,1868,307.46882669648954
SIM,1890,31,50-100,1921,2
SIM,1804,57,na,1861,1273
STAT,1892,29,45-49,1921,1.3971177258331304
STAT,1847,85,na,1932,205.25459857873716
STAT,1877,39,20-24,1916,0.7954634734748449
STAT,1849,16,35-39,1865,0.5312058167371791
SIM,1904,31,45-49,1935,3
SIM,1939,23,30-34,1962,46
SIM,1824,31,20-24,1855,2
STAT,1853,105,na,1958,0.04468012639922075
STAT,1904,41,45-49,1945,0.15131935496374957
SIM,1844,54,na,1898,1381
STAT,1937,26,na,1963,3688.2276365814105
STAT,1842,35,40-44,1877,4.72036493648531
STAT,1883,22,20-24,1905,68.11113353556834
STAT,1902,33,35-39,1935,14.392961099709682
STAT,1880,49,20-24,1929,0.01246276452784596
STAT,1875,19,40-44,1894,0.18869287320968894
SIM,1918,32,na,1950,4174
SIM,1879,67,na,1946,1855
SIM,1902,23,35-39,1925,12
STAT,1912,40,40-44,1952,0.24614223391638565
STAT,1931,18,40-44,1949,1.845428271349752
STAT,1894,15,35-39,1909,0.7168209577510033
STAT,1919,29,20-24,1948,19.77175467881068
SIM,1875,53,na,1928,2107
STAT,1895,21,na,1916,3128.830269385631
STAT,1899,35,na,1934,3296.7572794538733
SIM,1921,34,25-29,1955,17
STAT,1933,12,na,1945,5359.844477551944
STAT,1779,102,na,1881,0.0989010893339293
STAT,1840,95,na,1935,9.320008265800807
STAT,1778,95,na,1873,2.730840465584822
SIM,1833,38,45-49,1871,1
STAT,1920,24,15-19,1944,5.9386839160238365
STAT,1882,31,50-100,1913,0.9000698916590734
SIM,1865,16,na,1881,2390
SIM,1908,32,40-44,1940,5
STAT,1894,38,50-100,1932,1.5885588099281187
SIM,1927,29,20-24,1956,4
SIM,1910,52,na,1962,3148
STAT,1910,18,20-24,1928,27.032140870258
STAT,1913,34,25-29,1947,9.198743659011129
STAT,1930,31,20-24,1961,3.1834344099596104
SIM,1837,36,na,1873,1615
STAT,1883,36,40-44,1919,4.3474224481490245
SIM,1846,15,20-24,1861,15
STAT,1836,38,20-24,1874,0.5907222806379904
STAT,1812,50,50-100,1862,0.03470120005906311
STAT,1917,16,40-44,1933,0.3045643201406327
STAT,1842,54,na,1896,1885.2622297899777
STAT,1856,54,50-100,1910,0.011373159448118047
SIM,1913,36,40-44,1949,1
STAT,1848,37,25-29,1885,2.422488810613837
SIM,1835,77,na,1912,482
SIM,1910,33,35-39,1943,13
SIM,1819,41,40-44,1860,4
SIM,1906,15,na,1921,3629
STAT,1922,32,25-29,1954,10.549882119004309
SIM,1822,37,30-34,1859,5
STAT,1908,45,na,1953,3403.1968606113564
STAT,1905,28,40-44,1933,4.358416847896054
SIM,1854,91,na,1945,69
STAT,1923,41,30-34,1964,0.1511955782247954
STAT,1799,57,na,1856,1047.6679645421677
SIM,1835,24,35-39,1859,6
SIM,1948,21,30-34,1969,59
STAT,1852,80,na,1932,469.1384450742482
SIM,1885,20,30-34,1905,39
STAT,1840,44,50-100,1884,0.752968806424994
STAT,1854,46,15-19,1900,3.010466800858945E-4
STAT,1856,19,30-34,1875,1.4422282616608555
SIM,1930,32,25-29,1962,20
STAT,1905,36,40-44,1941,1.3862056631011415
SIM,1841,37,40-44,1878,5
SIM,1925,16,40-44,1941,1
STAT,1825,50,50-100,1875,0.020335230579944148
STAT,1869,53,na,1922,2080.3735985995227
STAT,1833,37,40-44,1870,3.8863207565551536
STAT,1928,42,45-49,1970,0.21445088104501273
SIM,1926,23,45-49,1949,2
STAT,1881,28,30-34,1909,24.42993061047561
SIM,1870,22,na,1892,2604
SIM,1896,18,15-19,1914,9
STAT,1881,20,50-100,1901,0.3993794475424584
SIM,1891,36,40-44,1927,10
STAT,1792,78,na,1870,296.8930480996841
STAT,1864,22,na,1886,2190.1367891096834
STAT,1846,24,45-49,1870,0.6436008013420761
SIM,1851,9,na,1860,2426
STAT,1891,42,25-29,1933,0.8020147369175981
STAT,1913,39,50-100,1952,0.4138450881595795
SIM,1874,39,45-49,1913,1
STAT,1907,22,30-34,1929,26.419674685652396
SIM,1840,56,na,1896,1454
STAT,1803,63,na,1866,1081.8774631539084
STAT,1874,24,20-24,1898,70.82243023887875
STAT,1896,28,15-19,1924,0.6044294375489482
STAT,1816,45,40-44,1861,0.4561241712624172
STAT,1924,17,50-100,1941,0.4508409372317245
SIM,1935,12,na,1947,5405
STAT,1856,9,na,1865,2230.7299499196056
STAT,1911,39,20-24,1950,0.254287869545899
STAT,1853,21,50-100,1874,0.40133670071770616
STAT,1921,33,45-49,1954,1.7611565903681512
STAT,1921,19,35-39,1940,4.804873184138245
STAT,1827,44,50-100,1871,1.0981580298089055
STAT,1829,37,15-19,1866,0.046019719463639745
SIM,1816,42,na,1858,1363
STAT,1866,39,45-49,1905,1.845609607303035
STAT,1850,89,na,1939,80.4409330198468
STAT,1888,26,15-19,1914,0.542720200883442
STAT,1917,44,35-39,1961,0.21141077492152233
SIM,1905,26,40-44,1931,5
SIM,1841,26,25-29,1867,45
SIM,1878,30,40-44,1908,14
STAT,1863,1,na,1864,3241.6625052525724
STAT,1850,49,35-39,1899,0.10496168148674868
STAT,1835,41,na,1876,1915.057858740665
STAT,1918,20,40-44,1938,3.682946869470112
STAT,1829,48,30-34,1877,0.07128648508687341
STAT,1887,34,na,1921,2667.875455658156
SIM,1934,22,40-44,1956,5
STAT,1868,16,45-49,1884,0.06457724537567011
STAT,1898,66,na,1964,2465.2768118026843
SIM,1811,43,na,1854,1593
SIM,1899,28,na,1927,3613
SIM,1906,33,20-24,1939,2
STAT,1896,42,50-100,1938,0.09795871052382887
STAT,1822,47,30-34,1869,0.143523089500201
STAT,1904,16,30-34,1920,2.3158581971575933
SIM,1815,57,na,1872,1171
SIM,1961,4,na,1965,5232
STAT,1903,37,20-24,1940,0.239324579532234
SIM,1881,22,na,1903,2084
STAT,1889,49,40-44,1938,0.11775790835319065
STAT,1932,33,20-24,1965,3.274787017916935
SIM,1923,27,na,1950,4322
STAT,1900,39,45-49,1939,0.5976070583951183
SIM,1915,51,na,1966,4061
SIM,1885,36,na,1921,2519
STAT,1883,20,na,1903,2351.4933782200333
STAT,1857,46,40-44,1903,0.1353305699769502
SIM,1852,41,na,1893,1720
STAT,1925,18,40-44,1943,1.7031036220700484
SIM,1918,18,15-19,1936,47
STAT,1952,20,40-44,1972,4.087303178869658
SIM,1801,65,na,1866,624
STAT,1839,55,na,1894,1465.952822763244
STAT,1935,35,15-19,1970,0.02717687724451744
STAT,1885,49,20-24,1934,0.011812164932549333
SIM,1770,87,na,1857,34
SIM,1859,15,30-34,1874,4
STAT,1772,107,na,1879,0.005834699170344693
SIM,1960,11,na,1971,5273
STAT,1880,44,15-19,1924,0.0144505076044068
SIM,1866,92,na,1958,9
STAT,1896,39,30-34,1935,7.053513308505367
STAT,1926,22,40-44,1948,4.128424528545976
SIM,1912,16,30-34,1928,4
STAT,1833,26,25-29,1859,39.87652797022596
STAT,1851,28,45-49,1879,0.9772845713809425
STAT,1869,45,45-49,1914,0.23405257390214798
SIM,1898,17,35-39,1915,4
SIM,1933,29,20-24,1962,37
SIM,1936,20,50-100,1956,1
STAT,1893,19,na,1912,3221.5722755508154
STAT,1906,41,50-100,1947,0.10841169539582299
SIM,1869,35,45-49,1904,1
STAT,1852,49,45-49,1901,0.17524352318739023
STAT,1945,19,20-24,1964,149.46517726097244
SIM,1892,49,na,1941,3009
SIM,1796,80,na,1876,247
SIM,1924,15,35-39,1939,5
STAT,1871,48,50-100,1919,0.24334444567138067
STAT,1837,104,na,1941,0.045501405832312755
STAT,1849,33,na,1882,1945.7197285178247
SIM,1895,14,na,1909,3417
STAT,1840,16,15-19,1856,5.418040164404876
STAT,1853,22,35-39,1875,5.701891859517416
SIM,1848,27,25-29,1875,44
STAT,1904,30,40-44,1934,6.3362439412013565
STAT,1898,33,20-24,1931,3.685433294523628
STAT,1913,38,40-44,1951,1.4831685938402803
STAT,1823,46,50-100,1869,0.34289391754736914
STAT,1857,68,na,1925,1204.5930510813662
SIM,1876,25,35-39,1901,14
STAT,1891,28,50-100,1919,0.7971056574347967
STAT,1868,30,30-34,1898,16.989178329257875
STAT,1924,31,20-24,1955,2.877287504315551
STAT,1928,20,50-100,1948,0.8353368270772478
STAT,1853,54,na,1907,1731.6532961496698
SIM,1947,13,na,1960,4831
SIM,1921,38,40-44,1959,4
SIM,1913,28,40-44,1941,5
STAT,1850,41,25-29,1891,0.4939333769799547
STAT,1852,37,na,1889,1796.4491311125325
STAT,1817,49,50-100,1866,0.5115869195999583
STAT,1916,15,35-39,1931,0.9026103591600579
STAT,1873,42,na,1915,2363.5869589217577
STAT,1946,23,20-24,1969,124.93427800681836
STAT,1828,44,45-49,1872,1.3815317346449916
SIM,1902,17,na,1919,3829
STAT,1904,41,20-24,1945,0.016056956034775086
SIM,1930,26,15-19,1956,1
STAT,1925,29,20-24,1954,21.633125111403725
STAT,1833,48,45-49,1881,0.17636271152383934
STAT,1902,43,50-100,1945,0.10395053884606943
STAT,1879,15,na,1894,2674.3564003902347
STAT,1806,53,50-100,1859,0.04271439445750334
STAT,1914,38,35-39,1952,2.424494404520804
STAT,1906,43,20-24,1949,0.016106577615969543
SIM,1874,25,25-29,1899,49
SIM,1888,16,15-19,1904,10
STAT,1878,40,40-44,1918,2.3820597234250314
SIM,1925,45,na,1970,4504
STAT,1911,47,20-24,1958,0.010555011813731346
STAT,1880,32,50-100,1912,0.9718712760705548
STAT,1889,30,15-19,1919,0.1787792842955238
SIM,1807,81,na,1888,239
SIM,1835,32,35-39,1867,1
STAT,1921,35,50-100,1956,0.4743001279541454
STAT,1902,36,15-19,1938,0.017382322327655932
SIM,1933,18,40-44,1951,4
SIM,1849,85,na,1934,179
STAT,1929,35,15-19,1964,0.024961922269695805
SIM,1845,71,na,1916,1000
STAT,1832,53,25-29,1885,0.002466860342750614
SIM,1846,56,na,1902,1459
SIM,1912,30,40-44,1942,4
SIM,1931,14,na,1945,5130
SIM,1860,76,na,1936,811
STAT,1841,69,na,1910,1097.4502869780008
STAT,1820,75,na,1895,524.0191331355222
SIM,1935,28,na,1963,5240
STAT,1893,27,50-100,1920,0.820368052140045
STAT,1933,28,40-44,1961,6.250987471393591
SIM,1887,16,20-24,1903,23
SIM,1836,44,45-49,1880,3
SIM,1895,25,45-49,1920,2
STAT,1849,92,na,1941,32.56371472409754
STAT,1909,45,15-19,1954,3.448566894003378E-4
STAT,1840,27,30-34,1867,22.009717580017934
STAT,1869,69,na,1938,1441.0666868295764
STAT,1935,32,35-39,1967,12.773526737096422
STAT,1821,92,na,1913,24.94766272006517
STAT,1914,16,15-19,1930,9.495123354637512
STAT,1931,26,40-44,1957,6.08443186255805
STAT,1922,26,15-19,1948,0.8097708024773113
STAT,1894,23,35-39,1917,7.564633948631839
STAT,1889,38,25-29,1927,3.567950198590639
STAT,1871,35,na,1906,2386.496143204781
STAT,1860,51,35-39,1911,0.007141876347029529
SIM,1840,40,na,1880,1777
STAT,1872,22,45-49,1894,0.7080748895693889
STAT,1950,21,20-24,1971,133.3169649846048
STAT,1864,17,50-100,1881,0.046190024375646725
STAT,1827,32,35-39,1859,13.629522131788844
STAT,1875,49,na,1924,2284.8509440290154
STAT,1895,35,45-49,1930,2.654307074581627
SIM,1889,28,25-29,1917,58
SIM,1922,16,15-19,1938,61
STAT,1796,76,na,1872,361.3748843948302
SIM,1931,16,40-44,1947,1
STAT,1866,25,25-29,1891,39.830065976780595
SIM,1922,38,35-39,1960,3
STAT,1923,16,40-44,1939,1.663564991746925
SIM,1828,34,45-49,1862,1
SIM,1928,25,20-24,1953,24
STAT,1848,48,40-44,1896,0.13802137467152736
STAT,1792,62,na,1854,853.9999999999999
STAT,1842,21,20-24,1863,78.82209958782127
STAT,1923,34,na,1957,4375.148862585026
SIM,1850,21,20-24,1871,73
SIM,1894,56,na,1950,2875
STAT,1831,49,25-29,1880,0.04193420202078184
SIM,1886,40,40-44,1926,5
SIM,1897,21,na,1918,3261
SIM,1890,42,na,1932,3151
STAT,1867,32,50-100,1899,0.8715528575455197
STAT,1943,27,na,1970,4028.467785059698
STAT,1804,104,na,1908,0.020678323098309387
STAT,1814,49,25-29,1863,0.13434028359317637
STAT,1891,39,na,1930,2916.446900839617
STAT,1902,29,na,1931,3381.844619334132
SIM,1824,34,25-29,1858,15
SIM,1805,74,na,1879,393
SIM,1922,18,40-44,1940,4
SIM,1925,19,20-24,1944,179
SIM,1809,88,na,1897,16
STAT,1870,38,20-24,1908,0.7607268494907391
STAT,1875,29,45-49,1904,1.1433949282281208
SIM,1934,30,40-44,1964,9
STAT,1890,18,30-34,1908,1.9619374554427078
SIM,1818,38,na,1856,1452
SIM,1847,15,15-19,1862,10
STAT,1914,15,25-29,1929,9.086423158459056
SIM,1876,47,50-100,1923,1
STAT,1883,25,25-29,1908,42.093161232985615
STAT,1944,22,35-39,1966,10.26613097338402
SIM,1828,31,40-44,1859,6
STAT,1783,85,na,1868,89.50106977905062
STAT,1913,31,20-24,1944,2.458550052238228
STAT,1839,47,25-29,1886,0.04160745568865327
STAT,1847,69,na,1916,1098.8040734276485
STAT,1880,87,na,1967,424.98027507200277
STAT,1917,19,20-24,1936,145.99435533629588
STAT,1931,22,25-29,1953,121.07689708273135
SIM,1816,38,45-49,1854,1
STAT,1872,57,na,1929,2040.621291041052
STAT,1869,50,40-44,1919,0.010486272108930059
STAT,1926,31,30-34,1957,19.265045210261157
STAT,1937,32,45-49,1969,1.5716780434628628
SIM,1884,35,35-39,1919,6
SIM,1883,29,45-49,1912,1
STAT,1863,48,30-34,1911,0.08553687929295122
SIM,1836,41,50-100,1877,3
SIM,1882,27,25-29,1909,7
SIM,1846,22,45-49,1868,1
SIM,1937,30,na,1967,3645
STAT,1867,52,35-39,1919,0.008145530922493815
SIM,1891,28,40-44,1919,4
STAT,1921,41,45-49,1962,0.18959709103541844
STAT,1838,92,na,1930,27.88122038806902
SIM,1831,24,15-19,1855,3
SIM,1932,32,35-39,1964,19
STAT,1878,46,na,1924,2365.553527764392
SIM,1817,44,35-39,1861,3
STAT,1768,109,na,1877,0.005530514498810735
SIM,1867,26,45-49,1893,1
STAT,1902,31,45-49,1933,2.499058929098257
SIM,1904,51,na,1955,3311
STAT,1865,44,25-29,1909,0.5842391428400052
STAT,1882,41,20-24,1923,0.15607737536093386
SIM,1891,25,25-29,1916,75
STAT,1920,29,20-24,1949,20.07651431917999
SIM,1940,1,na,1941,4353
STAT,1839,15,15-19,1854,5.569350539036579
STAT,1866,16,35-39,1882,0.5298488148130752
STAT,1874,42,25-29,1916,0.6632944899244315
STAT,1781,99,na,1880,0.20540503937185928
STAT,1838,22,45-49,1860,0.6056323010856047
STAT,1876,35,35-39,1911,7.44599649093447
SIM,1853,10,na,1863,2187
STAT,1838,17,na,1855,2029.71582703517
STAT,1919,27,30-34,1946,42.7461584648787
SIM,1930,36,40-44,1966,5
STAT,1808,47,50-100,1855,0.89699973183805
SIM,1882,42,25-29,1924,4
STAT,1913,36,15-19,1949,0.019212941421085938
SIM,1831,27,30-34,1858,20
SIM,1873,28,50-100,1901,1
STAT,1919,41,40-44,1960,0.274073199495147
SIM,1918,29,30-34,1947,48
STAT,1807,51,25-29,1858,0.012268438506552862
SIM,1857,24,na,1881,2163
SIM,1927,27,30-34,1954,7
STAT,1907,38,40-44,1945,1.3944701606499603
STAT,1883,28,40-44,1911,2.950307720993117
SIM,1927,41,40-44,1968,4
SIM,1885,68,na,1953,1548
SIM,1863,15,20-24,1878,18
SIM,1882,49,45-49,1931,3
SIM,1832,33,20-24,1865,2
SIM,1838,17,15-19,1855,5
SIM,1915,38,40-44,1953,3
SIM,1898,5,na,1903,3565
STAT,1822,48,20-24,1870,0.017544377034268352
STAT,1846,37,15-19,1883,0.044501872122195044
STAT,1846,109,na,1955,5.399160597276251E-4
STAT,1906,41,30-34,1947,0.11797743348375588
SIM,1904,24,20-24,1928,121
STAT,1891,24,20-24,1915,85.63410916072974
STAT,1851,17,50-100,1868,0.0451020094197372
STAT,1924,32,35-39,1956,10.773565403819362
STAT,1822,93,na,1915,16.340607053106243
STAT,1929,27,15-19,1956,0.8930115432707184
SIM,1876,16,na,1892,2913
SIM,1827,74,na,1901,574
SIM,1934,31,30-34,1965,28
STAT,1819,38,20-24,1857,2.0298260082531643
STAT,1918,48,20-24,1966,0.01183967883140149
STAT,1901,50,na,1951,3092.47259829124
STAT,1836,105,na,1941,0.018487386399390116
STAT,1930,20,40-44,1950,4.3795742958227954
SIM,1874,17,25-29,1891,6
STAT,1866,17,25-29,1883,5.439720858995613
SIM,1857,6,na,1863,2617
STAT,1879,23,45-49,1902,0.7327057357906648
SIM,1887,23,45-49,1910,5
STAT,1914,14,na,1928,4108.47871762999
STAT,1833,41,25-29,1874,0.5596624550090255
STAT,1886,29,20-24,1915,12.420923811733493
STAT,1937,28,25-29,1965,64.74228712066893
STAT,1830,26,na,1856,1881.2055454797219
SIM,1848,48,50-100,1896,2
SIM,1872,54,50-100,1926,3
STAT,1872,6,na,1878,2792.928358062855
STAT,1874,27,25-29,1901,43.74768919207785
STAT,1879,36,15-19,1915,0.059471767931193416
STAT,1905,64,na,1969,2849.9140766253918
STAT,1918,28,na,1946,4010.7253940720007
STAT,1824,33,20-24,1857,4.663297047148571
SIM,1872,28,30-34,1900,37
STAT,1896,20,40-44,1916,2.8025104114844135
STAT,1768,96,na,1864,2.641793367682237
STAT,1874,49,45-49,1923,0.23897277457646998
SIM,1830,41,na,1871,1523
SIM,1865,35,25-29,1900,6
STAT,1879,90,na,1969,256.85606884591175
STAT,1890,15,15-19,1905,7.358219357081922
SIM,1906,26,50-100,1932,1
STAT,1797,98,na,1895,0.8110742732287801
SIM,1835,21,30-34,1856,24
STAT,1851,74,na,1925,840.3183614783171
STAT,1856,51,20-24,1907,5.741390718613182E-4
SIM,1780,86,na,1866,91
STAT,1940,28,35-39,1968,15.448588273792096
STAT,1793,84,na,1877,107.09865279307483
STAT,1910,40,30-34,1950,0.1232827537289002
STAT,1855,88,na,1943,103.33621990420347
STAT,1829,40,na,1869,1577.8674814185822
SIM,1856,55,na,1911,1878
SIM,1869,32,40-44,1901,4
STAT,1848,91,na,1939,47.311984541498035
STAT,1907,25,35-39,1932,14.408653856422186
STAT,1951,19,50-100,1970,0.45045309397788286
SIM,1894,29,20-24,1923,20
SIM,1913,28,na,1941,3720
STAT,1855,15,20-24,1870,16.060750832989665
STAT,1913,23,45-49,1936,1.1428457928731288
SIM,1834,55,na,1889,1443
SIM,1902,20,30-34,1922,43
STAT,1905,32,25-29,1937,8.587271615117405
SIM,1937,27,15-19,1964,1
SIM,1859,30,30-34,1889,38
STAT,1811,48,45-49,1859,0.5782951624863109
STAT,1899,40,25-29,1939,0.062435964475907185
SIM,1915,25,35-39,1940,27
STAT,1851,95,na,1946,10.06721934418041
STAT,1855,38,30-34,1893,3.9917863310214488
STAT,1914,18,40-44,1932,0.29115822079615017
SIM,1913,32,25-29,1945,12
SIM,1835,93,na,1928,7
STAT,1926,30,40-44,1956,4.787764525326092
SIM,1874,48,50-100,1922,2
SIM,1921,23,45-49,1944,1
STAT,1891,46,40-44,1937,0.12110286109321326
STAT,1905,21,45-49,1926,1.0212307625383186
SIM,1875,32,50-100,1907,1
SIM,1777,82,na,1859,104
STAT,1826,51,35-39,1877,0.008345739427808984
SIM,1903,18,30-34,1921,2
STAT,1872,36,na,1908,2403.8227364517124
SIM,1844,46,50-100,1890,3
STAT,1862,28,20-24,1890,10.196391918655989
STAT,1938,27,40-44,1965,4.661746456019076
SIM,1934,25,45-49,1959,5
SIM,1843,34,35-39,1877,5
STAT,1950,22,35-39,1972,11.285497278738335
SIM,1870,28,20-24,1898,16
STAT,1955,17,15-19,1972,60.865119772811966
SIM,1898,45,50-100,1943,1
SIM,1853,28,20-24,1881,16
STAT,1845,28,20-24,1873,10.358749176489235
STAT,1817,55,na,1872,1157.6283182208235
SIM,1937,26,25-29,1963,83
STAT,1805,59,na,1864,1197.7153234694974
STAT,1926,25,45-49,1951,2.1072892210886276
STAT,1946,26,25-29,1972,74.08601503611916
STAT,1813,41,na,1854,1428.4583670321754
STAT,1836,51,40-44,1887,0.006854182206925335
STAT,1841,40,20-24,1881,0.12661233534868407
STAT,1835,34,35-39,1869,9.481667433770392
SIM,1845,43,50-100,1888,1
SIM,1909,20,40-44,1929,6
STAT,1930,31,na,1961,4936.087609771241
STAT,1922,49,na,1971,4238.679132958822
STAT,1892,40,15-19,1932,0.017678895060620616
STAT,1811,53,40-44,1864,0.024576638752053015
SIM,1815,89,na,1904,48
STAT,1850,23,20-24,1873,62.87928263544681
STAT,1928,42,20-24,1970,0.02275603388200715
SIM,1861,48,50-100,1909,1
STAT,1866,22,20-24,1888,64.97544339964207
SIM,1851,40,na,1891,1855
STAT,1937,3,na,1940,3983.5418463581445
STAT,1842,24,25-29,1866,64.0772380134107
STAT,1900,40,25-29,1940,0.06319535197408653
SIM,1913,21,45-49,1934,1
SIM,1919,19,20-24,1938,163
STAT,1846,21,40-44,1867,1.9653042757230426
SIM,1854,21,40-44,1875,2
SIM,1895,7,na,1902,3450
STAT,1929,26,25-29,1955,83.29832987849181
SIM,1874,22,20-24,1896,91
SIM,1794,78,na,1872,354
SIM,1820,63,na,1883,945
STAT,1823,56,na,1879,1232.031818828127
STAT,1841,48,30-34,1889,0.07179093084727786
STAT,1936,16,15-19,1952,43.97329689836197
SIM,1848,23,30-34,1871,30
STAT,1861,4,na,1865,2571.20463315752
SIM,1906,47,na,1953,3149
STAT,1862,23,50-100,1885,0.36149449833536984
STAT,1841,96,na,1937,6.4212273794186645
STAT,1911,20,30-34,1931,27.66421050793961
STAT,1865,28,50-100,1893,0.5878834854516816
SIM,1944,16,15-19,1960,46
STAT,1871,94,na,1965,63.701354176428765
STAT,1777,78,na,1855,218.2968
STAT,1815,50,20-24,1865,0.0016281478193878177
STAT,1858,54,35-39,1912,0.006634110659701642
SIM,1790,64,na,1854,1010
SIM,1855,17,15-19,1872,8
SIM,1953,17,30-34,1970,19
SIM,1862,41,50-100,1903,2
SIM,1907,23,35-39,1930,15
STAT,1850,45,40-44,1895,0.1323971182044659
STAT,1906,46,25-29,1952,0.047933619539620234
STAT,1949,11,na,1960,4616.135905265966
SIM,1919,42,45-49,1961,1
SIM,1928,39,40-44,1967,1
SIM,1865,38,40-44,1903,5
STAT,1955,12,na,1967,5268.173964528317
SIM,1917,31,30-34,1948,30
SIM,1824,37,40-44,1861,7
STAT,1901,27,45-49,1928,1.5720309354043045
STAT,1866,21,50-100,1887,0.3872734947854546
SIM,1836,62,na,1898,1303
STAT,1847,17,15-19,1864,5.545823199614898
STAT,1945,17,30-34,1962,13.44655497160791
SIM,1834,37,50-100,1871,2
STAT,1922,39,45-49,1961,0.7819760155243396
SIM,1855,92,na,1947,33
SIM,1850,24,25-29,1874,80
STAT,1929,29,40-44,1958,5.890259012520553
STAT,1882,49,30-34,1931,0.09272669633867055
STAT,1819,53,50-100,1872,0.027719133255761225
STAT,1837,31,40-44,1868,3.7481479817372456
STAT,1832,92,na,1924,28.360093178202625
STAT,1833,77,na,1910,611.553777900473
SIM,1930,39,45-49,1969,1
STAT,1950,22,50-100,1972,0.7886442068225304
SIM,1889,24,30-34,1913,32
STAT,1906,19,45-49,1925,0.0955808203106471
STAT,1848,52,25-29,1900,0.0028765112425162137
STAT,1861,24,35-39,1885,4.959504651831165
SIM,1955,8,na,1963,5058
SIM,1911,21,na,1932,3739
STAT,1884,21,na,1905,2362.688284437291
STAT,1863,49,20-24,1912,0.010514462220039095
STAT,1949,19,40-44,1968,1.6423431446850574
STAT,1888,35,na,1923,2835.2614048071646
STAT,1905,34,15-19,1939,0.11837062253569722
STAT,1808,78,na,1886,324.62878752790067
SIM,1950,12,na,1962,4537
SIM,1917,7,na,1924,4225
STAT,1893,42,35-39,1935,2.3194036144388366
SIM,1865,42,25-29,1907,1
SIM,1908,35,45-49,1943,1
STAT,1955,16,25-29,1971,58.13459510551323
SIM,1888,17,na,1905,3114
SIM,1876,91,na,1967,210
STAT,1878,8,na,1886,2785.236036813046
SIM,1858,34,50-100,1892,1
STAT,1872,27,15-19,1899,0.46069903522053457
STAT,1932,34,35-39,1966,12.260837654756298
SIM,1857,40,na,1897,2044
STAT,1857,84,na,1941,262.21987506652215
STAT,1892,72,na,1964,1864.0154044551848
STAT,1804,64,na,1868,790.0262683608862
STAT,1902,41,35-39,1943,0.18028520674511156
STAT,1922,21,45-49,1943,1.3074518534819513
SIM,1868,40,na,1908,2127
STAT,1847,16,25-29,1863,5.326919444496216
STAT,1887,22,40-44,1909,2.3497985919724513
STAT,1883,16,35-39,1899,0.5436603557317856
SIM,1919,38,25-29,1957,1
STAT,1882,48,40-44,1930,0.16538854660128097
STAT,1822,43,15-19,1865,0.021440637468578973
SIM,1875,0,na,1875,3535
STAT,1903,21,35-39,1924,8.419173630614278
STAT,1864,28,30-34,1892,22.869674846213762
SIM,1930,17,25-29,1947,85
STAT,1922,28,na,1950,4267.291439209741
SIM,1928,9,na,1937,5143
STAT,1911,38,30-34,1949,1.767188445426341
STAT,1820,47,20-24,1867,0.020409186024924177
SIM,1888,4,na,1892,3230
STAT,1919,44,45-49,1963,0.18149639674158277
SIM,1845,31,40-44,1876,10
STAT,1894,20,na,1914,3093.705675547122
STAT,1838,50,50-100,1888,0.010462681647095741
STAT,1869,32,na,1901,2343.2583959651865
STAT,1927,26,15-19,1953,0.8704344099801015
STAT,1898,34,na,1932,3239.3842000021286
STAT,1920,15,50-100,1935,0.08555784624568528
SIM,1934,27,na,1961,5179
STAT,1857,102,na,1959,0.46450212415881387
STAT,1844,21,30-34,1865,17.723026798907362
SIM,1864,69,na,1933,1700
SIM,1913,37,30-34,1950,5
SIM,1900,34,50-100,1934,1
STAT,1900,47,45-49,1947,0.18590322142984278
SIM,1841,41,na,1882,1674
SIM,1849,21,na,1870,2069
STAT,1780,113,na,1893,1.0438920615097312E-4
STAT,1861,39,45-49,1900,1.6562548117846325
STAT,1849,39,45-49,1888,1.5620937416627207
STAT,1909,46,50-100,1955,0.21024728533660747
STAT,1821,40,40-44,1861,3.8000034855008504
SIM,1853,1,na,1854,2955
SIM,1896,17,25-29,1913,10
STAT,1884,25,50-100,1909,0.6414529242680015
STAT,1906,44,35-39,1950,0.18248932823280284
STAT,1922,17,25-29,1939,50.665492919083206
STAT,1898,39,40-44,1937,1.2806703538810564
SIM,1932,3,na,1935,6098
STAT,1864,25,15-19,1889,0.4179183483310097
STAT,1947,19,30-34,1966,13.859666255129772
SIM,1919,45,50-100,1964,2
STAT,1917,40,40-44,1957,0.2642088043451635
STAT,1854,39,na,1893,1750.3337738136993
SIM,1862,41,45-49,1903,2
SIM,1949,17,40-44,1966,2
STAT,1865,37,25-29,1902,2.655356879297216
SIM,1878,26,20-24,1904,13
SIM,1911,21,35-39,1932,14
STAT,1814,63,na,1877,1016.6549004854909
STAT,1906,16,40-44,1922,0.26973016448673615
STAT,1779,96,na,1875,1.7931091129498067
SIM,1930,13,na,1943,5502
STAT,1802,78,na,1880,315.0446961724752
STAT,1900,25,25-29,1925,59.752010888909496
SIM,1917,46,50-100,1963,1
SIM,1939,20,15-19,1959,7
SIM,1860,44,na,1904,2041
SIM,1882,24,20-24,1906,73
STAT,1859,91,na,1950,47.07307310301452
SIM,1876,54,na,1930,2417
STAT,1937,22,50-100,1959,0.6468741287430455
STAT,1909,46,na,1955,3415.0049040935287
STAT,1950,20,30-34,1970,34.471756634863006
STAT,1886,49,na,1935,2349.120685117675
STAT,1882,35,na,1917,2326.8550576378575
STAT,1847,41,15-19,1888,0.010531666977859672
STAT,1811,93,na,1904,12.740595214964273
SIM,1871,87,na,1958,294
STAT,1923,28,35-39,1951,17.354989285539112
STAT,1952,15,45-49,1967,0.6051483566469915
SIM,1945,22,50-100,1967,1
SIM,1887,20,40-44,1907,3
STAT,1857,35,25-29,1892,2.2910646693315364
STAT,1937,25,20-24,1962,17.979236864810265
SIM,1917,10,na,1927,4193
STAT,1927,29,30-34,1956,47.95264181099062
STAT,1885,16,45-49,1901,0.06583246805784232
STAT,1888,17,25-29,1905,6.755373179560519
STAT,1838,38,30-34,1876,4.260578226397307
STAT,1852,41,35-39,1893,1.3795204752186037
STAT,1912,50,na,1962,3529.9857196165467
SIM,1946,12,na,1958,4456
STAT,1852,54,40-44,1906,0.007764527538090468
STAT,1797,77,na,1874,350.66419225581416
STAT,1913,20,40-44,1933,3.3069725895932907
STAT,1916,38,45-49,1954,0.7010245926744391
STAT,1831,29,30-34,1860,21.215424952023024
STAT,1792,99,na,1891,0.340456703382096
STAT,1865,34,20-24,1899,2.471568833054736
STAT,1793,63,na,1856,836.25374356
STAT,1856,54,25-29,1910,0.0026673207638036236
SIM,1797,59,na,1856,941
STAT,1830,96,na,1926,5.664959890270965
STAT,1877,72,na,1949,1316.4710982508518
STAT,1891,27,25-29,1918,52.89700422829461
STAT,1908,29,20-24,1937,17.29465669384564
STAT,1843,92,na,1935,28.091188125696164
STAT,1861,48,20-24,1909,0.009944814779467416
STAT,1865,41,20-24,1906,0.14712899709473612
SIM,1904,27,25-29,1931,69
STAT,1875,54,35-39,1929,0.008683912285864926
STAT,1869,31,50-100,1900,0.9033919044713347
STAT,1855,15,50-100,1870,0.04438305343709079
STAT,1820,49,25-29,1869,0.0950341719815852
SIM,1829,26,25-29,1855,10
STAT,1860,18,45-49,1878,0.06183451330637936
SIM,1850,18,na,1868,2194
STAT,1896,23,45-49,1919,0.9293832991920739
SIM,1859,33,35-39,1892,15
STAT,1891,49,45-49,1940,0.16299249630191387
SIM,1916,29,20-24,1945,3
SIM,1852,21,30-34,1873,22
STAT,1827,92,na,1919,24.767186835451625
STAT,1941,23,20-24,1964,115.9750215997973
SIM,1849,16,25-29,1865,9
STAT,1829,32,45-49,1861,1.5532260025175442
STAT,1953,16,15-19,1969,55.48296086027961
SIM,1892,25,50-100,1917,1
SIM,1935,29,30-34,1964,75
STAT,1880,48,30-34,1928,0.10138663897076332
STAT,1842,27,40-44,1869,3.335256449879993
STAT,1863,21,40-44,1884,1.915696947403163
STAT,1898,36,25-29,1934,3.9611961499419355
SIM,1883,72,na,1955,1359
SIM,1893,25,35-39,1918,16
STAT,1867,31,15-19,1898,0.13601488205948514
STAT,1910,29,50-100,1939,0.9627912901174644
STAT,1877,52,40-44,1929,0.010915845670232072
SIM,1857,39,45-49,1896,1
STAT,1931,24,15-19,1955,6.9338949355308275
STAT,1941,31,na,1972,4011.27879315578
SIM,1915,31,20-24,1946,3
SIM,1830,78,na,1908,348
STAT,1931,28,30-34,1959,51.10059374466189
STAT,1897,49,na,1946,2983.3644287574975
SIM,1837,32,45-49,1869,2
STAT,1905,37,30-34,1942,1.6796112356414103
STAT,1849,17,25-29,1866,5.453652590964951
SIM,1934,34,35-39,1968,2
STAT,1813,78,na,1891,342.5822671782824
SIM,1857,17,25-29,1874,8
STAT,1824,36,25-29,1860,4.140429480020955
STAT,1926,34,35-39,1960,11.153317838948402
STAT,1789,95,na,1884,3.2233840347875917
STAT,1893,35,na,1928,3050.0974709184297
STAT,1868,68,na,1936,1475.1551435624465
SIM,1841,50,50-100,1891,1
SIM,1937,23,20-24,1960,109
STAT,1885,25,35-39,1910,9.76624268400408
STAT,1911,34,15-19,1945,0.12516343812793262
STAT,1932,31,30-34,1963,21.178056175329363
STAT,1862,41,40-44,1903,1.9707410249568333
STAT,1934,26,50-100,1960,1.3535621379997207
SIM,1867,32,30-34,1899,28
STAT,1926,39,50-100,1965,0.5174857254231142
STAT,1930,38,40-44,1968,1.9715677580051345
STAT,1917,42,45-49,1959,0.1753146206586175
SIM,1932,30,30-34,1962,31
STAT,1899,15,35-39,1914,0.7641280299994921
STAT,1953,19,30-34,1972,14.88716077930864
STAT,1932,36,25-29,1968,1.3381333423551198
STAT,1879,39,50-100,1918,1.2810167117607176
STAT,1932,27,na,1959,4958.5851746514845
SIM,1904,32,50-100,1936,1
SIM,1869,20,35-39,1889,10
STAT,1942,28,45-49,1970,1.8298629500836185
SIM,1858,41,40-44,1899,5
SIM,1837,25,20-24,1862,10
STAT,1769,108,na,1877,0.004090016988732115
STAT,1861,73,na,1934,996.8571903113632
STAT,1907,31,20-24,1938,2.3115205517086386
STAT,1863,30,50-100,1893,0.8265295541316001
STAT,1865,87,na,1952,162.4837853238405
STAT,1833,49,35-39,1882,0.1032901102662828
SIM,1826,34,35-39,1860,20
SIM,1892,41,30-34,1933,1
STAT,1890,41,50-100,1931,1.3097310656747454
STAT,1862,58,na,1920,1724.9006744124363
SIM,1941,21,20-24,1962,132
SIM,1963,1,na,1964,5088
STAT,1888,42,15-19,1930,0.016442590717712594
SIM,1816,74,na,1890,450
SIM,1929,27,40-44,1956,9
STAT,1850,26,25-29,1876,38.3931395208992
SIM,1833,21,20-24,1854,94
STAT,1901,9,na,1910,3673.630569574343
STAT,1918,32,35-39,1950,9.803732998321863
SIM,1903,15,15-19,1918,7
SIM,1940,31,30-34,1971,3
STAT,1887,38,15-19,1925,0.06300838460394405
SIM,1898,18,25-29,1916,14
SIM,1921,20,40-44,1941,4
STAT,1930,23,45-49,1953,1.45237755100887
STAT,1781,78,na,1859,170.58121426045219
STAT,1931,27,30-34,1958,51.12513380889015
SIM,1943,23,50-100,1966,1
SIM,1819,44,45-49,1863,3
STAT,1851,36,na,1887,1821.8404453763494
STAT,1801,106,na,1907,0.004832155068443979
STAT,1844,18,na,1862,2294.9993847018654
STAT,1863,44,15-19,1907,0.012191461687929669
SIM,1945,25,20-24,1970,29
STAT,1874,46,40-44,1920,0.17755594509692896
SIM,1846,38,30-34,1884,8
STAT,1844,15,45-49,1859,0.06647765567224645
STAT,1869,52,45-49,1921,0.014174724977236302
STAT,1922,36,40-44,1958,1.7223739648416267
SIM,1846,40,na,1886,1707
STAT,1859,32,30-34,1891,14.183149584778139
SIM,1824,93,na,1917,7
STAT,1842,59,na,1901,1749.7682874034151
STAT,1829,25,20-24,1854,30.73303094848158
SIM,1926,32,35-39,1958,18
SIM,1849,15,25-29,1864,6
SIM,1865,91,na,1956,100
SIM,1905,16,15-19,1921,7
SIM,1876,15,30-34,1891,4
STAT,1877,23,35-39,1900,6.064243904927777
STAT,1885,86,na,1971,527.3352721470134
STAT,1841,43,25-29,1884,0.4926505222457346
STAT,1851,50,50-100,1901,0.011599952204596007
STAT,1896,16,20-24,1912,23.75986116978501
STAT,1915,33,20-24,1948,2.496105002741784
STAT,1834,53,35-39,1887,0.005153985160994007
STAT,1840,74,na,1914,777.9480914369313
SIM,1866,17,na,1883,2626
SIM,1868,16,35-39,1884,1
STAT,1881,72,na,1953,1229.5108555401164
STAT,1844,88,na,1932,108.61660745807947
STAT,1840,39,25-29,1879,2.3380699885723635
STAT,1871,20,25-29,1891,57.784362027378165
SIM,1887,39,50-100,1926,2
STAT,1859,26,45-49,1885,0.9241424218080163
STAT,1897,71,na,1968,2153.40094484464
SIM,1913,38,30-34,1951,4
SIM,1885,23,35-39,1908,10
SIM,1846,18,na,1864,2098
SIM,1910,4,na,1914,3842
STAT,1880,31,45-49,1911,1.8572495100906947
STAT,1895,40,40-44,1935,2.9966476517134306
STAT,1850,48,45-49,1898,0.17843785240539406
STAT,1849,15,20-24,1864,17.26469631587528
SIM,1925,13,na,1938,4852
SIM,1842,28,45-49,1870,2
STAT,1859,54,na,1913,1700.9957654991772
STAT,1952,16,50-100,1968,0.4537478021683723
STAT,1815,53,25-29,1868,0.007358975091889024
STAT,1863,21,na,1884,2174.2476144936086
STAT,1877,20,30-34,1897,18.678726196316067
STAT,1855,22,45-49,1877,0.6131999924868904
STAT,1878,35,45-49,1913,2.109930399173823
STAT,1911,23,35-39,1934,8.981475406524183
STAT,1842,22,na,1864,2428.0308758850583
SIM,1889,38,50-100,1927,1
STAT,1933,21,20-24,1954,149.49507925560857
STAT,1905,48,50-100,1953,0.19973845197174936
STAT,1868,15,30-34,1883,1.5850208805054533
STAT,1904,48,40-44,1952,0.13821315456248667
STAT,1924,38,40-44,1962,1.7819645525825594
STAT,1845,110,na,1955,2.0191638357813639E-4
SIM,1922,15,25-29,1937,74
STAT,1857,38,40-44,1895,3.4334270837600256
STAT,1924,30,30-34,1954,18.65824388173082
SIM,1897,53,na,1950,2889
SIM,1941,15,35-39,1956,6
SIM,1932,38,40-44,1970,6
SIM,1905,38,35-39,1943,5
STAT,1832,30,15-19,1862,0.129503156793235
STAT,1834,52,50-100,1886,0.009222414057371425
STAT,1836,22,35-39,1858,4.858373310085173
STAT,1905,38,30-34,1943,1.6712803639126286
STAT,1858,51,30-34,1909,0.004739288067358353
STAT,1831,26,15-19,1857,0.4045775752717732
SIM,1889,33,20-24,1922,4
STAT,1842,81,na,1923,486.86906973346447
STAT,1909,22,40-44,1931,3.1534459307687075
SIM,1844,22,35-39,1866,8
STAT,1882,44,25-29,1926,0.6197725383723977
SIM,1870,41,40-44,1911,2
STAT,1935,23,50-100,1958,0.9049867822549896
STAT,1854,18,50-100,1872,0.04372393717884648
SIM,1907,32,na,1939,3793
STAT,1860,52,25-29,1912,0.0029088119312782055
STAT,1879,16,45-49,1895,0.0690190052007895
STAT,1944,12,na,1956,4268.735501804941
STAT,1787,99,na,1886,0.31021583055544927
SIM,1908,44,35-39,1952,1
STAT,1879,39,30-34,1918,5.560837668495246
SIM,1900,23,25-29,1923,84
STAT,1912,27,20-24,1939,18.148530472442356
SIM,1867,35,35-39,1902,7
STAT,1933,15,35-39,1948,5.702581708551722
SIM,1831,63,na,1894,1213
STAT,1838,35,15-19,1873,0.04631157638906076
STAT,1934,19,20-24,1953,184.29807034539314
STAT,1812,56,na,1868,1190.0124288621134
SIM,1783,78,na,1861,329
SIM,1942,19,20-24,1961,1
STAT,1861,20,40-44,1881,1.8227936980402843
SIM,1921,31,20-24,1952,3
SIM,1913,48,50-100,1961,1
SIM,1917,22,40-44,1939,5
STAT,1807,93,na,1900,10.352515466197126
SIM,1857,15,20-24,1872,25
SIM,1887,39,30-34,1926,12
SIM,1910,36,na,1946,3403
SIM,1821,40,45-49,1861,1
SIM,1825,78,na,1903,350
STAT,1834,28,45-49,1862,0.8608481825795493
STAT,1925,42,40-44,1967,0.30603809375180335
STAT,1908,18,40-44,1926,0.27316677943386525
SIM,1920,27,20-24,1947,28
STAT,1809,73,na,1882,599.0341566087749
SIM,1914,28,35-39,1942,21
STAT,1843,40,30-34,1883,0.8190980737478833
STAT,1889,30,na,1919,2995.7864649601856
STAT,1843,22,50-100,1865,0.34523336759866013
SIM,1842,26,na,1868,2000
STAT,1822,77,na,1899,483.3020405859114
STAT,1852,46,40-44,1898,0.13020533170273696
SIM,1850,45,na,1895,1892
SIM,1947,22,15-19,1969,8
SIM,1853,30,25-29,1883,20
STAT,1910,17,45-49,1927,0.09986420662037807
STAT,1938,19,40-44,1957,1.3919727790844076
STAT,1828,51,45-49,1879,0.013022307943464434
STAT,1928,43,20-24,1971,0.022720079348473574
STAT,1889,45,25-29,1934,0.07244986914502786
SIM,1835,40,na,1875,1552
SIM,1837,41,na,1878,1532
STAT,1829,44,15-19,1873,0.010412116699346854
STAT,1868,29,15-19,1897,0.43482477486464094
STAT,1921,49,50-100,1970,0.2560107370728754
STAT,1827,48,50-100,1875,0.24859221846296672
STAT,1941,25,35-39,1966,15.693711281663226
STAT,1861,31,35-39,1892,8.534179258211653
SIM,1857,36,40-44,1893,14
SIM,1860,37,50-100,1897,4
STAT,1909,38,15-19,1947,0.018251033886193275
STAT,1887,37,15-19,1924,0.06332246402551063
STAT,1835,30,40-44,1865,4.232534311620088
STAT,1894,5,na,1899,3407.708948496089
SIM,1791,70,na,1861,541
STAT,1839,93,na,1932,20.72001125913065
SIM,1857,18,25-29,1875,9
SIM,1871,17,na,1888,2427
STAT,1895,42,45-49,1937,0.1369107853413292
STAT,1834,62,na,1896,1087.917684588624
SIM,1863,95,na,1958,36
SIM,1834,43,35-39,1877,1
SIM,1858,35,na,1893,1971
SIM,1851,40,30-34,1891,1
STAT,1842,28,40-44,1870,3.311309308569854
STAT,1870,34,40-44,1904,4.264280095072023
STAT,1901,19,45-49,1920,0.09199136385057506
STAT,1841,41,20-24,1882,0.1250005603196953
STAT,1780,98,na,1878,0.50890540859089
STAT,1873,31,15-19,1904,0.14640846247662775
SIM,1810,80,na,1890,364
SIM,1898,65,na,1963,2516
STAT,1893,34,35-39,1927,12.876176826029972
STAT,1843,23,na,1866,1797.1318067479585
STAT,1913,49,45-49,1962,0.2127796464674205
STAT,1849,18,25-29,1867,5.421530577204169
STAT,1903,17,50-100,1920,0.07047056803200635
STAT,1894,34,50-100,1928,1.1812259797387563
STAT,1827,86,na,1913,131.94060594479458
SIM,1851,62,na,1913,1463
STAT,1921,48,40-44,1969,0.17901013732958093
SIM,1850,28,40-44,1878,4
STAT,1880,47,30-34,1927,0.10219809181981264
STAT,1900,21,30-34,1921,25.066281417964866
SIM,1884,67,na,1951,1674
STAT,1947,17,40-44,1964,1.5915197080442425
SIM,1913,2,na,1915,4200
STAT,1944,26,15-19,1970,0.7708248660363134
STAT,1834,51,30-34,1885,0.003707598862270173
STAT,1835,41,35-39,1876,1.6501251526957619
STAT,1942,26,na,1968,3971.564667089425
SIM,1946,19,40-44,1965,1
SIM,1905,52,na,1957,3312
STAT,1935,28,15-19,1963,0.9717847680189124
STAT,1826,43,35-39,1869,1.8518683211250468
STAT,1877,35,na,1912,2479.249761836249
SIM,1808,76,na,1884,283
SIM,1899,20,20-24,1919,97
SIM,1874,32,25-29,1906,26
STAT,1844,47,45-49,1891,0.1858489752571171
STAT,1855,29,50-100,1884,0.4947123378090035
STAT,1921,17,20-24,1938,156.08019307445403
STAT,1917,43,45-49,1960,0.17503762355797692
STAT,1856,73,na,1929,919.7318268029776
STAT,1831,38,na,1869,1675.1370829398227
SIM,1922,27,30-34,1949,11
STAT,1854,60,na,1914,1431.3127177314384
STAT,1855,34,15-19,1889,0.10690153198566792
STAT,1857,42,25-29,1899,0.5055534543495069
STAT,1913,27,25-29,1940,66.17183826941968
STAT,1934,35,45-49,1969,0.9522083895681692
STAT,1923,48,50-100,1971,0.2665965449063551
SIM,1880,22,50-100,1902,1
STAT,1833,33,25-29,1866,9.26750660529589
SIM,1843,30,40-44,1873,7
SIM,1904,32,20-24,1936,5
STAT,1817,50,30-34,1867,0.012756800224848795
STAT,1845,21,50-100,1866,0.37258164244517594
STAT,1822,55,na,1877,1271.2759022508267
STAT,1850,30,20-24,1880,2.4292547734910346
SIM,1811,43,40-44,1854,8
SIM,1921,27,25-29,1948,11
STAT,1879,20,40-44,1899,2.2094387266187696
STAT,1864,60,na,1924,1738.179094513704
SIM,1884,57,na,1941,2106
STAT,1831,25,15-19,1856,0.4178063330678724
STAT,1806,108,na,1914,6.175873886227748E-4
STAT,1914,27,30-34,1941,39.85336512001144
STAT,1826,30,15-19,1856,0.22768469057912058
SIM,1867,1,na,1868,3271
STAT,1938,19,50-100,1957,0.3728497608727075
STAT,1881,34,50-100,1915,0.8843878584868412
STAT,1917,49,na,1966,3850.6266835879374
STAT,1930,24,20-24,1954,143.07413753192657
STAT,1864,29,30-34,1893,22.78642922977355
STAT,1914,23,50-100,1937,0.6761605102799562
SIM,1896,52,na,1948,2799
SIM,1866,38,na,1904,2370
STAT,1932,18,35-39,1950,5.600390814941639
STAT,1878,20,35-39,1898,6.154741811968026
STAT,1862,52,35-39,1914,0.0074690219731000955
STAT,1881,40,na,1921,2272.8479515439017
STAT,1845,30,25-29,1875,9.085395676907842
STAT,1954,11,na,1965,4906.8586566671565
SIM,1821,58,na,1879,1066
SIM,1885,19,15-19,1904,9
SIM,1907,6,na,1913,4097
STAT,1800,107,na,1907,0.0016542894285356388
STAT,1943,9,na,1952,4225.7475942630335
SIM,1920,15,15-19,1935,59
STAT,1839,51,20-24,1890,5.256679703382352E-4
STAT,1820,35,40-44,1855,12.328588377452359
STAT,1884,41,30-34,1925,1.1502449572443714
STAT,1815,51,20-24,1866,0.001595834626451253
STAT,1879,36,na,1915,2495.1512935084424
SIM,1818,46,50-100,1864,2
STAT,1900,35,50-100,1935,1.7388959321904893
SIM,1940,18,35-39,1958,4
STAT,1902,48,30-34,1950,0.07695382249183977
SIM,1907,38,45-49,1945,3
SIM,1923,35,35-39,1958,2
STAT,1890,49,na,1939,2719.1961777304155
STAT,1833,46,30-34,1879,0.081556127934854
STAT,1935,30,45-49,1965,2.202014996934512
SIM,1876,38,na,1914,2691
SIM,1900,26,40-44,1926,3
STAT,1939,22,15-19,1961,5.396945628713242
STAT,1932,32,30-34,1964,21.165772902747662
STAT,1919,19,30-34,1938,13.527042251366186
STAT,1849,36,40-44,1885,3.5387425292088457
STAT,1815,41,50-100,1856,2.8500917516049267
STAT,1816,43,na,1859,1581.1433273099983
STAT,1831,47,35-39,1878,0.10457309468552446
STAT,1912,15,15-19,1927,9.301684874756946
STAT,1915,35,35-39,1950,2.4889664972594003
STAT,1845,52,45-49,1897,0.010547567774738278
STAT,1838,54,50-100,1892,0.009832157105939585
STAT,1927,38,20-24,1965,0.33093291370846634
SIM,1875,44,35-39,1919,3
STAT,1829,28,25-29,1857,47.47478629206513
SIM,1831,23,15-19,1854,2
SIM,1833,43,na,1876,1722
SIM,1858,44,35-39,1902,6
SIM,1932,33,35-39,1965,17
STAT,1874,31,20-24,1905,2.806899299964099
STAT,1841,51,50-100,1892,0.011348093486422347
STAT,1882,42,20-24,1924,0.15518305200011565
SIM,1910,24,45-49,1934,2
STAT,1809,51,35-39,1860,0.02823625627833762
STAT,1918,50,na,1968,3911.3338720410766
STAT,1809,89,na,1898,48.508345214995906
SIM,1817,40,40-44,1857,3
STAT,1857,39,40-44,1896,3.415813602820336
STAT,1784,70,na,1854,544.9999999999999
SIM,1915,33,35-39,1948,14
STAT,1839,61,na,1900,1324.811925780198
SIM,1929,17,15-19,1946,49
STAT,1835,54,40-44,1889,0.007742816017923369
STAT,1807,88,na,1895,48.6299862082919
STAT,1834,25,40-44,1859,2.373336834696465
STAT,1908,39,50-100,1947,0.3928211780546736
SIM,1814,88,na,1902,58
STAT,1844,33,50-100,1877,0.8579271370083421
SIM,1930,22,20-24,1952,162
STAT,1867,44,35-39,1911,1.6992354435723545
STAT,1876,42,35-39,1918,1.8860694478093956
SIM,1838,18,15-19,1856,5
STAT,1872,48,35-39,1920,0.14037269250203244
SIM,1898,37,40-44,1935,1
SIM,1889,82,na,1971,786
STAT,1907,37,40-44,1944,1.4014212098508205
STAT,1848,44,25-29,1892,0.5172175430989472
STAT,1896,19,25-29,1915,7.535341034309067
STAT,1840,23,15-19,1863,2.9197917708587093
STAT,1854,104,na,1958,0.08962302652242309
STAT,1884,15,na,1899,2527.178422784808
STAT,1920,17,15-19,1937,51.41813862713954
SIM,1868,41,25-29,1909,1
SIM,1830,25,na,1855,1698
SIM,1837,28,25-29,1865,35
SIM,1882,31,20-24,1913,4
STAT,1807,102,na,1909,0.10385141913095117
SIM,1929,39,35-39,1968,5
STAT,1896,48,20-24,1944,0.008935910311521727
STAT,1891,43,15-19,1934,0.017144144123427345
STAT,1907,33,35-39,1940,8.588516015112457
STAT,1850,47,45-49,1897,0.17986598835291617
SIM,1843,41,35-39,1884,5
STAT,1928,38,25-29,1966,1.2564602452936522
STAT,1892,18,na,1910,3192.514287027841
SIM,1906,35,35-39,1941,2
STAT,1885,32,50-100,1917,0.9211362198573722
STAT,1898,4,na,1902,3601.960725148478
SIM,1826,95,na,1921,31
STAT,1772,85,na,1857,59.89727498034101
STAT,1904,34,20-24,1938,2.230377240024685
SIM,1884,31,40-44,1915,6
SIM,1912,34,20-24,1946,3
STAT,1897,65,na,1962,2460.640453796688
SIM,1900,37,na,1937,3474
STAT,1879,68,na,1947,1610.7199434573063
STAT,1876,31,40-44,1907,4.540996048178025
SIM,1946,17,15-19,1963,65
STAT,1846,32,50-100,1878,0.821700627105297
STAT,1938,17,15-19,1955,45.19481897324976
STAT,1859,42,35-39,1901,1.4691774269470321
STAT,1885,45,40-44,1930,0.1738297192925124
STAT,1935,6,na,1941,5535.895754836193
SIM,1919,17,30-34,1936,22
STAT,1820,46,20-24,1866,0.020721558830108705
STAT,1897,39,50-100,1936,0.35521079699123465
SIM,1920,19,20-24,1939,168
STAT,1830,45,50-100,1875,0.21081614945843333
STAT,1818,54,40-44,1872,0.017301667298643554
STAT,1899,20,50-100,1919,0.5686320928222952
STAT,1874,26,50-100,1900,0.6638335210974078
STAT,1913,32,20-24,1945,2.4485437535256187
STAT,1912,19,20-24,1931,27.510476399867912
STAT,1860,15,40-44,1875,0.17623240026764816
STAT,1925,19,50-100,1944,0.45493384127573205
STAT,1886,31,25-29,1917,10.96727837762451
SIM,1905,30,na,1935,3645
SIM,1957,12,na,1969,5431
STAT,1854,41,45-49,1895,1.1282905949192783
STAT,1951,8,na,1959,4728.388411532823
SIM,1901,31,40-44,1932,8
STAT,1936,28,20-24,1964,17.628041641449826
STAT,1784,80,na,1864,211.23106064415808
STAT,1846,45,50-100,1891,0.18824027681901492
STAT,1906,65,na,1971,2842.0593290991983
SIM,1884,42,35-39,1926,1
STAT,1839,71,na,1910,946.337423314472
STAT,1875,52,30-34,1927,0.006141220581292232
STAT,1818,41,35-39,1859,3.6768877168462004
STAT,1909,40,45-49,1949,0.1588648008668932
STAT,1929,17,50-100,1946,0.4832750786064105
STAT,1929,28,na,1957,4736.504982058857
SIM,1867,7,na,1874,2560
SIM,1842,25,40-44,1867,3
STAT,1827,76,na,1903,563.3818381975578
SIM,1837,21,40-44,1858,5
SIM,1905,62,na,1967,2972
STAT,1856,52,20-24,1908,5.683632327983936E-4
SIM,1873,73,na,1946,1045
SIM,1841,30,20-24,1871,2
SIM,1941,23,35-39,1964,15
STAT,1857,28,50-100,1885,0.5156397013144507
STAT,1885,32,35-39,1917,10.181121504150072
STAT,1877,29,na,1906,2469.986935932549
SIM,1842,20,na,1862,2188
SIM,1884,5,na,1889,2677
STAT,1882,7,na,1889,2563.433960714207
STAT,1918,36,15-19,1954,0.02053285346708268
STAT,1896,35,15-19,1931,0.07578721320714654
STAT,1830,41,45-49,1871,1.3188758932247922
STAT,1879,35,15-19,1914,0.05974900330653576
STAT,1823,32,50-100,1855,2.451354642701083
STAT,1854,17,na,1871,2060.7585292576896
STAT,1919,48,25-29,1967,0.057930319924925575
SIM,1855,60,na,1915,1641
STAT,1868,18,35-39,1886,0.536077731583793
STAT,1928,17,30-34,1945,15.523522739947698
SIM,1894,31,25-29,1925,26
STAT,1840,36,20-24,1876,0.6457793185985389
STAT,1819,40,25-29,1859,1.4718845112552068
STAT,1900,24,35-39,1924,8.13599005771061
STAT,1826,37,50-100,1863,1.419249755579418
SIM,1893,32,35-39,1925,29
STAT,1922,22,20-24,1944,128.8194300806821
STAT,1834,40,na,1874,1547.7974381198512
STAT,1861,47,20-24,1908,0.010024408583621367
SIM,1860,23,na,1883,2091
SIM,1896,27,50-100,1923,4
STAT,1842,75,na,1917,926.860470374005
SIM,1935,26,15-19,1961,1
SIM,1826,41,35-39,1867,2
STAT,1819,73,na,1892,603.809409170895
STAT,1891,48,45-49,1939,0.16437654682619032
STAT,1908,45,45-49,1953,0.2013305956647106
STAT,1911,41,50-100,1952,0.11377531743836485
STAT,1913,44,15-19,1957,0.001505974463499255
STAT,1824,40,20-24,1864,0.20564233089105968
SIM,1869,68,na,1937,1451
SIM,1846,39,30-34,1885,11
STAT,1838,39,30-34,1877,4.21656645331862
SIM,1878,29,25-29,1907,51
STAT,1929,40,50-100,1969,0.1542016832994105
SIM,1900,15,na,1915,3724
SIM,1775,86,na,1861,80
STAT,1860,88,na,1948,113.34497804517763
STAT,1891,31,20-24,1922,3.393929299595677
SIM,1825,56,na,1881,1041
STAT,1924,33,35-39,1957,10.766885793268996
SIM,1898,15,20-24,1913,23
STAT,1847,90,na,1937,59.030851862640155
SIM,1786,81,na,1867,139
STAT,1908,42,40-44,1950,0.23360197164103397
STAT,1943,28,50-100,1971,1.0698476063059732
STAT,1811,61,na,1872,1000.4306403740704
STAT,1831,44,30-34,1875,0.8660409888799433
STAT,1881,37,20-24,1918,0.750471849343442
STAT,1913,46,40-44,1959,0.15565149472246667
STAT,1903,40,50-100,1943,0.10658992858956651
SIM,1826,73,na,1899,845
SIM,1934,33,45-49,1967,4
SIM,1788,82,na,1870,194
SIM,1850,23,25-29,1873,65
STAT,1860,41,30-34,1901,0.9534915152201974
STAT,1861,40,25-29,1901,0.5443878268498732
STAT,1930,36,15-19,1966,0.02533988052663686
STAT,1875,26,40-44,1901,3.117713840576324
SIM,1867,20,25-29,1887,2
STAT,1823,40,15-19,1863,0.02153016050527745
STAT,1903,29,20-24,1932,16.754068653798225
SIM,1829,39,30-34,1868,6
STAT,1846,41,na,1887,1798.0882249717536
SIM,1932,25,35-39,1957,39
SIM,1806,59,na,1865,1168
SIM,1929,19,40-44,1948,6
STAT,1893,31,30-34,1924,22.48256984047521
STAT,1843,43,35-39,1886,1.241495029770712
STAT,1922,6,na,1928,4686.046278751755
STAT,1925,45,45-49,1970,0.26741050518025317
STAT,1900,37,40-44,1937,1.3256288091528647
SIM,1886,16,na,1902,2897
STAT,1826,40,30-34,1866,1.248257629700043
STAT,1926,33,45-49,1959,1.9218244437868979
STAT,1872,73,na,1945,1206.0688572382505
STAT,1811,45,40-44,1856,0.440740889119187
STAT,1941,22,30-34,1963,29.98675183836753
STAT,1951,18,45-49,1969,0.6008144103474653
STAT,1852,59,na,1911,1473.907559492509
STAT,1837,46,15-19,1883,2.869237573638513E-4
STAT,1891,45,40-44,1936,0.12196392641369391
STAT,1882,45,15-19,1927,3.9524017615695295E-4
STAT,1877,15,35-39,1892,0.5746447420304089
STAT,1963,0,na,1963,5081.512932566409
STAT,1820,43,40-44,1863,4.099082437828621
STAT,1839,54,25-29,1893,0.002442134947555635
STAT,1874,47,30-34,1921,0.09964283673575391
STAT,1931,15,25-29,1946,57.59185550803165
SIM,1896,36,na,1932,3143
STAT,1879,52,na,1931,2257.3569806210357
SIM,1845,41,45-49,1886,2
STAT,1814,46,20-24,1860,0.029433437136886374
STAT,1824,54,40-44,1878,0.011412534196477085
SIM,1908,8,na,1916,3808
STAT,1836,40,25-29,1876,0.4944264782377531
SIM,1916,42,40-44,1958,3
STAT,1853,51,40-44,1904,0.008747774531596473
STAT,1901,16,40-44,1917,0.25960067743853427
STAT,1859,20,25-29,1879,53.789504576400766
STAT,1924,25,35-39,1949,17.7843493992406
STAT,1892,56,na,1948,2584.9897028765813
STAT,1911,49,25-29,1960,0.050367091557941744
STAT,1929,38,30-34,1967,2.362627607908174
STAT,1938,27,na,1965,3746.7154280666564
SIM,1878,22,40-44,1900,3
STAT,1852,30,40-44,1882,3.476753931634221
SIM,1864,90,na,1954,65
SIM,1920,5,na,1925,4876
STAT,1858,39,50-100,1897,0.9630556219128442
SIM,1843,75,na,1918,913
SIM,1900,29,45-49,1929,2
STAT,1880,49,na,1929,2336.60289439565
SIM,1855,17,na,1872,2349
SIM,1903,19,20-24,1922,23
SIM,1923,32,30-34,1955,29
STAT,1848,70,na,1918,1145.551787633892
SIM,1852,44,40-44,1896,8
STAT,1850,33,25-29,1883,8.119711173022669
SIM,1920,51,na,1971,4290
STAT,1883,32,25-29,1915,10.123496504222802
STAT,1878,47,15-19,1925,4.1742637753023986E-4
SIM,1941,27,40-44,1968,9
SIM,1876,22,30-34,1898,22
SIM,1901,34,45-49,1935,1
STAT,1932,35,35-39,1967,3.2899029594371494
STAT,1855,18,25-29,1873,5.043462690614741
STAT,1877,31,50-100,1908,0.9590189372590631
STAT,1904,46,15-19,1950,3.2796540804523003E-4
STAT,1851,18,40-44,1869,0.16738911275273102
SIM,1860,30,40-44,1890,5
STAT,1933,27,40-44,1960,6.253989386299015
STAT,1871,42,45-49,1913,1.4999160674701089
SIM,1921,24,20-24,1945,175
SIM,1938,17,40-44,1955,1
STAT,1834,56,na,1890,1214.0483182821674
STAT,1811,49,20-24,1860,0.02892738943130449
SIM,1840,18,30-34,1858,3
SIM,1857,18,na,1875,2423
STAT,1809,100,na,1909,0.4902133994188853
STAT,1923,46,25-29,1969,0.06285445174948893
STAT,1848,16,50-100,1864,0.04987950710578836
STAT,1858,41,15-19,1899,0.010992236922956344
STAT,1915,32,30-34,1947,16.191279779190328
STAT,1844,44,40-44,1888,1.7764906149253945
STAT,1855,47,20-24,1902,0.008990539785899877
SIM,1841,62,na,1903,1236
STAT,1897,55,na,1952,2799.8057515802766
SIM,1813,42,50-100,1855,1
SIM,1859,25,35-39,1884,10
SIM,1928,36,25-29,1964,1
STAT,1876,34,35-39,1910,10.470520768780535
STAT,1864,41,15-19,1905,0.012643050717709919
STAT,1878,42,45-49,1920,1.5672276446283728
STAT,1899,33,50-100,1932,1.2646958418167986
STAT,1817,53,35-39,1870,0.017375401619873186
STAT,1926,26,na,1952,4554.226419519836
STAT,1804,51,45-49,1855,0.04010261601593872
SIM,1891,32,25-29,1923,24
STAT,1826,40,40-44,1866,2.4421617020800492
SIM,1843,39,50-100,1882,2
STAT,1862,30,25-29,1892,9.00561866459535
STAT,1829,93,na,1922,17.23240013677352
STAT,1868,22,30-34,1890,17.194034329845636
STAT,1926,38,15-19,1964,0.023695327536556093
SIM,1945,7,na,1952,4236
STAT,1885,48,45-49,1933,0.23427852671903654
STAT,1918,34,50-100,1952,0.8793979509179211
STAT,1816,41,25-29,1857,1.9139067617385146
STAT,1914,20,na,1934,3797.2662853693355
SIM,1818,44,na,1862,1338
SIM,1883,22,25-29,1905,69
STAT,1835,39,50-100,1874,1.1162425330498793
STAT,1861,44,40-44,1905,1.8622911064473529
STAT,1843,101,na,1944,0.38486723334265893
STAT,1870,72,na,1942,1252.524318146417
SIM,1883,26,40-44,1909,4
SIM,1817,43,35-39,1860,1
SIM,1904,46,50-100,1950,2
STAT,1905,44,50-100,1949,0.1056700157340787
STAT,1842,23,25-29,1865,64.54063980722661
SIM,1893,34,na,1927,3069
SIM,1926,34,50-100,1960,1
STAT,1913,24,20-24,1937,112.5820734654932
SIM,1856,61,na,1917,1666
SIM,1886,42,45-49,1928,1
SIM,1911,29,20-24,1940,21
STAT,1931,21,50-100,1952,0.8650979591772889
SIM,1879,19,15-19,1898,8
SIM,1830,30,45-49,1860,1
STAT,1818,56,na,1874,1235.9890342047531
STAT,1860,72,na,1932,1042.6795728635052
STAT,1859,38,na,1897,1904.3514033142458
STAT,1928,35,20-24,1963,0.33731612957130086
STAT,1936,19,30-34,1955,11.71799467695391
SIM,1835,56,na,1891,1172
SIM,1874,29,40-44,1903,2
STAT,1861,23,35-39,1884,4.995371418616835
SIM,1915,30,30-34,1945,33
STAT,1910,43,35-39,1953,0.19085112598549422
STAT,1812,50,40-44,1862,0.024189110156556476
STAT,1843,35,50-100,1878,0.986987683626165
STAT,1925,28,45-49,1953,2.054909960273691
STAT,1832,51,20-24,1883,5.34695013643204E-4
SIM,1933,28,45-49,1961,2
STAT,1877,67,na,1944,1652.468033415905
STAT,1850,44,40-44,1894,1.6990537479461805
STAT,1902,13,na,1915,3680.198953030676
STAT,1884,44,35-39,1928,1.7792167819924323
SIM,1913,25,25-29,1938,9
SIM,1800,80,na,1880,290
STAT,1824,62,na,1886,945.8956580456717
SIM,1944,19,30-34,1963,19
STAT,1824,43,25-29,1867,0.7815852432554993
SIM,1803,94,na,1897,5
STAT,1898,13,na,1911,3530.5133460744573
SIM,1878,40,45-49,1918,5
STAT,1843,30,15-19,1873,0.11789289618244282
SIM,1943,26,na,1969,3913
SIM,1891,24,25-29,1915,87
SIM,1868,20,30-34,1888,16
SIM,1847,41,na,1888,1744
STAT,1824,53,50-100,1877,0.01670065448259385
STAT,1891,34,25-29,1925,12.698495031803683
STAT,1842,31,25-29,1873,11.256408301990316
SIM,1825,49,50-100,1874,1
STAT,1863,36,15-19,1899,0.05049400902341091
STAT,1867,41,30-34,1908,1.0985378622335389
STAT,1895,48,na,1943,2930.7161698222503
SIM,1831,46,50-100,1877,3
SIM,1901,32,na,1933,3403
SIM,1867,18,na,1885,2423
STAT,1842,91,na,1933,52.17243250174265
STAT,1947,4,na,1951,4525.425776561903
STAT,1889,52,na,1941,2667.3404117314894
STAT,1939,22,na,1961,3702.399333398434
STAT,1901,66,na,1967,2607.732396073422
STAT,1907,30,30-34,1937,14.989435058792377
STAT,1901,46,50-100,1947,0.1967081757389077
STAT,1850,30,50-100,1880,0.8234352613936896
SIM,1832,42,na,1874,1552
STAT,1919,45,50-100,1964,0.24886284978885304
STAT,1915,48,40-44,1963,0.15986334020592072
STAT,1922,38,30-34,1960,2.0929534844861157
SIM,1850,31,25-29,1881,14
SIM,1930,38,30-34,1968,6
SIM,1875,41,30-34,1916,1
SIM,1881,19,30-34,1900,1
STAT,1830,49,30-34,1879,0.07889596741345416
STAT,1959,10,na,1969,5191.172029881097
STAT,1821,51,35-39,1872,0.012380613064323457
STAT,1835,33,35-39,1868,9.5806353974258
SIM,1939,24,30-34,1963,55
STAT,1883,24,25-29,1907,56.22572139322386
STAT,1859,16,na,1875,2177.3149056195225
SIM,1903,27,20-24,1930,25
SIM,1874,90,na,1964,197
STAT,1934,32,40-44,1966,5.398739374768794
STAT,1902,35,na,1937,3421.3123629224606
SIM,1877,2,na,1879,3374
SIM,1844,18,15-19,1862,8
STAT,1836,18,15-19,1854,9.095348245017373
STAT,1841,44,15-19,1885,0.010459765883476439
STAT,1892,19,40-44,1911,0.2305643932741352
STAT,1913,35,25-29,1948,0.9896919553300477
STAT,1913,51,na,1964,3571.8427634268455
SIM,1820,57,na,1877,1154
STAT,1855,52,50-100,1907,0.011307635825283397
SIM,1871,31,45-49,1902,2
STAT,1870,37,45-49,1907,1.9771166760196461
STAT,1931,32,na,1963,5008.50597655929
SIM,1824,33,25-29,1857,10
SIM,1851,43,35-39,1894,3
SIM,1900,21,na,1921,3462
STAT,1897,40,15-19,1937,0.0013116217619149333
SIM,1817,53,na,1870,1375
SIM,1955,11,na,1966,5053
STAT,1944,5,na,1949,4325.9557110538035
STAT,1860,94,na,1954,16.501036548147336
STAT,1938,11,na,1949,3951.7036998510325
STAT,1899,42,15-19,1941,0.0013276593463529243
STAT,1910,46,15-19,1956,3.476140440257197E-4
STAT,1892,34,na,1926,2998.4675915651756
STAT,1906,28,35-39,1934,14.144607316170157
STAT,1888,3,na,1891,3151.516019235152
STAT,1890,31,15-19,1921,0.1764722146987203
STAT,1875,37,50-100,1912,1.2734362631580032
STAT,1857,0,na,1857,3117.504085446235
SIM,1796,58,na,1854,1172
STAT,1905,25,25-29,1930,62.18318916146632
STAT,1893,47,40-44,1940,0.1232693496320365
STAT,1950,15,35-39,1965,5.01540574078039
SIM,1843,33,35-39,1876,11
STAT,1881,5,na,1886,2607.1545800196604
STAT,1872,45,30-34,1917,0.09927267837181528
STAT,1926,1,na,1927,5174.6845735556435
STAT,1940,17,30-34,1957,12.494005988293322
SIM,1858,47,50-100,1905,3
STAT,1876,51,25-29,1927,0.0037114363943528627
STAT,1857,90,na,1947,62.14562993904454
SIM,1776,81,na,1857,137
STAT,1857,51,50-100,1908,0.011961615919164793
STAT,1911,22,45-49,1933,1.076584799199292
SIM,1910,15,na,1925,3659
STAT,1942,17,50-100,1959,0.39531231890859514
SIM,1883,3,na,1886,3221
STAT,1882,51,na,1933,2116.6253957162094
STAT,1812,77,na,1889,390.00152254515854
STAT,1833,45,na,1878,1740.4600448066553
STAT,1898,43,25-29,1941,0.06061565822121731
STAT,1907,15,50-100,1922,0.07300373706273482
SIM,1850,23,na,1873,2009
STAT,1858,15,25-29,1873,5.307535076787499
STAT,1805,54,30-34,1859,0.02350429693550227
SIM,1833,28,40-44,1861,5
SIM,1941,20,30-34,1961,50
SIM,1851,22,50-100,1873,1
SIM,1820,79,na,1899,346
STAT,1896,30,45-49,1926,2.3500926064236523
SIM,1833,35,40-44,1868,6
SIM,1823,41,50-100,1864,1
SIM,1835,31,35-39,1866,17
STAT,1825,42,na,1867,1994.6989812117
SIM,1932,22,30-34,1954,58
STAT,1953,10,na,1963,4802.273649984162
SIM,1861,39,na,1900,2046
SIM,1826,57,na,1883,1531
STAT,1907,15,30-34,1922,2.3750553953140687
SIM,1953,18,20-24,1971,237
STAT,1869,45,50-100,1914,0.24357335616932516
STAT,1933,20,30-34,1953,38.7545654086486
STAT,1894,22,35-39,1916,7.588081119290448
SIM,1895,51,na,1946,2997
STAT,1912,43,45-49,1955,0.16097260041489667
SIM,1850,20,20-24,1870,3
STAT,1915,44,25-29,1959,0.07230253543523694
SIM,1817,40,30-34,1857,4
STAT,1890,17,50-100,1907,0.060463857619279804
SIM,1882,7,na,1889,2353
SIM,1877,17,15-19,1894,7
STAT,1840,40,15-19,1880,0.01138493063008983
STAT,1869,17,15-19,1886,5.908178694383805
STAT,1919,9,na,1928,4441.764010075283
SIM,1927,15,15-19,1942,58
SIM,1929,17,25-29,1946,64
STAT,1890,70,na,1960,1875.3927483326854
STAT,1913,48,30-34,1961,0.08754623735404443
STAT,1882,88,na,1970,364.5503709380346
SIM,1852,89,na,1941,27
STAT,1831,46,20-24,1877,0.009079171802058457
STAT,1909,51,na,1960,3363.1391150057334
STAT,1830,41,35-39,1871,1.5957333477064046
STAT,1802,94,na,1896,6.982801471487246
SIM,1845,39,na,1884,1973
STAT,1835,50,25-29,1885,0.002819825076571568
SIM,1950,17,40-44,1967,4
STAT,1872,34,15-19,1906,0.14336568706794092
STAT,1896,18,50-100,1914,0.06532667585252326
STAT,1862,52,45-49,1914,0.012590637022816226
STAT,1910,48,na,1958,3448.5742158010817
SIM,1915,29,na,1944,4189
STAT,1899,29,na,1928,3284.440130453234
STAT,1857,89,na,1946,82.8078428992705
STAT,1828,87,na,1915,114.36901762817675
SIM,1868,19,15-19,1887,8
STAT,1827,31,35-39,1858,14.231681943758396
SIM,1900,30,50-100,1930,2
SIM,1883,66,na,1949,1755
SIM,1921,20,na,1941,4146
STAT,1825,35,40-44,1860,7.8598507441929195
STAT,1834,21,25-29,1855,46.08800698770137
SIM,1889,25,20-24,1914,17
SIM,1928,33,20-24,1961,5
STAT,1941,25,na,1966,3915.8605775511096
SIM,1895,32,45-49,1927,5
STAT,1942,17,40-44,1959,1.4758330161444344
STAT,1892,26,40-44,1918,3.809543984504564
SIM,1920,43,45-49,1963,1
STAT,1916,27,40-44,1943,4.863541832851406
SIM,1854,54,na,1908,1930
SIM,1842,21,25-29,1863,52
SIM,1906,53,na,1959,3053
STAT,1870,56,na,1926,2022.8850354431686
STAT,1873,52,20-24,1925,7.515404726033075E-4
STAT,1833,61,na,1894,1322.0517426344877
SIM,1898,23,20-24,1921,95
STAT,1844,24,na,1868,2081.9174828658593
SIM,1870,16,na,1886,2865
SIM,1843,30,30-34,1873,32
SIM,1894,19,na,1913,3584
STAT,1922,34,15-19,1956,0.14596304938946578
STAT,1887,32,45-49,1919,1.9664140286127543
STAT,1804,51,35-39,1855,0.023789687500247292
SIM,1843,91,na,1934,87
SIM,1874,4,na,1878,2713
SIM,1927,14,na,1941,5418
STAT,1941,7,na,1948,4132.869237971117
SIM,1895,73,na,1968,1940
SIM,1858,30,25-29,1888,14
STAT,1824,94,na,1918,9.936094884773352
SIM,1835,72,na,1907,695
STAT,1866,36,40-44,1902,4.113687778883665
STAT,1872,47,20-24,1919,0.012128243766954476
STAT,1938,28,30-34,1966,39.16968149851547
STAT,1896,15,45-49,1911,0.0877367945561209
STAT,1899,16,25-29,1915,7.874238050580341
SIM,1869,42,45-49,1911,2
STAT,1902,19,na,1921,3585.3654963492286
STAT,1900,30,50-100,1930,1.295835784335077
STAT,1946,19,50-100,1965,0.419420459377915
SIM,1861,21,35-39,1882,5
STAT,1882,51,25-29,1933,0.0034818999272163936
STAT,1884,31,15-19,1915,0.1424169685704022
STAT,1831,33,15-19,1864,0.11647910200789109
SIM,1887,22,na,1909,2591
STAT,1843,76,na,1919,638.9932497603951
STAT,1869,30,35-39,1899,10.02429261071339
STAT,1902,21,40-44,1923,2.9831162982744734
STAT,1901,39,15-19,1940,0.016988139565715092
SIM,1914,9,na,1923,4357
STAT,1870,30,25-29,1900,10.240149965591758
STAT,1880,43,15-19,1923,0.014542415671450362
SIM,1927,28,20-24,1955,27
SIM,1828,41,45-49,1869,2
SIM,1954,10,na,1964,4837
STAT,1868,25,35-39,1893,9.377211945335807
STAT,1919,28,20-24,1947,19.843986790728934
SIM,1899,66,na,1965,2711
STAT,1820,110,na,1930,1.4066224293479254E-4
STAT,1902,44,15-19,1946,0.0013502428625959235
STAT,1941,20,50-100,1961,0.6869838981394445
STAT,1851,106,na,1957,0.014281906241372924
STAT,1895,47,15-19,1942,2.962143886919489E-4
STAT,1853,40,25-29,1893,0.536407270066232
STAT,1896,70,na,1966,2165.741004566279
STAT,1842,20,20-24,1862,79.3921351179683
STAT,1917,48,15-19,1965,3.872984803529022E-4
SIM,1857,22,20-24,1879,3
STAT,1891,47,30-34,1938,0.06796186187714674
STAT,1853,21,35-39,1874,5.74312751507566
STAT,1920,25,15-19,1945,0.7873346370227673
STAT,1898,32,20-24,1930,3.7010517328361963
STAT,1817,40,15-19,1857,0.03690707901184802
STAT,1873,19,50-100,1892,0.0498942381862192
STAT,1924,22,30-34,1946,34.27065267757991
STAT,1863,16,na,1879,2357.886658352136
STAT,1873,19,30-34,1892,1.623226212343518
STAT,1821,76,na,1897,567.4871423768103
SIM,1851,24,na,1875,1974
STAT,1867,53,25-29,1920,0.003315143545726711
STAT,1939,26,30-34,1965,39.78371633895662
SIM,1901,16,na,1917,3725
SIM,1922,23,50-100,1945,2
STAT,1843,40,40-44,1883,1.602529716910532
SIM,1884,31,30-34,1915,26
STAT,1810,50,30-34,1860,0.022710587307313734
SIM,1846,18,25-29,1864,7
STAT,1838,18,25-29,1856,4.98121975241495
STAT,1846,17,50-100,1863,0.04670457914069506
STAT,1919,15,15-19,1934,10.206586017472246
STAT,1909,33,45-49,1942,1.5088856442745422
STAT,1833,42,15-19,1875,0.01188253739482717
STAT,1943,25,45-49,1968,1.8594252621030773
STAT,1876,31,30-34,1907,18.282151420472157
STAT,1813,57,na,1870,1133.766853019758
SIM,1775,80,na,1855,155
STAT,1922,33,na,1955,4298.758496092137
SIM,1897,34,50-100,1931,1
SIM,1906,31,na,1937,3418
STAT,1808,72,na,1880,573.2845836630418
SIM,1864,74,na,1938,1274
STAT,1920,39,25-29,1959,1.0863163079043399
STAT,1888,30,45-49,1918,2.0955407438835376
STAT,1822,35,15-19,1857,0.11320526936411474
STAT,1852,42,25-29,1894,0.48640713793087226
SIM,1812,44,na,1856,1356
STAT,1863,40,35-39,1903,1.6368299377921978
STAT,1873,53,25-29,1926,0.003568470317879577
STAT,1921,37,25-29,1958,1.110364609675095
SIM,1868,23,35-39,1891,8
SIM,1911,0,na,1911,4305
STAT,1832,29,50-100,1861,0.5760194269364202
STAT,1882,56,na,1938,1995.4709761013273
STAT,1915,15,30-34,1930,2.5861077817643867
STAT,1850,46,30-34,1896,0.07433154098139085
STAT,1876,20,50-100,1896,0.4277987013139395
STAT,1930,42,25-29,1972,0.09496413313171977
STAT,1909,46,15-19,1955,3.424220011731714E-4
STAT,1866,32,25-29,1898,9.579217190343153
SIM,1916,25,40-44,1941,10
SIM,1865,24,20-24,1889,61
SIM,1838,16,25-29,1854,6
STAT,1809,95,na,1904,6.139199836693878
STAT,1887,45,15-19,1932,4.555548541387865E-4
STAT,1900,30,20-24,1930,3.8229055911797385
STAT,1893,31,40-44,1924,5.584313270929449
STAT,1883,14,na,1897,2544.2146462807755
STAT,1857,24,20-24,1881,56.24883809718772
STAT,1846,31,45-49,1877,1.5802053698081908
SIM,1848,39,40-44,1887,9
SIM,1864,19,30-34,1883,2
STAT,1829,35,na,1864,1649.1164677935533
STAT,1820,39,20-24,1859,1.6349537405571648
SIM,1848,24,20-24,1872,68
SIM,1879,30,45-49,1909,2
SIM,1948,17,35-39,1965,5
STAT,1874,37,na,1911,2436.527067365859
STAT,1877,41,25-29,1918,0.6724283402145339
STAT,1876,66,na,1942,1709.230162085172
STAT,1849,22,20-24,1871,65.14185267513675
STAT,1947,25,na,1972,4284.684806192505
SIM,1899,33,50-100,1932,1
SIM,1958,7,na,1965,5244
SIM,1910,21,40-44,1931,6
STAT,1847,29,30-34,1876,22.3380295949319
SIM,1825,94,na,1919,3
SIM,1896,30,45-49,1926,4
STAT,1920,28,50-100,1948,1.09873123362075
SIM,1923,15,30-34,1938,26
STAT,1935,23,45-49,1958,1.5475273386908104
STAT,1845,89,na,1934,76.7611422815538
STAT,1861,20,30-34,1881,15.58114009551083
STAT,1921,44,25-29,1965,0.08096219421455143
STAT,1821,51,45-49,1872,0.02087017627933603
STAT,1810,101,na,1911,0.29635915833294196
STAT,1835,30,30-34,1865,17.040277585889843
STAT,1898,21,15-19,1919,4.530690002925752
STAT,1769,114,na,1883,2.477185559288472E-4
STAT,1817,50,40-44,1867,0.022561613579001667
STAT,1845,52,35-39,1897,0.006257031739499824
STAT,1905,22,20-24,1927,100.61889809609168
STAT,1884,85,na,1969,573.5982323572007
SIM,1838,39,50-100,1877,1
STAT,1863,31,45-49,1894,1.5669059431719763
STAT,1914,36,50-100,1950,0.4249858421883615
SIM,1907,16,na,1923,3955
SIM,1924,27,40-44,1951,3
STAT,1867,89,na,1956,112.22530017143173
SIM,1913,22,20-24,1935,152
STAT,1926,40,45-49,1966,0.2079371060928077
SIM,1820,50,50-100,1870,2
SIM,1824,30,20-24,1854,3
STAT,1917,35,45-49,1952,0.7215152830108512
SIM,1855,29,30-34,1884,24
STAT,1935,36,15-19,1971,0.02715459220517693
SIM,1811,96,na,1907,1
SIM,1939,27,35-39,1966,21
SIM,1854,7,na,1861,2704
SIM,1907,27,40-44,1934,6
STAT,1867,41,40-44,1908,2.149241495985343
STAT,1826,52,25-29,1878,0.003366169845949333
STAT,1900,48,20-24,1948,0.009377652043258586
STAT,1939,33,30-34,1972,16.21843851224986
STAT,1883,21,20-24,1904,68.31676700425113
SIM,1886,20,35-39,1906,11
STAT,1930,27,25-29,1957,84.59089528874091
STAT,1912,37,50-100,1949,0.41343040152493415
SIM,1829,87,na,1916,71
STAT,1908,29,na,1937,3549.2848169738536
SIM,1954,16,20-24,1970,151
SIM,1857,29,40-44,1886,6
SIM,1925,29,na,1954,4385
STAT,1911,31,35-39,1942,9.014324387078497
STAT,1843,52,25-29,1895,0.002376255873759076
STAT,1874,43,15-19,1917,0.01417881219395603
STAT,1832,39,na,1871,1792.1304558123668
SIM,1937,16,20-24,1953,191
STAT,1857,20,15-19,1877,3.0456332699541075
STAT,1868,32,35-39,1900,9.775564387929908
SIM,1860,30,30-34,1890,25
STAT,1826,91,na,1917,31.797148204930707
SIM,1848,42,na,1890,1738
SIM,1844,76,na,1920,644
STAT,1907,44,na,1951,3393.5016598874417
STAT,1857,74,na,1931,874.7845506759206
SIM,1889,0,na,1889,3540
STAT,1877,19,15-19,1896,6.153138179577807
STAT,1837,41,45-49,1878,1.2203554059955275
STAT,1849,29,40-44,1878,2.7366033671855488
STAT,1870,51,50-100,1921,0.015050396910321156
STAT,1841,50,25-29,1891,0.0026868326705554906
SIM,1894,29,na,1923,3361
STAT,1860,78,na,1938,645.0890314830611
STAT,1842,15,50-100,1857,0.057315051448389984
SIM,1915,45,na,1960,4128
SIM,1925,35,45-49,1960,1
STAT,1876,20,25-29,1896,60.054375417249744
SIM,1862,89,na,1951,107
SIM,1876,32,35-39,1908,19
STAT,1946,16,20-24,1962,151.9185912346985
STAT,1857,52,na,1909,1688.1870394114173
STAT,1898,47,40-44,1945,0.13160949430091645
SIM,1875,37,na,1912,2311
STAT,1859,7,na,1866,2333.9243231265655
SIM,1871,40,35-39,1911,3
SIM,1875,41,40-44,1916,5
SIM,1883,88,na,1971,469
STAT,1851,25,40-44,1876,2.6943035162304785
STAT,1929,16,20-24,1945,175.31068812639867
STAT,1870,54,45-49,1924,0.013997436961139934
STAT,1893,43,25-29,1936,0.056774420463639994
STAT,1880,36,15-19,1916,0.05985041663151837
STAT,1928,43,na,1971,4777.970214818504
SIM,1942,15,40-44,1957,5
SIM,1924,23,35-39,1947,22
STAT,1894,41,25-29,1935,0.8387977677275834
SIM,1824,38,50-100,1862,2
SIM,1854,31,45-49,1885,1
STAT,1916,23,35-39,1939,9.926289699924105
STAT,1897,20,45-49,1917,0.9498481334356651
STAT,1813,45,15-19,1858,0.0012077970267020518
STAT,1852,30,30-34,1882,13.997488911130368
SIM,1888,27,50-100,1915,1
STAT,1945,18,20-24,1963,149.51750838890865
STAT,1888,27,50-100,1915,0.7625847692234956
SIM,1844,86,na,1930,53
STAT,1844,46,50-100,1890,0.1948665349363425
SIM,1891,21,20-24,1912,115
STAT,1934,15,40-44,1949,1.9205137311454121
STAT,1866,29,40-44,1895,2.7815257368914184
SIM,1838,29,30-34,1867,27
STAT,1898,25,20-24,1923,16.171781322878655
STAT,1827,50,25-29,1877,0.003649547980639115
STAT,1911,27,15-19,1938,0.6945690484752918
STAT,1809,57,na,1866,1226.5356194588182
SIM,1938,26,30-34,1964,54
SIM,1805,58,na,1863,967
SIM,1908,19,20-24,1927,37
STAT,1806,102,na,1908,0.09884743299809805
STAT,1867,67,na,1934,1507.8939556865757
STAT,1916,20,30-34,1936,30.574371736521194
STAT,1785,109,na,1894,5.172960758092879E-4
STAT,1891,55,na,1946,2585.6307188479736
SIM,1885,15,na,1900,2753
STAT,1879,30,45-49,1909,1.852762292869625
STAT,1912,37,25-29,1949,0.9695415688411101
STAT,1816,38,50-100,1854,4.935767225308725
STAT,1924,29,na,1953,4376.107358059696
STAT,1932,11,na,1943,5310.0554328239
SIM,1864,15,15-19,1879,9
STAT,1859,48,na,1907,1804.6615204854236
STAT,1872,22,50-100,1894,0.4140788985667072
SIM,1874,52,na,1926,2018
SIM,1848,42,25-29,1890,1
SIM,1848,20,na,1868,2108
STAT,1850,42,15-19,1892,0.01056135852751562
SIM,1852,31,35-39,1883,1
SIM,1907,26,na,1933,3728
STAT,1791,100,na,1891,0.18877607975102115
STAT,1812,62,na,1874,1020.3760876540306
SIM,1854,45,50-100,1899,2
STAT,1851,90,na,1941,59.69711500170554
STAT,1794,79,na,1873,289.37998143714935
SIM,1924,20,30-34,1944,5
STAT,1907,28,50-100,1935,0.9454697663599623
STAT,1903,25,15-19,1928,0.6570392824411133
STAT,1878,51,35-39,1929,0.009069396170895883
STAT,1833,30,20-24,1863,2.5231134293976964
STAT,1933,23,35-39,1956,12.616909334267465
SIM,1892,41,40-44,1933,5
STAT,1893,40,20-24,1933,0.20572350713435833
SIM,1836,35,na,1871,1979
SIM,1825,72,na,1897,622
STAT,1905,47,35-39,1952,0.11476868748676235
SIM,1917,30,40-44,1947,7
STAT,1818,50,25-29,1868,0.006304367070349149
SIM,1795,79,na,1874,207
SIM,1890,1,na,1891,3595
STAT,1889,14,na,1903,3205.8296693851516
SIM,1857,25,25-29,1882,55
SIM,1930,6,na,1936,5567
STAT,1853,38,na,1891,1938.674070484015
STAT,1880,92,na,1972,182.77579575884303
STAT,1884,41,40-44,1925,2.250404175993648
SIM,1911,25,15-19,1936,1
STAT,1875,41,15-19,1916,0.014388608535615176
STAT,1846,44,15-19,1890,0.01033860964265515
STAT,1885,41,25-29,1926,0.6485058091448099
STAT,1948,16,30-34,1964,14.095012113675127
STAT,1851,42,40-44,1893,1.7010273855889637
SIM,1871,43,50-100,1914,4
SIM,1905,27,30-34,1932,57
STAT,1838,49,na,1887,1510.273536897724
STAT,1863,43,50-100,1906,0.9385785675215658
SIM,1806,80,na,1886,225
STAT,1777,94,na,1871,3.0572543881419376
STAT,1920,36,20-24,1956,0.2917259552846094
STAT,1868,15,na,1883,2511.584914294673
STAT,1799,78,na,1877,318.54861739235304
SIM,1871,60,na,1931,1734
STAT,1932,33,na,1965,5077.734780150401
SIM,1884,20,25-29,1904,76
STAT,1901,34,na,1935,3349.749377308632
STAT,1881,24,15-19,1905,3.191709310895388
SIM,1874,74,na,1948,1057
STAT,1895,20,35-39,1915,7.742707882746717
STAT,1787,94,na,1881,3.60801447523572
STAT,1865,51,25-29,1916,0.003282272290207983
STAT,1891,33,na,1924,2971.437319649328
STAT,1914,30,na,1944,3871.9527621913408
STAT,1918,21,50-100,1939,0.7186215464394978
STAT,1886,43,50-100,1929,1.1184546417368681
STAT,1909,30,40-44,1939,3.7986451382329633
SIM,1816,95,na,1911,6
SIM,1820,73,na,1893,638
STAT,1856,15,15-19,1871,5.498336769557961
SIM,1880,38,30-34,1918,8
STAT,1934,4,na,1938,5516.285744135133
STAT,1790,98,na,1888,0.5231039245120608
SIM,1856,71,na,1927,1082
SIM,1868,67,na,1935,1424
SIM,1898,26,25-29,1924,65
STAT,1902,24,45-49,1926,0.9890287309531978
STAT,1831,109,na,1940,4.4708167629557846E-4
STAT,1915,41,20-24,1956,0.01796683849112533
SIM,1922,15,na,1937,4797
STAT,1871,19,na,1890,2520.6636456579904
SIM,1785,80,na,1865,190
SIM,1874,89,na,1963,238
STAT,1889,42,20-24,1931,0.19754132219815784
STAT,1867,50,20-24,1917,7.120120566840031E-4
SIM,1937,14,na,1951,3762
STAT,1844,31,35-39,1875,9.681471133384056
STAT,1844,40,25-29,1884,0.5338480753609278
STAT,1772,95,na,1867,1.7879297540476284
STAT,1938,17,25-29,1955,43.155206866932375
STAT,1834,40,15-19,1874,0.010172191825802023
STAT,1828,49,na,1877,1577.5745075032592
STAT,1800,77,na,1877,304.9214020754951
STAT,1874,22,na,1896,2445.908653308415
STAT,1889,36,na,1925,2948.242366921229
SIM,1891,17,25-29,1908,15
SIM,1927,19,30-34,1946,24
SIM,1872,23,na,1895,2570
STAT,1916,0,na,1916,4807.848982261798
SIM,1957,5,na,1962,5438
SIM,1851,40,40-44,1891,8
STAT,1879,19,25-29,1898,5.940700249054034
SIM,1836,57,na,1893,1476
SIM,1873,2,na,1875,3186
STAT,1918,7,na,1925,4392.49954284165
STAT,1937,33,20-24,1970,2.4347115933639834
SIM,1919,11,na,1930,4353
SIM,1946,17,25-29,1963,74
STAT,1853,16,na,1869,2297.033097989291
STAT,1861,89,na,1950,88.1693320992769
SIM,1800,59,na,1859,990
SIM,1892,8,na,1900,3576
STAT,1878,2,na,1880,3396.7895745606224
STAT,1861,47,45-49,1908,0.1971466946627808
STAT,1818,72,na,1890,650.652022521476
SIM,1833,31,25-29,1864,13
SIM,1930,25,25-29,1955,95
STAT,1857,27,25-29,1884,34.34469016194488
SIM,1870,38,na,1908,2576
STAT,1919,51,na,1970,3972.0403552899757
STAT,1825,52,40-44,1877,0.013622742407615674
STAT,1848,41,20-24,1889,0.1311744543751738
SIM,1893,66,na,1959,2289
STAT,1931,37,35-39,1968,3.237429126618156
STAT,1904,37,25-29,1941,0.9007404694288883
SIM,1891,37,na,1928,3038
STAT,1899,14,na,1913,3568.1608096392047
STAT,1892,22,25-29,1914,72.5518967841384
STAT,1939,29,35-39,1968,15.221954176547767
STAT,1873,50,20-24,1923,7.66420474770811E-4
SIM,1857,36,50-100,1893,2
SIM,1916,28,45-49,1944,5
STAT,1883,17,25-29,1900,5.600831955428598
SIM,1931,17,30-34,1948,21
SIM,1880,21,45-49,1901,3
STAT,1846,48,30-34,1894,0.07253702859405951
STAT,1783,110,na,1893,5.108705163180986E-4
SIM,1891,39,45-49,1930,2
SIM,1939,31,30-34,1970,23
SIM,1801,81,na,1882,41
SIM,1889,66,na,1955,1906
SIM,1853,68,na,1921,1080
STAT,1921,30,40-44,1951,4.433741513184993
STAT,1852,106,na,1958,0.017529898414581892
STAT,1849,23,na,1872,2006.62543163245
STAT,1857,23,50-100,1880,0.3684178707327426
SIM,1890,52,na,1942,2941
STAT,1943,22,40-44,1965,3.6120878516193122
SIM,1883,15,25-29,1898,7
SIM,1874,36,40-44,1910,7
SIM,1821,47,50-100,1868,2
STAT,1825,31,25-29,1856,27.834265768600087
SIM,1907,16,35-39,1923,1
STAT,1855,23,na,1878,1866.6943503057623
STAT,1875,15,25-29,1890,5.904938161499501
SIM,1896,3,na,1899,3542
SIM,1902,22,45-49,1924,1
STAT,1923,17,30-34,1940,14.46126295329757
STAT,1868,49,20-24,1917,0.011341636460375719
STAT,1849,25,25-29,1874,39.774630587094244
STAT,1926,42,35-39,1968,0.2508906955394618
STAT,1904,52,na,1956,3122.877261859272
STAT,1834,24,na,1858,1677.6348811420662
STAT,1887,29,na,1916,2671.919084062229
STAT,1931,34,50-100,1965,1.0934960489406242
STAT,1915,18,35-39,1933,0.8838602561845995
STAT,1935,20,40-44,1955,4.629202303386721
STAT,1819,57,na,1876,1149.4526800540814
STAT,1870,28,50-100,1898,0.6322061630588521
SIM,1841,33,25-29,1874,14
STAT,1957,5,na,1962,5236.513233100672
SIM,1826,32,50-100,1858,1
STAT,1852,53,na,1905,1606.7263537884428
STAT,1948,18,50-100,1966,0.43298832496041295
SIM,1870,30,25-29,1900,2
STAT,1795,97,na,1892,1.2438361781057723
STAT,1871,42,35-39,1913,1.8147773417636928
STAT,1899,30,20-24,1929,3.7769676128003793
STAT,1881,41,15-19,1922,0.01350560748306889
STAT,1888,51,na,1939,2579.1682810649404
STAT,1870,21,35-39,1891,5.805033671848518
STAT,1873,2,na,1875,3369.7128555890786
STAT,1946,19,25-29,1965,48.51297625933421
SIM,1845,49,na,1894,1836
SIM,1900,31,na,1931,3548
SIM,1893,36,50-100,1929,2
SIM,1850,61,na,1911,1527
SIM,1923,18,35-39,1941,5
STAT,1921,46,15-19,1967,4.204563342883266E-4
STAT,1908,28,45-49,1936,1.6428029753760993
SIM,1879,17,25-29,1896,5
STAT,1885,36,50-100,1921,1.240236851395127
SIM,1889,43,25-29,1932,6
SIM,1837,24,45-49,1861,3
SIM,1794,94,na,1888,3
STAT,1852,33,35-39,1885,7.869874012386736
STAT,1859,22,50-100,1881,0.34369623647377184
STAT,1917,44,na,1961,3899.177973025159
STAT,1923,43,20-24,1966,0.0208228481969565
SIM,1859,22,30-34,1881,15
STAT,1939,28,na,1967,3800.086818868543
STAT,1802,84,na,1886,111.81050002097803
STAT,1884,51,35-39,1935,0.008615606035609494
STAT,1921,41,20-24,1962,0.02011872278867614
SIM,1855,9,na,1864,2512
SIM,1938,28,50-100,1966,2
STAT,1792,83,na,1875,130.19697836439482
STAT,1843,38,na,1881,1670.6598634902969
SIM,1906,32,30-34,1938,26
STAT,1882,41,na,1923,2271.427171402965
STAT,1870,51,40-44,1921,0.010491156160133236
STAT,1771,84,na,1855,80.93
SIM,1915,30,na,1945,4264
SIM,1860,38,na,1898,2077
STAT,1813,47,50-100,1860,0.7147388848326608
STAT,1822,54,30-34,1876,0.008169446673409426
STAT,1867,52,na,1919,2037.2370118059266
STAT,1913,49,35-39,1962,0.12622521418206648
STAT,1915,15,na,1930,4097.882476695325
SIM,1857,34,na,1891,2055
STAT,1822,39,na,1861,1571.716610890705
STAT,1804,58,na,1862,954.1512384362983
SIM,1819,87,na,1906,53
STAT,1919,45,20-24,1964,0.012159423109543219
SIM,1915,28,50-100,1943,1
STAT,1859,51,25-29,1910,0.002891069879990949
STAT,1851,51,30-34,1902,0.004528763045600465
SIM,1882,23,na,1905,2081
STAT,1934,18,45-49,1952,0.6809368109016423
STAT,1932,18,50-100,1950,0.5000348015466559
STAT,1941,31,20-24,1972,2.586996817640593
STAT,1956,16,30-34,1972,16.297837237241023
SIM,1839,37,25-29,1876,3
SIM,1884,52,na,1936,2243
STAT,1851,21,25-29,1872,52.13754186087619
SIM,1878,25,45-49,1903,1
SIM,1858,19,na,1877,2177
STAT,1922,25,25-29,1947,75.75206430250033
STAT,1860,30,15-19,1890,0.11852064656203773
SIM,1875,15,na,1890,2522
STAT,1873,74,na,1947,1136.3231407409032
SIM,1838,42,na,1880,1735
STAT,1842,16,25-29,1858,6.590394873790999
STAT,1900,33,25-29,1933,14.309844658295322
STAT,1819,35,na,1854,1496.9674429580045
SIM,1912,17,20-24,1929,32
STAT,1841,54,40-44,1895,0.0076562345351824665
SIM,1860,42,25-29,1902,3
STAT,1858,37,na,1895,1866.8446984088866
STAT,1892,43,40-44,1935,2.83009267297046
STAT,1904,17,20-24,1921,25.696066791331244
STAT,1900,71,na,1971,2284.781124594342
SIM,1860,33,35-39,1893,17
STAT,1813,49,30-34,1862,0.2715400927592216
STAT,1920,48,na,1968,4089.5864368903326
SIM,1835,48,50-100,1883,1
SIM,1882,34,25-29,1916,17
STAT,1837,38,na,1875,1760.5199612923013
STAT,1874,34,25-29,1908,10.502103511588643
SIM,1850,38,45-49,1888,4
STAT,1918,16,45-49,1934,0.11040094167523398
SIM,1807,91,na,1898,38
SIM,1900,53,na,1953,3168
STAT,1897,16,15-19,1913,8.055466598381955
STAT,1917,32,40-44,1949,4.136347105104357
SIM,1929,15,25-29,1944,75
SIM,1925,32,40-44,1957,6
SIM,1820,47,na,1867,1407
STAT,1837,50,35-39,1887,0.006132725991694591
SIM,1926,16,45-49,1942,2
STAT,1820,46,45-49,1866,0.40752397485982145
STAT,1887,49,30-34,1936,0.06028754621194461
STAT,1852,75,na,1927,780.7357486780579
SIM,1817,43,na,1860,1617
SIM,1887,30,45-49,1917,3
STAT,1902,45,na,1947,3243.724219742208
SIM,1865,85,na,1950,225
STAT,1865,40,45-49,1905,1.3942129657787161
STAT,1868,41,25-29,1909,0.622673080824891
STAT,1893,28,35-39,1921,12.330628915530951
SIM,1825,57,na,1882,1012
STAT,1921,45,25-29,1966,0.06067986507311026
STAT,1923,44,na,1967,4371.324491857041
SIM,1930,20,45-49,1950,1
SIM,1933,21,25-29,1954,121
STAT,1889,67,na,1956,2002.2265354610033
SIM,1853,42,40-44,1895,3
SIM,1827,34,40-44,1861,6
STAT,1896,29,15-19,1925,0.6022293143962701
SIM,1806,74,na,1880,528
SIM,1802,60,na,1862,1073
STAT,1840,89,na,1929,73.64122204686984
STAT,1941,15,30-34,1956,12.681842240777796
STAT,1866,21,20-24,1887,65.44534094764617
STAT,1829,38,15-19,1867,0.04525585158620845
SIM,1848,24,30-34,1872,22
SIM,1870,36,50-100,1906,4
STAT,1869,54,20-24,1923,7.046800130249502E-4
STAT,1882,49,40-44,1931,0.16399597503889815
SIM,1887,40,45-49,1927,6
STAT,1871,100,na,1971,8.63268479373743
SIM,1877,45,50-100,1922,2
STAT,1848,69,na,1917,1198.1881950420907
SIM,1874,21,20-24,1895,67
SIM,1791,71,na,1862,541
SIM,1915,30,20-24,1945,4
SIM,1860,40,35-39,1900,3
STAT,1849,24,25-29,1873,53.33906191114737
STAT,1871,57,na,1928,2016.512394880179
SIM,1873,40,45-49,1913,3
STAT,1845,48,25-29,1893,0.04155868468813249
STAT,1897,50,na,1947,2957.4938985268855
SIM,1881,25,30-34,1906,29
STAT,1925,21,25-29,1946,112.07645436265129
SIM,1842,25,na,1867,2021
STAT,1882,17,20-24,1899,17.344665559729368
STAT,1813,42,20-24,1855,0.5773247077278189
STAT,1850,48,35-39,1898,0.10585296343890423
STAT,1826,37,35-39,1863,8.176176935567803
STAT,1843,34,30-34,1877,13.866060051983906
STAT,1777,104,na,1881,0.024817727844132248
STAT,1923,31,15-19,1954,0.14945670249516563
SIM,1855,8,na,1863,2539
STAT,1847,38,35-39,1885,5.4378256873028485
STAT,1858,75,na,1933,815.7319373172488
SIM,1843,35,35-39,1878,16
STAT,1852,74,na,1926,841.654717101893
STAT,1873,19,20-24,1892,18.05506528852358
SIM,1855,38,35-39,1893,15
SIM,1910,14,na,1924,3742
STAT,1894,14,na,1908,3347.256413270001
SIM,1919,23,15-19,1942,5
SIM,1900,36,45-49,1936,3
STAT,1871,35,20-24,1906,0.7808343480108647
SIM,1877,70,na,1947,1491
STAT,1852,32,30-34,1884,13.709794446870891
STAT,1840,26,30-34,1866,22.168890211738205
STAT,1898,28,na,1926,3256.1464221002984
SIM,1851,34,30-34,1885,8
SIM,1860,32,30-34,1892,3
SIM,1834,37,35-39,1871,15
STAT,1835,35,35-39,1870,6.703296002544829
STAT,1893,20,25-29,1913,73.85217737735837
STAT,1845,42,40-44,1887,1.67362123663882
STAT,1855,21,45-49,1876,0.6176346089793624
STAT,1781,106,na,1887,0.007615942544491884
SIM,1856,33,na,1889,2141
SIM,1839,26,30-34,1865,37
SIM,1874,58,na,1932,1803
STAT,1880,33,20-24,1913,2.8550633571868658
SIM,1870,44,na,1914,2525
SIM,1866,22,25-29,1888,68
STAT,1864,35,30-34,1899,4.903439290462558
STAT,1887,56,na,1943,2299.9850326324927
STAT,1879,21,na,1900,2500.286674911173
STAT,1867,38,35-39,1905,6.694547493136657
STAT,1898,17,30-34,1915,2.1823400187276203
STAT,1817,53,45-49,1870,0.02928996268981048
STAT,1886,43,40-44,1929,2.381284972631314
STAT,1861,32,25-29,1893,8.59641416140011
STAT,1932,17,na,1949,4925.434402179828
SIM,1912,27,50-100,1939,1
SIM,1825,44,30-34,1869,2
SIM,1907,31,25-29,1938,15
STAT,1894,31,25-29,1925,13.373249788256478
STAT,1847,29,20-24,1876,10.406582063443635
STAT,1883,42,na,1925,2281.550700950559
STAT,1891,61,na,1952,2336.6880289752994
STAT,1871,17,45-49,1888,0.06596950421134862
STAT,1912,47,25-29,1959,0.05143256910351049
SIM,1837,42,na,1879,1487
STAT,1880,28,25-29,1908,44.71162030357467
STAT,1884,44,45-49,1928,1.4705252139798912
STAT,1803,73,na,1876,627.0944412609886
STAT,1861,25,35-39,1886,8.275396697948315
STAT,1879,40,45-49,1919,1.5933756082923105
STAT,1851,45,45-49,1896,0.1804778449072803
STAT,1819,52,40-44,1871,0.019711164063120734
STAT,1858,22,25-29,1880,52.044953854348684
SIM,1797,96,na,1893,2
SIM,1889,25,30-34,1914,46
STAT,1876,40,20-24,1916,0.1672881852416132
SIM,1949,20,20-24,1969,136
STAT,1933,16,35-39,1949,5.690150080427078
SIM,1894,43,40-44,1937,3
STAT,1922,20,45-49,1942,1.3112939447400398
STAT,1824,63,na,1887,911.2758769611997
SIM,1855,29,20-24,1884,11
SIM,1888,28,20-24,1916,17
STAT,1807,87,na,1894,62.40854470918597
STAT,1798,93,na,1891,9.724084481775744
STAT,1829,47,30-34,1876,0.07222014956347304
SIM,1846,19,na,1865,2087
STAT,1843,50,35-39,1893,0.005889975452449578
STAT,1866,98,na,1964,10.531732402374377
SIM,1875,38,35-39,1913,12
STAT,1827,40,25-29,1867,0.7149422631477942
STAT,1859,43,25-29,1902,0.5178787421176398
STAT,1817,44,30-34,1861,2.581006566725185
SIM,1916,25,50-100,1941,1
SIM,1941,16,35-39,1957,5
SIM,1924,34,na,1958,4453
STAT,1853,26,40-44,1879,2.8905504417954324
STAT,1862,39,15-19,1901,0.04848619553821139
STAT,1866,94,na,1960,35.50886719361682
SIM,1816,80,na,1896,280
STAT,1780,83,na,1863,113.45853916191237
STAT,1830,34,20-24,1864,2.5115349857625926
STAT,1886,25,40-44,1911,3.2161205605943515
SIM,1892,35,30-34,1927,1
STAT,1840,19,40-44,1859,0.1640509180456364
SIM,1877,28,45-49,1905,5
STAT,1896,38,30-34,1934,7.089884415557174
STAT,1836,29,45-49,1865,0.893360987187096
STAT,1859,49,50-100,1908,0.19534400847567607
STAT,1858,40,25-29,1898,0.5139709627846503
SIM,1920,29,25-29,1949,86
STAT,1911,59,na,1970,3299.5449688560493
SIM,1861,26,40-44,1887,2
STAT,1884,35,30-34,1919,5.35864576867231
STAT,1917,20,35-39,1937,10.161604262533512
STAT,1855,28,15-19,1883,0.3534127809251226
SIM,1821,37,25-29,1858,2
STAT,1912,29,25-29,1941,64.97249567254026
SIM,1894,25,40-44,1919,5
STAT,1886,49,25-29,1935,0.06014174506211119
STAT,1896,22,45-49,1918,0.9322639949364275
STAT,1830,31,40-44,1861,4.2306898125159815
SIM,1840,24,30-34,1864,22
SIM,1861,30,25-29,1891,21
STAT,1928,41,45-49,1969,0.21476013564033486
STAT,1833,71,na,1904,944.365773939072
SIM,1911,29,30-34,1940,48
STAT,1831,40,15-19,1871,0.010958517132703016
STAT,1818,42,25-29,1860,1.260567457857702
STAT,1912,15,50-100,1927,0.07678879740649279
STAT,1844,50,25-29,1894,0.002842656075508629
STAT,1807,101,na,1908,0.2021320781870667
STAT,1876,36,35-39,1912,7.411447067216534
STAT,1843,43,45-49,1886,1.026097417012961
SIM,1865,16,30-34,1881,2
STAT,1869,49,25-29,1918,0.05537986198421261
STAT,1892,19,na,1911,3183.734872738513
STAT,1838,55,na,1893,1384.182208862661
SIM,1827,29,45-49,1856,1
SIM,1906,28,35-39,1934,16
SIM,1936,23,na,1959,3601
STAT,1907,23,30-34,1930,26.33803789087374
STAT,1878,83,na,1961,602.382094882773
SIM,1875,30,25-29,1905,14
STAT,1873,36,na,1909,2423.9181365311547
STAT,1778,89,na,1867,39.24561183056947
STAT,1911,27,na,1938,3685.74142172556
STAT,1947,18,30-34,1965,13.864518836722628
STAT,1881,31,15-19,1912,0.13920977588785077
STAT,1879,46,30-34,1925,0.102316857077604
STAT,1899,20,20-24,1919,96.09312718172221
SIM,1817,58,na,1875,1284
SIM,1822,36,30-34,1858,1
SIM,1876,69,na,1945,1500
SIM,1887,40,50-100,1927,2
STAT,1770,109,na,1879,0.0016408716962952952
STAT,1835,42,25-29,1877,0.5777238245969764
SIM,1837,31,45-49,1868,1
STAT,1839,32,15-19,1871,0.12424683960658825
STAT,1814,40,15-19,1854,0.051559488371903606
SIM,1884,36,35-39,1920,4
STAT,1829,31,45-49,1860,1.594177690760218
SIM,1905,31,na,1936,3678
STAT,1853,30,25-29,1883,8.905794231567626
STAT,1874,54,30-34,1928,0.00598677701257868
STAT,1933,20,20-24,1953,149.93438700954647
STAT,1857,16,30-34,1873,1.4854033358625571
STAT,1903,36,na,1939,3432.048983320203
STAT,1903,29,30-34,1932,35.96309327524027
SIM,1959,7,na,1966,5502
STAT,1862,33,50-100,1895,0.7957954850570466
STAT,1828,27,45-49,1855,2.1507911237715254
STAT,1848,26,30-34,1874,24.722229961510116
STAT,1895,44,20-24,1939,0.014349584688368973
STAT,1905,15,na,1920,3704.7621873674384
SIM,1932,23,30-34,1955,51
STAT,1849,17,35-39,1866,0.5280770144765973
STAT,1854,17,45-49,1871,0.05864399604181493
SIM,1867,36,35-39,1903,12
STAT,1885,21,na,1906,2384.850986806975
STAT,1781,102,na,1883,0.0493819278454907
STAT,1828,53,20-24,1881,5.791259992123642E-4
STAT,1913,46,30-34,1959,0.08800855559026355
STAT,1819,72,na,1891,642.0089411705419
SIM,1865,53,na,1918,1895
SIM,1872,40,50-100,1912,1
SIM,1836,27,45-49,1863,1
STAT,1933,29,50-100,1962,1.3341961306096146
STAT,1841,90,na,1931,58.9581226388455
STAT,1860,21,25-29,1881,49.07426665420768
SIM,1887,22,45-49,1909,4
SIM,1852,32,25-29,1884,6
SIM,1857,17,35-39,1874,2
SIM,1898,25,25-29,1923,86
STAT,1782,94,na,1876,4.250751959947357
STAT,1847,91,na,1938,43.38767611904051
STAT,1924,23,30-34,1947,34.16475636080619
STAT,1834,45,45-49,1879,0.16804837237241405
STAT,1879,22,45-49,1901,0.7349768141463773
SIM,1941,20,20-24,1961,170
SIM,1893,26,35-39,1919,22
STAT,1840,17,15-19,1857,5.386127907836535
SIM,1793,78,na,1871,301
SIM,1859,85,na,1944,149
SIM,1896,36,30-34,1932,9
STAT,1891,49,35-39,1940,0.0966904640427104
SIM,1932,18,35-39,1950,9
STAT,1833,53,30-34,1886,0.004270841958388906
STAT,1890,17,30-34,1907,1.9670912344770377
STAT,1869,44,50-100,1913,1.0233890568501716
STAT,1963,1,na,1964,5051.481191134942
SIM,1866,39,na,1905,2372
STAT,1865,8,na,1873,2564.5812400146033
SIM,1863,90,na,1953,53
SIM,1912,49,na,1961,3351
SIM,1859,53,na,1912,1977
SIM,1848,35,50-100,1883,2
STAT,1891,30,45-49,1921,2.1981396859741666
STAT,1913,39,40-44,1952,1.4755599389538794
STAT,1879,37,na,1916,2483.1995188125366
SIM,1826,94,na,1920,31
SIM,1846,21,45-49,1867,3
SIM,1947,19,35-39,1966,6
STAT,1862,37,na,1899,2054.9311202383174
STAT,1903,36,20-24,1939,0.24047646178418014
SIM,1853,27,45-49,1880,2
STAT,1805,50,15-19,1855,1.0528782554530049E-4
STAT,1882,6,na,1888,2583.7682165786814
STAT,1895,18,45-49,1913,0.08593225760479282
SIM,1831,26,30-34,1857,33
STAT,1839,92,na,1931,29.528304487858986
STAT,1895,39,25-29,1934,3.759334916584821
SIM,1831,57,na,1888,1336
STAT,1907,47,45-49,1954,0.19653217830854522
SIM,1907,23,50-100,1930,4
STAT,1875,46,45-49,1921,0.2454783121228026
SIM,1927,31,50-100,1958,1
STAT,1939,19,35-39,1958,4.23743738286545
STAT,1819,88,na,1907,69.78988678366363
STAT,1851,27,50-100,1878,0.5671267696915918
STAT,1885,26,35-39,1911,9.733721095866347
SIM,1921,39,40-44,1960,2
SIM,1818,39,45-49,1857,5
SIM,1906,15,30-34,1921,2
STAT,1845,27,45-49,1872,0.9874761593818459
STAT,1924,18,35-39,1942,5.036189953619291
SIM,1915,23,30-34,1938,44
SIM,1840,93,na,1933,11
STAT,1838,21,45-49,1859,0.6100121885997504
STAT,1860,34,30-34,1894,14.291789126496406
STAT,1809,45,35-39,1854,0.5299108447182961
STAT,1872,41,15-19,1913,0.014086239218922889
SIM,1898,30,20-24,1928,4
SIM,1843,42,25-29,1885,1
SIM,1893,33,25-29,1926,19
STAT,1892,46,45-49,1938,0.16919717054630967
STAT,1907,30,20-24,1937,2.3206173718061183
SIM,1913,50,na,1963,3531
STAT,1871,41,na,1912,2329.647549953833
STAT,1823,102,na,1925,0.16214437156198164
STAT,1899,46,30-34,1945,0.07590330582735647
SIM,1857,24,25-29,1881,64
STAT,1867,36,na,1903,2251.8434650917948
STAT,1924,30,20-24,1954,2.8886108588823696
STAT,1849,42,25-29,1891,0.5014542017033996
STAT,1881,27,30-34,1908,24.51622773209257
STAT,1862,50,45-49,1912,0.012839923272884421
SIM,1826,35,35-39,1861,17
STAT,1934,12,na,1946,5415.260059061744
STAT,1937,31,45-49,1968,1.5725901457473956
STAT,1811,92,na,1903,18.15675532986215
STAT,1838,45,30-34,1883,0.06839674364909602
SIM,1882,16,30-34,1898,2
STAT,1791,67,na,1858,667.6183581986701
STAT,1885,33,25-29,1918,10.2538220265808
STAT,1899,15,25-29,1914,7.891441392816681
STAT,1874,16,30-34,1890,1.65241159919265
STAT,1823,52,30-34,1875,0.00788602468877046
STAT,1839,50,45-49,1889,0.01054492228363212
SIM,1898,15,30-34,1913,2
SIM,1950,21,25-29,1971,167
STAT,1821,44,20-24,1865,0.23910592166195854
STAT,1841,16,20-24,1857,17.200200674963057
SIM,1857,21,20-24,1878,77
STAT,1879,29,15-19,1908,0.47478459458333033
STAT,1866,24,25-29,1890,53.20280366420336
STAT,1901,44,45-49,1945,0.145163484965628
SIM,1864,19,20-24,1883,24
SIM,1830,32,20-24,1862,3
STAT,1888,14,na,1902,3068.6725688799884
SIM,1877,25,40-44,1902,2
SIM,1929,20,20-24,1949,3
STAT,1846,38,15-19,1884,0.04404216778317278
SIM,1848,27,35-39,1875,14
SIM,1865,24,30-34,1889,17
SIM,1836,25,na,1861,2127
SIM,1860,54,na,1914,1887
STAT,1869,31,na,1900,2352.8344321038503
STAT,1893,41,35-39,1934,2.332770388766468
STAT,1926,26,50-100,1952,1.210055121267922
SIM,1864,68,na,1932,1785
SIM,1842,31,25-29,1873,9
STAT,1856,19,20-24,1875,16.041833989143317
STAT,1870,22,25-29,1892,56.77552453471338
STAT,1835,32,30-34,1867,16.69004380024225
STAT,1922,27,na,1949,4282.365365295581
SIM,1844,34,40-44,1878,3
SIM,1881,28,35-39,1909,16
STAT,1942,21,25-29,1963,97.81652639185452
STAT,1918,47,20-24,1965,0.011872684895410731
STAT,1845,19,45-49,1864,0.059618302592037174
STAT,1836,34,40-44,1870,3.387001849416445
STAT,1822,32,20-24,1854,8.323004156588151
STAT,1941,18,35-39,1959,4.3621700848787395
SIM,1883,37,50-100,1920,1
STAT,1924,3,na,1927,4880.855515485211
SIM,1880,26,25-29,1906,39
STAT,1890,43,30-34,1933,1.4086258591690735
STAT,1867,44,45-49,1911,1.404420523430112
STAT,1871,32,40-44,1903,4.3515663206801936
STAT,1867,30,25-29,1897,9.821305329244055
STAT,1896,40,45-49,1936,0.14034791981856654
STAT,1868,51,25-29,1919,0.0034354316753094725
STAT,1903,39,25-29,1942,0.8849043644718856
SIM,1852,19,na,1871,2108
SIM,1875,44,45-49,1919,3
STAT,1880,5,na,1885,2858.3037698971675
STAT,1863,22,na,1885,2158.6365166215414
SIM,1929,28,30-34,1957,53
STAT,1844,32,25-29,1876,9.690775127033255
STAT,1924,32,50-100,1956,0.9747375381400859
STAT,1933,37,45-49,1970,0.9383121970983247
STAT,1862,16,40-44,1878,0.18379438129341166
STAT,1876,43,25-29,1919,0.6648313915411499
SIM,1890,20,na,1910,3192
SIM,1957,6,na,1963,5438
STAT,1865,22,15-19,1887,3.0795294181841912
SIM,1918,20,45-49,1938,1
STAT,1809,52,25-29,1861,0.011376183666141104
STAT,1875,22,25-29,1897,59.376149398466644
SIM,1841,31,na,1872,1789
SIM,1874,24,25-29,1898,90
SIM,1816,64,na,1880,906
STAT,1853,49,15-19,1902,3.238836841456127E-4
STAT,1887,44,15-19,1931,0.015362397548914258
SIM,1911,39,25-29,1950,1
STAT,1853,31,50-100,1884,0.7884325503086251
STAT,1903,20,na,1923,3422.2150549031708
STAT,1861,22,30-34,1883,15.358198168905957
STAT,1880,25,20-24,1905,12.528095500737546
STAT,1854,43,20-24,1897,0.11832606580601261
SIM,1848,10,na,1858,2250
STAT,1897,28,20-24,1925,15.829159405838213
SIM,1924,31,25-29,1955,10
STAT,1864,29,20-24,1893,10.61547728302274
SIM,1812,50,na,1862,1240
SIM,1877,44,50-100,1921,2
SIM,1839,34,30-34,1873,8
STAT,1874,49,35-39,1923,0.1417635105396051
SIM,1858,30,50-100,1888,1
STAT,1803,57,na,1860,1283.9896698470855
STAT,1887,28,na,1915,2681.680400720852
STAT,1877,35,40-44,1912,4.606548377404288
STAT,1891,65,na,1956,2139.6944238620795
STAT,1812,48,15-19,1860,9.079190238855201E-4
STAT,1890,25,30-34,1915,31.28936109733366
SIM,1781,81,na,1862,99
STAT,1840,29,35-39,1869,8.31277641420336
STAT,1928,28,na,1956,4662.650606051435
SIM,1928,17,30-34,1945,21
SIM,1952,19,15-19,1971,2
SIM,1934,28,na,1962,5149
STAT,1787,93,na,1880,5.893715043346271
STAT,1873,28,35-39,1901,9.84485386907577
SIM,1854,32,50-100,1886,1
STAT,1823,34,30-34,1857,35.84525414518639
STAT,1858,18,40-44,1876,0.1683002520422162
STAT,1872,21,45-49,1893,0.710212629584438
SIM,1811,65,na,1876,1006
SIM,1831,34,30-34,1865,18
STAT,1916,16,35-39,1932,0.9006426685770887
STAT,1895,47,25-29,1942,0.042654907502586416
SIM,1821,34,20-24,1855,2
SIM,1930,34,na,1964,5182
STAT,1908,25,40-44,1933,4.516076549727289
STAT,1826,50,35-39,1876,0.008513106409312708
SIM,1860,35,35-39,1895,11
STAT,1808,107,na,1915,0.001777949917971862
SIM,1800,65,na,1865,842
STAT,1780,112,na,1892,2.687603464148016E-4
STAT,1944,19,15-19,1963,49.28520792748445
SIM,1836,24,40-44,1860,2
SIM,1849,22,25-29,1871,54
STAT,1825,40,50-100,1865,1.5862531653587877
STAT,1832,54,na,1886,1457.5691375789777
STAT,1857,54,30-34,1911,0.0045630347381209095
SIM,1804,79,na,1883,289
SIM,1895,36,na,1931,3229
STAT,1836,26,40-44,1862,2.462932209847698
STAT,1809,58,na,1867,1202.483255961232
STAT,1849,53,40-44,1902,0.008098914514474524
STAT,1916,31,25-29,1947,9.669183214982311
STAT,1866,17,35-39,1883,0.5267280052938261
STAT,1939,27,na,1966,3801.911736502063
SIM,1862,45,50-100,1907,1
STAT,1836,52,40-44,1888,0.006719771693847531
STAT,1911,55,na,1966,3398.744064630051
SIM,1839,37,na,1876,1688
STAT,1814,73,na,1887,589.28913716035
STAT,1852,35,35-39,1887,5.506325383136753
STAT,1950,20,20-24,1970,133.36497637610015
STAT,1834,31,25-29,1865,7.895161343633074
SIM,1852,25,35-39,1877,14
SIM,1853,96,na,1949,6
STAT,1890,76,na,1966,1519.2730185809285
STAT,1908,21,25-29,1929,85.9800428917138
STAT,1834,89,na,1923,62.530851362851706
SIM,1916,21,25-29,1937,114
STAT,1768,115,na,1883,3.349646392578052E-4
STAT,1898,44,na,1942,3132.635474079969
STAT,1843,36,50-100,1879,0.9767921008543069
STAT,1844,25,35-39,1869,9.481061594234562
STAT,1901,26,45-49,1927,1.5774257314057114
STAT,1881,71,na,1952,1299.515770074003
SIM,1838,37,20-24,1875,3
SIM,1834,43,45-49,1877,2
STAT,1856,40,na,1896,1807.7585788864023
STAT,1838,39,20-24,1877,0.6098673649537748
STAT,1870,15,35-39,1885,0.555916773795474
SIM,1848,19,35-39,1867,2
SIM,1884,33,30-34,1917,5
SIM,1868,43,50-100,1911,2
SIM,1888,22,50-100,1910,2
SIM,1895,37,25-29,1932,5
STAT,1781,77,na,1858,187.54050184202666
STAT,1906,18,50-100,1924,0.07188329429228914
STAT,1934,28,na,1962,5089.600262131468
SIM,1864,27,20-24,1891,11
STAT,1900,3,na,1903,3709.0586348241236
STAT,1931,34,30-34,1965,20.83735296516038
STAT,1808,52,40-44,1860,0.03563962066613852
SIM,1818,75,na,1893,419
SIM,1906,25,30-34,1931,42
STAT,1873,25,30-34,1898,25.95891516382635
STAT,1899,19,40-44,1918,0.2521717771551256
STAT,1853,29,45-49,1882,0.9541056456813172
SIM,1854,85,na,1939,199
SIM,1840,27,35-39,1867,10
SIM,1897,18,20-24,1915,24
STAT,1874,19,35-39,1893,0.5644260635069468
STAT,1889,18,20-24,1907,22.02116306329462
SIM,1890,15,30-34,1905,2
STAT,1858,101,na,1959,0.8847380429869367
STAT,1869,46,20-24,1915,0.011816957875426304
SIM,1898,22,20-24,1920,90
STAT,1856,27,20-24,1883,9.413316666175769
SIM,1924,16,35-39,1940,9
STAT,1849,32,25-29,1881,8.438654778861062
STAT,1855,37,30-34,1892,4.011684285075422
SIM,1940,25,30-34,1965,48
SIM,1914,17,30-34,1931,8
STAT,1924,26,35-39,1950,17.725127515741125
SIM,1857,32,25-29,1889,15
SIM,1861,29,45-49,1890,2
STAT,1858,45,30-34,1903,0.07746771751352377
STAT,1871,29,15-19,1900,0.4520023112500673
STAT,1876,33,30-34,1909,18.13090638845996
SIM,1938,20,45-49,1958,1
STAT,1882,29,na,1911,2318.1615997887084
SIM,1903,29,25-29,1932,70
STAT,1831,25,25-29,1856,38.95460127358533
STAT,1872,33,15-19,1905,0.14399349872237047
STAT,1895,15,40-44,1910,0.24236328251927564
STAT,1906,17,30-34,1923,2.3447468866141503
STAT,1880,9,na,1889,2769.3810119891
STAT,1864,18,15-19,1882,5.56219730187514
SIM,1903,49,50-100,1952,1
SIM,1946,15,25-29,1961,63
STAT,1793,62,na,1855,868.0234000000002
STAT,1852,27,35-39,1879,8.523191159163934
SIM,1847,56,na,1903,1450
STAT,1792,84,na,1876,105.36841459030477
STAT,1858,7,na,1865,2291.009125278334
STAT,1803,104,na,1907,0.02780482662128557
STAT,1875,71,na,1946,1384.4785378883598
STAT,1918,29,15-19,1947,0.7530603375137584
SIM,1775,81,na,1856,155
SIM,1838,29,20-24,1867,11
SIM,1883,43,40-44,1926,9
STAT,1875,43,40-44,1918,2.3161352467705236
SIM,1817,42,30-34,1859,2
SIM,1873,22,15-19,1895,3
STAT,1869,47,na,1916,2198.9506107886536
STAT,1916,23,25-29,1939,97.3761401545379
SIM,1853,7,na,1860,2235
STAT,1938,15,25-29,1953,43.355712251799055
STAT,1888,20,45-49,1908,0.8362451136856457
STAT,1832,27,35-39,1859,8.862388228349392
STAT,1923,12,na,1935,4700.991533676281
SIM,1945,21,15-19,1966,4
SIM,1937,19,25-29,1956,64
SIM,1904,30,45-49,1934,4
SIM,1936,3,na,1939,4009
STAT,1846,74,na,1920,842.2017720750425
STAT,1905,44,30-34,1949,0.11499384090413407
SIM,1875,16,na,1891,2514
STAT,1910,33,na,1943,3663.6677014296897
STAT,1780,99,na,1879,0.31154171303117095
SIM,1896,20,45-49,1916,1
SIM,1924,23,25-29,1947,177
STAT,1799,94,na,1893,6.706763848013881
STAT,1898,25,30-34,1923,34.71319666638853
STAT,1851,37,na,1888,1803.0208335756115
SIM,1896,39,35-39,1935,3
STAT,1877,27,40-44,1904,3.1226456628126593
STAT,1867,51,35-39,1918,0.008228307697935042
STAT,1813,45,25-29,1858,0.1739229167204704
STAT,1848,29,35-39,1877,9.270214619121402
STAT,1880,36,25-29,1916,3.068693712387689
SIM,1906,18,35-39,1924,5
SIM,1947,16,30-34,1963,31
STAT,1834,42,40-44,1876,1.6148817563394278
STAT,1875,32,25-29,1907,10.623808314953052
SIM,1819,88,na,1907,33
SIM,1862,38,25-29,1900,5
SIM,1856,17,20-24,1873,20
STAT,1857,24,30-34,1881,14.539021492508924
SIM,1860,27,35-39,1887,9
STAT,1823,77,na,1900,478.0637045617138
SIM,1946,13,na,1959,4456
STAT,1929,19,25-29,1948,55.59905474833904
STAT,1836,91,na,1927,36.537488480296865
STAT,1881,54,20-24,1935,6.986569454620437E-4
SIM,1843,32,30-34,1875,3
STAT,1866,47,35-39,1913,0.13032214595487734
SIM,1861,40,25-29,1901,2
SIM,1872,35,30-34,1907,9
STAT,1921,6,na,1927,4614.256526774374
STAT,1939,16,30-34,1955,12.320447639976406
STAT,1899,13,na,1912,3574.2012096835697
SIM,1842,42,40-44,1884,6
SIM,1865,31,20-24,1896,3
SIM,1883,32,25-29,1915,16
STAT,1848,17,20-24,1865,17.943421663683036
STAT,1859,36,35-39,1895,5.77323955107496
STAT,1864,53,30-34,1917,0.005337971832511818
STAT,1880,22,na,1902,2508.6318828576077
STAT,1932,25,30-34,1957,51.90910476607078
SIM,1932,15,30-34,1947,21
SIM,1866,70,na,1936,1423
STAT,1882,41,50-100,1923,1.0382538250004194
SIM,1884,20,na,1904,2349
STAT,1828,45,20-24,1873,0.011226665331701514
STAT,1909,45,na,1954,3439.2862651253126
SIM,1822,39,35-39,1861,8
STAT,1841,48,40-44,1889,0.1269690840731428
STAT,1905,31,na,1936,3528.242492012706
STAT,1834,93,na,1927,17.39578756748495
STAT,1849,21,20-24,1870,65.6129536825777
STAT,1850,53,30-34,1903,0.004484766618774265
SIM,1881,16,na,1897,2233
STAT,1861,50,25-29,1911,0.0030154605295739305
SIM,1898,33,25-29,1931,21
SIM,1870,24,40-44,1894,4
STAT,1917,12,na,1929,4289.775795370251
STAT,1815,42,na,1857,1381.3844278098131
STAT,1862,24,40-44,1886,1.833973592220177
STAT,1818,46,40-44,1864,0.3094068115920631
STAT,1857,31,20-24,1888,2.166201875556812
STAT,1924,15,30-34,1939,14.735508173792468
SIM,1876,53,na,1929,2448
STAT,1895,36,20-24,1931,1.021614985413224
STAT,1896,19,50-100,1915,0.06514702749392881
STAT,1831,32,15-19,1863,0.11787502003422558
STAT,1830,28,15-19,1858,0.47512703663204586
STAT,1918,22,45-49,1940,1.2251439807683693
STAT,1901,8,na,1909,3680.586878775228
SIM,1885,27,40-44,1912,3
STAT,1888,39,35-39,1927,8.346850873870316
STAT,1921,27,25-29,1948,74.08890691672742
STAT,1937,21,15-19,1958,5.2349386288151125
SIM,1840,16,30-34,1856,1
STAT,1852,43,na,1895,1740.1636010758166
SIM,1940,28,na,1968,4137
STAT,1867,83,na,1950,377.62273314303616
STAT,1908,22,50-100,1930,0.6106372126865512
STAT,1900,17,35-39,1917,0.7698450481641687
SIM,1861,34,40-44,1895,5
STAT,1924,33,25-29,1957,10.88972372771254
STAT,1863,44,50-100,1907,0.9326467509748295
STAT,1814,44,30-34,1858,2.9212973574235654
SIM,1923,21,15-19,1944,5
STAT,1840,52,30-34,1892,0.004150450488224823
STAT,1843,35,45-49,1878,1.6025725294546858
SIM,1921,21,na,1942,4082
STAT,1825,46,35-39,1871,0.19060868600183406
STAT,1916,37,45-49,1953,0.7045190069489056
SIM,1880,23,20-24,1903,78
SIM,1887,32,na,1919,2681
STAT,1860,32,40-44,1892,3.5805083137774147
STAT,1907,50,na,1957,3275.1095681754796
SIM,1891,39,35-39,1930,13
SIM,1884,41,35-39,1925,5
SIM,1833,23,25-29,1856,63
STAT,1874,50,50-100,1924,0.01584355947258788
STAT,1863,33,20-24,1896,2.4087316853243785
STAT,1903,18,15-19,1921,8.513971333266431
STAT,1951,15,40-44,1966,1.683711509464992
STAT,1907,29,50-100,1936,0.9340992063197936
STAT,1851,31,25-29,1882,8.156419323708088
STAT,1860,37,35-39,1897,5.839591803302282
STAT,1872,28,15-19,1900,0.4590773746165581
STAT,1879,42,15-19,1921,0.01453763768029084
STAT,1919,38,25-29,1957,1.0669309993323939
STAT,1834,37,50-100,1871,0.9094885546829673
SIM,1822,44,30-34,1866,1
SIM,1847,36,30-34,1883,11
STAT,1946,21,45-49,1967,1.265037579474836
STAT,1858,38,50-100,1896,0.9680215725801806
STAT,1852,37,50-100,1889,0.9361624764132028
STAT,1883,39,35-39,1922,6.920314815918332
STAT,1892,37,35-39,1929,8.96407346879431
SIM,1794,84,na,1878,181
SIM,1952,13,na,1965,4780
SIM,1835,71,na,1906,695
STAT,1853,34,40-44,1887,3.617303221520043
STAT,1825,41,na,1866,2020.291241942736
STAT,1922,32,50-100,1954,0.9437328893106852
STAT,1915,21,15-19,1936,5.569097732191089
STAT,1916,27,na,1943,3908.901393953756
SIM,1932,33,25-29,1965,15
STAT,1951,20,35-39,1971,11.373738865250933
SIM,1838,52,na,1890,1544
SIM,1875,47,na,1922,2243
SIM,1835,19,na,1854,1827
SIM,1820,42,na,1862,1462
SIM,1856,40,45-49,1896,1
STAT,1881,35,30-34,1916,5.2379704750595595
SIM,1929,23,25-29,1952,131
STAT,1918,35,50-100,1953,0.45101549687773473
SIM,1900,52,na,1952,3205
SIM,1852,22,30-34,1874,21
STAT,1809,50,35-39,1859,0.028834745264418135
STAT,1913,42,15-19,1955,0.0015110019219791314
STAT,1912,13,na,1925,4022.8036529824026
SIM,1837,73,na,1910,756
STAT,1857,27,35-39,1884,7.8340029948369
STAT,1937,17,30-34,1954,11.970862079233527
STAT,1825,41,25-29,1866,0.942213967676181
STAT,1898,49,50-100,1947,0.1857280589394819
STAT,1913,1,na,1914,4293.940168056911
STAT,1851,96,na,1947,6.501712269052035
STAT,1892,71,na,1963,1920.1806896267678
SIM,1856,29,35-39,1885,7
STAT,1922,48,25-29,1970,0.06139143325295788
STAT,1911,26,50-100,1937,0.9826598954753744
STAT,1876,41,35-39,1917,1.8969389077508076
STAT,1840,58,na,1898,1386.2714237248538
SIM,1856,22,15-19,1878,4
SIM,1896,28,30-34,1924,38
STAT,1837,43,20-24,1880,0.12621964286700602
SIM,1893,72,na,1965,1983
STAT,1813,56,na,1869,1156.4447342585688
STAT,1849,50,25-29,1899,0.0028091295055988415
STAT,1849,55,na,1904,1616.6478349298893
STAT,1840,25,na,1865,1918.2082969817257
SIM,1878,17,na,1895,2956
STAT,1861,95,na,1956,12.867943191379151
SIM,1945,17,30-34,1962,20
STAT,1851,36,35-39,1887,5.469379996269838
STAT,1840,53,20-24,1893,5.0896701810806E-4
STAT,1844,22,30-34,1866,17.59577546649121
SIM,1805,64,na,1869,798
STAT,1881,47,50-100,1928,0.23799294360293247
SIM,1826,67,na,1893,1182
STAT,1923,43,50-100,1966,0.1385172049305521
STAT,1840,34,30-34,1874,14.600684057710012
SIM,1835,44,40-44,1879,7
SIM,1889,35,25-29,1924,5
STAT,1899,47,45-49,1946,0.18366931374810416
SIM,1870,42,40-44,1912,4
STAT,1942,27,45-49,1969,1.830741706102548
SIM,1932,26,35-39,1958,23
STAT,1869,20,30-34,1889,17.670604204139813
SIM,1862,73,na,1935,1083
SIM,1956,12,na,1968,5292
STAT,1859,47,40-44,1906,0.13842349032773127
STAT,1909,20,25-29,1929,87.1471645877404
STAT,1848,22,15-19,1870,3.2796315235061306
STAT,1920,32,na,1952,4183.389269052461
SIM,1889,67,na,1956,1865
SIM,1900,22,25-29,1922,2
STAT,1922,47,35-39,1969,0.149631265580545
SIM,1879,36,30-34,1915,9
SIM,1912,24,20-24,1936,110
STAT,1862,42,40-44,1904,1.959448678883831
STAT,1852,105,na,1957,0.03375613489935086
STAT,1890,21,15-19,1911,4.083818522506939
SIM,1927,38,25-29,1965,1
STAT,1836,30,25-29,1866,8.338792654536304
SIM,1909,4,na,1913,4284
SIM,1872,94,na,1966,17
STAT,1880,86,na,1966,482.56472353095126
SIM,1939,31,20-24,1970,2
SIM,1851,30,na,1881,2071
STAT,1888,28,30-34,1916,29.913967730253276
STAT,1928,33,50-100,1961,1.0442946728871811
SIM,1893,65,na,1958,2339
STAT,1897,29,50-100,1926,0.8599903500675411
SIM,1920,19,30-34,1939,21
SIM,1843,11,na,1854,2773
STAT,1841,19,25-29,1860,5.401277392155062
SIM,1847,25,na,1872,2081
STAT,1858,43,40-44,1901,1.7694210885710946
STAT,1827,44,40-44,1871,2.3380717611377
STAT,1838,70,na,1908,939.2550226590171
STAT,1837,105,na,1942,0.020001962989826365
STAT,1845,16,40-44,1861,0.16991605502931492
STAT,1908,49,50-100,1957,0.20527466067968989
SIM,1866,43,40-44,1909,6
STAT,1904,42,20-24,1946,0.01596494967669582
STAT,1925,30,35-39,1955,10.979369373407684
STAT,1826,43,45-49,1869,1.53057181493951
STAT,1912,19,30-34,1931,2.4733073900711986
STAT,1910,34,45-49,1944,1.5176728855182013
SIM,1889,21,15-19,1910,6
STAT,1947,19,na,1966,4185.324005438238
SIM,1820,41,na,1861,1483
SIM,1877,20,30-34,1897,26
STAT,1857,49,35-39,1906,0.1080500947055587
SIM,1885,46,na,1931,2431
STAT,1839,36,30-34,1875,4.562516660948767
SIM,1801,75,na,1876,239
SIM,1886,15,40-44,1901,1
SIM,1892,30,25-29,1922,5
SIM,1843,40,35-39,1883,7
STAT,1894,35,40-44,1929,5.74628144712501
STAT,1889,41,45-49,1930,1.872340725091344
STAT,1918,38,na,1956,3999.3580941347036
SIM,1829,37,30-34,1866,1
STAT,1821,47,25-29,1868,0.0844228983018981
STAT,1904,49,40-44,1953,0.1370493998010705
STAT,1931,41,15-19,1972,0.0020763942616241673
STAT,1842,16,35-39,1858,0.6381477351416038
STAT,1893,34,45-49,1927,2.2172031740200673
STAT,1815,54,25-29,1869,0.007212926588154434
SIM,1830,39,40-44,1869,5
STAT,1837,69,na,1906,1001.1281279484915
SIM,1844,30,25-29,1874,17
STAT,1921,34,20-24,1955,2.718025908549848
SIM,1940,28,35-39,1968,2
STAT,1908,39,na,1947,3519.9594856511017
STAT,1834,25,na,1859,1712.8957458325501
STAT,1835,40,35-39,1875,1.6714021014471843
STAT,1896,46,30-34,1942,0.0732075192428365
SIM,1871,54,na,1925,1968
SIM,1892,36,45-49,1928,5
STAT,1855,55,na,1910,1556.411099768608
SIM,1831,26,na,1857,1861
SIM,1903,26,20-24,1929,16
STAT,1932,28,35-39,1960,19.863130881741537
SIM,1784,85,na,1869,65
SIM,1855,39,na,1894,1993
STAT,1877,53,40-44,1930,0.010798063695450262
SIM,1891,20,45-49,1911,2
STAT,1842,38,35-39,1880,7.392974274555707
STAT,1882,45,25-29,1927,0.056914632775700184
STAT,1863,20,50-100,1883,0.37760298725226465
STAT,1912,26,20-24,1938,18.21081144759312
STAT,1892,25,50-100,1917,0.8162330977468387
SIM,1920,26,20-24,1946,31
SIM,1923,28,35-39,1951,22
SIM,1864,25,30-34,1889,51
STAT,1915,28,35-39,1943,15.397758331832147
STAT,1898,26,50-100,1924,0.8788781907844805
STAT,1883,20,45-49,1903,0.6933248883233848
STAT,1921,49,40-44,1970,0.1784569960052325
SIM,1850,55,na,1905,1739
STAT,1856,25,30-34,1881,20.49926939376151
STAT,1916,20,20-24,1936,118.28670083587865
STAT,1797,99,na,1896,0.47284819054964666
SIM,1862,18,na,1880,2385
SIM,1919,27,30-34,1946,64
SIM,1868,27,40-44,1895,4
STAT,1868,45,40-44,1913,0.1669053466051916
SIM,1848,34,25-29,1882,8
STAT,1896,64,na,1960,2446.9596452247183
STAT,1892,50,na,1942,2768.1709343968305
STAT,1925,25,40-44,1950,5.601414155279768
STAT,1869,25,40-44,1894,2.9614756370365205
SIM,1850,38,35-39,1888,13
STAT,1848,17,na,1865,2323.2657103950714
SIM,1895,34,20-24,1929,7
STAT,1888,45,na,1933,2708.8004714487606
SIM,1897,23,15-19,1920,8
STAT,1904,24,20-24,1928,99.25777917043479
STAT,1879,40,50-100,1919,1.1247357202773798
STAT,1878,49,15-19,1927,4.106251889508298E-4
SIM,1867,24,na,1891,2150
STAT,1890,47,25-29,1937,0.039912416833652244
STAT,1910,16,45-49,1926,0.10010947483372071
STAT,1865,26,30-34,1891,23.303857383811255
SIM,1790,85,na,1875,104
SIM,1883,35,na,1918,2690
STAT,1833,40,na,1873,1848.900950362703
STAT,1887,34,20-24,1921,3.021996681365569
STAT,1888,19,15-19,1907,7.036707421555308
SIM,1810,79,na,1889,364
SIM,1935,34,na,1969,5147
STAT,1858,48,35-39,1906,0.10954023068292215
STAT,1852,40,35-39,1892,1.3871637474671472
SIM,1885,35,40-44,1920,6
SIM,1931,20,na,1951,4506
STAT,1773,86,na,1859,69.78205574196633
STAT,1904,24,50-100,1928,0.587358954317736
SIM,1903,29,na,1932,3205
STAT,1812,53,45-49,1865,0.03140176983956913
STAT,1889,23,15-19,1912,4.09588984023173
STAT,1898,35,25-29,1933,3.979661780603936
SIM,1928,31,45-49,1959,3
STAT,1832,82,na,1914,317.7072612571472
SIM,1862,40,na,1902,2140
STAT,1831,27,15-19,1858,0.3952012605476555
STAT,1858,46,45-49,1904,0.18753417049481966
STAT,1859,40,20-24,1899,0.13031122784867347
SIM,1933,25,40-44,1958,9
STAT,1880,40,35-39,1920,1.9401302377552374
SIM,1889,28,35-39,1917,18
STAT,1950,16,35-39,1966,5.014151889345197
STAT,1832,54,25-29,1886,0.002418483726196624
STAT,1865,72,na,1937,1164.712406791834
SIM,1818,44,40-44,1862,4
SIM,1873,26,30-34,1899,37
SIM,1852,74,na,1926,723
STAT,1898,28,35-39,1926,13.164893307456296
SIM,1869,39,25-29,1908,2
STAT,1849,37,50-100,1886,0.9822461165228431
STAT,1929,22,20-24,1951,142.12543570374532
STAT,1905,40,15-19,1945,0.0014143362717359748
STAT,1903,51,na,1954,3112.0489091747654
STAT,1817,45,45-49,1862,0.5238982168363231
SIM,1941,29,50-100,1970,1
SIM,1924,20,20-24,1944,12
STAT,1861,30,35-39,1891,8.567764896606347
STAT,1922,40,15-19,1962,0.0017856322169412758
STAT,1886,71,na,1957,1485.4178021954485
SIM,1896,19,15-19,1915,8
STAT,1874,30,45-49,1904,1.8179390909879083
STAT,1841,44,25-29,1885,0.4863790810975462
SIM,1871,5,na,1876,2677
SIM,1869,21,35-39,1890,10
STAT,1916,31,na,1947,3956.5971180413994
STAT,1821,41,40-44,1862,3.6917615480610775
SIM,1937,22,20-24,1959,104
STAT,1857,34,25-29,1891,8.004551204435026
STAT,1930,39,40-44,1969,1.9693596021161686
SIM,1915,14,na,1929,4525
STAT,1844,55,na,1899,1635.9423019700373
STAT,1940,31,15-19,1971,0.1343455770531669
STAT,1929,15,30-34,1944,15.795601692076893
STAT,1816,48,35-39,1864,0.35665721018703905
STAT,1853,54,45-49,1907,0.01167139452385503
SIM,1895,20,na,1915,3122
STAT,1822,46,30-34,1868,0.14555020388054515
SIM,1870,20,25-29,1890,74
STAT,1928,12,na,1940,5046.305375194412
STAT,1852,33,45-49,1885,1.3551467858166941
STAT,1930,32,20-24,1962,3.181588018001834
STAT,1854,50,35-39,1904,0.006553830286064912
SIM,1860,33,45-49,1893,6
STAT,1820,97,na,1917,2.734591013977692
STAT,1869,16,na,1885,2529.2802498087676
SIM,1855,91,na,1946,58
STAT,1837,48,15-19,1885,2.796651753283272E-4
SIM,1839,37,35-39,1876,15
SIM,1882,30,45-49,1912,1
STAT,1884,36,45-49,1920,1.9950591300623322
STAT,1878,44,20-24,1922,0.16426073195388435
SIM,1838,35,30-34,1873,4
STAT,1872,51,na,1923,2196.832403085226
SIM,1841,19,na,1860,2049
STAT,1853,91,na,1944,47.92148449282483
STAT,1856,36,na,1892,1833.1227636288459
STAT,1859,33,30-34,1892,14.123296693530378
STAT,1846,10,na,1856,2304.2976542828997
SIM,1859,37,40-44,1896,1
SIM,1835,78,na,1913,412
STAT,1875,16,na,1891,2626.0366317644925
SIM,1921,14,na,1935,4512
SIM,1865,34,25-29,1899,7
STAT,1853,37,45-49,1890,1.6485667204347185
STAT,1822,39,40-44,1861,7.459176747288383
SIM,1860,24,30-34,1884,21
STAT,1837,17,45-49,1854,0.08819055722834061
STAT,1862,20,25-29,1882,51.855560507067
SIM,1937,15,30-34,1952,16
STAT,1897,26,30-34,1923,34.21478753924345
STAT,1852,24,30-34,1876,15.818076531200871
SIM,1849,91,na,1940,23
STAT,1849,54,na,1903,1637.166340097663
STAT,1833,48,35-39,1881,0.10462194765999458
STAT,1887,39,15-19,1926,0.06268515159092582
STAT,1808,46,35-39,1854,0.5256683097059597
STAT,1860,35,45-49,1895,1.66150664584427
STAT,1863,36,25-29,1899,2.5889652357371964
SIM,1844,55,na,1899,1382
SIM,1859,41,50-100,1900,2
SIM,1895,29,25-29,1924,62
STAT,1839,39,35-39,1878,5.869237875302616
STAT,1835,46,40-44,1881,0.1372412950786863
STAT,1919,35,20-24,1954,0.2875333594763159
STAT,1889,27,30-34,1916,31.361391717118106
STAT,1904,45,25-29,1949,0.04756285183193028
STAT,1907,33,25-29,1940,8.686501225273348
STAT,1807,56,na,1863,1075.746615070589
SIM,1910,32,45-49,1942,1
SIM,1894,6,na,1900,3751
STAT,1843,70,na,1913,946.3283590990185
STAT,1895,20,na,1915,3138.024681703023
STAT,1831,44,na,1875,1569.7248547847312
SIM,1851,37,35-39,1888,10
SIM,1891,36,30-34,1927,8
STAT,1801,78,na,1879,339.3237236999181
SIM,1861,37,45-49,1898,3
STAT,1908,35,na,1943,3589.5158478034546
STAT,1792,77,na,1869,326.41033466328497
STAT,1878,21,35-39,1899,6.13670841845896
STAT,1879,38,30-34,1917,5.589511864359408
STAT,1779,112,na,1891,5.725871790101447E-4
SIM,1887,38,30-34,1925,7
STAT,1920,18,15-19,1938,51.283423103936464
SIM,1888,26,30-34,1914,44
SIM,1850,92,na,1942,24
SIM,1811,64,na,1875,1063
STAT,1847,84,na,1931,249.07724993172482
STAT,1845,45,20-24,1890,0.008855648383230358
SIM,1828,38,25-29,1866,3
STAT,1871,38,25-29,1909,2.8747264302334887
SIM,1838,38,35-39,1876,21
STAT,1771,108,na,1879,0.0039982448823138
STAT,1888,82,na,1970,986.9424315541739
SIM,1828,92,na,1920,7
STAT,1800,54,30-34,1854,0.01764403618347517
STAT,1930,42,15-19,1972,0.002042239558583862
SIM,1834,34,30-34,1868,15
STAT,1778,85,na,1863,91.48564250037049
SIM,1859,84,na,1943,202
SIM,1856,40,na,1896,2120
STAT,1906,43,30-34,1949,0.11659761425315461
STAT,1934,20,35-39,1954,12.82764702021912
STAT,1826,34,30-34,1860,21.904261328093746
STAT,1836,49,15-19,1885,2.5739601471218667E-4
SIM,1907,37,45-49,1944,1
SIM,1897,27,30-34,1924,50
STAT,1902,32,45-49,1934,2.4888877592568277
STAT,1893,25,30-34,1918,32.5134079379628
STAT,1853,34,50-100,1887,0.764250554793548
STAT,1819,41,na,1860,1462.7089632696382
STAT,1875,37,35-39,1912,7.33615782762451
STAT,1809,49,50-100,1858,0.8138758347859353
SIM,1840,18,20-24,1858,18
STAT,1897,29,35-39,1926,12.971836928008768
STAT,1901,46,15-19,1947,3.203713525993986E-4
STAT,1887,29,25-29,1916,47.360097660049874
SIM,1896,46,na,1942,2993
STAT,1838,104,na,1942,0.04465077349261483
STAT,1896,42,15-19,1938,0.0012805061134904265
STAT,1905,20,45-49,1925,1.024231761599807
STAT,1913,20,15-19,1933,5.235500414145941
STAT,1843,32,40-44,1875,3.516382319868729
SIM,1935,13,na,1948,5388
STAT,1851,40,50-100,1891,0.8080040810806334
SIM,1939,27,na,1966,3846
SIM,1851,32,40-44,1883,7
SIM,1959,3,na,1962,5512
STAT,1883,36,30-34,1919,5.292955158997803
STAT,1835,33,45-49,1868,1.6497300013276504
STAT,1922,44,30-34,1966,0.14774914774981668
SIM,1817,49,50-100,1866,2
SIM,1937,4,na,1941,3847
STAT,1882,15,30-34,1897,1.5666032986328717
STAT,1912,44,20-24,1956,0.017051398949196682
SIM,1921,32,20-24,1953,1
STAT,1921,17,na,1938,4237.445148541315
SIM,1843,33,45-49,1876,2
STAT,1830,37,25-29,1867,2.617560234377416
STAT,1869,16,50-100,1885,0.049063149524966376
SIM,1826,63,na,1889,1333
STAT,1835,26,50-100,1861,0.63050963806735
SIM,1857,37,50-100,1894,3
SIM,1907,35,40-44,1942,3
STAT,1816,45,30-34,1861,0.2579019851636359
STAT,1867,35,30-34,1902,5.117757943739842
SIM,1869,19,20-24,1888,1
SIM,1863,58,na,1921,1767
STAT,1850,53,50-100,1903,0.011378705358735702
SIM,1866,38,50-100,1904,4
STAT,1883,51,50-100,1934,0.014998545292969808
STAT,1933,23,25-29,1956,123.7709122735073
SIM,1846,37,30-34,1883,5
SIM,1941,23,25-29,1964,132
STAT,1837,46,25-29,1883,0.041317055476928176
SIM,1930,35,na,1965,5270
STAT,1899,6,na,1905,3621.123924508113
STAT,1817,47,35-39,1864,0.30104514816021366
SIM,1889,32,20-24,1921,3
SIM,1900,15,35-39,1915,3
STAT,1827,47,45-49,1874,0.24206395552543813
SIM,1856,26,30-34,1882,44
STAT,1850,18,35-39,1868,0.5103976451642628
STAT,1945,25,20-24,1970,20.24217647355558
SIM,1827,52,na,1879,1309
STAT,1909,36,50-100,1945,0.4029531372804137
SIM,1923,28,na,1951,4322
SIM,1845,77,na,1922,687
STAT,1857,46,30-34,1903,0.07651868690445257
STAT,1894,38,45-49,1932,2.5793439497247874
STAT,1884,38,35-39,1922,7.009653248871235
SIM,1847,39,35-39,1886,8
STAT,1910,31,40-44,1941,3.82245566614563
STAT,1859,17,na,1876,2164.4905208254236
STAT,1813,63,na,1876,955.301148878468
STAT,1882,57,na,1939,1966.117598042877
SIM,1864,28,35-39,1892,13
SIM,1854,28,25-29,1882,47
SIM,1892,38,35-39,1930,21
STAT,1817,77,na,1894,395.4787113494628
STAT,1883,35,na,1918,2350.6951068350063
STAT,1936,2,na,1938,3953.0719828743077
SIM,1906,21,15-19,1927,7
SIM,1942,26,50-100,1968,1
STAT,1861,36,40-44,1897,3.691634000492616
SIM,1842,36,35-39,1878,5
STAT,1840,96,na,1936,6.019140938302135
SIM,1855,18,15-19,1873,9
STAT,1847,18,15-19,1865,5.513158300969168
SIM,1916,46,na,1962,3767
SIM,1881,19,20-24,1900,28
SIM,1844,29,45-49,1873,1
STAT,1901,65,na,1966,2653.6943827832274
STAT,1863,47,30-34,1910,0.08622147782689679
STAT,1899,44,40-44,1943,0.21358659329098098
SIM,1832,26,na,1858,1794
SIM,1861,88,na,1949,65
STAT,1840,30,15-19,1870,0.12413886304797697
STAT,1914,41,15-19,1955,0.0015375135226879048
STAT,1856,28,35-39,1884,7.6867105884548605
SIM,1798,81,na,1879,117
STAT,1864,32,na,1896,2174.853287852272
STAT,1834,36,35-39,1870,5.294176741611999
STAT,1846,28,25-29,1874,38.556535931036024
STAT,1863,43,15-19,1906,0.012269001779174048
SIM,1865,39,40-44,1904,6
STAT,1782,105,na,1887,0.02162395400985623
STAT,1936,33,15-19,1969,0.12593448656912187
SIM,1937,18,35-39,1955,5
SIM,1898,16,na,1914,3489
STAT,1812,78,na,1890,354.7336848614
STAT,1896,49,na,1945,2945.6055783829884
SIM,1867,33,30-34,1900,31
STAT,1870,40,25-29,1910,0.6433101831064881
SIM,1839,92,na,1931,9
STAT,1885,30,20-24,1915,2.7393304743985496
STAT,1955,15,25-29,1970,58.149132388610376
SIM,1876,32,na,1908,2753
STAT,1884,30,25-29,1914,10.28358449616972
STAT,1923,21,50-100,1944,0.7758954741113661
STAT,1821,38,15-19,1859,0.10416018269111721
STAT,1842,35,30-34,1877,5.74700992160535
STAT,1882,18,35-39,1900,0.5354217649523477
STAT,1842,44,na,1886,2098.441791089988
SIM,1938,18,30-34,1956,20
SIM,1824,38,40-44,1862,5
SIM,1847,27,20-24,1874,11
STAT,1803,105,na,1908,0.012222723734450925
STAT,1893,21,15-19,1914,4.243578421235056
STAT,1935,29,15-19,1964,0.9712891577872232
STAT,1911,28,na,1939,3672.7676119210832
STAT,1855,41,15-19,1896,0.010441981260014754
STAT,1866,42,25-29,1908,0.5998267789507649
STAT,1881,19,50-100,1900,0.04744101261979598
SIM,1805,50,50-100,1855,1
SIM,1891,29,40-44,1920,7
SIM,1813,60,na,1873,1071
SIM,1897,31,na,1928,3289
SIM,1798,77,na,1875,237
STAT,1883,29,40-44,1912,2.9395686008887023
STAT,1921,40,45-49,1961,0.1898495909914372
SIM,1825,41,na,1866,1416
STAT,1876,34,45-49,1910,1.80296311520452
SIM,1871,36,25-29,1907,3
STAT,1816,38,40-44,1854,17.598421713921024
STAT,1839,27,20-24,1866,10.477905979237278
SIM,1876,34,50-100,1910,1
SIM,1936,2,na,1938,4038
STAT,1930,17,25-29,1947,56.62645053164906
STAT,1929,18,35-39,1947,5.398500656698822
SIM,1828,37,na,1865,1665
SIM,1898,71,na,1969,2161
STAT,1868,34,50-100,1902,0.8768712176558947
SIM,1849,36,na,1885,1932
SIM,1944,27,na,1971,4091
STAT,1860,73,na,1933,980.6401382781268
SIM,1893,30,20-24,1923,4
STAT,1855,45,30-34,1900,0.0735897943432223
SIM,1881,87,na,1968,299
STAT,1798,62,na,1860,1066.6677273743776
STAT,1890,44,20-24,1934,0.19335517987417722
SIM,1831,41,na,1872,1707
SIM,1875,43,na,1918,2292
STAT,1908,30,35-39,1938,8.777484669929308
STAT,1864,54,50-100,1918,0.013385938846169603
SIM,1831,29,35-39,1860,14
STAT,1964,2,na,1966,5004.820985182281
STAT,1864,54,20-24,1918,6.540361258707143E-4
STAT,1876,47,40-44,1923,0.17770237357157942
SIM,1817,43,45-49,1860,1
STAT,1928,31,15-19,1959,0.16250468468753823
SIM,1796,70,na,1866,726
SIM,1908,32,na,1940,3462
STAT,1886,17,40-44,1903,0.1950465410179947
STAT,1940,0,na,1940,4599.027419281664
SIM,1843,26,50-100,1869,1
SIM,1923,25,30-34,1948,77
STAT,1869,28,45-49,1897,1.0864338209875275
STAT,1838,37,30-34,1875,4.305049386560475
SIM,1848,14,na,1862,2221
STAT,1886,46,20-24,1932,0.012833048738117043
STAT,1877,31,25-29,1908,10.720763102116626
SIM,1917,20,25-29,1937,4
STAT,1907,26,35-39,1933,14.360673039080304
STAT,1868,48,45-49,1916,0.22494622244884876
STAT,1899,49,35-39,1948,0.10718113071322999
STAT,1899,23,25-29,1922,79.1059160008037
SIM,1875,35,30-34,1910,9
SIM,1916,30,35-39,1946,13
STAT,1878,15,50-100,1893,0.05160442187957149
SIM,1954,6,na,1960,4839
STAT,1865,17,na,1882,2400.25525650548
STAT,1892,32,25-29,1924,12.981263556657142
STAT,1878,47,25-29,1925,0.060109448434690585
STAT,1915,25,30-34,1940,40.60081617916949
STAT,1872,18,25-29,1890,5.739038643884707
SIM,1866,91,na,1957,28
STAT,1823,53,20-24,1876,9.583477753901387E-4
STAT,1889,20,na,1909,2962.9918412271277
STAT,1865,29,35-39,1894,8.835180912044228
SIM,1879,39,35-39,1918,8
SIM,1873,17,20-24,1890,25
STAT,1829,62,na,1891,1077.6995743351563
STAT,1947,20,45-49,1967,1.2853882059923136
SIM,1912,27,25-29,1939,70
STAT,1909,39,15-19,1948,0.0181574060823571
STAT,1929,25,25-29,1954,83.57664008999144
STAT,1959,6,na,1965,5193.768428518259
SIM,1845,92,na,1937,13
SIM,1867,17,na,1884,2392
STAT,1930,35,25-29,1965,1.300310878788366
STAT,1904,27,25-29,1931,61.31247485292209
SIM,1860,20,15-19,1880,3
STAT,1839,24,50-100,1863,0.3661598333648817
STAT,1822,42,15-19,1864,0.02197116572159415
SIM,1825,42,40-44,1867,1
SIM,1880,18,25-29,1898,8
STAT,1848,40,45-49,1888,1.2521160690945259
SIM,1904,14,na,1918,3879
STAT,1913,50,na,1963,3585.3235800879766
STAT,1927,36,50-100,1963,0.5280953497592733
SIM,1915,26,35-39,1941,2
STAT,1902,14,na,1916,3673.9794168000544
STAT,1862,19,45-49,1881,0.05868387874009505
SIM,1807,60,na,1867,941
SIM,1883,37,35-39,1920,18
STAT,1899,41,25-29,1940,0.06209194231164494
SIM,1928,31,na,1959,4860
SIM,1841,15,30-34,1856,1
SIM,1953,1,na,1954,4982
STAT,1841,17,35-39,1858,0.5292213937864398
SIM,1820,78,na,1898,399
STAT,1865,51,50-100,1916,0.013995244447256626
STAT,1948,24,30-34,1972,33.3139208335339
SIM,1872,27,30-34,1899,39
STAT,1881,53,30-34,1934,0.005702148471539229
SIM,1823,93,na,1916,12
STAT,1865,17,20-24,1882,16.848629002739603
SIM,1829,39,20-24,1868,3
STAT,1914,22,50-100,1936,0.6782563223159122
STAT,1830,59,na,1889,1283.4100445595077
STAT,1909,24,na,1933,3556.6430376456315
SIM,1892,33,40-44,1925,9
SIM,1826,32,30-34,1858,27
SIM,1814,78,na,1892,325
SIM,1820,36,45-49,1856,2
STAT,1873,43,na,1916,2349.405437168227
STAT,1843,37,35-39,1880,5.569086937696421
STAT,1817,42,40-44,1859,5.502738630915041
SIM,1915,33,25-29,1948,19
STAT,1864,27,30-34,1891,22.950460467057802
STAT,1867,37,50-100,1904,1.1678558334054088
STAT,1852,20,15-19,1872,3.0153483554528635
STAT,1885,23,30-34,1908,17.8520264575666
STAT,1927,37,20-24,1964,0.3312674938772822
SIM,1847,24,50-100,1871,3
SIM,1890,21,na,1911,3171
SIM,1893,23,30-34,1916,28
SIM,1938,15,15-19,1953,58
SIM,1937,25,25-29,1962,120
STAT,1884,33,40-44,1917,4.301120312810172
STAT,1937,32,50-100,1969,0.8257969329930365
STAT,1821,82,na,1903,279.47910988003537
STAT,1822,35,25-29,1857,5.804342189388709
SIM,1850,35,30-34,1885,4
SIM,1858,44,45-49,1902,3
STAT,1923,13,na,1936,4693.704996799082
STAT,1880,45,50-100,1925,0.26310767556267123
STAT,1959,11,na,1970,5190.549089237511
STAT,1864,37,20-24,1901,0.7025417897978676
SIM,1961,9,na,1970,5231
STAT,1788,88,na,1876,43.255050925751746
STAT,1872,26,na,1898,2431.641758550648
SIM,1800,96,na,1896,13
SIM,1834,32,40-44,1866,3
STAT,1873,21,15-19,1894,3.3881004549899267
SIM,1920,45,na,1965,4369
SIM,1859,26,35-39,1885,18
STAT,1815,46,25-29,1861,0.12995752719520687
STAT,1832,43,20-24,1875,0.13098894089653212
STAT,1901,28,na,1929,3367.0826849896466
SIM,1902,21,45-49,1923,4
STAT,1893,23,40-44,1916,2.664105284277633
SIM,1843,69,na,1912,1384
STAT,1914,45,30-34,1959,0.08962183646626612
SIM,1909,24,35-39,1933,15
STAT,1875,34,30-34,1909,17.95447767630173
STAT,1866,50,25-29,1916,0.0033602093616428557
STAT,1927,33,na,1960,4699.449521103167
STAT,1882,37,25-29,1919,2.8168555522773766
SIM,1869,74,na,1943,1028
STAT,1900,32,25-29,1932,14.370488118153938
STAT,1857,6,na,1863,2311.292834293542
SIM,1837,33,20-24,1870,3
SIM,1926,35,50-100,1961,3
STAT,1838,33,15-19,1871,0.11723546901397865
STAT,1807,60,na,1867,993.8148442777377
STAT,1932,36,35-39,1968,3.2872052390104107
SIM,1926,21,30-34,1947,48
STAT,1826,32,40-44,1858,6.082011672700729
STAT,1850,34,25-29,1884,8.035834556605343
STAT,1870,20,35-39,1890,5.822092402588106
STAT,1937,32,20-24,1969,2.436222051035626
STAT,1876,26,45-49,1902,1.161845285679983
SIM,1919,35,30-34,1954,2
STAT,1803,94,na,1897,8.331470530623603
STAT,1820,76,na,1896,482.24956803328956
SIM,1812,81,na,1893,181
SIM,1857,55,na,1912,1791
SIM,1941,8,na,1949,4270
STAT,1811,99,na,1910,0.8256173871747026
STAT,1857,52,25-29,1909,0.0027771084772727503
STAT,1828,41,50-100,1869,1.0260736321034392
SIM,1845,20,35-39,1865,5
STAT,1851,17,40-44,1868,0.16838087611303681
STAT,1846,49,20-24,1895,0.008916479687013605
STAT,1946,25,25-29,1971,74.11714423669856
SIM,1846,26,25-29,1872,53
SIM,1890,37,25-29,1927,7
STAT,1824,44,25-29,1868,0.7653809126550384
STAT,1952,10,na,1962,4757.355055916502
SIM,1912,16,na,1928,3857
STAT,1835,49,45-49,1884,0.18205427093765392
SIM,1918,22,35-39,1940,14
SIM,1928,35,25-29,1963,1
STAT,1914,38,25-29,1952,0.9869468332982402
STAT,1883,28,50-100,1911,0.6300280868094743
STAT,1923,36,25-29,1959,1.153754181958807
SIM,1799,60,na,1859,1121
SIM,1894,51,na,1945,3062
SIM,1858,8,na,1866,2352
STAT,1837,20,35-39,1857,5.544301376875956
SIM,1888,49,50-100,1937,1
SIM,1866,29,45-49,1895,1
STAT,1820,42,na,1862,1384.2886436630176
SIM,1895,29,na,1924,3159
SIM,1842,33,30-34,1875,27
STAT,1884,15,50-100,1899,0.04902237814205619
SIM,1924,35,40-44,1959,4
SIM,1867,25,30-34,1892,34
STAT,1786,77,na,1863,344.6683799993627
SIM,1894,20,30-34,1914,40
SIM,1887,38,50-100,1925,2
SIM,1920,35,na,1955,4462
STAT,1866,48,50-100,1914,0.22680701732052094
SIM,1882,56,na,1938,1760
STAT,1841,36,25-29,1877,2.563260074584247
STAT,1931,35,20-24,1966,0.35344540414250214
SIM,1826,33,45-49,1859,1
STAT,1833,108,na,1941,0.0012959366797423869
STAT,1943,27,50-100,1970,1.070361379768263
SIM,1843,25,45-49,1868,1
SIM,1817,90,na,1907,17
SIM,1866,32,na,1898,2431
SIM,1860,22,40-44,1882,1
STAT,1929,33,25-29,1962,11.858962738584875
STAT,1861,58,na,1919,1659.75824600441
SIM,1893,24,45-49,1917,1
STAT,1821,43,45-49,1864,2.318448959907054
SIM,1862,42,45-49,1904,4
STAT,1837,43,50-100,1880,0.8396349995878853
STAT,1918,21,30-34,1939,31.389385744211268
SIM,1936,25,20-24,1961,4
STAT,1845,34,na,1879,1844.185494158269
STAT,1907,29,na,1936,3515.624378678366
SIM,1919,28,25-29,1947,79
STAT,1904,16,20-24,1920,25.759176774428596
STAT,1942,16,na,1958,3884.784487814559
STAT,1834,33,30-34,1867,13.181600290890213
SIM,1787,75,na,1862,393
SIM,1889,39,40-44,1928,10
STAT,1885,24,45-49,1909,0.6966550282442286
SIM,1912,16,20-24,1928,35
STAT,1827,29,15-19,1856,0.7500871067843206
STAT,1890,17,na,1907,3117.0041545309555
STAT,1929,17,20-24,1946,174.88117694048904
SIM,1874,37,na,1911,2305
SIM,1858,33,50-100,1891,4
SIM,1870,37,na,1907,2607
STAT,1852,22,40-44,1874,1.8773745395841437
STAT,1884,39,50-100,1923,1.2105184607092936
STAT,1886,20,30-34,1906,19.108228395978706
SIM,1836,20,25-29,1856,78
STAT,1883,73,na,1956,1207.3802018174401
SIM,1916,7,na,1923,4248
SIM,1941,13,na,1954,4238
SIM,1872,37,20-24,1909,2
STAT,1801,93,na,1894,11.631135016875547
STAT,1877,16,35-39,1893,0.5733920164927826
STAT,1917,25,45-49,1942,1.8411951016188806
SIM,1887,27,25-29,1914,6
STAT,1776,105,na,1881,0.017739970771502432
STAT,1905,17,35-39,1922,0.801168354718854
STAT,1820,53,40-44,1873,0.016843979416069764
STAT,1916,35,40-44,1951,1.5617477503507469
SIM,1937,17,20-24,1954,136
STAT,1835,25,45-49,1860,1.1022791435824815
SIM,1878,9,na,1887,3093
SIM,1857,89,na,1946,102
SIM,1936,27,30-34,1963,59
STAT,1892,40,25-29,1932,0.8220685654148437
STAT,1928,25,20-24,1953,22.884895060793372
STAT,1845,24,na,1869,1911.743637441519
STAT,1940,15,na,1955,3774.924138248531
STAT,1915,48,na,1963,3725.069838621293
STAT,1829,33,20-24,1862,2.347413696976021
STAT,1881,29,20-24,1910,11.339705315673102
STAT,1943,5,na,1948,4268.101308725343
STAT,1832,61,na,1893,1272.3991543154361
STAT,1874,42,15-19,1916,0.014264398585468841
SIM,1897,3,na,1900,3625
STAT,1879,27,25-29,1906,44.5856901020899
SIM,1925,25,45-49,1950,2
STAT,1896,24,20-24,1920,91.55382075144068
STAT,1910,36,15-19,1946,0.018618801128292384
STAT,1903,29,na,1932,3408.271764685867
STAT,1924,37,40-44,1961,1.7837661564005236
SIM,1861,19,15-19,1880,5
SIM,1872,16,25-29,1888,7
STAT,1892,18,40-44,1910,0.23120019380710483
SIM,1880,6,na,1886,2613
STAT,1895,19,20-24,1914,23.257883849774924
STAT,1942,10,na,1952,4163.0165190906755
STAT,1786,108,na,1894,9.787821919600695E-4
STAT,1954,18,25-29,1972,54.1068595517539
SIM,1880,21,na,1901,2276
STAT,1918,17,45-49,1935,0.11013045936812967
SIM,1833,27,40-44,1860,3
SIM,1821,41,45-49,1862,5
SIM,1836,28,20-24,1864,2
STAT,1870,52,40-44,1922,0.0103856151291623
STAT,1863,25,20-24,1888,10.65075143718345
SIM,1802,81,na,1883,183
STAT,1865,42,20-24,1907,0.14628594794138333
STAT,1934,17,45-49,1951,0.682725551847483
STAT,1937,18,25-29,1955,42.44883141191976
STAT,1818,46,50-100,1864,0.44386864995043307
SIM,1876,2,na,1878,3628
SIM,1797,65,na,1862,741
SIM,1899,29,na,1928,3570
STAT,1852,81,na,1933,410.11144591500624
SIM,1822,38,20-24,1860,3
SIM,1863,89,na,1952,53
STAT,1856,102,na,1958,0.38714880935550766
STAT,1864,16,25-29,1880,5.905826262847906
SIM,1886,19,20-24,1905,28
SIM,1817,59,na,1876,1250
SIM,1878,34,20-24,1912,1
STAT,1881,16,25-29,1897,5.530480748720904
SIM,1849,43,40-44,1892,5
SIM,1868,31,25-29,1899,12
STAT,1862,44,45-49,1906,1.2877795012729207
SIM,1857,44,30-34,1901,1
SIM,1913,47,50-100,1960,2
SIM,1853,69,na,1922,1026
SIM,1914,35,na,1949,3966
SIM,1913,17,35-39,1930,1
STAT,1853,19,15-19,1872,5.834344237587809
STAT,1885,15,30-34,1900,1.6098219590619052
SIM,1852,30,35-39,1882,9
STAT,1890,21,na,1911,2927.6626119959474
SIM,1821,64,na,1885,924
STAT,1868,90,na,1958,107.63838286395108
SIM,1926,17,45-49,1943,4
STAT,1887,35,na,1922,2681.939186170623
STAT,1918,30,45-49,1948,1.7017156762124444
SIM,1917,19,45-49,1936,1
STAT,1802,57,na,1859,1036.1439904549595
STAT,1810,76,na,1886,469.38740257277647
STAT,1879,48,20-24,1927,0.012489075817054428
STAT,1885,6,na,1891,2626.301344062654
STAT,1874,21,na,1895,2453.293065435373
STAT,1905,24,25-29,1929,83.06087180724563
SIM,1863,99,na,1962,21
STAT,1907,13,na,1920,3824.5122994009116
STAT,1927,43,na,1970,4700.421533995175
STAT,1880,32,45-49,1912,1.8496905045846253
STAT,1853,48,50-100,1901,0.2005534088221752
STAT,1859,28,35-39,1887,7.916212900437962
STAT,1828,28,20-24,1856,18.852393737770797
STAT,1909,19,45-49,1928,0.09832298251632873
STAT,1933,35,40-44,1968,2.0640114737969717
SIM,1859,30,20-24,1889,5
STAT,1820,38,45-49,1858,4.549768267691091
SIM,1926,30,45-49,1956,1
STAT,1884,16,40-44,1900,0.1826179460102215
SIM,1926,20,na,1946,4408
STAT,1918,8,na,1926,4382.704268861113
STAT,1813,41,45-49,1854,5.770660944355202
SIM,1832,44,25-29,1876,3
SIM,1932,37,40-44,1969,1
SIM,1912,10,na,1922,3976
SIM,1937,33,25-29,1970,18
STAT,1925,27,45-49,1952,2.062168794430084
STAT,1844,30,35-39,1874,9.782524612632546
SIM,1853,48,50-100,1901,1
STAT,1932,40,20-24,1972,0.024255866619873324
STAT,1923,38,35-39,1961,2.8288275271331353
STAT,1914,3,na,1917,4219.3933053024875
STAT,1790,82,na,1872,144.10483710782407
STAT,1843,15,40-44,1858,0.15952206702177674
SIM,1812,43,45-49,1855,1
STAT,1908,27,45-49,1935,1.662600171302627
SIM,1845,18,20-24,1863,24
STAT,1833,41,15-19,1874,0.012035752524463587
SIM,1863,26,25-29,1889,7
SIM,1916,1,na,1917,4387
STAT,1891,35,25-29,1926,3.6345664582579054
STAT,1858,29,45-49,1887,0.8877496451224786
STAT,1863,43,na,1906,2053.3638397759782
STAT,1838,26,25-29,1864,36.28193676749625
STAT,1902,51,na,1953,3087.918624226069
SIM,1805,95,na,1900,2
STAT,1862,36,na,1898,2064.8216157778943
STAT,1845,22,35-39,1867,5.2933614849195205
SIM,1856,18,na,1874,2431
STAT,1925,14,na,1939,4821.555649796862
SIM,1931,38,35-39,1969,11
STAT,1868,23,30-34,1891,17.14090476376641
SIM,1831,36,20-24,1867,3
SIM,1926,30,na,1956,4617
STAT,1861,54,40-44,1915,0.008592672442541945
SIM,1894,41,na,1935,3271
SIM,1873,37,25-29,1910,4
STAT,1854,18,20-24,1872,15.822238581717032
STAT,1798,78,na,1876,370.8269705968874
STAT,1833,39,na,1872,1855.2358614567413
STAT,1886,16,na,1902,2699.903460956961
STAT,1861,23,45-49,1884,0.5969312229315774
STAT,1860,33,40-44,1893,3.565398568693275
STAT,1837,18,20-24,1855,19.37269159326248
STAT,1905,21,50-100,1926,0.597210995000079
SIM,1932,30,na,1962,5751
STAT,1856,47,25-29,1903,0.04439440567623412
SIM,1925,22,25-29,1947,145
SIM,1870,44,45-49,1914,1
SIM,1906,16,na,1922,3619
SIM,1916,27,45-49,1943,4
STAT,1844,23,45-49,1867,0.6838997421525173
SIM,1872,23,15-19,1895,3
STAT,1937,25,30-34,1962,38.59295229999101
SIM,1876,23,30-34,1899,32
SIM,1884,26,45-49,1910,1
STAT,1899,20,na,1919,3297.876823622712
STAT,1960,1,na,1961,5179.47503300619
STAT,1874,90,na,1964,192.62036856387743
STAT,1802,105,na,1907,0.010244152333587829
STAT,1913,13,na,1926,4067.779067128559
STAT,1942,25,40-44,1967,4.943585173236537
STAT,1943,15,45-49,1958,0.5351592355499271
STAT,1823,36,20-24,1859,1.4008314373971231
STAT,1890,27,20-24,1917,14.47849764896636
STAT,1868,30,20-24,1898,2.6302113594642833
STAT,1913,16,30-34,1929,2.5206192184261167
SIM,1921,16,30-34,1937,20
SIM,1865,54,na,1919,1876
STAT,1871,50,35-39,1921,0.008762677830758212
STAT,1850,41,15-19,1891,0.010622223870292394
STAT,1877,54,50-100,1931,0.015310523539773501
STAT,1902,41,na,1943,3325.1101192158835
SIM,1886,22,na,1908,2644
STAT,1829,52,50-100,1881,0.00990745214531916
STAT,1855,26,25-29,1881,33.42912133514669
SIM,1911,17,15-19,1928,7
SIM,1816,43,30-34,1859,1
STAT,1917,22,25-29,1939,99.09331082808917
STAT,1919,14,na,1933,4406.696442936229
SIM,1945,25,30-34,1970,66
STAT,1869,53,45-49,1922,0.014021779694731928
STAT,1948,20,15-19,1968,6.178552252320125
STAT,1864,23,15-19,1887,3.0331030494047373
STAT,1903,17,15-19,1920,8.536336534988102
STAT,1833,49,na,1882,1653.5838023481485
SIM,1883,34,30-34,1917,32
STAT,1848,76,na,1924,773.5157173625587
STAT,1914,46,50-100,1960,0.226885107411886
STAT,1855,48,35-39,1903,0.10405680336274434
SIM,1922,22,25-29,1944,126
STAT,1838,47,20-24,1885,0.008264435815751887
SIM,1867,41,35-39,1908,3
SIM,1929,25,15-19,1954,1
SIM,1842,43,40-44,1885,3
STAT,1871,72,na,1943,1267.2193205291617
SIM,1807,59,na,1866,977
STAT,1827,39,na,1866,1635.0939181453996
STAT,1892,34,30-34,1926,21.938630651885948
SIM,1908,25,45-49,1933,4
STAT,1879,24,20-24,1903,72.17905643069581
STAT,1899,27,40-44,1926,4.1523064672629175
SIM,1844,22,25-29,1866,71
SIM,1911,35,45-49,1946,1
STAT,1904,46,na,1950,3270.8280221780533
STAT,1914,48,35-39,1962,0.12865250787314292
STAT,1840,54,20-24,1894,5.03047731687463E-4
STAT,1835,20,15-19,1855,5.20386417433922
STAT,1856,21,15-19,1877,2.9883702521094113
STAT,1806,52,50-100,1858,0.043579458226595175
STAT,1845,20,25-29,1865,52.681256927691464
STAT,1944,21,50-100,1965,0.7176464791708363
SIM,1846,87,na,1933,26
SIM,1912,22,15-19,1934,6
SIM,1932,32,50-100,1964,2
STAT,1825,43,30-34,1868,1.6111626542424715
STAT,1814,47,35-39,1861,0.33767165353606515
STAT,1846,33,20-24,1879,2.39909600916095
SIM,1909,21,30-34,1930,32
STAT,1905,48,25-29,1953,0.04684419687463349
STAT,1873,73,na,1946,1216.1513129210402
STAT,1906,36,25-29,1942,0.918616571867437
STAT,1899,43,50-100,1942,0.10095653697877223
SIM,1854,33,20-24,1887,2
SIM,1850,17,na,1867,2201
STAT,1881,38,35-39,1919,6.851797700949716
STAT,1876,87,na,1963,346.9731073026462
SIM,1853,22,35-39,1875,4
SIM,1904,31,20-24,1935,2
STAT,1840,34,50-100,1874,0.766210101428465
SIM,1833,43,30-34,1876,1
STAT,1911,21,45-49,1932,1.0798351028588973
SIM,1814,52,50-100,1866,2
STAT,1839,24,na,1863,1919.8502316681002
STAT,1871,18,20-24,1889,17.798671734533478
STAT,1909,31,30-34,1940,15.233479845810477
STAT,1904,22,15-19,1926,4.781667462766795
STAT,1824,41,20-24,1865,0.20146666346777725
STAT,1944,20,45-49,1964,1.2276173748781887
STAT,1851,58,na,1909,1497.4126733790208
STAT,1917,43,na,1960,3906.013496644286
STAT,1877,20,20-24,1897,72.2646050299617
SIM,1887,24,20-24,1911,5
STAT,1785,108,na,1893,0.0013318299626922268
STAT,1836,22,25-29,1858,47.66026931185949
SIM,1917,24,40-44,1941,6
STAT,1831,75,na,1906,646.9144909663164
STAT,1932,33,30-34,1965,21.152650123547964
STAT,1861,88,na,1949,115.21938776482487
STAT,1883,50,25-29,1933,0.0035511323159413176
SIM,1903,19,30-34,1922,2
SIM,1892,22,na,1914,3485
SIM,1861,31,50-100,1892,1
STAT,1838,48,na,1886,1529.7472189955365
STAT,1818,93,na,1911,15.057121089760344
STAT,1937,19,20-24,1956,132.75597258657106
SIM,1933,27,45-49,1960,5
STAT,1897,15,50-100,1912,0.0666461000140825
STAT,1839,65,na,1904,1198.1375755465297
STAT,1929,30,20-24,1959,3.1351045616874673
STAT,1931,31,50-100,1962,1.0955434406642701
SIM,1864,21,15-19,1885,3
SIM,1913,24,25-29,1937,125
SIM,1904,16,30-34,1920,3
STAT,1877,73,na,1950,1238.141067904926
STAT,1786,102,na,1888,0.09075580423735728
STAT,1952,16,na,1968,4457.7888911491245
STAT,1872,39,20-24,1911,0.7748581702826174
SIM,1930,21,20-24,1951,7
SIM,1881,27,20-24,1908,15
SIM,1852,20,40-44,1872,1
STAT,1858,90,na,1948,62.472207517713066
SIM,1880,39,20-24,1919,1
STAT,1812,51,40-44,1863,0.023709835765213447
STAT,1872,15,20-24,1887,18.275790926708783
SIM,1812,77,na,1889,265
SIM,1873,3,na,1876,2972
STAT,1888,72,na,1960,1665.5327618834565
STAT,1903,35,45-49,1938,0.6247934720005384
STAT,1834,43,40-44,1877,1.5943241460032314
SIM,1843,20,15-19,1863,2
SIM,1945,19,20-24,1964,161
STAT,1914,22,25-29,1936,95.213612580819
SIM,1853,20,25-29,1873,4
STAT,1928,28,25-29,1956,81.92325143023511
STAT,1840,37,35-39,1877,5.864137221560013
SIM,1908,11,na,1919,3789
STAT,1875,44,40-44,1919,2.301497272010933
STAT,1943,16,40-44,1959,1.4980716123684603
STAT,1828,52,45-49,1880,0.012766590193364107
STAT,1918,28,15-19,1946,0.7558114913422443
STAT,1900,19,40-44,1919,0.2552388571077251
STAT,1898,31,45-49,1929,2.397414111142594
STAT,1895,54,na,1949,2761.928281627592
STAT,1864,31,15-19,1895,0.1303189256134959
SIM,1851,36,50-100,1887,1
STAT,1775,115,na,1890,1.404778008926873E-4
STAT,1906,38,35-39,1944,2.234688400664574
SIM,1877,21,25-29,1898,64
SIM,1900,30,25-29,1930,31
STAT,1891,32,20-24,1923,3.3801160073463246
SIM,1893,21,40-44,1914,5
SIM,1894,23,35-39,1917,12
STAT,1779,95,na,1874,2.9290553643533057
STAT,1872,20,na,1892,2415.84858686518
STAT,1813,108,na,1921,8.031354888681313E-4
STAT,1834,50,30-34,1884,0.003781759161723556
SIM,1868,30,30-34,1898,23
STAT,1897,59,na,1956,2654.4062259777816
SIM,1826,30,40-44,1856,11
STAT,1848,26,50-100,1874,0.6280154594425018
SIM,1914,38,35-39,1952,7
STAT,1816,92,na,1908,21.29422231773016
STAT,1926,19,45-49,1945,0.6156735113869573
STAT,1865,88,na,1953,126.610615200043
SIM,1832,36,na,1868,1675
SIM,1866,26,40-44,1892,5
SIM,1846,23,20-24,1869,80
STAT,1909,24,40-44,1933,3.1337048111731907
STAT,1861,53,45-49,1914,0.011984417905766041
STAT,1886,23,35-39,1909,6.20368628815469
SIM,1893,31,35-39,1924,15
SIM,1839,40,45-49,1879,4
SIM,1824,62,na,1886,1112
STAT,1875,40,25-29,1915,0.6727772548949573
STAT,1891,42,15-19,1933,0.01724762990284441
SIM,1879,18,15-19,1897,11
STAT,1889,48,50-100,1937,0.1703675689399489
STAT,1848,49,40-44,1897,0.1368592346967931
STAT,1895,43,45-49,1938,0.13608932062928117
STAT,1842,41,25-29,1883,0.6058782316909559
STAT,1808,53,40-44,1861,0.03491352378241371
SIM,1839,22,15-19,1861,3
STAT,1847,54,20-24,1901,5.373139743299297E-4
SIM,1936,28,25-29,1964,4
SIM,1877,29,20-24,1906,10
SIM,1883,44,40-44,1927,7
SIM,1926,28,15-19,1954,4
SIM,1951,16,40-44,1967,2
SIM,1812,43,na,1855,1373
STAT,1921,16,20-24,1937,156.46352871981753
STAT,1832,23,na,1855,1935.3347217212633
STAT,1907,49,20-24,1956,0.009883182589655173
STAT,1865,45,25-29,1910,0.053651548284556386
STAT,1903,16,50-100,1919,0.07064364496216362
STAT,1885,31,35-39,1916,10.22272800713913
STAT,1869,21,25-29,1890,56.38252573697883
STAT,1853,1,na,1854,3158.0
STAT,1935,21,30-34,1956,39.55592096197457
SIM,1847,35,na,1882,1891
SIM,1943,21,30-34,1964,41
SIM,1946,23,25-29,1969,4
SIM,1827,32,35-39,1859,9
SIM,1880,37,na,1917,2263
STAT,1874,86,na,1960,345.5720267729938
SIM,1914,36,25-29,1950,2
SIM,1931,28,25-29,1959,5
STAT,1851,33,30-34,1884,13.617806846345724
STAT,1886,21,25-29,1907,61.23062368407446
STAT,1931,38,25-29,1969,1.316539768647298
STAT,1885,21,40-44,1906,2.101256418534282
STAT,1924,41,25-29,1965,0.08595532689201146
SIM,1830,31,na,1861,1660
STAT,1938,23,25-29,1961,92.25928859318398
STAT,1868,21,na,1889,2299.47002804766
STAT,1879,54,50-100,1933,0.015480552678355781
SIM,1852,56,na,1908,1492
STAT,1814,42,na,1856,1509.6006089470773
STAT,1866,28,40-44,1894,2.7916874793161295
SIM,1875,84,na,1959,332
STAT,1896,49,35-39,1945,0.1033744789325078
STAT,1818,40,35-39,1858,3.804101727384641
STAT,1855,24,na,1879,1853.2914848705666
SIM,1859,20,na,1879,2227
STAT,1880,55,na,1935,2193.2454846186415
SIM,1884,51,na,1935,2243
SIM,1919,29,20-24,1948,23
STAT,1816,51,25-29,1867,0.008974003988103682
SIM,1895,67,na,1962,2174
SIM,1909,32,35-39,1941,10
STAT,1897,48,25-29,1945,0.04344219212081876
SIM,1838,21,na,1859,2065
SIM,1894,21,25-29,1915,114
STAT,1839,52,20-24,1891,5.203797505566325E-4
STAT,1944,18,15-19,1962,49.30246378981088
STAT,1928,27,30-34,1955,48.79206818962259
STAT,1900,22,30-34,1922,24.990831910896798
STAT,1853,52,40-44,1905,0.008659771919808615
STAT,1879,8,na,1887,2791.4139069582866
STAT,1838,41,15-19,1879,0.010950813279628335
STAT,1879,34,15-19,1913,0.14881258676350187
STAT,1883,69,na,1952,1450.4778142439834
STAT,1824,43,50-100,1867,1.2858337792086894
STAT,1917,26,40-44,1943,4.950946394720685
STAT,1913,29,na,1942,3739.243630544698
SIM,1917,25,na,1942,4021
SIM,1827,30,25-29,1857,12
STAT,1909,33,50-100,1942,0.7928043166740215
STAT,1771,85,na,1856,65.496649
STAT,1831,38,20-24,1869,0.6094716839396158
STAT,1951,17,45-49,1968,0.6010067325018659
STAT,1891,34,na,1925,2958.4818529356558
SIM,1832,97,na,1929,7
SIM,1854,25,20-24,1879,13
STAT,1863,28,25-29,1891,37.72185869581885
SIM,1886,21,35-39,1907,7
STAT,1922,2,na,1924,4781.660548985614
STAT,1846,25,20-24,1871,10.92655467089229
STAT,1936,27,20-24,1963,17.636507164888982
STAT,1946,18,35-39,1964,4.699154719521254
SIM,1952,18,15-19,1970,51
SIM,1876,30,20-24,1906,7
STAT,1828,93,na,1921,18.971873633118012
STAT,1882,20,na,1902,2327.6452331924097
SIM,1882,22,na,1904,2241
SIM,1871,28,25-29,1899,8
STAT,1859,25,30-34,1884,21.111316597268655
SIM,1859,33,25-29,1892,13
STAT,1861,15,45-49,1876,0.06376262102247013
SIM,1826,40,35-39,1866,2
SIM,1875,33,40-44,1908,3
STAT,1832,108,na,1940,0.001247264900589037
STAT,1954,15,20-24,1969,169.4189127041962
STAT,1838,23,20-24,1861,59.42160982492569
STAT,1843,18,45-49,1861,0.0559713728062408
SIM,1806,81,na,1887,176
SIM,1868,33,35-39,1901,13
SIM,1911,1,na,1912,4215
STAT,1822,92,na,1914,23.287169806336394
STAT,1858,26,40-44,1884,2.4474621419696097
STAT,1847,59,na,1906,1455.1435709786344
STAT,1911,28,15-19,1939,0.6921241654246589
STAT,1844,32,50-100,1876,0.8668820283613143
STAT,1895,45,50-100,1940,0.18454938973485566
STAT,1807,48,40-44,1855,0.6036575333897751
STAT,1914,28,30-34,1942,39.713081274789005
STAT,1844,17,35-39,1861,0.5518536854037583
SIM,1864,37,na,1901,2566
SIM,1867,34,45-49,1901,2
SIM,1867,55,na,1922,1836
STAT,1854,42,45-49,1896,1.12182548981039
SIM,1898,21,45-49,1919,1
STAT,1829,41,na,1870,1557.7951725842368
STAT,1933,39,20-24,1972,0.3620576484246041
STAT,1807,94,na,1901,7.0796712267135655
SIM,1844,21,na,1865,1818
SIM,1869,84,na,1953,333
STAT,1922,21,20-24,1943,129.20834720577142
STAT,1867,33,40-44,1900,4.107771552385875
STAT,1916,1,na,1917,4456.683692597396
STAT,1875,51,30-34,1926,0.0062036290899369975
STAT,1908,60,na,1968,3123.1945109005474
SIM,1859,44,50-100,1903,1
STAT,1871,88,na,1959,205.09345035892457
SIM,1836,56,na,1892,1503
SIM,1922,28,30-34,1950,54
STAT,1910,28,15-19,1938,0.6853554899390576
STAT,1922,34,na,1956,4295.878327899755
SIM,1800,58,na,1858,1025
SIM,1849,54,na,1903,1647
STAT,1947,15,15-19,1962,51.66650805182554
STAT,1878,3,na,1881,3204.5312846404913
STAT,1878,18,50-100,1896,0.05123119071063956
STAT,1933,38,45-49,1971,0.9373645017792553
STAT,1926,39,15-19,1965,0.023668788769715156
STAT,1867,73,na,1940,1129.8163685029447
STAT,1926,32,45-49,1958,1.9230167141496712
STAT,1909,16,40-44,1925,0.27746857749034826
SIM,1929,10,na,1939,4962
SIM,1899,50,na,1949,3264
STAT,1813,94,na,1907,8.763073367500668
STAT,1843,60,na,1903,1286.331260384055
STAT,1847,108,na,1955,0.0013714792853192605
STAT,1872,45,50-100,1917,0.2518736543918869
STAT,1844,20,40-44,1864,2.088361426237333
SIM,1893,18,35-39,1911,1
SIM,1955,15,15-19,1970,62
STAT,1788,78,na,1866,284.1111310268908
STAT,1928,17,20-24,1945,172.6673795964562
STAT,1820,52,45-49,1872,0.023687531886948877
SIM,1921,19,35-39,1940,6
SIM,1879,36,na,1915,2729
STAT,1860,19,50-100,1879,0.04610273101725359
SIM,1835,22,30-34,1857,18
SIM,1858,72,na,1930,869
STAT,1871,31,40-44,1902,4.369349573444111
STAT,1918,46,45-49,1964,0.23407663747610785
STAT,1954,17,30-34,1971,15.223400306764994
STAT,1925,47,15-19,1972,4.511145618880214E-4
SIM,1937,30,20-24,1967,2
STAT,1878,19,20-24,1897,18.487882063468046
STAT,1885,18,35-39,1903,0.5501927101341838
STAT,1914,35,20-24,1949,0.2680748954039521
SIM,1954,11,na,1965,4836
STAT,1884,19,45-49,1903,0.06471198027227233
SIM,1936,17,20-24,1953,1
SIM,1916,24,40-44,1940,4
STAT,1913,19,35-39,1932,0.8609859575854629
STAT,1833,45,30-34,1878,0.0826077242647442
SIM,1930,32,50-100,1962,1
SIM,1855,54,na,1909,1819
SIM,1847,27,50-100,1874,2
SIM,1848,38,40-44,1886,7
SIM,1870,33,50-100,1903,2
SIM,1910,5,na,1915,3816
STAT,1915,14,na,1929,4157.328676498771
SIM,1944,27,20-24,1971,22
STAT,1909,14,na,1923,3895.481271079746
STAT,1838,76,na,1914,634.2170912579189
STAT,1857,30,45-49,1887,1.4120667868577632
STAT,1883,40,15-19,1923,0.013786965464770394
SIM,1860,17,na,1877,2326
STAT,1908,24,40-44,1932,3.1008219593720687
SIM,1904,24,30-34,1928,42
SIM,1934,32,45-49,1966,3
STAT,1859,41,35-39,1900,1.4776443289519268
STAT,1843,39,na,1882,1653.4019471004437
STAT,1883,42,25-29,1925,0.6339081972135308
STAT,1894,20,20-24,1914,90.14401351006175
SIM,1831,39,25-29,1870,5
STAT,1823,39,25-29,1862,4.58202731885468
STAT,1897,22,15-19,1919,4.467072519849161
STAT,1849,54,40-44,1903,0.008004724138671187
SIM,1895,26,20-24,1921,2
STAT,1873,44,20-24,1917,0.16041525089714512
STAT,1885,37,40-44,1922,4.400868718701976
SIM,1918,8,na,1926,4512
SIM,1928,28,35-39,1956,34
STAT,1887,26,20-24,1913,13.274321691036322
SIM,1893,37,40-44,1930,6
STAT,1906,46,35-39,1952,0.11650532644556923
SIM,1830,72,na,1902,605
STAT,1904,40,45-49,1944,0.1521577441339274
STAT,1927,22,35-39,1949,11.72556920021527
SIM,1935,22,35-39,1957,15
SIM,1921,17,25-29,1938,83
STAT,1833,38,40-44,1871,3.8461750631399383
STAT,1872,23,20-24,1895,69.7589623288834
SIM,1865,30,45-49,1895,1
STAT,1806,53,20-24,1859,0.0020870226131275873
STAT,1822,49,35-39,1871,0.20183492279042664
SIM,1880,45,50-100,1925,1
STAT,1850,31,20-24,1881,2.187786094978638
SIM,1841,38,40-44,1879,15
STAT,1836,54,45-49,1890,0.008903494743389863
STAT,1913,17,25-29,1930,8.939671752789462
STAT,1825,75,na,1900,751.2591269957464
SIM,1858,36,45-49,1894,3
STAT,1901,24,40-44,1925,2.9319063774032337
SIM,1844,82,na,1926,217
SIM,1925,26,40-44,1951,6
SIM,1861,22,25-29,1883,2
SIM,1906,36,35-39,1942,6
SIM,1889,33,na,1922,2893
STAT,1907,48,45-49,1955,0.19497171281277534
SIM,1830,62,na,1892,988
SIM,1943,24,35-39,1967,13
STAT,1846,36,25-29,1882,2.3055483871764277
SIM,1892,18,na,1910,3473
SIM,1946,20,20-24,1966,144
SIM,1849,21,30-34,1870,25
SIM,1880,37,30-34,1917,11
STAT,1871,20,35-39,1891,5.890398989924634
SIM,1822,43,na,1865,1577
STAT,1842,43,30-34,1885,1.0572763495816138
STAT,1945,23,15-19,1968,5.889939932640114
SIM,1792,83,na,1875,57
STAT,1940,18,30-34,1958,12.490007906377075
SIM,1911,4,na,1915,4160
STAT,1797,83,na,1880,139.87123998201525
STAT,1864,38,na,1902,2136.557227809718
STAT,1924,45,40-44,1969,0.19056501325189362
SIM,1904,52,na,1956,3296
SIM,1950,11,na,1961,4537
STAT,1889,24,50-100,1913,0.5046805167579695
STAT,1842,23,na,1865,2410.5976141962033
STAT,1845,43,50-100,1888,0.7760686200471046
STAT,1909,52,na,1961,3349.21571906961
STAT,1888,38,20-24,1926,0.9143800312045613
SIM,1825,88,na,1913,40
STAT,1881,23,15-19,1904,3.201891325309873
STAT,1851,43,40-44,1894,1.6908212212754306
SIM,1897,52,na,1949,2889
SIM,1944,17,na,1961,3971
STAT,1841,65,na,1906,1263.7785462221157
STAT,1884,52,na,1936,2133.1862108227056
STAT,1929,41,50-100,1970,0.15399659506062227
STAT,1897,18,na,1915,3410.8592816729633
STAT,1873,15,na,1888,2616.7265443523615
SIM,1877,48,na,1925,2306
STAT,1815,58,na,1873,1081.263275365676
SIM,1904,18,20-24,1922,22
STAT,1894,16,35-39,1910,0.7152582880631062
SIM,1882,39,40-44,1921,4
STAT,1823,40,na,1863,1563.7635828675834
STAT,1864,38,35-39,1902,6.4141969140740205
SIM,1825,35,50-100,1860,4
STAT,1934,37,15-19,1971,0.02677639134189181
STAT,1872,37,30-34,1909,5.411764597467415
STAT,1836,32,35-39,1868,8.075273327485528
STAT,1884,4,na,1888,2779.87508881376
SIM,1854,36,25-29,1890,4
SIM,1886,43,45-49,1929,4
SIM,1858,33,40-44,1891,4
STAT,1777,79,na,1856,198.556220376
STAT,1935,24,35-39,1959,12.945826712547436
SIM,1866,60,na,1926,1914
SIM,1810,48,na,1858,1434
STAT,1836,37,45-49,1873,1.5436080685588365
SIM,1858,68,na,1926,1133
SIM,1943,22,50-100,1965,4
STAT,1930,19,35-39,1949,5.453732540061632
SIM,1810,58,na,1868,1205
STAT,1933,31,25-29,1964,12.593913433653627
STAT,1901,41,40-44,1942,0.22214954878897267
STAT,1837,38,25-29,1875,2.366780715144365
STAT,1930,30,45-49,1960,2.054856744618883
SIM,1845,38,25-29,1883,3
STAT,1868,24,45-49,1892,0.6689043129482921
STAT,1870,38,50-100,1908,1.2116212397168218
STAT,1890,19,20-24,1909,21.762521811226478
SIM,1908,22,25-29,1930,98
STAT,1774,112,na,1886,5.066234964223228E-4
STAT,1850,42,na,1892,1767.569366247998
SIM,1841,31,20-24,1872,2
SIM,1850,43,30-34,1893,6
STAT,1941,30,20-24,1971,2.588420448887481
SIM,1835,25,35-39,1860,11
SIM,1835,39,45-49,1874,2
SIM,1844,37,45-49,1881,2
STAT,1808,73,na,1881,521.4424587623932
STAT,1815,51,50-100,1866,0.032661414061551486
STAT,1876,21,15-19,1897,3.450750684292222
STAT,1848,38,na,1886,1961.7870121874803
SIM,1939,25,50-100,1964,1
STAT,1905,39,45-49,1944,0.6219223789053854
STAT,1854,35,20-24,1889,0.587363606558505
SIM,1914,35,30-34,1949,2
STAT,1871,25,50-100,1896,0.6462375725725961
STAT,1823,37,35-39,1860,12.315877507520895
SIM,1849,26,40-44,1875,3
STAT,1874,39,40-44,1913,4.481603917185975
SIM,1867,31,40-44,1898,4
STAT,1879,38,50-100,1917,1.287622213717086
STAT,1797,93,na,1890,7.296802959221802
STAT,1892,44,40-44,1936,0.19528538779869373
SIM,1920,25,45-49,1945,2
STAT,1904,27,50-100,1931,0.9271821770188824
STAT,1898,72,na,1970,2131.266273425336
SIM,1852,36,40-44,1888,3
STAT,1827,39,45-49,1866,2.213294617491343
STAT,1848,45,25-29,1893,0.04749685523003724
STAT,1921,19,25-29,1940,49.621756621817205
SIM,1844,32,35-39,1876,8
STAT,1837,60,na,1897,1301.039024846379
SIM,1935,20,45-49,1955,3
STAT,1919,33,15-19,1952,0.1393925404487825
STAT,1868,31,35-39,1899,9.815513527988823
STAT,1922,24,25-29,1946,106.34040295288816
SIM,1861,30,na,1891,2072
STAT,1859,31,40-44,1890,3.537265765896152
STAT,1825,53,40-44,1878,0.0133547134891593
STAT,1890,28,35-39,1918,11.866412202357575
STAT,1902,38,15-19,1940,0.01721325766112808
STAT,1909,34,35-39,1943,8.724491086303393
SIM,1855,37,20-24,1892,1
SIM,1896,38,20-24,1934,1
STAT,1829,34,na,1863,1646.209805292466
STAT,1860,40,30-34,1900,0.9587743619545667
STAT,1844,36,40-44,1880,4.063818039447223
STAT,1830,25,na,1855,1887.6175865898224
STAT,1841,68,na,1909,1142.8083504055987
SIM,1909,28,15-19,1937,2
SIM,1930,24,25-29,1954,139
SIM,1928,27,20-24,1955,27
STAT,1930,37,50-100,1967,0.5535177034132619
SIM,1831,28,20-24,1859,17
SIM,1892,39,50-100,1931,3
STAT,1910,49,na,1959,3437.9181214742553
STAT,1861,17,35-39,1878,0.5293152570803378
STAT,1875,23,50-100,1898,0.4216603738425317
STAT,1802,54,50-100,1856,0.04233142553164229
STAT,1900,49,na,1949,3091.21994377461
STAT,1912,25,45-49,1937,1.7292896050471533
STAT,1855,8,na,1863,2198.5078110732115
STAT,1887,37,25-29,1924,3.246715029643569
SIM,1826,36,na,1862,2062
STAT,1938,20,20-24,1958,111.17545729694407
SIM,1917,27,45-49,1944,2
SIM,1835,20,40-44,1855,1
STAT,1905,46,35-39,1951,0.11563362701684839
SIM,1858,38,35-39,1896,21
STAT,1861,50,40-44,1911,0.008962618866006867
STAT,1810,80,na,1890,321.27426655775133
STAT,1898,65,na,1963,2508.727980423622
STAT,1836,19,15-19,1855,6.619714831187723
SIM,1885,38,45-49,1923,1
STAT,1870,49,15-19,1919,3.8843185724755653E-4
SIM,1938,0,na,1938,4153
STAT,1906,35,30-34,1941,1.7083446380818668
STAT,1943,19,45-49,1962,0.534517331844431
STAT,1874,32,20-24,1906,2.795475219813246
SIM,1882,32,20-24,1914,1
SIM,1855,23,na,1878,2320
STAT,1875,18,40-44,1893,0.18921320953591284
STAT,1940,25,20-24,1965,18.80822817522396
STAT,1876,25,30-34,1901,26.438928082291415
STAT,1830,30,40-44,1860,4.297989998661504
SIM,1867,49,50-100,1916,2
STAT,1877,38,45-49,1915,2.067749864969989
STAT,1897,28,na,1925,3220.11794128582
STAT,1900,36,40-44,1936,1.3320091328994528
SIM,1845,42,45-49,1887,1
STAT,1909,27,45-49,1936,1.6660888103294915
STAT,1908,25,50-100,1933,0.9643926456430995
SIM,1844,19,15-19,1863,8
STAT,1874,46,30-34,1920,0.10039378222681045
STAT,1927,20,45-49,1947,1.409528927949038
STAT,1928,30,50-100,1958,1.0461243240327796
SIM,1885,67,na,1952,1625
STAT,1853,22,25-29,1875,55.93512154522668
SIM,1831,37,35-39,1868,15
STAT,1872,67,na,1939,1609.66329632941
STAT,1880,24,45-49,1904,0.7350259350191684
SIM,1884,25,30-34,1909,37
STAT,1912,44,na,1956,3585.8623137125096
SIM,1909,30,45-49,1939,1
STAT,1935,17,45-49,1952,0.6899601869775287
SIM,1928,15,20-24,1943,176
STAT,1923,28,25-29,1951,76.08520575860764
SIM,1890,17,20-24,1907,27
SIM,1815,88,na,1903,48
STAT,1931,29,45-49,1960,2.2519433964572646
STAT,1910,15,na,1925,3879.0535155120356
SIM,1899,20,30-34,1919,31
STAT,1940,23,50-100,1963,0.6764770575053055
STAT,1831,36,30-34,1867,4.307153469809954
SIM,1885,30,30-34,1915,9
STAT,1863,15,na,1878,2371.856895466434
SIM,1896,15,na,1911,3446
STAT,1905,47,50-100,1952,0.20133706829400363
SIM,1917,6,na,1923,4241
SIM,1830,27,25-29,1857,9
STAT,1819,51,40-44,1870,0.020108029489039538
STAT,1843,51,35-39,1894,0.00583431518442393
STAT,1907,41,25-29,1948,0.06644041091508715
SIM,1840,26,20-24,1866,18
STAT,1864,40,50-100,1904,0.9725520711405649
SIM,1848,16,30-34,1864,4
SIM,1934,5,na,1939,5599
STAT,1941,23,30-34,1964,29.976856210260863
STAT,1909,15,45-49,1924,0.09931239746108288
STAT,1947,16,50-100,1963,0.42641921551242923
STAT,1823,46,na,1869,1459.1043140024099
SIM,1848,41,na,1889,1743
SIM,1876,60,na,1936,2215
SIM,1875,36,45-49,1911,1
STAT,1835,24,30-34,1859,17.523529852090192
STAT,1846,43,15-19,1889,0.010471917147948536
STAT,1873,47,25-29,1920,0.0587022359954355
SIM,1872,29,20-24,1901,11
SIM,1943,17,45-49,1960,2
SIM,1876,33,25-29,1909,13
SIM,1927,15,na,1942,5049
STAT,1838,28,15-19,1866,0.38357275507774075
STAT,1892,40,na,1932,2958.7740305239618
STAT,1889,46,25-29,1935,0.07193837306886397
STAT,1846,108,na,1954,0.001390067350808746
STAT,1870,26,40-44,1896,2.9811606249499834
STAT,1917,29,45-49,1946,1.8157173131086628
STAT,1904,26,30-34,1930,36.6243743738021
STAT,1939,30,15-19,1969,0.13251512754150072
STAT,1915,26,25-29,1941,67.975531942694
SIM,1894,42,40-44,1936,3
STAT,1866,44,30-34,1910,1.0606939003323697
STAT,1941,16,25-29,1957,45.076835053436824
STAT,1862,27,45-49,1889,0.9719990087450853
SIM,1827,73,na,1900,634
SIM,1843,24,30-34,1867,29
STAT,1912,49,30-34,1961,0.08592865791719982
SIM,1874,44,30-34,1918,3
STAT,1802,88,na,1890,47.964591628543374
SIM,1949,21,35-39,1970,22
STAT,1876,23,40-44,1899,2.1663705062558924
STAT,1873,27,20-24,1900,12.011945242346442
STAT,1917,17,45-49,1934,0.10850645131261273
STAT,1868,33,25-29,1901,9.84536894116778
STAT,1897,45,20-24,1942,0.009257000824392519
STAT,1878,9,na,1887,2763.3162292033276
SIM,1954,15,30-34,1969,19
SIM,1864,75,na,1939,1145
STAT,1841,75,na,1916,769.846712830454
STAT,1877,30,30-34,1907,18.346714090189277
SIM,1912,26,30-34,1938,40
STAT,1946,15,30-34,1961,13.661534891671149
STAT,1822,36,50-100,1858,2.383246408823521
STAT,1886,42,40-44,1928,2.3956589261884447
STAT,1926,15,45-49,1941,0.6218689761467285
STAT,1912,34,na,1946,3722.4771120641303
SIM,1872,38,35-39,1910,5
SIM,1876,26,35-39,1902,15
SIM,1928,25,30-34,1953,56
STAT,1877,23,25-29,1900,59.48976730168014
SIM,1923,26,25-29,1949,113
STAT,1847,35,30-34,1882,4.227153648355955
SIM,1925,29,45-49,1954,4
SIM,1835,32,25-29,1867,8
STAT,1854,42,50-100,1896,0.7918768140675215
STAT,1854,38,na,1892,1759.3592869557826
SIM,1913,16,20-24,1929,31
STAT,1946,22,20-24,1968,124.97551992839479
SIM,1840,62,na,1902,1280
STAT,1901,20,25-29,1921,81.53522524406141
SIM,1817,80,na,1897,299
SIM,1940,26,25-29,1966,93
STAT,1915,47,40-44,1962,0.16030899922376274
STAT,1904,15,na,1919,3677.6689823848087
STAT,1894,23,25-29,1917,74.20847848168094
STAT,1905,16,20-24,1921,25.94894335208312
SIM,1904,27,35-39,1931,17
SIM,1886,39,25-29,1925,1
STAT,1929,39,30-34,1968,2.3599814649873165
STAT,1845,41,40-44,1886,1.695201147243227
STAT,1857,53,na,1910,1669.9715012561674
STAT,1832,26,20-24,1858,10.895187242111458
STAT,1878,43,45-49,1921,1.557824278760603
STAT,1791,98,na,1889,0.550095350250792
STAT,1872,26,25-29,1898,43.10115221907369
SIM,1809,61,na,1870,940
STAT,1846,19,na,1865,2162.5722946703286
STAT,1829,29,50-100,1858,0.6391706457443779
SIM,1944,11,na,1955,4297
STAT,1840,80,na,1920,433.6283639232755
STAT,1868,48,50-100,1916,0.23409657687586252
STAT,1827,32,25-29,1859,13.785019494560927
STAT,1903,30,na,1933,3460.092396817377
STAT,1898,23,50-100,1921,0.5566249013365798
STAT,1848,48,na,1896,1813.8207754780053
STAT,1853,60,na,1913,1577.1928299087022
SIM,1870,27,45-49,1897,7
STAT,1915,40,20-24,1955,0.017990766210184878
SIM,1830,31,45-49,1861,1
STAT,1915,33,50-100,1948,0.8460952296267504
STAT,1919,31,50-100,1950,0.9043276433440298
SIM,1911,31,na,1942,3938
STAT,1860,42,50-100,1902,0.8711608710745814
SIM,1905,38,25-29,1943,1
STAT,1833,34,25-29,1867,9.171773262063187
SIM,1843,38,na,1881,2245
STAT,1901,28,20-24,1929,16.551595166746104
SIM,1855,35,30-34,1890,14
SIM,1904,34,25-29,1938,14
STAT,1785,98,na,1883,0.5885860274153403
STAT,1867,36,45-49,1903,1.9053750055281133
STAT,1862,22,35-39,1884,5.210396311230354
SIM,1905,24,15-19,1929,5
SIM,1899,36,30-34,1935,1
STAT,1915,33,30-34,1948,16.122952578522156
STAT,1931,36,35-39,1967,3.2403778704802937
SIM,1923,33,30-34,1956,7
STAT,1811,53,50-100,1864,0.03525714061387878
STAT,1861,3,na,1864,2725.4660092829345
SIM,1853,41,40-44,1894,4
STAT,1883,44,30-34,1927,1.1209612203897141
SIM,1870,22,35-39,1892,13
STAT,1853,20,35-39,1873,5.784661383811428
SIM,1940,6,na,1946,4254
STAT,1878,50,35-39,1928,0.009155919611221934
SIM,1885,23,25-29,1908,88
STAT,1878,52,na,1930,2245.481116210189
STAT,1867,19,45-49,1886,0.06277575286300609
STAT,1932,26,25-29,1958,87.16207521748066
SIM,1932,30,20-24,1962,4
STAT,1945,6,na,1951,4371.527167317389
STAT,1816,53,30-34,1869,0.014491679653002519
STAT,1828,86,na,1914,144.03251385703263
STAT,1878,39,25-29,1917,2.988326067144333
STAT,1783,79,na,1862,283.42907317719795
SIM,1908,29,45-49,1937,6
SIM,1841,34,25-29,1875,14
SIM,1804,54,50-100,1858,1
STAT,1949,21,na,1970,4306.341210088965
STAT,1854,20,35-39,1874,5.220394846886903
SIM,1817,37,35-39,1854,12
STAT,1916,49,15-19,1965,3.7905918735061143E-4
STAT,1832,46,25-29,1878,0.04710926281996165
STAT,1927,36,45-49,1963,0.8574687551800569
STAT,1882,34,20-24,1916,2.6218895262276636
SIM,1827,37,45-49,1864,1
SIM,1863,37,30-34,1900,6
SIM,1840,20,15-19,1860,3
SIM,1923,36,35-39,1959,5
SIM,1926,24,35-39,1950,20
STAT,1893,26,45-49,1919,1.4287852221744954
STAT,1933,15,50-100,1948,0.5091589867856329
SIM,1866,21,30-34,1887,24
STAT,1876,28,35-39,1904,10.026897571893608
SIM,1868,34,na,1902,2169
STAT,1924,48,45-49,1972,0.26073729247135174
STAT,1866,67,na,1933,1482.54735033739
STAT,1886,28,45-49,1914,1.179851728545549
STAT,1863,53,na,1916,1895.9101277860543
SIM,1961,0,na,1961,5246
STAT,1775,105,na,1880,0.015038989420211334
SIM,1849,20,na,1869,2137
STAT,1961,3,na,1964,5132.575814149944
STAT,1815,43,20-24,1858,0.3914273087532167
STAT,1935,22,45-49,1957,1.5480381912939383
STAT,1944,4,na,1948,4342.544230012451
SIM,1896,37,50-100,1933,3
SIM,1898,29,40-44,1927,8
STAT,1896,33,na,1929,3176.8467308593367
STAT,1896,27,25-29,1923,56.55366641714728
STAT,1890,55,na,1945,2551.891088027569
SIM,1884,28,35-39,1912,11
SIM,1886,15,na,1901,2846
STAT,1868,37,40-44,1905,4.225563510361937
SIM,1894,28,45-49,1922,1
SIM,1906,33,30-34,1939,17
STAT,1907,45,40-44,1952,0.14466489346192032
SIM,1804,58,na,1862,1239
SIM,1859,23,30-34,1882,23
SIM,1876,22,na,1898,2725
STAT,1818,49,45-49,1867,0.40786833431572295
STAT,1829,36,25-29,1865,2.398729279732622
STAT,1828,48,25-29,1876,0.05178899349536067
STAT,1874,52,25-29,1926,0.003643612233384081
SIM,1889,29,na,1918,2873
STAT,1838,48,35-39,1886,0.09519100791138198
STAT,1830,33,45-49,1863,1.647037564030208
SIM,1943,22,45-49,1965,1
SIM,1927,37,30-34,1964,3
STAT,1878,36,20-24,1914,0.8120901061587377
STAT,1932,21,15-19,1953,7.079681084008778
SIM,1862,20,35-39,1882,7
STAT,1805,49,35-39,1854,0.5840574908575432
STAT,1840,28,20-24,1868,10.18001079415465
STAT,1819,37,45-49,1856,5.78445614850577
STAT,1880,21,40-44,1901,2.216991051712809
SIM,1819,54,na,1873,1250
STAT,1846,47,30-34,1893,0.07311758219670131
STAT,1913,30,45-49,1943,1.5923244012250115
SIM,1856,49,na,1905,2037
STAT,1888,36,30-34,1924,6.384031445016646
SIM,1919,38,35-39,1957,3
STAT,1940,16,40-44,1956,1.4341400084572307
STAT,1891,46,30-34,1937,0.06847404775434926
STAT,1930,16,30-34,1946,15.966326664823335
STAT,1915,36,35-39,1951,2.4774176927121165
SIM,1900,19,15-19,1919,8
STAT,1855,33,15-19,1888,0.10801735122380988
STAT,1910,42,45-49,1952,0.15869087372027482
STAT,1913,26,50-100,1939,1.0041006783926705
SIM,1876,37,40-44,1913,4
SIM,1834,35,45-49,1869,1
SIM,1922,36,35-39,1958,7
STAT,1866,40,15-19,1906,0.013045723533139608
SIM,1835,23,45-49,1858,2
SIM,1850,25,50-100,1875,3
STAT,1843,102,na,1945,0.19773708714679133
SIM,1861,23,na,1884,2134
SIM,1845,61,na,1906,1466
STAT,1888,37,50-100,1925,1.4636064906981618
STAT,1921,42,20-24,1963,0.020089751827860453
SIM,1908,20,35-39,1928,10
STAT,1833,46,na,1879,1718.3039884362686
SIM,1914,45,na,1959,3857
SIM,1873,89,na,1962,175
STAT,1881,34,na,1915,2303.339441590548
SIM,1775,87,na,1862,64
STAT,1826,35,45-49,1861,2.426482928638727
STAT,1914,36,35-39,1950,2.4483072321719366
SIM,1786,80,na,1866,169
STAT,1866,20,45-49,1886,0.6670269040208466
STAT,1831,29,40-44,1860,2.5237238561507995
SIM,1816,43,na,1859,1362
STAT,1856,33,15-19,1889,0.11046989128455557
STAT,1868,26,35-39,1894,9.345985829557833
SIM,1880,22,45-49,1902,2
SIM,1919,25,20-24,1944,24
STAT,1844,39,45-49,1883,1.632427022291693
STAT,1856,26,50-100,1882,0.517001249701041
STAT,1919,37,30-34,1956,1.9769541162416018
SIM,1875,74,na,1949,1086
STAT,1929,37,40-44,1966,1.9425301239984745
SIM,1807,69,na,1876,639
STAT,1859,34,45-49,1893,1.4044407079247028
STAT,1874,35,25-29,1909,3.0059147220811204
STAT,1945,17,20-24,1962,149.56536930708688
SIM,1815,44,25-29,1859,3
STAT,1808,79,na,1887,295.2726062717526
STAT,1933,33,na,1966,5147.204635438842
STAT,1848,42,20-24,1890,0.1295046035709778
STAT,1887,48,30-34,1935,0.10778457730731364
SIM,1936,29,na,1965,3704
SIM,1867,21,15-19,1888,3
SIM,1878,88,na,1966,286
SIM,1931,35,30-34,1966,1
STAT,1871,34,45-49,1905,1.7348123704082756
SIM,1893,15,30-34,1908,2
STAT,1850,79,na,1929,535.3145493858177
SIM,1923,23,20-24,1946,154
SIM,1961,3,na,1964,5232
STAT,1842,25,50-100,1867,0.7225714421336875
STAT,1966,0,na,1966,4995.572793601142
SIM,1885,74,na,1959,1127
SIM,1849,29,45-49,1878,1
SIM,1889,17,30-34,1906,2
STAT,1894,21,35-39,1915,7.610990199791821
STAT,1852,25,45-49,1877,0.9950013495628272
STAT,1893,66,na,1959,2205.769941212341
STAT,1805,58,na,1863,1221.6723176179864
STAT,1840,15,25-29,1855,5.204180238712612
STAT,1795,64,na,1859,958.5644143105001
STAT,1851,53,35-39,1904,0.0064140102200295245
SIM,1928,32,20-24,1960,3
STAT,1827,30,35-39,1857,14.901388977804578
STAT,1861,39,50-100,1900,1.0200493707041458
SIM,1882,35,25-29,1917,3
STAT,1877,1,na,1878,3590.6220758883824
STAT,1922,17,35-39,1939,4.905938138050824
STAT,1832,24,30-34,1856,16.89914267433412
STAT,1839,34,na,1873,1852.0056135439904
SIM,1877,42,40-44,1919,7
STAT,1906,31,15-19,1937,0.12078444678888038
STAT,1851,68,na,1919,1157.1325284045438
STAT,1918,24,35-39,1942,10.188337315542698
STAT,1868,21,40-44,1889,2.0260285369575706
STAT,1858,21,30-34,1879,16.3111845090641
SIM,1858,41,na,1899,1916
STAT,1854,38,25-29,1892,2.1500812316165323
STAT,1870,93,na,1963,73.47012338866473
STAT,1837,42,45-49,1879,1.2048202816772051
SIM,1835,30,35-39,1865,14
STAT,1772,91,na,1863,12.730161216698153
SIM,1870,75,na,1945,1062
STAT,1829,43,15-19,1872,0.010566895161913222
SIM,1930,17,35-39,1947,7
STAT,1941,26,35-39,1967,15.687119922924925
STAT,1859,21,15-19,1880,3.0775940981262933
SIM,1837,36,25-29,1873,3
SIM,1843,42,na,1885,2137
STAT,1903,67,na,1970,2632.8737072942085
SIM,1827,80,na,1907,227
SIM,1838,49,50-100,1887,1
STAT,1824,35,na,1859,1452.3418069773847
STAT,1865,49,40-44,1914,0.15459359999646607
SIM,1936,23,15-19,1959,5
SIM,1912,19,25-29,1931,16
STAT,1904,19,25-29,1923,8.169415653203046
SIM,1834,24,na,1858,2021
STAT,1841,33,20-24,1874,2.427210568457207
STAT,1913,18,20-24,1931,27.89475731805314
SIM,1926,29,na,1955,4433
STAT,1923,18,30-34,1941,14.42337444435993
SIM,1921,18,20-24,1939,148
STAT,1842,46,35-39,1888,0.12769346291455594
SIM,1871,25,20-24,1896,12
STAT,1887,17,50-100,1904,0.05524549349038719
STAT,1928,23,15-19,1951,6.697034003098436
SIM,1837,35,na,1872,1635
SIM,1848,30,45-49,1878,1
STAT,1877,33,35-39,1910,10.512140528995676
SIM,1862,42,50-100,1904,1
SIM,1904,17,25-29,1921,13
SIM,1821,37,50-100,1858,1
STAT,1945,27,30-34,1972,43.41262401475844
STAT,1900,25,35-39,1925,13.629397442342123
SIM,1830,24,20-24,1854,55
STAT,1896,34,15-19,1930,0.18875781380136997
STAT,1869,29,20-24,1898,11.4374640393262
SIM,1945,15,20-24,1960,160
SIM,1865,19,35-39,1884,1
SIM,1849,46,45-49,1895,1
STAT,1879,49,35-39,1928,0.14447903570293658
STAT,1849,28,40-44,1877,2.7563942781023236
STAT,1940,28,25-29,1968,67.72744126502477
STAT,1904,29,35-39,1933,13.88538249499266
STAT,1927,18,15-19,1945,56.885596118530515
STAT,1822,61,na,1883,1109.2790749723972
STAT,1917,24,50-100,1941,0.7014744248913294
SIM,1936,29,20-24,1965,15
STAT,1833,51,25-29,1884,0.0026440086832880943
STAT,1853,15,35-39,1868,0.5523427104467289
SIM,1931,25,20-24,1956,26
STAT,1877,66,na,1943,1708.5423948136902
STAT,1915,23,20-24,1938,115.62295975953205
SIM,1905,28,30-34,1933,47
STAT,1859,85,na,1944,222.68915018904835
SIM,1877,1,na,1878,3625
STAT,1819,54,45-49,1873,0.02610995189514308
STAT,1801,62,na,1863,976.0500014888647
SIM,1885,33,35-39,1918,12
STAT,1868,52,na,1920,2067.368554257912
SIM,1861,15,35-39,1876,3
STAT,1855,39,20-24,1894,0.574394227409628
STAT,1916,39,20-24,1955,0.26968419484732575
SIM,1839,36,50-100,1875,1
STAT,1845,24,40-44,1869,1.863175965423908
STAT,1897,34,15-19,1931,0.1911774446238574
SIM,1896,7,na,1903,3487
SIM,1860,75,na,1935,897
STAT,1921,48,na,1969,4171.220634542831
STAT,1923,25,20-24,1948,21.31890361980226
SIM,1857,28,40-44,1885,4
SIM,1899,23,35-39,1922,10
STAT,1892,30,15-19,1922,0.18193528231721748
STAT,1816,98,na,1914,1.6608915197476568
STAT,1928,29,20-24,1957,22.708184834700422
SIM,1912,29,35-39,1941,25
STAT,1883,47,35-39,1930,0.13772688965931598
SIM,1859,40,30-34,1899,2
STAT,1870,29,45-49,1899,1.0933152024533086
STAT,1855,23,20-24,1878,60.16411382432699
SIM,1841,26,50-100,1867,1
SIM,1934,16,40-44,1950,2
SIM,1925,44,na,1969,4518
STAT,1823,87,na,1910,97.43915246077697
SIM,1871,23,na,1894,2246
STAT,1867,16,40-44,1883,0.178914994460139
STAT,1850,38,40-44,1888,3.369820219969166
SIM,1953,17,20-24,1970,165
SIM,1902,16,na,1918,3849
STAT,1914,26,40-44,1940,4.75710709427336
STAT,1937,15,20-24,1952,133.76995028165462
STAT,1833,26,50-100,1859,0.6030225676598404
STAT,1831,39,35-39,1870,5.53139935357431
STAT,1905,26,15-19,1931,0.664722888432454
SIM,1954,17,20-24,1971,198
STAT,1956,15,50-100,1971,0.5010832807707172
STAT,1835,22,40-44,1857,2.0797869275107947
SIM,1853,24,40-44,1877,1
STAT,1866,54,40-44,1920,0.009575047691650483
SIM,1853,44,45-49,1897,2
STAT,1931,16,15-19,1947,60.182292056488144
STAT,1827,36,40-44,1863,5.213890695153901
STAT,1869,31,35-39,1900,9.984997383679397
SIM,1904,45,na,1949,3431
STAT,1856,44,20-24,1900,0.12131632814696333
STAT,1902,49,20-24,1951,0.009459405883945095
STAT,1847,53,na,1900,1586.2714788179894
SIM,1900,34,40-44,1934,7
STAT,1847,37,20-24,1884,0.5988324001173148
SIM,1876,31,35-39,1907,18
STAT,1801,99,na,1900,0.7537220310735623
STAT,1842,102,na,1944,0.26395562732193134
SIM,1917,32,45-49,1949,2
STAT,1835,72,na,1907,947.8629802981924
STAT,1890,48,na,1938,2742.286227768223
SIM,1843,22,40-44,1865,2
SIM,1899,39,35-39,1938,5
SIM,1818,42,35-39,1860,6
SIM,1850,24,na,1874,1951
STAT,1946,17,20-24,1963,151.87605402915284
STAT,1887,30,40-44,1917,4.929589558631711
STAT,1804,80,na,1884,244.81761410214838
STAT,1888,32,15-19,1920,0.16976585159517085
SIM,1840,29,25-29,1869,45
SIM,1922,26,40-44,1948,9
STAT,1856,67,na,1923,1227.5074969275133
SIM,1878,37,25-29,1915,4
STAT,1926,16,40-44,1942,1.7374376674818273
SIM,1935,18,15-19,1953,61
STAT,1832,29,25-29,1861,38.090870925050815
STAT,1923,35,30-34,1958,2.1374253351880403
STAT,1905,19,25-29,1924,8.229599333121133
STAT,1909,32,45-49,1941,1.5152801264079838
STAT,1847,31,15-19,1878,0.12649912650342374
SIM,1863,23,20-24,1886,77
SIM,1913,21,20-24,1934,103
SIM,1921,30,45-49,1951,3
STAT,1837,35,20-24,1872,0.6537092751579049
STAT,1900,15,25-29,1915,7.987422322824291
STAT,1845,44,45-49,1889,1.0854347973384852
STAT,1894,27,40-44,1921,3.895237685157378
STAT,1828,30,35-39,1858,12.789000678795244
STAT,1840,22,15-19,1862,2.940907486612589
SIM,1885,20,20-24,1905,104
SIM,1916,30,na,1946,3901
SIM,1858,22,35-39,1880,11
SIM,1928,21,15-19,1949,5
SIM,1796,79,na,1875,308
STAT,1937,28,35-39,1965,14.767676424051631
SIM,1843,27,35-39,1870,12
SIM,1874,20,45-49,1894,3
SIM,1854,75,na,1929,998
SIM,1917,15,na,1932,4095
SIM,1869,40,40-44,1909,1
STAT,1836,20,na,1856,1785.9546701622926
STAT,1824,48,40-44,1872,0.1975850937748491
SIM,1907,63,na,1970,3074
STAT,1833,31,20-24,1864,2.4970496676720195
SIM,1919,44,na,1963,3952
SIM,1821,95,na,1916,5
SIM,1833,76,na,1909,552
STAT,1869,37,na,1906,2313.4717825442513
STAT,1881,18,15-19,1899,5.762536132585464
STAT,1891,39,40-44,1930,5.418878705023286
STAT,1863,32,45-49,1895,1.5605286359832662
STAT,1886,45,45-49,1931,0.25417777737992053
STAT,1905,21,20-24,1926,100.92267534889184
SIM,1835,36,40-44,1871,5
SIM,1904,38,40-44,1942,3
SIM,1927,27,20-24,1954,7
SIM,1913,19,25-29,1932,15
STAT,1835,27,35-39,1862,9.442133777648488
SIM,1815,95,na,1910,2
SIM,1836,30,35-39,1866,15
SIM,1859,43,35-39,1902,1
SIM,1914,34,35-39,1948,2
STAT,1817,87,na,1904,80.60664317844558
STAT,1808,101,na,1909,0.21512937140440055
SIM,1935,36,45-49,1971,1
STAT,1908,47,15-19,1955,3.3629443021916227E-4
STAT,1901,38,15-19,1939,0.017075738102179258
STAT,1762,102,na,1864,0.05422617178273584
STAT,1838,86,na,1924,148.52979213677045
STAT,1889,43,20-24,1932,0.19635607426496893
STAT,1938,3,na,1941,4039.2199511697536
STAT,1938,25,15-19,1963,0.7066741252918904
STAT,1895,21,35-39,1916,7.720021748650267
SIM,1933,3,na,1936,5229
SIM,1851,61,na,1912,1513
STAT,1889,51,na,1940,2694.4465439637643
SIM,1901,31,na,1932,3428
STAT,1939,21,na,1960,3703.6215285028416
STAT,1920,37,20-24,1957,0.29146048466530045
STAT,1829,49,20-24,1878,0.008722927011598818
STAT,1850,45,30-34,1895,0.07486005295525491
SIM,1853,90,na,1943,45
SIM,1884,23,40-44,1907,2
STAT,1917,49,15-19,1966,3.861017280486116E-4
STAT,1857,19,35-39,1876,0.5023855903540314
STAT,1859,32,50-100,1891,0.7442988588051391
STAT,1915,43,25-29,1958,0.07242928668693915
STAT,1853,53,na,1906,1752.0293980489787
STAT,1937,35,25-29,1972,0.9956807789637278
SIM,1836,94,na,1930,8
SIM,1867,32,50-100,1899,1
STAT,1942,29,20-24,1971,19.324452485001487
STAT,1919,27,20-24,1946,19.91408436770325
SIM,1871,16,na,1887,2466
STAT,1859,50,30-34,1909,0.004904955423900506
SIM,1863,96,na,1959,36
STAT,1906,50,na,1956,3230.9704556570628
STAT,1880,31,50-100,1911,0.9758429569051587
SIM,1910,29,25-29,1939,100
STAT,1847,38,na,1885,1811.329762933153
STAT,1904,26,25-29,1930,61.522883113169094
SIM,1881,36,25-29,1917,3
SIM,1848,91,na,1939,38
STAT,1906,34,35-39,1940,8.481170866468785
STAT,1851,43,na,1894,1737.4006183859017
SIM,1916,39,45-49,1955,3
STAT,1862,46,20-24,1908,0.01049636078035646
STAT,1923,20,20-24,1943,131.50386860865598
STAT,1930,18,20-24,1948,176.69341101592596
SIM,1816,42,25-29,1858,3
SIM,1826,88,na,1914,100
STAT,1921,23,20-24,1944,126.45397560270575
SIM,1871,91,na,1962,123
SIM,1793,84,na,1877,94
SIM,1931,39,40-44,1970,2
STAT,1877,30,25-29,1907,10.762953881331441
SIM,1838,20,40-44,1858,2
SIM,1912,26,25-29,1938,75
SIM,1935,33,40-44,1968,11
STAT,1932,26,30-34,1958,51.88730294206906
STAT,1869,27,45-49,1896,1.0902715769383502
STAT,1927,33,40-44,1960,4.8625668412885075
STAT,1875,21,30-34,1896,18.530989814933147
STAT,1893,17,40-44,1910,0.23456246837849007
SIM,1914,14,na,1928,4330
STAT,1858,49,50-100,1907,0.19054683311145063
SIM,1903,39,35-39,1942,6
SIM,1918,28,na,1946,4296
STAT,1852,27,50-100,1879,0.565059689644675
STAT,1914,42,15-19,1956,0.0015352995032152342
SIM,1884,42,na,1926,2372
SIM,1919,29,15-19,1948,4
SIM,1839,55,na,1894,1355
SIM,1876,43,35-39,1919,4
SIM,1893,40,30-34,1933,2
SIM,1899,25,30-34,1924,46
STAT,1859,23,na,1882,1979.0116802341236
SIM,1834,83,na,1917,193
STAT,1943,16,35-39,1959,4.4942145768957005
STAT,1811,109,na,1920,3.10155646176764E-4
STAT,1924,16,50-100,1940,0.4519482103470748
STAT,1836,48,15-19,1884,2.6071491558761706E-4
STAT,1843,48,na,1891,1498.3783855840636
STAT,1838,61,na,1899,1250.9141285307178
STAT,1902,29,25-29,1931,59.94361595684027
SIM,1883,33,25-29,1916,16
STAT,1875,33,25-29,1908,10.578975843863951
STAT,1934,21,35-39,1955,12.790062014449878
SIM,1928,0,na,1928,5404
SIM,1941,28,na,1969,4013
SIM,1785,89,na,1874,11
STAT,1892,30,20-24,1922,3.453337466570165
SIM,1928,18,30-34,1946,20
STAT,1912,45,15-19,1957,3.588513673766338E-4
SIM,1920,36,30-34,1956,2
STAT,1810,47,40-44,1857,0.6613589005767281
STAT,1910,23,45-49,1933,1.0627621508636187
STAT,1864,93,na,1957,34.57932362411956
SIM,1800,71,na,1871,596
STAT,1892,38,50-100,1930,1.5482977893345227
SIM,1942,21,35-39,1963,13
SIM,1951,16,35-39,1967,7
STAT,1911,16,15-19,1927,9.18477072081748
SIM,1832,29,40-44,1861,5
STAT,1930,29,30-34,1959,50.30684700938607
STAT,1904,39,30-34,1943,1.6505471963168323
STAT,1796,80,na,1876,247.34462471719266
SIM,1942,29,45-49,1971,3
STAT,1892,25,na,1917,3045.1499680364523
STAT,1913,20,50-100,1933,0.6471571096258499
SIM,1858,34,na,1892,1908
SIM,1854,20,na,1874,2540
SIM,1942,23,30-34,1965,45
STAT,1911,16,50-100,1927,0.07582362847186536
SIM,1857,31,30-34,1888,4
STAT,1939,27,25-29,1966,66.79998083081429
STAT,1932,24,35-39,1956,12.442267408974574
STAT,1916,41,40-44,1957,0.2590446166639691
SIM,1891,43,30-34,1934,3
SIM,1935,31,45-49,1966,3
STAT,1876,17,35-39,1893,0.5722174573362909
STAT,1937,19,15-19,1956,44.439499355505816
STAT,1896,15,na,1911,3392.2242630296896
STAT,1866,46,35-39,1912,0.13130430213484603
SIM,1858,10,na,1868,2300
STAT,1894,37,50-100,1931,1.5964773375222292
STAT,1914,44,40-44,1958,0.24922987451289194
SIM,1888,22,20-24,1910,92
STAT,1778,112,na,1890,8.613087717010062E-4
STAT,1849,31,30-34,1880,15.972328779748036
STAT,1866,40,20-24,1906,0.15002581252808098
STAT,1881,65,na,1946,1645.2891281501709
STAT,1856,98,na,1954,2.5154957129393978
SIM,1911,27,50-100,1938,1
STAT,1870,40,40-44,1910,2.2533149629926434
STAT,1818,43,50-100,1861,2.0063069382121954
STAT,1843,25,50-100,1868,0.5386863878313374
SIM,1829,37,na,1866,1859
SIM,1940,24,35-39,1964,16
STAT,1883,43,30-34,1926,1.1280907539547078
SIM,1825,47,na,1872,1274
SIM,1925,26,35-39,1951,23
SIM,1821,33,na,1854,1513
SIM,1953,7,na,1960,4918
STAT,1914,33,30-34,1947,15.933502662099514
STAT,1852,84,na,1936,252.28908603504706
SIM,1922,44,40-44,1966,3
SIM,1945,19,15-19,1964,52
STAT,1863,33,50-100,1896,0.8164786281687473
STAT,1940,32,15-19,1972,0.1342676566184761
STAT,1794,97,na,1891,1.0447353436382532
STAT,1870,22,na,1892,2345.6274000259027
SIM,1813,45,50-100,1858,2
SIM,1922,33,30-34,1955,29
STAT,1809,64,na,1873,995.6423271329472
STAT,1866,50,50-100,1916,0.014327559462524678
STAT,1864,49,35-39,1913,0.12493013503174721
STAT,1840,20,50-100,1860,0.3688008019531769
STAT,1865,27,30-34,1892,23.224158191558608
STAT,1868,99,na,1967,9.374545778742627
SIM,1909,43,40-44,1952,1
STAT,1934,23,30-34,1957,39.01476256370604
STAT,1863,19,20-24,1882,16.280735579796094
STAT,1915,29,35-39,1944,15.341710491504283
SIM,1885,30,25-29,1915,5
SIM,1838,73,na,1911,858
SIM,1940,26,30-34,1966,62
STAT,1917,26,35-39,1943,15.947357182783254
STAT,1958,7,na,1965,5214.548827198947
SIM,1929,34,25-29,1963,17
STAT,1864,43,20-24,1907,0.14369458984899128
STAT,1881,46,30-34,1927,0.09450870442619286
SIM,1879,21,40-44,1900,3
SIM,1888,32,na,1920,2927
STAT,1930,16,25-29,1946,56.76552607052181
SIM,1906,23,20-24,1929,96
STAT,1866,17,na,1883,2424.4310409806835
SIM,1871,19,20-24,1890,27
STAT,1835,19,45-49,1854,0.14002186266000635
SIM,1923,29,35-39,1952,25
SIM,1924,41,40-44,1965,1
STAT,1818,104,na,1922,0.034364313612865155
STAT,1844,89,na,1933,83.11668652514612
SIM,1934,34,na,1968,5366
SIM,1804,61,na,1865,1111
SIM,1892,77,na,1969,1543
STAT,1876,94,na,1970,93.84714899054332
SIM,1916,33,30-34,1949,22
STAT,1830,27,15-19,1857,0.49869337278340614
STAT,1890,9,na,1899,3202.194530333281
SIM,1896,24,50-100,1920,1
STAT,1938,34,25-29,1972,9.370005125839155
SIM,1847,24,25-29,1871,75
STAT,1849,40,15-19,1889,0.010985961549499141
SIM,1873,16,20-24,1889,17
SIM,1859,75,na,1934,896
STAT,1896,41,45-49,1937,0.13957460278036626
STAT,1831,82,na,1913,293.2006357951109
STAT,1869,7,na,1876,2707.8328020603103
STAT,1777,110,na,1887,0.0015031262021455254
STAT,1869,21,30-34,1890,17.5437292659541
STAT,1852,16,40-44,1868,0.1687611598591296
SIM,1863,80,na,1943,442
STAT,1910,25,40-44,1935,4.610648991227278
STAT,1894,33,35-39,1927,13.113010684450105
STAT,1865,16,20-24,1881,16.948455405075507
SIM,1905,30,20-24,1935,3
STAT,1909,39,na,1948,3557.287106401073
STAT,1908,33,30-34,1941,14.948929126593258
STAT,1861,29,50-100,1890,0.5330439131835569
SIM,1850,42,30-34,1892,1
STAT,1899,38,40-44,1937,1.3032032700858267
STAT,1894,44,45-49,1938,0.1333193641632813
SIM,1852,42,35-39,1894,1
SIM,1926,39,na,1965,4600
STAT,1877,49,15-19,1926,4.0826298244097786E-4
STAT,1830,38,25-29,1868,2.5806668549157226
STAT,1879,54,20-24,1933,7.563788253064188E-4
STAT,1839,37,30-34,1876,4.515385863841167
SIM,1905,21,na,1926,3790
STAT,1934,29,45-49,1963,2.34597316976392
STAT,1851,32,25-29,1883,8.072163512094187
SIM,1846,25,na,1871,1898
STAT,1945,24,15-19,1969,5.887878453663695
STAT,1867,58,na,1925,1881.1340805073635
STAT,1944,24,50-100,1968,0.7169219001275589
SIM,1851,95,na,1946,11
STAT,1805,74,na,1879,553.5583542435447
SIM,1881,5,na,1886,2346
STAT,1907,16,25-29,1923,8.42569248515287
STAT,1928,24,15-19,1952,6.675737434968584
STAT,1792,90,na,1882,29.60517877066754
STAT,1848,27,30-34,1875,24.54472435038647
STAT,1904,28,20-24,1932,16.943932778687305
SIM,1877,21,30-34,1898,26
STAT,1871,63,na,1934,1790.414077064445
STAT,1886,5,na,1891,2794.6305692201704
SIM,1851,55,na,1906,1637
STAT,1844,42,35-39,1886,1.4673107829127694
STAT,1788,85,na,1873,81.60339107604126
SIM,1842,19,na,1861,2210
STAT,1912,36,30-34,1948,1.8033212481874321
STAT,1784,79,na,1863,232.23178056021862
SIM,1856,27,30-34,1883,2
STAT,1862,27,na,1889,2089.2476810705934
SIM,1896,67,na,1963,2290
SIM,1915,16,25-29,1931,11
STAT,1889,15,25-29,1904,7.090099998565887
SIM,1858,27,35-39,1885,12
STAT,1848,16,20-24,1864,18.04973460047987
STAT,1780,106,na,1886,0.011551244282583254
STAT,1844,53,45-49,1897,0.0112976369735716
SIM,1913,31,50-100,1944,1
SIM,1901,25,40-44,1926,4
SIM,1912,28,20-24,1940,3
STAT,1798,87,na,1885,69.76062317443763
STAT,1936,34,20-24,1970,2.388777460308804
STAT,1899,31,15-19,1930,0.198205357565416
STAT,1927,31,45-49,1958,1.9576185073581929
SIM,1861,32,35-39,1893,15
SIM,1925,38,50-100,1963,3
STAT,1823,42,20-24,1865,0.23561260003545248
STAT,1930,16,na,1946,4821.490578405562
SIM,1847,37,30-34,1884,7
SIM,1898,34,na,1932,3203
STAT,1899,22,30-34,1921,24.690529361272294
SIM,1821,73,na,1894,617
STAT,1885,40,30-34,1925,1.167467334051773
STAT,1889,17,20-24,1906,22.07901006967718
SIM,1916,20,25-29,1936,152
STAT,1823,48,35-39,1871,0.18997083780327045
STAT,1852,68,na,1920,1158.9727125923978
STAT,1840,48,35-39,1888,0.09770479558845609
STAT,1840,42,20-24,1882,0.11612922228089814
STAT,1914,47,45-49,1961,0.21747595326245756
SIM,1814,63,na,1877,951
SIM,1772,82,na,1854,128
STAT,1834,20,30-34,1854,27.09612778934767
STAT,1821,48,25-29,1869,0.08320974326262558
SIM,1901,23,45-49,1924,1
SIM,1830,36,50-100,1866,2
SIM,1854,42,50-100,1896,3
SIM,1916,31,35-39,1947,17
STAT,1829,39,50-100,1868,0.9732020340706768
STAT,1889,45,na,1934,2829.872762536023
STAT,1839,26,20-24,1865,10.553681411773812
SIM,1876,47,na,1923,2562
STAT,1890,33,20-24,1923,3.3219312603422884
STAT,1890,39,35-39,1929,8.641267884804245
STAT,1923,39,40-44,1962,1.7488291542498065
STAT,1858,30,15-19,1888,0.11520987212119807
STAT,1856,74,na,1930,859.3606296916298
SIM,1936,24,15-19,1960,5
STAT,1881,30,45-49,1911,1.7113716049350647
SIM,1850,30,na,1880,2073
STAT,1853,32,35-39,1885,8.624356738157989
SIM,1894,20,na,1914,3355
STAT,1821,37,15-19,1858,0.1106811822512527
STAT,1927,12,na,1939,4979.546581053225
STAT,1810,45,45-49,1855,0.9471240049536297
SIM,1868,32,50-100,1900,2
STAT,1924,16,25-29,1940,52.27535354745436
STAT,1825,42,25-29,1867,0.9207831978972914
STAT,1839,24,25-29,1863,51.40151203842775
SIM,1897,17,20-24,1914,24
STAT,1908,20,25-29,1928,86.23270471653325
STAT,1834,32,25-29,1866,7.813599808760285
SIM,1893,19,na,1912,3279
STAT,1858,37,40-44,1895,3.468674495284375
STAT,1822,46,na,1868,1475.9693566698256
SIM,1875,22,na,1897,2305
SIM,1868,12,na,1880,2517
SIM,1880,52,na,1932,2010
SIM,1797,74,na,1871,460
SIM,1959,10,na,1969,5501
STAT,1889,28,30-34,1917,31.25099961827385
SIM,1899,28,35-39,1927,20
STAT,1901,19,na,1920,3556.721419124865
STAT,1947,24,25-29,1971,105.37760507702362
STAT,1871,39,25-29,1910,2.859979083646391
SIM,1897,28,30-34,1925,39
SIM,1809,47,50-100,1856,1
STAT,1845,21,45-49,1866,0.6371145843053612
STAT,1908,31,35-39,1939,8.743076930023188
STAT,1913,44,na,1957,3642.0761242339695
SIM,1817,68,na,1885,883
SIM,1847,26,20-24,1873,10
STAT,1919,34,15-19,1953,0.13878478897242583
STAT,1911,3,na,1914,4081.4804234457542
SIM,1842,32,25-29,1874,13
SIM,1932,16,25-29,1948,82
STAT,1835,96,na,1931,6.4446968343775035
SIM,1824,51,50-100,1875,1
SIM,1931,20,20-24,1951,231
STAT,1906,34,na,1940,3510.060556675016
SIM,1819,94,na,1913,1
SIM,1898,32,30-34,1930,36
STAT,1908,39,45-49,1947,0.6378239965726751
STAT,1923,37,45-49,1960,0.7981046408954289
SIM,1836,23,40-44,1859,3
SIM,1853,21,45-49,1874,1
STAT,1900,18,35-39,1918,0.7678280541379786
STAT,1849,47,50-100,1896,0.19112784896282498
STAT,1893,50,na,1943,2801.069527679502
STAT,1815,39,40-44,1854,13.150069604766326
STAT,1895,17,45-49,1912,0.08615799154263452
STAT,1906,20,20-24,1926,101.98228495732279
SIM,1936,24,45-49,1960,1
STAT,1921,26,25-29,1947,74.34316052572541
SIM,1932,4,na,1936,6073
STAT,1851,46,45-49,1897,0.179203671322235
STAT,1905,7,na,1912,3804.071704315134
SIM,1883,47,50-100,1930,3
SIM,1837,19,15-19,1856,6
SIM,1883,30,20-24,1913,5
STAT,1846,96,na,1942,6.516284595857851
SIM,1905,37,na,1942,3586
SIM,1867,27,na,1894,2268
STAT,1920,14,na,1934,4474.620774639838
STAT,1851,100,na,1951,0.8038646645625256
STAT,1887,15,15-19,1902,6.723164475415297
SIM,1924,44,45-49,1968,1
STAT,1918,24,50-100,1942,0.7119733408818678
STAT,1853,43,45-49,1896,1.228745532989901
STAT,1874,17,30-34,1891,1.6483631907746277
STAT,1865,2,na,1867,3127.685662563503
STAT,1875,24,35-39,1899,6.014771253057827
STAT,1850,16,30-34,1866,1.5002040208277707
STAT,1932,6,na,1938,5363.424667639851
SIM,1895,15,15-19,1910,9
STAT,1875,47,50-100,1922,0.25355300041366285
STAT,1845,38,15-19,1883,0.04266592930968983
STAT,1875,30,20-24,1905,2.8261960117798104
SIM,1910,26,20-24,1936,3
STAT,1917,23,30-34,1940,30.738146863242005
STAT,1910,20,40-44,1930,3.204707891045631
SIM,1907,41,40-44,1948,3
SIM,1836,66,na,1902,1148
SIM,1914,20,20-24,1934,110
STAT,1916,44,45-49,1960,0.1715441882184013
SIM,1859,7,na,1866,2693
SIM,1882,17,30-34,1899,3
STAT,1902,26,20-24,1928,16.801292244932366
STAT,1923,23,25-29,1946,108.25679514274113
STAT,1847,46,25-29,1893,0.04324969872504486
STAT,1939,15,30-34,1954,12.347364895448482
SIM,1879,12,na,1891,2982
SIM,1851,26,40-44,1877,6
STAT,1828,26,45-49,1854,2.8857063616040035
SIM,1797,58,na,1855,964
SIM,1879,32,20-24,1911,3
SIM,1910,15,35-39,1925,2
STAT,1826,29,45-49,1855,2.0149248332266048
STAT,1764,99,na,1863,0.18113546585731038
SIM,1831,35,na,1866,1771
STAT,1838,21,na,1859,1870.419698281306
STAT,1862,49,25-29,1911,0.04919091846484835
SIM,1843,16,35-39,1859,3
STAT,1864,53,na,1917,1930.8614742044235
SIM,1839,15,na,1854,2087
SIM,1888,27,20-24,1915,17
STAT,1806,99,na,1905,0.6385397832654677
STAT,1862,38,15-19,1900,0.048736212307348085
SIM,1917,49,50-100,1966,2
STAT,1931,33,30-34,1964,20.851323351806084
SIM,1912,31,na,1943,3604
STAT,1894,30,25-29,1924,13.425879234857115
STAT,1823,71,na,1894,738.2294356851742
SIM,1947,15,30-34,1962,20
SIM,1894,20,25-29,1914,102
SIM,1925,23,30-34,1948,39
SIM,1834,29,45-49,1863,1
SIM,1888,38,30-34,1926,8
STAT,1886,46,50-100,1932,0.2626497204411391
SIM,1884,82,na,1966,644
STAT,1902,18,45-49,1920,0.09298793366720043
STAT,1886,39,15-19,1925,0.05928013751511016
STAT,1930,32,na,1962,4933.224678957569
SIM,1939,2,na,1941,4167
STAT,1921,35,15-19,1956,0.02169356368780353
SIM,1904,18,15-19,1922,8
SIM,1906,26,25-29,1932,83
SIM,1902,16,15-19,1918,10
STAT,1885,71,na,1956,1372.8590688860204
SIM,1878,19,30-34,1897,2
STAT,1888,47,25-29,1935,0.06834550957097306
SIM,1838,31,20-24,1869,2
STAT,1883,40,20-24,1923,0.15855009428143113
STAT,1901,59,na,1960,2862.6623937005643
SIM,1860,2,na,1862,2991
STAT,1841,29,40-44,1870,2.7425337754154104
STAT,1878,17,45-49,1895,0.06848769203398179
STAT,1928,44,50-100,1972,0.15087342490964262
STAT,1842,42,30-34,1884,1.070909021424346
STAT,1937,4,na,1941,3964.0224913109896
SIM,1847,10,na,1857,2299
STAT,1897,22,20-24,1919,93.31156885395318
SIM,1821,34,50-100,1855,3
STAT,1913,16,25-29,1929,8.96162774075431
SIM,1921,16,25-29,1937,59
STAT,1814,94,na,1908,9.354688595850826
STAT,1891,17,30-34,1908,1.993098979224721
SIM,1872,51,50-100,1923,2
STAT,1881,49,35-39,1930,0.13345334161968714
STAT,1896,6,na,1902,3492.5158594157106
SIM,1916,34,45-49,1950,2
STAT,1843,26,40-44,1869,2.504458984724127
STAT,1847,81,na,1928,404.8904085365105
STAT,1825,45,35-39,1870,0.19327016480391057
STAT,1908,36,50-100,1944,0.3987248359264553
SIM,1850,14,na,1864,2278
SIM,1947,24,20-24,1971,150
STAT,1833,42,50-100,1875,0.9090140442794137
STAT,1841,41,na,1882,1819.1596859836675
STAT,1872,88,na,1960,225.05870093731392
STAT,1949,2,na,1951,4713.245210161121
SIM,1802,78,na,1880,334
SIM,1901,22,30-34,1923,28
STAT,1827,53,45-49,1880,0.014089247942314018
STAT,1893,10,na,1903,3321.941508213624
STAT,1928,24,45-49,1952,1.4110645108803384
STAT,1827,42,35-39,1869,1.9478849422822497
SIM,1843,60,na,1903,1748
STAT,1819,48,15-19,1867,7.680555617495668E-4
STAT,1943,27,15-19,1970,0.7591550019730666
SIM,1909,11,na,1920,4242
STAT,1918,41,45-49,1959,0.1789025220791515
SIM,1857,34,35-39,1891,18
STAT,1868,40,25-29,1908,0.6261230186576952
STAT,1927,44,20-24,1971,0.022312207070717904
STAT,1939,24,20-24,1963,112.65881028095457
STAT,1905,43,30-34,1948,0.11572522432184809
STAT,1776,84,na,1860,88.37099892004443
SIM,1918,31,45-49,1949,1
STAT,1875,53,na,1928,2197.445103175272
SIM,1853,19,na,1872,2029
STAT,1859,17,35-39,1876,0.5174060522440781
SIM,1832,26,30-34,1858,28
STAT,1854,16,45-49,1870,0.05899145571598207
STAT,1900,43,50-100,1943,0.10218443715913607
STAT,1849,34,35-39,1883,8.171979647260377
STAT,1832,35,25-29,1867,2.5378409649887663
STAT,1873,16,50-100,1889,0.050460465573127895
STAT,1917,34,na,1951,3963.3654216258287
SIM,1835,42,35-39,1877,3
SIM,1882,16,na,1898,2262
SIM,1938,24,na,1962,3494
STAT,1840,43,na,1883,1668.5388430460039
STAT,1920,42,15-19,1962,0.0017127460891924267
STAT,1834,71,na,1905,794.5113821251039
SIM,1863,40,45-49,1903,1
STAT,1822,102,na,1924,0.1639210525661436
SIM,1855,45,na,1900,1950
STAT,1921,29,35-39,1950,16.77884987749173
SIM,1905,33,25-29,1938,2
STAT,1902,26,15-19,1928,0.6497737384393247
SIM,1931,34,40-44,1965,6
STAT,1848,19,25-29,1867,5.668051511392048
STAT,1908,34,45-49,1942,1.4865427711991792
SIM,1796,89,na,1885,46
STAT,1862,49,30-34,1911,0.08266807210572416
STAT,1816,52,30-34,1868,0.014783556483003479
STAT,1846,50,45-49,1896,0.011171516689135477
STAT,1843,91,na,1934,39.08393595138182
STAT,1852,19,45-49,1871,0.05921308549994827
STAT,1914,45,25-29,1959,0.05332869556512621
STAT,1869,24,35-39,1893,5.694327152198623
SIM,1864,21,20-24,1885,72
SIM,1914,36,30-34,1950,3
SIM,1861,43,45-49,1904,1
SIM,1864,22,na,1886,2549
SIM,1866,37,40-44,1903,5
STAT,1909,27,15-19,1936,0.680812932738418
STAT,1904,23,15-19,1927,4.766892110306848
SIM,1860,91,na,1951,21
STAT,1882,16,20-24,1898,17.387264357405012
SIM,1864,81,na,1945,566
SIM,1858,24,30-34,1882,25
STAT,1923,34,40-44,1957,4.527009746433668
SIM,1857,43,25-29,1900,3
SIM,1840,35,25-29,1875,2
STAT,1837,29,20-24,1866,10.1253414140288
SIM,1849,21,25-29,1870,78
SIM,1867,70,na,1937,1164
STAT,1875,49,40-44,1924,0.17386407327444678
STAT,1938,31,20-24,1969,2.4774066617453783
STAT,1905,49,na,1954,3216.994903498915
STAT,1933,18,50-100,1951,0.5054764728287152
SIM,1877,27,45-49,1904,1
SIM,1837,19,20-24,1856,25
STAT,1845,74,na,1919,810.9070229231999
STAT,1892,36,35-39,1928,9.007218043221345
STAT,1872,35,50-100,1907,1.2585154750928282
STAT,1912,22,40-44,1934,3.251011648101198
SIM,1887,47,na,1934,2433
SIM,1806,68,na,1874,921
SIM,1920,22,40-44,1942,5
STAT,1925,47,20-24,1972,0.01353344876111282
STAT,1782,102,na,1884,0.08786550211382015
STAT,1915,24,35-39,1939,9.759766972224545
STAT,1948,17,25-29,1965,50.09835783628993
STAT,1826,36,na,1862,1571.2437447069499
STAT,1871,28,15-19,1899,0.45365361039189367
STAT,1864,51,50-100,1915,0.01383030987664907
STAT,1906,36,30-34,1942,1.7004179189611668
STAT,1910,55,na,1965,3349.6567151628087
STAT,1938,32,50-100,1970,0.8392700648856347
STAT,1892,47,45-49,1939,0.1679315757106233
SIM,1847,50,na,1897,1605
SIM,1873,27,30-34,1900,23
STAT,1912,33,20-24,1945,2.4112528111569342
STAT,1858,34,30-34,1892,13.716397381812671
SIM,1872,57,na,1929,2264
STAT,1920,42,45-49,1962,0.1856188443843198
STAT,1934,24,45-49,1958,1.5268291744576832
SIM,1931,8,na,1939,5190
SIM,1845,29,20-24,1874,18
STAT,1868,54,45-49,1922,0.013623470782412583
STAT,1878,45,na,1923,2382.373081721346
STAT,1949,21,25-29,1970,108.92559544792537
STAT,1834,48,40-44,1882,0.10675187654030233
STAT,1922,22,50-100,1944,0.7622903351290515
STAT,1886,20,25-29,1906,61.41055661495626
STAT,1901,31,25-29,1932,14.561332157281843
STAT,1840,45,30-34,1885,0.0702029530286328
STAT,1863,68,na,1931,1367.56834693764
STAT,1845,49,25-29,1894,0.04120876056305842
STAT,1942,30,50-100,1972,0.8902419960173997
SIM,1966,1,na,1967,5082
STAT,1941,19,35-39,1960,4.360643325349031
SIM,1898,10,na,1908,3526
STAT,1889,61,na,1950,2327.1878908406
SIM,1911,30,45-49,1941,3
STAT,1919,39,20-24,1958,0.2853300372999409
SIM,1818,53,na,1871,1205
SIM,1936,27,25-29,1963,86
STAT,1868,43,35-39,1911,1.7353351269337367
SIM,1825,36,40-44,1861,1
STAT,1858,23,20-24,1881,56.60389318475342
SIM,1922,49,na,1971,4698
STAT,1902,15,35-39,1917,0.7867892743045897
STAT,1874,31,na,1905,2477.9834455325827
STAT,1892,65,na,1957,2194.1451705993054
SIM,1898,35,35-39,1933,3
SIM,1931,23,25-29,1954,145
SIM,1822,47,50-100,1869,2
STAT,1917,37,15-19,1954,0.020133169436639543
SIM,1930,22,50-100,1952,1
SIM,1869,53,na,1922,2055
STAT,1926,30,na,1956,4627.1564875263075
STAT,1925,36,40-44,1961,1.8174411611855994
STAT,1873,36,25-29,1909,2.9622266077034327
SIM,1929,28,na,1957,4551
STAT,1855,33,na,1888,1810.0358777711162
STAT,1784,95,na,1879,2.1890156618755876
STAT,1839,27,50-100,1866,0.5713390897763786
SIM,1835,25,na,1860,1664
STAT,1860,63,na,1923,1473.1689731046847
STAT,1834,23,35-39,1857,4.615118668609472
SIM,1820,42,45-49,1862,2
STAT,1781,90,na,1871,17.009786437985646
STAT,1844,38,50-100,1882,1.0158683009307048
SIM,1866,23,20-24,1889,74
STAT,1939,18,40-44,1957,1.4129737502152537
STAT,1856,21,20-24,1877,62.42332429163888
STAT,1928,27,25-29,1955,81.96259347510315
STAT,1839,33,15-19,1872,0.12296336975345222
STAT,1857,36,50-100,1893,0.9724191597483189
SIM,1903,20,45-49,1923,1
SIM,1851,71,na,1922,1124
SIM,1920,33,20-24,1953,3
STAT,1903,30,45-49,1933,2.528499336011272
SIM,1855,85,na,1940,309
SIM,1912,23,20-24,1935,1
STAT,1859,35,50-100,1894,1.0068109751932077
STAT,1851,35,35-39,1886,5.526468414996749
STAT,1869,24,40-44,1893,2.0334041255396254
STAT,1857,53,30-34,1910,0.004616727276344802
STAT,1904,23,20-24,1927,99.57442584462072
SIM,1926,23,na,1949,4403
STAT,1876,19,na,1895,2619.6859421107065
SIM,1947,18,40-44,1965,6
STAT,1812,42,45-49,1854,4.924545049117726
SIM,1852,38,50-100,1890,1
STAT,1821,45,20-24,1866,0.01810502862769053
STAT,1875,30,15-19,1905,0.14889502525151105
STAT,1884,27,40-44,1911,2.9835666750213212
SIM,1933,36,40-44,1969,3
STAT,1875,93,na,1968,112.19151662436217
SIM,1927,24,na,1951,4883
STAT,1853,40,40-44,1893,1.8788673949813703
SIM,1851,29,45-49,1880,4
STAT,1938,31,15-19,1969,0.1305194423604539
STAT,1939,18,35-39,1957,4.238921005217276
STAT,1897,37,25-29,1934,3.8986022772837736
SIM,1844,31,45-49,1875,3
STAT,1830,32,50-100,1862,0.8795917772909274
STAT,1854,32,na,1886,1833.9839668706788
SIM,1788,78,na,1866,322
SIM,1911,32,40-44,1943,1
STAT,1826,102,na,1928,0.16087109224206805
STAT,1928,34,na,1962,4773.781587374044
SIM,1874,80,na,1954,677
SIM,1919,24,45-49,1943,2
STAT,1865,94,na,1959,31.072490998393707
SIM,1870,23,40-44,1893,2
STAT,1847,23,45-49,1870,0.6354609387160364
SIM,1796,73,na,1869,525
STAT,1850,19,35-39,1869,0.5073914030342453
STAT,1889,19,40-44,1908,0.22656483497088406
STAT,1910,22,30-34,1932,27.231189688405166
STAT,1955,11,na,1966,5268.964309174693
SIM,1900,62,na,1962,2976
SIM,1894,32,50-100,1926,1
STAT,1831,52,20-24,1883,4.849170130280489E-4
STAT,1825,30,30-34,1855,55.78266384010623
SIM,1872,17,na,1889,2775
STAT,1842,39,50-100,1881,1.1557383968312747
STAT,1862,20,50-100,1882,0.3693942578987794
SIM,1921,47,50-100,1968,2
STAT,1839,21,15-19,1860,3.026966548606745
STAT,1888,32,20-24,1920,3.2223479052051536
SIM,1842,23,35-39,1865,5
SIM,1947,18,35-39,1965,7
SIM,1847,21,15-19,1868,3
SIM,1896,32,20-24,1928,4
STAT,1828,31,50-100,1859,1.114864320054747
STAT,1834,35,35-39,1869,5.349438326066653
STAT,1838,40,45-49,1878,1.202097000675989
STAT,1845,55,na,1900,1510.849446193246
STAT,1862,23,40-44,1885,1.8472367521002568
STAT,1946,21,50-100,1967,0.739788086360462
STAT,1834,46,45-49,1880,0.16590911482237605
STAT,1936,34,15-19,1970,0.12585011046312053
SIM,1847,29,25-29,1876,6
STAT,1928,28,30-34,1956,48.76864799689158
STAT,1940,23,25-29,1963,94.963839412797
SIM,1915,39,na,1954,4187
STAT,1811,46,na,1857,1330.0106016216414
SIM,1827,89,na,1916,35
STAT,1932,27,45-49,1959,2.286750017382743
SIM,1837,18,30-34,1855,1
STAT,1899,35,30-34,1934,7.45776511961814
SIM,1872,20,40-44,1892,3
STAT,1876,53,35-39,1929,0.008833746855152156
STAT,1868,42,50-100,1910,1.0185278441673178
SIM,1842,35,35-39,1877,12
STAT,1880,40,na,1920,2476.2933638940995
SIM,1808,94,na,1902,2
SIM,1854,19,15-19,1873,6
SIM,1923,46,50-100,1969,1
STAT,1846,19,15-19,1865,5.591033624188939
STAT,1816,52,25-29,1868,0.00879682691336828
STAT,1874,68,na,1942,1580.445997370543
STAT,1820,82,na,1902,237.50085235320205
STAT,1895,17,na,1912,3331.181984063511
SIM,1889,42,30-34,1931,2
STAT,1814,44,15-19,1858,0.03509066143522618
STAT,1899,24,20-24,1923,94.92518976238318
SIM,1889,57,na,1946,2436
STAT,1948,15,50-100,1963,0.4333565742259771
SIM,1885,43,na,1928,2457
STAT,1864,20,40-44,1884,1.9577084292073725
STAT,1832,39,40-44,1871,3.697874897750629
STAT,1917,37,20-24,1954,0.2763734729490004
STAT,1947,16,na,1963,4189.302587913073
STAT,1931,40,25-29,1971,0.09668091233042174
SIM,1840,39,40-44,1879,4
STAT,1903,27,50-100,1930,0.9201420150201954
SIM,1855,31,20-24,1886,1
STAT,1883,43,25-29,1926,0.6301047480302495
SIM,1902,19,25-29,1921,17
SIM,1871,32,na,1903,2341
STAT,1891,30,50-100,1921,1.1549547431281106
STAT,1910,39,25-29,1949,0.940501915488591
STAT,1827,50,40-44,1877,0.01084726769356689
SIM,1846,40,45-49,1886,3
STAT,1841,25,25-29,1866,39.86082495468211
STAT,1904,35,15-19,1939,0.017734477388010816
SIM,1818,41,45-49,1859,1
STAT,1890,36,30-34,1926,6.609214269551583
SIM,1862,29,20-24,1891,15
SIM,1883,24,35-39,1907,8
STAT,1855,73,na,1928,894.0461829337171
SIM,1873,58,na,1931,1883
STAT,1866,38,50-100,1904,1.142529826517356
SIM,1826,43,50-100,1869,2
SIM,1906,62,na,1968,2808
SIM,1836,63,na,1899,1271
STAT,1919,34,20-24,1953,2.634292290336893
STAT,1823,45,30-34,1868,0.13708654810970364
STAT,1886,56,na,1942,2175.0514365332733
STAT,1892,21,30-34,1913,22.64307258017761
STAT,1931,17,na,1948,4869.054143830901
STAT,1854,29,20-24,1883,9.097709327842226
SIM,1863,37,na,1900,2138
STAT,1886,47,20-24,1933,0.012737057533555928
SIM,1874,50,50-100,1924,1
SIM,1904,17,30-34,1921,2
STAT,1876,35,na,1911,2480.2477744399757
STAT,1899,22,25-29,1921,79.35111093358847
STAT,1894,41,40-44,1935,2.938047011502884
STAT,1954,18,30-34,1972,15.218528818666831
STAT,1825,51,na,1876,1775.8830718027848
STAT,1830,81,na,1911,356.7638771429664
SIM,1873,19,25-29,1892,6
STAT,1843,29,45-49,1872,0.9084236837769456
STAT,1905,65,na,1970,2805.2274239039048
STAT,1928,2,na,1930,5208.784724136539
STAT,1843,23,30-34,1866,14.971518955700317
STAT,1922,43,30-34,1965,0.14800816203337516
STAT,1875,47,45-49,1922,0.24364213434812404
STAT,1829,65,na,1894,996.4659701438679
SIM,1895,42,na,1937,3139
STAT,1764,100,na,1864,0.11088750948852827
STAT,1845,20,30-34,1865,16.392059363233322
STAT,1865,23,15-19,1888,3.0574183969616304
SIM,1940,0,na,1940,4460
SIM,1923,2,na,1925,4847
STAT,1872,53,20-24,1925,7.372679618839433E-4
SIM,1927,34,20-24,1961,3
STAT,1901,2,na,1903,3774.19445504787
SIM,1895,8,na,1903,3442
SIM,1833,30,30-34,1863,22
SIM,1848,51,na,1899,1651
STAT,1877,32,45-49,1909,1.8178009170560931
STAT,1943,26,na,1969,4030.2814116949608
SIM,1885,32,45-49,1917,3
STAT,1797,62,na,1859,917.4563069376668
STAT,1950,0,na,1950,5262.786726939836
SIM,1841,34,na,1875,1761
STAT,1902,15,40-44,1917,0.26226310661958435
SIM,1851,23,30-34,1874,26
STAT,1835,52,35-39,1887,0.006587573450872223
STAT,1910,39,na,1949,3593.6719568356666
SIM,1923,31,na,1954,4405
STAT,1875,36,35-39,1911,7.3714671552983875
STAT,1910,20,35-39,1930,8.974435986257035
STAT,1894,21,50-100,1915,0.5318652054931785
SIM,1883,36,35-39,1919,12
SIM,1866,36,35-39,1902,16
STAT,1882,23,20-24,1905,67.21204177285463
STAT,1865,19,25-29,1884,5.322223312466046
STAT,1879,41,45-49,1920,1.5845961086906188
STAT,1912,48,25-29,1960,0.05128958656140273
SIM,1933,33,30-34,1966,6
SIM,1897,37,50-100,1934,3
STAT,1901,33,45-49,1934,2.4585844285110974
STAT,1930,25,15-19,1955,0.90806679493523
SIM,1922,30,20-24,1952,6
SIM,1937,23,na,1960,3451
SIM,1914,39,35-39,1953,3
SIM,1896,24,45-49,1920,3
STAT,1898,41,na,1939,3189.8671248171136
STAT,1894,30,30-34,1924,22.885981901175015
SIM,1837,88,na,1925,126
SIM,1848,41,30-34,1889,1
STAT,1837,33,50-100,1870,0.775618908190597
SIM,1928,18,25-29,1946,65
SIM,1942,13,na,1955,4384
STAT,1906,37,45-49,1943,0.6329813918079427
STAT,1878,42,na,1920,2420.246963663561
SIM,1869,29,30-34,1898,3
STAT,1877,34,40-44,1911,4.481990025005225
SIM,1907,30,25-29,1937,18
STAT,1817,56,na,1873,1134.9272269005126
STAT,1890,46,50-100,1936,0.171464667579776
STAT,1910,28,45-49,1938,1.6772053790054502
STAT,1844,33,na,1877,2029.308407822136
SIM,1861,33,na,1894,2114
STAT,1888,24,45-49,1912,0.8260812030225467
SIM,1836,23,35-39,1859,8
STAT,1906,39,35-39,1945,2.2232244491691637
SIM,1915,36,na,1951,4223
STAT,1871,22,50-100,1893,0.4091867683062901
STAT,1770,90,na,1860,14.891317108132268
SIM,1885,34,40-44,1919,6
STAT,1906,20,15-19,1926,4.8821627182938885
STAT,1844,92,na,1936,32.95235812983724
SIM,1891,43,25-29,1934,7
STAT,1790,67,na,1857,634.8604529938402
SIM,1926,43,40-44,1969,2
STAT,1822,86,na,1908,124.05620853916903
STAT,1862,21,45-49,1883,0.6271288082918799
STAT,1864,46,30-34,1910,0.08847275806166835
STAT,1918,35,na,1953,4041.422319113022
STAT,1787,84,na,1871,91.4312128406763
STAT,1810,50,50-100,1860,0.05762107673830169
STAT,1857,43,na,1900,1808.661203862072
STAT,1866,36,na,1902,2213.9916072721026
SIM,1914,37,45-49,1951,1
SIM,1841,93,na,1934,18
STAT,1879,83,na,1962,632.9863776302501
STAT,1862,43,na,1905,2001.3477591423273
STAT,1915,17,40-44,1932,0.29539403482425847
SIM,1829,33,45-49,1862,1
SIM,1923,17,40-44,1940,1
SIM,1887,41,45-49,1928,1
STAT,1873,24,25-29,1897,58.247393663276576
STAT,1925,33,30-34,1958,18.896036867529617
STAT,1880,19,20-24,1899,18.70399286251653
STAT,1884,24,30-34,1908,17.62988358466702
SIM,1890,7,na,1897,3537
SIM,1938,24,25-29,1962,118
SIM,1883,57,na,1940,2157
SIM,1881,21,20-24,1902,2
SIM,1914,20,15-19,1934,5
STAT,1917,38,50-100,1955,0.43800092594545387
SIM,1919,24,15-19,1943,6
SIM,1940,27,45-49,1967,2
STAT,1881,25,na,1906,2339.199545350196
SIM,1828,52,na,1880,1348
SIM,1844,33,40-44,1877,15
STAT,1845,46,20-24,1891,0.008793127505644753
SIM,1908,23,30-34,1931,29
STAT,1866,57,na,1923,1879.472368521881
SIM,1825,33,30-34,1858,5
STAT,1916,43,30-34,1959,0.13200543774762521
SIM,1807,53,na,1860,1133
STAT,1941,16,30-34,1957,12.678671780217602
STAT,1868,40,30-34,1908,1.1209621739781723
SIM,1825,39,45-49,1864,2
STAT,1845,58,na,1903,1445.0028807190167
SIM,1803,79,na,1882,231
SIM,1925,38,na,1963,4534
SIM,1870,21,45-49,1891,2
SIM,1855,34,25-29,1889,17
SIM,1890,14,na,1904,3491
STAT,1806,49,40-44,1855,0.5001782389535665
STAT,1862,47,50-100,1909,0.21321861399330735
STAT,1847,34,25-29,1881,8.025593052249304
STAT,1836,31,45-49,1867,1.4050293126529052
STAT,1914,30,20-24,1944,2.4971411837378885
SIM,1860,27,50-100,1887,1
SIM,1786,71,na,1857,586
STAT,1867,98,na,1965,12.029853852459253
STAT,1817,39,45-49,1856,5.82000669313021
STAT,1833,30,na,1863,2015.110016737276
STAT,1919,46,15-19,1965,4.044180037425153E-4
STAT,1867,27,40-44,1894,2.8494460561350046
STAT,1916,49,na,1965,3780.39080231118
SIM,1823,39,40-44,1862,5
SIM,1869,18,20-24,1887,17
SIM,1890,23,20-24,1913,96
STAT,1868,51,40-44,1919,0.01021086644777168
SIM,1840,20,20-24,1860,92
STAT,1921,26,30-34,1947,44.25624426958979
STAT,1890,20,45-49,1910,0.8657418413138074
STAT,1914,49,40-44,1963,0.15683750779543687
SIM,1803,60,na,1863,933
STAT,1842,42,25-29,1884,0.5981654018015299
STAT,1850,51,25-29,1901,0.002725144897096824
STAT,1935,15,50-100,1950,0.5198743819726053
SIM,1874,83,na,1957,494
STAT,1925,20,25-29,1945,112.40580336651516
STAT,1851,20,30-34,1871,16.340202116842626
STAT,1829,25,na,1854,1576.2124125592068
SIM,1859,35,na,1894,2243
STAT,1846,42,50-100,1888,0.8114311214548617
SIM,1850,42,25-29,1892,4
STAT,1836,33,40-44,1869,3.422354774234284
STAT,1901,45,45-49,1946,0.19036322147153897
STAT,1917,50,na,1967,3838.4191468779595
SIM,1888,72,na,1960,1842
STAT,1856,36,25-29,1892,2.2402262451731225
SIM,1868,31,30-34,1899,25
SIM,1933,20,25-29,1953,226
SIM,1876,40,30-34,1916,2
STAT,1945,24,20-24,1969,122.99043127047747
SIM,1874,21,na,1895,2311
SIM,1934,16,35-39,1950,7
STAT,1892,17,50-100,1909,0.06209128745482806
STAT,1928,29,15-19,1957,0.878217100096271
STAT,1869,68,na,1937,1500.6265547891571
STAT,1768,89,na,1857,62.017532501769004
SIM,1904,36,na,1940,3604
SIM,1864,36,25-29,1900,2
SIM,1901,47,na,1948,3234
STAT,1865,54,na,1919,1931.164412697123
SIM,1948,23,na,1971,4644
STAT,1868,43,na,1911,2214.9022654944433
STAT,1849,44,30-34,1893,0.8867383579860015
SIM,1916,36,40-44,1952,2
STAT,1914,49,50-100,1963,0.22499586382259476
STAT,1915,26,30-34,1941,40.46561546129287
STAT,1892,33,25-29,1925,12.926482624448049
STAT,1928,24,20-24,1952,139.44782193395363
SIM,1894,22,45-49,1916,1
SIM,1922,3,na,1925,5257
STAT,1814,52,20-24,1866,0.0016995225234728644
STAT,1915,8,na,1923,4198.346702459934
STAT,1789,105,na,1894,0.00892423139066633
SIM,1827,31,45-49,1858,1
STAT,1925,39,45-49,1964,0.8251375291802694
STAT,1847,20,40-44,1867,1.9404483296313106
STAT,1877,20,na,1897,2480.091689032786
SIM,1853,81,na,1934,305
SIM,1862,55,na,1917,1886
STAT,1920,25,50-100,1945,1.1100929141384126
STAT,1874,53,30-34,1927,0.006057222510374331
SIM,1922,49,50-100,1971,2
STAT,1925,31,35-39,1956,10.973330720252308
STAT,1841,81,na,1922,404.3915615064306
SIM,1903,11,na,1914,3541
STAT,1864,23,45-49,1887,0.6411133020959056
SIM,1889,48,50-100,1937,2
STAT,1926,16,35-39,1942,5.212312700658775
SIM,1813,78,na,1891,337
STAT,1855,40,45-49,1895,1.1379195764697017
STAT,1881,43,20-24,1924,0.15349797855533506
STAT,1932,29,35-39,1961,19.853000684991837
SIM,1913,32,na,1945,3774
SIM,1840,71,na,1911,846
STAT,1875,3,na,1878,3197.2677135937456
SIM,1917,46,na,1963,3704
SIM,1901,20,35-39,1921,11
STAT,1854,91,na,1945,43.48905784153266
SIM,1872,23,45-49,1895,3
SIM,1866,34,30-34,1900,5
SIM,1885,83,na,1968,635
SIM,1859,44,40-44,1903,5
STAT,1783,104,na,1887,0.035426065161323836
SIM,1840,55,na,1895,1454
SIM,1940,29,35-39,1969,21
STAT,1855,17,na,1872,2055.0781846633467
STAT,1940,20,20-24,1960,114.43452940489351
SIM,1856,23,15-19,1879,1
STAT,1929,30,50-100,1959,1.0626944824481153
SIM,1870,47,50-100,1917,5
STAT,1821,103,na,1924,0.08596433902326762
STAT,1875,23,20-24,1898,71.2563790236256
SIM,1774,86,na,1860,57
SIM,1842,20,30-34,1862,2
SIM,1853,59,na,1912,1482
STAT,1886,22,45-49,1908,0.7436188437343947
STAT,1841,22,20-24,1863,65.28301956247067
SIM,1894,57,na,1951,2816
SIM,1936,24,20-24,1960,119
STAT,1906,10,na,1916,3810.637598686058
SIM,1897,49,na,1946,3000
STAT,1922,46,35-39,1968,0.15000327369931923
STAT,1873,53,50-100,1926,0.01521556104607631
STAT,1848,23,15-19,1871,3.2560837691673568
STAT,1825,33,35-39,1858,21.398015586007475
SIM,1913,19,30-34,1932,2
SIM,1833,33,35-39,1866,11
STAT,1952,17,15-19,1969,54.94860497304573
STAT,1866,43,25-29,1909,0.5962278182770604
STAT,1818,52,35-39,1870,0.014724128944286765
SIM,1783,82,na,1865,182
STAT,1929,41,20-24,1970,0.023149815385050728
SIM,1872,73,na,1945,1145
SIM,1883,21,30-34,1904,33
SIM,1849,37,40-44,1886,9
STAT,1831,66,na,1897,1029.9548060187858
STAT,1905,31,50-100,1936,0.7713080584079064
SIM,1835,22,na,1857,1697
STAT,1918,43,40-44,1961,0.26805827523014303
SIM,1903,36,30-34,1939,2
SIM,1852,40,na,1892,1737
STAT,1818,41,na,1859,1544.6437199416823
STAT,1844,50,40-44,1894,0.008449005623536563
STAT,1899,46,50-100,1945,0.19258111428762578
SIM,1849,33,25-29,1882,18
STAT,1885,43,35-39,1928,1.8073286693857475
SIM,1850,70,na,1920,1073
SIM,1876,87,na,1963,296
STAT,1816,74,na,1890,567.4049750583774
STAT,1853,69,na,1922,1213.6239383032507
SIM,1901,28,45-49,1929,2
STAT,1905,19,30-34,1924,2.314723043524442
SIM,1812,53,na,1865,1191
SIM,1874,43,25-29,1917,3
SIM,1829,44,25-29,1873,3
SIM,1923,26,30-34,1949,79
SIM,1916,21,na,1937,3806
SIM,1818,43,40-44,1861,8
STAT,1951,21,35-39,1972,11.369644319259443
STAT,1866,31,30-34,1897,16.395626610787517
STAT,1888,35,25-29,1923,3.4649217919272113
STAT,1921,23,15-19,1944,6.053687515688921
SIM,1861,40,40-44,1901,5
STAT,1849,46,35-39,1895,0.10977018085525614
STAT,1825,53,50-100,1878,0.019158397374662177
STAT,1864,9,na,1873,2524.162638931225
STAT,1937,18,30-34,1955,11.939498420585933
SIM,1839,16,15-19,1855,5
STAT,1829,50,45-49,1879,0.010884713981032924
SIM,1863,40,na,1903,2115
STAT,1921,28,20-24,1949,20.47474778101575
STAT,1783,101,na,1884,0.1439481882868343
STAT,1821,45,na,1866,1596.5777273161561
SIM,1861,44,35-39,1905,1
SIM,1930,28,na,1958,5047
SIM,1874,43,na,1917,2221
SIM,1883,17,na,1900,2908
STAT,1833,52,30-34,1885,0.004356268381347124
STAT,1835,36,50-100,1871,1.151562065052368
STAT,1907,35,na,1942,3555.4738695074766
SIM,1845,40,na,1885,1942
STAT,1921,39,30-34,1960,2.050980195339024
STAT,1897,34,20-24,1931,3.6287641620364885
STAT,1789,70,na,1859,802.5270579626776
SIM,1843,36,50-100,1879,2
SIM,1859,40,25-29,1899,1
SIM,1896,35,25-29,1931,9
SIM,1816,67,na,1883,799
STAT,1828,62,na,1890,1186.4847598983292
SIM,1837,29,na,1866,1721
SIM,1927,37,25-29,1964,1
SIM,1922,33,25-29,1955,12
SIM,1836,20,30-34,1856,28
STAT,1772,108,na,1880,0.003656430929079909
STAT,1845,23,35-39,1868,5.255355149457797
SIM,1859,91,na,1950,61
SIM,1838,92,na,1930,12
STAT,1858,21,25-29,1879,52.42133906886312
STAT,1908,47,20-24,1955,0.010088841781056042
STAT,1780,89,na,1869,31.878246892178886
SIM,1818,93,na,1911,21
STAT,1879,17,50-100,1896,0.0516374314785357
SIM,1786,74,na,1860,434
STAT,1882,26,25-29,1908,41.52751627452306
SIM,1832,29,35-39,1861,9
STAT,1912,45,20-24,1957,0.010765550491035704
STAT,1902,40,50-100,1942,0.10576344885721252
SIM,1898,31,na,1929,3239
SIM,1866,21,25-29,1887,69
STAT,1855,53,20-24,1908,5.465290005340461E-4
STAT,1927,26,50-100,1953,1.2272584302844778
STAT,1841,44,na,1885,1750.5666250786744
STAT,1872,45,15-19,1917,4.1021733356312996E-4
STAT,1856,33,20-24,1889,2.096843501942263
STAT,1919,37,25-29,1956,1.0680096891184037
SIM,1864,33,20-24,1897,3
SIM,1866,44,40-44,1910,5
STAT,1847,31,20-24,1878,2.4010965189313995
STAT,1860,23,30-34,1883,15.051238682940014
STAT,1801,53,30-34,1854,0.022011761740056326
SIM,1905,8,na,1913,3901
SIM,1824,78,na,1902,362
STAT,1900,15,30-34,1915,2.2466063972996544
STAT,1830,35,20-24,1865,0.7206393590582868
STAT,1906,34,40-44,1940,3.6318943308483544
SIM,1942,26,40-44,1968,9
SIM,1829,30,40-44,1859,2
SIM,1857,47,50-100,1904,4
SIM,1932,7,na,1939,6042
SIM,1814,60,na,1874,1030
STAT,1848,18,40-44,1866,0.18402969731596086
SIM,1896,21,40-44,1917,2
SIM,1935,26,50-100,1961,1
STAT,1832,23,25-29,1855,57.60562179606159
STAT,1870,43,45-49,1913,1.4736275176162532
STAT,1926,27,15-19,1953,0.8552977872116452
SIM,1908,47,50-100,1955,6
SIM,1888,22,15-19,1910,4
STAT,1876,31,50-100,1907,0.9594049867008461
STAT,1881,47,15-19,1928,3.87610331725032E-4
STAT,1883,41,50-100,1924,1.0488913686608576
STAT,1891,24,na,1915,2938.927602789733
STAT,1870,32,35-39,1902,10.043904997855588
STAT,1903,43,20-24,1946,0.01574866428771125
STAT,1843,51,50-100,1894,0.010235055749597134
STAT,1890,61,na,1951,2306.196825855926
STAT,1893,24,50-100,1917,0.5196934682350369
STAT,1934,26,40-44,1960,6.338486982076676
SIM,1868,32,45-49,1900,1
SIM,1849,23,15-19,1872,6
STAT,1860,16,50-100,1876,0.046927057721565364
STAT,1819,103,na,1922,0.0729577149145931
SIM,1848,44,35-39,1892,1
STAT,1851,48,40-44,1899,0.12800173778138654
STAT,1860,36,45-49,1896,1.6537972550075535
STAT,1888,21,40-44,1909,2.4916326728544336
SIM,1877,32,na,1909,2490
SIM,1840,23,25-29,1863,65
STAT,1858,44,40-44,1902,1.7582383472913257
SIM,1886,46,na,1932,2530
SIM,1882,32,na,1914,2093
STAT,1860,25,35-39,1885,8.168649847644344
STAT,1919,42,50-100,1961,0.12854279530269244
STAT,1839,29,25-29,1868,37.24077797750444
STAT,1917,24,45-49,1941,1.1995212208589805
STAT,1912,20,45-49,1932,1.0944030613931603
SIM,1873,98,na,1971,21
STAT,1934,37,20-24,1971,0.36756678035663387
SIM,1857,33,20-24,1890,2
STAT,1803,52,45-49,1855,0.06293864461537238
SIM,1870,3,na,1873,3362
SIM,1875,27,40-44,1902,5
SIM,1936,23,50-100,1959,1
SIM,1949,3,na,1952,4467
STAT,1812,43,35-39,1855,4.550538130331642
STAT,1892,24,35-39,1916,7.349467211211971
SIM,1908,26,35-39,1934,3
SIM,1919,28,30-34,1947,42
STAT,1947,21,15-19,1968,6.078974398384498
STAT,1877,18,50-100,1895,0.05093647266737158
STAT,1884,20,15-19,1904,3.30541646833998
SIM,1802,75,na,1877,395
STAT,1919,20,na,1939,4061.5628715047774
SIM,1933,24,40-44,1957,3
STAT,1916,46,35-39,1962,0.13378483683751438
SIM,1938,28,40-44,1966,6
STAT,1831,44,15-19,1875,0.010402895498668761
STAT,1777,113,na,1890,3.699237025254795E-4
SIM,1881,24,25-29,1905,59
STAT,1889,24,15-19,1913,4.082864910539792
STAT,1941,16,na,1957,3828.6888285767163
STAT,1819,66,na,1885,866.019293399717
STAT,1888,20,na,1908,2836.224229820902
SIM,1825,63,na,1888,871
STAT,1830,41,na,1871,1713.7235325012384
SIM,1891,41,50-100,1932,2
STAT,1920,17,na,1937,4170.206471120136
SIM,1828,74,na,1902,629
STAT,1871,36,20-24,1907,0.7772112766360944
STAT,1913,18,15-19,1931,9.337651826167317
STAT,1925,24,40-44,1949,4.0419743829851384
STAT,1908,36,40-44,1944,1.4216488521718786
STAT,1912,39,35-39,1951,2.3577661961630474
STAT,1812,54,45-49,1866,0.030779588560114684
STAT,1856,58,na,1914,1531.3452102122444
SIM,1865,47,na,1912,2016
SIM,1921,18,15-19,1939,51
SIM,1920,39,35-39,1959,3
STAT,1808,63,na,1871,899.6042818242879
STAT,1923,35,25-29,1958,1.1547010368089905
SIM,1897,24,15-19,1921,7
SIM,1925,24,45-49,1949,1
SIM,1892,20,15-19,1912,5
STAT,1892,49,40-44,1941,0.11983669352825106
SIM,1920,20,45-49,1940,2
STAT,1777,85,na,1862,62.69996911652963
STAT,1903,32,40-44,1935,6.237990523785514
STAT,1952,19,na,1971,4453.555327116286
STAT,1867,23,25-29,1890,54.285020179163176
STAT,1873,21,20-24,1894,70.77318926100126
STAT,1849,33,20-24,1882,2.203985403433239
STAT,1945,27,25-29,1972,72.92601822043547
STAT,1854,31,50-100,1885,0.7115246597264296
SIM,1901,39,25-29,1940,1
STAT,1851,23,35-39,1874,5.238729523548501
STAT,1932,24,40-44,1956,4.443046070984445
SIM,1865,0,na,1865,3306
SIM,1931,35,25-29,1966,1
STAT,1901,30,40-44,1931,6.189527895461679
SIM,1862,95,na,1957,4
STAT,1840,46,15-19,1886,2.864016984914335E-4
SIM,1855,20,40-44,1875,2
STAT,1923,1,na,1924,4954.666438409117
SIM,1858,44,50-100,1902,6
STAT,1804,89,na,1893,32.568655639264826
STAT,1879,86,na,1965,460.8145699326169
SIM,1830,93,na,1923,9
SIM,1890,26,25-29,1916,84
SIM,1906,24,35-39,1930,12
STAT,1828,39,20-24,1867,0.7590747315272849
SIM,1841,96,na,1937,5
SIM,1836,39,20-24,1875,1
SIM,1823,35,25-29,1858,3
SIM,1875,23,25-29,1898,66
STAT,1798,84,na,1882,131.60783059494327
STAT,1859,53,35-39,1912,0.006881157790890349
STAT,1849,20,50-100,1869,0.3910732508519977
SIM,1940,24,40-44,1964,6
STAT,1914,33,25-29,1947,9.347262593030333
SIM,1849,14,na,1863,2408
STAT,1895,7,na,1902,3436.369380773644
SIM,1873,38,50-100,1911,2
STAT,1868,83,na,1951,383.2079229607135
STAT,1831,45,50-100,1876,0.18822027586151724
STAT,1890,45,20-24,1935,0.014957579158407303
STAT,1825,51,20-24,1876,9.740293017267622E-4
STAT,1867,37,45-49,1904,1.896248259251633
SIM,1928,29,50-100,1957,1
STAT,1870,25,na,1895,2382.9836900960695
SIM,1869,50,na,1919,2131
STAT,1861,52,45-49,1913,0.012115140269271478
SIM,1886,68,na,1954,1759
SIM,1950,1,na,1951,4654
STAT,1838,44,25-29,1882,0.44591137396990244
STAT,1929,22,na,1951,4667.609735921193
SIM,1878,41,40-44,1919,10
STAT,1842,51,50-100,1893,0.01366258904711337
SIM,1825,43,40-44,1868,5
STAT,1874,4,na,1878,3018.720951573246
STAT,1932,25,25-29,1957,87.19869867092243
SIM,1836,31,50-100,1867,1
STAT,1792,93,na,1885,6.792116071418313
STAT,1905,45,20-24,1950,0.009981926507771141
STAT,1914,9,na,1923,4141.17313058435
SIM,1890,26,30-34,1916,46
STAT,1934,22,25-29,1956,125.42812183350756
SIM,1827,40,40-44,1867,5
SIM,1892,34,40-44,1926,9
STAT,1874,15,na,1889,2633.8841592986405
STAT,1920,35,45-49,1955,0.7550495136057392
STAT,1936,30,35-39,1966,8.971295497630704
STAT,1884,34,40-44,1918,4.282367428246319
STAT,1903,48,20-24,1951,0.009614277849128236
SIM,1872,31,20-24,1903,5
SIM,1919,17,15-19,1936,53
STAT,1803,70,na,1873,833.3444892271411
STAT,1898,45,35-39,1943,0.10920668483271422
STAT,1849,47,35-39,1896,0.10894909990245881
STAT,1925,32,na,1957,4538.844465049711
STAT,1921,22,15-19,1943,6.072451390485523
STAT,1930,27,50-100,1957,1.2792041201718545
SIM,1823,35,30-34,1858,7
STAT,1885,52,na,1937,2153.1961170811765
STAT,1840,41,45-49,1881,1.1085029169893204
STAT,1820,39,50-100,1859,2.604015724355793
SIM,1827,33,35-39,1860,10
SIM,1848,29,na,1877,1890
SIM,1865,60,na,1925,1666
STAT,1880,19,15-19,1899,6.261082364615725
STAT,1852,52,35-39,1904,0.006494283721482887
SIM,1922,46,na,1968,4770
SIM,1873,29,35-39,1902,12
STAT,1886,24,35-39,1910,6.183958565758357
STAT,1796,83,na,1879,131.10857523535347
SIM,1854,23,na,1877,2312
STAT,1912,48,30-34,1960,0.08619500046864792
STAT,1915,24,na,1939,3785.1539981871824
SIM,1844,30,30-34,1874,21
SIM,1924,40,35-39,1964,2
STAT,1854,88,na,1942,103.0294898280438
STAT,1860,17,na,1877,2185.7478235102944
STAT,1896,18,na,1914,3367.689857239339
STAT,1923,30,25-29,1953,10.791906639047447
SIM,1823,43,na,1866,1542
SIM,1830,25,20-24,1855,21
STAT,1847,39,25-29,1886,2.1907269923941732
STAT,1844,41,45-49,1885,1.228371630681686
STAT,1892,42,20-24,1934,0.20102852724272882
SIM,1907,34,40-44,1941,3
SIM,1815,48,na,1863,1436
STAT,1784,98,na,1882,0.5022110682993972
STAT,1823,54,20-24,1877,9.394685448420392E-4
STAT,1882,26,30-34,1908,24.72119682776596
STAT,1855,41,20-24,1896,0.12008277800439453
SIM,1894,24,35-39,1918,11
STAT,1873,48,25-29,1921,0.058236140241631755
SIM,1842,22,20-24,1864,94
STAT,1914,30,15-19,1944,0.13155913392400925
SIM,1825,36,35-39,1861,5
SIM,1931,30,25-29,1961,20
SIM,1940,25,25-29,1965,79
STAT,1856,39,35-39,1895,5.421767810931729
SIM,1865,36,50-100,1901,3
SIM,1853,30,40-44,1883,8
STAT,1814,51,45-49,1865,0.03410117398689343
SIM,1857,65,na,1922,1469
STAT,1866,1,na,1867,3348.726151595288
SIM,1840,25,20-24,1865,10
STAT,1824,56,na,1880,1103.1497142088201
STAT,1908,15,50-100,1923,0.07370271326782755
SIM,1873,15,30-34,1888,6
SIM,1891,15,na,1906,3311
STAT,1829,51,20-24,1880,5.425997866941607E-4
STAT,1919,21,50-100,1940,0.729684534853281
STAT,1867,18,45-49,1885,0.06314769277344165
SIM,1910,22,35-39,1932,1
STAT,1863,29,25-29,1892,37.584551130166055
STAT,1834,22,20-24,1856,54.91026571249491
SIM,1840,15,na,1855,2185
STAT,1882,19,25-29,1901,5.5142984906556585
STAT,1914,49,35-39,1963,0.12825497162381488
STAT,1858,78,na,1936,619.1175523340137
STAT,1907,40,25-29,1947,0.06680852589275625
STAT,1847,46,30-34,1893,0.07268352216899147
STAT,1853,36,45-49,1889,1.6657741675858806
STAT,1848,18,35-39,1866,0.5520890599825827
SIM,1887,34,45-49,1921,3
STAT,1896,42,20-24,1938,0.014725819509785597
STAT,1940,20,15-19,1960,5.47828471758477
STAT,1958,4,na,1962,5217.209158344584
STAT,1884,15,40-44,1899,0.18301692290214822
STAT,1879,34,45-49,1913,1.8222521599159565
STAT,1866,73,na,1939,1110.8249735832296
STAT,1924,19,40-44,1943,1.6741135740114585
SIM,1837,40,40-44,1877,4
SIM,1947,15,25-29,1962,66
STAT,1899,60,na,1959,2734.6719850445356
STAT,1903,39,na,1942,3381.2328786508274
STAT,1884,27,35-39,1911,9.610284509634308
STAT,1880,50,45-49,1930,0.015614680546895115
STAT,1892,48,35-39,1940,0.0988294402222152
SIM,1861,70,na,1931,1213
SIM,1919,24,20-24,1943,137
SIM,1875,37,45-49,1912,3
STAT,1833,92,na,1925,29.466783658537672
STAT,1860,48,15-19,1908,3.261007379605023E-4
SIM,1808,54,na,1862,1138
SIM,1858,13,na,1871,2253
SIM,1870,47,na,1917,2482
STAT,1829,100,na,1929,0.6259861650293223
STAT,1846,59,na,1905,1474.8655633437309
SIM,1910,19,20-24,1929,29
STAT,1832,25,20-24,1857,11.029364013506324
STAT,1902,22,35-39,1924,8.328747607969243
STAT,1929,40,45-49,1969,0.2184523853001682
SIM,1853,23,35-39,1876,4
SIM,1894,31,40-44,1925,12
STAT,1817,43,40-44,1860,5.2685640980855855
STAT,1833,40,30-34,1873,1.0148959521127798
STAT,1886,2,na,1888,3152.0626667381844
SIM,1886,37,20-24,1923,1
SIM,1912,27,30-34,1939,47
STAT,1849,48,na,1897,1736.9420644860709
STAT,1879,46,na,1925,2378.064429214212
STAT,1865,15,30-34,1880,1.6843575073467048
SIM,1890,19,25-29,1909,13
STAT,1904,27,30-34,1931,36.4991190134437
SIM,1884,44,50-100,1928,1
STAT,1902,19,20-24,1921,25.1675287132419
STAT,1918,45,50-100,1963,0.24413794345552642
STAT,1816,43,35-39,1859,5.01050203675272
STAT,1818,51,45-49,1869,0.02532050071739544
STAT,1913,25,15-19,1938,0.7145389403179889
STAT,1911,34,na,1945,3683.7192943573336
STAT,1844,51,30-34,1895,0.004732096574037872
STAT,1844,101,na,1945,0.45146836968230386
SIM,1853,75,na,1928,626
SIM,1811,58,na,1869,1245
SIM,1870,20,30-34,1890,27
STAT,1874,53,25-29,1927,0.0036042976573858673
STAT,1819,40,40-44,1859,5.15555245370562
SIM,1898,34,20-24,1932,4
SIM,1899,24,25-29,1923,105
SIM,1795,70,na,1865,617
STAT,1878,37,20-24,1915,0.8082001945502374
STAT,1882,10,na,1892,2534.2391426056565
SIM,1820,88,na,1908,58
STAT,1886,31,40-44,1917,4.643543338306529
STAT,1884,28,50-100,1912,0.6348877231935405
STAT,1889,16,30-34,1905,1.9898709351205708
SIM,1851,26,35-39,1877,12
STAT,1933,30,25-29,1963,12.600843897797416
SIM,1832,73,na,1905,777
SIM,1859,41,30-34,1900,1
SIM,1859,4,na,1863,2772
SIM,1845,33,50-100,1878,3
STAT,1842,54,30-34,1896,0.005211910234867463
SIM,1838,76,na,1914,650
SIM,1858,90,na,1948,30
SIM,1835,31,50-100,1866,2
STAT,1831,54,25-29,1885,0.0022372027537490968
STAT,1871,23,45-49,1894,0.697547245260155
STAT,1832,45,50-100,1877,0.2034608329751794
SIM,1867,35,50-100,1902,1
STAT,1837,36,20-24,1873,0.646956458345524
STAT,1856,95,na,1951,10.29535037130314
SIM,1910,21,na,1931,3245
SIM,1847,25,30-34,1872,5
SIM,1877,20,25-29,1897,91
SIM,1944,5,na,1949,4342
SIM,1873,95,na,1968,66
STAT,1859,17,40-44,1876,0.17246869406709103
STAT,1862,20,30-34,1882,16.135139435118035
SIM,1863,18,na,1881,2458
SIM,1868,41,40-44,1909,13
STAT,1942,30,35-39,1972,9.839654259772391
SIM,1778,82,na,1860,84
STAT,1841,28,na,1869,1994.8658676245923
STAT,1840,30,20-24,1870,2.356296048578105
STAT,1866,34,35-39,1900,9.39007368428129
SIM,1923,30,50-100,1953,4
STAT,1821,39,50-100,1860,2.142739236933286
SIM,1847,38,50-100,1885,1
STAT,1860,26,35-39,1886,8.109998941738255
STAT,1915,22,15-19,1937,5.552334748017195
SIM,1874,34,35-39,1908,15
SIM,1864,36,30-34,1900,5
STAT,1908,32,25-29,1940,8.806835204819874
SIM,1856,30,na,1886,2184
SIM,1923,22,15-19,1945,6
STAT,1829,43,45-49,1872,1.1451871827711575
STAT,1923,27,40-44,1950,5.406986259997181
STAT,1939,19,50-100,1958,0.3783425533722483
STAT,1820,51,45-49,1871,0.02416499378248464
STAT,1841,28,35-39,1869,8.897786174634359
SIM,1896,30,na,1926,3168
STAT,1843,26,35-39,1869,8.067043913384891
STAT,1849,52,20-24,1901,5.738730360319398E-4
STAT,1867,21,na,1888,2275.2904287146825
SIM,1783,85,na,1868,143
STAT,1849,43,30-34,1892,0.892378188135015
STAT,1866,52,20-24,1918,6.864523491087163E-4
STAT,1888,37,20-24,1925,0.9189379635035385
STAT,1894,35,na,1929,3092.6554422199215
STAT,1899,26,40-44,1925,4.166556089087596
SIM,1885,44,50-100,1929,1
STAT,1899,45,40-44,1944,0.1351966987506708
STAT,1855,33,45-49,1888,1.3227029773281533
SIM,1956,15,35-39,1971,5
STAT,1948,11,na,1959,4541.880617175377
SIM,1914,32,20-24,1946,3
STAT,1887,27,50-100,1914,0.7213465297731431
STAT,1908,20,na,1928,3562.6230954109897
STAT,1840,49,40-44,1889,0.11795803914335587
STAT,1839,25,30-34,1864,22.81761306540102
STAT,1862,36,50-100,1898,1.0760162832893807
STAT,1771,91,na,1862,13.920214253438902
STAT,1879,42,20-24,1921,0.16718282429365514
SIM,1916,32,25-29,1948,16
SIM,1789,76,na,1865,337
STAT,1881,42,45-49,1923,1.4552832784963061
SIM,1931,27,40-44,1958,6
SIM,1916,24,na,1940,3810
STAT,1870,48,15-19,1918,3.9173022574835763E-4
SIM,1860,69,na,1929,1206
SIM,1878,33,na,1911,2751
STAT,1854,29,15-19,1883,0.3518451149475946
STAT,1828,40,na,1868,1762.8609246415851
STAT,1873,67,na,1940,1623.1197078369737
STAT,1830,39,15-19,1869,0.04962251934938729
STAT,1878,18,20-24,1896,18.538863939301113
STAT,1948,15,35-39,1963,4.853594530586465
STAT,1828,46,na,1874,1639.3880146489194
SIM,1835,62,na,1897,1032
STAT,1848,51,30-34,1899,0.0048832626177539576
SIM,1890,67,na,1957,2351
STAT,1891,19,35-39,1910,0.6824691410967891
SIM,1871,26,20-24,1897,11
STAT,1845,33,45-49,1878,1.4993632673853463
STAT,1896,34,45-49,1930,2.3113927482975636
STAT,1927,3,na,1930,5097.4210719077755
STAT,1939,25,35-39,1964,15.250299989966312
SIM,1832,28,35-39,1860,14
SIM,1868,34,35-39,1902,14
STAT,1924,40,25-29,1964,0.08606979972564653
STAT,1809,67,na,1876,890.2731532724849
STAT,1906,32,20-24,1938,2.283294447895526
STAT,1860,22,30-34,1882,15.160088115610096
STAT,1864,34,25-29,1898,9.255055866111679
STAT,1840,110,na,1950,1.9370958789850752E-4
STAT,1816,77,na,1893,441.9403982723883
STAT,1847,16,50-100,1863,0.04605404930294029
STAT,1869,29,50-100,1898,0.6236618563411058
STAT,1928,36,15-19,1964,0.02455255165728053
STAT,1851,44,25-29,1895,0.4796702285080335
STAT,1878,15,40-44,1893,0.19265655519965608
SIM,1851,33,40-44,1884,10
STAT,1923,49,45-49,1972,0.25538425014862937
STAT,1833,52,25-29,1885,0.002592159673008816
STAT,1838,46,20-24,1884,0.008370998628290018
STAT,1893,35,50-100,1928,1.5894615395584937
STAT,1860,110,na,1970,0.003167732981569182
SIM,1798,59,na,1857,1032
STAT,1881,20,40-44,1901,2.0408288284639227
STAT,1898,33,50-100,1931,1.2492373222195783
SIM,1942,22,25-29,1964,123
SIM,1897,16,30-34,1913,5
STAT,1765,97,na,1862,0.7562432260533074
SIM,1941,30,25-29,1971,18
STAT,1920,46,25-29,1966,0.059360832503626004
SIM,1830,47,na,1877,1402
STAT,1853,47,na,1900,1851.8914667793383
STAT,1899,38,35-39,1937,2.1056421395779004
SIM,1872,54,na,1926,2336
STAT,1843,45,na,1888,1549.5717123811783
STAT,1843,33,40-44,1876,3.480058090504485
SIM,1810,70,na,1880,873
SIM,1853,33,45-49,1886,1
STAT,1914,37,40-44,1951,1.5080239687073396
SIM,1866,25,40-44,1891,3
STAT,1892,28,na,1920,3013.9831885492986
SIM,1867,73,na,1940,972
STAT,1823,49,40-44,1872,0.22902232092580424
STAT,1869,28,20-24,1897,11.479248503880324
STAT,1902,38,20-24,1940,0.2362910527099799
SIM,1906,29,40-44,1935,5
STAT,1869,20,25-29,1889,56.790279946998275
SIM,1883,23,20-24,1906,87
SIM,1925,33,35-39,1958,3
STAT,1940,30,25-29,1970,9.668059274960108
SIM,1931,29,na,1960,4792
STAT,1944,27,na,1971,4088.553422252269
STAT,1957,8,na,1965,5234.261853917102
SIM,1952,8,na,1960,4781
STAT,1890,21,20-24,1911,85.30587125163188
STAT,1895,34,50-100,1929,1.198147680429723
SIM,1846,33,45-49,1879,3
STAT,1854,36,20-24,1890,0.5812961405027556
STAT,1890,32,45-49,1922,2.152157041864134
STAT,1875,26,50-100,1901,0.6657770890205732
SIM,1911,52,na,1963,3720
STAT,1810,46,35-39,1856,0.5512256345916403
STAT,1838,33,45-49,1871,1.4355814335046475
STAT,1858,25,40-44,1883,2.4651620051667074
STAT,1839,89,na,1928,74.48009693467614
SIM,1840,35,30-34,1875,3
STAT,1916,34,40-44,1950,4.042359886764268
SIM,1922,37,40-44,1959,1
SIM,1847,87,na,1934,102
STAT,1790,64,na,1854,710.0
STAT,1845,71,na,1916,975.3201806532663
SIM,1858,20,15-19,1878,4
SIM,1914,30,25-29,1944,11
STAT,1917,33,35-39,1950,9.618403311961059
STAT,1863,19,15-19,1882,5.449907256215573
STAT,1895,21,50-100,1916,0.5394844620703878
STAT,1834,32,30-34,1866,13.319195017190658
STAT,1867,34,40-44,1901,4.0898616684174725
STAT,1819,43,45-49,1862,3.1078924896028273
STAT,1826,39,na,1865,1524.4775110663659
STAT,1827,40,30-34,1867,1.2799772723340321
STAT,1873,45,20-24,1918,0.012409410573180419
SIM,1875,34,40-44,1909,4
STAT,1919,30,35-39,1949,10.034675834451276
STAT,1924,42,50-100,1966,0.14120674466999028
SIM,1909,14,na,1923,4218
STAT,1796,67,na,1863,713.7091643481017
STAT,1921,27,30-34,1948,44.104887914187806
SIM,1831,41,45-49,1872,1
STAT,1856,48,25-29,1904,0.04404191409516482
SIM,1843,97,na,1940,17
STAT,1806,54,20-24,1860,0.0020455947235132723
STAT,1932,22,20-24,1954,147.44056457549104
SIM,1842,32,30-34,1874,23
STAT,1858,28,45-49,1886,0.8941697841728393
STAT,1837,23,na,1860,1895.6741914305653
SIM,1871,19,15-19,1890,5
STAT,1849,61,na,1910,1460.9981291654112
SIM,1940,22,20-24,1962,126
STAT,1887,81,na,1968,993.4567262960618
SIM,1865,44,na,1909,2058
STAT,1825,32,20-24,1857,6.410236573446866
STAT,1864,30,50-100,1894,0.8417667324915307
SIM,1924,34,40-44,1958,7
SIM,1946,22,na,1968,4138
STAT,1922,45,20-24,1967,0.01288590177287814
STAT,1931,30,15-19,1961,0.1703687917481489
SIM,1848,17,30-34,1865,4
SIM,1861,30,30-34,1891,24
STAT,1863,26,20-24,1889,10.57427904186448
STAT,1814,40,20-24,1854,0.5929340842520069
STAT,1832,35,30-34,1867,4.697705641830442
SIM,1869,37,20-24,1906,1
SIM,1892,37,45-49,1929,5
STAT,1837,76,na,1913,646.2994254710626
SIM,1844,33,35-39,1877,20
STAT,1906,30,25-29,1936,8.721552472608282
STAT,1856,18,na,1874,2089.3596090924
STAT,1892,45,25-29,1937,0.04158920000077315
SIM,1901,21,25-29,1922,133
STAT,1869,47,20-24,1916,0.011728567030518115
SIM,1865,44,35-39,1909,1
STAT,1892,23,20-24,1915,87.06838534509339
STAT,1840,40,na,1880,1733.281349605446
SIM,1864,29,25-29,1893,59
SIM,1927,1,na,1928,5603
SIM,1863,43,na,1906,2091
STAT,1834,34,na,1868,1618.4015807352803
STAT,1857,44,35-39,1901,1.4080969647240205
STAT,1825,54,25-29,1879,0.004404770957900852
STAT,1898,59,na,1957,2706.2804564747476
STAT,1920,48,20-24,1968,0.012301876361760949
STAT,1842,28,50-100,1870,0.7071187366890722
SIM,1892,24,30-34,1916,36
SIM,1949,11,na,1960,4419
STAT,1911,18,na,1929,3889.0311418373967
STAT,1817,46,45-49,1863,0.5156189853247786
STAT,1881,31,20-24,1912,2.642359022743861
STAT,1862,45,45-49,1907,0.2078961677909307
SIM,1849,25,40-44,1874,1
STAT,1816,105,na,1921,0.014990868534774502
SIM,1811,74,na,1885,559
SIM,1884,27,45-49,1911,1
SIM,1881,37,na,1918,2069
SIM,1872,34,25-29,1906,21
STAT,1920,32,40-44,1952,4.328594200778117
STAT,1874,41,30-34,1915,1.19435475079257
STAT,1884,37,45-49,1921,1.985502796829333
STAT,1846,51,20-24,1897,5.626752343921484E-4
STAT,1851,22,20-24,1873,62.31273823307466
STAT,1853,30,30-34,1883,15.180968190901105
STAT,1863,50,45-49,1913,0.013173639630394642
STAT,1873,36,30-34,1909,5.483270559252818
STAT,1775,81,na,1856,141.334080192
STAT,1945,20,35-39,1965,10.429056802706215
STAT,1837,29,15-19,1866,0.39158779263258364
STAT,1949,5,na,1954,4633.641282153782
STAT,1865,18,35-39,1883,0.518404121714681
STAT,1912,32,15-19,1944,0.12757255576261212
STAT,1851,53,50-100,1904,0.011252006466114477
STAT,1861,42,35-39,1903,1.5179089037074909
SIM,1886,62,na,1948,2099
SIM,1931,24,30-34,1955,42
STAT,1858,47,45-49,1905,0.18613141489951843
STAT,1912,2,na,1914,4158.774717081184
STAT,1943,23,35-39,1966,10.111921233989445
SIM,1878,67,na,1945,1733
SIM,1938,21,20-24,1959,6
STAT,1838,24,na,1862,1830.4194395248849
STAT,1875,33,30-34,1908,18.033102001026197
STAT,1936,26,na,1962,3621.070342082604
SIM,1894,34,45-49,1928,1
STAT,1882,29,50-100,1911,0.6213684854717972
STAT,1895,37,20-24,1932,1.0167214496330945
SIM,1931,20,15-19,1951,11
STAT,1856,29,25-29,1885,33.456993858472515
STAT,1811,83,na,1894,173.06355781974835
SIM,1830,28,25-29,1858,48
STAT,1913,17,30-34,1930,2.514443701340973
STAT,1914,40,25-29,1954,0.07189049063343772
SIM,1820,40,30-34,1860,1
SIM,1890,29,50-100,1919,5
STAT,1836,33,35-39,1869,7.991855754012601
STAT,1828,46,20-24,1874,0.011078954610215457
STAT,1864,42,45-49,1906,1.362339333623451
STAT,1960,11,na,1971,5167.88413770543
SIM,1921,17,30-34,1938,24
STAT,1883,45,na,1928,2245.847244571807
STAT,1803,88,na,1891,57.228546923229615
STAT,1886,34,45-49,1920,1.8436786277714257
SIM,1881,36,30-34,1917,7
SIM,1891,34,35-39,1925,1
STAT,1844,54,35-39,1898,0.006624043923555097
STAT,1879,31,40-44,1910,4.589578004774417
SIM,1866,48,na,1914,2257
STAT,1845,109,na,1954,5.198537204967339E-4
STAT,1901,32,30-34,1933,24.720470766870655
STAT,1850,58,na,1908,1514.2737130598512
STAT,1875,48,35-39,1923,0.14338587398038463
SIM,1872,42,45-49,1914,1
STAT,1842,52,35-39,1894,0.007709772320567799
STAT,1923,20,15-19,1943,6.295439300083048
STAT,1940,27,40-44,1967,4.798404026120757
STAT,1833,86,na,1919,156.97645909411733
STAT,1928,17,15-19,1945,57.799673753207706
STAT,1859,46,50-100,1905,0.20007606193193392
SIM,1899,35,na,1934,3577
SIM,1846,71,na,1917,905
STAT,1838,41,20-24,1879,0.12593434591390246
STAT,1862,26,45-49,1888,0.9790284328932587
STAT,1891,40,na,1931,2919.3176210629617
SIM,1867,46,50-100,1913,4
STAT,1806,53,na,1859,1124.9179150414113
STAT,1941,19,40-44,1960,1.4535478592750313
STAT,1887,41,40-44,1928,2.5478633356275253
SIM,1870,26,45-49,1896,1
STAT,1776,111,na,1887,0.0010744502905106071
SIM,1921,25,15-19,1946,4
SIM,1931,39,35-39,1970,9
STAT,1892,45,30-34,1937,0.06989296178602872
SIM,1887,31,40-44,1918,2
STAT,1885,42,45-49,1927,1.5027763874252698
SIM,1791,64,na,1855,710
SIM,1827,43,45-49,1870,3
SIM,1892,28,50-100,1920,3
STAT,1858,22,50-100,1880,0.37074340569095393
SIM,1931,23,na,1954,4613
STAT,1923,24,30-34,1947,33.57757276212192
SIM,1824,43,35-39,1867,4
SIM,1841,40,30-34,1881,4
SIM,1844,45,na,1889,1507
SIM,1819,78,na,1897,343
SIM,1918,25,na,1943,4182
STAT,1850,52,25-29,1902,0.002697729939432031
STAT,1862,23,35-39,1885,5.172985665715721
STAT,1839,28,35-39,1867,8.556031172821253
SIM,1868,44,45-49,1912,1
SIM,1858,23,25-29,1881,48
STAT,1837,39,25-29,1876,2.342331870356924
STAT,1883,34,35-39,1917,9.923606097275565
STAT,1803,53,35-39,1856,0.036569904071633505
STAT,1858,44,na,1902,1806.6749774701
SIM,1905,34,30-34,1939,20
STAT,1939,15,25-29,1954,43.89893045462013
STAT,1826,48,50-100,1874,0.23874362759426826
STAT,1854,17,20-24,1871,15.915983725862358
STAT,1844,22,50-100,1866,0.40283373110810194
STAT,1825,54,30-34,1879,0.007402462375593908
SIM,1843,26,45-49,1869,1
STAT,1775,99,na,1874,0.2541821177169429
STAT,1846,40,40-44,1886,1.7724450293012097
STAT,1862,48,25-29,1910,0.04960862307110706
STAT,1854,94,na,1948,14.999282778209128
STAT,1857,53,25-29,1910,0.0027471434768029782
SIM,1888,37,30-34,1925,11
SIM,1871,94,na,1965,42
SIM,1883,33,30-34,1916,39
STAT,1880,26,20-24,1906,12.486376942720085
STAT,1938,33,na,1971,3836.7450735092625
STAT,1899,48,45-49,1947,0.18221097939694425
STAT,1901,42,40-44,1943,0.2208766318744118
SIM,1876,84,na,1960,398
SIM,1933,30,35-39,1963,8
STAT,1836,41,na,1877,1597.3244814434627
SIM,1853,41,na,1894,1754
SIM,1861,17,na,1878,2387
STAT,1886,34,na,1920,2522.9583062457878
SIM,1914,51,na,1965,3766
SIM,1870,23,35-39,1893,8
STAT,1768,86,na,1854,117.0
STAT,1879,45,25-29,1924,0.061315645803065505
STAT,1868,41,30-34,1909,1.1147856723995524
SIM,1847,28,35-39,1875,15
STAT,1867,17,30-34,1884,1.5499331230278535
STAT,1908,14,na,1922,3854.604883209948
STAT,1841,37,25-29,1878,2.536781598013792
STAT,1914,46,30-34,1960,0.08942377220767564
SIM,1908,24,45-49,1932,1
STAT,1871,20,40-44,1891,2.1034199980172494
STAT,1847,35,na,1882,1868.6428625820072
SIM,1939,22,50-100,1961,4
STAT,1899,29,45-49,1928,1.5280488665887633
STAT,1831,51,20-24,1882,4.946170331419932E-4
SIM,1846,30,40-44,1876,6
STAT,1870,44,35-39,1914,1.77170194650379
STAT,1824,101,na,1925,0.28368598538091083
STAT,1841,18,25-29,1859,5.4332794078674
STAT,1845,30,40-44,1875,3.8467546020767873
SIM,1816,42,30-34,1858,1
STAT,1818,39,20-24,1857,1.6867472145887898
SIM,1831,72,na,1903,808
STAT,1877,37,45-49,1914,2.078057027828015
SIM,1874,31,30-34,1905,19
STAT,1942,24,40-44,1966,3.5570437006472537
STAT,1807,50,30-34,1857,0.021040841949752087
STAT,1882,18,50-100,1900,0.04780550587066441
STAT,1863,90,na,1953,70.55361669971705
STAT,1938,30,45-49,1968,1.5991269592753534
SIM,1854,40,40-44,1894,4
STAT,1922,19,30-34,1941,14.17415951512045
STAT,1853,13,na,1866,2364.039522123291
SIM,1885,37,45-49,1922,2
SIM,1848,35,na,1883,1854
SIM,1880,35,50-100,1915,1
STAT,1927,43,15-19,1970,0.0019435933122808047
STAT,1869,62,na,1931,1794.7561090396457
SIM,1930,19,30-34,1949,22
SIM,1826,39,20-24,1865,1
STAT,1801,54,45-49,1855,0.05259376478214992
STAT,1850,15,30-34,1865,1.5090925761010057
STAT,1814,41,50-100,1855,3.8342317146702225
SIM,1936,28,30-34,1964,2
SIM,1841,56,na,1897,1420
STAT,1836,36,45-49,1872,1.5597199759099867
STAT,1851,41,20-24,1892,0.12079539777757832
STAT,1872,52,20-24,1924,7.453098552217864E-4
SIM,1857,43,30-34,1900,1
SIM,1893,56,na,1949,2593
STAT,1828,27,20-24,1855,22.725236744997115
STAT,1876,27,45-49,1903,1.1578717748029574
STAT,1906,35,25-29,1941,0.9228988224033887
SIM,1912,22,45-49,1934,2
SIM,1831,33,25-29,1864,22
SIM,1851,36,45-49,1887,3
SIM,1851,58,na,1909,1581
STAT,1895,30,na,1925,3172.756582503288
SIM,1827,27,na,1854,1666
STAT,1881,46,25-29,1927,0.05623658390994938
SIM,1829,56,na,1885,1416
SIM,1782,81,na,1863,46
STAT,1842,33,35-39,1875,10.900687604326059
SIM,1832,25,30-34,1857,30
SIM,1866,28,45-49,1894,1
SIM,1890,11,na,1901,3511
SIM,1850,33,35-39,1883,14
SIM,1902,42,40-44,1944,1
STAT,1886,21,30-34,1907,19.05224128677849
STAT,1859,52,45-49,1911,0.011726191581349778
STAT,1890,24,25-29,1914,70.20800837811917
SIM,1909,17,15-19,1926,10
STAT,1843,36,45-49,1879,1.586017955225419
STAT,1835,26,45-49,1861,1.0943647793315596
STAT,1870,31,45-49,1901,1.7365701876478514
SIM,1906,22,na,1928,3613
STAT,1895,18,20-24,1913,23.322019403133538
STAT,1881,62,na,1943,1779.4159019898082
SIM,1890,41,50-100,1931,3
STAT,1838,30,40-44,1868,3.683116430896743
SIM,1927,30,35-39,1957,21
STAT,1814,47,50-100,1861,0.5923725561188588
STAT,1790,100,na,1890,0.1960407035076609
STAT,1815,73,na,1888,538.6466971741365
STAT,1838,49,25-29,1887,0.038665738463584204
SIM,1928,17,25-29,1945,66
SIM,1903,57,na,1960,2720
STAT,1820,41,35-39,1861,3.537095666811331
STAT,1878,18,45-49,1896,0.06830825428085276
SIM,1844,36,45-49,1880,1
STAT,1904,22,45-49,1926,1.0107110001358537
STAT,1927,40,35-39,1967,0.25596549546252284
STAT,1917,27,50-100,1944,1.053641787318774
STAT,1935,36,50-100,1971,0.5936980545385947
STAT,1823,33,25-29,1856,23.72404460225614
SIM,1845,39,25-29,1884,3
SIM,1881,26,20-24,1907,7
SIM,1900,47,50-100,1947,1
SIM,1914,35,25-29,1949,1
STAT,1888,47,30-34,1935,0.1148584269137631
SIM,1859,42,45-49,1901,3
STAT,1821,44,45-49,1865,2.253313377426034
STAT,1866,33,20-24,1899,2.5173204697407625
SIM,1890,38,25-29,1928,4
STAT,1937,35,50-100,1972,0.42457664268038614
SIM,1894,21,30-34,1915,45
STAT,1864,31,20-24,1895,2.473600627060266
STAT,1887,19,na,1906,2832.7163342353556
SIM,1785,86,na,1871,39
SIM,1918,46,50-100,1964,1
SIM,1836,27,20-24,1863,14
STAT,1894,31,30-34,1925,22.796268852122406
STAT,1920,43,20-24,1963,0.019665458367123786
STAT,1891,16,30-34,1907,1.9979940646831948
SIM,1892,40,na,1932,3169
SIM,1839,23,15-19,1862,2
STAT,1815,47,25-29,1862,0.12780133513860759
STAT,1890,48,25-29,1938,0.039595512243993033
STAT,1784,103,na,1887,0.0463192232493963
SIM,1838,39,25-29,1877,3
SIM,1834,86,na,1920,94
SIM,1866,37,35-39,1903,17
SIM,1827,30,30-34,1857,21
SIM,1812,59,na,1871,1039
STAT,1818,78,na,1896,402.5479101774059
SIM,1849,22,30-34,1871,17
SIM,1888,29,35-39,1917,16
STAT,1882,38,25-29,1920,2.8028839487380806
SIM,1870,13,na,1883,2955
STAT,1780,103,na,1883,0.04693664620568254
SIM,1868,74,na,1942,860
SIM,1845,46,50-100,1891,2
STAT,1881,34,25-29,1915,9.886470801425316
STAT,1851,32,30-34,1883,13.759947099887565
STAT,1869,84,na,1953,326.66144584270813
STAT,1920,46,30-34,1966,0.09975917780783607
STAT,1856,45,20-24,1901,0.00938479425607497
SIM,1923,22,20-24,1945,142
STAT,1933,34,40-44,1967,5.322295152545371
SIM,1870,90,na,1960,114
STAT,1836,21,40-44,1857,1.7474374966895205
STAT,1832,38,35-39,1870,6.038808796241888
SIM,1823,99,na,1922,4
STAT,1795,82,na,1877,194.55460391770606
SIM,1917,16,35-39,1933,2
STAT,1897,26,50-100,1923,0.8691536139595492
STAT,1864,3,na,1867,2927.192356231999
SIM,1933,30,na,1963,4880
STAT,1871,26,na,1897,2402.9131556909606
SIM,1853,26,45-49,1879,1
STAT,1846,37,na,1883,1867.0859746041183
SIM,1882,44,35-39,1926,4
SIM,1929,38,40-44,1967,1
STAT,1845,26,45-49,1871,0.994617513126091
STAT,1799,72,na,1871,562.5471877860411
SIM,1921,45,na,1966,4088
SIM,1850,76,na,1926,710
SIM,1904,29,30-34,1933,46
STAT,1853,45,50-100,1898,0.2051303097085028
SIM,1906,25,25-29,1931,65
STAT,1814,43,25-29,1857,1.710464993142268
STAT,1899,23,30-34,1922,24.614235625545955
STAT,1844,29,20-24,1873,11.19983677400895
SIM,1858,27,40-44,1885,5
SIM,1919,29,na,1948,3893
STAT,1873,42,50-100,1915,1.0803794335637407
STAT,1926,33,na,1959,4619.063680606731
SIM,1822,43,25-29,1865,3
SIM,1870,30,40-44,1900,2
STAT,1887,44,45-49,1931,1.6648997174744677
STAT,1888,66,na,1954,1953.8831403997922
STAT,1900,18,40-44,1918,0.2559426995314366
STAT,1813,47,na,1860,1350.6000822001856
STAT,1910,21,25-29,1931,87.78057538645952
STAT,1857,99,na,1956,1.7595210354723423
SIM,1838,36,20-24,1874,1
SIM,1899,16,40-44,1915,1
STAT,1861,51,30-34,1912,0.0050197597113783915
STAT,1947,21,20-24,1968,126.98218701751168
SIM,1844,43,45-49,1887,3
STAT,1827,43,35-39,1870,1.9147531331257275
SIM,1908,33,35-39,1941,9
SIM,1864,26,20-24,1890,18
STAT,1819,49,15-19,1868,7.567438703994182E-4
SIM,1947,19,40-44,1966,5
STAT,1840,45,25-29,1885,0.041773657597900304
STAT,1867,20,15-19,1887,3.1967725005817793
SIM,1868,30,25-29,1898,11
STAT,1903,49,35-39,1952,0.11122212827992607
SIM,1849,44,40-44,1893,6
STAT,1906,32,15-19,1938,0.1202928540904496
STAT,1881,19,na,1900,2445.6566162577733
STAT,1814,107,na,1921,0.002207350511157982
STAT,1914,23,na,1937,3752.6105138021626
STAT,1954,17,25-29,1971,54.1241792891264
SIM,1881,31,na,1912,2096
STAT,1842,32,20-24,1874,2.9399187717476214
STAT,1851,44,30-34,1895,0.8587644378475263
STAT,1942,20,25-29,1962,97.85175302294277
STAT,1858,22,na,1880,1943.8828305231134
STAT,1828,49,25-29,1877,0.05110777044877674
STAT,1901,35,40-44,1936,1.3504714954680175
SIM,1807,50,na,1857,1165
STAT,1894,34,35-39,1928,13.055837957865908
STAT,1836,43,45-49,1879,1.1088829296820752
STAT,1914,48,na,1962,3665.890737998398
SIM,1868,9,na,1877,2548
STAT,1939,19,40-44,1958,1.4124792094026783
SIM,1856,89,na,1945,14
SIM,1875,20,15-19,1895,2
STAT,1834,47,35-39,1881,0.0884227175413197
SIM,1949,15,35-39,1964,9
STAT,1923,35,50-100,1958,0.4923858126679598
STAT,1870,19,20-24,1889,17.54195983934037
STAT,1825,42,30-34,1867,1.648498944329359
STAT,1906,31,50-100,1937,0.7771225330657323
STAT,1932,17,40-44,1949,1.8717009027644447
STAT,1907,44,40-44,1951,0.22854464679139183
STAT,1807,53,35-39,1860,0.02863213074568733
STAT,1888,44,20-24,1932,0.18676736719830175
SIM,1882,4,na,1886,2411
STAT,1874,44,35-39,1918,1.8474464963996944
STAT,1940,24,30-34,1964,29.53817268707981
STAT,1852,8,na,1860,2252.4337246045347
STAT,1873,39,35-39,1912,7.169144145568574
SIM,1899,28,40-44,1927,6
STAT,1868,37,na,1905,2274.203257709398
SIM,1921,48,na,1969,4065
SIM,1843,47,50-100,1890,2
SIM,1927,21,50-100,1948,1
STAT,1889,21,50-100,1910,0.5093930805910226
STAT,1847,43,20-24,1890,0.11805022399746289
STAT,1876,24,40-44,1900,2.159481448045998
STAT,1831,32,45-49,1863,1.4434129164011413
STAT,1806,48,35-39,1854,0.4158906514997477
STAT,1870,41,na,1911,2302.6323555491012
STAT,1900,22,50-100,1922,0.5721344922440904
STAT,1784,109,na,1893,6.679580526122454E-4
SIM,1906,56,na,1962,2980
SIM,1927,33,45-49,1960,2
STAT,1868,21,50-100,1889,0.3964831084850946
SIM,1940,17,40-44,1957,5
SIM,1863,44,25-29,1907,3
SIM,1833,42,30-34,1875,4
STAT,1872,52,45-49,1924,0.014657759929762338
STAT,1909,16,35-39,1925,0.8324056842757454
SIM,1831,94,na,1925,6
STAT,1910,29,20-24,1939,17.65682901099554
STAT,1894,51,na,1945,2813.3133711454043
SIM,1767,92,na,1859,6
SIM,1865,17,30-34,1882,4
STAT,1851,89,na,1940,79.5452443792047
STAT,1892,33,30-34,1925,22.03470195239841
SIM,1868,34,40-44,1902,7
STAT,1890,46,35-39,1936,0.09774044598557904
SIM,1943,17,15-19,1960,58
SIM,1826,42,na,1868,1919
STAT,1845,39,15-19,1884,0.042225190259920733
STAT,1853,33,35-39,1886,8.535267133052816
STAT,1949,22,25-29,1971,108.88965000142754
STAT,1898,44,20-24,1942,0.0148962265022499
STAT,1932,22,15-19,1954,7.058371243945913
STAT,1894,49,15-19,1943,2.872727866873174E-4
STAT,1923,39,35-39,1962,2.8256592403027465
STAT,1857,17,30-34,1874,1.4766543102143266
SIM,1879,37,20-24,1916,1
SIM,1940,22,15-19,1962,6
SIM,1881,53,na,1934,1897
STAT,1855,44,50-100,1899,0.7844794686448208
STAT,1914,45,na,1959,3693.4121849951907
STAT,1935,17,15-19,1952,62.68289567115981
STAT,1927,9,na,1936,5002.923797535303
SIM,1907,29,50-100,1936,1
STAT,1820,50,30-34,1870,0.010111531221717592
STAT,1932,29,40-44,1961,6.163475304350908
STAT,1867,27,35-39,1894,9.178272275117532
SIM,1874,33,20-24,1907,2
STAT,1919,33,45-49,1952,1.7069010319177182
STAT,1857,50,20-24,1907,5.900194817946437E-4
STAT,1914,29,na,1943,3783.049514844423
SIM,1891,33,20-24,1924,4
SIM,1821,38,25-29,1859,1
STAT,1827,31,50-100,1858,1.2876103779472963
SIM,1835,87,na,1922,61
STAT,1883,50,30-34,1933,0.005967875199585568
STAT,1915,29,40-44,1944,4.762919985812046
STAT,1937,26,15-19,1963,0.6950375696462441
STAT,1941,22,na,1963,3810.048735172829
STAT,1815,54,50-100,1869,0.03075511775256814
STAT,1868,44,35-39,1912,1.7243678089315158
SIM,1933,32,25-29,1965,1
SIM,1899,32,na,1931,3588
STAT,1839,38,50-100,1877,1.0294371875979194
STAT,1832,32,20-24,1864,2.4059364661592677
STAT,1853,48,15-19,1901,3.2663394193671987E-4
STAT,1893,17,35-39,1910,0.7036873643928089
STAT,1901,46,20-24,1947,0.009611149032268687
SIM,1859,44,35-39,1903,5
SIM,1944,21,45-49,1965,2
STAT,1872,40,45-49,1912,1.5350542169068193
SIM,1813,84,na,1897,138
SIM,1834,23,30-34,1857,20
STAT,1831,32,50-100,1863,0.7584033920715402
STAT,1915,30,50-100,1945,0.8565107386396134
SIM,1880,40,45-49,1920,3
SIM,1918,41,na,1959,4197
SIM,1919,26,na,1945,3971
SIM,1940,29,40-44,1969,11
SIM,1860,23,40-44,1883,2
STAT,1882,22,15-19,1904,3.2275921304621202
SIM,1881,39,35-39,1920,10
SIM,1918,21,35-39,1939,13
STAT,1883,29,na,1912,2341.912579208113
SIM,1929,31,20-24,1960,3
STAT,1857,41,30-34,1898,0.910319894336405
SIM,1913,37,50-100,1950,1
STAT,1916,30,25-29,1946,9.70723557844984
STAT,1922,40,na,1962,4318.405538480107
SIM,1782,84,na,1866,19
SIM,1893,41,na,1934,3069
SIM,1923,29,40-44,1952,6
STAT,1858,25,35-39,1883,7.940465493979065
STAT,1874,50,20-24,1924,7.741153143261821E-4
SIM,1839,27,30-34,1866,5
STAT,1871,16,45-49,1887,0.06636036677163354
SIM,1863,44,50-100,1907,1
STAT,1815,44,20-24,1859,0.37158890012460444
SIM,1924,30,25-29,1954,3
STAT,1916,42,25-29,1958,0.07384944946203235
STAT,1893,24,40-44,1917,2.65563342947363
STAT,1800,99,na,1899,0.6643415856672137
STAT,1841,15,20-24,1856,17.30211010347251
STAT,1901,23,40-44,1924,2.9412595828767802
SIM,1788,75,na,1863,432
SIM,1929,24,15-19,1953,7
SIM,1900,68,na,1968,2581
STAT,1898,18,30-34,1916,2.1766222878785544
STAT,1877,41,40-44,1918,2.3553067872002025
STAT,1901,41,na,1942,3298.5452651915725
STAT,1841,34,20-24,1875,2.402137483285043
STAT,1876,17,40-44,1893,0.19073916348900033
SIM,1861,45,50-100,1906,2
STAT,1867,15,40-44,1882,0.17997504748985424
SIM,1818,47,na,1865,1327
STAT,1826,33,40-44,1859,5.745547045249171
STAT,1909,22,50-100,1931,0.6171127515056485
SIM,1848,29,30-34,1877,34
STAT,1834,49,na,1883,1384.2722017663743
STAT,1821,61,na,1882,1184.5646931610243
SIM,1885,22,40-44,1907,2
SIM,1903,38,50-100,1941,1
STAT,1877,44,50-100,1921,1.0864050041242632
SIM,1876,44,35-39,1920,2
SIM,1868,89,na,1957,51
STAT,1912,38,20-24,1950,0.2582883485758228
SIM,1827,33,40-44,1860,5
SIM,1845,24,na,1869,2027
SIM,1899,21,15-19,1920,6
SIM,1927,21,45-49,1948,2
STAT,1856,26,20-24,1882,9.48139306840693
STAT,1926,23,35-39,1949,11.525479869293871
SIM,1885,41,40-44,1926,5
STAT,1880,29,25-29,1909,44.54887000566966
STAT,1773,116,na,1889,1.2519753124321875E-4
SIM,1834,33,40-44,1867,7
STAT,1919,21,45-49,1940,1.247760507055863
SIM,1889,51,na,1940,2588
STAT,1886,24,40-44,1910,2.208248055246359
STAT,1897,5,na,1902,3548.4986473332615
SIM,1885,34,35-39,1919,17
STAT,1916,49,45-49,1965,0.2236451087751579
STAT,1911,45,45-49,1956,0.20855888924659816
STAT,1831,51,45-49,1882,0.00972746794929905
SIM,1934,23,35-39,1957,11
STAT,1848,107,na,1955,0.0038503802892123247
STAT,1831,69,na,1900,922.2050077358289
SIM,1854,43,45-49,1897,8
STAT,1945,23,45-49,1968,1.2449688579168194
SIM,1818,43,35-39,1861,2
STAT,1882,66,na,1948,1603.521586956397
STAT,1895,14,na,1909,3395.20767080482
SIM,1823,77,na,1900,501
SIM,1890,35,20-24,1925,1
SIM,1904,16,25-29,1920,16
STAT,1806,62,na,1868,909.0560335807471
SIM,1868,71,na,1939,1110
STAT,1887,1,na,1888,3349.527864248722
STAT,1852,23,40-44,1875,1.86389499038993
STAT,1812,84,na,1896,151.03276650084578
SIM,1894,24,40-44,1918,4
STAT,1812,54,20-24,1866,0.0015650638844851908
SIM,1950,20,25-29,1970,124
SIM,1860,16,35-39,1876,3
STAT,1847,24,20-24,1871,62.34824643877116
STAT,1917,21,35-39,1938,10.13183076204429
SIM,1814,42,50-100,1856,2
STAT,1762,92,na,1854,7.0
STAT,1902,1,na,1903,3884.811306139696
STAT,1910,36,20-24,1946,0.25558532878625667
SIM,1869,37,na,1906,2256
STAT,1862,33,45-49,1895,1.514578513167699
STAT,1882,35,20-24,1917,0.7613204643216287
STAT,1853,31,45-49,1884,1.5005651856567799
SIM,1833,32,20-24,1865,3
SIM,1849,37,35-39,1886,12
STAT,1846,43,45-49,1889,1.134893941230401
STAT,1781,84,na,1865,60.53988875980034
STAT,1925,32,25-29,1957,11.092086812871914
STAT,1841,21,15-19,1862,3.1478731859730775
STAT,1849,64,na,1913,1359.1405554909325
STAT,1883,33,20-24,1916,2.660351516105065
SIM,1925,21,35-39,1946,20
SIM,1844,21,40-44,1865,1
STAT,1842,54,25-29,1896,0.003101301928047764
STAT,1862,45,20-24,1907,0.010570991983761813
STAT,1948,6,na,1954,4556.2721839669775
STAT,1812,47,15-19,1859,9.22619797865898E-4
STAT,1897,27,20-24,1924,15.885074869378425
STAT,1910,48,20-24,1958,0.010373648847339241
STAT,1857,15,50-100,1872,0.045928398405898865
STAT,1906,27,40-44,1933,4.406784478703982
STAT,1852,16,35-39,1868,0.506283450264179
SIM,1943,6,na,1949,4244
SIM,1843,23,40-44,1866,3
STAT,1940,20,50-100,1960,0.6771675337777562
STAT,1936,21,45-49,1957,1.0863717420387664
STAT,1908,11,na,1919,3872.8948491272104
STAT,1816,42,20-24,1858,0.45566083408730085
SIM,1819,40,50-100,1859,1
STAT,1841,103,na,1944,0.10732261963277347
SIM,1840,32,20-24,1872,3
SIM,1840,38,35-39,1878,11
SIM,1847,72,na,1919,855
STAT,1880,18,na,1898,2671.918119311115
SIM,1914,27,40-44,1941,4
STAT,1863,74,na,1937,993.1384385959293
SIM,1939,15,35-39,1954,9
STAT,1877,34,35-39,1911,10.466307596289255
STAT,1876,50,30-34,1926,0.006296779679707981
STAT,1850,24,na,1874,1936.9293699448401
STAT,1915,22,20-24,1937,115.98134210664158
SIM,1871,29,25-29,1900,47
STAT,1906,39,40-44,1945,1.3759761537033146
SIM,1889,18,30-34,1907,3
STAT,1821,49,15-19,1870,5.695444678178225E-4
STAT,1827,61,na,1888,1143.203149068143
STAT,1832,44,20-24,1876,0.12930888533903986
STAT,1898,42,30-34,1940,0.10917664105643803
SIM,1845,46,na,1891,1878
STAT,1835,23,40-44,1858,2.0648540573712655
STAT,1848,54,35-39,1902,0.006835647912962049
STAT,1855,44,25-29,1899,0.47684046433049526
SIM,1861,31,45-49,1892,2
STAT,1848,60,na,1908,1557.1329556532153
STAT,1801,53,25-29,1854,0.013097907686029177
SIM,1900,33,40-44,1933,10
SIM,1844,61,na,1905,1240
SIM,1853,23,40-44,1876,7
STAT,1913,36,50-100,1949,0.42006471161397363
STAT,1847,36,20-24,1883,0.605082906541893
STAT,1902,20,na,1922,3395.6797957087942
STAT,1842,19,45-49,1861,0.0746354564480056
SIM,1874,19,30-34,1893,2
STAT,1840,22,45-49,1862,0.6216257341704221
STAT,1903,46,30-34,1949,0.07876505091356198
STAT,1913,29,30-34,1942,39.110341262967374
SIM,1906,22,20-24,1928,2
STAT,1842,51,20-24,1893,6.675532372011901E-4
STAT,1920,49,35-39,1969,0.14307840301396824
STAT,1894,69,na,1963,2119.9862639879234
SIM,1900,46,na,1946,3295
SIM,1923,25,25-29,1948,115
SIM,1888,35,50-100,1923,1
STAT,1845,45,45-49,1890,0.17416107826073496
STAT,1901,56,na,1957,2930.828071146739
STAT,1882,29,35-39,1911,9.372536174517435
STAT,1866,19,30-34,1885,1.5120489217549422
SIM,1828,39,30-34,1867,1
SIM,1869,8,na,1877,2576
SIM,1869,34,na,1903,2220
STAT,1856,36,30-34,1892,4.14680179574333
STAT,1836,40,40-44,1876,1.7318217724037903
STAT,1915,25,25-29,1940,68.20264675639281
SIM,1861,19,20-24,1880,19
SIM,1890,29,35-39,1919,14
STAT,1845,23,40-44,1868,1.8766503146833335
STAT,1897,33,15-19,1930,0.19201462840369746
SIM,1875,27,35-39,1902,17
STAT,1827,41,45-49,1868,1.6378649102728737
STAT,1922,15,15-19,1937,53.30658279818297
STAT,1923,32,15-19,1955,0.14884841371601024
SIM,1877,88,na,1965,399
SIM,1870,33,45-49,1903,1
STAT,1916,46,40-44,1962,0.16359974295545213
STAT,1898,47,25-29,1945,0.04427982951353748
STAT,1836,24,45-49,1860,0.5722534607272473
STAT,1873,33,20-24,1906,2.756008072489427
SIM,1823,38,35-39,1861,18
SIM,1899,18,30-34,1917,5
SIM,1859,30,50-100,1889,1
SIM,1878,11,na,1889,3074
STAT,1836,75,na,1911,649.1005332749545
SIM,1839,17,20-24,1856,18
SIM,1881,29,25-29,1910,54
STAT,1861,42,na,1903,1937.3893938149274
STAT,1912,19,na,1931,3919.1417638204302
STAT,1873,29,25-29,1902,43.003264725053825
SIM,1919,27,25-29,1946,109
STAT,1852,21,50-100,1873,0.3700492582082335
STAT,1842,30,30-34,1872,19.388144413124586
SIM,1930,15,15-19,1945,83
STAT,1853,19,20-24,1872,17.429180231524462
STAT,1840,31,50-100,1871,0.7904540998398956
SIM,1835,41,45-49,1876,1
STAT,1918,17,15-19,1935,10.005354258236654
SIM,1829,34,20-24,1863,1
SIM,1856,15,30-34,1871,4
STAT,1873,26,20-24,1899,12.053167073738635
STAT,1832,28,25-29,1860,38.457910548280374
SIM,1810,73,na,1883,658
STAT,1858,37,35-39,1895,5.604488074426691
STAT,1810,44,45-49,1854,6.051854783249489
STAT,1834,31,na,1865,1669.6100908561298
STAT,1944,21,na,1965,3982.852713203497
SIM,1840,28,25-29,1868,59
SIM,1850,30,30-34,1880,22
STAT,1894,32,45-49,1926,2.2675536710920583
SIM,1868,37,45-49,1905,3
STAT,1846,19,20-24,1865,16.70232827344991
SIM,1888,26,na,1914,2935
STAT,1864,46,25-29,1910,0.05264494643840172
STAT,1923,36,30-34,1959,2.1356726464131865
STAT,1901,38,45-49,1939,0.6061886305367107
SIM,1829,53,na,1882,1488
SIM,1832,76,na,1908,606
SIM,1850,35,25-29,1885,5
SIM,1808,69,na,1877,663
STAT,1834,44,30-34,1878,0.8045301656677074
STAT,1938,24,15-19,1962,5.314976525048378
SIM,1832,57,na,1889,1194
STAT,1871,35,50-100,1906,1.2436467588645537
STAT,1904,30,na,1934,3486.5661482670184
STAT,1815,76,na,1891,410.11056709737096
STAT,1848,15,30-34,1863,1.6323615707477688
STAT,1816,40,30-34,1856,3.558942935728763
SIM,1844,40,40-44,1884,6
STAT,1842,35,25-29,1877,3.1047064923301466
STAT,1848,29,50-100,1877,0.6145849011010682
SIM,1864,39,35-39,1903,12
STAT,1847,49,35-39,1896,0.10263455597061635
STAT,1838,53,20-24,1891,4.860513519077232E-4
SIM,1901,30,50-100,1931,1
STAT,1855,52,45-49,1907,0.010865643563312781
STAT,1829,54,25-29,1883,0.0022332830953082066
STAT,1861,64,na,1925,1458.969652718948
STAT,1941,15,25-29,1956,45.088107080206875
SIM,1868,6,na,1874,2636
SIM,1928,19,15-19,1947,1
STAT,1787,101,na,1888,0.1190096007067364
STAT,1870,41,30-34,1911,1.1453866950512437
STAT,1886,46,45-49,1932,0.25238328227161844
STAT,1861,54,35-39,1915,0.007026718135105542
SIM,1889,73,na,1962,1496
SIM,1834,26,35-39,1860,1
SIM,1858,17,30-34,1875,4
STAT,1896,45,25-29,1941,0.04387122951411888
SIM,1938,33,20-24,1971,2
STAT,1836,97,na,1933,3.3873276245483215
SIM,1833,21,na,1854,1922
STAT,1883,46,35-39,1929,0.1387648507428727
STAT,1883,52,20-24,1935,7.25455725497406E-4
SIM,1921,29,30-34,1950,51
SIM,1824,40,30-34,1864,4
STAT,1903,42,15-19,1945,0.001377715435072198
SIM,1856,86,na,1942,95
SIM,1885,44,45-49,1929,2
SIM,1859,32,40-44,1891,12
STAT,1887,4,na,1891,2966.484374055405
STAT,1884,49,50-100,1933,0.23950896901776084
SIM,1877,85,na,1962,555
SIM,1812,48,50-100,1860,2
SIM,1901,29,20-24,1930,17
SIM,1878,29,50-100,1907,3
STAT,1883,31,30-34,1914,17.327205906363194
STAT,1783,94,na,1877,4.364077720945222
SIM,1913,19,na,1932,3946
STAT,1833,43,35-39,1876,1.5382630244961997
STAT,1856,32,15-19,1888,0.11162295642441981
STAT,1868,42,45-49,1910,1.4429144500385571
SIM,1883,63,na,1946,1945
SIM,1939,17,25-29,1956,55
STAT,1820,53,35-39,1873,0.013774282264532407
STAT,1829,40,40-44,1869,1.7994902420491508
SIM,1909,29,15-19,1938,5
STAT,1762,95,na,1857,1.6059626887656235
STAT,1867,24,30-34,1891,16.837365382521476
STAT,1873,52,na,1925,2192.912526061229
STAT,1815,98,na,1913,1.406223273124184
SIM,1833,39,na,1872,1825
STAT,1876,41,na,1917,2421.1659287423904
SIM,1854,19,20-24,1873,18
SIM,1929,29,50-100,1958,1
STAT,1818,87,na,1905,90.7695349782578
STAT,1877,25,45-49,1902,1.1652580868826492
SIM,1841,43,35-39,1884,4
SIM,1885,25,45-49,1910,2
STAT,1877,44,45-49,1921,1.5390737602531195
SIM,1871,78,na,1949,622
STAT,1846,34,na,1880,1903.6718119383772
STAT,1828,39,15-19,1867,0.05529684170423479
STAT,1856,12,na,1868,2185.78769083618
SIM,1892,49,50-100,1941,2
STAT,1854,39,25-29,1893,2.1390513148983406
STAT,1912,44,15-19,1956,0.0014827304234919616
STAT,1883,36,25-29,1919,2.8594125414633833
SIM,1891,31,30-34,1922,43
STAT,1896,31,40-44,1927,5.8215419091454725
SIM,1880,19,30-34,1899,2
SIM,1866,22,30-34,1888,24
STAT,1866,43,30-34,1909,1.0674401219027954
SIM,1926,17,15-19,1943,75
SIM,1891,6,na,1897,3403
STAT,1929,41,15-19,1970,0.002013027533512379
SIM,1876,42,45-49,1918,3
SIM,1908,63,na,1971,2864
STAT,1842,45,35-39,1887,0.1293399606131614
STAT,1852,26,45-49,1878,0.9878572398729667
SIM,1822,32,45-49,1854,2
SIM,1870,93,na,1963,95
STAT,1897,37,30-34,1934,7.216561701820451
SIM,1921,30,na,1951,4143
SIM,1915,44,40-44,1959,2
STAT,1811,51,35-39,1862,0.020919058427422848
STAT,1837,17,20-24,1854,23.934922044196394
SIM,1922,34,30-34,1956,34
SIM,1845,17,20-24,1862,1
SIM,1854,29,30-34,1883,33
STAT,1846,29,30-34,1875,22.787782250869267
STAT,1881,23,45-49,1904,0.6767904311475719
SIM,1934,18,na,1952,5452
STAT,1889,19,35-39,1908,0.6796944655591511
STAT,1914,34,30-34,1948,15.864032590492753
STAT,1923,46,40-44,1969,0.18681739970978342
STAT,1875,45,30-34,1920,0.10140362414513254
SIM,1882,19,na,1901,2247
STAT,1837,54,50-100,1891,0.010020053943944394
STAT,1830,34,45-49,1864,1.620264618668029
STAT,1858,22,30-34,1880,16.194070204289016
STAT,1897,40,na,1937,3172.0500040858938
STAT,1906,44,50-100,1950,0.1064666048814112
SIM,1791,80,na,1871,140
SIM,1854,38,na,1892,2180
STAT,1824,72,na,1896,627.8492348136716
STAT,1836,30,30-34,1866,14.214447667151246
STAT,1839,86,na,1925,157.30419496306388
STAT,1840,33,25-29,1873,8.654779028084755
STAT,1947,10,na,1957,4470.826307397166
STAT,1825,35,na,1860,2126.251071247015
STAT,1916,40,35-39,1956,0.20882555287896934
STAT,1808,54,30-34,1862,0.019338685878157874
SIM,1881,56,na,1937,1874
STAT,1847,53,30-34,1900,0.004385334000273716
SIM,1944,8,na,1952,4306
STAT,1893,27,45-49,1920,1.4238987767146585
SIM,1874,43,30-34,1917,1
STAT,1864,56,na,1920,1858.896283713905
STAT,1930,17,30-34,1947,15.927209164494526
SIM,1792,65,na,1857,707
SIM,1819,91,na,1910,9
STAT,1855,30,40-44,1885,3.3935163518382128
SIM,1856,64,na,1920,1473
SIM,1920,29,50-100,1949,1
STAT,1912,29,50-100,1941,0.982529903229714
STAT,1948,3,na,1951,4610.835828203363
STAT,1851,47,35-39,1898,0.10551208447126406
STAT,1870,78,na,1948,774.9165902263491
STAT,1832,47,25-29,1879,0.046509072834685646
STAT,1911,42,40-44,1953,0.24084929901535346
SIM,1881,43,30-34,1924,2
STAT,1834,23,50-100,1857,0.3225100774827594
STAT,1872,19,30-34,1891,1.6097689178644408
STAT,1824,40,50-100,1864,1.3679685228938434
STAT,1937,17,25-29,1954,42.56033950141346
STAT,1837,20,na,1857,1930.2133232409553
SIM,1834,36,45-49,1870,1
SIM,1885,31,30-34,1916,7
SIM,1855,39,25-29,1894,1
STAT,1885,55,na,1940,2078.7504525179547
SIM,1821,36,na,1857,1463
STAT,1927,20,50-100,1947,0.8242859541848685
SIM,1865,41,30-34,1906,1
SIM,1842,35,na,1877,1875
SIM,1863,30,40-44,1893,5
STAT,1826,36,45-49,1862,2.366646693770001
STAT,1812,87,na,1899,79.98802329343295
SIM,1878,52,50-100,1930,1
STAT,1816,45,25-29,1861,0.15346233680014046
SIM,1945,17,25-29,1962,63
SIM,1886,18,20-24,1904,20
SIM,1835,29,20-24,1864,10
STAT,1841,25,30-34,1866,23.729020847470338
SIM,1933,33,na,1966,4895
STAT,1877,31,30-34,1908,18.274794970955742
SIM,1827,36,45-49,1863,1
SIM,1860,5,na,1865,2563
SIM,1863,34,na,1897,2209
STAT,1904,8,na,1912,3767.8311988551477
SIM,1849,34,30-34,1883,19
SIM,1891,36,25-29,1927,4
STAT,1805,80,na,1885,313.45859017490056
STAT,1890,36,25-29,1926,3.570495045560311
STAT,1916,55,na,1971,3683.3371213248033
STAT,1810,58,na,1868,1252.1331050383021
STAT,1877,22,40-44,1899,2.1722109246738994
STAT,1883,11,na,1894,2556.2868561639125
SIM,1914,23,25-29,1937,109
STAT,1886,27,45-49,1913,1.184019477104958
SIM,1842,23,50-100,1865,1
SIM,1912,34,na,1946,3571
STAT,1901,49,25-29,1950,0.045042396911949424
SIM,1894,27,45-49,1921,1
STAT,1919,38,30-34,1957,1.9749573925841972
STAT,1773,113,na,1886,5.087202803466026E-4
STAT,1906,23,25-29,1929,83.95399654491106
SIM,1832,40,50-100,1872,1
STAT,1825,57,na,1882,1576.981693529687
STAT,1827,83,na,1910,236.0717756591719
STAT,1871,35,45-49,1906,2.019310033109367
STAT,1823,45,25-29,1868,0.08157216007248595
STAT,1862,30,40-44,1892,3.8129770319888925
STAT,1819,36,45-49,1855,6.449684571858854
SIM,1789,79,na,1868,269
STAT,1827,29,20-24,1856,19.395109319912848
SIM,1828,29,20-24,1857,11
SIM,1927,38,30-34,1965,11
SIM,1857,49,na,1906,1903
STAT,1774,80,na,1854,155.0
STAT,1852,50,50-100,1902,0.011618399571775453
SIM,1892,17,30-34,1909,3
SIM,1893,49,50-100,1942,2
SIM,1824,87,na,1911,64
SIM,1857,19,30-34,1876,2
STAT,1848,53,20-24,1901,5.928070456131057E-4
STAT,1837,46,50-100,1883,0.17617133501249915
SIM,1864,1,na,1865,3420
STAT,1886,30,35-39,1916,10.886239673067355
STAT,1895,42,50-100,1937,0.09664290702281907
SIM,1892,33,35-39,1925,20
STAT,1895,36,45-49,1931,2.6419910897555683
STAT,1851,27,45-49,1878,0.9843522203228606
STAT,1898,46,40-44,1944,0.1326013524169956
STAT,1866,70,na,1936,1312.200697582171
STAT,1890,44,15-19,1934,0.016813494810213776
SIM,1939,15,40-44,1954,2
STAT,1826,42,na,1868,1486.554733890005
STAT,1849,39,na,1888,1846.1408246766734
SIM,1949,19,15-19,1968,50
STAT,1787,107,na,1894,0.0015357905391359277
STAT,1904,61,na,1965,2926.0119443505732
STAT,1917,15,40-44,1932,0.30522972093226514
SIM,1869,99,na,1968,3
SIM,1899,36,25-29,1935,4
STAT,1836,37,20-24,1873,0.5968881350732979
SIM,1871,43,45-49,1914,6
STAT,1941,26,40-44,1967,4.870154279218402
STAT,1853,44,na,1897,1885.5415241964909
SIM,1890,36,35-39,1926,14
STAT,1855,103,na,1958,0.18851685031220716
SIM,1928,29,25-29,1957,96
STAT,1873,43,30-34,1916,1.168652791023528
STAT,1850,40,25-29,1890,0.49667002883885675
STAT,1881,87,na,1968,403.9416019811932
STAT,1815,47,30-34,1862,0.21477724584459662
STAT,1852,53,40-44,1905,0.007855891556897185
STAT,1892,41,15-19,1933,0.017581484348836593
STAT,1924,29,45-49,1953,2.018128805827182
SIM,1886,31,na,1917,2687
SIM,1943,17,na,1960,3855
STAT,1853,24,45-49,1877,0.6716090224125154
SIM,1945,26,20-24,1971,20
STAT,1870,21,40-44,1891,2.0729366440907095
STAT,1908,51,na,1959,3311.1681324594915
STAT,1857,34,na,1891,1864.8918174874161
SIM,1919,18,20-24,1937,169
STAT,1850,24,20-24,1874,62.42780938612432
STAT,1806,52,30-34,1858,0.017176268596220828
STAT,1880,40,40-44,1920,2.409904385590408
STAT,1884,17,30-34,1901,1.5874860016570158
SIM,1904,6,na,1910,3941
SIM,1795,85,na,1880,10
STAT,1863,43,45-49,1906,1.3296529744658432
SIM,1828,77,na,1905,428
STAT,1852,21,20-24,1873,62.53461751695122
STAT,1840,37,40-44,1877,3.6293739851259734
SIM,1894,30,35-39,1924,20
SIM,1921,4,na,1925,4580
STAT,1833,27,25-29,1860,39.59021449939976
STAT,1884,33,35-39,1917,10.043942077373691
STAT,1909,39,20-24,1948,0.2492516339525691
STAT,1831,29,na,1860,1774.6656491714953
STAT,1854,17,15-19,1871,5.327808118512088
STAT,1784,73,na,1857,410.1142743551337
STAT,1828,45,45-49,1873,0.2207910764777128
STAT,1864,24,20-24,1888,62.90282804009137
SIM,1851,89,na,1940,55
STAT,1872,30,35-39,1902,10.36589244514398
STAT,1814,57,na,1871,1206.5824776655722
SIM,1951,12,na,1963,4983
SIM,1924,10,na,1934,4815
STAT,1864,36,15-19,1900,0.051424872557269706
STAT,1893,72,na,1965,1906.9189553621254
STAT,1845,100,na,1945,0.7757292138979098
SIM,1830,30,50-100,1860,4
SIM,1872,24,20-24,1896,84
SIM,1925,15,40-44,1940,1
SIM,1836,72,na,1908,865
STAT,1835,24,25-29,1859,56.31760829811573
STAT,1910,16,50-100,1926,0.07508210612529054
SIM,1876,32,40-44,1908,6
STAT,1862,27,20-24,1889,10.270131462557146
SIM,1859,69,na,1928,1413
STAT,1921,22,50-100,1943,0.7506121247917339
STAT,1857,46,25-29,1903,0.04553178019853147
SIM,1947,21,25-29,1968,120
STAT,1815,45,35-39,1860,0.3212255327209447
STAT,1950,19,45-49,1969,0.5963558355966997
SIM,1905,23,15-19,1928,4
STAT,1917,28,na,1945,3951.5823523938843
SIM,1890,38,30-34,1928,7
SIM,1935,19,15-19,1954,56
STAT,1903,0,na,1903,4223.665361081036
SIM,1901,53,na,1954,3041
STAT,1941,30,50-100,1971,0.8773870456837446
STAT,1892,23,15-19,1915,4.1681947511937745
STAT,1841,53,35-39,1894,0.006334610996670524
STAT,1776,78,na,1854,249.0
STAT,1929,16,15-19,1945,58.684510084290125
STAT,1901,23,35-39,1924,8.236677645175394
SIM,1955,16,35-39,1971,7
STAT,1810,67,na,1877,927.0320249475941
STAT,1909,6,na,1915,3953.302886482427
SIM,1867,64,na,1931,1543
SIM,1887,17,20-24,1904,15
STAT,1903,20,35-39,1923,8.443914299511846
STAT,1939,21,25-29,1960,93.68026373776203
STAT,1817,42,35-39,1859,4.430063562744453
STAT,1889,39,25-29,1928,3.5496466140718703
SIM,1841,27,25-29,1868,53
STAT,1831,48,25-29,1879,0.042475781801288894
STAT,1952,16,45-49,1968,0.6049970695578298
STAT,1877,22,35-39,1899,6.083040500073002
STAT,1839,45,20-24,1884,0.008893200043740754
SIM,1912,25,na,1937,3581
SIM,1840,42,30-34,1882,1
STAT,1849,37,30-34,1886,4.263887546779849
STAT,1869,46,45-49,1915,0.23240016273039885
STAT,1876,39,15-19,1915,0.05797100416203664
STAT,1882,38,30-34,1920,5.188317125080827
SIM,1851,32,35-39,1883,11
SIM,1916,15,na,1931,4151
STAT,1836,60,na,1896,1202.522531676253
STAT,1842,54,50-100,1896,0.01322360692537988
STAT,1835,23,50-100,1858,0.4040810582382061
SIM,1938,30,na,1968,3735
STAT,1866,53,40-44,1919,0.009687715826715184
SIM,1882,41,na,1923,2095
SIM,1870,27,20-24,1897,17
STAT,1896,49,40-44,1945,0.1264122196602313
STAT,1849,19,30-34,1868,1.5159214477261196
STAT,1947,16,35-39,1963,4.775896098599057
SIM,1922,37,35-39,1959,5
STAT,1870,16,na,1886,2543.710290391171
STAT,1828,27,15-19,1855,0.87887656624563
STAT,1927,19,15-19,1946,56.72916072920455
STAT,1860,29,50-100,1889,0.5261680181802205
STAT,1897,33,45-49,1930,2.351273363053418
STAT,1849,109,na,1958,9.748162557907281E-4
STAT,1879,28,50-100,1907,0.6718623547682951
STAT,1862,80,na,1942,539.5522439363762
STAT,1939,27,50-100,1966,1.0101655788664063
STAT,1919,30,40-44,1949,4.29715222683855
STAT,1821,98,na,1919,1.9458499508000724
SIM,1869,21,40-44,1890,2
STAT,1882,36,35-39,1918,6.953080764949763
STAT,1920,18,20-24,1938,153.2011118592455
STAT,1832,42,30-34,1874,0.9605653276318188
STAT,1868,32,40-44,1900,4.186192854778321
STAT,1925,23,na,1948,4403.92214925413
STAT,1854,85,na,1939,205.7342063064304
STAT,1871,4,na,1875,2958.0358045299627
SIM,1878,36,na,1914,2748
STAT,1845,49,na,1894,1609.6033087627843
STAT,1854,50,40-44,1904,0.008014398159905824
SIM,1848,38,na,1886,1787
SIM,1832,82,na,1914,290
STAT,1958,10,na,1968,5212.671814359262
SIM,1911,20,35-39,1931,14
STAT,1825,32,15-19,1857,0.33771625623038776
SIM,1920,20,na,1940,4245
STAT,1895,18,15-19,1913,7.806947183176948
SIM,1838,42,45-49,1880,3
STAT,1864,38,40-44,1902,3.9698115060859003
STAT,1915,33,na,1948,3870.3461073909953
STAT,1879,35,20-24,1914,0.8201907603786004
STAT,1906,9,na,1915,3816.973775152812
SIM,1882,25,20-24,1907,12
STAT,1881,38,40-44,1919,4.240647070082951
STAT,1867,32,20-24,1899,2.571208738327212
STAT,1843,16,30-34,1859,1.3819330027478842
STAT,1837,85,na,1922,187.00890995694013
SIM,1898,56,na,1954,2746
STAT,1914,37,35-39,1951,2.436579840529833
STAT,1848,38,25-29,1886,2.3974645012001967
STAT,1820,45,45-49,1865,0.4137633389029266
SIM,1879,43,45-49,1922,10
STAT,1881,31,50-100,1912,0.8956703991414814
SIM,1929,23,30-34,1952,45
STAT,1870,49,20-24,1919,0.01165296596776359
STAT,1933,31,30-34,1964,21.467798858137808
STAT,1929,34,15-19,1963,0.16477018375145067
STAT,1878,21,40-44,1899,2.191375360390066
SIM,1946,23,30-34,1969,1
STAT,1869,28,15-19,1897,0.44394884072623136
STAT,1809,48,15-19,1857,0.001374968385822257
SIM,1925,33,40-44,1958,5
SIM,1856,38,25-29,1894,6
STAT,1859,27,45-49,1886,0.9175070792194354
STAT,1925,16,50-100,1941,0.45851006210247847
STAT,1823,35,15-19,1858,0.10633425114451434
STAT,1843,32,35-39,1875,8.211428133612683
SIM,1897,15,na,1912,3557
SIM,1813,44,na,1857,1425
STAT,1820,57,na,1877,1100.4096589794033
STAT,1897,15,15-19,1912,8.073065882004725
STAT,1861,46,15-19,1907,3.3666491240538494E-4
STAT,1919,23,na,1942,4024.9972165941654
STAT,1876,25,25-29,1901,44.413020286506956
STAT,1935,28,50-100,1963,1.370156137325178
STAT,1860,16,30-34,1876,1.5266939216007762
STAT,1910,47,45-49,1957,0.20458382930069757
STAT,1917,33,40-44,1950,4.118891720320816
SIM,1868,40,35-39,1908,3
SIM,1884,25,25-29,1909,62
STAT,1854,35,15-19,1889,0.042788082682379026
SIM,1872,38,40-44,1910,4
SIM,1844,36,50-100,1880,4
SIM,1835,31,40-44,1866,9
SIM,1890,76,na,1966,1657
SIM,1893,25,50-100,1918,1
STAT,1866,38,45-49,1904,1.8551264057646069
SIM,1909,45,na,1954,3765
STAT,1841,21,45-49,1862,0.6653725046481451
STAT,1872,11,na,1883,2684.7429199588073
STAT,1918,31,35-39,1949,9.843797253142153
SIM,1855,42,50-100,1897,3
SIM,1877,43,40-44,1920,3
SIM,1844,36,na,1880,1673
SIM,1866,23,na,1889,2349
STAT,1905,18,25-29,1923,8.252293139254084
SIM,1946,24,15-19,1970,10
STAT,1890,26,15-19,1916,0.5618634756025069
STAT,1905,37,50-100,1942,0.38692193341798065
SIM,1884,36,na,1920,2440
STAT,1860,32,35-39,1892,8.361174646528069
STAT,1892,28,45-49,1920,1.4022218132332993
STAT,1906,56,na,1962,3138.8645639187052
SIM,1838,24,15-19,1862,3
STAT,1814,48,25-29,1862,0.1366145715675132
STAT,1851,54,35-39,1905,0.006339415281170581
SIM,1880,30,35-39,1910,12
STAT,1818,41,40-44,1859,4.567192274887394
STAT,1903,18,20-24,1921,25.434142177885153
STAT,1856,48,30-34,1904,0.07401488412327456
STAT,1857,111,na,1968,7.534952766943032E-4
SIM,1880,74,na,1954,980
SIM,1904,39,40-44,1943,3
SIM,1937,16,15-19,1953,58
STAT,1824,50,25-29,1874,0.004157268345983117
STAT,1861,67,na,1928,1330.4418079417203
SIM,1841,59,na,1900,1351
SIM,1888,1,na,1889,3492
STAT,1874,43,20-24,1917,0.1630563314236802
SIM,1857,37,30-34,1894,3
STAT,1885,32,40-44,1917,4.359864699671652
STAT,1881,39,25-29,1920,2.7748750930443147
STAT,1891,41,25-29,1932,0.8066367655843967
STAT,1823,93,na,1916,16.163497123092753
STAT,1807,52,20-24,1859,0.00250453649977481
SIM,1801,59,na,1860,865
SIM,1896,61,na,1957,2513
STAT,1850,42,20-24,1892,0.12145561650650626
SIM,1885,41,50-100,1926,4
SIM,1913,18,25-29,1931,12
STAT,1885,15,25-29,1900,5.7234448664612865
STAT,1839,48,25-29,1887,0.04107779277773671
STAT,1921,33,na,1954,4232.9019535213865
STAT,1820,45,15-19,1865,7.012932044836236E-4
SIM,1866,40,30-34,1906,3
STAT,1869,43,40-44,1912,2.192740383459244
STAT,1827,31,40-44,1858,6.094437405373692
SIM,1862,35,45-49,1897,1
STAT,1825,37,45-49,1862,3.291734525791368
STAT,1899,28,30-34,1927,34.783068222511275
STAT,1891,43,20-24,1934,0.1971576467707586
STAT,1859,29,40-44,1888,2.4399868491695305
SIM,1843,24,25-29,1867,91
STAT,1864,28,50-100,1892,0.5809552527505191
SIM,1883,40,30-34,1923,2
SIM,1830,87,na,1917,80
STAT,1844,31,40-44,1875,4.145899272307623
STAT,1930,24,50-100,1954,0.8466427167020025
STAT,1850,95,na,1945,10.18057739694405
SIM,1829,90,na,1919,22
STAT,1776,114,na,1890,2.644253217580332E-4
STAT,1843,14,na,1857,2038.9750791086358
SIM,1845,30,50-100,1875,1
STAT,1805,109,na,1914,2.824324784528392E-4
STAT,1879,47,15-19,1926,4.196340554417901E-4
SIM,1855,79,na,1934,728
STAT,1899,44,35-39,1943,0.1719511406762475
STAT,1841,15,50-100,1856,0.04781348551398342
STAT,1844,110,na,1954,2.1863432798586828E-4
SIM,1932,29,45-49,1961,4
SIM,1789,85,na,1874,68
STAT,1833,42,20-24,1875,0.13664917265997187
SIM,1831,37,40-44,1868,4
SIM,1926,31,35-39,1957,5
STAT,1794,63,na,1857,881.6512769745443
STAT,1825,29,na,1854,1918.26638446523
STAT,1910,61,na,1971,3185.6638922973075
STAT,1924,41,30-34,1965,0.15388776203187338
STAT,1899,69,na,1968,2360.260674766026
STAT,1938,23,30-34,1961,28.70697898314967
SIM,1846,34,20-24,1880,5
STAT,1868,77,na,1945,834.3898494813857
STAT,1948,15,40-44,1963,1.617864937201271
STAT,1855,49,25-29,1904,0.04245146497531784
STAT,1946,25,na,1971,4218.3670870087235
STAT,1856,46,35-39,1902,0.1087162681263967
STAT,1875,87,na,1962,325.5154521483067
STAT,1924,47,45-49,1971,0.26146416284405816
SIM,1933,27,na,1960,4680
STAT,1868,17,45-49,1885,0.06419688540040737
SIM,1902,28,20-24,1930,4
STAT,1824,52,20-24,1876,8.323638277072923E-4
STAT,1854,35,45-49,1889,1.518976754580972
SIM,1833,37,45-49,1870,1
SIM,1887,5,na,1892,2899
STAT,1937,26,20-24,1963,17.971685585327062
STAT,1880,37,50-100,1917,1.3022796371462495
STAT,1954,8,na,1962,4908.57645816537
STAT,1838,34,20-24,1872,2.20227486597314
STAT,1894,22,40-44,1916,2.7096503310205904
STAT,1909,23,35-39,1932,8.803595013709034
SIM,1893,15,25-29,1908,8
STAT,1891,25,20-24,1916,14.76944956802249
STAT,1838,16,20-24,1854,15.769109761512548
SIM,1915,29,45-49,1944,3
STAT,1814,47,40-44,1861,0.41292419251470924
STAT,1880,22,40-44,1902,2.2103179086471543
SIM,1846,16,20-24,1862,20
STAT,1824,34,20-24,1858,4.227959569377902
SIM,1832,34,20-24,1866,2
STAT,1943,23,40-44,1966,3.610895862628278
STAT,1872,49,25-29,1921,0.057267052673795775
STAT,1882,22,45-49,1904,0.682222863804588
SIM,1822,80,na,1902,261
STAT,1821,36,50-100,1857,2.554564124639073
STAT,1907,41,30-34,1948,0.1189497674419414
STAT,1922,47,40-44,1969,0.18297766148795608
SIM,1898,38,30-34,1936,2
STAT,1875,28,45-49,1903,1.1475720906380427
SIM,1867,29,40-44,1896,5
SIM,1917,23,35-39,1940,10
SIM,1918,10,na,1928,4502
STAT,1777,91,na,1868,13.325826849341471
STAT,1808,57,na,1865,1067.6649104467658
STAT,1861,46,45-49,1907,0.19863246550475638
STAT,1872,82,na,1954,473.77754510306545
STAT,1907,29,45-49,1936,1.6212999930204899
SIM,1877,30,35-39,1907,13
STAT,1831,48,50-100,1879,0.1811120153470585
SIM,1852,31,40-44,1883,1
STAT,1875,40,30-34,1915,1.2044883062547502
STAT,1885,49,na,1934,2214.624107581046
SIM,1936,18,20-24,1954,141
STAT,1897,30,40-44,1927,5.9193704725806375
STAT,1865,53,20-24,1918,6.696236135444844E-4
SIM,1875,33,35-39,1908,12
SIM,1902,35,na,1937,3678
SIM,1928,26,20-24,1954,39
STAT,1833,24,20-24,1857,64.8398208161805
STAT,1895,4,na,1899,3469.780783871025
SIM,1806,90,na,1896,14
SIM,1871,40,40-44,1911,2
STAT,1930,37,20-24,1967,0.3475308659604984
SIM,1899,33,20-24,1932,4
STAT,1833,40,25-29,1873,0.5668788224184118
STAT,1899,26,35-39,1925,13.420779155604041
STAT,1902,37,15-19,1939,0.017299061003706467
STAT,1866,42,na,1908,2158.8854884346088
STAT,1812,50,35-39,1862,0.019780814425978434
STAT,1937,29,25-29,1966,64.70926855423744
SIM,1846,62,na,1908,1298
SIM,1956,15,40-44,1971,6
STAT,1878,51,50-100,1929,0.01591031209148972
SIM,1938,31,25-29,1969,11
STAT,1873,44,15-19,1917,0.013949153005331495
SIM,1867,42,40-44,1909,1
STAT,1894,8,na,1902,3380.281911406418
SIM,1842,42,35-39,1884,4
STAT,1810,53,35-39,1863,0.030915540322617258
STAT,1867,33,35-39,1900,9.592435583902725
STAT,1862,52,na,1914,1868.0388240344082
SIM,1926,29,20-24,1955,21
STAT,1867,49,15-19,1916,3.7254414070615966E-4
STAT,1871,97,na,1968,26.666479160440424
STAT,1922,29,40-44,1951,5.290132248409835
STAT,1859,42,40-44,1901,1.8249172429303462
STAT,1910,29,15-19,1939,0.6828607959556792
STAT,1882,40,45-49,1922,1.4790089288300512
STAT,1848,85,na,1933,223.81937138981638
STAT,1909,26,45-49,1935,1.6859974253859396
STAT,1926,23,40-44,1949,4.115667696752768
SIM,1930,29,40-44,1959,7
STAT,1923,28,na,1951,4330.379038288393
STAT,1895,33,40-44,1928,5.6958319536404565
STAT,1804,98,na,1902,1.007111588602744
STAT,1867,45,50-100,1912,0.23594919628240799
SIM,1841,24,20-24,1865,61
SIM,1861,21,40-44,1882,1
SIM,1884,23,50-100,1907,1
SIM,1831,23,20-24,1854,60
STAT,1943,26,45-49,1969,1.8586443034929947
STAT,1926,39,20-24,1965,0.3249078776875536
STAT,1928,18,20-24,1946,172.21499106191348
SIM,1833,36,na,1869,1884
STAT,1873,46,35-39,1919,0.14375432964778337
SIM,1851,49,na,1900,1731
STAT,1880,46,na,1926,2393.2052437003836
SIM,1890,33,30-34,1923,33
SIM,1914,20,na,1934,4010
STAT,1863,40,40-44,1903,2.0331643560769734
SIM,1934,23,40-44,1957,7
STAT,1855,16,20-24,1871,15.966153010583358
SIM,1838,67,na,1905,1274
STAT,1882,51,30-34,1933,0.005851526322968162
SIM,1810,95,na,1905,12
SIM,1890,40,45-49,1930,5
STAT,1935,16,45-49,1951,0.6916547410932068
SIM,1863,16,20-24,1879,24
SIM,1899,35,40-44,1934,10
SIM,1855,42,45-49,1897,1
STAT,1865,54,35-39,1919,0.007721418445122247
STAT,1919,15,45-49,1934,0.11234544801441654
STAT,1793,78,na,1871,301.7682822574371
STAT,1846,40,35-39,1886,1.4269338720107647
STAT,1854,57,na,1911,1508.201061483903
STAT,1941,29,45-49,1970,1.8025202708413646
STAT,1899,43,20-24,1942,0.015176473168465775
STAT,1865,36,35-39,1901,6.554440048085385
STAT,1889,39,na,1928,2904.589670401951
STAT,1838,46,15-19,1884,2.7903304216269617E-4
STAT,1841,19,na,1860,2187.9150766093558
STAT,1928,36,20-24,1964,0.33703953034505224
SIM,1873,36,35-39,1909,14
SIM,1918,19,15-19,1937,63
SIM,1847,32,45-49,1879,1
STAT,1827,34,50-100,1861,1.135489480133172
SIM,1873,64,na,1937,1609
SIM,1835,34,50-100,1869,2
STAT,1851,9,na,1860,2242.8819923236265
STAT,1847,42,45-49,1889,1.1268396970394163
STAT,1853,21,40-44,1874,2.0508303914617874
STAT,1931,23,na,1954,4771.948302933422
STAT,1824,53,35-39,1877,0.009519917079245035
STAT,1818,110,na,1928,1.42371257022425E-4
STAT,1832,45,35-39,1877,0.1159793025367111
STAT,1843,54,na,1897,1412.3065517063937
STAT,1889,36,20-24,1925,0.964631312272524
STAT,1882,33,30-34,1915,17.00958737441964
STAT,1933,19,45-49,1952,0.6721152167045816
SIM,1873,35,20-24,1908,4
SIM,1893,32,40-44,1925,8
STAT,1866,33,15-19,1899,0.13262225738976752
STAT,1868,35,45-49,1903,1.942569780451672
STAT,1854,53,45-49,1907,0.01071649907771947
SIM,1896,21,na,1917,3131
STAT,1857,43,20-24,1900,0.1242791744194817
STAT,1894,54,na,1948,2722.9209668574667
STAT,1865,35,20-24,1900,0.7176717068973522
SIM,1866,25,35-39,1891,15
SIM,1892,31,na,1923,3310
SIM,1937,17,na,1954,3485
SIM,1826,41,40-44,1867,6
SIM,1888,33,45-49,1921,2
STAT,1871,50,40-44,1921,0.010715503151187435
STAT,1828,45,15-19,1873,3.742218485450952E-4
STAT,1850,17,50-100,1867,0.045841214629141515
STAT,1935,31,35-39,1966,12.780939682112049
STAT,1950,16,40-44,1966,1.6713840598862095
SIM,1906,20,25-29,1926,143
SIM,1839,23,20-24,1862,77
STAT,1807,50,25-29,1857,0.012520170295713812
SIM,1905,15,na,1920,3867
STAT,1852,24,25-29,1876,50.83657491572848
SIM,1834,77,na,1911,479
SIM,1868,18,na,1886,2365
SIM,1860,24,25-29,1884,69
SIM,1927,30,na,1957,5112
STAT,1942,24,35-39,1966,9.961114109954636
SIM,1929,26,50-100,1955,1
SIM,1815,79,na,1894,247
STAT,1914,51,na,1965,3629.2795796509267
STAT,1895,36,15-19,1931,0.07442229306909633
SIM,1876,35,45-49,1911,3
STAT,1844,18,40-44,1862,0.182867766320069
STAT,1900,49,50-100,1949,0.1903132264255137
STAT,1952,7,na,1959,4759.068115330353
SIM,1834,32,35-39,1866,2
SIM,1897,36,20-24,1933,1
STAT,1857,45,40-44,1902,0.13629279712465023
SIM,1887,35,20-24,1922,1
STAT,1828,42,40-44,1870,2.14773049778592
STAT,1830,75,na,1905,679.177124893574
STAT,1874,41,25-29,1915,0.6671170707397707
SIM,1885,4,na,1889,2829
SIM,1944,22,50-100,1966,1
STAT,1845,80,na,1925,451.99967647531423
SIM,1858,32,20-24,1890,2
STAT,1871,47,15-19,1918,3.994981410578137E-4
SIM,1906,36,40-44,1942,1
STAT,1790,73,na,1863,427.17574333843896
STAT,1835,59,na,1894,1458.6627221984354
STAT,1891,44,35-39,1935,2.2338182184328788
STAT,1893,23,35-39,1916,7.460537168209032
SIM,1809,70,na,1879,629
STAT,1897,46,20-24,1943,0.009191646398572312
STAT,1893,39,15-19,1932,0.07129014084939725
STAT,1830,38,50-100,1868,1.1004439297070985
SIM,1861,4,na,1865,2595
SIM,1910,30,na,1940,3502
STAT,1894,48,50-100,1942,0.17788341757309714
SIM,1840,18,na,1858,2092
STAT,1856,50,45-49,1906,0.011399123030734492
SIM,1836,42,40-44,1878,9
STAT,1834,42,35-39,1876,1.3000851588167175
STAT,1847,24,15-19,1871,2.9847760759797666
STAT,1935,13,na,1948,5464.161325631906
STAT,1826,48,15-19,1874,3.888329430617269E-4
STAT,1936,27,15-19,1963,0.6820748681994
SIM,1858,34,40-44,1892,6
STAT,1936,22,50-100,1958,0.6350954858152674
SIM,1862,100,na,1962,2
STAT,1826,32,35-39,1858,14.202665471267611
STAT,1841,50,30-34,1891,0.004515371614868702
STAT,1887,72,na,1959,1551.4069378998738
SIM,1925,9,na,1934,4879
SIM,1927,30,40-44,1957,10
STAT,1886,40,50-100,1926,1.1379606264053728
STAT,1931,4,na,1935,5339.234244538014
SIM,1906,7,na,1913,3739
STAT,1849,53,35-39,1902,0.0066229441275772035
STAT,1850,43,35-39,1893,1.3765488919206468
SIM,1814,57,na,1871,1124
STAT,1855,79,na,1934,526.231094463469
STAT,1910,44,40-44,1954,0.2355646957464519
STAT,1905,15,20-24,1920,26.005635637773462
STAT,1830,46,15-19,1876,3.3893077507059E-4
STAT,1897,49,30-34,1946,0.07239229892607514
SIM,1908,33,40-44,1941,4
STAT,1860,26,na,1886,2005.8912306126854
SIM,1845,20,40-44,1865,3
STAT,1774,106,na,1880,0.008364729478938744
STAT,1841,19,30-34,1860,1.5192065540507036
SIM,1862,9,na,1871,2465
STAT,1891,26,35-39,1917,12.107181140326528
STAT,1833,95,na,1928,9.406536996168333
STAT,1842,52,40-44,1894,0.009427950130266686
STAT,1816,44,40-44,1860,6.011457345520971
SIM,1889,35,50-100,1924,2
STAT,1877,82,na,1959,622.0100246443077
STAT,1878,67,na,1945,1662.0292008833005
STAT,1901,41,35-39,1942,0.17884487844673416
STAT,1854,32,40-44,1886,3.3329554937945822
SIM,1839,21,na,1860,2027
SIM,1880,46,na,1926,2123
STAT,1920,48,15-19,1968,4.100621846873621E-4
SIM,1832,35,35-39,1867,8
SIM,1862,0,na,1862,3339
STAT,1849,21,15-19,1870,3.141066278719645
STAT,1824,35,35-39,1859,10.46138426296044
STAT,1900,21,25-29,1921,80.55871335870718
STAT,1855,70,na,1925,1056.123199257907
STAT,1887,26,15-19,1913,0.5133715612281231
STAT,1853,51,35-39,1904,0.007153553955886556
SIM,1857,74,na,1931,1026
STAT,1906,46,40-44,1952,0.14246937029631682
SIM,1913,15,20-24,1928,26
STAT,1887,41,35-39,1928,2.0511961921293573
STAT,1865,22,45-49,1887,0.6509265402575166
STAT,1845,35,50-100,1880,1.0575257203664923
STAT,1883,35,40-44,1918,4.367688522895259
STAT,1916,43,50-100,1959,0.12130229388028065
STAT,1880,25,15-19,1905,0.48451198457633216
SIM,1869,24,45-49,1893,5
STAT,1855,46,20-24,1901,0.009058295838773904
SIM,1843,82,na,1925,470
SIM,1857,21,15-19,1878,4
STAT,1851,80,na,1931,468.39356028174177
STAT,1916,34,35-39,1950,9.4396867805895
SIM,1883,25,40-44,1908,3
STAT,1851,22,15-19,1873,2.983076203907695
SIM,1840,77,na,1917,653
SIM,1899,47,50-100,1946,3
STAT,1880,25,45-49,1905,1.1857001492704013
SIM,1919,39,25-29,1958,5
STAT,1860,19,35-39,1879,0.5163506830607292
STAT,1848,35,20-24,1883,0.6621841944494599
STAT,1938,26,35-39,1964,15.022583381489138
STAT,1796,98,na,1894,0.6805738125488381
SIM,1824,44,40-44,1868,3
SIM,1900,30,30-34,1930,53
STAT,1852,38,15-19,1890,0.042375935078816616
STAT,1820,42,40-44,1862,4.24397339121224
STAT,1929,13,na,1942,5103.0828425638265
STAT,1815,42,30-34,1857,2.981728379006656
SIM,1849,45,50-100,1894,2
SIM,1952,19,20-24,1971,1
STAT,1917,36,45-49,1953,0.718167452097681
STAT,1849,70,na,1919,1096.99762726786
STAT,1864,16,na,1880,2392.2945226045645
STAT,1799,63,na,1862,882.7550457173735
STAT,1817,41,20-24,1858,0.4062039889744621
SIM,1831,40,50-100,1871,4
STAT,1851,40,15-19,1891,0.01056214562254044
SIM,1884,22,20-24,1906,5
SIM,1856,35,20-24,1891,4
SIM,1909,17,20-24,1926,27
SIM,1926,45,na,1971,4562
SIM,1898,34,50-100,1932,5
SIM,1925,36,45-49,1961,3
STAT,1833,45,25-29,1878,0.049155009006098906
STAT,1877,38,20-24,1915,0.7995652431723189
STAT,1884,15,35-39,1899,0.54905073691706
SIM,1924,34,35-39,1958,16
STAT,1839,32,45-49,1871,1.5214376469085507
STAT,1944,19,20-24,1963,147.23176020060066
STAT,1859,25,25-29,1884,35.463515366092814
STAT,1918,47,15-19,1965,3.9575581506005853E-4
STAT,1921,16,15-19,1937,52.37550332562471
STAT,1930,8,na,1938,5211.690432248505
STAT,1841,37,30-34,1878,4.695744685929833
SIM,1863,74,na,1937,842
STAT,1883,82,na,1965,739.6495429869342
SIM,1934,12,na,1946,5532
STAT,1842,60,na,1902,1717.100113477593
STAT,1885,19,40-44,1904,0.18289323731640522
SIM,1908,51,na,1959,3149
SIM,1843,21,20-24,1864,85
STAT,1834,107,na,1941,0.002807070136322777
STAT,1842,34,40-44,1876,4.619784216854252
STAT,1814,45,20-24,1859,0.029931957235786358
STAT,1836,19,20-24,1855,19.77535060937169
STAT,1847,44,na,1891,1707.1521432748677
SIM,1917,26,45-49,1943,6
STAT,1940,27,35-39,1967,15.456007157227567
SIM,1826,28,40-44,1854,3
STAT,1895,39,na,1934,3076.172518978692
STAT,1858,16,na,1874,2137.2793744642554
STAT,1881,36,20-24,1917,0.7540839112784654
SIM,1827,36,na,1863,1626
STAT,1787,78,na,1865,257.62266213519626
STAT,1913,25,20-24,1938,18.475935308653376
SIM,1891,35,40-44,1926,5
STAT,1823,40,50-100,1863,1.6470571582974447
STAT,1904,47,20-24,1951,0.009765375393740915
STAT,1918,29,20-24,1947,19.47198857101476
STAT,1875,43,35-39,1918,1.8646399640827582
SIM,1883,43,35-39,1926,5
STAT,1867,0,na,1867,3595.835067976627
STAT,1924,44,40-44,1968,0.299640854621752
SIM,1844,19,20-24,1863,17
STAT,1874,46,25-29,1920,0.05973844835259947
SIM,1850,34,40-44,1884,3
STAT,1861,43,40-44,1904,1.874135643715636
STAT,1837,20,40-44,1857,1.979830977681303
SIM,1819,69,na,1888,722
SIM,1862,32,40-44,1894,6
STAT,1875,25,40-44,1900,3.1281305151919114
STAT,1830,107,na,1937,0.003111302484940179
STAT,1818,47,na,1865,1444.7751635863665
SIM,1867,25,25-29,1892,47
STAT,1827,34,45-49,1861,2.1610928948841455
SIM,1803,54,na,1857,1075
SIM,1797,80,na,1877,248
STAT,1835,21,20-24,1856,69.27689562544715
STAT,1945,20,40-44,1965,3.724142740889399
STAT,1913,38,na,1951,3727.470723292739
SIM,1895,76,na,1971,1717
STAT,1879,50,40-44,1929,0.011255596913481854
STAT,1894,25,45-49,1919,1.4535614037204954
SIM,1864,43,30-34,1907,4
SIM,1919,20,35-39,1939,13
STAT,1808,52,35-39,1860,0.029144549677370683
SIM,1821,34,45-49,1855,1
STAT,1863,29,30-34,1892,22.37396236340984
STAT,1917,18,45-49,1935,0.1082221644101737
STAT,1849,50,30-34,1899,0.004720898242408501
STAT,1835,19,na,1854,2267.8920150807967
STAT,1843,31,20-24,1874,2.2146246722347933
SIM,1879,40,40-44,1919,6
STAT,1872,33,45-49,1905,1.763241065607564
STAT,1884,36,na,1920,2357.835518713223
STAT,1880,43,45-49,1923,1.5760341877433803
SIM,1932,26,40-44,1958,8
SIM,1882,28,25-29,1910,47
STAT,1821,106,na,1927,0.007272774233601733
SIM,1892,71,na,1963,2038
STAT,1874,28,25-29,1902,43.59369732612174
STAT,1902,66,na,1968,2646.5535446910717
STAT,1932,36,40-44,1968,2.0344846526392115
SIM,1948,20,30-34,1968,40
STAT,1869,46,15-19,1915,3.9389824936122227E-4
SIM,1803,85,na,1888,84
SIM,1880,33,45-49,1913,3
STAT,1813,52,45-49,1865,0.040131144062090326
SIM,1845,21,na,1866,2144
SIM,1851,31,20-24,1882,2
SIM,1879,89,na,1968,208
SIM,1940,12,na,1952,4198
STAT,1924,26,40-44,1950,5.502865155912125
SIM,1835,34,45-49,1869,2
STAT,1850,25,35-39,1875,8.820785074944393
SIM,1913,29,40-44,1942,5
SIM,1904,28,25-29,1932,9
STAT,1816,40,25-29,1856,1.9878780443062152
STAT,1873,32,45-49,1905,1.7855162301074698
SIM,1845,39,30-34,1884,2
SIM,1849,27,30-34,1876,41
SIM,1807,75,na,1882,517
STAT,1923,15,35-39,1938,5.001598170296736
STAT,1857,16,25-29,1873,5.281095868651954
SIM,1863,30,35-39,1893,13
STAT,1827,55,na,1882,1310.1541781302897
SIM,1953,17,15-19,1970,52
STAT,1888,37,15-19,1925,0.06694250907499824
STAT,1860,44,35-39,1904,1.474875499068804
SIM,1886,33,40-44,1919,13
SIM,1790,70,na,1860,754
SIM,1819,42,40-44,1861,6
STAT,1773,107,na,1880,0.008399348935845591
SIM,1925,35,na,1960,4552
STAT,1831,60,na,1891,1198.472673454643
STAT,1856,44,15-19,1900,0.010549246495596834
STAT,1884,49,15-19,1933,3.9007942641771146E-4
STAT,1840,35,20-24,1875,0.6525198486349378
STAT,1885,49,50-100,1934,0.2417556327144382
STAT,1945,15,na,1960,4062.726157340528
STAT,1900,28,45-49,1928,1.5522843225651657
STAT,1878,33,40-44,1911,4.527663397599112
SIM,1880,16,20-24,1896,22
SIM,1921,25,20-24,1946,26
SIM,1794,60,na,1854,947
STAT,1831,100,na,1931,0.6671382806869951
STAT,1911,46,20-24,1957,0.01058125332196983
STAT,1868,19,50-100,1887,0.04758215491136893
STAT,1858,42,20-24,1900,0.12568638437352891
STAT,1956,9,na,1965,5252.912068672077
SIM,1864,84,na,1948,309
STAT,1823,38,25-29,1861,4.795748201546886
SIM,1886,30,50-100,1916,1
SIM,1836,41,na,1877,1883
STAT,1922,43,na,1965,4299.647631864122
STAT,1947,15,20-24,1962,154.3455175248775
SIM,1873,36,na,1909,2275
SIM,1831,38,25-29,1869,2
STAT,1836,33,50-100,1869,0.7230625620071222
SIM,1873,38,25-29,1911,4
STAT,1919,27,15-19,1946,0.7701579651470877
STAT,1910,1,na,1911,4161.15452046797
SIM,1815,70,na,1885,718
SIM,1931,15,35-39,1946,8
STAT,1837,50,40-44,1887,0.007499447766834796
STAT,1805,100,na,1905,0.42144764161755327
SIM,1923,32,25-29,1955,20
STAT,1825,52,35-39,1877,0.011140093116030259
STAT,1870,22,50-100,1892,0.40444173290646823
SIM,1871,54,50-100,1925,1
STAT,1945,17,15-19,1962,50.066373688716546
STAT,1883,31,25-29,1914,10.164867515008886
SIM,1865,16,25-29,1881,12
SIM,1892,32,20-24,1924,4
SIM,1858,39,40-44,1897,6
SIM,1840,27,40-44,1867,2
SIM,1899,41,na,1940,3515
SIM,1909,29,20-24,1938,22
SIM,1918,40,40-44,1958,1
STAT,1812,48,20-24,1860,0.027237594675660837
STAT,1874,45,40-44,1919,0.17881840302226618
STAT,1881,24,20-24,1905,66.67082340885635
STAT,1943,17,50-100,1960,0.4011567289621741
SIM,1955,15,20-24,1970,194
STAT,1876,32,na,1908,2488.5476381739695
STAT,1933,5,na,1938,5438.979769096809
STAT,1950,3,na,1953,4738.190551585869
STAT,1909,23,40-44,1932,3.143701782842633
STAT,1893,0,na,1893,3765.6797196521675
STAT,1884,18,45-49,1902,0.06489042895189003
STAT,1931,23,15-19,1954,6.956015063432541
SIM,1824,56,na,1880,1304
SIM,1826,44,45-49,1870,1
SIM,1814,41,45-49,1855,6
SIM,1877,28,20-24,1905,19
SIM,1888,19,30-34,1907,3
STAT,1931,37,40-44,1968,2.003677711980838
SIM,1903,1,na,1904,3645
STAT,1884,32,20-24,1916,2.692233000754594
STAT,1915,32,25-29,1947,9.498485488273172
STAT,1924,44,35-39,1968,0.2412304346987848
STAT,1834,24,40-44,1858,1.636073588579
STAT,1856,43,30-34,1899,0.88381039017655
SIM,1891,31,25-29,1922,17
SIM,1885,21,na,1906,2501
SIM,1875,17,30-34,1892,2
SIM,1881,68,na,1949,1393
STAT,1802,60,na,1862,976.3751799078664
STAT,1847,42,15-19,1889,0.010397598857231518
SIM,1873,33,na,1906,2344
STAT,1923,27,35-39,1950,17.416294642681347
SIM,1878,39,20-24,1917,1
STAT,1844,39,na,1883,1929.2633270204685
STAT,1886,31,na,1917,2555.1448400013323
SIM,1926,2,na,1928,4994
STAT,1878,51,40-44,1929,0.011090575863405113
STAT,1892,43,35-39,1935,2.2784092195982875
STAT,1896,47,20-24,1943,0.009007429300165038
STAT,1911,28,20-24,1939,17.89635327677293
SIM,1944,25,50-100,1969,1
SIM,1898,36,40-44,1934,5
STAT,1870,25,50-100,1895,0.6387436348501124
SIM,1931,27,35-39,1958,26
STAT,1807,54,40-44,1861,0.03430908685815583
SIM,1884,23,35-39,1907,6
STAT,1867,9,na,1876,2603.475236352911
SIM,1917,23,40-44,1940,3
SIM,1858,37,45-49,1895,1
SIM,1899,38,45-49,1937,3
STAT,1860,50,35-39,1910,0.007210010950511867
SIM,1833,92,na,1925,29
STAT,1872,16,20-24,1888,18.16814651815047
STAT,1891,41,30-34,1932,1.4441400098956314
STAT,1824,50,30-34,1874,0.006986520482112256
STAT,1931,37,50-100,1968,0.5619644159938205
STAT,1783,88,na,1871,47.441329093721095
STAT,1827,52,na,1879,1390.2968355026055
SIM,1826,35,50-100,1861,1
STAT,1832,27,40-44,1859,2.7513780838326776
STAT,1851,42,35-39,1893,1.3694380099741421
STAT,1889,23,45-49,1912,0.8657567572613091
SIM,1819,60,na,1879,1090
STAT,1878,18,15-19,1896,6.2058061571967205
STAT,1914,22,30-34,1936,29.626232945711873
SIM,1950,21,30-34,1971,49
STAT,1839,18,30-34,1857,1.4695107795099567
STAT,1840,17,20-24,1857,16.090204868429108
STAT,1837,39,30-34,1876,4.3358058263763875
SIM,1900,33,35-39,1933,23
STAT,1798,103,na,1901,0.04775135624631756
STAT,1882,34,15-19,1916,0.13813136300071868
STAT,1855,30,35-39,1885,7.924512498515585
STAT,1897,49,25-29,1946,0.04307640886316147
STAT,1922,18,25-29,1940,50.532749327635244
STAT,1850,43,50-100,1893,0.8030962051057411
STAT,1847,36,15-19,1883,0.04407889277734795
STAT,1905,15,15-19,1920,8.705276347628937
SIM,1929,25,20-24,1954,27
STAT,1884,50,20-24,1934,7.45525762792379E-4
STAT,1848,51,25-29,1899,0.002905743017269949
SIM,1951,9,na,1960,4989
STAT,1876,44,50-100,1920,1.0868423323449041
SIM,1805,89,na,1894,30
SIM,1897,23,45-49,1920,2
STAT,1903,36,15-19,1939,0.017518155049265148
SIM,1930,18,25-29,1948,73
STAT,1890,29,25-29,1919,51.83362516710449
STAT,1815,43,15-19,1858,0.03403715912126484
STAT,1843,17,45-49,1860,0.05630299746128777
SIM,1855,24,15-19,1879,3
STAT,1820,104,na,1924,0.033951806922227754
SIM,1918,50,na,1968,4104
SIM,1967,0,na,1967,5087
STAT,1918,13,na,1931,4347.231883513243
SIM,1878,27,20-24,1905,21
STAT,1840,23,20-24,1863,60.99080542235925
SIM,1913,15,15-19,1928,10
STAT,1839,40,na,1879,1771.1928071180898
STAT,1838,52,45-49,1890,0.009663276309463892
STAT,1894,24,50-100,1918,0.5269447446016444
SIM,1886,21,40-44,1907,3
STAT,1942,21,30-34,1963,30.436143722260685
STAT,1859,45,45-49,1904,0.19362247423439802
STAT,1861,16,45-49,1877,0.06338705918464779
STAT,1887,27,20-24,1914,13.228923510852976
STAT,1936,33,45-49,1969,1.5421033606733403
STAT,1941,22,25-29,1963,96.37225823908689
STAT,1899,38,na,1937,3275.185340303522
STAT,1842,49,45-49,1891,0.2080425990567009
SIM,1854,69,na,1923,1374
SIM,1900,1,na,1901,3936
STAT,1815,67,na,1882,800.5264613086387
STAT,1916,31,30-34,1947,16.482254024951047
SIM,1932,17,na,1949,5458
STAT,1873,48,30-34,1921,0.09786906996043467
STAT,1838,39,na,1877,1694.5180020368275
STAT,1910,4,na,1914,4021.761637241133
SIM,1875,68,na,1943,1581
STAT,1906,45,35-39,1951,0.11733370238440313
STAT,1872,30,40-44,1902,4.438989214867361
SIM,1897,71,na,1968,2001
STAT,1859,69,na,1928,1192.1377013241545
STAT,1871,17,20-24,1888,17.90412704281566
SIM,1879,21,na,1900,2750
SIM,1918,22,40-44,1940,5
STAT,1915,20,25-29,1935,93.0050438455194
STAT,1945,21,50-100,1966,0.7285327437085429
STAT,1846,44,20-24,1890,0.11889400446896574
STAT,1841,32,30-34,1873,15.841590207754262
STAT,1833,47,45-49,1880,0.19630401581316037
SIM,1923,39,45-49,1962,1
STAT,1853,49,20-24,1902,0.009716519071342102
STAT,1888,43,45-49,1931,1.771273850060491
SIM,1889,29,25-29,1918,67
SIM,1890,36,na,1926,3214
STAT,1828,77,na,1905,561.1263529454362
STAT,1898,42,25-29,1940,0.06098154750625484
SIM,1839,26,25-29,1865,50
STAT,1869,87,na,1956,191.87439308887747
SIM,1895,27,20-24,1922,3
STAT,1836,36,50-100,1872,0.9605957782470426
STAT,1789,73,na,1862,603.9042239022455
STAT,1927,21,35-39,1948,11.760969719069672
SIM,1858,20,20-24,1878,80
SIM,1866,54,na,1920,2107
STAT,1931,19,40-44,1950,1.8403533436035402
STAT,1832,31,45-49,1863,1.56889941311299
STAT,1861,18,40-44,1879,0.17539920689411642
STAT,1832,31,15-19,1863,0.12812276213619744
SIM,1822,52,na,1874,1401
STAT,1832,43,15-19,1875,0.011390343301857266
STAT,1925,42,50-100,1967,0.14374160608202136
SIM,1860,22,35-39,1882,8
SIM,1887,53,na,1940,2255
STAT,1856,15,50-100,1871,0.04539077317229464
STAT,1877,41,50-100,1918,1.106253068883023
STAT,1896,29,20-24,1925,15.571929290247585
STAT,1873,50,45-49,1923,0.015072935431803791
STAT,1909,61,na,1970,3138.082087917162
STAT,1850,40,30-34,1890,0.8891995641217336
SIM,1871,25,45-49,1896,1
STAT,1829,44,20-24,1873,0.11973933557526327
STAT,1837,54,na,1891,1428.4547009452763
STAT,1866,50,30-34,1916,0.005647018564963837
STAT,1879,53,45-49,1932,0.01505048682831199
SIM,1889,17,25-29,1906,16
SIM,1866,2,na,1868,3089
STAT,1843,85,na,1928,184.89484347048165
STAT,1811,49,15-19,1860,9.642454661936504E-4
STAT,1784,100,na,1884,0.18821080577933572
SIM,1923,20,25-29,1943,129
STAT,1829,38,20-24,1867,0.6212393390671525
STAT,1868,46,na,1914,2177.916768664648
SIM,1905,25,35-39,1930,18
STAT,1796,58,na,1854,963.9999999999998
STAT,1861,23,50-100,1884,0.34908259981074036
STAT,1863,25,45-49,1888,1.0080221345827787
SIM,1857,35,40-44,1892,9
STAT,1896,35,20-24,1931,1.040351614041823
SIM,1902,66,na,1968,2713
STAT,1910,47,15-19,1957,3.4675196119653595E-4
SIM,1840,45,50-100,1885,1
STAT,1906,49,45-49,1955,0.1917497084836402
STAT,1951,15,na,1966,4430.734942648412
SIM,1853,44,na,1897,1732
SIM,1845,35,45-49,1880,2
STAT,1852,22,35-39,1874,5.257383262544216
SIM,1854,26,20-24,1880,15
SIM,1840,31,45-49,1871,1
SIM,1867,22,20-24,1889,76
STAT,1891,49,na,1940,2755.1478198656587
STAT,1832,25,15-19,1857,0.4265499928927049
STAT,1900,43,40-44,1943,0.2175593498060571
STAT,1916,19,45-49,1935,0.10638307141428664
STAT,1849,35,40-44,1884,3.5756792963400383
STAT,1821,67,na,1888,947.1061046370162
SIM,1940,20,25-29,1960,107
SIM,1837,26,20-24,1863,12
STAT,1837,30,50-100,1867,0.8001606148882663
SIM,1901,25,na,1926,3453
STAT,1835,106,na,1941,0.009112918501953829
SIM,1848,28,25-29,1876,62
SIM,1880,30,40-44,1910,4
STAT,1885,25,50-100,1910,0.6474699390127546
STAT,1859,22,20-24,1881,58.081220846032565
STAT,1809,109,na,1918,3.285157435862629E-4
STAT,1892,40,30-34,1932,1.4717679094790381
SIM,1849,25,35-39,1874,15
SIM,1909,31,35-39,1940,14
STAT,1888,25,15-19,1913,0.5445334974298837
STAT,1896,17,20-24,1913,23.70164950991903
SIM,1835,37,50-100,1872,1
STAT,1905,47,40-44,1952,0.14034570894587323
STAT,1898,17,25-29,1915,7.758934276395537
SIM,1891,9,na,1900,3391
STAT,1801,54,50-100,1855,0.054733172073228566
SIM,1937,33,30-34,1970,26
STAT,1841,33,15-19,1874,0.12787491645123977
STAT,1897,44,30-34,1941,0.1066425483318171
STAT,1841,44,50-100,1885,0.8001720316145531
SIM,1837,26,na,1863,1748
STAT,1842,30,25-29,1872,11.373900696181876
SIM,1848,69,na,1917,1061
STAT,1837,35,45-49,1872,1.6905528060154467
SIM,1928,26,15-19,1954,1
STAT,1864,39,25-29,1903,2.5976533510729114
STAT,1932,39,45-49,1971,0.9236775722295109
STAT,1855,34,20-24,1889,2.0291120058625367
STAT,1905,29,40-44,1934,4.342552210569712
STAT,1808,88,na,1896,51.75694258044731
STAT,1846,26,20-24,1872,10.848102008355285
SIM,1924,31,30-34,1955,24
STAT,1852,22,na,1874,1926.3123278472044
SIM,1948,23,35-39,1971,14
SIM,1842,41,na,1883,1752
STAT,1817,93,na,1910,13.371270297547305
STAT,1929,33,30-34,1962,20.214989413678474
STAT,1907,17,45-49,1924,0.09688815956412537
SIM,1838,36,na,1874,1812
STAT,1945,24,50-100,1969,0.7277971732379086
STAT,1915,39,45-49,1954,0.6879159010721903
SIM,1863,28,20-24,1891,10
SIM,1885,40,35-39,1925,4
STAT,1857,43,15-19,1900,0.010806885315818082
SIM,1850,30,25-29,1880,19
SIM,1943,28,50-100,1971,1
SIM,1813,75,na,1888,435
STAT,1823,41,45-49,1864,2.2767932671142734
STAT,1885,22,50-100,1907,0.4099670820212758
SIM,1848,16,25-29,1864,7
STAT,1876,22,20-24,1898,71.86490790531721
STAT,1873,28,40-44,1901,3.0563900470150482
STAT,1795,73,na,1868,576.726008761779
STAT,1936,15,45-49,1951,0.4850782520987398
SIM,1829,62,na,1891,1183
SIM,1841,101,na,1942,5
SIM,1949,20,15-19,1969,7
STAT,1877,40,35-39,1917,1.9066814240859793
SIM,1782,75,na,1857,205
SIM,1881,28,40-44,1909,3
STAT,1821,33,50-100,1854,3.157290293669524
STAT,1888,43,15-19,1931,0.016343935173406324
STAT,1806,93,na,1899,9.853688928567676
STAT,1874,46,na,1920,2333.3680221117143
STAT,1898,48,30-34,1946,0.07382386137443708
SIM,1830,28,30-34,1858,29
STAT,1873,21,na,1894,2428.9069098181544
SIM,1897,46,na,1943,3096
STAT,1928,8,na,1936,5079.5964379579445
STAT,1932,20,25-29,1952,123.20966205666927
SIM,1861,48,na,1909,1932
SIM,1865,69,na,1934,1200
SIM,1880,19,25-29,1899,7
SIM,1869,28,na,1897,2279
SIM,1825,29,35-39,1854,10
STAT,1905,46,na,1951,3294.9240499859534
STAT,1840,38,25-29,1878,2.3624743485933335
STAT,1904,21,na,1925,3438.295191339917
SIM,1891,21,na,1912,3018
SIM,1874,18,25-29,1892,9
STAT,1834,27,45-49,1861,0.8670773365576373
STAT,1827,28,15-19,1855,0.9107950414607111
STAT,1844,95,na,1939,10.519219859595793
STAT,1883,33,15-19,1916,0.14015769059093153
STAT,1819,37,20-24,1856,2.2367551149939318
STAT,1890,33,50-100,1923,1.1260224187028505
SIM,1906,25,na,1931,3414
STAT,1876,29,40-44,1905,3.1015755548086843
STAT,1874,48,45-49,1922,0.24100201151341302
STAT,1817,46,50-100,1863,0.5365933160499442
SIM,1864,39,50-100,1903,1
STAT,1890,26,20-24,1916,14.528184038377614
STAT,1878,36,45-49,1914,2.1001403221216557
STAT,1869,31,40-44,1900,4.275878409040934
SIM,1901,22,na,1923,3426
STAT,1912,23,50-100,1935,0.6342399721920043
STAT,1934,18,50-100,1952,0.5107026081762319
STAT,1837,17,15-19,1854,8.012113745492924
STAT,1863,25,15-19,1888,0.41190751744789733
SIM,1944,15,15-19,1959,44
STAT,1775,96,na,1871,1.1079179089684754
STAT,1762,111,na,1873,8.082748898543938E-4
SIM,1885,22,35-39,1907,7
SIM,1899,34,35-39,1933,2
STAT,1936,15,15-19,1951,44.069368120865455
STAT,1868,47,45-49,1915,0.22674659037643768
STAT,1855,28,20-24,1883,9.138244690650435
STAT,1834,54,35-39,1888,0.005052915508864361
STAT,1897,34,na,1931,3203.5411891631916
SIM,1908,18,15-19,1926,10
STAT,1829,26,20-24,1855,19.451359254151594
SIM,1871,29,30-34,1900,39
SIM,1817,38,40-44,1855,5
STAT,1940,15,35-39,1955,4.303495650179248
SIM,1855,70,na,1925,1230
SIM,1853,27,20-24,1880,15
STAT,1856,80,na,1936,479.0077229766784
STAT,1823,37,40-44,1860,7.622421464739082
STAT,1850,22,30-34,1872,16.37037710115508
STAT,1866,18,25-29,1884,5.40768090313613
SIM,1939,17,30-34,1956,19
STAT,1838,40,50-100,1878,0.8485390568691005
SIM,1851,18,na,1869,2298
STAT,1816,42,15-19,1858,0.03962268336503815
STAT,1844,16,45-49,1860,0.06608610228033697
STAT,1890,28,40-44,1918,3.6839941589167
STAT,1832,47,30-34,1879,0.07816108148937416
SIM,1787,81,na,1868,154
STAT,1894,19,15-19,1913,7.675522075560602
STAT,1820,107,na,1927,0.0024005255349791505
SIM,1919,35,na,1954,4000
STAT,1845,40,na,1885,1764.3615264807652
STAT,1940,31,na,1971,3953.961330116872
SIM,1843,28,40-44,1871,4
STAT,1823,35,20-24,1858,1.4596790820604073
STAT,1804,67,na,1871,706.4175135332748
STAT,1862,21,na,1883,2126.9815418793128
STAT,1876,72,na,1948,1317.0010387065156
STAT,1904,16,15-19,1920,8.62277528733479
STAT,1913,28,25-29,1941,65.93891339871132
STAT,1842,36,30-34,1878,5.687643309115163
STAT,1900,25,40-44,1925,4.231322805149723
SIM,1833,67,na,1900,1093
STAT,1837,53,45-49,1890,0.009741686426555164
SIM,1825,46,50-100,1871,2
STAT,1845,27,20-24,1872,10.433662875938472
STAT,1854,39,30-34,1893,3.95952054080238
STAT,1883,47,40-44,1930,0.16842031039499553
STAT,1921,22,45-49,1943,1.283546684487061
SIM,1912,16,15-19,1928,12
SIM,1921,28,25-29,1949,90
SIM,1823,74,na,1897,683
STAT,1838,34,15-19,1872,0.11602442661906423
STAT,1946,16,15-19,1962,50.85410475872371
STAT,1873,32,15-19,1905,0.14581258003434783
STAT,1835,22,35-39,1857,5.824217145703672
SIM,1844,21,35-39,1865,5
SIM,1882,72,na,1954,1005
SIM,1842,44,na,1886,1677
STAT,1938,25,20-24,1963,18.272573664609098
SIM,1830,56,na,1886,1142
SIM,1864,28,na,1892,2552
SIM,1820,35,45-49,1855,1
STAT,1911,15,45-49,1926,0.10131904681788347
SIM,1850,36,30-34,1886,8
SIM,1945,12,na,1957,4209
STAT,1895,21,40-44,1916,2.756765400614539
SIM,1922,23,15-19,1945,8
STAT,1867,15,35-39,1882,0.539925111208541
STAT,1939,12,na,1951,3995.2541039537705
STAT,1878,54,45-49,1932,0.014797190523258947
SIM,1889,9,na,1898,3236
SIM,1874,35,50-100,1909,1
SIM,1843,22,35-39,1865,7
STAT,1828,49,30-34,1877,0.0858894483875399
STAT,1842,32,15-19,1874,0.15488638365216742
STAT,1925,43,40-44,1968,0.30555455356367545
STAT,1866,35,50-100,1901,1.1591298548038984
SIM,1899,21,20-24,1920,127
STAT,1861,36,na,1897,1986.8417666906576
SIM,1836,30,40-44,1866,9
STAT,1897,31,na,1928,3244.410230227812
SIM,1848,66,na,1914,1249
STAT,1914,23,15-19,1937,5.470137898425456
STAT,1845,18,na,1863,2107.4084384922203
STAT,1849,6,na,1855,2400.9546
SIM,1934,29,50-100,1963,1
STAT,1858,47,na,1905,1774.4324010294101
STAT,1926,29,50-100,1955,1.1972978201165856
SIM,1901,9,na,1910,3784
STAT,1788,109,na,1897,1.995944744944841E-4
STAT,1881,20,35-39,1901,5.715119225416049
STAT,1933,34,35-39,1967,12.428581472515473
STAT,1837,35,15-19,1872,0.047621211466578
STAT,1836,21,35-39,1857,4.893508702569621
STAT,1850,27,25-29,1877,38.11747677913914
SIM,1954,16,15-19,1970,53
SIM,1906,32,25-29,1938,11
STAT,1901,20,30-34,1921,25.370128397462725
STAT,1870,24,45-49,1894,0.6872658299099201
STAT,1879,49,40-44,1928,0.1766772203950102
SIM,1918,25,45-49,1943,1
STAT,1851,18,na,1869,2100.741527628913
STAT,1914,25,35-39,1939,15.374182775180216
STAT,1879,47,20-24,1926,0.012589032736986099
STAT,1903,48,15-19,1951,3.204756464029765E-4
SIM,1913,10,na,1923,4082
STAT,1869,90,na,1959,121.44159040689804
STAT,1872,19,25-29,1891,5.723256287614024
STAT,1858,27,30-34,1885,20.42661494583544
STAT,1875,42,20-24,1917,0.164520851914206
STAT,1782,78,na,1860,303.5159763117349
SIM,1922,25,35-39,1947,32
STAT,1891,23,30-34,1914,22.205045317709832
STAT,1891,43,50-100,1934,1.3115269296042897
SIM,1888,21,45-49,1909,3
STAT,1881,18,20-24,1899,17.214664880149243
SIM,1866,27,30-34,1893,35
STAT,1944,21,35-39,1965,10.269519914955952
STAT,1812,93,na,1905,13.268651786618506
STAT,1808,51,20-24,1859,0.002550063723822401
SIM,1877,54,na,1931,2197
STAT,1923,45,35-39,1968,0.15310961067232418
STAT,1824,32,30-34,1856,34.08052930492701
SIM,1862,20,40-44,1882,4
STAT,1927,19,20-24,1946,169.46939132635381
SIM,1832,32,30-34,1864,20
SIM,1939,12,na,1951,4089
STAT,1866,53,35-39,1919,0.007922197540116025
SIM,1867,24,40-44,1891,6
STAT,1882,44,50-100,1926,1.0196257825259745
STAT,1922,15,20-24,1937,159.24498131778768
SIM,1890,44,50-100,1934,1
STAT,1846,47,25-29,1893,0.04350798237540768
STAT,1882,72,na,1954,1235.550157290438
SIM,1842,29,50-100,1871,3
SIM,1858,28,na,1886,1960
SIM,1886,18,15-19,1904,6
SIM,1883,34,50-100,1917,1
STAT,1841,35,35-39,1876,6.362527839025274
STAT,1864,24,15-19,1888,3.0113253695100126
SIM,1856,22,45-49,1878,5
STAT,1827,46,45-49,1873,0.24529534517151846
STAT,1822,42,45-49,1864,2.3811249179039837
STAT,1816,46,30-34,1862,0.254080790912332
STAT,1956,15,na,1971,4922.830417879118
STAT,1927,0,na,1927,5661.790015996891
STAT,1917,49,20-24,1966,0.011583062030305407
SIM,1857,38,45-49,1895,2
STAT,1850,45,25-29,1895,0.044544824469678064
STAT,1870,47,na,1917,2220.962885980386
SIM,1817,74,na,1891,565
STAT,1898,44,15-19,1942,0.0012953241136354813
SIM,1852,34,45-49,1886,2
SIM,1903,32,45-49,1935,2
SIM,1794,63,na,1857,811
SIM,1946,25,20-24,1971,19
STAT,1912,28,na,1940,3711.410202793931
STAT,1864,87,na,1951,160.56890677605395
STAT,1842,46,40-44,1888,0.15615086286112653
STAT,1839,20,45-49,1859,0.6444433201938872
SIM,1872,24,15-19,1896,3
STAT,1883,37,30-34,1920,5.267601903786202
STAT,1901,35,35-39,1936,2.1820154648391634
STAT,1843,48,15-19,1891,2.6639700754916196E-4
SIM,1930,15,20-24,1945,244
STAT,1859,24,40-44,1883,1.7311578909282694
STAT,1924,13,na,1937,4760.598576998693
STAT,1919,19,50-100,1938,0.4157901486018413
SIM,1891,37,30-34,1928,8
STAT,1864,47,na,1911,2040.9166031083817
SIM,1923,36,40-44,1959,2
STAT,1824,37,25-29,1861,4.015451852632488
SIM,1769,93,na,1862,7
STAT,1920,36,15-19,1956,0.021251562330276162
STAT,1818,44,45-49,1862,2.7508805354947246
STAT,1828,30,40-44,1858,5.476637576796208
STAT,1844,34,45-49,1878,1.615961952920438
STAT,1873,26,15-19,1899,0.4661445866998223
STAT,1945,12,na,1957,4333.489646447078
SIM,1847,20,45-49,1867,4
STAT,1870,87,na,1957,213.16817130057274
SIM,1861,1,na,1862,3167
STAT,1933,27,na,1960,5026.424912139356
SIM,1907,10,na,1917,4080
STAT,1906,42,30-34,1948,0.11730142278989397
SIM,1901,44,40-44,1945,1
STAT,1901,39,20-24,1940,0.2332007956072047
STAT,1860,31,20-24,1891,2.2408372929544256
SIM,1888,35,na,1923,2949
SIM,1923,5,na,1928,4801
STAT,1936,30,40-44,1966,3.841780547899334
STAT,1870,51,35-39,1921,0.008579216505874922
STAT,1891,28,25-29,1919,52.710806773411015
STAT,1835,28,40-44,1863,2.9103161493151766
STAT,1888,40,40-44,1928,2.708444177505003
STAT,1837,32,40-44,1869,3.7094296130859
SIM,1945,4,na,1949,4269
SIM,1845,32,40-44,1877,6
SIM,1804,64,na,1868,993
SIM,1861,36,45-49,1897,1
SIM,1881,45,50-100,1926,4
STAT,1860,17,45-49,1877,0.06220087646878046
STAT,1885,46,na,1931,2268.2716176550284
STAT,1900,46,45-49,1946,0.18730425727425415
STAT,1838,48,40-44,1886,0.11640500369176093
STAT,1885,35,45-49,1920,2.0231608304363826
STAT,1896,31,35-39,1927,13.594418543074397
STAT,1878,36,15-19,1914,0.059158889348723945
STAT,1901,43,50-100,1944,0.1031200608194211
STAT,1865,38,25-29,1903,2.642186309175903
SIM,1871,69,na,1940,1344
SIM,1926,17,20-24,1943,235
STAT,1875,15,30-34,1890,1.660870217338509
STAT,1893,13,na,1906,3306.7833468211466
SIM,1870,84,na,1954,310
STAT,1764,103,na,1867,0.027289736560559448
STAT,1833,55,na,1888,1479.2528569205883
STAT,1891,46,25-29,1937,0.040744887527250015
STAT,1915,36,40-44,1951,1.5332989294933654
STAT,1897,47,35-39,1944,0.10643374641681588
SIM,1861,18,15-19,1879,10
STAT,1827,28,45-49,1855,2.228902175782134
STAT,1853,18,15-19,1871,5.868912130033707
SIM,1854,29,25-29,1883,51
STAT,1817,37,na,1854,1409.0084087920275
SIM,1845,18,na,1863,2284
STAT,1769,96,na,1865,1.2243267175655614
STAT,1894,19,45-49,1913,0.08448564141302942
STAT,1846,29,25-29,1875,38.27970000305116
STAT,1870,49,50-100,1919,0.2384973606974935
SIM,1824,49,50-100,1873,1
SIM,1893,35,45-49,1928,3
STAT,1864,36,20-24,1900,0.7059231617426147
STAT,1929,36,35-39,1965,3.141489067282789
STAT,1834,41,20-24,1875,0.11549102934648196
STAT,1809,106,na,1915,0.00560641160461992
SIM,1827,37,20-24,1864,1
SIM,1822,33,20-24,1855,2
SIM,1840,29,30-34,1869,30
STAT,1906,28,na,1934,3498.4645472573297
STAT,1816,52,na,1868,1410.08759422947
STAT,1863,22,40-44,1885,1.9019422433208084
SIM,1830,42,45-49,1872,1
SIM,1894,28,20-24,1922,22
STAT,1832,29,30-34,1861,22.675372908273538
STAT,1928,39,25-29,1967,1.2550530098189234
SIM,1873,33,30-34,1906,3
STAT,1928,20,35-39,1948,11.953668596378346
SIM,1841,44,40-44,1885,9
STAT,1926,26,45-49,1952,2.1002719479824026
STAT,1949,15,25-29,1964,50.94441376490808
SIM,1935,19,20-24,1954,176
SIM,1871,22,40-44,1893,2
STAT,1918,17,20-24,1935,29.88941268216227
SIM,1805,49,na,1854,1137
STAT,1841,59,na,1900,1453.3507548648954
STAT,1854,20,40-44,1874,1.8641662368322174
STAT,1930,13,na,1943,5169.508464224784
SIM,1830,24,15-19,1854,2
STAT,1843,19,35-39,1862,0.4673903785277714
SIM,1859,32,35-39,1891,14
STAT,1894,37,45-49,1931,2.592201268014137
SIM,1877,94,na,1971,106
SIM,1884,29,40-44,1913,5
SIM,1904,25,20-24,1929,17
STAT,1829,40,35-39,1869,1.448707032536364
STAT,1848,22,45-49,1870,0.693222538583214
STAT,1849,38,45-49,1887,1.578398599192377
STAT,1907,44,35-39,1951,0.18399334951558194
STAT,1822,52,na,1874,1349.0127909667563
SIM,1810,64,na,1874,988
STAT,1883,18,50-100,1901,0.04829530243453289
STAT,1851,40,na,1891,1767.7010959919116
SIM,1936,20,35-39,1956,16
STAT,1865,38,50-100,1903,1.1266769593097195
STAT,1886,28,20-24,1914,12.46630114791189
STAT,1865,51,30-34,1916,0.005516040985317887
STAT,1857,47,30-34,1904,0.07594632712640727
STAT,1816,49,50-100,1865,0.6164018644402212
STAT,1927,27,na,1954,4603.176798492583
STAT,1910,32,40-44,1942,3.8068982715844175
STAT,1877,57,na,1934,2094.886215920249
STAT,1948,18,45-49,1966,0.5773177666138839
SIM,1894,35,na,1929,3344
STAT,1921,47,20-24,1968,0.012582419145293604
STAT,1834,29,50-100,1863,0.49240827538359977
STAT,1811,52,40-44,1863,0.02507379860767524
STAT,1875,34,50-100,1909,0.942209427111726
STAT,1885,17,45-49,1902,0.0656711785111006
SIM,1837,40,35-39,1877,2
STAT,1833,44,40-44,1877,1.8864073025746353
SIM,1841,15,25-29,1856,5
SIM,1888,34,20-24,1922,5
STAT,1838,28,20-24,1866,9.918095444629563
STAT,1826,54,45-49,1880,0.013254979978275063
STAT,1825,97,na,1922,3.9204416937195816
SIM,1902,27,45-49,1929,2
SIM,1890,73,na,1963,1915
STAT,1823,43,50-100,1866,1.5279684407800458
STAT,1898,39,50-100,1937,0.35918509408775123
SIM,1876,44,40-44,1920,10
STAT,1817,54,35-39,1871,0.017031322103653684
STAT,1855,15,45-49,1870,0.0591774045827877
STAT,1862,45,15-19,1907,3.5236608950550886E-4
STAT,1878,30,50-100,1908,0.9683637996272233
SIM,1923,17,35-39,1940,5
STAT,1826,38,40-44,1864,4.91785985589813
STAT,1835,20,50-100,1855,0.6432465727347767
SIM,1907,41,na,1948,3689
STAT,1907,39,50-100,1946,0.38909577034384807
SIM,1864,28,40-44,1892,6
STAT,1953,15,15-19,1968,55.496835069046874
STAT,1849,25,30-34,1874,23.67770961776668
SIM,1860,41,40-44,1901,1
SIM,1844,33,50-100,1877,1
STAT,1906,17,25-29,1923,8.336343939029833
SIM,1896,21,35-39,1917,9
STAT,1767,92,na,1859,8.343267837861532
STAT,1847,28,30-34,1875,22.499576554593872
STAT,1801,103,na,1904,0.05711617096506542
STAT,1921,28,15-19,1949,0.7918410807529186
STAT,1782,111,na,1893,3.118336879793978E-4
STAT,1853,18,45-49,1871,0.06460001037341707
STAT,1893,29,40-44,1922,3.814178507919609
STAT,1902,40,35-39,1942,0.18128408203713614
STAT,1915,24,40-44,1939,3.485144055687817
SIM,1853,41,35-39,1894,5
SIM,1844,39,na,1883,1607
SIM,1903,51,na,1954,2860
STAT,1887,41,na,1928,2618.0528604572883
STAT,1890,39,na,1929,2878.3904834926366
STAT,1863,37,na,1900,2108.3398606027226
STAT,1893,45,45-49,1938,0.17242533342072813
STAT,1915,17,35-39,1932,0.8861820531638888
STAT,1786,99,na,1885,0.3775004410707993
STAT,1856,28,40-44,1884,2.3863823728898255
SIM,1840,49,na,1889,1582
SIM,1897,34,30-34,1931,35
STAT,1808,54,25-29,1862,0.011507317105849228
STAT,1888,21,35-39,1909,6.977546373658002
STAT,1878,48,15-19,1926,4.1411201209264986E-4
STAT,1894,29,na,1923,3081.1008463972753
STAT,1897,21,45-49,1918,0.9470650784046986
STAT,1906,6,na,1912,3843.047913682716
SIM,1901,17,15-19,1918,11
STAT,1887,48,25-29,1935,0.06413627678786864
STAT,1839,18,na,1857,2116.344733477561
SIM,1876,42,50-100,1918,4
SIM,1821,38,30-34,1859,8
STAT,1924,17,45-49,1941,0.6011212496422995
SIM,1883,21,25-29,1904,92
SIM,1938,33,na,1971,3740
STAT,1911,24,40-44,1935,3.197022653703453
SIM,1882,78,na,1960,727
STAT,1892,40,50-100,1932,1.3524353733102503
STAT,1906,24,30-34,1930,26.039671911040344
STAT,1788,100,na,1888,0.20943404406357566
STAT,1901,40,50-100,1941,0.10491848719300677
SIM,1874,15,20-24,1889,22
STAT,1843,51,40-44,1894,0.00713453398049964
STAT,1833,22,30-34,1855,17.002876256108483
STAT,1883,51,na,1934,2138.311513809455
STAT,1930,35,30-34,1965,2.406958448416662
STAT,1794,94,na,1888,4.455706380861866
STAT,1866,15,20-24,1881,17.22059245748078
SIM,1932,17,45-49,1949,2
SIM,1836,33,45-49,1869,1
SIM,1837,51,na,1888,1357
STAT,1864,42,15-19,1906,0.012570606037097445
STAT,1884,45,35-39,1929,0.1408294505605835
SIM,1848,25,20-24,1873,17
SIM,1852,34,na,1886,1754
STAT,1909,27,20-24,1936,17.603877119659497
SIM,1883,15,30-34,1898,6
STAT,1917,21,40-44,1938,3.6180054148900656
SIM,1917,27,20-24,1944,20
SIM,1893,16,na,1909,3337
SIM,1825,32,na,1857,1503
STAT,1852,99,na,1951,1.4362935012354907
SIM,1899,31,30-34,1930,1
STAT,1871,29,20-24,1900,11.687488240041272
SIM,1875,90,na,1965,123
SIM,1914,24,30-34,1938,51
STAT,1866,47,40-44,1913,0.15936536668587803
STAT,1915,46,50-100,1961,0.23054775247170456
SIM,1878,23,40-44,1901,4
SIM,1925,21,40-44,1946,4
SIM,1897,27,25-29,1924,72
STAT,1895,70,na,1965,2117.3181815261105
STAT,1927,25,15-19,1952,0.8733426409745466
SIM,1862,39,30-34,1901,3
STAT,1843,44,35-39,1887,1.2256907980417309
SIM,1860,28,40-44,1888,2
STAT,1864,18,20-24,1882,16.61618432335804
STAT,1837,54,20-24,1891,4.895792023126001E-4
SIM,1880,43,na,1923,2173
STAT,1852,28,40-44,1880,2.62707365287857
STAT,1837,82,na,1919,318.29300552979703
STAT,1845,49,30-34,1894,0.06925361216926283
STAT,1862,83,na,1945,346.2601171396625
STAT,1936,25,50-100,1961,0.9625203916421269
STAT,1851,39,45-49,1890,1.494251919809231
STAT,1868,74,na,1942,1071.268781004601
SIM,1855,76,na,1931,728
SIM,1824,84,na,1908,130
SIM,1926,14,na,1940,4848
SIM,1841,22,30-34,1863,23
SIM,1855,20,35-39,1875,11
SIM,1808,60,na,1868,962
STAT,1948,17,30-34,1965,14.091065510283295
STAT,1823,41,15-19,1864,0.021008474527918344
STAT,1875,45,25-29,1920,0.060339346017214635
STAT,1883,15,50-100,1898,0.048647144972868005
STAT,1857,31,15-19,1888,0.11412396083518032
STAT,1913,35,na,1948,3781.627838501299
SIM,1857,25,30-34,1882,37
SIM,1948,4,na,1952,5037
STAT,1890,32,15-19,1922,0.17575397278489663
STAT,1913,38,35-39,1951,2.396419931545228
STAT,1856,26,15-19,1882,0.366683712767968
STAT,1876,50,25-29,1926,0.00374684407082213
SIM,1937,22,45-49,1959,2
SIM,1921,38,35-39,1959,8
STAT,1927,43,45-49,1970,0.2106369104300569
SIM,1904,9,na,1913,3923
SIM,1847,33,20-24,1880,2
STAT,1831,36,25-29,1867,2.326853011147383
STAT,1930,28,25-29,1958,84.5502916590023
STAT,1863,54,50-100,1917,0.013143634262439505
SIM,1939,27,40-44,1966,7
STAT,1939,33,25-29,1972,9.514417942987308
STAT,1868,44,40-44,1912,2.141898241802074
SIM,1863,71,na,1934,1078
STAT,1831,91,na,1922,36.414437440319574
STAT,1829,87,na,1916,103.88286961694973
STAT,1869,34,45-49,1903,1.6977004548800148
STAT,1921,30,na,1951,4285.009360470031
STAT,1931,7,na,1938,5287.821397823075
SIM,1907,21,20-24,1928,161
STAT,1920,17,45-49,1937,0.5659672891841258
SIM,1849,30,20-24,1879,1
STAT,1858,23,15-19,1881,2.7097786358928753
STAT,1845,41,35-39,1886,1.3647475080378326
STAT,1847,20,35-39,1867,5.434014553268257
SIM,1933,28,15-19,1961,5
STAT,1837,47,15-19,1884,2.832712179326094E-4
STAT,1925,28,15-19,1953,0.8396967003761607
STAT,1933,22,35-39,1955,12.621074288782767
SIM,1924,13,na,1937,4797
SIM,1851,44,35-39,1895,3
STAT,1823,96,na,1919,4.748966456351445
STAT,1916,17,50-100,1933,0.08021749353395137
SIM,1816,89,na,1905,35
SIM,1855,28,30-34,1883,37
STAT,1844,64,na,1908,1375.3617089692875
STAT,1889,37,50-100,1926,1.5290237087423688
STAT,1955,7,na,1962,5271.494171483367
STAT,1860,34,25-29,1894,8.384164406445382
SIM,1898,26,30-34,1924,38
SIM,1837,57,na,1894,1247
STAT,1872,37,25-29,1909,2.923596950399232
STAT,1844,43,40-44,1887,1.7993969379454398
SIM,1799,78,na,1877,476
STAT,1827,43,40-44,1870,2.3783825864090287
STAT,1788,106,na,1894,0.003406256168450741
STAT,1924,22,25-29,1946,110.13997806991512
STAT,1825,49,45-49,1874,0.3082285587990503
STAT,1852,24,50-100,1876,0.3621354909962263
STAT,1865,33,30-34,1898,16.034377343969926
STAT,1922,33,15-19,1955,0.1460609101992993
STAT,1858,84,na,1942,263.5978501866069
STAT,1854,54,na,1908,1571.4865921778633
STAT,1840,47,50-100,1887,0.17361221003128283
STAT,1841,18,50-100,1859,0.046973587705574936
STAT,1907,22,25-29,1929,84.90828633665615
SIM,1953,16,na,1969,4529
STAT,1851,20,25-29,1871,52.51459666493044
SIM,1929,28,25-29,1957,87
STAT,1854,23,45-49,1877,0.6104799641870488
STAT,1808,49,45-49,1857,0.817159001346737
STAT,1917,45,40-44,1962,0.16700835105992518
STAT,1910,42,50-100,1952,0.11201708701095935
SIM,1843,51,na,1894,1996
SIM,1862,23,45-49,1885,3
STAT,1830,30,35-39,1860,10.036632192574709
STAT,1839,36,25-29,1875,2.464807837786927
SIM,1932,22,25-29,1954,149
STAT,1864,20,35-39,1884,5.48234958536107
STAT,1894,34,40-44,1928,5.5909053844343335
SIM,1842,20,25-29,1862,2
SIM,1887,29,20-24,1916,10
SIM,1924,4,na,1928,4879
SIM,1820,94,na,1914,5
SIM,1837,25,45-49,1862,1
SIM,1875,20,20-24,1895,66
SIM,1873,26,25-29,1899,58
SIM,1868,49,na,1917,2060
STAT,1904,45,30-34,1949,0.0799320156545894
SIM,1902,16,20-24,1918,29
STAT,1879,29,20-24,1908,12.276572990078071
STAT,1889,27,25-29,1916,52.68194392035059
SIM,1929,35,30-34,1964,2
SIM,1822,89,na,1911,29
STAT,1811,43,45-49,1854,4.144891841096745
STAT,1834,20,25-29,1854,87.08229016165672
STAT,1938,28,25-29,1966,65.79857752155935
STAT,1895,76,na,1971,1715.259050565986
STAT,1910,35,45-49,1945,0.6640485467059114
SIM,1901,0,na,1901,3982
STAT,1914,19,40-44,1933,0.2903575356889606
SIM,1884,20,30-34,1904,26
STAT,1922,40,20-24,1962,0.02053476938572393
STAT,1896,24,na,1920,3142.0896834723344
SIM,1915,22,25-29,1937,108
STAT,1848,54,na,1902,1709.628882446957
STAT,1865,32,na,1897,2200.789691039593
STAT,1910,19,50-100,1929,0.0744964915143265
SIM,1835,43,40-44,1878,4
SIM,1879,31,45-49,1910,4
STAT,1868,8,na,1876,2652.013817062298
STAT,1906,0,na,1906,4319.6548430597295
STAT,1878,54,50-100,1932,0.015399110112473904
STAT,1850,64,na,1914,1331.085053249672
SIM,1847,36,25-29,1883,2
STAT,1897,27,15-19,1924,0.6143399170011957
SIM,1831,66,na,1897,1057
STAT,1858,52,30-34,1910,0.004691610829400728
SIM,1934,35,40-44,1969,8
STAT,1848,33,30-34,1881,14.971588240283177
STAT,1840,41,15-19,1881,0.010228401336239753
STAT,1858,30,20-24,1888,2.186813700166168
SIM,1856,33,30-34,1889,23
STAT,1807,78,na,1885,320.67191189427825
STAT,1800,54,25-29,1854,0.01049893052038481
SIM,1881,18,30-34,1899,1
SIM,1846,34,na,1880,1834
SIM,1918,19,na,1937,4051
STAT,1813,72,na,1885,608.7781399806498
SIM,1899,16,35-39,1915,3
STAT,1901,10,na,1911,3667.5323428288502
STAT,1828,33,45-49,1861,1.9708483001346193
STAT,1926,35,40-44,1961,1.8522287552607348
SIM,1851,86,na,1937,150
STAT,1848,26,25-29,1874,41.52925176810264
STAT,1923,32,20-24,1955,2.8253112721082685
SIM,1842,39,45-49,1881,1
STAT,1875,56,na,1931,2115.5440670029993
STAT,1922,18,na,1940,4292.097539648215
STAT,1870,5,na,1875,2766.657348507476
STAT,1884,39,na,1923,2322.924590257828
STAT,1859,32,na,1891,1938.4853617845322
STAT,1788,94,na,1882,3.978986416896316
STAT,1908,21,30-34,1929,26.75315756168843
STAT,1904,38,25-29,1942,0.8962727967005208
STAT,1867,20,20-24,1887,66.77658712120778
STAT,1839,43,30-34,1882,0.8481264907140702
STAT,1865,26,25-29,1891,39.14662075253745
SIM,1832,22,20-24,1854,7
STAT,1829,25,45-49,1854,2.90867509598735
SIM,1768,86,na,1854,56
SIM,1793,81,na,1874,219
STAT,1867,48,50-100,1915,0.2306846593783891
STAT,1826,73,na,1899,651.7440933251971
STAT,1851,12,na,1863,2197.6949074430963
SIM,1916,21,30-34,1937,53
STAT,1853,33,40-44,1886,3.6550599912294435
STAT,1819,63,na,1882,968.5178772976193
SIM,1907,47,na,1954,3550
SIM,1833,30,25-29,1863,14
STAT,1780,74,na,1854,378.0
STAT,1873,18,30-34,1891,1.627702393926817
STAT,1895,24,45-49,1919,0.9139838722622331
STAT,1898,19,na,1917,3439.537073122555
STAT,1864,84,na,1948,303.18496702236735
STAT,1870,37,20-24,1907,0.7645188630514742
SIM,1862,58,na,1920,1816
SIM,1922,19,40-44,1941,2
SIM,1817,37,na,1854,1684
STAT,1886,42,35-39,1928,1.9286617136504138
STAT,1880,29,30-34,1909,26.51979898302665
SIM,1848,60,na,1908,1459
SIM,1823,37,na,1860,1672
SIM,1846,28,20-24,1874,13
STAT,1896,16,45-49,1912,0.0875455283439886
SIM,1856,26,25-29,1882,67
SIM,1880,37,25-29,1917,3
SIM,1901,56,na,1957,2958
STAT,1885,50,35-39,1935,0.008779388140623907
STAT,1852,48,50-100,1900,0.18392068515261767
STAT,1846,99,na,1945,1.437227056869158
STAT,1889,76,na,1965,1513.0851064535618
STAT,1903,46,25-29,1949,0.04686845959602789
SIM,1852,43,40-44,1895,8
STAT,1891,8,na,1899,3250.6758752675337
STAT,1819,51,35-39,1870,0.01644348209671458
SIM,1827,53,50-100,1880,1
SIM,1892,42,30-34,1934,6
STAT,1889,34,30-34,1923,21.558065243933374
STAT,1778,103,na,1881,0.05778414992039364
SIM,1806,65,na,1871,921
STAT,1947,18,25-29,1965,49.29291013537755
STAT,1841,15,15-19,1856,5.791808050600166
STAT,1820,39,15-19,1859,0.11910260535669864
STAT,1868,29,45-49,1897,1.0641053614273364
STAT,1825,30,25-29,1855,32.72445601634622
STAT,1910,17,15-19,1927,9.072665007368293
SIM,1821,42,na,1863,1394
STAT,1881,56,na,1937,1985.7172228541804
SIM,1947,16,na,1963,4470
STAT,1830,38,30-34,1868,4.776979098087841
SIM,1800,74,na,1874,439
SIM,1876,78,na,1954,723
SIM,1847,43,30-34,1890,1
STAT,1834,44,25-29,1878,0.4493772114908576
STAT,1892,21,25-29,1913,72.77093730542776
SIM,1838,36,50-100,1874,1
SIM,1924,19,na,1943,4387
SIM,1847,28,40-44,1875,6
SIM,1940,17,35-39,1957,5
SIM,1869,33,40-44,1902,4
SIM,1887,16,na,1903,2769
STAT,1843,54,45-49,1897,0.009518988004262645
SIM,1920,29,na,1949,4392
SIM,1839,49,50-100,1888,1
SIM,1829,93,na,1922,14
SIM,1846,30,35-39,1876,10
STAT,1893,42,40-44,1935,2.881013260665217
STAT,1901,17,50-100,1918,0.06936551592993276
STAT,1828,52,50-100,1880,0.013285909094664093
SIM,1869,90,na,1959,122
STAT,1904,28,15-19,1932,0.6552902232144099
SIM,1851,80,na,1931,519
SIM,1906,17,35-39,1923,1
SIM,1849,40,30-34,1889,1
STAT,1866,25,30-34,1891,23.710710126889378
STAT,1830,44,na,1874,1649.134618268019
STAT,1911,40,na,1951,3616.742946752355
STAT,1845,39,20-24,1884,0.5796366297314802
SIM,1860,44,45-49,1904,2
STAT,1817,51,30-34,1868,0.012504179757999325
STAT,1852,28,na,1880,1897.1622784922788
SIM,1790,79,na,1869,335
STAT,1845,51,45-49,1896,0.010654754606075402
STAT,1888,19,20-24,1907,21.021049991643963
SIM,1886,24,45-49,1910,1
STAT,1876,45,45-49,1921,0.24856455480780132
SIM,1794,69,na,1863,715
STAT,1884,42,30-34,1926,1.1436540536393611
STAT,1850,15,25-29,1865,5.365318884538831
SIM,1882,16,25-29,1898,6
SIM,1891,21,15-19,1912,9
STAT,1911,27,45-49,1938,1.6997528454861341
STAT,1951,2,na,1953,4794.314939464296
SIM,1879,21,35-39,1900,10
STAT,1874,16,25-29,1890,5.874865000718116
STAT,1809,54,45-49,1863,0.044698009085977784
SIM,1928,32,45-49,1960,7
SIM,1900,27,40-44,1927,5
STAT,1850,52,30-34,1902,0.004533685080796056
SIM,1815,42,na,1857,1542
STAT,1798,56,na,1854,1244.0
STAT,1826,51,40-44,1877,0.01020564704818531
SIM,1857,31,25-29,1888,6
SIM,1862,24,na,1886,2116
SIM,1917,31,na,1948,3874
SIM,1932,14,na,1946,5985
STAT,1859,109,na,1968,0.006422516037667716
STAT,1860,29,45-49,1889,0.9132608168721015
STAT,1932,17,35-39,1949,5.615102383185583
STAT,1835,87,na,1922,132.23209790596252
STAT,1883,39,50-100,1922,1.201252760113201
SIM,1825,44,25-29,1869,3
SIM,1855,48,na,1903,1882
SIM,1896,19,20-24,1915,25
STAT,1910,25,35-39,1935,14.851234581320663
STAT,1817,62,na,1879,973.1432844479704
STAT,1831,33,20-24,1864,2.210905119189366
STAT,1851,36,40-44,1887,3.385054735801255
SIM,1930,27,20-24,1957,29
SIM,1926,24,50-100,1950,2
STAT,1772,114,na,1886,2.2145770839109176E-4
STAT,1849,31,25-29,1880,9.370039626104917
STAT,1905,34,50-100,1939,0.7615920797012526
STAT,1836,18,45-49,1854,0.10011388447463229
SIM,1872,88,na,1960,77
SIM,1913,34,50-100,1947,4
SIM,1784,70,na,1854,605
SIM,1939,32,20-24,1971,4
STAT,1834,39,45-49,1873,1.4463843949073418
SIM,1829,28,20-24,1857,13
STAT,1832,45,na,1877,1681.3599094410204
STAT,1857,41,25-29,1898,0.5084669700881117
STAT,1861,26,50-100,1887,0.5446925517389976
STAT,1833,21,na,1854,2040.3359116104998
STAT,1896,29,50-100,1925,0.849105911465701
STAT,1947,25,30-34,1972,44.815342762255234
STAT,1836,51,35-39,1887,0.005605055555972321
STAT,1838,30,35-39,1868,8.600784308677127
SIM,1850,39,na,1889,1970
STAT,1867,52,40-44,1919,0.009960820647964502
STAT,1953,0,na,1953,5298.007029136105
STAT,1885,48,20-24,1933,0.011912467912371499
STAT,1927,40,40-44,1967,0.317943794736514
STAT,1860,54,na,1914,1728.8265096330517
SIM,1872,20,35-39,1892,11
STAT,1835,56,na,1891,1530.84280338231
STAT,1867,27,na,1894,2270.113227029318
STAT,1906,27,35-39,1933,14.19457221035059
STAT,1891,16,25-29,1907,7.103523969442515
SIM,1842,75,na,1917,596
STAT,1908,24,35-39,1932,8.683514730599981
STAT,1822,49,50-100,1871,0.3540761206200798
SIM,1914,27,35-39,1941,24
STAT,1937,11,na,1948,3897.2319514826345
STAT,1878,24,45-49,1902,0.7265332541618793
SIM,1874,31,25-29,1905,13
SIM,1898,32,25-29,1930,22
STAT,1906,25,na,1931,3534.641216557353
SIM,1888,63,na,1951,2223
SIM,1895,23,40-44,1918,3
SIM,1888,29,40-44,1917,11
STAT,1912,38,15-19,1950,0.018815709879458853
STAT,1857,26,35-39,1883,7.890657918693122
STAT,1838,43,50-100,1881,0.7430552197053808
STAT,1848,20,na,1868,2156.414258232312
STAT,1887,23,40-44,1910,2.3425377143232566
STAT,1913,43,15-19,1956,0.001508614538942404
SIM,1851,41,30-34,1892,1
STAT,1893,41,na,1934,2977.4412669711905
STAT,1946,22,na,1968,4104.381110116915
STAT,1768,100,na,1868,0.3710354398284563
STAT,1911,30,35-39,1941,9.049799601516444
STAT,1859,39,15-19,1898,0.04515724001109203
STAT,1922,12,na,1934,4632.504626057695
SIM,1902,32,na,1934,3644
STAT,1877,51,na,1928,2255.2513492409767
SIM,1865,26,35-39,1891,11
STAT,1883,21,15-19,1904,3.2705050003743388
SIM,1814,94,na,1908,8
SIM,1874,25,30-34,1899,28
STAT,1843,41,30-34,1884,0.808670955269073
STAT,1887,45,20-24,1932,0.013666657645810739
STAT,1904,24,na,1928,3406.4863855601648
STAT,1811,100,na,1911,0.462816338728523
STAT,1913,35,30-34,1948,1.831982991199272
STAT,1871,31,35-39,1902,10.203270506236347
STAT,1889,20,40-44,1909,2.610647650056779
STAT,1879,25,50-100,1904,0.6788099004401937
SIM,1888,37,25-29,1925,6
SIM,1849,76,na,1925,770
SIM,1867,33,na,1900,2107
STAT,1863,37,15-19,1900,0.050252142720188776
SIM,1846,65,na,1911,1214
SIM,1889,26,20-24,1915,14
SIM,1900,21,35-39,1921,7
SIM,1941,22,35-39,1963,12
STAT,1858,45,25-29,1903,0.04609649262162708
STAT,1921,45,30-34,1966,0.10197588534180584
STAT,1816,49,35-39,1865,0.3513691420344593
STAT,1871,38,50-100,1909,1.2258363545426745
STAT,1819,97,na,1916,2.7310487723468717
STAT,1925,36,35-39,1961,2.9365186406751094
SIM,1881,90,na,1971,193
SIM,1894,40,50-100,1934,3
SIM,1853,35,50-100,1888,1
SIM,1858,50,na,1908,1761
STAT,1875,21,25-29,1896,59.555411186136936
STAT,1866,37,30-34,1903,4.984394738278915
STAT,1856,20,45-49,1876,0.6362261413574121
SIM,1879,58,na,1937,2295
SIM,1909,20,50-100,1929,4
STAT,1899,66,na,1965,2515.5661235119296
STAT,1838,30,na,1868,1840.6191878876587
STAT,1848,7,na,1855,2505.1282499999998
SIM,1866,23,15-19,1889,3
SIM,1858,59,na,1917,1559
SIM,1907,22,35-39,1929,14
STAT,1779,89,na,1868,42.09420920348029
STAT,1839,33,20-24,1872,2.3339838561106396
SIM,1880,34,20-24,1914,2
STAT,1867,30,30-34,1897,16.74156396606268
STAT,1912,32,45-49,1944,1.5621619806519935
SIM,1887,2,na,1889,3201
STAT,1905,33,15-19,1938,0.11888897848187822
SIM,1882,23,30-34,1905,23
STAT,1836,69,na,1905,925.3213070185012
STAT,1890,48,30-34,1938,0.06654245871803713
STAT,1919,49,25-29,1968,0.057751315236357535
STAT,1921,25,50-100,1946,1.1279915913090044
STAT,1844,46,45-49,1890,0.18724960228218784
STAT,1931,33,25-29,1964,12.232262981643428
STAT,1823,62,na,1885,1056.4056111272657
SIM,1911,46,na,1957,3792
STAT,1907,8,na,1915,3855.719416409444
STAT,1923,42,30-34,1965,0.1509778565921517
SIM,1910,61,na,1971,2855
SIM,1933,36,35-39,1969,5
STAT,1830,28,20-24,1858,12.285427562981004
STAT,1850,101,na,1951,0.4369343678685556
STAT,1888,39,40-44,1927,5.16595063771239
STAT,1928,37,na,1965,4805.807349973221
SIM,1874,37,30-34,1911,6
STAT,1939,23,15-19,1962,5.395164636655762
SIM,1839,36,35-39,1875,18
STAT,1861,34,45-49,1895,1.451024917880811
STAT,1865,18,40-44,1883,0.17280138390988775
STAT,1821,44,15-19,1865,0.020791820397937144
SIM,1901,32,40-44,1933,9
SIM,1924,21,20-24,1945,149
STAT,1843,17,na,1860,1978.495499494819
STAT,1898,27,35-39,1925,13.211397426397212
SIM,1788,69,na,1857,543
SIM,1905,46,na,1951,3463
SIM,1908,29,na,1937,3421
STAT,1946,22,45-49,1968,1.2646201170736096
SIM,1896,29,30-34,1925,40
STAT,1802,63,na,1865,873.0450549411979
STAT,1856,39,50-100,1895,0.9411296625687363
STAT,1871,7,na,1878,2746.859602993031
STAT,1905,43,25-29,1948,0.06463931475054872
SIM,1875,39,40-44,1914,1
STAT,1888,29,30-34,1917,29.80508088771515
STAT,1919,39,15-19,1958,0.02078563447144745
STAT,1922,27,20-24,1949,20.866749965010623
SIM,1878,73,na,1951,1287
STAT,1867,39,40-44,1906,4.122068073406082
SIM,1832,25,25-29,1857,47
SIM,1899,72,na,1971,2391
STAT,1806,90,na,1896,26.582034479317127
STAT,1830,40,45-49,1870,1.337634703507296
SIM,1838,20,35-39,1858,9
SIM,1827,67,na,1894,862
STAT,1916,21,20-24,1937,117.94012080242952
STAT,1811,77,na,1888,368.3830646218702
STAT,1890,0,na,1890,3623.9114875290866
STAT,1842,20,15-19,1862,3.8007122743023416
STAT,1918,10,na,1928,4367.159419003029
SIM,1925,0,na,1925,5160
SIM,1916,24,35-39,1940,11
STAT,1870,18,15-19,1888,5.90688830559325
STAT,1840,104,na,1944,0.04675590542348504
STAT,1871,66,na,1937,1644.6224573617756
STAT,1925,46,45-49,1971,0.26681952796380476
STAT,1823,31,na,1854,1584.6992438244706
SIM,1895,45,na,1940,3092
STAT,1880,44,20-24,1924,0.16618082847510726
STAT,1879,31,35-39,1910,10.717546194243615
STAT,1898,32,15-19,1930,0.19498583570314937
SIM,1843,44,45-49,1887,3
SIM,1866,33,25-29,1899,16
STAT,1842,39,35-39,1881,6.658110446433827
STAT,1846,22,40-44,1868,1.9511933910233514
STAT,1884,67,na,1951,1578.8690387614731
STAT,1927,23,50-100,1950,0.8168650286195281
STAT,1939,28,45-49,1967,1.7524854959689866
SIM,1910,34,40-44,1944,5
SIM,1837,29,25-29,1866,33
SIM,1902,8,na,1910,3942
STAT,1865,23,20-24,1888,63.86565384729003
STAT,1819,49,20-24,1868,0.02270233608171331
SIM,1839,52,na,1891,1411
STAT,1909,49,50-100,1958,0.208496582787114
SIM,1943,17,20-24,1960,178
STAT,1847,38,40-44,1885,3.365525454040527
SIM,1838,39,na,1877,1775
STAT,1907,32,35-39,1939,8.624913148599544
SIM,1850,39,35-39,1889,6
SIM,1915,32,35-39,1947,18
STAT,1829,106,na,1935,0.0071592006748739
STAT,1831,97,na,1928,3.375919774576115
STAT,1858,33,25-29,1891,8.081852292398397
STAT,1842,69,na,1911,1321.2802915799866
STAT,1926,38,45-49,1964,0.8411840275103886
SIM,1855,38,40-44,1893,3
STAT,1826,45,na,1871,1438.1430495876032
STAT,1899,24,15-19,1923,4.544320836494483
STAT,1805,77,na,1882,416.5544637868135
SIM,1829,38,30-34,1867,8
SIM,1870,39,50-100,1909,1
STAT,1844,30,na,1874,2093.5186678067294
STAT,1949,22,30-34,1971,33.88160630478179
STAT,1822,36,15-19,1858,0.1090050470290838
STAT,1935,17,20-24,1952,187.25523239578067
STAT,1862,39,50-100,1901,1.060084413918247
SIM,1888,38,50-100,1926,3
SIM,1946,3,na,1949,4516
SIM,1884,73,na,1957,1303
SIM,1887,31,35-39,1918,1
STAT,1839,28,40-44,1867,2.656267819343099
STAT,1951,18,15-19,1969,54.584000225459604
STAT,1934,37,na,1971,5245.865584788198
STAT,1844,47,20-24,1891,0.009449948253057875
STAT,1921,35,20-24,1956,0.29779342770182865
SIM,1859,20,35-39,1879,12
SIM,1819,38,na,1857,1579
SIM,1920,26,50-100,1946,1
STAT,1911,40,45-49,1951,0.16207473193922212
STAT,1825,46,40-44,1871,0.2330871926304313
SIM,1856,24,na,1880,2176
STAT,1842,15,35-39,1857,0.6419286951560731
STAT,1813,53,20-24,1866,0.001999850063641728
SIM,1840,17,30-34,1857,1
SIM,1772,85,na,1857,56
STAT,1930,18,15-19,1948,59.14737071316258
SIM,1866,88,na,1954,68
STAT,1839,103,na,1942,0.10174825618974667
SIM,1920,32,45-49,1952,4
STAT,1854,34,50-100,1888,0.6897015042470722
STAT,1834,26,50-100,1860,0.5031752920908065
SIM,1914,29,na,1943,3878
STAT,1916,16,40-44,1932,0.3002142402410759
STAT,1858,110,na,1968,0.00225117524142985
STAT,1886,65,na,1951,1802.164195641062
SIM,1864,59,na,1923,2133
STAT,1922,38,50-100,1960,0.48214110002783883
SIM,1834,38,40-44,1872,10
SIM,1898,22,15-19,1920,4
STAT,1864,30,45-49,1894,1.6020721781798777
SIM,1951,15,na,1966,4980
SIM,1938,25,50-100,1963,1
STAT,1829,29,25-29,1858,42.266919182949344
SIM,1924,16,40-44,1940,1
STAT,1835,44,45-49,1879,1.3124063243571127
SIM,1873,23,20-24,1896,4
STAT,1902,34,40-44,1936,3.5236526697354837
SIM,1902,24,40-44,1926,5
STAT,1892,37,40-44,1929,5.547955959963901
SIM,1914,17,25-29,1931,8
STAT,1882,16,15-19,1898,5.820313076317816
STAT,1872,34,20-24,1906,2.721242918177182
SIM,1929,38,35-39,1967,11
STAT,1867,42,30-34,1909,1.0922432402829405
SIM,1831,43,50-100,1874,3
STAT,1844,28,15-19,1872,0.4362753189261656
STAT,1877,19,45-49,1896,0.06772852982338175
SIM,1828,46,na,1874,1508
STAT,1804,95,na,1899,4.1218780911970265
SIM,1860,50,50-100,1910,1
STAT,1865,40,50-100,1905,0.9841503259647671
STAT,1913,37,20-24,1950,0.2624779329928191
STAT,1943,27,20-24,1970,19.629579179341874
SIM,1842,29,35-39,1871,12
SIM,1826,100,na,1926,1
STAT,1924,44,na,1968,4449.160161065325
STAT,1829,56,na,1885,1237.9636110076653
SIM,1929,25,na,1954,4522
SIM,1866,85,na,1951,235
SIM,1863,19,25-29,1882,12
STAT,1860,38,40-44,1898,3.5962562313096154
STAT,1892,15,30-34,1907,2.0294223488885397
STAT,1822,83,na,1905,221.9647940956086
SIM,1930,37,30-34,1967,8
STAT,1891,15,na,1906,3172.888913359624
SIM,1833,24,30-34,1857,18
STAT,1886,46,15-19,1932,4.27767914991335E-4
STAT,1857,48,45-49,1905,0.18368824296982567
SIM,1941,28,40-44,1969,7
SIM,1811,80,na,1891,331
SIM,1865,48,45-49,1913,3
STAT,1859,100,na,1959,1.6461196199237897
STAT,1922,37,30-34,1959,2.0950695046858483
STAT,1871,41,45-49,1912,1.5085601169401759
STAT,1907,26,40-44,1933,4.4583514116906775
SIM,1841,25,na,1866,1840
STAT,1848,16,15-19,1864,6.0420721833965505
SIM,1875,35,25-29,1910,3
STAT,1834,29,35-39,1863,7.427338980927448
STAT,1834,36,40-44,1870,3.276619665041538
SIM,1860,94,na,1954,4
STAT,1855,19,25-29,1874,5.013756695367022
STAT,1804,50,45-49,1854,0.040920315771295145
STAT,1926,41,35-39,1967,0.2512524991382208
SIM,1852,65,na,1917,1136
SIM,1911,15,na,1926,4122
SIM,1865,9,na,1874,2518
SIM,1906,26,30-34,1932,53
STAT,1830,52,45-49,1882,0.010675164570977206
STAT,1854,47,15-19,1901,2.9879485091885205E-4
SIM,1866,49,50-100,1915,1
STAT,1904,41,15-19,1945,0.0013962571219152374
SIM,1878,26,50-100,1904,4
STAT,1853,75,na,1928,851.3409769911841
STAT,1876,23,50-100,1899,0.4239472923419895
STAT,1865,17,50-100,1882,0.046560313969525036
SIM,1839,83,na,1922,197
STAT,1821,48,30-34,1869,0.13983859766410106
STAT,1867,35,25-29,1902,2.764765770521736
STAT,1893,9,na,1902,3327.465100280089
STAT,1810,98,na,1908,1.6871628607188864
STAT,1862,41,35-39,1903,1.5865750841259103
STAT,1939,25,40-44,1964,4.734541083411992
SIM,1880,12,na,1892,2517
SIM,1910,25,45-49,1935,2
SIM,1938,18,25-29,1956,56
STAT,1874,25,20-24,1899,12.214855995461113
STAT,1912,59,na,1971,3349.5952272857635
STAT,1885,47,45-49,1932,0.23615358619341223
SIM,1859,38,na,1897,2185
SIM,1939,30,30-34,1969,8
STAT,1839,46,35-39,1885,0.10243320833924467
STAT,1835,50,na,1885,1713.4145743408753
STAT,1878,36,na,1914,2482.024402768232
SIM,1889,32,50-100,1921,1
SIM,1923,34,na,1957,4379
STAT,1897,25,25-29,1922,57.667208116880985
STAT,1902,25,45-49,1927,1.5954423620349407
SIM,1870,41,35-39,1911,1
STAT,1882,53,20-24,1935,7.103500883271264E-4
SIM,1777,91,na,1868,10
SIM,1888,30,40-44,1918,11
STAT,1909,25,50-100,1934,0.9746196050945859
STAT,1880,77,na,1957,997.2687061756793
SIM,1916,43,40-44,1959,1
STAT,1821,40,35-39,1861,3.059250694707244
STAT,1842,38,na,1880,2238.723208738867
STAT,1924,16,30-34,1940,14.703384765973603
SIM,1866,49,40-44,1915,3
SIM,1833,36,30-34,1869,7
STAT,1849,33,15-19,1882,0.11611454440185558
STAT,1884,30,na,1914,2395.8585674012133
SIM,1822,58,na,1880,1257
STAT,1900,16,45-49,1916,0.09187329260619571
STAT,1872,42,na,1914,2343.991732149764
SIM,1784,79,na,1863,259
SIM,1864,50,na,1914,2385
STAT,1949,15,50-100,1964,0.4404415286704893
SIM,1828,35,45-49,1863,1
SIM,1889,11,na,1900,3217
STAT,1899,46,25-29,1945,0.04516560303221831
STAT,1868,48,20-24,1916,0.011437943948421427
STAT,1953,9,na,1962,4802.801958199564
SIM,1865,23,30-34,1888,19
SIM,1902,30,35-39,1932,24
STAT,1893,32,30-34,1925,22.391065781224473
SIM,1838,34,25-29,1872,16
SIM,1901,25,35-39,1926,16
STAT,1876,54,40-44,1930,0.010676778381975392
STAT,1903,24,15-19,1927,4.7156531346365265
STAT,1892,7,na,1899,3301.9742019249566
SIM,1877,23,na,1900,2495
SIM,1911,24,15-19,1935,9
SIM,1932,16,30-34,1948,21
SIM,1879,35,25-29,1914,3
SIM,1877,26,na,1903,2514
STAT,1857,35,30-34,1892,4.24090696438293
STAT,1892,27,30-34,1919,31.915015648474576
STAT,1907,19,35-39,1926,0.8094961230825879
SIM,1878,70,na,1948,1495
STAT,1932,40,15-19,1972,0.002109205906952501
STAT,1814,88,na,1902,64.25699200304072
STAT,1858,49,40-44,1907,0.13282417692387732
STAT,1826,76,na,1902,519.8596960617328
STAT,1885,29,15-19,1914,0.4528642736349549
STAT,1917,18,15-19,1935,9.8319856262242
SIM,1882,26,35-39,1908,13
STAT,1830,35,50-100,1865,1.1477732831376386
STAT,1885,40,25-29,1925,0.6520988739402206
STAT,1849,40,20-24,1889,0.1263385509955852
STAT,1825,36,30-34,1861,9.178951974502805
SIM,1933,24,35-39,1957,14
STAT,1859,63,na,1922,1449.4538180396792
SIM,1902,38,30-34,1940,2
SIM,1915,19,35-39,1934,1
STAT,1898,50,na,1948,2990.5839946428873
STAT,1850,40,50-100,1890,0.8171023003728679
SIM,1860,60,na,1920,1694
STAT,1857,23,30-34,1880,16.092490848330907
STAT,1956,15,30-34,1971,16.301912715419874
SIM,1816,39,35-39,1855,13
SIM,1884,42,40-44,1926,2
STAT,1876,42,40-44,1918,2.3427535664115346
STAT,1908,43,40-44,1951,0.23220035981118783
STAT,1899,34,25-29,1933,14.076249083506825
SIM,1916,31,40-44,1947,9
STAT,1809,51,40-44,1860,0.03452890759788239
STAT,1874,26,35-39,1900,10.013066056316964
STAT,1925,24,35-39,1949,11.319109757100286
SIM,1839,86,na,1925,101
STAT,1818,38,15-19,1856,0.12915569044770486
STAT,1845,45,15-19,1890,2.9518801978357196E-4
SIM,1939,23,25-29,1962,104
STAT,1860,26,40-44,1886,2.5177946139649916
SIM,1864,24,25-29,1888,88
SIM,1880,15,na,1895,2496
SIM,1897,17,15-19,1914,6
STAT,1919,46,20-24,1965,0.012132550784471122
STAT,1937,17,na,1954,3614.9453748543533
STAT,1805,103,na,1908,0.05697202433445036
STAT,1899,30,50-100,1929,1.2802643623304815
STAT,1888,24,50-100,1912,0.4830884412272548
STAT,1914,42,20-24,1956,0.01765594333336235
STAT,1880,71,na,1951,1415.8370231163385
STAT,1870,36,45-49,1906,1.9866326463958823
STAT,1893,25,25-29,1918,54.61714037111102
STAT,1856,41,50-100,1897,0.8217610919503977
STAT,1916,18,na,1934,4124.499662903833
STAT,1936,32,na,1968,3708.711632597928
SIM,1845,23,45-49,1868,5
SIM,1907,24,25-29,1931,92
STAT,1825,103,na,1928,0.10473136559325764
STAT,1807,52,50-100,1859,0.05125951166589289
STAT,1843,34,25-29,1877,8.13441383136174
STAT,1898,29,25-29,1927,57.505515013884185
STAT,1877,52,35-39,1929,0.008926509330354774
STAT,1921,48,35-39,1969,0.14638679488280282
STAT,1874,77,na,1951,893.9453613501514
STAT,1891,18,na,1909,3149.9408597841375
STAT,1893,20,30-34,1913,22.979506304022134
SIM,1920,36,25-29,1956,1
SIM,1848,35,30-34,1883,8
STAT,1901,17,40-44,1918,0.2589646557788099
STAT,1908,31,40-44,1939,3.7440504425945242
SIM,1854,60,na,1914,1739
STAT,1875,23,15-19,1898,3.411232031674377
SIM,1851,34,25-29,1885,10
STAT,1898,24,30-34,1922,24.23605652721881
STAT,1835,41,40-44,1876,2.0496788127252734
STAT,1948,20,20-24,1968,129.06224408677923
STAT,1859,60,na,1919,1549.269897741983
STAT,1911,16,20-24,1927,27.43804920645932
STAT,1930,31,15-19,1961,0.16771573694174277
STAT,1943,11,na,1954,4212.278191991074
SIM,1815,73,na,1888,543
SIM,1816,58,na,1874,1092
SIM,1924,24,25-29,1948,134
SIM,1876,40,25-29,1916,1
STAT,1859,50,25-29,1909,0.002918651133199687
SIM,1850,37,45-49,1887,5
STAT,1909,30,na,1939,3671.217621962681
STAT,1911,20,25-29,1931,88.90801022471652
STAT,1889,17,15-19,1906,7.390855075253139
SIM,1828,43,na,1871,1555
STAT,1934,33,40-44,1967,5.395392156356438
STAT,1826,41,30-34,1867,1.2235177053712754
STAT,1905,40,20-24,1945,0.016264866246484152
STAT,1930,5,na,1935,5253.977209071119
SIM,1809,79,na,1888,273
SIM,1933,31,40-44,1964,4
STAT,1873,92,na,1965,120.82809248887199
SIM,1933,21,30-34,1954,47
STAT,1868,50,35-39,1918,0.008429667990929438
STAT,1886,62,na,1948,1949.079692349175
STAT,1896,31,50-100,1927,1.2299540186041507
SIM,1859,29,45-49,1888,2
SIM,1847,19,na,1866,2128
STAT,1887,26,45-49,1913,1.2563254494347118
STAT,1934,15,50-100,1949,0.5144231957476352
STAT,1846,90,na,1936,59.830914504539585
STAT,1822,46,25-29,1868,0.08660838494543988
STAT,1861,31,40-44,1892,3.6545941302615996
SIM,1860,34,35-39,1894,10
SIM,1875,48,50-100,1923,1
STAT,1920,20,35-39,1940,10.633890281385131
STAT,1843,22,25-29,1865,48.46385508102934
STAT,1852,34,35-39,1886,7.7885782138387825
SIM,1851,22,25-29,1873,61
STAT,1849,47,40-44,1896,0.13322918471633644
STAT,1856,18,30-34,1874,1.4507733164950116
STAT,1847,42,50-100,1889,0.795416254454338
STAT,1789,79,na,1868,341.967500217296
STAT,1925,31,40-44,1956,4.699112688670783
SIM,1839,38,25-29,1877,1
SIM,1927,15,45-49,1942,1
SIM,1778,79,na,1857,159
STAT,1940,32,20-24,1972,2.5485520084043722
STAT,1811,43,na,1854,1360.8946285542822
SIM,1910,19,15-19,1929,8
SIM,1834,41,30-34,1875,1
STAT,1914,33,50-100,1947,0.8361533365548878
SIM,1891,38,45-49,1929,3
STAT,1785,80,na,1865,247.56055511137203
SIM,1892,23,25-29,1915,91
STAT,1835,53,40-44,1888,0.007897689713199204
STAT,1896,55,na,1951,2764.370105357316
STAT,1817,44,25-29,1861,1.4416433134386701
STAT,1867,24,50-100,1891,0.38547086100230027
SIM,1865,28,25-29,1893,46
STAT,1832,50,20-24,1882,5.45390448735516E-4
STAT,1898,36,30-34,1934,7.332426956100307
SIM,1843,41,40-44,1884,5
STAT,1902,37,45-49,1939,0.614116592598098
STAT,1951,21,40-44,1972,4.06001991925839
SIM,1843,20,na,1863,2445
STAT,1847,18,20-24,1865,16.469688067676454
SIM,1891,55,na,1946,2607
STAT,1862,39,20-24,1901,0.6655831459200425
SIM,1889,36,30-34,1925,4
STAT,1894,40,35-39,1934,2.3784246240732756
STAT,1934,21,40-44,1955,4.5672410753654
STAT,1880,47,25-29,1927,0.06081208710833584
SIM,1916,55,na,1971,3621
STAT,1912,36,25-29,1948,0.974208025282212
STAT,1924,47,na,1971,4419.6661476884665
STAT,1846,25,45-49,1871,1.034125059433453
STAT,1863,47,25-29,1910,0.05130534168351469
STAT,1866,48,na,1914,2077.685978551264
STAT,1902,19,15-19,1921,8.42472360557978
STAT,1857,28,25-29,1885,34.09809528658212
SIM,1891,39,50-100,1930,1
STAT,1884,35,25-29,1919,2.89490057178239
SIM,1911,49,na,1960,3764
SIM,1825,32,25-29,1857,8
STAT,1907,5,na,1912,3887.004073196317
SIM,1855,18,20-24,1873,13
STAT,1920,28,30-34,1948,43.25225727337817
SIM,1942,21,40-44,1963,6
STAT,1836,35,na,1871,1692.3534068218896
STAT,1852,41,40-44,1893,1.7135511722592358
SIM,1874,12,na,1886,2546
STAT,1841,41,50-100,1882,0.8315254506234083
SIM,1907,31,30-34,1938,32
STAT,1916,24,25-29,1940,97.06648402884647
STAT,1887,10,na,1897,2920.970621428089
SIM,1780,80,na,1860,202
SIM,1796,64,na,1860,1004
STAT,1860,57,na,1917,1659.2047236855894
STAT,1884,23,25-29,1907,56.84016260307738
SIM,1875,42,30-34,1917,1
STAT,1885,18,na,1903,2532.4347131049312
SIM,1854,25,45-49,1879,2
STAT,1909,49,30-34,1958,0.08217617779287055
STAT,1851,26,30-34,1877,22.486762728415638
STAT,1866,11,na,1877,2529.7325769989784
SIM,1938,25,30-34,1963,49
STAT,1841,52,20-24,1893,5.488891910779977E-4
STAT,1856,24,25-29,1880,50.746100765396115
SIM,1860,48,50-100,1908,3
SIM,1903,36,25-29,1939,1
SIM,1834,34,25-29,1868,6
STAT,1815,106,na,1921,0.005255875142512188
STAT,1839,35,50-100,1874,1.0620100726254884
SIM,1891,15,20-24,1906,27
SIM,1839,33,30-34,1872,4
STAT,1931,26,na,1957,4890.148991486318
SIM,1875,30,30-34,1905,27
STAT,1816,47,45-49,1863,0.6102705647679928
STAT,1837,23,45-49,1860,0.6182874377535964
STAT,1816,51,50-100,1867,0.038264156163658386
STAT,1915,27,45-49,1942,1.778080372301891
SIM,1838,18,20-24,1856,15
SIM,1853,13,na,1866,2149
SIM,1923,27,45-49,1950,2
STAT,1841,50,na,1891,1633.3089357580254
STAT,1883,38,45-49,1921,1.9605324016018737
STAT,1826,34,25-29,1860,12.849960669794921
STAT,1890,30,50-100,1920,1.1398838568010872
STAT,1853,78,na,1931,646.1438099504511
STAT,1791,80,na,1871,231.37129311459657
STAT,1931,30,20-24,1961,3.2337923913645152
STAT,1909,41,35-39,1950,0.19115448581908656
STAT,1821,50,45-49,1871,0.021289877681741554
SIM,1897,37,35-39,1934,21
STAT,1903,45,na,1948,3269.072034643576
STAT,1843,38,40-44,1881,3.1041549753566167
SIM,1928,40,na,1968,4914
STAT,1849,43,25-29,1892,0.4984454764931792
STAT,1828,71,na,1899,866.4953790264462
SIM,1849,42,50-100,1891,3
SIM,1849,45,na,1894,1793
STAT,1872,15,45-49,1887,0.06733893608004908
STAT,1906,15,35-39,1921,0.8109583357810468
SIM,1846,19,25-29,1865,4
STAT,1898,49,45-49,1947,0.17846833054439828
STAT,1902,22,40-44,1924,2.9741371182166674
SIM,1851,49,50-100,1900,1
SIM,1808,91,na,1899,17
SIM,1905,12,na,1917,3881
SIM,1942,18,15-19,1960,66
STAT,1861,28,15-19,1889,0.38079610576872486
STAT,1907,18,50-100,1925,0.07247573443955051
STAT,1926,27,20-24,1953,22.115556892006794
STAT,1897,19,30-34,1916,2.1466190024004326
SIM,1846,31,na,1877,1835
SIM,1934,27,20-24,1961,25
SIM,1883,26,na,1909,2711
SIM,1908,26,na,1934,3603
STAT,1821,36,na,1857,1726.6696045991584
STAT,1916,40,50-100,1956,0.12183149471154153
SIM,1798,90,na,1888,1
SIM,1887,84,na,1971,697
SIM,1902,2,na,1904,4022
SIM,1838,28,30-34,1866,34
SIM,1893,44,40-44,1937,1
SIM,1938,15,20-24,1953,170
SIM,1892,30,30-34,1922,6
SIM,1924,28,40-44,1952,11
STAT,1773,95,na,1868,2.573816650797343
STAT,1851,24,40-44,1875,1.8572816983908746
SIM,1861,79,na,1940,569
STAT,1890,30,na,1920,2968.764689617639
STAT,1893,44,na,1937,2934.1191498020576
STAT,1929,1,na,1930,5386.804946138523
STAT,1899,31,20-24,1930,3.762161899758201
SIM,1898,25,na,1923,3175
STAT,1930,38,35-39,1968,3.185547679001243
STAT,1915,30,na,1945,3917.9904189919635
SIM,1858,42,30-34,1900,6
SIM,1873,16,15-19,1889,3
STAT,1838,19,25-29,1857,4.951880368073225
STAT,1833,25,35-39,1858,9.161592074774248
STAT,1939,27,30-34,1966,39.765813666604096
STAT,1882,18,40-44,1900,0.17847393198421035
STAT,1884,30,30-34,1914,17.529572889909048
SIM,1857,71,na,1928,1189
STAT,1930,25,20-24,1955,23.480012652204973
STAT,1860,23,na,1883,1998.447408826545
SIM,1818,84,na,1902,165
SIM,1934,31,25-29,1965,19
SIM,1840,42,50-100,1882,1
SIM,1842,26,30-34,1868,31
STAT,1921,38,25-29,1959,1.1092431414193233
SIM,1855,30,45-49,1885,2
STAT,1874,16,50-100,1890,0.050791329812718514
STAT,1865,16,15-19,1881,5.673423638695559
SIM,1947,5,na,1952,4866
STAT,1912,26,15-19,1938,0.7042855312444966
SIM,1865,38,35-39,1903,9
STAT,1862,89,na,1951,91.62981462309462
SIM,1920,26,15-19,1946,1
STAT,1814,44,50-100,1858,2.684435403633635
STAT,1895,48,15-19,1943,2.938624464457349E-4
SIM,1851,38,40-44,1889,7
STAT,1853,37,20-24,1890,0.6374739387200055
STAT,1883,18,25-29,1901,5.586157775705374
SIM,1903,7,na,1910,3562
STAT,1839,49,na,1888,1584.0626126916059
STAT,1819,94,na,1913,10.160180824679198
STAT,1859,54,40-44,1913,0.008316810290062829
SIM,1845,86,na,1931,232
STAT,1924,19,35-39,1943,5.022340431246838
STAT,1834,26,30-34,1860,19.80781698122808
STAT,1934,18,15-19,1952,61.863121788779495
SIM,1863,2,na,1865,3165
STAT,1863,49,15-19,1912,3.504817657056003E-4
SIM,1862,27,na,1889,2171
SIM,1947,2,na,1949,4934
STAT,1826,44,35-39,1870,1.8150902130981716
STAT,1842,17,25-29,1859,6.551577447984371
STAT,1842,37,45-49,1879,2.105442072128078
STAT,1885,15,na,1900,2550.8840904296644
SIM,1911,28,30-34,1939,57
SIM,1869,18,15-19,1887,7
STAT,1925,21,30-34,1946,34.87319779888547
STAT,1944,25,15-19,1969,0.7711487485106882
STAT,1870,19,na,1889,2499.027149742478
SIM,1942,26,35-39,1968,22
STAT,1893,35,35-39,1928,9.156752522676792
STAT,1913,47,30-34,1960,0.0877902943723997
STAT,1875,27,30-34,1902,26.119106752458023
STAT,1900,34,na,1934,3319.356602628995
SIM,1866,30,20-24,1896,2
STAT,1907,16,30-34,1923,2.369877774552284
SIM,1805,80,na,1885,207
SIM,1864,18,30-34,1882,2
SIM,1913,41,na,1954,3645
SIM,1896,31,45-49,1927,5
SIM,1829,40,45-49,1869,7
STAT,1825,39,35-39,1864,10.764852827320228
SIM,1878,26,45-49,1904,2
SIM,1879,52,na,1931,2550
STAT,1849,106,na,1955,0.009493015359923671
SIM,1834,44,35-39,1878,5
STAT,1903,28,30-34,1931,36.09447717214687
STAT,1832,42,50-100,1874,0.8826816504814714
STAT,1871,39,30-34,1910,5.294003864746575
STAT,1829,109,na,1938,4.1950365029413863E-4
STAT,1835,38,15-19,1873,0.05158765900174844
STAT,1856,18,50-100,1874,0.04459343303907579
SIM,1883,23,15-19,1906,4
SIM,1906,29,35-39,1935,15
STAT,1871,35,15-19,1906,0.0568819795283018
STAT,1934,26,35-39,1960,20.416725983820985
SIM,1906,24,40-44,1930,5
STAT,1874,23,30-34,1897,18.364356077003723
STAT,1818,53,40-44,1871,0.01765007841134766
STAT,1885,44,40-44,1929,2.230758796518981
STAT,1894,45,50-100,1939,0.18194295850204323
SIM,1915,16,30-34,1931,3
STAT,1908,28,15-19,1936,0.6712976551088019
STAT,1908,46,45-49,1954,0.19990920165931775
SIM,1883,27,30-34,1910,34
SIM,1856,36,35-39,1892,10
STAT,1821,39,na,1860,1680.1502683405402
SIM,1833,39,35-39,1872,12
STAT,1873,51,20-24,1924,7.591778012842267E-4
STAT,1883,15,20-24,1898,17.603783733649582
STAT,1832,76,na,1908,645.1100616449348
STAT,1918,44,na,1962,3973.2468746708905
SIM,1820,39,25-29,1859,8
SIM,1888,25,25-29,1913,61
SIM,1864,53,na,1917,2353
SIM,1875,32,20-24,1907,3
STAT,1911,19,25-29,1930,8.701863054223187
STAT,1792,68,na,1860,682.8066191991956
SIM,1850,17,25-29,1867,9
STAT,1865,63,na,1928,1645.5853024565072
STAT,1821,38,20-24,1859,1.4298350552277124
STAT,1847,75,na,1922,770.7963759363844
SIM,1879,39,40-44,1918,2
STAT,1923,32,50-100,1955,0.9576850280399768
STAT,1941,17,45-49,1958,0.5194720973416818
STAT,1881,42,15-19,1923,0.013428220352190915
STAT,1860,22,25-29,1882,48.72191341963048
STAT,1889,24,20-24,1913,85.28595148799766
STAT,1825,100,na,1925,0.7747449304864171
STAT,1852,90,na,1942,59.79205113424871
SIM,1842,72,na,1914,778
STAT,1839,26,15-19,1865,0.40815342803731375
STAT,1904,48,35-39,1952,0.11302477618791525
SIM,1864,41,50-100,1905,3
SIM,1895,11,na,1906,3431
STAT,1866,21,15-19,1887,3.133042212128706
STAT,1900,31,na,1931,3361.7031539266227
STAT,1913,31,15-19,1944,0.1295260026496121
STAT,1857,38,35-39,1895,5.5475373003453585
SIM,1874,21,15-19,1895,3
SIM,1914,15,35-39,1929,3
SIM,1897,24,20-24,1921,142
STAT,1888,31,45-49,1919,2.087326224167514
SIM,1928,20,45-49,1948,1
SIM,1916,52,na,1968,3685
SIM,1948,22,20-24,1970,204
SIM,1860,31,30-34,1891,9
STAT,1841,17,40-44,1858,0.1764071414759097
STAT,1836,38,na,1874,1640.4472767697102
SIM,1929,26,35-39,1955,27
STAT,1816,83,na,1899,202.9687468030141
SIM,1833,98,na,1931,3
SIM,1924,22,35-39,1946,13
SIM,1884,47,50-100,1931,2
SIM,1891,28,35-39,1919,13
STAT,1870,101,na,1971,5.016336243853455
SIM,1834,31,20-24,1865,2
STAT,1876,47,50-100,1923,0.2549281712459485
STAT,1813,46,15-19,1859,0.0011857147384165725
STAT,1875,37,40-44,1912,4.540422463592274
STAT,1898,26,20-24,1924,16.11792929107347
STAT,1848,36,35-39,1884,6.013105205392678
SIM,1886,3,na,1889,2957
STAT,1873,20,45-49,1893,0.7182543274862542
STAT,1870,33,40-44,1903,4.282953773524593
STAT,1893,22,20-24,1915,88.3762405146344
SIM,1871,38,na,1909,2251
SIM,1840,46,na,1886,1658
STAT,1894,38,20-24,1932,0.9973903552481582
STAT,1927,37,15-19,1964,0.024132072126593015
SIM,1842,22,15-19,1864,4
SIM,1939,20,20-24,1959,151
STAT,1920,30,45-49,1950,1.7545470004798676
SIM,1892,39,40-44,1931,12
STAT,1929,22,45-49,1951,1.438159131018522
SIM,1885,52,na,1937,2280
STAT,1925,34,45-49,1959,1.8860128313977123
STAT,1857,37,na,1894,1857.0856448139962
STAT,1883,28,35-39,1911,9.503155008095144
STAT,1916,22,35-39,1938,9.957057006072873
SIM,1870,53,na,1923,2346
STAT,1852,31,30-34,1883,13.85289485067839
STAT,1808,46,40-44,1854,0.6428172458151625
STAT,1770,84,na,1854,53.0
STAT,1786,68,na,1854,721.0
STAT,1952,17,20-24,1969,164.15026274521253
SIM,1886,37,na,1923,2655
STAT,1875,22,na,1897,2453.0697704416743
STAT,1822,48,15-19,1870,5.848120533883367E-4
STAT,1862,51,45-49,1913,0.012718585997955658
SIM,1903,33,20-24,1936,3
SIM,1950,18,40-44,1968,4
SIM,1916,36,35-39,1952,7
SIM,1874,35,40-44,1909,4
SIM,1857,26,50-100,1883,1
SIM,1891,52,na,1943,2716
STAT,1834,22,15-19,1856,2.6287001926397258
STAT,1942,18,40-44,1960,1.475360749579268
SIM,1880,32,50-100,1912,4
STAT,1850,19,40-44,1869,0.1691304774705347
SIM,1938,28,35-39,1966,25
STAT,1869,22,45-49,1891,0.6847408383700953
STAT,1866,35,40-44,1901,4.132864269092255
STAT,1859,103,na,1962,0.3883276274846286
STAT,1884,20,20-24,1904,69.04602399132564
STAT,1918,35,15-19,1953,0.0206285700320313
SIM,1837,22,40-44,1859,1
SIM,1848,97,na,1945,4
STAT,1880,37,15-19,1917,0.05956373313585339
STAT,1948,23,25-29,1971,107.10269256534386
STAT,1908,7,na,1915,3901.3360830748124
SIM,1865,38,na,1903,2139
STAT,1839,21,20-24,1860,63.22955274710172
SIM,1892,20,20-24,1912,119
STAT,1933,16,40-44,1949,1.8967168032933333
STAT,1791,83,na,1874,122.64168111718644
STAT,1908,36,35-39,1944,2.297019812280331
STAT,1917,48,45-49,1965,0.2285062957380881
SIM,1838,38,40-44,1876,5
SIM,1847,21,20-24,1868,68
STAT,1926,31,25-29,1957,11.301685528019629
SIM,1883,37,40-44,1920,8
STAT,1808,54,na,1862,1132.830313506435
SIM,1841,25,35-39,1866,16
STAT,1899,41,30-34,1940,0.11116460594182526
STAT,1919,29,na,1948,4057.645660662737
STAT,1817,48,40-44,1865,0.3623253781270654
STAT,1836,49,20-24,1885,0.00772188723379474
STAT,1871,53,45-49,1924,0.01432829731513484
STAT,1831,45,20-24,1876,0.00919643078079725
SIM,1833,61,na,1894,1352
SIM,1834,46,na,1880,1740
STAT,1898,39,35-39,1937,2.069234727950382
STAT,1850,107,na,1957,0.0057593893584373616
SIM,1831,32,na,1863,1853
SIM,1941,22,na,1963,3882
STAT,1922,43,25-29,1965,0.0826712259785125
SIM,1941,16,40-44,1957,1
STAT,1863,44,20-24,1907,0.1402018018387701
STAT,1892,25,40-44,1917,3.8222721507666195
STAT,1838,110,na,1948,1.8498803208416892E-4
STAT,1858,43,35-39,1901,1.4244994024597093
SIM,1901,20,40-44,1921,2
STAT,1801,84,na,1885,120.4272145406865
STAT,1866,31,25-29,1897,9.61836393154454
STAT,1856,32,45-49,1888,1.3668546314826326
STAT,1897,29,40-44,1926,4.027179458986757
SIM,1860,21,20-24,1881,69
SIM,1866,43,35-39,1909,3
SIM,1907,34,35-39,1941,10
SIM,1865,25,20-24,1890,7
SIM,1842,36,40-44,1878,3
SIM,1856,23,20-24,1879,78
SIM,1864,32,45-49,1896,1
STAT,1830,34,15-19,1864,0.1323174555361695
STAT,1847,30,45-49,1877,1.5651859065772942
STAT,1852,44,45-49,1896,1.1197189514365353
SIM,1822,44,50-100,1866,1
SIM,1898,31,50-100,1929,1
SIM,1924,1,na,1925,4955
STAT,1858,40,30-34,1898,0.9201738167044067
STAT,1849,26,50-100,1875,0.5971630123641938
SIM,1813,47,na,1860,1381
STAT,1872,32,50-100,1904,0.9303748717284731
SIM,1888,66,na,1954,2034
STAT,1827,47,20-24,1874,0.01230833718873731
STAT,1903,42,45-49,1945,0.1493098997932148
STAT,1848,23,20-24,1871,68.01552548584066
STAT,1822,43,20-24,1865,0.24656731757134295
STAT,1872,46,20-24,1918,0.012219646724453382
SIM,1783,91,na,1874,31
STAT,1904,35,20-24,1939,0.24344597715153157
SIM,1799,75,na,1874,666
SIM,1894,66,na,1960,2461
STAT,1826,31,20-24,1857,4.030183477727921
SIM,1850,27,35-39,1877,1
SIM,1879,29,30-34,1908,1
SIM,1893,46,50-100,1939,2
STAT,1860,104,na,1964,0.260543909955749
STAT,1888,29,na,1917,2824.668469319794
STAT,1907,41,50-100,1948,0.1093051914635463
STAT,1952,1,na,1953,4903.760963885574
STAT,1848,23,na,1871,2110.297801912594
STAT,1889,37,35-39,1926,8.80857532806257
STAT,1867,45,35-39,1912,0.13449872793094075
STAT,1916,28,40-44,1944,4.84642216559977
STAT,1854,23,na,1877,1871.8539920367589
STAT,1884,39,40-44,1923,4.316089756991365
STAT,1877,88,na,1965,318.5325404006565
STAT,1935,29,20-24,1964,25.114762307127634
SIM,1904,67,na,1971,2802
STAT,1851,29,35-39,1880,8.4319706153619
STAT,1825,34,40-44,1859,8.295223897627428
STAT,1833,24,na,1857,2003.552173500285
SIM,1833,34,40-44,1867,7
STAT,1856,89,na,1945,81.3478015384908
STAT,1885,46,50-100,1931,0.24761197090613973
STAT,1906,59,na,1965,3065.8603397822867
SIM,1829,30,35-39,1859,3
STAT,1934,36,45-49,1970,0.9514275786887234
STAT,1869,22,na,1891,2322.379557321026
STAT,1785,83,na,1868,131.22303224594435
STAT,1879,17,20-24,1896,18.68586896140106
SIM,1778,76,na,1854,255
SIM,1873,67,na,1940,1430
STAT,1857,25,20-24,1882,9.663075100640226
STAT,1932,31,50-100,1963,1.1113753647445115
