Source,YOB,Age,NPA,Date,freq
SIM,1896,0,na,1896,4216
STAT,1868,71,na,1939,1289.2450143244039
SIM,1875,18,na,1893,3113
STAT,1839,17,35-39,1856,0.6668755285007872
STAT,1876,90,na,1966,212.88202042564262
STAT,1906,62,na,1968,2921.3369986373764
STAT,1890,48,20-24,1938,0.008091634684983605
SIM,1867,4,na,1871,3115
STAT,1810,57,na,1867,76.56423043142739
SIM,1905,65,na,1970,2064
SIM,1859,55,na,1914,1535
STAT,1838,30,15-19,1868,0.07712432819446054
STAT,1871,18,50-100,1889,0.048897454441295174
SIM,1901,51,na,1952,3325
SIM,1941,16,na,1957,2442
STAT,1917,14,na,1931,4179.563381348922
STAT,1898,31,25-29,1929,13.82968889081334
STAT,1927,35,35-39,1962,2.9879027098862156
STAT,1934,25,25-29,1959,88.02146824801181
STAT,1925,27,25-29,1952,77.03004706538616
SIM,1907,9,na,1916,4894
STAT,1925,33,na,1958,4447.321368020313
SIM,1884,2,na,1886,3913
SIM,1933,27,25-29,1960,14
STAT,1907,36,20-24,1943,0.24393438275814355
STAT,1902,27,30-34,1929,35.46015475229568
STAT,1855,21,na,1876,1665.1330175619896
STAT,1859,35,na,1894,1885.0643722830682
STAT,1829,32,15-19,1861,0.07851553561458015
STAT,1942,24,20-24,1966,115.17657646123244
SIM,1797,62,na,1859,1587
STAT,1913,20,35-39,1933,9.063372552016917
STAT,1922,26,45-49,1948,1.939724170086116
SIM,1833,62,na,1895,1984
SIM,1915,36,20-24,1951,2
SIM,1924,7,na,1931,5320
STAT,1931,24,45-49,1955,1.4399964920781474
STAT,1916,34,20-24,1950,2.4626417831843685
SIM,1876,35,na,1911,3771
SIM,1869,23,20-24,1892,117
SIM,1914,26,na,1940,5085
STAT,1932,17,15-19,1949,59.676213799598806
SIM,1821,40,50-100,1861,30
STAT,1893,70,na,1963,1968.1006329884601
STAT,1815,88,na,1903,9.67926137745908
STAT,1918,42,30-34,1960,0.1340945523276397
STAT,1900,19,20-24,1919,24.427370841224146
STAT,1844,69,na,1913,1453.8789346311894
STAT,1923,19,15-19,1942,52.447424512842865
STAT,1909,44,30-34,1953,0.11690795922769498
STAT,1896,23,15-19,1919,4.335429922180428
STAT,1909,31,25-29,1940,8.765887335880356
STAT,1852,88,na,1940,138.18800471461358
SIM,1970,1,na,1971,5628
STAT,1907,23,15-19,1930,4.798721601437453
STAT,1940,30,50-100,1970,0.8470540583557828
STAT,1941,15,15-19,1956,46.23869326998214
SIM,1832,36,50-100,1868,52
SIM,1858,38,na,1896,2353
STAT,1787,105,na,1892,0.005278860141677973
STAT,1912,41,25-29,1953,0.0684642907656911
SIM,1854,24,na,1878,2138
STAT,1849,24,40-44,1873,2.092441236654108
STAT,1826,40,na,1866,2215.862097786572
STAT,1904,22,35-39,1926,8.337126648647718
SIM,1860,6,na,1866,2680
STAT,1924,48,15-19,1972,4.3313045603072294E-4
STAT,1801,96,na,1897,2.8486076539571603
STAT,1958,3,na,1961,5120.941555985737
STAT,1855,101,na,1956,0.4510989576426835
SIM,1850,10,na,1860,2356
SIM,1825,43,na,1868,439
SIM,1829,57,na,1886,1785
SIM,1865,30,25-29,1895,15
SIM,1917,39,35-39,1956,6
STAT,1867,15,45-49,1882,0.063905686300224
STAT,1829,101,na,1930,0.20837431671594153
STAT,1901,18,25-29,1919,7.9025467174828625
STAT,1929,7,na,1936,5065.662181248159
SIM,1941,5,na,1946,3904
STAT,1943,23,25-29,1966,97.12076957217735
SIM,1915,23,15-19,1938,26
STAT,1867,20,40-44,1887,2.007564331329003
STAT,1920,18,35-39,1938,4.635112574294858
SIM,1884,54,na,1938,3654
SIM,1953,3,na,1956,4664
STAT,1841,48,25-29,1889,0.06361190202594477
STAT,1942,13,na,1955,4057.4835509377144
SIM,1880,40,na,1920,3291
STAT,1838,41,na,1879,1062.1142549470258
STAT,1903,26,35-39,1929,13.743765811117392
STAT,1905,34,45-49,1939,1.4278639570190905
SIM,1884,22,na,1906,3791
STAT,1899,18,45-49,1917,0.08898811167330008
STAT,1855,22,15-19,1877,2.5507698357545547
STAT,1848,15,35-39,1863,0.6440846636036612
STAT,1809,60,na,1869,2436.4168902256524
STAT,1929,43,45-49,1972,0.21368346589750847
STAT,1827,89,na,1916,74.08285644348368
STAT,1920,23,30-34,1943,31.443907649251482
STAT,1922,31,40-44,1953,4.390125561706795
STAT,1857,30,25-29,1887,8.074256487712171
SIM,1888,36,na,1924,327
SIM,1912,35,40-44,1947,4
STAT,1904,35,40-44,1939,1.3627170937459752
SIM,1892,73,na,1965,2903
SIM,1850,42,na,1892,1274
STAT,1910,33,15-19,1943,0.12200249653597633
STAT,1878,15,20-24,1893,18.32508777323817
SIM,1882,42,50-100,1924,6
STAT,1912,21,30-34,1933,27.306652727784744
STAT,1926,36,30-34,1962,2.210337260898533
STAT,1934,30,20-24,1964,3.3114782169145194
STAT,1917,46,na,1963,3795.4864907140905
STAT,1938,18,20-24,1956,132.26290822311339
SIM,1950,19,25-29,1969,415
STAT,1944,27,35-39,1971,16.04412487670747
STAT,1913,32,na,1945,3715.654672341483
SIM,1884,30,35-39,1914,8
STAT,1942,19,25-29,1961,44.7396418250202
SIM,1902,45,25-29,1947,1
SIM,1929,18,20-24,1947,2
SIM,1930,32,na,1962,5344
STAT,1932,20,45-49,1952,1.474801587208214
STAT,1831,94,na,1925,15.642104579264021
SIM,1863,17,na,1880,1515
STAT,1914,32,45-49,1946,1.5619350482680205
STAT,1950,15,50-100,1965,0.4390106583271259
STAT,1915,25,15-19,1940,0.7147012008864606
STAT,1822,58,na,1880,1235.4954368185643
STAT,1910,16,25-29,1926,8.511506607655367
STAT,1919,41,35-39,1960,0.21562971446822748
STAT,1839,90,na,1929,73.2480979158642
SIM,1896,30,50-100,1926,17
STAT,1954,14,na,1968,4811.400987266994
STAT,1858,17,45-49,1875,0.058271683017124105
STAT,1894,2,na,1896,3389.8092187391926
STAT,1944,18,50-100,1962,0.398522444379475
STAT,1917,30,20-24,1947,2.5403465776329535
STAT,1944,15,40-44,1959,1.4890828511559628
STAT,1877,4,na,1881,2935.8288084448627
STAT,1897,52,na,1949,2844.373794370671
STAT,1903,39,40-44,1942,1.3277200466031345
STAT,1922,9,na,1931,4555.724610984687
STAT,1908,35,25-29,1943,0.9234126866110388
STAT,1934,38,30-34,1972,2.4955435151603456
SIM,1887,19,na,1906,3884
SIM,1911,23,30-34,1934,60
SIM,1920,21,30-34,1941,22
STAT,1899,23,40-44,1922,2.837411558769523
SIM,1793,80,na,1873,591
STAT,1917,38,30-34,1955,1.8585105419475008
SIM,1880,72,na,1952,3193
STAT,1905,13,na,1918,3708.7184728853513
STAT,1848,20,30-34,1868,20.58994909479763
STAT,1927,40,30-34,1967,0.1594727761079266
STAT,1839,22,30-34,1861,21.263230406828402
STAT,1871,46,45-49,1917,0.23608869835453514
STAT,1909,27,na,1936,3543.731509127985
STAT,1813,97,na,1910,3.935307394849235
STAT,1940,22,45-49,1962,1.1333468619740816
SIM,1894,32,na,1926,1577
STAT,1882,49,25-29,1931,0.05399540672081001
STAT,1889,33,na,1922,2861.5286363350347
STAT,1933,26,20-24,1959,24.083817592542218
STAT,1927,24,na,1951,4434.627264249329
STAT,1919,49,45-49,1968,0.23123968463537983
SIM,1898,25,40-44,1923,1
STAT,1885,83,na,1968,708.2297195025072
STAT,1923,22,45-49,1945,1.2954130058878808
STAT,1864,20,15-19,1884,3.0916284651134425
STAT,1865,49,25-29,1914,0.051490281798837335
STAT,1924,23,15-19,1947,6.201720156196812
SIM,1868,48,na,1916,1116
STAT,1913,28,45-49,1941,1.6938264665825618
SIM,1833,47,50-100,1880,9
STAT,1845,43,na,1888,1153.0183958345237
SIM,1941,26,20-24,1967,12
SIM,1872,53,na,1925,2166
STAT,1908,40,20-24,1948,0.016396602727926618
STAT,1869,25,20-24,1894,11.918307808473587
STAT,1912,29,40-44,1941,4.507463429739684
SIM,1942,25,25-29,1967,6
SIM,1902,33,30-34,1935,57
STAT,1889,65,na,1954,2035.0951352140253
STAT,1826,72,na,1898,1006.8253937568002
STAT,1837,24,na,1861,2212.185884083528
SIM,1876,67,na,1943,2321
STAT,1806,105,na,1911,0.008828993817378011
STAT,1885,51,na,1936,2126.6395154083116
STAT,1918,37,35-39,1955,2.515030219957122
SIM,1893,20,35-39,1913,64
STAT,1913,33,40-44,1946,3.828400277431783
SIM,1922,45,na,1967,3317
SIM,1901,16,25-29,1917,89
STAT,1859,21,45-49,1880,0.6347073279127661
STAT,1927,15,40-44,1942,1.7329829361317841
STAT,1920,43,25-29,1963,0.07772990086970154
STAT,1930,40,50-100,1970,0.1539143312042101
SIM,1922,13,na,1935,3692
STAT,1903,43,25-29,1946,0.06284257640106898
STAT,1940,19,15-19,1959,45.53193718975538
SIM,1839,35,na,1874,1000
SIM,1901,29,30-34,1930,8
SIM,1926,37,35-39,1963,1
STAT,1930,20,35-39,1950,12.049187248724934
STAT,1818,53,na,1871,1549.4614909159177
STAT,1846,60,na,1906,1129.5478800194117
SIM,1835,21,na,1856,1372
STAT,1861,33,50-100,1894,0.7587735667180262
SIM,1902,28,35-39,1930,2
STAT,1800,79,na,1879,496.1942762972079
STAT,1875,17,45-49,1892,0.06707655948885302
STAT,1876,15,na,1891,2565.0178560855406
STAT,1822,106,na,1928,0.007001509214542199
SIM,1789,75,na,1864,215
STAT,1939,25,na,1964,3727.8638696088774
SIM,1926,27,na,1953,5975
STAT,1930,28,45-49,1958,2.180262860338712
STAT,1810,49,35-39,1859,7.158762938240046E-4
STAT,1858,22,40-44,1880,1.8258272242049394
STAT,1860,45,30-34,1905,0.07975596589341923
STAT,1917,25,25-29,1942,68.56741602017512
SIM,1848,71,na,1919,1928
STAT,1877,32,na,1909,2422.392904812697
STAT,1876,30,35-39,1906,10.319823112130216
STAT,1935,11,na,1946,5385.716389356145
STAT,1808,54,50-100,1862,0.018580073920275792
STAT,1908,48,30-34,1956,0.07977468436399376
STAT,1924,36,20-24,1960,0.3081371576478248
SIM,1938,28,na,1966,4225
STAT,1926,44,30-34,1970,0.15573624748549733
STAT,1907,3,na,1910,3857.329148279927
SIM,1916,27,25-29,1943,158
SIM,1934,14,na,1948,5257
SIM,1856,40,25-29,1896,5
STAT,1910,21,20-24,1931,103.56568377388689
SIM,1904,48,na,1952,3986
STAT,1835,103,na,1938,0.10859137485892287
STAT,1851,39,na,1890,1842.0058188365952
STAT,1835,76,na,1911,716.8578239027653
STAT,1875,22,40-44,1897,2.1397637402137866
STAT,1891,39,25-29,1930,3.504996661001475
STAT,1855,30,15-19,1885,0.09798036668473309
STAT,1902,31,15-19,1933,0.2013523552627826
SIM,1868,16,na,1884,1326
SIM,1889,31,25-29,1920,1
STAT,1858,18,na,1876,2035.6145874733108
STAT,1914,24,45-49,1938,1.1264521852516491
SIM,1881,9,na,1890,3275
STAT,1916,46,15-19,1962,3.7360295207506137E-4
STAT,1931,21,40-44,1952,4.343328834174859
SIM,1834,36,na,1870,1011
SIM,1918,35,35-39,1953,4
STAT,1904,38,45-49,1942,0.6116853348174959
STAT,1864,20,50-100,1884,0.3821543660112959
STAT,1942,27,25-29,1969,68.2928665816899
STAT,1809,103,na,1912,0.13969408566947508
STAT,1848,40,25-29,1888,0.615751640176521
STAT,1922,43,35-39,1965,0.22818885978786552
SIM,1802,58,na,1860,935
STAT,1846,32,15-19,1878,0.09967179161835792
SIM,1903,41,25-29,1944,1
STAT,1920,35,25-29,1955,1.066012824884514
SIM,1948,18,30-34,1966,10
STAT,1930,42,30-34,1972,0.16703136746916766
STAT,1885,20,35-39,1905,5.770205526372967
SIM,1826,60,na,1886,1370
SIM,1888,23,30-34,1911,1
STAT,1861,49,40-44,1910,0.13940454523632134
STAT,1886,9,na,1895,2686.8725607954457
SIM,1901,33,15-19,1934,2
STAT,1849,27,45-49,1876,1.1089858791911207
SIM,1891,56,na,1947,1305
STAT,1901,43,15-19,1944,0.001331178348316274
STAT,1922,23,40-44,1945,3.8010601984676353
SIM,1855,20,15-19,1875,1
SIM,1928,42,40-44,1970,3
STAT,1879,87,na,1966,394.9830231586242
STAT,1875,73,na,1948,1219.6464589506952
STAT,1864,16,30-34,1880,1.6569625536248107
STAT,1913,45,35-39,1958,0.12484724044578327
STAT,1928,31,35-39,1959,11.346249672455825
SIM,1821,61,na,1882,1753
STAT,1935,37,35-39,1972,3.357843087821758
STAT,1921,22,35-39,1943,10.509047650955393
SIM,1898,46,na,1944,4080
STAT,1860,0,na,1860,3165.9969394841755
STAT,1896,35,na,1931,3135.2119211737904
STAT,1812,49,45-49,1861,0.05886187516770393
STAT,1907,19,30-34,1926,2.3131381378778015
STAT,1905,31,40-44,1936,3.596260251516027
STAT,1829,45,50-100,1874,0.11658892061575625
STAT,1933,22,50-100,1955,0.8668746427826332
STAT,1910,29,30-34,1939,37.14592233881208
STAT,1892,21,na,1913,2936.9924360853015
STAT,1902,22,25-29,1924,80.61100504774771
SIM,1846,26,30-34,1872,27
STAT,1802,108,na,1910,9.2807420365033E-4
STAT,1904,30,35-39,1934,14.584797877628375
STAT,1948,24,15-19,1972,6.045417335789632
STAT,1900,5,na,1905,3630.3323369790032
SIM,1902,3,na,1905,3827
STAT,1829,37,na,1866,1000.4714355362366
STAT,1884,34,na,1918,2264.792010773319
STAT,1867,23,45-49,1890,0.6574401879392227
STAT,1903,23,30-34,1926,25.20660582630239
STAT,1850,27,50-100,1877,0.3476095981479679
STAT,1888,48,na,1936,2564.533852928673
STAT,1881,69,na,1950,1385.8713172654896
SIM,1910,22,25-29,1932,20
STAT,1918,45,35-39,1963,0.1359879201068998
STAT,1923,30,45-49,1953,1.7993188179452577
SIM,1901,37,30-34,1938,4
STAT,1922,34,45-49,1956,1.7495213584961387
SIM,1869,26,25-29,1895,2
STAT,1777,97,na,1874,2.4256930215829597
STAT,1854,25,50-100,1879,0.41569396583075574
STAT,1841,45,20-24,1886,0.013771756747995696
STAT,1824,48,25-29,1872,0.009885307246250813
STAT,1888,21,15-19,1909,3.8191093052710197
SIM,1924,37,25-29,1961,1
SIM,1917,34,na,1951,2041
STAT,1925,24,20-24,1949,131.05578815049225
SIM,1913,20,na,1933,3545
STAT,1928,39,45-49,1967,0.8531790992969706
STAT,1830,45,45-49,1875,0.20691967384684498
SIM,1912,30,35-39,1942,33
STAT,1838,26,30-34,1864,13.77296941841876
STAT,1918,17,40-44,1935,0.30132208417970857
STAT,1880,20,na,1900,2469.935373248579
STAT,1937,15,50-100,1952,0.3623864034429522
STAT,1852,56,na,1908,2053.0709779448634
STAT,1829,40,15-19,1869,0.0068414927087424105
STAT,1943,28,30-34,1971,41.2336759695538
STAT,1933,34,20-24,1967,3.2605657792295095
SIM,1900,34,na,1934,4134
STAT,1916,37,25-29,1953,0.9945407781313859
STAT,1814,51,50-100,1865,0.05079661853432174
STAT,1943,20,20-24,1963,117.0337007239361
STAT,1908,27,25-29,1935,62.26441658635788
STAT,1911,42,20-24,1953,0.01666592727440032
STAT,1896,31,15-19,1927,0.18849303943375129
SIM,1903,4,na,1907,3100
SIM,1933,24,20-24,1957,48
STAT,1933,38,15-19,1971,0.02595253351700671
STAT,1921,51,na,1972,4040.2875352571496
STAT,1934,7,na,1941,5370.178910293841
STAT,1904,27,40-44,1931,4.27974996540089
STAT,1903,40,20-24,1943,0.015812761996199395
STAT,1865,6,na,1871,2579.255322117706
STAT,1840,49,20-24,1889,0.004644300482372848
STAT,1839,15,na,1854,2822.9298087351194
STAT,1935,21,25-29,1956,124.92024210116718
SIM,1897,72,na,1969,1237
STAT,1820,48,40-44,1868,0.26545755892242195
STAT,1872,39,15-19,1911,0.05566497005212049
STAT,1900,42,45-49,1942,0.14379513404132205
STAT,1952,17,40-44,1969,1.660868256430641
STAT,1909,39,35-39,1948,2.243319731180128
SIM,1919,25,na,1944,4628
STAT,1798,59,na,1857,1495.4556748752773
STAT,1879,27,30-34,1906,25.832596090464097
STAT,1851,104,na,1955,0.052679197040231315
STAT,1856,70,na,1926,1007.763035386243
SIM,1915,11,na,1926,3758
STAT,1907,44,20-24,1951,0.015874158762679908
STAT,1944,24,30-34,1968,30.6621319723992
SIM,1842,23,na,1865,3370
SIM,1854,56,na,1910,986
STAT,1934,17,25-29,1951,58.21835436203009
STAT,1864,57,na,1921,1826.9679034647054
STAT,1913,41,40-44,1954,0.24224543520799396
STAT,1860,43,na,1903,1871.8709290781949
SIM,1840,75,na,1915,1993
SIM,1909,47,na,1956,3834
STAT,1860,22,50-100,1882,0.34293753416030875
SIM,1905,33,na,1938,2993
SIM,1846,37,na,1883,1155
SIM,1888,7,na,1895,676
STAT,1797,74,na,1871,18.657645604141678
STAT,1872,22,15-19,1894,3.3035093596678213
STAT,1850,38,25-29,1888,1.3366050359881223
STAT,1858,30,40-44,1888,3.3812922495718123
STAT,1848,23,35-39,1871,6.601214197962421
STAT,1925,32,20-24,1957,2.8699934541926146
SIM,1847,54,na,1901,1382
SIM,1916,49,na,1965,4515
STAT,1821,52,40-44,1873,0.010865709534220709
STAT,1871,16,na,1887,2550.6971385746515
SIM,1853,39,na,1892,3182
SIM,1877,17,20-24,1894,43
SIM,1912,35,na,1947,4580
STAT,1869,17,20-24,1886,18.137265611938332
STAT,1897,15,30-34,1912,2.1265760966377902
STAT,1929,35,45-49,1964,0.8705846686057231
SIM,1925,33,25-29,1958,4
STAT,1889,16,35-39,1905,0.6623921370490086
STAT,1808,75,na,1883,267.992399382002
STAT,1785,84,na,1869,47.573218098043604
SIM,1829,25,na,1854,2107
STAT,1789,98,na,1887,1.0331855810199702
SIM,1848,30,25-29,1878,235
STAT,1917,33,25-29,1950,9.50898839564113
STAT,1804,61,na,1865,1805.7092780160833
STAT,1924,28,20-24,1952,20.9754229430392
STAT,1926,19,40-44,1945,1.6910732704142628
SIM,1856,23,35-39,1879,32
SIM,1907,34,20-24,1941,26
STAT,1912,37,40-44,1949,1.4441107132684168
STAT,1934,26,na,1960,5007.625692365641
STAT,1889,41,25-29,1930,0.7768005700732138
STAT,1916,29,25-29,1945,66.64778332355952
STAT,1898,7,na,1905,3503.4662124029246
STAT,1868,16,15-19,1884,5.870368962239855
STAT,1893,30,50-100,1923,1.15500057993044
STAT,1914,41,35-39,1955,0.19704006264653826
STAT,1930,12,na,1942,5086.629087106078
STAT,1919,46,40-44,1965,0.16915528881734312
STAT,1868,50,50-100,1918,0.014796931332738116
SIM,1924,29,25-29,1953,273
STAT,1934,33,50-100,1967,1.1205159959599147
SIM,1873,70,na,1943,609
STAT,1950,18,20-24,1968,158.72835970942745
STAT,1882,46,20-24,1928,0.011521542738192761
STAT,1930,25,40-44,1955,5.8902308228253935
STAT,1862,53,40-44,1915,0.008822858878277025
STAT,1860,48,35-39,1908,0.11277583983004608
STAT,1849,68,na,1917,1287.6468420016115
STAT,1911,25,30-34,1936,38.037313003642225
STAT,1830,77,na,1907,625.6231147160448
SIM,1869,33,na,1902,3598
STAT,1908,44,15-19,1952,0.0013924953280470655
STAT,1816,62,na,1878,1844.5972685153038
SIM,1839,67,na,1906,127
STAT,1839,40,50-100,1879,1.166287345478595
STAT,1936,33,35-39,1969,8.782677896649382
SIM,1886,15,20-24,1901,143
STAT,1915,17,15-19,1932,9.364306743878448
STAT,1875,16,50-100,1891,0.050430975506630976
STAT,1918,34,30-34,1952,16.37480566481173
STAT,1899,31,40-44,1930,5.94758589918927
STAT,1901,35,15-19,1936,0.01710797152179567
STAT,1923,27,15-19,1950,0.801984595557285
SIM,1862,43,na,1905,3484
SIM,1931,27,15-19,1958,5
STAT,1831,38,15-19,1869,0.056324375418333725
STAT,1935,29,35-39,1964,20.29808761331149
STAT,1914,21,40-44,1935,3.260353042304453
STAT,1917,22,20-24,1939,116.60164690102637
STAT,1919,30,30-34,1949,16.90705176151249
STAT,1830,42,40-44,1872,1.9884197588834136
SIM,1921,42,30-34,1963,2
STAT,1918,28,45-49,1946,1.8073789348803984
STAT,1856,48,20-24,1904,0.008510744410708591
STAT,1921,38,45-49,1959,0.7514098623650843
STAT,1887,16,25-29,1903,6.252534780317853
STAT,1940,31,35-39,1971,9.357157958547603
STAT,1836,18,na,1854,2301.99181339832
SIM,1889,21,na,1910,3885
STAT,1840,23,na,1863,1062.956080799928
STAT,1874,39,25-29,1913,2.9416159297964564
STAT,1844,37,na,1881,2466.4390453774167
SIM,1918,32,30-34,1950,34
STAT,1914,40,45-49,1954,0.16375619008370104
STAT,1957,11,na,1968,5134.451122179958
STAT,1944,19,35-39,1963,4.461889995750147
STAT,1937,21,35-39,1958,9.077467493064002
SIM,1899,52,na,1951,1549
SIM,1927,12,na,1939,1973
STAT,1881,20,15-19,1901,3.1340143751465033
STAT,1861,92,na,1953,34.63744167197312
STAT,1873,17,35-39,1890,0.5628546584589879
SIM,1852,49,40-44,1901,2
STAT,1855,26,30-34,1881,17.49746972876069
STAT,1859,30,35-39,1889,8.14356268223986
STAT,1828,74,na,1902,751.2494177407534
STAT,1906,48,20-24,1954,0.009678832247965062
STAT,1926,28,30-34,1954,46.40417266800446
STAT,1905,18,50-100,1923,0.07028140429669916
STAT,1921,19,40-44,1940,1.5669996631656242
STAT,1910,24,25-29,1934,85.23610728544773
STAT,1874,30,25-29,1904,10.656020511192892
STAT,1913,42,30-34,1955,0.12310898500218373
SIM,1827,77,na,1904,783
STAT,1807,48,25-29,1855,0.1958400213833356
STAT,1906,35,15-19,1941,0.017717990958986345
STAT,1857,87,na,1944,135.1943369249552
STAT,1876,47,na,1923,2263.7788237941922
STAT,1853,73,na,1926,920.9699871516899
STAT,1866,27,45-49,1893,1.0135054689923637
STAT,1881,29,15-19,1910,0.4253907460264216
STAT,1809,92,na,1901,40.540542425698995
STAT,1919,38,40-44,1957,1.5852666570751688
STAT,1932,38,20-24,1970,0.3513669557996454
STAT,1898,29,50-100,1927,0.8540570512871537
SIM,1925,22,20-24,1947,1
STAT,1920,32,20-24,1952,2.637365121027704
SIM,1822,38,15-19,1860,2
STAT,1824,36,50-100,1860,0.1917744389904591
SIM,1927,38,40-44,1965,2
STAT,1901,27,15-19,1928,0.6343737818195281
STAT,1842,49,30-34,1891,0.02352833527605625
STAT,1867,49,35-39,1916,0.12963775189137328
STAT,1886,22,50-100,1908,0.4222873987536669
STAT,1921,30,35-39,1951,10.129807248795839
STAT,1937,34,40-44,1971,3.8266962742973356
STAT,1910,37,30-34,1947,1.7235976503016446
STAT,1804,93,na,1897,18.517220996227515
STAT,1831,62,na,1893,1430.4738536392579
STAT,1832,23,50-100,1855,0.5337981129793314
SIM,1902,36,35-39,1938,2
STAT,1952,18,30-34,1970,14.46864849376854
STAT,1940,30,45-49,1970,1.6121351532739596
SIM,1896,25,30-34,1921,109
SIM,1810,45,na,1855,3168
STAT,1907,27,30-34,1934,36.7428309242716
STAT,1864,5,na,1869,2598.6912831592467
STAT,1866,20,25-29,1886,53.4462651158013
STAT,1869,24,50-100,1893,0.40891789039143805
SIM,1913,43,35-39,1956,7
SIM,1814,59,na,1873,2442
SIM,1871,36,na,1907,1866
STAT,1917,42,15-19,1959,0.0015812248635349358
STAT,1930,36,45-49,1966,0.8837715265074629
SIM,1883,69,na,1952,1771
STAT,1926,20,20-24,1946,134.7292240489947
STAT,1836,53,50-100,1889,0.011480007085366414
SIM,1838,20,15-19,1858,1
SIM,1850,74,na,1924,644
STAT,1937,29,45-49,1966,1.6650032786450297
STAT,1846,40,15-19,1886,0.008492890212360322
STAT,1924,43,45-49,1967,0.19575115720856828
STAT,1930,17,40-44,1947,1.795622533364907
STAT,1909,35,40-44,1944,1.415849149018766
STAT,1933,37,25-29,1970,1.3320023320549392
STAT,1829,69,na,1898,535.9020457620805
STAT,1888,25,30-34,1913,29.26121458733577
STAT,1917,49,35-39,1966,0.13209145810236944
STAT,1833,38,25-29,1871,1.5387751683561737
STAT,1828,34,50-100,1862,1.2988310075014962
STAT,1905,43,35-39,1948,0.1795574306897826
SIM,1899,31,na,1930,1964
STAT,1863,72,na,1935,1078.1489084810382
STAT,1878,35,50-100,1913,1.275183391897896
STAT,1915,20,45-49,1935,1.106889915539169
STAT,1937,0,na,1937,4337.451467549759
STAT,1924,38,50-100,1962,0.4898329077453913
STAT,1912,47,na,1959,3489.6676299270375
STAT,1932,25,15-19,1957,0.9190183600970236
STAT,1928,30,na,1958,4698.4007792970815
STAT,1900,14,na,1914,3565.9304773130007
STAT,1950,4,na,1954,4622.387427121999
SIM,1846,69,na,1915,319
SIM,1909,21,25-29,1930,3
STAT,1900,47,15-19,1947,3.1110907457536276E-4
SIM,1940,4,na,1944,4380
SIM,1945,21,35-39,1966,8
STAT,1921,8,na,1929,4492.363689834396
SIM,1940,25,15-19,1965,13
STAT,1904,28,na,1932,3397.6142008842153
STAT,1867,86,na,1953,209.83497725981303
STAT,1910,35,na,1945,3591.6857144958853
STAT,1913,4,na,1917,4061.617252554321
STAT,1914,49,na,1963,3571.787318393558
STAT,1825,55,na,1880,1384.51639664885
STAT,1856,1,na,1857,2696.073715200934
SIM,1857,21,na,1878,1484
STAT,1926,27,40-44,1953,5.539601769594218
STAT,1850,22,na,1872,1185.0157894142287
SIM,1829,34,30-34,1863,202
SIM,1881,57,na,1938,2070
STAT,1821,41,na,1862,1408.316093233597
STAT,1901,6,na,1907,3652.6376508345525
SIM,1812,57,na,1869,1143
STAT,1874,42,50-100,1916,1.0889862409907614
STAT,1823,49,20-24,1872,0.0181947301247666
STAT,1893,39,35-39,1932,8.755865221473034
SIM,1932,0,na,1932,6597
STAT,1824,92,na,1916,8.060149427721216
STAT,1856,25,35-39,1881,7.285704585119585
STAT,1947,12,na,1959,4378.302205107344
STAT,1907,47,25-29,1954,0.04718678543026503
STAT,1854,36,na,1890,1316.2698899027114
SIM,1856,58,na,1914,158
STAT,1916,38,15-19,1954,0.01930086480663121
STAT,1779,77,na,1856,508.8003147135
STAT,1806,49,20-24,1855,0.03421440999212919
STAT,1902,19,30-34,1921,2.2323874962612154
STAT,1836,102,na,1938,0.2243776611423169
STAT,1838,73,na,1911,506.5435411784565
STAT,1836,26,20-24,1862,11.716280900503449
STAT,1846,49,15-19,1895,2.3195776817012956E-4
STAT,1938,30,40-44,1968,3.8971334621887554
STAT,1806,63,na,1869,782.1609421843287
STAT,1909,16,50-100,1925,0.07290217912963798
STAT,1795,62,na,1857,1087.3767981579383
STAT,1901,30,45-49,1931,2.457837582620749
STAT,1846,17,na,1863,1707.8073702849829
STAT,1787,96,na,1883,0.7475329606649167
SIM,1944,13,na,1957,2516
STAT,1799,76,na,1875,76.30118825358761
SIM,1918,27,35-39,1945,11
STAT,1901,25,50-100,1926,0.9004957037272558
STAT,1905,18,45-49,1923,0.09370853906226558
STAT,1921,31,25-29,1952,10.205214963627531
STAT,1893,30,35-39,1923,12.76597422632712
STAT,1884,20,40-44,1904,2.006674631885453
STAT,1938,26,50-100,1964,0.975978437596785
STAT,1838,22,15-19,1860,1.8271112576518131
STAT,1903,47,50-100,1950,0.1957406285240014
STAT,1911,17,30-34,1928,2.411618267318344
STAT,1903,17,45-49,1920,0.09272602832024324
STAT,1904,44,50-100,1948,0.10339748874934195
STAT,1920,26,35-39,1946,16.313515214045523
STAT,1865,31,50-100,1896,0.8399425724332403
STAT,1815,56,na,1871,183.22781060208925
SIM,1878,90,na,1968,213
STAT,1815,47,20-24,1862,0.0012163652732359428
STAT,1929,33,50-100,1962,1.042204334248011
STAT,1841,37,20-24,1878,1.0113526007086833
SIM,1900,66,na,1966,3491
STAT,1867,40,35-39,1907,1.7298211876196476
SIM,1868,5,na,1873,1405
SIM,1879,32,na,1911,1430
SIM,1824,37,na,1861,2227
STAT,1851,43,50-100,1894,0.8283504956652895
STAT,1882,54,na,1936,2004.8308573858385
STAT,1814,82,na,1896,315.7757794750525
STAT,1821,39,45-49,1860,2.3322830829331447
STAT,1846,92,na,1938,24.667317798941575
STAT,1909,40,15-19,1949,0.001437878462797004
STAT,1888,28,35-39,1916,11.097242693924926
SIM,1933,16,20-24,1949,2047
SIM,1844,26,20-24,1870,39
STAT,1925,16,20-24,1941,162.6747307103652
STAT,1882,38,20-24,1920,0.7343580608467966
SIM,1877,20,na,1897,68
STAT,1882,86,na,1968,465.179808026358
STAT,1880,53,50-100,1933,0.015427243689075502
STAT,1830,52,50-100,1882,0.011355653019275868
STAT,1811,63,na,1874,1290.393942876845
STAT,1815,77,na,1892,60.94448360373826
STAT,1874,35,na,1909,2454.617626887849
STAT,1893,38,na,1931,2931.6017631994337
SIM,1907,26,20-24,1933,41
STAT,1906,22,45-49,1928,1.0097714170399763
STAT,1884,40,35-39,1924,1.7509331045677823
STAT,1886,68,na,1954,1582.5251221790502
SIM,1847,22,na,1869,1712
STAT,1862,55,na,1917,1761.1564707797068
STAT,1878,49,na,1927,2266.460859788908
STAT,1915,46,20-24,1961,0.01100577985138855
STAT,1866,69,na,1935,1339.6010674568533
STAT,1862,16,20-24,1878,17.396640874566494
STAT,1853,51,50-100,1904,0.011766531569913138
STAT,1858,18,50-100,1876,0.043446347103114916
SIM,1911,29,na,1940,2510
STAT,1830,45,na,1875,1793.1698568791235
STAT,1925,40,20-24,1965,0.02124444040285581
STAT,1834,59,na,1893,856.4948848563008
STAT,1920,13,na,1933,4381.469032866611
STAT,1935,30,15-19,1965,0.17670554238500258
STAT,1877,38,50-100,1915,1.240124980301313
STAT,1844,40,50-100,1884,1.0997294368490005
STAT,1882,15,35-39,1897,0.5277805682985546
STAT,1924,27,na,1951,4319.873662737213
STAT,1901,26,25-29,1927,59.34946427857033
SIM,1958,9,na,1967,4197
STAT,1912,33,25-29,1945,8.951105771812736
SIM,1917,20,20-24,1937,13
SIM,1782,85,na,1867,514
STAT,1863,15,25-29,1878,5.58594297300111
SIM,1832,56,na,1888,1048
STAT,1939,18,15-19,1957,44.91393150992117
SIM,1861,58,na,1919,1737
STAT,1847,20,15-19,1867,3.7095821131993576
STAT,1945,20,30-34,1965,31.173673947461978
SIM,1870,16,20-24,1886,92
STAT,1861,17,na,1878,2194.1614234966087
STAT,1922,42,45-49,1964,0.1888968759095646
STAT,1911,16,40-44,1927,0.27742277669139215
SIM,1920,33,25-29,1953,49
SIM,1929,24,na,1953,6227
STAT,1820,43,50-100,1863,1.7133472717375677
STAT,1846,15,25-29,1861,4.266148997618349
STAT,1867,31,45-49,1898,1.6559246852253846
STAT,1931,33,35-39,1964,11.882740394440514
STAT,1826,48,35-39,1874,0.1977075347753295
SIM,1925,10,na,1935,5291
STAT,1925,35,25-29,1960,1.1729625864262063
STAT,1929,32,40-44,1961,4.935957066712312
SIM,1861,69,na,1930,1395
SIM,1906,50,na,1956,3168
STAT,1847,27,35-39,1874,10.485514025017164
STAT,1879,23,15-19,1902,3.3738128979776283
STAT,1922,18,45-49,1940,0.5701785426240166
STAT,1935,25,40-44,1960,6.313389766209019
STAT,1881,16,30-34,1897,1.5088637646696956
SIM,1908,38,30-34,1946,15
SIM,1832,45,na,1877,1745
STAT,1894,41,50-100,1935,1.3495248370978283
STAT,1908,42,50-100,1950,0.10785051344555753
STAT,1911,21,15-19,1932,5.00668762926446
STAT,1912,31,50-100,1943,0.807394819772913
SIM,1932,36,20-24,1968,10
STAT,1845,53,40-44,1898,0.005140121867186481
STAT,1902,38,35-39,1940,2.1390743890696555
STAT,1845,27,50-100,1872,0.38636437719622785
STAT,1853,51,25-29,1904,0.002759577417124276
STAT,1858,25,45-49,1883,0.880590129137989
SIM,1853,18,na,1871,3603
STAT,1909,47,35-39,1956,0.11726685001611137
STAT,1848,49,25-29,1897,0.052775210129172336
STAT,1905,40,30-34,1945,0.11598744515452857
STAT,1908,10,na,1918,3812.7593375189176
STAT,1921,35,40-44,1956,1.6545522840921176
SIM,1919,46,na,1965,4904
STAT,1917,37,40-44,1954,1.5341157131371346
SIM,1915,32,na,1947,3240
STAT,1911,49,40-44,1960,0.1467130787850157
STAT,1918,25,40-44,1943,4.926677151560038
STAT,1869,16,30-34,1885,1.6402776017873437
SIM,1845,74,na,1919,553
SIM,1881,25,na,1906,3129
SIM,1935,32,30-34,1967,9
STAT,1870,44,50-100,1914,1.0389955058880282
STAT,1899,26,50-100,1925,0.8767333390700892
STAT,1919,33,35-39,1952,9.687255340347953
SIM,1864,30,30-34,1894,29
STAT,1852,54,50-100,1906,0.014784193609074564
SIM,1896,20,25-29,1916,6
STAT,1841,40,na,1881,2743.8259409924717
STAT,1911,41,30-34,1952,0.12134210960894229
STAT,1843,95,na,1938,13.136586678906713
STAT,1935,28,45-49,1963,2.336894706531276
STAT,1837,88,na,1925,110.07859717637639
SIM,1851,59,na,1910,1047
SIM,1818,41,na,1859,921
STAT,1863,40,na,1903,1993.0434343533693
STAT,1812,54,40-44,1866,0.002488064404542178
STAT,1918,31,na,1949,3980.9509950129045
STAT,1895,3,na,1898,3439.040584510259
STAT,1891,68,na,1959,1985.617677383681
STAT,1794,77,na,1871,4.256969710452003
STAT,1833,74,na,1907,456.608302712276
STAT,1856,30,30-34,1886,12.960420934385677
SIM,1842,55,na,1897,3011
STAT,1888,20,25-29,1908,66.46502310997886
STAT,1845,54,na,1899,1039.057084738677
STAT,1844,15,15-19,1859,7.562413226824766
STAT,1867,54,na,1921,1980.3180859283498
SIM,1848,34,40-44,1882,2
STAT,1916,41,45-49,1957,0.16846941558288495
STAT,1930,21,25-29,1951,117.85527149025815
STAT,1950,17,30-34,1967,14.274914271807772
SIM,1862,38,45-49,1900,1
STAT,1881,50,50-100,1931,0.014467202241413252
SIM,1925,8,na,1933,5336
STAT,1906,15,50-100,1921,0.07127335270374856
SIM,1870,37,40-44,1907,2
STAT,1865,15,35-39,1880,0.5740355205577526
STAT,1890,38,50-100,1928,1.4789421934218927
STAT,1827,37,50-100,1864,1.2106457972689584
STAT,1945,23,35-39,1968,10.202390286967466
SIM,1852,15,15-19,1867,53
SIM,1890,3,na,1893,4061
STAT,1855,39,15-19,1894,0.03679108647168838
STAT,1849,9,na,1858,2526.864273606376
STAT,1903,18,35-39,1921,0.776858067392077
STAT,1901,23,20-24,1924,96.05676019528872
STAT,1923,31,35-39,1954,10.408395412469194
STAT,1888,16,na,1904,2922.1221206699233
STAT,1849,20,25-29,1869,59.16372711967198
STAT,1926,23,25-29,1949,110.91197667360817
STAT,1896,67,na,1963,2289.2061139174757
STAT,1952,6,na,1958,4667.970710976842
STAT,1862,87,na,1949,150.06040120536943
STAT,1897,31,30-34,1928,23.28216998787721
STAT,1892,53,na,1945,2623.0928638431087
STAT,1922,16,50-100,1938,0.42981028616665035
SIM,1896,28,35-39,1924,51
STAT,1884,15,45-49,1899,0.0628219610522195
STAT,1831,30,na,1861,2240.1624893891308
STAT,1865,38,20-24,1903,0.7002874094413717
STAT,1868,20,35-39,1888,5.7181378155517
STAT,1866,24,40-44,1890,1.8902319802679561
STAT,1942,28,15-19,1970,0.7321213745368429
STAT,1882,24,50-100,1906,0.38797860715506294
STAT,1887,41,15-19,1928,0.015268886079522056
STAT,1852,20,45-49,1872,0.8459469314660117
SIM,1966,2,na,1968,5081
STAT,1913,17,40-44,1930,0.28239087625704945
STAT,1835,44,na,1879,1857.8476987078843
STAT,1788,81,na,1869,81.87286994550706
STAT,1943,27,40-44,1970,4.907391009216945
STAT,1852,38,35-39,1890,7.0842045607831405
SIM,1817,56,na,1873,2287
SIM,1813,42,na,1855,240
SIM,1860,38,35-39,1898,144
STAT,1908,32,20-24,1940,2.284565771754458
STAT,1874,37,50-100,1911,1.2671121910678014
SIM,1858,49,35-39,1907,1
STAT,1923,48,20-24,1971,0.01275632442086447
SIM,1902,36,na,1938,3387
SIM,1940,31,na,1971,4258
STAT,1906,19,15-19,1925,8.547567171703834
STAT,1930,41,40-44,1971,0.3272608533637952
STAT,1931,17,20-24,1948,176.20769213457191
SIM,1823,63,na,1886,708
STAT,1927,32,30-34,1959,19.222837570800433
STAT,1867,28,15-19,1895,0.4275697695058907
STAT,1823,39,50-100,1862,2.1770022280521366
STAT,1897,49,20-24,1946,0.00880188742186503
STAT,1917,46,30-34,1963,0.09209870237679504
SIM,1949,12,na,1961,4479
STAT,1904,31,25-29,1935,14.693369171456778
STAT,1877,27,20-24,1904,11.90883491846678
STAT,1914,29,50-100,1943,0.9823871729264376
STAT,1936,17,35-39,1953,3.977499001329655
STAT,1841,18,na,1859,3277.3112851395103
STAT,1891,30,25-29,1921,12.696870428587417
STAT,1897,20,na,1917,3159.6478308704714
STAT,1870,21,na,1891,2364.913704624737
SIM,1792,63,na,1855,1099
SIM,1796,77,na,1873,580
STAT,1859,26,15-19,1885,0.36845385579412976
STAT,1781,109,na,1890,0.0035160328908477156
STAT,1914,17,na,1931,3939.7002420990034
STAT,1840,55,na,1895,814.1717159931952
STAT,1870,39,40-44,1909,4.320155089409237
SIM,1855,73,na,1928,2200
STAT,1907,28,20-24,1935,17.057070803550666
SIM,1899,20,na,1919,2176
STAT,1871,17,25-29,1888,5.689316781051726
STAT,1903,65,na,1968,2695.555793075329
STAT,1928,44,40-44,1972,0.3153856627102922
SIM,1837,36,30-34,1873,28
STAT,1921,42,50-100,1963,0.13075140410316013
STAT,1829,49,15-19,1878,1.802732943939868E-4
SIM,1912,31,25-29,1943,6
STAT,1925,19,25-29,1944,51.59161346977197
SIM,1894,49,50-100,1943,1
SIM,1865,40,na,1905,1699
STAT,1820,52,25-29,1872,0.005372767479522323
STAT,1858,48,30-34,1906,0.07299386287693184
SIM,1869,54,na,1923,3598
STAT,1848,33,50-100,1881,0.9004916466778548
STAT,1820,56,na,1876,1516.4405588500993
STAT,1911,45,25-29,1956,0.04988613517216395
STAT,1839,25,35-39,1864,11.457181728844953
STAT,1902,35,30-34,1937,1.6352509199665808
STAT,1951,5,na,1956,4638.429911902696
STAT,1872,76,na,1948,948.6917383727563
SIM,1867,26,15-19,1893,8
STAT,1899,26,45-49,1925,1.5217310398062005
STAT,1871,91,na,1962,123.24877968426992
STAT,1880,53,35-39,1933,0.008794031445556539
SIM,1929,30,40-44,1959,171
STAT,1848,8,na,1856,2848.6276853885997
STAT,1872,30,15-19,1902,0.14374753983158967
SIM,1926,29,35-39,1955,2
STAT,1812,50,25-29,1862,9.0722958591034E-4
STAT,1840,44,na,1884,925.3105739870877
SIM,1905,41,35-39,1946,1
SIM,1838,18,na,1856,2432
STAT,1940,27,15-19,1967,0.7118029352551521
STAT,1880,28,45-49,1908,1.1486087448401834
STAT,1840,37,50-100,1877,0.5717786495376668
STAT,1917,17,25-29,1934,9.200887267989913
STAT,1918,27,50-100,1945,1.044985470213758
STAT,1938,33,45-49,1971,1.5643222027140329
STAT,1906,2,na,1908,3860.065885090897
STAT,1952,12,na,1964,4664.377523988158
STAT,1821,107,na,1928,0.002381637386844381
STAT,1886,49,50-100,1935,0.249020864723302
STAT,1896,27,30-34,1923,33.19550118660489
STAT,1918,21,25-29,1939,98.57591165900087
STAT,1851,16,45-49,1867,0.0630971331075944
STAT,1857,44,50-100,1901,0.799737760088543
SIM,1926,21,25-29,1947,313
STAT,1909,38,45-49,1947,0.6355348184471019
STAT,1883,17,na,1900,2429.7421923683855
SIM,1869,65,na,1934,3598
STAT,1905,15,40-44,1920,0.2642955015992705
SIM,1838,40,30-34,1878,2
STAT,1829,36,30-34,1865,2.750563720678376
SIM,1889,53,na,1942,3555
STAT,1883,21,50-100,1904,0.393496412351692
STAT,1849,30,50-100,1879,0.9127350465007228
STAT,1924,27,30-34,1951,45.18339799590593
STAT,1920,45,50-100,1965,0.24796800699356378
SIM,1890,39,na,1929,3595
STAT,1840,28,15-19,1868,0.22114797678199058
STAT,1847,24,30-34,1871,19.459925304898505
STAT,1918,29,35-39,1947,15.64959218940237
STAT,1909,19,40-44,1928,0.2700453832137444
STAT,1804,52,40-44,1856,0.06649742997864985
STAT,1931,30,30-34,1961,20.522507161100364
SIM,1941,18,20-24,1959,1111
STAT,1805,78,na,1883,128.04899966772757
STAT,1905,27,20-24,1932,16.873587322449282
STAT,1933,18,20-24,1951,179.78322760889097
SIM,1889,30,35-39,1919,8
STAT,1937,23,na,1960,3518.21297271746
STAT,1895,15,20-24,1910,23.169710600025212
STAT,1913,36,45-49,1949,0.6675175410144283
SIM,1921,28,na,1949,5245
SIM,1906,17,15-19,1923,154
STAT,1935,34,30-34,1969,21.612384051062033
SIM,1932,27,30-34,1959,424
STAT,1914,37,15-19,1951,0.018906754056175683
STAT,1860,41,15-19,1901,0.011316926601931215
STAT,1801,64,na,1865,755.1480727909185
SIM,1879,41,30-34,1920,3
STAT,1849,40,40-44,1889,1.9283448141712676
SIM,1898,21,25-29,1919,31
SIM,1878,37,30-34,1915,37
STAT,1925,44,15-19,1969,0.0018360996128547623
SIM,1866,36,na,1902,2881
STAT,1871,43,40-44,1914,2.227542428878868
SIM,1803,64,na,1867,965
STAT,1915,49,25-29,1964,0.0523878509070835
SIM,1872,21,na,1893,2464
SIM,1821,37,45-49,1858,9
STAT,1839,50,25-29,1889,0.0033726467476198813
STAT,1887,53,na,1940,2331.946024685712
SIM,1866,48,30-34,1914,1
STAT,1892,17,45-49,1909,0.0808753903799026
STAT,1852,17,15-19,1869,7.22489985211267
STAT,1840,15,30-34,1855,0.8222198099803214
STAT,1861,53,25-29,1914,0.002898393857650615
STAT,1826,30,45-49,1856,4.16837900321577
STAT,1912,24,35-39,1936,9.236307315917061
SIM,1935,31,na,1966,5704
STAT,1903,47,40-44,1950,0.1364446076049771
STAT,1934,22,20-24,1956,148.42083936781168
STAT,1912,30,20-24,1942,2.391307042069634
STAT,1870,10,na,1880,2673.285601166203
STAT,1925,39,40-44,1964,1.776486815717421
SIM,1907,29,25-29,1936,6
STAT,1816,41,na,1857,2689.835162374672
STAT,1860,49,25-29,1909,0.046008520922153705
STAT,1893,21,45-49,1914,0.8746527298509907
STAT,1833,33,40-44,1866,2.419903863402758
SIM,1887,6,na,1893,4012
STAT,1821,95,na,1916,6.7144744829986545
STAT,1859,34,15-19,1893,0.11190491226896175
SIM,1838,42,50-100,1880,12
SIM,1882,42,na,1924,1729
STAT,1831,25,30-34,1856,33.82533991722368
SIM,1914,15,na,1929,5124
STAT,1909,32,15-19,1941,0.12138015718652462
SIM,1799,74,na,1873,105
SIM,1924,47,na,1971,5037
SIM,1922,34,na,1956,3341
STAT,1808,49,30-34,1857,0.1343644035583151
STAT,1895,39,45-49,1934,2.5671718627729105
SIM,1827,36,50-100,1863,36
STAT,1879,38,35-39,1917,7.219696457237013
STAT,1901,22,45-49,1923,0.9750056135727647
STAT,1920,31,50-100,1951,0.8976309933925961
SIM,1835,36,20-24,1871,1
STAT,1817,52,50-100,1869,0.010215412565086526
STAT,1856,33,35-39,1889,7.28679840710644
STAT,1898,43,40-44,1941,0.20851987569990094
SIM,1916,3,na,1919,4952
STAT,1904,23,25-29,1927,81.53385207393193
STAT,1836,34,20-24,1870,2.5643308020487816
SIM,1823,31,na,1854,1860
STAT,1819,37,25-29,1856,0.772354099242909
SIM,1836,48,45-49,1884,2
STAT,1894,27,20-24,1921,14.918400191627502
SIM,1862,25,25-29,1887,6
SIM,1881,19,15-19,1900,16
STAT,1854,25,25-29,1879,27.48890828386858
STAT,1871,22,20-24,1893,68.74321923900939
SIM,1856,36,na,1892,711
STAT,1946,26,50-100,1972,1.097269255700042
STAT,1906,31,35-39,1937,8.454890981897726
STAT,1895,72,na,1967,1973.008029630175
SIM,1853,27,25-29,1880,7
STAT,1915,12,na,1927,4075.019075419827
STAT,1813,41,15-19,1854,0.08602770445067456
STAT,1850,27,20-24,1877,6.374884463621103
STAT,1841,29,20-24,1870,15.99362147800675
STAT,1857,33,na,1890,1823.435536304433
SIM,1857,53,na,1910,1397
STAT,1835,38,35-39,1873,6.547745839406074
STAT,1944,20,15-19,1964,5.686739351565769
STAT,1910,20,45-49,1930,1.051054803752598
STAT,1843,37,30-34,1880,6.14742672255064
STAT,1908,64,na,1972,2919.576169604567
STAT,1929,24,40-44,1953,4.195745138089512
SIM,1920,22,20-24,1942,76
SIM,1841,33,40-44,1874,5
STAT,1858,50,na,1908,1667.9265396739695
SIM,1865,72,na,1937,1399
STAT,1840,23,30-34,1863,8.855258725608284
STAT,1921,20,20-24,1941,124.84417582428132
STAT,1828,48,45-49,1876,0.27807232958768724
SIM,1943,22,15-19,1965,51
STAT,1849,43,45-49,1892,1.2519472663745883
STAT,1842,31,40-44,1873,1.3140928387547173
STAT,1868,37,20-24,1905,0.7445404761049947
SIM,1916,28,na,1944,4686
STAT,1883,27,45-49,1910,1.0681595637341728
STAT,1938,22,40-44,1960,3.2920969782304708
SIM,1844,25,na,1869,2978
SIM,1842,39,30-34,1881,73
SIM,1855,35,35-39,1890,10
STAT,1923,31,na,1954,4307.6715197457925
SIM,1899,17,20-24,1916,1
SIM,1804,60,na,1864,845
SIM,1908,0,na,1908,3348
STAT,1857,23,na,1880,1880.5134503508793
STAT,1885,40,na,1925,2294.7552436492465
STAT,1849,14,na,1863,2453.5251849205483
STAT,1914,30,30-34,1944,15.764309220631281
SIM,1833,41,na,1874,2159
SIM,1890,71,na,1961,2631
STAT,1912,22,20-24,1934,105.32649854810627
STAT,1895,50,na,1945,2841.3259569535976
SIM,1885,22,15-19,1907,1
STAT,1864,32,30-34,1896,15.87273648742798
SIM,1882,52,na,1934,1485
STAT,1884,38,30-34,1922,5.076552487154865
STAT,1828,35,25-29,1863,4.041548032727171
STAT,1874,48,15-19,1922,4.076390809172584E-4
STAT,1878,31,20-24,1909,2.7924592831337445
STAT,1834,39,30-34,1873,2.861573762491106
STAT,1862,24,20-24,1886,59.22629196611915
STAT,1890,17,35-39,1907,0.6642712765469035
STAT,1932,21,35-39,1953,12.30559832073117
SIM,1871,23,25-29,1894,26
STAT,1847,35,35-39,1882,6.774065130419059
STAT,1845,32,20-24,1877,1.5948159894022433
STAT,1950,11,na,1961,4601.139381237638
SIM,1891,26,20-24,1917,1
STAT,1841,49,15-19,1890,4.361254874990161E-4
STAT,1880,50,30-34,1930,0.0062684701539525425
STAT,1861,28,35-39,1889,8.024728590496839
STAT,1880,32,15-19,1912,0.14784116065853475
SIM,1827,55,na,1882,1866
STAT,1820,78,na,1898,537.3319511211092
STAT,1833,104,na,1937,0.027442878068843487
SIM,1961,7,na,1968,4644
STAT,1839,21,40-44,1860,2.5055150388620295
STAT,1845,27,25-29,1872,25.549408463689854
STAT,1857,39,25-29,1896,2.1871483677035504
STAT,1889,15,45-49,1904,0.07902847425524724
STAT,1913,21,25-29,1934,88.6504799606582
STAT,1827,36,20-24,1863,0.7694921187497452
STAT,1839,48,20-24,1887,0.011214576504688122
STAT,1893,18,15-19,1911,7.401876973568568
SIM,1874,33,na,1907,2524
STAT,1947,15,45-49,1962,0.5570822168418099
SIM,1829,36,na,1865,2095
SIM,1882,20,na,1902,2114
STAT,1869,49,45-49,1918,0.2331710735112782
STAT,1890,24,50-100,1914,0.4905835475040164
STAT,1896,22,25-29,1918,75.46280416451607
STAT,1863,23,25-29,1886,49.48734564476444
STAT,1863,36,30-34,1899,4.5718251259314595
STAT,1878,92,na,1970,162.99620180860836
STAT,1931,27,50-100,1958,1.2760089059030837
STAT,1838,39,15-19,1877,0.02833053477064972
STAT,1945,15,50-100,1960,0.4049603873794282
STAT,1857,2,na,1859,2701.082705279269
STAT,1844,58,na,1902,1959.1838624476216
SIM,1905,33,35-39,1938,6
STAT,1897,34,35-39,1931,13.33412237945743
SIM,1878,48,50-100,1926,3
SIM,1904,5,na,1909,4260
SIM,1836,35,25-29,1871,2
STAT,1861,15,15-19,1876,5.740122483747771
STAT,1933,33,45-49,1966,2.1048965545732803
STAT,1895,26,25-29,1921,55.217598393820325
SIM,1869,34,25-29,1903,8
STAT,1810,46,na,1856,92.56911126114144
SIM,1854,35,na,1889,1686
SIM,1819,36,na,1855,1950
SIM,1933,1,na,1934,4652
SIM,1940,29,30-34,1969,465
STAT,1855,17,40-44,1872,0.14397917798560825
STAT,1874,34,40-44,1908,4.437460028539062
STAT,1888,16,40-44,1904,0.2116185363279542
STAT,1817,47,30-34,1864,0.06781454631615964
STAT,1932,29,30-34,1961,50.913563074966866
SIM,1829,68,na,1897,1590
STAT,1846,39,35-39,1885,4.284597401920667
STAT,1927,36,25-29,1963,1.2152979249260263
STAT,1896,35,30-34,1931,7.092325011022396
SIM,1892,52,na,1944,3403
STAT,1848,47,45-49,1895,0.2198132142204188
STAT,1831,50,35-39,1881,0.007429967547951897
STAT,1851,24,45-49,1875,0.6482797352659545
STAT,1925,44,na,1969,4440.456809709287
STAT,1878,17,35-39,1895,0.5645499547043871
STAT,1932,38,50-100,1970,0.5596275021270625
SIM,1823,39,20-24,1862,7
STAT,1815,39,20-24,1854,0.08436392970197128
STAT,1940,11,na,1951,3967.5276386717314
STAT,1922,39,15-19,1961,0.021561185925067748
STAT,1863,36,50-100,1899,1.0531838436403294
STAT,1829,44,30-34,1873,0.5372386282365713
SIM,1932,38,50-100,1970,1
SIM,1890,61,na,1951,3139
SIM,1886,31,20-24,1917,1
STAT,1819,42,20-24,1861,0.03722002161656574
STAT,1873,25,35-39,1898,9.964823259830027
STAT,1885,16,15-19,1901,5.847689721296846
STAT,1847,15,40-44,1862,0.20884570851579634
STAT,1858,72,na,1930,964.4277524895
STAT,1864,15,40-44,1879,0.19126983074166698
STAT,1923,23,35-39,1946,10.807063282267105
STAT,1912,40,35-39,1952,0.19413160274374622
SIM,1875,72,na,1947,2443
STAT,1856,47,50-100,1903,0.17558067258297624
STAT,1935,32,na,1967,5194.793929364427
SIM,1880,26,30-34,1906,1
STAT,1872,22,na,1894,2368.264110507306
STAT,1884,23,45-49,1907,0.6654640361528286
STAT,1876,39,35-39,1915,7.078110818437056
STAT,1857,42,40-44,1899,1.7238825116418386
SIM,1845,30,20-24,1875,12
STAT,1939,21,45-49,1960,1.1179415610237433
SIM,1810,98,na,1908,76
SIM,1882,28,20-24,1910,10
STAT,1869,24,30-34,1893,17.86153151516535
STAT,1870,26,20-24,1896,11.735608261310514
STAT,1907,40,40-44,1947,0.23020227526107861
STAT,1918,43,20-24,1961,0.018494304861541067
STAT,1835,25,15-19,1860,0.453892951467944
STAT,1844,49,40-44,1893,0.16606469597910162
STAT,1834,32,45-49,1866,0.9844267882462654
STAT,1932,14,na,1946,5193.272902309812
STAT,1879,43,30-34,1922,1.17085593498798
STAT,1940,23,35-39,1963,9.481193164394044
STAT,1872,51,35-39,1923,0.008662011087912385
STAT,1862,37,40-44,1899,3.728498729419779
STAT,1927,41,20-24,1968,0.02199997381411131
SIM,1907,45,na,1952,4403
STAT,1838,37,35-39,1875,3.643239776395848
SIM,1844,35,na,1879,2932
STAT,1807,80,na,1887,303.66044708403206
STAT,1874,28,20-24,1902,12.065019125506318
STAT,1927,13,na,1940,4878.9066527018185
SIM,1884,39,35-39,1923,20
SIM,1838,43,35-39,1881,1
SIM,1931,17,na,1948,3101
SIM,1834,44,50-100,1878,6
STAT,1839,54,50-100,1893,0.013645596844780006
SIM,1936,32,25-29,1968,2
STAT,1829,31,25-29,1860,5.7939293382955555
SIM,1902,14,na,1916,3722
STAT,1905,35,35-39,1940,2.216633940536637
STAT,1841,22,35-39,1863,8.231908449252236
STAT,1866,35,45-49,1901,1.8369738079139952
STAT,1908,36,15-19,1944,0.017926258529027794
SIM,1921,29,20-24,1950,7
STAT,1864,27,35-39,1891,8.7719002009076
SIM,1872,42,na,1914,2342
SIM,1898,67,na,1965,3261
STAT,1848,44,40-44,1892,2.0764040433064115
STAT,1880,15,25-29,1895,5.910272361423353
SIM,1867,53,na,1920,2035
STAT,1885,8,na,1893,2555.222308238652
STAT,1892,25,45-49,1917,1.3839855869503568
STAT,1816,41,50-100,1857,3.5665078350295474
SIM,1849,56,na,1905,1844
STAT,1955,17,45-49,1972,0.6573525184915633
SIM,1914,47,na,1961,4827
STAT,1930,21,50-100,1951,0.8395446915605134
STAT,1937,30,25-29,1967,9.059926406682436
SIM,1837,31,25-29,1868,18
SIM,1867,39,35-39,1906,12
STAT,1928,32,25-29,1960,11.469041585990384
SIM,1907,35,na,1942,4614
STAT,1889,32,35-39,1921,12.19526622103463
STAT,1920,42,35-39,1962,0.21953682991452672
STAT,1827,49,40-44,1876,0.15275147895236807
STAT,1913,29,20-24,1942,17.831807999853698
SIM,1959,11,na,1970,5256
STAT,1833,47,15-19,1880,2.008586782038085E-4
STAT,1886,33,20-24,1919,2.7873403279260978
STAT,1947,20,40-44,1967,3.762654051323045
STAT,1853,39,40-44,1892,3.3601044262028603
STAT,1889,45,40-44,1934,0.2082186822970128
STAT,1909,15,25-29,1924,8.450776447203495
SIM,1839,56,na,1895,346
STAT,1839,16,45-49,1855,0.07986030636456201
STAT,1922,19,20-24,1941,154.32093474108476
STAT,1825,34,45-49,1859,2.7134086371964394
STAT,1902,22,50-100,1924,0.5742343173405563
SIM,1837,27,40-44,1864,1
STAT,1936,31,20-24,1967,2.3470379320133192
SIM,1831,60,na,1891,2102
SIM,1895,49,na,1944,4388
STAT,1870,48,30-34,1918,0.09529056213423899
SIM,1879,44,35-39,1923,34
STAT,1871,38,na,1909,2338.5330720437482
STAT,1928,15,35-39,1943,5.271437465791303
SIM,1896,33,30-34,1929,7
STAT,1885,29,35-39,1914,9.416621190570414
SIM,1887,83,na,1970,1759
STAT,1801,109,na,1910,2.3602545248133534E-4
STAT,1839,54,40-44,1893,0.009511914419920345
STAT,1866,18,50-100,1884,0.045631806332516116
SIM,1936,20,30-34,1956,128
STAT,1896,18,40-44,1914,0.24047634481526123
STAT,1861,50,20-24,1911,6.225043782270718E-4
SIM,1894,21,na,1915,1764
STAT,1803,76,na,1879,285.5492963996248
STAT,1837,30,20-24,1867,2.7744755189046653
STAT,1852,40,50-100,1892,1.0741419245884989
STAT,1934,26,15-19,1960,0.9436749392577987
STAT,1899,49,30-34,1948,0.07302361854227041
SIM,1931,23,35-39,1954,79
STAT,1855,37,35-39,1892,4.681117391239698
STAT,1829,27,40-44,1856,2.2343847393457823
STAT,1809,48,35-39,1857,1.2044015460509936
STAT,1864,29,15-19,1893,0.40951581405717336
STAT,1885,72,na,1957,1303.0243165212519
STAT,1886,28,25-29,1914,43.65104616167578
STAT,1818,38,35-39,1856,16.554674657309736
STAT,1884,32,50-100,1916,0.8770965770933722
STAT,1918,30,15-19,1948,0.1357949335484615
SIM,1878,32,25-29,1910,16
SIM,1861,26,20-24,1887,6
STAT,1891,28,20-24,1919,14.375721630234937
STAT,1869,33,20-24,1902,2.7160971036374857
STAT,1939,23,50-100,1962,0.6533356046233731
SIM,1836,38,na,1874,1938
STAT,1838,42,30-34,1880,0.5739447814867953
STAT,1944,16,30-34,1960,12.973048826694537
STAT,1854,38,45-49,1892,1.1029161184942493
STAT,1881,24,30-34,1905,16.715687452920026
STAT,1875,25,45-49,1900,1.1478521602024883
STAT,1928,20,30-34,1948,35.82452273489544
SIM,1915,40,40-44,1955,2
STAT,1849,36,na,1885,2052.512592899885
STAT,1798,80,na,1878,391.3813393967124
STAT,1853,26,20-24,1879,10.614022104391408
STAT,1919,42,25-29,1961,0.07635724070882813
STAT,1800,58,na,1858,1758.986211990683
STAT,1830,29,45-49,1859,1.0523494466988847
STAT,1895,43,15-19,1938,0.0012385026945292551
STAT,1860,22,45-49,1882,0.5864231610697265
STAT,1824,37,20-24,1861,0.12171718845212016
SIM,1907,13,na,1920,4894
STAT,1878,39,45-49,1917,2.0303943595329024
STAT,1898,46,45-49,1944,0.17952186600900735
STAT,1847,23,40-44,1870,2.2930257808285455
STAT,1926,32,15-19,1958,0.15405225871797096
SIM,1916,39,40-44,1955,4
STAT,1888,70,na,1958,1706.722491989526
STAT,1850,50,45-49,1900,0.006797576548954095
STAT,1907,47,na,1954,3268.038837853428
STAT,1893,28,30-34,1921,31.379819005217403
SIM,1887,35,30-34,1922,45
STAT,1937,13,na,1950,3808.8773736347775
SIM,1917,45,na,1962,1998
STAT,1830,56,na,1886,1494.1633926726097
STAT,1929,27,45-49,1956,2.1470003250250316
SIM,1879,54,na,1933,1050
STAT,1826,31,50-100,1857,1.9695229804992544
STAT,1899,39,15-19,1938,0.016388333707902183
STAT,1931,40,45-49,1971,0.2213876810247281
SIM,1886,34,25-29,1920,7
STAT,1881,49,45-49,1930,0.2182127990854028
STAT,1944,3,na,1947,4272.926703195826
STAT,1834,24,45-49,1858,0.40513154523227074
STAT,1945,24,25-29,1969,100.04963609085073
SIM,1845,25,25-29,1870,1
STAT,1915,29,30-34,1944,39.119222607073894
STAT,1865,42,na,1907,2107.5433287971982
SIM,1861,37,na,1898,2234
STAT,1851,21,40-44,1872,1.9795919037484404
STAT,1879,35,30-34,1914,5.519216785495271
SIM,1838,35,35-39,1873,1
STAT,1830,26,40-44,1856,2.901251997192119
STAT,1816,94,na,1910,16.872775613316904
STAT,1825,49,30-34,1874,0.11975856509037529
STAT,1845,15,30-34,1860,1.0115156063380255
SIM,1849,26,20-24,1875,3
STAT,1838,45,35-39,1883,0.06308000075897789
SIM,1867,17,25-29,1884,2
STAT,1848,31,35-39,1879,11.16681319057386
STAT,1826,37,30-34,1863,8.70831340495799
STAT,1846,44,30-34,1890,0.6717125815122595
STAT,1843,22,45-49,1865,0.8648170688485501
STAT,1866,7,na,1873,2548.3859203238194
STAT,1908,39,40-44,1947,1.3767422884938296
SIM,1872,74,na,1946,1216
SIM,1932,12,na,1944,6513
STAT,1927,33,20-24,1960,2.974174352792528
STAT,1888,33,30-34,1921,20.066333281150307
STAT,1857,37,45-49,1894,1.5297247955066888
STAT,1877,22,15-19,1899,3.3489064197142633
SIM,1892,20,na,1912,3671
STAT,1892,49,20-24,1941,0.008205674937573642
STAT,1909,20,20-24,1929,102.90408247403583
SIM,1861,34,20-24,1895,10
SIM,1920,25,25-29,1945,253
STAT,1929,41,30-34,1970,0.1646412343144585
STAT,1897,26,35-39,1923,12.85825335981293
STAT,1789,104,na,1893,0.028362982232668983
SIM,1869,31,20-24,1900,24
STAT,1866,42,50-100,1908,0.9631617824979437
STAT,1918,26,30-34,1944,41.27769064688663
STAT,1872,26,30-34,1898,25.302672023500826
SIM,1834,25,na,1859,1177
STAT,1929,28,50-100,1957,1.2363835581198885
STAT,1914,33,35-39,1947,9.032496666988099
SIM,1861,7,na,1868,2691
STAT,1837,25,25-29,1862,44.16629227677363
STAT,1836,37,25-29,1873,2.7080661432255666
STAT,1863,20,20-24,1883,60.874916080686546
STAT,1853,34,20-24,1887,2.1140032401878273
STAT,1878,5,na,1883,2798.7669630537644
STAT,1941,19,30-34,1960,12.403641758650346
SIM,1878,28,40-44,1906,1
STAT,1885,24,15-19,1909,3.2224732289751863
SIM,1829,42,30-34,1871,6
STAT,1878,49,50-100,1927,0.247414302637237
STAT,1837,35,na,1872,2134.791976076507
STAT,1842,34,45-49,1876,0.5121986547567219
STAT,1859,17,25-29,1876,5.213582602871093
STAT,1880,2,na,1882,3331.8532925552195
STAT,1807,90,na,1897,31.96614812567794
STAT,1820,46,na,1866,1796.0526122786566
STAT,1851,39,30-34,1890,4.166896614278154
STAT,1864,68,na,1932,1389.2937900437128
STAT,1887,45,30-34,1932,0.10760737435383311
STAT,1867,33,na,1900,2247.282379192638
STAT,1845,35,25-29,1880,1.684208286280546
SIM,1891,29,25-29,1920,84
STAT,1786,106,na,1892,0.011959002865401445
STAT,1845,24,20-24,1869,41.8441548673643
STAT,1933,30,40-44,1963,5.243844767427953
STAT,1832,39,20-24,1871,0.06259618744665156
STAT,1928,17,50-100,1945,0.46848731186759834
STAT,1867,38,30-34,1905,5.015341836552585
SIM,1926,26,30-34,1952,69
STAT,1850,4,na,1854,1504.0
STAT,1855,21,25-29,1876,44.58178738944095
STAT,1878,34,25-29,1912,10.448075726743136
STAT,1854,42,15-19,1896,0.007669055900003362
STAT,1860,49,50-100,1909,0.196175222538122
STAT,1868,28,30-34,1896,24.236848036136724
STAT,1854,68,na,1922,849.7048528297893
STAT,1872,17,40-44,1889,0.1837541867135268
SIM,1923,29,30-34,1952,2
STAT,1878,26,25-29,1904,43.671988600197324
STAT,1868,24,15-19,1892,3.1664835556480577
STAT,1862,27,25-29,1889,36.16267848062353
STAT,1882,22,na,1904,2264.3217997435822
STAT,1942,20,50-100,1962,0.6824931406323262
STAT,1907,25,na,1932,3505.7927480590906
STAT,1858,38,15-19,1896,0.04267053321333757
STAT,1918,22,15-19,1940,5.663760540497426
STAT,1872,15,50-100,1887,0.049804832565470886
STAT,1856,16,45-49,1872,0.05580631413758472
STAT,1782,109,na,1891,0.006258870354576394
SIM,1886,39,45-49,1925,1
SIM,1917,5,na,1922,2494
STAT,1874,21,35-39,1895,6.040786324735095
STAT,1846,36,30-34,1882,3.3306789479397136
STAT,1852,24,na,1876,2520.14624321859
STAT,1844,23,15-19,1867,4.051394246611646
SIM,1870,27,25-29,1897,445
STAT,1938,34,35-39,1972,9.0785517822918
STAT,1816,38,25-29,1854,11.214165033995936
SIM,1912,46,na,1958,4554
SIM,1934,32,15-19,1966,1
SIM,1848,42,40-44,1890,24
STAT,1896,39,50-100,1935,1.6021567250040534
SIM,1883,1,na,1884,2348
STAT,1837,27,50-100,1864,0.6583369101298414
STAT,1883,29,25-29,1912,40.40493365042474
STAT,1903,32,20-24,1935,3.8370222003735663
SIM,1923,6,na,1929,4291
SIM,1911,32,20-24,1943,5
STAT,1839,24,45-49,1863,0.8205098348920861
STAT,1864,35,35-39,1899,6.491103250427407
SIM,1952,2,na,1954,6382
SIM,1902,46,na,1948,3288
SIM,1928,30,25-29,1958,29
STAT,1937,26,40-44,1963,4.498602858219617
STAT,1859,15,50-100,1874,0.04560989433253518
SIM,1864,25,35-39,1889,2
STAT,1794,98,na,1892,0.007688531622044005
STAT,1898,38,45-49,1936,0.5757303026205971
STAT,1925,31,45-49,1956,1.8525911554343937
STAT,1862,49,35-39,1911,0.11675402518403873
STAT,1925,12,na,1937,4742.616406783331
STAT,1867,53,50-100,1920,0.014053793358169952
STAT,1875,19,na,1894,2579.5162696136304
SIM,1907,33,45-49,1940,2
SIM,1918,24,30-34,1942,78
STAT,1820,36,25-29,1856,5.650703281117217
STAT,1879,46,35-39,1925,0.14402533527593903
STAT,1797,63,na,1860,35.38879986306713
SIM,1867,36,30-34,1903,5
STAT,1887,21,na,1908,2611.004715184478
STAT,1911,19,45-49,1930,0.09830675267439233
STAT,1926,24,15-19,1950,6.371452757206517
STAT,1850,19,20-24,1869,9.886101288423538
SIM,1886,26,25-29,1912,37
STAT,1819,45,25-29,1864,0.010457051060079117
SIM,1874,55,na,1929,2445
STAT,1821,73,na,1894,599.8354266294543
STAT,1936,22,30-34,1958,27.205307537528057
STAT,1890,51,na,1941,2619.18401881086
SIM,1946,1,na,1947,4109
STAT,1865,20,na,1885,2217.241266375505
STAT,1857,55,na,1912,1586.6836245646202
STAT,1932,25,50-100,1957,1.295758780998871
SIM,1863,21,25-29,1884,3
STAT,1905,39,15-19,1944,0.017257662631054282
SIM,1849,24,na,1873,2529
STAT,1828,48,50-100,1876,0.2893837459092095
SIM,1819,58,na,1877,1842
STAT,1915,34,na,1949,3764.9496072534516
STAT,1870,29,25-29,1899,41.870279046428855
STAT,1888,24,40-44,1912,2.3900004513030195
SIM,1850,28,25-29,1878,25
SIM,1861,39,40-44,1900,2
STAT,1813,54,50-100,1867,0.0504081652198652
STAT,1873,26,50-100,1899,0.6584352663654992
STAT,1914,16,45-49,1930,0.10214702290571258
STAT,1907,43,45-49,1950,0.15054815372639246
STAT,1931,25,35-39,1956,19.263692024358935
STAT,1948,16,15-19,1964,51.42037114917068
STAT,1922,32,30-34,1954,17.602807269379955
STAT,1785,106,na,1891,0.003954675893979821
STAT,1934,29,40-44,1963,6.221631217763098
STAT,1891,36,na,1927,2911.1572996919062
STAT,1842,28,25-29,1870,12.892931984745674
SIM,1906,49,25-29,1955,1
STAT,1857,48,15-19,1905,3.0308754498145813E-4
STAT,1838,34,30-34,1872,9.071034819251192
SIM,1871,68,na,1939,1433
STAT,1835,54,na,1889,1595.796749874321
STAT,1923,0,na,1923,5234.456153670791
STAT,1927,44,25-29,1971,0.08853276479636453
STAT,1867,16,20-24,1883,17.241850549364724
SIM,1885,49,na,1934,1207
STAT,1843,27,15-19,1870,0.5516866278340419
STAT,1914,17,20-24,1931,27.65478695702126
SIM,1902,68,na,1970,2054
SIM,1831,26,35-39,1857,71
STAT,1919,34,25-29,1953,9.755057614909658
SIM,1839,47,45-49,1886,1
STAT,1874,19,50-100,1893,0.05029171900309311
SIM,1919,14,na,1933,5211
STAT,1840,48,45-49,1888,0.09251562999014118
SIM,1837,23,25-29,1860,1
STAT,1910,13,na,1923,3863.464251130864
STAT,1842,26,45-49,1868,0.34331854468353507
SIM,1800,78,na,1878,167
SIM,1820,38,40-44,1858,5
STAT,1951,21,45-49,1972,1.3322155049968412
STAT,1887,37,30-34,1924,5.866123373576993
STAT,1892,22,40-44,1914,2.5799508670284363
STAT,1926,46,50-100,1972,0.27737402223721336
STAT,1864,24,30-34,1888,16.21823083185984
STAT,1835,20,45-49,1855,0.7115169229325718
SIM,1878,37,45-49,1915,26
STAT,1835,42,50-100,1877,0.9577693971738943
SIM,1893,26,30-34,1919,82
STAT,1876,48,25-29,1924,0.05749666151197472
STAT,1885,43,50-100,1928,1.0309372564266548
STAT,1805,57,na,1862,421.1377087168905
SIM,1924,25,na,1949,5269
STAT,1819,47,40-44,1866,0.03189184638354895
STAT,1890,19,15-19,1909,7.145881778592393
STAT,1928,23,35-39,1951,11.630806156625573
SIM,1932,39,25-29,1971,9
STAT,1877,21,na,1898,2408.057216193015
SIM,1862,54,na,1916,3426
STAT,1900,18,30-34,1918,2.2021792422357964
SIM,1942,29,40-44,1971,2
STAT,1886,38,40-44,1924,4.510639182537651
STAT,1947,23,45-49,1970,1.2578430642787395
STAT,1813,44,na,1857,2314.797115618589
STAT,1876,69,na,1945,1483.5513964317927
STAT,1917,21,50-100,1938,0.6920746190035513
STAT,1836,21,15-19,1857,3.3604188885538187
STAT,1903,15,30-34,1918,2.2730275282221672
SIM,1826,35,30-34,1861,18
STAT,1898,15,na,1913,3412.0043356981196
STAT,1912,25,25-29,1937,64.54463584978353
SIM,1874,26,20-24,1900,7
STAT,1827,44,20-24,1871,0.1467161406399302
STAT,1824,60,na,1884,396.7125956636814
STAT,1821,48,35-39,1869,0.1477367227643619
SIM,1802,52,50-100,1854,1
STAT,1883,71,na,1954,1284.1358483739316
STAT,1840,15,45-49,1855,0.03369752634486106
SIM,1895,37,30-34,1932,11
SIM,1826,38,na,1864,1920
STAT,1885,26,30-34,1911,24.83747638526334
STAT,1922,14,na,1936,4519.757328999339
SIM,1863,39,na,1902,885
STAT,1841,93,na,1934,32.54437623711499
STAT,1803,98,na,1901,0.8194495627866216
SIM,1932,34,na,1966,6270
STAT,1825,31,40-44,1856,7.980436198853036
STAT,1922,15,40-44,1937,1.6081311845425779
STAT,1886,25,20-24,1911,12.230925010267539
STAT,1864,18,45-49,1882,0.06107072193879326
STAT,1894,35,20-24,1929,0.9895661839651532
SIM,1827,47,40-44,1874,1
STAT,1849,35,45-49,1884,1.754840669874293
STAT,1848,72,na,1920,1181.7849161825739
STAT,1800,109,na,1909,4.908896626491316E-4
SIM,1845,33,25-29,1878,3
STAT,1940,20,30-34,1960,28.970037023311907
STAT,1836,39,na,1875,1970.6082648850713
STAT,1837,33,25-29,1870,10.1907706162139
SIM,1859,15,25-29,1874,40
SIM,1901,19,na,1920,4011
STAT,1945,21,20-24,1966,120.5618745257712
STAT,1872,8,na,1880,2711.071242364797
STAT,1869,20,15-19,1889,3.3631835352501387
SIM,1902,49,40-44,1951,4
STAT,1928,36,40-44,1964,1.879205293772071
SIM,1916,24,20-24,1940,1
STAT,1863,19,na,1882,2212.63042063942
SIM,1817,37,30-34,1854,2
STAT,1834,91,na,1925,25.537908013274464
STAT,1933,17,30-34,1950,16.20572637050196
SIM,1845,22,20-24,1867,522
STAT,1795,94,na,1889,5.294274162866259
STAT,1847,26,45-49,1873,1.2152949229897123
SIM,1863,37,35-39,1900,1
STAT,1851,61,na,1912,1475.8344974287666
STAT,1862,15,30-34,1877,1.5732978158574826
STAT,1887,28,40-44,1915,3.285530948897773
STAT,1862,29,40-44,1891,2.5332090125118416
STAT,1864,47,50-100,1911,0.2222355440288987
STAT,1895,29,na,1924,3082.3735130925306
STAT,1955,10,na,1965,5170.496457956376
STAT,1846,20,20-24,1866,51.09007106386732
SIM,1844,57,na,1901,1796
STAT,1855,74,na,1929,734.4985542325886
SIM,1897,51,na,1948,2249
STAT,1844,39,25-29,1883,2.9522391052695616
SIM,1852,39,25-29,1891,7
STAT,1902,16,na,1918,3565.1933364376227
STAT,1924,39,25-29,1963,1.1474276229468634
STAT,1842,24,na,1866,659.8888866852518
SIM,1954,13,na,1967,5557
SIM,1828,37,40-44,1865,32
STAT,1819,36,50-100,1855,0.6480055851230131
SIM,1869,39,45-49,1908,54
STAT,1830,24,25-29,1854,134.4530491635279
STAT,1851,15,20-24,1866,17.22602666557608
STAT,1829,35,40-44,1864,2.3003313939688583
STAT,1853,37,25-29,1890,2.232496950473867
STAT,1852,103,na,1955,0.1444604872886137
STAT,1859,89,na,1948,83.26464586183465
STAT,1942,20,40-44,1962,3.487539694899442
STAT,1834,21,40-44,1855,1.2371127512814866
STAT,1884,66,na,1950,1568.9791707447318
SIM,1892,19,na,1911,3506
STAT,1896,27,45-49,1923,1.4636333631516125
STAT,1812,47,30-34,1859,0.025026380758732075
STAT,1838,28,45-49,1866,0.5985792920611553
STAT,1965,5,na,1970,4859.665804468498
SIM,1906,29,30-34,1935,15
STAT,1837,42,15-19,1879,0.013066320649835815
STAT,1875,53,50-100,1928,0.01525928965715795
SIM,1861,17,30-34,1878,2
STAT,1857,21,35-39,1878,5.20688928944583
STAT,1894,19,35-39,1913,0.694028665348583
STAT,1934,34,15-19,1968,0.1740397691859582
STAT,1846,49,na,1895,1304.6712100559203
SIM,1937,28,20-24,1965,27
SIM,1844,26,35-39,1870,114
STAT,1846,47,35-39,1893,0.08252995992542025
STAT,1849,48,15-19,1897,3.328015929529271E-4
SIM,1929,14,na,1943,6274
STAT,1871,27,40-44,1898,2.988205683719212
STAT,1889,41,50-100,1930,1.2779622201518281
STAT,1903,35,25-29,1938,0.890532342579836
STAT,1853,17,30-34,1870,1.4866691915961934
STAT,1829,36,45-49,1865,1.028826753975854
SIM,1908,25,25-29,1933,2
STAT,1899,27,20-24,1926,16.023605618070498
STAT,1827,28,35-39,1855,11.274708481581802
STAT,1872,48,40-44,1920,0.16927870362633538
SIM,1820,44,na,1864,565
STAT,1819,38,na,1857,695.2936108524832
STAT,1810,48,50-100,1858,0.001272653621676368
STAT,1855,25,40-44,1880,2.303845985753033
STAT,1859,99,na,1958,2.415388257526878
STAT,1898,49,15-19,1947,2.970776235834109E-4
STAT,1864,49,45-49,1913,0.2100694311991517
STAT,1847,49,50-100,1896,0.2174148659980061
STAT,1836,26,35-39,1862,9.636451040809762
STAT,1885,19,na,1904,2469.2295586736254
STAT,1907,15,15-19,1922,8.69931578933341
STAT,1941,28,na,1969,3829.3837638181353
STAT,1924,19,30-34,1943,14.29830786439182
STAT,1844,25,30-34,1869,30.983185138173777
SIM,1900,28,25-29,1928,266
STAT,1854,16,35-39,1870,0.36712516899864955
SIM,1859,36,30-34,1895,9
STAT,1887,15,35-39,1902,0.6067554795140417
STAT,1916,30,40-44,1946,4.017149752643057
STAT,1827,57,na,1884,1493.3426474330781
STAT,1837,49,35-39,1886,0.11358026117247326
STAT,1909,23,25-29,1932,84.71283996134974
STAT,1931,29,15-19,1960,0.9041150000805661
STAT,1880,41,na,1921,2410.2806726743083
STAT,1892,16,20-24,1908,22.003493922462805
STAT,1902,18,40-44,1920,0.25688205017541765
STAT,1944,18,45-49,1962,0.5313632591726334
STAT,1863,23,50-100,1886,0.3525242257739527
STAT,1842,17,20-24,1859,5.651475035771695
STAT,1937,22,25-29,1959,89.01987319321904
SIM,1927,25,35-39,1952,10
STAT,1873,16,45-49,1889,0.06740350116656382
SIM,1837,35,40-44,1872,68
STAT,1938,31,30-34,1969,15.681316811288763
SIM,1822,57,na,1879,1219
STAT,1818,49,25-29,1867,0.09964229094066984
STAT,1896,26,40-44,1922,3.9623894674195226
SIM,1840,36,50-100,1876,2
STAT,1890,73,na,1963,1681.2069829215875
STAT,1919,31,20-24,1950,2.607236194176247
SIM,1879,33,30-34,1912,12
STAT,1848,111,na,1959,1.5142697881135968E-4
STAT,1859,67,na,1926,1256.4319513423536
STAT,1804,107,na,1911,0.002988030169059739
STAT,1817,57,na,1874,770.4159565365052
SIM,1835,27,30-34,1862,31
STAT,1803,107,na,1910,0.0011896066656259532
STAT,1816,47,15-19,1863,0.0012166515753740685
STAT,1953,17,35-39,1970,5.030531463859262
STAT,1908,24,20-24,1932,100.79886232826122
STAT,1879,29,45-49,1908,1.1308525836176437
STAT,1886,36,25-29,1922,2.9959033017814827
STAT,1910,45,na,1955,3405.254097249592
STAT,1939,30,35-39,1969,9.232000156967132
STAT,1890,39,45-49,1929,2.389040406188298
SIM,1852,86,na,1938,906
STAT,1835,47,25-29,1882,0.04593795593030136
STAT,1852,34,na,1886,2435.900822912217
SIM,1812,47,na,1859,1806
STAT,1866,29,25-29,1895,38.33755051147978
STAT,1922,35,35-39,1957,2.7262371734082245
STAT,1957,2,na,1959,5142.93091100513
STAT,1833,39,15-19,1872,0.02964058883830636
STAT,1837,22,20-24,1859,72.33440165838145
STAT,1839,30,30-34,1869,20.380993578674822
STAT,1884,28,15-19,1912,0.43278812243620923
STAT,1928,6,na,1934,5011.877438558978
SIM,1895,48,35-39,1943,1
STAT,1827,27,30-34,1854,39.33414763831338
STAT,1825,104,na,1929,0.041074728978295214
STAT,1845,37,40-44,1882,2.28230158227722
STAT,1802,81,na,1883,305.89656907652494
STAT,1877,27,35-39,1904,9.794823597986595
STAT,1867,36,15-19,1903,0.0533626644038342
STAT,1942,16,20-24,1958,140.10237842487186
STAT,1823,48,45-49,1871,0.3629853961569373
STAT,1835,46,20-24,1881,0.00969381013493004
STAT,1843,15,20-24,1858,22.651030053934612
SIM,1833,25,20-24,1858,7
SIM,1910,23,15-19,1933,2
STAT,1873,22,30-34,1895,18.271477089262493
STAT,1876,28,30-34,1904,25.366977536008665
STAT,1894,18,30-34,1912,2.0215473194021083
STAT,1919,38,50-100,1957,0.4446141441863997
STAT,1855,36,50-100,1891,0.8164758584171795
SIM,1884,28,30-34,1912,396
STAT,1863,93,na,1956,28.494361482462843
STAT,1838,21,25-29,1859,31.933843847338476
STAT,1889,24,35-39,1913,6.9832393873873615
SIM,1850,64,na,1914,814
SIM,1870,19,na,1889,2524
STAT,1827,67,na,1894,1117.8822286322354
STAT,1843,29,30-34,1872,30.18219161712277
STAT,1863,32,15-19,1895,0.12157518216076549
SIM,1920,2,na,1922,4900
STAT,1870,51,25-29,1921,0.0035480452125949747
SIM,1794,75,na,1869,438
SIM,1852,76,na,1928,1138
STAT,1841,48,50-100,1889,0.271234084162964
STAT,1887,48,35-39,1935,0.15215804709677536
STAT,1857,34,40-44,1891,3.2993374015487187
STAT,1909,36,30-34,1945,1.715787657104695
SIM,1838,61,na,1899,1518
SIM,1879,27,45-49,1906,310
STAT,1836,72,na,1908,966.5401743892855
STAT,1885,29,na,1914,2329.0653924694934
STAT,1828,26,35-39,1854,21.911210706114428
SIM,1937,11,na,1948,2988
STAT,1858,33,45-49,1891,1.3260750003049717
STAT,1893,48,na,1941,2778.653425530763
STAT,1905,66,na,1971,2715.527997021107
STAT,1851,93,na,1944,23.081998892279735
STAT,1870,31,50-100,1901,0.9171684243822843
STAT,1870,15,30-34,1885,1.6231826823141668
SIM,1851,29,30-34,1880,4
STAT,1894,38,25-29,1932,3.6431953470755074
STAT,1855,26,45-49,1881,0.7714864831166849
STAT,1888,30,50-100,1918,1.0659976736098602
SIM,1859,37,35-39,1896,1
STAT,1873,93,na,1966,97.00606431132005
STAT,1817,37,15-19,1854,0.04440141365552434
STAT,1898,35,40-44,1933,5.942406367267318
STAT,1842,56,na,1898,506.32786471625093
SIM,1911,8,na,1919,2616
SIM,1874,7,na,1881,2818
STAT,1879,7,na,1886,2738.3860954043644
SIM,1879,22,na,1901,1689
STAT,1877,38,25-29,1915,2.90823489159365
STAT,1856,22,30-34,1878,14.858727316251224
SIM,1876,28,30-34,1904,2
STAT,1846,38,50-100,1884,0.7514985749653481
STAT,1851,48,20-24,1899,0.009358425985419822
STAT,1873,19,15-19,1892,6.054895025396944
STAT,1861,38,na,1899,1949.613533395684
SIM,1864,22,30-34,1886,745
STAT,1881,15,40-44,1896,0.173526595744974
STAT,1830,24,na,1854,1848.6493673286375
STAT,1888,27,45-49,1915,1.2814715619965589
STAT,1831,47,40-44,1878,0.1614419667097092
STAT,1865,20,30-34,1885,16.69907717885733
STAT,1883,38,15-19,1921,0.053755159409021425
STAT,1919,25,35-39,1944,16.115177706096738
STAT,1891,49,50-100,1940,0.16680811492293943
STAT,1902,48,na,1950,3128.9106430068987
SIM,1928,37,45-49,1965,5
SIM,1887,51,na,1938,3252
STAT,1929,20,25-29,1949,116.68211084004682
STAT,1936,25,35-39,1961,14.23802898440449
STAT,1863,28,45-49,1891,0.9445428915964885
SIM,1924,30,40-44,1954,1
STAT,1898,18,15-19,1916,7.95938173332137
SIM,1929,2,na,1931,6340
STAT,1886,16,30-34,1902,1.6545853969405409
STAT,1916,29,na,1945,3793.2494362753023
SIM,1960,5,na,1965,6451
STAT,1835,27,30-34,1862,24.83200306785025
SIM,1887,41,na,1928,3653
STAT,1924,48,na,1972,4319.648347330191
STAT,1925,36,15-19,1961,0.022858173600724434
STAT,1878,43,15-19,1921,0.01410586968165508
STAT,1927,27,35-39,1954,18.10349731300559
SIM,1859,34,na,1893,1895
STAT,1852,25,15-19,1877,0.5396489347376298
STAT,1861,37,25-29,1898,2.394464054184831
SIM,1900,56,na,1956,3980
STAT,1833,42,na,1875,1047.8364761329833
SIM,1843,27,30-34,1870,10
SIM,1855,41,na,1896,2997
STAT,1826,44,50-100,1870,1.532778623650815
SIM,1918,51,na,1969,4314
STAT,1866,28,20-24,1894,10.670993708994933
STAT,1853,19,na,1872,2115.908397643782
SIM,1869,22,na,1891,3681
STAT,1852,39,25-29,1891,2.8689963784282977
SIM,1886,23,20-24,1909,382
STAT,1887,29,45-49,1916,1.2133464372044687
STAT,1887,21,20-24,1908,76.07913260164938
STAT,1846,27,40-44,1873,2.1462892865571193
STAT,1878,23,20-24,1901,70.68285766709522
STAT,1822,38,35-39,1860,13.763743720552393
STAT,1826,35,15-19,1861,0.09668826471034404
SIM,1852,54,na,1906,1806
STAT,1857,17,15-19,1874,5.352455303871719
STAT,1861,17,30-34,1878,1.523543784152292
STAT,1898,22,35-39,1920,7.847068051491402
SIM,1874,23,na,1897,1753
STAT,1836,39,40-44,1875,4.032692473876044
STAT,1907,48,15-19,1955,3.2508391222292143E-4
SIM,1887,22,25-29,1909,1
SIM,1848,36,20-24,1884,6
STAT,1847,32,30-34,1879,18.534336884726343
STAT,1836,25,30-34,1861,25.331214172809013
STAT,1893,26,15-19,1919,0.5693147036785098
STAT,1843,49,25-29,1892,0.05572311019757026
STAT,1926,15,25-29,1941,52.92029804042537
STAT,1842,23,40-44,1865,0.6477754980323793
STAT,1849,32,40-44,1881,3.8504906897045656
STAT,1874,88,na,1962,264.47687264808576
STAT,1881,16,45-49,1897,0.061838666307468565
SIM,1937,33,na,1970,2972
STAT,1905,19,20-24,1924,25.362563232840177
STAT,1831,106,na,1937,0.009502694092350779
STAT,1862,16,35-39,1878,0.5384369235055972
SIM,1889,8,na,1897,3895
SIM,1825,39,30-34,1864,19
STAT,1826,49,25-29,1875,0.08026859078995413
STAT,1879,22,25-29,1901,58.724829273623406
STAT,1817,39,30-34,1856,4.030440625971984
STAT,1874,56,na,1930,2105.0379634964515
SIM,1855,32,30-34,1887,2
STAT,1873,71,na,1944,1369.2112719181748
STAT,1884,16,20-24,1900,17.012714911297646
SIM,1837,20,20-24,1857,3
STAT,1876,17,25-29,1893,5.728541303464737
STAT,1935,26,30-34,1961,53.05057093624863
STAT,1860,38,20-24,1898,0.6257333773133809
SIM,1801,62,na,1863,1846
SIM,1898,14,na,1912,4409
STAT,1837,38,45-49,1875,1.9260168386761687
STAT,1929,28,20-24,1957,22.674294316752405
STAT,1807,49,15-19,1856,0.001315259849449395
SIM,1839,31,35-39,1870,19
STAT,1927,20,15-19,1947,6.54384131593314
SIM,1805,55,na,1860,2097
STAT,1834,31,50-100,1865,0.5226400624767793
SIM,1903,33,25-29,1936,3
STAT,1876,21,45-49,1897,0.707056218082384
STAT,1899,34,45-49,1933,2.361437421873828
STAT,1859,36,30-34,1895,4.244515235220148
STAT,1863,37,35-39,1900,6.038240023648545
STAT,1827,47,25-29,1874,0.05273429050524198
SIM,1844,39,40-44,1883,70
SIM,1861,48,30-34,1909,3
STAT,1846,28,45-49,1874,0.7898083989880392
STAT,1901,39,30-34,1940,1.592238317045513
STAT,1799,97,na,1896,0.35724722648141816
STAT,1901,53,na,1954,2962.334670652939
STAT,1920,39,40-44,1959,1.6145082125449064
STAT,1946,20,25-29,1966,101.74888232322292
STAT,1861,36,20-24,1897,0.6441565579227454
STAT,1897,17,45-49,1914,0.08675167938516701
STAT,1916,26,20-24,1942,18.680369330777328
SIM,1939,30,35-39,1969,49
STAT,1827,102,na,1929,0.20674452656437303
STAT,1883,18,20-24,1901,17.01092730031627
STAT,1837,37,40-44,1874,4.273490708757894
STAT,1897,23,30-34,1920,23.582541241597422
SIM,1860,27,30-34,1887,3
SIM,1887,73,na,1960,1759
STAT,1852,27,30-34,1879,29.523622166036983
STAT,1866,37,na,1903,2150.5800513964014
STAT,1870,53,na,1923,2112.098820135675
SIM,1854,20,20-24,1874,222
STAT,1905,23,40-44,1928,2.9879237449922784
STAT,1945,15,35-39,1960,4.5355571789803655
SIM,1895,33,15-19,1928,1
STAT,1842,37,15-19,1879,0.0163527414516754
SIM,1899,25,20-24,1924,1
STAT,1853,48,30-34,1901,0.07411452435759644
STAT,1900,27,20-24,1927,16.251408470163923
SIM,1924,26,20-24,1950,227
STAT,1812,43,50-100,1855,0.34980333100005145
STAT,1887,33,15-19,1920,0.15608284752328658
STAT,1866,32,40-44,1898,3.9586359813115637
STAT,1822,36,35-39,1858,14.894367374450487
STAT,1849,44,50-100,1893,0.8781423219431709
SIM,1870,1,na,1871,4030
SIM,1909,26,na,1935,4182
STAT,1867,47,20-24,1914,0.011295852679037563
STAT,1838,38,50-100,1876,0.6258737073216799
STAT,1889,21,30-34,1910,21.5147563420848
SIM,1880,19,na,1899,3157
STAT,1851,18,25-29,1869,5.40938737539678
SIM,1910,6,na,1916,4577
STAT,1846,25,50-100,1871,0.4649859368623557
STAT,1921,23,25-29,1944,102.77439371151671
STAT,1824,104,na,1928,0.012908039942463014
STAT,1825,37,15-19,1862,0.0808253574275683
SIM,1847,75,na,1922,1382
SIM,1842,15,20-24,1857,47
STAT,1796,79,na,1875,508.3280811369458
STAT,1941,17,50-100,1958,0.3815149750760487
SIM,1860,42,na,1902,1949
STAT,1871,25,25-29,1896,42.48379465878401
STAT,1896,38,35-39,1934,9.277481886600144
STAT,1883,24,40-44,1907,1.9921642548281258
STAT,1862,18,35-39,1880,0.5321128160542952
STAT,1833,36,45-49,1869,1.0925648646808783
STAT,1916,17,30-34,1933,2.55075975118215
STAT,1839,33,35-39,1872,11.45890185945367
STAT,1919,1,na,1920,4553.625504428173
SIM,1852,28,35-39,1880,52
STAT,1878,47,30-34,1925,0.09913022688205979
STAT,1956,0,na,1956,5195.490934830729
STAT,1855,28,45-49,1883,0.7604477091989014
STAT,1909,59,na,1968,3142.1275717066933
STAT,1886,17,35-39,1903,0.5682158080655307
SIM,1941,29,25-29,1970,180
STAT,1892,28,15-19,1920,0.5597490389623456
STAT,1901,31,na,1932,3350.2117159669765
SIM,1849,34,na,1883,2259
SIM,1858,24,20-24,1882,11
STAT,1844,36,20-24,1880,0.8960593156208033
STAT,1900,67,na,1967,2484.7508910264605
STAT,1818,75,na,1893,626.5885512799689
STAT,1905,26,45-49,1931,1.602452169223035
STAT,1846,23,25-29,1869,41.53290334564129
STAT,1930,33,na,1963,4843.60468170993
STAT,1894,16,30-34,1910,2.0318356839665626
STAT,1829,47,35-39,1876,0.06475568484777944
STAT,1898,47,na,1945,3011.8539901739964
STAT,1850,39,15-19,1889,0.025799253106230127
STAT,1847,29,15-19,1876,0.485985022330485
SIM,1951,15,25-29,1966,453
SIM,1913,30,na,1943,3293
STAT,1833,27,20-24,1860,7.21068846816113
STAT,1885,38,25-29,1923,2.8160676998139884
STAT,1875,38,15-19,1913,0.05737643096968239
SIM,1809,58,na,1867,612
STAT,1876,26,15-19,1902,0.46022551298753533
STAT,1868,15,25-29,1883,5.638654794024808
STAT,1915,6,na,1921,4122.117410698443
STAT,1942,23,45-49,1965,1.1658732258639486
STAT,1905,34,na,1939,3431.84028387019
STAT,1920,15,30-34,1935,2.7209303700085985
STAT,1808,47,15-19,1855,7.310945944056219E-4
STAT,1926,29,na,1955,4420.439745880278
STAT,1854,22,20-24,1876,45.020617091768536
SIM,1876,26,30-34,1902,4
STAT,1865,52,na,1917,1955.3577868125067
STAT,1818,47,25-29,1865,0.10272878899676205
STAT,1911,28,35-39,1939,14.425556142460769
STAT,1912,16,35-39,1928,0.8407119173658166
STAT,1879,26,40-44,1905,3.0835144223176143
STAT,1878,48,35-39,1926,0.14223180381741343
STAT,1895,23,20-24,1918,89.36935947019352
STAT,1896,29,45-49,1925,1.4531725015130024
STAT,1909,27,40-44,1936,4.409189360902437
STAT,1933,29,25-29,1962,86.71675302841233
STAT,1923,27,50-100,1950,1.1307484453406034
SIM,1911,39,40-44,1950,1
SIM,1883,37,na,1920,2199
SIM,1837,38,45-49,1875,31
STAT,1926,21,45-49,1947,1.359322769901153
STAT,1845,49,35-39,1894,0.0680198931219577
STAT,1835,49,25-29,1884,0.044775819951294475
SIM,1954,4,na,1958,5556
STAT,1840,26,35-39,1866,4.771443780369925
STAT,1863,39,35-39,1902,5.977467823619684
STAT,1924,15,15-19,1939,53.773483445987324
STAT,1838,25,40-44,1863,1.6502402049223335
STAT,1914,29,15-19,1943,0.696759197685879
STAT,1885,37,20-24,1922,0.7577054198993772
SIM,1946,25,na,1971,3044
STAT,1916,33,45-49,1949,1.595679346737758
SIM,1852,27,30-34,1879,7
STAT,1943,19,40-44,1962,1.46532094046721
STAT,1894,66,na,1960,2209.6523497376356
STAT,1863,27,40-44,1890,2.557349734003052
STAT,1847,111,na,1958,1.2124689398839946E-4
STAT,1943,15,25-29,1958,45.45330038434871
STAT,1901,39,50-100,1940,0.3667943599211372
STAT,1886,15,na,1901,2627.5431719021612
STAT,1822,35,30-34,1857,11.743009494673426
SIM,1794,65,na,1859,745
STAT,1887,26,40-44,1913,3.30845177575566
SIM,1836,32,20-24,1868,9
STAT,1860,75,na,1935,839.827100359445
SIM,1824,80,na,1904,857
SIM,1859,39,35-39,1898,4
STAT,1855,48,40-44,1903,0.11188270499562716
SIM,1871,39,35-39,1910,23
STAT,1828,32,20-24,1860,4.094071846534267
STAT,1854,27,40-44,1881,1.7460776305826866
STAT,1844,27,30-34,1871,30.539863857143125
SIM,1819,68,na,1887,1056
STAT,1915,44,na,1959,3673.9990705320383
STAT,1931,3,na,1934,5271.677131196526
SIM,1913,52,na,1965,2906
STAT,1818,46,20-24,1864,0.02173045904483056
SIM,1869,25,35-39,1894,7
STAT,1889,11,na,1900,3114.5627885364456
STAT,1938,25,45-49,1963,1.694700831783672
STAT,1866,38,15-19,1904,0.05100469058867872
SIM,1830,36,35-39,1866,4
SIM,1833,28,25-29,1861,115
SIM,1895,70,na,1965,4126
SIM,1852,37,25-29,1889,2
SIM,1847,33,35-39,1880,13
STAT,1895,17,35-39,1912,0.713800623037703
SIM,1905,30,30-34,1935,1
SIM,1917,36,30-34,1953,1
SIM,1933,29,na,1962,4022
STAT,1938,20,25-29,1958,90.5016837764977
STAT,1776,80,na,1856,455.02467169500005
STAT,1844,28,35-39,1872,11.61791538473737
SIM,1842,76,na,1918,584
STAT,1898,69,na,1967,2271.700538522817
STAT,1948,20,35-39,1968,10.708101617108577
STAT,1902,23,15-19,1925,4.631200327238518
STAT,1866,26,20-24,1892,10.74543768867728
STAT,1915,38,20-24,1953,0.2612353514215331
STAT,1883,20,25-29,1903,55.40134654110052
STAT,1931,16,45-49,1947,0.6508490263405587
STAT,1834,48,20-24,1882,0.0055372629495262105
STAT,1919,22,30-34,1941,31.054138985073184
STAT,1874,37,45-49,1911,2.057410870297676
SIM,1824,33,40-44,1857,25
STAT,1889,39,20-24,1928,0.9189328330072114
STAT,1901,15,20-24,1916,24.903471929248276
STAT,1943,24,15-19,1967,5.595042171275654
STAT,1851,6,na,1857,2395.5769163693362
STAT,1931,22,30-34,1953,37.014784686495084
STAT,1829,38,45-49,1867,0.9941812949837227
STAT,1869,37,50-100,1906,1.2388929799667134
SIM,1946,20,25-29,1966,520
STAT,1890,41,na,1931,2810.6639558051393
STAT,1859,47,20-24,1906,0.009466770483752097
STAT,1895,40,na,1935,3036.9661602995466
STAT,1896,26,50-100,1922,0.8461546697617028
SIM,1927,20,15-19,1947,1
STAT,1838,26,45-49,1864,0.6072683595631019
STAT,1865,74,na,1939,1013.2270554237926
STAT,1861,52,50-100,1913,0.01249323141946008
SIM,1831,39,na,1870,2114
STAT,1859,38,30-34,1897,4.203232054567515
SIM,1814,69,na,1883,2292
STAT,1843,20,na,1863,2690.195073344151
STAT,1921,27,40-44,1948,5.133162624526232
STAT,1935,17,40-44,1952,1.898370055739767
SIM,1882,74,na,1956,993
STAT,1870,18,35-39,1888,0.5489846228420595
SIM,1899,28,25-29,1927,1
STAT,1895,28,40-44,1923,3.883129735669541
STAT,1827,35,na,1862,2029.8327651835298
SIM,1905,17,20-24,1922,232
STAT,1849,89,na,1938,88.5172443145772
STAT,1941,28,20-24,1969,18.65949929616737
STAT,1841,61,na,1902,2080.84721657707
SIM,1896,55,na,1951,2599
STAT,1905,32,30-34,1937,14.419696021941814
STAT,1878,70,na,1948,1443.5798797337554
STAT,1834,37,15-19,1871,0.030783384810463013
STAT,1923,20,30-34,1943,33.287278546249716
STAT,1855,34,30-34,1889,11.524033189102717
SIM,1895,24,25-29,1919,7
STAT,1881,27,35-39,1908,9.11194401399219
SIM,1935,24,30-34,1959,2
STAT,1887,24,25-29,1911,62.61426441963053
STAT,1786,79,na,1865,525.6097522780173
STAT,1785,94,na,1879,1.877311414761472
STAT,1906,27,15-19,1933,0.6569936661735003
SIM,1938,7,na,1945,4264
STAT,1892,19,25-29,1911,6.97831647530643
STAT,1919,20,15-19,1939,5.78587344169273
SIM,1878,48,35-39,1926,1
STAT,1826,46,20-24,1872,0.017402901044917644
STAT,1869,36,25-29,1905,2.919329297259181
STAT,1939,26,15-19,1965,0.7022118689016523
STAT,1913,25,40-44,1938,4.617148064842415
SIM,1863,49,na,1912,416
STAT,1828,37,40-44,1865,5.883488820056427
STAT,1939,32,35-39,1971,9.221570941797811
STAT,1927,24,30-34,1951,34.902458344189924
STAT,1869,27,35-39,1896,9.736558883907147
STAT,1875,52,na,1927,2199.2148253124906
STAT,1860,29,30-34,1889,20.466219710499516
SIM,1893,37,na,1930,3209
STAT,1826,94,na,1920,15.93362242089176
SIM,1883,15,na,1898,2241
STAT,1869,99,na,1968,10.868855020257243
STAT,1847,23,na,1870,2352.798408920531
STAT,1945,10,na,1955,4244.778050834807
STAT,1879,31,15-19,1910,0.1466844716753629
SIM,1866,89,na,1955,402
STAT,1811,95,na,1906,8.054847491841315
STAT,1926,39,35-39,1965,2.924446270327453
SIM,1833,27,20-24,1860,19
STAT,1837,46,30-34,1883,0.08160980934505
STAT,1915,21,35-39,1936,9.62460641155545
SIM,1895,9,na,1904,4648
STAT,1848,38,20-24,1886,0.7356769883001211
STAT,1832,24,35-39,1856,7.377552678233817
STAT,1842,39,15-19,1881,0.014575141376163931
STAT,1910,25,15-19,1935,0.6844100358989111
STAT,1825,76,na,1901,583.4231548335976
STAT,1877,24,50-100,1901,0.4113649031656337
STAT,1908,31,45-49,1939,1.4798631887375233
STAT,1918,46,25-29,1964,0.05582566715008645
STAT,1877,29,35-39,1906,9.724818160140812
STAT,1881,18,45-49,1899,0.06152554121168873
STAT,1877,35,20-24,1912,0.7899359297488127
SIM,1923,30,na,1953,3941
STAT,1907,15,na,1922,3702.225513044067
STAT,1813,76,na,1889,696.1418699934625
STAT,1946,22,25-29,1968,101.67868768218712
SIM,1799,64,na,1863,1026
STAT,1843,42,na,1885,2351.232891506709
STAT,1869,38,40-44,1907,4.39534917803159
STAT,1860,27,15-19,1887,0.37409277231513516
SIM,1854,23,25-29,1877,2
STAT,1851,17,20-24,1868,17.023701678495282
SIM,1896,33,na,1929,3750
STAT,1893,37,20-24,1930,0.9639679774943712
STAT,1934,21,45-49,1955,1.5023577376197885
SIM,1896,36,35-39,1932,6
STAT,1871,39,35-39,1910,6.984536798895154
SIM,1843,16,25-29,1859,102
SIM,1851,42,50-100,1893,13
STAT,1903,33,50-100,1936,0.743664963231713
SIM,1848,39,25-29,1887,27
STAT,1846,25,40-44,1871,2.1774451463353337
STAT,1788,104,na,1892,0.00805367760777937
STAT,1935,22,15-19,1957,7.1966893307745075
STAT,1927,18,45-49,1945,0.6144459447174835
STAT,1830,106,na,1936,0.008787819123774446
STAT,1875,49,20-24,1924,0.012064948456138347
STAT,1889,48,45-49,1937,0.15829652295695099
SIM,1867,48,25-29,1915,1
STAT,1816,49,15-19,1865,0.0011821415195425152
STAT,1830,38,35-39,1868,6.384779920508946
SIM,1864,23,na,1887,2492
STAT,1828,102,na,1930,0.19845900836653946
STAT,1859,48,25-29,1907,0.04507969866249055
STAT,1892,18,20-24,1910,21.892077448703418
STAT,1948,21,50-100,1969,0.7480257130249478
SIM,1878,48,na,1926,3809
STAT,1858,26,20-24,1884,9.237501268631028
STAT,1852,36,20-24,1888,0.7882803408327171
STAT,1911,20,50-100,1931,0.6206923251319203
SIM,1863,34,30-34,1897,1
STAT,1843,42,50-100,1885,1.0747324738419086
STAT,1907,31,50-100,1938,0.7707799388557679
STAT,1926,33,50-100,1959,0.9905518455533441
STAT,1917,34,15-19,1951,0.13163144532163162
STAT,1821,54,50-100,1875,0.014981222257356866
SIM,1902,25,30-34,1927,4
STAT,1884,26,15-19,1910,0.43580737922447293
SIM,1834,57,na,1891,714
STAT,1876,37,na,1913,2381.6762436927856
STAT,1860,53,na,1913,1728.334250171086
STAT,1879,27,45-49,1906,1.1389931811025074
SIM,1835,25,30-34,1860,113
STAT,1837,47,35-39,1884,0.11652818503309963
STAT,1936,34,25-29,1970,8.876926744844603
STAT,1843,19,50-100,1862,0.06113319009470524
SIM,1814,80,na,1894,16
STAT,1904,20,20-24,1924,99.04243845525357
STAT,1929,25,na,1954,4673.209890069883
SIM,1915,39,25-29,1954,1
STAT,1836,28,35-39,1864,9.498568386042368
STAT,1951,17,25-29,1968,51.123432160663604
STAT,1844,54,50-100,1898,0.01455067760502432
STAT,1894,49,30-34,1943,0.06798691822680558
STAT,1870,17,30-34,1887,1.6041179019324396
SIM,1924,15,na,1939,3693
SIM,1808,95,na,1903,12
STAT,1917,29,40-44,1946,4.788393583968492
STAT,1946,24,40-44,1970,3.698709626907349
STAT,1859,39,35-39,1898,5.549523996769848
STAT,1845,86,na,1931,110.09873681256514
SIM,1893,15,na,1908,3526
STAT,1856,60,na,1916,1369.8385798255554
STAT,1907,39,25-29,1946,0.8976288088485057
STAT,1865,23,35-39,1888,5.353786202113325
STAT,1884,88,na,1972,376.4041435815844
STAT,1906,30,na,1936,3512.9550134953142
STAT,1888,36,35-39,1924,8.202599680346337
STAT,1828,34,35-39,1862,14.35570116087489
STAT,1826,30,na,1856,2359.180434507272
SIM,1873,17,na,1890,2321
STAT,1917,31,45-49,1948,1.6324275194705091
SIM,1859,29,35-39,1888,27
STAT,1919,27,na,1946,3993.9278417645214
SIM,1939,8,na,1947,4798
STAT,1908,63,na,1971,2961.871697444067
SIM,1854,34,na,1888,1780
STAT,1864,50,25-29,1914,0.003266339402196778
STAT,1915,26,50-100,1941,1.00432869388306
SIM,1876,36,30-34,1912,5
STAT,1908,20,40-44,1928,3.085505976945161
STAT,1827,42,20-24,1869,0.15072356791773037
STAT,1854,39,35-39,1893,3.8930888106183077
STAT,1868,36,30-34,1904,5.172459948678188
STAT,1892,38,15-19,1930,0.06917977440464493
STAT,1834,45,15-19,1879,2.1077740176745572E-4
STAT,1854,31,25-29,1885,5.892968943830739
STAT,1807,105,na,1912,0.011888155403111573
STAT,1836,48,30-34,1884,0.07663828426159378
STAT,1894,33,20-24,1927,3.4228620366838816
SIM,1916,4,na,1920,4952
STAT,1845,33,25-29,1878,5.980753443562133
SIM,1827,36,35-39,1863,2
SIM,1852,3,na,1855,2713
STAT,1893,60,na,1953,2384.9812361246936
SIM,1846,15,na,1861,1516
STAT,1871,41,50-100,1912,1.0586253020749454
SIM,1890,72,na,1962,2631
STAT,1897,36,50-100,1933,1.638353873544577
STAT,1823,97,na,1920,4.24394775949791
SIM,1882,53,na,1935,1485
STAT,1900,44,25-29,1944,0.06093979192806891
STAT,1886,27,35-39,1913,9.991948813610502
SIM,1815,44,45-49,1859,7
STAT,1882,34,40-44,1916,4.116468958103742
STAT,1875,28,15-19,1903,0.4642455453311319
STAT,1895,25,35-39,1920,12.637182520264322
STAT,1816,42,45-49,1858,4.919110264502407
STAT,1861,27,30-34,1888,21.094500220431534
STAT,1884,19,25-29,1903,5.395511693440709
STAT,1845,31,30-34,1876,10.40882966200299
STAT,1874,35,45-49,1909,2.076950350636464
STAT,1832,36,50-100,1868,0.09047993536033687
SIM,1945,0,na,1945,6728
STAT,1885,40,15-19,1925,0.013711333384624732
STAT,1813,53,30-34,1866,0.020274354275177812
STAT,1824,41,40-44,1865,0.38081537495194856
STAT,1848,47,50-100,1895,0.22875476832148978
STAT,1887,52,na,1939,2357.3821783905464
STAT,1859,45,20-24,1904,0.009605933478712685
STAT,1871,46,30-34,1917,0.09683638145009374
STAT,1940,12,na,1952,3961.6160224901105
STAT,1880,44,30-34,1924,1.1774227373654031
STAT,1854,49,35-39,1903,0.07621718366847036
STAT,1815,43,40-44,1858,0.23496793523524287
STAT,1926,32,50-100,1958,0.9911663687019391
STAT,1891,32,40-44,1923,5.3329849547935835
STAT,1913,10,na,1923,3999.301251662369
STAT,1819,41,30-34,1860,0.27430332005420743
STAT,1876,42,15-19,1918,0.013943280046670992
STAT,1883,33,45-49,1916,1.6705526662467571
STAT,1843,43,15-19,1886,0.013869950418100031
SIM,1819,37,na,1856,1950
STAT,1927,22,15-19,1949,6.505028610616216
SIM,1855,51,na,1906,3004
SIM,1867,28,30-34,1895,70
STAT,1863,47,35-39,1910,0.11896251446424017
SIM,1823,42,na,1865,1436
STAT,1854,89,na,1943,58.41161535898997
STAT,1928,31,20-24,1959,3.0284762987414307
STAT,1828,49,35-39,1877,0.16279135441875076
STAT,1811,46,50-100,1857,1.1730222467666587
STAT,1833,34,45-49,1867,0.959565364638719
STAT,1890,40,25-29,1930,0.7852442182975543
SIM,1778,81,na,1859,830
SIM,1852,23,na,1875,2406
SIM,1827,56,na,1883,1716
STAT,1842,88,na,1930,34.07989207786104
STAT,1856,101,na,1957,0.5807083220294824
STAT,1906,48,50-100,1954,0.19809342549864783
STAT,1831,26,35-39,1857,12.086647886196056
STAT,1856,44,40-44,1900,1.5937434710229896
STAT,1929,30,25-29,1959,11.671095668436857
STAT,1895,71,na,1966,2032.457408838707
STAT,1857,3,na,1860,2548.201424160462
SIM,1909,57,na,1966,3677
STAT,1896,25,50-100,1921,0.8489817790860597
SIM,1864,44,40-44,1908,10
STAT,1859,28,30-34,1887,20.157720554704984
STAT,1836,40,na,1876,1963.8441303977352
STAT,1880,39,35-39,1919,7.268883049456548
STAT,1886,32,30-34,1918,18.08041209792816
STAT,1879,33,50-100,1912,0.9359547272868192
STAT,1825,47,15-19,1872,5.08159455697687E-4
STAT,1862,30,20-24,1892,2.320812286413384
STAT,1815,44,50-100,1859,0.1085133846978581
STAT,1889,28,15-19,1917,0.5444367609520586
SIM,1852,34,20-24,1886,45
SIM,1853,26,35-39,1879,17
SIM,1919,21,20-24,1940,10
STAT,1856,29,15-19,1885,0.3328478467640268
STAT,1830,45,30-34,1875,0.08487213748822448
STAT,1870,102,na,1972,3.118144028716138
STAT,1854,38,50-100,1892,0.6792607542056212
STAT,1859,13,na,1872,2186.3680651266827
STAT,1835,37,30-34,1872,4.985346817974469
SIM,1872,43,35-39,1915,9
STAT,1877,36,25-29,1913,2.936798907296633
SIM,1831,61,na,1892,2058
STAT,1813,48,35-39,1861,0.5046088241778476
STAT,1850,31,40-44,1881,2.11671210330769
STAT,1788,105,na,1893,0.003540316139603733
STAT,1835,19,30-34,1854,1.61290105545483
STAT,1877,19,35-39,1896,0.5540187083169027
STAT,1906,1,na,1907,3941.4569715534767
STAT,1952,13,na,1965,4663.5845798090795
STAT,1853,15,30-34,1868,1.504338105834927
SIM,1869,87,na,1956,2201
SIM,1894,54,na,1948,1169
STAT,1895,32,25-29,1927,13.324322078261588
STAT,1875,46,15-19,1921,4.119067126755851E-4
STAT,1825,29,15-19,1854,1.065834697118277
STAT,1857,22,na,1879,1894.1131830048544
STAT,1919,16,30-34,1935,2.6730591276894677
SIM,1914,48,na,1962,4772
SIM,1919,16,25-29,1935,335
SIM,1844,24,na,1868,2978
STAT,1881,40,30-34,1921,1.0966415968464873
STAT,1831,44,35-39,1875,1.7229113670511396
STAT,1843,25,15-19,1868,0.5596949943324303
STAT,1851,30,45-49,1881,1.4635595060814615
STAT,1833,29,20-24,1862,6.84721386748677
SIM,1868,27,35-39,1895,230
SIM,1841,34,45-49,1875,1
STAT,1852,51,45-49,1903,0.014677914608159781
STAT,1864,43,35-39,1907,1.6343300065859847
STAT,1828,41,25-29,1869,0.8165622951513549
SIM,1799,63,na,1862,1026
STAT,1897,48,45-49,1945,0.17457368986265176
SIM,1858,16,na,1874,2443
STAT,1839,19,15-19,1858,7.127862591676756
STAT,1881,42,25-29,1923,0.6056729580214961
STAT,1836,18,35-39,1854,1.3305122617259997
STAT,1844,34,20-24,1878,3.1364914233240104
STAT,1844,59,na,1903,1925.3683489817754
STAT,1848,50,40-44,1898,0.009993076800701084
STAT,1852,78,na,1930,786.4800687366624
STAT,1869,47,30-34,1916,0.0972237412841774
SIM,1859,44,30-34,1903,8
SIM,1872,43,na,1915,2344
STAT,1862,23,30-34,1885,15.419335163374074
STAT,1885,28,30-34,1913,24.665403302625318
STAT,1855,23,40-44,1878,1.599610281073044
STAT,1887,47,50-100,1934,0.26906506413420217
STAT,1889,46,45-49,1935,0.2850039919795508
SIM,1857,43,50-100,1900,1
STAT,1850,5,na,1855,1418.8736000000001
STAT,1853,27,50-100,1880,0.5746057220586599
SIM,1880,62,na,1942,3193
STAT,1831,51,25-29,1882,0.00299694461967939
STAT,1844,35,30-34,1879,6.259936223975243
STAT,1913,20,20-24,1933,107.031400734051
STAT,1881,43,35-39,1924,1.6976850145716629
STAT,1892,31,45-49,1923,2.1678386014523023
SIM,1873,42,40-44,1915,2
STAT,1848,27,15-19,1875,0.5068483340870508
STAT,1867,32,na,1899,2256.8061009386015
SIM,1903,32,na,1935,2883
STAT,1843,18,25-29,1861,7.112969136309488
SIM,1843,37,30-34,1880,4
SIM,1907,46,na,1953,4398
STAT,1919,24,50-100,1943,0.706495833897462
STAT,1853,40,na,1893,1810.1922176136852
SIM,1851,18,25-29,1869,6
STAT,1814,52,35-39,1866,0.02838619857701637
STAT,1860,17,15-19,1877,5.58363989609473
STAT,1933,39,40-44,1972,2.020851818836934
STAT,1826,50,50-100,1876,0.021709732546237478
STAT,1868,18,na,1886,2468.948643670033
STAT,1825,40,45-49,1865,2.0554624458218393
STAT,1872,45,35-39,1917,0.14158798083599783
STAT,1846,54,25-29,1900,0.0020401076155261563
STAT,1818,37,30-34,1855,13.569377799897225
SIM,1839,57,na,1896,346
STAT,1844,53,50-100,1897,0.014721893223210256
STAT,1872,23,na,1895,2360.946174405838
SIM,1835,43,na,1878,1271
STAT,1801,108,na,1909,6.076708953974803E-4
STAT,1814,51,25-29,1865,0.011913213383289769
SIM,1865,43,45-49,1908,4
SIM,1937,30,25-29,1967,39
STAT,1885,18,30-34,1903,1.562588213773277
STAT,1943,2,na,1945,4250.5504188619825
STAT,1857,43,45-49,1900,1.14016768983853
STAT,1858,42,50-100,1900,0.8057813184542363
STAT,1928,16,25-29,1944,54.32146426354269
SIM,1831,42,35-39,1873,2
STAT,1845,21,na,1866,1326.6578701718622
STAT,1870,25,30-34,1895,25.274988506134214
STAT,1809,51,15-19,1860,2.073049608236204E-4
STAT,1905,21,25-29,1926,82.58612308140854
SIM,1827,41,30-34,1868,20
STAT,1868,19,40-44,1887,0.17774682141505296
SIM,1882,17,15-19,1899,15
SIM,1893,28,30-34,1921,3
STAT,1878,22,50-100,1900,0.4195630048559325
STAT,1899,37,15-19,1936,0.016554951935490274
STAT,1827,35,30-34,1862,5.385619658780949
STAT,1838,23,40-44,1861,1.1457975986059799
SIM,1895,16,na,1911,4648
STAT,1873,40,na,1913,2394.745109120781
STAT,1874,17,15-19,1891,6.124851115599368
STAT,1894,26,30-34,1920,32.13267152841042
SIM,1911,51,na,1962,2293
STAT,1830,48,35-39,1878,0.11812059873122704
STAT,1841,36,45-49,1877,2.642751231468426
STAT,1885,19,50-100,1904,0.047898282152731196
STAT,1860,35,15-19,1895,0.04624551914877189
STAT,1829,33,40-44,1862,2.333014992604057
STAT,1834,27,15-19,1861,0.26219429065451727
STAT,1855,52,25-29,1907,0.0023317537557422806
STAT,1869,38,50-100,1907,1.2327480707860785
STAT,1889,17,50-100,1906,0.058997245882894844
STAT,1947,23,50-100,1970,0.735580767372024
STAT,1871,24,35-39,1895,5.784704578400073
STAT,1866,41,45-49,1907,1.3723427195652866
STAT,1835,86,na,1921,167.88374997070983
STAT,1851,27,15-19,1878,0.41955569082211197
STAT,1858,36,15-19,1894,0.043089633398224116
STAT,1805,49,50-100,1854,0.29377566939804617
SIM,1941,26,na,1967,3640
STAT,1831,72,na,1903,988.4047510472593
STAT,1845,16,35-39,1861,0.34617562273656743
SIM,1871,26,na,1897,1872
STAT,1819,36,35-39,1855,3.7331049720976486
STAT,1866,48,15-19,1914,3.605393429350234E-4
STAT,1809,47,30-34,1856,0.8516035674757795
STAT,1853,32,20-24,1885,2.1583647389678076
STAT,1869,32,30-34,1901,17.618284512926145
STAT,1907,21,35-39,1928,8.540236776939462
STAT,1865,42,40-44,1907,2.051040472403163
STAT,1822,52,50-100,1874,0.02433653917090072
STAT,1823,42,35-39,1865,3.0413425913813397
STAT,1879,24,40-44,1903,2.1242720459787807
STAT,1913,54,na,1967,3448.397455300622
STAT,1892,32,50-100,1924,1.1343979667037696
STAT,1805,54,35-39,1859,0.009677760485606311
STAT,1818,44,20-24,1862,0.2928100549943617
STAT,1855,50,30-34,1905,0.00399622827028787
STAT,1868,26,30-34,1894,24.405931391630162
STAT,1910,22,50-100,1932,0.6110063436237438
STAT,1890,33,35-39,1923,12.208162935373421
STAT,1853,25,30-34,1878,22.94807280949662
STAT,1876,38,30-34,1914,5.36098993267757
STAT,1815,46,45-49,1861,0.02424165846994012
STAT,1833,47,50-100,1880,0.12332733201711878
SIM,1848,61,na,1909,2307
STAT,1869,34,25-29,1903,10.247136956348523
STAT,1880,26,30-34,1906,26.232416196086323
STAT,1943,21,45-49,1964,1.183830971487843
SIM,1861,32,20-24,1893,17
STAT,1917,48,50-100,1965,0.23244441045283656
STAT,1901,21,na,1922,3316.830540308808
SIM,1894,34,25-29,1928,13
STAT,1885,35,20-24,1920,0.7649014400859407
SIM,1867,52,na,1919,2035
SIM,1875,71,na,1946,2443
SIM,1882,32,40-44,1914,38
STAT,1896,13,na,1909,3399.060741023077
STAT,1896,24,40-44,1920,2.7297401692039287
STAT,1905,35,na,1940,3447.8256539452377
SIM,1861,25,30-34,1886,173
STAT,1882,37,45-49,1919,1.9085846243518534
STAT,1865,27,15-19,1892,0.41422636647777533
STAT,1854,24,35-39,1878,3.757777840691599
STAT,1904,31,50-100,1935,1.3143858467298377
STAT,1918,24,15-19,1942,5.62830441515233
STAT,1830,55,na,1885,1524.0500134360905
STAT,1875,31,45-49,1906,1.7979654160492513
STAT,1886,34,25-29,1920,10.515919348376979
STAT,1840,42,35-39,1882,0.7437798951136038
STAT,1844,17,30-34,1861,2.0072163438222246
STAT,1907,49,40-44,1956,0.13870610107588846
STAT,1872,52,25-29,1924,0.0035279469955907753
STAT,1885,41,na,1926,2282.1111422567387
STAT,1855,45,35-39,1900,0.09358085778922498
STAT,1819,43,25-29,1862,0.1347701058616676
STAT,1895,22,30-34,1917,23.171508903989984
STAT,1909,29,50-100,1938,0.9348376959414582
STAT,1854,46,30-34,1900,0.0539753234808299
STAT,1881,50,25-29,1931,0.0033929594593921975
STAT,1864,46,40-44,1910,0.15608086092085005
STAT,1874,32,40-44,1906,4.475779869046513
STAT,1928,21,20-24,1949,138.19248929965738
SIM,1840,37,50-100,1877,1
STAT,1899,40,45-49,1939,0.14338663569218904
STAT,1964,5,na,1969,4903.607974732873
STAT,1860,22,na,1882,1988.9235238979843
STAT,1862,38,30-34,1900,4.516904516996562
STAT,1879,54,35-39,1933,0.008588655067411766
STAT,1827,45,25-29,1872,0.05411064632466709
STAT,1831,43,25-29,1874,0.6192268440852197
STAT,1868,39,35-39,1907,6.762772429071451
STAT,1885,36,30-34,1921,5.263919240266034
SIM,1870,38,30-34,1908,2
STAT,1877,33,20-24,1910,2.732350548313614
STAT,1883,49,50-100,1932,0.23134450807410087
STAT,1800,89,na,1889,67.21616674613945
SIM,1840,42,na,1882,2567
SIM,1823,46,45-49,1869,2
STAT,1892,23,45-49,1915,0.8606817872074412
STAT,1862,31,30-34,1893,14.931930539187832
STAT,1832,37,50-100,1869,0.09364273142560568
STAT,1868,40,15-19,1908,0.013473102366851886
STAT,1830,53,30-34,1883,0.004387912741926972
STAT,1935,24,15-19,1959,7.191796413247197
STAT,1893,16,15-19,1909,7.439547726082956
STAT,1841,41,40-44,1882,2.6362719959575514
SIM,1859,26,30-34,1885,93
SIM,1858,38,30-34,1896,7
STAT,1825,32,45-49,1857,3.02234692995923
STAT,1854,36,30-34,1890,2.9776021832417703
STAT,1828,101,na,1929,0.38627235074650523
STAT,1923,47,30-34,1970,0.10318787548050788
SIM,1866,90,na,1956,338
STAT,1858,29,25-29,1887,32.59637280960747
STAT,1842,19,20-24,1861,5.585096721387394
STAT,1894,36,25-29,1930,3.6789779757083263
SIM,1830,43,30-34,1873,2
STAT,1856,92,na,1948,29.914839538477175
STAT,1865,44,50-100,1909,0.9515117777303881
STAT,1822,36,na,1858,1665.332937430614
STAT,1891,21,50-100,1912,0.5029855759530654
SIM,1879,53,na,1932,1085
STAT,1919,41,20-24,1960,0.018911281263748966
STAT,1899,33,na,1932,3245.6296141511402
STAT,1855,53,35-39,1908,0.005606305240262553
STAT,1822,50,20-24,1872,0.0012372939878690656
STAT,1805,53,25-29,1858,0.00406428319092542
SIM,1936,21,20-24,1957,705
SIM,1927,23,20-24,1950,152
STAT,1846,37,35-39,1883,4.374507936968443
STAT,1835,44,20-24,1879,0.1403360506849455
STAT,1844,42,20-24,1886,0.16113658093979286
SIM,1947,11,na,1958,4369
SIM,1862,36,30-34,1898,3
STAT,1868,29,35-39,1897,9.25300973227662
STAT,1816,40,na,1856,2724.1822428138025
SIM,1900,12,na,1912,4181
SIM,1883,18,20-24,1901,4
SIM,1860,10,na,1870,2608
STAT,1939,20,40-44,1959,3.3419523302550393
STAT,1803,77,na,1880,259.72707352620654
STAT,1828,39,40-44,1867,5.63605915385541
SIM,1871,44,30-34,1915,1
STAT,1897,45,40-44,1942,0.12952999120178046
STAT,1947,22,na,1969,4083.733514441495
SIM,1844,32,20-24,1876,5
STAT,1839,37,na,1876,2377.9301982742445
SIM,1823,62,na,1885,708
STAT,1856,47,45-49,1903,0.16871758468092773
STAT,1898,48,na,1946,2987.939869492017
STAT,1895,37,30-34,1932,6.933101060175619
STAT,1883,30,40-44,1913,4.205644601285459
STAT,1919,23,20-24,1942,119.77159197934105
SIM,1919,47,na,1966,4901
SIM,1815,75,na,1890,482
STAT,1831,105,na,1936,0.0229478244200695
SIM,1864,24,na,1888,2423
STAT,1818,52,20-24,1870,0.0012627217819188555
SIM,1835,45,25-29,1880,1
SIM,1923,29,na,1952,4239
STAT,1877,26,30-34,1903,25.650383137993263
SIM,1841,31,40-44,1872,2
STAT,1872,27,35-39,1899,9.662047061621022
SIM,1889,63,na,1952,2370
SIM,1893,69,na,1962,1380
STAT,1850,12,na,1862,1347.0354151040458
STAT,1827,36,na,1863,2008.908136877542
SIM,1836,39,40-44,1875,23
STAT,1869,67,na,1936,1599.6145952253319
STAT,1828,46,30-34,1874,0.1171134142341664
STAT,1863,44,30-34,1907,0.968237689272783
STAT,1818,45,30-34,1863,0.17798210034245462
STAT,1833,31,40-44,1864,2.4895075372421207
STAT,1823,45,40-44,1868,0.27486466764552087
STAT,1828,31,30-34,1859,27.32093544197464
STAT,1900,35,na,1935,3294.696591966879
STAT,1904,49,na,1953,3147.810587804673
SIM,1882,73,na,1955,1035
STAT,1885,43,20-24,1928,0.154977499018421
STAT,1813,45,30-34,1858,0.37076338187261393
SIM,1844,41,30-34,1885,6
STAT,1871,37,na,1908,2350.190014515748
SIM,1905,11,na,1916,3866
STAT,1820,108,na,1928,0.001259698474187331
STAT,1862,88,na,1950,116.93006582724803
STAT,1792,64,na,1856,1067.360494
SIM,1893,36,30-34,1929,44
STAT,1880,36,30-34,1916,5.559555173454519
STAT,1881,26,50-100,1907,0.6061651626304014
STAT,1821,37,30-34,1858,6.577070525992409
STAT,1852,33,15-19,1885,0.14688435365477284
STAT,1890,36,40-44,1926,5.324943196712796
STAT,1940,32,na,1972,3870.354926090581
STAT,1894,34,na,1928,3008.5920200745572
STAT,1807,52,45-49,1859,0.04627893584174533
STAT,1925,20,40-44,1945,4.011686325731748
STAT,1893,42,15-19,1935,0.017248314411226408
STAT,1873,40,25-29,1913,0.6653582382702301
STAT,1836,41,30-34,1877,1.0615320525183711
SIM,1876,39,35-39,1915,1
STAT,1786,80,na,1866,478.07886237951607
STAT,1966,6,na,1972,4860.666772821162
STAT,1877,41,20-24,1918,0.16194379685872715
SIM,1840,40,35-39,1880,4
SIM,1906,29,na,1935,3346
STAT,1841,33,40-44,1874,5.79875390058572
STAT,1855,49,50-100,1904,0.1591531791090309
STAT,1805,88,na,1893,18.41836992651856
STAT,1839,17,50-100,1856,0.059542446870056054
STAT,1854,29,40-44,1883,1.721093970299962
STAT,1845,26,35-39,1871,5.869950820966234
STAT,1861,46,50-100,1907,0.2048314178633994
SIM,1898,68,na,1966,3069
STAT,1945,11,na,1956,4244.268677468706
SIM,1835,75,na,1910,234
STAT,1922,47,na,1969,4173.410675266193
SIM,1869,32,25-29,1901,7
STAT,1887,38,35-39,1925,7.746361551443486
SIM,1863,42,30-34,1905,9
STAT,1863,51,20-24,1914,6.329850240754093E-4
SIM,1895,38,35-39,1933,10
STAT,1889,43,40-44,1932,2.6890676638020716
SIM,1865,41,na,1906,1701
STAT,1853,18,35-39,1871,0.5087896123197307
STAT,1837,50,50-100,1887,0.012644859505738619
SIM,1794,64,na,1858,745
STAT,1927,43,50-100,1970,0.14590601217397225
SIM,1848,43,45-49,1891,4
STAT,1861,34,20-24,1895,2.2287334611532246
SIM,1853,60,na,1913,2608
STAT,1842,32,50-100,1874,0.2747687270464496
STAT,1841,62,na,1903,2035.297471006198
STAT,1863,52,30-34,1915,0.0050547118504428844
STAT,1871,23,25-29,1894,56.92854072142568
STAT,1903,64,na,1967,2738.4954009624194
SIM,1947,1,na,1948,4477
STAT,1853,28,35-39,1881,7.83050470259427
STAT,1880,54,25-29,1934,0.0035760370719644945
STAT,1832,40,35-39,1872,0.15500307610176767
STAT,1869,35,35-39,1904,7.204939359976803
STAT,1952,19,50-100,1971,0.4445773010102708
STAT,1851,22,45-49,1873,0.6576902619156039
STAT,1887,30,25-29,1917,11.364380051891604
STAT,1811,50,45-49,1861,0.06795363996836108
STAT,1867,44,15-19,1911,0.012884080532079853
STAT,1868,18,30-34,1886,1.5581138152406844
STAT,1834,69,na,1903,646.754098440687
STAT,1880,42,na,1922,2396.469764419884
STAT,1914,16,50-100,1930,0.07661026717928442
STAT,1852,41,15-19,1893,0.01396370562931857
STAT,1914,15,50-100,1929,0.0767776424398032
SIM,1909,28,30-34,1937,2
SIM,1928,28,na,1956,2507
STAT,1851,37,15-19,1888,0.04482539769692151
SIM,1924,14,na,1938,5281
STAT,1915,45,na,1960,3666.8209857917977
SIM,1829,67,na,1896,1590
SIM,1940,3,na,1943,4380
STAT,1908,18,50-100,1926,0.0719233184543838
STAT,1877,49,30-34,1926,0.09621197973456685
STAT,1893,34,15-19,1927,0.17656006713694894
STAT,1840,50,35-39,1890,0.0034385702714647254
SIM,1845,41,na,1886,2370
STAT,1817,49,30-34,1866,0.06604056726342146
STAT,1837,35,40-44,1872,4.363168174363851
STAT,1872,44,25-29,1916,0.6343504069348298
STAT,1864,99,na,1963,5.516622479210027
STAT,1831,36,35-39,1867,7.275155004850516
STAT,1810,79,na,1889,21.174546101003305
SIM,1830,44,na,1874,455
SIM,1866,35,na,1901,3155
STAT,1843,39,30-34,1882,5.479179980039608
SIM,1834,58,na,1892,690
STAT,1840,45,na,1885,916.5308121120652
SIM,1899,30,na,1929,1934
STAT,1836,33,30-34,1869,16.736528033906684
STAT,1853,35,25-29,1888,2.279344991603624
STAT,1869,42,25-29,1911,0.647191248224407
SIM,1895,30,25-29,1925,29
STAT,1859,46,30-34,1905,0.07694079623185056
STAT,1894,29,35-39,1923,12.182445226343402
STAT,1873,41,35-39,1914,1.865900607104618
STAT,1927,18,30-34,1945,14.992484099232222
STAT,1879,65,na,1944,1733.6308817158902
STAT,1822,51,30-34,1873,0.009784449693125252
STAT,1871,16,35-39,1887,0.5541603754448878
STAT,1875,51,na,1926,2221.563756704941
STAT,1851,17,na,1868,2204.182854025683
STAT,1833,49,15-19,1882,1.7813367093926232E-4
STAT,1826,43,15-19,1869,0.02038862788584826
SIM,1888,14,na,1902,639
SIM,1901,41,na,1942,3489
STAT,1917,21,45-49,1938,1.1834475534033329
STAT,1833,42,45-49,1875,0.7790883228892355
SIM,1961,6,na,1967,4644
STAT,1865,50,40-44,1915,0.009749773411533963
STAT,1862,33,na,1895,2023.9417890843872
STAT,1948,22,35-39,1970,10.700714299115244
SIM,1831,29,na,1860,1804
SIM,1885,34,30-34,1919,1
STAT,1863,25,40-44,1888,2.59447260938406
STAT,1906,20,na,1926,3445.193279479823
STAT,1805,105,na,1910,0.003933747392761006
STAT,1880,47,35-39,1927,0.14466403340440004
STAT,1854,21,30-34,1875,11.720942864311377
STAT,1877,34,30-34,1911,17.571971033234885
STAT,1903,20,50-100,1923,0.5823168853182318
STAT,1868,93,na,1961,58.64972904272819
STAT,1827,38,35-39,1865,6.889318745674081
STAT,1851,19,15-19,1870,5.631680057256164
STAT,1797,96,na,1893,0.08583614264333583
SIM,1851,39,30-34,1890,5
STAT,1933,30,na,1963,5067.937281968257
SIM,1875,26,15-19,1901,1
STAT,1863,18,na,1881,2225.7400294126605
STAT,1843,46,20-24,1889,0.011953428646517559
STAT,1859,53,20-24,1912,5.754787514409942E-4
STAT,1911,33,50-100,1944,0.7926734511488227
STAT,1880,29,35-39,1909,9.945484090263385
SIM,1853,17,na,1870,3603
STAT,1947,22,40-44,1969,3.7600582670309324
STAT,1880,21,25-29,1901,59.6092103049635
STAT,1836,40,20-24,1876,0.14852883586290777
SIM,1847,76,na,1923,1382
STAT,1902,20,45-49,1922,0.9877994623441273
STAT,1821,41,50-100,1862,1.212350562520956
STAT,1900,36,25-29,1936,0.8650283028242837
STAT,1872,37,35-39,1909,7.082537766160726
SIM,1821,38,35-39,1859,1
STAT,1806,50,35-39,1856,0.023806703702545475
SIM,1858,48,na,1906,2325
STAT,1808,53,na,1861,717.8577723726324
STAT,1811,96,na,1907,5.202062155655877
STAT,1937,32,25-29,1969,9.049691579959406
STAT,1848,42,40-44,1890,2.1022237232533065
STAT,1895,47,30-34,1942,0.07070072582122609
SIM,1912,13,na,1925,4823
STAT,1835,19,50-100,1854,0.049576866625067224
STAT,1920,48,45-49,1968,0.2364999382554516
SIM,1939,24,na,1963,4711
STAT,1870,30,50-100,1900,0.9207778736469804
STAT,1852,6,na,1858,3037.196299500082
SIM,1934,32,50-100,1966,16
STAT,1869,39,30-34,1908,5.323853405730589
STAT,1915,47,25-29,1962,0.0526967280251581
STAT,1884,47,20-24,1931,0.011433714965223555
STAT,1933,36,50-100,1969,0.5685076960754679
SIM,1840,32,35-39,1872,7
SIM,1849,29,25-29,1878,1
STAT,1885,39,35-39,1924,6.882351581287171
STAT,1836,92,na,1928,31.87583665411958
STAT,1881,46,40-44,1927,0.16213135509901688
SIM,1819,45,40-44,1864,1
SIM,1929,13,na,1942,6274
STAT,1837,101,na,1938,0.45754517625966395
STAT,1829,37,35-39,1866,3.587272455225354
STAT,1904,18,na,1922,3598.8694029021467
STAT,1878,36,40-44,1914,4.52555536667914
SIM,1846,59,na,1905,833
STAT,1891,14,na,1905,3165.5044877960104
STAT,1867,48,30-34,1915,0.0903963830985329
SIM,1822,41,30-34,1863,8
STAT,1844,45,25-29,1889,0.05796357046457602
SIM,1890,17,na,1907,3965
STAT,1828,73,na,1901,804.0256622080929
STAT,1835,33,15-19,1868,0.1357613862054989
SIM,1929,32,40-44,1961,1
STAT,1823,41,25-29,1864,1.1029348420395666
STAT,1895,15,50-100,1910,0.06402829571146673
STAT,1878,22,30-34,1900,18.326510064546262
STAT,1925,23,45-49,1948,1.330376600013226
STAT,1884,21,45-49,1905,0.66954201510162
SIM,1893,39,35-39,1932,40
STAT,1789,77,na,1866,577.485990767077
STAT,1880,19,40-44,1899,0.18886332808701006
STAT,1870,21,15-19,1891,3.2988358533884132
SIM,1854,33,40-44,1887,5
SIM,1822,56,na,1878,1219
STAT,1818,48,35-39,1866,0.24590959903735163
SIM,1899,53,na,1952,1506
STAT,1863,94,na,1957,22.361235116977543
STAT,1876,52,45-49,1928,0.014592616168430305
STAT,1895,40,25-29,1935,0.843793540451197
SIM,1914,48,50-100,1962,7
STAT,1900,15,na,1915,3514.9407596036776
SIM,1873,27,15-19,1900,3
STAT,1858,28,15-19,1886,0.35213971973184416
STAT,1904,29,na,1933,3385.246885192997
STAT,1814,41,30-34,1855,4.259764402261517
STAT,1878,37,30-34,1915,5.483438600580123
STAT,1957,12,na,1969,5133.68095451163
STAT,1872,34,30-34,1906,17.33376914755839
STAT,1930,3,na,1933,5207.038406317979
SIM,1857,22,na,1879,1470
STAT,1869,31,20-24,1900,2.738754337897401
STAT,1881,32,30-34,1913,16.4880451110616
STAT,1945,3,na,1948,4332.1465209580865
STAT,1900,29,35-39,1929,13.270986901787
STAT,1893,38,30-34,1931,6.631727943836239
STAT,1867,26,15-19,1893,0.4305526215346622
STAT,1821,42,na,1863,1390.4435310883002
SIM,1898,29,20-24,1927,10
STAT,1892,20,40-44,1912,2.5953443231879816
STAT,1904,30,20-24,1934,3.892891128736425
STAT,1880,73,na,1953,1233.0707103344173
STAT,1876,36,na,1912,2393.1393813293535
STAT,1873,33,35-39,1906,10.344300020198283
STAT,1853,41,30-34,1894,0.8954733079389167
STAT,1843,20,45-49,1863,0.8773708841704689
STAT,1872,41,20-24,1913,0.15974852134225828
STAT,1897,38,15-19,1935,0.07420627685256025
SIM,1845,35,40-44,1880,1
STAT,1809,93,na,1902,28.447298620113006
STAT,1850,46,50-100,1896,0.11373065163200277
SIM,1867,21,na,1888,2413
STAT,1869,50,25-29,1919,0.0036255435191823613
STAT,1823,34,35-39,1857,20.662843128456043
STAT,1869,98,na,1967,15.817526297781011
STAT,1873,47,45-49,1920,0.24095538322498297
STAT,1860,39,30-34,1899,4.304068865588566
SIM,1845,21,30-34,1866,21
SIM,1857,28,20-24,1885,2
STAT,1922,21,25-29,1943,105.06119037228055
STAT,1806,74,na,1880,412.370064007363
STAT,1852,44,20-24,1896,0.15770148052953883
SIM,1930,21,25-29,1951,1515
STAT,1803,108,na,1911,4.620551249957765E-4
STAT,1826,104,na,1930,0.05317567975947255
STAT,1855,27,35-39,1882,6.65635327343472
STAT,1847,39,15-19,1886,0.05159376209239417
STAT,1890,25,35-39,1915,11.760311064128617
STAT,1890,32,25-29,1922,12.399771239176138
STAT,1890,72,na,1962,1738.0588891868908
STAT,1825,45,na,1870,1628.5096310457498
SIM,1814,42,35-39,1856,10
STAT,1837,36,30-34,1873,5.25725120989107
STAT,1944,18,30-34,1962,12.965266159783702
STAT,1859,49,35-39,1908,0.10864614456797209
STAT,1879,53,25-29,1932,0.0035751975972764575
STAT,1849,28,20-24,1877,11.633401428142271
STAT,1872,53,35-39,1925,0.00848234839551178
SIM,1956,15,na,1971,4927
STAT,1880,15,50-100,1895,0.051097445261355665
SIM,1912,30,20-24,1942,5
SIM,1886,12,na,1898,3155
STAT,1840,45,40-44,1885,0.0697427465418579
STAT,1914,28,na,1942,3710.871053092648
STAT,1899,29,15-19,1928,0.6152683660586139
STAT,1779,78,na,1857,462.7895022539582
STAT,1840,22,na,1862,1070.6432996917147
STAT,1886,67,na,1953,1641.5724844445192
STAT,1948,8,na,1956,4451.663977493211
STAT,1840,31,30-34,1871,8.460913398848362
STAT,1867,19,25-29,1886,5.4143564561289645
STAT,1942,29,40-44,1971,4.831354640103455
STAT,1805,50,20-24,1855,9.005098263804589E-4
STAT,1847,50,25-29,1897,0.0032484136573789676
STAT,1931,28,na,1959,4800.148337585005
STAT,1882,53,na,1935,2028.3658095724174
SIM,1790,82,na,1872,969
STAT,1857,40,40-44,1897,1.7434235484349485
STAT,1885,46,25-29,1931,0.056778631287067234
STAT,1932,39,25-29,1971,1.3109206105750615
STAT,1936,23,20-24,1959,105.21766899931465
SIM,1820,45,na,1865,514
STAT,1819,37,na,1856,702.0590021035608
STAT,1837,54,30-34,1891,0.004641701170819878
STAT,1841,44,45-49,1885,1.6880010754562924
SIM,1870,31,30-34,1901,1
STAT,1925,41,45-49,1966,0.19993948211595497
STAT,1823,74,na,1897,876.7074309994875
SIM,1831,34,35-39,1865,70
SIM,1873,69,na,1942,609
STAT,1831,33,30-34,1864,18.29848817005965
SIM,1925,31,na,1956,4750
STAT,1848,18,na,1866,2647.1007399977384
STAT,1936,19,35-39,1955,3.956168489572818
STAT,1860,43,15-19,1903,0.01118456812882714
SIM,1924,39,40-44,1963,5
STAT,1831,52,35-39,1883,0.007141371599718756
STAT,1827,51,30-34,1878,0.005373214311944976
STAT,1863,73,na,1936,1013.9990484264165
SIM,1895,71,na,1966,4126
STAT,1868,32,15-19,1900,0.13754742212535837
SIM,1851,37,na,1888,1183
STAT,1864,42,25-29,1906,0.5830701696580478
SIM,1897,2,na,1899,3185
STAT,1847,54,40-44,1901,0.009256481470072842
STAT,1899,47,15-19,1946,3.067481273608164E-4
STAT,1815,55,na,1870,186.89277797824252
STAT,1881,17,35-39,1898,0.5181722532351111
SIM,1834,29,30-34,1863,12
STAT,1898,41,40-44,1939,0.210987505387663
STAT,1859,68,na,1927,1211.238094052569
STAT,1843,17,15-19,1860,7.493279466486095
STAT,1911,47,40-44,1958,0.14757809447423226
SIM,1942,12,na,1954,3646
STAT,1866,47,na,1913,2044.122324399929
STAT,1871,20,20-24,1891,69.15338043438153
STAT,1920,35,na,1955,4073.251028334689
STAT,1855,54,na,1909,1385.8571135234145
STAT,1843,74,na,1917,1096.520758715571
STAT,1835,51,45-49,1886,0.011414128658885752
STAT,1906,21,40-44,1927,3.026614062877709
STAT,1826,29,30-34,1855,79.51776731868225
STAT,1868,46,25-29,1914,0.05579211664696415
SIM,1881,33,35-39,1914,3
STAT,1925,22,50-100,1947,0.7804095067233677
SIM,1891,4,na,1895,2810
STAT,1894,42,30-34,1936,0.10139827534527332
STAT,1861,23,15-19,1884,2.7983797699097903
STAT,1893,49,na,1942,2755.2571636877938
STAT,1896,43,30-34,1939,0.10448096638839809
STAT,1882,30,25-29,1912,9.885199499066584
SIM,1843,18,na,1861,680
STAT,1851,92,na,1943,32.89439773732326
SIM,1840,28,15-19,1868,9
STAT,1916,39,40-44,1955,1.4968714156268772
SIM,1918,5,na,1923,4531
STAT,1852,15,15-19,1867,7.310767062243899
STAT,1877,44,25-29,1921,0.6430676952421348
STAT,1877,42,30-34,1919,1.1656147850034981
SIM,1928,22,25-29,1950,622
STAT,1871,28,30-34,1899,25.031621095206617
STAT,1831,26,50-100,1857,0.8013052125523783
STAT,1832,28,15-19,1860,0.5435260434661281
STAT,1859,57,na,1916,1592.8186947543911
SIM,1848,40,40-44,1888,2
STAT,1877,16,30-34,1893,1.621943065677214
STAT,1914,48,20-24,1962,0.01077758867116514
STAT,1829,52,30-34,1881,0.0024211023153491414
STAT,1819,92,na,1911,9.68733562495878
STAT,1867,87,na,1954,166.61946369315453
STAT,1826,47,30-34,1873,0.13852971850685128
STAT,1807,59,na,1866,1160.2769297252655
STAT,1872,26,45-49,1898,1.1156281311222591
STAT,1888,44,35-39,1932,2.0617647905989314
STAT,1868,27,50-100,1895,0.617860236161516
SIM,1828,41,na,1869,1751
STAT,1857,36,20-24,1893,0.5943667157481912
STAT,1828,96,na,1924,5.812567927053786
SIM,1819,46,30-34,1865,2
STAT,1846,33,40-44,1879,3.0039334724294164
SIM,1918,33,20-24,1951,15
STAT,1883,48,15-19,1931,3.7998171597570515E-4
STAT,1913,5,na,1918,4046.1018746495633
STAT,1921,30,20-24,1951,2.7037904196900415
SIM,1845,24,35-39,1869,3
STAT,1843,35,15-19,1878,0.06613095383907232
STAT,1795,84,na,1879,134.1629616910817
SIM,1820,34,25-29,1854,11
STAT,1836,43,25-29,1879,0.5779279590325714
STAT,1776,81,na,1857,368.2514668027635
STAT,1799,98,na,1897,0.21602382538104872
STAT,1814,60,na,1874,1644.0018590393174
STAT,1899,9,na,1908,3543.924481008989
STAT,1876,45,20-24,1921,0.0122518366830089
SIM,1875,48,30-34,1923,1
STAT,1906,49,25-29,1955,0.046067212957190996
STAT,1846,39,na,1885,1427.191536206509
STAT,1884,18,15-19,1902,5.666097475350795
STAT,1837,24,35-39,1861,6.037602974599158
STAT,1843,73,na,1916,1173.5527620141818
STAT,1847,87,na,1934,159.28803391354896
STAT,1833,50,45-49,1883,0.006669320661428786
STAT,1822,43,30-34,1865,2.0043917306997447
STAT,1893,45,20-24,1938,0.008549212958972534
STAT,1856,37,15-19,1893,0.04033321361044143
SIM,1782,86,na,1868,514
SIM,1898,13,na,1911,4434
STAT,1887,34,40-44,1921,4.732440424305299
SIM,1876,8,na,1884,4087
STAT,1826,54,20-24,1880,9.798275192193441E-4
SIM,1937,12,na,1949,2988
SIM,1864,55,na,1919,2415
STAT,1863,29,35-39,1892,8.178534547245958
STAT,1831,40,20-24,1871,0.15943960330421197
STAT,1815,78,na,1893,55.08832817425506
SIM,1878,16,na,1894,4356
STAT,1875,18,20-24,1893,18.156885900948154
SIM,1860,41,na,1901,1968
STAT,1896,25,30-34,1921,33.420710366476534
STAT,1907,20,45-49,1927,1.023530463573258
SIM,1894,9,na,1903,1764
STAT,1832,46,45-49,1878,0.02160470189837404
STAT,1868,52,30-34,1920,0.005718787109819298
STAT,1877,37,35-39,1914,7.179866502739188
SIM,1830,25,30-34,1855,101
STAT,1863,21,25-29,1884,50.205711436068135
SIM,1904,31,25-29,1935,38
STAT,1856,19,15-19,1875,4.9809443142477905
STAT,1832,32,35-39,1864,0.6617758200635397
STAT,1930,20,20-24,1950,142.291556651382
SIM,1871,21,25-29,1892,9
SIM,1872,42,25-29,1914,6
STAT,1814,44,35-39,1858,6.161431305116842
STAT,1782,108,na,1890,0.016114081394856965
STAT,1856,91,na,1947,41.621225392321534
STAT,1824,44,45-49,1868,0.2570665314613933
SIM,1887,72,na,1959,2002
STAT,1777,96,na,1873,3.9623852814253313
SIM,1932,13,na,1945,6513
STAT,1859,108,na,1967,0.014128203930575359
STAT,1868,50,45-49,1918,0.014218549675331236
SIM,1904,39,50-100,1943,1
STAT,1884,24,na,1908,2249.8227421725287
STAT,1843,43,50-100,1886,1.0610511294499012
SIM,1853,30,20-24,1883,8
STAT,1908,23,45-49,1931,1.0232317827541115
STAT,1855,42,30-34,1897,0.7599555840605582
STAT,1838,49,15-19,1887,1.71224947186461E-4
SIM,1891,57,na,1948,1305
STAT,1934,31,45-49,1965,2.1351563930866515
STAT,1806,53,40-44,1859,0.027240616092297217
STAT,1895,36,40-44,1931,5.721981223111925
STAT,1898,37,20-24,1935,1.0365734446780954
STAT,1817,45,15-19,1862,2.8775327581791513E-4
STAT,1900,41,20-24,1941,0.015346473408054465
SIM,1802,57,na,1859,935
STAT,1871,49,35-39,1920,0.13674019523742495
STAT,1938,32,40-44,1970,3.892730944562057
STAT,1834,30,45-49,1864,1.0050845842872433
STAT,1814,93,na,1907,19.77929486901501
STAT,1882,23,35-39,1905,5.569684816283348
STAT,1877,86,na,1963,404.4693558517141
STAT,1901,28,40-44,1929,4.173699621857616
STAT,1937,12,na,1949,3814.790298597604
STAT,1888,19,45-49,1907,0.07498854766078257
STAT,1825,33,50-100,1858,1.501960224851297
STAT,1809,54,20-24,1863,0.005849998776746862
STAT,1891,35,45-49,1926,2.474729610452702
STAT,1881,35,35-39,1916,6.742731683246642
STAT,1850,105,na,1955,0.013539161707449331
SIM,1861,36,na,1897,2232
STAT,1894,18,50-100,1912,0.06213771234838607
STAT,1936,26,25-29,1962,62.39406776035643
STAT,1852,19,30-34,1871,1.9176335160050832
STAT,1859,53,50-100,1912,0.011778131313165309
STAT,1884,36,15-19,1920,0.054013938736168644
STAT,1907,46,na,1953,3292.6679944519274
STAT,1835,102,na,1937,0.22183235589745648
STAT,1923,49,25-29,1972,0.06104115256893897
STAT,1816,39,15-19,1855,0.19666840525000234
SIM,1851,81,na,1932,438
SIM,1921,31,25-29,1952,16
STAT,1882,50,40-44,1932,0.01022412312382029
STAT,1860,21,na,1881,2003.3072700972823
STAT,1875,20,na,1895,2443.045566302271
SIM,1822,44,35-39,1866,2
SIM,1832,44,45-49,1876,3
STAT,1872,50,30-34,1922,0.006046299479581611
STAT,1827,31,15-19,1858,0.14889306716910028
STAT,1837,31,25-29,1868,10.404619795658899
STAT,1848,73,na,1921,1111.468713669711
SIM,1832,23,na,1855,2411
STAT,1880,21,na,1901,2462.698462604961
STAT,1949,21,40-44,1970,3.886043976876364
SIM,1844,36,35-39,1880,22
STAT,1874,51,45-49,1925,0.01504943950163094
STAT,1839,37,15-19,1876,0.06234535494828368
STAT,1864,51,35-39,1915,0.007863995726551012
STAT,1864,35,na,1899,2162.1745873952436
STAT,1847,25,35-39,1872,10.637723331894877
STAT,1894,22,15-19,1916,4.195232070614684
SIM,1909,24,15-19,1933,13
STAT,1845,30,20-24,1875,1.6282825547429256
STAT,1837,39,35-39,1876,6.762946902786044
SIM,1853,38,30-34,1891,1
STAT,1827,39,25-29,1866,2.770268226926036
STAT,1913,31,25-29,1944,9.117473065005758
STAT,1869,17,35-39,1886,0.5613597226791803
SIM,1902,47,na,1949,3205
SIM,1934,24,na,1958,5205
STAT,1850,34,45-49,1884,0.8250384294376606
SIM,1878,34,40-44,1912,7
STAT,1840,34,35-39,1874,4.7570191268881175
SIM,1853,4,na,1857,3646
SIM,1868,34,30-34,1902,1
STAT,1858,28,na,1886,1852.2920877875556
STAT,1855,24,30-34,1879,13.575205672297963
STAT,1860,20,45-49,1880,0.6537755724228239
STAT,1842,25,20-24,1867,3.653733998598721
STAT,1890,22,30-34,1912,21.563679411860587
SIM,1874,54,na,1928,2445
SIM,1845,31,25-29,1876,16
SIM,1878,68,na,1946,1639
STAT,1908,41,45-49,1949,0.15366874975513778
STAT,1903,17,30-34,1920,2.262515551006527
STAT,1932,13,na,1945,5202.0643911308225
STAT,1936,27,na,1963,3549.551781675054
STAT,1854,69,na,1923,815.9800672209748
STAT,1847,43,35-39,1890,1.6253607663942131
STAT,1846,36,45-49,1882,1.2458142979139561
STAT,1948,18,15-19,1966,51.38952353374642
STAT,1888,26,35-39,1914,11.174660311455733
STAT,1836,36,35-39,1872,6.721965670607632
SIM,1878,30,25-29,1908,116
SIM,1850,25,20-24,1875,40
STAT,1798,58,na,1856,1525.3681441827
STAT,1865,21,na,1886,2201.321474082929
STAT,1837,25,na,1862,2258.6389190556743
SIM,1855,43,35-39,1898,8
SIM,1938,27,na,1965,4231
STAT,1852,47,25-29,1899,0.05770916091270049
STAT,1873,44,40-44,1917,2.276117629048003
STAT,1840,41,25-29,1881,0.26716277607158984
STAT,1828,45,40-44,1873,0.20988339694571997
SIM,1858,17,na,1875,2443
STAT,1902,7,na,1909,3668.759479174609
STAT,1823,31,30-34,1854,75.94698844497857
STAT,1831,41,na,1872,2031.50668138269
STAT,1835,55,na,1890,1564.5460518292532
STAT,1849,38,15-19,1887,0.04791600554349793
STAT,1863,54,25-29,1917,0.002940705798717872
STAT,1870,28,35-39,1898,9.585476388944123
STAT,1924,25,50-100,1949,1.155574708755919
STAT,1847,36,50-100,1883,1.1637195235632052
STAT,1878,25,35-39,1903,9.994836918248895
STAT,1871,8,na,1879,2709.2705054774697
STAT,1886,46,na,1932,2336.437638758042
STAT,1862,33,25-29,1895,8.68723082679896
STAT,1858,4,na,1862,2377.7114975099394
SIM,1855,40,na,1895,2994
STAT,1873,29,15-19,1902,0.462072528143797
STAT,1883,39,na,1922,2243.7399686129443
STAT,1854,58,na,1912,1099.5791614408363
STAT,1929,20,50-100,1949,0.8311876551396686
SIM,1881,36,na,1917,2984
STAT,1936,17,50-100,1953,0.3551337736065874
SIM,1937,7,na,1944,2988
STAT,1850,16,15-19,1866,3.3685020587744714
STAT,1902,47,na,1949,3153.9530300656206
STAT,1921,36,45-49,1957,0.7528546513469604
STAT,1879,50,20-24,1929,7.678653304680657E-4
STAT,1899,19,20-24,1918,24.084962073578513
STAT,1921,15,25-29,1936,49.037549498760995
STAT,1896,46,35-39,1942,0.1043982689903069
SIM,1929,3,na,1932,6340
STAT,1878,32,25-29,1910,10.53830044829187
SIM,1837,31,50-100,1868,18
STAT,1872,23,40-44,1895,2.0801942470319057
STAT,1900,36,na,1936,3305.286148315656
STAT,1891,17,15-19,1908,7.2978876990213974
STAT,1901,24,25-29,1925,79.54060874659443
SIM,1886,32,25-29,1918,89
SIM,1847,55,na,1902,1382
SIM,1860,37,30-34,1897,17
STAT,1861,41,45-49,1902,1.2503021013200126
STAT,1847,18,45-49,1865,0.07327751720221501
STAT,1936,16,30-34,1952,11.582063840058892
STAT,1845,23,30-34,1868,10.893963257012906
STAT,1842,29,15-19,1871,0.13728986063238072
STAT,1834,49,30-34,1883,0.04409863867817917
STAT,1914,6,na,1920,4075.023638997751
STAT,1932,36,20-24,1968,0.35204255394090067
STAT,1829,31,50-100,1860,0.5182922058476678
SIM,1832,26,15-19,1858,2
STAT,1852,37,30-34,1889,5.393797733020123
STAT,1840,16,35-39,1856,0.28139205461864325
STAT,1849,41,45-49,1890,1.2667628432189975
SIM,1886,35,na,1921,3045
STAT,1883,26,20-24,1909,11.324894028526199
STAT,1858,46,15-19,1904,3.0633273570653983E-4
SIM,1869,47,45-49,1916,3
STAT,1837,21,30-34,1858,18.831980628649667
STAT,1963,4,na,1967,4948.316751547632
STAT,1820,45,na,1865,1819.2103921297553
STAT,1868,43,20-24,1911,0.15228480340032388
STAT,1906,39,30-34,1945,1.6490128049384867
STAT,1839,52,40-44,1891,0.00972881357380597
SIM,1807,56,na,1863,1094
STAT,1805,89,na,1894,14.0942892188698
STAT,1928,42,25-29,1970,0.09034162146396725
SIM,1876,43,20-24,1919,2
STAT,1845,38,30-34,1883,2.7499817277871976
STAT,1850,49,15-19,1899,1.8084801909258258E-4
STAT,1837,29,40-44,1866,3.038761702539542
STAT,1872,87,na,1959,254.86569511628883
STAT,1831,25,45-49,1856,1.4914037822320962
STAT,1898,44,45-49,1942,0.137869654623389
SIM,1951,16,na,1967,2006
STAT,1836,47,40-44,1883,0.1372897882740825
STAT,1862,26,35-39,1888,8.308338900971075
STAT,1873,0,na,1873,3793.094100547225
STAT,1830,27,30-34,1857,24.213962860233437
STAT,1930,42,45-49,1972,0.2174417352747344
SIM,1939,23,na,1962,4708
SIM,1903,5,na,1908,3100
SIM,1861,29,25-29,1890,169
STAT,1832,26,na,1858,2437.1156117592936
STAT,1906,46,20-24,1952,0.009829824334134415
STAT,1893,48,25-29,1941,0.04012061345688069
STAT,1894,40,45-49,1934,1.9224193888664967
STAT,1886,8,na,1894,2691.960365886972
STAT,1928,23,50-100,1951,0.8127748090799268
STAT,1886,31,20-24,1917,2.8105918614177945
SIM,1884,21,na,1905,3798
SIM,1916,50,na,1966,4520
STAT,1903,48,45-49,1951,0.18659609848361502
STAT,1823,50,35-39,1873,0.013450991240631363
SIM,1893,68,na,1961,1380
SIM,1936,24,25-29,1960,1
SIM,1931,9,na,1940,5309
STAT,1936,9,na,1945,3773.4444582988976
SIM,1837,22,na,1859,2276
STAT,1863,19,40-44,1882,0.1602375231816365
STAT,1832,43,40-44,1875,0.19984084817706102
SIM,1926,20,20-24,1946,428
STAT,1873,15,35-39,1888,0.56954412962406
STAT,1896,28,35-39,1924,12.674721099946359
SIM,1915,10,na,1925,3758
SIM,1919,24,na,1943,5164
STAT,1872,54,na,1926,2096.803930489056
STAT,1884,35,na,1919,2276.730883121628
STAT,1837,66,na,1903,1314.2134258218045
STAT,1928,17,35-39,1945,5.247058865072196
STAT,1822,53,25-29,1875,0.005595286761289417
STAT,1890,41,35-39,1931,2.2021034374744186
SIM,1827,33,30-34,1860,13
STAT,1794,99,na,1893,0.004482337050335435
STAT,1853,29,25-29,1882,34.082868702892014
STAT,1921,19,50-100,1940,0.4197319505653116
SIM,1920,32,na,1952,3743
STAT,1819,40,20-24,1859,0.03563380654954426
STAT,1790,85,na,1875,120.27922880026735
SIM,1872,32,30-34,1904,3
STAT,1849,58,na,1907,1666.307577324966
SIM,1926,28,30-34,1954,4
STAT,1886,24,30-34,1910,18.330039468790734
SIM,1894,39,30-34,1933,12
STAT,1945,16,50-100,1961,0.4048591472825833
STAT,1854,35,40-44,1889,2.4712113922564485
STAT,1822,46,35-39,1868,0.2373789213906431
STAT,1921,33,25-29,1954,10.12078901022814
STAT,1819,48,30-34,1867,0.017634974102882547
STAT,1928,24,25-29,1952,113.73448631600354
STAT,1853,21,15-19,1874,3.0442732353397233
STAT,1876,34,15-19,1910,0.14272852421725227
STAT,1918,20,20-24,1938,119.01478602463501
STAT,1896,20,25-29,1916,75.91305823036998
STAT,1887,37,45-49,1924,2.194177369346903
STAT,1844,38,35-39,1882,7.328052147725706
SIM,1835,74,na,1909,234
STAT,1880,52,30-34,1932,0.0061467682259010534
SIM,1875,7,na,1882,3301
STAT,1842,32,45-49,1874,0.5229469353487984
STAT,1865,45,45-49,1910,0.21761399458525837
STAT,1918,28,30-34,1946,40.99172039114833
STAT,1886,39,30-34,1925,5.463498075192587
STAT,1820,40,45-49,1860,2.562737667722603
STAT,1835,53,30-34,1888,0.0044999103739411335
STAT,1948,21,45-49,1969,1.279123920534377
STAT,1838,37,50-100,1875,0.6324064661166653
STAT,1863,26,30-34,1889,21.65357006779114
SIM,1878,27,30-34,1905,14
STAT,1905,47,15-19,1952,3.2301976448942323E-4
STAT,1851,24,50-100,1875,0.3791109707410926
SIM,1853,45,40-44,1898,1
STAT,1859,34,na,1893,1875.1793467511156
STAT,1909,30,20-24,1939,2.3224520290174078
STAT,1930,31,25-29,1961,11.851080807688456
STAT,1802,53,20-24,1855,0.003670842081964707
SIM,1886,56,na,1942,2700
STAT,1840,18,50-100,1858,0.02482919346193121
SIM,1880,41,na,1921,3256
STAT,1820,44,25-29,1864,1.023216969010121
STAT,1927,21,25-29,1948,113.21790903311377
STAT,1944,15,na,1959,3918.5640675531813
STAT,1862,30,50-100,1892,0.7866769235415246
STAT,1902,46,35-39,1948,0.11152049651119296
SIM,1852,22,na,1874,2400
STAT,1877,48,40-44,1925,0.1716049435840394
STAT,1907,42,20-24,1949,0.01607155083576888
STAT,1912,40,20-24,1952,0.01702584150205476
STAT,1860,46,20-24,1906,0.009817300624597972
SIM,1825,44,na,1869,394
STAT,1836,61,na,1897,1430.1359077681695
STAT,1897,16,35-39,1913,0.7305039765914526
STAT,1880,29,50-100,1909,0.6593530578471201
SIM,1795,60,na,1855,12
STAT,1899,27,50-100,1926,0.8737349110504699
SIM,1896,1,na,1897,4216
STAT,1876,91,na,1967,177.05184756780275
STAT,1837,46,45-49,1883,0.19896606391849006
STAT,1865,31,35-39,1896,9.283705495562106
SIM,1859,54,na,1913,1659
STAT,1834,32,50-100,1866,0.5172411906313942
STAT,1854,43,40-44,1897,1.2416028084235495
STAT,1913,34,45-49,1947,1.532713007771185
STAT,1845,45,40-44,1890,0.08579929077317541
STAT,1863,18,30-34,1881,1.404628766926087
STAT,1904,50,na,1954,3120.514046964051
SIM,1903,63,na,1966,1711
SIM,1943,28,na,1971,4488
STAT,1879,25,30-34,1904,26.00785290453614
STAT,1924,20,45-49,1944,1.322779280323807
STAT,1876,16,na,1892,2559.4261171592743
SIM,1838,72,na,1910,713
STAT,1864,39,15-19,1903,0.050536657384257264
STAT,1811,51,20-24,1862,0.0033868154326066498
STAT,1911,44,35-39,1955,0.18769386157172116
STAT,1922,32,45-49,1954,1.7581135629285711
SIM,1878,37,na,1915,4011
STAT,1828,42,na,1870,1789.6642329928222
STAT,1882,20,30-34,1902,17.15541447773852
STAT,1873,37,15-19,1910,0.057602205250734666
STAT,1840,76,na,1916,373.04454153181985
STAT,1870,11,na,1881,2652.246843485025
STAT,1915,22,45-49,1937,1.1466484589375514
STAT,1875,50,35-39,1925,0.008967269420796951
SIM,1837,55,na,1892,1649
STAT,1833,21,50-100,1854,0.45428106537409596
SIM,1886,66,na,1952,2499
STAT,1899,64,na,1963,2562.6246830666255
SIM,1812,42,50-100,1854,1
STAT,1929,42,40-44,1971,0.32164956298157943
STAT,1874,43,50-100,1917,1.0824523235448167
SIM,1860,45,30-34,1905,1
STAT,1901,40,45-49,1941,0.1467824676482266
STAT,1944,25,na,1969,4006.7801542400157
STAT,1822,32,40-44,1854,12.139927810822446
SIM,1850,11,na,1861,2356
STAT,1855,102,na,1957,0.2789550844166591
STAT,1821,36,40-44,1857,5.550571584808875
STAT,1845,50,50-100,1895,0.0076019366189138795
STAT,1889,64,na,1953,2093.37468648579
STAT,1929,34,50-100,1963,1.0415060573440658
SIM,1878,47,na,1925,3845
SIM,1838,62,na,1900,1518
STAT,1807,104,na,1911,0.027043734850910117
STAT,1894,3,na,1897,3361.809394592407
STAT,1886,46,40-44,1932,0.17778952534640474
STAT,1811,46,25-29,1857,0.27510619274066567
STAT,1954,18,40-44,1972,1.7133052714641266
STAT,1925,36,50-100,1961,0.4997627323774844
STAT,1827,54,35-39,1881,0.006663763098003287
STAT,1870,36,35-39,1906,7.085167706295492
STAT,1891,35,50-100,1926,1.5241292365425256
STAT,1823,38,15-19,1861,0.10283404115056793
STAT,1923,43,15-19,1966,0.0017732111539816616
STAT,1882,53,45-49,1935,0.013671245655730932
SIM,1867,5,na,1872,2999
STAT,1810,56,na,1866,78.09568685056698
SIM,1859,0,na,1859,3746
STAT,1865,7,na,1872,2558.9565827326396
SIM,1941,27,na,1968,3821
SIM,1860,7,na,1867,2608
SIM,1870,41,25-29,1911,2
SIM,1912,36,na,1948,4578
STAT,1862,41,25-29,1903,0.5494263155686541
SIM,1838,25,35-39,1863,73
SIM,1899,19,15-19,1918,24
SIM,1848,17,na,1865,2559
STAT,1842,46,50-100,1888,0.06176530138665495
STAT,1847,40,30-34,1887,1.0723602116592954
STAT,1863,36,45-49,1899,1.71005527655882
SIM,1896,66,na,1962,1991
STAT,1904,41,40-44,1945,0.22416392239199068
STAT,1894,45,35-39,1939,0.10142617863181694
STAT,1870,45,50-100,1915,0.24728779413853322
SIM,1829,26,na,1855,2121
SIM,1846,36,na,1882,1135
STAT,1864,17,35-39,1881,0.5160335972190889
STAT,1822,57,na,1879,1260.2081180127961
STAT,1868,17,na,1885,2483.5769116798283
STAT,1873,49,na,1922,2259.654867592954
SIM,1895,39,na,1934,4479
STAT,1885,47,35-39,1932,0.136971352033321
SIM,1828,72,na,1900,713
STAT,1844,53,25-29,1897,0.003452691545906918
STAT,1899,39,50-100,1938,0.3583085235084422
STAT,1792,97,na,1889,1.2845813628425864
STAT,1870,40,20-24,1910,0.15992353948819313
SIM,1835,20,na,1855,987
SIM,1840,21,na,1861,2831
SIM,1896,56,na,1952,2543
STAT,1881,68,na,1949,1443.1499383173036
STAT,1946,16,40-44,1962,1.535040641020922
STAT,1878,44,40-44,1922,2.2829732064384025
STAT,1852,52,20-24,1904,7.38826542642151E-4
STAT,1866,91,na,1957,67.45099611347372
STAT,1810,48,30-34,1858,5.015996372007753E-4
STAT,1839,41,35-39,1880,1.9736292423399449
STAT,1929,6,na,1935,5079.2746372760585
STAT,1898,16,50-100,1914,0.06604200499126697
STAT,1934,8,na,1942,5358.203411323886
STAT,1840,86,na,1926,87.36476669460336
STAT,1830,34,40-44,1864,3.98977521217302
SIM,1886,44,40-44,1930,10
STAT,1808,104,na,1912,0.015621398684074684
STAT,1895,44,40-44,1939,0.2004462349024268
SIM,1848,72,na,1920,1928
STAT,1828,53,40-44,1881,0.010827884208538302
STAT,1839,48,50-100,1887,0.2295249900417886
SIM,1868,37,na,1905,1174
STAT,1840,38,15-19,1878,0.025881890743041428
STAT,1913,33,na,1946,3699.9746096242043
STAT,1845,44,na,1889,1138.3404716555517
STAT,1858,18,20-24,1876,15.72178796611541
STAT,1826,61,na,1887,1549.909525030047
STAT,1838,42,na,1880,1048.5935404815511
STAT,1890,29,15-19,1919,0.5453299595453206
STAT,1829,29,35-39,1858,5.886783633474412
STAT,1853,44,35-39,1897,1.3851320340739481
STAT,1838,17,40-44,1855,0.10313199304677377
STAT,1820,37,35-39,1857,13.159508561066176
STAT,1943,22,20-24,1965,116.95296137404024
STAT,1880,40,50-100,1920,1.107826937190069
STAT,1861,45,25-29,1906,0.04838020260867262
STAT,1859,16,15-19,1875,5.492338110325701
SIM,1926,26,na,1952,5700
STAT,1923,21,40-44,1944,3.882775006989256
SIM,1888,37,na,1925,327
STAT,1855,22,50-100,1877,0.3152991507301803
STAT,1869,35,15-19,1904,0.0572027010507186
STAT,1889,47,20-24,1936,0.008113396416582338
SIM,1850,41,na,1891,1319
SIM,1862,22,na,1884,3810
SIM,1855,5,na,1860,3430
SIM,1877,28,25-29,1905,17
STAT,1895,25,15-19,1920,0.5942133201471604
STAT,1937,18,40-44,1955,1.3431245927053836
STAT,1869,46,40-44,1915,0.17324530126887916
SIM,1924,6,na,1930,5320
STAT,1792,87,na,1879,75.2105970695091
STAT,1904,41,25-29,1945,0.06399768178361445
STAT,1818,42,na,1860,1805.1245529116795
SIM,1879,64,na,1943,798
STAT,1922,8,na,1930,4564.351234818494
SIM,1910,11,na,1921,4577
STAT,1854,80,na,1934,343.95047363708323
STAT,1933,32,20-24,1965,3.2647759840610027
STAT,1903,42,35-39,1945,0.17827898152782654
STAT,1863,37,50-100,1900,1.048139093029292
STAT,1914,31,40-44,1945,3.9002548673277957
STAT,1855,19,35-39,1874,0.42686426991200194
STAT,1900,6,na,1906,3618.86048679415
SIM,1903,53,na,1956,2235
STAT,1914,45,15-19,1959,3.619497065710032E-4
STAT,1838,24,30-34,1862,9.723892277978553
STAT,1890,47,45-49,1937,0.16040912454768325
STAT,1938,17,45-49,1955,0.4874915965369418
STAT,1911,47,50-100,1958,0.21171249986215637
STAT,1869,34,na,1903,2387.3670583778917
STAT,1908,32,na,1940,3542.3430633231496
SIM,1875,19,na,1894,3100
STAT,1811,47,35-39,1858,0.6580190490358176
SIM,1821,34,40-44,1855,51
STAT,1908,16,20-24,1924,26.159115538103542
STAT,1930,34,45-49,1964,2.0138975737943845
STAT,1892,20,na,1912,2945.6231118028836
STAT,1828,34,15-19,1862,0.20187110531260696
STAT,1835,75,na,1910,778.947748973438
STAT,1884,48,30-34,1932,0.09149964217874697
STAT,1848,46,20-24,1894,0.011261177125016774
STAT,1918,28,50-100,1946,1.041307121358606
STAT,1905,14,na,1919,3702.4507386661753
STAT,1916,51,na,1967,3669.386596948888
SIM,1922,31,40-44,1953,3
STAT,1886,20,15-19,1906,3.436688281830593
STAT,1928,28,40-44,1956,5.695961117784623
SIM,1912,41,25-29,1953,1
SIM,1845,43,40-44,1888,1
SIM,1894,31,na,1925,1587
STAT,1877,53,na,1930,2150.6301879829093
STAT,1880,25,40-44,1905,3.130956298138247
STAT,1889,34,na,1923,2849.0523714806122
STAT,1910,48,35-39,1958,0.1186151064688237
STAT,1837,43,40-44,1880,2.1010851367113506
STAT,1838,19,35-39,1857,0.3057620103990396
STAT,1927,23,na,1950,4448.77436673555
STAT,1860,47,30-34,1907,0.07860052596618058
STAT,1862,77,na,1939,736.2382522480733
STAT,1869,23,50-100,1892,0.41022239761585644
SIM,1828,62,na,1890,1168
STAT,1832,22,50-100,1854,0.6271326883349437
STAT,1858,50,35-39,1908,0.006668908490582973
STAT,1904,19,40-44,1923,0.2599114884856102
STAT,1794,78,na,1872,3.8720119395358283
STAT,1824,38,na,1862,557.4488643558179
STAT,1870,35,25-29,1905,2.897627283645116
STAT,1907,45,50-100,1952,0.2041568711449427
SIM,1895,27,30-34,1922,3
STAT,1854,90,na,1944,43.83674909461479
SIM,1875,40,na,1915,2923
SIM,1890,27,15-19,1917,3
STAT,1824,30,35-39,1854,5.161327720650386
STAT,1883,49,na,1932,2119.2520686480107
STAT,1826,71,na,1897,1064.151219976959
STAT,1877,52,25-29,1929,0.0035764282935567666
STAT,1887,0,na,1887,3465.5594006455262
STAT,1835,48,35-39,1883,0.11023339009124375
STAT,1801,65,na,1866,727.5096533267708
STAT,1823,46,15-19,1869,6.330853669341775E-4
STAT,1845,48,45-49,1893,0.11563575847495253
SIM,1832,77,na,1909,167
STAT,1860,76,na,1936,772.8844821897939
STAT,1909,33,25-29,1942,8.693368687487258
STAT,1903,33,na,1936,3401.7929600154434
STAT,1956,1,na,1957,5164.78558340588
SIM,1921,31,40-44,1952,14
STAT,1921,41,40-44,1962,0.27878229640681695
STAT,1874,36,20-24,1910,0.7993964309890211
STAT,1880,18,30-34,1898,1.6503473916182696
STAT,1852,45,30-34,1897,0.09840912370392407
STAT,1910,30,45-49,1940,1.5123457539887493
STAT,1856,33,50-100,1889,0.6592725503618355
STAT,1905,32,45-49,1937,1.4401943259119738
STAT,1912,43,25-29,1955,0.06766355843732605
SIM,1836,27,25-29,1863,1
STAT,1885,82,na,1967,772.1313064219913
SIM,1846,27,35-39,1873,2
SIM,1936,26,na,1962,2385
STAT,1843,54,20-24,1897,7.090476684649113E-4
STAT,1923,35,15-19,1958,0.022054708833329807
STAT,1895,18,25-29,1913,7.352377249543786
STAT,1933,35,25-29,1968,1.3343096921604851
STAT,1856,16,na,1872,1961.0419754387271
STAT,1824,105,na,1929,0.0056742452783073195
STAT,1913,49,15-19,1962,3.5295409772817467E-4
STAT,1911,43,25-29,1954,0.06698398388764465
SIM,1949,13,na,1962,4479
STAT,1860,11,na,1871,2256.323373630071
STAT,1916,18,20-24,1934,28.297640626408665
STAT,1817,51,50-100,1868,0.010420038853006245
STAT,1932,33,15-19,1965,0.16953481528233003
STAT,1880,33,40-44,1913,4.483182335819347
STAT,1845,85,na,1930,136.03016767679196
STAT,1870,33,30-34,1903,17.332716710291244
STAT,1939,24,na,1963,3624.665921432741
STAT,1880,52,50-100,1932,0.015595519342784138
STAT,1838,27,35-39,1865,5.239486136816498
STAT,1813,42,40-44,1855,11.260936366967787
STAT,1828,27,25-29,1855,88.510506228465
SIM,1931,27,na,1958,4992
SIM,1933,28,na,1961,4371
STAT,1869,54,40-44,1923,0.01033112772692024
STAT,1859,54,30-34,1913,0.004588206360924722
STAT,1931,22,45-49,1953,1.4490679090367207
STAT,1822,35,45-49,1857,4.392380459861815
STAT,1811,43,20-24,1854,0.8144137420380924
STAT,1852,48,35-39,1900,0.1391516164129943
STAT,1903,45,40-44,1948,0.13845036450730402
STAT,1913,31,40-44,1944,3.860336161392018
SIM,1882,0,na,1882,3335
STAT,1788,82,na,1870,66.25971364689889
STAT,1850,20,35-39,1870,3.281149635262567
STAT,1900,46,na,1946,3126.1015572294323
STAT,1873,30,30-34,1903,18.05378404238751
STAT,1876,16,15-19,1892,6.0140193929809795
STAT,1846,61,na,1907,1106.7197173642192
STAT,1893,46,30-34,1939,0.06847676529060798
SIM,1921,27,na,1948,4157
SIM,1891,67,na,1958,675
SIM,1851,47,30-34,1898,1
STAT,1886,36,na,1922,2451.474957924197
SIM,1876,66,na,1942,2726
STAT,1863,33,40-44,1896,3.6866844572198514
STAT,1891,21,35-39,1912,7.197722749442994
STAT,1843,47,30-34,1890,0.09519683924226092
STAT,1909,58,na,1967,3169.7999250524012
STAT,1813,53,50-100,1866,0.05143989046612272
STAT,1830,41,15-19,1871,0.012365672243394311
SIM,1883,38,na,1921,2054
STAT,1854,24,15-19,1878,2.1244180845261824
SIM,1823,73,na,1896,102
STAT,1875,10,na,1885,2708.0194187965144
STAT,1917,32,20-24,1949,2.5200897381831044
SIM,1959,0,na,1959,5273
STAT,1906,43,15-19,1949,0.001378644213325796
STAT,1894,65,na,1959,2248.598068280249
STAT,1940,21,40-44,1961,3.387902957689536
STAT,1836,51,25-29,1887,0.002801163949504116
STAT,1846,18,30-34,1864,1.1788531012943406
STAT,1833,43,na,1876,1034.5005226040284
STAT,1876,49,35-39,1925,0.13857214631302592
STAT,1906,32,45-49,1938,1.449957879116123
SIM,1887,17,30-34,1904,15
STAT,1886,49,45-49,1935,0.23928715053427316
STAT,1915,44,20-24,1959,0.01747050455647867
STAT,1888,44,50-100,1932,1.20285991210989
STAT,1863,40,15-19,1903,0.011908582866989816
STAT,1887,27,30-34,1914,27.717041888728133
SIM,1910,55,na,1965,3678
SIM,1881,30,30-34,1911,31
STAT,1833,35,20-24,1868,0.42789310494944427
STAT,1911,36,35-39,1947,2.3209955140458334
STAT,1854,28,30-34,1882,14.57283232857137
SIM,1931,39,30-34,1970,2
STAT,1853,94,na,1947,15.496978784103877
SIM,1837,45,na,1882,1889
STAT,1878,47,45-49,1925,0.24168113142720696
STAT,1854,17,25-29,1871,3.769109949540576
STAT,1871,42,15-19,1913,0.013758947137363203
STAT,1902,21,20-24,1923,97.33281878727584
STAT,1946,19,45-49,1965,0.5477080140475016
SIM,1838,17,na,1855,2487
STAT,1841,52,45-49,1893,0.016074485972255397
STAT,1904,15,25-29,1919,8.13364723778031
STAT,1785,95,na,1880,1.1492525018886777
STAT,1841,26,15-19,1867,0.6320547945783183
STAT,1864,47,15-19,1911,3.619468360618779E-4
STAT,1915,37,30-34,1952,1.8151602093005355
STAT,1846,26,30-34,1872,18.173042519087296
SIM,1908,62,na,1970,1852
SIM,1916,19,25-29,1935,11
STAT,1872,77,na,1949,865.5673682565356
STAT,1901,21,20-24,1922,96.6453982353399
SIM,1845,19,na,1864,2687
STAT,1900,48,40-44,1948,0.13209754679173447
STAT,1888,41,30-34,1929,1.3329092763809745
STAT,1860,54,20-24,1914,5.854345598030641E-4
STAT,1828,52,na,1880,1561.8273636334916
STAT,1901,47,30-34,1948,0.075991175343574
STAT,1885,44,30-34,1929,1.1148118883211504
SIM,1828,28,30-34,1856,18
SIM,1870,41,na,1911,1871
SIM,1909,31,25-29,1940,15
SIM,1939,13,na,1952,4753
STAT,1818,53,30-34,1871,0.009984630266893743
STAT,1836,71,na,1907,1021.5722727207524
STAT,1919,48,na,1967,3920.8814327613472
STAT,1923,39,30-34,1962,2.0851240341188952
STAT,1921,33,40-44,1954,4.285139919739149
SIM,1845,10,na,1855,3044
STAT,1888,17,na,1905,2914.962921474283
STAT,1882,45,45-49,1927,0.22820143404296725
SIM,1855,74,na,1929,2200
SIM,1886,47,45-49,1933,2
SIM,1815,44,na,1859,2062
SIM,1870,34,35-39,1904,54
SIM,1846,16,30-34,1862,3
SIM,1939,29,20-24,1968,68
STAT,1850,76,na,1926,437.4746837265433
STAT,1804,51,15-19,1855,1.5853797286418566E-4
SIM,1910,21,20-24,1931,2
SIM,1822,46,na,1868,1544
STAT,1862,19,25-29,1881,4.971297528277663
STAT,1854,35,na,1889,1330.0088816501566
STAT,1803,52,25-29,1855,0.007737599570708335
STAT,1877,45,35-39,1922,0.143533692916109
STAT,1910,36,50-100,1946,0.3989658655743538
SIM,1924,18,20-24,1942,4
SIM,1808,96,na,1904,11
STAT,1898,30,35-39,1928,13.727499447493788
STAT,1823,105,na,1928,0.02316265528024496
STAT,1830,37,45-49,1867,1.8183188209086478
SIM,1893,14,na,1907,3526
STAT,1887,19,30-34,1906,1.7449212553630848
STAT,1922,33,40-44,1955,4.353806822962818
STAT,1861,38,35-39,1899,5.852969883873969
STAT,1939,31,45-49,1970,1.5888226960503107
STAT,1866,16,na,1882,2380.347181059894
STAT,1870,43,25-29,1913,0.6355630503407101
SIM,1854,26,30-34,1880,7
STAT,1879,18,40-44,1897,0.18713765609390903
STAT,1906,31,na,1937,3499.184229842414
STAT,1844,80,na,1924,612.8364751365352
STAT,1908,19,25-29,1927,8.296254566763832
STAT,1895,29,30-34,1924,32.52430962490858
STAT,1917,17,50-100,1934,0.07954655974920183
SIM,1836,38,30-34,1874,1
STAT,1838,16,30-34,1854,0.9040464514651277
STAT,1923,46,20-24,1969,0.012823688611321264
SIM,1913,53,na,1966,2906
STAT,1859,16,50-100,1875,0.04534125205491655
STAT,1953,16,50-100,1969,0.44928031025665205
SIM,1872,22,na,1894,2464
SIM,1819,35,50-100,1854,1
STAT,1867,53,na,1920,2003.6201887231998
STAT,1872,16,30-34,1888,1.6107738785275139
SIM,1842,56,na,1898,3011
STAT,1941,27,30-34,1968,40.072390044828325
STAT,1811,44,30-34,1855,5.647870686050825
STAT,1815,54,45-49,1869,0.0013649281740396875
STAT,1913,42,45-49,1955,0.16026349860140718
STAT,1882,3,na,1885,2863.506238637476
STAT,1853,63,na,1916,1383.5293470801148
STAT,1932,22,45-49,1954,1.4660542724978347
SIM,1884,1,na,1885,3913
STAT,1828,38,30-34,1866,7.01007917857018
STAT,1821,40,25-29,1861,0.750722610837278
STAT,1951,4,na,1955,4639.4041867819205
STAT,1935,20,20-24,1955,150.43363809062203
STAT,1873,32,50-100,1905,0.9398660187034534
STAT,1879,34,na,1913,2427.014388349584
STAT,1906,51,na,1957,3168.427042272858
STAT,1879,28,35-39,1907,9.863413385254702
STAT,1924,37,50-100,1961,0.4903281391659489
STAT,1917,40,50-100,1957,0.12129946041379822
SIM,1829,50,30-34,1879,1
STAT,1833,33,50-100,1866,0.5112684109947124
STAT,1836,29,25-29,1865,41.343243055542416
STAT,1856,15,35-39,1871,0.4715505583971714
STAT,1907,45,25-29,1952,0.04788043849751839
STAT,1894,48,40-44,1942,0.12126235525919657
STAT,1890,37,15-19,1927,0.06798112059440357
STAT,1949,17,20-24,1966,156.1236925349649
STAT,1931,37,15-19,1968,0.025253584518733944
STAT,1913,19,50-100,1932,0.0752347509577713
STAT,1821,33,35-39,1854,14.128083326009069
STAT,1882,27,15-19,1909,0.43437946639778985
STAT,1782,97,na,1879,2.952955517877015
STAT,1918,32,na,1950,3964.748524463202
STAT,1871,38,45-49,1909,1.97872655632899
STAT,1878,17,na,1895,2598.5184395237225
SIM,1921,42,45-49,1963,2
SIM,1869,64,na,1933,3598
SIM,1885,40,na,1925,1510
STAT,1846,19,40-44,1865,0.13448144135605336
STAT,1864,90,na,1954,71.67444447331224
STAT,1844,50,20-24,1894,7.415540156218965E-4
STAT,1855,75,na,1930,681.335548877234
STAT,1902,36,50-100,1938,0.3749550129079384
STAT,1911,40,20-24,1951,0.01685484356994891
STAT,1913,42,50-100,1955,0.11312717515916577
STAT,1804,83,na,1887,265.21464749682104
SIM,1911,20,25-29,1931,117
STAT,1830,30,25-29,1860,9.82281962386633
SIM,1927,26,25-29,1953,2
STAT,1847,56,na,1903,1844.067697957005
STAT,1912,46,45-49,1958,0.20695940139342422
STAT,1829,68,na,1897,558.0510936698362
STAT,1870,32,20-24,1902,2.6947688196811366
STAT,1818,50,50-100,1868,0.026896408571879114
SIM,1844,58,na,1902,1796
SIM,1850,75,na,1925,644
STAT,1922,40,30-34,1962,0.14550695005346848
STAT,1844,31,15-19,1875,0.1704711127139176
SIM,1824,68,na,1892,1678
STAT,1813,45,45-49,1858,0.9039272524752744
STAT,1853,47,40-44,1900,0.13212767375554538
STAT,1915,33,15-19,1948,0.12848362673775648
STAT,1859,88,na,1947,108.80996022350757
STAT,1852,102,na,1954,0.2951064048223029
STAT,1857,51,45-49,1908,0.011189549494696615
STAT,1837,24,15-19,1861,3.4132919747237906
STAT,1827,46,35-39,1873,0.1298354659684061
STAT,1847,22,50-100,1869,0.45197826611407893
STAT,1903,20,25-29,1923,81.74563582193176
STAT,1869,28,25-29,1897,42.53534412810221
SIM,1920,32,35-39,1952,1
STAT,1827,56,na,1883,1523.2128514500125
STAT,1836,19,na,1855,2307.4800479384076
STAT,1878,48,na,1926,2285.7065085912486
STAT,1884,46,50-100,1930,0.23577361029484503
STAT,1923,32,45-49,1955,1.7849709676420247
SIM,1900,34,25-29,1934,14
STAT,1880,52,na,1932,2223.4208666986174
STAT,1891,36,20-24,1927,0.9524975007960638
STAT,1834,90,na,1924,34.74545307928498
STAT,1844,43,30-34,1887,1.1516393063141743
STAT,1903,34,35-39,1937,8.183732361763791
STAT,1835,45,30-34,1880,0.08703842450934855
STAT,1950,5,na,1955,4604.729907150393
STAT,1897,42,35-39,1939,0.166792445732734
STAT,1824,45,20-24,1869,0.0021298986609889397
STAT,1908,42,20-24,1950,0.01621282259172503
SIM,1824,58,na,1882,1811
STAT,1823,53,40-44,1876,0.015495363160426823
STAT,1912,32,35-39,1944,8.887641625052966
STAT,1921,44,45-49,1965,0.18461484875713696
STAT,1834,28,na,1862,1241.1297594634136
STAT,1885,50,45-49,1935,0.014469961671483027
STAT,1900,40,45-49,1940,0.1454251209957668
STAT,1931,31,40-44,1962,5.094661226238877
STAT,1890,44,40-44,1934,2.6862344306754937
SIM,1863,38,na,1901,886
STAT,1886,42,25-29,1928,0.6641670740124944
STAT,1855,85,na,1940,181.43216412029707
STAT,1823,43,na,1866,2153.7242296229547
STAT,1853,43,25-29,1896,0.494324433818611
STAT,1935,31,25-29,1966,12.70247203213794
STAT,1835,52,20-24,1887,5.689982044352521E-4
SIM,1950,21,na,1971,4829
STAT,1890,30,30-34,1920,21.306761864906388
SIM,1855,20,na,1875,3317
STAT,1891,37,na,1928,2897.2128562263815
SIM,1871,57,na,1928,1742
STAT,1883,35,50-100,1918,1.1923590162668403
STAT,1880,40,15-19,1920,0.014481398929972468
STAT,1836,44,35-39,1880,1.6089486831701458
STAT,1887,33,50-100,1920,1.004231099782423
SIM,1873,38,na,1911,2176
SIM,1816,39,na,1855,234
STAT,1800,80,na,1880,451.32342789165114
STAT,1813,43,na,1856,2341.4525509417413
STAT,1846,16,na,1862,1717.9259541549552
STAT,1862,45,40-44,1907,0.14727180676016438
STAT,1876,46,30-34,1922,0.09813372867741621
STAT,1884,55,na,1939,1979.3651223671443
STAT,1903,41,25-29,1944,0.06358625710134862
SIM,1881,67,na,1948,1140
STAT,1934,32,20-24,1966,3.307737302890957
STAT,1880,36,45-49,1916,2.079507942191643
STAT,1831,48,15-19,1879,3.723763803084886E-4
STAT,1812,46,40-44,1858,0.045074177347296074
SIM,1815,52,45-49,1867,2
SIM,1859,23,na,1882,2255
SIM,1859,33,na,1892,1883
STAT,1821,62,na,1883,962.1672189387274
SIM,1873,48,na,1921,2117
SIM,1871,67,na,1938,1577
STAT,1874,43,45-49,1917,1.5334741294161909
STAT,1893,1,na,1894,3403.7697536284304
STAT,1853,36,35-39,1889,5.54150713724705
STAT,1841,21,50-100,1862,0.5794159305421691
STAT,1868,51,20-24,1919,7.161449956982099E-4
STAT,1885,32,15-19,1917,0.1399795317815259
STAT,1929,16,40-44,1945,1.7768930455684302
STAT,1841,30,35-39,1871,13.969667497013523
STAT,1891,40,40-44,1931,2.793909094695715
STAT,1906,47,30-34,1953,0.0787007948887952
STAT,1808,76,na,1884,243.7578467058875
SIM,1902,67,na,1969,2054
STAT,1883,18,na,1901,2423.376267824381
STAT,1919,26,25-29,1945,70.41454131040629
SIM,1869,23,na,1892,3246
STAT,1818,41,15-19,1859,0.027748359899688078
STAT,1864,40,30-34,1904,1.0557166098616875
SIM,1887,52,na,1939,3113
SIM,1917,12,na,1929,2454
SIM,1862,46,45-49,1908,3
STAT,1868,47,35-39,1915,0.13459150875438725
STAT,1852,23,na,1875,2538.371752400827
STAT,1871,92,na,1963,100.69795046543906
SIM,1905,42,45-49,1947,1
STAT,1837,17,25-29,1854,6.055810217548489
STAT,1827,53,25-29,1880,0.0030730890051127073
STAT,1901,52,na,1953,2994.6469108206948
STAT,1871,54,30-34,1925,0.0057746387235115115
STAT,1919,19,35-39,1938,4.550962575752886
SIM,1909,1,na,1910,4331
STAT,1864,54,40-44,1918,0.00930756157939525
SIM,1833,73,na,1906,1813
STAT,1900,33,20-24,1933,3.728706052971119
SIM,1966,3,na,1969,5081
STAT,1795,61,na,1856,1128.6867325700002
STAT,1850,35,20-24,1885,0.3691728192887971
STAT,1856,41,35-39,1897,1.3065084476300155
SIM,1805,54,na,1859,2214
STAT,1873,18,na,1891,2583.927632116014
SIM,1889,7,na,1896,3896
STAT,1821,72,na,1893,637.7835477187185
STAT,1834,38,na,1872,1161.9464433331395
STAT,1868,18,15-19,1886,5.801419671291744
SIM,1836,60,na,1896,1300
STAT,1838,53,35-39,1891,0.003616034080071924
STAT,1926,40,15-19,1966,0.0018821608455334646
SIM,1796,76,na,1872,580
SIM,1923,7,na,1930,4291
STAT,1873,52,40-44,1925,0.010741559464088607
SIM,1932,1,na,1933,6596
STAT,1842,40,45-49,1882,0.3943675202538728
STAT,1911,33,30-34,1944,15.104962202379845
STAT,1877,30,15-19,1907,0.1457229287246664
STAT,1845,41,25-29,1886,0.32867040437212564
STAT,1945,16,25-29,1961,46.82871748704321
SIM,1880,19,35-39,1899,6
STAT,1856,52,40-44,1908,0.00752126781411409
STAT,1886,17,20-24,1903,18.35878246946578
STAT,1822,54,35-39,1876,0.01333206191040308
STAT,1872,19,35-39,1891,0.5465085490540884
STAT,1874,89,na,1963,227.28877958503847
SIM,1911,7,na,1918,2657
STAT,1921,41,25-29,1962,0.07959095514553788
STAT,1870,52,na,1922,2135.1369478024644
STAT,1837,56,na,1893,1635.4471115089618
STAT,1892,46,15-19,1938,2.8014811676221863E-4
STAT,1928,7,na,1935,4998.445607023639
SIM,1835,46,35-39,1881,1
STAT,1815,51,40-44,1866,0.00105085833719554
STAT,1915,30,45-49,1945,1.5926859930822996
STAT,1845,16,20-24,1861,11.184769701654528
STAT,1883,41,45-49,1924,1.4463474006529218
STAT,1920,45,40-44,1965,0.17285066298168317
STAT,1941,23,15-19,1964,5.436758907757487
STAT,1847,51,35-39,1898,0.00782083793941239
STAT,1859,42,15-19,1901,0.010932093209268103
STAT,1910,41,15-19,1951,0.001443378467039795
SIM,1925,41,na,1966,4740
SIM,1885,30,15-19,1915,2
STAT,1894,37,35-39,1931,8.994340969848162
STAT,1832,51,40-44,1883,8.591696196272348E-4
STAT,1878,25,15-19,1903,0.4699675121411373
STAT,1920,31,30-34,1951,17.105003589093624
STAT,1821,44,40-44,1865,2.44200110276031
STAT,1825,47,50-100,1872,0.3120101678996249
STAT,1811,54,25-29,1865,0.015309515894408937
STAT,1861,37,na,1898,1959.33181921901
STAT,1900,26,30-34,1926,35.003831747245506
STAT,1920,12,na,1932,4388.270852688278
STAT,1870,42,na,1912,2301.314706064571
STAT,1848,53,45-49,1901,0.013362300721973539
STAT,1816,95,na,1911,11.224445249002942
SIM,1918,52,na,1970,4274
STAT,1905,41,40-44,1946,0.22567403286338886
SIM,1923,30,45-49,1953,8
STAT,1936,23,40-44,1959,3.181622027652718
SIM,1861,47,40-44,1908,1
SIM,1945,9,na,1954,6355
STAT,1861,35,30-34,1896,4.4743999722722725
STAT,1846,29,35-39,1875,6.8144340011659414
STAT,1882,42,40-44,1924,2.15082847945788
STAT,1842,57,na,1899,498.8797818262749
STAT,1926,33,25-29,1959,11.073265880330723
STAT,1816,50,45-49,1866,0.04419271929645479
SIM,1903,32,35-39,1935,9
SIM,1879,33,na,1912,1444
SIM,1934,33,25-29,1967,41
SIM,1837,76,na,1913,1243
STAT,1839,68,na,1907,1419.7965301972465
STAT,1851,45,15-19,1896,3.1906631811415363E-4
STAT,1846,52,30-34,1898,0.003506694258526259
STAT,1854,46,45-49,1900,0.13159273067655272
STAT,1894,44,25-29,1938,0.05594125612229309
STAT,1888,15,30-34,1903,1.8481332449599912
STAT,1832,47,20-24,1879,0.00108629398404743
STAT,1862,34,35-39,1896,8.551788311603245
STAT,1924,42,20-24,1966,0.02080462072968294
SIM,1890,42,40-44,1932,25
STAT,1862,26,50-100,1888,0.5508156878304739
STAT,1894,30,15-19,1924,0.1825495930285742
STAT,1870,47,40-44,1917,0.16987925666104298
STAT,1916,44,20-24,1960,0.017791663760521877
SIM,1855,19,na,1874,3288
STAT,1922,47,15-19,1969,4.1846722780079125E-4
STAT,1858,17,50-100,1875,0.04370376226284307
STAT,1944,21,25-29,1965,98.6424090326264
STAT,1845,34,35-39,1879,5.852205247415506
STAT,1926,30,20-24,1956,2.92739315735009
STAT,1913,43,40-44,1956,0.2404768142214467
STAT,1936,30,30-34,1966,15.168434556725105
STAT,1889,40,35-39,1929,2.202630568344959
STAT,1927,5,na,1932,4958.627021481207
STAT,1846,71,na,1917,790.5501643525669
STAT,1881,39,15-19,1920,0.05249571725542569
SIM,1918,33,40-44,1951,72
SIM,1798,57,na,1855,42
STAT,1878,40,25-29,1918,0.6673622712940895
SIM,1886,40,25-29,1926,16
STAT,1912,43,40-44,1955,0.23700434515104785
STAT,1902,43,30-34,1945,0.11160883566647312
SIM,1862,12,na,1874,3854
STAT,1831,41,30-34,1872,1.1387838830582224
STAT,1931,34,45-49,1965,2.0447682532654614
STAT,1868,54,25-29,1922,0.0033270482894104327
STAT,1941,20,45-49,1961,1.1503520023089928
STAT,1840,53,40-44,1893,0.00407875295129931
STAT,1873,48,20-24,1921,0.01215468846884214
STAT,1832,57,na,1889,1712.3102990088976
STAT,1882,23,na,1905,2257.325045382375
STAT,1877,63,na,1940,1811.283548430153
STAT,1893,69,na,1962,2018.08868983569
STAT,1809,104,na,1913,0.06492422325574525
SIM,1845,20,na,1865,2054
STAT,1871,35,40-44,1906,4.40822159478965
STAT,1905,45,na,1950,3268.8613002285374
SIM,1861,33,30-34,1894,13
SIM,1847,86,na,1933,1018
SIM,1900,31,20-24,1931,40
STAT,1844,46,35-39,1890,0.13909023039242982
STAT,1847,47,15-19,1894,3.599604636057591E-4
STAT,1899,10,na,1909,3538.041566370514
SIM,1962,8,na,1970,4673
STAT,1851,49,30-34,1900,0.07485566340786154
STAT,1860,1,na,1861,2986.8015127093713
STAT,1853,40,20-24,1893,0.12438437550671069
STAT,1865,53,45-49,1918,0.013036966181114383
STAT,1852,57,na,1909,2022.8703038592948
STAT,1862,23,na,1885,2047.3218883971458
STAT,1911,52,na,1963,3380.941156504832
SIM,1907,12,na,1919,4894
SIM,1900,35,na,1935,4147
SIM,1874,41,45-49,1915,12
SIM,1832,46,na,1878,1751
STAT,1918,31,25-29,1949,9.728699534538547
SIM,1819,57,na,1876,1842
STAT,1952,20,20-24,1972,132.56300507735153
STAT,1862,48,45-49,1910,0.19848517305008462
STAT,1867,22,na,1889,2245.911818609373
STAT,1911,22,25-29,1933,86.61597924013415
STAT,1903,31,30-34,1934,24.88554883263443
SIM,1826,39,na,1865,1920
STAT,1818,39,50-100,1857,2.656137682652876
STAT,1809,51,50-100,1860,0.12728535287058187
SIM,1902,44,35-39,1946,1
STAT,1854,102,na,1956,0.1962008035462361
STAT,1934,25,na,1959,5009.72977887276
STAT,1832,105,na,1937,0.024889567299633868
STAT,1877,22,na,1899,2400.8089639722753
STAT,1840,41,50-100,1881,0.4395258546452861
STAT,1864,89,na,1953,95.50480289056637
STAT,1861,42,20-24,1903,0.13191313254687703
STAT,1853,33,30-34,1886,13.797390907953579
STAT,1904,44,45-49,1948,0.14647977614799107
SIM,1815,54,na,1869,1467
STAT,1811,62,na,1873,1339.4165900735359
STAT,1906,34,50-100,1940,0.7553196813701081
STAT,1886,35,35-39,1921,7.393924912121173
STAT,1812,42,25-29,1854,0.31122037572402794
SIM,1820,35,35-39,1855,3
STAT,1814,48,15-19,1862,0.0013491141375356992
STAT,1786,105,na,1891,0.028879504625456277
STAT,1899,15,40-44,1914,0.25098201131317605
STAT,1896,36,na,1932,3120.664537859544
STAT,1894,55,na,1949,2629.4256089036244
STAT,1904,59,na,1963,2944.1365558715984
STAT,1879,88,na,1967,343.9591162269932
STAT,1880,51,20-24,1931,7.697396703467944E-4
SIM,1957,9,na,1966,6080
SIM,1866,3,na,1869,3337
SIM,1918,40,30-34,1958,3
STAT,1819,44,35-39,1863,0.3440899701026823
STAT,1814,83,na,1897,268.6746642085536
STAT,1881,37,na,1918,2224.86177498482
SIM,1800,55,na,1855,216
STAT,1878,6,na,1884,2776.740667054531
SIM,1873,6,na,1879,2483
STAT,1922,37,na,1959,4233.146491212685
STAT,1838,50,30-34,1888,0.002629623624275756
STAT,1867,18,15-19,1885,5.703846773331806
STAT,1824,52,45-49,1876,0.0024471842626425004
STAT,1899,54,na,1953,2860.1457614377146
STAT,1874,40,40-44,1914,2.3448260566992465
STAT,1888,48,15-19,1936,2.571454034937249E-4
SIM,1845,28,30-34,1873,11
STAT,1829,26,30-34,1855,21.538673555623898
STAT,1892,46,50-100,1938,0.17201108818832
SIM,1932,33,na,1965,5962
STAT,1847,17,35-39,1864,0.6191782182473716
STAT,1881,54,40-44,1935,0.00966837037309878
STAT,1875,41,na,1916,2384.040317288254
STAT,1869,88,na,1957,171.7033204549317
STAT,1872,52,50-100,1924,0.01504277410120928
STAT,1929,19,45-49,1948,0.6296548078814013
STAT,1868,44,30-34,1912,1.0954423081840485
STAT,1845,75,na,1920,510.8365950839738
STAT,1853,102,na,1955,0.22732457305344617
STAT,1854,54,30-34,1908,0.003218707560309803
STAT,1927,43,35-39,1970,0.2500905347401025
SIM,1827,44,35-39,1871,5
SIM,1944,14,na,1958,2516
STAT,1882,31,35-39,1913,9.735379892995928
STAT,1891,43,45-49,1934,1.8271663710047286
STAT,1827,50,20-24,1877,6.79427531051158E-4
STAT,1878,18,25-29,1896,5.81504710031651
STAT,1894,41,20-24,1935,0.20286975062050533
STAT,1932,37,30-34,1969,2.431774668498964
STAT,1844,90,na,1934,78.10647420400005
STAT,1820,34,30-34,1854,48.85735022144317
STAT,1857,56,na,1913,1565.1364609430323
SIM,1926,31,25-29,1957,10
STAT,1895,51,na,1946,2814.4754266603863
STAT,1835,41,15-19,1876,0.01268129520378053
STAT,1901,33,20-24,1934,3.7635084766813556
STAT,1839,15,35-39,1854,0.6748012772736799
SIM,1814,58,na,1872,2442
SIM,1840,65,na,1905,2500
SIM,1842,19,15-19,1861,95
STAT,1876,53,20-24,1929,7.339913078538007E-4
STAT,1837,28,30-34,1865,25.729777421667954
STAT,1864,33,50-100,1897,0.829449358314211
STAT,1893,49,35-39,1942,0.09669430140665373
STAT,1832,54,45-49,1886,0.001116340320003249
SIM,1810,99,na,1909,76
STAT,1896,17,30-34,1913,2.101084333661709
STAT,1806,95,na,1901,4.003531357133499
SIM,1884,46,30-34,1930,1
STAT,1931,41,35-39,1972,0.26750496427055054
SIM,1883,2,na,1885,2348
STAT,1819,51,25-29,1870,6.319466830902369E-4
STAT,1844,16,50-100,1860,0.06206276080049741
SIM,1864,34,na,1898,2415
STAT,1871,31,25-29,1902,10.259199632242762
STAT,1830,76,na,1906,685.7045471361105
STAT,1805,51,30-34,1856,0.007116509270825467
STAT,1883,70,na,1953,1349.817991857729
STAT,1920,41,25-29,1961,0.07796517832185983
STAT,1832,36,15-19,1868,0.0041383759449408735
STAT,1853,15,50-100,1868,0.0462398913930608
STAT,1855,49,15-19,1904,2.59206914354854E-4
STAT,1910,45,30-34,1955,0.08262958763975141
SIM,1905,34,na,1939,3232
STAT,1876,27,50-100,1903,0.6466701737673828
SIM,1908,52,na,1960,1972
STAT,1860,42,na,1902,1883.1699487708177
SIM,1819,38,30-34,1857,8
STAT,1865,46,20-24,1911,0.010986999050018332
STAT,1930,31,40-44,1961,5.0177450996911475
SIM,1901,37,50-100,1938,1
STAT,1914,49,30-34,1963,0.08667056989789179
STAT,1845,19,25-29,1864,3.5122871452275795
STAT,1872,29,50-100,1901,0.635983892817585
SIM,1862,53,na,1915,3426
STAT,1888,18,35-39,1906,0.63164092961321
STAT,1924,45,25-29,1969,0.06283908281154915
STAT,1867,16,50-100,1883,0.04764696135593675
STAT,1881,51,50-100,1932,0.014330487180231891
STAT,1815,40,35-39,1855,0.19899243181292076
STAT,1894,34,30-34,1928,22.012707189599258
STAT,1821,47,45-49,1868,0.2524034639411878
STAT,1876,50,50-100,1926,0.015486891041268446
STAT,1920,34,35-39,1954,9.796346787124733
STAT,1844,38,na,1882,2440.9607300386688
SIM,1862,8,na,1870,3926
STAT,1925,11,na,1936,4749.693450023866
STAT,1879,51,30-34,1930,0.006135579064560258
STAT,1872,42,30-34,1914,1.1498139599716841
STAT,1820,41,20-24,1861,0.26698222267708016
SIM,1853,38,na,1891,3235
SIM,1865,19,na,1884,1859
STAT,1905,44,45-49,1949,0.14746655689954455
STAT,1900,22,15-19,1922,4.570089897772944
STAT,1884,44,15-19,1928,0.013041326633638276
STAT,1871,21,30-34,1892,17.822174296359442
STAT,1895,29,50-100,1924,0.8262106324525696
STAT,1860,35,50-100,1895,1.0110950863227781
STAT,1916,37,50-100,1953,0.424090525305948
STAT,1878,29,30-34,1907,25.72370621840119
STAT,1850,42,45-49,1892,0.6902402059706925
STAT,1873,9,na,1882,2746.295748622252
STAT,1895,47,45-49,1942,0.17236953799700228
STAT,1827,43,30-34,1870,1.0765023314860551
STAT,1909,40,50-100,1949,0.10999769436605102
STAT,1861,31,15-19,1892,0.11891632844027177
STAT,1855,16,30-34,1871,1.2621094686274663
STAT,1927,22,30-34,1949,35.12233023572657
STAT,1929,30,40-44,1959,4.94153942991704
STAT,1839,15,40-44,1854,0.22493377211462376
STAT,1948,22,50-100,1970,0.7477788645396493
STAT,1908,28,35-39,1936,14.03336152101992
STAT,1907,41,15-19,1948,0.0014055802097153478
STAT,1800,108,na,1908,0.0012638440376126563
STAT,1776,108,na,1884,0.009643461616011267
STAT,1903,19,45-49,1922,0.09222875763919756
STAT,1893,20,40-44,1913,2.6214089707797568
SIM,1933,25,30-34,1958,169
SIM,1852,21,na,1873,2413
STAT,1850,85,na,1935,126.58476940131682
STAT,1865,25,35-39,1890,8.869151249369436
STAT,1923,28,50-100,1951,1.126768210813005
STAT,1916,47,25-29,1963,0.05366544871513756
STAT,1887,54,na,1941,2304.8254924186176
SIM,1823,32,na,1855,1770
SIM,1869,43,50-100,1912,26
STAT,1900,15,50-100,1915,0.06818305882587464
STAT,1914,39,15-19,1953,0.01871646598632448
STAT,1882,25,50-100,1907,0.6166031044924666
STAT,1906,45,45-49,1951,0.1946944137961674
STAT,1836,62,na,1898,1398.830232747124
STAT,1937,16,50-100,1953,0.36159640108344654
STAT,1869,30,45-49,1899,1.7738037739865014
STAT,1936,28,40-44,1964,4.414311186212426
STAT,1900,24,15-19,1924,4.541480340731261
STAT,1921,34,30-34,1955,17.17684991748034
SIM,1959,9,na,1968,5256
SIM,1873,25,35-39,1898,6
STAT,1923,42,40-44,1965,0.2892687912947199
STAT,1851,54,20-24,1905,5.667765459396811E-4
SIM,1929,36,20-24,1965,2
SIM,1895,18,na,1913,4616
STAT,1902,21,15-19,1923,4.659580429567262
SIM,1894,76,na,1970,542
SIM,1937,30,40-44,1967,1
SIM,1835,41,na,1876,1263
STAT,1859,28,15-19,1887,0.36318185310548157
STAT,1867,22,35-39,1889,5.541524017734454
SIM,1916,2,na,1918,4952
STAT,1847,21,25-29,1868,63.90755864036421
STAT,1904,37,35-39,1941,2.1810871609150975
SIM,1827,46,na,1873,1981
STAT,1878,18,na,1896,2591.710321212169
SIM,1855,21,25-29,1876,1
STAT,1920,36,35-39,1956,2.6165774258619114
STAT,1921,45,40-44,1966,0.17645504904071194
SIM,1848,16,na,1864,2635
STAT,1870,37,40-44,1907,4.364077589202854
STAT,1911,27,25-29,1938,63.46581308122419
STAT,1849,37,na,1886,2031.310137815229
STAT,1911,30,25-29,1941,8.970288171568766
STAT,1850,33,50-100,1883,0.4380195068393179
STAT,1920,16,40-44,1936,1.5529008534773399
STAT,1782,96,na,1878,4.823671988429898
STAT,1904,48,45-49,1952,0.18780343862329785
STAT,1925,45,25-29,1970,0.06398991003146384
SIM,1848,31,35-39,1879,22
STAT,1914,19,20-24,1933,27.506480003802086
STAT,1917,15,25-29,1932,9.243635932096003
STAT,1897,19,50-100,1916,0.06471483593453897
STAT,1900,37,20-24,1937,0.23048511880914474
STAT,1940,29,15-19,1969,0.7110984245986082
SIM,1857,44,na,1901,1420
STAT,1904,51,na,1955,3091.0251892202414
STAT,1950,19,30-34,1969,14.265351678036064
STAT,1886,13,na,1899,2670.1723898835735
STAT,1934,18,35-39,1952,5.622511804322095
STAT,1782,88,na,1870,139.92131077669217
STAT,1921,15,45-49,1936,0.5652742317187155
STAT,1942,26,15-19,1968,0.7328027227836436
STAT,1841,49,na,1890,2453.034326034017
STAT,1951,15,30-34,1966,14.38701023592926
STAT,1786,78,na,1864,577.8661920226232
SIM,1920,10,na,1930,4866
STAT,1904,17,40-44,1921,0.2613128557619259
SIM,1873,15,na,1888,2414
SIM,1903,30,na,1933,2898
SIM,1887,7,na,1894,3989
STAT,1879,20,50-100,1899,0.4208236302884279
SIM,1799,73,na,1872,105
STAT,1835,22,45-49,1857,0.7013362203242776
STAT,1952,16,30-34,1968,14.4773335967575
SIM,1833,42,na,1875,2189
SIM,1837,56,na,1893,1649
STAT,1930,27,35-39,1957,18.95635760251245
STAT,1932,35,45-49,1967,0.9111618431835241
STAT,1790,83,na,1873,183.64180555293345
STAT,1857,32,na,1889,1842.468233152904
STAT,1916,16,20-24,1932,28.44165726172767
STAT,1831,39,na,1870,2064.387711373374
STAT,1871,47,na,1918,2233.8512217362445
STAT,1811,52,25-29,1863,0.01593464179370423
STAT,1902,34,20-24,1936,2.1668885229296193
STAT,1932,15,20-24,1947,179.10152955748978
SIM,1831,51,na,1882,2133
STAT,1863,22,20-24,1885,60.003890533791655
STAT,1905,16,45-49,1921,0.09418545474137033
STAT,1893,31,50-100,1924,1.1504729776571128
STAT,1915,18,25-29,1933,8.918274553061998
SIM,1912,15,na,1927,4794
SIM,1808,75,na,1883,1101
STAT,1911,21,50-100,1932,0.6188736966192836
STAT,1866,48,30-34,1914,0.08725059450971755
SIM,1875,9,na,1884,3270
STAT,1840,75,na,1915,405.35542223844647
STAT,1934,34,50-100,1968,1.119765250242621
STAT,1908,22,20-24,1930,101.43385589537039
STAT,1810,77,na,1887,25.59421736885083
STAT,1844,17,15-19,1861,7.473590355008677
STAT,1934,32,15-19,1966,0.1742644979989043
STAT,1913,40,30-34,1953,0.12450448451519809
STAT,1917,32,15-19,1949,0.1327681532487002
SIM,1852,13,na,1865,2610
STAT,1912,23,25-29,1935,87.22436813431169
SIM,1923,39,50-100,1962,5
STAT,1896,16,25-29,1912,7.488390231272757
SIM,1847,35,35-39,1882,12
STAT,1803,75,na,1878,313.93878030236766
SIM,1827,54,na,1881,1866
STAT,1894,24,na,1918,2988.7065639953894
STAT,1898,38,na,1936,3177.2829977795323
SIM,1943,19,35-39,1962,6
STAT,1932,15,na,1947,4862.454950691181
STAT,1854,67,na,1921,881.4091395805
SIM,1878,46,na,1924,3850
STAT,1935,19,35-39,1954,5.6645681309183304
STAT,1830,52,35-39,1882,0.006473092131620138
STAT,1870,54,30-34,1924,0.005771104644225242
STAT,1890,18,na,1908,3049.506441662665
STAT,1829,25,25-29,1854,42.31391219685131
STAT,1889,26,35-39,1915,11.659355998944106
SIM,1882,51,na,1933,1573
STAT,1860,47,25-29,1907,0.04677056045472798
STAT,1937,24,40-44,1961,3.238226903507852
STAT,1868,16,na,1884,2498.291850680333
STAT,1872,21,na,1893,2375.4141069692832
STAT,1924,29,30-34,1953,44.8604637920971
STAT,1792,98,na,1890,0.7863950187049746
SIM,1849,40,40-44,1889,8
STAT,1819,49,50-100,1868,0.043683449479139165
STAT,1899,31,na,1930,3272.7041213144757
STAT,1836,52,50-100,1888,0.011709632988266317
STAT,1885,48,40-44,1933,0.166166474431714
STAT,1903,30,20-24,1933,3.867864730106064
STAT,1908,41,na,1949,3429.1611046536523
STAT,1825,78,na,1903,481.1545633527777
STAT,1852,53,25-29,1905,0.003508101936742589
STAT,1918,19,35-39,1937,4.48149345173112
STAT,1869,18,30-34,1887,1.6210120363128777
STAT,1877,52,na,1929,2174.0886040202877
STAT,1931,2,na,1933,5315.583853829155
STAT,1933,31,15-19,1964,0.17210094676569124
SIM,1850,44,50-100,1894,1
STAT,1858,40,40-44,1898,1.735023786704571
SIM,1906,27,na,1933,3547
STAT,1907,41,45-49,1948,0.15232974453314926
SIM,1898,66,na,1964,3479
SIM,1933,0,na,1933,4982
STAT,1924,41,45-49,1965,0.1963436683659192
STAT,1909,29,35-39,1938,14.100811881151524
STAT,1913,43,50-100,1956,0.11294843422241431
STAT,1866,60,na,1926,1740.9092980523108
SIM,1886,33,na,1919,3058
STAT,1943,22,15-19,1965,5.598848741753017
STAT,1854,103,na,1957,0.11658251746717346
STAT,1938,23,45-49,1961,1.1012971227890094
STAT,1853,42,na,1895,1789.9028090194588
STAT,1903,36,35-39,1939,2.177495715432766
SIM,1840,44,na,1884,2544
STAT,1866,92,na,1958,55.109487354591444
SIM,1853,62,na,1915,2608
STAT,1823,39,20-24,1862,1.3668496325365531
STAT,1915,11,na,1926,4081.0999142921223
STAT,1919,25,na,1944,4021.0239596587535
SIM,1932,29,30-34,1961,32
STAT,1890,39,50-100,1929,1.4713552199696391
SIM,1911,41,na,1952,2467
SIM,1915,55,na,1970,2623
STAT,1952,5,na,1957,4668.717705809772
STAT,1849,8,na,1857,2546.908443053205
STAT,1840,39,20-24,1879,0.3516176059938256
STAT,1910,34,25-29,1944,8.736712760310548
STAT,1786,107,na,1893,0.004644996302950576
STAT,1918,44,25-29,1962,0.07465045139434365
SIM,1844,26,na,1870,2089
STAT,1857,43,50-100,1900,0.8048242493443994
STAT,1889,20,20-24,1909,83.48129165031962
SIM,1915,29,30-34,1944,281
STAT,1878,20,15-19,1898,3.4145164324903856
STAT,1839,35,35-39,1874,8.017465214120124
STAT,1928,34,40-44,1962,4.849727564645632
STAT,1905,24,50-100,1929,0.5828615194079676
SIM,1878,26,25-29,1904,311
STAT,1907,29,30-34,1936,36.17316906364656
SIM,1910,32,na,1942,4251
STAT,1871,53,35-39,1924,0.008450024002893124
STAT,1871,39,na,1910,2326.5363973841654
STAT,1857,24,na,1881,1879.2941706116264
STAT,1923,30,na,1953,4324.6240460061335
STAT,1917,45,20-24,1962,0.01144248281909338
STAT,1922,30,30-34,1952,17.744301135776777
STAT,1800,100,na,1900,0.7325088522085771
STAT,1933,31,45-49,1964,2.107424706391025
STAT,1919,28,40-44,1947,4.951841571156971
STAT,1863,5,na,1868,2449.5893185570503
SIM,1819,67,na,1886,1056
STAT,1893,23,45-49,1916,0.8693254832564746
STAT,1891,67,na,1958,2028.2515244271397
SIM,1829,80,na,1909,1137
STAT,1856,15,40-44,1871,0.1571835285664626
SIM,1924,19,25-29,1943,9
STAT,1835,21,na,1856,2165.9892962467165
SIM,1878,78,na,1956,1265
STAT,1918,41,20-24,1959,0.018550284515169543
STAT,1898,40,50-100,1938,0.09964679200374232
SIM,1815,77,na,1892,434
STAT,1857,101,na,1958,0.7312474311902004
SIM,1935,34,25-29,1969,9
STAT,1805,107,na,1912,6.327062161589158E-4
SIM,1881,26,na,1907,3141
SIM,1908,36,30-34,1944,4
STAT,1847,110,na,1957,3.075458958715488E-4
STAT,1867,30,40-44,1897,4.134330508065766
SIM,1941,16,20-24,1957,17
SIM,1919,45,na,1964,4903
STAT,1905,29,20-24,1934,16.752988635120182
STAT,1924,28,na,1952,4304.667707444377
STAT,1911,24,20-24,1935,103.61591878285954
STAT,1841,21,30-34,1862,25.30888510126312
STAT,1839,59,na,1898,1805.6066515303073
STAT,1847,23,50-100,1870,0.44873306216337994
STAT,1916,19,25-29,1935,9.020153169943384
STAT,1883,48,30-34,1931,0.09195565275015738
STAT,1921,37,35-39,1958,2.668709135914547
SIM,1918,20,na,1938,4461
SIM,1910,37,30-34,1947,1
STAT,1856,90,na,1946,56.62751754057353
STAT,1878,34,50-100,1912,0.9346258642619538
STAT,1907,26,20-24,1933,17.176065928744077
STAT,1940,32,45-49,1972,1.6103139548218743
STAT,1878,33,20-24,1911,2.7693577572817376
SIM,1866,13,na,1879,3337
STAT,1910,47,30-34,1957,0.08224250774996487
STAT,1889,40,50-100,1929,1.2850428060129604
STAT,1887,26,25-29,1913,46.719821586240116
SIM,1911,33,25-29,1944,14
STAT,1941,25,15-19,1966,0.7226131896474388
SIM,1924,31,15-19,1955,3
STAT,1920,8,na,1928,4417.220785266348
STAT,1895,20,45-49,1915,0.9125388755794064
SIM,1887,74,na,1961,1759
SIM,1888,16,na,1904,639
STAT,1923,45,45-49,1968,0.2527577945108228
STAT,1924,41,15-19,1965,0.0018117064096959264
STAT,1907,25,50-100,1932,0.9397054676593898
STAT,1826,32,45-49,1858,3.4588102004379184
STAT,1875,29,na,1904,2433.0917519456148
STAT,1854,59,na,1913,1080.6004251143672
STAT,1894,56,na,1950,2593.7180091347127
STAT,1807,57,na,1864,1207.157429173012
STAT,1931,19,20-24,1950,175.26272640423113
SIM,1879,43,30-34,1922,5
STAT,1869,30,15-19,1899,0.14485609281975964
STAT,1922,16,45-49,1938,0.5730803815555338
SIM,1940,30,na,1970,4253
STAT,1844,41,50-100,1885,1.0857298811179124
STAT,1865,11,na,1876,2479.346612966628
SIM,1866,4,na,1870,3337
STAT,1900,24,45-49,1924,0.9599421484282487
SIM,1864,54,na,1918,2415
STAT,1915,43,na,1958,3680.4398402524794
STAT,1859,90,na,1949,62.488451426389695
STAT,1901,25,15-19,1926,0.6386775818535312
STAT,1903,33,25-29,1936,8.313345637300785
STAT,1949,23,na,1972,4217.779277336719
STAT,1945,18,40-44,1963,1.5105677681254506
SIM,1923,35,45-49,1958,1
SIM,1858,18,na,1876,2443
STAT,1800,54,15-19,1854,1.4340813719187928E-4
STAT,1875,38,30-34,1913,5.445544264326938
SIM,1846,60,na,1906,664
STAT,1875,21,na,1896,2435.8874427930064
STAT,1878,20,45-49,1898,0.721733442430933
SIM,1928,30,na,1958,4402
STAT,1841,60,na,1901,2123.7685795701827
SIM,1913,29,20-24,1942,3
STAT,1933,16,20-24,1949,180.69820761972827
STAT,1913,23,40-44,1936,3.3423577365900705
STAT,1850,106,na,1956,0.007031022066295512
STAT,1852,22,45-49,1874,0.8338427441247492
SIM,1883,38,30-34,1921,28
SIM,1921,27,35-39,1948,83
STAT,1838,19,40-44,1857,0.10192067603409878
SIM,1887,82,na,1969,1759
STAT,1897,33,30-34,1930,23.08956067926012
STAT,1913,27,35-39,1940,14.771950803830563
STAT,1914,42,45-49,1956,0.1626193838697339
STAT,1914,18,na,1932,3929.3782274647037
STAT,1903,16,40-44,1919,0.2602706054161889
SIM,1877,21,na,1898,45
SIM,1921,38,45-49,1959,13
STAT,1907,56,na,1963,3129.980789141447
STAT,1902,37,25-29,1939,0.875100476420794
STAT,1899,41,40-44,1940,0.21430604125486727
SIM,1851,28,na,1879,967
STAT,1817,67,na,1884,559.201569099005
STAT,1921,48,45-49,1969,0.24143157731141188
STAT,1925,42,20-24,1967,0.021185633990292156
SIM,1891,36,na,1927,2140
STAT,1904,43,50-100,1947,0.10405511708934666
STAT,1930,24,30-34,1954,36.33204975220695
STAT,1870,97,na,1967,24.26116858635599
STAT,1863,40,50-100,1903,0.9110065227542591
SIM,1902,30,25-29,1932,72
STAT,1899,30,30-34,1929,24.039347791474977
SIM,1838,42,30-34,1880,4
SIM,1874,64,na,1938,2153
STAT,1860,44,20-24,1904,0.12780963216679966
STAT,1873,62,na,1935,1874.8493604630494
STAT,1911,26,40-44,1937,4.509738026566714
SIM,1879,31,na,1910,1447
STAT,1879,67,na,1946,1626.179612725209
STAT,1932,23,na,1955,4743.441997307863
SIM,1861,52,50-100,1913,1
STAT,1813,53,na,1866,2050.122847688927
STAT,1911,15,30-34,1926,2.4228229974991358
SIM,1854,25,25-29,1879,6
STAT,1901,20,45-49,1921,0.9808230523308646
STAT,1860,23,50-100,1883,0.3404752426650377
STAT,1901,36,25-29,1937,0.873102171101524
STAT,1930,35,40-44,1965,1.9422689295767002
SIM,1837,22,20-24,1859,30
SIM,1910,37,25-29,1947,4
STAT,1846,25,25-29,1871,30.74847561511633
SIM,1938,6,na,1944,4264
STAT,1902,40,25-29,1942,0.06342728902359857
SIM,1823,64,na,1887,708
SIM,1834,56,na,1890,727
SIM,1926,16,30-34,1942,3
STAT,1879,45,50-100,1924,0.25445806131548915
STAT,1909,38,25-29,1947,0.9179043181270117
STAT,1911,43,30-34,1954,0.11992293840495775
STAT,1937,27,45-49,1964,1.6666528569768173
SIM,1917,38,25-29,1955,2
STAT,1834,30,50-100,1864,0.5280952867893128
STAT,1909,41,25-29,1950,0.06649293804880912
STAT,1926,37,40-44,1963,1.8138308566903976
SIM,1844,34,na,1878,2931
SIM,1848,48,na,1896,2307
STAT,1849,19,50-100,1868,0.0502157862909577
STAT,1848,22,25-29,1870,65.22572537428623
SIM,1925,15,25-29,1940,48
STAT,1901,20,15-19,1921,4.640267767375353
STAT,1808,47,30-34,1855,0.17692504092743996
SIM,1853,5,na,1858,3646
STAT,1924,38,20-24,1962,0.3075458175140025
STAT,1926,20,50-100,1946,0.7972616032197979
STAT,1906,25,20-24,1931,17.103230973491133
STAT,1915,35,45-49,1950,0.6853944545655181
SIM,1929,4,na,1933,6340
STAT,1855,37,50-100,1892,0.8125649390553614
STAT,1903,66,na,1969,2648.868766739264
STAT,1889,23,30-34,1912,21.383716434995335
STAT,1943,0,na,1943,4682.159999675951
STAT,1927,38,40-44,1965,1.844180965722876
STAT,1869,89,na,1958,147.56011656576376
STAT,1836,30,na,1866,2140.48469602208
STAT,1813,77,na,1890,633.1897606899536
STAT,1871,45,35-39,1916,0.14104841970631743
STAT,1816,42,na,1858,2655.9897254265043
STAT,1936,26,45-49,1962,1.6376832460796211
STAT,1872,49,15-19,1921,3.921804575129566E-4
STAT,1781,108,na,1889,0.005610660939326465
STAT,1882,31,na,1913,2294.015325361226
STAT,1825,46,50-100,1871,0.31617123026083366
STAT,1940,10,na,1950,3973.6072577761292
STAT,1856,32,30-34,1888,12.69404163014271
STAT,1837,87,na,1924,141.26767431069067
STAT,1884,30,40-44,1914,4.184788695852523
SIM,1936,17,na,1953,3927
SIM,1904,4,na,1908,4260
STAT,1833,73,na,1906,488.6856272874226
STAT,1917,48,25-29,1965,0.054514649623903504
STAT,1823,50,50-100,1873,0.023596881704771686
SIM,1897,0,na,1897,3549
SIM,1910,21,15-19,1931,10
STAT,1888,22,25-29,1910,66.07080704768387
STAT,1837,32,20-24,1869,2.7174509159147946
STAT,1822,81,na,1903,311.83201896803195
STAT,1936,15,35-39,1951,3.9959790417689818
STAT,1964,3,na,1967,4906.011631959049
STAT,1910,31,20-24,1941,2.335062961800261
STAT,1826,95,na,1921,10.599682979274036
SIM,1810,104,na,1914,2
STAT,1872,15,25-29,1887,5.760760129423557
STAT,1923,45,15-19,1968,4.2840268096418904E-4
SIM,1886,33,20-24,1919,2
SIM,1857,52,na,1909,1397
SIM,1946,20,40-44,1966,94
STAT,1828,103,na,1931,0.09714965377558837
STAT,1922,33,35-39,1955,10.166975198455205
SIM,1919,37,45-49,1956,2
STAT,1918,27,40-44,1945,4.893478188742414
STAT,1820,55,na,1875,1546.7727729272015
SIM,1862,7,na,1869,4008
SIM,1902,37,na,1939,3353
SIM,1829,31,25-29,1860,16
STAT,1904,45,40-44,1949,0.1393461853941383
STAT,1922,45,na,1967,4193.053113081042
STAT,1824,69,na,1893,284.0044527570481
STAT,1903,33,30-34,1936,14.171070249128663
SIM,1799,65,na,1864,1026
STAT,1895,41,na,1936,3030.6630000064897
STAT,1866,21,35-39,1887,5.409065856852532
STAT,1916,36,15-19,1952,0.019490433471463384
STAT,1828,28,50-100,1856,1.1934320103086369
STAT,1918,16,30-34,1934,2.632255655244244
STAT,1915,35,15-19,1950,0.019306888340160012
STAT,1904,34,30-34,1938,14.200576245405733
STAT,1920,20,25-29,1940,101.97335735031905
STAT,1827,34,na,1861,2027.490848311626
STAT,1928,30,25-29,1958,11.482012597463502
SIM,1912,45,40-44,1957,1
STAT,1846,37,50-100,1883,0.7593425838565864
STAT,1926,26,30-34,1952,46.727901777165236
STAT,1921,32,35-39,1953,10.049031703874729
SIM,1925,7,na,1932,5336
STAT,1889,23,25-29,1912,68.72358345087659
STAT,1912,44,30-34,1956,0.12092760176839865
STAT,1898,46,na,1944,3034.552442443477
STAT,1911,53,na,1964,3365.659302477431
STAT,1938,28,15-19,1966,0.6915701856968871
STAT,1938,20,40-44,1958,3.2943697019536993
SIM,1878,38,na,1916,4132
STAT,1925,25,30-34,1950,46.166839573323074
STAT,1842,47,30-34,1889,0.024034079935377074
STAT,1920,17,25-29,1937,47.99431922059523
SIM,1924,47,25-29,1971,1
SIM,1908,1,na,1909,3348
STAT,1834,37,30-34,1871,2.921622724839099
STAT,1872,32,na,1904,2389.5554640563696
STAT,1875,20,50-100,1895,0.4212389326599113
STAT,1928,38,35-39,1966,3.0304867014641714
STAT,1849,69,na,1918,1236.5401388425678
SIM,1952,12,na,1964,6372
STAT,1880,75,na,1955,1068.7406384461003
STAT,1919,44,40-44,1963,0.26656571548572616
STAT,1831,49,20-24,1880,0.011028429105110022
STAT,1830,44,35-39,1874,1.5603104717465686
SIM,1920,26,35-39,1946,176
STAT,1914,23,35-39,1937,9.456697736502731
SIM,1896,43,30-34,1939,1
STAT,1849,50,50-100,1899,0.012908324203980638
STAT,1802,82,na,1884,247.5620933536317
STAT,1843,32,45-49,1875,2.0713459999504464
SIM,1855,10,na,1865,3381
STAT,1829,29,40-44,1858,1.827584964241971
STAT,1888,43,30-34,1931,1.3173200759899475
STAT,1903,21,30-34,1924,25.361072487678115
SIM,1918,34,25-29,1952,24
STAT,1830,105,na,1935,0.021221490277166008
STAT,1902,17,na,1919,3556.4586127633497
STAT,1849,20,45-49,1869,0.7206865656635956
STAT,1924,25,15-19,1949,0.8195926505640141
STAT,1870,46,30-34,1916,0.09677711757814851
STAT,1813,45,na,1858,2316.1010123846254
STAT,1843,21,35-39,1864,7.289491342159916
STAT,1926,45,40-44,1971,0.19377691408799608
STAT,1893,19,50-100,1912,0.06093715177377862
STAT,1912,26,35-39,1938,14.673566056721674
STAT,1839,32,25-29,1871,11.710605465458341
STAT,1882,87,na,1969,409.66990153457266
STAT,1823,52,na,1875,1904.7838978723937
STAT,1855,31,25-29,1886,6.974393866112554
SIM,1810,46,na,1856,3168
SIM,1893,39,50-100,1932,1
STAT,1917,48,30-34,1965,0.09161489816758678
STAT,1853,37,40-44,1890,3.394266205794574
STAT,1866,43,50-100,1909,0.9573828118029564
STAT,1856,18,45-49,1874,0.05515085179527468
SIM,1908,53,na,1961,1972
STAT,1921,9,na,1930,4483.873122460609
STAT,1869,97,na,1966,22.325057229652387
STAT,1890,82,na,1972,1029.9191379091512
STAT,1832,31,30-34,1863,1.1205654143744128
STAT,1889,22,40-44,1911,2.509374729904457
SIM,1902,22,25-29,1924,703
STAT,1910,19,30-34,1929,2.3753420519327695
STAT,1855,20,15-19,1875,2.587797196337781
STAT,1831,38,50-100,1869,1.23145550691021
STAT,1901,44,25-29,1945,0.06150858239569086
STAT,1933,19,25-29,1952,57.30768412210205
STAT,1884,31,50-100,1915,0.8806809485539866
STAT,1914,34,45-49,1948,1.5485623839092206
STAT,1919,45,30-34,1964,0.09585571957401597
STAT,1938,31,na,1969,3764.3305829842943
STAT,1854,50,30-34,1904,0.0033572848606873646
STAT,1854,32,20-24,1886,1.539109950038897
STAT,1844,14,na,1858,2979.097185727401
STAT,1812,44,50-100,1856,0.318208974690413
STAT,1894,38,40-44,1932,5.539078046696385
SIM,1913,29,na,1942,3369
STAT,1797,73,na,1870,20.512600024343016
STAT,1901,62,na,1963,2736.5737902656133
STAT,1785,85,na,1870,38.5010054067467
STAT,1884,48,25-29,1932,0.054446067548560614
STAT,1838,29,na,1867,1156.7184958023934
STAT,1844,15,50-100,1859,0.0624304763059394
STAT,1881,4,na,1885,2680.6351642002064
STAT,1956,16,20-24,1972,177.88080069274966
STAT,1899,44,45-49,1943,0.14003814982895177
STAT,1914,22,45-49,1936,1.1335483952164151
STAT,1847,54,na,1901,1893.1820295129712
STAT,1907,29,25-29,1936,60.764932922036365
STAT,1865,48,15-19,1913,3.6060741798826286E-4
STAT,1825,105,na,1930,0.018056040111568788
SIM,1915,29,25-29,1944,283
STAT,1911,29,45-49,1940,1.6539079116576934
STAT,1819,47,na,1866,627.6088718318455
STAT,1835,27,15-19,1862,0.4473984479558555
STAT,1857,15,35-39,1872,0.5007702398351963
STAT,1899,33,35-39,1932,13.77385623208235
STAT,1911,18,35-39,1929,0.8280540240277683
STAT,1848,28,na,1876,2399.3198695055366
STAT,1881,39,50-100,1920,1.1477471276557258
STAT,1884,8,na,1892,2488.4738585143455
STAT,1853,23,15-19,1876,3.0007144112717814
STAT,1880,72,na,1952,1311.0799684576475
STAT,1852,34,50-100,1886,0.9352859910105361
STAT,1884,86,na,1970,490.809317106557
STAT,1867,18,20-24,1885,17.03933970589666
STAT,1940,24,45-49,1964,1.1325763170095018
STAT,1944,17,50-100,1961,0.3986500123834378
STAT,1847,65,na,1912,1527.9237648251867
STAT,1838,18,na,1856,1285.4399992608128
STAT,1845,17,30-34,1862,0.9996350440959303
STAT,1901,51,na,1952,3025.0792076496505
STAT,1922,29,20-24,1951,20.27903085087198
STAT,1768,92,na,1860,28.61649489738758
STAT,1910,17,35-39,1927,0.8221497120207792
STAT,1834,54,20-24,1888,3.205069112767066E-4
STAT,1827,47,40-44,1874,0.15673803133299513
STAT,1865,22,25-29,1887,52.90005415056438
STAT,1851,70,na,1921,1108.1375873111149
STAT,1910,23,20-24,1933,102.93489635693436
STAT,1884,65,na,1949,1617.754467953531
SIM,1859,19,20-24,1878,12
STAT,1841,50,45-49,1891,0.016392750117471842
STAT,1930,23,40-44,1953,4.263943517618966
STAT,1950,15,15-19,1965,53.17883517307481
STAT,1888,79,na,1967,1180.6902327131124
STAT,1920,33,25-29,1953,9.951500516406984
SIM,1901,26,25-29,1927,273
STAT,1859,98,na,1957,3.5151326622331376
SIM,1881,58,na,1939,2070
STAT,1894,24,15-19,1918,4.1689691887213
STAT,1925,22,20-24,1947,131.88138856388747
STAT,1861,17,15-19,1878,5.672702977792443
STAT,1860,48,50-100,1908,0.19784104412969403
STAT,1906,28,25-29,1934,61.03985791025092
STAT,1802,90,na,1892,39.94592657698599
STAT,1936,24,25-29,1960,87.37373061667574
STAT,1918,44,30-34,1962,0.13364838823982578
STAT,1853,101,na,1954,0.4424550839920708
STAT,1768,105,na,1873,0.05455619302828986
STAT,1871,54,50-100,1925,0.014651356062300919
STAT,1913,38,45-49,1951,0.661025104138284
SIM,1892,33,45-49,1925,6
STAT,1851,37,50-100,1888,0.9800460712316456
STAT,1826,92,na,1918,33.20441575115055
STAT,1829,46,50-100,1875,0.11508471154623494
SIM,1958,8,na,1966,4197
STAT,1951,16,15-19,1967,53.55463580807637
STAT,1813,42,na,1855,2367.729417905052
STAT,1942,22,20-24,1964,115.25493650611145
STAT,1873,32,30-34,1905,17.909822345180956
SIM,1926,32,30-34,1958,9
STAT,1868,48,40-44,1916,0.1632793731401663
STAT,1924,23,50-100,1947,0.7665909604645537
SIM,1949,16,25-29,1965,120
STAT,1900,29,15-19,1929,0.6240154540693768
SIM,1809,60,na,1869,389
STAT,1858,43,45-49,1901,1.1346743965215293
STAT,1860,21,50-100,1881,0.3454176327635511
STAT,1941,29,30-34,1970,40.032728188405024
STAT,1823,44,na,1867,2126.4791580860556
SIM,1841,29,na,1870,1137
SIM,1907,38,35-39,1945,9
STAT,1879,20,30-34,1899,18.3815741774658
STAT,1941,25,45-49,1966,1.768382607870755
SIM,1887,16,25-29,1903,10
SIM,1933,22,20-24,1955,35
STAT,1935,32,30-34,1967,21.640291037123035
STAT,1843,18,50-100,1861,0.06149539798885964
SIM,1859,17,25-29,1876,17
SIM,1881,32,30-34,1913,24
STAT,1913,17,50-100,1930,0.07564039488928152
SIM,1946,16,na,1962,3421
STAT,1879,17,30-34,1896,1.6350547816216296
SIM,1933,20,na,1953,4062
STAT,1891,48,50-100,1939,0.16822456576669492
STAT,1926,35,20-24,1961,0.3199567357343591
SIM,1814,41,30-34,1855,8
SIM,1844,66,na,1910,1600
SIM,1866,43,45-49,1909,2
STAT,1847,102,na,1949,0.2650644787438259
STAT,1855,19,40-44,1874,0.14228809820897848
STAT,1906,17,15-19,1923,8.593653171966192
SIM,1870,18,na,1888,2495
STAT,1929,34,35-39,1963,11.51154355733627
SIM,1868,68,na,1936,328
SIM,1917,22,15-19,1939,16
STAT,1882,22,30-34,1904,17.053662614487667
SIM,1869,21,20-24,1890,148
STAT,1892,45,50-100,1937,0.17323412108316713
STAT,1926,29,35-39,1955,17.715928270668467
STAT,1842,44,50-100,1886,0.26447049288820607
STAT,1902,37,30-34,1939,1.6198668482241432
STAT,1925,42,15-19,1967,0.0018422291421344918
SIM,1895,61,na,1956,4339
STAT,1892,34,15-19,1926,0.17480453185801992
STAT,1916,28,na,1944,3807.1073068723176
SIM,1855,29,na,1884,3037
STAT,1911,34,40-44,1945,3.735474717226974
SIM,1929,23,na,1952,6274
STAT,1912,46,na,1958,3498.343521861253
STAT,1872,19,40-44,1891,0.18216952689876117
STAT,1879,5,na,1884,2782.0025062415784
STAT,1884,33,45-49,1917,1.6622683503496578
SIM,1840,31,30-34,1871,101
STAT,1871,19,50-100,1890,0.048609448434635924
SIM,1899,19,20-24,1918,1
STAT,1909,22,15-19,1931,4.89707288682515
STAT,1925,34,20-24,1959,2.866292354831987
STAT,1795,63,na,1858,1047.5788073453575
SIM,1824,30,35-39,1854,3
SIM,1902,4,na,1906,3806
SIM,1933,34,20-24,1967,7
SIM,1944,12,na,1956,2516
STAT,1817,42,45-49,1859,1.0984374179716405
STAT,1956,2,na,1958,5161.738359911671
STAT,1874,36,na,1910,2443.228201099089
STAT,1824,93,na,1917,5.655806853431977
STAT,1828,49,50-100,1877,0.2855825465988867
STAT,1885,28,na,1913,2337.574162420704
SIM,1874,5,na,1879,2818
SIM,1902,40,20-24,1942,2
STAT,1919,23,40-44,1942,3.621710487912321
STAT,1847,45,35-39,1892,0.1278382861726217
STAT,1884,22,35-39,1906,5.586143995245682
STAT,1922,0,na,1922,5155.69638114649
SIM,1851,36,na,1887,1186
STAT,1905,49,15-19,1954,3.177567565641273E-4
STAT,1862,54,na,1916,1783.5090805232612
STAT,1909,35,20-24,1944,0.24932153969268256
STAT,1824,106,na,1930,0.0023497049697470606
STAT,1867,33,45-49,1900,1.6422255107537045
STAT,1851,62,na,1913,1443.5284802800506
SIM,1883,36,na,1919,1966
SIM,1898,1,na,1899,4642
STAT,1837,55,na,1892,1657.9622387106526
STAT,1912,40,15-19,1952,0.0014805080366639353
SIM,1918,31,na,1949,4397
STAT,1863,95,na,1958,17.15419790763815
STAT,1897,49,50-100,1946,0.1801452887684142
STAT,1940,26,50-100,1966,1.0040497304773752
STAT,1792,66,na,1858,990.6594992625428
STAT,1827,33,15-19,1860,0.14455532983183914
STAT,1898,16,35-39,1914,0.7396705929455422
STAT,1965,4,na,1969,4860.686548643714
STAT,1846,91,na,1937,34.32022400164395
STAT,1916,32,20-24,1948,2.483908012007095
STAT,1944,22,30-34,1966,30.682992863660793
STAT,1870,49,35-39,1919,0.13665651022876435
SIM,1924,32,20-24,1956,14
STAT,1915,39,30-34,1954,1.7968914291771863
STAT,1887,34,50-100,1921,0.9998526521873716
STAT,1883,21,35-39,1904,5.630933001689616
STAT,1915,39,50-100,1954,0.4139390658779027
SIM,1893,46,na,1939,3003
STAT,1813,74,na,1887,841.444546446582
SIM,1906,39,30-34,1945,1
STAT,1848,25,35-39,1873,10.935656597277363
STAT,1888,46,35-39,1934,0.1620416824484265
SIM,1892,21,na,1913,3671
SIM,1866,69,na,1935,2225
STAT,1803,67,na,1870,563.9549357583414
STAT,1814,49,20-24,1863,0.03992756637493114
SIM,1788,70,na,1858,325
STAT,1813,44,35-39,1857,7.3657755102749105
STAT,1876,28,50-100,1904,0.6443938947557218
STAT,1858,17,na,1875,2047.6753955531187
STAT,1833,35,50-100,1868,0.6815118654378944
STAT,1867,40,50-100,1907,1.0091997744813328
STAT,1816,93,na,1909,24.672850602925905
STAT,1928,35,30-34,1963,2.2897963879135785
STAT,1901,41,20-24,1942,0.015489711963847672
STAT,1920,19,45-49,1939,0.5502815664644248
STAT,1929,33,45-49,1962,1.9835501967809346
STAT,1907,4,na,1911,3838.4282354533552
SIM,1920,23,30-34,1943,1
STAT,1915,15,20-24,1930,28.104357738014247
STAT,1925,28,35-39,1953,17.508658829849022
SIM,1929,39,25-29,1968,4
STAT,1838,31,25-29,1869,5.4898288268124045
STAT,1950,15,45-49,1965,0.5853475444361679
SIM,1855,18,na,1873,3381
SIM,1821,38,na,1859,2014
SIM,1938,9,na,1947,4264
SIM,1933,37,25-29,1970,1
STAT,1880,3,na,1883,3143.2703961965935
STAT,1900,69,na,1969,2376.7437109691614
SIM,1868,47,na,1915,1113
STAT,1869,57,na,1926,2027.8822334586068
STAT,1885,18,15-19,1903,5.818079470730193
SIM,1943,23,25-29,1966,15
STAT,1874,87,na,1961,303.71014979913855
STAT,1912,23,30-34,1935,27.140336122591613
STAT,1908,25,30-34,1933,37.317273468999794
STAT,1931,39,15-19,1970,0.02519982295056385
STAT,1792,63,na,1855,1107.91
STAT,1841,19,20-24,1860,25.162773961056747
STAT,1796,77,na,1873,614.4291991549879
STAT,1890,23,50-100,1913,0.49214857998837935
STAT,1855,15,25-29,1870,4.51379923821683
STAT,1944,19,50-100,1963,0.39838296152394215
STAT,1882,48,15-19,1930,3.7815182827873056E-4
STAT,1925,26,15-19,1951,0.829018555526246
STAT,1879,47,50-100,1926,0.2507716787288304
SIM,1900,33,na,1933,3802
STAT,1935,12,na,1947,5377.691671936004
STAT,1935,23,25-29,1958,124.83780834519479
SIM,1893,35,na,1928,3273
SIM,1916,25,30-34,1941,68
SIM,1821,60,na,1881,1753
STAT,1925,37,25-29,1962,1.1709342364163702
STAT,1917,19,40-44,1936,1.4722747009108532
STAT,1832,34,35-39,1866,0.688705854422644
STAT,1838,30,50-100,1868,0.4962149919205472
STAT,1922,13,na,1935,4527.408649617192
STAT,1901,54,na,1955,2927.882718433246
STAT,1902,37,50-100,1939,0.37315897839610973
SIM,1839,36,na,1875,1001
STAT,1880,22,20-24,1902,71.54181236049229
SIM,1917,35,na,1952,2043
STAT,1883,16,na,1899,2435.709681087049
STAT,1842,20,35-39,1862,1.853666833430617
SIM,1865,28,na,1893,1768
SIM,1868,17,na,1885,1326
STAT,1868,34,15-19,1902,0.13636979600605195
STAT,1903,10,na,1913,3676.99681168023
STAT,1932,18,25-29,1950,56.83377034823855
SIM,1867,43,na,1910,2079
STAT,1911,61,na,1972,3167.8075625648394
STAT,1822,59,na,1881,1211.2673713025533
STAT,1806,54,45-49,1860,0.03673251926865675
STAT,1827,104,na,1931,0.047036305660008715
STAT,1844,47,40-44,1891,0.16881522698432824
STAT,1908,42,15-19,1950,0.0014098107362951011
STAT,1910,44,20-24,1954,0.016301039799829976
STAT,1918,32,30-34,1950,16.51621086900074
SIM,1854,6,na,1860,2666
STAT,1920,30,20-24,1950,2.6585646366710667
STAT,1846,40,na,1886,1421.3865130290976
SIM,1834,59,na,1893,511
STAT,1864,21,25-29,1885,53.261640098338056
SIM,1892,10,na,1902,3699
STAT,1873,45,45-49,1918,0.244497464744654
STAT,1835,77,na,1912,654.046741372405
STAT,1925,13,na,1938,4735.265351352817
STAT,1796,88,na,1884,85.08569538919737
STAT,1923,24,45-49,1947,1.2873034953282425
STAT,1898,32,35-39,1930,13.618035740925496
STAT,1924,25,45-49,1949,2.005711229133848
STAT,1820,45,35-39,1865,0.22592519268775516
SIM,1867,54,na,1921,2035
STAT,1875,54,50-100,1929,0.015081824118445202
STAT,1839,18,45-49,1857,0.07892232247732188
STAT,1870,23,15-19,1893,3.2787436368251326
STAT,1874,15,35-39,1889,0.5710587202950747
SIM,1923,39,na,1962,4188
STAT,1821,54,40-44,1875,0.010442936695165255
STAT,1848,95,na,1943,12.441626461647452
STAT,1904,15,45-49,1919,0.09375960341418545
STAT,1951,18,35-39,1969,4.948696291160119
STAT,1946,17,45-49,1963,0.5480751630223081
STAT,1872,28,50-100,1900,0.6383073315042606
STAT,1861,69,na,1930,1220.4721209162606
SIM,1845,11,na,1856,2993
STAT,1832,44,45-49,1876,0.13387901572368893
SIM,1819,59,na,1878,1842
STAT,1860,44,na,1904,1860.0407048064194
STAT,1868,39,50-100,1907,1.1739059945297445
SIM,1911,9,na,1920,2607
STAT,1884,57,na,1941,1923.7642845950788
STAT,1883,72,na,1955,1214.959450222028
STAT,1926,38,25-29,1964,1.1917986820703543
SIM,1888,8,na,1896,676
STAT,1913,35,40-44,1948,1.4726365952082447
STAT,1871,36,na,1907,2361.501607214305
STAT,1847,42,30-34,1889,1.0452316997525932
STAT,1850,77,na,1927,399.1431519384235
STAT,1952,19,35-39,1971,4.979266693854614
STAT,1895,49,na,1944,2866.1803139147423
SIM,1908,21,na,1929,2780
STAT,1894,64,na,1958,2284.417738418654
STAT,1910,15,15-19,1925,8.93325404093873
STAT,1945,16,45-49,1961,0.5398121963767781
STAT,1926,41,25-29,1967,0.08740407124230293
SIM,1903,45,50-100,1948,1
SIM,1845,51,na,1896,2062
STAT,1919,39,50-100,1958,0.4441161763449109
STAT,1869,43,20-24,1912,0.1590977043650807
STAT,1926,38,na,1964,4553.880679472048
STAT,1882,51,45-49,1933,0.013960813200996864
SIM,1946,2,na,1948,3975
STAT,1930,38,45-49,1968,0.8820754974509787
SIM,1970,0,na,1970,5628
SIM,1846,81,na,1927,319
STAT,1884,45,20-24,1929,0.011601792349249837
STAT,1921,17,40-44,1938,1.575448470345149
STAT,1934,15,30-34,1949,16.451041246029998
STAT,1947,18,15-19,1965,50.56792247654647
SIM,1840,34,35-39,1874,2
STAT,1915,48,20-24,1963,0.010947965327618854
STAT,1879,21,15-19,1900,3.394487701164068
SIM,1854,25,na,1879,2110
STAT,1839,34,50-100,1873,1.0260337452707233
STAT,1825,47,30-34,1872,0.1229746919002627
STAT,1868,19,20-24,1887,17.2287447501918
STAT,1965,7,na,1972,4858.208013583671
STAT,1904,33,40-44,1937,3.5426435257235935
STAT,1873,94,na,1967,76.12647902895154
STAT,1910,26,25-29,1936,63.06386347096303
SIM,1960,7,na,1967,6451
STAT,1849,80,na,1929,521.2242106288955
STAT,1859,28,50-100,1887,0.5120638451784444
STAT,1851,37,30-34,1888,4.25433724613555
STAT,1902,25,na,1927,3383.4070551578143
STAT,1918,47,35-39,1965,0.13535088208419102
STAT,1935,27,40-44,1962,6.307898310343084
SIM,1806,49,na,1855,489
STAT,1913,24,30-34,1937,28.479436248084912
SIM,1908,61,na,1969,1851
STAT,1849,22,40-44,1871,2.122815429998714
STAT,1861,46,35-39,1907,0.11676058056982772
SIM,1848,19,15-19,1867,12
STAT,1924,45,30-34,1969,0.10560457074276614
STAT,1926,27,na,1953,4452.260887909407
STAT,1879,32,25-29,1911,10.507271620874596
STAT,1919,40,25-29,1959,0.07656919072181348
SIM,1855,42,30-34,1897,1
STAT,1935,16,30-34,1951,16.583568139622727
SIM,1887,32,25-29,1919,3
STAT,1817,54,20-24,1871,4.797135220123139E-4
SIM,1824,89,na,1913,375
STAT,1856,39,na,1895,1675.157847225628
STAT,1892,38,30-34,1930,6.565788728052899
SIM,1880,17,na,1897,3279
STAT,1949,15,na,1964,4240.87348816741
SIM,1847,77,na,1924,1382
STAT,1919,15,35-39,1934,0.9222439453935939
STAT,1895,48,50-100,1943,0.17795689335739287
STAT,1852,50,20-24,1902,7.534548174413007E-4
STAT,1857,54,20-24,1911,5.506793446964191E-4
SIM,1932,35,na,1967,6247
STAT,1919,48,35-39,1967,0.1376012722281549
SIM,1858,69,na,1927,2126
STAT,1841,47,15-19,1888,4.474449255558925E-4
STAT,1919,26,45-49,1945,1.848199976756492
STAT,1802,109,na,1911,3.6047330143982475E-4
STAT,1838,20,15-19,1858,1.8536338809063462
STAT,1848,21,40-44,1869,2.3914652584524787
SIM,1912,33,40-44,1945,1
STAT,1902,33,15-19,1935,0.19968660254489667
STAT,1871,50,30-34,1921,0.006023258341779329
SIM,1869,24,25-29,1893,662
STAT,1911,21,na,1932,3589.2613987024424
STAT,1915,35,na,1950,3782.486586776868
STAT,1912,42,35-39,1954,0.19195569271010782
STAT,1853,104,na,1957,0.07693268462817512
STAT,1914,50,na,1964,3560.4637785148766
STAT,1864,80,na,1944,562.3696928588859
SIM,1814,44,35-39,1858,4
SIM,1882,43,na,1925,1747
STAT,1841,49,50-100,1890,0.2677812742715694
STAT,1824,37,na,1861,563.3526662101244
STAT,1873,35,35-39,1908,7.324162795209324
STAT,1909,26,30-34,1935,37.50830272900289
STAT,1895,33,20-24,1928,3.501495795172081
STAT,1857,31,35-39,1888,7.900711278648613
STAT,1913,43,35-39,1956,0.19359952267806457
SIM,1866,80,na,1946,637
SIM,1888,13,na,1901,667
SIM,1867,3,na,1870,3840
STAT,1935,35,35-39,1970,3.3636597091557223
SIM,1892,50,na,1942,3507
SIM,1943,27,na,1970,4366
SIM,1911,21,30-34,1932,49
SIM,1955,4,na,1959,3825
SIM,1868,23,25-29,1891,327
STAT,1868,44,25-29,1912,0.6118686791468
STAT,1909,37,40-44,1946,1.4025291596403655
SIM,1947,12,na,1959,4369
STAT,1875,72,na,1947,1296.8064422654918
STAT,1813,41,50-100,1854,6.581118909571021
STAT,1828,42,20-24,1870,0.19859174564522025
STAT,1858,32,35-39,1890,7.733678766121642
STAT,1880,35,35-39,1915,7.412520231615073
SIM,1881,35,35-39,1916,3
STAT,1860,84,na,1944,271.384027099953
STAT,1836,70,na,1906,1073.8245766190348
STAT,1804,60,na,1864,1874.3089869380149
STAT,1897,22,50-100,1919,0.5415668435426425
STAT,1879,36,40-44,1915,4.512230383478195
SIM,1837,53,na,1890,1705
STAT,1820,42,30-34,1862,1.8980900786574857
STAT,1863,29,40-44,1892,2.539071876718263
SIM,1884,55,na,1939,3654
STAT,1892,39,20-24,1931,0.9447778089915315
STAT,1902,44,40-44,1946,0.21697780594805186
STAT,1822,50,40-44,1872,0.017652060207598907
STAT,1903,34,50-100,1937,0.7404225839920225
SIM,1818,37,30-34,1855,2
SIM,1919,20,15-19,1939,29
STAT,1936,27,35-39,1963,14.22564459017554
STAT,1879,20,25-29,1899,59.075215048970236
STAT,1942,14,na,1956,4056.672054227527
SIM,1833,63,na,1896,1984
SIM,1797,61,na,1858,1587
SIM,1924,8,na,1932,5281
STAT,1805,53,45-49,1858,0.01665227155208767
SIM,1928,20,25-29,1948,60
STAT,1837,26,35-39,1863,10.001970973960594
STAT,1855,20,na,1875,1677.175135031516
STAT,1877,28,30-34,1905,25.47267826858795
SIM,1793,71,na,1864,740
SIM,1829,58,na,1887,1785
STAT,1856,20,30-34,1876,15.074418848444644
STAT,1931,18,45-49,1949,0.6475533995769124
STAT,1869,2,na,1871,3366.9009866228057
SIM,1936,6,na,1942,4057
STAT,1851,30,na,1881,2002.7891829589482
STAT,1868,72,na,1940,1219.793385402748
SIM,1789,66,na,1855,303
STAT,1888,43,50-100,1931,1.210510337442527
STAT,1900,25,20-24,1925,16.361663361414113
STAT,1930,20,15-19,1950,6.811874565294272
STAT,1875,15,15-19,1890,6.122219841791348
STAT,1854,45,35-39,1899,0.07861853123902514
STAT,1894,47,30-34,1941,0.06911298614527614
SIM,1808,64,na,1872,1261
STAT,1871,24,15-19,1895,3.2703186673038585
STAT,1843,37,15-19,1880,0.06477174509409722
STAT,1916,28,20-24,1944,18.550952449379885
SIM,1905,64,na,1969,2064
STAT,1872,44,45-49,1916,1.47844570142853
STAT,1916,35,25-29,1951,1.0039860524132362
SIM,1871,35,35-39,1906,6
STAT,1848,48,15-19,1896,3.696062945007728E-4
STAT,1914,27,15-19,1941,0.7017749143711534
STAT,1848,20,50-100,1868,0.4713816695932865
SIM,1861,60,na,1921,1689
STAT,1814,48,45-49,1862,0.795978011107262
SIM,1924,15,15-19,1939,175
STAT,1856,45,45-49,1901,0.17119775935369644
STAT,1887,31,15-19,1918,0.15738486490534317
STAT,1787,106,na,1893,0.0021859759846688492
STAT,1847,42,25-29,1889,0.5838231139622299
STAT,1867,21,45-49,1888,0.6669836891048336
SIM,1859,56,na,1915,1535
STAT,1909,38,30-34,1947,1.6990994918173976
STAT,1831,45,40-44,1876,0.16565212673553853
STAT,1825,48,20-24,1873,0.015044140832440128
STAT,1917,13,na,1930,4186.638800922481
STAT,1843,17,20-24,1860,22.384986731698998
STAT,1917,15,na,1932,4119.799244521501
STAT,1848,32,50-100,1880,0.9998800322397794
SIM,1831,62,na,1893,1986
STAT,1908,29,40-44,1937,4.340877198884984
SIM,1892,72,na,1964,3096
STAT,1845,34,15-19,1879,0.08229421388568452
STAT,1885,42,na,1927,2269.0346454116093
STAT,1840,78,na,1918,307.6533421836405
STAT,1786,89,na,1875,71.20088731405436
STAT,1927,34,30-34,1961,19.19804809550083
STAT,1942,18,20-24,1960,140.01832955099002
STAT,1920,37,40-44,1957,1.6179526214004838
STAT,1946,26,na,1972,4129.739667065592
SIM,1880,44,45-49,1924,16
STAT,1934,19,40-44,1953,1.8690167405005764
STAT,1844,16,25-29,1860,7.1785941147672325
STAT,1848,9,na,1857,2826.2089855045915
STAT,1905,28,45-49,1933,1.5913504421288205
STAT,1941,29,25-29,1970,67.2483530202847
STAT,1872,24,na,1896,2353.438365571229
SIM,1905,42,na,1947,3090
STAT,1792,95,na,1887,3.4277042483259046
STAT,1880,25,25-29,1905,44.21334495949345
STAT,1910,47,25-29,1957,0.048937690090308156
STAT,1852,17,30-34,1869,1.9404243980164584
STAT,1874,25,na,1899,2479.760859443081
STAT,1919,41,15-19,1960,0.0016444593291446686
STAT,1863,16,35-39,1879,0.5377008655515568
STAT,1889,49,15-19,1938,2.6603988833897647E-4
STAT,1894,34,25-29,1928,12.913579571810159
SIM,1930,31,na,1961,5295
STAT,1929,31,30-34,1960,19.88380590191119
STAT,1899,49,15-19,1948,3.0175023558189843E-4
STAT,1875,34,15-19,1909,0.1449796597582703
STAT,1902,28,35-39,1930,13.539412136595391
STAT,1826,47,25-29,1873,0.08243090608565261
STAT,1943,17,25-29,1960,45.42921331687604
STAT,1866,49,20-24,1915,0.01072511748419579
SIM,1879,43,25-29,1922,8
STAT,1821,38,35-39,1859,8.497474469685464
STAT,1843,44,20-24,1887,0.15747392991138884
STAT,1831,43,45-49,1874,1.443198042972173
STAT,1851,31,35-39,1882,8.411670088456843
STAT,1920,17,30-34,1937,13.499266751792982
SIM,1896,9,na,1905,4109
STAT,1837,39,40-44,1876,4.185656410207648
STAT,1885,50,na,1935,2146.8691485297095
STAT,1876,54,30-34,1930,0.005852003360898314
STAT,1827,43,25-29,1870,0.6012895930199523
STAT,1924,22,40-44,1946,3.929421435211726
STAT,1869,17,40-44,1886,0.18711991839374684
STAT,1890,15,40-44,1905,0.22245253880479662
STAT,1820,39,30-34,1859,9.13987245038271
STAT,1868,70,na,1938,1355.1884860558832
STAT,1882,22,25-29,1904,54.80753588332423
STAT,1844,68,na,1912,1513.9683379650203
SIM,1937,31,30-34,1968,3
STAT,1842,87,na,1929,43.73590523582689
SIM,1890,35,45-49,1925,43
STAT,1877,37,50-100,1914,1.2463066613415679
STAT,1817,80,na,1897,195.96476489553027
STAT,1857,19,15-19,1876,5.289589068306757
STAT,1872,46,40-44,1918,0.17191949168317544
STAT,1884,18,20-24,1902,16.926569651314377
STAT,1886,28,40-44,1914,3.0911372578897494
STAT,1922,25,40-44,1947,5.2508017162786444
STAT,1895,46,35-39,1941,0.10302373342953673
STAT,1942,25,25-29,1967,68.35232018165944
STAT,1878,15,na,1893,2610.5915351621334
SIM,1844,80,na,1924,719
STAT,1909,15,50-100,1924,0.07306145309739029
SIM,1895,15,na,1910,4648
STAT,1819,37,40-44,1856,1.1742795068144039
STAT,1877,55,na,1932,2098.978114583354
SIM,1821,34,25-29,1855,39
SIM,1842,22,na,1864,3355
SIM,1884,38,25-29,1922,10
SIM,1891,25,na,1916,1880
STAT,1849,38,20-24,1887,0.6577559933410281
SIM,1884,23,na,1907,3075
STAT,1888,40,20-24,1928,0.18514576200082383
STAT,1869,46,25-29,1915,0.058288138290901306
SIM,1839,34,na,1873,985
STAT,1846,54,45-49,1900,0.008358774330754316
STAT,1908,30,na,1938,3570.8169202746712
STAT,1835,43,50-100,1878,0.9455769927478709
STAT,1864,28,45-49,1892,1.005830368637924
STAT,1915,19,15-19,1934,9.314087886493912
SIM,1842,31,35-39,1873,152
STAT,1886,35,15-19,1921,0.058703127841577024
STAT,1899,29,20-24,1928,15.909081909099172
STAT,1819,61,na,1880,477.43685994414545
STAT,1897,53,na,1950,2813.6830011294114
STAT,1951,6,na,1957,4637.687763116792
STAT,1819,44,15-19,1863,0.0026241372289339164
STAT,1917,47,na,1964,3786.0736842171204
SIM,1886,24,30-34,1910,294
STAT,1938,17,na,1955,3591.9754539624378
STAT,1894,1,na,1895,3461.2847488019534
STAT,1850,6,na,1856,1407.707064768
STAT,1915,39,25-29,1954,0.9707344449164341
SIM,1904,17,na,1921,4008
SIM,1857,49,20-24,1906,1
STAT,1859,20,40-44,1879,1.9104152217889314
STAT,1878,21,20-24,1899,71.11600384772613
STAT,1838,35,40-44,1873,2.3021548975626205
SIM,1906,39,25-29,1945,1
SIM,1855,72,na,1927,2200
STAT,1917,24,20-24,1941,115.87170032605974
STAT,1928,40,50-100,1968,0.14903909044410785
STAT,1934,24,20-24,1958,148.31993033964852
STAT,1904,16,35-39,1920,0.7858638884233071
STAT,1859,27,25-29,1886,34.10651674212913
STAT,1878,24,30-34,1902,18.211782926394747
STAT,1860,23,15-19,1883,2.7544443960598985
STAT,1871,29,35-39,1900,9.556433793010934
STAT,1904,40,na,1944,3346.896708849602
STAT,1908,49,35-39,1957,0.11502009594575308
SIM,1923,39,25-29,1962,4
STAT,1904,36,45-49,1940,0.6176931678022095
SIM,1852,16,25-29,1868,8
STAT,1827,88,na,1915,96.81122857635438
STAT,1855,46,40-44,1901,0.11362810181631412
STAT,1925,21,45-49,1946,1.3385291784758928
SIM,1935,34,30-34,1969,1
STAT,1858,38,30-34,1896,4.04982104095048
STAT,1826,63,na,1889,1438.5323446011964
STAT,1834,31,35-39,1865,5.776628759464677
STAT,1841,38,na,1879,2781.0179633746475
STAT,1917,44,15-19,1961,0.0015759637568261119
SIM,1867,27,25-29,1894,467
STAT,1867,48,25-29,1915,0.053789582812942174
SIM,1862,20,na,1882,2956
STAT,1853,33,25-29,1886,8.094129624247826
SIM,1867,51,na,1918,2035
SIM,1833,41,35-39,1874,19
STAT,1868,27,na,1895,2305.0732487961354
STAT,1877,25,50-100,1902,0.6537702638583807
STAT,1813,49,40-44,1862,0.6047810845251645
STAT,1943,3,na,1946,4215.440872402182
STAT,1826,49,na,1875,1985.100850194373
STAT,1830,49,40-44,1879,0.14260583756260317
STAT,1858,94,na,1952,15.26265403682182
STAT,1892,32,35-39,1924,12.538257951533133
STAT,1881,39,45-49,1920,1.8635977409402642
STAT,1918,23,25-29,1941,97.97551544257773
SIM,1905,10,na,1915,3866
SIM,1876,26,na,1902,3870
SIM,1884,77,na,1961,1955
STAT,1895,36,25-29,1931,3.7634955117716595
STAT,1897,75,na,1972,1835.7559663390143
STAT,1935,31,50-100,1966,1.1362914293310709
SIM,1883,32,35-39,1915,1
STAT,1875,32,35-39,1907,10.399000257334007
STAT,1909,18,na,1927,3739.1885703303037
STAT,1837,26,50-100,1863,0.6630979534355081
STAT,1840,38,45-49,1878,0.9188070121093468
STAT,1831,93,na,1924,22.873255606796754
STAT,1937,23,35-39,1960,9.071477353054789
STAT,1908,21,45-49,1929,1.029502170698634
SIM,1813,43,na,1856,246
STAT,1829,102,na,1931,0.10705855644231646
STAT,1889,24,na,1913,2830.221401571
STAT,1809,102,na,1911,0.285369516402752
STAT,1839,99,na,1938,1.7595276465462322
STAT,1850,103,na,1953,0.06626973409204431
STAT,1899,16,15-19,1915,8.12571680671361
SIM,1821,52,na,1873,1900
STAT,1825,41,35-39,1866,2.447517102333629
SIM,1926,23,25-29,1949,1024
STAT,1867,28,30-34,1895,23.731449844318448
STAT,1889,25,45-49,1914,1.3461258130257787
STAT,1839,23,35-39,1862,6.916028317487286
STAT,1853,46,30-34,1899,0.07527072857330191
SIM,1854,33,na,1887,1876
STAT,1776,79,na,1855,500.2634999999999
STAT,1834,33,15-19,1867,0.07956187715236994
STAT,1896,34,na,1930,3118.771289042299
SIM,1925,39,35-39,1964,2
STAT,1914,20,30-34,1934,27.951215221830473
SIM,1880,20,15-19,1900,77
STAT,1834,50,na,1884,1012.2676250131381
STAT,1861,43,30-34,1904,0.9492067383207392
STAT,1826,41,na,1867,2187.718492286906
STAT,1839,81,na,1920,502.40596830089765
STAT,1862,39,35-39,1901,5.963665503776172
STAT,1858,2,na,1860,2671.575265957295
STAT,1893,71,na,1964,1915.4933030686786
STAT,1908,34,20-24,1942,2.2650062316153514
SIM,1848,19,na,1867,2584
STAT,1848,50,na,1898,2043.834201990942
STAT,1917,39,35-39,1956,2.4636804519859523
SIM,1914,25,na,1939,5026
SIM,1845,23,30-34,1868,83
STAT,1891,23,50-100,1914,0.4999220421582951
STAT,1904,30,15-19,1934,0.2050926830618402
STAT,1849,25,15-19,1874,0.45974247671315804
STAT,1860,17,20-24,1877,16.6802406806907
STAT,1864,66,na,1930,1490.034204870708
STAT,1837,23,30-34,1860,18.562524220620414
STAT,1805,50,40-44,1855,0.012847273023753235
SIM,1895,47,na,1942,4386
STAT,1934,36,30-34,1970,2.5003418734932366
STAT,1911,23,15-19,1934,4.9761934014269205
STAT,1829,34,30-34,1863,9.174484792514884
STAT,1894,28,30-34,1922,31.91005761395618
STAT,1846,29,40-44,1875,2.1155792187659768
SIM,1892,24,15-19,1916,58
STAT,1903,24,35-39,1927,8.231673065983625
SIM,1842,54,na,1896,3011
STAT,1786,104,na,1890,0.06569645493631857
STAT,1877,87,na,1964,356.204027617929
STAT,1852,34,20-24,1886,2.759230828172366
STAT,1835,37,25-29,1872,2.693233323661845
STAT,1839,20,30-34,1859,21.57189067417273
STAT,1919,47,45-49,1966,0.2326030665290432
STAT,1809,69,na,1878,1741.8525126778616
STAT,1837,45,35-39,1882,0.11955262091261329
STAT,1853,29,50-100,1882,0.5154094412075438
SIM,1925,19,na,1944,4621
STAT,1866,42,35-39,1908,1.6509096618919903
STAT,1919,27,35-39,1946,16.006583785893405
STAT,1898,39,15-19,1937,0.016134559839023198
STAT,1897,46,45-49,1943,0.17729708096473304
STAT,1872,41,40-44,1913,2.2625252180953894
SIM,1853,49,na,1902,3151
STAT,1853,52,50-100,1905,0.011648160262319813
SIM,1898,39,20-24,1937,3
STAT,1840,24,50-100,1864,0.20127470058242425
STAT,1828,45,25-29,1873,0.07061497412359469
STAT,1864,35,50-100,1899,1.1267486961459807
SIM,1817,55,na,1872,2287
SIM,1909,23,25-29,1932,1
STAT,1856,23,35-39,1879,4.8329147036855815
STAT,1856,32,25-29,1888,7.44685854705647
STAT,1858,31,45-49,1889,1.3455947458840647
SIM,1837,34,30-34,1871,9
STAT,1871,9,na,1880,2687.948546599362
SIM,1936,28,na,1964,3510
STAT,1884,24,15-19,1908,3.1382946071704785
STAT,1898,20,35-39,1918,7.893888128406568
STAT,1843,19,na,1862,2864.305559227069
SIM,1900,18,25-29,1918,8
STAT,1891,36,50-100,1927,1.517057276884968
STAT,1932,39,50-100,1971,0.5590007193246802
STAT,1900,28,25-29,1928,58.393271324231975
SIM,1879,52,50-100,1931,3
STAT,1924,17,na,1941,4341.064668498406
STAT,1839,67,na,1906,1472.7721442250204
SIM,1885,34,25-29,1919,2
STAT,1873,20,30-34,1893,18.38049512721749
STAT,1897,21,na,1918,3150.3900627260177
STAT,1877,34,25-29,1911,10.308457029694079
STAT,1841,71,na,1912,1486.3872787731436
SIM,1921,43,50-100,1964,1
STAT,1858,48,15-19,1906,3.016272783907178E-4
STAT,1901,29,30-34,1930,34.958064247950034
STAT,1943,29,35-39,1972,15.791417007235323
SIM,1847,85,na,1932,1018
STAT,1848,24,45-49,1872,0.7831606411966372
STAT,1849,44,15-19,1893,0.011478985439374248
STAT,1794,76,na,1870,4.680200215983379
STAT,1826,44,20-24,1870,0.2304177059869411
STAT,1924,29,25-29,1953,75.35814925095262
STAT,1908,46,30-34,1954,0.08059996396639829
STAT,1817,53,50-100,1870,0.01001480470600727
STAT,1838,38,45-49,1876,1.016231536524005
STAT,1842,27,15-19,1869,0.13928278100598715
STAT,1862,34,15-19,1896,0.12025598328612534
STAT,1920,32,50-100,1952,0.8939776352494884
STAT,1867,23,na,1890,2229.786171751757
STAT,1864,39,45-49,1903,1.7940511237845789
STAT,1939,16,na,1955,3644.877152636568
STAT,1858,28,20-24,1886,9.105326965773884
SIM,1851,39,na,1890,1185
STAT,1853,27,30-34,1880,22.619721512180938
STAT,1833,53,20-24,1886,3.1955245618511086E-4
STAT,1834,36,na,1870,1186.3294171850384
SIM,1893,17,25-29,1910,7
STAT,1905,44,na,1949,3290.757437428849
STAT,1933,15,15-19,1948,60.6201112510689
STAT,1941,26,20-24,1967,18.67686474617852
STAT,1834,27,20-24,1861,6.7795951754221875
STAT,1826,43,50-100,1869,1.5597299192924217
STAT,1876,38,25-29,1914,2.8961669592265564
STAT,1885,17,25-29,1902,5.5701070963276
SIM,1872,52,na,1924,2251
SIM,1931,17,15-19,1948,1233
STAT,1864,25,40-44,1889,2.7523933515408
STAT,1928,20,15-19,1948,6.635082119782507
STAT,1805,79,na,1884,116.46952862777498
STAT,1931,27,15-19,1958,0.905010739165711
SIM,1921,40,na,1961,5173
STAT,1923,17,15-19,1940,52.73020579683911
STAT,1886,16,50-100,1902,0.050858147352859935
SIM,1918,34,30-34,1952,17
STAT,1822,53,45-49,1875,0.022925133457439316
STAT,1860,21,35-39,1881,4.942925746309971
STAT,1809,47,25-29,1856,0.5067393079942689
STAT,1844,60,na,1904,1889.4217219062853
STAT,1854,39,40-44,1893,2.4094721383897446
SIM,1864,57,na,1921,2415
STAT,1878,41,15-19,1919,0.014272798914090693
STAT,1941,22,40-44,1963,3.4352299417941006
STAT,1819,93,na,1912,6.797603408033577
STAT,1831,40,40-44,1871,2.25814999855951
STAT,1854,35,25-29,1889,1.6253798502222419
STAT,1922,16,na,1938,4222.617740117112
SIM,1932,29,25-29,1961,228
STAT,1893,35,20-24,1928,0.9731228981839597
SIM,1800,76,na,1876,216
SIM,1951,17,na,1968,2365
STAT,1926,17,25-29,1943,52.67555970781006
STAT,1829,30,15-19,1859,0.08274352212766467
STAT,1880,0,na,1880,3743.640410331863
SIM,1926,35,35-39,1961,4
SIM,1875,28,30-34,1903,9
SIM,1908,27,25-29,1935,131
STAT,1850,37,15-19,1887,0.02634063994681736
STAT,1806,94,na,1900,6.018175932195145
STAT,1875,28,20-24,1903,12.004063290170498
SIM,1886,27,35-39,1913,272
STAT,1934,27,25-29,1961,87.94490620669355
SIM,1888,21,30-34,1909,2
STAT,1801,107,na,1908,0.0015645088833899242
STAT,1815,44,45-49,1859,0.15372729542915758
STAT,1884,38,15-19,1922,0.05348858611825307
STAT,1936,21,20-24,1957,105.28714705059774
SIM,1855,30,30-34,1885,50
STAT,1932,19,15-19,1951,59.35618249861536
SIM,1859,22,15-19,1881,33
STAT,1854,20,20-24,1874,45.67414317607835
STAT,1859,24,20-24,1883,55.85876387997684
STAT,1863,30,15-19,1893,0.1225524207522342
STAT,1838,52,25-29,1890,0.0015039675304416565
STAT,1935,28,30-34,1963,53.00124536420124
SIM,1862,76,na,1938,2089
STAT,1882,35,45-49,1917,1.9267106837991055
SIM,1890,25,35-39,1915,3
SIM,1904,15,na,1919,4130
STAT,1925,25,25-29,1950,77.55264419767677
STAT,1831,95,na,1926,10.405753650309597
STAT,1896,21,15-19,1917,4.3619975366511134
STAT,1947,20,25-29,1967,103.36621506421996
STAT,1866,22,40-44,1888,1.9176708734751209
STAT,1878,27,35-39,1905,9.927485596250438
STAT,1878,46,35-39,1924,0.14445065380136035
STAT,1914,58,na,1972,3408.2699833393103
STAT,1862,51,25-29,1913,0.003031312298345432
SIM,1837,21,na,1858,2294
STAT,1897,19,45-49,1916,0.08628644791271861
SIM,1886,36,na,1922,3028
STAT,1810,49,50-100,1859,0.0012558515516379533
SIM,1833,31,na,1864,2293
STAT,1880,51,40-44,1931,0.01098161887017657
STAT,1901,17,20-24,1918,24.78830186365943
SIM,1911,46,50-100,1957,1
STAT,1930,26,45-49,1956,2.1822919204496753
STAT,1939,20,35-39,1959,9.358774115044394
STAT,1918,35,35-39,1953,2.5389157667109417
SIM,1810,54,na,1864,3098
STAT,1890,18,45-49,1908,0.07887270988704169
SIM,1863,20,15-19,1883,15
SIM,1876,38,30-34,1914,20
SIM,1933,25,25-29,1958,4
STAT,1913,31,na,1944,3730.839187835976
STAT,1845,27,40-44,1872,1.8092745847748881
SIM,1871,37,na,1908,1879
STAT,1828,49,40-44,1877,0.19907057008727835
STAT,1823,107,na,1930,0.003725494932777319
STAT,1818,97,na,1915,3.2698489681833154
STAT,1945,17,35-39,1962,4.533153651164509
STAT,1803,51,50-100,1854,0.033721151272840894
SIM,1851,47,25-29,1898,2
STAT,1877,40,45-49,1917,1.5345998801479617
STAT,1882,25,35-39,1907,9.300656594753702
STAT,1915,36,20-24,1951,0.26380114509306485
STAT,1862,43,50-100,1905,0.8933232892992414
STAT,1899,32,45-49,1931,2.3818296969123764
STAT,1849,42,35-39,1891,1.523898503909046
SIM,1937,8,na,1945,2988
STAT,1868,38,30-34,1906,5.122151353551019
SIM,1897,28,na,1925,2113
STAT,1928,16,45-49,1944,0.6261838997110897
STAT,1841,21,25-29,1862,81.33839983300741
STAT,1903,46,50-100,1949,0.19721580272840994
SIM,1875,6,na,1881,3301
SIM,1783,79,na,1862,1461
STAT,1859,23,45-49,1882,0.5693193402888448
STAT,1906,24,45-49,1930,1.0034500724710336
STAT,1854,24,50-100,1878,0.26259806292902826
STAT,1843,47,25-29,1890,0.05664605255688644
STAT,1881,38,na,1919,2213.8264605808954
STAT,1790,86,na,1876,97.34197986805638
STAT,1859,36,na,1895,1876.3176735956747
STAT,1871,90,na,1961,148.19076781525564
STAT,1824,49,50-100,1873,0.041678644925812275
SIM,1884,28,15-19,1912,4
STAT,1927,37,35-39,1964,2.982735867771113
STAT,1855,48,50-100,1903,0.160504628077443
STAT,1871,17,40-44,1888,0.18363213424325403
SIM,1851,82,na,1933,438
STAT,1861,27,25-29,1888,35.43526663818343
STAT,1925,10,na,1935,4756.9716165972595
SIM,1912,44,na,1956,4576
SIM,1943,28,30-34,1971,113
STAT,1836,49,35-39,1885,0.10942949433070764
STAT,1841,34,45-49,1875,2.3076303984936444
SIM,1838,42,25-29,1880,1
SIM,1862,74,na,1936,2633
SIM,1944,15,na,1959,2509
STAT,1801,63,na,1864,783.8364882612809
STAT,1828,30,20-24,1858,4.364861675131258
STAT,1933,37,50-100,1970,0.5679903540720391
STAT,1837,40,15-19,1877,0.013405451041125853
STAT,1822,34,35-39,1856,22.61426967054287
STAT,1864,88,na,1952,124.80535641645825
SIM,1916,5,na,1921,4952
STAT,1908,37,25-29,1945,0.9147254283773043
SIM,1844,49,35-39,1893,2
STAT,1847,30,30-34,1877,18.923272411157456
STAT,1886,18,30-34,1904,1.6462072697617143
STAT,1867,45,20-24,1912,0.011461903466066414
STAT,1817,47,15-19,1864,2.8022516187602376E-4
STAT,1917,15,30-34,1932,2.5999391017567786
SIM,1912,8,na,1920,4883
STAT,1906,28,50-100,1934,0.9230595972175547
STAT,1851,48,na,1899,1754.580630618629
STAT,1919,28,na,1947,3979.869215761513
SIM,1921,29,na,1950,5238
STAT,1876,28,15-19,1904,0.4570370883062173
STAT,1891,38,15-19,1929,0.0687123667893315
STAT,1810,48,na,1858,90.22730754324982
STAT,1950,19,25-29,1969,50.718002304738526
SIM,1848,32,40-44,1880,4
SIM,1901,52,na,1953,3325
STAT,1893,18,30-34,1911,1.9879559529712758
STAT,1827,37,30-34,1864,5.255360598227855
STAT,1851,38,20-24,1889,0.6089740190310589
SIM,1887,39,45-49,1926,4
SIM,1929,30,25-29,1959,314
STAT,1874,54,20-24,1928,7.406388869126877E-4
STAT,1862,22,na,1884,2062.127967201654
STAT,1924,46,15-19,1970,4.3541775145925307E-4
STAT,1883,28,15-19,1911,0.434945026597935
STAT,1907,25,15-19,1932,0.6664871506383344
SIM,1928,39,45-49,1967,1
STAT,1864,48,50-100,1912,0.22047099380930918
SIM,1834,27,30-34,1861,23
STAT,1812,45,30-34,1857,0.026057166734213755
SIM,1927,43,na,1970,1553
STAT,1879,39,45-49,1918,2.0244160942063374
STAT,1897,33,25-29,1930,13.545307105645131
SIM,1865,50,na,1915,1666
STAT,1848,22,30-34,1870,20.295338887088064
SIM,1843,39,na,1882,38
SIM,1881,66,na,1947,1140
STAT,1922,15,50-100,1937,0.43074931968356056
STAT,1908,19,na,1927,3697.5605213782574
STAT,1902,21,50-100,1923,0.5759679809632556
SIM,1871,59,na,1930,1634
STAT,1853,74,na,1927,860.5175171950526
STAT,1928,16,50-100,1944,0.46963792478331723
STAT,1939,22,50-100,1961,0.6535512765446331
STAT,1921,7,na,1928,4502.404050867831
STAT,1878,24,25-29,1902,58.529535197309194
STAT,1933,21,50-100,1954,0.8694918131401849
STAT,1853,49,35-39,1902,0.10628788443608829
STAT,1835,34,20-24,1869,2.5502852602943333
STAT,1881,2,na,1883,3011.9375749465607
STAT,1846,34,30-34,1880,11.96897317160377
SIM,1826,69,na,1895,971
STAT,1860,27,30-34,1887,20.763310450076975
STAT,1881,51,35-39,1932,0.008168844508649634
SIM,1927,11,na,1938,1973
STAT,1865,29,15-19,1894,0.41126581309338317
STAT,1916,31,45-49,1947,1.6089902407828667
STAT,1808,84,na,1892,77.91096190925062
STAT,1895,21,20-24,1916,89.91701696449381
STAT,1917,36,30-34,1953,1.876764405986405
SIM,1902,23,15-19,1925,26
STAT,1850,24,45-49,1874,0.38094705164503906
STAT,1912,27,40-44,1939,4.539911023697393
SIM,1906,41,na,1947,3445
SIM,1850,51,na,1901,1227
STAT,1804,94,na,1898,12.663186750480145
STAT,1831,61,na,1892,1462.487709602456
STAT,1835,30,50-100,1865,0.9011218783312986
SIM,1831,35,40-44,1866,76
STAT,1789,75,na,1864,698.0221396320002
STAT,1877,45,15-19,1922,4.100959197318106E-4
STAT,1957,10,na,1967,5135.067330259589
SIM,1925,36,30-34,1961,5
SIM,1875,49,na,1924,2631
STAT,1847,57,na,1904,1816.9414621200578
STAT,1919,24,30-34,1943,30.859734677817276
STAT,1944,25,35-39,1969,16.058092382100433
STAT,1950,16,20-24,1966,158.82363966262693
SIM,1899,51,na,1950,1549
STAT,1931,20,30-34,1951,37.23563597192398
STAT,1893,47,15-19,1940,2.808450488333387E-4
STAT,1886,66,na,1952,1697.27711950673
STAT,1912,38,na,1950,3611.3098270404034
STAT,1824,34,45-49,1858,0.7150823920114538
STAT,1858,34,15-19,1892,0.1078205681744568
STAT,1883,19,na,1902,2416.7119830878632
STAT,1873,15,40-44,1888,0.1898480541999958
SIM,1897,41,na,1938,2516
STAT,1930,1,na,1931,5361.113765463673
STAT,1908,3,na,1911,3891.235749307224
SIM,1845,35,25-29,1880,14
STAT,1857,64,na,1921,1333.9491856447817
STAT,1950,16,50-100,1966,0.43890090566254414
STAT,1875,41,50-100,1916,1.0897285237857273
STAT,1895,27,50-100,1922,0.8321582230527472
STAT,1903,63,na,1966,2778.1676347871808
STAT,1872,24,30-34,1896,17.724840998743183
STAT,1951,15,25-29,1966,51.15053836545959
STAT,1857,86,na,1943,170.2592241357033
SIM,1925,33,na,1958,4723
STAT,1946,26,40-44,1972,5.138313711526938
STAT,1883,22,40-44,1905,2.004714113598566
STAT,1939,19,25-29,1958,42.87198521942936
STAT,1900,21,40-44,1921,2.8953851174950684
STAT,1942,21,45-49,1963,1.1666430832514632
STAT,1837,35,25-29,1872,2.8697689141302
STAT,1840,21,na,1861,1078.3861119756996
STAT,1853,96,na,1949,6.6579972017255935
STAT,1795,60,na,1855,1171.56605
STAT,1853,24,20-24,1877,62.23112750709102
STAT,1857,35,45-49,1892,1.5442527772516452
SIM,1861,24,20-24,1885,2
STAT,1834,39,na,1873,1149.9435365735094
STAT,1855,52,na,1907,1417.458663123156
STAT,1875,33,50-100,1908,0.936878402170706
STAT,1787,97,na,1884,0.45762472785984876
SIM,1873,37,na,1910,2223
STAT,1899,35,15-19,1934,0.07742810541337153
STAT,1847,25,40-44,1872,3.3025408144077995
STAT,1849,48,30-34,1897,0.08053805335790215
SIM,1862,20,20-24,1882,151
STAT,1906,29,na,1935,3431.1563680117156
STAT,1873,23,35-39,1896,5.967420067797073
SIM,1845,23,25-29,1868,456
STAT,1837,23,25-29,1860,59.65675733742036
STAT,1839,19,20-24,1858,21.293361638743303
STAT,1836,33,25-29,1869,9.818351039703265
STAT,1821,33,15-19,1854,0.19867032372776483
STAT,1912,20,20-24,1932,105.95493642208265
STAT,1930,34,50-100,1964,1.0581495661396993
STAT,1913,26,45-49,1939,1.7056430964581277
SIM,1860,19,na,1879,2353
STAT,1924,26,20-24,1950,21.121753641190033
STAT,1854,46,25-29,1900,0.03211754754681731
STAT,1887,36,35-39,1923,7.8224445369120925
STAT,1864,37,na,1901,2141.833336663618
SIM,1862,46,25-29,1908,1
STAT,1841,24,35-39,1865,8.114122618558119
STAT,1842,34,na,1876,636.5694064554815
SIM,1876,17,25-29,1893,185
STAT,1868,17,25-29,1885,5.572427057327176
STAT,1789,78,na,1867,525.2639326220103
STAT,1804,62,na,1866,1739.6203184406954
STAT,1864,36,40-44,1900,3.998768836812499
STAT,1832,27,na,1859,2420.4257987747756
SIM,1895,36,35-39,1931,4
STAT,1871,43,20-24,1914,0.15727851623244946
STAT,1944,17,40-44,1961,1.4882937414806496
STAT,1827,34,20-24,1861,2.7066928013721103
STAT,1856,37,na,1893,1692.188976589344
STAT,1877,24,15-19,1901,3.3279416834869178
STAT,1853,44,15-19,1897,0.010563448090386743
SIM,1920,20,20-24,1940,1090
STAT,1922,48,na,1970,4161.808593588952
STAT,1926,45,50-100,1971,0.2779883765493875
SIM,1828,42,na,1870,1736
STAT,1900,44,30-34,1944,0.10910188510224972
STAT,1836,44,15-19,1880,0.01227034353163806
STAT,1911,27,30-34,1938,37.780994332610526
SIM,1855,25,40-44,1880,57
SIM,1844,33,25-29,1877,5
SIM,1838,25,40-44,1863,1
STAT,1865,35,45-49,1900,1.8373206551921735
STAT,1915,32,40-44,1947,3.9292714024936632
STAT,1894,25,20-24,1919,15.019611517019664
STAT,1905,2,na,1907,3834.073434424965
STAT,1843,23,15-19,1866,4.0620676109748715
STAT,1888,47,na,1935,2584.578680729894
STAT,1872,49,45-49,1921,0.23138666468687794
STAT,1920,44,50-100,1964,0.12765443631700205
STAT,1863,54,45-49,1917,0.012048725252311654
STAT,1897,24,35-39,1921,7.70130540000522
SIM,1824,35,na,1859,2300
STAT,1812,48,35-39,1860,0.035548166135834044
STAT,1928,39,na,1967,4708.439757153992
STAT,1836,46,30-34,1882,0.07862739596533558
STAT,1921,30,15-19,1951,0.1424462214002683
STAT,1871,93,na,1964,80.69732354399355
STAT,1876,20,40-44,1896,2.119107903822054
STAT,1932,32,40-44,1964,5.166017621219075
STAT,1902,25,30-34,1927,35.700728085561344
SIM,1925,30,na,1955,4733
STAT,1882,85,na,1967,522.509556573615
STAT,1847,46,40-44,1893,0.1552242856115207
STAT,1947,25,45-49,1972,1.93559725452483
STAT,1893,2,na,1895,3333.481908216003
STAT,1900,13,na,1913,3571.967101714899
STAT,1879,11,na,1890,2653.1940152675415
SIM,1913,30,30-34,1943,1
STAT,1897,36,35-39,1933,9.438417093617577
STAT,1843,64,na,1907,1717.5758797590697
SIM,1911,19,na,1930,2427
SIM,1838,33,35-39,1871,1
STAT,1872,25,35-39,1897,9.727597561443174
STAT,1880,54,45-49,1934,0.014651818686169398
SIM,1904,38,45-49,1942,2
STAT,1897,16,40-44,1913,0.24350133962892134
STAT,1853,71,na,1924,1034.9893102423734
SIM,1827,49,50-100,1876,7
STAT,1842,24,45-49,1866,0.2152138711805751
STAT,1819,90,na,1909,18.337713873350147
SIM,1835,34,20-24,1869,3
SIM,1903,3,na,1906,3100
STAT,1916,19,30-34,1935,2.5370805495423094
STAT,1909,34,15-19,1943,0.12034094873565238
STAT,1887,35,30-34,1922,5.921834658074256
STAT,1882,44,35-39,1926,1.710290108340467
SIM,1802,59,na,1861,935
STAT,1846,35,35-39,1881,4.466305208050958
SIM,1869,36,25-29,1905,6
STAT,1815,57,na,1872,179.63471323618228
STAT,1798,57,na,1855,1555.8789299999996
STAT,1863,35,35-39,1898,6.095585920827507
STAT,1837,39,50-100,1876,1.173936280295175
SIM,1915,3,na,1918,3887
STAT,1867,77,na,1944,817.4816390906062
SIM,1899,22,na,1921,1273
SIM,1869,27,35-39,1896,25
STAT,1811,49,30-34,1860,0.4406156430423878
STAT,1906,29,15-19,1935,0.6522980094521439
SIM,1881,32,25-29,1913,24
STAT,1811,52,30-34,1863,0.02677905105029001
SIM,1886,36,25-29,1922,2
STAT,1912,47,35-39,1959,0.12246805055596728
STAT,1917,18,35-39,1935,0.8885874195758746
SIM,1919,48,na,1967,4848
STAT,1939,16,20-24,1955,134.25380383083325
STAT,1877,84,na,1961,504.8527827515649
STAT,1862,36,30-34,1898,4.561268516591403
SIM,1814,41,25-29,1855,2
STAT,1897,30,20-24,1927,3.618657749607328
STAT,1924,26,na,1950,4334.698331029333
STAT,1898,15,45-49,1913,0.0882483881411704
STAT,1905,30,30-34,1935,25.31452931397258
STAT,1910,18,40-44,1928,0.2733319090840199
STAT,1920,33,na,1953,4072.120404378475
STAT,1894,45,15-19,1939,2.897888374906407E-4
SIM,1914,29,15-19,1943,1
STAT,1828,75,na,1903,696.8739848846774
STAT,1927,34,25-29,1961,11.262382203576738
SIM,1870,23,25-29,1893,8
STAT,1856,35,35-39,1891,5.128397797462061
STAT,1896,76,na,1972,1729.955934168784
STAT,1852,46,15-19,1898,4.0377798741370627E-4
STAT,1852,53,30-34,1905,0.0058955602560685225
STAT,1858,49,na,1907,1682.2499789202168
STAT,1831,48,45-49,1879,0.21970224930166743
SIM,1865,43,50-100,1908,1
STAT,1888,25,na,1913,2773.1255127348195
STAT,1841,28,50-100,1869,0.8784068978669697
STAT,1868,35,20-24,1903,0.7516114672251016
STAT,1832,29,20-24,1861,13.876436713695462
STAT,1854,27,na,1881,1391.075263934728
SIM,1875,27,na,1902,2596
STAT,1926,34,15-19,1960,0.15385359529753306
STAT,1862,23,25-29,1885,49.55508880219607
STAT,1916,30,na,1946,3882.392386045975
STAT,1886,69,na,1955,1519.7147000797634
SIM,1834,23,15-19,1857,4
STAT,1838,82,na,1920,198.98445597616032
STAT,1936,24,30-34,1960,27.186811070615562
SIM,1883,78,na,1961,912
SIM,1899,54,na,1953,1506
SIM,1869,43,30-34,1912,15
STAT,1888,26,40-44,1914,3.46923590831458
STAT,1873,46,50-100,1919,0.2526467554548049
SIM,1824,57,na,1881,1811
STAT,1861,24,20-24,1885,58.03495581597597
STAT,1806,72,na,1878,498.4422808530137
STAT,1878,36,25-29,1914,2.9765751837801764
SIM,1886,24,25-29,1910,140
SIM,1937,5,na,1942,2988
STAT,1864,34,na,1898,2150.8364329453493
STAT,1926,22,15-19,1948,6.411590427617819
STAT,1906,42,40-44,1948,0.2259020730561123
STAT,1919,18,50-100,1937,0.4074563740077951
SIM,1882,11,na,1893,2283
STAT,1906,49,50-100,1955,0.19642547885594913
SIM,1907,39,40-44,1946,5
SIM,1952,10,na,1962,6372
STAT,1847,33,35-39,1880,10.639320432642979
STAT,1898,36,45-49,1934,2.693577287766528
STAT,1820,87,na,1907,121.16165579080575
STAT,1900,40,15-19,1940,0.0013418697227751718
STAT,1928,37,50-100,1965,0.5265744569689813
STAT,1877,47,30-34,1924,0.09780553959251202
STAT,1908,43,50-100,1951,0.10720341036488419
SIM,1853,2,na,1855,3646
STAT,1891,15,35-39,1906,0.6778984572891764
STAT,1931,23,35-39,1954,12.088938834243658
SIM,1823,72,na,1895,534
STAT,1811,73,na,1884,747.9579676758655
STAT,1927,17,40-44,1944,1.724968480999356
STAT,1866,19,50-100,1885,0.04536303499321761
SIM,1896,11,na,1907,4094
SIM,1826,61,na,1887,1370
STAT,1865,22,30-34,1887,16.460139308075302
SIM,1945,20,25-29,1965,7
STAT,1841,43,35-39,1884,2.0686793033955024
STAT,1916,30,50-100,1946,0.8487286630773839
STAT,1925,29,40-44,1954,5.415875432533158
SIM,1934,1,na,1935,5471
STAT,1887,33,30-34,1920,19.136345215906466
STAT,1842,48,20-24,1890,0.0029415033441275986
STAT,1814,45,40-44,1859,0.6011263552105827
SIM,1838,21,25-29,1859,34
SIM,1837,24,na,1861,1194
STAT,1848,41,na,1889,2187.9897045817083
STAT,1888,47,40-44,1935,0.1966716377295065
STAT,1848,45,45-49,1893,0.22304450257533662
STAT,1947,24,40-44,1971,3.7575018616960816
STAT,1873,18,45-49,1891,0.0668309375289857
STAT,1931,15,40-44,1946,1.8263591799224783
STAT,1933,36,15-19,1969,0.026002434292010025
STAT,1833,76,na,1909,389.79710636919583
STAT,1874,38,15-19,1912,0.05766778467165838
STAT,1836,37,40-44,1873,4.1173168863930245
STAT,1848,29,15-19,1877,0.49959612125761904
STAT,1898,33,40-44,1931,5.807045922581137
STAT,1836,23,15-19,1859,3.3123365109728966
STAT,1892,44,na,1936,2832.6554321284134
SIM,1910,16,25-29,1926,6
SIM,1904,49,na,1953,3949
STAT,1828,33,25-29,1861,15.00732170958249
STAT,1859,107,na,1966,0.03014466998927916
STAT,1866,78,na,1944,713.2151156728254
STAT,1779,114,na,1893,1.1701504062201385E-4
SIM,1875,41,na,1916,2929
STAT,1843,27,30-34,1870,30.62032087384132
STAT,1881,36,40-44,1917,4.153781613037755
STAT,1820,109,na,1929,4.892794843591015E-4
STAT,1858,15,15-19,1873,5.356901936002767
SIM,1869,24,30-34,1893,63
STAT,1845,23,25-29,1868,35.01132253039404
STAT,1826,37,15-19,1863,0.0917542707741975
STAT,1863,34,30-34,1897,14.77795983348607
SIM,1854,32,30-34,1886,41
STAT,1902,16,25-29,1918,7.999260952675783
STAT,1895,24,25-29,1919,74.0030502913116
STAT,1951,19,40-44,1970,1.6489881779605196
SIM,1839,42,40-44,1881,2
STAT,1850,53,20-24,1903,3.3527188778363756E-4
STAT,1893,28,15-19,1921,0.5653705132731099
SIM,1959,1,na,1960,5267
STAT,1842,106,na,1948,0.0030141073637560013
STAT,1873,32,25-29,1905,10.506654814395338
STAT,1846,16,35-39,1862,0.4106579712106986
STAT,1923,29,15-19,1952,0.7962526615213209
STAT,1840,53,na,1893,834.2070164768649
STAT,1872,20,15-19,1892,3.323219977862374
STAT,1918,40,na,1958,3906.269164821761
STAT,1934,15,25-29,1949,58.488845326971045
STAT,1908,33,na,1941,3527.394375595926
SIM,1862,23,na,1885,3815
STAT,1903,37,40-44,1940,1.341218817426401
SIM,1936,25,na,1961,3826
SIM,1815,43,na,1858,2187
SIM,1919,30,25-29,1949,17
SIM,1862,23,25-29,1885,3
STAT,1829,38,na,1867,990.2131402134014
STAT,1876,23,45-49,1899,0.7027497514112602
STAT,1883,25,45-49,1908,1.0754063089472772
STAT,1877,38,40-44,1915,4.421651464721463
SIM,1906,18,25-29,1924,24
STAT,1832,31,25-29,1863,0.6573707867599106
STAT,1905,25,40-44,1930,4.337811906544011
STAT,1830,46,na,1876,1770.342804601053
STAT,1862,17,30-34,1879,1.554818948591839
STAT,1933,19,30-34,1952,16.11881838215086
SIM,1926,18,na,1944,6203
STAT,1852,27,15-19,1879,0.5319273962325406
STAT,1953,15,35-39,1968,5.033198706849981
STAT,1832,35,40-44,1867,0.3112991511102421
STAT,1922,28,45-49,1950,1.9262858355211672
SIM,1941,28,20-24,1969,3
STAT,1824,91,na,1915,11.2142769676395
STAT,1842,21,40-44,1863,0.6571787050981114
STAT,1874,19,15-19,1893,6.092004794660889
STAT,1854,23,25-29,1877,37.13010638712253
SIM,1847,31,na,1878,1592
SIM,1895,33,30-34,1928,66
SIM,1840,35,40-44,1875,12
STAT,1862,56,na,1918,1737.2399659065184
STAT,1930,11,na,1941,5094.219474122521
STAT,1883,49,20-24,1932,0.01130347804073137
SIM,1840,31,25-29,1871,56
STAT,1875,74,na,1949,1139.5888653851714
STAT,1933,28,20-24,1961,24.06142484428575
SIM,1860,64,na,1924,1638
STAT,1921,16,35-39,1937,4.737953122535898
STAT,1899,39,30-34,1938,1.5554016713256116
SIM,1804,69,na,1873,592
STAT,1845,45,na,1890,1127.5393865336414
STAT,1847,28,45-49,1875,1.1979059392655675
STAT,1831,23,30-34,1854,44.72849848889596
STAT,1855,49,45-49,1904,0.1529322081898112
SIM,1827,33,25-29,1860,12
SIM,1871,51,40-44,1922,1
STAT,1863,25,25-29,1888,36.63746841016735
SIM,1840,76,na,1916,1993
STAT,1846,30,15-19,1876,0.10176336365487165
STAT,1833,37,15-19,1870,0.03039010391609097
STAT,1832,24,na,1856,2392.4283289113982
STAT,1837,20,20-24,1857,73.38441876899402
SIM,1854,22,20-24,1876,11
SIM,1851,68,na,1919,979
SIM,1894,24,25-29,1918,38
SIM,1854,4,na,1858,2723
SIM,1892,28,30-34,1920,1
STAT,1886,24,25-29,1910,58.9095913669029
STAT,1908,25,25-29,1933,62.686838833148876
STAT,1839,45,45-49,1884,0.2291953473743125
STAT,1887,62,na,1949,2011.7346612977806
STAT,1928,24,30-34,1952,35.38910345092397
STAT,1867,38,15-19,1905,0.052843646237422805
STAT,1907,46,15-19,1953,3.3015529860808753E-4
STAT,1815,54,na,1869,190.62550298937128
SIM,1870,34,15-19,1904,1
STAT,1850,39,50-100,1889,0.5640654170751089
STAT,1846,22,20-24,1868,50.359051459169685
STAT,1871,46,25-29,1917,0.05762164791082233
STAT,1824,37,50-100,1861,0.19386081990655352
STAT,1872,22,30-34,1894,17.83650059243563
STAT,1900,27,50-100,1927,0.8861565413286404
STAT,1884,28,30-34,1912,24.021084635334923
STAT,1893,38,25-29,1931,3.5826576051645684
STAT,1940,17,15-19,1957,45.56245893424593
STAT,1937,28,50-100,1965,0.9597679913884747
STAT,1865,30,50-100,1895,0.8432481050048592
STAT,1899,65,na,1964,2522.4427280361406
STAT,1917,34,50-100,1951,0.8469117087421815
SIM,1845,20,20-24,1865,333
SIM,1871,25,25-29,1896,119
STAT,1876,35,20-24,1911,0.7866580331105109
STAT,1873,36,40-44,1909,4.511965502828218
STAT,1831,24,35-39,1855,9.43482816687185
SIM,1884,35,20-24,1919,8
STAT,1820,42,50-100,1862,1.7441908792632106
STAT,1888,43,25-29,1931,0.7358004058157194
STAT,1907,38,20-24,1945,0.24156181801689108
STAT,1917,27,25-29,1944,68.10536684891298
STAT,1781,100,na,1881,0.23588633758894084
SIM,1866,19,30-34,1885,7
STAT,1858,19,30-34,1877,1.4051295311382075
SIM,1825,37,30-34,1862,4
STAT,1846,32,30-34,1878,12.220137208941074
SIM,1912,12,na,1924,4857
STAT,1897,21,30-34,1918,23.727055597772438
SIM,1873,60,na,1933,1459
STAT,1836,27,30-34,1863,24.968763822173006
STAT,1896,47,40-44,1943,0.12670924066086536
STAT,1943,26,30-34,1969,41.27205006134802
SIM,1861,27,na,1888,2363
STAT,1879,33,na,1912,2437.64250969184
STAT,1927,31,20-24,1958,2.9777465778883245
STAT,1891,25,45-49,1916,1.3746347989723435
STAT,1942,1,na,1943,4283.072239933677
STAT,1830,45,25-29,1875,0.050502428431877786
STAT,1821,35,30-34,1856,6.945374315405709
STAT,1823,98,na,1921,2.5662727706907904
SIM,1846,38,na,1884,1020
STAT,1929,38,15-19,1967,0.024456381408756934
STAT,1870,24,20-24,1894,68.2710672550776
STAT,1857,32,40-44,1889,3.348374211966042
SIM,1866,67,na,1933,2225
STAT,1826,39,30-34,1865,8.283977551398605
STAT,1866,54,50-100,1920,0.013406964491755104
STAT,1916,15,15-19,1931,9.541524789216925
STAT,1807,47,15-19,1854,0.0014070676859254368
STAT,1839,32,30-34,1871,19.96209708474509
SIM,1888,6,na,1894,676
STAT,1809,83,na,1892,386.41763799034374
STAT,1888,29,45-49,1917,1.2723126448514932
SIM,1855,75,na,1930,1575
SIM,1949,21,na,1970,4453
STAT,1811,45,15-19,1856,0.001941368545028885
SIM,1851,50,na,1901,1151
SIM,1968,3,na,1971,3299
SIM,1901,20,na,1921,4011
SIM,1834,37,15-19,1871,1
SIM,1865,32,40-44,1897,42
STAT,1817,37,30-34,1854,4.214097310925627
SIM,1834,39,30-34,1873,1
SIM,1829,38,45-49,1867,15
STAT,1828,72,na,1900,854.8917195195031
STAT,1872,100,na,1972,9.341871101235032
SIM,1916,25,25-29,1941,629
SIM,1940,22,na,1962,4194
SIM,1897,73,na,1970,1237
STAT,1928,37,45-49,1965,0.8549992805894394
SIM,1939,14,na,1953,4736
STAT,1937,20,25-29,1957,89.08132872717894
SIM,1796,68,na,1864,998
SIM,1913,33,35-39,1946,9
STAT,1863,51,40-44,1914,0.009030585992526452
STAT,1849,21,35-39,1870,5.9877055138235304
SIM,1828,26,35-39,1854,161
STAT,1926,38,30-34,1964,2.2060954448785846
SIM,1828,32,20-24,1860,14
SIM,1880,25,35-39,1905,11
STAT,1840,24,na,1864,1055.3240561397834
SIM,1858,71,na,1929,1695
STAT,1887,17,35-39,1904,0.6039494423249078
STAT,1851,16,na,1867,2217.242411831368
SIM,1860,37,25-29,1897,5
STAT,1957,13,na,1970,5132.8082287493635
STAT,1887,23,20-24,1910,75.61575749718372
STAT,1788,90,na,1878,12.193429674037066
STAT,1862,27,40-44,1889,2.560850486435441
SIM,1870,27,40-44,1897,240
STAT,1840,35,40-44,1875,2.081450916272017
STAT,1927,25,35-39,1952,18.22631738310339
STAT,1856,3,na,1859,2399.5152045512577
STAT,1949,23,20-24,1972,128.4284144152857
SIM,1819,49,40-44,1868,1
STAT,1852,37,25-29,1889,2.913890713337309
STAT,1866,15,na,1881,2394.4504944723367
STAT,1868,22,15-19,1890,3.186431168565012
STAT,1893,43,50-100,1936,0.0910787351340418
STAT,1886,30,45-49,1916,1.8203306451888839
SIM,1865,35,45-49,1900,1
STAT,1858,54,45-49,1912,0.010777847961485721
STAT,1905,33,35-39,1938,8.328483609507222
STAT,1918,48,40-44,1966,0.16505466144363554
STAT,1834,61,na,1895,823.5175369825881
STAT,1923,39,25-29,1962,1.1264463110991498
STAT,1891,34,35-39,1925,12.346921939926188
STAT,1845,20,20-24,1865,43.06780436782375
STAT,1812,58,na,1870,199.5162481734718
STAT,1854,42,35-39,1896,1.005604884627171
STAT,1902,47,40-44,1949,0.13535356062625856
STAT,1875,18,15-19,1893,6.077940627243754
STAT,1896,43,25-29,1939,0.05835873822148332
SIM,1838,71,na,1909,713
STAT,1894,46,25-29,1940,0.04143501618969902
STAT,1898,9,na,1907,3489.0466976668704
SIM,1876,38,25-29,1914,16
STAT,1854,26,30-34,1880,16.246564717518755
STAT,1857,38,20-24,1895,0.5885857614718257
STAT,1833,52,45-49,1885,0.00641026228626775
SIM,1814,81,na,1895,16
SIM,1933,2,na,1935,4652
STAT,1852,29,30-34,1881,26.48207809087277
STAT,1801,94,na,1895,6.630344086982905
STAT,1938,16,40-44,1954,1.3683292087932004
STAT,1822,33,30-34,1855,40.49309696196025
STAT,1873,54,40-44,1927,0.010502081634495307
STAT,1837,29,35-39,1866,9.788071693814933
STAT,1901,29,na,1930,3313.023782812148
STAT,1858,19,25-29,1877,4.995696173999617
STAT,1824,43,35-39,1867,0.30986671441133445
STAT,1838,51,na,1889,931.6474363461823
SIM,1903,52,na,1955,2247
STAT,1827,53,30-34,1880,0.005164496850033531
STAT,1894,44,30-34,1938,0.10015289361562063
STAT,1819,49,40-44,1868,0.030450352427892253
SIM,1825,45,na,1870,251
STAT,1877,47,35-39,1924,0.1414542928631913
STAT,1829,52,25-29,1881,0.0014406559092981265
SIM,1829,35,na,1864,2109
SIM,1897,19,na,1916,2983
STAT,1875,16,20-24,1891,18.249292672588506
STAT,1868,38,25-29,1906,2.7671392217860102
SIM,1899,25,15-19,1924,4
STAT,1852,86,na,1938,223.33788811603486
STAT,1888,35,45-49,1923,2.3226610679414614
SIM,1871,32,35-39,1903,1
STAT,1848,45,15-19,1893,3.7804121159755845E-4
STAT,1859,33,na,1892,1883.390931211197
STAT,1877,6,na,1883,2747.8636666205134
SIM,1886,67,na,1953,2499
STAT,1863,35,40-44,1898,3.7726199318484173
STAT,1879,42,40-44,1921,2.3045559924806147
SIM,1862,26,30-34,1888,109
SIM,1878,33,30-34,1911,23
STAT,1865,45,50-100,1910,0.2264660889083189
SIM,1884,32,na,1916,3741
SIM,1848,39,30-34,1887,60
STAT,1863,17,40-44,1880,0.17817794613410995
SIM,1914,16,na,1930,5124
STAT,1885,37,15-19,1922,0.0551970905134926
SIM,1876,37,na,1913,3699
STAT,1811,45,20-24,1856,0.058241107581684125
STAT,1893,17,25-29,1910,7.086401563271139
SIM,1864,39,45-49,1903,1
STAT,1843,23,20-24,1866,84.8515218606063
SIM,1896,65,na,1961,2178
STAT,1813,99,na,1912,1.3873069232584907
SIM,1869,63,na,1932,3598
STAT,1944,26,na,1970,4005.0973065752355
SIM,1870,32,na,1902,1908
SIM,1887,42,40-44,1929,20
SIM,1881,36,40-44,1917,7
STAT,1882,29,15-19,1911,0.43127487503560863
STAT,1834,20,45-49,1854,0.41697881552641797
STAT,1845,39,40-44,1884,2.235392773478686
STAT,1876,51,50-100,1927,0.015340539920928459
SIM,1850,20,na,1870,2111
STAT,1845,51,25-29,1896,0.001766016531145002
STAT,1918,22,20-24,1940,118.30888782275106
SIM,1837,32,30-34,1869,109
STAT,1917,24,na,1941,3805.3981954857545
STAT,1879,25,na,1904,2464.7999557830462
STAT,1906,52,na,1958,3155.3097543178487
STAT,1906,60,na,1966,2988.5567723391655
STAT,1864,16,45-49,1880,0.0679082875716126
STAT,1828,41,na,1869,1812.6975824717047
STAT,1847,49,45-49,1896,0.20891656539005482
STAT,1914,46,20-24,1960,0.010834503461974456
SIM,1859,65,na,1924,1535
STAT,1865,44,35-39,1909,1.6309409445058367
STAT,1882,47,45-49,1929,0.2248954362358725
STAT,1883,30,na,1913,2314.1877482235395
STAT,1896,23,30-34,1919,23.408106336714017
STAT,1889,46,15-19,1935,4.83057206943257E-4
SIM,1880,25,40-44,1905,2
STAT,1831,25,50-100,1856,0.8592605287624483
STAT,1849,26,20-24,1875,11.802273642111285
STAT,1875,43,na,1918,2356.1574876725717
STAT,1865,32,40-44,1897,3.959383429157308
STAT,1878,45,30-34,1923,0.10058745659811848
STAT,1880,16,30-34,1896,1.658746589331824
STAT,1779,90,na,1869,46.1478166468097
STAT,1846,38,45-49,1884,1.2202087139923885
STAT,1868,26,50-100,1894,0.6199805697099239
STAT,1844,52,20-24,1896,7.271567940927161E-4
STAT,1829,32,30-34,1861,9.626300507544508
SIM,1866,19,25-29,1885,186
STAT,1843,38,20-24,1881,0.8007585890194351
SIM,1856,37,na,1893,713
STAT,1861,21,15-19,1882,2.8390014737330223
STAT,1879,26,35-39,1905,9.9322234479044
STAT,1834,50,40-44,1884,0.004949535062708783
STAT,1902,70,na,1972,2389.2467013889436
SIM,1804,51,na,1855,875
SIM,1851,44,50-100,1895,22
STAT,1907,22,45-49,1929,1.0174597194418502
STAT,1821,35,35-39,1856,9.217256808163729
STAT,1808,103,na,1911,0.03361175377415157
STAT,1882,37,50-100,1919,1.1754535178726309
STAT,1841,28,15-19,1869,0.6230110716697659
SIM,1880,49,50-100,1929,2
STAT,1858,37,25-29,1895,2.198740094313989
STAT,1895,43,35-39,1938,0.1623986544734908
STAT,1859,47,15-19,1906,3.1555873854885154E-4
STAT,1894,28,25-29,1922,53.6036117554057
STAT,1879,44,35-39,1923,1.832530746035962
STAT,1881,15,35-39,1896,0.5205797570939734
STAT,1906,23,40-44,1929,3.0081798673288933
SIM,1853,20,20-24,1873,384
STAT,1821,94,na,1915,10.09331141091734
STAT,1837,27,40-44,1864,3.082872826839844
SIM,1892,24,20-24,1916,3
STAT,1855,42,25-29,1897,0.4244796973381492
SIM,1870,35,25-29,1905,50
STAT,1817,89,na,1906,33.2798450601072
STAT,1820,36,30-34,1856,10.45981251395382
SIM,1922,11,na,1933,3724
SIM,1885,47,35-39,1932,3
STAT,1887,20,na,1907,2618.677440083925
STAT,1880,31,25-29,1911,10.676860106112773
STAT,1896,41,30-34,1937,0.10571739688981048
STAT,1903,46,45-49,1949,0.18950704202094387
SIM,1910,34,na,1944,4203
SIM,1865,73,na,1938,1399
STAT,1884,24,20-24,1908,65.55505692369334
STAT,1912,49,20-24,1961,0.010435733106426492
STAT,1920,43,40-44,1963,0.27226360362562524
STAT,1877,30,na,1907,2441.8644432320484
SIM,1890,40,na,1930,3648
STAT,1829,50,30-34,1879,0.0027681080222262725
STAT,1923,32,na,1955,4290.139296660423
STAT,1863,19,35-39,1882,0.48071254171222516
STAT,1828,52,35-39,1880,0.00992518287708976
STAT,1832,53,40-44,1885,8.259465115886006E-4
STAT,1870,12,na,1882,2640.205642815603
STAT,1943,24,50-100,1967,0.6915998535716211
STAT,1912,60,na,1972,3249.628781183906
SIM,1821,63,na,1884,1753
SIM,1886,27,30-34,1913,1
STAT,1919,21,25-29,1940,100.10396972856084
STAT,1928,27,35-39,1955,18.355914443491574
STAT,1885,73,na,1958,1260.4023911278414
STAT,1876,50,45-49,1926,0.014881540275822194
STAT,1845,53,20-24,1898,3.602889299259438E-4
STAT,1838,43,na,1881,1035.6254344391664
STAT,1840,17,45-49,1857,0.033301738522472306
STAT,1861,36,15-19,1897,0.04692531807050211
STAT,1960,0,na,1960,5112.195879414041
STAT,1835,31,15-19,1866,0.13861028371617098
STAT,1864,33,35-39,1897,9.167726245575128
SIM,1911,43,40-44,1954,3
STAT,1787,103,na,1890,0.025838280497500282
STAT,1897,40,35-39,1937,0.168683118268052
STAT,1839,42,40-44,1881,2.202479477821087
STAT,1859,50,45-49,1909,0.0116677270232127
STAT,1890,21,40-44,1911,2.53029029761203
STAT,1874,9,na,1883,2753.598982391787
STAT,1878,71,na,1949,1373.3352827859105
STAT,1814,41,25-29,1855,2.3793278740612593
STAT,1853,45,25-29,1898,0.04510765346358055
STAT,1844,37,25-29,1881,3.0141906429857417
STAT,1855,25,35-39,1880,7.420854903236686
SIM,1838,63,na,1901,1388
SIM,1927,21,25-29,1948,8
STAT,1858,41,50-100,1899,0.8104250540137351
STAT,1864,34,45-49,1898,1.5717466093025294
SIM,1875,27,25-29,1902,394
STAT,1887,39,45-49,1926,2.17209395009452
SIM,1941,3,na,1944,4031
STAT,1849,46,15-19,1895,3.3799337699392184E-4
SIM,1845,44,30-34,1889,7
STAT,1890,20,30-34,1910,21.6923406037876
STAT,1927,14,na,1941,4870.6613004587525
STAT,1947,21,30-34,1968,32.15138084427637
STAT,1844,36,15-19,1880,0.06527585239702782
STAT,1869,35,na,1904,2399.952086240476
STAT,1873,48,na,1921,2278.8427233233374
STAT,1903,43,40-44,1946,0.22011794844245008
SIM,1931,28,na,1959,4986
STAT,1878,27,30-34,1905,25.908881847105132
SIM,1845,65,na,1910,1416
SIM,1878,39,45-49,1917,11
STAT,1849,31,45-49,1880,1.7191962401206722
STAT,1886,21,20-24,1907,71.57778909731107
STAT,1821,40,50-100,1861,1.2350597713559368
STAT,1895,27,30-34,1922,32.758440330329485
STAT,1849,44,20-24,1893,0.13200832542291951
SIM,1797,64,na,1861,1360
SIM,1906,31,35-39,1937,1
STAT,1899,17,20-24,1916,24.21482119561223
STAT,1948,23,45-49,1971,1.2782798380434193
STAT,1828,54,30-34,1882,0.0060021060670075515
STAT,1830,28,40-44,1858,2.859739585015901
STAT,1849,35,na,1884,2073.9363554517013
STAT,1909,29,na,1938,3518.4037966457095
STAT,1845,104,na,1949,0.03309769500460939
STAT,1916,50,na,1966,3683.235562664508
SIM,1857,31,45-49,1888,4
STAT,1858,71,na,1929,1019.3395754172257
STAT,1862,25,na,1887,2069.8089864870603
STAT,1851,5,na,1856,2414.57965828
STAT,1853,27,25-29,1880,37.99738579676044
SIM,1827,30,20-24,1857,3
STAT,1829,35,35-39,1864,3.7167453683689744
STAT,1850,33,35-39,1883,4.841335867793255
STAT,1869,52,25-29,1921,0.0035551538346688533
STAT,1939,15,45-49,1954,0.4957519878130735
STAT,1844,21,15-19,1865,4.110204898020234
STAT,1825,34,50-100,1859,1.4256892751499328
STAT,1889,35,na,1924,2864.071177805859
SIM,1870,36,35-39,1906,14
STAT,1838,41,40-44,1879,1.1373767812549598
STAT,1855,43,35-39,1898,1.1898051772278642
SIM,1840,38,50-100,1878,5
STAT,1838,43,35-39,1881,0.8121733643700866
STAT,1836,40,50-100,1876,0.9880396284272881
STAT,1873,24,45-49,1897,0.7108203691165546
STAT,1870,27,25-29,1897,42.17168799506958
STAT,1818,46,15-19,1864,7.243479976665062E-4
STAT,1954,17,35-39,1971,5.141560816258586
STAT,1861,39,25-29,1900,2.370364838537071
STAT,1913,34,na,1947,3683.8427203262404
STAT,1938,34,40-44,1972,3.8877109386840067
STAT,1924,21,35-39,1945,11.037139254415893
SIM,1867,6,na,1873,2947
STAT,1853,6,na,1859,2326.9683538881372
STAT,1871,29,40-44,1900,2.9668484183055654
SIM,1898,27,20-24,1925,2
STAT,1789,103,na,1892,0.06102715860372877
STAT,1840,31,25-29,1871,4.963527542757096
STAT,1880,10,na,1890,2689.1584736940194
STAT,1908,15,15-19,1923,8.775784303774525
STAT,1835,46,15-19,1881,3.2312672026439524E-4
STAT,1868,53,20-24,1921,7.012911082152083E-4
STAT,1828,36,30-34,1864,7.3206184870689865
STAT,1881,30,30-34,1911,16.62057836080907
STAT,1937,17,35-39,1954,4.0399582353969565
STAT,1939,33,45-49,1972,1.586916680155691
STAT,1828,51,25-29,1879,0.004165292714072083
SIM,1893,40,45-49,1933,4
STAT,1820,38,25-29,1858,5.100903666068881
STAT,1834,103,na,1937,0.06324782536985983
STAT,1885,40,45-49,1925,1.4859656512321755
SIM,1896,57,na,1953,2543
STAT,1831,27,45-49,1858,1.3181085295270418
STAT,1913,29,15-19,1942,0.6896279392254475
STAT,1934,9,na,1943,5348.076406876484
STAT,1899,19,15-19,1918,8.06233900963069
STAT,1895,42,25-29,1937,0.057937999445961466
STAT,1837,44,30-34,1881,0.9648300804372855
STAT,1871,40,15-19,1911,0.013914911415920451
STAT,1942,11,na,1953,4069.8464849414795
STAT,1891,20,50-100,1911,0.5044636544606355
SIM,1845,26,30-34,1871,3
SIM,1846,41,40-44,1887,1
SIM,1891,34,na,1925,2284
STAT,1853,43,30-34,1896,0.8850001924091202
SIM,1879,85,na,1964,42
STAT,1847,35,50-100,1882,1.1758662216326716
SIM,1929,34,40-44,1963,2
STAT,1850,21,40-44,1871,1.1632627987113981
STAT,1869,50,30-34,1919,0.006092927361793111
SIM,1887,29,na,1916,3785
STAT,1818,43,na,1861,1782.400226153739
STAT,1874,50,40-44,1924,0.011021372479804585
STAT,1854,44,30-34,1898,0.6306073784675261
STAT,1848,53,50-100,1901,0.013905851914944572
SIM,1880,42,na,1922,3256
STAT,1822,56,na,1878,1285.41510828629
STAT,1838,25,35-39,1863,5.315543309729288
STAT,1885,22,15-19,1907,3.2427735550236774
STAT,1896,24,50-100,1920,0.5341957666933237
STAT,1875,51,40-44,1926,0.010862063672670097
STAT,1880,17,40-44,1897,0.18988162431246472
STAT,1885,7,na,1892,2560.933189250681
SIM,1869,49,45-49,1918,5
STAT,1889,55,na,1944,2489.992400662247
STAT,1842,31,50-100,1873,0.2776367143052226
SIM,1900,36,na,1936,4146
STAT,1859,18,30-34,1877,1.4577768352751337
STAT,1899,35,20-24,1934,1.062876586038732
SIM,1876,57,na,1933,3199
SIM,1850,40,na,1890,1328
SIM,1892,75,na,1967,2903
STAT,1881,35,na,1916,2245.9915568560255
STAT,1909,49,na,1958,3321.8762684563612
STAT,1849,28,15-19,1877,0.44991055607698055
SIM,1808,73,na,1881,1101
STAT,1913,47,15-19,1960,3.5503510396590453E-4
STAT,1938,19,45-49,1957,0.48716503176632087
SIM,1872,75,na,1947,767
STAT,1856,54,40-44,1910,0.007353584816320731
STAT,1837,89,na,1926,84.2354449172785
SIM,1866,27,na,1893,3195
STAT,1880,32,35-39,1912,10.513458666629075
STAT,1877,44,30-34,1921,1.1512986109649026
STAT,1930,34,na,1964,4840.359466573187
STAT,1852,58,na,1910,1990.6257512157772
STAT,1874,34,35-39,1908,10.362321501345635
STAT,1862,20,20-24,1882,60.95824766717521
STAT,1869,39,50-100,1908,1.226424073182946
STAT,1889,18,50-100,1907,0.05884267309868167
STAT,1802,106,na,1908,0.006151795583024215
SIM,1843,30,na,1873,425
STAT,1830,25,35-39,1855,9.412726341295913
SIM,1858,40,na,1898,2326
STAT,1858,18,15-19,1876,5.262801910716133
STAT,1896,40,20-24,1936,0.014684516306354423
STAT,1832,22,35-39,1854,8.974267719694957
STAT,1934,24,na,1958,4871.046111180035
SIM,1896,34,35-39,1930,12
STAT,1814,92,na,1906,28.187679733525744
STAT,1846,52,25-29,1898,0.00208662796843393
SIM,1798,58,na,1856,42
STAT,1829,53,35-39,1882,0.0034328936124910373
STAT,1861,37,30-34,1898,4.432305826757771
SIM,1845,73,na,1918,553
STAT,1857,31,50-100,1888,0.7148162722969519
STAT,1883,28,20-24,1911,11.246435597572505
STAT,1835,29,30-34,1864,24.47669565315087
STAT,1839,21,50-100,1860,0.490316090244179
STAT,1820,39,35-39,1859,12.129591256467373
SIM,1898,12,na,1910,4434
SIM,1891,28,20-24,1919,33
STAT,1858,51,40-44,1909,0.008078056457623932
STAT,1860,25,15-19,1885,0.37952315955663773
STAT,1824,31,40-44,1855,2.0082072620239466
STAT,1923,36,20-24,1959,0.30250270919357447
STAT,1894,43,20-24,1937,0.013922927387670196
STAT,1864,15,35-39,1879,0.5738094590021157
SIM,1897,59,na,1956,1686
SIM,1840,73,na,1913,1993
STAT,1844,53,30-34,1897,0.00580244001501665
STAT,1856,48,na,1904,1595.6515891069637
SIM,1873,47,45-49,1920,1
SIM,1874,22,na,1896,2641
SIM,1837,35,35-39,1872,41
STAT,1794,67,na,1861,9.24331471105159
STAT,1854,29,35-39,1883,5.543768423502897
STAT,1927,4,na,1931,4977.641612440731
STAT,1867,27,25-29,1894,40.005725420569846
STAT,1875,54,45-49,1929,0.014492306587128034
STAT,1830,42,20-24,1872,0.1403949506281096
STAT,1871,42,50-100,1913,1.0525593790940555
STAT,1896,26,35-39,1922,12.763143669181732
STAT,1834,35,15-19,1869,0.031429361629113355
STAT,1881,91,na,1972,206.25158317798613
STAT,1894,47,35-39,1941,0.09995679818929243
SIM,1880,70,na,1950,3193
STAT,1875,19,25-29,1894,5.787687181343758
STAT,1921,29,na,1950,4096.113228223083
STAT,1932,24,50-100,1956,0.8543933842145626
STAT,1944,15,25-29,1959,46.13497571310394
STAT,1822,34,40-44,1856,9.684115448898766
SIM,1870,20,20-24,1890,34
SIM,1894,37,35-39,1931,17
STAT,1876,32,15-19,1908,0.14396106135532086
SIM,1862,29,35-39,1891,1
SIM,1962,6,na,1968,4676
SIM,1909,49,na,1958,3811
STAT,1856,109,na,1965,0.003529068297788194
STAT,1890,20,na,1910,2880.228184817695
STAT,1865,47,45-49,1912,0.21446137903790594
SIM,1904,26,na,1930,4170
STAT,1834,53,45-49,1887,0.006429382540855979
STAT,1819,37,50-100,1856,0.3293460287124155
SIM,1827,46,35-39,1873,1
STAT,1880,19,35-39,1899,0.566589951456146
SIM,1867,29,na,1896,2119
STAT,1855,41,40-44,1896,1.495388587569215
STAT,1847,16,45-49,1863,0.07414841314489826
SIM,1937,13,na,1950,2988
STAT,1839,21,35-39,1860,7.01642243016882
STAT,1835,23,na,1858,2134.9973518992097
SIM,1890,44,40-44,1934,8
SIM,1967,4,na,1971,6509
STAT,1873,39,45-49,1912,2.024297255271867
STAT,1890,26,50-100,1916,0.777073847286955
STAT,1888,34,35-39,1922,11.588221508180368
STAT,1891,22,40-44,1913,2.5625196352448474
STAT,1874,52,35-39,1926,0.008837821620940376
STAT,1868,37,15-19,1905,0.05423805475218044
STAT,1870,42,20-24,1912,0.1581310480583116
STAT,1832,58,na,1890,1678.7318940453333
STAT,1881,32,25-29,1913,9.672580509583641
STAT,1876,47,15-19,1923,4.024777120479237E-4
STAT,1832,38,15-19,1870,0.004424610409449094
STAT,1896,44,35-39,1940,0.1635253130302962
SIM,1898,29,15-19,1927,7
STAT,1846,19,35-39,1865,0.4034443007092148
STAT,1886,33,15-19,1919,0.1468479563276115
STAT,1836,48,na,1884,1779.0148012772233
STAT,1897,30,na,1927,3194.6190583644516
STAT,1882,44,40-44,1926,2.1244118320069
STAT,1803,51,20-24,1854,0.001647613319606654
SIM,1839,65,na,1904,127
STAT,1819,42,15-19,1861,0.003236523793639256
STAT,1806,103,na,1909,0.043215014726947276
SIM,1870,32,20-24,1902,24
STAT,1918,25,25-29,1943,69.57135637297246
STAT,1956,15,45-49,1971,0.6555830738359634
STAT,1865,53,na,1918,1934.2594762927993
STAT,1806,48,45-49,1854,0.7554139526608403
STAT,1849,29,25-29,1878,41.646685662244714
SIM,1829,43,35-39,1872,19
SIM,1862,42,35-39,1904,15
STAT,1891,19,15-19,1910,7.258750623358521
SIM,1928,20,30-34,1948,8
SIM,1954,5,na,1959,5556
STAT,1895,40,30-34,1935,1.5106626226914364
STAT,1854,81,na,1935,300.6746250440654
STAT,1873,51,35-39,1924,0.008873250462977544
STAT,1836,30,20-24,1866,2.6730828925074404
STAT,1861,16,50-100,1877,0.04710769406394538
STAT,1836,49,40-44,1885,0.13381663847295455
STAT,1839,54,35-39,1893,0.007778434707125161
STAT,1854,50,50-100,1904,0.008518069831144625
STAT,1907,14,na,1921,3755.932089261771
STAT,1818,51,na,1869,1612.0667956754328
STAT,1850,50,50-100,1900,0.0070740881257681095
STAT,1870,26,15-19,1896,0.45386330656269425
STAT,1804,52,20-24,1856,0.004661034992726162
STAT,1924,22,45-49,1946,1.314933637385991
SIM,1837,78,na,1915,1243
STAT,1915,27,50-100,1942,1.00089388974998
STAT,1861,19,30-34,1880,1.505649293308292
SIM,1862,45,na,1907,3497
STAT,1807,99,na,1906,0.7678741562044125
SIM,1832,47,na,1879,1753
STAT,1866,31,45-49,1897,1.5982986077191466
SIM,1848,30,na,1878,1740
STAT,1833,48,50-100,1881,0.11079150775281031
SIM,1844,49,40-44,1893,4
STAT,1847,49,15-19,1896,3.540955755059712E-4
STAT,1812,44,25-29,1856,0.19342114269431132
STAT,1896,37,na,1933,3105.716554723197
SIM,1836,39,35-39,1875,10
STAT,1853,42,20-24,1895,0.12299022222683405
STAT,1884,39,20-24,1923,0.7304856026744271
SIM,1843,19,na,1862,585
STAT,1902,49,50-100,1951,0.1910117064061041
STAT,1801,74,na,1875,413.2534436364593
STAT,1833,34,15-19,1867,0.07836204408018733
SIM,1863,22,30-34,1885,1
STAT,1875,19,30-34,1894,1.6278912672515928
STAT,1850,18,15-19,1868,3.328937964932383
SIM,1869,43,35-39,1912,29
STAT,1827,37,25-29,1864,2.839102836331335
STAT,1847,34,45-49,1881,1.6499251459031556
STAT,1838,100,na,1938,0.452762141812471
SIM,1827,28,35-39,1855,1
STAT,1845,76,na,1921,470.1178100898302
STAT,1837,45,40-44,1882,0.14619577609313714
STAT,1889,63,na,1952,2148.703809582541
STAT,1864,27,50-100,1891,0.5815482854434912
STAT,1878,28,40-44,1906,3.071194736499557
STAT,1815,53,40-44,1868,0.001009986948260555
STAT,1900,47,35-39,1947,0.10888826790258647
SIM,1869,55,na,1924,3598
STAT,1851,47,15-19,1898,3.1444394335815393E-4
SIM,1828,73,na,1901,713
STAT,1844,91,na,1935,57.40825853994004
SIM,1857,29,25-29,1886,28
STAT,1888,61,na,1949,2156.7113496527572
STAT,1820,35,15-19,1855,0.11790780780205105
STAT,1840,32,35-39,1872,4.856843239823269
SIM,1850,12,na,1862,2356
SIM,1931,1,na,1932,5635
STAT,1870,20,na,1890,2371.8632639882244
STAT,1901,49,45-49,1950,0.18224914715484813
STAT,1845,36,35-39,1881,3.726104477588781
STAT,1819,46,35-39,1865,0.02663346028608806
SIM,1857,42,50-100,1899,1
STAT,1824,46,45-49,1870,0.04142150884703592
STAT,1848,81,na,1929,506.0336635088448
STAT,1859,32,15-19,1891,0.11287127103333787
STAT,1954,16,na,1970,4511.318159557118
STAT,1849,47,25-29,1896,0.04830702709997997
STAT,1876,48,30-34,1924,0.09662633486111709
STAT,1906,20,30-34,1926,25.947355997103656
SIM,1878,60,na,1938,2671
STAT,1817,48,20-24,1865,0.008296073625134107
STAT,1824,51,na,1875,474.1075138735117
STAT,1869,53,35-39,1922,0.008547762611793743
STAT,1891,37,45-49,1928,2.451447912576564
STAT,1898,39,20-24,1937,0.22148347537865798
STAT,1888,17,45-49,1905,0.07539286413560466
SIM,1842,35,15-19,1877,13
STAT,1871,22,15-19,1893,3.2909204009759336
STAT,1876,47,20-24,1923,0.012074341982430977
STAT,1812,43,15-19,1855,0.004572592896227657
SIM,1840,38,45-49,1878,20
STAT,1822,53,50-100,1875,0.02385768121991557
STAT,1903,24,na,1927,3336.1962822240703
STAT,1949,16,15-19,1965,52.276381989539146
STAT,1832,38,45-49,1870,0.1570736508555444
STAT,1927,42,50-100,1969,0.1461369084893855
STAT,1890,40,na,1930,2826.2365190249648
STAT,1894,10,na,1904,3294.0101772227576
SIM,1883,41,50-100,1924,7
STAT,1936,1,na,1937,3958.4833832551526
STAT,1901,48,35-39,1949,0.10903195002449793
SIM,1849,35,na,1884,2296
STAT,1835,47,30-34,1882,0.07720128779358913
SIM,1875,24,15-19,1899,1
SIM,1904,46,na,1950,3985
SIM,1864,36,40-44,1900,7
STAT,1837,47,50-100,1884,0.20442372969449146
STAT,1849,29,30-34,1878,24.79213798086156
SIM,1965,3,na,1968,4974
STAT,1929,22,25-29,1951,115.99004815619705
STAT,1881,33,35-39,1914,9.523114304999067
STAT,1891,45,na,1936,2794.7961623883475
STAT,1886,37,35-39,1923,7.324364534617398
SIM,1874,43,45-49,1917,6
STAT,1852,16,25-29,1868,6.939719879535517
STAT,1855,40,30-34,1895,0.7685700458518746
STAT,1803,52,30-34,1855,0.013003466070543705
STAT,1949,0,na,1949,5088.422985237604
STAT,1874,23,50-100,1897,0.41956634630545764
SIM,1883,36,15-19,1919,11
STAT,1912,45,50-100,1957,0.21585512838774715
STAT,1853,46,35-39,1899,0.10886262401898543
STAT,1894,4,na,1898,3345.3365285589043
STAT,1895,48,35-39,1943,0.10144122616321016
STAT,1846,15,na,1861,1728.1044895986913
STAT,1878,23,50-100,1901,0.41826655517092776
STAT,1874,35,15-19,1909,0.05850565063765224
SIM,1893,60,na,1953,1952
STAT,1832,23,45-49,1855,0.9127947384145639
STAT,1809,105,na,1914,0.02854003930099304
STAT,1793,82,na,1875,150.6323419893825
STAT,1825,39,15-19,1864,0.0769768940408878
STAT,1831,54,35-39,1885,0.006863985355434096
SIM,1883,18,15-19,1901,53
STAT,1828,39,35-39,1867,9.106425626702217
STAT,1874,53,45-49,1927,0.01473729226555129
STAT,1855,22,30-34,1877,13.772265410253874
STAT,1886,36,50-100,1922,1.2775084068503488
STAT,1777,95,na,1872,6.472582053359031
STAT,1814,42,35-39,1856,6.337526883011662
STAT,1936,20,15-19,1956,5.042190428833255
SIM,1937,22,25-29,1959,395
STAT,1919,26,50-100,1945,1.0648258427437631
STAT,1875,36,15-19,1911,0.05793996910751864
STAT,1867,24,15-19,1891,3.100454546386593
STAT,1948,16,na,1964,4170.387537142156
STAT,1886,19,35-39,1905,0.5651685831711158
SIM,1842,45,na,1887,3110
SIM,1871,34,30-34,1905,22
SIM,1944,0,na,1944,2732
STAT,1845,32,15-19,1877,0.08402112451641983
SIM,1921,18,na,1939,5272
STAT,1872,86,na,1958,289.3997696257268
SIM,1829,44,45-49,1873,5
STAT,1813,41,35-39,1854,11.280381957943884
SIM,1850,27,20-24,1877,7
STAT,1929,40,25-29,1969,0.09208424293735368
STAT,1842,27,20-24,1869,3.601454737135431
STAT,1850,36,45-49,1886,0.9448529377536322
STAT,1857,39,30-34,1896,4.048551256058197
STAT,1839,39,15-19,1878,0.06106395271929878
STAT,1861,83,na,1944,330.1514384382681
STAT,1878,46,40-44,1924,0.17664251338401993
SIM,1881,38,50-100,1919,2
STAT,1939,30,40-44,1969,3.9534221819587545
SIM,1858,9,na,1867,2591
STAT,1873,1,na,1874,3578.404974456252
STAT,1856,68,na,1924,1097.6333202555
STAT,1892,48,15-19,1940,2.7584487113457726E-4
STAT,1858,49,20-24,1907,0.00897263519382873
STAT,1820,35,20-24,1855,1.6185524307341816
SIM,1833,40,na,1873,2195
STAT,1841,25,40-44,1866,4.203311641722834
STAT,1851,50,40-44,1901,0.008434144541960443
STAT,1823,41,na,1864,2209.3183162059345
STAT,1941,23,50-100,1964,0.6720345529856837
STAT,1910,0,na,1910,4399.61359793056
STAT,1842,48,na,1890,551.4928258819452
SIM,1929,34,35-39,1963,8
STAT,1860,26,25-29,1886,35.13116443725496
STAT,1921,44,50-100,1965,0.13031636345512898
STAT,1883,42,35-39,1925,1.7399362886164822
STAT,1797,95,na,1892,0.13290826168393516
STAT,1819,36,na,1855,703.3001066359157
SIM,1852,37,30-34,1889,12
SIM,1887,20,na,1907,3884
STAT,1916,6,na,1922,4180.703681087574
STAT,1867,24,20-24,1891,64.76462528830258
STAT,1848,44,35-39,1892,1.671640706703413
STAT,1882,76,na,1958,1008.0225478250075
SIM,1826,29,30-34,1855,13
STAT,1924,19,15-19,1943,53.237756895092204
STAT,1862,39,40-44,1901,3.690973048144405
SIM,1866,98,na,1964,40
STAT,1866,43,45-49,1909,1.3562923206074846
STAT,1872,42,25-29,1914,0.6422384307200075
STAT,1822,37,45-49,1859,4.021674336788367
STAT,1830,25,30-34,1855,24.565456405988613
STAT,1846,51,40-44,1897,0.006264947436785247
STAT,1910,38,35-39,1948,2.276053488509152
STAT,1890,71,na,1961,1790.4289355517803
STAT,1812,89,na,1901,8.319669411678488
STAT,1870,43,na,1913,2287.5068178281836
STAT,1881,27,50-100,1908,0.6040920777742056
STAT,1895,23,15-19,1918,4.278348491071478
SIM,1891,42,35-39,1933,3
SIM,1889,32,na,1921,3869
STAT,1909,17,25-29,1926,8.411694487849953
STAT,1841,31,40-44,1872,5.920438394344294
STAT,1861,52,20-24,1913,6.104184974315864E-4
STAT,1922,19,15-19,1941,51.65827906910464
STAT,1851,84,na,1935,262.7349187493375
STAT,1900,20,35-39,1920,8.132038064544457
STAT,1833,37,20-24,1870,0.41717319217937143
STAT,1898,60,na,1958,2632.06343584264
STAT,1880,50,na,1930,2267.4431230132313
STAT,1857,41,45-49,1898,1.1536604642372725
STAT,1891,19,45-49,1910,0.07989817451301914
STAT,1816,51,35-39,1867,0.02569933645300152
STAT,1893,17,na,1910,3158.3407244945997
SIM,1867,20,na,1887,2460
STAT,1916,39,na,1955,3761.9083908971925
STAT,1876,18,30-34,1894,1.607033934555598
STAT,1821,63,na,1884,926.9518987255699
STAT,1923,26,45-49,1949,1.969355906150818
SIM,1879,32,40-44,1911,2
STAT,1834,92,na,1926,18.35511600546088
STAT,1844,37,30-34,1881,5.579459305941706
STAT,1845,18,35-39,1863,0.3421096834600522
STAT,1872,16,50-100,1888,0.04951148210166027
SIM,1822,40,40-44,1862,2
STAT,1922,37,15-19,1959,0.02160718478661581
STAT,1940,23,40-44,1963,3.385667310680094
STAT,1825,56,na,1881,1357.3660301105658
STAT,1828,32,15-19,1860,0.21569166767995315
STAT,1861,45,50-100,1906,0.20628780980059155
STAT,1856,24,45-49,1880,0.5733715744832739
SIM,1917,17,25-29,1934,14
STAT,1874,38,20-24,1912,0.7916213081670441
STAT,1872,51,50-100,1923,0.015195642262368709
STAT,1892,15,15-19,1907,7.381668402040568
STAT,1820,51,20-24,1871,0.0011417520461127278
STAT,1860,43,45-49,1903,1.212127485860715
SIM,1878,91,na,1969,70
STAT,1851,35,15-19,1886,0.045766040448759246
STAT,1898,46,50-100,1944,0.18682445008220658
STAT,1895,41,15-19,1936,0.0012531591679571985
STAT,1865,84,na,1949,303.71852324318877
SIM,1827,46,30-34,1873,3
STAT,1834,81,na,1915,238.3177651712218
STAT,1888,31,30-34,1919,20.23372332522483
STAT,1869,33,15-19,1902,0.1430945854944357
SIM,1894,37,30-34,1931,13
STAT,1814,40,40-44,1854,9.101944808911194
STAT,1914,33,40-44,1947,3.8679887429150965
STAT,1869,37,35-39,1906,7.137156915912459
STAT,1861,91,na,1952,48.191893691700926
SIM,1909,22,15-19,1931,1
STAT,1886,37,30-34,1923,5.519044806296835
STAT,1895,35,50-100,1930,1.6123049732608126
STAT,1873,17,na,1890,2590.715306218304
STAT,1853,30,20-24,1883,2.2036571457694016
STAT,1881,31,40-44,1912,4.112104802201584
STAT,1865,45,15-19,1910,3.6883696851397935E-4
SIM,1897,50,na,1947,2249
STAT,1872,52,30-34,1924,0.0059289109802875975
SIM,1833,71,na,1904,1813
SIM,1870,39,40-44,1909,43
SIM,1927,34,na,1961,1663
SIM,1923,21,na,1944,4291
STAT,1841,63,na,1904,1986.9388030950904
STAT,1836,27,25-29,1863,41.94338782236522
STAT,1805,51,25-29,1856,0.0042346170459595526
STAT,1892,21,45-49,1913,0.8659560650333794
STAT,1910,14,na,1924,3856.934996546453
STAT,1889,30,35-39,1919,12.293293504009782
STAT,1851,17,15-19,1868,5.698612009915255
STAT,1851,29,15-19,1880,0.41355250020470213
STAT,1870,27,30-34,1897,25.10467018045191
SIM,1852,55,na,1907,1806
STAT,1849,66,na,1915,1381.0166374642629
SIM,1875,24,20-24,1899,1
STAT,1815,41,40-44,1856,0.24303744536392521
STAT,1904,39,20-24,1943,0.23531537801097177
STAT,1821,50,25-29,1871,0.003803752576743379
STAT,1912,33,40-44,1945,3.7898962847499993
STAT,1807,47,20-24,1854,0.042212067708903456
STAT,1935,25,25-29,1960,89.15361730315972
STAT,1914,15,40-44,1929,0.28663660147811804
SIM,1823,35,40-44,1858,4
SIM,1838,40,na,1878,1966
STAT,1799,99,na,1898,0.12593972995889763
STAT,1871,26,35-39,1897,9.658258336396782
STAT,1856,39,45-49,1895,1.4174181917604463
SIM,1920,33,40-44,1953,1
STAT,1848,10,na,1858,2803.96672078867
STAT,1898,71,na,1969,2156.212058486019
STAT,1825,42,45-49,1867,1.9904216894911821
STAT,1850,43,na,1893,1059.5323900865947
SIM,1896,31,30-34,1927,5
STAT,1902,43,25-29,1945,0.06234007062732833
SIM,1833,30,45-49,1863,5
STAT,1882,26,40-44,1908,2.877825775541719
SIM,1821,83,na,1904,446
STAT,1892,33,45-49,1925,2.149904452941378
SIM,1880,21,25-29,1901,10
STAT,1857,52,35-39,1909,0.0065710913979284795
STAT,1856,42,40-44,1898,1.6135613607405133
STAT,1915,31,35-39,1946,9.213100768229772
SIM,1891,5,na,1896,2810
STAT,1897,22,40-44,1919,2.7674063691635915
STAT,1852,49,25-29,1901,0.056768897174579704
SIM,1883,47,na,1930,2156
STAT,1825,30,45-49,1855,3.4244176819705445
STAT,1930,29,20-24,1959,23.02488612467046
STAT,1932,31,35-39,1963,12.07064439327274
STAT,1906,23,35-39,1929,8.424080625233474
SIM,1891,65,na,1956,1011
STAT,1863,38,45-49,1901,1.6934228657896544
STAT,1851,32,45-49,1883,1.433478541510797
STAT,1811,47,50-100,1858,1.1543534139462974
STAT,1877,25,20-24,1902,11.98962836484791
SIM,1917,13,na,1930,2415
STAT,1812,45,35-39,1857,0.03768598496325529
STAT,1847,88,na,1935,124.12042178611564
STAT,1832,35,50-100,1867,0.08730897419630142
STAT,1846,18,na,1864,1697.7483848740037
STAT,1892,15,45-49,1907,0.08125114923848878
SIM,1849,34,20-24,1883,4
STAT,1821,52,20-24,1873,7.616151838659274E-4
SIM,1832,55,na,1887,1207
STAT,1836,42,20-24,1878,0.1447713612304233
STAT,1819,46,30-34,1865,0.01841513538946415
STAT,1845,54,30-34,1899,0.0028725299690347886
STAT,1889,45,35-39,1934,0.1702722873177947
STAT,1865,73,na,1938,1084.4075682004714
SIM,1851,14,na,1865,1456
STAT,1880,37,35-39,1917,7.342784913540605
SIM,1919,37,50-100,1956,23
SIM,1863,47,na,1910,505
STAT,1842,41,35-39,1883,0.4710787032568879
STAT,1840,30,40-44,1870,2.1234921828069857
STAT,1841,43,40-44,1884,2.569579726462605
STAT,1842,23,35-39,1865,1.814024846632919
STAT,1850,52,45-49,1902,0.0066656020556937826
STAT,1916,36,50-100,1952,0.4261316961304125
STAT,1860,36,50-100,1896,1.0064036051222405
STAT,1842,30,45-49,1872,0.533920764240569
STAT,1878,40,30-34,1918,1.194793738879958
STAT,1894,31,20-24,1925,3.451414987497258
SIM,1886,40,30-34,1926,3
STAT,1882,41,35-39,1923,1.7415362354272723
SIM,1822,48,na,1870,1485
STAT,1813,46,35-39,1859,0.5254345439633712
STAT,1831,41,25-29,1872,0.6360774868332272
SIM,1889,42,45-49,1931,15
STAT,1827,40,20-24,1867,0.15484234089166468
SIM,1850,23,35-39,1873,2
STAT,1897,37,40-44,1934,5.813551100449804
STAT,1852,17,50-100,1869,0.05964418043570585
STAT,1851,20,45-49,1871,0.6672373931928647
STAT,1941,21,35-39,1962,9.623163567633501
SIM,1889,36,45-49,1925,1
STAT,1818,74,na,1892,675.4797775813034
SIM,1858,28,30-34,1886,8
STAT,1863,32,35-39,1895,8.645600770730422
STAT,1866,25,15-19,1891,0.41695788646824083
STAT,1902,39,na,1941,3310.1184964088147
STAT,1847,52,40-44,1899,0.009467556014079682
SIM,1866,37,25-29,1903,2
SIM,1911,6,na,1917,2657
SIM,1934,16,na,1950,5257
STAT,1821,71,na,1892,674.0971618263011
SIM,1909,3,na,1912,4331
STAT,1833,51,na,1884,931.1384052607087
SIM,1860,73,na,1933,1638
STAT,1842,25,na,1867,673.7456976121605
STAT,1872,25,40-44,1897,3.0199871692919245
STAT,1878,49,45-49,1927,0.23774338566076328
SIM,1824,33,35-39,1857,80
STAT,1854,47,35-39,1901,0.07747956954510218
SIM,1820,53,na,1873,390
STAT,1866,28,15-19,1894,0.4126903677452259
SIM,1911,28,na,1939,2514
STAT,1787,74,na,1861,208.0862357582049
STAT,1791,70,na,1861,846.5335722871416
STAT,1824,82,na,1906,90.29476680185441
STAT,1877,31,20-24,1908,2.7551433661294578
STAT,1832,50,35-39,1882,7.165831989267136E-4
STAT,1862,35,25-29,1897,2.475620431711054
STAT,1929,26,40-44,1955,5.795149096780623
STAT,1811,48,25-29,1859,0.26642100779282757
STAT,1833,33,35-39,1866,5.650940329299925
STAT,1811,64,na,1875,1243.165524567551
SIM,1895,72,na,1967,3903
STAT,1896,42,40-44,1938,0.20564633956697717
STAT,1880,30,15-19,1910,0.1490295289178724
SIM,1853,36,30-34,1889,2
STAT,1905,37,15-19,1942,0.017433119221769967
STAT,1857,38,15-19,1895,0.04287711384620656
STAT,1909,32,20-24,1941,2.30393269063421
SIM,1859,25,na,1884,2130
STAT,1831,51,30-34,1882,0.005036531978835899
STAT,1898,42,45-49,1940,0.1395840369317072
SIM,1870,17,25-29,1887,4
STAT,1862,17,25-29,1879,5.527891130756085
STAT,1883,24,35-39,1907,5.578839378471729
STAT,1878,47,50-100,1925,0.25151222788575495
STAT,1914,17,50-100,1931,0.0764225720246952
STAT,1845,36,30-34,1881,2.8076889766423903
STAT,1833,51,35-39,1884,0.003878776292690068
STAT,1897,43,40-44,1940,0.20593572307713456
SIM,1920,0,na,1920,5151
STAT,1877,43,20-24,1920,0.16004976374931035
STAT,1870,46,35-39,1916,0.13996690565166095
STAT,1821,38,40-44,1859,5.259173108391921
STAT,1832,38,50-100,1870,0.09673806081611258
STAT,1858,16,20-24,1874,15.908639839298173
STAT,1851,30,50-100,1881,0.7689888882789064
STAT,1896,45,na,1941,2995.9292393558694
STAT,1909,41,50-100,1950,0.10939160707009409
STAT,1955,16,40-44,1971,1.8411030082035205
SIM,1850,29,na,1879,1872
SIM,1883,39,na,1922,2068
SIM,1945,8,na,1953,6355
STAT,1856,17,na,1873,1949.4914382033935
STAT,1940,26,45-49,1966,1.7427119196779235
SIM,1834,23,20-24,1857,308
STAT,1887,32,25-29,1919,11.273759967142096
STAT,1830,28,35-39,1858,9.21142847771952
STAT,1843,26,25-29,1869,51.80905666882431
STAT,1874,98,na,1972,24.363942859008468
STAT,1925,36,20-24,1961,0.31378034358597295
STAT,1879,41,30-34,1920,1.1847118748861356
STAT,1877,46,25-29,1923,0.058636941369302656
STAT,1886,38,na,1924,2427.631320207073
STAT,1854,100,na,1954,0.5902934104176955
STAT,1863,10,na,1873,2354.703285108309
STAT,1851,53,45-49,1904,0.011277765391972224
SIM,1817,78,na,1895,1118
STAT,1805,56,na,1861,429.56140792632567
STAT,1854,26,35-39,1880,6.22518324694661
STAT,1914,18,45-49,1932,0.10162979318132065
STAT,1832,103,na,1935,0.121826228407129
STAT,1900,7,na,1907,3609.1619406895416
SIM,1832,78,na,1910,167
STAT,1885,50,50-100,1935,0.015058570257117234
STAT,1829,51,40-44,1880,0.004799605330641472
SIM,1876,65,na,1941,2726
STAT,1835,35,30-34,1870,5.089962294705577
SIM,1851,26,25-29,1877,322
STAT,1850,33,40-44,1883,2.073206703273513
STAT,1871,26,30-34,1897,25.20624902050069
STAT,1903,32,na,1935,3387.3952987156736
STAT,1841,22,50-100,1863,0.5752557241608762
STAT,1830,40,25-29,1870,0.5824179007917768
STAT,1852,28,20-24,1880,13.655367963724466
SIM,1907,14,na,1921,4894
SIM,1907,28,20-24,1935,16
STAT,1866,46,15-19,1912,3.661638424760022E-4
SIM,1917,21,na,1938,2278
STAT,1912,36,45-49,1948,0.660804008297984
SIM,1866,58,na,1924,2670
STAT,1900,49,30-34,1949,0.07406177368479043
STAT,1862,53,20-24,1915,6.184247117631071E-4
STAT,1804,50,25-29,1854,0.023295326647980962
STAT,1806,97,na,1903,1.6176810506626003
SIM,1839,25,na,1864,1023
SIM,1862,26,35-39,1888,74
STAT,1834,29,15-19,1863,0.25844269738566783
STAT,1911,50,na,1961,3407.809806646768
STAT,1867,17,50-100,1884,0.04736632075355029
SIM,1861,5,na,1866,2725
SIM,1944,23,na,1967,2508
STAT,1815,50,35-39,1865,8.765620347613496E-4
STAT,1837,58,na,1895,1585.7041329277565
STAT,1951,19,na,1970,4339.359503710588
STAT,1891,16,40-44,1907,0.22547355927207877
SIM,1833,28,30-34,1861,6
SIM,1836,37,na,1873,2095
STAT,1852,46,20-24,1898,0.012113350277717446
STAT,1910,35,30-34,1945,1.7399668660408314
STAT,1879,32,50-100,1911,0.9399211947285737
STAT,1919,25,40-44,1944,5.003047216526824
STAT,1837,42,35-39,1879,1.7133211755014077
SIM,1849,32,na,1881,2296
STAT,1869,43,na,1912,2315.3826604719634
STAT,1872,28,45-49,1900,1.1078991022699638
SIM,1917,4,na,1921,2494
STAT,1892,19,30-34,1911,1.9627772017270213
STAT,1848,48,20-24,1896,0.011088198588571883
STAT,1861,25,30-34,1886,21.400711174880044
STAT,1879,23,30-34,1902,18.216087560773836
STAT,1880,16,35-39,1896,0.5710438975045219
SIM,1838,43,50-100,1881,2
STAT,1887,46,50-100,1933,0.27109283856668104
STAT,1893,29,20-24,1922,14.565653339422077
SIM,1827,49,35-39,1876,2
STAT,1862,32,20-24,1894,2.3023060234124837
STAT,1875,33,45-49,1908,1.7830911635254099
STAT,1914,36,45-49,1950,0.6744201617481416
STAT,1860,19,15-19,1879,5.5180583263123735
STAT,1895,45,30-34,1940,0.07174003746061315
STAT,1871,41,25-29,1912,0.6434781288354892
STAT,1925,18,20-24,1943,161.85101403476006
STAT,1870,32,50-100,1902,0.9134355488950483
SIM,1854,31,25-29,1885,3
STAT,1779,99,na,1878,0.5572670844411743
STAT,1901,42,25-29,1943,0.062273429640408724
STAT,1860,40,40-44,1900,1.853456839190119
SIM,1849,66,na,1915,586
STAT,1863,17,50-100,1880,0.04772622396580973
STAT,1830,46,35-39,1876,0.12118636498177734
STAT,1944,2,na,1946,4308.51503740479
STAT,1846,17,40-44,1863,0.13607973979894378
STAT,1858,34,20-24,1892,2.0465563523546306
STAT,1887,18,40-44,1905,0.20078904322078495
STAT,1945,15,40-44,1960,1.5118524805279105
STAT,1816,96,na,1912,7.24908347516357
SIM,1898,26,15-19,1924,1
SIM,1870,40,na,1910,1990
STAT,1886,35,na,1921,2462.90282704167
STAT,1909,57,na,1966,3194.7509298142504
STAT,1832,55,na,1887,1781.4954736603192
SIM,1890,32,40-44,1922,6
STAT,1846,35,40-44,1881,2.7642415788184005
STAT,1923,23,40-44,1946,3.8591261927486853
STAT,1891,34,40-44,1925,5.287326066538234
STAT,1884,27,25-29,1911,40.493982564472226
SIM,1909,0,na,1909,4331
SIM,1934,13,na,1947,5305
STAT,1856,36,40-44,1892,3.1592899548961646
STAT,1803,78,na,1881,236.23995426723187
SIM,1902,24,25-29,1926,26
STAT,1845,84,na,1929,165.07313505908792
STAT,1859,48,30-34,1907,0.0757589387601726
STAT,1935,22,20-24,1957,150.3298567518557
STAT,1811,110,na,1921,1.6741414210493102E-4
STAT,1860,37,15-19,1897,0.045810451737609365
STAT,1833,96,na,1929,3.5328703262805403
STAT,1925,20,50-100,1945,0.7850658742851565
STAT,1843,41,50-100,1884,1.0885902274371844
STAT,1905,41,50-100,1946,0.10599578482898993
STAT,1824,43,40-44,1867,0.3848964051363719
SIM,1899,29,30-34,1928,2
STAT,1836,24,20-24,1860,68.69378671507219
STAT,1914,49,25-29,1963,0.05157257002070477
SIM,1865,17,na,1882,1859
STAT,1897,42,50-100,1939,0.09730884314713151
SIM,1861,8,na,1869,2691
SIM,1844,45,25-29,1889,3
SIM,1933,18,20-24,1951,9
STAT,1856,21,40-44,1877,1.7508517773132888
SIM,1825,36,25-29,1861,8
STAT,1863,50,30-34,1913,0.0051547917876286434
STAT,1901,46,40-44,1947,0.13541048608377557
SIM,1832,43,40-44,1875,6
STAT,1837,48,45-49,1885,0.19393263095878488
SIM,1922,36,45-49,1958,1
STAT,1836,45,25-29,1881,0.04738982164392883
STAT,1846,31,25-29,1877,7.243673434630111
SIM,1849,55,na,1904,1928
STAT,1870,51,na,1921,2156.834704934101
STAT,1826,38,20-24,1864,1.2281093464265682
STAT,1869,37,30-34,1906,5.377980386191932
STAT,1882,32,40-44,1914,4.152016869051428
STAT,1850,34,15-19,1884,0.06737602268479559
STAT,1933,31,na,1964,5065.149916463174
STAT,1866,25,45-49,1891,1.0203814228809367
STAT,1923,8,na,1931,4634.077463517667
STAT,1925,47,50-100,1972,0.27156771660024415
STAT,1887,36,40-44,1923,4.8413902386149985
STAT,1812,42,30-34,1854,0.5571848639358795
STAT,1894,40,15-19,1934,0.01773858845522977
STAT,1858,109,na,1967,0.00518181722300972
STAT,1825,45,15-19,1870,5.21802971202361E-4
STAT,1949,22,15-19,1971,6.150238722065212
STAT,1934,16,na,1950,4957.034114118084
STAT,1781,89,na,1870,39.42773934185093
SIM,1853,39,35-39,1892,7
SIM,1817,45,30-34,1862,2
SIM,1892,27,25-29,1919,7
STAT,1867,39,20-24,1906,0.7216777553984588
SIM,1893,38,30-34,1931,17
STAT,1831,104,na,1935,0.05220278991803613
STAT,1893,47,20-24,1940,0.00842535887622638
SIM,1805,53,na,1858,2285
STAT,1856,51,35-39,1907,0.006213073002750308
SIM,1828,70,na,1898,830
STAT,1927,44,40-44,1971,0.31010266721945273
STAT,1878,43,35-39,1921,1.8496320327747837
STAT,1854,22,15-19,1876,2.155256458629039
SIM,1875,39,20-24,1914,1
STAT,1882,29,45-49,1911,1.0554180288304773
STAT,1845,39,35-39,1884,3.6118212180626625
STAT,1892,36,15-19,1928,0.06985924227298491
STAT,1841,46,45-49,1887,0.26739668811589656
STAT,1838,22,30-34,1860,9.86504576842771
STAT,1883,61,na,1944,1797.7081370080484
SIM,1810,48,50-100,1858,1
STAT,1844,19,30-34,1863,1.9836409698421202
STAT,1883,21,30-34,1904,17.18792142744413
STAT,1911,39,na,1950,3556.699917058543
STAT,1823,32,35-39,1855,27.992518128618975
STAT,1851,18,30-34,1869,1.5214876329140026
SIM,1818,37,25-29,1855,13
STAT,1872,21,25-29,1893,57.496506865860084
STAT,1900,4,na,1904,3644.253384909357
STAT,1834,47,15-19,1881,1.8695520910407272E-4
STAT,1877,28,25-29,1905,42.789880632574146
STAT,1897,25,45-49,1922,1.4845439799279778
STAT,1838,40,30-34,1878,0.5888412564425775
STAT,1909,35,25-29,1944,0.9312407206362521
STAT,1876,36,30-34,1912,5.413644345518559
STAT,1832,66,na,1898,1391.3137688783195
STAT,1890,23,35-39,1913,7.04264535533911
STAT,1927,30,15-19,1957,0.156965631067533
SIM,1846,22,30-34,1868,10
STAT,1852,55,na,1907,2081.3355142280802
STAT,1929,29,45-49,1958,2.1448753202889357
SIM,1864,32,na,1896,2415
STAT,1892,18,15-19,1910,7.328280172388644
SIM,1884,36,30-34,1920,5
STAT,1809,45,30-34,1854,0.8908472036231636
STAT,1819,49,35-39,1868,0.02490098919238315
STAT,1865,44,40-44,1909,2.0258494292378693
STAT,1868,54,30-34,1922,0.005591289540258354
STAT,1947,24,35-39,1971,10.522475393234819
SIM,1869,24,na,1893,2702
SIM,1824,30,30-34,1854,14
STAT,1892,75,na,1967,1630.42790289489
STAT,1849,91,na,1940,48.82635981220484
STAT,1937,20,30-34,1957,27.7181395017943
SIM,1869,32,na,1901,3589
STAT,1866,29,30-34,1895,22.82222047240883
SIM,1830,31,35-39,1861,8
STAT,1813,43,30-34,1856,5.1645708553107985
STAT,1938,30,25-29,1968,9.204382179873672
STAT,1902,29,45-49,1931,1.5523104018150826
STAT,1831,24,40-44,1855,3.3691106965758486
STAT,1875,48,15-19,1923,4.055795748000812E-4
SIM,1901,29,na,1930,3782
STAT,1842,20,30-34,1862,5.6581528986589795
SIM,1871,1,na,1872,2833
STAT,1838,40,na,1878,1075.8093074306187
STAT,1899,38,25-29,1937,0.8446072969391614
STAT,1856,39,15-19,1895,0.03992727775566573
STAT,1925,46,30-34,1971,0.10730093953367338
STAT,1948,20,40-44,1968,3.8237876790270207
STAT,1949,22,45-49,1971,1.2999887546040232
STAT,1821,34,25-29,1855,13.643015936068167
STAT,1875,83,na,1958,502.6488425432623
SIM,1885,17,na,1902,1854
STAT,1885,38,30-34,1923,5.212721089972321
STAT,1880,34,30-34,1914,17.970696774763788
SIM,1857,43,45-49,1900,25
STAT,1869,36,50-100,1905,1.2448558394376197
STAT,1876,68,na,1944,1544.867174591323
STAT,1910,25,20-24,1935,17.696887929206486
STAT,1870,44,15-19,1914,0.013581641592301928
STAT,1818,47,30-34,1865,0.17264143872789606
SIM,1853,40,na,1893,3222
STAT,1839,36,na,1875,2402.7506120972107
STAT,1934,27,na,1961,5005.372260804072
STAT,1855,43,na,1898,1518.6128267889544
SIM,1913,54,na,1967,2906
STAT,1891,35,15-19,1926,0.06971070154249506
SIM,1924,46,na,1970,5042
STAT,1864,30,30-34,1894,16.000323799016105
STAT,1939,33,40-44,1972,3.946507723267675
SIM,1843,35,30-34,1878,3
SIM,1821,43,30-34,1864,1
STAT,1889,49,20-24,1938,0.007981203670701806
STAT,1945,19,na,1964,3973.7109546219763
SIM,1856,14,na,1870,1191
SIM,1908,39,na,1947,2531
STAT,1907,19,15-19,1926,8.612647525640803
STAT,1895,27,35-39,1922,12.552025458069387
SIM,1829,66,na,1895,1590
STAT,1865,76,na,1941,864.9710746675754
SIM,1841,15,na,1856,1206
STAT,1809,52,50-100,1861,0.12471530071463112
SIM,1907,46,20-24,1953,1
STAT,1828,36,35-39,1864,9.715246079716058
STAT,1919,21,20-24,1940,120.5055550550599
STAT,1854,40,15-19,1894,0.007755988334492568
STAT,1929,35,50-100,1964,0.536173140169823
STAT,1802,52,15-19,1854,1.2495488424439514E-4
STAT,1824,44,15-19,1868,0.002372009684055317
STAT,1841,28,45-49,1869,1.5246358071449846
STAT,1914,40,50-100,1954,0.11559260443371998
SIM,1842,14,na,1856,3413
SIM,1881,0,na,1881,4260
STAT,1891,31,35-39,1922,12.504437273735988
STAT,1854,23,30-34,1877,11.553234367514783
STAT,1933,15,45-49,1948,0.667254804449467
SIM,1920,33,na,1953,3734
STAT,1897,61,na,1958,2550.404029370541
STAT,1936,25,40-44,1961,4.420275877708993
SIM,1914,42,45-49,1956,1
STAT,1885,41,20-24,1926,0.15681150681374192
SIM,1935,18,25-29,1953,27
SIM,1835,52,na,1887,1206
STAT,1850,38,30-34,1888,2.474141250410533
SIM,1867,29,20-24,1896,28
STAT,1866,47,25-29,1913,0.05233323451139438
SIM,1924,23,na,1947,5236
SIM,1827,57,na,1884,1716
STAT,1896,45,50-100,1941,0.18444658421430116
STAT,1889,66,na,1955,1973.7370168873226
STAT,1865,26,40-44,1891,2.7443086208570335
STAT,1898,32,30-34,1930,23.4783752095993
STAT,1927,16,30-34,1943,15.06878611831398
SIM,1918,29,na,1947,4400
STAT,1920,24,35-39,1944,10.268576795672026
STAT,1807,50,45-49,1857,0.04826832120809183
STAT,1846,69,na,1915,869.1685129779588
STAT,1845,16,15-19,1861,3.744054269377828
SIM,1944,9,na,1953,2516
STAT,1906,42,45-49,1948,0.15031243071366365
STAT,1885,39,50-100,1924,1.194662967365823
STAT,1850,74,na,1924,512.4578134419744
STAT,1864,42,30-34,1906,1.043883686568364
STAT,1894,17,50-100,1911,0.06230094081331694
STAT,1841,47,20-24,1888,0.013423359574310838
STAT,1852,35,30-34,1887,5.506984386192694
SIM,1869,86,na,1955,2525
STAT,1816,53,20-24,1869,0.0021168274590414758
STAT,1911,24,25-29,1935,86.07374815623378
SIM,1860,35,30-34,1895,7
STAT,1876,14,na,1890,2602.2274551502833
STAT,1902,15,15-19,1917,8.39562647648569
STAT,1927,45,na,1972,4595.504338901355
STAT,1948,24,20-24,1972,126.28122186797727
SIM,1878,30,30-34,1908,125
STAT,1883,44,20-24,1927,0.15072268606711636
STAT,1839,42,50-100,1881,1.03447232213336
STAT,1862,54,30-34,1916,0.004930608105268089
STAT,1873,42,40-44,1915,2.3044207085439967
SIM,1848,39,na,1887,2233
STAT,1907,17,na,1924,3685.1039825051394
STAT,1918,25,20-24,1943,19.294221374895525
STAT,1790,94,na,1884,5.864822666316152
STAT,1858,74,na,1932,847.5059132845316
STAT,1865,41,35-39,1906,1.6607374028812827
STAT,1894,29,50-100,1923,0.8076562627965399
STAT,1868,19,na,1887,2454.4065361588177
STAT,1949,9,na,1958,4525.22911347889
STAT,1886,15,20-24,1901,18.44408005026697
STAT,1888,31,50-100,1919,1.0618189627293095
STAT,1931,36,45-49,1967,0.8973187038195013
STAT,1887,31,na,1918,2637.2823335260377
STAT,1882,40,25-29,1922,0.6210113642042938
SIM,1876,34,na,1910,3760
SIM,1848,34,35-39,1882,22
STAT,1909,45,35-39,1954,0.11839425829889309
SIM,1879,3,na,1882,2987
SIM,1852,44,na,1896,1972
STAT,1896,20,30-34,1916,23.620760580272336
STAT,1907,25,45-49,1932,1.6310306848027574
STAT,1951,18,30-34,1969,14.374784724034104
STAT,1871,45,40-44,1916,0.17248206712881897
STAT,1825,87,na,1912,108.49435524072348
STAT,1870,49,40-44,1919,0.1671113892657966
STAT,1854,48,45-49,1902,0.12957138621970646
STAT,1873,31,na,1904,2457.8326314575042
STAT,1906,21,50-100,1927,0.5922924233024198
STAT,1944,15,20-24,1959,144.334667423095
SIM,1778,80,na,1858,830
SIM,1870,43,na,1913,1821
STAT,1879,23,35-39,1902,5.967770392750853
STAT,1880,52,25-29,1932,0.0036575810578469083
STAT,1801,97,na,1898,1.782231378698298
STAT,1911,48,50-100,1959,0.21112393911253963
STAT,1932,32,45-49,1964,2.077289621088812
STAT,1927,18,25-29,1945,53.303196462332124
STAT,1865,24,50-100,1889,0.37144281197120194
STAT,1848,29,45-49,1877,1.2226141239169859
STAT,1844,40,20-24,1884,0.1653188073836188
STAT,1859,44,15-19,1903,0.010797824365904415
SIM,1851,19,15-19,1870,79
STAT,1921,20,na,1941,4100.067575272991
STAT,1934,31,50-100,1965,1.121861826730478
STAT,1892,37,25-29,1929,3.564716263061483
STAT,1883,41,na,1924,2233.5733528124265
STAT,1902,31,20-24,1933,3.821895475989872
SIM,1840,41,40-44,1881,9
SIM,1808,50,na,1858,1411
STAT,1842,43,20-24,1885,0.040269635415595376
SIM,1917,45,35-39,1962,2
STAT,1887,51,na,1938,2381.3384431284176
STAT,1934,37,40-44,1971,2.0518123286640377
STAT,1843,19,15-19,1862,7.405268591971467
STAT,1782,99,na,1881,1.106662462323186
STAT,1900,43,20-24,1943,0.015166986886733763
STAT,1889,32,na,1921,2873.6554623863026
STAT,1856,34,50-100,1890,0.6524622649165979
SIM,1920,20,25-29,1940,126
STAT,1825,46,25-29,1871,0.07415090689963082
SIM,1911,50,na,1961,2293
STAT,1859,29,20-24,1888,9.323418716592302
STAT,1833,40,45-49,1873,0.8004280570492942
STAT,1914,5,na,1919,4087.9415342459683
STAT,1840,41,30-34,1881,0.4783075487518212
SIM,1913,51,na,1964,2906
STAT,1919,24,25-29,1943,99.17787480253533
SIM,1909,46,na,1955,3844
STAT,1942,22,na,1964,3785.1427584733724
STAT,1856,50,25-29,1906,0.0025806226075492677
SIM,1922,14,na,1936,3673
STAT,1861,33,15-19,1894,0.1179325545130094
STAT,1877,40,15-19,1917,0.01416009216045212
STAT,1924,47,25-29,1971,0.06254471192160803
SIM,1883,16,na,1899,2234
STAT,1838,109,na,1947,3.034178418247104E-4
STAT,1844,33,15-19,1877,0.16696737031016745
STAT,1905,46,45-49,1951,0.19201811697320798
STAT,1840,48,15-19,1888,1.568060205445824E-4
STAT,1832,41,40-44,1873,0.19548761147152174
STAT,1848,64,na,1912,1626.7115680674142
SIM,1945,21,40-44,1966,1
STAT,1844,18,20-24,1862,22.19466749339132
STAT,1805,52,50-100,1857,0.017689061263058022
STAT,1830,47,45-49,1877,0.2016850308839183
SIM,1876,68,na,1944,1766
STAT,1881,60,na,1941,1801.040862644136
STAT,1855,22,35-39,1877,4.511930318857573
STAT,1806,106,na,1912,0.0036560863397762334
SIM,1831,39,50-100,1870,2
STAT,1849,25,45-49,1874,1.1250840858795217
SIM,1855,47,50-100,1902,3
STAT,1889,27,40-44,1916,3.6073329839661845
STAT,1804,54,40-44,1858,0.06386456241172268
STAT,1926,42,30-34,1968,0.15625614841145713
STAT,1857,31,30-34,1888,13.621337713585605
STAT,1850,30,35-39,1880,5.48848660544395
STAT,1852,89,na,1941,105.74560684776375
STAT,1928,33,35-39,1961,11.332638252960262
STAT,1900,45,15-19,1945,3.1568242624282247E-4
SIM,1868,39,na,1907,1149
STAT,1841,34,50-100,1875,1.2124837612154231
STAT,1865,49,30-34,1914,0.08653227996814282
SIM,1894,15,20-24,1909,98
STAT,1898,49,na,1947,2962.7814157908947
SIM,1872,44,na,1916,2361
STAT,1937,21,40-44,1958,3.2414997165593737
STAT,1937,9,na,1946,3832.69939477583
STAT,1896,14,na,1910,3393.316328370748
STAT,1813,47,45-49,1860,0.8679690985539615
SIM,1823,41,na,1864,1497
SIM,1863,16,na,1879,1229
STAT,1859,51,20-24,1910,5.876678360060583E-4
STAT,1865,48,20-24,1913,0.01081823205572503
SIM,1894,53,na,1947,1169
STAT,1908,21,15-19,1929,4.870568373962251
SIM,1932,9,na,1941,6513
STAT,1890,29,na,1919,2868.4931369528767
STAT,1907,48,35-39,1955,0.11377946520288867
STAT,1924,40,40-44,1964,0.2954746422167191
SIM,1848,70,na,1918,1928
SIM,1903,21,na,1924,2982
STAT,1856,46,50-100,1902,0.17690391385863885
STAT,1902,26,40-44,1928,4.2327104180087
STAT,1829,32,35-39,1861,5.583491327416586
STAT,1839,36,40-44,1875,4.910832118126764
STAT,1880,38,45-49,1918,2.05928214553677
STAT,1818,43,15-19,1861,0.02625296666124763
STAT,1896,23,35-39,1919,7.668727078772958
STAT,1905,36,na,1941,3431.8277429109276
STAT,1807,48,30-34,1855,0.32912003910789495
STAT,1807,82,na,1889,198.88741717845926
STAT,1821,97,na,1918,2.7130743254828693
STAT,1835,43,15-19,1878,0.01236048446855581
STAT,1907,22,40-44,1929,3.0404789392924454
STAT,1903,39,35-39,1942,2.145254960498813
STAT,1875,30,40-44,1905,4.488962172218497
STAT,1814,51,30-34,1865,0.020020817128764166
STAT,1824,48,30-34,1872,0.01661280817117224
STAT,1923,49,30-34,1972,0.10258304905592529
STAT,1886,17,15-19,1903,6.145524648148475
STAT,1828,33,30-34,1861,25.581735618395136
STAT,1926,5,na,1931,4887.401339506833
STAT,1959,2,na,1961,5101.552811213571
STAT,1867,52,50-100,1919,0.014207087835919521
SIM,1852,24,na,1876,2391
STAT,1865,22,na,1887,2185.515985899014
STAT,1860,98,na,1958,4.1934727845663815
SIM,1926,41,25-29,1967,1
STAT,1865,40,25-29,1905,0.5921994496401451
STAT,1871,47,35-39,1918,0.13900502428157413
STAT,1923,41,35-39,1964,0.23321607826354088
SIM,1859,2,na,1861,3746
STAT,1871,101,na,1972,5.509789424665083
STAT,1808,106,na,1914,0.0028436291091431627
STAT,1895,24,30-34,1919,23.026451231042753
STAT,1917,26,15-19,1943,0.732968692083817
STAT,1848,51,45-49,1899,0.013645324574854496
STAT,1885,34,15-19,1919,0.13878108291024155
STAT,1925,35,50-100,1960,0.5001728741342745
STAT,1908,47,40-44,1955,0.14148243208899
STAT,1881,46,na,1927,2130.664333222759
SIM,1858,15,na,1873,2443
STAT,1891,39,30-34,1930,6.4879725783196855
STAT,1924,48,35-39,1972,0.151595787417696
STAT,1878,94,na,1972,102.50683926613604
STAT,1928,31,40-44,1959,4.8588078828483505
SIM,1927,24,25-29,1951,3
SIM,1911,39,35-39,1950,1
STAT,1867,31,na,1898,2266.028838310525
STAT,1818,50,20-24,1868,0.0013141568226438909
STAT,1837,20,50-100,1857,0.43425307146313785
STAT,1874,39,30-34,1913,5.4451188786623925
STAT,1838,22,35-39,1860,3.2318865323599724
STAT,1874,19,45-49,1893,0.0670556253374575
STAT,1869,19,35-39,1888,0.5547663798936546
STAT,1824,40,35-39,1864,0.3045257761315995
STAT,1933,38,35-39,1971,3.268839177052285
STAT,1936,28,na,1964,3547.8479968198494
STAT,1917,42,20-24,1959,0.018184084948513538
STAT,1854,98,na,1952,1.8062463304786471
STAT,1845,22,na,1867,1317.1324666640285
STAT,1960,9,na,1969,5071.776521241667
STAT,1881,49,15-19,1930,3.698518905413367E-4
SIM,1832,24,na,1856,2409
SIM,1880,73,na,1953,3193
STAT,1918,41,25-29,1959,0.07500767121167798
SIM,1909,25,20-24,1934,37
STAT,1850,15,40-44,1865,0.10443245608839376
STAT,1890,32,30-34,1922,21.136860774207292
STAT,1890,43,na,1933,2777.7914982303455
STAT,1832,89,na,1921,89.1772462815272
SIM,1817,47,na,1864,2640
STAT,1782,107,na,1889,0.025713822896990382
STAT,1823,41,30-34,1864,1.974609144604638
STAT,1883,47,25-29,1930,0.05515534612759981
STAT,1918,40,15-19,1958,0.0016152165438369144
STAT,1887,30,30-34,1917,19.371915361074944
STAT,1812,48,40-44,1860,0.04347032877442949
STAT,1863,41,na,1904,1982.0617650300815
STAT,1818,53,25-29,1871,0.00594126753956826
SIM,1872,45,35-39,1917,1
STAT,1920,21,30-34,1941,31.636596639933398
SIM,1954,2,na,1956,5556
STAT,1900,44,na,1944,3169.4175204068797
STAT,1901,35,20-24,1936,0.23484576134280283
STAT,1845,17,25-29,1862,3.554030325688732
SIM,1913,31,na,1944,3263
STAT,1874,44,50-100,1918,1.0756112248600138
STAT,1908,28,30-34,1936,36.624450576200516
STAT,1868,41,20-24,1909,0.15408694576495133
STAT,1841,40,35-39,1881,2.149737084012295
STAT,1918,29,50-100,1947,1.0375167634368607
STAT,1932,39,30-34,1971,2.4265977392785656
STAT,1807,68,na,1875,844.1384171766927
STAT,1878,23,15-19,1901,3.3837760417819203
STAT,1869,18,25-29,1887,5.7632292599073205
SIM,1882,44,50-100,1926,11
STAT,1871,23,30-34,1894,17.713624795412553
SIM,1876,41,20-24,1917,2
STAT,1883,31,45-49,1914,1.6844881411795154
SIM,1783,81,na,1864,783
STAT,1881,42,30-34,1923,1.0843499687954212
SIM,1870,63,na,1933,804
STAT,1925,43,25-29,1968,0.08552830082194837
SIM,1898,35,na,1933,4265
SIM,1858,0,na,1858,2651
STAT,1881,15,50-100,1896,0.04648032684311942
STAT,1864,45,35-39,1909,0.12854373712117045
STAT,1850,40,45-49,1890,0.6980644104451097
SIM,1951,16,15-19,1967,132
STAT,1824,50,45-49,1874,0.0025455587386876448
STAT,1836,26,15-19,1862,0.45311583956416257
STAT,1947,8,na,1955,4380.492042462414
STAT,1905,19,15-19,1924,8.490010584682262
STAT,1895,49,45-49,1944,0.1695610960863602
SIM,1896,34,na,1930,3646
SIM,1869,27,30-34,1896,199
STAT,1857,19,45-49,1876,0.05822331313073645
STAT,1800,78,na,1878,545.5262116134087
SIM,1930,23,na,1953,4729
STAT,1853,17,na,1870,2141.0557567377327
STAT,1875,15,45-49,1890,0.06738820696669541
STAT,1943,16,15-19,1959,47.58962517592303
STAT,1935,8,na,1943,5413.168928594585
STAT,1896,68,na,1964,2241.08700140293
STAT,1885,44,25-29,1929,0.62268772395233
STAT,1918,54,na,1972,3756.1134389021727
STAT,1879,53,30-34,1932,0.006008318242219129
STAT,1865,29,45-49,1894,1.0064517524804646
STAT,1814,43,45-49,1857,5.083753067504114
STAT,1903,35,na,1938,3402.737467601843
STAT,1891,41,45-49,1932,1.8487891058468524
STAT,1891,38,20-24,1929,0.943233279979925
STAT,1892,30,40-44,1922,5.412420834421585
STAT,1878,40,na,1918,2401.957987847407
STAT,1867,46,30-34,1913,0.0918065881849039
STAT,1884,42,15-19,1926,0.013203492990831107
STAT,1871,48,45-49,1919,0.23246223221700987
STAT,1906,41,35-39,1947,0.18291400250777773
SIM,1818,40,na,1858,935
STAT,1927,15,20-24,1942,167.9755532355411
STAT,1927,19,50-100,1946,0.45956716377713264
SIM,1874,53,na,1927,2445
STAT,1820,54,25-29,1874,0.0051637845418051435
STAT,1816,40,45-49,1856,5.176333498697492
STAT,1932,12,na,1944,5210.140108298686
STAT,1824,47,20-24,1871,0.002082692634689907
STAT,1850,54,na,1904,966.9090593122163
STAT,1912,30,50-100,1942,0.8105722630440455
SIM,1936,33,35-39,1969,1
STAT,1907,45,na,1952,3316.0795158337123
STAT,1912,48,45-49,1960,0.2058722218029918
STAT,1925,23,50-100,1948,0.7779980413475925
SIM,1891,11,na,1902,2686
STAT,1875,37,25-29,1912,2.956510025570689
SIM,1845,76,na,1921,553
SIM,1861,35,na,1896,2174
SIM,1895,30,30-34,1925,62
STAT,1810,88,na,1898,4.27426608230265
SIM,1866,44,na,1910,2937
SIM,1898,25,35-39,1923,13
STAT,1935,25,20-24,1960,24.724968985772666
SIM,1870,2,na,1872,4030
SIM,1839,44,35-39,1883,6
STAT,1822,51,25-29,1873,0.005822151827399487
STAT,1947,11,na,1958,4378.959048964689
SIM,1910,7,na,1917,4577
STAT,1862,16,15-19,1878,5.823451825710676
STAT,1898,35,35-39,1933,9.60140412829844
STAT,1892,34,20-24,1926,3.3179877564321725
STAT,1915,7,na,1922,4111.070136037771
STAT,1838,74,na,1912,473.2940231355026
SIM,1835,66,na,1901,1160
STAT,1838,52,30-34,1890,0.0025275010130185855
STAT,1853,49,40-44,1902,0.12997489838210805
STAT,1912,20,25-29,1932,88.01677020898794
STAT,1909,42,30-34,1951,0.1183616869355726
STAT,1844,43,25-29,1887,0.6432579935461102
STAT,1881,34,45-49,1915,1.632675564031712
SIM,1853,71,na,1924,2333
STAT,1869,34,30-34,1903,17.46744379414565
SIM,1875,46,30-34,1921,1
STAT,1841,91,na,1932,64.52866201408771
STAT,1920,38,50-100,1958,0.4533231419613103
STAT,1855,52,30-34,1907,0.003918641766167526
SIM,1791,68,na,1859,859
STAT,1879,16,25-29,1895,5.8274330345193075
SIM,1852,43,25-29,1895,3
STAT,1886,18,25-29,1904,5.8528065754174605
SIM,1889,52,na,1941,3740
SIM,1890,49,na,1939,3485
STAT,1837,22,15-19,1859,3.462839837079841
STAT,1865,51,45-49,1916,0.013313099197069496
SIM,1874,25,na,1899,2584
STAT,1929,26,na,1955,4657.648101135953
STAT,1840,33,45-49,1873,0.8276811252170347
STAT,1870,29,na,1899,2362.199471001815
STAT,1804,53,30-34,1857,0.036847154932722136
STAT,1863,27,na,1890,2037.4042332897488
STAT,1833,65,na,1898,695.3134441631134
STAT,1928,30,30-34,1958,19.572433797287154
SIM,1879,62,na,1941,798
STAT,1900,28,30-34,1928,34.76132654504772
STAT,1919,50,na,1969,3896.374055223727
STAT,1902,41,30-34,1943,0.11292961756020259
SIM,1910,49,50-100,1959,3
STAT,1907,45,30-34,1952,0.0804657376949578
STAT,1823,44,35-39,1867,2.894681295646322
STAT,1839,39,45-49,1878,2.167770063734231
SIM,1847,39,45-49,1886,2
STAT,1825,43,20-24,1868,0.20778457173529047
STAT,1834,45,50-100,1879,0.12941743340113127
STAT,1926,35,25-29,1961,1.1950701953988947
STAT,1830,51,50-100,1881,0.01158279156180282
STAT,1910,32,25-29,1942,8.812158947404379
SIM,1861,49,40-44,1910,3
STAT,1856,79,na,1935,502.1348318489371
STAT,1902,40,20-24,1942,0.015686318991202847
STAT,1922,43,40-44,1965,0.2834414531788912
STAT,1890,35,35-39,1925,8.643849520462908
STAT,1829,110,na,1939,1.009102337263697E-4
STAT,1863,31,25-29,1894,8.779971738071822
STAT,1923,25,50-100,1948,1.138419814077734
STAT,1859,54,25-29,1913,0.002730172353741371
SIM,1792,64,na,1856,1100
STAT,1830,44,40-44,1874,1.9381168210105864
STAT,1879,56,na,1935,2092.337839590291
SIM,1904,57,na,1961,3873
STAT,1842,46,25-29,1888,0.014485673187187652
STAT,1863,53,35-39,1916,0.0072316530129954435
STAT,1867,29,50-100,1896,0.600652443937392
SIM,1902,31,30-34,1933,3
SIM,1921,49,na,1970,5139
STAT,1910,31,15-19,1941,0.12302022124861939
SIM,1842,45,50-100,1887,3
STAT,1860,13,na,1873,2235.8824638323576
STAT,1942,27,50-100,1969,1.0327413607747007
STAT,1802,59,na,1861,1444.2370948734977
SIM,1814,50,na,1864,2442
STAT,1834,36,25-29,1870,1.5948224157112973
STAT,1849,42,50-100,1891,0.8890618507186455
SIM,1881,35,na,1916,3084
STAT,1916,46,20-24,1962,0.011208098421268426
STAT,1926,45,35-39,1971,0.15846243011028918
SIM,1885,62,na,1947,976
STAT,1806,51,40-44,1857,0.028472947809792298
STAT,1830,28,50-100,1858,0.610687572249041
STAT,1829,25,50-100,1854,0.639881285545476
STAT,1830,43,30-34,1873,1.0033993684635816
STAT,1842,45,15-19,1887,1.0189195346217758E-4
SIM,1909,28,25-29,1937,45
STAT,1816,73,na,1889,1030.061322492215
STAT,1850,18,45-49,1868,0.03664212758725674
STAT,1863,52,25-29,1915,0.0030077623944156496
STAT,1914,27,na,1941,3723.979460794646
STAT,1913,22,35-39,1935,9.009616051659489
STAT,1903,55,na,1958,2995.2423216633038
SIM,1850,43,na,1893,1300
STAT,1933,35,30-34,1968,2.469892422450945
SIM,1807,57,na,1864,1094
STAT,1817,58,na,1875,755.3080996288242
STAT,1896,45,45-49,1941,0.1772369460344662
STAT,1838,24,50-100,1862,0.22261660559893903
STAT,1855,21,50-100,1876,0.31757937061116853
SIM,1928,39,na,1967,4599
SIM,1946,24,na,1970,3755
STAT,1856,100,na,1956,0.9045160075847454
STAT,1883,47,na,1930,2154.3532591107946
SIM,1825,42,na,1867,453
STAT,1862,79,na,1941,595.4566227891911
STAT,1861,94,na,1955,16.621280776721928
STAT,1934,18,30-34,1952,16.33205839280219
SIM,1890,18,na,1908,3965
SIM,1831,44,35-39,1875,1
STAT,1857,34,35-39,1891,7.704586559964589
STAT,1872,55,na,1927,2070.5248156368775
SIM,1835,19,30-34,1854,10
STAT,1785,93,na,1878,3.0666003704163356
STAT,1948,23,40-44,1971,3.8198887403869355
STAT,1869,12,na,1881,2683.819267571501
STAT,1928,34,45-49,1962,1.9501073116296037
STAT,1871,44,30-34,1915,1.1313639772481088
STAT,1826,45,30-34,1871,0.14226200528082006
STAT,1883,46,15-19,1929,3.859095211624774E-4
STAT,1924,28,15-19,1952,0.8112042087212337
STAT,1843,41,na,1884,2381.550023303362
STAT,1829,91,na,1920,21.160773749704703
STAT,1850,37,20-24,1887,0.3615851028677467
STAT,1849,24,35-39,1873,5.859654162498333
STAT,1887,85,na,1972,673.0358550609229
STAT,1858,40,na,1898,1782.8208931875754
STAT,1886,0,na,1886,3439.196014096505
SIM,1845,22,15-19,1867,25
SIM,1921,22,35-39,1943,159
STAT,1829,54,45-49,1883,0.005673340309442261
SIM,1878,69,na,1947,1639
STAT,1883,34,50-100,1917,0.873921024355812
SIM,1852,78,na,1930,1138
STAT,1927,19,35-39,1946,5.1471531879488355
STAT,1846,103,na,1949,0.08499833005828597
STAT,1866,44,20-24,1910,0.14301071845129085
STAT,1854,13,na,1867,1580.6139952762362
STAT,1893,36,30-34,1929,6.696863253804907
STAT,1888,39,na,1927,2691.8159607548096
SIM,1918,35,40-44,1953,19
STAT,1957,4,na,1961,5139.537123811715
SIM,1794,73,na,1867,438
STAT,1820,49,45-49,1869,0.36109612433865756
STAT,1822,52,35-39,1874,0.013872620090682235
STAT,1841,107,na,1948,0.005251521167757393
SIM,1952,4,na,1956,6381
SIM,1910,57,na,1967,3570
SIM,1931,25,na,1956,4977
STAT,1887,8,na,1895,2861.250846352184
STAT,1910,23,50-100,1933,0.6091183340219466
STAT,1936,18,50-100,1954,0.35420332311973823
STAT,1910,36,40-44,1946,1.422508240630784
SIM,1883,67,na,1950,1771
STAT,1927,30,50-100,1957,1.0099108955035778
STAT,1930,17,50-100,1947,0.48097020447707534
STAT,1872,40,30-34,1912,1.162847653825705
STAT,1874,33,na,1907,2452.4385724147123
STAT,1916,24,50-100,1940,0.6758275977647238
STAT,1809,91,na,1900,56.40501770556673
STAT,1846,53,35-39,1899,0.005016941984161434
STAT,1816,38,30-34,1854,20.758135389643527
STAT,1941,26,na,1967,3832.947577148206
STAT,1947,24,50-100,1971,0.7353233141034436
STAT,1896,2,na,1898,3513.949248084727
STAT,1893,32,15-19,1925,0.17808475774129465
STAT,1912,49,na,1961,3469.213257882241
STAT,1936,7,na,1943,3789.03933067722
STAT,1883,29,30-34,1912,24.05292700343287
STAT,1887,17,30-34,1904,1.7543293641052617
STAT,1846,38,na,1884,1442.0883084326185
STAT,1883,40,40-44,1923,2.185735054362898
STAT,1912,24,40-44,1936,3.2982202987206364
STAT,1835,53,25-29,1888,0.0026776325933980044
STAT,1872,49,50-100,1921,0.24079900319392256
STAT,1876,45,na,1921,2297.056723748382
STAT,1909,40,na,1949,3477.3915134888307
SIM,1891,2,na,1893,2852
STAT,1898,17,40-44,1915,0.24595281423798313
STAT,1847,15,35-39,1862,0.6265370892716366
SIM,1852,75,na,1927,1138
STAT,1929,17,45-49,1946,0.6330497237748124
STAT,1901,24,30-34,1925,24.74949263552103
SIM,1863,43,35-39,1906,10
STAT,1910,34,na,1944,3575.033357009714
STAT,1881,52,40-44,1933,0.00988883717513247
STAT,1837,41,25-29,1878,0.6154181425934914
STAT,1864,4,na,1868,2754.6017417418343
STAT,1835,28,20-24,1863,11.485384051483631
STAT,1895,20,15-19,1915,4.31721575136843
SIM,1828,26,30-34,1854,98
STAT,1826,103,na,1929,0.1144153536437571
SIM,1873,45,50-100,1918,1
SIM,1908,30,na,1938,2762
STAT,1893,44,15-19,1937,0.0011830473743970834
STAT,1933,16,25-29,1949,57.758178050879344
STAT,1861,40,20-24,1901,0.1334084313037152
STAT,1912,29,35-39,1941,14.518866408863097
STAT,1832,80,na,1912,525.1105607621479
STAT,1866,38,na,1904,2139.9131743414728
SIM,1935,32,na,1967,5630
STAT,1903,17,25-29,1920,8.043984580284366
SIM,1790,83,na,1873,776
STAT,1848,41,35-39,1889,1.7142496311828979
STAT,1821,40,na,1861,1426.4176614759378
STAT,1942,28,35-39,1970,15.570084216081826
SIM,1941,16,25-29,1957,941
STAT,1851,33,20-24,1884,2.199048893502453
STAT,1811,49,35-39,1860,0.6372540294823245
SIM,1894,34,30-34,1928,41
STAT,1884,46,30-34,1930,0.09292705836929245
STAT,1912,45,40-44,1957,0.15046578993066181
STAT,1840,51,40-44,1891,0.004165144090014517
STAT,1957,1,na,1958,5145.967031553747
SIM,1850,28,30-34,1878,1
SIM,1817,38,20-24,1855,13
STAT,1867,42,15-19,1909,0.013044291564619838
STAT,1928,18,40-44,1946,1.7444372912827404
SIM,1929,15,na,1944,6274
STAT,1843,44,50-100,1887,1.047543948572004
SIM,1861,26,15-19,1887,1
STAT,1870,33,25-29,1903,10.168100384297365
STAT,1873,21,40-44,1894,2.143982031961229
SIM,1899,62,na,1961,1469
STAT,1842,28,30-34,1870,7.675120928853517
STAT,1907,46,50-100,1953,0.20271552363465944
STAT,1908,18,20-24,1926,26.026656737688
SIM,1884,29,20-24,1913,9
STAT,1886,34,30-34,1920,17.92561482724621
STAT,1853,26,15-19,1879,0.4104870460025614
STAT,1857,16,40-44,1873,0.16594024398193122
STAT,1889,42,35-39,1931,2.177942542869855
SIM,1915,26,25-29,1941,39
STAT,1876,29,20-24,1905,11.774656858185708
STAT,1861,15,na,1876,2220.2388119545444
STAT,1890,45,45-49,1935,0.28855165463687277
STAT,1852,7,na,1859,3013.293564623016
STAT,1924,23,20-24,1947,129.5461926791035
SIM,1882,8,na,1890,2313
STAT,1836,93,na,1929,22.367274580195705
STAT,1887,33,35-39,1920,11.099551428684686
SIM,1895,33,35-39,1928,8
STAT,1813,44,40-44,1857,9.14929026930889
STAT,1855,44,45-49,1899,0.9771607456902062
SIM,1937,10,na,1947,2989
STAT,1907,26,25-29,1933,61.933683697085414
STAT,1934,33,25-29,1967,12.526120265311777
STAT,1870,45,25-29,1915,0.057995834046804924
STAT,1858,15,45-49,1873,0.05896423612550648
SIM,1900,33,20-24,1933,20
STAT,1919,43,35-39,1962,0.21497900333125974
STAT,1921,41,50-100,1962,0.13093995764216482
SIM,1906,52,na,1958,3086
STAT,1935,28,25-29,1963,89.03331399229677
STAT,1823,54,45-49,1877,0.020939545591739887
STAT,1922,46,45-49,1968,0.2475096962572554
STAT,1869,15,20-24,1884,18.352825194684772
STAT,1803,54,25-29,1857,0.007406822140481529
STAT,1892,33,50-100,1925,1.1296108072842792
SIM,1841,38,na,1879,568
STAT,1861,60,na,1921,1586.0925427227444
STAT,1950,18,15-19,1968,53.1336459036354
SIM,1939,22,na,1961,4710
STAT,1911,46,35-39,1957,0.12098305944793906
STAT,1873,39,15-19,1912,0.057022464676346925
STAT,1896,65,na,1961,2374.914862888245
SIM,1867,23,na,1890,2219
STAT,1936,21,25-29,1957,87.46203754958785
STAT,1873,50,25-29,1923,0.0036855370501956935
STAT,1890,39,15-19,1929,0.06729692085362331
SIM,1878,15,na,1893,4356
STAT,1872,52,na,1924,2144.6171233237883
STAT,1861,18,20-24,1879,16.846488822670814
STAT,1891,59,na,1950,2389.933736047386
STAT,1942,21,15-19,1963,5.519381179284314
STAT,1920,46,45-49,1966,0.23774885811340074
SIM,1860,50,na,1910,2000
SIM,1900,67,na,1967,3491
STAT,1888,16,35-39,1904,0.6348555722264799
SIM,1897,42,35-39,1939,4
STAT,1925,21,15-19,1946,6.332573227976981
STAT,1890,74,na,1964,1620.0110487432416
SIM,1868,70,na,1938,328
STAT,1900,46,25-29,1946,0.045137371595954816
STAT,1847,31,40-44,1878,4.651686837213651
STAT,1838,36,50-100,1874,0.6390074126897505
STAT,1843,75,na,1918,1017.154586199738
STAT,1877,27,15-19,1904,0.4605626800975915
STAT,1819,43,30-34,1862,0.24128196273287839
STAT,1905,67,na,1972,2663.6614122780034
STAT,1808,46,25-29,1854,0.11183352314070105
SIM,1909,9,na,1918,4299
STAT,1833,30,35-39,1863,5.897788201817609
SIM,1898,15,na,1913,4409
STAT,1926,32,20-24,1958,2.924086136920702
STAT,1854,39,50-100,1893,0.6757761465365465
STAT,1927,38,45-49,1965,0.839828184237557
STAT,1925,47,40-44,1972,0.18930127490193702
STAT,1912,15,na,1927,3878.0948363813604
STAT,1892,52,na,1944,2651.704758183914
STAT,1809,94,na,1903,19.453969634350464
STAT,1941,29,na,1970,3827.4307780985887
STAT,1836,43,30-34,1879,1.0346774708088065
STAT,1779,106,na,1885,0.020662171239903576
STAT,1814,103,na,1917,0.09712874845558943
STAT,1941,22,45-49,1963,1.149558396089217
STAT,1857,50,40-44,1907,0.008194603715898901
STAT,1969,1,na,1970,4868.245614768502
STAT,1823,48,15-19,1871,6.152289671835292E-4
SIM,1844,43,30-34,1887,1
STAT,1843,48,35-39,1891,0.13658818898147318
STAT,1852,31,15-19,1883,0.1499666621165496
STAT,1872,22,35-39,1894,5.84341394883472
STAT,1880,19,na,1899,2607.9081651482506
STAT,1849,21,30-34,1870,18.276937742180895
STAT,1947,14,na,1961,4376.682382153729
STAT,1850,23,na,1873,1176.5073760462344
STAT,1916,31,15-19,1947,0.13139674358743586
STAT,1823,75,na,1898,813.2513471437445
STAT,1899,16,45-49,1915,0.08944100343893437
SIM,1902,45,na,1947,3281
STAT,1943,21,na,1964,3842.176327377876
SIM,1911,59,na,1970,2132
STAT,1812,54,35-39,1866,0.002034632111210231
STAT,1840,54,50-100,1894,0.00578324455523456
STAT,1829,46,na,1875,908.3746771553749
STAT,1838,71,na,1909,569.2554128864025
STAT,1846,16,30-34,1862,1.1928636521718174
STAT,1827,52,20-24,1879,6.530358063961471E-4
STAT,1927,31,25-29,1958,11.2834691641876
STAT,1948,7,na,1955,4452.242769053188
STAT,1901,45,30-34,1946,0.07710825741179755
STAT,1846,32,35-39,1878,7.08798048351887
STAT,1878,42,25-29,1920,0.6598821895265822
SIM,1843,16,na,1859,458
SIM,1854,32,35-39,1886,2
STAT,1884,49,35-39,1933,0.13121993938616267
STAT,1911,34,35-39,1945,8.723050964089007
STAT,1916,38,35-39,1954,2.4310313669207635
STAT,1862,33,30-34,1895,14.808401296897742
STAT,1882,45,na,1927,2175.4953012408655
STAT,1804,106,na,1910,0.007692979503771116
SIM,1857,30,na,1887,1470
STAT,1826,41,15-19,1867,0.0211175850561197
STAT,1876,51,20-24,1927,7.495378108290183E-4
SIM,1801,63,na,1864,1783
STAT,1852,43,15-19,1895,0.013800391434486204
STAT,1864,49,15-19,1913,3.5604958370724106E-4
SIM,1938,29,na,1967,4216
STAT,1897,18,35-39,1915,0.72680501053516
SIM,1812,55,na,1867,1143
SIM,1918,31,25-29,1949,3
STAT,1922,49,15-19,1971,4.1601441989078076E-4
SIM,1829,41,40-44,1870,4
STAT,1825,53,na,1878,1440.3862392840933
STAT,1902,44,35-39,1946,0.17468128808706673
STAT,1843,41,15-19,1884,0.014229938653389725
SIM,1810,44,30-34,1854,12
STAT,1888,32,40-44,1920,5.0052807701083415
SIM,1853,33,30-34,1886,17
STAT,1913,6,na,1919,4033.3161927256706
STAT,1910,35,50-100,1945,0.40082569680754077
STAT,1795,83,na,1878,165.7765497233186
SIM,1863,30,na,1893,1069
SIM,1847,23,na,1870,1712
STAT,1920,44,na,1964,4035.579618884696
STAT,1806,48,15-19,1854,0.00128036155396902
STAT,1866,21,30-34,1887,16.510691730048176
SIM,1891,29,30-34,1920,132
STAT,1815,46,na,1861,217.09871682790427
STAT,1930,40,30-34,1970,0.16749500785448562
STAT,1857,35,15-19,1892,0.04350008340566386
SIM,1896,32,40-44,1928,1
STAT,1926,16,15-19,1942,55.30061159326812
STAT,1870,74,na,1944,1106.3849987653816
SIM,1824,38,30-34,1862,9
STAT,1819,39,na,1858,688.4550960801942
STAT,1779,76,na,1855,559.38555
STAT,1874,67,na,1941,1636.0502379103493
STAT,1845,33,30-34,1878,10.194893955949532
STAT,1827,36,15-19,1863,0.056055724312608725
STAT,1867,88,na,1955,129.8332184989799
STAT,1910,37,na,1947,3557.8959455782046
STAT,1866,40,40-44,1906,2.073898419839844
STAT,1894,27,15-19,1921,0.5769547081696371
STAT,1816,52,45-49,1868,0.0424679243687789
STAT,1846,50,30-34,1896,0.003576124475620082
STAT,1901,20,na,1921,3326.5774121263385
STAT,1833,38,30-34,1871,2.8483710719546136
STAT,1837,26,30-34,1863,26.103274760770848
STAT,1892,55,na,1947,2560.023409986026
STAT,1841,94,na,1935,22.25579713351345
STAT,1916,15,45-49,1931,0.10502501770427582
SIM,1847,20,na,1867,1712
STAT,1912,27,45-49,1939,1.6827140235743976
STAT,1835,46,na,1881,1817.4607061210615
STAT,1845,53,na,1898,1051.2835119830404
STAT,1854,27,50-100,1881,0.3728688845536856
STAT,1874,31,35-39,1905,10.494518379099501
STAT,1861,43,25-29,1904,0.5301875496997626
SIM,1927,40,30-34,1967,1
SIM,1838,49,na,1887,1869
SIM,1871,31,25-29,1902,2
STAT,1860,23,20-24,1883,57.53690515998326
STAT,1834,33,50-100,1867,0.5118980891321717
STAT,1894,40,50-100,1934,1.3570019176641577
STAT,1898,36,15-19,1934,0.07587542558024625
STAT,1899,8,na,1907,3550.6351815020275
SIM,1892,49,35-39,1941,1
STAT,1805,52,35-39,1857,0.01008334114148101
STAT,1942,25,30-34,1967,40.68991628767207
STAT,1885,18,50-100,1903,0.048030365658291496
STAT,1809,53,15-19,1862,1.9901805770270874E-4
STAT,1876,30,50-100,1906,0.9336852376459226
STAT,1902,56,na,1958,2934.654845623793
STAT,1853,52,30-34,1905,0.004590968714598048
STAT,1909,16,15-19,1925,8.830885752218306
STAT,1901,27,35-39,1928,13.491278292008547
STAT,1910,39,45-49,1949,0.6382095619537681
STAT,1911,21,20-24,1932,104.58345490753781
SIM,1894,22,na,1916,1761
STAT,1872,43,35-39,1915,1.8001770512869426
SIM,1836,68,na,1904,939
STAT,1907,23,20-24,1930,100.23930418273197
STAT,1820,46,40-44,1866,0.27262016826448865
STAT,1907,48,na,1955,3242.0906094808693
STAT,1921,39,20-24,1960,0.29023254801580384
STAT,1883,43,45-49,1926,1.4294314710668978
SIM,1917,44,na,1961,2000
STAT,1814,61,na,1875,1583.8313909984793
STAT,1829,60,na,1889,708.2921612781269
STAT,1884,26,na,1910,2292.392806331647
STAT,1840,54,45-49,1894,0.005557189402593196
STAT,1933,18,15-19,1951,60.18167372655174
SIM,1858,49,na,1907,2314
STAT,1906,49,30-34,1955,0.07741851141031662
STAT,1835,50,20-24,1885,5.919883366402521E-4
STAT,1830,54,na,1884,1554.4917883253493
STAT,1945,17,50-100,1962,0.40474578672134437
SIM,1818,43,na,1861,859
STAT,1874,16,40-44,1890,0.18923173910047078
STAT,1859,59,na,1918,1540.3753373762486
STAT,1894,33,na,1927,3021.7669238625995
STAT,1811,46,30-34,1857,0.4623312450339449
STAT,1917,55,na,1972,3667.252104200659
STAT,1777,98,na,1875,1.484960753952656
SIM,1907,37,na,1944,4612
STAT,1820,47,na,1867,1773.1896185591165
SIM,1837,32,35-39,1869,81
SIM,1915,23,20-24,1938,789
STAT,1944,18,25-29,1962,46.095772036654594
STAT,1838,44,45-49,1882,0.6627172758307214
STAT,1856,17,35-39,1873,0.46601205189837974
STAT,1883,22,50-100,1905,0.39231198815051344
STAT,1900,21,45-49,1921,0.9689058165317185
STAT,1834,33,20-24,1867,1.5101744300584772
STAT,1856,93,na,1949,20.99124290414944
STAT,1869,66,na,1935,1653.895443687144
SIM,1926,28,25-29,1954,8
STAT,1836,100,na,1936,0.8125162093198778
STAT,1838,20,na,1858,1200.1237571803724
STAT,1931,33,40-44,1964,5.0885494648075635
SIM,1869,23,15-19,1892,7
SIM,1810,77,na,1887,2322
SIM,1942,11,na,1953,3646
STAT,1921,18,50-100,1939,0.4208893964054265
STAT,1918,31,50-100,1949,0.8702745317340193
STAT,1864,26,na,1890,2177.0484631815657
STAT,1924,26,25-29,1950,76.16109617697988
STAT,1842,24,15-19,1866,1.018175487574507
STAT,1863,16,30-34,1879,1.5618930185789304
STAT,1913,44,45-49,1957,0.1597302642796381
STAT,1843,72,na,1915,1247.796663491953
STAT,1890,42,40-44,1932,2.719637232738973
STAT,1791,79,na,1870,360.7192638463218
STAT,1919,40,30-34,1959,0.137083550570112
SIM,1861,38,na,1899,2179
STAT,1886,30,15-19,1916,0.14865566798830182
STAT,1918,28,25-29,1946,68.85930108983099
STAT,1949,19,20-24,1968,156.01910714682012
STAT,1811,87,na,1898,106.73575653866006
STAT,1823,51,40-44,1874,0.016124537291880913
STAT,1842,42,45-49,1884,0.3843908315885321
SIM,1830,30,25-29,1860,10
STAT,1876,44,15-19,1920,0.013772027565675372
SIM,1865,42,na,1907,1694
SIM,1878,33,35-39,1911,14
STAT,1901,23,na,1924,3296.6287235220993
STAT,1870,30,20-24,1900,2.716429754412014
STAT,1808,98,na,1906,0.7608204770821829
STAT,1902,34,25-29,1936,8.210913585550037
STAT,1882,48,20-24,1930,0.0113445648274189
STAT,1885,19,20-24,1904,17.332795186650323
STAT,1827,41,50-100,1868,1.0162445402028781
SIM,1909,15,na,1924,4249
SIM,1850,42,45-49,1892,17
STAT,1854,41,25-29,1895,0.35866623304831313
STAT,1848,26,40-44,1874,3.37065950852769
STAT,1909,26,na,1935,3554.7133878098334
STAT,1937,21,na,1958,3520.536143185577
STAT,1836,29,50-100,1865,0.6252025903898369
STAT,1854,45,40-44,1899,0.0961392322648712
STAT,1864,31,40-44,1895,3.9586473408083975
STAT,1861,47,40-44,1908,0.14171350393269755
STAT,1863,38,50-100,1901,1.0429403231278676
STAT,1881,15,na,1896,2396.131798043979
STAT,1839,51,35-39,1890,0.00803665425272778
SIM,1863,40,30-34,1903,6
STAT,1911,30,na,1941,3670.6116264955617
SIM,1884,63,na,1947,3459
STAT,1874,0,na,1874,3803.1810887894917
STAT,1905,43,40-44,1948,0.22303463513115118
SIM,1957,10,na,1967,6080
STAT,1847,34,na,1881,2257.818845886322
STAT,1890,24,45-49,1914,0.8388978342674587
STAT,1883,25,15-19,1908,0.4394426746885122
STAT,1924,44,20-24,1968,0.02073539886742942
STAT,1823,33,45-49,1856,4.03167272171582
STAT,1855,12,na,1867,1879.2057241963462
SIM,1831,33,45-49,1864,69
SIM,1892,41,na,1933,3638
STAT,1821,53,30-34,1874,0.00602298755274617
SIM,1930,31,40-44,1961,3
STAT,1878,26,na,1904,2463.8466883535666
SIM,1881,21,40-44,1902,31
STAT,1858,100,na,1958,1.3281229579853056
STAT,1904,32,35-39,1936,8.307812060356255
STAT,1880,35,40-44,1915,4.587683929689293
SIM,1874,56,na,1930,2445
STAT,1932,35,15-19,1967,0.0256665338462803
SIM,1869,4,na,1873,3989
STAT,1820,42,25-29,1862,1.0601944626870066
STAT,1893,48,30-34,1941,0.06742492048708949
STAT,1915,32,45-49,1947,1.5799858423469808
STAT,1848,49,30-34,1897,0.08869167343298993
SIM,1892,4,na,1896,3699
SIM,1905,56,na,1961,2737
STAT,1805,87,na,1892,23.636931709297187
STAT,1862,36,35-39,1898,6.053292649059926
STAT,1937,24,45-49,1961,1.0836336980182733
STAT,1831,42,35-39,1873,1.7697372721660634
SIM,1898,69,na,1967,3069
STAT,1861,30,45-49,1891,1.4618946590343158
STAT,1840,44,35-39,1884,0.724963790672976
STAT,1927,35,40-44,1962,1.849243282622841
SIM,1812,58,na,1870,1143
STAT,1875,34,20-24,1909,2.751877945592137
STAT,1906,30,45-49,1936,1.4616128466044924
STAT,1912,19,50-100,1931,0.0744780802623451
STAT,1849,12,na,1861,2475.9558304498382
STAT,1848,19,na,1867,2631.5093166391507
STAT,1906,45,15-19,1951,3.2999025411047377E-4
STAT,1845,51,50-100,1896,0.007530098317865145
SIM,1889,55,na,1944,3555
STAT,1846,40,20-24,1886,0.0976682321669976
STAT,1930,22,35-39,1952,11.97772134186461
SIM,1924,35,30-34,1959,13
SIM,1893,77,na,1970,229
STAT,1850,51,35-39,1901,0.0039943539169214936
STAT,1916,35,30-34,1951,1.8584422774346736
SIM,1890,63,na,1953,3139
STAT,1852,47,30-34,1899,0.09698345191300088
STAT,1911,31,30-34,1942,15.23096530685212
STAT,1917,45,25-29,1962,0.054923914969600154
STAT,1857,78,na,1935,599.5645764847939
STAT,1940,27,20-24,1967,18.405190035452964
STAT,1867,85,na,1952,259.25717194832157
STAT,1845,28,50-100,1873,0.38359028096795883
STAT,1779,79,na,1858,420.9394475651327
SIM,1941,18,na,1959,2599
STAT,1879,45,45-49,1924,0.24451181827801743
STAT,1874,41,45-49,1915,1.5516213025547767
STAT,1897,30,25-29,1927,13.712051064600061
SIM,1858,60,na,1918,2126
STAT,1812,80,na,1892,48.98947267703586
STAT,1895,46,40-44,1941,0.12598330801758725
SIM,1900,64,na,1964,3568
STAT,1851,36,25-29,1887,2.3223095666830504
SIM,1856,34,na,1890,740
SIM,1820,36,na,1856,724
STAT,1914,8,na,1922,4055.039626901548
STAT,1902,5,na,1907,3690.279458976349
SIM,1912,32,35-39,1944,20
STAT,1832,35,na,1867,2353.24909924319
STAT,1920,33,30-34,1953,16.963496894618675
SIM,1882,41,45-49,1923,2
STAT,1960,10,na,1970,5071.21862582433
SIM,1830,43,na,1873,439
STAT,1908,43,25-29,1951,0.06516285769022279
SIM,1870,49,na,1919,1412
STAT,1843,45,30-34,1888,0.09766762977365726
STAT,1950,16,25-29,1966,50.76621500102353
STAT,1910,43,15-19,1953,0.0014264972609731147
STAT,1907,28,15-19,1935,0.6596657269734902
STAT,1849,110,na,1959,4.39853013926177E-4
STAT,1857,53,45-49,1910,0.010957461984237011
STAT,1864,52,40-44,1916,0.009519800897600354
STAT,1814,54,35-39,1868,0.02728050264381147
STAT,1864,7,na,1871,2557.9488372444557
STAT,1866,24,35-39,1890,5.2933891271306175
STAT,1797,64,na,1861,34.093569788078874
STAT,1781,80,na,1861,264.7378351846391
STAT,1836,46,35-39,1882,0.11371730826586227
STAT,1901,24,50-100,1925,0.5666093250840701
STAT,1818,42,50-100,1860,2.0660480840633264
STAT,1892,21,50-100,1913,0.5064070748706344
STAT,1812,51,30-34,1863,0.0014942920395921522
STAT,1842,79,na,1921,173.54901237876814
STAT,1895,18,na,1913,3276.8835186306583
SIM,1935,18,na,1953,4568
SIM,1845,42,na,1887,2422
SIM,1891,25,15-19,1916,2
SIM,1885,48,na,1933,1216
STAT,1901,41,15-19,1942,0.0013469315478661281
STAT,1938,25,50-100,1963,0.9763885207755105
STAT,1881,45,35-39,1926,0.13352675123643634
STAT,1876,54,25-29,1930,0.0034821837844944106
STAT,1917,18,30-34,1935,2.581134931983013
STAT,1850,20,na,1870,1202.217657774286
STAT,1902,16,20-24,1918,25.02592992385755
STAT,1904,24,30-34,1928,25.28902547852771
STAT,1840,44,45-49,1884,0.5991836094380911
STAT,1917,38,na,1955,3836.3867117433965
STAT,1822,53,40-44,1875,0.016630435781076782
STAT,1843,12,na,1855,3014.25288
STAT,1841,37,15-19,1878,0.07367470203629627
STAT,1883,47,20-24,1930,0.011490697645925734
STAT,1884,10,na,1894,2479.6475836545033
STAT,1934,36,35-39,1970,3.3182218998726714
STAT,1886,1,na,1887,3244.537519698643
STAT,1913,24,na,1937,3618.532632021086
SIM,1908,35,20-24,1943,1
STAT,1929,32,35-39,1961,11.526407835374084
SIM,1855,65,na,1920,2860
STAT,1839,108,na,1947,0.001701792296923015
STAT,1907,24,50-100,1931,0.5912808674205136
STAT,1836,33,15-19,1869,0.13650908382516483
STAT,1898,18,na,1916,3387.3268696936507
STAT,1827,97,na,1924,3.7884598920818826
STAT,1869,3,na,1872,3176.3343907799544
STAT,1839,20,35-39,1859,7.067164672517498
SIM,1851,51,na,1902,1151
SIM,1924,18,15-19,1942,37
STAT,1835,40,45-49,1875,1.392056145958573
SIM,1933,38,35-39,1971,17
STAT,1909,19,na,1928,3728.905801761895
STAT,1825,54,20-24,1879,8.699166658236362E-4
STAT,1839,28,45-49,1867,1.290184526521575
STAT,1916,45,30-34,1961,0.09061224364392789
STAT,1865,23,40-44,1888,1.9117993504168493
STAT,1848,26,45-49,1874,1.249331978994306
STAT,1906,32,40-44,1938,3.6059044812505143
STAT,1859,36,50-100,1895,0.9777834336802903
STAT,1902,38,40-44,1940,1.3238948282784815
STAT,1822,66,na,1888,949.4645258878168
SIM,1842,15,na,1857,3281
STAT,1854,17,30-34,1871,1.060130062306449
STAT,1871,67,na,1938,1581.323948606446
STAT,1856,25,40-44,1881,2.2618878122100474
STAT,1788,89,na,1877,15.066637432394746
STAT,1805,70,na,1875,273.32991612522994
STAT,1872,25,na,1897,2405.980911169636
SIM,1881,1,na,1882,4260
STAT,1846,36,50-100,1882,0.767268467121956
STAT,1845,31,15-19,1876,0.0848981221178977
STAT,1898,42,35-39,1940,0.16888541498380663
SIM,1846,29,na,1875,1243
STAT,1792,94,na,1886,5.599177118373524
STAT,1846,18,35-39,1864,0.40583466689723935
STAT,1925,38,35-39,1963,2.873565318646726
STAT,1943,4,na,1947,4194.785212127412
STAT,1806,49,15-19,1855,0.0011404793298664952
STAT,1872,47,45-49,1919,0.2352191240284909
STAT,1926,6,na,1932,4871.957151273991
SIM,1889,30,40-44,1919,1
STAT,1777,114,na,1891,4.969004758219791E-4
STAT,1892,45,20-24,1937,0.008464208205633199
STAT,1809,84,na,1893,323.8063881067686
STAT,1955,2,na,1957,5178.414293064802
SIM,1930,40,na,1970,5214
STAT,1915,25,45-49,1940,1.7490203494467025
STAT,1863,48,na,1911,1896.5828598397443
STAT,1972,0,na,1972,5020.173177431097
STAT,1913,17,35-39,1930,0.8471725797208641
STAT,1838,41,25-29,1879,0.324715398169832
STAT,1839,82,na,1921,433.48591756938055
STAT,1863,15,30-34,1878,1.5711470748497958
STAT,1932,28,25-29,1960,85.5699942114101
STAT,1857,42,50-100,1899,0.8096823434048286
STAT,1798,83,na,1881,207.45730715061114
STAT,1927,37,30-34,1964,2.247546913015213
STAT,1831,51,40-44,1882,0.008907585466725227
SIM,1896,63,na,1959,2219
STAT,1814,54,45-49,1868,0.045987132964029044
STAT,1844,42,50-100,1886,1.0719085397312815
STAT,1932,22,40-44,1954,4.381015832090766
STAT,1810,46,50-100,1856,0.0013069351552702998
SIM,1858,14,na,1872,2443
SIM,1917,28,25-29,1945,24
SIM,1814,83,na,1897,16
STAT,1877,24,na,1901,2385.7794825972096
STAT,1905,25,50-100,1930,0.9263248429893716
STAT,1920,34,40-44,1954,4.195092507786791
STAT,1888,20,30-34,1908,20.68095311189817
STAT,1897,48,50-100,1945,0.18167499220276148
STAT,1928,38,50-100,1966,0.526042616767443
STAT,1892,29,na,1921,2933.621622340723
STAT,1903,37,45-49,1940,0.6107824476232668
STAT,1894,48,35-39,1942,0.09916314121166944
SIM,1884,78,na,1962,1955
SIM,1955,16,na,1971,2918
STAT,1875,48,25-29,1923,0.05840350742052257
STAT,1830,54,50-100,1884,0.010914651148075303
STAT,1881,61,na,1942,1764.6418268100972
STAT,1831,46,45-49,1877,0.22543167318746235
STAT,1885,75,na,1960,1166.695799048493
STAT,1837,25,30-34,1862,26.292051691918825
STAT,1874,35,50-100,1909,1.279146109086727
STAT,1879,42,25-29,1921,0.6579392414511293
SIM,1829,33,na,1862,2086
STAT,1888,23,50-100,1911,0.4692025583006837
STAT,1912,30,15-19,1942,0.12598337869313164
STAT,1826,28,50-100,1854,2.2775467274172163
STAT,1871,21,15-19,1892,3.3008559774681134
SIM,1910,16,20-24,1926,88
STAT,1902,25,35-39,1927,13.679419510906605
STAT,1859,26,20-24,1885,9.527163909144976
STAT,1909,28,25-29,1937,62.04455932038941
SIM,1867,50,na,1917,2035
STAT,1929,26,50-100,1955,1.2375341976162852
STAT,1822,50,na,1872,1447.5063541190257
STAT,1873,47,50-100,1920,0.2507569577240029
STAT,1877,34,15-19,1911,0.1433232544939795
STAT,1929,23,na,1952,4571.462655488497
STAT,1900,17,25-29,1917,7.850036315673072
STAT,1844,54,30-34,1898,0.005734957637642006
STAT,1818,45,na,1863,1751.4386382745056
STAT,1816,40,35-39,1856,6.262945607812013
SIM,1846,9,na,1855,1528
STAT,1842,46,20-24,1888,0.0030178487214383492
STAT,1875,46,50-100,1921,0.2529109340382915
SIM,1887,11,na,1898,3965
SIM,1899,16,15-19,1915,75
SIM,1837,52,na,1889,1705
STAT,1914,37,20-24,1951,0.2595381366626016
STAT,1882,15,40-44,1897,0.17592686628547397
SIM,1916,25,na,1941,3960
STAT,1824,34,50-100,1858,0.37572125450026106
SIM,1912,11,na,1923,4883
STAT,1899,21,45-49,1920,0.9553242547353327
STAT,1945,20,25-29,1965,100.18682157105059
STAT,1803,53,30-34,1856,0.012722455146902387
STAT,1865,18,45-49,1883,0.06109478174155318
SIM,1875,5,na,1880,3301
STAT,1825,49,25-29,1874,0.07126129424300404
STAT,1840,79,na,1919,275.27590445223416
STAT,1857,41,35-39,1898,1.3958360177564455
STAT,1886,32,15-19,1918,0.14747028091306455
STAT,1843,44,na,1887,2291.7515261975955
STAT,1827,81,na,1908,381.3425625441038
STAT,1871,35,35-39,1906,7.122555140592207
STAT,1869,23,25-29,1892,57.58701416185014
STAT,1860,37,25-29,1897,2.3488265098360297
SIM,1847,33,40-44,1880,1
SIM,1808,71,na,1879,1101
STAT,1842,86,na,1928,55.07953559073975
STAT,1919,38,35-39,1957,2.5613842078415208
STAT,1844,15,20-24,1859,22.591512901557614
SIM,1941,24,na,1965,3808
STAT,1864,50,50-100,1914,0.01392730838261848
SIM,1793,88,na,1881,591
SIM,1937,19,na,1956,2167
STAT,1944,0,na,1944,4746.010464108336
STAT,1910,27,35-39,1937,14.33563289236298
STAT,1912,32,40-44,1944,3.8059574250838537
SIM,1900,26,na,1926,4149
STAT,1926,25,20-24,1951,21.84178589315053
STAT,1889,24,40-44,1913,2.4936656079659274
STAT,1882,49,50-100,1931,0.2302304163920829
STAT,1883,42,50-100,1925,1.01510105359499
STAT,1917,27,20-24,1944,18.887658561043747
STAT,1919,41,50-100,1960,0.12580112948683458
SIM,1859,3,na,1862,3746
SIM,1852,15,20-24,1867,1
STAT,1887,19,35-39,1906,0.6007105852753547
STAT,1819,41,15-19,1860,0.0032949350089680218
STAT,1858,20,45-49,1878,0.6198603670919004
STAT,1855,38,50-100,1893,0.8085346169576466
STAT,1882,38,15-19,1920,0.05349628930891971
STAT,1914,21,35-39,1935,9.130264181804348
SIM,1928,4,na,1932,4662
STAT,1919,30,25-29,1949,9.918387428065332
STAT,1868,19,25-29,1887,5.506977185788578
STAT,1856,48,15-19,1904,2.836912308124804E-4
SIM,1880,32,na,1912,3259
SIM,1884,46,na,1930,3652
STAT,1918,48,45-49,1966,0.2275286222910276
STAT,1943,25,20-24,1968,19.23542272471246
SIM,1876,27,na,1903,3210
STAT,1821,44,35-39,1865,1.965970188869625
STAT,1934,27,20-24,1961,24.389757187565262
STAT,1903,42,40-44,1945,0.22144662821172031
STAT,1902,40,na,1942,3298.7897520324605
SIM,1945,2,na,1947,6372
STAT,1908,35,50-100,1943,0.39376019560991554
STAT,1923,24,40-44,1947,3.8468541714557434
STAT,1855,52,40-44,1907,0.006930490383520627
STAT,1881,45,45-49,1926,0.22508795177048516
STAT,1834,67,na,1901,698.6138464977868
SIM,1893,39,na,1932,3029
SIM,1936,20,25-29,1956,1219
STAT,1839,33,40-44,1872,4.907048962500777
SIM,1817,48,na,1865,2640
STAT,1903,31,50-100,1934,1.3059359972306954
STAT,1908,24,15-19,1932,4.825509135350462
STAT,1869,32,15-19,1901,0.14370100373017705
STAT,1828,27,50-100,1855,1.3384774314005765
STAT,1809,111,na,1920,1.0447486314801955E-4
STAT,1906,54,na,1960,3125.5623887999855
STAT,1843,31,50-100,1874,1.0996941730463263
SIM,1800,75,na,1875,216
STAT,1906,35,20-24,1941,0.24321966347248766
SIM,1821,53,na,1874,1900
SIM,1927,30,25-29,1957,2
STAT,1885,41,50-100,1926,1.0431373950064402
STAT,1838,45,50-100,1883,0.11066034385259496
STAT,1917,49,40-44,1966,0.1615289826783931
SIM,1836,27,30-34,1863,77
STAT,1895,18,30-34,1913,2.0679885320430764
STAT,1923,35,20-24,1958,0.302750964984862
STAT,1811,105,na,1916,0.017763367477733064
STAT,1888,46,50-100,1934,0.2842674077749397
STAT,1901,39,na,1940,3286.740528811393
STAT,1834,51,na,1885,992.4170568866303
STAT,1914,27,50-100,1941,0.9894590217818414
STAT,1801,88,na,1889,43.063524442660196
STAT,1851,47,25-29,1898,0.04527996556115685
STAT,1864,31,25-29,1895,9.349667747759648
STAT,1860,99,na,1959,2.881502889186943
STAT,1832,25,50-100,1857,0.7999585163818681
STAT,1908,46,35-39,1954,0.11657019587199792
STAT,1895,22,15-19,1917,4.291609564626176
STAT,1819,62,na,1881,459.9626708701899
STAT,1899,19,50-100,1918,0.06655754577464885
STAT,1903,32,15-19,1935,0.20214929008248195
STAT,1855,47,45-49,1902,0.1554652256854551
STAT,1881,45,na,1926,2145.8137784989635
STAT,1938,16,na,1954,3600.7974076110827
STAT,1879,21,50-100,1900,0.4195906170516826
STAT,1885,59,na,1944,1910.3268397682111
SIM,1869,57,na,1926,3598
SIM,1917,42,na,1959,1994
STAT,1828,27,30-34,1855,52.69001958447173
STAT,1835,40,50-100,1875,0.9826278649196171
SIM,1865,43,na,1908,1694
STAT,1868,38,50-100,1906,1.1799591851495617
SIM,1842,31,na,1873,2638
STAT,1928,16,40-44,1944,1.7533153455534929
SIM,1925,36,35-39,1961,9
STAT,1875,20,45-49,1895,0.7203185474022494
STAT,1942,21,na,1963,3786.392267921787
SIM,1905,41,na,1946,3096
STAT,1938,33,50-100,1971,0.8219319997420856
SIM,1846,45,na,1891,1025
SIM,1931,35,20-24,1966,1
STAT,1865,38,15-19,1903,0.051014321013472315
STAT,1928,39,15-19,1967,0.024033216922840293
SIM,1870,45,35-39,1915,1
STAT,1914,34,40-44,1948,3.8511243119959864
STAT,1874,16,45-49,1890,0.06758274753001593
STAT,1938,30,35-39,1968,9.100555184526916
STAT,1915,20,50-100,1935,0.64730406883909
STAT,1920,32,15-19,1952,0.13894667767419844
STAT,1876,41,45-49,1917,1.5198113882211148
STAT,1908,37,20-24,1945,0.24489989231061565
STAT,1834,47,25-29,1881,0.026921572536282645
STAT,1927,41,15-19,1968,0.0019130413045520874
STAT,1890,35,45-49,1925,2.4362491767343313
STAT,1952,15,20-24,1967,161.07093696907077
STAT,1798,67,na,1865,1129.3249206512962
STAT,1930,17,35-39,1947,5.386867288201512
SIM,1902,17,25-29,1919,11
STAT,1862,45,35-39,1907,0.12043255253487503
STAT,1809,50,45-49,1859,0.12483056570030582
SIM,1796,69,na,1865,846
SIM,1860,12,na,1872,2609
SIM,1900,10,na,1910,4181
STAT,1915,28,25-29,1943,65.953887090093
STAT,1890,5,na,1895,3172.56403435279
STAT,1853,33,15-19,1886,0.11253643457034004
SIM,1830,46,na,1876,378
STAT,1917,54,na,1971,3687.2740020316905
STAT,1891,28,15-19,1919,0.5559671393287174
STAT,1879,63,na,1942,1830.410389910896
STAT,1913,40,na,1953,3616.864128625027
SIM,1945,22,na,1967,6292
STAT,1838,65,na,1903,720.7221055188115
SIM,1905,4,na,1909,3894
SIM,1864,26,na,1890,2445
STAT,1837,50,20-24,1887,6.17827036142428E-4
SIM,1934,0,na,1934,5471
STAT,1886,24,15-19,1910,3.3949180016797227
STAT,1931,37,20-24,1968,0.3466627984142448
STAT,1898,30,40-44,1928,5.878531184555059
SIM,1926,19,na,1945,6133
SIM,1907,1,na,1908,4894
STAT,1920,46,35-39,1966,0.141037458399484
STAT,1892,44,50-100,1936,0.08960324578321205
STAT,1855,41,25-29,1896,0.4269259832220114
STAT,1824,37,15-19,1861,0.008866816168388662
SIM,1920,26,30-34,1946,87
STAT,1947,20,35-39,1967,10.536903540063879
SIM,1894,24,15-19,1918,2
STAT,1813,73,na,1886,925.101472615172
STAT,1912,26,30-34,1938,38.295264752928446
STAT,1902,19,25-29,1921,7.936869467772792
STAT,1843,71,na,1914,1318.842720864948
STAT,1903,40,15-19,1943,0.0013750228565443836
STAT,1849,30,45-49,1879,1.737140905676309
STAT,1842,54,20-24,1896,1.7814695632065432E-4
STAT,1868,15,50-100,1883,0.04874916705462558
STAT,1892,21,35-39,1913,7.246684393222773
STAT,1931,21,na,1952,4717.213475089496
STAT,1847,22,35-39,1869,6.467808231078717
STAT,1897,44,na,1941,3038.4720828218888
STAT,1893,30,na,1923,3008.1353619728866
STAT,1782,106,na,1888,0.04103247785435776
STAT,1910,32,30-34,1942,15.021355894292036
STAT,1954,18,35-39,1972,5.139915516797385
STAT,1886,46,35-39,1932,0.1453886308755671
STAT,1825,30,35-39,1855,19.886949520863954
STAT,1914,49,15-19,1963,3.581425490379857E-4
STAT,1921,25,45-49,1946,1.9155100851645395
SIM,1821,37,na,1858,1829
SIM,1933,33,50-100,1966,7
STAT,1879,44,50-100,1923,1.069121842688543
STAT,1869,20,45-49,1889,0.7108831011402527
STAT,1930,36,na,1966,4877.270194590183
STAT,1937,8,na,1945,3839.9569133420464
STAT,1871,99,na,1970,12.90637317198486
STAT,1827,43,15-19,1870,0.012930959853304553
STAT,1848,51,35-39,1899,0.008094684081113673
STAT,1903,34,40-44,1937,3.504522151225724
STAT,1925,35,30-34,1960,2.171228629345891
SIM,1880,48,na,1928,3193
STAT,1888,23,35-39,1911,6.714287823420241
STAT,1814,90,na,1904,53.35807756833292
SIM,1847,46,na,1893,1426
SIM,1912,27,35-39,1939,4
STAT,1922,18,15-19,1940,51.800731079573445
STAT,1928,20,25-29,1948,115.1338489379827
STAT,1894,34,15-19,1928,0.17954348027715716
STAT,1814,51,40-44,1865,0.035408717831542966
STAT,1901,55,na,1956,2911.984315272153
STAT,1928,28,35-39,1956,18.347103604558693
STAT,1923,27,45-49,1950,1.9626207089517818
STAT,1841,27,50-100,1868,0.8847594708678005
STAT,1877,50,50-100,1927,0.015551422802141964
STAT,1856,94,na,1950,14.355071372431635
STAT,1925,33,50-100,1958,0.9722276224633695
STAT,1881,42,40-44,1923,2.1214835002292185
STAT,1943,17,20-24,1960,142.1266684122632
STAT,1875,45,20-24,1920,0.012445074475882653
SIM,1879,36,40-44,1915,9
STAT,1853,47,35-39,1900,0.10804833159132342
STAT,1877,53,30-34,1930,0.005945534425421425
STAT,1916,48,35-39,1964,0.13007424137298818
SIM,1896,32,25-29,1928,2
STAT,1885,16,20-24,1901,17.469047752426494
STAT,1945,25,30-34,1970,42.549446169070386
STAT,1904,27,35-39,1931,13.785384835519453
SIM,1918,32,25-29,1950,50
SIM,1887,27,na,1914,3785
STAT,1896,42,25-29,1938,0.05871100424696512
STAT,1856,33,40-44,1889,3.1204278561862764
STAT,1908,38,35-39,1946,2.2359326609848575
STAT,1888,32,25-29,1920,11.821642130720075
STAT,1943,22,na,1965,3840.9084091898394
STAT,1848,23,40-44,1871,2.3572471031146907
STAT,1868,47,na,1915,2162.9247418948594
STAT,1808,54,20-24,1862,9.078212372594235E-4
STAT,1870,44,30-34,1914,1.1306715824181184
SIM,1863,7,na,1870,1723
STAT,1924,22,50-100,1946,0.7689670687068578
STAT,1872,36,50-100,1908,1.2353292214418783
SIM,1932,8,na,1940,6513
STAT,1829,51,25-29,1880,0.001614820472504392
STAT,1830,34,35-39,1864,9.316891465104137
STAT,1852,40,45-49,1892,1.521701064194337
SIM,1857,29,na,1886,1442
STAT,1941,18,25-29,1959,44.11445321306136
SIM,1853,15,na,1868,3603
STAT,1872,84,na,1956,361.2245944208799
STAT,1842,38,50-100,1880,0.35383705897003886
STAT,1941,15,45-49,1956,0.5089563446704627
SIM,1922,30,25-29,1952,2
STAT,1879,30,30-34,1909,18.05484391264775
STAT,1901,46,25-29,1947,0.04555866786043162
SIM,1892,3,na,1895,3699
STAT,1860,34,20-24,1894,2.186254676810119
SIM,1905,57,na,1962,2608
STAT,1843,28,na,1871,2611.5754928680194
SIM,1836,22,25-29,1858,32
SIM,1888,12,na,1900,667
STAT,1932,2,na,1934,5377.894556306306
STAT,1845,45,35-39,1890,0.070162971588466
STAT,1804,54,50-100,1858,0.09161878806579472
STAT,1804,109,na,1913,4.5078118773738876E-4
STAT,1858,53,50-100,1911,0.01134824901311391
STAT,1789,101,na,1890,0.24264732911652984
STAT,1934,28,35-39,1962,20.050550878190293
SIM,1908,22,na,1930,2780
STAT,1876,18,20-24,1894,17.874959379434827
SIM,1943,18,25-29,1961,168
STAT,1816,97,na,1913,4.535389076236086
STAT,1855,13,na,1868,1870.6741302084947
STAT,1859,27,na,1886,1924.1905628723905
SIM,1839,59,na,1898,334
STAT,1840,30,25-29,1870,5.015335963257545
STAT,1917,22,15-19,1939,5.582030385278037
STAT,1851,39,25-29,1890,2.2510820666208504
STAT,1821,41,30-34,1862,1.319322673873809
STAT,1869,20,20-24,1889,70.25270591053032
STAT,1937,17,45-49,1954,0.48094731986772277
SIM,1835,45,na,1880,1203
STAT,1870,77,na,1947,861.7411698701837
SIM,1831,31,na,1862,2182
STAT,1868,16,20-24,1884,17.536798396168642
SIM,1901,26,20-24,1927,29
STAT,1880,44,na,1924,2367.0361310556973
STAT,1848,40,50-100,1888,1.013010756503371
STAT,1833,40,35-39,1873,0.9684533242550546
STAT,1877,56,na,1933,2070.4739917873117
STAT,1867,62,na,1929,1728.5402854212875
STAT,1889,27,45-49,1916,1.3370547942762891
SIM,1860,28,na,1888,2133
STAT,1860,83,na,1943,323.8588817021529
STAT,1878,51,20-24,1929,7.628551433245596E-4
STAT,1843,106,na,1949,0.011996532766618656
STAT,1850,27,15-19,1877,0.24654249504500111
STAT,1925,43,30-34,1968,0.1531232476192433
STAT,1897,26,40-44,1923,3.991916803801119
STAT,1862,42,30-34,1904,0.9780140187182904
STAT,1830,31,50-100,1861,0.8696170746697465
STAT,1896,59,na,1955,2561.9300814513067
STAT,1903,45,45-49,1948,0.19085447461170246
STAT,1823,51,na,1874,1942.8838415123716
STAT,1834,44,20-24,1878,0.08224282276952878
STAT,1827,65,na,1892,1191.7472944027786
STAT,1812,46,35-39,1858,0.036859724551249556
STAT,1892,45,na,1937,2813.807427326346
STAT,1869,28,30-34,1897,25.321153506420497
STAT,1821,49,40-44,1870,0.17825489984953502
STAT,1886,76,na,1962,1200.6397280962533
SIM,1847,30,na,1877,1642
SIM,1819,35,30-34,1854,7
SIM,1818,49,na,1867,691
SIM,1914,18,na,1932,5124
STAT,1881,29,na,1910,2237.6002164220836
STAT,1943,28,25-29,1971,69.2657463881694
STAT,1878,17,40-44,1895,0.18818332913038596
STAT,1882,62,na,1944,1749.8885443210402
SIM,1857,13,na,1870,1495
STAT,1916,18,15-19,1934,9.472515306681043
SIM,1869,21,25-29,1890,249
STAT,1851,20,35-39,1871,5.583723007516551
SIM,1850,34,na,1884,1703
SIM,1896,8,na,1904,4109
STAT,1889,41,na,1930,2795.846295946126
SIM,1923,28,25-29,1951,833
STAT,1914,30,25-29,1944,9.248006606449058
SIM,1884,62,na,1946,3459
STAT,1936,29,50-100,1965,0.9421802444659745
STAT,1869,49,50-100,1918,0.2426559981369435
STAT,1863,54,40-44,1917,0.00874043119201054
STAT,1919,35,30-34,1954,1.9427761323881254
STAT,1814,40,25-29,1854,2.5985598452997642
STAT,1935,18,25-29,1953,58.661473037861846
SIM,1859,31,na,1890,1948
STAT,1923,38,25-29,1961,1.1277093455661833
STAT,1899,20,30-34,1919,24.474376889924244
STAT,1840,41,40-44,1881,0.9357878931276232
SIM,1886,26,30-34,1912,2
STAT,1832,39,15-19,1871,0.004559987738706179
SIM,1806,48,na,1854,490
STAT,1831,86,na,1917,173.65140464515903
STAT,1902,24,na,1926,3309.519179053601
STAT,1922,40,25-29,1962,0.08127415261465033
STAT,1936,22,25-29,1958,87.43317507719645
STAT,1878,26,30-34,1904,25.997794303623532
STAT,1839,48,15-19,1887,3.738188879991066E-4
STAT,1828,82,na,1910,315.84374486967357
STAT,1845,23,15-19,1868,2.0176777051593824
SIM,1817,64,na,1881,2170
SIM,1905,37,45-49,1942,7
STAT,1848,59,na,1907,1818.6442964041246
STAT,1867,15,15-19,1882,5.80583277521964
STAT,1861,40,50-100,1901,0.887456069581354
STAT,1918,45,40-44,1963,0.16629379906151634
STAT,1927,45,30-34,1972,0.11151139318114582
STAT,1910,24,30-34,1934,26.521677955249388
STAT,1869,36,30-34,1905,5.403864899058423
STAT,1840,47,na,1887,893.3444641117339
STAT,1920,43,30-34,1963,0.13916159614895768
STAT,1838,81,na,1919,230.62105187195527
STAT,1860,29,25-29,1889,34.379859439132964
STAT,1881,31,25-29,1912,9.712108792368578
STAT,1890,32,40-44,1922,5.250060511974774
STAT,1926,39,40-44,1965,1.809969448771112
STAT,1859,2,na,1861,2755.348520581557
STAT,1917,38,25-29,1955,1.0040229309429523
SIM,1842,20,35-39,1862,2
STAT,1910,35,35-39,1945,2.3091226928432773
STAT,1866,30,45-49,1896,1.6045885950115921
STAT,1830,31,30-34,1861,16.571178237890148
STAT,1839,50,na,1889,2050.2110646525375
STAT,1874,32,na,1906,2462.831722282746
STAT,1940,20,25-29,1960,93.10471184926156
SIM,1925,33,30-34,1958,13
STAT,1863,40,20-24,1903,0.1369486955736649
SIM,1801,60,na,1861,1846
STAT,1917,33,30-34,1950,16.209183213574637
STAT,1891,16,45-49,1907,0.08052625158662438
STAT,1902,17,35-39,1919,0.7726705026236346
STAT,1903,62,na,1965,2814.8165462189518
STAT,1878,15,15-19,1893,6.134245491345835
STAT,1926,17,20-24,1943,164.79708234879712
SIM,1887,43,na,1930,3565
STAT,1823,41,40-44,1864,3.8632368148947718
STAT,1921,27,35-39,1948,16.53428886604846
STAT,1916,5,na,1921,4193.956583892676
STAT,1936,31,15-19,1967,0.12365110936990596
STAT,1823,67,na,1890,1252.2856027859902
STAT,1867,38,25-29,1905,2.7094375290116477
SIM,1911,5,na,1916,2736
STAT,1953,5,na,1958,4713.625455408048
STAT,1822,82,na,1904,269.0549026059974
STAT,1826,96,na,1922,6.84559325850455
STAT,1837,21,15-19,1858,3.4878828358411793
SIM,1882,28,15-19,1910,3
SIM,1845,21,15-19,1866,10
STAT,1908,45,20-24,1953,0.010062774628882212
STAT,1914,37,45-49,1951,0.6711896891733679
STAT,1866,31,35-39,1897,9.28195292832599
STAT,1965,3,na,1968,4862.047922061891
STAT,1835,25,20-24,1860,11.736374793854399
STAT,1787,88,na,1875,21.6838524584385
STAT,1901,30,15-19,1931,0.2007170997296088
SIM,1866,25,15-19,1891,1
STAT,1840,108,na,1948,7.21249583090612E-4
STAT,1862,27,30-34,1889,21.52752614986431
SIM,1831,41,40-44,1872,2
STAT,1874,28,15-19,1902,0.4666029533464466
STAT,1914,25,na,1939,3749.2441602341846
STAT,1918,39,na,1957,3903.633032084715
SIM,1828,48,na,1876,1714
STAT,1851,63,na,1914,1409.2302435885965
STAT,1920,30,25-29,1950,10.074004390310009
STAT,1927,33,15-19,1960,0.1566911012242776
STAT,1855,77,na,1932,572.0862485469866
SIM,1847,14,na,1861,1776
STAT,1789,74,na,1863,767.4199232956236
STAT,1864,42,40-44,1906,2.042312980995757
STAT,1904,15,40-44,1919,0.26252695339970855
SIM,1905,48,25-29,1953,1
STAT,1843,50,45-49,1893,0.0145449705309846
STAT,1846,51,25-29,1897,0.0021078327660604998
SIM,1854,2,na,1856,2723
STAT,1847,58,na,1905,1787.9794152138636
STAT,1929,41,25-29,1970,0.09196177089424695
SIM,1878,19,35-39,1897,63
STAT,1881,0,na,1881,3384.185985667923
STAT,1819,52,30-34,1871,0.0010454890253511436
STAT,1924,18,25-29,1942,50.97535457745462
STAT,1920,40,15-19,1960,0.0016789035552547175
STAT,1876,26,20-24,1902,11.900116740405235
STAT,1907,16,20-24,1923,25.931175944894537
STAT,1874,41,35-39,1915,1.8773365016508774
SIM,1884,26,20-24,1910,11
STAT,1870,53,20-24,1923,7.238445339726853E-4
SIM,1820,52,na,1872,390
STAT,1832,24,40-44,1856,2.6344721072996906
STAT,1807,50,35-39,1857,0.02863374990912508
STAT,1853,44,30-34,1897,0.8794069911930943
STAT,1886,43,30-34,1929,1.1819388652301437
STAT,1928,24,40-44,1952,4.140071545099926
STAT,1922,18,50-100,1940,0.42763390696801223
SIM,1872,42,40-44,1914,8
STAT,1830,39,40-44,1869,3.910784950533417
STAT,1934,35,20-24,1969,0.361936270186033
SIM,1907,34,15-19,1941,1
STAT,1873,20,35-39,1893,6.021631937063992
STAT,1922,47,20-24,1969,0.012554027876964682
STAT,1940,27,45-49,1967,1.74192769931407
STAT,1899,26,15-19,1925,0.6218240982271862
STAT,1857,79,na,1936,536.4664004555341
STAT,1937,18,35-39,1955,4.029373544820217
SIM,1872,13,na,1885,2546
STAT,1926,16,30-34,1942,14.852338185619447
SIM,1881,47,50-100,1928,1
STAT,1869,80,na,1949,624.2143097431485
STAT,1915,17,45-49,1932,0.10307435166710063
STAT,1856,36,45-49,1892,1.4387203835282965
SIM,1927,20,na,1947,1838
STAT,1833,27,15-19,1860,0.27886640708196564
SIM,1829,45,40-44,1874,2
STAT,1910,26,20-24,1936,17.489498638517944
STAT,1880,18,50-100,1898,0.05072788082230746
STAT,1905,18,15-19,1923,8.513422496547765
STAT,1880,76,na,1956,1023.4580975951394
STAT,1873,10,na,1883,2724.682401080595
STAT,1826,37,25-29,1863,4.704491123980239
SIM,1903,32,40-44,1935,1
STAT,1861,15,20-24,1876,17.147707650796637
STAT,1849,65,na,1914,1423.948690482304
SIM,1866,65,na,1931,2408
SIM,1911,10,na,1921,2607
STAT,1892,49,15-19,1941,2.7352225731962427E-4
STAT,1863,29,50-100,1892,0.5422100838423964
STAT,1918,47,30-34,1965,0.09358546699865852
STAT,1925,24,15-19,1949,6.273988499009523
SIM,1882,2,na,1884,3334
SIM,1864,21,25-29,1885,252
SIM,1908,27,20-24,1935,77
STAT,1901,43,20-24,1944,0.015308550178809058
STAT,1921,20,15-19,1941,5.976622126681109
SIM,1898,0,na,1898,4642
SIM,1853,42,30-34,1895,17
STAT,1832,71,na,1903,1133.0780831066525
STAT,1916,41,15-19,1957,0.0015545045205145928
SIM,1919,49,na,1968,4792
STAT,1884,9,na,1893,2483.7706429217533
STAT,1877,83,na,1960,555.5891873393987
SIM,1790,75,na,1865,1197
STAT,1836,37,30-34,1873,5.012803313913352
SIM,1935,23,na,1958,4792
SIM,1862,51,na,1913,3426
STAT,1810,49,40-44,1859,8.754144372859767E-4
SIM,1915,35,na,1950,3317
STAT,1911,28,40-44,1939,4.478494734692598
STAT,1894,45,30-34,1939,0.07012895776507552
STAT,1905,47,20-24,1952,0.009690601458858422
STAT,1949,20,45-49,1969,1.3008862115447064
STAT,1848,18,45-49,1866,0.07532981817846986
STAT,1867,51,45-49,1918,0.013790494322327018
STAT,1857,95,na,1952,10.202483225915923
STAT,1808,49,25-29,1857,0.07995237159470896
STAT,1841,85,na,1926,305.26651351838933
STAT,1936,30,25-29,1966,8.898441474777572
STAT,1890,48,15-19,1938,2.6972091891040977E-4
STAT,1856,14,na,1870,2009.0844080501186
STAT,1900,26,15-19,1926,0.6306643871392417
STAT,1871,25,30-34,1896,25.290466273190415
STAT,1886,60,na,1946,1974.9801011866195
STAT,1893,41,45-49,1934,1.880058679310469
STAT,1828,38,35-39,1866,9.303127103044911
STAT,1902,22,30-34,1924,25.082552261163098
STAT,1785,104,na,1889,0.015239361157168466
STAT,1937,29,15-19,1966,0.6803693525372324
STAT,1888,39,45-49,1927,2.2776533673910473
STAT,1853,41,15-19,1894,0.010756436893805225
STAT,1929,40,35-39,1969,0.25966766275166586
STAT,1869,64,na,1933,1754.1459810937438
STAT,1914,45,20-24,1959,0.010858500748628925
STAT,1873,21,25-29,1894,58.89866694802888
STAT,1955,17,50-100,1972,0.4930143888686724
STAT,1945,16,40-44,1961,1.5114745174077786
STAT,1836,52,30-34,1888,0.0046151973786330396
STAT,1920,37,45-49,1957,0.7368052471361156
STAT,1820,86,na,1906,152.586935068076
STAT,1827,54,30-34,1881,0.004607516197102828
STAT,1900,16,50-100,1916,0.06803441975763422
STAT,1888,24,na,1912,2712.565151251257
SIM,1836,30,na,1866,2273
SIM,1949,7,na,1956,4496
STAT,1896,75,na,1971,1806.4972214412496
STAT,1901,37,35-39,1938,2.1345544007748125
SIM,1854,59,na,1913,986
STAT,1847,38,45-49,1885,1.8506960264133865
STAT,1892,61,na,1953,2313.5461736299826
SIM,1875,51,45-49,1926,1
STAT,1826,50,45-49,1876,0.02086114368618298
STAT,1852,48,na,1900,2236.2069999792393
STAT,1878,22,15-19,1900,3.394264318526167
STAT,1897,22,25-29,1919,76.02514555502945
STAT,1931,30,50-100,1961,1.0769736699541572
SIM,1870,27,30-34,1897,25
STAT,1892,48,25-29,1940,0.03972169453099924
STAT,1912,44,35-39,1956,0.19047005162637795
SIM,1875,58,na,1933,2579
SIM,1919,28,35-39,1947,1
STAT,1920,18,40-44,1938,1.545037614220788
STAT,1852,25,20-24,1877,13.953779486334227
STAT,1853,100,na,1953,0.8231875644050508
SIM,1920,44,35-39,1964,1
STAT,1894,42,15-19,1936,0.001217997387775313
STAT,1925,37,20-24,1962,0.3134948034733097
SIM,1954,15,na,1969,5552
SIM,1917,17,20-24,1934,191
STAT,1804,53,na,1857,2152.6597523405308
SIM,1966,5,na,1971,5081
STAT,1871,83,na,1954,396.01184765371147
STAT,1856,21,25-29,1877,48.09874064709731
STAT,1921,22,40-44,1943,3.7527069094887557
STAT,1777,89,na,1866,93.01914410926203
STAT,1912,22,15-19,1934,5.042259100932963
STAT,1875,97,na,1972,36.48816385212284
STAT,1852,32,na,1884,2487.0172116336344
STAT,1919,26,40-44,1945,4.986387069295788
SIM,1835,29,na,1864,1310
STAT,1847,30,35-39,1877,10.975963955335809
STAT,1847,31,25-29,1878,10.98651196994302
STAT,1837,17,30-34,1854,1.7033057006013441
SIM,1855,38,45-49,1893,5
STAT,1817,37,20-24,1854,0.6095102380398316
SIM,1865,4,na,1869,2114
STAT,1936,26,40-44,1962,4.418419361840357
STAT,1845,42,30-34,1887,0.5809353805878797
SIM,1849,10,na,1859,2663
STAT,1851,48,15-19,1899,3.119472584478901E-4
STAT,1791,88,na,1879,60.37842594884129
SIM,1850,66,na,1916,719
STAT,1893,28,25-29,1921,52.71289871237665
STAT,1889,19,45-49,1908,0.07824114099688037
STAT,1925,46,35-39,1971,0.1551873093132432
STAT,1888,56,na,1944,2354.0715467048667
SIM,1855,30,35-39,1885,5
STAT,1853,70,na,1923,1087.9278809283467
STAT,1902,27,25-29,1929,59.56718697045952
SIM,1890,6,na,1896,4061
STAT,1884,51,45-49,1935,0.013958802915660488
STAT,1871,16,50-100,1887,0.04947859578322883
SIM,1906,58,na,1964,3086
STAT,1873,48,15-19,1921,4.051559259057809E-4
STAT,1805,53,40-44,1858,0.012079952911514204
STAT,1842,70,na,1912,348.305412032695
STAT,1854,28,na,1882,1381.0873435396763
SIM,1855,81,na,1936,891
STAT,1851,8,na,1859,2358.0189103135945
SIM,1924,30,35-39,1954,7
STAT,1869,27,40-44,1896,3.0227692620635604
STAT,1877,30,20-24,1907,2.7659860313724374
STAT,1779,85,na,1864,132.9240167459042
STAT,1934,38,25-29,1972,1.3481671789504144
STAT,1829,38,50-100,1867,0.6122934690352747
STAT,1823,44,45-49,1867,2.3924582292423553
STAT,1934,33,30-34,1967,21.352237471315053
STAT,1939,29,25-29,1968,65.37720893254388
SIM,1878,40,30-34,1918,2
STAT,1922,31,35-39,1953,10.251786429422475
SIM,1831,44,45-49,1875,20
STAT,1880,15,30-34,1895,1.662370557146404
STAT,1927,40,25-29,1967,0.08907488431662465
STAT,1858,80,na,1938,472.3999025617078
SIM,1951,16,30-34,1967,18
STAT,1848,38,15-19,1886,0.05359237012886625
STAT,1892,20,45-49,1912,0.8685007722962073
STAT,1909,35,na,1944,3558.2847920893296
STAT,1875,21,35-39,1896,6.010266590561525
STAT,1853,48,25-29,1901,0.04410120415137997
STAT,1921,24,30-34,1945,31.87711846061251
SIM,1837,38,50-100,1875,2
STAT,1868,79,na,1947,675.2453887222381
STAT,1848,43,na,1891,2147.175776068529
SIM,1946,23,na,1969,3765
STAT,1828,31,15-19,1859,0.2228392805768731
STAT,1887,82,na,1969,897.3254686743165
STAT,1873,25,40-44,1898,3.093635216595426
STAT,1865,26,45-49,1891,1.0171755739766342
STAT,1917,26,30-34,1943,40.68203833433818
STAT,1916,30,35-39,1946,9.380816275125582
STAT,1818,77,na,1895,526.1177026135732
STAT,1932,27,50-100,1959,1.2946317157578118
STAT,1865,51,35-39,1916,0.007897601229610529
STAT,1872,44,40-44,1916,2.2219316610601747
SIM,1810,103,na,1913,9
SIM,1864,58,na,1922,2272
SIM,1930,31,35-39,1961,32
STAT,1880,40,20-24,1920,0.16653607869992507
STAT,1923,20,25-29,1943,106.97958289804008
STAT,1898,45,na,1943,3056.1287111441534
SIM,1901,11,na,1912,4179
STAT,1894,31,na,1925,3046.974005369782
STAT,1805,50,25-29,1855,0.0043224469649960585
STAT,1922,17,na,1939,4212.272326653823
SIM,1873,62,na,1935,1269
STAT,1930,33,50-100,1963,1.0588590016708186
STAT,1858,58,na,1916,1510.2205943510921
STAT,1915,37,15-19,1952,0.019125253490289804
STAT,1908,43,30-34,1951,0.11666253506484885
STAT,1824,50,35-39,1874,0.0015100772199707383
STAT,1831,43,40-44,1874,2.1689585364964903
SIM,1859,19,25-29,1878,2
STAT,1827,39,50-100,1866,1.1812934506343942
STAT,1921,38,15-19,1959,0.021166477513411077
STAT,1888,31,35-39,1919,11.736057753359852
STAT,1845,51,na,1896,1073.5505089787287
SIM,1807,49,na,1856,1084
STAT,1915,22,40-44,1937,3.426534164993071
STAT,1941,20,na,1961,3733.5188366194357
SIM,1868,13,na,1881,1370
SIM,1898,30,30-34,1928,35
STAT,1802,89,na,1891,53.227170047151105
SIM,1883,61,na,1944,1967
STAT,1812,43,30-34,1855,0.3806683316295124
SIM,1860,27,25-29,1887,5
STAT,1939,27,20-24,1966,18.149021727977573
STAT,1852,27,25-29,1879,49.59479545124302
STAT,1893,46,na,1939,2822.0010801562207
STAT,1838,52,40-44,1890,0.004470125750278926
STAT,1882,46,na,1928,2160.1363044141044
STAT,1943,16,30-34,1959,12.781363295550259
STAT,1932,38,na,1970,5014.663782381958
STAT,1938,22,35-39,1960,9.219159622701127
SIM,1829,40,35-39,1869,3
STAT,1850,102,na,1952,0.1353769694640552
STAT,1902,20,50-100,1922,0.5776605263053303
STAT,1903,30,25-29,1933,14.656362209422822
STAT,1908,48,25-29,1956,0.04746923321363515
STAT,1851,101,na,1952,0.45067427525630455
STAT,1864,45,45-49,1909,0.2166880137021758
STAT,1879,42,na,1921,2368.042792496112
STAT,1916,16,25-29,1932,9.0910603144555
STAT,1949,6,na,1955,4526.9944122436345
STAT,1830,85,na,1915,198.41091428942144
STAT,1870,42,50-100,1912,1.0519152126834235
SIM,1895,46,na,1941,4507
STAT,1917,35,20-24,1952,0.27271311190718134
SIM,1885,30,20-24,1915,18
SIM,1891,32,na,1923,2322
STAT,1876,39,na,1915,2357.7057316696114
STAT,1839,36,45-49,1875,2.236361451244706
STAT,1854,21,15-19,1875,2.17084311217445
STAT,1797,66,na,1863,31.643590861936822
STAT,1866,13,na,1879,2446.7362278463206
SIM,1904,41,35-39,1945,2
STAT,1940,24,40-44,1964,3.384482327121356
SIM,1872,45,45-49,1917,1
STAT,1873,27,45-49,1900,1.138926318990317
STAT,1916,53,na,1969,3637.678373516822
SIM,1930,24,na,1954,5434
SIM,1862,25,30-34,1887,1
STAT,1891,41,35-39,1932,2.236885550969196
STAT,1854,25,30-34,1879,16.364058658688137
STAT,1877,38,30-34,1915,5.383328445905241
SIM,1841,30,na,1871,1048
STAT,1832,27,45-49,1859,1.3481003442931927
STAT,1918,43,15-19,1961,0.0016082005096030032
STAT,1839,66,na,1905,1522.7487584782775
SIM,1845,44,na,1889,2170
STAT,1927,43,40-44,1970,0.3106462982413752
STAT,1873,7,na,1880,2790.0381426745103
STAT,1876,17,30-34,1893,1.6112554237658645
STAT,1928,27,45-49,1955,2.1122168371358527
STAT,1849,31,35-39,1880,9.984053354164695
STAT,1906,35,45-49,1941,0.6289886042418878
SIM,1924,17,na,1941,5281
SIM,1857,31,35-39,1888,2
STAT,1812,47,25-29,1859,0.014891730555886468
STAT,1924,24,na,1948,4240.959496185274
STAT,1928,38,na,1966,4713.719122571269
SIM,1896,31,na,1927,3762
STAT,1851,47,na,1898,1768.6235012183024
SIM,1903,37,35-39,1940,1
STAT,1902,24,20-24,1926,96.43236069496369
STAT,1904,20,15-19,1924,4.74142446168476
STAT,1844,29,na,1873,2586.0115549492057
STAT,1884,15,15-19,1899,5.707376316515193
STAT,1944,23,na,1967,3897.225033275893
STAT,1912,35,45-49,1947,0.6638844320627552
SIM,1867,18,20-24,1885,2
SIM,1922,7,na,1929,3756
STAT,1941,27,15-19,1968,0.7219846527463384
SIM,1907,21,na,1928,4839
STAT,1850,40,35-39,1890,0.8446015764763194
STAT,1871,28,35-39,1899,9.59134629351934
SIM,1877,28,na,1905,13
SIM,1842,39,25-29,1881,2
STAT,1888,36,40-44,1924,5.076672111423059
STAT,1920,10,na,1930,4401.553510067144
STAT,1865,28,na,1893,2171.204763902918
SIM,1825,36,20-24,1861,2
STAT,1869,38,35-39,1907,7.101756617609532
SIM,1847,51,na,1898,1426
STAT,1870,47,35-39,1917,0.13891995319738648
SIM,1938,5,na,1943,4282
STAT,1889,39,15-19,1928,0.06694213533018564
STAT,1828,35,30-34,1863,7.481163420795829
STAT,1863,32,na,1895,2037.2230855910702
SIM,1826,52,na,1878,1726
STAT,1897,20,20-24,1917,92.06542787967506
STAT,1889,40,40-44,1929,2.7359653301582503
STAT,1924,16,20-24,1940,160.28957841920322
STAT,1834,39,25-29,1873,1.5459076563079992
STAT,1859,43,na,1902,1818.6385413614237
STAT,1882,83,na,1965,638.982577465804
STAT,1901,34,30-34,1935,24.203432453568254
STAT,1918,18,25-29,1936,46.40971760109449
STAT,1936,35,30-34,1971,1.7745686110383863
STAT,1861,84,na,1945,276.6570008681155
STAT,1865,98,na,1963,9.12334519384642
STAT,1872,41,25-29,1913,0.64593966500046
SIM,1844,81,na,1925,719
STAT,1846,54,40-44,1900,0.006063653237796668
STAT,1896,30,30-34,1926,23.20090440881032
STAT,1840,53,35-39,1893,0.0033354288230067375
STAT,1859,18,20-24,1877,16.214780008382313
STAT,1917,28,35-39,1945,15.480110399350306
STAT,1841,29,15-19,1870,0.6185378521751768
STAT,1943,18,35-39,1961,4.397501692472992
STAT,1870,98,na,1968,17.189280555119087
STAT,1936,29,45-49,1965,1.6353261125176037
SIM,1916,6,na,1922,4952
STAT,1927,7,na,1934,4929.710633296275
SIM,1836,35,30-34,1871,46
STAT,1916,31,50-100,1947,0.8454016467181205
SIM,1810,53,na,1863,3098
STAT,1858,25,15-19,1883,0.35983504879333156
SIM,1814,67,na,1881,2292
STAT,1810,46,25-29,1856,3.0651247724960246E-4
STAT,1862,47,na,1909,1907.3478822166153
STAT,1850,15,45-49,1865,0.037297296676082954
STAT,1853,44,50-100,1897,0.8081037198635947
STAT,1873,28,45-49,1901,1.1349172983474713
SIM,1831,52,na,1883,2133
STAT,1895,26,30-34,1921,32.87085866697052
STAT,1849,48,20-24,1897,0.009984056570896425
STAT,1799,73,na,1872,101.39648921899251
SIM,1890,10,na,1900,4046
SIM,1931,20,25-29,1951,1
SIM,1874,9,na,1883,2818
SIM,1855,35,40-44,1890,1
STAT,1812,67,na,1879,147.7142891677978
STAT,1932,25,45-49,1957,2.249026322232506
SIM,1857,51,na,1908,1397
STAT,1850,52,40-44,1902,0.004835385893618728
STAT,1931,41,40-44,1972,0.33227737706345384
STAT,1919,22,25-29,1941,99.80265677967787
STAT,1862,23,15-19,1885,2.8558246483429555
STAT,1815,39,15-19,1854,0.006145717506484294
SIM,1944,16,na,1960,2509
STAT,1867,94,na,1961,40.325772573406276
SIM,1880,44,40-44,1924,9
STAT,1907,0,na,1907,4284.399376089095
SIM,1894,24,na,1918,928
STAT,1832,26,45-49,1858,1.3674642237174441
STAT,1927,16,na,1943,4550.4524505019135
STAT,1954,17,45-49,1971,0.6120904599583061
STAT,1914,48,25-29,1962,0.051732423208418796
SIM,1876,43,na,1919,3477
STAT,1903,36,30-34,1939,1.6407834921641538
STAT,1897,60,na,1957,2578.144868151855
SIM,1797,70,na,1867,1152
STAT,1896,38,na,1934,3090.312200611768
STAT,1889,20,25-29,1909,69.3479125376956
SIM,1906,28,25-29,1934,13
STAT,1879,53,40-44,1932,0.0106262818301853
STAT,1912,41,30-34,1953,0.12257316522416532
STAT,1833,66,na,1899,674.3497438215954
STAT,1881,54,35-39,1935,0.007906377659785755
STAT,1923,39,15-19,1962,0.021969700253944287
STAT,1892,2,na,1894,3300.337125330269
STAT,1892,24,na,1916,2909.821347863634
STAT,1831,40,25-29,1871,0.6446905616451887
STAT,1846,95,na,1941,7.87442702131341
STAT,1878,18,30-34,1896,1.6355867372680128
STAT,1834,20,35-39,1854,3.489454022893568
STAT,1847,35,40-44,1882,4.192537594021631
STAT,1786,103,na,1889,0.10483421088662061
STAT,1871,32,30-34,1903,17.41682985189792
STAT,1829,29,na,1858,1039.317219971073
STAT,1912,39,na,1951,3592.78380762769
STAT,1918,30,50-100,1948,0.873699433513392
STAT,1911,36,50-100,1947,0.4028866231698927
STAT,1852,28,25-29,1880,49.238704819903106
STAT,1942,20,35-39,1962,9.76647569934784
STAT,1851,44,20-24,1895,0.12373629237346014
STAT,1933,24,50-100,1957,0.8662852681495623
SIM,1920,35,45-49,1955,2
STAT,1862,43,20-24,1905,0.1342904316702762
STAT,1864,51,30-34,1915,0.005437391328465463
STAT,1899,62,na,1961,2634.0443577557144
STAT,1782,73,na,1855,1476.2321099999997
SIM,1949,16,15-19,1965,647
STAT,1898,18,20-24,1916,23.77739350171037
STAT,1854,50,na,1904,1214.4035597843613
STAT,1890,47,15-19,1937,2.718796432780375E-4
STAT,1925,28,30-34,1953,45.6943269799521
STAT,1845,34,30-34,1879,10.089580701384568
STAT,1837,80,na,1917,496.01129840812115
SIM,1922,10,na,1932,3724
STAT,1945,27,45-49,1972,1.8744292972346865
STAT,1841,48,na,1889,2484.6641000273653
STAT,1847,42,40-44,1889,2.044950310096814
STAT,1897,21,50-100,1918,0.54320188120507
STAT,1839,18,40-44,1857,0.22098255667393235
STAT,1922,42,50-100,1964,0.13333897084818092
STAT,1852,85,na,1937,275.94040811499667
STAT,1927,36,40-44,1963,1.8477269031310901
SIM,1853,34,30-34,1887,3
STAT,1894,30,20-24,1924,3.4649977787901154
STAT,1902,26,25-29,1928,59.77160586250928
STAT,1842,65,na,1907,419.52384836534844
STAT,1882,51,35-39,1933,0.008281838351120051
SIM,1910,15,30-34,1925,52
STAT,1906,4,na,1910,3809.423650349734
STAT,1887,77,na,1964,1238.2873570587496
STAT,1853,40,50-100,1893,0.8274264821629955
STAT,1851,51,20-24,1902,5.855917430405456E-4
SIM,1945,17,na,1962,6340
SIM,1852,20,na,1872,2408
STAT,1867,41,50-100,1908,1.0036390837239406
SIM,1935,36,40-44,1971,13
SIM,1901,4,na,1905,4179
SIM,1886,42,na,1928,2993
STAT,1910,34,20-24,1944,2.3056487455630053
STAT,1871,30,na,1901,2399.5837761676676
STAT,1879,45,40-44,1924,0.17737467479245303
STAT,1828,44,na,1872,1744.4701427423734
STAT,1852,24,20-24,1876,81.22506258516172
STAT,1912,48,15-19,1960,3.4893567546412266E-4
SIM,1901,37,25-29,1938,1
STAT,1858,21,35-39,1879,5.150007665841984
STAT,1902,61,na,1963,2808.0244334091763
STAT,1894,41,15-19,1935,0.01764084883284146
SIM,1827,31,na,1858,2118
STAT,1902,15,30-34,1917,2.2548518021107284
STAT,1904,23,40-44,1927,2.9679298853629636
STAT,1819,44,30-34,1863,0.218459408824536
STAT,1882,45,50-100,1927,0.23748420385129676
STAT,1841,50,35-39,1891,0.009724512795107958
STAT,1843,46,15-19,1889,3.9844727106278963E-4
STAT,1883,30,45-49,1913,1.6911173210781414
STAT,1920,39,35-39,1959,2.608631059378218
SIM,1948,0,na,1948,5982
STAT,1867,18,50-100,1885,0.04708733312431188
STAT,1929,19,15-19,1948,57.20415087162054
STAT,1812,104,na,1916,0.005282281653603206
STAT,1853,40,15-19,1893,0.010816033236940772
STAT,1919,37,45-49,1956,0.7226501452587036
STAT,1936,34,40-44,1970,3.7584889004692568
STAT,1849,28,na,1877,2145.190143511277
STAT,1921,18,45-49,1939,0.5611858618739022
SIM,1845,50,na,1895,2062
STAT,1803,52,50-100,1855,0.032992265068962134
STAT,1899,22,35-39,1921,7.970491363850214
STAT,1895,74,na,1969,1839.0025948748648
STAT,1896,33,50-100,1929,1.2027241145820073
STAT,1837,19,45-49,1856,0.06898768477327251
STAT,1837,96,na,1933,6.885070628444807
SIM,1817,40,50-100,1857,16
SIM,1868,47,50-100,1915,3
STAT,1918,29,40-44,1947,4.858503584068354
STAT,1900,18,15-19,1918,8.199507539597551
STAT,1897,36,45-49,1933,2.6601962261797487
SIM,1824,88,na,1912,857
SIM,1874,57,na,1931,2445
STAT,1829,83,na,1912,144.96753202156995
STAT,1864,46,35-39,1910,0.12763621833709496
STAT,1910,21,15-19,1931,4.957964223169512
STAT,1932,16,na,1948,4851.854798898675
STAT,1776,109,na,1885,0.006043268090905781
STAT,1934,26,30-34,1960,52.376889311460474
STAT,1887,55,na,1942,2275.876884233839
SIM,1907,38,30-34,1945,7
STAT,1847,54,35-39,1901,0.007569552621487787
STAT,1887,45,na,1932,2501.0274609774056
STAT,1902,34,50-100,1936,0.7345019702175433
STAT,1828,66,na,1894,1109.4954896578565
STAT,1895,22,50-100,1917,0.5304833199863652
STAT,1908,40,na,1948,3448.1604688369425
SIM,1855,42,40-44,1897,10
STAT,1849,38,na,1887,2010.326704091598
SIM,1837,31,na,1868,2180
SIM,1840,35,na,1875,2611
STAT,1779,91,na,1870,28.25077039484395
STAT,1823,33,40-44,1856,10.026378658001171
STAT,1863,25,35-39,1888,8.35698432261647
STAT,1903,25,na,1928,3410.6797477137034
STAT,1879,41,35-39,1920,1.8660101471632236
STAT,1853,33,na,1886,1885.761702364882
SIM,1870,33,na,1903,2288
STAT,1782,95,na,1877,7.879499474713152
STAT,1907,44,15-19,1951,0.0013803617060919138
STAT,1881,43,30-34,1924,1.077843868982649
STAT,1864,34,40-44,1898,3.9087812297893616
SIM,1920,37,35-39,1957,4
STAT,1862,85,na,1947,233.4915403975877
STAT,1890,24,40-44,1914,2.506881745360365
STAT,1913,16,45-49,1929,0.1011015586711196
STAT,1895,33,30-34,1928,22.61701755232379
SIM,1920,25,na,1945,3626
SIM,1886,64,na,1950,2614
STAT,1924,27,15-19,1951,0.8140697341855669
STAT,1812,44,20-24,1856,0.04783533697644065
SIM,1932,27,15-19,1959,9
STAT,1803,90,na,1893,19.887655561381685
STAT,1908,36,30-34,1944,1.7013647008676875
SIM,1827,53,na,1880,1975
SIM,1903,55,na,1958,2147
STAT,1886,20,45-49,1906,0.7264199523557646
STAT,1910,25,50-100,1935,0.9649756221694432
STAT,1865,19,20-24,1884,16.48346425989676
STAT,1910,17,30-34,1927,2.3881492065569447
SIM,1840,45,na,1885,2572
STAT,1782,89,na,1871,113.23831681157696
STAT,1913,40,50-100,1953,0.11440952606020283
STAT,1881,46,35-39,1927,0.13258405237270712
SIM,1886,33,30-34,1919,4
STAT,1847,80,na,1927,559.2833952130629
STAT,1930,16,45-49,1946,0.6428686341230352
STAT,1878,33,30-34,1911,17.887958937853572
STAT,1830,35,25-29,1865,2.6813115987062686
STAT,1870,51,30-34,1921,0.005962687150856294
STAT,1879,26,na,1905,2456.5921719302905
STAT,1866,5,na,1871,2588.976050203296
SIM,1932,10,na,1942,6513
STAT,1866,54,45-49,1920,0.012882913783593743
STAT,1857,17,20-24,1874,15.989613292157957
STAT,1939,18,45-49,1957,0.49437449005309714
STAT,1841,24,45-49,1865,0.9696122133504548
STAT,1849,47,20-24,1896,0.010063964448618458
SIM,1861,50,na,1911,2014
STAT,1919,34,na,1953,3991.7366324876234
STAT,1838,44,na,1882,1022.441922658756
STAT,1825,31,50-100,1856,1.6860772843657366
STAT,1886,35,30-34,1921,5.571459843583927
SIM,1860,33,na,1893,1628
STAT,1878,19,30-34,1897,1.631088873740525
STAT,1933,38,50-100,1971,0.5674166838144261
STAT,1860,44,25-29,1904,0.5167954625932158
SIM,1866,29,30-34,1895,6
STAT,1864,30,35-39,1894,9.280581787120221
STAT,1881,30,25-29,1911,9.750330086306905
STAT,1811,43,50-100,1854,5.417621745935636
STAT,1878,37,50-100,1915,1.2631867542282944
STAT,1848,19,20-24,1867,20.324098560528917
SIM,1893,12,na,1905,3561
SIM,1831,68,na,1899,1502
SIM,1840,19,na,1859,2766
STAT,1891,15,45-49,1906,0.08070218234413461
STAT,1921,31,50-100,1952,0.9129009115951916
SIM,1937,19,15-19,1956,93
STAT,1850,31,45-49,1881,0.8511438414328372
STAT,1853,11,na,1864,2236.8321031343767
STAT,1919,15,25-29,1934,9.524364712754242
STAT,1918,16,35-39,1934,0.9061863567746554
STAT,1828,42,30-34,1870,1.437631525746579
STAT,1903,44,30-34,1947,0.11179742948325525
SIM,1915,15,20-24,1930,122
STAT,1801,101,na,1902,0.18930331458616578
STAT,1869,24,15-19,1893,3.3081453524226903
STAT,1871,36,25-29,1907,2.8859484937208086
STAT,1867,57,na,1924,1900.5684516428037
SIM,1862,32,30-34,1894,70
SIM,1925,26,30-34,1951,6
STAT,1890,41,30-34,1931,1.398094268709955
STAT,1917,37,25-29,1954,1.0090277083764998
STAT,1840,45,35-39,1885,0.057032619967155224
STAT,1839,29,20-24,1868,13.534198040781806
SIM,1833,65,na,1898,1813
STAT,1871,27,35-39,1898,9.625227092886298
STAT,1823,45,35-39,1868,0.22477250910697807
STAT,1871,62,na,1933,1823.2415531419738
STAT,1808,46,na,1854,800.0788287412753
STAT,1855,53,30-34,1908,0.0038763596215105776
STAT,1821,45,25-29,1866,0.06327790308840922
STAT,1869,35,30-34,1904,5.429055717588031
STAT,1890,36,35-39,1926,8.603742058687963
STAT,1838,44,40-44,1882,0.9959868638239678
STAT,1838,40,35-39,1878,0.9274691871353086
STAT,1894,25,na,1919,3055.4320211886893
STAT,1899,40,na,1939,3199.7128552570784
STAT,1915,10,na,1925,4087.3535652469504
SIM,1881,27,na,1908,3113
STAT,1933,34,15-19,1967,0.17177931821043643
STAT,1854,32,30-34,1886,9.941487521699333
STAT,1903,18,40-44,1921,0.25895270412374494
STAT,1948,19,25-29,1967,49.05317391076373
STAT,1858,29,30-34,1887,19.40451585812543
SIM,1825,46,na,1871,250
STAT,1839,21,25-29,1860,68.83056555852747
STAT,1837,32,30-34,1869,17.55267995682479
STAT,1907,15,20-24,1922,25.987829413014907
STAT,1910,37,25-29,1947,0.9311389553964261
SIM,1936,34,na,1970,3800
STAT,1871,50,20-24,1921,7.466849460367318E-4
STAT,1886,15,50-100,1901,0.05096926034040203
STAT,1903,31,25-29,1934,14.59890926956188
STAT,1823,50,30-34,1873,0.009300399653593245
STAT,1850,84,na,1934,153.6111076879315
STAT,1842,34,50-100,1876,0.2691213254142875
STAT,1921,22,na,1943,4075.7493336018347
STAT,1854,50,20-24,1904,4.1619235350475413E-4
STAT,1874,53,40-44,1927,0.010690781498141205
STAT,1814,68,na,1882,1219.9876663534624
STAT,1839,52,45-49,1891,0.013411214985468534
STAT,1922,44,40-44,1966,0.28294543063582805
STAT,1899,30,na,1929,3285.583609061998
SIM,1856,28,na,1884,809
STAT,1845,39,50-100,1884,0.6269527214648032
STAT,1884,16,50-100,1900,0.04701375688284426
STAT,1882,25,45-49,1907,1.0702274471987896
STAT,1869,39,35-39,1908,7.065324606161197
STAT,1855,40,35-39,1895,1.210555523893218
STAT,1794,74,na,1868,5.657078129856368
STAT,1942,28,30-34,1970,40.63500957949553
STAT,1943,27,25-29,1970,69.29900991292764
SIM,1843,28,25-29,1871,7
SIM,1836,67,na,1903,939
SIM,1913,55,na,1968,2906
SIM,1814,41,40-44,1855,1
SIM,1879,78,na,1957,63
STAT,1878,24,50-100,1902,0.4169364675254842
STAT,1884,28,20-24,1912,11.190664218980771
STAT,1808,99,na,1907,0.4435507299341415
STAT,1916,47,20-24,1963,0.011180302337183683
STAT,1860,26,20-24,1886,9.742924375031762
STAT,1873,32,40-44,1905,4.44851541935959
STAT,1845,37,35-39,1882,3.687613818335291
STAT,1849,20,40-44,1869,2.1536305397261457
STAT,1915,47,50-100,1962,0.2246929946923918
SIM,1846,47,45-49,1893,3
STAT,1830,52,25-29,1882,0.0026632150215634134
STAT,1925,32,15-19,1957,0.15120244528424237
SIM,1933,32,15-19,1965,1
STAT,1931,37,45-49,1968,0.8965021437990256
SIM,1865,27,na,1892,1159
STAT,1812,52,20-24,1864,1.8155451073571634E-4
STAT,1863,11,na,1874,2336.1717702545066
STAT,1847,33,50-100,1880,0.9625917342388295
SIM,1876,64,na,1940,2726
STAT,1809,51,20-24,1860,0.006219154295283816
STAT,1900,8,na,1908,3601.113509561804
SIM,1910,41,na,1951,4070
STAT,1891,32,45-49,1923,2.1444282827284034
SIM,1885,30,45-49,1915,10
STAT,1829,54,40-44,1883,0.004115575678350374
SIM,1881,32,40-44,1913,16
SIM,1911,42,na,1953,2462
STAT,1823,37,50-100,1860,2.3068108090154307
STAT,1824,41,45-49,1865,0.2533898157187089
STAT,1835,28,25-29,1863,41.414148381540905
SIM,1897,10,na,1907,3016
SIM,1924,47,20-24,1971,1
STAT,1883,46,45-49,1929,0.22768680912598951
SIM,1925,40,na,1965,4735
STAT,1863,22,30-34,1885,15.509615551482243
STAT,1950,17,15-19,1967,53.15065411295156
STAT,1880,22,30-34,1902,18.491901036694347
STAT,1832,23,40-44,1855,2.727708158873266
STAT,1946,15,50-100,1961,0.4112743188665281
STAT,1872,53,30-34,1925,0.005864938030810296
SIM,1902,12,na,1914,3754
STAT,1877,30,45-49,1907,1.784418424496672
STAT,1887,39,na,1926,2567.061892223195
STAT,1875,32,50-100,1907,0.9408487840393517
STAT,1909,17,20-24,1926,26.316240717639683
STAT,1864,54,35-39,1918,0.0076113237390206655
STAT,1909,39,40-44,1948,1.388413327493555
STAT,1887,39,50-100,1926,1.3377428709274624
STAT,1921,23,40-44,1944,3.7411110451384344
SIM,1800,54,na,1854,367
SIM,1888,39,na,1927,206
SIM,1834,66,na,1900,44
STAT,1856,44,35-39,1900,1.2830674602051306
STAT,1838,47,45-49,1885,0.10364480465453389
SIM,1848,44,50-100,1892,1
SIM,1836,38,35-39,1874,62
SIM,1864,44,35-39,1908,4
SIM,1881,41,30-34,1922,2
STAT,1946,19,15-19,1965,49.759283145298106
STAT,1857,40,45-49,1897,1.1600523527006528
STAT,1842,45,45-49,1887,0.06011630314155816
SIM,1817,38,25-29,1855,25
STAT,1876,29,25-29,1905,42.45721206019581
SIM,1895,25,na,1920,4058
STAT,1907,49,na,1956,3232.0725494975754
STAT,1836,40,15-19,1876,0.012915551642180795
STAT,1809,47,na,1856,3077.978062553381
STAT,1824,36,na,1860,569.3122020314072
STAT,1922,38,na,1960,4228.871013256561
STAT,1834,36,20-24,1870,0.42698259581032466
STAT,1934,29,35-39,1963,20.040325097242427
STAT,1895,29,35-39,1924,12.462313782381399
STAT,1862,63,na,1925,1519.7651274071513
SIM,1879,56,na,1935,798
STAT,1918,46,40-44,1964,0.16592628976559048
STAT,1792,67,na,1859,954.4013615895336
STAT,1840,51,45-49,1891,0.0057416705966116845
STAT,1937,15,na,1952,3560.2201836606
STAT,1844,111,na,1955,1.0633309231165145E-4
STAT,1849,102,na,1951,0.24702686488015282
STAT,1918,42,25-29,1960,0.07489966016513318
STAT,1919,17,50-100,1936,0.408526713998471
STAT,1768,104,na,1872,0.08705729176167656
STAT,1843,27,20-24,1870,14.26503983390292
STAT,1881,52,45-49,1933,0.01363180826787214
STAT,1900,37,30-34,1937,1.5935527555790077
STAT,1920,44,30-34,1964,0.138918063355697
SIM,1923,26,20-24,1949,44
STAT,1935,29,40-44,1964,6.3016550351893486
STAT,1904,20,na,1924,3399.0959802876273
STAT,1833,32,50-100,1865,0.5185316003167201
STAT,1901,44,20-24,1945,0.015211800141678984
STAT,1834,54,25-29,1888,0.001538433102364561
STAT,1912,37,35-39,1949,2.333312417082576
STAT,1901,49,40-44,1950,0.13220785578158442
STAT,1853,5,na,1858,2345.4268633023266
STAT,1911,47,45-49,1958,0.20343709303553237
STAT,1928,17,na,1945,4602.595372379884
STAT,1835,30,na,1865,2131.479615561337
STAT,1863,51,25-29,1914,0.003038327973832404
STAT,1848,41,30-34,1889,1.088360584570771
STAT,1869,43,30-34,1912,1.1517290143456373
STAT,1870,21,45-49,1891,0.6972817977461317
STAT,1819,47,35-39,1866,0.02607978098126947
SIM,1870,11,na,1881,2671
SIM,1885,25,na,1910,1803
STAT,1911,16,25-29,1927,8.595151743896292
SIM,1815,68,na,1883,482
STAT,1898,32,50-100,1930,1.2320907828440546
STAT,1799,68,na,1867,145.17814766692442
STAT,1867,35,20-24,1902,0.7359385102498762
STAT,1829,61,na,1890,682.3686681753475
STAT,1886,38,35-39,1924,7.288035686525697
SIM,1848,17,20-24,1865,132
SIM,1884,29,25-29,1913,158
SIM,1942,29,35-39,1971,14
STAT,1851,54,25-29,1905,0.0027205272936054272
STAT,1853,53,20-24,1906,5.629874789557518E-4
STAT,1832,65,na,1897,1434.565931719667
SIM,1856,41,30-34,1897,2
STAT,1869,42,na,1911,2329.3588133520752
STAT,1921,15,40-44,1936,1.582768233702053
STAT,1893,25,20-24,1918,14.770035724618136
STAT,1908,39,35-39,1947,2.224462326434005
STAT,1849,81,na,1930,455.643780447568
STAT,1823,36,45-49,1859,3.761563662496299
SIM,1922,42,40-44,1964,5
SIM,1866,81,na,1947,637
STAT,1808,46,20-24,1854,0.023298651741130064
STAT,1846,63,na,1909,1056.77357427455
STAT,1923,28,20-24,1951,20.664035744365023
STAT,1847,9,na,1856,2749.2111697616997
STAT,1876,53,50-100,1929,0.015022354839300112
STAT,1848,15,40-44,1863,0.2146949002984657
STAT,1917,18,50-100,1935,0.07933814776265892
STAT,1911,49,50-100,1960,0.2104715661406819
STAT,1792,73,na,1865,642.1838203303289
STAT,1864,27,na,1891,2169.602957437484
SIM,1827,47,35-39,1874,2
STAT,1926,40,50-100,1966,0.14398529416179634
STAT,1911,44,na,1955,3461.7524626365853
STAT,1826,34,20-24,1860,4.764391315426365
SIM,1890,34,35-39,1924,2
STAT,1854,28,35-39,1882,5.583860542195863
STAT,1882,34,35-39,1916,9.612745696826911
STAT,1818,41,45-49,1859,3.007228292997509
STAT,1829,50,25-29,1879,0.0016471386419787655
STAT,1831,52,30-34,1883,0.004937748360996444
STAT,1909,56,na,1965,3216.9478701180647
STAT,1815,43,35-39,1858,0.18916451572875356
STAT,1901,36,20-24,1937,0.2337560770101722
STAT,1915,26,20-24,1941,18.41859206741073
STAT,1878,78,na,1956,843.8830915862846
SIM,1880,16,na,1896,3249
SIM,1916,39,35-39,1955,22
STAT,1875,37,20-24,1912,0.7915478944998373
STAT,1888,43,40-44,1931,2.577279371195917
STAT,1830,32,20-24,1862,2.5389963017164145
STAT,1898,41,45-49,1939,0.14038846282368694
SIM,1815,46,na,1861,2085
STAT,1850,78,na,1928,360.7894864686604
STAT,1899,39,20-24,1938,0.22496709804952028
SIM,1896,43,40-44,1939,1
STAT,1855,40,25-29,1895,0.42929137871875184
SIM,1915,40,na,1955,3103
SIM,1955,3,na,1958,3825
SIM,1865,70,na,1935,1399
STAT,1890,20,35-39,1910,7.106625260383381
STAT,1889,42,30-34,1931,1.3827547493673547
SIM,1852,30,na,1882,2366
STAT,1906,39,15-19,1945,0.017374658028304464
STAT,1814,84,na,1898,225.14130836684168
STAT,1890,27,45-49,1917,1.3441410290178675
STAT,1835,52,na,1887,1660.2742437678799
STAT,1844,31,45-49,1875,2.087466928048867
SIM,1840,51,na,1891,2550
STAT,1868,40,20-24,1908,0.15494066885031654
STAT,1878,36,35-39,1914,7.312136413258797
STAT,1870,54,35-39,1924,0.008346638952042141
SIM,1923,38,na,1961,4233
SIM,1901,47,40-44,1948,2
STAT,1830,26,35-39,1856,9.34514296616541
STAT,1876,12,na,1888,2626.0175682462495
SIM,1935,17,na,1952,5802
SIM,1885,47,na,1932,1204
STAT,1916,38,30-34,1954,1.8318273177332498
STAT,1866,51,40-44,1917,0.009655814895001166
STAT,1805,51,50-100,1856,0.01805593669834394
STAT,1861,18,25-29,1879,5.384793317926288
STAT,1871,53,25-29,1924,0.003476581268965164
STAT,1856,35,45-49,1891,1.4454271655765716
SIM,1896,30,20-24,1926,28
SIM,1877,12,na,1889,213
STAT,1869,58,na,1927,1995.5577906572762
SIM,1826,41,45-49,1867,7
SIM,1840,31,40-44,1871,9
STAT,1948,16,20-24,1964,153.61022247485928
STAT,1899,24,na,1923,3210.1200312669844
SIM,1918,22,20-24,1940,453
STAT,1879,48,45-49,1927,0.23905623075716548
STAT,1926,18,35-39,1944,5.087209343203218
STAT,1819,67,na,1886,381.7295646598849
STAT,1885,32,45-49,1917,1.714088906594229
SIM,1893,32,45-49,1925,1
STAT,1878,25,na,1903,2472.0787104593946
STAT,1908,31,50-100,1939,0.7775552299605679
SIM,1856,40,50-100,1896,16
STAT,1823,53,35-39,1876,0.012671441866019435
STAT,1871,33,20-24,1904,2.6850401400079336
SIM,1915,18,25-29,1933,4
STAT,1810,106,na,1916,3.780263401036428E-4
STAT,1907,18,25-29,1925,8.246642741453478
STAT,1870,9,na,1879,2694.491247282315
STAT,1837,35,35-39,1872,7.04976037191853
STAT,1890,44,35-39,1934,2.16259395012302
STAT,1932,29,15-19,1961,0.9173101758002772
STAT,1871,39,50-100,1910,1.2124006394168114
STAT,1896,41,25-29,1937,0.05904935706293573
STAT,1857,57,na,1914,1542.1133036025608
STAT,1870,41,15-19,1911,0.013829771250054714
STAT,1844,50,na,1894,2163.7731418180233
STAT,1920,36,30-34,1956,1.9716397216746495
SIM,1887,48,45-49,1935,5
SIM,1940,29,15-19,1969,6
STAT,1822,50,25-29,1872,0.005939010864733151
STAT,1842,53,45-49,1895,0.0035447824950965417
SIM,1900,33,15-19,1933,2
STAT,1877,41,15-19,1918,0.01408207005264803
STAT,1815,102,na,1917,0.020670477385764364
STAT,1903,35,40-44,1938,1.35395653505561
STAT,1888,30,20-24,1918,3.1448494600099437
STAT,1880,18,35-39,1898,0.568152370474952
STAT,1884,47,15-19,1931,3.81123496924905E-4
STAT,1865,42,45-49,1907,1.3647368292297246
STAT,1840,49,15-19,1889,1.548098799030498E-4
SIM,1845,35,35-39,1880,30
SIM,1913,47,45-49,1960,1
SIM,1823,33,na,1856,1788
STAT,1887,40,30-34,1927,1.2781774336828848
STAT,1904,26,35-39,1930,13.832692644363174
STAT,1833,30,30-34,1863,10.168168665682403
STAT,1941,16,20-24,1957,138.09624702160906
SIM,1907,11,na,1918,4894
SIM,1846,67,na,1913,319
STAT,1871,24,30-34,1895,17.65729546856316
STAT,1927,39,45-49,1966,0.8388875766712106
STAT,1832,31,40-44,1863,0.27833065164864307
STAT,1858,38,20-24,1896,0.5857499731410472
SIM,1841,36,na,1877,807
SIM,1873,42,45-49,1915,1
STAT,1905,47,45-49,1952,0.1905818214582484
STAT,1859,42,45-49,1901,1.1847655183745311
STAT,1928,3,na,1931,5071.897184191427
STAT,1910,39,40-44,1949,1.401446091459762
STAT,1910,38,50-100,1948,0.39508542717562456
STAT,1841,41,45-49,1882,1.7541426086705822
STAT,1844,42,25-29,1886,0.6515522537361718
STAT,1890,20,25-29,1910,69.71544840023783
STAT,1812,50,30-34,1862,0.0015246497354603422
STAT,1924,26,50-100,1950,1.151726644975762
STAT,1926,27,25-29,1953,78.22668241103469
SIM,1871,34,na,1905,1788
SIM,1810,47,na,1857,3168
STAT,1846,50,35-39,1896,0.005172080855513402
STAT,1785,87,na,1872,25.21686837272791
STAT,1898,61,na,1959,2603.7424332729734
SIM,1880,11,na,1891,3337
STAT,1873,35,45-49,1908,2.064298497776411
STAT,1915,48,30-34,1963,0.08831358370769564
STAT,1882,18,45-49,1900,0.06237658046261584
STAT,1826,51,20-24,1877,0.0010399032519747445
STAT,1879,40,20-24,1919,0.16456062442806857
STAT,1866,20,40-44,1886,1.9455080738045298
STAT,1874,31,30-34,1905,18.09322907033204
STAT,1883,43,40-44,1926,2.1482689826285086
SIM,1860,71,na,1931,1638
SIM,1882,31,30-34,1913,1
STAT,1834,43,45-49,1877,0.7850427924242985
STAT,1859,64,na,1923,1377.8100453343854
STAT,1879,54,30-34,1933,0.0059384415010621215
STAT,1910,25,30-34,1935,37.986882137745305
SIM,1826,28,25-29,1854,6
STAT,1875,52,20-24,1927,7.537003549066326E-4
STAT,1880,41,50-100,1921,1.1017228107661516
STAT,1816,52,40-44,1868,0.03080724002247493
STAT,1848,27,na,1875,2416.6715713881044
STAT,1870,43,30-34,1913,1.1378628757931306
STAT,1911,42,15-19,1953,0.001449211145612307
STAT,1821,33,30-34,1854,24.357730265288726
STAT,1889,16,40-44,1905,0.22079739180024183
SIM,1911,26,na,1937,2516
STAT,1885,11,na,1896,2542.263662091603
STAT,1901,27,30-34,1928,35.20971466995478
STAT,1930,16,35-39,1946,5.40009752714301
SIM,1830,51,na,1881,308
STAT,1864,52,45-49,1916,0.013123090034361577
STAT,1872,31,na,1903,2399.3206993025315
SIM,1863,40,35-39,1903,6
SIM,1809,50,na,1859,612
STAT,1894,30,45-49,1924,2.235371331302501
STAT,1949,16,na,1965,4239.813269795369
STAT,1931,34,40-44,1965,5.085140136666145
STAT,1858,45,20-24,1903,0.009255332804618148
STAT,1912,21,25-29,1933,87.75888107227561
STAT,1909,15,30-34,1924,2.3769330906899477
STAT,1912,23,na,1935,3603.592736878988
SIM,1852,42,25-29,1894,3
STAT,1842,49,na,1891,546.849256288019
SIM,1871,0,na,1871,3356
STAT,1823,42,30-34,1865,1.9309191266103414
STAT,1923,35,45-49,1958,0.7829420704722483
SIM,1854,64,na,1918,347
STAT,1933,30,35-39,1963,12.245384754739359
STAT,1905,31,35-39,1936,8.39795844673515
STAT,1928,33,na,1961,4690.183367493492
STAT,1857,42,35-39,1899,1.3878378773747009
STAT,1864,37,45-49,1901,1.8122910268629056
SIM,1822,54,na,1876,1219
SIM,1887,48,50-100,1935,1
STAT,1825,107,na,1932,0.0029041439821040293
STAT,1940,32,40-44,1972,4.004694473919542
STAT,1885,19,25-29,1904,5.54023575384195
STAT,1855,54,45-49,1909,0.00934071800722903
STAT,1886,31,15-19,1917,0.1480729377697876
SIM,1841,14,na,1855,1206
STAT,1884,35,20-24,1919,0.7449204054992397
STAT,1829,45,na,1874,920.0873103473147
SIM,1941,30,35-39,1971,2
STAT,1873,26,na,1899,2456.447963041132
STAT,1898,17,50-100,1915,0.06588020207903839
STAT,1872,51,40-44,1923,0.010592402105934137
STAT,1901,47,25-29,1948,0.045217889024835575
STAT,1909,42,50-100,1951,0.10876479316158241
STAT,1860,48,40-44,1908,0.13790874095985162
STAT,1890,33,30-34,1923,21.047663221740137
STAT,1892,41,40-44,1933,2.7974151675290715
SIM,1890,45,50-100,1935,1
STAT,1819,40,15-19,1859,0.003098592041231054
STAT,1817,45,50-100,1862,0.1766806597711479
STAT,1839,51,30-34,1890,0.005556772366510728
SIM,1821,34,35-39,1855,103
SIM,1852,42,50-100,1894,1
STAT,1808,53,45-49,1861,0.018254278361789084
STAT,1817,44,20-24,1861,0.11271469083967899
SIM,1826,47,na,1873,1920
STAT,1919,37,35-39,1956,2.5639738214011363
STAT,1823,51,45-49,1874,0.022227750025435155
STAT,1920,47,35-39,1967,0.14068768550265331
STAT,1814,43,40-44,1857,7.640288640147408
STAT,1852,41,20-24,1893,0.16058260606395752
STAT,1900,38,na,1938,3273.138136680005
STAT,1920,24,50-100,1944,0.7175805728539729
STAT,1899,49,25-29,1948,0.043452070118764535
SIM,1810,69,na,1879,2853
SIM,1855,12,na,1867,3381
SIM,1905,19,na,1924,3711
SIM,1879,39,45-49,1918,22
STAT,1927,19,40-44,1946,1.7157178286542945
STAT,1837,52,35-39,1889,0.006928056622209562
STAT,1797,72,na,1869,22.55197513588071
STAT,1912,28,45-49,1940,1.676790870211416
SIM,1850,42,40-44,1892,3
SIM,1930,18,na,1948,5518
STAT,1917,15,15-19,1932,9.68051094955629
STAT,1914,42,40-44,1956,0.24439798997902326
SIM,1926,7,na,1933,6370
STAT,1836,47,35-39,1883,0.11226968693163782
STAT,1875,44,45-49,1919,1.516083999162517
STAT,1933,17,15-19,1950,60.33976390799066
STAT,1934,22,15-19,1956,7.105299600637998
SIM,1831,42,30-34,1873,14
STAT,1881,34,40-44,1915,4.0603056251254515
STAT,1861,31,45-49,1892,1.456164031970901
STAT,1841,64,na,1905,1935.7751289153919
STAT,1897,39,na,1936,3121.8099854333304
STAT,1859,17,30-34,1876,1.4664140138165127
STAT,1880,25,35-39,1905,10.08503716851742
SIM,1870,34,30-34,1904,3
SIM,1963,6,na,1969,5558
STAT,1870,48,25-29,1918,0.05670182154992267
STAT,1880,66,na,1946,1701.5456792611265
STAT,1885,43,25-29,1928,0.6266481401983837
STAT,1866,30,50-100,1896,0.8430889175983377
STAT,1844,18,50-100,1862,0.06133381456577151
SIM,1822,32,na,1854,1525
STAT,1811,66,na,1877,1153.8311029792967
STAT,1869,46,35-39,1915,0.1416725597755629
STAT,1872,78,na,1950,782.3949998407646
STAT,1890,42,45-49,1932,1.809612800723769
STAT,1906,36,20-24,1942,0.24209112423397536
STAT,1825,50,40-44,1875,0.013435506633701312
STAT,1912,34,30-34,1946,15.191681229846484
STAT,1834,51,20-24,1885,3.4012674313369743E-4
STAT,1940,28,20-24,1968,18.396355544235952
STAT,1907,40,35-39,1947,0.18532784856717624
STAT,1842,42,40-44,1884,0.5776946411373476
SIM,1935,33,na,1968,5694
STAT,1847,79,na,1926,632.0729117276153
STAT,1858,21,45-49,1879,0.6154097696561804
SIM,1925,15,15-19,1940,420
STAT,1935,32,50-100,1967,1.135632380302059
STAT,1820,54,20-24,1874,0.0010757884963919478
STAT,1952,17,25-29,1969,51.4572554600372
STAT,1874,40,45-49,1914,1.5602181043095218
STAT,1893,14,na,1907,3219.0443830807153
STAT,1818,52,25-29,1870,0.0060610642704786895
STAT,1831,64,na,1895,1360.5262856587112
STAT,1862,30,15-19,1892,0.12226944010579134
STAT,1892,51,na,1943,2678.6519972765145
STAT,1924,40,na,1964,4387.298949654728
STAT,1864,43,30-34,1907,1.037620384448953
STAT,1789,68,na,1857,1208.0231999925038
STAT,1843,37,25-29,1880,3.32102361349246
STAT,1894,15,50-100,1909,0.06259040007031573
STAT,1847,20,30-34,1867,20.02899230968795
SIM,1890,31,30-34,1921,6
STAT,1922,1,na,1923,4779.124317467551
SIM,1844,47,35-39,1891,4
SIM,1848,30,40-44,1878,164
SIM,1847,24,na,1871,1713
STAT,1942,24,15-19,1966,5.513808480120527
SIM,1845,28,35-39,1873,1
STAT,1840,33,40-44,1873,2.0583626058750846
STAT,1928,24,50-100,1952,0.8101901851870524
SIM,1928,42,35-39,1970,2
STAT,1850,34,50-100,1884,0.43349476533366776
SIM,1836,50,50-100,1886,1
STAT,1831,50,40-44,1881,0.00908578886625688
STAT,1842,27,na,1869,664.1054426021518
STAT,1911,60,na,1971,3202.263922369535
STAT,1888,46,45-49,1934,0.2731559786036858
STAT,1911,44,40-44,1955,0.23314118369364545
SIM,1902,6,na,1908,3754
STAT,1845,30,15-19,1875,0.08578427366485564
SIM,1851,37,25-29,1888,6
SIM,1864,64,na,1928,1934
STAT,1945,27,35-39,1972,16.28945627432331
STAT,1806,50,30-34,1856,0.016460635124014734
STAT,1880,82,na,1962,707.3035713873875
STAT,1842,53,20-24,1895,1.8024318455705287E-4
STAT,1876,6,na,1882,2744.295689315338
SIM,1872,43,30-34,1915,4
STAT,1849,54,45-49,1903,0.011891779116677164
SIM,1894,28,30-34,1922,5
SIM,1888,9,na,1897,676
STAT,1863,26,na,1889,2052.1385883541307
STAT,1851,79,na,1930,552.1481355551903
STAT,1912,55,na,1967,3380.148413951722
STAT,1898,43,35-39,1941,0.16787210249390383
SIM,1908,37,25-29,1945,3
STAT,1859,53,25-29,1912,0.0027622978780632483
STAT,1877,17,50-100,1894,0.04973265295747648
STAT,1819,37,30-34,1856,1.4296767447444614
STAT,1907,27,15-19,1934,0.6619959527270894
SIM,1808,98,na,1906,4
STAT,1867,52,20-24,1919,6.941574136033539E-4
SIM,1933,36,30-34,1969,2
STAT,1779,75,na,1854,615.0
STAT,1856,32,40-44,1888,3.1529983289240624
STAT,1832,49,na,1881,1992.221260725331
STAT,1860,46,15-19,1906,3.272430662991146E-4
STAT,1860,33,50-100,1893,0.7443116405758189
STAT,1886,28,30-34,1914,25.985327337351777
STAT,1893,18,20-24,1911,22.11193624688069
SIM,1815,84,na,1899,339
SIM,1967,1,na,1968,6509
STAT,1925,36,30-34,1961,2.169448221869828
STAT,1841,17,45-49,1858,0.09381660238205432
STAT,1903,41,na,1944,3307.057522480403
STAT,1910,38,na,1948,3540.248781688136
SIM,1855,20,30-34,1875,9
STAT,1822,41,35-39,1863,3.3019321726177755
STAT,1851,36,20-24,1887,0.6217530913090583
STAT,1939,30,50-100,1969,0.8352645357237867
STAT,1896,46,50-100,1942,0.18314439132974825
STAT,1857,53,40-44,1910,0.007948802923688545
STAT,1878,29,35-39,1907,9.856531998268734
STAT,1914,19,na,1933,3918.5724373391763
STAT,1860,46,na,1906,1840.613533484824
STAT,1823,35,na,1858,2327.5640957355477
SIM,1913,44,40-44,1957,2
SIM,1796,75,na,1871,580
SIM,1940,29,25-29,1969,12
SIM,1828,32,na,1860,1811
STAT,1941,29,50-100,1970,1.0169459723139904
STAT,1884,29,50-100,1913,0.6079832158124611
SIM,1920,21,25-29,1941,340
SIM,1831,36,na,1867,2178
STAT,1817,47,25-29,1864,0.04035245692318381
STAT,1932,29,25-29,1961,85.52635351436228
STAT,1779,107,na,1886,0.012948362850910377
STAT,1947,9,na,1956,4379.966383417319
SIM,1895,41,na,1936,4508
STAT,1873,41,30-34,1914,1.1846423289576726
STAT,1900,15,20-24,1915,24.673181181317773
STAT,1901,42,30-34,1943,0.11148952680328263
STAT,1899,22,45-49,1921,0.9524487287285792
STAT,1931,37,na,1968,4947.526656144494
SIM,1838,38,45-49,1876,1
STAT,1896,45,40-44,1941,0.12857188615858947
STAT,1921,26,45-49,1947,1.909131436580941
SIM,1819,38,35-39,1857,12
STAT,1832,34,45-49,1866,0.1185911646774813
STAT,1893,42,20-24,1935,0.19835560501574515
STAT,1905,44,40-44,1949,0.22162505623712228
STAT,1920,42,40-44,1962,0.2726944608738059
STAT,1844,34,na,1878,2514.7692984757914
STAT,1877,45,30-34,1922,0.09924329619987787
STAT,1832,40,30-34,1872,0.09840996051431475
STAT,1781,94,na,1875,4.481547101830767
STAT,1853,51,30-34,1904,0.0046376232040305975
STAT,1888,21,30-34,1909,20.620357919280305
SIM,1872,30,25-29,1902,3
SIM,1934,27,25-29,1961,542
STAT,1878,41,na,1919,2388.7231993343676
SIM,1910,9,na,1919,4577
STAT,1863,64,na,1927,1484.0579512477123
STAT,1851,40,40-44,1891,1.7943864908109168
STAT,1846,41,20-24,1887,0.0964249155715117
STAT,1863,6,na,1869,2430.3110506200064
STAT,1829,67,na,1896,578.8731612811185
STAT,1912,45,na,1957,3506.091985148431
SIM,1896,26,na,1922,3422
STAT,1901,4,na,1905,3678.267557281037
STAT,1853,110,na,1963,9.353594275096334E-4
STAT,1904,26,na,1930,3421.3169533585146
STAT,1911,49,35-39,1960,0.11997564881582602
STAT,1815,40,30-34,1855,0.12633837888804117
STAT,1871,20,15-19,1891,3.310555906273495
STAT,1845,27,30-34,1872,15.209480655874366
STAT,1869,26,na,1895,2416.4616638814164
STAT,1897,29,45-49,1926,1.4640013999909218
STAT,1909,41,na,1950,3458.231086249508
STAT,1862,37,35-39,1899,6.02429737727093
STAT,1868,40,45-49,1908,1.4601473664936917
STAT,1878,53,35-39,1931,0.008715377909232968
STAT,1931,21,35-39,1952,12.163020130002746
SIM,1853,27,30-34,1880,1
SIM,1906,49,50-100,1955,2
STAT,1882,31,30-34,1913,16.784425175859695
STAT,1884,63,na,1947,1708.0652044777055
STAT,1833,52,40-44,1885,0.004650156366136234
STAT,1836,53,20-24,1889,5.60912420515795E-4
STAT,1829,50,35-39,1879,0.004003462017430785
STAT,1852,27,na,1879,2536.2494656969584
STAT,1864,30,25-29,1894,9.38646268147102
SIM,1877,22,na,1899,46
STAT,1870,32,25-29,1902,10.21119161290382
STAT,1885,81,na,1966,834.4027863686862
STAT,1862,34,30-34,1896,14.74383666724327
STAT,1898,45,50-100,1943,0.1881528089131332
SIM,1842,40,40-44,1882,72
STAT,1941,19,15-19,1960,46.18323166794737
STAT,1903,38,45-49,1941,0.6077529666830553
SIM,1794,68,na,1862,657
STAT,1862,53,na,1915,1804.4953615784177
STAT,1929,18,na,1947,4652.267791870232
STAT,1834,43,50-100,1877,0.5541478518879936
STAT,1906,39,25-29,1945,0.890845993180041
STAT,1872,54,45-49,1926,0.014132520618487871
STAT,1846,15,30-34,1861,1.1999312472179309
STAT,1876,42,45-49,1918,1.5111028689666082
STAT,1851,43,45-49,1894,1.173496538888632
SIM,1855,49,na,1904,3004
STAT,1831,30,20-24,1861,2.9620802291175323
STAT,1909,27,25-29,1936,62.263727641688156
STAT,1867,19,30-34,1886,1.5228852763727352
STAT,1897,33,40-44,1930,5.7350801548048365
STAT,1809,51,45-49,1860,0.1223100298322149
SIM,1898,11,na,1909,4434
SIM,1917,27,25-29,1944,1
STAT,1859,29,25-29,1888,33.61850543450586
SIM,1867,29,25-29,1896,181
STAT,1911,40,25-29,1951,0.06815219269468105
SIM,1917,2,na,1919,2533
STAT,1862,46,25-29,1908,0.04919957383156253
STAT,1819,83,na,1902,92.33614368818453
SIM,1914,56,na,1970,4713
SIM,1886,7,na,1893,3155
SIM,1829,30,30-34,1859,18
STAT,1864,12,na,1876,2467.1184179744273
STAT,1863,18,35-39,1881,0.4835607143195675
STAT,1824,40,30-34,1864,0.1933404830303236
STAT,1834,40,40-44,1874,1.2260574708088112
STAT,1823,49,15-19,1872,6.064904706692041E-4
STAT,1884,38,25-29,1922,2.742505351569288
SIM,1906,48,30-34,1954,2
STAT,1852,33,50-100,1885,0.9450483403665221
SIM,1868,45,na,1913,1116
SIM,1971,0,na,1971,5187
SIM,1838,42,40-44,1880,5
STAT,1913,16,35-39,1929,0.8492532501838145
STAT,1910,9,na,1919,3887.6276772640385
STAT,1948,21,na,1969,4151.453852472918
STAT,1850,68,na,1918,705.6630350496947
STAT,1919,34,40-44,1953,4.130289324553604
STAT,1936,36,na,1972,3660.107802002025
SIM,1849,8,na,1857,2894
STAT,1896,41,35-39,1937,0.16651283701113243
STAT,1873,96,na,1969,43.715070824375104
STAT,1910,28,35-39,1938,14.285171464581857
SIM,1878,77,na,1955,1359
STAT,1846,104,na,1950,0.03950382387788899
STAT,1899,46,20-24,1945,0.009271805017135799
STAT,1857,16,45-49,1873,0.05926435843907643
STAT,1909,18,35-39,1927,0.8123701205668754
STAT,1854,35,35-39,1889,3.992843605278444
SIM,1910,31,na,1941,4259
STAT,1847,45,45-49,1892,0.21549882496199424
STAT,1856,28,45-49,1884,0.8204376558733553
STAT,1891,31,30-34,1922,21.558459361020894
STAT,1816,41,35-39,1857,6.113180932899331
STAT,1836,27,50-100,1863,0.634278125715463
STAT,1855,44,40-44,1899,1.4685587686422017
SIM,1876,11,na,1887,4087
STAT,1807,98,na,1905,1.3171309219787855
STAT,1825,53,45-49,1878,0.017451062346778654
STAT,1843,51,20-24,1894,7.325858189611664E-4
SIM,1860,33,50-100,1893,8
STAT,1904,26,45-49,1930,1.5917292704918227
STAT,1928,17,40-44,1945,1.7490197229568882
SIM,1801,55,na,1856,1904
STAT,1890,44,na,1934,2760.235855961529
STAT,1883,32,35-39,1915,9.742674946491869
SIM,1825,47,25-29,1872,1
STAT,1810,87,na,1897,5.485313624268691
STAT,1803,54,20-24,1857,0.0015430880179144197
STAT,1887,42,20-24,1929,0.17458603723675
STAT,1891,24,50-100,1915,0.4983322900642319
SIM,1929,30,35-39,1959,281
STAT,1839,45,na,1884,2184.9704992879388
STAT,1865,41,30-34,1906,1.0543861860837536
STAT,1836,44,30-34,1880,1.0215060266054108
STAT,1875,41,40-44,1916,2.3201246265194153
SIM,1858,30,na,1888,2443
STAT,1814,46,45-49,1860,0.8176866538811012
STAT,1916,34,15-19,1950,0.12974157098953207
STAT,1842,31,35-39,1873,3.0686591857088708
STAT,1852,17,20-24,1869,21.583245099923865
STAT,1885,40,20-24,1925,0.15768032540673302
STAT,1863,42,35-39,1905,1.544010715794338
STAT,1870,82,na,1952,465.15148368244905
STAT,1861,53,30-34,1914,0.004870911946607986
STAT,1870,45,20-24,1915,0.012082465990031144
STAT,1842,49,25-29,1891,0.014000331599579627
STAT,1925,45,20-24,1970,0.013331231878419881
STAT,1924,40,35-39,1964,0.23787636193463438
SIM,1883,41,40-44,1924,34
STAT,1903,47,35-39,1950,0.1115785345137194
SIM,1861,34,na,1895,2091
STAT,1892,37,20-24,1929,0.9543832519123588
STAT,1933,22,na,1955,4811.051295065603
STAT,1855,51,40-44,1906,0.00700091963504922
STAT,1936,15,25-29,1951,41.26799852514852
STAT,1805,54,na,1859,446.8513211068303
SIM,1877,28,30-34,1905,2
STAT,1808,50,40-44,1858,0.014156411458255256
SIM,1875,63,na,1938,2443
SIM,1954,1,na,1955,5556
SIM,1901,25,30-34,1926,429
SIM,1846,61,na,1907,664
STAT,1871,17,30-34,1888,1.6002228203272957
STAT,1959,1,na,1960,5104.56450427109
STAT,1835,20,na,1855,2181.6535688712115
STAT,1945,24,40-44,1969,3.6419266037433164
STAT,1812,53,35-39,1865,0.0020759635712794267
SIM,1850,31,35-39,1881,5
STAT,1923,32,40-44,1955,4.4390495088353985
SIM,1885,63,na,1948,976
STAT,1847,20,50-100,1867,0.45853925095896864
STAT,1860,41,20-24,1901,0.13014464889298347
STAT,1814,52,30-34,1866,0.019627028721499677
STAT,1858,48,25-29,1906,0.04343436426848579
STAT,1881,37,45-49,1918,1.882544716152449
STAT,1898,17,45-49,1915,0.08784026943871785
STAT,1832,87,na,1919,149.55535874470036
STAT,1837,28,35-39,1865,9.858858296382964
STAT,1914,45,45-49,1959,0.21355050661873345
STAT,1842,42,15-19,1884,0.003546859133340766
STAT,1840,36,45-49,1876,0.9380878038185897
STAT,1909,17,30-34,1926,2.3659405856796907
STAT,1828,45,35-39,1873,0.1716336193934751
STAT,1804,91,na,1895,36.71575962617556
SIM,1831,33,40-44,1864,1
SIM,1871,12,na,1883,2073
STAT,1824,46,na,1870,508.8617185160682
SIM,1904,56,na,1960,3873
STAT,1817,98,na,1915,1.029103503631576
STAT,1927,32,25-29,1959,11.276924752072366
SIM,1873,47,50-100,1920,3
STAT,1898,40,30-34,1938,0.10843915624203143
STAT,1908,55,na,1963,3193.300270449948
STAT,1822,87,na,1909,101.59470335966954
STAT,1847,64,na,1911,1571.679317010766
STAT,1848,50,45-49,1898,0.013775503078950582
STAT,1849,51,40-44,1900,0.008912953998737724
STAT,1875,11,na,1886,2686.707305970586
STAT,1911,46,30-34,1957,0.08365114392323776
SIM,1865,42,35-39,1907,11
SIM,1860,17,20-24,1877,8
STAT,1907,48,30-34,1955,0.07867037304748867
STAT,1889,62,na,1951,2200.9995591069214
SIM,1905,42,40-44,1947,6
STAT,1890,59,na,1949,2352.771822950769
SIM,1870,37,35-39,1907,47
STAT,1825,46,20-24,1871,0.015448106324700986
STAT,1838,97,na,1935,2.2911122206181496
STAT,1865,15,40-44,1880,0.19134518459790884
STAT,1865,47,50-100,1912,0.22318523137798787
STAT,1850,30,30-34,1880,9.462506216532777
SIM,1850,13,na,1863,2356
STAT,1925,39,35-39,1964,2.870346925489843
SIM,1915,19,na,1934,3594
STAT,1901,23,15-19,1924,4.598492117153347
STAT,1791,72,na,1863,700.3521105613676
STAT,1853,54,35-39,1907,0.006491798999398682
STAT,1882,42,45-49,1924,1.431134528434287
SIM,1936,18,na,1954,3927
STAT,1880,51,25-29,1931,0.0036947502453147756
STAT,1837,86,na,1923,177.9077820171156
STAT,1931,30,25-29,1961,12.039365578947582
STAT,1839,33,50-100,1872,1.0367433035968787
STAT,1912,25,40-44,1937,4.570711270772732
STAT,1944,19,40-44,1963,1.4872967513627566
SIM,1916,41,na,1957,4578
STAT,1860,50,45-49,1910,0.01200924676699208
STAT,1918,49,45-49,1967,0.22682555884814834
STAT,1932,26,20-24,1958,23.75320829552164
SIM,1902,16,25-29,1918,11
STAT,1822,72,na,1894,728.248737137104
STAT,1875,21,45-49,1896,0.7182080140583609
STAT,1905,40,25-29,1945,0.06478578044147404
STAT,1835,52,25-29,1887,0.0027311912538867233
SIM,1852,79,na,1931,1138
STAT,1879,41,25-29,1920,0.6617309598510759
STAT,1918,33,na,1951,3948.0172856899667
STAT,1868,63,na,1931,1723.4074741089132
SIM,1935,32,25-29,1967,8
STAT,1854,12,na,1866,1587.8227103813679
STAT,1877,48,35-39,1925,0.14033114577785752
STAT,1877,77,na,1954,877.4620564540986
STAT,1832,43,35-39,1875,0.16088491917158856
STAT,1837,34,50-100,1871,0.9021918829060375
STAT,1887,16,30-34,1903,1.758638027272079
STAT,1847,51,30-34,1898,0.005407550801371707
STAT,1877,54,20-24,1931,7.284778608514667E-4
STAT,1831,53,45-49,1884,0.011802199641749113
SIM,1885,41,na,1926,1391
SIM,1920,25,40-44,1945,35
STAT,1892,44,45-49,1936,0.12693793188997404
STAT,1794,90,na,1884,0.38610404118869407
STAT,1802,99,na,1901,0.9595602367701905
STAT,1896,48,45-49,1944,0.17328240642231488
STAT,1921,37,na,1958,4150.99834639211
STAT,1873,44,35-39,1917,1.8324231713126289
SIM,1894,77,na,1971,542
STAT,1901,45,35-39,1946,0.11152020705107193
STAT,1876,92,na,1968,144.65667101832193
STAT,1815,51,45-49,1866,0.0014486131296981976
STAT,1838,40,25-29,1878,0.32890232476407866
STAT,1854,34,na,1888,1330.8282939577616
SIM,1859,50,50-100,1909,1
STAT,1897,49,15-19,1946,2.9339598931439213E-4
STAT,1881,30,35-39,1911,9.640344705787404
SIM,1841,36,50-100,1877,2
SIM,1910,37,40-44,1947,7
STAT,1867,28,20-24,1895,11.05573252286442
SIM,1909,25,25-29,1934,5
STAT,1922,47,45-49,1969,0.24689587221053738
SIM,1879,4,na,1883,2233
STAT,1840,42,30-34,1882,0.47221869365621055
STAT,1841,21,40-44,1862,2.960815189659945
STAT,1913,16,50-100,1929,0.0758261690033397
SIM,1824,41,35-39,1865,12
STAT,1933,38,30-34,1971,2.4631310740287207
SIM,1884,0,na,1884,3913
STAT,1882,22,40-44,1904,1.9950599604164705
STAT,1856,52,45-49,1908,0.010368102837323503
STAT,1951,3,na,1954,4662.249207900633
STAT,1856,78,na,1934,561.1949929019368
STAT,1879,48,50-100,1927,0.2487805515997236
STAT,1878,50,30-34,1928,0.006212405157141979
STAT,1914,38,20-24,1952,0.25825082750475536
STAT,1855,24,50-100,1879,0.3107877093536332
STAT,1835,41,45-49,1876,1.3743352712205206
STAT,1821,42,20-24,1863,0.178904853994307
SIM,1881,44,35-39,1925,2
STAT,1919,18,na,1937,4003.0045082308857
SIM,1891,59,na,1950,1305
STAT,1835,79,na,1914,528.9815661909693
STAT,1859,50,20-24,1909,5.932742779325206E-4
STAT,1844,18,25-29,1862,7.094279316600162
STAT,1806,53,35-39,1859,0.022276204799745392
STAT,1895,36,35-39,1931,9.245253646781034
STAT,1883,43,15-19,1926,0.01318968001314215
STAT,1843,34,20-24,1877,3.1447544838275063
STAT,1866,47,20-24,1913,0.010902757698457166
STAT,1836,31,na,1867,2118.373489112172
STAT,1849,51,50-100,1900,0.012786340540253023
SIM,1879,43,40-44,1922,24
STAT,1821,36,35-39,1857,8.968299647489017
SIM,1907,49,35-39,1956,1
STAT,1820,52,30-34,1872,0.00902923432344192
STAT,1920,45,45-49,1965,0.23827544685094132
SIM,1800,70,na,1870,216
SIM,1869,22,15-19,1891,15
STAT,1859,96,na,1955,6.805721370310988
STAT,1833,36,50-100,1869,0.6728856542734132
STAT,1902,37,40-44,1939,1.3304940789098745
STAT,1839,25,40-44,1864,3.556946265386446
STAT,1915,29,15-19,1944,0.7048114254747332
STAT,1868,41,na,1909,2242.460027019459
SIM,1886,26,na,1912,3102
STAT,1872,31,20-24,1903,2.717795231200263
STAT,1881,38,50-100,1919,1.1536654313183883
STAT,1908,32,15-19,1940,0.12035983238823554
STAT,1863,16,50-100,1879,0.04800899695789171
SIM,1858,24,na,1882,2432
STAT,1859,37,15-19,1896,0.044507691119612294
STAT,1879,39,40-44,1918,4.445420739276276
STAT,1856,36,35-39,1892,5.10460203168184
STAT,1906,5,na,1911,3794.871652005398
STAT,1824,30,30-34,1854,8.89846311982878
SIM,1935,15,25-29,1950,522
STAT,1788,101,na,1889,0.056487994055648055
STAT,1886,16,25-29,1902,5.882593564420985
STAT,1829,98,na,1927,1.1862680750896613
STAT,1874,22,50-100,1896,0.4208668247940713
STAT,1892,39,na,1931,2887.5632880232624
STAT,1834,43,20-24,1877,0.0833032734404254
STAT,1845,13,na,1858,1490.418201545037
STAT,1915,37,na,1952,3746.901806297446
STAT,1945,17,40-44,1962,1.5110513045429048
SIM,1894,62,na,1956,1151
SIM,1823,32,30-34,1855,4
SIM,1911,44,50-100,1955,2
SIM,1924,9,na,1933,5281
STAT,1820,41,25-29,1861,1.0795367996404233
STAT,1890,27,50-100,1917,0.7744162547292339
STAT,1945,18,50-100,1963,0.40461626806959344
STAT,1873,32,na,1905,2447.829252647472
STAT,1833,41,35-39,1874,0.9554507838166618
STAT,1877,46,na,1923,2290.3434501344336
STAT,1899,61,na,1960,2665.6590743778365
SIM,1827,32,na,1859,2385
STAT,1817,46,25-29,1863,0.04089087660453755
STAT,1788,99,na,1887,0.1472441709603371
STAT,1891,21,30-34,1912,21.97040757487822
STAT,1790,93,na,1883,9.580225858924095
STAT,1887,45,25-29,1932,0.06403083370912784
SIM,1846,39,na,1885,988
STAT,1927,22,na,1949,4462.563688533114
SIM,1835,51,na,1886,1206
SIM,1887,39,40-44,1926,24
STAT,1854,20,15-19,1874,2.1865424872327823
STAT,1929,21,40-44,1950,4.234923818727883
STAT,1836,22,20-24,1858,69.69095610874817
SIM,1903,22,25-29,1925,24
STAT,1820,54,30-34,1874,0.008678026883060106
SIM,1864,42,45-49,1906,3
SIM,1949,22,15-19,1971,25
STAT,1865,34,35-39,1899,9.166760931155615
STAT,1910,40,20-24,1950,0.016690817880963358
SIM,1910,49,35-39,1959,2
STAT,1852,18,20-24,1870,21.456119786285317
SIM,1825,39,35-39,1864,3
STAT,1879,31,30-34,1910,17.984068924510186
STAT,1881,51,na,1932,2043.0678534105455
STAT,1889,31,na,1920,2885.399036464715
STAT,1882,23,30-34,1905,17.0009667970089
STAT,1902,49,35-39,1951,0.10888289486178171
STAT,1807,49,50-100,1856,0.8075702259538001
SIM,1872,32,25-29,1904,2
SIM,1935,33,25-29,1968,1
STAT,1882,41,30-34,1923,1.1056845868666716
STAT,1843,41,20-24,1884,0.16364428567541178
STAT,1847,43,30-34,1890,1.031925900214743
STAT,1850,20,30-34,1870,10.015417002059474
SIM,1945,16,na,1961,6340
SIM,1823,66,na,1889,708
SIM,1870,48,na,1918,1412
STAT,1832,50,na,1882,1966.9316779973701
STAT,1840,40,40-44,1880,1.0415977920213846
STAT,1887,76,na,1963,1298.4170506755336
STAT,1901,42,20-24,1943,0.015400955914294825
STAT,1958,14,na,1972,5111.782459645569
STAT,1879,57,na,1936,2061.559549969918
STAT,1894,17,15-19,1911,7.546722157643254
STAT,1817,39,35-39,1856,5.348827091613691
STAT,1895,75,na,1970,1766.5826726886926
STAT,1888,37,40-44,1925,5.052354852009343
STAT,1891,81,na,1972,1144.7016885318758
STAT,1850,39,20-24,1889,0.35415333899108253
SIM,1861,0,na,1861,2919
SIM,1815,47,na,1862,1999
STAT,1826,44,25-29,1870,0.931688973173661
STAT,1834,36,30-34,1870,2.952118104862328
STAT,1917,19,30-34,1936,12.829821882194025
STAT,1933,30,45-49,1963,2.1085844278263295
STAT,1870,48,35-39,1918,0.13781692876899926
SIM,1916,19,na,1935,4456
STAT,1847,52,45-49,1899,0.01305107021822767
STAT,1927,15,25-29,1942,53.691522676255424
STAT,1890,18,40-44,1908,0.22084364138736692
STAT,1909,42,20-24,1951,0.01635026333596967
STAT,1841,18,45-49,1859,0.09326402259402405
SIM,1885,10,na,1895,1861
STAT,1847,36,40-44,1883,4.149228680675386
STAT,1809,53,50-100,1862,0.1221971900800783
STAT,1944,25,25-29,1969,70.39954003318694
STAT,1876,53,25-29,1929,0.0035231581133527024
SIM,1808,65,na,1873,1261
SIM,1894,37,50-100,1931,1
STAT,1862,84,na,1946,283.3428881362859
SIM,1890,41,30-34,1931,2
STAT,1862,53,25-29,1915,0.002968438477993503
SIM,1920,24,na,1944,4320
STAT,1897,37,35-39,1934,9.393207075739156
SIM,1891,26,na,1917,2446
STAT,1952,3,na,1955,4671.006224204466
SIM,1882,45,na,1927,1745
STAT,1820,53,na,1873,1609.1817229813348
STAT,1950,22,45-49,1972,1.3221000020590834
STAT,1882,50,45-49,1932,0.0140940015153166
STAT,1831,33,25-29,1864,10.734662528902415
SIM,1869,25,30-34,1894,40
STAT,1861,18,15-19,1879,5.639290757253245
STAT,1870,18,40-44,1888,0.1829948848758721
STAT,1871,39,40-44,1910,4.322800643693239
STAT,1866,39,30-34,1905,4.815974901863036
STAT,1919,27,40-44,1946,4.969333625518796
SIM,1837,62,na,1899,1516
STAT,1837,81,na,1918,433.60315684241135
SIM,1882,77,na,1959,59
STAT,1815,50,30-34,1865,6.060800351889009E-4
SIM,1840,14,na,1854,2862
STAT,1830,79,na,1909,505.9930340350574
SIM,1851,36,25-29,1887,1
SIM,1901,5,na,1906,4179
STAT,1828,30,15-19,1858,0.22995793166120138
STAT,1927,33,25-29,1960,11.269933058726082
SIM,1875,51,50-100,1926,2
SIM,1908,3,na,1911,3095
STAT,1854,47,40-44,1901,0.09474644482522879
SIM,1930,1,na,1931,5850
STAT,1843,36,25-29,1879,3.3556878691811005
STAT,1860,33,20-24,1893,2.1958284890222575
SIM,1823,41,45-49,1864,22
STAT,1935,1,na,1936,5667.882669470965
STAT,1874,45,15-19,1919,4.169419578003248E-4
STAT,1833,23,35-39,1856,4.663214376491857
STAT,1782,74,na,1856,1342.7364402926999
STAT,1890,28,na,1918,2878.972597206711
STAT,1828,45,na,1873,1731.3285738753602
STAT,1845,15,25-29,1860,3.5962696196630897
SIM,1874,39,30-34,1913,26
STAT,1861,47,na,1908,1862.3412367152469
STAT,1818,38,40-44,1856,10.245855999508919
STAT,1949,16,50-100,1965,0.43156057851766794
STAT,1814,50,40-44,1864,0.036119132612488385
STAT,1949,17,25-29,1966,49.90320684515052
STAT,1885,19,15-19,1904,5.802079752185683
STAT,1835,28,15-19,1863,0.44418612709953237
STAT,1933,28,30-34,1961,51.64854483355951
STAT,1843,29,35-39,1872,11.564886293066172
STAT,1864,20,30-34,1884,16.692500897025358
STAT,1860,29,35-39,1889,7.842025085632263
STAT,1920,21,20-24,1941,122.39625639610797
STAT,1881,67,na,1948,1496.9969174375317
STAT,1848,65,na,1913,1581.423918012417
SIM,1925,19,30-34,1944,32
STAT,1828,50,50-100,1878,0.01811606937893796
STAT,1858,44,20-24,1902,0.11964279247865064
STAT,1806,107,na,1913,0.0014200604952324875
STAT,1824,49,20-24,1873,0.0020364159564810525
SIM,1806,54,na,1860,129
STAT,1852,20,50-100,1872,0.4947058267245683
STAT,1872,34,25-29,1906,10.168717788248479
STAT,1828,105,na,1933,0.0198480481370803
STAT,1893,40,na,1933,2919.4334803081224
STAT,1929,5,na,1934,5095.376025516692
STAT,1839,44,35-39,1883,1.7282828626592064
STAT,1894,25,50-100,1919,0.8189891367543549
STAT,1867,29,20-24,1896,11.015489656481197
STAT,1875,44,20-24,1919,0.16087627471984897
SIM,1851,29,35-39,1880,1
STAT,1861,31,na,1892,1992.6689415270548
SIM,1846,35,na,1881,1148
STAT,1918,40,20-24,1958,0.018574989250873208
STAT,1841,25,35-39,1866,13.539171454690484
STAT,1883,19,50-100,1902,0.046879542665935414
SIM,1914,24,na,1938,5089
STAT,1808,53,20-24,1861,9.281836807395309E-4
SIM,1897,35,35-39,1932,44
STAT,1777,108,na,1885,0.013236845103859196
STAT,1858,79,na,1937,533.8817216239182
STAT,1878,18,40-44,1896,0.18769028880806446
STAT,1931,40,50-100,1971,0.15627365674610352
STAT,1890,22,25-29,1912,69.3019534781945
STAT,1809,78,na,1887,786.1529407200393
SIM,1859,33,20-24,1892,2
STAT,1854,65,na,1919,939.649034981226
STAT,1864,41,40-44,1905,2.0540828758745184
SIM,1883,8,na,1891,2265
SIM,1886,63,na,1949,2614
STAT,1861,42,25-29,1903,0.5333878769615317
STAT,1855,38,40-44,1893,2.882820949611184
STAT,1833,44,15-19,1877,0.00699748867845853
STAT,1853,16,15-19,1869,5.568202282246172
STAT,1960,8,na,1968,5072.385207466563
STAT,1798,89,na,1887,58.288915984508435
STAT,1879,16,35-39,1895,0.5642701634551239
STAT,1935,17,25-29,1952,58.81556983081855
STAT,1867,45,25-29,1912,0.0550171340707223
STAT,1899,48,25-29,1947,0.043821043303378986
SIM,1856,29,na,1885,777
STAT,1903,21,20-24,1924,98.11739126085298
SIM,1829,27,na,1856,2077
STAT,1889,35,35-39,1924,8.598279639438125
STAT,1856,84,na,1940,238.9365203857611
STAT,1807,49,20-24,1856,0.03945783019190321
SIM,1894,30,na,1924,1502
STAT,1885,29,40-44,1914,2.9234428124703427
STAT,1856,51,30-34,1907,0.004295896188526274
SIM,1855,71,na,1926,2200
STAT,1820,49,35-39,1869,0.2142095655842721
STAT,1879,41,na,1920,2381.689875482626
STAT,1880,37,40-44,1917,4.544524034260274
STAT,1809,101,na,1910,0.5554313449389849
STAT,1833,39,20-24,1872,0.40688439558791184
STAT,1842,64,na,1906,431.5378624561269
STAT,1907,38,30-34,1945,1.6701360275768855
STAT,1823,31,25-29,1854,44.55369664786021
SIM,1860,34,na,1894,2020
SIM,1915,32,45-49,1947,6
STAT,1894,19,40-44,1913,0.23134290184400574
STAT,1844,28,40-44,1872,3.606846929492094
STAT,1870,45,30-34,1915,0.0974652220457918
STAT,1827,28,40-44,1855,3.5002964233269873
STAT,1848,34,35-39,1882,9.850127569747269
STAT,1813,46,40-44,1859,0.6425313837077424
STAT,1838,30,30-34,1868,9.455733235862922
STAT,1891,16,35-39,1907,0.6764206386522861
SIM,1821,46,40-44,1867,1
STAT,1831,92,na,1923,32.596915500636655
STAT,1803,54,30-34,1857,0.012447576217166068
STAT,1809,90,na,1899,76.74152068784586
STAT,1838,54,45-49,1892,0.006024708466444447
STAT,1890,31,40-44,1921,5.27151558038695
STAT,1838,38,40-44,1876,2.231545560865297
STAT,1951,7,na,1958,4637.038486829955
SIM,1878,44,na,1922,3915
STAT,1918,17,25-29,1935,9.335603472070819
SIM,1835,40,50-100,1875,1
SIM,1924,5,na,1929,5321
STAT,1924,32,45-49,1956,1.8182180315652663
SIM,1799,71,na,1870,564
STAT,1924,38,30-34,1962,2.1263432862755067
STAT,1823,40,40-44,1863,3.940664084018294
STAT,1894,0,na,1894,3734.0173780982495
SIM,1932,38,30-34,1970,11
STAT,1833,28,na,1861,1158.8917244012302
STAT,1882,19,45-49,1901,0.06220504486634361
STAT,1907,32,45-49,1939,1.4609977188823373
SIM,1953,5,na,1958,4654
STAT,1881,41,40-44,1922,2.1337096565613147
STAT,1920,34,50-100,1954,0.8863237556123538
SIM,1887,43,25-29,1930,6
STAT,1937,22,30-34,1959,27.699017278453038
STAT,1870,16,15-19,1886,6.008097169849912
STAT,1850,44,15-19,1894,0.006290774333627371
STAT,1866,31,50-100,1897,0.839784009041352
SIM,1926,35,25-29,1961,3
STAT,1884,34,20-24,1918,2.5654098380135135
STAT,1929,24,45-49,1953,1.4040556623765028
STAT,1827,87,na,1914,124.24120091418902
STAT,1875,37,30-34,1912,5.4726888007787995
STAT,1830,46,40-44,1876,0.14819361169310769
STAT,1829,48,40-44,1877,0.07816538246960697
SIM,1846,30,30-34,1876,1
STAT,1879,43,25-29,1922,0.6539916060024227
SIM,1882,21,30-34,1903,1
STAT,1900,26,50-100,1926,0.8891975971107595
STAT,1817,44,50-100,1861,0.7497977117273346
STAT,1808,46,30-34,1854,0.1879424504228182
STAT,1902,62,na,1964,2774.721263628943
STAT,1817,43,20-24,1860,0.11461770494724235
SIM,1892,34,20-24,1926,1
STAT,1918,35,25-29,1953,1.0335247098504232
STAT,1873,26,40-44,1899,3.0833334113241624
STAT,1870,52,20-24,1922,7.317400086661933E-4
STAT,1834,45,na,1879,1078.7579884770462
STAT,1838,59,na,1897,828.8335161526663
SIM,1823,35,35-39,1858,16
STAT,1935,35,25-29,1970,1.3692559125127208
SIM,1866,6,na,1872,3337
SIM,1936,32,30-34,1968,2
STAT,1832,33,45-49,1865,0.11617058180319798
STAT,1942,20,45-49,1962,1.1670632260128275
SIM,1855,39,45-49,1894,7
STAT,1916,54,na,1970,3619.7446191353847
SIM,1863,30,30-34,1893,1
STAT,1849,47,30-34,1896,0.08118264354767073
STAT,1841,30,30-34,1871,24.08461112071785
STAT,1856,33,30-34,1889,12.562912180103336
STAT,1902,46,30-34,1948,0.07710845755279544
STAT,1851,50,45-49,1901,0.011626507673586495
STAT,1928,32,30-34,1960,19.550323190702596
STAT,1918,32,20-24,1950,2.5569880191404644
SIM,1864,33,30-34,1897,3
STAT,1910,43,25-29,1953,0.06633211820508461
STAT,1882,26,35-39,1908,9.269685408293173
STAT,1900,43,15-19,1943,0.0013188684961666
STAT,1808,49,35-39,1857,0.19432868292033909
STAT,1839,36,35-39,1875,7.934644798458265
STAT,1953,19,40-44,1972,1.6757206207548914
STAT,1893,27,25-29,1920,52.89910355689691
SIM,1893,45,na,1938,3002
SIM,1859,9,na,1868,2403
STAT,1866,23,45-49,1889,0.637117911351112
SIM,1924,18,na,1942,5240
STAT,1846,30,na,1876,1548.7010413443627
SIM,1855,43,50-100,1898,1
STAT,1827,28,na,1855,2084.7258997424574
STAT,1883,39,30-34,1922,5.075680208458256
SIM,1896,45,45-49,1941,2
SIM,1871,37,40-44,1908,1
SIM,1807,48,na,1855,1094
STAT,1860,36,25-29,1896,2.3601315399122096
STAT,1929,17,na,1946,4664.488752401521
STAT,1933,22,45-49,1955,1.482355582676311
STAT,1865,50,45-49,1915,0.013440108219746096
STAT,1834,46,25-29,1880,0.029965590544706575
STAT,1870,83,na,1953,395.769488376375
SIM,1788,71,na,1859,325
STAT,1936,23,25-29,1959,87.40432212942096
STAT,1862,50,20-24,1912,6.375482559663257E-4
STAT,1871,61,na,1932,1864.0455093414585
SIM,1888,5,na,1893,720
STAT,1957,9,na,1966,5135.632249807068
STAT,1861,28,40-44,1889,2.4913219556294117
STAT,1871,47,40-44,1918,0.16998328644375255
STAT,1866,43,15-19,1909,0.012514808911925458
SIM,1919,35,35-39,1954,1
STAT,1861,47,30-34,1908,0.08012772900761388
STAT,1909,25,na,1934,3566.590132952566
STAT,1815,53,35-39,1868,8.259239081925123E-4
STAT,1820,49,na,1869,1728.3330277591942
STAT,1841,15,40-44,1856,0.2658085538560443
STAT,1862,49,40-44,1911,0.1427734933243724
STAT,1863,37,40-44,1900,3.7371279746326436
STAT,1844,18,15-19,1862,7.429570907817675
STAT,1847,39,45-49,1886,1.8315783364605365
STAT,1853,18,40-44,1871,0.16959654725934803
STAT,1927,29,40-44,1956,5.597692330517102
STAT,1855,30,30-34,1885,12.012762138904579
STAT,1844,19,50-100,1863,0.06097255839797913
STAT,1876,29,15-19,1905,0.45537347330478267
STAT,1895,36,50-100,1931,1.6048238781848816
STAT,1888,8,na,1896,3000.30190906841
STAT,1846,94,na,1940,11.836971651303902
SIM,1812,54,na,1866,1143
STAT,1806,51,45-49,1857,0.039250091642753636
STAT,1843,50,na,1893,2157.9980105119575
STAT,1834,39,35-39,1873,3.79761536910673
SIM,1892,42,20-24,1934,2
STAT,1832,34,na,1866,2376.2734306526
STAT,1888,45,45-49,1933,0.2750981716958586
STAT,1848,52,35-39,1900,0.00801325155925767
STAT,1892,3,na,1895,3273.0763406750407
SIM,1823,70,na,1893,593
SIM,1896,25,na,1921,3103
SIM,1866,59,na,1925,2670
STAT,1835,101,na,1936,0.43176526119634173
STAT,1816,48,30-34,1864,0.29022357642790714
STAT,1916,30,45-49,1946,1.6153223042153906
STAT,1932,37,na,1969,5019.733713432518
STAT,1832,51,45-49,1883,0.0011843693365476218
STAT,1886,39,na,1925,2415.1775715344124
STAT,1802,68,na,1870,1050.7284804697883
STAT,1840,43,45-49,1883,0.6069095682418094
SIM,1868,14,na,1882,1326
STAT,1847,46,35-39,1893,0.126935747872243
STAT,1858,39,20-24,1897,0.5827450757788336
STAT,1826,36,25-29,1862,4.827741245925742
STAT,1850,15,35-39,1865,0.31329735012563725
STAT,1838,42,25-29,1880,0.32058177115112996
STAT,1857,49,30-34,1906,0.07272966386411456
STAT,1861,99,na,1960,3.38744860369402
STAT,1897,42,30-34,1939,0.10589491777484247
STAT,1919,34,30-34,1953,16.628636986404253
STAT,1851,102,na,1953,0.23154742914118412
STAT,1911,32,50-100,1943,0.796032709181569
SIM,1800,69,na,1869,216
SIM,1824,51,na,1875,2003
SIM,1842,39,35-39,1881,60
SIM,1799,67,na,1866,1026
STAT,1938,22,45-49,1960,1.1016606708103767
STAT,1811,72,na,1883,822.3204015918129
STAT,1838,46,40-44,1884,0.07615586475439667
STAT,1873,42,45-49,1915,1.5333328880169792
STAT,1901,45,25-29,1946,0.04588259900943827
STAT,1903,24,25-29,1927,80.75208103040603
STAT,1824,108,na,1932,3.5448196208418166E-4
SIM,1829,82,na,1911,1137
SIM,1925,5,na,1930,5349
SIM,1834,29,35-39,1863,2
STAT,1895,48,40-44,1943,0.12404812770779922
STAT,1895,21,15-19,1916,4.304566309216917
STAT,1897,27,40-44,1924,3.9782644483321197
STAT,1812,47,35-39,1859,0.03619517879969297
STAT,1936,30,15-19,1966,0.12371915490510382
SIM,1841,51,na,1892,184
SIM,1815,51,35-39,1866,2
STAT,1846,44,25-29,1890,0.37519081283022726
STAT,1821,48,40-44,1869,0.18066090627808068
STAT,1889,32,30-34,1921,21.025428451324085
SIM,1847,52,na,1899,1382
SIM,1887,80,na,1967,1759
SIM,1922,8,na,1930,3756
STAT,1875,47,25-29,1922,0.05887094270560508
STAT,1879,47,40-44,1926,0.17480501396469697
STAT,1910,32,20-24,1942,2.325559255545735
STAT,1848,17,50-100,1865,0.05683210473071631
STAT,1933,9,na,1942,5292.804298555855
STAT,1829,82,na,1911,170.38166050205677
STAT,1874,42,35-39,1916,1.866579363496418
STAT,1822,88,na,1910,79.16462475192169
STAT,1817,51,20-24,1868,5.091224396854815E-4
STAT,1923,15,50-100,1938,0.43732955946597574
SIM,1929,21,na,1950,6274
STAT,1864,8,na,1872,2537.8177798953416
STAT,1892,23,na,1915,2919.104098898131
STAT,1881,25,50-100,1906,0.6081904367848949
SIM,1902,39,na,1941,3333
SIM,1899,61,na,1960,1469
STAT,1892,33,15-19,1925,0.17557001713271858
SIM,1864,48,na,1912,2400
SIM,1909,39,40-44,1948,13
SIM,1869,95,na,1964,612
STAT,1891,40,45-49,1931,1.8590323742288533
STAT,1814,53,45-49,1867,0.04690982722113996
STAT,1849,18,15-19,1867,6.118846818027801
STAT,1877,40,50-100,1917,1.0832469711179074
SIM,1857,18,15-19,1875,28
STAT,1871,43,25-29,1914,0.6359522531623181
STAT,1922,23,na,1945,4128.264994986105
STAT,1926,37,na,1963,4558.484749068601
STAT,1825,42,15-19,1867,0.018366060708046236
STAT,1901,38,35-39,1939,2.1239670109469695
STAT,1840,69,na,1909,577.8519503292914
SIM,1824,83,na,1907,857
STAT,1804,52,25-29,1856,0.022372966921448804
STAT,1859,29,15-19,1888,0.36057420740018437
STAT,1944,22,20-24,1966,118.70693628277978
SIM,1916,51,na,1967,4520
STAT,1876,50,20-24,1926,7.566885173176705E-4
STAT,1893,35,25-29,1928,3.6347107036539184
STAT,1856,54,35-39,1910,0.00601344554123278
STAT,1884,42,20-24,1926,0.15184016119353871
STAT,1804,90,na,1894,49.9534144573817
STAT,1864,32,25-29,1896,9.311614600026267
STAT,1925,43,50-100,1968,0.14070784885485962
SIM,1838,43,30-34,1881,1
SIM,1876,33,na,1909,3771
STAT,1830,41,50-100,1871,0.9459738574940161
STAT,1927,8,na,1935,4918.717378584024
STAT,1860,26,30-34,1886,20.91346915863599
STAT,1817,38,20-24,1855,0.595959095236416
SIM,1928,38,50-100,1966,1
STAT,1886,7,na,1893,2697.9768542719985
STAT,1840,14,na,1854,1206.0
STAT,1844,28,na,1872,2604.713397140676
STAT,1944,22,na,1966,3898.5115420847806
STAT,1814,53,na,1867,1888.2797151926536
SIM,1895,56,na,1951,4395
STAT,1839,29,45-49,1868,1.2809210016211505
SIM,1883,62,na,1945,1967
STAT,1812,54,25-29,1866,8.371057744506622E-4
SIM,1883,29,30-34,1912,5
STAT,1837,24,30-34,1861,18.429245296716363
STAT,1875,29,30-34,1904,25.67327715150754
STAT,1884,29,20-24,1913,11.149930201223684
STAT,1937,25,35-39,1962,14.496414359812428
STAT,1897,34,30-34,1931,22.988890194698545
STAT,1898,24,na,1922,3160.41122044946
SIM,1877,24,25-29,1901,3
SIM,1887,76,na,1963,1759
STAT,1838,53,30-34,1891,0.0025002292770881147
STAT,1945,24,30-34,1969,31.130987939831282
STAT,1875,27,na,1902,2450.606696760938
STAT,1913,21,30-34,1934,27.584078566857272
STAT,1918,43,25-29,1961,0.07478131870207229
STAT,1924,48,30-34,1972,0.10481765868130612
STAT,1832,41,45-49,1873,0.130075026126006
STAT,1823,73,na,1896,938.2972633668902
SIM,1884,19,20-24,1903,32
SIM,1918,33,25-29,1951,29
SIM,1873,68,na,1941,609
STAT,1901,37,50-100,1938,0.370523514283542
SIM,1903,6,na,1909,3100
STAT,1823,35,40-44,1858,8.348228844230235
STAT,1910,48,30-34,1958,0.08201387357841997
STAT,1828,51,50-100,1879,0.017760345447794035
STAT,1848,30,50-100,1878,1.0208621083251461
STAT,1877,23,20-24,1900,69.73831546149813
STAT,1900,18,25-29,1918,7.829469220526012
STAT,1941,24,50-100,1965,0.6717993408921386
STAT,1834,28,30-34,1862,14.448109616233792
STAT,1905,11,na,1916,3720.0187384670144
STAT,1800,102,na,1902,0.2022835004881702
STAT,1897,9,na,1906,3445.80751413836
STAT,1921,45,50-100,1966,0.253138785121198
STAT,1891,22,45-49,1913,0.8575163851479248
STAT,1853,48,35-39,1901,0.1071904278384883
STAT,1863,32,30-34,1895,14.905575419925771
STAT,1916,49,35-39,1965,0.12967231196714568
STAT,1865,4,na,1869,2755.6869618355927
STAT,1868,73,na,1941,1147.215678971285
SIM,1901,21,na,1922,3964
SIM,1856,31,30-34,1887,6
SIM,1879,37,40-44,1916,5
SIM,1879,44,30-34,1923,19
STAT,1926,42,20-24,1968,0.021584933778295526
STAT,1951,20,50-100,1971,0.7793539918569902
SIM,1816,43,50-100,1859,1
STAT,1865,19,45-49,1884,0.06073493347709542
STAT,1873,34,45-49,1907,1.7734624755186263
STAT,1869,31,15-19,1900,0.1442882569359062
STAT,1890,26,40-44,1916,3.63889645466843
SIM,1867,2,na,1869,3840
STAT,1881,44,45-49,1925,1.394271252585271
STAT,1907,1,na,1908,3971.4668456595477
STAT,1868,29,40-44,1897,2.8726487184840885
SIM,1922,43,45-49,1965,1
STAT,1811,88,na,1899,83.17063621005472
STAT,1837,17,40-44,1854,0.19546131769708927
SIM,1843,18,20-24,1861,2
STAT,1946,21,40-44,1967,3.7024478409057617
SIM,1821,49,45-49,1870,2
SIM,1887,9,na,1896,3966
STAT,1809,62,na,1871,2261.334900470604
STAT,1841,40,30-34,1881,1.3648473751250638
STAT,1807,51,35-39,1858,0.028037437679273892
STAT,1867,84,na,1951,314.60958176385407
STAT,1938,22,na,1960,3575.488944060225
SIM,1851,28,20-24,1879,38
SIM,1917,36,na,1953,2040
STAT,1850,20,50-100,1870,0.22929070714879224
STAT,1856,41,30-34,1897,0.8294896332152355
STAT,1817,97,na,1914,1.701869558999779
SIM,1907,42,na,1949,4469
STAT,1863,70,na,1933,1197.8217003896937
STAT,1843,28,20-24,1871,14.162616847895501
STAT,1858,52,20-24,1910,5.60522770123877E-4
STAT,1867,37,25-29,1904,2.7229433279181205
STAT,1900,25,15-19,1925,0.6327715162884824
STAT,1841,22,30-34,1863,25.127167306236053
STAT,1820,46,30-34,1866,0.1541450486968509
STAT,1852,54,na,1906,2107.751838539313
SIM,1875,37,25-29,1912,1
STAT,1848,31,30-34,1879,19.25230884773532
SIM,1851,45,50-100,1896,1
STAT,1865,26,35-39,1891,8.83961697570904
STAT,1830,42,25-29,1872,0.5676839235474533
STAT,1842,38,30-34,1880,1.5359912388072736
SIM,1900,32,na,1932,4130
STAT,1873,52,45-49,1925,0.014807289928953839
STAT,1852,34,25-29,1886,10.455455208225688
STAT,1813,49,45-49,1862,0.8336935518581212
SIM,1780,75,na,1855,615
STAT,1842,34,15-19,1876,0.04182824332865601
STAT,1912,24,na,1936,3582.1393753380103
STAT,1849,49,20-24,1898,0.009899990814569484
SIM,1884,27,25-29,1911,25
STAT,1851,85,na,1936,216.50933714457904
SIM,1927,23,25-29,1950,14
SIM,1840,35,35-39,1875,4
SIM,1817,70,na,1887,1947
STAT,1931,40,40-44,1971,0.3327198945231697
SIM,1913,39,na,1952,3084
STAT,1832,30,40-44,1862,0.7018628483785552
SIM,1854,22,30-34,1876,373
SIM,1900,63,na,1963,3727
STAT,1900,31,45-49,1931,2.425563507275809
STAT,1856,45,50-100,1901,0.17816173571277102
STAT,1859,65,na,1924,1339.451813672276
STAT,1837,42,30-34,1879,1.0877711169985618
STAT,1921,16,40-44,1937,1.5793177989525828
SIM,1866,39,20-24,1905,1
STAT,1915,36,15-19,1951,0.01921730437826168
STAT,1855,99,na,1954,1.2534302709592198
STAT,1878,25,30-34,1903,26.08465620879883
SIM,1868,23,20-24,1891,366
SIM,1878,42,20-24,1920,6
STAT,1846,48,40-44,1894,0.10012102729672688
STAT,1823,66,na,1889,1299.860496975286
SIM,1891,1,na,1892,2852
STAT,1878,48,40-44,1926,0.1739291768384792
SIM,1940,17,na,1957,4270
STAT,1886,37,50-100,1923,1.2713891415815353
STAT,1876,27,25-29,1903,42.762846126667874
STAT,1812,44,30-34,1856,0.3462862379229872
SIM,1871,33,na,1904,1880
STAT,1824,31,45-49,1855,0.8075133319837777
STAT,1897,45,35-39,1942,0.10592405847002805
STAT,1873,29,45-49,1902,1.1307861993814867
STAT,1854,51,50-100,1905,0.008437574071240314
SIM,1880,10,na,1890,3342
STAT,1937,31,40-44,1968,3.833861134461662
STAT,1903,32,25-29,1935,14.539491708834763
STAT,1881,20,30-34,1901,16.921353376950414
STAT,1881,21,20-24,1902,65.27383387028857
STAT,1907,61,na,1968,2994.9220587616696
STAT,1846,22,30-34,1868,13.016648099329137
SIM,1886,25,30-34,1911,15
STAT,1896,60,na,1956,2537.053740360415
STAT,1945,20,15-19,1965,5.773695525474762
SIM,1896,33,25-29,1929,9
SIM,1840,30,40-44,1870,21
SIM,1790,81,na,1871,1197
SIM,1866,50,na,1916,2840
STAT,1920,43,na,1963,4042.6542638464266
STAT,1825,49,35-39,1874,0.17320453636622493
STAT,1916,44,50-100,1960,0.11835323928125711
STAT,1855,34,25-29,1889,6.760482401999747
STAT,1911,31,20-24,1942,2.3580103280626847
SIM,1830,52,na,1882,157
SIM,1828,32,30-34,1860,146
STAT,1923,41,45-49,1964,0.19275342210295268
STAT,1840,20,20-24,1860,35.00806285310841
SIM,1845,24,30-34,1869,76
STAT,1878,21,15-19,1899,3.40451189934319
STAT,1880,29,40-44,1909,3.0876312630409024
STAT,1936,34,30-34,1970,15.131760182463173
STAT,1860,40,45-49,1900,1.2332671362972807
SIM,1893,76,na,1969,550
STAT,1837,47,40-44,1884,0.14249732308328947
SIM,1822,53,na,1875,1219
STAT,1851,32,15-19,1883,0.11706373822711345
STAT,1953,4,na,1957,4714.615524668228
STAT,1838,49,45-49,1887,0.10102280386919363
STAT,1873,36,35-39,1909,7.290178679839556
STAT,1921,49,20-24,1970,0.012238248959573102
STAT,1888,42,40-44,1930,2.592836389533115
STAT,1936,6,na,1942,3799.221243610095
STAT,1816,44,15-19,1860,0.04305369722282062
SIM,1857,39,30-34,1896,4
STAT,1943,16,na,1959,3859.6994789318433
SIM,1814,45,35-39,1859,1
SIM,1911,32,25-29,1943,1
STAT,1848,102,na,1950,0.2743456945634586
SIM,1857,14,na,1871,1495
SIM,1929,6,na,1935,6274
STAT,1891,13,na,1904,3170.863246682904
STAT,1912,18,40-44,1930,0.2788183176347714
STAT,1919,30,15-19,1949,0.13789993608429293
SIM,1885,57,na,1942,1103
STAT,1851,39,35-39,1890,5.529918826934555
STAT,1918,49,na,1967,3834.1516212666747
SIM,1869,3,na,1872,3989
SIM,1927,35,na,1962,1658
STAT,1811,44,50-100,1855,5.189935213630884
STAT,1869,28,40-44,1897,3.012129114261097
SIM,1926,6,na,1932,6370
STAT,1787,73,na,1860,228.7742952804126
STAT,1866,54,20-24,1920,6.55063437584947E-4
STAT,1924,40,45-49,1964,0.1966051532197014
STAT,1910,49,45-49,1959,0.19933333005354725
STAT,1953,15,25-29,1968,51.979761315042616
STAT,1841,33,35-39,1874,13.541204166031479
STAT,1852,52,25-29,1904,0.0035463672392541416
STAT,1817,54,25-29,1871,0.002302624798248055
STAT,1869,21,20-24,1890,69.74829148209272
STAT,1838,28,na,1866,1165.0837974682172
SIM,1880,32,35-39,1912,2
SIM,1831,23,25-29,1854,1
STAT,1860,18,30-34,1878,1.4907909213281731
STAT,1881,28,40-44,1909,2.818896509466716
SIM,1843,15,na,1858,761
STAT,1900,39,na,1939,3256.346938038836
SIM,1818,48,na,1866,699
STAT,1896,1,na,1897,3588.0423220347448
STAT,1874,49,30-34,1923,0.09781811830902694
STAT,1915,24,50-100,1939,0.666356891060923
SIM,1882,49,30-34,1931,1
STAT,1864,26,50-100,1890,0.583544005943819
STAT,1826,29,35-39,1855,30.468759491850275
STAT,1846,49,50-100,1895,0.14242218929689754
STAT,1835,51,na,1886,1693.4834543068373
STAT,1877,93,na,1970,122.768580792147
SIM,1855,44,na,1899,3000
STAT,1840,109,na,1949,2.8014055056822465E-4
STAT,1872,46,na,1918,2259.2960435778796
SIM,1878,41,30-34,1919,2
STAT,1912,46,50-100,1958,0.2153780885540102
STAT,1884,45,25-29,1929,0.055688600678680644
STAT,1942,18,30-34,1960,12.588235993817637
SIM,1889,56,na,1945,3496
STAT,1851,46,25-29,1897,0.04562121222862699
STAT,1857,32,50-100,1889,0.7074322202041242
STAT,1889,27,35-39,1916,11.619481001427722
STAT,1871,40,20-24,1911,0.16002147264018646
STAT,1889,19,na,1908,3025.0876864093093
STAT,1919,23,25-29,1942,99.49426657022866
STAT,1947,15,na,1962,4104.738754369734
SIM,1837,41,20-24,1878,2
STAT,1900,47,30-34,1947,0.07528845948709802
STAT,1887,41,30-34,1928,1.2711346760232918
SIM,1902,43,na,1945,3333
STAT,1811,52,15-19,1863,1.1065714250256138E-4
STAT,1852,26,25-29,1878,49.95346130340147
STAT,1930,42,na,1972,4852.273102505573
SIM,1830,36,40-44,1866,13
STAT,1848,80,na,1928,578.8666676300588
STAT,1884,32,na,1916,2284.3497010008873
STAT,1789,84,na,1873,186.4180659537268
STAT,1835,26,25-29,1861,42.01532242079599
STAT,1896,32,20-24,1928,3.563249423647308
STAT,1856,42,45-49,1898,1.073643667618352
STAT,1904,25,na,1929,3432.748004212541
STAT,1837,48,50-100,1885,0.2018214156154806
SIM,1924,28,30-34,1952,2
STAT,1812,82,na,1894,36.95079905391162
SIM,1878,49,40-44,1927,5
STAT,1849,39,30-34,1888,4.500686623765649
STAT,1856,35,50-100,1891,0.8902054564033963
STAT,1890,75,na,1965,1556.215013643733
STAT,1898,20,25-29,1918,77.43843671637325
STAT,1916,28,30-34,1944,39.8201563493265
SIM,1881,22,25-29,1903,27
STAT,1832,28,45-49,1860,1.3301196490189355
STAT,1873,51,30-34,1924,0.006135218888764142
SIM,1790,74,na,1864,1197
STAT,1866,46,na,1912,2059.5275907789583
SIM,1810,90,na,1900,258
STAT,1872,32,35-39,1904,10.140834701838703
STAT,1941,19,25-29,1960,44.09901315443679
SIM,1919,41,40-44,1960,4
STAT,1827,59,na,1886,1435.3480168518424
STAT,1856,13,na,1869,2018.247250567696
SIM,1881,36,35-39,1917,5
STAT,1904,18,50-100,1922,0.0698111123307766
SIM,1815,74,na,1889,482
STAT,1853,52,20-24,1905,5.691283741124246E-4
STAT,1953,15,na,1968,4415.002322657839
SIM,1854,58,na,1912,986
STAT,1816,101,na,1917,0.48173553407888914
SIM,1860,26,25-29,1886,18
STAT,1883,35,15-19,1918,0.05453617811507779
STAT,1878,43,30-34,1921,1.1743135677634615
STAT,1884,31,na,1915,2293.6849989465995
SIM,1911,11,na,1922,2607
STAT,1911,36,30-34,1947,1.7489132574833048
STAT,1887,49,40-44,1936,0.10407385322676377
STAT,1904,23,30-34,1927,25.369701128115118
STAT,1937,16,na,1953,3552.458903660221
SIM,1831,37,na,1868,2176
SIM,1882,3,na,1885,3334
STAT,1866,47,30-34,1913,0.08794890884595442
STAT,1927,25,25-29,1952,79.90515496720057
STAT,1872,15,35-39,1887,0.557814228082971
STAT,1893,4,na,1897,3289.7482056506333
STAT,1860,54,25-29,1914,0.002810085755972011
STAT,1931,27,na,1958,4802.453515272336
STAT,1897,19,40-44,1916,0.2416021129072035
STAT,1829,41,20-24,1870,0.07752993617928577
STAT,1842,52,45-49,1894,0.0035834478979150457
SIM,1904,24,35-39,1928,153
SIM,1855,43,na,1898,2982
STAT,1915,29,25-29,1944,65.71381494108508
STAT,1804,63,na,1867,1675.9502147857656
STAT,1872,47,na,1919,2242.3965091719147
SIM,1903,26,40-44,1929,87
STAT,1840,27,40-44,1867,1.470685569233524
SIM,1895,49,40-44,1944,3
SIM,1912,23,30-34,1935,1035
STAT,1888,47,35-39,1935,0.1608296106637123
SIM,1906,57,na,1963,3087
STAT,1845,29,50-100,1874,0.3808361027506091
SIM,1889,25,35-39,1914,17
STAT,1811,51,25-29,1862,0.016256713318181397
STAT,1840,25,50-100,1865,0.31861879548258043
STAT,1898,46,15-19,1944,3.0427409306524696E-4
STAT,1812,51,20-24,1863,1.852428216811926E-4
STAT,1825,52,na,1877,1469.1971942455882
STAT,1877,26,25-29,1903,43.08839538118059
STAT,1857,94,na,1951,15.336545045270764
STAT,1888,33,25-29,1921,11.771754800928433
STAT,1916,46,30-34,1962,0.09041199058547485
SIM,1866,43,na,1909,2961
STAT,1905,20,40-44,1925,3.015067959678482
STAT,1896,31,30-34,1927,23.109956863527785
STAT,1861,16,25-29,1877,5.4487910464496
STAT,1887,23,30-34,1910,19.54492147063324
SIM,1904,62,na,1966,3873
SIM,1838,47,na,1885,1870
STAT,1814,102,na,1916,0.1984163026139676
SIM,1895,23,30-34,1918,1
SIM,1863,31,20-24,1894,4
STAT,1846,26,50-100,1872,0.4616473378356839
SIM,1867,19,20-24,1886,25
STAT,1827,40,50-100,1867,1.0300381610788503
STAT,1916,22,45-49,1938,1.1629453883947876
STAT,1900,29,30-34,1929,34.63479531642377
STAT,1853,80,na,1933,479.6525722164599
SIM,1935,25,25-29,1960,124
STAT,1832,53,35-39,1885,6.7542355075389E-4
STAT,1852,19,35-39,1871,0.6601689034404892
STAT,1822,36,40-44,1858,9.218274987664598
STAT,1829,40,30-34,1869,0.5695542276332978
STAT,1957,0,na,1957,5176.560504133174
STAT,1890,29,45-49,1919,1.3345342014602757
SIM,1924,46,30-34,1970,1
STAT,1921,23,30-34,1944,31.978811079846412
SIM,1922,40,40-44,1962,1
STAT,1823,38,45-49,1861,3.650608026698585
STAT,1888,40,15-19,1928,0.0160996323478876
SIM,1887,21,na,1908,3883
STAT,1897,40,40-44,1937,0.20952726707645306
STAT,1903,44,50-100,1947,0.10273277281323015
STAT,1878,31,na,1909,2465.2355273371254
STAT,1846,40,30-34,1886,0.7070330600651088
SIM,1794,67,na,1861,745
STAT,1831,31,35-39,1862,10.930872507048853
STAT,1915,42,45-49,1957,0.16519013951310116
SIM,1810,68,na,1878,2853
STAT,1876,19,20-24,1895,17.825803241141383
STAT,1969,2,na,1971,4865.373349855789
STAT,1832,81,na,1913,459.04115000705457
STAT,1892,44,20-24,1936,0.013469769230716534
SIM,1939,20,na,1959,3937
STAT,1930,4,na,1934,5181.523918127021
STAT,1908,2,na,1910,3923.6450574820255
STAT,1832,35,35-39,1867,0.5029795624664026
STAT,1941,26,15-19,1967,0.722309692107787
STAT,1777,99,na,1876,0.9090632743547372
STAT,1843,21,50-100,1864,0.5093984762645833
STAT,1896,39,40-44,1935,5.71247151888374
STAT,1903,40,na,1943,3325.38036830979
SIM,1870,17,na,1887,2339
STAT,1825,53,20-24,1878,8.87342186900918E-4
SIM,1903,2,na,1905,3197
SIM,1862,29,na,1891,3695
STAT,1873,31,40-44,1904,4.466694867470195
STAT,1836,95,na,1931,10.175567182539066
STAT,1825,46,30-34,1871,0.12461471974067613
SIM,1858,1,na,1859,2651
SIM,1854,25,35-39,1879,2
STAT,1831,51,50-100,1882,0.012778638954614546
STAT,1938,21,30-34,1959,28.149953060955728
STAT,1904,16,40-44,1920,0.26195464464129714
STAT,1819,52,na,1871,580.6448374228861
STAT,1892,37,30-34,1929,6.598517374229076
SIM,1840,41,na,1881,2555
STAT,1875,39,20-24,1914,0.7835813170221999
STAT,1899,34,na,1933,3231.478669033444
SIM,1810,75,na,1885,2853
SIM,1933,38,na,1971,4296
SIM,1840,32,30-34,1872,13
SIM,1835,67,na,1902,1160
STAT,1873,22,25-29,1895,58.721381960515316
STAT,1855,25,50-100,1880,0.49197840224581
STAT,1859,19,20-24,1878,16.11927495413293
STAT,1897,43,45-49,1940,0.13702706968435438
STAT,1887,43,35-39,1930,1.9787163658272726
SIM,1888,40,40-44,1928,4
STAT,1851,14,na,1865,2271.5613506851346
SIM,1853,48,na,1901,3151
STAT,1852,31,20-24,1883,2.8465368917315232
STAT,1805,108,na,1913,2.4574942141828457E-4
SIM,1815,78,na,1893,387
STAT,1914,21,45-49,1935,1.09103794433006
STAT,1860,22,15-19,1882,2.7743643319633957
STAT,1906,21,na,1927,3435.098863170949
SIM,1886,8,na,1894,3155
STAT,1901,17,30-34,1918,2.2285724643793836
STAT,1879,52,40-44,1931,0.010742190060942871
SIM,1939,16,na,1955,4736
STAT,1855,31,20-24,1886,1.8405666879098754
STAT,1865,31,30-34,1896,16.00570927458977
STAT,1876,61,na,1937,1889.0187088449247
STAT,1835,19,35-39,1854,0.5552610090773991
STAT,1829,48,50-100,1877,0.11213445047030013
STAT,1883,50,40-44,1933,0.010273597953022604
STAT,1832,32,30-34,1864,1.140944355241949
STAT,1949,19,50-100,1968,0.43115072525009174
SIM,1906,36,na,1942,3447
STAT,1837,20,15-19,1857,3.5131069436969224
STAT,1920,32,25-29,1952,9.993673819927077
SIM,1848,62,na,1910,2307
STAT,1862,19,40-44,1881,0.16045687210039378
SIM,1867,28,na,1895,2316
STAT,1851,43,20-24,1894,0.1245232794998995
SIM,1863,14,na,1877,1563
STAT,1846,25,35-39,1871,7.0137086379191835
STAT,1906,29,20-24,1935,16.866562680597642
STAT,1802,67,na,1869,1090.6461287832562
STAT,1836,25,25-29,1861,42.55224438135824
STAT,1875,51,45-49,1926,0.014973405543738695
STAT,1910,46,40-44,1956,0.14581531309946977
STAT,1926,15,30-34,1941,14.884787021325932
STAT,1824,33,35-39,1857,4.296543435140228
STAT,1838,66,na,1904,698.992334037419
STAT,1924,44,15-19,1968,0.001803078259770984
STAT,1922,20,40-44,1942,3.8355914659523944
SIM,1822,33,25-29,1855,1
SIM,1827,63,na,1890,1305
STAT,1813,51,50-100,1864,0.05356717330581697
STAT,1834,32,15-19,1866,0.08039232992044819
SIM,1851,29,na,1880,1256
SIM,1860,31,20-24,1891,10
STAT,1843,81,na,1924,534.2995229458462
STAT,1869,27,na,1896,2408.19736499094
STAT,1921,19,45-49,1940,0.5596426007537493
STAT,1947,25,50-100,1972,1.1151790951642633
STAT,1842,50,40-44,1892,0.0026509868661336883
STAT,1830,38,40-44,1868,3.951605030498465
STAT,1832,50,30-34,1882,4.954660973190801E-4
STAT,1843,18,30-34,1861,2.00065068799035
SIM,1914,29,20-24,1943,110
STAT,1854,42,30-34,1896,0.6384488584225808
STAT,1902,47,45-49,1949,0.1865855159867416
SIM,1931,24,na,1955,5009
SIM,1814,42,30-34,1856,3
SIM,1942,3,na,1945,3672
STAT,1834,50,45-49,1884,0.006822957218835264
STAT,1919,20,20-24,1939,120.85967389958566
STAT,1883,46,na,1929,2170.5892668266592
STAT,1910,39,50-100,1949,0.3930586389342136
STAT,1849,54,20-24,1903,6.046667576935699E-4
STAT,1912,43,50-100,1955,0.1113174664068388
STAT,1873,33,30-34,1906,17.834242894884298
STAT,1911,39,35-39,1950,2.286630051445469
STAT,1817,66,na,1883,580.4458886225921
STAT,1868,27,15-19,1895,0.4382180613652433
STAT,1901,39,25-29,1940,0.8601747182797889
STAT,1868,32,45-49,1900,1.6843070368579875
STAT,1930,18,50-100,1948,0.4797100625413454
SIM,1906,29,25-29,1935,156
STAT,1814,52,na,1866,1926.0495350489466
STAT,1870,19,50-100,1889,0.04872776806239577
SIM,1880,47,na,1927,3256
STAT,1850,23,35-39,1873,3.2109799110292077
STAT,1840,23,25-29,1863,28.45927712605194
STAT,1849,101,na,1950,0.4808028044691363
SIM,1916,10,na,1926,4884
STAT,1828,52,30-34,1880,0.00686255501476355
STAT,1891,24,35-39,1915,7.131134236167526
STAT,1803,53,na,1856,840.8928625510645
STAT,1881,24,25-29,1905,53.72134189590744
STAT,1807,67,na,1874,876.2076159193407
STAT,1917,33,50-100,1950,0.8506204137461147
STAT,1913,47,20-24,1960,0.010651062488006367
STAT,1821,34,na,1855,1465.2880316655378
STAT,1849,27,50-100,1876,0.6389334694576743
STAT,1901,31,15-19,1932,0.19993028869866872
STAT,1914,37,50-100,1951,0.41337034325454514
STAT,1850,41,35-39,1891,0.839947821789935
SIM,1901,58,na,1959,2787
STAT,1808,48,20-24,1856,0.018614333191799205
STAT,1901,35,30-34,1936,1.6237018340163012
STAT,1903,28,40-44,1931,4.237268677872066
SIM,1945,23,na,1968,5219
STAT,1873,54,35-39,1927,0.008588150889135535
STAT,1847,32,25-29,1879,10.873021301293514
STAT,1895,43,30-34,1938,0.10310534201154364
STAT,1913,24,35-39,1937,9.330144899475693
STAT,1869,24,25-29,1893,57.40388745681547
STAT,1925,21,20-24,1946,132.27955000941583
STAT,1856,18,40-44,1874,0.15442242257844008
STAT,1851,36,30-34,1887,4.298743264053219
STAT,1893,32,20-24,1925,3.380250154342299
STAT,1895,25,30-34,1920,32.98068434584218
STAT,1810,45,25-29,1855,3.1061331552438033E-4
STAT,1852,36,15-19,1888,0.05742440291469541
SIM,1876,25,25-29,1901,2
STAT,1828,34,30-34,1862,24.75015814791765
STAT,1826,41,20-24,1867,0.2428522150287174
SIM,1883,39,20-24,1922,8
SIM,1885,0,na,1885,3539
STAT,1910,47,40-44,1957,0.14545369112298306
SIM,1947,0,na,1947,4477
STAT,1891,42,35-39,1933,2.224068196762143
STAT,1892,47,25-29,1939,0.04003960902667101
STAT,1821,52,25-29,1873,0.0036557527120257404
SIM,1831,30,na,1861,1930
STAT,1846,42,35-39,1888,1.08545759463111
STAT,1887,26,50-100,1913,0.7065085203651571
STAT,1870,76,na,1946,944.4980927576048
STAT,1832,25,40-44,1857,3.7460612261074417
STAT,1822,39,45-49,1861,3.745661899127663
STAT,1830,48,na,1878,1725.556765981388
STAT,1859,23,50-100,1882,0.3329352994044102
STAT,1918,39,40-44,1957,1.5532639542641589
STAT,1934,21,50-100,1955,0.878571809861941
STAT,1896,35,25-29,1931,3.8314859044624447
SIM,1869,94,na,1963,836
STAT,1859,39,40-44,1898,3.4346566703210075
STAT,1828,27,40-44,1855,6.267848026004505
STAT,1906,28,20-24,1934,16.928181260385447
STAT,1815,41,45-49,1856,0.16171409439884457
STAT,1829,51,na,1880,846.4645562796177
STAT,1874,16,35-39,1890,0.5676951844325365
STAT,1883,51,40-44,1934,0.010176512452366537
STAT,1829,44,25-29,1873,0.3000792350175692
STAT,1882,32,45-49,1914,1.6695532576659855
STAT,1813,67,na,1880,1374.868187457984
STAT,1836,29,40-44,1865,2.9277107929472947
STAT,1860,51,20-24,1911,6.04869144228378E-4
SIM,1824,82,na,1906,857
STAT,1844,99,na,1943,1.8762330305702497
STAT,1897,38,na,1935,3113.3409030202274
STAT,1921,26,35-39,1947,16.591030189295843
SIM,1886,21,15-19,1907,3
STAT,1805,104,na,1909,0.008948673520237052
STAT,1834,38,20-24,1872,0.41820669822400136
STAT,1912,17,na,1929,3860.1599701934374
STAT,1936,27,40-44,1963,4.4164310731275265
STAT,1887,44,35-39,1931,1.9662108783952446
SIM,1831,43,45-49,1874,7
STAT,1845,49,40-44,1894,0.08317861196874599
SIM,1879,57,na,1936,799
STAT,1824,51,35-39,1875,0.0014806109026983913
STAT,1895,18,40-44,1913,0.23731016887509046
STAT,1867,42,20-24,1909,0.15000934489099307
STAT,1893,37,15-19,1930,0.0702228416327433
STAT,1867,47,15-19,1914,3.76528091427647E-4
SIM,1965,4,na,1969,4974
STAT,1862,15,25-29,1877,5.593589562433091
STAT,1838,108,na,1946,7.811792740266997E-4
STAT,1890,34,45-49,1924,2.093009562621625
STAT,1830,52,na,1882,1617.3003726875056
STAT,1860,28,20-24,1888,9.603518252140859
STAT,1808,52,na,1860,732.2163557284906
STAT,1843,44,25-29,1887,0.6367424041148904
STAT,1839,41,30-34,1880,1.253038202164789
SIM,1846,66,na,1912,425
STAT,1842,33,na,1875,643.2138050617698
STAT,1929,32,45-49,1961,1.9847807608526629
STAT,1857,45,15-19,1902,3.1000441396617065E-4
STAT,1823,43,45-49,1866,2.4536761110845307
STAT,1907,40,45-49,1947,0.15317373179534163
SIM,1878,13,na,1891,4375
STAT,1838,51,40-44,1889,0.004559538296268756
STAT,1841,108,na,1949,0.0020397433367686495
STAT,1870,52,50-100,1922,0.014976278251084711
SIM,1896,37,40-44,1933,1
SIM,1851,44,25-29,1895,1
STAT,1908,16,25-29,1924,8.361471166791762
STAT,1949,19,15-19,1968,52.226735087013736
STAT,1822,50,50-100,1872,0.02532328261577184
STAT,1826,46,15-19,1872,5.800961912248798E-4
STAT,1894,15,25-29,1909,7.239624402627183
STAT,1850,99,na,1949,0.8745151808077501
STAT,1821,93,na,1914,14.759324146634313
SIM,1818,39,40-44,1857,1
SIM,1863,34,25-29,1897,11
STAT,1843,18,na,1861,2881.2762764956274
STAT,1846,43,35-39,1889,1.0716397194514558
STAT,1884,19,30-34,1903,1.5175848474358489
STAT,1861,53,50-100,1914,0.012358429452444107
STAT,1827,31,45-49,1858,1.8232376652157574
SIM,1915,40,45-49,1955,1
STAT,1848,26,35-39,1874,10.857138582908908
STAT,1831,96,na,1927,6.720347879979446
STAT,1833,48,30-34,1881,0.04366701131179321
STAT,1882,61,na,1943,1789.0508678175665
STAT,1939,15,40-44,1954,1.3881059034292453
STAT,1905,38,50-100,1943,0.37926082057188626
STAT,1854,24,30-34,1878,11.470282144756027
SIM,1907,43,na,1950,4403
STAT,1865,52,35-39,1917,0.007818151361240649
SIM,1891,10,na,1901,2716
SIM,1900,11,na,1911,4181
STAT,1812,54,50-100,1866,0.0035693260356850953
STAT,1888,44,30-34,1932,1.3089946131096912
SIM,1892,19,30-34,1911,156
SIM,1861,44,na,1905,2170
SIM,1866,28,na,1894,3189
STAT,1844,66,na,1910,1623.7491485426983
SIM,1850,44,na,1894,1284
STAT,1894,22,45-49,1916,0.8867549311845089
SIM,1925,24,na,1949,4905
STAT,1849,23,45-49,1872,0.7052741696461082
STAT,1864,44,45-49,1908,1.3422391820989636
SIM,1921,10,na,1931,5331
SIM,1904,25,na,1929,4169
STAT,1927,22,20-24,1949,135.8819276829081
STAT,1841,31,45-49,1872,2.3806471697564433
SIM,1873,34,35-39,1907,3
SIM,1935,22,20-24,1957,96
STAT,1854,17,40-44,1871,0.12165427429471987
STAT,1848,19,45-49,1867,0.07488612554939866
STAT,1875,33,15-19,1908,0.14561453914895983
SIM,1869,49,50-100,1918,1
STAT,1887,26,35-39,1913,10.656762966823765
SIM,1897,42,na,1939,2511
SIM,1926,39,40-44,1965,1
STAT,1846,50,25-29,1896,0.0021279418162238137
SIM,1845,29,na,1874,2521
STAT,1930,0,na,1930,5783.5438049793665
STAT,1916,42,15-19,1958,0.0015522660340050525
STAT,1861,62,na,1923,1520.0197290981303
STAT,1928,35,35-39,1963,3.0388054534354176
STAT,1909,47,30-34,1956,0.08108165054582418
STAT,1833,29,na,1862,1151.5057666529474
STAT,1942,21,50-100,1963,0.6822474431016987
SIM,1933,24,25-29,1957,1
STAT,1828,37,35-39,1865,9.506208487667765
SIM,1830,32,25-29,1862,15
SIM,1895,19,na,1914,4585
STAT,1814,48,50-100,1862,0.8283567763003393
STAT,1871,68,na,1939,1524.443726175072
SIM,1924,24,15-19,1948,41
STAT,1859,32,20-24,1891,2.142424406054495
SIM,1884,31,na,1915,3798
STAT,1900,60,na,1960,2753.769747344736
STAT,1901,23,50-100,1924,0.5684168907968037
STAT,1906,20,25-29,1926,83.3903353805367
STAT,1788,102,na,1890,0.035399331234852977
STAT,1880,32,30-34,1912,18.12588335217246
STAT,1777,115,na,1892,1.9300111381401495E-4
STAT,1852,47,50-100,1899,0.2460654517386593
STAT,1874,22,45-49,1896,0.7196822429759082
STAT,1853,43,na,1896,1779.1633921653417
STAT,1839,34,45-49,1873,1.9527739143438576
STAT,1886,39,35-39,1925,7.25064806345382
STAT,1898,17,na,1915,3396.2249791389945
STAT,1916,24,15-19,1940,5.467444636487284
SIM,1910,25,na,1935,4322
STAT,1829,104,na,1933,0.024356818862491962
STAT,1834,48,15-19,1882,1.8457526929217786E-4
STAT,1918,47,40-44,1965,0.1655147925669717
SIM,1844,45,30-34,1889,5
SIM,1886,32,na,1918,2512
STAT,1853,21,45-49,1874,0.6434743675371898
STAT,1920,28,40-44,1948,5.029534699037809
STAT,1836,45,30-34,1881,0.07964122880806218
STAT,1949,21,45-49,1970,1.3004178925085512
STAT,1819,48,35-39,1867,0.0255051278463058
STAT,1907,33,20-24,1940,2.255102159942845
STAT,1856,31,40-44,1887,3.185908766481819
STAT,1840,21,35-39,1861,2.943182688342781
STAT,1931,15,50-100,1946,0.4892032328029294
STAT,1951,21,15-19,1972,6.302703277970247
STAT,1868,48,30-34,1916,0.09232151489050598
STAT,1845,45,25-29,1890,0.02886705087652769
STAT,1847,24,25-29,1871,62.54084993618689
STAT,1904,34,35-39,1938,8.236683889974064
STAT,1908,18,30-34,1926,2.339905769442768
STAT,1813,41,30-34,1854,7.161805887896093
STAT,1922,23,45-49,1945,1.271979092877538
STAT,1925,24,25-29,1949,108.86804881132073
SIM,1864,22,25-29,1886,149
SIM,1872,46,na,1918,2324
STAT,1875,25,15-19,1900,0.4690461821078057
STAT,1895,28,35-39,1923,12.507842328456983
STAT,1894,38,30-34,1932,6.743787168839706
STAT,1864,21,20-24,1885,64.11657320480708
STAT,1869,35,50-100,1904,1.2506588967183931
STAT,1917,18,40-44,1935,0.2961958236746764
STAT,1812,57,na,1869,203.50702085238717
STAT,1872,33,35-39,1905,10.098040379396942
STAT,1825,54,50-100,1879,0.017804293722271845
STAT,1948,15,na,1963,4171.430394740841
SIM,1865,74,na,1939,1399
SIM,1903,36,35-39,1939,2
SIM,1920,33,30-34,1953,10
STAT,1871,32,20-24,1903,2.696419028307392
STAT,1855,44,na,1899,1509.015193723648
STAT,1856,22,25-29,1878,47.753391689251195
STAT,1923,33,na,1956,4287.479410296497
STAT,1921,31,30-34,1952,17.395982852937205
SIM,1855,24,25-29,1879,2
STAT,1848,32,45-49,1880,1.9029974924615674
STAT,1849,21,40-44,1870,2.138167472450912
STAT,1907,26,15-19,1933,0.664267748426709
STAT,1857,28,15-19,1885,0.35602908850436155
SIM,1879,84,na,1963,42
STAT,1827,47,30-34,1874,0.0886229057309998
STAT,1925,31,15-19,1956,0.15129019359652837
STAT,1851,42,45-49,1893,1.1805800190026476
STAT,1865,24,45-49,1889,0.6351671842690673
STAT,1822,51,na,1873,1419.1207610959123
STAT,1845,52,30-34,1897,0.0029380319586752674
SIM,1924,45,na,1969,5064
STAT,1845,38,35-39,1883,3.6495207675918855
STAT,1889,30,25-29,1919,12.433546016252913
STAT,1913,39,na,1952,3629.285207941142
STAT,1880,30,20-24,1910,2.828749043520114
SIM,1882,76,na,1958,873
SIM,1939,30,40-44,1969,65
STAT,1901,15,25-29,1916,7.960118612806641
STAT,1952,20,na,1972,4353.565356251786
STAT,1845,14,na,1859,1483.6517029100225
SIM,1894,61,na,1955,1169
STAT,1884,41,45-49,1925,1.4391749247375842
STAT,1817,50,45-49,1867,0.01021330750547172
STAT,1903,19,na,1922,3565.899928252443
STAT,1850,8,na,1858,1385.6369445802516
STAT,1913,41,35-39,1954,0.19502337794620134
SIM,1968,1,na,1969,3309
STAT,1843,22,15-19,1865,4.091444180188625
STAT,1903,5,na,1908,3720.0257636595375
STAT,1930,24,35-39,1954,11.902738724536569
STAT,1955,16,50-100,1971,0.49315247156070935
STAT,1831,28,50-100,1859,0.7286673924933618
SIM,1854,31,na,1885,1928
STAT,1866,50,40-44,1916,0.009747932860533206
STAT,1831,32,35-39,1863,10.769648894760808
STAT,1902,39,45-49,1941,0.5998003718835622
STAT,1851,36,50-100,1887,0.9902756183694014
SIM,1843,16,30-34,1859,8
STAT,1896,33,35-39,1929,13.29345224143585
STAT,1849,53,45-49,1902,0.012031707879313578
STAT,1932,1,na,1933,5491.289688371171
STAT,1830,31,20-24,1861,2.56549789497147
STAT,1930,39,20-24,1969,0.3407022345457588
STAT,1811,53,15-19,1864,1.084648503832652E-4
SIM,1929,31,25-29,1960,13
STAT,1844,105,na,1949,0.029047663161530363
STAT,1884,49,40-44,1933,0.1604632397936037
SIM,1892,49,40-44,1941,1
STAT,1875,49,15-19,1924,4.0216459478026464E-4
STAT,1920,26,30-34,1946,42.575225528536215
STAT,1911,38,na,1949,3575.039871599849
STAT,1946,23,30-34,1969,31.62743569560486
SIM,1945,3,na,1948,6372
STAT,1878,51,30-34,1929,0.006153697928406987
STAT,1917,39,na,1956,3832.089958626246
STAT,1798,82,na,1880,256.3416621161635
STAT,1932,18,20-24,1950,177.8061701522389
SIM,1853,79,na,1932,1079
SIM,1874,47,na,1921,2477
SIM,1947,18,na,1965,4369
STAT,1803,84,na,1887,83.84241262418031
STAT,1929,26,35-39,1955,18.66659527406541
STAT,1824,52,na,1876,464.8102645438425
STAT,1862,35,30-34,1897,4.582531462577765
SIM,1940,18,20-24,1958,6
STAT,1903,29,35-39,1932,13.598868809051794
STAT,1855,108,na,1963,0.006180748111911288
STAT,1819,99,na,1918,0.4404990088845133
STAT,1828,50,20-24,1878,8.851500047003524E-4
STAT,1879,32,20-24,1911,2.7729053588684263
SIM,1902,38,40-44,1940,2
STAT,1907,39,na,1946,3429.8531718894797
SIM,1847,79,na,1926,1382
STAT,1914,15,35-39,1929,0.8599097546466021
SIM,1884,47,na,1931,3654
STAT,1845,50,20-24,1895,3.714301426658523E-4
STAT,1950,16,15-19,1966,53.16554046428158
SIM,1888,23,25-29,1911,4
SIM,1838,32,25-29,1870,6
STAT,1886,46,25-29,1932,0.05981703609947486
STAT,1825,52,45-49,1877,0.017800628894249118
SIM,1865,64,na,1929,1523
STAT,1803,74,na,1877,345.15076388003973
STAT,1880,17,35-39,1897,0.5696448399556355
SIM,1851,40,45-49,1891,18
SIM,1885,19,na,1904,1854
STAT,1897,23,25-29,1920,75.7902278552644
STAT,1808,52,45-49,1860,0.018664403269360905
STAT,1849,43,15-19,1892,0.011551994041717906
STAT,1835,23,20-24,1858,68.81159932436753
STAT,1837,50,30-34,1887,0.004983804573768139
STAT,1874,11,na,1885,2710.4278837937527
STAT,1935,16,35-39,1951,5.709097125436536
STAT,1861,43,15-19,1904,0.011401883550746979
STAT,1829,42,35-39,1871,0.8711706101990223
STAT,1910,60,na,1970,3156.1669712434023
STAT,1922,37,20-24,1959,0.29660768111652824
STAT,1917,25,30-34,1942,40.81796214829199
STAT,1926,39,30-34,1965,2.2036246179803203
STAT,1889,43,50-100,1932,1.2630156596505762
STAT,1942,16,25-29,1958,44.78217147258494
SIM,1894,46,25-29,1940,1
SIM,1892,66,na,1958,3096
STAT,1889,30,40-44,1919,5.264360745423541
STAT,1913,39,20-24,1952,0.25429638966487955
STAT,1899,34,15-19,1933,0.1928446671427661
SIM,1842,42,45-49,1884,1
SIM,1826,41,50-100,1867,6
STAT,1848,23,30-34,1871,20.149618353878758
STAT,1907,19,25-29,1926,8.223964473914478
STAT,1835,85,na,1920,207.42521957906746
STAT,1878,72,na,1950,1299.3537111022338
STAT,1962,10,na,1972,4987.182947998623
STAT,1880,11,na,1891,2685.0440612292673
STAT,1895,41,20-24,1936,0.01441132965313935
STAT,1948,16,45-49,1964,0.5659918628944105
STAT,1938,31,25-29,1969,9.199319769674744
STAT,1903,36,40-44,1939,1.3476741767329519
STAT,1777,90,na,1867,75.28039332762576
STAT,1908,18,15-19,1926,8.712313071761967
SIM,1907,34,25-29,1941,54
STAT,1843,40,45-49,1883,1.5620544463911885
STAT,1912,33,30-34,1945,15.25820701242064
SIM,1880,33,35-39,1913,1
STAT,1787,102,na,1889,0.04123107935197198
STAT,1858,42,na,1900,1762.8382741042324
STAT,1854,43,25-29,1897,0.35447140907974867
SIM,1892,76,na,1968,2903
STAT,1933,23,20-24,1956,146.44478762491624
SIM,1931,29,20-24,1960,1
STAT,1854,27,35-39,1881,5.6242426040932525
SIM,1836,77,na,1913,570
STAT,1848,16,40-44,1864,0.21343034733570773
STAT,1937,34,45-49,1971,1.5387397094826865
STAT,1860,38,15-19,1898,0.04558323189699083
STAT,1912,26,40-44,1938,4.555490802241059
STAT,1870,33,15-19,1903,0.14137181101896001
SIM,1840,82,na,1922,1449
STAT,1834,102,na,1936,0.12920376158248864
STAT,1924,26,15-19,1950,0.8168634070376355
SIM,1813,42,35-39,1855,1
STAT,1881,22,35-39,1903,5.510722563529927
STAT,1844,47,30-34,1891,0.09545160048108897
STAT,1851,24,15-19,1875,3.0670074002119523
STAT,1858,33,15-19,1891,0.1082927244530722
SIM,1951,15,30-34,1966,34
STAT,1909,26,35-39,1935,14.372026445579019
STAT,1830,27,35-39,1857,9.278044839668345
STAT,1843,48,40-44,1891,0.16702784214073035
STAT,1904,49,20-24,1953,0.009468922410369777
STAT,1801,89,na,1890,34.85131033144491
STAT,1862,16,na,1878,2252.4700125473023
SIM,1902,36,30-34,1938,1
STAT,1919,24,na,1943,3920.9679564743333
STAT,1844,21,20-24,1865,85.85704969894259
STAT,1873,25,50-100,1898,0.6606351815199608
SIM,1857,45,na,1902,1416
SIM,1920,26,40-44,1946,27
STAT,1924,19,25-29,1943,50.8351723523666
STAT,1923,29,20-24,1952,20.58881865425553
STAT,1872,40,25-29,1912,0.6495185120015888
STAT,1869,51,20-24,1920,7.481838125936304E-4
STAT,1892,43,45-49,1935,1.83959545060361
SIM,1836,49,50-100,1885,3
STAT,1869,53,30-34,1922,0.005910167288904755
STAT,1878,62,na,1940,1880.4963335025611
SIM,1884,24,20-24,1908,3
STAT,1910,20,15-19,1930,4.972533747048364
SIM,1859,64,na,1923,1535
SIM,1888,30,15-19,1918,4
STAT,1830,41,30-34,1871,1.0294421412966135
STAT,1876,24,20-24,1900,69.22808364402198
STAT,1875,43,45-49,1918,1.525726591219021
STAT,1938,24,35-39,1962,9.212891658970628
STAT,1862,26,na,1888,2054.9477579640834
STAT,1933,16,15-19,1949,60.48795940854156
SIM,1842,24,15-19,1866,9
SIM,1862,27,35-39,1889,7
STAT,1834,66,na,1900,722.3204020945292
STAT,1838,31,20-24,1869,1.448784834199554
STAT,1820,42,15-19,1862,0.022799882440750253
STAT,1834,24,15-19,1858,1.9166748236807518
SIM,1941,16,15-19,1957,132
STAT,1943,15,30-34,1958,12.784559435409108
STAT,1851,4,na,1855,2559.4442
STAT,1798,88,na,1886,72.02386752070733
STAT,1893,79,na,1972,1361.50850842612
STAT,1947,21,25-29,1968,103.32900322679681
SIM,1926,40,na,1966,5889
STAT,1853,37,30-34,1890,4.132494377817236
STAT,1830,86,na,1916,160.587841698429
STAT,1864,11,na,1875,2478.370218767632
STAT,1839,31,40-44,1870,5.010021390558144
STAT,1933,23,na,1956,4809.463648138229
STAT,1907,36,25-29,1943,0.911119154276264
STAT,1858,48,na,1906,1696.5348019526573
STAT,1836,48,35-39,1884,0.11084049381699805
STAT,1860,52,na,1912,1747.1863913335753
STAT,1825,34,15-19,1859,0.22158808046974882
STAT,1860,32,45-49,1892,1.4225964883114988
STAT,1873,6,na,1879,2812.1699199444733
STAT,1818,76,na,1894,576.6431778574424
SIM,1875,64,na,1939,2443
STAT,1863,33,25-29,1896,8.707336571889794
STAT,1889,24,30-34,1913,21.315716216732053
STAT,1845,42,20-24,1887,0.08024933320664693
STAT,1910,8,na,1918,3894.9892068650133
SIM,1840,72,na,1912,1993
STAT,1903,43,30-34,1946,0.11250848309642465
SIM,1916,20,na,1936,4766
STAT,1806,98,na,1904,0.9781955545251675
SIM,1839,26,na,1865,996
STAT,1853,45,30-34,1898,0.07580591835690162
STAT,1817,48,15-19,1865,2.765355442543834E-4
STAT,1867,25,na,1892,2272.3190487707234
STAT,1946,20,na,1966,4022.6119786369513
STAT,1809,99,na,1908,1.8434448283334837
STAT,1873,20,50-100,1893,0.4207989267544229
STAT,1897,15,25-29,1912,7.560675250406867
STAT,1862,42,50-100,1904,0.8987155827960174
STAT,1892,25,15-19,1917,0.5655372513623889
STAT,1793,89,na,1882,34.251927112768875
STAT,1849,35,15-19,1884,0.04943213742444407
STAT,1859,35,25-29,1894,2.303703147665651
SIM,1827,45,30-34,1872,1
SIM,1861,13,na,1874,2632
STAT,1927,44,30-34,1971,0.15850220729336748
STAT,1911,34,25-29,1945,8.822571065170077
SIM,1837,25,na,1862,2277
STAT,1878,54,35-39,1932,0.00861401806414859
SIM,1914,55,na,1969,4713
STAT,1871,35,25-29,1906,2.899401717690895
SIM,1918,21,na,1939,4462
STAT,1892,34,50-100,1926,1.1246857041645204
STAT,1940,29,20-24,1969,18.386973402908396
STAT,1915,18,20-24,1933,27.90109177923421
STAT,1893,39,40-44,1932,5.419093764594693
STAT,1884,39,15-19,1923,0.05321418967146644
STAT,1946,26,35-39,1972,16.55088089062933
SIM,1906,26,na,1932,2905
SIM,1848,31,40-44,1879,2
STAT,1905,23,45-49,1928,0.9998727555734853
STAT,1862,19,50-100,1881,0.04297950886106129
STAT,1912,19,35-39,1931,0.8341546534872645
STAT,1868,42,na,1910,2229.610731064635
SIM,1814,52,na,1866,2442
STAT,1883,25,na,1908,2311.5148441123797
SIM,1937,23,30-34,1960,1
STAT,1852,16,30-34,1868,1.9519212139667212
STAT,1888,22,20-24,1910,79.53629908790005
STAT,1890,65,na,1955,2045.880902492453
STAT,1897,30,15-19,1927,0.19064499941214172
STAT,1922,41,50-100,1963,0.13353125585661446
SIM,1860,65,na,1925,1638
STAT,1857,22,45-49,1879,0.617739499472838
STAT,1827,54,50-100,1881,0.011690144370715225
STAT,1820,45,50-100,1865,0.39633733682592714
STAT,1847,70,na,1917,1268.5431794535866
STAT,1906,27,50-100,1933,0.9263202444781183
STAT,1920,18,30-34,1938,13.463898672903287
STAT,1866,53,45-49,1919,0.013034505077646776
STAT,1923,39,na,1962,4304.168287605268
STAT,1848,96,na,1944,8.035175617725773
SIM,1804,68,na,1872,592
STAT,1856,34,45-49,1890,1.2417830279906281
STAT,1836,21,45-49,1857,0.7102987320160471
STAT,1834,42,45-49,1876,0.7951652460059544
STAT,1883,18,15-19,1901,5.694335840943024
STAT,1866,21,40-44,1887,1.9315393258346145
STAT,1900,66,na,1966,2533.1337455667863
SIM,1903,33,30-34,1936,97
SIM,1861,9,na,1870,2691
SIM,1890,47,na,1937,3578
STAT,1849,7,na,1856,2567.1116114352
STAT,1865,32,45-49,1897,1.5920940860744917
STAT,1855,32,35-39,1887,6.82448871466882
STAT,1918,15,20-24,1933,29.342416600475687
SIM,1855,46,50-100,1901,1
SIM,1829,31,20-24,1860,1
STAT,1879,10,na,1889,2674.240286320887
SIM,1875,49,40-44,1924,8
STAT,1830,34,25-29,1864,9.42318661162864
STAT,1837,43,25-29,1880,0.5998493269777807
STAT,1866,77,na,1943,789.033328177391
STAT,1826,48,40-44,1874,0.24176807053914381
STAT,1865,21,40-44,1886,1.9395513188298374
STAT,1872,1,na,1873,3504.706843194287
STAT,1898,23,45-49,1921,0.9348025367687856
SIM,1941,26,25-29,1967,161
STAT,1881,82,na,1963,666.2808909943568
STAT,1849,44,na,1893,1921.1451789448522
STAT,1933,26,25-29,1959,86.84174520421612
SIM,1841,20,na,1861,1206
STAT,1929,23,30-34,1952,35.97941278887078
SIM,1856,23,30-34,1879,279
STAT,1914,56,na,1970,3458.964957704538
STAT,1867,49,40-44,1916,0.15852845051872308
STAT,1912,6,na,1918,3992.7512658857286
STAT,1843,43,na,1886,2321.3016967978306
STAT,1866,35,15-19,1901,0.05174574722183396
STAT,1887,83,na,1970,823.0628128868302
STAT,1921,38,na,1959,4146.8058380622515
STAT,1839,44,na,1883,2205.9010784176103
STAT,1822,42,35-39,1864,3.2284660830984198
STAT,1864,24,25-29,1888,52.12260195214948
STAT,1927,37,40-44,1964,1.8460454716492416
STAT,1845,105,na,1950,0.01454941574707625
STAT,1904,18,45-49,1922,0.0930814831077021
STAT,1917,49,30-34,1966,0.09133180813224892
SIM,1934,17,na,1951,5257
STAT,1930,20,50-100,1950,0.8420117860937681
SIM,1845,43,25-29,1888,4
SIM,1899,39,na,1938,1799
STAT,1850,19,15-19,1869,3.3093305203189325
STAT,1878,28,35-39,1906,9.892540846951642
STAT,1861,68,na,1929,1270.9147264073692
SIM,1836,36,na,1872,2089
SIM,1876,12,na,1888,4003
STAT,1889,17,40-44,1906,0.22025643819033122
STAT,1851,78,na,1929,617.0907679771004
STAT,1908,20,45-49,1928,1.032527476203912
SIM,1801,54,na,1855,1904
STAT,1909,39,30-34,1948,1.6903831114243741
STAT,1949,7,na,1956,4526.36063302592
SIM,1933,16,25-29,1949,235
STAT,1793,73,na,1866,446.5254876349377
STAT,1905,38,na,1943,3398.448957153795
STAT,1902,38,30-34,1940,1.6118323086569502
STAT,1852,23,20-24,1875,81.81247616401933
STAT,1826,47,na,1873,2036.6219213138274
STAT,1880,40,30-34,1920,1.2055763754700042
STAT,1867,27,30-34,1894,23.815279628611155
STAT,1926,30,50-100,1956,0.9922873368529224
STAT,1862,57,na,1919,1711.6851660080333
STAT,1796,87,na,1883,105.13492572494425
STAT,1840,53,50-100,1893,0.00585129511745051
STAT,1841,51,35-39,1892,0.009632616149194192
STAT,1874,8,na,1882,2775.4417086387743
STAT,1945,19,45-49,1964,0.5392995365010255
STAT,1875,82,na,1957,548.0014418726423
STAT,1839,42,45-49,1881,1.465502460555179
STAT,1843,45,50-100,1888,0.24780134101699747
STAT,1905,42,na,1947,3331.677365364447
STAT,1925,16,25-29,1941,51.997173544306435
STAT,1934,16,15-19,1950,61.11962777486203
STAT,1952,16,35-39,1968,4.984000000805276
STAT,1858,49,15-19,1907,2.9908757670666784E-4
STAT,1876,67,na,1943,1602.5094391163377
STAT,1923,23,na,1946,4191.329455708452
SIM,1865,33,na,1898,1768
SIM,1896,32,na,1928,3748
STAT,1886,43,20-24,1929,0.16327083699009065
SIM,1839,32,45-49,1871,11
STAT,1876,43,50-100,1919,1.0602608805519036
STAT,1842,17,15-19,1859,1.891807323742498
STAT,1898,55,na,1953,2780.4891580279595
SIM,1814,68,na,1882,2292
SIM,1887,35,25-29,1922,19
STAT,1908,56,na,1964,3173.916937808318
STAT,1845,35,30-34,1880,3.11757705767537
STAT,1938,16,35-39,1954,4.104987388705715
STAT,1910,29,25-29,1939,62.39899731410331
SIM,1846,8,na,1854,1528
SIM,1881,33,na,1914,3075
SIM,1910,35,na,1945,4202
STAT,1879,35,25-29,1914,2.9816458332680447
STAT,1943,23,30-34,1966,30.219655207072513
STAT,1819,52,20-24,1871,1.2960608231950784E-4
STAT,1830,70,na,1900,1015.5062814221767
STAT,1878,44,25-29,1922,0.6517774636842415
STAT,1956,15,40-44,1971,1.8356330531207463
STAT,1830,24,30-34,1854,41.835796865692906
STAT,1907,15,45-49,1922,0.09575469487040035
STAT,1911,37,45-49,1948,0.6510338050009853
STAT,1912,36,35-39,1948,2.3445427769843294
STAT,1895,10,na,1905,3369.6838088086647
STAT,1919,45,35-39,1964,0.13863430523185705
STAT,1847,41,40-44,1888,2.071318190663966
STAT,1929,24,na,1953,4556.925404244048
SIM,1902,28,30-34,1930,34
SIM,1922,20,na,1942,2900
STAT,1891,47,50-100,1938,0.16957095918260479
STAT,1884,23,15-19,1907,3.14830622095311
SIM,1880,30,30-34,1910,49
STAT,1936,19,50-100,1955,0.3532292639811589
STAT,1908,26,15-19,1934,0.6701067786612036
STAT,1919,29,45-49,1948,1.8287148778738325
STAT,1949,19,30-34,1968,14.026773113256338
STAT,1838,34,25-29,1872,5.32145042080094
STAT,1838,96,na,1934,3.661971103041876
STAT,1847,43,50-100,1890,0.9482562305489102
STAT,1845,15,50-100,1860,0.031091661906348548
STAT,1882,22,50-100,1904,0.39042272124552885
STAT,1877,25,na,1902,2439.0440715857917
STAT,1935,37,30-34,1972,2.5301971750059065
SIM,1890,31,na,1921,3743
STAT,1880,17,50-100,1897,0.05086113700125072
STAT,1872,30,30-34,1902,17.623990014304194
STAT,1909,49,40-44,1958,0.14256007512137328
STAT,1781,88,na,1869,48.718323664711384
STAT,1852,26,na,1878,2554.591432180011
STAT,1928,4,na,1932,5047.044887988889
STAT,1842,71,na,1913,331.3568706831842
STAT,1848,33,40-44,1881,4.2621510891276
STAT,1898,29,15-19,1927,0.6057409158347843
STAT,1909,23,30-34,1932,26.35886048391935
STAT,1874,42,na,1916,2382.4163971362113
STAT,1894,46,30-34,1940,0.06963384732325406
STAT,1912,29,45-49,1941,1.670687351443846
SIM,1872,50,na,1922,2251
SIM,1894,36,30-34,1930,16
STAT,1858,29,50-100,1887,0.49293028828195457
STAT,1892,40,40-44,1932,2.8129143254623696
STAT,1917,23,na,1940,3817.537966218329
STAT,1844,24,25-29,1868,69.79619468977465
STAT,1876,37,15-19,1913,0.05676709753859053
STAT,1819,45,30-34,1864,0.017573655423116424
STAT,1858,51,45-49,1909,0.01113563858491792
STAT,1896,32,50-100,1928,1.2078211197071722
STAT,1837,59,na,1896,1558.3348795934235
STAT,1787,89,na,1876,17.548741794614283
STAT,1837,53,35-39,1890,0.006792197431848031
STAT,1873,25,na,1898,2464.6552650738245
STAT,1809,46,15-19,1855,0.0035990123828504874
STAT,1886,36,30-34,1922,5.545608269909702
STAT,1822,32,25-29,1854,28.67249384477839
STAT,1906,22,50-100,1928,0.5905096231082797
STAT,1882,52,35-39,1934,0.008198523057307786
SIM,1902,61,na,1963,2613
SIM,1907,26,25-29,1933,239
SIM,1914,20,25-29,1934,30
STAT,1925,20,45-49,1945,1.3424625938759491
STAT,1912,16,30-34,1928,2.4420679944839523
STAT,1903,46,35-39,1949,0.1124194318640626
STAT,1862,38,35-39,1900,5.994416862279664
SIM,1837,25,35-39,1862,1
STAT,1813,46,na,1859,2286.644239539336
SIM,1854,65,na,1919,347
STAT,1896,16,35-39,1912,0.725100598288485
STAT,1857,31,40-44,1888,3.3833239483525217
STAT,1917,21,15-19,1938,5.598883023177802
STAT,1906,47,15-19,1953,3.2520962220503876E-4
STAT,1864,22,35-39,1886,5.390380755543441
STAT,1835,36,15-19,1871,0.0530758805789636
STAT,1882,24,45-49,1906,0.6634433929560649
SIM,1916,21,20-24,1937,1
STAT,1863,50,25-29,1913,0.00306731409200182
STAT,1801,53,20-24,1854,0.001871391329151591
STAT,1812,88,na,1900,10.87211611107574
SIM,1870,27,na,1897,1667
SIM,1862,5,na,1867,4008
STAT,1872,7,na,1879,2732.576620367086
STAT,1946,24,45-49,1970,1.2377287047302428
STAT,1951,18,40-44,1969,1.6495655258945827
STAT,1850,21,45-49,1871,0.3892719089478289
STAT,1885,10,na,1895,2546.1592857988753
STAT,1922,44,na,1966,4201.26133777558
STAT,1827,38,50-100,1865,1.1958723524404282
STAT,1909,48,45-49,1957,0.1971288580740679
STAT,1908,18,na,1926,3707.756852723247
STAT,1869,95,na,1964,40.91195144827316
SIM,1911,46,35-39,1957,1
STAT,1824,83,na,1907,76.82639938568978
STAT,1829,25,35-39,1854,9.651777707422694
STAT,1857,24,35-39,1881,4.636937967262196
SIM,1925,34,na,1959,4741
STAT,1877,22,45-49,1899,0.7078653175250846
STAT,1909,45,50-100,1954,0.20769735535654335
STAT,1873,18,40-44,1891,0.18712667058568613
STAT,1885,25,25-29,1910,41.862247958263026
SIM,1834,33,20-24,1867,3
STAT,1904,15,50-100,1919,0.07031970256063907
STAT,1882,77,na,1959,961.3410236352311
SIM,1815,49,50-100,1864,4
STAT,1863,30,20-24,1893,2.3261835791952405
STAT,1874,21,30-34,1895,18.43896218945795
SIM,1908,36,35-39,1944,2
SIM,1908,55,na,1963,1972
STAT,1835,31,20-24,1866,2.630979983169954
STAT,1899,38,30-34,1937,1.5634220263206362
STAT,1910,59,na,1969,3187.113846694809
STAT,1821,65,na,1886,860.3407274243151
STAT,1904,38,15-19,1942,0.017230574860896946
SIM,1850,65,na,1915,814
STAT,1800,70,na,1870,1164.4654316029582
STAT,1888,55,na,1943,2386.479944349127
STAT,1821,51,30-34,1872,0.0062668227726716385
STAT,1825,31,na,1856,1820.0650489293175
STAT,1838,44,50-100,1882,0.467800428657614
STAT,1893,15,na,1908,3173.0148361135666
STAT,1877,42,15-19,1919,0.01400137979124636
SIM,1882,12,na,1894,2283
STAT,1893,24,20-24,1917,85.63750773003085
STAT,1867,23,15-19,1890,3.110345444901377
STAT,1858,11,na,1869,2139.274536479368
STAT,1793,83,na,1876,121.90675437200724
STAT,1804,54,35-39,1858,0.052225693681426606
STAT,1889,34,40-44,1923,5.177670538656553
STAT,1838,32,35-39,1870,5.371832390493815
STAT,1932,37,15-19,1969,0.025622149895093795
STAT,1908,35,30-34,1943,1.709295833535292
STAT,1809,48,40-44,1857,1.472811030060173
STAT,1919,42,30-34,1961,0.13670409167744885
STAT,1837,24,50-100,1861,0.4219150021845045
STAT,1887,18,35-39,1905,0.6023670947860165
STAT,1898,20,40-44,1918,2.8188518604261414
STAT,1936,20,20-24,1956,105.32506407366427
STAT,1899,30,35-39,1929,13.943413651511866
STAT,1893,18,na,1911,3150.0658717964243
STAT,1894,62,na,1956,2348.083858865368
STAT,1841,23,45-49,1864,0.9766243763728114
STAT,1799,74,na,1873,92.22720469891902
STAT,1870,45,na,1915,2265.301967365611
STAT,1833,50,na,1883,949.7632627344282
STAT,1845,78,na,1923,387.71057981518106
STAT,1867,28,50-100,1895,0.6028468063123688
SIM,1893,25,25-29,1918,246
SIM,1946,8,na,1954,3798
STAT,1908,21,20-24,1929,101.74009357703723
STAT,1911,15,35-39,1926,0.8340865906544596
SIM,1869,30,na,1899,3420
STAT,1808,83,na,1891,92.97583673550439
SIM,1832,53,na,1885,1409
STAT,1844,35,na,1879,2515.6901333263404
SIM,1932,19,na,1951,6458
STAT,1876,32,20-24,1908,2.7325437956488576
SIM,1881,64,na,1945,1140
SIM,1845,13,na,1858,2914
STAT,1867,5,na,1872,2671.5571336022067
SIM,1920,16,30-34,1936,33
STAT,1855,78,na,1933,517.1144809241065
SIM,1942,16,15-19,1958,299
STAT,1793,80,na,1873,229.98480729812985
STAT,1863,97,na,1960,9.360796453354453
STAT,1920,24,25-29,1944,100.73395029470474
SIM,1826,34,25-29,1860,3
SIM,1826,46,na,1872,1920
STAT,1942,26,50-100,1968,1.0332063036113255
SIM,1851,20,na,1871,1410
STAT,1845,19,40-44,1864,0.11336489237184955
SIM,1866,40,40-44,1906,17
STAT,1843,26,30-34,1869,30.841764744708325
STAT,1945,17,na,1962,3976.3746803038134
SIM,1862,43,25-29,1905,2
STAT,1876,39,40-44,1915,4.380714553170056
STAT,1867,39,15-19,1906,0.052572558332224816
STAT,1826,40,45-49,1866,2.329495087195406
SIM,1887,58,na,1945,3006
STAT,1889,10,na,1899,3119.3353716550773
STAT,1867,51,50-100,1918,0.014351463559326347
STAT,1837,40,20-24,1877,0.15416267864648714
STAT,1839,33,30-34,1872,19.755888621859675
STAT,1821,44,25-29,1865,0.6971791349029044
SIM,1851,26,30-34,1877,217
SIM,1879,45,45-49,1924,1
STAT,1855,15,35-39,1870,0.4370710429214433
SIM,1884,39,40-44,1923,1
STAT,1939,26,45-49,1965,1.7184563938169488
STAT,1863,43,35-39,1906,1.5347466514995727
STAT,1833,22,40-44,1855,1.9473270240434148
SIM,1885,49,35-39,1934,3
SIM,1855,28,40-44,1883,21
STAT,1852,28,15-19,1880,0.528108157527591
STAT,1902,36,40-44,1938,1.3368978194651122
STAT,1839,26,40-44,1865,3.531407391200972
STAT,1893,31,45-49,1924,2.189609874218645
SIM,1907,28,30-34,1935,10
STAT,1930,28,15-19,1958,0.8909195853697016
SIM,1826,53,na,1879,1521
STAT,1897,21,35-39,1918,7.773218010241303
STAT,1916,16,15-19,1932,9.520724265176431
STAT,1934,25,30-34,1959,52.398896848136665
SIM,1847,83,na,1930,1018
SIM,1871,17,35-39,1888,5
STAT,1905,37,20-24,1942,0.23930915193543048
STAT,1931,39,20-24,1970,0.34592479879858
SIM,1891,42,50-100,1933,11
STAT,1866,18,15-19,1884,5.527533925607671
STAT,1856,26,40-44,1882,2.245647457718379
STAT,1898,32,40-44,1930,5.831655508828395
STAT,1863,17,35-39,1880,0.5345338074534582
STAT,1889,20,15-19,1909,3.99647105319093
STAT,1897,35,45-49,1932,2.672597076615243
STAT,1906,24,40-44,1930,2.998613855350787
STAT,1827,50,na,1877,1715.3533815474896
STAT,1836,41,15-19,1877,0.01275113666977584
STAT,1845,53,25-29,1898,0.0017293867829734405
STAT,1893,17,30-34,1910,1.9931780795396699
STAT,1910,15,50-100,1925,0.07374726664757082
SIM,1951,4,na,1955,2374
STAT,1878,41,20-24,1919,0.16413717864685132
STAT,1905,3,na,1908,3802.4039878566145
SIM,1906,20,na,1926,3557
SIM,1856,50,na,1906,330
SIM,1933,18,15-19,1951,65
SIM,1868,78,na,1946,328
STAT,1835,38,40-44,1873,4.0524662900769135
STAT,1948,17,20-24,1965,153.5672116125662
STAT,1865,23,30-34,1888,16.341955507843316
SIM,1869,21,15-19,1890,21
STAT,1821,37,35-39,1858,8.728478168413199
STAT,1846,23,50-100,1869,0.2958605761797532
STAT,1956,4,na,1960,5158.332161803091
STAT,1847,28,40-44,1875,3.231913624557657
STAT,1861,26,15-19,1887,0.3828083859353597
STAT,1831,65,na,1896,1322.6492338659727
STAT,1879,33,35-39,1912,10.3449072954337
STAT,1941,21,na,1962,3732.1747698382533
SIM,1829,32,35-39,1861,7
STAT,1920,29,35-39,1949,16.141526002343824
SIM,1867,38,na,1905,2190
STAT,1849,50,40-44,1899,0.008997984956577379
STAT,1813,52,35-39,1865,0.029922576745477027
SIM,1786,69,na,1855,297
STAT,1914,39,20-24,1953,0.2569260007596558
STAT,1926,26,35-39,1952,17.904692860670277
STAT,1859,37,50-100,1896,0.9730998510329617
STAT,1812,98,na,1910,0.2572668510070043
STAT,1880,43,35-39,1923,1.866324378395387
SIM,1890,5,na,1895,4061
STAT,1916,28,15-19,1944,0.7174401557284642
STAT,1868,44,15-19,1912,0.01315846709703358
STAT,1863,53,50-100,1916,0.012686385532847873
STAT,1925,28,40-44,1953,5.435661239444736
STAT,1849,75,na,1924,867.4163854767356
STAT,1911,17,25-29,1928,8.574093622123748
STAT,1882,16,40-44,1898,0.17554334571697153
SIM,1875,26,na,1901,2594
SIM,1907,15,na,1922,4865
STAT,1884,27,30-34,1911,24.105937535459745
STAT,1898,25,35-39,1923,13.063103300663581
SIM,1924,23,20-24,1947,4
STAT,1826,33,20-24,1859,5.026865758237714
STAT,1900,45,20-24,1945,0.00947048111783522
STAT,1930,41,35-39,1971,0.26346633544514225
STAT,1934,35,50-100,1969,0.576461410130132
STAT,1781,95,na,1876,2.7435135047987584
STAT,1837,27,35-39,1864,9.930156822367566
SIM,1887,33,35-39,1920,97
STAT,1918,44,50-100,1962,0.12281203216709789
STAT,1858,52,50-100,1910,0.01147203224099424
STAT,1863,63,na,1926,1523.282474978407
STAT,1909,45,25-29,1954,0.048710780065716844
STAT,1928,32,na,1960,4693.093085206316
STAT,1851,31,50-100,1882,0.7610452330629855
STAT,1931,27,20-24,1958,23.40099178222672
STAT,1935,15,20-24,1950,184.86120985464632
SIM,1895,40,na,1935,4508
STAT,1939,19,20-24,1958,134.12630293542338
STAT,1854,54,50-100,1908,0.008166472879855276
SIM,1879,23,na,1902,1670
STAT,1847,21,20-24,1868,76.93217209120958
SIM,1915,34,na,1949,3317
STAT,1831,54,45-49,1885,0.01157071815445826
SIM,1862,50,na,1912,3426
SIM,1918,30,20-24,1948,27
STAT,1854,53,35-39,1907,0.004709932074568368
STAT,1919,49,15-19,1968,3.919313389912829E-4
STAT,1867,34,20-24,1901,2.53447734876148
SIM,1825,36,30-34,1861,1
STAT,1826,38,15-19,1864,0.08946493053220578
STAT,1828,76,na,1904,641.32615954952
SIM,1871,43,35-39,1914,7
STAT,1877,49,35-39,1926,0.13914955753040797
STAT,1916,23,20-24,1939,114.57243398211287
STAT,1847,44,45-49,1891,1.3348729429853579
STAT,1942,18,15-19,1960,46.8705425797893
SIM,1838,21,20-24,1859,775
STAT,1852,30,45-49,1882,1.8555519906685642
STAT,1894,49,35-39,1943,0.09832818756266723
STAT,1893,29,15-19,1922,0.5633125646047956
STAT,1925,18,15-19,1943,54.178941208805895
STAT,1897,43,50-100,1940,0.09672499008824874
STAT,1934,18,40-44,1952,1.8741707099529465
STAT,1883,15,na,1898,2441.0311289481556
SIM,1864,27,na,1891,2042
STAT,1841,49,20-24,1890,0.013083776133895641
STAT,1892,30,na,1922,2978.2254970902372
STAT,1900,29,50-100,1929,0.8798230146392606
STAT,1842,20,40-44,1862,0.661931372351596
STAT,1880,50,25-29,1930,0.003729998733344885
STAT,1926,45,25-29,1971,0.06519597058748151
STAT,1874,36,50-100,1910,1.273210871140564
STAT,1846,17,35-39,1863,0.40823919576026746
STAT,1862,42,20-24,1904,0.13510103789766217
SIM,1808,99,na,1907,1
SIM,1855,44,45-49,1899,2
STAT,1861,21,20-24,1882,59.30319696302101
STAT,1843,38,15-19,1881,0.05833341448637397
STAT,1888,29,40-44,1917,3.4326606428828517
STAT,1911,24,15-19,1935,4.960369106410382
STAT,1852,38,40-44,1890,4.384486032094802
SIM,1844,65,na,1909,1600
STAT,1921,21,50-100,1942,0.7366021396639546
SIM,1878,21,25-29,1899,1
SIM,1967,2,na,1969,6509
SIM,1860,38,40-44,1898,55
SIM,1903,44,35-39,1947,1
STAT,1857,63,na,1920,1369.2062464919495
STAT,1865,16,40-44,1881,0.173098525959615
STAT,1920,24,40-44,1944,3.6668364605075374
SIM,1875,27,30-34,1902,13
STAT,1882,21,40-44,1903,2.0010832209114136
SIM,1897,11,na,1908,3016
STAT,1835,34,25-29,1869,9.663705201810648
STAT,1885,27,15-19,1912,0.44596662082266525
STAT,1917,36,35-39,1953,2.490667703830887
STAT,1934,21,15-19,1955,7.10764512352876
SIM,1834,22,15-19,1856,14
STAT,1816,48,50-100,1864,0.736352377960359
SIM,1870,35,30-34,1905,132
SIM,1944,1,na,1945,2732
STAT,1926,35,15-19,1961,0.023308109509202656
STAT,1869,54,25-29,1923,0.003475893413773436
STAT,1885,22,20-24,1907,67.73749172704001
SIM,1817,79,na,1896,1118
STAT,1839,22,25-29,1861,68.33636209781729
SIM,1908,33,30-34,1941,3
STAT,1836,64,na,1900,1330.4299802368137
STAT,1927,30,20-24,1957,2.979385239770198
SIM,1855,21,20-24,1876,60
STAT,1821,41,20-24,1862,0.18224878084657778
STAT,1921,34,35-39,1955,9.962995905999607
STAT,1865,33,40-44,1898,3.942674831086265
STAT,1867,56,na,1923,1928.943206206095
SIM,1851,33,20-24,1884,2
STAT,1834,53,50-100,1887,0.006690916734919024
SIM,1920,22,25-29,1942,12
STAT,1848,54,50-100,1902,0.013744126857173765
SIM,1843,34,25-29,1877,8
STAT,1857,34,45-49,1891,1.3266852425272897
SIM,1929,38,45-49,1967,10
STAT,1810,105,na,1915,9.128865976905163E-4
STAT,1901,45,na,1946,3177.714145543933
STAT,1949,22,20-24,1971,128.47080978251392
SIM,1847,45,na,1892,1424
SIM,1892,27,30-34,1919,2
STAT,1818,83,na,1901,241.62862500870767
STAT,1901,19,40-44,1920,0.25436636439880794
STAT,1818,36,15-19,1854,0.15912343870870374
STAT,1851,28,30-34,1879,23.1194454920452
STAT,1898,22,30-34,1920,23.952476270694547
SIM,1885,26,na,1911,1754
STAT,1923,47,15-19,1970,4.263958203798807E-4
STAT,1860,30,50-100,1890,0.7534741843762562
STAT,1799,67,na,1866,150.6935308977833
STAT,1894,58,na,1952,2514.828720409849
STAT,1923,29,50-100,1952,1.1226667745256451
STAT,1909,45,40-44,1954,0.14477926410019737
STAT,1812,51,na,1863,229.17017091509908
STAT,1881,28,50-100,1909,0.6019656736604403
STAT,1856,20,35-39,1876,4.9385286599847555
SIM,1869,26,na,1895,3655
STAT,1867,41,45-49,1908,1.4218220393499958
SIM,1848,31,na,1879,2599
SIM,1902,37,45-49,1939,5
STAT,1804,69,na,1873,1339.9881734239289
SIM,1859,30,na,1889,2031
STAT,1907,38,50-100,1945,0.3847391867525217
STAT,1880,45,na,1925,2358.9679663396055
SIM,1866,12,na,1878,3337
STAT,1949,1,na,1950,4716.76457039585
SIM,1934,28,25-29,1962,2
STAT,1935,35,40-44,1970,2.0818030994128973
SIM,1933,18,30-34,1951,799
STAT,1834,35,na,1869,1198.712113315587
STAT,1887,15,30-34,1902,1.762480234182597
SIM,1917,25,20-24,1942,6
SIM,1937,18,na,1955,2988
STAT,1911,35,50-100,1946,0.4047647315241649
STAT,1903,26,30-34,1929,35.868659902061744
SIM,1836,46,na,1882,1917
STAT,1943,26,35-39,1969,15.814178509503675
STAT,1804,51,30-34,1855,0.03836622176143082
STAT,1856,21,50-100,1877,0.3426324666720937
STAT,1861,78,na,1939,649.7898412004556
STAT,1939,23,40-44,1962,3.338544696733644
STAT,1871,42,30-34,1913,1.1454322679982445
STAT,1877,53,20-24,1930,7.37049749437424E-4
STAT,1853,49,na,1902,1708.0772564189197
SIM,1879,42,40-44,1921,1
STAT,1786,94,na,1880,8.09303641336033
STAT,1843,33,20-24,1876,3.1775788735917083
STAT,1925,18,30-34,1943,14.551086040247972
STAT,1854,40,20-24,1894,0.08919386102922662
STAT,1908,31,15-19,1939,0.12085169880236118
STAT,1932,17,45-49,1949,0.6568651813293028
SIM,1833,32,na,1865,2335
STAT,1908,24,25-29,1932,83.73361923914018
STAT,1876,35,25-29,1911,2.9382459074779614
STAT,1895,44,25-29,1939,0.0572264003017262
STAT,1841,20,40-44,1861,2.98222758371099
STAT,1885,44,15-19,1929,0.013391134742799354
STAT,1927,27,50-100,1954,1.2002026450118464
STAT,1908,28,40-44,1936,4.356735716894481
STAT,1865,37,50-100,1902,1.1209181771635794
STAT,1911,38,40-44,1949,1.422516031084938
STAT,1874,24,35-39,1898,5.984901012896703
STAT,1776,115,na,1891,2.2685940390851676E-4
STAT,1844,26,15-19,1870,0.5542163060357836
STAT,1835,24,na,1859,2119.6680709125726
SIM,1905,3,na,1908,3894
STAT,1862,31,15-19,1893,0.1217901439005766
STAT,1836,37,50-100,1873,1.1547693352519959
STAT,1872,52,40-44,1924,0.010485842540748438
STAT,1891,44,na,1935,2803.833643050275
STAT,1809,68,na,1877,1808.0262743178967
STAT,1849,34,na,1883,2075.214098027928
STAT,1886,29,na,1915,2453.7010755861334
STAT,1821,34,30-34,1855,23.256116812048877
STAT,1909,25,20-24,1934,17.532315517378983
SIM,1829,64,na,1893,1687
SIM,1889,77,na,1966,986
STAT,1924,18,na,1942,4329.691079066941
SIM,1884,35,25-29,1919,1
STAT,1885,26,50-100,1911,0.6309430487366378
STAT,1876,77,na,1953,873.8209637821866
STAT,1853,12,na,1865,2226.6768853861468
SIM,1826,31,20-24,1857,6
STAT,1885,48,30-34,1933,0.09395394132473296
STAT,1864,28,40-44,1892,2.713699603482881
STAT,1867,63,na,1930,1687.4701682396774
SIM,1851,13,na,1864,1456
STAT,1825,38,30-34,1863,7.4840312734630015
STAT,1883,31,35-39,1914,9.782489679487384
STAT,1865,20,50-100,1885,0.38230492193037086
SIM,1821,47,na,1868,1900
STAT,1913,28,15-19,1941,0.6921473555998308
STAT,1898,35,45-49,1933,2.706133748358914
STAT,1846,64,na,1910,1029.5616547369802
SIM,1842,46,na,1888,3042
STAT,1788,68,na,1856,281.22628668
SIM,1872,12,na,1884,2546
STAT,1858,47,25-29,1905,0.04378199329525007
SIM,1901,27,na,1928,3835
STAT,1863,40,30-34,1903,0.9913894534080812
STAT,1924,15,45-49,1939,0.5918929286142848
STAT,1927,40,15-19,1967,0.0019155890379725904
SIM,1921,41,na,1962,5173
SIM,1933,22,na,1955,4240
STAT,1930,21,30-34,1951,36.67130815025808
SIM,1903,56,na,1959,2024
STAT,1920,27,45-49,1947,1.870777745392977
STAT,1939,17,na,1956,3643.8565870338302
STAT,1832,39,50-100,1871,0.09969790114077187
SIM,1900,42,na,1942,4145
SIM,1850,72,na,1922,644
STAT,1888,62,na,1950,2109.500938208858
STAT,1892,29,30-34,1921,30.95472289846142
STAT,1828,53,25-29,1881,0.0036430264343251246
STAT,1898,14,na,1912,3461.500799450712
SIM,1854,27,na,1881,2110
STAT,1850,22,40-44,1872,1.1549105718166504
STAT,1880,54,40-44,1934,0.010628776935527499
STAT,1899,45,20-24,1944,0.009337729386605233
STAT,1819,68,na,1887,367.7582625933332
SIM,1921,0,na,1921,5527
STAT,1862,45,25-29,1907,0.04954939254291551
SIM,1925,16,15-19,1941,1
STAT,1906,27,45-49,1933,1.6077981821910978
STAT,1889,33,45-49,1922,2.0910924990342865
STAT,1859,37,na,1896,1867.3301119391515
STAT,1955,16,35-39,1971,5.523308704817556
SIM,1769,91,na,1860,178
STAT,1897,32,40-44,1929,5.759384758485645
SIM,1845,9,na,1854,3044
STAT,1877,46,30-34,1923,0.09854263852870673
STAT,1918,18,na,1936,3941.899805211882
STAT,1944,27,30-34,1971,41.87216710017853
STAT,1868,48,na,1916,2145.7511194442145
STAT,1869,16,25-29,1885,5.83172466164638
STAT,1873,63,na,1936,1830.302939658448
SIM,1883,40,40-44,1923,1
STAT,1875,40,40-44,1915,2.3329793426976786
STAT,1916,26,25-29,1942,67.35792062494109
SIM,1916,26,na,1942,4714
SIM,1890,41,na,1931,3529
STAT,1928,19,45-49,1947,0.6212998806052684
STAT,1844,43,15-19,1887,0.013833506161457846
STAT,1885,44,na,1929,2241.1661803738903
STAT,1917,16,15-19,1933,9.659407435686258
STAT,1926,28,25-29,1954,77.95132448894786
STAT,1830,49,45-49,1879,0.196582813641755
SIM,1858,49,40-44,1907,3
STAT,1858,37,30-34,1895,4.070008282029344
STAT,1888,25,25-29,1913,49.15399417972716
STAT,1870,37,30-34,1907,5.313232671895642
SIM,1906,18,20-24,1924,243
STAT,1842,23,45-49,1865,0.2167702818039273
STAT,1794,68,na,1862,8.905009392627102
SIM,1897,33,45-49,1930,11
STAT,1884,37,25-29,1921,2.7561759844521707
STAT,1913,30,na,1943,3745.5216326359077
STAT,1861,24,25-29,1885,48.20964027381482
SIM,1838,31,na,1869,2236
STAT,1813,42,25-29,1855,3.2149411667525545
STAT,1839,43,40-44,1882,2.1744419140684244
SIM,1926,37,30-34,1963,3
STAT,1852,64,na,1916,1749.8105931609032
STAT,1831,102,na,1933,0.22945341764202246
STAT,1857,21,30-34,1878,15.89356576637323
STAT,1904,31,30-34,1935,25.046566786642302
STAT,1826,28,20-24,1854,41.76840146284656
STAT,1837,49,na,1886,1825.267874284189
SIM,1924,26,25-29,1950,113
STAT,1938,32,na,1970,3762.1472712461637
STAT,1880,33,25-29,1913,10.588532315176169
STAT,1821,54,35-39,1875,0.008539784700319518
STAT,1912,22,25-29,1934,87.49472684024806
SIM,1829,34,25-29,1863,62
STAT,1903,39,45-49,1942,0.6046351939639714
STAT,1926,23,30-34,1949,34.51086423816284
STAT,1952,18,25-29,1970,51.440789138290015
STAT,1911,28,30-34,1939,37.64800523255971
STAT,1833,21,45-49,1854,0.7768205921906155
SIM,1896,25,25-29,1921,442
STAT,1856,29,45-49,1885,0.8145469135041846
STAT,1917,47,40-44,1964,0.16248135247007853
STAT,1842,30,35-39,1872,3.1006893062423537
STAT,1850,90,na,1940,36.40555106846547
SIM,1860,27,na,1887,2126
STAT,1947,25,40-44,1972,5.222182254468606
STAT,1893,19,20-24,1912,22.051128422201767
SIM,1915,41,na,1956,3104
SIM,1865,71,na,1936,1399
SIM,1837,20,25-29,1857,357
STAT,1843,49,na,1892,2176.52997379802
STAT,1918,37,30-34,1955,1.895122014685335
STAT,1836,52,20-24,1888,5.721319276163518E-4
STAT,1935,32,20-24,1967,3.3502820563094544
SIM,1912,31,30-34,1943,1
STAT,1882,30,na,1912,2303.043254920517
STAT,1900,48,25-29,1948,0.04444403408860913
SIM,1912,39,na,1951,4585
STAT,1911,38,35-39,1949,2.298420950923708
SIM,1837,30,20-24,1867,1
STAT,1861,39,40-44,1900,3.603879174456356
STAT,1859,31,15-19,1890,0.11333253444854335
STAT,1904,40,35-39,1944,0.1814664608015371
STAT,1870,29,35-39,1899,9.550585254888368
STAT,1883,40,na,1923,2245.9485292083646
STAT,1896,21,20-24,1917,91.11668361626198
SIM,1931,17,20-24,1948,693
STAT,1868,26,15-19,1894,0.439721910298464
STAT,1854,99,na,1953,1.0530235482057466
STAT,1902,43,35-39,1945,0.1757922953939565
STAT,1866,20,50-100,1886,0.38072567815021985
STAT,1879,35,na,1914,2439.808417484354
STAT,1866,29,15-19,1895,0.41118817480663344
STAT,1923,17,20-24,1940,157.52314622739178
STAT,1900,35,25-29,1935,4.02638924225429
STAT,1940,26,na,1966,3778.8938112674496
SIM,1885,27,25-29,1912,14
STAT,1877,27,25-29,1904,42.94103306897694
STAT,1908,17,25-29,1925,8.340985562433124
STAT,1932,40,40-44,1972,0.3375758005453969
SIM,1856,35,na,1891,736
SIM,1961,8,na,1969,4644
STAT,1928,40,20-24,1968,0.022404569578819308
STAT,1941,22,35-39,1963,9.619987923656172
STAT,1873,50,35-39,1923,0.008957902642953458
SIM,1852,45,na,1897,1949
STAT,1944,16,na,1960,3917.584426536293
STAT,1877,8,na,1885,2704.7824866650394
STAT,1859,47,30-34,1906,0.07636527907603631
STAT,1891,23,40-44,1914,2.55460144957194
STAT,1894,24,20-24,1918,87.0845623783409
STAT,1912,17,45-49,1929,0.09983952592690336
SIM,1890,62,na,1952,3139
SIM,1926,35,40-44,1961,9
SIM,1910,32,25-29,1942,6
STAT,1910,28,50-100,1938,0.9470601331777938
STAT,1920,0,na,1920,4989.5041038024765
STAT,1936,17,30-34,1953,11.55368778365075
STAT,1913,35,35-39,1948,2.3794029238054226
STAT,1921,34,50-100,1955,0.9014013223951873
STAT,1866,84,na,1950,303.66118761000956
SIM,1882,67,na,1949,1035
SIM,1839,45,50-100,1884,2
SIM,1907,52,na,1959,4381
SIM,1928,38,na,1966,4607
STAT,1930,32,30-34,1962,20.18983683915867
STAT,1868,34,20-24,1902,2.588452991955277
STAT,1860,52,20-24,1912,5.987841606374405E-4
STAT,1845,23,na,1868,1307.675455553381
STAT,1929,27,40-44,1956,5.792541279687073
STAT,1824,32,40-44,1856,1.9355136808603612
SIM,1864,30,na,1894,2379
STAT,1902,32,25-29,1934,14.42323010803224
SIM,1919,43,25-29,1962,1
SIM,1934,30,15-19,1964,1
STAT,1913,46,45-49,1959,0.20999166698209482
STAT,1864,21,50-100,1885,0.3794104976633349
STAT,1902,45,30-34,1947,0.07765671395330576
SIM,1891,29,20-24,1920,35
SIM,1898,42,na,1940,4193
STAT,1937,33,25-29,1970,9.044080771179829
STAT,1829,76,na,1905,345.96289387507846
STAT,1930,30,35-39,1960,11.723846717687252
STAT,1918,35,40-44,1953,1.5713607110434422
STAT,1833,81,na,1914,222.49063355449385
STAT,1876,20,35-39,1896,5.9343312643129
STAT,1822,35,40-44,1857,9.645240050670834
SIM,1872,8,na,1880,2546
STAT,1895,25,50-100,1920,0.8378038576790673
STAT,1885,21,45-49,1906,0.6875011716265766
SIM,1924,24,na,1948,5234
STAT,1904,42,30-34,1946,0.11391997102480626
STAT,1918,24,30-34,1942,30.388669776727102
STAT,1924,46,20-24,1970,0.013062544034026286
STAT,1851,44,50-100,1895,0.8231153205326851
STAT,1827,33,20-24,1860,2.7438236835794667
SIM,1835,20,15-19,1855,7
STAT,1877,15,30-34,1892,1.625486626523034
STAT,1900,48,30-34,1948,0.07469066911877047
STAT,1807,103,na,1910,0.058188602398894285
STAT,1829,30,20-24,1859,1.570565650818796
SIM,1878,22,na,1900,3092
STAT,1863,20,25-29,1883,50.568795386946405
SIM,1924,27,30-34,1951,26
STAT,1862,94,na,1956,19.534612209911792
STAT,1863,33,30-34,1896,14.842673891653682
SIM,1920,34,na,1954,3797
STAT,1907,49,25-29,1956,0.04666747289587503
STAT,1872,29,45-49,1901,1.1038663495377015
STAT,1915,43,45-49,1958,0.16492913909267046
SIM,1869,31,25-29,1900,96
STAT,1887,30,na,1917,2647.661165293992
STAT,1811,49,25-29,1860,0.2621845123413012
STAT,1837,71,na,1908,1070.287998747917
STAT,1932,40,50-100,1972,0.15855440461661005
STAT,1846,36,35-39,1882,4.4201682752517915
SIM,1887,24,25-29,1911,10
STAT,1880,48,35-39,1928,0.14351540097916915
STAT,1820,38,40-44,1858,7.7553633070254495
STAT,1917,40,45-49,1957,0.17184090274531305
SIM,1903,62,na,1965,1891
STAT,1907,38,15-19,1945,0.01759722074503948
STAT,1865,30,30-34,1895,16.068698572995913
STAT,1915,32,35-39,1947,9.175603448103086
STAT,1821,108,na,1929,9.250517774242262E-4
SIM,1916,29,na,1945,4699
STAT,1806,49,50-100,1855,0.7002548967806534
STAT,1909,46,25-29,1955,0.04836688195845289
STAT,1830,54,30-34,1884,0.004301865773057785
STAT,1916,27,30-34,1943,39.960818430200796
STAT,1926,43,20-24,1969,0.021550829582925833
STAT,1849,13,na,1862,2464.7149909795958
STAT,1879,24,25-29,1903,58.35720163599521
SIM,1882,36,50-100,1918,3
STAT,1828,51,na,1879,1593.0674138268373
SIM,1837,36,35-39,1873,3
STAT,1891,75,na,1966,1600.568302253666
STAT,1890,10,na,1900,3135.8674859527737
SIM,1916,19,20-24,1935,85
STAT,1878,47,40-44,1925,0.1753212273839074
STAT,1830,41,25-29,1871,0.5750037209146972
STAT,1895,47,40-44,1942,0.12504095287361572
STAT,1896,27,35-39,1923,12.71949371783313
STAT,1891,51,na,1942,2660.5538991968924
STAT,1925,37,na,1962,4474.157318990961
SIM,1823,48,na,1871,1228
STAT,1922,36,15-19,1958,0.021626865233978734
STAT,1806,48,na,1854,1090.9240489458928
STAT,1895,65,na,1960,2322.4411286622385
STAT,1914,16,40-44,1930,0.28601173368689575
STAT,1924,33,15-19,1957,0.14839108374442717
STAT,1807,89,na,1896,42.59427050111654
STAT,1850,53,na,1903,978.2865316756031
STAT,1942,17,30-34,1959,12.592265518783654
STAT,1946,22,40-44,1968,3.7012260331182634
STAT,1810,53,na,1863,82.87602136934437
STAT,1835,46,30-34,1881,0.07819673219442416
STAT,1917,43,25-29,1960,0.07341077866071838
STAT,1944,28,45-49,1972,1.8453128142447277
STAT,1844,20,15-19,1864,4.139929592494341
SIM,1919,3,na,1922,5272
STAT,1929,27,na,1956,4655.552159490441
STAT,1842,37,50-100,1879,0.3575303474592932
STAT,1808,105,na,1913,0.006867010647532391
STAT,1873,78,na,1951,801.4751683077741
SIM,1852,39,35-39,1891,215
SIM,1874,32,na,1906,2491
STAT,1828,35,na,1863,1912.2733788028197
STAT,1858,73,na,1931,907.0443012163746
STAT,1903,24,40-44,1927,2.939472482890578
STAT,1914,4,na,1918,4103.617352532643
STAT,1875,17,50-100,1892,0.05030741961663976
STAT,1944,17,35-39,1961,4.464880965930651
STAT,1899,71,na,1970,2207.4864881166927
STAT,1952,20,15-19,1972,6.346142974581169
STAT,1853,109,na,1962,0.002234014252811467
STAT,1891,46,15-19,1937,2.7825531840724766E-4
STAT,1885,37,30-34,1922,5.238705067105161
STAT,1927,17,35-39,1944,5.174905143377216
STAT,1892,20,50-100,1912,0.507895207829575
SIM,1879,63,na,1942,798
STAT,1844,39,35-39,1883,7.2523533690396995
SIM,1957,11,na,1968,6080
STAT,1848,30,30-34,1878,19.4532610342188
STAT,1838,23,25-29,1861,31.47692011598225
STAT,1851,18,15-19,1869,5.665047185176854
STAT,1818,46,30-34,1864,0.17529236314084054
SIM,1832,25,na,1857,2404
SIM,1836,39,na,1875,1917
SIM,1912,42,30-34,1954,1
STAT,1924,39,50-100,1963,0.48928429488871644
STAT,1882,15,na,1897,2429.2757927227685
STAT,1920,25,25-29,1945,71.75828253678908
STAT,1927,28,45-49,1955,2.075838411167977
STAT,1841,17,na,1858,3296.7290190617823
STAT,1901,26,50-100,1927,0.8974970530338441
SIM,1856,30,30-34,1886,1
SIM,1910,0,na,1910,4577
STAT,1796,72,na,1868,986.941037431096
STAT,1878,93,na,1971,130.62189620538257
STAT,1900,32,45-49,1932,2.415691463801196
SIM,1846,23,25-29,1869,54
STAT,1866,6,na,1872,2568.6008086881957
SIM,1783,74,na,1857,1461
STAT,1953,18,45-49,1971,0.5986810431013518
SIM,1873,33,40-44,1906,5
STAT,1903,25,25-29,1928,60.45472218915189
SIM,1936,33,na,1969,3772
SIM,1863,23,25-29,1886,4
STAT,1874,23,35-39,1897,6.003993712903736
STAT,1840,15,35-39,1855,0.28305927374097756
STAT,1869,33,na,1902,2397.8215603811536
STAT,1858,15,20-24,1873,16.002896902051262
SIM,1838,65,na,1903,1202
STAT,1933,28,15-19,1961,0.9305523495053841
STAT,1949,15,15-19,1964,52.28945435312743
STAT,1821,51,25-29,1872,0.003729018473418588
SIM,1928,14,na,1942,4638
STAT,1861,20,45-49,1881,0.6044254227421069
STAT,1820,71,na,1891,917.9585261389967
STAT,1839,40,30-34,1879,1.2691950552177103
STAT,1915,19,na,1934,3963.8581515104106
SIM,1931,18,na,1949,5085
STAT,1821,96,na,1917,4.33640905535502
SIM,1911,25,25-29,1936,8
STAT,1908,19,20-24,1927,25.955083431659354
SIM,1878,37,35-39,1915,24
STAT,1845,82,na,1927,231.52613916918637
STAT,1933,39,25-29,1972,1.329166673848701
SIM,1897,31,30-34,1928,78
STAT,1900,21,35-39,1921,8.108211193015345
STAT,1849,96,na,1945,7.235047901031002
STAT,1939,20,50-100,1959,0.6540024605469181
STAT,1804,51,25-29,1855,0.022829487109088536
STAT,1840,38,50-100,1878,0.5658721760879426
STAT,1889,31,30-34,1920,21.11135165254996
STAT,1848,49,20-24,1897,0.010994835956456105
STAT,1844,20,45-49,1864,0.8750655313242642
STAT,1875,45,na,1920,2333.2862445041183
SIM,1861,6,na,1867,2725
STAT,1927,44,na,1971,4604.500392893793
SIM,1894,52,na,1946,1272
STAT,1847,30,na,1877,2348.9218118599397
STAT,1884,19,50-100,1903,0.0466470657447326
SIM,1862,47,na,1909,3497
SIM,1914,46,na,1960,4828
STAT,1876,47,30-34,1923,0.09739968838690911
STAT,1923,40,45-49,1963,0.19301012556996072
SIM,1907,36,na,1943,4592
STAT,1855,23,25-29,1878,43.9438912206648
STAT,1895,40,15-19,1935,0.0181460988560467
STAT,1837,46,40-44,1883,0.14433470386347147
STAT,1871,42,25-29,1913,0.6397909991572616
STAT,1935,7,na,1942,5425.267274616981
STAT,1853,23,20-24,1876,62.681178367771636
SIM,1903,22,na,1925,2915
STAT,1816,66,na,1882,1589.0154837986304
SIM,1835,36,25-29,1871,8
SIM,1815,53,na,1868,1687
SIM,1935,23,15-19,1958,41
STAT,1871,52,50-100,1923,0.014985449347090663
STAT,1850,45,15-19,1895,1.865459330062827E-4
STAT,1836,46,na,1882,1825.188318814121
SIM,1897,34,35-39,1931,1
STAT,1839,35,na,1874,2427.8300969992088
STAT,1838,23,50-100,1861,0.22422655224405144
STAT,1856,107,na,1963,0.016976605235007845
SIM,1862,42,25-29,1904,2
STAT,1840,51,na,1891,851.8761655864457
STAT,1810,47,50-100,1857,0.0012896804870396823
STAT,1894,27,25-29,1921,53.792962985113306
STAT,1940,19,50-100,1959,0.37588272957705854
STAT,1924,38,15-19,1962,0.02240400277012778
SIM,1899,24,na,1923,2095
STAT,1817,51,na,1868,867.5842372162775
STAT,1911,35,30-34,1946,1.7570660439271268
STAT,1907,37,30-34,1944,1.6784611951046045
STAT,1899,7,na,1906,3558.57079437348
SIM,1915,31,na,1946,3365
STAT,1921,40,35-39,1961,0.22473683464165872
SIM,1885,16,na,1901,1861
STAT,1906,17,20-24,1923,25.672179062807047
SIM,1892,45,na,1937,3563
SIM,1896,59,na,1955,2543
STAT,1815,42,40-44,1857,0.23896863125106957
STAT,1896,24,25-29,1920,74.99039389501084
STAT,1917,40,15-19,1957,0.001585613977484679
STAT,1790,105,na,1895,0.008525586748691218
STAT,1888,16,45-49,1904,0.07557803030986385
STAT,1853,29,35-39,1882,7.774281678829645
STAT,1878,44,30-34,1922,1.166891906015197
STAT,1832,56,na,1888,1746.56034742184
STAT,1909,19,50-100,1928,0.07233356719967704
STAT,1835,49,40-44,1884,0.13308368811350402
SIM,1919,21,na,1940,5200
STAT,1829,33,25-29,1862,5.51019405202572
STAT,1835,30,45-49,1865,1.71503842418516
SIM,1882,27,na,1909,1606
STAT,1915,43,15-19,1958,0.0015218376071234056
STAT,1827,36,25-29,1863,2.87412951192143
SIM,1920,18,na,1938,4258
STAT,1833,22,35-39,1855,5.4532775890173
STAT,1902,40,30-34,1942,0.11355530730344456
STAT,1851,7,na,1858,2376.7237260375096
STAT,1874,20,30-34,1894,18.493147110491687
STAT,1846,39,45-49,1885,1.2076039579768483
STAT,1930,35,35-39,1965,3.1382082890570238
SIM,1861,29,35-39,1890,75
SIM,1886,73,na,1959,1682
STAT,1915,37,50-100,1952,0.41814753482388156
STAT,1954,18,na,1972,4508.611772875492
STAT,1776,100,na,1876,0.40543544991929276
SIM,1907,27,30-34,1934,32
STAT,1919,17,30-34,1936,13.29073846422689
SIM,1895,37,35-39,1932,3
SIM,1921,30,35-39,1951,1
SIM,1903,46,na,1949,2571
STAT,1862,52,25-29,1914,0.003000817296624077
SIM,1862,40,50-100,1902,2
SIM,1790,68,na,1858,1197
STAT,1887,37,35-39,1924,7.784975027580283
SIM,1906,11,na,1917,3664
STAT,1846,20,25-29,1866,42.44052421376446
STAT,1901,28,25-29,1929,58.938293469067816
SIM,1824,73,na,1897,1465
STAT,1894,16,15-19,1910,7.5652570373848445
SIM,1915,37,30-34,1952,10
STAT,1813,54,30-34,1867,0.0198677133790226
STAT,1852,17,na,1869,2794.540205293997
STAT,1859,20,35-39,1879,5.349910100393505
STAT,1904,35,na,1939,3424.7543348505424
STAT,1908,49,na,1957,3277.4417800466845
STAT,1785,69,na,1854,296.99999999999994
STAT,1781,79,na,1860,291.05823101535776
SIM,1902,21,na,1923,3600
STAT,1878,10,na,1888,2690.3553637461773
SIM,1850,39,30-34,1889,16
SIM,1860,40,na,1900,2000
STAT,1868,37,25-29,1905,2.780932647718695
STAT,1842,39,30-34,1881,1.3833132556582777
STAT,1833,97,na,1930,2.2103403196374205
SIM,1846,76,na,1922,319
SIM,1849,65,na,1914,586
STAT,1938,28,20-24,1966,17.88202894392684
STAT,1808,53,50-100,1861,0.018996825247001702
STAT,1832,101,na,1933,0.4843877646553908
STAT,1880,45,30-34,1925,0.1014952266631267
STAT,1933,27,30-34,1960,51.673348040619004
SIM,1941,1,na,1942,4031
STAT,1902,48,35-39,1950,0.1098074737911027
STAT,1823,47,50-100,1870,0.3831936541349629
STAT,1822,32,30-34,1854,48.87562026399633
STAT,1842,28,20-24,1870,3.5755962921227997
STAT,1913,30,35-39,1943,9.050102822309062
STAT,1917,41,50-100,1958,0.12113813213144788
STAT,1933,32,na,1965,5062.212129511625
SIM,1902,38,35-39,1940,14
SIM,1830,32,30-34,1862,1
SIM,1875,73,na,1948,2443
STAT,1946,1,na,1947,4522.855104428392
STAT,1890,16,50-100,1906,0.0594555906142594
STAT,1831,31,na,1862,2217.266326091157
STAT,1836,101,na,1937,0.43671933734734114
STAT,1937,30,20-24,1967,2.3909459458660285
STAT,1862,52,30-34,1914,0.005043040227652892
SIM,1837,33,25-29,1870,2
STAT,1835,45,na,1880,1840.817648966502
STAT,1918,38,45-49,1956,0.7081395593058452
STAT,1841,32,40-44,1873,5.859280265730717
STAT,1811,94,na,1905,12.108182748844495
STAT,1899,16,20-24,1915,24.27429321398649
SIM,1835,39,35-39,1874,3
STAT,1827,39,35-39,1866,6.80533093435067
SIM,1928,37,40-44,1965,5
STAT,1891,20,30-34,1911,22.0349700370869
STAT,1852,42,15-19,1894,0.013883693596062575
SIM,1885,24,20-24,1909,2
STAT,1834,46,50-100,1880,0.12776994947393494
STAT,1859,31,45-49,1890,1.3877888972914443
STAT,1918,27,35-39,1945,15.76224792602246
STAT,1877,24,20-24,1901,69.51654761833058
STAT,1904,45,35-39,1949,0.11395132009443998
STAT,1857,48,na,1905,1704.7482271592144
STAT,1953,17,30-34,1970,14.61249642044709
SIM,1854,36,35-39,1890,3
SIM,1817,40,45-49,1857,15
SIM,1830,42,na,1872,465
SIM,1866,37,na,1903,3108
STAT,1848,33,35-39,1881,9.952941454977182
STAT,1903,16,35-39,1919,0.7808117710404939
STAT,1921,43,45-49,1964,0.184938491116591
STAT,1806,88,na,1894,41.338616329727586
SIM,1863,48,na,1911,505
STAT,1816,49,30-34,1865,0.28607848878587894
SIM,1837,33,30-34,1870,19
STAT,1812,51,50-100,1863,0.0037913029336341373
STAT,1903,27,45-49,1930,1.5760877333901837
STAT,1905,21,40-44,1926,3.006233810556624
STAT,1944,25,40-44,1969,4.98532475782777
STAT,1912,19,40-44,1931,0.27805156726127556
STAT,1847,15,45-49,1862,0.07458773490347977
STAT,1802,74,na,1876,667.4954337728411
SIM,1930,22,25-29,1952,72
SIM,1949,16,na,1965,2591
STAT,1806,64,na,1870,753.5338517003823
STAT,1876,31,45-49,1907,1.7700479560666695
SIM,1893,67,na,1960,1626
SIM,1844,10,na,1854,3028
SIM,1848,24,na,1872,2625
STAT,1887,21,25-29,1908,63.19893869997069
STAT,1853,26,25-29,1879,38.27218004951598
SIM,1856,33,35-39,1889,1
STAT,1858,19,50-100,1877,0.04319044811867759
STAT,1893,43,15-19,1936,0.0011905717880978618
SIM,1878,62,na,1940,2281
STAT,1911,32,20-24,1943,2.3484132260274704
STAT,1927,27,30-34,1954,47.246744238964354
STAT,1795,87,na,1882,71.11500715564316
STAT,1855,20,20-24,1875,54.055853177483996
STAT,1929,25,45-49,1954,2.1551435381165196
SIM,1841,45,na,1886,244
SIM,1862,30,25-29,1892,9
STAT,1865,27,na,1892,2178.874401797246
SIM,1909,21,20-24,1930,63
STAT,1909,30,15-19,1939,0.12235582813953506
STAT,1909,49,35-39,1958,0.11657950095221178
SIM,1918,36,na,1954,4400
STAT,1911,29,na,1940,3586.331338644083
STAT,1886,17,25-29,1903,5.868181210188152
SIM,1835,73,na,1908,327
STAT,1803,106,na,1909,0.0030627601390951662
STAT,1883,29,20-24,1912,11.20549857199734
SIM,1840,20,na,1860,2831
STAT,1897,44,40-44,1941,0.204634209307287
STAT,1854,30,25-29,1884,5.954478708893611
STAT,1935,36,25-29,1971,1.3681331226644604
STAT,1937,22,na,1959,3519.3743662583242
STAT,1886,45,na,1931,2353.050172979279
STAT,1811,44,25-29,1855,3.1546665222329886
STAT,1849,111,na,1960,1.7340765221025598E-4
STAT,1917,40,20-24,1957,0.018234559756209398
STAT,1816,38,20-24,1854,3.0023739626994055
STAT,1831,28,45-49,1859,1.2647355124283142
STAT,1837,43,30-34,1880,1.0739237906791697
SIM,1911,57,na,1968,2132
STAT,1896,24,30-34,1920,23.333668558563268
SIM,1962,4,na,1966,4676
STAT,1829,33,30-34,1862,9.392770420518751
STAT,1861,36,30-34,1897,4.453638756400931
STAT,1881,14,na,1895,2430.8914404768634
STAT,1967,4,na,1971,4862.541020726433
SIM,1878,34,25-29,1912,127
SIM,1845,43,30-34,1888,1
STAT,1908,25,na,1933,3536.6092823561
STAT,1895,2,na,1897,3467.683651471413
STAT,1874,20,25-29,1894,59.43379124862071
STAT,1907,40,na,1947,3418.114640512156
SIM,1854,20,25-29,1874,352
SIM,1863,20,20-24,1883,906
STAT,1903,22,20-24,1925,97.82205791315779
SIM,1828,49,45-49,1877,1
STAT,1901,17,15-19,1918,8.297779024411344
SIM,1861,26,25-29,1887,37
STAT,1814,50,50-100,1864,0.05181576497166268
SIM,1911,22,20-24,1933,3
STAT,1828,40,25-29,1868,0.8303846502987853
STAT,1845,16,25-29,1861,3.575087591603276
STAT,1825,86,na,1911,136.6341606205194
STAT,1895,31,25-29,1926,13.37877368716836
STAT,1902,6,na,1908,3678.618175885984
STAT,1853,15,15-19,1868,5.60119331084706
STAT,1837,28,na,1865,2210.3363154835642
SIM,1927,17,30-34,1944,81
SIM,1878,34,30-34,1912,203
STAT,1949,18,25-29,1967,49.887237818960074
STAT,1903,30,50-100,1933,1.3110754128490643
STAT,1955,16,na,1971,4844.9151684272265
STAT,1861,13,na,1874,2271.5464010218
STAT,1899,55,na,1954,2824.222330674057
STAT,1922,22,25-29,1944,104.74495618926001
STAT,1923,9,na,1932,4625.319057111618
STAT,1938,17,40-44,1955,1.3649768022316577
STAT,1858,108,na,1966,0.01168286337874762
STAT,1889,34,35-39,1923,12.090855220000407
STAT,1820,35,50-100,1855,2.5778931083944863
STAT,1800,54,20-24,1854,0.004302247900156903
STAT,1854,83,na,1937,220.73178757062607
STAT,1845,52,25-29,1897,0.0017482504048416828
SIM,1879,47,na,1926,1082
STAT,1872,26,35-39,1898,9.695204661563574
SIM,1858,61,na,1919,2126
SIM,1875,33,na,1908,3021
SIM,1789,71,na,1860,303
STAT,1952,11,na,1963,4665.077285580995
STAT,1856,43,40-44,1899,1.6038799925760712
STAT,1915,46,25-29,1961,0.052827740822397634
STAT,1920,28,35-39,1948,16.200495807081595
STAT,1955,15,45-49,1970,0.6577010540111152
STAT,1815,84,na,1899,23.45461669171632
STAT,1928,41,35-39,1969,0.25512103187641394
SIM,1853,30,na,1883,3208
SIM,1890,2,na,1892,4061
STAT,1842,58,na,1900,490.92763810396394
SIM,1861,65,na,1926,1395
STAT,1876,46,na,1922,2280.8395032787203
STAT,1839,51,na,1890,2010.006425674701
STAT,1849,17,45-49,1866,0.06775012783293916
STAT,1895,44,30-34,1939,0.10245371625003066
STAT,1937,24,35-39,1961,9.068302335981219
STAT,1833,45,15-19,1878,2.0610084412282827E-4
STAT,1880,51,na,1931,2246.0157855007574
STAT,1924,36,25-29,1960,1.1509228969806027
STAT,1846,33,25-29,1879,7.094792105894824
SIM,1838,41,na,1879,1973
SIM,1880,20,20-24,1900,7
SIM,1934,9,na,1943,5336
SIM,1859,24,na,1883,2159
STAT,1939,32,45-49,1971,1.587901178886601
SIM,1834,51,na,1885,727
STAT,1937,35,45-49,1972,0.6758091315868932
STAT,1897,40,25-29,1937,0.059818989694071976
SIM,1816,38,na,1854,356
STAT,1838,26,35-39,1864,5.277377708765436
STAT,1855,23,30-34,1878,13.673380544608253
SIM,1885,32,na,1917,1435
SIM,1801,61,na,1862,1846
STAT,1864,17,40-44,1881,0.17201120903227354
STAT,1887,9,na,1896,2855.8430822525784
STAT,1840,48,na,1888,881.9721890835916
SIM,1824,33,na,1857,2078
STAT,1865,83,na,1948,362.44558068091783
STAT,1941,27,na,1968,3831.222750738493
SIM,1805,75,na,1880,924
SIM,1927,13,na,1940,1973
STAT,1827,66,na,1893,1155.8161134765353
SIM,1854,22,15-19,1876,12
SIM,1932,36,25-29,1968,16
STAT,1857,109,na,1966,0.0044439213790385
SIM,1851,44,na,1895,1153
STAT,1900,29,na,1929,3282.3871419845996
STAT,1926,34,30-34,1960,18.86303049335835
SIM,1883,68,na,1951,1771
STAT,1854,43,na,1897,1275.8069629132908
SIM,1906,51,na,1957,3128
STAT,1853,98,na,1951,2.5188821207577985
SIM,1861,26,30-34,1887,5
SIM,1913,36,45-49,1949,2
STAT,1905,25,35-39,1930,13.97240655628024
STAT,1928,42,40-44,1970,0.31643852805618916
STAT,1902,42,20-24,1944,0.015510500018910812
STAT,1931,26,15-19,1957,0.9054181773455164
STAT,1856,32,50-100,1888,0.6661539203591457
STAT,1912,15,25-29,1927,8.701321265913842
STAT,1891,39,20-24,1930,0.9383944932536282
STAT,1911,46,50-100,1957,0.2122388522156512
STAT,1839,43,35-39,1882,1.7505675880551483
STAT,1853,26,30-34,1879,22.783305646724433
SIM,1873,47,na,1920,2113
STAT,1846,22,15-19,1868,2.4108214840007642
STAT,1928,31,30-34,1959,19.561668958698643
STAT,1949,15,20-24,1964,156.206471030158
STAT,1832,42,40-44,1874,0.19793213248783614
STAT,1824,48,20-24,1872,0.002059439105702696
STAT,1863,45,30-34,1908,0.0834632291511672
SIM,1827,78,na,1905,783
SIM,1864,70,na,1934,922
STAT,1827,36,30-34,1863,5.320197210846283
STAT,1830,92,na,1922,30.144693139510604
STAT,1899,19,25-29,1918,7.698491015040628
STAT,1863,17,na,1880,2236.1419126731425
SIM,1898,9,na,1907,4434
SIM,1902,33,35-39,1935,18
STAT,1854,28,50-100,1882,0.37019168596259017
STAT,1883,29,15-19,1912,0.4333618267011183
SIM,1837,21,30-34,1858,3
SIM,1937,34,na,1971,2970
SIM,1917,14,na,1931,2415
STAT,1882,32,50-100,1914,0.8772228926806159
STAT,1852,47,20-24,1899,0.012022742417640123
STAT,1918,24,na,1942,3861.1155176287702
STAT,1816,38,15-19,1854,0.21871601155562587
STAT,1854,43,30-34,1897,0.6346181652720452
STAT,1851,105,na,1956,0.028685929956287555
STAT,1909,50,na,1959,3311.3450147604303
STAT,1917,45,15-19,1962,3.8141575846348263E-4
SIM,1904,31,40-44,1935,3
STAT,1835,30,15-19,1865,0.14005707328318634
STAT,1917,20,50-100,1937,0.6941083564880612
STAT,1852,3,na,1855,3439.6363999999994
STAT,1893,39,na,1932,2916.5626461542215
STAT,1915,21,50-100,1936,0.6725791431202895
SIM,1913,24,na,1937,1858
STAT,1816,42,50-100,1858,3.472313117933691
STAT,1887,34,25-29,1921,11.177238534788403
STAT,1894,27,30-34,1921,32.02277779178326
SIM,1859,22,20-24,1881,357
SIM,1863,32,na,1895,966
STAT,1900,44,15-19,1944,0.0013105332472708264
SIM,1847,39,na,1886,1488
STAT,1800,94,na,1894,13.789899936169345
STAT,1822,97,na,1919,3.097905172309939
STAT,1875,50,45-49,1925,0.015116254145412848
STAT,1918,33,20-24,1951,2.5461975296996897
STAT,1900,39,40-44,1939,1.2957074294283766
STAT,1841,47,45-49,1888,0.26399272827618114
SIM,1926,33,20-24,1959,17
STAT,1855,84,na,1939,220.16863349792135
STAT,1835,49,35-39,1884,0.10883011903538224
STAT,1789,99,na,1888,0.6324955489888053
STAT,1931,15,35-39,1946,5.4790772225353805
SIM,1950,19,20-24,1969,123
SIM,1926,21,20-24,1947,1171
STAT,1862,50,50-100,1912,0.013048487122153717
STAT,1865,33,35-39,1898,9.20690302835927
STAT,1878,40,15-19,1918,0.014351877760551333
STAT,1857,106,na,1963,0.04327606731925705
STAT,1836,23,20-24,1859,69.19057504388734
STAT,1885,42,50-100,1927,1.0371602177330532
STAT,1822,47,35-39,1869,0.23410828484715107
STAT,1873,43,40-44,1916,2.290594184292734
STAT,1843,59,na,1902,1920.2295223584952
SIM,1907,27,25-29,1934,253
STAT,1850,49,30-34,1899,0.04376525749805978
STAT,1906,40,45-49,1946,0.1520162943581995
STAT,1852,30,50-100,1882,0.9749510399261556
SIM,1822,63,na,1885,516
STAT,1901,19,35-39,1920,0.7630990490138964
STAT,1850,38,20-24,1888,0.35784992875512295
STAT,1942,19,20-24,1961,139.9693231356472
STAT,1921,45,35-39,1966,0.14429735352026432
STAT,1821,56,na,1877,1122.1264032296704
STAT,1829,36,na,1865,1010.8284472947166
SIM,1937,23,25-29,1960,5
STAT,1787,95,na,1882,1.2210999390128994
STAT,1831,25,40-44,1856,4.023761837651389
SIM,1881,43,40-44,1924,1
STAT,1906,42,35-39,1948,0.18186590527340815
SIM,1801,64,na,1865,1783
STAT,1858,50,45-49,1908,0.011241874297024805
SIM,1852,85,na,1937,1138
STAT,1931,26,45-49,1957,2.215743887056692
STAT,1900,32,15-19,1932,0.19727527477171217
STAT,1918,21,20-24,1939,118.66607270158285
SIM,1891,29,15-19,1920,2
SIM,1835,36,30-34,1871,1
STAT,1818,73,na,1891,722.9331067054494
STAT,1898,30,na,1928,3234.7062423413645
STAT,1818,41,50-100,1859,2.122749377209348
STAT,1898,42,50-100,1940,0.09852990814003144
SIM,1871,43,na,1914,1812
SIM,1875,57,na,1932,2579
STAT,1920,23,35-39,1943,10.301335041102735
STAT,1923,26,50-100,1949,1.1346288760968548
STAT,1929,23,25-29,1952,115.63163890739443
STAT,1879,27,35-39,1906,9.898255243712573
STAT,1865,34,50-100,1899,0.8293620215630488
STAT,1935,21,20-24,1956,150.3794819809094
SIM,1928,36,35-39,1964,9
STAT,1902,48,40-44,1950,0.134278853354886
SIM,1920,1,na,1921,4900
STAT,1842,21,50-100,1863,0.12860640957149821
STAT,1861,20,15-19,1881,2.8595329200993347
STAT,1905,36,45-49,1941,0.621854341067094
STAT,1925,19,20-24,1944,161.4059237461645
STAT,1926,46,30-34,1972,0.10932331197850988
STAT,1852,45,25-29,1897,0.05855749453218117
STAT,1852,33,na,1885,2461.326323837458
SIM,1882,9,na,1891,2312
STAT,1877,16,15-19,1893,6.039078990825533
STAT,1914,27,20-24,1941,18.14589406896004
SIM,1887,42,na,1929,3471
SIM,1876,37,30-34,1913,2
STAT,1912,14,na,1926,3934.3526724250505
SIM,1803,71,na,1874,118
STAT,1922,36,45-49,1958,0.767753624501563
STAT,1941,30,40-44,1971,4.066572049671037
STAT,1932,30,45-49,1962,2.079638949697145
STAT,1893,48,20-24,1941,0.008358461526749144
SIM,1890,33,40-44,1923,12
STAT,1846,36,40-44,1882,2.7356869633092056
STAT,1872,23,25-29,1895,57.14631294323906
STAT,1799,77,na,1876,69.40127179981569
SIM,1900,29,35-39,1929,28
STAT,1909,46,30-34,1955,0.08128323296357387
STAT,1887,37,40-44,1924,4.818199979372033
STAT,1944,23,20-24,1967,118.66776299380649
STAT,1866,24,45-49,1890,0.6325434047476105
STAT,1922,25,35-39,1947,16.913212907083196
STAT,1882,33,40-44,1915,4.134495357864031
SIM,1897,57,na,1954,1702
STAT,1876,43,na,1919,2319.5728393875684
STAT,1920,25,30-34,1945,42.717474719351664
STAT,1874,46,15-19,1920,4.1399834757825443E-4
STAT,1893,46,25-29,1939,0.040746504573603244
STAT,1944,9,na,1953,4193.714112878221
SIM,1828,63,na,1891,1134
STAT,1806,52,40-44,1858,0.02784923897444187
STAT,1868,37,30-34,1905,5.1476838655240185
STAT,1889,33,50-100,1922,1.0987096113543564
STAT,1901,25,20-24,1926,16.51437734122876
SIM,1839,63,na,1902,334
STAT,1845,52,50-100,1897,0.007454345528787417
STAT,1909,10,na,1919,3845.081191286796
STAT,1857,46,15-19,1903,3.078157828035695E-4
STAT,1866,68,na,1934,1394.967320403675
STAT,1870,29,50-100,1899,0.6331725570005406
STAT,1916,20,na,1936,3796.911401626884
STAT,1882,45,40-44,1927,0.16554273505307207
STAT,1925,17,25-29,1942,51.86978046912287
SIM,1877,6,na,1883,365
SIM,1803,68,na,1871,965
STAT,1837,34,40-44,1871,4.270198541559232
STAT,1804,105,na,1909,0.01857758875578631
STAT,1929,27,50-100,1956,1.236977307227358
SIM,1924,29,20-24,1953,193
STAT,1833,41,na,1874,1061.344291382924
STAT,1852,49,40-44,1901,0.16872977902688144
STAT,1921,40,40-44,1961,0.2791535706557893
SIM,1932,33,20-24,1965,16
SIM,1810,78,na,1888,1727
STAT,1916,29,20-24,1945,18.483426982464152
SIM,1868,4,na,1872,1405
STAT,1859,58,na,1917,1567.429164760006
STAT,1853,18,na,1871,2128.44493833055
STAT,1922,24,45-49,1946,1.2679341993621873
STAT,1842,28,15-19,1870,0.13828273063836422
STAT,1815,54,40-44,1869,9.901512846715122E-4
STAT,1836,19,30-34,1855,2.886478331330441
STAT,1952,20,45-49,1972,1.3413974440482488
SIM,1833,28,15-19,1861,3
STAT,1841,44,40-44,1885,2.5368689765447363
SIM,1842,30,na,1872,3146
STAT,1860,46,50-100,1906,0.20092741149486318
STAT,1856,47,na,1903,1608.4224634668903
SIM,1871,48,35-39,1919,1
SIM,1852,48,na,1900,1950
STAT,1877,53,50-100,1930,0.015084950941233268
STAT,1902,34,15-19,1936,0.11416013609602108
STAT,1818,52,na,1870,1580.4541817726604
STAT,1838,23,30-34,1861,9.794214739810393
STAT,1843,40,na,1883,2412.2580685155654
STAT,1915,40,40-44,1955,0.24895065275448183
STAT,1870,26,30-34,1896,25.190822794408785
STAT,1924,33,20-24,1957,2.8166306319084216
SIM,1884,46,25-29,1930,1
SIM,1896,35,na,1931,3650
STAT,1849,17,50-100,1866,0.05081259587470437
STAT,1925,30,50-100,1955,0.9739310089015144
STAT,1937,21,30-34,1958,27.708160971573655
SIM,1880,23,25-29,1903,5
SIM,1909,24,30-34,1933,14
STAT,1892,19,15-19,1911,7.308127401914574
STAT,1863,48,35-39,1911,0.1180179520993941
SIM,1854,30,20-24,1884,13
STAT,1855,35,50-100,1890,0.8202819667428662
STAT,1811,48,40-44,1859,0.7918624459932656
STAT,1874,39,20-24,1913,0.7875602908561474
STAT,1909,31,50-100,1940,0.7841467885181524
STAT,1902,45,25-29,1947,0.04620895331198372
SIM,1868,1,na,1869,1958
STAT,1855,26,35-39,1881,6.70449152256675
STAT,1831,55,na,1886,1646.4504135980026
STAT,1802,54,30-34,1856,0.028996878346837587
STAT,1926,30,45-49,1956,1.8885468785715713
SIM,1873,33,35-39,1906,82
STAT,1863,39,45-49,1902,1.6847356064881531
SIM,1904,47,na,1951,3986
STAT,1846,30,20-24,1876,1.9315837585633377
SIM,1901,36,na,1937,3745
STAT,1868,32,na,1900,2304.8683023709314
STAT,1806,67,na,1873,673.787102023518
STAT,1940,17,20-24,1957,136.110636640242
STAT,1885,21,15-19,1906,3.2525637719773295
STAT,1849,24,45-49,1873,0.7002103011080496
STAT,1870,73,na,1943,1184.1099777017225
STAT,1877,18,35-39,1895,0.5555464610848859
STAT,1939,26,na,1965,3726.2981667836407
SIM,1853,70,na,1923,2333
STAT,1841,92,na,1933,46.37933053600539
STAT,1911,23,30-34,1934,26.867753921408728
STAT,1853,58,na,1911,1533.4067360442539
STAT,1861,8,na,1869,2347.2980562552348
STAT,1888,18,40-44,1906,0.21054698872815614
SIM,1895,0,na,1895,4648
STAT,1844,84,na,1928,329.5657301687707
STAT,1876,46,25-29,1922,0.058393623113028585
SIM,1863,26,35-39,1889,11
STAT,1856,50,35-39,1906,0.006272346678865586
STAT,1842,18,na,1860,727.4277685730111
SIM,1839,66,na,1905,127
STAT,1857,39,15-19,1896,0.04265715425217553
SIM,1913,33,40-44,1946,21
STAT,1868,22,20-24,1890,66.56056960408971
STAT,1811,46,20-24,1857,0.05731379282783447
STAT,1862,16,25-29,1878,5.560643319910358
STAT,1916,23,15-19,1939,5.484886575798323
STAT,1887,31,20-24,1918,2.9873427722560604
STAT,1878,31,25-29,1909,10.581366610396183
STAT,1905,22,30-34,1927,25.61977263601664
STAT,1932,32,35-39,1964,12.063643419524642
STAT,1844,36,30-34,1880,6.195271082781577
SIM,1913,21,na,1934,3545
STAT,1935,34,35-39,1969,12.535714921773506
SIM,1819,44,40-44,1863,8
STAT,1928,34,35-39,1962,11.325045385330775
STAT,1806,104,na,1910,0.020084610244496027
STAT,1948,22,45-49,1970,1.2787018096406007
STAT,1832,45,45-49,1877,0.02184770751947419
STAT,1865,43,na,1908,2094.8980688244155
STAT,1905,33,40-44,1938,3.566509021239284
STAT,1863,36,40-44,1899,3.7551149753646396
STAT,1907,24,na,1931,3429.2321758333055
SIM,1846,23,30-34,1869,535
STAT,1831,41,50-100,1872,1.0464500524058205
STAT,1921,28,na,1949,4111.077550506925
SIM,1924,23,15-19,1947,41
STAT,1876,83,na,1959,524.6183965101251
SIM,1859,26,15-19,1885,3
STAT,1888,71,na,1959,1661.1017997786455
STAT,1962,6,na,1968,4989.677320162544
STAT,1929,38,20-24,1967,0.33571937528141566
SIM,1830,45,na,1875,464
SIM,1839,30,25-29,1869,1
SIM,1852,36,30-34,1888,4
STAT,1829,36,35-39,1865,3.6502931345939946
STAT,1937,32,40-44,1969,3.831637495003676
STAT,1898,21,25-29,1919,77.2115420967943
STAT,1868,102,na,1970,2.4763061615517787
STAT,1833,38,20-24,1871,0.41197703849688494
STAT,1842,55,na,1897,513.2984577728055
STAT,1928,43,25-29,1971,0.09019888170205413
STAT,1813,42,30-34,1855,5.7557817427330455
STAT,1907,32,50-100,1939,0.767642864504625
STAT,1907,46,20-24,1953,0.009904667670718119
SIM,1935,8,na,1943,5881
STAT,1821,53,50-100,1874,0.015281464247243776
STAT,1822,38,45-49,1860,3.879279622880608
STAT,1897,45,na,1942,3018.254609225059
SIM,1851,5,na,1856,1504
STAT,1844,81,na,1925,535.7293898348564
STAT,1880,33,30-34,1913,18.049392124426294
STAT,1878,27,50-100,1905,0.6581598165773764
STAT,1820,34,25-29,1854,28.661775869644384
SIM,1895,3,na,1898,4648
STAT,1856,5,na,1861,2135.5770743247476
STAT,1921,42,30-34,1963,0.1422882930127353
STAT,1913,8,na,1921,4013.536714930282
SIM,1849,25,na,1874,2524
STAT,1841,24,50-100,1865,0.5670247077751206
STAT,1864,58,na,1922,1797.846035083478
STAT,1933,36,20-24,1969,0.35694246219041803
STAT,1833,49,30-34,1882,0.043108384691459486
STAT,1922,21,40-44,1943,3.8243531829571533
STAT,1847,46,50-100,1893,0.22268156844829293
SIM,1845,30,25-29,1875,68
STAT,1916,23,45-49,1939,1.159351887144647
STAT,1843,99,na,1942,1.8712253465839241
SIM,1826,37,na,1863,1894
SIM,1887,24,30-34,1911,2
STAT,1873,46,45-49,1919,0.24277131264355678
STAT,1822,44,30-34,1866,1.9603276209754101
STAT,1891,35,na,1926,2924.728037787241
STAT,1935,24,25-29,1959,124.79411511227391
SIM,1918,27,30-34,1945,162
STAT,1891,23,35-39,1914,7.153883585970913
STAT,1786,70,na,1856,1233.49747524
STAT,1882,48,45-49,1930,0.22310976647215972
STAT,1887,23,15-19,1910,3.6199270522600115
STAT,1824,32,35-39,1856,4.519796212774251
STAT,1804,108,na,1912,0.0011605807979644933
STAT,1879,24,30-34,1903,18.15816040233057
SIM,1848,40,na,1888,2347
SIM,1832,32,35-39,1864,2
STAT,1890,50,na,1940,2644.1714389085455
STAT,1954,15,na,1969,4512.446271124899
STAT,1927,25,40-44,1952,5.658462358536187
SIM,1804,53,na,1857,875
STAT,1905,36,15-19,1941,0.01751702577523333
STAT,1921,50,na,1971,4055.536351940446
STAT,1887,36,50-100,1923,1.3578476327671407
STAT,1933,16,na,1949,4905.80340878405
SIM,1870,16,25-29,1886,9
STAT,1818,49,35-39,1867,0.24218612625803584
STAT,1906,35,50-100,1941,0.3873796624600816
STAT,1914,19,45-49,1933,0.10135031125007203
STAT,1924,34,20-24,1958,2.8147434893850427
STAT,1918,36,25-29,1954,1.0287291551967173
STAT,1907,21,45-49,1928,1.0205315193149889
SIM,1858,39,na,1897,2350
STAT,1926,30,15-19,1956,0.1542264854482787
STAT,1869,54,30-34,1923,0.005841432043334792
STAT,1930,41,50-100,1971,0.15370962514370853
STAT,1811,97,na,1908,3.2546701876861
STAT,1957,3,na,1960,5140.976597258948
SIM,1817,63,na,1880,2170
SIM,1794,74,na,1868,438
SIM,1897,20,na,1917,2953
SIM,1952,3,na,1955,6382
STAT,1906,39,na,1945,3403.9359312600614
STAT,1943,20,50-100,1963,0.6925481574508299
SIM,1890,40,35-39,1930,29
STAT,1829,92,na,1921,15.209094524862751
STAT,1887,6,na,1893,2875.351638646405
SIM,1854,55,na,1909,986
STAT,1902,44,25-29,1946,0.06194608138096362
STAT,1919,49,na,1968,3908.7659091341166
STAT,1938,15,45-49,1953,0.4897565535903122
STAT,1848,43,50-100,1891,0.981459361989776
STAT,1881,16,35-39,1897,0.5194448932235086
SIM,1844,26,25-29,1870,124
STAT,1913,32,25-29,1945,9.080364949631186
STAT,1833,103,na,1936,0.05904741817033197
STAT,1807,48,20-24,1855,0.040800006358068484
STAT,1832,96,na,1928,7.288993839843646
STAT,1837,49,45-49,1886,0.19146386856667955
STAT,1955,17,40-44,1972,1.840587499361224
STAT,1868,94,na,1962,46.02596136357137
STAT,1840,17,50-100,1857,0.024976303891854235
STAT,1857,20,25-29,1877,51.44858516370164
STAT,1903,29,40-44,1932,4.221845019884611
SIM,1852,29,na,1881,2390
SIM,1929,38,50-100,1967,5
STAT,1858,18,25-29,1876,5.025295162506781
STAT,1914,19,15-19,1933,9.207677640296582
STAT,1910,49,50-100,1959,0.20744180415571464
STAT,1931,23,40-44,1954,4.316874925153546
STAT,1944,26,25-29,1970,70.36997222637298
STAT,1872,20,20-24,1892,69.41791708176889
SIM,1878,22,30-34,1900,155
STAT,1837,30,25-29,1867,10.51322137243616
STAT,1906,61,na,1967,2956.3999014687956
STAT,1847,17,40-44,1864,0.2063927513656846
SIM,1886,57,na,1943,2700
STAT,1882,40,35-39,1922,1.7511852662442782
STAT,1901,16,30-34,1917,2.2340458767774884
STAT,1861,43,50-100,1904,0.8722440278941942
SIM,1908,9,na,1917,2908
SIM,1950,16,na,1966,4844
STAT,1836,26,25-29,1862,42.24671926670009
STAT,1878,4,na,1882,2966.6811141125336
STAT,1830,30,na,1860,2076.2626753183513
STAT,1808,74,na,1882,294.63636595534365
STAT,1828,53,30-34,1881,0.006122308372246763
STAT,1880,46,45-49,1926,0.245700063876677
STAT,1850,22,35-39,1872,3.234201477638654
STAT,1888,31,na,1919,2765.448974918931
SIM,1795,59,na,1854,12
STAT,1841,33,na,1874,2897.898531178883
STAT,1953,15,40-44,1968,1.6777329994220664
STAT,1864,98,na,1962,8.028382104389248
STAT,1868,33,15-19,1901,0.1369669720039893
SIM,1883,12,na,1895,2241
STAT,1934,19,25-29,1953,57.90614126234916
STAT,1918,36,30-34,1954,1.9042433402853014
STAT,1836,50,25-29,1886,0.0028571935143199296
STAT,1913,49,na,1962,3520.042434574914
STAT,1883,77,na,1960,993.509144508613
STAT,1818,36,na,1854,1881.278247166241
STAT,1852,49,35-39,1901,0.13797995980279695
STAT,1866,36,15-19,1902,0.051505646954724676
SIM,1869,43,25-29,1912,10
STAT,1879,17,25-29,1896,5.813155823584733
STAT,1838,50,na,1888,950.282475694553
SIM,1800,60,na,1860,216
STAT,1814,46,na,1860,2106.128015509002
STAT,1891,20,25-29,1911,70.81660041577506
STAT,1880,43,40-44,1923,2.318227517361518
STAT,1905,28,50-100,1933,0.9168440087388552
SIM,1860,49,35-39,1909,4
STAT,1921,42,25-29,1963,0.07947634417012829
STAT,1940,16,45-49,1956,0.501653393213339
STAT,1884,30,35-39,1914,9.772285407131319
STAT,1900,47,25-29,1947,0.04479974405641709
STAT,1921,44,na,1965,4119.731954013142
STAT,1930,20,30-34,1950,36.7790708277835
STAT,1822,47,40-44,1869,0.2862809876671765
STAT,1919,15,40-44,1934,0.3074146662634739
SIM,1888,21,na,1909,252
STAT,1861,24,30-34,1885,15.000691542595021
STAT,1870,19,30-34,1889,1.5852770432663412
STAT,1898,8,na,1906,3495.6534827492665
SIM,1939,7,na,1946,4850
SIM,1821,68,na,1889,1505
STAT,1915,31,45-49,1946,1.5864426639894162
STAT,1851,32,na,1883,1961.625273869662
STAT,1908,62,na,1970,3000.943988170042
STAT,1834,60,na,1894,840.5041253560337
SIM,1871,27,na,1898,1880
SIM,1793,73,na,1866,740
SIM,1869,88,na,1957,1895
SIM,1909,39,35-39,1948,10
STAT,1871,43,30-34,1914,1.1385596743902553
STAT,1822,107,na,1929,0.0027194561940203353
STAT,1805,85,na,1890,36.778680789498694
STAT,1873,51,25-29,1924,0.003650708725071344
STAT,1854,34,40-44,1888,2.4185552075530015
STAT,1951,16,20-24,1967,159.98600043499206
STAT,1909,41,30-34,1950,0.11904380795515566
STAT,1872,27,40-44,1899,2.9996366493250797
STAT,1913,23,35-39,1936,9.35990941140396
STAT,1856,63,na,1919,1281.5828684982773
STAT,1804,52,30-34,1856,0.03759901421647534
SIM,1842,19,20-24,1861,57
STAT,1877,5,na,1882,2769.6608978868835
STAT,1944,26,30-34,1970,41.891018058304766
SIM,1920,31,na,1951,3890
SIM,1875,70,na,1945,2443
STAT,1817,88,na,1905,43.489990016213696
STAT,1864,53,40-44,1917,0.009417082245915248
STAT,1909,34,25-29,1943,8.655465600009808
SIM,1832,71,na,1903,167
STAT,1870,27,na,1897,2379.2040880057984
STAT,1892,26,15-19,1918,0.5636540123153522
STAT,1826,65,na,1891,1347.299104216433
STAT,1861,35,25-29,1896,2.4172045694528923
STAT,1929,37,45-49,1966,0.8690792067593145
STAT,1920,20,30-34,1940,31.729564263224642
STAT,1854,40,50-100,1894,0.5933330642317403
SIM,1832,44,50-100,1876,31
STAT,1872,39,50-100,1911,1.217038509589275
STAT,1925,34,na,1959,4444.3416627037395
STAT,1850,50,na,1900,1008.5380810979659
STAT,1926,31,20-24,1957,2.925783091113547
SIM,1888,43,na,1931,100
STAT,1843,40,15-19,1883,0.014413421509201867
STAT,1927,29,35-39,1956,18.030572718232566
SIM,1912,30,30-34,1942,7
STAT,1878,48,50-100,1926,0.24951522079634217
STAT,1849,43,50-100,1892,0.8837274796143336
STAT,1856,40,25-29,1896,0.4658855652280412
STAT,1786,73,na,1859,928.210866012738
SIM,1910,59,na,1969,3267
STAT,1877,51,25-29,1928,0.003612772787802055
SIM,1822,38,50-100,1860,41
STAT,1878,40,20-24,1918,0.16504658533203084
STAT,1899,15,45-49,1914,0.08963641081450999
STAT,1859,46,25-29,1905,0.0457829526884467
STAT,1835,34,30-34,1869,16.472916110606075
STAT,1927,40,50-100,1967,0.14654255069652172
STAT,1825,83,na,1908,244.46961329617181
STAT,1867,40,45-49,1907,1.4296996846122099
STAT,1904,30,30-34,1934,25.145135718659432
SIM,1941,17,na,1958,3849
STAT,1872,26,50-100,1898,0.64276035053074
STAT,1930,42,35-39,1972,0.2630869439221011
STAT,1825,35,15-19,1860,0.0850999656445495
STAT,1854,53,40-44,1907,0.00575957406647565
STAT,1922,48,15-19,1970,4.1730388890750495E-4
STAT,1853,29,40-44,1882,2.4135693085810175
STAT,1848,21,35-39,1869,6.697038421288616
STAT,1840,16,40-44,1856,0.09379735697030285
SIM,1890,65,na,1955,3139
SIM,1905,32,na,1937,3230
STAT,1870,22,15-19,1892,3.288906357469713
SIM,1902,23,25-29,1925,197
STAT,1890,43,40-44,1933,2.7033194093425394
STAT,1953,19,35-39,1972,5.027161571197999
STAT,1818,45,25-29,1863,0.1059067033152925
STAT,1835,45,25-29,1880,0.051791458713015735
STAT,1844,29,30-34,1873,30.102885815432064
STAT,1871,52,na,1923,2136.4444519504123
STAT,1871,49,45-49,1920,0.23050490022174266
STAT,1805,63,na,1868,354.84662115649274
STAT,1820,48,45-49,1868,0.3659344857641821
STAT,1835,27,50-100,1862,0.6308040107956746
SIM,1892,42,na,1934,3536
STAT,1860,19,30-34,1879,1.4820101628015503
STAT,1900,20,45-49,1920,0.9717530529769409
STAT,1809,45,15-19,1854,0.0036811836899750473
STAT,1933,20,40-44,1953,4.456159388903241
STAT,1870,38,30-34,1908,5.286879037843036
STAT,1839,50,35-39,1889,0.008197405372074156
STAT,1919,44,35-39,1963,0.21460279007543012
SIM,1896,72,na,1968,1165
STAT,1846,33,50-100,1879,0.634660044314001
SIM,1821,62,na,1883,1753
STAT,1841,30,na,1871,2989.592241892705
SIM,1916,29,25-29,1945,1
STAT,1876,36,15-19,1912,0.05704032067462197
STAT,1854,32,15-19,1886,0.08108631316466093
STAT,1885,16,50-100,1901,0.04827480906424786
STAT,1903,25,30-34,1928,35.98850161243114
STAT,1873,39,50-100,1912,1.2467182746676906
STAT,1843,34,50-100,1877,1.0659654798941305
STAT,1831,71,na,1902,1044.6817573137507
STAT,1841,35,50-100,1876,1.6445986047973165
STAT,1916,20,40-44,1936,3.495969571565857
STAT,1907,37,25-29,1944,0.9067548935272807
STAT,1776,89,na,1865,67.76739764903355
STAT,1840,52,40-44,1892,0.00412324274046897
STAT,1889,41,35-39,1930,2.190494073913379
STAT,1827,29,30-34,1856,27.195742845141602
STAT,1832,28,50-100,1860,0.766337947207558
STAT,1848,34,40-44,1882,4.2181230683769115
SIM,1868,23,na,1891,483
SIM,1789,74,na,1863,215
SIM,1876,58,na,1934,3199
STAT,1952,14,na,1966,4662.651862893118
STAT,1928,44,45-49,1972,0.20985369869734802
SIM,1926,28,na,1954,5882
STAT,1868,88,na,1956,148.18559737360067
STAT,1923,6,na,1929,4656.915084997691
STAT,1830,45,35-39,1875,0.12274895923281104
STAT,1874,24,40-44,1898,2.1371660049197585
SIM,1922,44,na,1966,3312
STAT,1876,35,30-34,1911,5.4388807522088065
STAT,1941,16,50-100,1957,0.38162182918822124
STAT,1908,29,25-29,1937,61.299067360098654
STAT,1899,41,35-39,1940,0.17253034321954064
STAT,1871,30,25-29,1901,10.299573962174486
STAT,1788,74,na,1862,178.65439616889626
STAT,1868,25,25-29,1893,41.13490177991547
STAT,1883,45,50-100,1928,0.23863339682183285
STAT,1848,40,35-39,1888,1.7363534100933873
SIM,1856,38,na,1894,670
STAT,1916,23,50-100,1939,0.6779835855668264
SIM,1902,30,30-34,1932,3
STAT,1798,98,na,1896,1.3789016043902902
STAT,1813,52,40-44,1865,0.03659103662151445
SIM,1928,35,na,1963,4608
STAT,1849,50,35-39,1899,0.00735816528519794
SIM,1893,36,25-29,1929,28
STAT,1791,78,na,1869,396.5821914160777
STAT,1885,49,30-34,1934,0.09316284913877869
STAT,1924,37,25-29,1961,1.1498755571443506
STAT,1895,35,40-44,1930,5.748654982229469
STAT,1884,45,50-100,1929,0.2374500073467128
SIM,1941,4,na,1945,3949
STAT,1853,19,30-34,1872,1.469207804195452
STAT,1920,37,50-100,1957,0.45378146123715996
STAT,1906,45,na,1951,3291.021991079441
STAT,1881,53,40-44,1934,0.009782136622012789
STAT,1828,44,40-44,1872,2.7203365400930495
SIM,1919,40,na,1959,4904
SIM,1898,45,na,1943,4080
STAT,1830,29,50-100,1859,0.6063028354802928
STAT,1861,49,45-49,1910,0.19216981720664084
SIM,1900,23,20-24,1923,1071
STAT,1885,36,25-29,1921,2.843726470510489
STAT,1869,17,25-29,1886,5.797375803389285
STAT,1902,41,20-24,1943,0.015599887373561322
STAT,1912,15,30-34,1927,2.447403333751531
STAT,1823,52,40-44,1875,0.01580682006341551
STAT,1826,31,na,1857,2345.112835237499
SIM,1855,50,na,1905,3004
STAT,1914,26,45-49,1940,1.7232806964888852
SIM,1876,36,na,1912,3686
SIM,1831,46,na,1877,2131
STAT,1885,20,na,1905,2338.59363345038
STAT,1909,28,na,1937,3531.257574215855
STAT,1933,27,25-29,1960,86.80266641887421
SIM,1856,40,35-39,1896,3
STAT,1813,98,na,1911,2.379641028591384
STAT,1929,18,45-49,1947,0.6313911334985225
STAT,1830,52,40-44,1882,0.007915666931269619
STAT,1913,30,40-44,1943,3.8755282320616997
STAT,1866,47,50-100,1913,0.2231430987269375
STAT,1917,41,20-24,1958,0.018210307791733635
STAT,1918,30,na,1948,3996.6177365401422
SIM,1942,16,20-24,1958,355
STAT,1883,20,35-39,1903,5.647480118436636
STAT,1816,45,15-19,1861,0.0012521897127919682
SIM,1838,25,na,1863,1790
SIM,1890,41,25-29,1931,4
STAT,1878,43,25-29,1921,0.6559228963894225
STAT,1951,19,25-29,1970,51.089185186940334
SIM,1846,16,25-29,1862,53
STAT,1883,36,15-19,1919,0.05428313024862382
SIM,1835,36,na,1871,1245
STAT,1872,38,40-44,1910,4.361712502000159
STAT,1894,28,50-100,1922,0.8106068718099279
STAT,1909,44,35-39,1953,0.18413881284340977
STAT,1814,62,na,1876,1525.8631620879353
STAT,1935,36,30-34,1971,2.5325017515998614
STAT,1861,25,15-19,1886,0.38557682755722056
SIM,1921,20,30-34,1941,5
STAT,1871,46,35-39,1917,0.14005261786319076
STAT,1900,44,20-24,1944,0.015071131529609602
STAT,1863,22,15-19,1885,2.8725455351314912
STAT,1932,31,45-49,1963,2.0784951482748113
STAT,1825,29,20-24,1854,27.55943980451482
STAT,1903,18,50-100,1921,0.06936231459453314
SIM,1833,29,20-24,1862,4
STAT,1785,91,na,1876,8.182742971090375
STAT,1889,35,40-44,1924,5.321562450053539
STAT,1895,40,20-24,1935,0.20868012557354212
STAT,1899,16,50-100,1915,0.06708075257920075
STAT,1820,43,15-19,1863,0.022396697999188246
STAT,1818,42,15-19,1860,0.02700716647106866
STAT,1834,29,30-34,1863,14.34437218918923
STAT,1888,15,na,1903,2928.5062643261554
STAT,1885,33,15-19,1918,0.1393888181574078
STAT,1884,40,45-49,1924,1.4471487141525645
STAT,1892,54,na,1946,2592.5862938366135
STAT,1838,16,25-29,1854,3.214181538867711
STAT,1810,72,na,1882,41.11130049969981
STAT,1823,109,na,1932,5.620368388835394E-4
STAT,1880,24,40-44,1904,2.1497726923357017
STAT,1776,95,na,1871,4.715481377798497
SIM,1940,19,20-24,1959,36
STAT,1863,79,na,1942,596.8347488352392
STAT,1923,16,45-49,1939,0.5818349080351201
SIM,1867,59,na,1926,1697
STAT,1937,33,30-34,1970,15.416693776345388
STAT,1857,27,15-19,1884,0.3586038642496742
STAT,1932,19,20-24,1951,177.31720318432016
STAT,1936,15,40-44,1951,1.3319930910438054
STAT,1908,26,20-24,1934,17.32704656645402
SIM,1908,44,25-29,1952,1
STAT,1869,50,20-24,1919,7.553216017299785E-4
STAT,1831,26,40-44,1857,3.752367561004047
STAT,1845,53,30-34,1898,0.00290633059384116
SIM,1860,46,30-34,1906,1
STAT,1904,42,25-29,1946,0.06363097506699436
STAT,1876,30,45-49,1906,1.777013850360081
STAT,1914,24,50-100,1938,0.6587439930834518
STAT,1881,36,na,1917,2235.570156032212
STAT,1878,7,na,1885,2754.8877180048116
STAT,1905,17,50-100,1922,0.07046602528294044
STAT,1914,40,na,1954,3654.2651552517264
STAT,1849,17,15-19,1866,6.155100359143156
STAT,1875,26,15-19,1901,0.4674842583213867
STAT,1929,34,40-44,1963,4.929591732492821
SIM,1850,19,na,1869,2245
STAT,1847,53,40-44,1900,0.009365401084687764
STAT,1835,35,15-19,1870,0.05362987721054854
STAT,1897,41,25-29,1938,0.05948938706085766
STAT,1938,23,50-100,1961,0.6440334296792879
SIM,1878,5,na,1883,4422
STAT,1835,48,na,1883,1771.482681321282
STAT,1896,10,na,1906,3414.641898266048
STAT,1920,29,40-44,1949,5.011227192733311
STAT,1926,34,25-29,1960,11.0658467921909
STAT,1861,44,15-19,1905,0.01132982364670626
STAT,1859,43,20-24,1902,0.12496475072568897
STAT,1921,30,30-34,1951,17.46444347134488
SIM,1916,26,20-24,1942,9
SIM,1878,44,35-39,1922,9
STAT,1839,41,50-100,1880,1.1514405075706526
STAT,1832,104,na,1936,0.05661995791449728
STAT,1842,35,15-19,1877,0.01669589708463148
STAT,1891,49,30-34,1940,0.06574521810363333
STAT,1903,31,na,1934,3401.238338754402
STAT,1909,31,20-24,1940,2.3133480170636593
STAT,1843,96,na,1939,8.484001774838319
STAT,1856,51,25-29,1907,0.0025562357239079275
STAT,1901,47,50-100,1948,0.1928040559521638
STAT,1913,20,30-34,1933,27.665137419496407
SIM,1872,28,na,1900,2405
STAT,1861,39,35-39,1900,5.822944148369695
SIM,1815,50,na,1865,2000
STAT,1841,95,na,1936,14.80544648509849
STAT,1907,34,20-24,1941,2.245269914525495
STAT,1859,24,15-19,1883,2.6741073179418122
SIM,1938,13,na,1951,4240
STAT,1831,37,40-44,1868,4.4459853296787
SIM,1847,21,na,1868,1712
STAT,1837,32,15-19,1869,0.1431659096037245
STAT,1911,45,35-39,1956,0.12125102421144641
STAT,1869,45,40-44,1914,0.17447710966310065
STAT,1874,82,na,1956,516.4535650479063
STAT,1829,35,50-100,1864,0.6451658271559009
SIM,1905,26,na,1931,3531
STAT,1896,15,35-39,1911,0.7266847710894602
STAT,1858,70,na,1928,1071.4776792915527
SIM,1797,69,na,1866,1152
SIM,1832,22,na,1854,2411
SIM,1861,29,40-44,1890,7
STAT,1887,38,40-44,1925,4.794301707474348
STAT,1844,48,30-34,1892,0.09469371477326914
STAT,1877,17,15-19,1894,6.024283247298009
STAT,1906,41,45-49,1947,0.1511786845762858
STAT,1881,23,35-39,1904,5.493694430808618
STAT,1822,40,15-19,1862,0.025758188504196713
STAT,1926,37,35-39,1963,2.9306853148568712
STAT,1927,26,30-34,1953,47.40888261751625
STAT,1844,32,15-19,1876,0.16871014611958285
STAT,1922,31,50-100,1953,0.9275296237780886
STAT,1949,18,30-34,1967,14.031684202727297
STAT,1851,19,20-24,1870,16.82375306068361
STAT,1885,33,20-24,1918,2.645757447555619
STAT,1923,42,35-39,1965,0.2328802471108414
SIM,1803,65,na,1868,965
STAT,1879,28,40-44,1907,3.0621519528067522
STAT,1933,23,45-49,1956,1.481866405334028
STAT,1938,27,45-49,1965,1.6932267623584762
STAT,1841,40,25-29,1881,0.7623471856214274
STAT,1916,36,20-24,1952,0.2675504621734744
SIM,1909,62,na,1971,3677
SIM,1929,17,na,1946,6274
STAT,1915,3,na,1918,4171.481833809385
STAT,1799,107,na,1906,3.1360488098061153E-4
SIM,1860,34,30-34,1894,16
STAT,1901,24,na,1925,3286.145444181298
STAT,1898,47,15-19,1945,3.01998122849119E-4
STAT,1863,57,na,1920,1715.6466937157293
STAT,1958,2,na,1960,5122.8882535220755
STAT,1928,41,40-44,1969,0.3168948566497648
STAT,1830,42,30-34,1872,1.016337342837908
STAT,1846,37,40-44,1883,2.707427316978222
STAT,1902,49,40-44,1951,0.13314822540963794
STAT,1852,34,30-34,1886,17.822546626425517
STAT,1869,36,na,1905,2388.816308560321
STAT,1953,16,30-34,1969,14.616589065385394
STAT,1931,19,15-19,1950,58.66845510100143
STAT,1924,21,45-49,1945,1.318903537032459
STAT,1839,31,35-39,1870,11.699362257618864
SIM,1796,78,na,1874,580
STAT,1858,19,15-19,1877,5.231804007462015
SIM,1893,33,20-24,1926,8
SIM,1898,39,na,1937,4145
STAT,1902,30,20-24,1932,3.8369362661531925
STAT,1914,23,40-44,1937,3.3769201658814616
STAT,1935,31,30-34,1966,21.6528496899432
SIM,1936,31,30-34,1967,2
STAT,1875,42,na,1917,2370.3797662701936
STAT,1898,70,na,1968,2215.430516183607
STAT,1934,17,na,1951,4944.889380538496
STAT,1860,15,na,1875,2185.3804187914157
STAT,1863,41,15-19,1904,0.011842966575392702
STAT,1905,48,15-19,1953,3.2045498755937723E-4
STAT,1834,25,15-19,1859,0.26600034261845534
STAT,1834,82,na,1916,205.6253341450337
STAT,1847,33,na,1880,2276.8780882751757
STAT,1851,54,na,1905,1653.791688375101
STAT,1859,43,15-19,1902,0.010866500650012495
STAT,1863,32,25-29,1895,8.744237253097868
STAT,1891,30,35-39,1921,12.553647572219079
SIM,1851,60,na,1911,979
STAT,1855,81,na,1936,357.89767226165435
STAT,1890,46,45-49,1936,0.16161802739257972
STAT,1905,29,15-19,1934,0.6479056430172453
SIM,1860,80,na,1940,1638
STAT,1840,22,35-39,1862,2.92205063664048
SIM,1880,57,na,1937,3193
STAT,1895,19,na,1914,3267.8720889544225
SIM,1914,49,na,1963,4784
STAT,1910,42,25-29,1952,0.06673251328479338
STAT,1896,22,50-100,1918,0.5375609919309114
STAT,1818,42,20-24,1860,0.31058239764246437
STAT,1883,1,na,1884,3214.704256035136
STAT,1920,48,50-100,1968,0.24612027432264805
SIM,1929,39,na,1968,6198
SIM,1893,33,15-19,1926,2
SIM,1953,2,na,1955,4668
STAT,1876,31,15-19,1907,0.14454937732101733
STAT,1831,48,20-24,1879,0.011171301235903217
SIM,1852,32,20-24,1884,5
STAT,1878,33,15-19,1911,0.14590056439194288
SIM,1840,66,na,1906,2500
SIM,1838,19,na,1857,2304
STAT,1849,99,na,1948,1.5957569759485386
STAT,1880,48,40-44,1928,0.1754988327926636
SIM,1866,40,35-39,1906,1
SIM,1909,16,na,1925,4248
STAT,1865,49,20-24,1914,0.010727142541815825
SIM,1908,31,na,1939,2660
STAT,1860,45,20-24,1905,0.009887103575843428
STAT,1815,50,25-29,1865,3.6064266209112714E-4
STAT,1820,38,35-39,1858,12.530677417601584
STAT,1916,23,na,1939,3762.728365088877
STAT,1930,32,25-29,1962,11.844207180819998
STAT,1827,39,40-44,1866,4.211888317090701
STAT,1933,24,20-24,1957,146.3935319492476
STAT,1911,26,35-39,1937,14.526193050106095
STAT,1914,7,na,1921,4064.102575645237
SIM,1926,34,na,1960,5868
STAT,1913,33,45-49,1946,1.5394249003366534
SIM,1820,37,na,1857,724
SIM,1887,17,25-29,1904,111
STAT,1924,48,25-29,1972,0.062370837622465945
STAT,1833,23,40-44,1856,1.6652010146226115
STAT,1838,27,40-44,1865,1.6266278294227892
STAT,1844,32,20-24,1876,3.2023094210470626
STAT,1931,12,na,1943,5149.773084223849
STAT,1872,49,20-24,1921,0.011765424074647488
STAT,1902,55,na,1957,2952.576987940592
STAT,1808,102,na,1910,0.06866267726375136
STAT,1929,15,40-44,1944,1.780775135363523
STAT,1865,23,50-100,1888,0.37412905861203627
STAT,1846,85,na,1931,162.359094348876
STAT,1802,101,na,1903,0.28911623752854854
SIM,1871,9,na,1880,2177
STAT,1882,41,25-29,1923,0.6175895915875282
STAT,1884,25,na,1909,2300.051979423126
STAT,1948,15,45-49,1963,0.566133396243471
SIM,1837,43,35-39,1880,5
STAT,1860,15,15-19,1875,5.650000896256538
STAT,1788,80,na,1868,101.16504379773515
STAT,1878,56,na,1934,2098.516683353526
STAT,1864,16,35-39,1880,0.5704297212885932
STAT,1894,39,50-100,1933,1.5455560831574033
STAT,1865,40,35-39,1905,1.669938765479072
STAT,1871,46,40-44,1917,0.17126434373488947
STAT,1850,48,30-34,1898,0.04413689011280963
STAT,1884,41,15-19,1925,0.013279585012955338
STAT,1858,27,na,1885,1865.6877256577777
STAT,1837,42,25-29,1879,0.607583869638276
STAT,1942,26,20-24,1968,18.948184537193086
STAT,1863,24,50-100,1887,0.3499931018328958
STAT,1934,16,20-24,1950,182.5852169141444
STAT,1896,34,35-39,1930,13.235492789663189
SIM,1818,42,na,1860,874
STAT,1866,41,50-100,1907,0.9687125051524677
STAT,1912,18,35-39,1930,0.8364549044745697
SIM,1879,60,na,1939,798
STAT,1829,43,35-39,1872,0.8585665113322359
SIM,1864,33,na,1897,2354
STAT,1926,17,50-100,1943,0.4554082052714216
STAT,1916,34,50-100,1950,0.8347523292261734
STAT,1892,76,na,1968,1561.3466726492334
STAT,1947,18,20-24,1965,151.06366694980608
STAT,1850,26,50-100,1876,0.3501234847686066
STAT,1818,49,40-44,1867,0.2961590337125644
STAT,1886,43,15-19,1929,0.014197464852912211
STAT,1893,47,30-34,1940,0.06796455908623421
SIM,1849,40,35-39,1889,59
SIM,1850,29,20-24,1879,1
SIM,1847,44,40-44,1891,5
STAT,1848,30,25-29,1878,11.41210084397401
STAT,1878,47,na,1925,2304.00027074093
STAT,1895,43,25-29,1938,0.05759037144928569
STAT,1926,44,35-39,1970,0.24529628194787156
SIM,1861,25,25-29,1886,162
STAT,1815,47,na,1862,214.33509575463023
STAT,1842,29,20-24,1871,3.5499235107453586
SIM,1896,19,na,1915,3972
STAT,1835,42,15-19,1877,0.012519862315836407
STAT,1867,45,30-34,1912,0.09245935120440707
STAT,1935,27,35-39,1962,20.318197655095254
STAT,1835,61,na,1896,1413.9126687506434
SIM,1855,34,na,1889,3116
STAT,1844,25,15-19,1869,0.5582243569184582
STAT,1912,48,na,1960,3479.966353915841
STAT,1813,48,45-49,1861,0.850626302428234
STAT,1861,93,na,1954,24.30509282122354
STAT,1855,33,35-39,1888,6.753991746246292
STAT,1809,49,30-34,1858,0.8144092068768838
STAT,1830,45,40-44,1875,0.1501044412299651
STAT,1861,32,50-100,1893,0.7619891609773507
STAT,1851,29,30-34,1880,22.9534478734123
SIM,1890,16,na,1906,3965
STAT,1905,40,50-100,1945,0.10658305747568092
STAT,1872,56,na,1928,2042.4070886405286
SIM,1923,23,na,1946,3327
STAT,1904,19,45-49,1923,0.09282550902915596
SIM,1857,2,na,1859,1832
STAT,1828,97,na,1925,3.636633123561202
STAT,1823,42,na,1865,2181.332119066866
SIM,1854,21,25-29,1875,339
STAT,1804,84,na,1888,214.63821421917726
SIM,1889,22,na,1911,3883
STAT,1884,41,na,1925,2222.4970020885594
SIM,1904,41,na,1945,4091
STAT,1896,38,50-100,1934,1.610418170217268
STAT,1939,22,40-44,1961,3.3396467801711007
SIM,1866,96,na,1962,78
STAT,1930,33,45-49,1963,2.0152477898135595
SIM,1821,84,na,1905,299
STAT,1850,23,40-44,1873,1.1466183139110067
STAT,1942,17,25-29,1959,44.76963246457262
SIM,1902,45,35-39,1947,1
SIM,1883,31,na,1914,1834
STAT,1828,52,25-29,1880,0.004083503771081594
SIM,1841,39,na,1880,581
STAT,1897,29,na,1926,3146.774330525369
SIM,1852,39,40-44,1891,69
SIM,1935,30,na,1965,5722
STAT,1841,79,na,1920,778.4991562468147
STAT,1868,21,45-49,1889,0.6783934506261718
STAT,1901,7,na,1908,3642.848581930316
STAT,1835,39,30-34,1874,4.88288153359018
SIM,1895,22,25-29,1917,21
STAT,1797,97,na,1894,0.053703382644803066
STAT,1893,35,30-34,1928,6.728081552207146
STAT,1922,22,30-34,1944,32.59196230284142
STAT,1924,30,40-44,1954,4.542161127151727
STAT,1915,48,15-19,1963,3.649318565808E-4
STAT,1921,33,35-39,1954,10.006624790084377
STAT,1869,53,25-29,1922,0.003516793724792777
STAT,1937,23,50-100,1960,0.6339258151509867
STAT,1844,39,40-44,1883,4.488555034449073
STAT,1814,99,na,1913,1.281739940276406
SIM,1891,63,na,1954,1025
STAT,1826,87,na,1913,140.45767880878222
SIM,1859,27,na,1886,2081
STAT,1827,32,na,1859,2069.6984257566046
SIM,1878,84,na,1962,689
STAT,1907,33,45-49,1940,1.4548323085086539
STAT,1909,37,35-39,1946,2.266127294425097
STAT,1861,32,15-19,1893,0.11843233898351986
STAT,1831,29,45-49,1860,1.224685955580086
SIM,1923,45,na,1968,4224
SIM,1909,8,na,1917,4317
STAT,1924,8,na,1932,4703.9085660987475
STAT,1905,60,na,1965,2952.050541883721
STAT,1861,48,30-34,1909,0.0794915148392934
STAT,1848,49,na,1897,2061.3857753518037
SIM,1880,39,50-100,1919,1
STAT,1836,50,50-100,1886,0.012182755765058681
SIM,1931,3,na,1934,5412
STAT,1870,22,20-24,1892,68.70114838422238
STAT,1910,18,25-29,1928,8.468407904515473
SIM,1932,30,40-44,1962,2
SIM,1909,19,na,1928,3930
STAT,1837,21,50-100,1858,0.43113513441003276
SIM,1902,23,30-34,1925,522
SIM,1892,29,na,1921,3655
STAT,1887,22,25-29,1909,63.008709894483786
STAT,1880,39,45-49,1919,2.0487180281301653
STAT,1797,94,na,1891,0.19978994300393116
STAT,1872,53,na,1925,2121.476704563125
STAT,1908,29,30-34,1937,36.49113757610312
STAT,1845,42,15-19,1887,0.006978203264433317
SIM,1920,32,50-100,1952,2
SIM,1907,39,25-29,1946,9
STAT,1885,26,15-19,1911,0.44749706077050033
STAT,1830,33,40-44,1863,4.031419778484767
STAT,1821,42,50-100,1863,1.1901061799711927
STAT,1890,37,50-100,1927,1.4863143124114542
STAT,1839,18,50-100,1857,0.05919174185799145
STAT,1852,46,30-34,1898,0.09771435529057437
STAT,1867,54,50-100,1921,0.013890347741414434
STAT,1870,34,15-19,1904,0.1407554299229174
STAT,1825,39,30-34,1864,7.3058061776542615
STAT,1917,47,50-100,1964,0.23309240734525644
STAT,1867,30,35-39,1897,9.654455846783973
STAT,1869,41,25-29,1910,0.6509210257016774
STAT,1881,11,na,1892,2442.42593569544
STAT,1839,20,50-100,1859,0.4938620195445085
STAT,1853,25,25-29,1878,38.548961593759174
STAT,1935,20,15-19,1955,7.201657618974675
STAT,1839,44,40-44,1883,2.1467612685023334
SIM,1931,40,na,1971,4967
STAT,1804,87,na,1891,111.62821424476937
STAT,1857,20,30-34,1877,16.008506845524092
STAT,1917,44,25-29,1961,0.07328230979806212
STAT,1905,24,45-49,1929,0.9966931602107618
SIM,1889,25,na,1914,3474
STAT,1811,45,30-34,1856,0.4698115837714895
STAT,1861,29,30-34,1890,20.79267066937932
STAT,1813,41,25-29,1854,4.000287989786595
STAT,1921,46,40-44,1967,0.17606508338233184
SIM,1918,4,na,1922,4571
STAT,1836,54,40-44,1890,0.007845424133854651
SIM,1807,55,na,1862,1094
STAT,1925,17,30-34,1942,14.589310032533206
SIM,1897,31,25-29,1928,96
SIM,1822,47,na,1869,1485
STAT,1819,54,40-44,1873,0.0017873497624451933
STAT,1898,21,30-34,1919,24.02479089127729
STAT,1889,31,25-29,1920,12.384806515869204
STAT,1938,24,40-44,1962,3.289858732522476
SIM,1909,2,na,1911,4331
STAT,1847,89,na,1936,94.98067036338925
STAT,1826,107,na,1933,0.003759728529173434
STAT,1865,34,40-44,1899,3.9254847688227286
STAT,1873,19,na,1892,2576.8218311276933
SIM,1834,32,na,1866,1068
STAT,1884,0,na,1884,3373.0297452789255
STAT,1920,35,35-39,1955,2.618724780181661
SIM,1836,61,na,1897,1299
STAT,1911,30,30-34,1941,15.290905657027674
STAT,1968,3,na,1971,4863.057577217093
STAT,1961,7,na,1968,5031.466014837318
STAT,1883,23,45-49,1906,0.6687805369407367
STAT,1911,23,25-29,1934,86.34833586428219
STAT,1916,27,25-29,1943,67.12755653640379
SIM,1895,47,50-100,1942,1
STAT,1820,47,30-34,1867,0.15210651694354338
STAT,1896,66,na,1962,2333.7813374630205
SIM,1866,42,50-100,1908,2
STAT,1882,19,15-19,1901,5.65132946968696
STAT,1854,37,na,1891,1309.9649571300772
STAT,1870,29,40-44,1899,2.965032706874486
STAT,1904,40,40-44,1944,0.22540590895030688
STAT,1934,19,30-34,1953,16.287145232221988
STAT,1886,45,40-44,1931,0.17905364407356403
STAT,1935,33,20-24,1968,3.3482048814345426
SIM,1867,22,na,1889,1626
SIM,1830,31,25-29,1861,8
SIM,1889,39,50-100,1928,1
STAT,1936,21,na,1957,3457.7857946913987
STAT,1865,21,35-39,1886,5.4315025720548356
STAT,1880,32,25-29,1912,10.63340528548089
STAT,1934,32,50-100,1966,1.1212111468709742
STAT,1916,39,25-29,1955,0.9845311675712314
SIM,1924,39,25-29,1963,7
SIM,1858,64,na,1922,2126
SIM,1876,36,25-29,1912,3
STAT,1826,44,30-34,1870,1.6680237999861993
STAT,1880,20,25-29,1900,59.784378534068324
SIM,1858,45,na,1903,2325
SIM,1940,5,na,1945,4380
STAT,1874,66,na,1940,1691.567482692311
STAT,1868,36,25-29,1904,2.794317428199772
STAT,1860,68,na,1928,1246.6915909259285
STAT,1822,43,25-29,1865,1.1195701604670596
STAT,1910,44,15-19,1954,0.001417481798283765
STAT,1840,91,na,1931,22.817219076585495
STAT,1862,53,30-34,1915,0.004988625823596517
STAT,1861,16,na,1877,2207.161605352133
STAT,1886,51,na,1937,2240.4427472122575
STAT,1915,43,20-24,1958,0.017501131536667842
STAT,1863,44,25-29,1907,0.5408174502750271
STAT,1891,29,na,1920,2913.800842372437
STAT,1930,30,50-100,1960,1.0607141701742437
STAT,1836,24,na,1860,2128.487305632292
SIM,1911,20,na,1931,1620
SIM,1932,2,na,1934,6596
STAT,1816,39,20-24,1855,2.6997204960371515
STAT,1845,26,50-100,1871,0.38915853548098134
SIM,1928,22,30-34,1950,48
STAT,1866,22,na,1888,2176.4879500847665
STAT,1936,18,45-49,1954,0.47227109749298435
STAT,1845,44,40-44,1889,1.1078217689942005
STAT,1919,18,45-49,1937,0.5432751653437271
STAT,1902,33,25-29,1935,14.362364076976338
SIM,1910,33,25-29,1943,1
SIM,1833,72,na,1905,1813
STAT,1879,31,50-100,1910,0.9437623073193637
STAT,1861,90,na,1951,65.56720230163393
STAT,1832,54,40-44,1886,8.098197568231045E-4
STAT,1827,35,25-29,1862,2.909472673255341
STAT,1942,29,25-29,1971,68.22527336186778
STAT,1835,50,50-100,1885,0.012116027476865259
STAT,1846,21,25-29,1867,42.135801249909626
STAT,1894,26,25-29,1920,53.97756626172844
SIM,1873,53,na,1926,2117
SIM,1853,24,na,1877,3434
STAT,1924,45,20-24,1969,0.013091476196420381
SIM,1871,44,25-29,1915,2
STAT,1836,18,40-44,1854,0.443504112920359
STAT,1838,72,na,1910,538.5896237942121
SIM,1917,11,na,1928,2454
STAT,1908,48,50-100,1956,0.20240353749157144
SIM,1866,74,na,1940,1197
STAT,1796,109,na,1905,2.7862171004308455E-4
STAT,1896,44,na,1940,3015.9971687179323
STAT,1911,35,25-29,1946,0.9492195817385278
SIM,1891,66,na,1957,1011
SIM,1933,29,25-29,1962,313
STAT,1854,49,45-49,1903,0.12848039514773651
SIM,1944,22,na,1966,2509
STAT,1915,19,20-24,1934,27.824363776841324
SIM,1790,84,na,1874,101
SIM,1862,49,45-49,1911,9
STAT,1876,17,50-100,1893,0.04952628369409207
STAT,1825,44,50-100,1869,1.3595910267936504
STAT,1950,20,40-44,1970,3.9535642009735112
STAT,1925,29,25-29,1954,76.47949889898503
STAT,1877,15,25-29,1892,5.779137895159606
STAT,1823,76,na,1899,748.4270822629167
STAT,1903,41,50-100,1944,0.10460964812207285
SIM,1783,80,na,1863,1461
STAT,1813,45,40-44,1858,0.6557302774687683
STAT,1915,41,na,1956,3691.5800128083156
STAT,1850,47,50-100,1897,0.11287994635779536
STAT,1817,54,30-34,1871,0.0038696889343512635
STAT,1879,15,35-39,1894,0.5655029599077228
STAT,1819,50,25-29,1869,6.414972325290389E-4
SIM,1898,36,na,1934,4098
STAT,1879,21,20-24,1900,70.90661086060979
STAT,1841,18,15-19,1859,8.473038167236018
STAT,1899,58,na,1957,2745.039380391298
SIM,1819,43,na,1862,1871
STAT,1877,19,40-44,1896,0.1846729134646422
SIM,1932,37,na,1969,6262
STAT,1844,44,15-19,1888,0.013657405628022486
STAT,1901,16,25-29,1917,7.942765554230724
SIM,1846,33,35-39,1879,1
STAT,1842,22,45-49,1864,0.2183379482725241
SIM,1887,21,20-24,1908,1
SIM,1834,35,na,1869,1020
STAT,1865,30,25-29,1895,9.42657419873637
STAT,1870,25,25-29,1895,42.45779457360212
STAT,1930,23,35-39,1953,11.940710182918249
STAT,1911,25,50-100,1936,0.966256710625689
STAT,1849,29,15-19,1878,0.44668019828434785
STAT,1862,78,na,1940,665.4931185895559
STAT,1808,68,na,1876,463.79766126872784
STAT,1893,15,50-100,1908,0.06155035661269525
STAT,1926,46,25-29,1972,0.06505188749248317
STAT,1884,45,30-34,1929,0.09358778815365729
STAT,1876,40,50-100,1916,1.078751958963938
SIM,1845,75,na,1920,553
SIM,1793,79,na,1872,591
STAT,1863,42,na,1905,1970.7045511164592
STAT,1858,40,35-39,1898,1.3968073305885302
SIM,1921,19,na,1940,5241
STAT,1930,30,40-44,1960,5.020506378199156
STAT,1903,34,na,1937,3386.9611427097743
SIM,1807,58,na,1865,1094
STAT,1853,22,20-24,1875,63.13448396262325
SIM,1808,80,na,1888,985
STAT,1851,38,na,1889,1861.2323490017836
STAT,1838,33,35-39,1871,5.3163413619000135
STAT,1909,34,30-34,1943,14.754253751499323
SIM,1843,31,na,1874,438
STAT,1886,41,25-29,1927,0.667994683549231
SIM,1837,21,25-29,1858,9
STAT,1828,35,50-100,1863,1.7233905998996228
STAT,1909,43,20-24,1952,0.01625216175595385
STAT,1925,18,na,1943,4394.1180536656975
STAT,1820,35,30-34,1855,11.190521537233497
STAT,1835,23,15-19,1858,3.294193937194005
STAT,1900,19,50-100,1919,0.06750377467700684
STAT,1893,55,na,1948,2585.733335028273
STAT,1826,40,15-19,1866,0.02149476586615331
STAT,1844,35,25-29,1879,3.381804608181297
STAT,1924,33,45-49,1957,1.817090736385696
STAT,1847,16,35-39,1863,0.6228467858158269
SIM,1908,15,na,1923,2858
STAT,1910,15,20-24,1925,26.68668292323607
STAT,1932,36,15-19,1968,0.025645487288526354
SIM,1861,22,20-24,1883,16
SIM,1856,3,na,1859,2567
STAT,1880,36,40-44,1916,4.566397076255535
SIM,1861,68,na,1929,1395
SIM,1865,12,na,1877,1931
STAT,1900,32,20-24,1932,3.7445078762087203
SIM,1878,22,25-29,1900,1109
STAT,1818,39,30-34,1857,11.530177821103049
SIM,1870,64,na,1934,521
SIM,1791,69,na,1860,859
STAT,1927,17,50-100,1944,0.46204501648129354
STAT,1884,59,na,1943,1860.4245848410635
STAT,1900,42,na,1942,3208.828610102448
STAT,1904,33,35-39,1937,8.272753093461553
STAT,1860,12,na,1872,2246.07966551379
STAT,1843,44,30-34,1887,1.139974299476976
STAT,1891,45,15-19,1936,2.8023376881508203E-4
STAT,1961,10,na,1971,5029.654903919528
STAT,1898,34,45-49,1932,2.324870488264489
SIM,1845,72,na,1917,553
STAT,1847,86,na,1933,200.60201991505443
STAT,1918,20,15-19,1938,5.697553761404279
STAT,1871,53,40-44,1924,0.01033317218542268
SIM,1846,20,20-24,1866,21
STAT,1828,42,15-19,1870,0.0172688483801159
STAT,1895,33,15-19,1928,0.18447245083750605
STAT,1857,23,35-39,1880,5.132386786888796
STAT,1795,68,na,1863,869.4005566110864
SIM,1926,39,35-39,1965,5
STAT,1840,19,45-49,1859,0.03291059934992059
STAT,1883,32,50-100,1915,0.8814677997755446
SIM,1851,44,30-34,1895,1
SIM,1829,43,50-100,1872,8
STAT,1913,46,15-19,1959,3.5591778006045457E-4
STAT,1907,48,50-100,1955,0.19960168977842033
STAT,1906,46,15-19,1952,3.276605229164537E-4
STAT,1903,56,na,1959,2977.0612007708073
STAT,1946,15,35-39,1961,4.606273224737884
STAT,1864,23,35-39,1887,5.351677821718639
SIM,1839,43,45-49,1882,1
STAT,1824,39,na,1863,551.6028307922862
STAT,1839,38,na,1877,2353.3661793260735
STAT,1821,52,30-34,1873,0.006143695589144201
STAT,1885,26,na,1911,2353.881764898866
STAT,1802,107,na,1909,0.002389418922402435
STAT,1852,30,15-19,1882,0.1515319875479196
STAT,1900,45,na,1945,3148.328758262768
STAT,1893,20,35-39,1913,7.340970784824608
STAT,1841,48,20-24,1889,0.01325248020692986
STAT,1918,39,35-39,1957,2.509676050590799
SIM,1908,37,na,1945,2522
STAT,1881,17,40-44,1898,0.17272409441222264
STAT,1935,24,30-34,1959,38.83036704895509
STAT,1854,17,50-100,1871,0.03258595840485079
STAT,1845,20,na,1865,1336.2521606855844
STAT,1908,17,30-34,1925,2.3460524268009872
STAT,1852,18,50-100,1870,0.059292876212939556
STAT,1830,48,45-49,1878,0.19911758044076597
SIM,1857,60,na,1917,1397
STAT,1913,32,30-34,1945,15.478544403541619
STAT,1802,58,na,1860,1473.1250776461393
STAT,1929,22,40-44,1951,4.222176698033511
STAT,1863,106,na,1969,0.11513788141497998
STAT,1888,17,35-39,1905,0.633300176074525
STAT,1859,36,15-19,1895,0.044721909064028974
STAT,1839,40,25-29,1879,0.7089197634725958
STAT,1907,30,40-44,1937,3.6625649509162606
STAT,1911,33,35-39,1944,8.761250014150708
STAT,1857,26,na,1883,1899.9357085123588
STAT,1888,18,na,1906,2907.32571862002
STAT,1848,34,na,1882,2321.0541191125158
SIM,1891,41,na,1932,2026
STAT,1824,33,40-44,1857,1.8399100772776458
STAT,1904,43,45-49,1947,0.14741141629900076
STAT,1880,54,50-100,1934,0.01524782484497155
STAT,1892,31,50-100,1923,1.139033834409818
STAT,1818,52,50-100,1870,0.025843704780052656
SIM,1807,49,30-34,1856,1
SIM,1892,26,na,1918,3671
STAT,1820,45,40-44,1865,0.27627423499247766
STAT,1928,43,30-34,1971,0.16148509399941377
STAT,1936,16,50-100,1952,0.3560059882778682
STAT,1920,16,35-39,1936,4.6587022906987
STAT,1867,41,15-19,1908,0.0131194661054038
SIM,1862,46,40-44,1908,2
STAT,1854,42,25-29,1896,0.35661107553294624
SIM,1870,42,na,1912,1811
STAT,1868,33,20-24,1901,2.599788067931459
SIM,1865,49,na,1914,1698
STAT,1854,46,40-44,1900,0.09546048928508119
STAT,1881,30,na,1911,2271.6215227257735
SIM,1840,49,50-100,1889,2
SIM,1859,29,40-44,1888,3
SIM,1810,44,na,1854,3125
STAT,1912,32,50-100,1944,0.8041087228564372
STAT,1782,80,na,1862,760.3394806059374
STAT,1946,25,45-49,1971,1.905311683836361
STAT,1851,25,15-19,1876,0.42564602466213874
SIM,1924,24,20-24,1948,2
STAT,1852,41,50-100,1893,1.0682234025840165
STAT,1880,41,15-19,1921,0.014401606421868319
SIM,1901,42,na,1943,3386
STAT,1880,22,15-19,1902,3.4248964832641016
STAT,1898,24,35-39,1922,7.7979440416686385
STAT,1829,37,40-44,1866,2.2201992952494973
SIM,1894,55,na,1949,1169
STAT,1869,25,50-100,1894,0.6498812977002575
STAT,1838,20,20-24,1858,38.72009794773902
STAT,1916,24,20-24,1940,114.20809364204973
STAT,1801,73,na,1874,454.33935116204265
STAT,1859,74,na,1933,879.6102309540586
STAT,1811,48,35-39,1859,0.6475510671420255
STAT,1896,28,40-44,1924,3.934938185344996
STAT,1870,15,15-19,1885,6.043694530635355
SIM,1910,56,na,1966,3678
STAT,1874,63,na,1937,1841.520660112549
STAT,1882,49,20-24,1931,0.011249043591572033
STAT,1848,12,na,1860,2769.2696789538227
STAT,1893,31,15-19,1924,0.1788125247168924
STAT,1925,46,50-100,1971,0.2722428789400153
STAT,1912,30,na,1942,3707.851188826093
STAT,1920,22,20-24,1942,122.02784366435571
SIM,1886,11,na,1897,3155
STAT,1856,48,50-100,1904,0.1741865620426674
STAT,1903,28,35-39,1931,13.648549529338586
SIM,1933,26,20-24,1959,1
STAT,1922,29,15-19,1951,0.7842719176479948
STAT,1838,75,na,1913,439.03700174095485
SIM,1845,18,25-29,1863,19
STAT,1832,50,25-29,1882,2.9482279886906734E-4
STAT,1889,22,35-39,1911,7.027231075251196
SIM,1809,65,na,1874,179
STAT,1833,35,na,1868,1123.9864413558691
STAT,1791,94,na,1885,5.55414758698135
STAT,1837,54,25-29,1891,0.002762003975851537
STAT,1871,34,40-44,1905,4.289025881671716
STAT,1939,32,na,1971,3816.486301597389
STAT,1861,46,40-44,1907,0.14278150962469016
STAT,1939,25,45-49,1964,1.7191784487654305
STAT,1904,19,na,1923,3588.9725120441663
STAT,1925,26,20-24,1951,21.43605104958976
STAT,1879,34,35-39,1913,10.299803499625611
STAT,1853,64,na,1917,1347.9034663928014
STAT,1874,30,35-39,1904,10.535818788751406
STAT,1866,17,15-19,1883,5.560283998358003
SIM,1931,0,na,1931,5883
STAT,1837,18,25-29,1855,6.020141495367124
STAT,1869,11,na,1880,2696.0593771437334
STAT,1832,49,50-100,1881,0.019781468128968676
STAT,1836,49,na,1885,1756.3679428569642
SIM,1828,57,na,1885,1596
SIM,1890,19,na,1909,3784
STAT,1886,23,50-100,1909,0.4209825306915179
STAT,1809,52,15-19,1861,2.0311921164283485E-4
STAT,1827,32,20-24,1859,2.7826848025204267
STAT,1900,37,15-19,1937,0.016790308780701285
STAT,1936,0,na,1936,4270.392879148132
SIM,1922,41,na,1963,3335
STAT,1816,72,na,1888,1132.470642712727
STAT,1885,45,15-19,1930,3.9709924281577686E-4
STAT,1913,45,45-49,1958,0.21045677645806715
STAT,1911,39,40-44,1950,1.4152185238454726
STAT,1893,30,45-49,1923,2.1982269237597833
STAT,1801,95,na,1896,4.41077010042451
STAT,1924,33,na,1957,4367.338469411621
SIM,1942,18,na,1960,2833
SIM,1869,85,na,1954,2525
SIM,1940,2,na,1942,4541
STAT,1919,41,30-34,1960,0.1369012294478538
STAT,1855,27,40-44,1882,2.0665021710730422
STAT,1926,41,30-34,1967,0.15648148174517015
SIM,1846,20,na,1866,1345
STAT,1891,24,40-44,1915,2.546477816962302
STAT,1894,23,20-24,1917,87.36237472998225
STAT,1863,48,40-44,1911,0.1443190953772999
STAT,1845,40,25-29,1885,0.33290832737966874
STAT,1911,20,20-24,1931,104.89078490731627
STAT,1941,21,45-49,1962,1.1499378755881613
STAT,1875,19,15-19,1894,6.0612262905188325
STAT,1869,43,15-19,1912,0.01383458373548573
STAT,1896,69,na,1965,2189.698876460761
STAT,1945,2,na,1947,4368.228084939688
STAT,1852,110,na,1962,0.0010003421576762264
STAT,1857,33,45-49,1890,1.3324949203801475
STAT,1876,43,15-19,1919,0.013859620366390962
STAT,1850,26,15-19,1876,0.24832547193348362
STAT,1867,34,45-49,1901,1.635065407526819
SIM,1857,54,na,1911,1397
STAT,1862,7,na,1869,2414.4851697056297
SIM,1876,47,40-44,1923,1
STAT,1893,42,45-49,1935,1.86928594307802
STAT,1890,16,45-49,1906,0.07927412081901257
STAT,1888,24,35-39,1912,6.692936388141768
STAT,1872,15,40-44,1887,0.1859380867932504
STAT,1905,48,20-24,1953,0.009613658083275085
SIM,1825,40,40-44,1865,3
STAT,1913,24,40-44,1937,3.3317290389877128
STAT,1894,35,15-19,1929,0.07208761187516609
STAT,1840,22,40-44,1862,1.0434437047204603
STAT,1884,31,40-44,1915,4.168384324164783
STAT,1915,21,40-44,1936,3.436879171298679
STAT,1873,29,20-24,1902,11.947875274777068
STAT,1886,11,na,1897,2678.308261445438
STAT,1829,41,15-19,1870,0.006741733944934345
STAT,1862,42,15-19,1904,0.011747916973442315
STAT,1836,51,30-34,1887,0.004707511682731404
STAT,1920,38,45-49,1958,0.7360610738365081
SIM,1880,66,na,1946,3193
STAT,1897,19,35-39,1916,0.7248062967561879
SIM,1853,64,na,1917,2608
STAT,1915,13,na,1928,4068.702795852926
STAT,1820,77,na,1897,594.4529335012439
STAT,1878,52,20-24,1930,7.551808205827147E-4
STAT,1824,67,na,1891,306.7772490989421
STAT,1911,23,na,1934,3567.4002875317024
STAT,1854,52,35-39,1906,0.004761306572485485
STAT,1857,15,45-49,1872,0.05961549369695148
STAT,1911,27,40-44,1938,4.494314722515856
SIM,1922,35,na,1957,3354
STAT,1819,38,30-34,1857,1.3054549358537018
STAT,1909,24,20-24,1933,101.65336317652678
STAT,1884,48,35-39,1932,0.1323341932936956
STAT,1864,95,na,1959,20.765369545112506
STAT,1845,28,30-34,1873,15.100276584765185
STAT,1843,49,30-34,1892,0.0936457833179057
SIM,1797,60,na,1857,1587
STAT,1847,41,35-39,1888,1.6675462635564675
STAT,1896,32,15-19,1928,0.18772587276325592
STAT,1866,18,20-24,1884,16.51263297160432
STAT,1923,28,15-19,1951,0.7991616097809233
STAT,1826,51,45-49,1877,0.020451429846032432
STAT,1950,10,na,1960,4601.691584227746
STAT,1925,43,na,1968,4448.241231865051
SIM,1878,44,40-44,1922,11
SIM,1892,51,na,1943,3507
STAT,1855,18,45-49,1873,0.051118252079056944
STAT,1878,16,na,1894,2604.90044561548
STAT,1782,100,na,1882,0.677476626185008
SIM,1908,40,50-100,1948,8
SIM,1848,18,na,1866,2622
STAT,1782,98,na,1880,1.807740308933951
STAT,1865,37,45-49,1902,1.8200355569676652
SIM,1855,41,35-39,1896,5
STAT,1883,48,50-100,1931,0.23330896959811698
STAT,1827,44,15-19,1871,0.012757925962104032
SIM,1839,40,40-44,1879,22
STAT,1883,62,na,1945,1758.3563058889424
SIM,1840,28,20-24,1868,151
STAT,1813,51,35-39,1864,0.030535033736098376
SIM,1896,41,na,1937,3307
SIM,1934,20,na,1954,5258
STAT,1922,17,45-49,1939,0.5716763346207228
STAT,1843,47,35-39,1890,0.13768137913177952
SIM,1837,43,40-44,1880,1
STAT,1850,75,na,1925,475.36611690504424
SIM,1827,38,30-34,1865,2
STAT,1834,25,20-24,1859,6.878008803986362
STAT,1872,23,50-100,1895,0.4070830525193601
STAT,1931,38,20-24,1969,0.3463126689878465
STAT,1898,31,40-44,1929,5.855487342311602
STAT,1832,28,20-24,1860,14.054030439795874
STAT,1876,37,20-24,1913,0.7792573318050598
STAT,1896,34,40-44,1930,5.667839026662174
STAT,1821,46,45-49,1867,0.2558105015045455
SIM,1930,30,na,1960,5345
STAT,1882,52,40-44,1934,0.010025622458387569
STAT,1879,37,45-49,1916,2.0449980903707683
STAT,1817,40,40-44,1857,1.7074584954298933
STAT,1863,26,25-29,1889,36.37441138698234
STAT,1924,33,50-100,1957,0.9547425844107505
SIM,1905,63,na,1968,2259
SIM,1917,22,25-29,1939,602
STAT,1807,83,na,1890,160.95958672252706
STAT,1871,31,30-34,1902,17.48800603646633
STAT,1827,28,50-100,1855,0.7474762863422316
STAT,1886,29,30-34,1915,25.890740745843832
STAT,1794,83,na,1877,1.697999525233616
STAT,1853,34,15-19,1887,0.11137393320122838
STAT,1847,23,35-39,1870,6.42136936797957
STAT,1868,47,40-44,1915,0.1645861874686675
STAT,1826,33,15-19,1859,0.26483488791614457
SIM,1851,47,35-39,1898,1
STAT,1923,46,15-19,1969,4.274559110392583E-4
SIM,1909,53,na,1962,3730
STAT,1849,40,50-100,1889,0.9057152894623324
STAT,1861,29,25-29,1890,34.92824298229895
SIM,1844,28,na,1872,2978
STAT,1929,33,na,1962,4767.420199192298
STAT,1925,25,15-19,1950,0.8317884109346584
SIM,1886,34,20-24,1920,5
STAT,1845,46,30-34,1891,0.048170183647285994
STAT,1849,90,na,1939,66.43042151320388
STAT,1831,49,na,1880,1840.3917987544917
STAT,1860,45,15-19,1905,3.2956982929392985E-4
STAT,1880,42,35-39,1922,1.8775899179028042
STAT,1882,21,35-39,1903,5.603815973187809
STAT,1847,25,30-34,1872,27.76246958568794
SIM,1847,47,50-100,1894,4
STAT,1845,44,35-39,1889,0.8918687915257596
SIM,1849,59,na,1908,1530
STAT,1858,26,15-19,1884,0.3572514331429958
SIM,1926,25,na,1951,5978
STAT,1912,43,35-39,1955,0.19080395855384719
STAT,1867,52,45-49,1919,0.013651761949444402
STAT,1878,34,20-24,1912,2.757283357459989
SIM,1874,26,na,1900,2575
STAT,1841,39,na,1880,2752.2900478129877
STAT,1855,31,15-19,1886,0.09696822949687975
STAT,1829,32,50-100,1861,0.5051659675062772
STAT,1907,18,na,1925,3675.449010070976
SIM,1855,25,30-34,1880,152
SIM,1959,12,na,1971,5256
STAT,1918,3,na,1921,4355.244796908841
STAT,1786,88,na,1874,87.97836069943698
STAT,1801,98,na,1899,1.0776974923850737
SIM,1846,82,na,1928,319
SIM,1865,30,40-44,1895,3
STAT,1827,46,40-44,1873,0.15877022658950846
STAT,1950,17,20-24,1967,158.77916904352136
SIM,1833,41,50-100,1874,1
SIM,1868,38,na,1906,1169
STAT,1830,33,35-39,1863,9.414139526411972
STAT,1866,62,na,1928,1668.3871894809483
STAT,1844,46,40-44,1890,0.17008748134478718
STAT,1880,24,35-39,1904,6.020204670221993
SIM,1884,24,15-19,1908,30
STAT,1860,18,25-29,1878,5.300250501375294
STAT,1903,32,30-34,1935,24.78426464888561
STAT,1876,24,15-19,1900,3.314132147237267
STAT,1824,36,45-49,1860,0.3113842785236819
STAT,1917,48,40-44,1965,0.1620296543102117
STAT,1908,31,na,1939,3556.8193179471946
SIM,1869,79,na,1948,3268
STAT,1862,47,45-49,1909,0.20007375869411573
STAT,1866,90,na,1956,81.1011267581355
STAT,1846,110,na,1956,1.7642331070975042E-4
STAT,1923,48,na,1971,4240.661326941896
STAT,1812,42,na,1854,254.8428654774421
SIM,1921,42,40-44,1963,3
STAT,1891,27,45-49,1918,1.3653716692451516
STAT,1860,30,40-44,1890,3.5662971749005643
SIM,1873,13,na,1886,2483
STAT,1835,39,25-29,1874,2.637878515160403
STAT,1897,54,na,1951,2780.9598678262764
SIM,1837,46,na,1883,1893
STAT,1855,36,45-49,1891,1.3257123704472722
STAT,1813,83,na,1896,290.80331356476023
STAT,1848,22,40-44,1870,2.374294537896791
STAT,1919,25,50-100,1944,1.0683835599985585
SIM,1842,21,na,1863,3346
SIM,1920,40,na,1960,3736
STAT,1935,33,na,1968,5191.57315712822
STAT,1891,27,15-19,1918,0.5579310566481189
SIM,1838,16,na,1854,2487
STAT,1829,46,45-49,1875,0.11058628652083564
STAT,1788,83,na,1871,53.62398625443526
STAT,1870,50,25-29,1920,0.0035818941119529282
STAT,1894,37,40-44,1931,5.566688823259755
STAT,1905,32,35-39,1937,8.36377875585694
STAT,1838,49,20-24,1887,0.005136752934052758
STAT,1844,47,25-29,1891,0.05679764601985202
STAT,1849,20,35-39,1869,6.031008152357459
STAT,1837,33,20-24,1870,2.6893796479533947
SIM,1910,10,na,1920,4577
STAT,1839,47,15-19,1886,3.78638961985178E-4
STAT,1850,44,45-49,1894,0.681762620541744
STAT,1848,40,40-44,1888,2.1567859809042442
STAT,1824,36,15-19,1860,0.008771389170560214
STAT,1899,42,40-44,1941,0.21307806763847692
STAT,1837,51,20-24,1888,6.057114479636751E-4
STAT,1852,70,na,1922,1412.317556937534
STAT,1933,17,20-24,1950,180.2554970110599
STAT,1928,38,45-49,1966,0.8541357313160444
STAT,1886,47,30-34,1933,0.09977391991998921
STAT,1809,49,25-29,1858,0.4846071266941834
STAT,1926,38,40-44,1964,1.8119988875251405
STAT,1820,43,20-24,1863,0.25756201307951665
STAT,1845,29,na,1874,1287.886969793024
STAT,1800,57,na,1857,1794.1698834042384
STAT,1881,53,35-39,1934,0.007999410807476707
SIM,1830,36,na,1866,652
STAT,1867,34,15-19,1901,0.13352614867132734
STAT,1913,27,50-100,1940,0.9793320108377915
STAT,1843,34,na,1877,2521.3944372251344
SIM,1871,23,20-24,1894,794
STAT,1839,29,na,1868,2495.6955553154257
SIM,1938,22,na,1960,3622
STAT,1878,19,25-29,1897,5.799055720790635
STAT,1886,45,35-39,1931,0.14642237282773085
STAT,1899,1,na,1900,3717.7084026590987
STAT,1913,42,40-44,1955,0.24085736886425219
STAT,1896,37,45-49,1933,2.627871248316644
STAT,1939,22,35-39,1961,9.352317672727384
STAT,1922,7,na,1929,4574.5524868642015
STAT,1829,28,45-49,1857,0.7400446347546001
STAT,1907,27,20-24,1934,17.117323783267764
SIM,1936,7,na,1943,4057
STAT,1869,45,35-39,1914,0.14267987972643154
STAT,1889,46,50-100,1935,0.2965973742170306
SIM,1789,65,na,1854,303
SIM,1855,4,na,1859,3430
STAT,1870,34,20-24,1904,2.67169728479874
STAT,1853,36,40-44,1889,3.429694954676382
STAT,1861,17,50-100,1878,0.04683022974590875
STAT,1815,45,50-100,1860,0.025565027389087662
STAT,1868,97,na,1965,19.267256644836998
STAT,1881,23,40-44,1904,1.9617595936241805
STAT,1917,48,na,1965,3775.5483993749945
STAT,1885,48,25-29,1933,0.05590647694366714
STAT,1918,16,40-44,1934,0.3020621364139226
STAT,1908,19,50-100,1927,0.0717255293286342
STAT,1933,35,50-100,1968,0.5689742549645387
SIM,1890,56,na,1946,3139
STAT,1840,20,15-19,1860,1.6759289064042742
STAT,1857,30,40-44,1887,3.418638483891119
STAT,1861,44,20-24,1905,0.13029296489988576
STAT,1841,54,45-49,1895,0.01571611314703076
STAT,1819,54,35-39,1873,0.0014616177997627561
STAT,1873,15,30-34,1888,1.6543901206481082
STAT,1879,32,15-19,1911,0.14608746587564414
STAT,1937,28,45-49,1965,1.6658528636054684
STAT,1875,26,20-24,1901,12.087807153961345
STAT,1818,39,25-29,1857,6.228946604793771
STAT,1896,19,45-49,1915,0.08564820591071451
STAT,1824,54,45-49,1878,0.0023526109675633205
STAT,1880,26,na,1906,2486.0821274838436
SIM,1884,56,na,1940,3654
STAT,1868,15,20-24,1883,17.640702131724506
STAT,1918,46,35-39,1964,0.1356873868034636
STAT,1924,27,20-24,1951,21.04951724373716
STAT,1923,39,50-100,1962,0.4803374766598822
SIM,1793,70,na,1863,863
SIM,1932,27,20-24,1959,215
STAT,1849,39,25-29,1888,2.4314054040897513
STAT,1801,70,na,1871,603.7706119170429
STAT,1826,62,na,1888,1493.1828364139471
STAT,1843,30,40-44,1873,5.259333014911029
STAT,1847,39,20-24,1886,0.7082415541603603
STAT,1854,33,20-24,1887,1.5232109442549953
SIM,1876,15,20-24,1891,10
SIM,1887,34,50-100,1921,123
STAT,1838,36,45-49,1874,1.0375567422808714
STAT,1891,45,45-49,1936,0.1653380627631433
SIM,1849,31,na,1880,2356
STAT,1830,35,30-34,1865,4.96327894399939
STAT,1833,75,na,1908,423.5589937619616
STAT,1855,59,na,1914,1286.255455500133
SIM,1859,15,20-24,1874,115
SIM,1917,20,na,1937,2333
STAT,1877,62,na,1939,1855.367070013678
STAT,1878,87,na,1965,378.98984596248226
STAT,1823,38,20-24,1861,1.4116307509160144
STAT,1930,24,40-44,1954,4.250384177232935
SIM,1882,45,45-49,1927,1
STAT,1847,28,35-39,1875,10.410228034317539
SIM,1881,31,35-39,1912,1
STAT,1846,41,15-19,1887,0.00838477571995697
STAT,1890,29,20-24,1919,14.100674555183856
STAT,1848,46,50-100,1894,0.23047874936675317
STAT,1868,18,25-29,1886,5.539605461959517
STAT,1868,25,50-100,1893,0.6220520028795129
STAT,1840,25,45-49,1865,0.5530211859694611
STAT,1833,26,15-19,1859,0.28790394192728147
STAT,1897,16,30-34,1913,2.121940160747121
STAT,1862,41,30-34,1903,0.9836503351386352
STAT,1855,90,na,1945,52.17956273557008
STAT,1864,26,45-49,1890,1.0128473360890113
STAT,1943,23,50-100,1966,0.6918419982710161
STAT,1837,65,na,1902,1355.0687485918484
SIM,1838,25,30-34,1863,156
STAT,1861,26,20-24,1887,9.8983310426779
SIM,1862,13,na,1875,3855
STAT,1885,47,40-44,1932,0.16749639581448095
STAT,1966,2,na,1968,4865.676550574761
STAT,1838,18,45-49,1856,0.03661590024154392
STAT,1855,15,40-44,1870,0.14569035607577896
STAT,1873,31,35-39,1904,10.430590465594582
STAT,1845,60,na,1905,946.3749975584241
STAT,1874,15,45-49,1889,0.06798316839184387
STAT,1862,28,30-34,1890,21.372958512108276
SIM,1850,28,na,1878,1847
SIM,1853,3,na,1856,3646
STAT,1928,27,50-100,1955,1.2169370749630113
SIM,1855,28,35-39,1883,1
STAT,1874,45,45-49,1919,0.24599596215282324
STAT,1839,47,45-49,1886,0.22339717560087105
SIM,1826,62,na,1888,1370
STAT,1846,26,25-29,1872,30.527701560199795
SIM,1880,26,na,1906,3275
STAT,1874,97,na,1971,34.38757795798008
STAT,1844,29,25-29,1873,50.56786244290564
STAT,1871,36,30-34,1907,5.342074900680123
STAT,1939,33,50-100,1972,0.833803674256792
STAT,1858,3,na,1861,2520.364105904112
STAT,1851,69,na,1920,1159.0548676468409
STAT,1865,19,15-19,1884,5.517769822947183
STAT,1865,77,na,1942,789.1823091052022
STAT,1934,15,15-19,1949,61.25315966292723
STAT,1942,25,15-19,1967,0.733110629247928
STAT,1872,62,na,1934,1830.2161103482285
STAT,1807,54,45-49,1861,0.044371944504294325
STAT,1821,43,40-44,1864,2.487445378606487
STAT,1902,46,na,1948,3177.7223935695188
STAT,1864,25,30-34,1889,23.137711539139087
STAT,1882,19,20-24,1901,16.88245257116047
STAT,1826,47,35-39,1873,0.20035289875772877
STAT,1850,26,45-49,1876,0.6077033355462585
STAT,1922,29,50-100,1951,1.1057746701338218
SIM,1844,38,30-34,1882,1
SIM,1852,82,na,1934,1138
SIM,1938,8,na,1946,4264
STAT,1868,48,25-29,1916,0.05493511576902616
STAT,1842,80,na,1922,153.5631081132292
SIM,1837,46,45-49,1883,1
STAT,1944,22,15-19,1966,5.682816176997821
SIM,1898,19,20-24,1917,132
SIM,1892,11,na,1903,3699
STAT,1891,69,na,1960,1940.0874640412737
STAT,1870,19,25-29,1889,5.636179643424008
STAT,1813,103,na,1916,0.10512849053514975
STAT,1881,21,15-19,1902,3.124831713027323
SIM,1863,54,na,1917,232
SIM,1949,22,na,1971,3190
SIM,1855,59,na,1914,2860
STAT,1814,77,na,1891,585.0072485359855
SIM,1837,35,50-100,1872,2
SIM,1885,37,40-44,1922,7
STAT,1820,46,25-29,1866,0.09172267272072783
SIM,1867,44,na,1911,2085
STAT,1834,40,50-100,1874,0.5758612198971753
STAT,1825,49,na,1874,1547.1580315014119
STAT,1838,31,15-19,1869,0.07632763388421177
SIM,1804,59,na,1863,845
STAT,1867,16,15-19,1883,5.771636420173597
STAT,1888,29,35-39,1917,11.056848730519043
STAT,1871,32,15-19,1903,0.14205786776114224
SIM,1840,30,35-39,1870,43
STAT,1838,35,30-34,1873,2.802856816239274
STAT,1874,27,15-19,1901,0.4682511975618642
SIM,1878,47,45-49,1925,6
STAT,1844,31,50-100,1875,1.0968046503398785
SIM,1914,40,na,1954,4878
STAT,1908,25,15-19,1933,0.672345689808265
STAT,1895,19,30-34,1914,2.0623015635799575
STAT,1919,45,40-44,1964,0.16952995000685822
STAT,1893,38,35-39,1931,8.801014425475726
STAT,1839,29,15-19,1868,0.5234220278734506
STAT,1858,95,na,1953,10.153327971455347
SIM,1909,25,na,1934,3944
STAT,1872,18,45-49,1890,0.06523993933305457
STAT,1867,16,na,1883,2456.273587973561
STAT,1872,16,25-29,1888,5.726829252261252
STAT,1834,28,25-29,1862,24.270431217567495
STAT,1828,28,30-34,1856,46.980213876373085
STAT,1796,78,na,1874,558.8663666754023
STAT,1866,20,35-39,1886,5.448183816656122
STAT,1793,98,na,1891,0.5401088548288719
STAT,1911,51,na,1962,3394.9964417737756
SIM,1901,46,35-39,1947,1
STAT,1914,22,35-39,1936,9.486009505875888
STAT,1826,51,50-100,1877,0.021283352381086158
STAT,1821,40,30-34,1861,1.3440356364837538
STAT,1906,36,na,1942,3455.0932371241256
STAT,1836,38,30-34,1874,4.961021055680626
SIM,1880,16,25-29,1896,7
SIM,1861,28,na,1889,2339
STAT,1916,17,15-19,1933,9.497398490726745
STAT,1862,44,40-44,1906,1.8899407980786587
STAT,1903,35,35-39,1938,2.1876463947041933
STAT,1854,36,25-29,1890,1.608589676369446
STAT,1828,38,50-100,1866,1.6148697577327835
STAT,1870,36,40-44,1906,4.385082132618091
SIM,1890,38,50-100,1928,4
STAT,1898,29,20-24,1927,15.662729269572546
SIM,1902,15,na,1917,3680
STAT,1889,59,na,1948,2340.368144266114
STAT,1866,50,35-39,1916,0.007971440441716285
STAT,1831,47,45-49,1878,0.22254850571401705
STAT,1860,15,20-24,1875,16.87848366825953
SIM,1914,31,40-44,1945,89
SIM,1939,4,na,1943,4904
STAT,1832,30,35-39,1862,1.6389845627845017
STAT,1880,21,30-34,1901,18.54772970310067
STAT,1887,40,25-29,1927,0.7139369478610589
STAT,1800,85,na,1885,156.6879432974653
STAT,1864,21,15-19,1885,3.069430572733929
SIM,1843,34,na,1877,284
STAT,1827,49,45-49,1876,0.21056862771984047
SIM,1832,31,na,1863,2304
STAT,1854,18,30-34,1872,1.0538858962394637
STAT,1887,27,25-29,1914,46.56003979641514
STAT,1826,93,na,1919,23.299538532582343
STAT,1829,43,40-44,1872,1.0664558289522625
STAT,1813,49,15-19,1862,0.0014130387290718482
STAT,1875,40,50-100,1915,1.0957661955230595
SIM,1862,36,25-29,1898,2
STAT,1809,46,20-24,1855,0.10797046645993225
STAT,1893,24,15-19,1917,4.0996948411395655
STAT,1909,22,25-29,1931,84.97541399058063
SIM,1903,43,35-39,1946,2
STAT,1835,54,20-24,1889,5.469009043117131E-4
SIM,1852,7,na,1859,2713
STAT,1818,67,na,1885,1039.0755658644148
STAT,1842,48,50-100,1890,0.060202766059559806
STAT,1890,47,20-24,1937,0.008156396472979058
STAT,1913,58,na,1971,3358.8939935085987
STAT,1862,27,50-100,1889,0.546860831191851
STAT,1852,41,45-49,1893,1.5133164913306263
STAT,1835,39,na,1874,1962.2910612424134
STAT,1884,56,na,1940,1952.4853440053985
STAT,1927,21,30-34,1948,35.22836762226957
STAT,1852,23,45-49,1875,0.8278557532219336
STAT,1896,16,40-44,1912,0.24170021342364914
STAT,1921,49,15-19,1970,4.079412731467267E-4
SIM,1865,18,na,1883,1859
SIM,1866,41,40-44,1907,1
STAT,1896,41,na,1937,3071.097897166072
STAT,1913,18,na,1931,3889.161446944389
STAT,1947,22,50-100,1969,0.7358235891564456
SIM,1820,46,na,1866,514
STAT,1918,32,15-19,1950,0.13471209855609714
STAT,1877,52,30-34,1929,0.006010386495710138
STAT,1853,39,45-49,1892,1.5301700058488585
STAT,1882,38,50-100,1920,1.1696232684239831
STAT,1906,31,40-44,1937,3.620640488036824
STAT,1860,33,45-49,1893,1.4165931311308244
STAT,1929,15,35-39,1944,5.342325096776301
STAT,1881,26,45-49,1907,1.0521104902914094
SIM,1857,36,20-24,1893,4
STAT,1963,5,na,1968,4947.277605029806
STAT,1848,43,45-49,1891,1.3904007668032219
STAT,1802,52,na,1854,1658.7002329808936
SIM,1896,2,na,1898,4173
STAT,1819,39,45-49,1858,0.4543362297190851
STAT,1828,46,25-29,1874,0.06968732019497507
STAT,1829,25,40-44,1854,2.9964484707722585
SIM,1856,13,na,1869,1237
STAT,1895,59,na,1954,2528.1990240763175
STAT,1776,86,na,1862,127.84748449498157
STAT,1853,28,50-100,1881,0.5191368437456371
STAT,1830,31,15-19,1861,0.13516043199491862
STAT,1863,41,20-24,1904,0.13619410826105402
STAT,1847,24,na,1871,2335.905316344481
STAT,1873,18,35-39,1891,0.5613799792538253
STAT,1888,42,35-39,1930,2.0874024342890647
STAT,1911,45,40-44,1956,0.1482726806937778
STAT,1929,33,35-39,1962,11.519261462516152
SIM,1905,35,na,1940,3230
STAT,1875,29,25-29,1904,43.12685353211184
SIM,1850,6,na,1856,2512
SIM,1866,99,na,1965,27
STAT,1868,45,15-19,1913,3.9019974193434494E-4
STAT,1887,23,50-100,1910,0.4474570419032557
STAT,1861,47,25-29,1908,0.04767930936318606
STAT,1891,37,50-100,1928,1.5097905725286889
SIM,1862,18,30-34,1880,6
STAT,1833,49,50-100,1882,0.10937416583545974
STAT,1870,54,40-44,1924,0.010206747037816459
SIM,1848,46,na,1894,2307
STAT,1897,35,50-100,1932,1.645991273051537
STAT,1876,21,na,1897,2398.064807496895
STAT,1918,43,30-34,1961,0.13388268293496203
SIM,1854,26,25-29,1880,12
SIM,1927,19,na,1946,1930
SIM,1835,49,45-49,1884,2
STAT,1822,40,20-24,1862,0.29621915179920855
STAT,1853,103,na,1956,0.13507626130835768
STAT,1942,2,na,1944,4194.626798179047
STAT,1838,34,50-100,1872,0.476026909523422
STAT,1857,28,20-24,1885,9.205894928942621
STAT,1883,20,40-44,1903,2.016675379688741
SIM,1851,69,na,1920,979
STAT,1878,21,50-100,1899,0.4208297022597343
STAT,1849,36,20-24,1885,0.6715587355229798
STAT,1942,15,na,1957,3804.6121561515524
STAT,1881,50,30-34,1931,0.005702056924211937
STAT,1943,22,25-29,1965,97.15283000607934
STAT,1866,104,na,1970,0.6310557126494402
STAT,1871,77,na,1948,862.2688784816727
STAT,1864,39,20-24,1903,0.693730391356214
STAT,1826,33,45-49,1859,3.242978010275788
STAT,1852,23,15-19,1875,3.9165804255752
STAT,1829,39,na,1868,980.0533760321663
STAT,1879,36,30-34,1915,5.493607619610575
STAT,1879,19,45-49,1898,0.06665106505628497
STAT,1867,48,35-39,1915,0.1307385706562993
STAT,1932,21,40-44,1953,4.39424250202185
STAT,1926,24,20-24,1950,133.0916948431052
STAT,1848,25,45-49,1873,1.258367054445223
STAT,1872,48,45-49,1920,0.23335148418370477
SIM,1859,18,na,1877,2302
STAT,1841,51,40-44,1892,0.011779313435278733
STAT,1921,30,25-29,1951,10.245376840843639
STAT,1893,24,45-49,1917,0.866561028219719
STAT,1921,49,45-49,1970,0.2406855537375196
STAT,1918,19,45-49,1937,0.5335110263591754
SIM,1857,18,20-24,1875,2
STAT,1831,29,15-19,1860,0.500442732663896
STAT,1835,36,20-24,1871,0.7285869962798536
STAT,1849,18,20-24,1867,18.27908667325896
STAT,1855,33,40-44,1888,2.8922639008217135
SIM,1896,24,35-39,1920,9
SIM,1832,62,na,1894,729
SIM,1875,48,35-39,1923,6
SIM,1911,35,na,1946,2516
SIM,1925,16,20-24,1941,1750
STAT,1854,51,20-24,1905,4.122593357641343E-4
STAT,1913,39,15-19,1952,0.018524904889093682
STAT,1935,28,40-44,1963,6.30487051915412
STAT,1811,57,na,1868,1531.460400198219
STAT,1864,23,40-44,1887,1.911046462625514
STAT,1823,52,35-39,1875,0.012926137932134917
STAT,1842,24,50-100,1866,0.12585606981335656
STAT,1889,38,45-49,1927,2.3886995502971238
STAT,1844,26,20-24,1870,14.330450084023482
STAT,1845,29,45-49,1874,0.6610107005273762
STAT,1840,38,20-24,1878,0.35528772822640436
SIM,1879,38,na,1917,1222
STAT,1916,38,na,1954,3781.3064932073453
STAT,1947,17,15-19,1964,50.584109391551756
STAT,1837,62,na,1899,1465.5362624590832
STAT,1819,53,20-24,1872,1.2748118798218625E-4
SIM,1871,58,na,1929,1742
SIM,1883,43,na,1926,2174
STAT,1895,28,na,1923,3093.6343420977646
STAT,1803,109,na,1912,1.794668310996096E-4
SIM,1863,16,25-29,1879,20
STAT,1796,100,na,1896,0.4157611873972752
STAT,1874,57,na,1931,2074.0728550534186
SIM,1954,12,na,1966,5556
STAT,1837,53,40-44,1890,0.008305887126076982
SIM,1833,31,35-39,1864,4
STAT,1846,14,na,1860,1760.012428038506
STAT,1872,31,15-19,1903,0.14318404947544985
STAT,1943,24,20-24,1967,116.87344686837292
STAT,1857,45,45-49,1902,0.182902758186192
STAT,1848,19,15-19,1867,6.803405882871924
STAT,1917,16,20-24,1933,28.85595128955048
STAT,1856,32,na,1888,1734.9611759241718
STAT,1864,28,35-39,1892,8.74102311220041
SIM,1893,61,na,1954,1952
STAT,1855,16,25-29,1871,4.487212960703734
STAT,1932,24,45-49,1956,1.4610126313381384
STAT,1825,38,25-29,1863,4.043097332435411
STAT,1862,44,35-39,1906,1.5215256305786378
STAT,1951,20,na,1971,4325.322078636808
STAT,1829,30,na,1859,1061.1316408345076
STAT,1869,42,30-34,1911,1.1586811009513458
STAT,1934,24,50-100,1958,0.877684750927052
STAT,1923,18,50-100,1941,0.4341665548872425
STAT,1928,23,na,1951,4510.803644306364
STAT,1847,55,na,1902,1869.45489543704
SIM,1865,30,35-39,1895,45
STAT,1821,45,30-34,1866,0.1063420326040414
STAT,1895,37,25-29,1932,3.745468368270276
STAT,1891,38,na,1929,2882.8426804595
STAT,1876,38,35-39,1914,7.114608761382949
SIM,1853,43,20-24,1896,3
STAT,1850,44,na,1894,1052.836145381247
STAT,1883,17,15-19,1900,5.709294191725344
STAT,1905,51,na,1956,3129.723635713196
STAT,1917,34,20-24,1951,2.498513735864604
SIM,1836,52,na,1888,1555
STAT,1892,29,25-29,1921,51.998807658673364
SIM,1942,27,na,1969,3642
SIM,1853,33,na,1886,3252
SIM,1909,31,30-34,1940,2
STAT,1857,30,35-39,1887,7.983177502246827
STAT,1849,36,15-19,1885,0.048921503444849586
SIM,1923,20,na,1943,4291
STAT,1865,80,na,1945,564.7728880145171
STAT,1909,38,40-44,1947,1.3955726150085488
STAT,1884,87,na,1971,432.24104129623163
STAT,1915,18,15-19,1933,9.339772260209484
SIM,1889,31,na,1920,3840
SIM,1911,21,15-19,1932,9
SIM,1860,18,na,1878,2431
STAT,1930,39,45-49,1969,0.8810875728938337
STAT,1869,17,30-34,1886,1.6306163667128166
STAT,1825,31,35-39,1856,18.63585138381917
STAT,1870,16,20-24,1886,17.9482396234338
STAT,1833,26,45-49,1859,0.7045599650485718
STAT,1892,40,35-39,1932,2.2645795292444317
STAT,1939,20,45-49,1959,1.1183441649231152
SIM,1856,44,na,1900,481
STAT,1884,34,15-19,1918,0.13515579281103898
STAT,1851,28,25-29,1879,38.8368393172014
STAT,1852,101,na,1953,0.5743828191488631
STAT,1853,50,25-29,1903,0.002785904211926987
SIM,1844,56,na,1900,1796
SIM,1927,10,na,1937,1973
STAT,1817,43,15-19,1860,0.009966757490247318
STAT,1871,19,45-49,1890,0.06481259791284794
STAT,1919,41,25-29,1960,0.07646735369815345
STAT,1922,44,35-39,1966,0.22778952928323676
SIM,1894,1,na,1895,1883
STAT,1853,38,30-34,1891,4.111997205703262
STAT,1839,32,40-44,1871,4.958267869593678
STAT,1859,26,50-100,1885,0.5194970413732887
STAT,1873,16,na,1889,2606.0650292405303
STAT,1903,21,15-19,1924,4.697139996720526
STAT,1888,33,50-100,1921,1.053034720693696
STAT,1821,43,35-39,1864,2.002555795431131
SIM,1827,53,20-24,1880,1
STAT,1889,26,45-49,1915,1.3416432140684027
STAT,1857,54,na,1911,1606.821823773394
STAT,1869,47,25-29,1916,0.057852143016485356
STAT,1886,42,na,1928,2390.4578926766158
STAT,1892,22,35-39,1914,7.224871873199173
STAT,1889,44,45-49,1933,1.7779639893938965
STAT,1922,32,35-39,1954,10.210061658654723
STAT,1890,43,35-39,1933,2.176348472469024
STAT,1882,49,15-19,1931,3.749677898846238E-4
SIM,1846,38,35-39,1884,4
STAT,1886,44,20-24,1930,0.16223896530031326
STAT,1901,61,na,1962,2769.419100801114
SIM,1852,51,na,1903,1883
STAT,1888,36,50-100,1924,1.4238363092174067
STAT,1910,10,na,1920,3881.17421531978
STAT,1864,34,50-100,1898,0.8258329591119611
STAT,1806,70,na,1876,602.4799786085315
STAT,1868,45,20-24,1913,0.01170600255501999
STAT,1862,46,30-34,1908,0.08268261793048128
STAT,1834,29,na,1863,1232.2184477904646
SIM,1805,60,na,1865,2097
STAT,1912,22,30-34,1934,27.224459703074107
STAT,1839,47,50-100,1886,0.2324845179553603
STAT,1839,50,40-44,1889,0.010024255689019311
SIM,1855,21,15-19,1876,4
STAT,1838,38,35-39,1876,3.6056051095056776
STAT,1869,29,30-34,1898,25.228984507657138
STAT,1841,50,50-100,1891,0.017059573823046396
SIM,1873,44,na,1917,2113
STAT,1848,37,15-19,1885,0.054151757786803915
STAT,1877,39,30-34,1916,5.355711970977749
STAT,1893,44,50-100,1937,0.09050311752799463
STAT,1833,22,50-100,1855,0.3810816371269754
STAT,1825,41,50-100,1866,1.4279127376820022
STAT,1839,44,50-100,1883,1.0083022960516155
STAT,1822,42,40-44,1864,4.0101919041222205
STAT,1823,45,na,1868,2111.4056657585274
STAT,1894,39,30-34,1933,6.70919154066356
STAT,1826,30,40-44,1856,10.366353908438285
STAT,1870,39,45-49,1909,1.9673709206412042
STAT,1849,50,na,1899,1840.3130257102205
STAT,1841,48,15-19,1889,4.4174895165356595E-4
SIM,1921,25,na,1946,5272
STAT,1827,48,30-34,1875,0.0874885986559843
STAT,1906,34,45-49,1940,1.4375439185783159
SIM,1874,6,na,1880,2818
STAT,1795,101,na,1896,0.13910071449447456
SIM,1903,40,30-34,1943,2
STAT,1835,37,35-39,1872,6.616090049618638
STAT,1860,6,na,1866,2347.245052151274
SIM,1861,59,na,1920,1689
SIM,1860,74,na,1934,1638
STAT,1833,44,45-49,1877,0.7583527822855864
STAT,1831,44,40-44,1875,2.1400891438319625
SIM,1876,43,25-29,1919,9
STAT,1888,46,na,1934,2604.057027294054
STAT,1912,40,30-34,1952,0.12325228531625791
STAT,1868,43,25-29,1911,0.6157602841425809
STAT,1939,6,na,1945,3959.270864202654
STAT,1898,28,15-19,1926,0.607953867913991
STAT,1916,17,20-24,1933,28.37197520143642
STAT,1797,88,na,1885,1.944240247452742
SIM,1839,40,35-39,1879,10
SIM,1855,28,na,1883,3016
SIM,1885,39,30-34,1924,5
STAT,1833,32,45-49,1865,0.9868827292754326
STAT,1879,39,35-39,1918,7.18265941441139
STAT,1859,37,20-24,1896,0.6109691375905769
STAT,1873,33,50-100,1906,0.9358997841045249
STAT,1841,18,20-24,1859,25.31186082129417
STAT,1893,21,40-44,1914,2.613728242495373
STAT,1862,24,15-19,1886,2.8353198273678535
SIM,1873,7,na,1880,2483
STAT,1866,31,na,1897,2187.1711736878883
SIM,1829,38,35-39,1867,2
STAT,1831,30,15-19,1861,0.1560539356340363
STAT,1931,38,15-19,1969,0.02522807839837003
SIM,1895,31,na,1926,4500
STAT,1900,11,na,1911,3582.850693228638
STAT,1915,49,20-24,1964,0.010914136114756513
STAT,1852,37,35-39,1889,7.158148232019903
STAT,1824,44,50-100,1868,0.18145872757040193
STAT,1866,36,20-24,1902,0.7070319737863541
STAT,1805,54,40-44,1859,0.011834518509392523
STAT,1839,69,na,1908,1363.4448059137173
SIM,1837,77,na,1914,1243
SIM,1860,37,35-39,1897,20
STAT,1808,77,na,1885,221.714824628274
STAT,1813,52,na,1865,2091.1298115711943
STAT,1878,54,40-44,1932,0.010533713494152611
STAT,1927,36,35-39,1963,2.9854526296641084
SIM,1915,25,na,1940,3455
STAT,1851,21,35-39,1872,5.543631876322581
SIM,1834,30,40-44,1864,3
STAT,1918,15,50-100,1933,0.08108624917318835
STAT,1880,26,25-29,1906,44.06611452077834
STAT,1904,46,40-44,1950,0.13836240132525568
SIM,1867,13,na,1880,2743
SIM,1887,39,35-39,1926,4
STAT,1856,29,20-24,1885,8.606494254462831
STAT,1872,45,40-44,1917,0.17314187330873515
STAT,1911,48,45-49,1959,0.2028715379168936
STAT,1852,20,40-44,1872,2.5279465906448375
STAT,1897,23,na,1920,3131.2019848063246
STAT,1874,33,45-49,1907,1.792145581910693
SIM,1842,52,na,1894,3011
STAT,1822,54,40-44,1876,0.016303207098552985
STAT,1845,43,20-24,1888,0.07922775919492632
STAT,1889,38,15-19,1927,0.0672873192780822
SIM,1837,23,20-24,1860,2
STAT,1883,17,45-49,1900,0.06284307139698624
STAT,1879,6,na,1885,2760.108146517457
SIM,1848,42,35-39,1890,1
STAT,1930,42,40-44,1972,0.3267895977349513
SIM,1904,10,na,1914,4192
STAT,1813,53,25-29,1866,0.012064078460693456
STAT,1888,22,15-19,1910,3.807613786262154
STAT,1946,18,45-49,1964,0.5478997789701413
SIM,1824,67,na,1891,1754
SIM,1921,27,50-100,1948,78
STAT,1852,39,30-34,1891,5.310695453051516
STAT,1874,30,50-100,1904,0.9532274306142778
SIM,1937,19,20-24,1956,569
STAT,1880,44,25-29,1924,0.6576595496877027
STAT,1852,104,na,1956,0.08227747053522994
STAT,1930,36,40-44,1966,1.940676269054447
STAT,1904,34,40-44,1938,3.527197599951438
STAT,1842,16,15-19,1858,1.9030160885037846
SIM,1808,49,na,1857,1407
STAT,1833,25,50-100,1858,0.4212181074707959
STAT,1923,17,na,1940,4276.620105446784
STAT,1951,19,30-34,1970,14.369753549380688
STAT,1865,22,40-44,1887,1.9256253403606391
SIM,1824,44,45-49,1868,1
SIM,1849,28,na,1877,2486
SIM,1823,45,50-100,1868,3
SIM,1838,20,30-34,1858,70
STAT,1899,49,na,1948,3009.3817885329795
STAT,1853,54,50-100,1907,0.011388470210079153
STAT,1906,16,45-49,1922,0.09482396905980585
STAT,1864,53,35-39,1917,0.007700885031942152
STAT,1887,42,15-19,1929,0.015181395362286397
STAT,1883,35,45-49,1918,1.9360340928434605
SIM,1943,28,40-44,1971,47
STAT,1861,27,35-39,1888,8.082762827599
SIM,1915,4,na,1919,3823
SIM,1807,64,na,1871,371
STAT,1801,67,na,1868,675.2304895344614
STAT,1879,34,50-100,1913,0.9318739646758489
STAT,1886,82,na,1968,829.7523558878476
STAT,1902,18,na,1920,3547.1406911979116
STAT,1915,24,45-49,1939,1.1394702402971
STAT,1929,19,20-24,1948,170.88834921831872
SIM,1848,30,35-39,1878,51
STAT,1846,70,na,1916,830.9859402028371
SIM,1883,46,na,1929,2156
STAT,1874,27,45-49,1901,1.145906670049928
STAT,1921,2,na,1923,4606.617011543936
STAT,1898,31,35-39,1929,13.673687649659612
SIM,1875,79,na,1954,1388
STAT,1917,19,25-29,1936,45.61422322257708
STAT,1937,16,45-49,1953,0.4821285347779289
STAT,1858,44,15-19,1902,0.010403721647014074
SIM,1809,59,na,1868,508
STAT,1845,69,na,1914,728.2199930588504
STAT,1816,44,45-49,1860,4.665944108937042
STAT,1890,18,35-39,1908,0.6625308858023505
SIM,1890,25,na,1915,3931
STAT,1921,34,40-44,1955,4.266456709689085
SIM,1962,7,na,1969,4676
STAT,1868,49,30-34,1917,0.09154416773512791
STAT,1844,44,na,1888,2285.729790123336
SIM,1868,69,na,1937,328
SIM,1871,43,40-44,1914,11
STAT,1859,80,na,1939,490.2948532649047
SIM,1908,32,25-29,1940,13
STAT,1873,47,15-19,1920,4.083986108761376E-4
STAT,1816,63,na,1879,1777.0850084876436
STAT,1889,30,50-100,1919,1.1122348263170132
SIM,1936,27,na,1963,3809
STAT,1897,32,35-39,1929,13.449269657314913
STAT,1884,34,45-49,1918,1.6550208603421335
STAT,1930,39,15-19,1969,0.02481937120216039
STAT,1857,19,50-100,1876,0.04366748484805232
STAT,1867,46,15-19,1913,3.793657472168289E-4
STAT,1828,29,45-49,1857,1.895283111402013
STAT,1840,52,35-39,1892,0.0033718106600284445
STAT,1940,28,15-19,1968,0.7114612698462296
STAT,1934,23,na,1957,4872.751574231013
STAT,1839,53,45-49,1892,0.013266507975775327
STAT,1879,16,40-44,1895,0.18809006537523174
STAT,1882,24,na,1906,2250.1467517380606
STAT,1843,15,15-19,1858,7.5823363414174
STAT,1889,41,40-44,1930,2.720890161189077
STAT,1922,48,20-24,1970,0.012519127679466722
SIM,1787,70,na,1857,1329
STAT,1819,51,30-34,1870,0.0010620215193178142
STAT,1873,72,na,1945,1295.451860699943
SIM,1850,59,na,1909,1110
STAT,1825,35,20-24,1860,1.168190290507504
STAT,1926,26,40-44,1952,5.55861222339824
STAT,1860,77,na,1937,705.1643438603242
STAT,1877,35,15-19,1912,0.05754500874494932
SIM,1894,46,na,1940,1387
STAT,1862,40,25-29,1902,0.5524704276248671
STAT,1866,32,35-39,1898,9.244175379907698
STAT,1902,36,35-39,1938,2.1600838868292236
STAT,1949,22,na,1971,4219.171603966028
STAT,1863,43,40-44,1906,1.9063630957570905
SIM,1948,12,na,1960,5824
STAT,1902,47,50-100,1949,0.1941754349622165
STAT,1904,10,na,1914,3700.7882300448423
STAT,1892,26,20-24,1918,14.574482201581393
STAT,1792,88,na,1880,60.86793620835371
STAT,1907,21,na,1928,3461.2533753652124
STAT,1913,42,35-39,1955,0.1939058939905696
STAT,1836,54,35-39,1890,0.0064156505915455245
SIM,1870,40,25-29,1910,2
STAT,1902,23,20-24,1925,96.73999387548773
STAT,1902,18,35-39,1920,0.7706461059067604
SIM,1847,35,45-49,1882,2
STAT,1869,44,20-24,1913,0.15809220687349343
SIM,1835,42,25-29,1877,2
STAT,1817,43,45-49,1860,1.0801472671706807
STAT,1920,21,15-19,1941,5.8594337250423685
STAT,1854,54,25-29,1908,0.0019152639843699347
STAT,1890,40,30-34,1930,1.4058404495871808
STAT,1861,32,20-24,1893,2.2479797665206522
STAT,1833,44,na,1877,1021.3342458375631
STAT,1847,95,na,1942,12.020721659326625
STAT,1894,33,25-29,1927,12.970129335713871
SIM,1907,39,30-34,1946,4
SIM,1862,44,na,1906,3474
STAT,1892,79,na,1971,1333.3028518570595
SIM,1921,42,35-39,1963,1
STAT,1920,35,40-44,1955,1.6207553186942056
SIM,1912,30,25-29,1942,52
STAT,1853,54,40-44,1907,0.00793854275810034
STAT,1827,42,25-29,1869,0.6094474624892737
STAT,1900,38,20-24,1938,0.2293419126198514
STAT,1828,29,na,1857,1903.4849247532698
SIM,1897,7,na,1904,3016
STAT,1840,29,na,1869,1046.8708272460224
STAT,1950,19,na,1969,4307.832362269526
STAT,1895,34,20-24,1929,3.4862292735051303
STAT,1851,25,20-24,1876,11.005989978017666
STAT,1845,41,30-34,1886,0.5884260441296505
STAT,1903,20,30-34,1923,25.435598792139082
STAT,1889,23,40-44,1912,2.5016207619890523
STAT,1921,13,na,1934,4456.003751733896
SIM,1887,34,40-44,1921,2
STAT,1885,45,20-24,1930,0.01191298776353403
STAT,1912,25,35-39,1937,14.722592289044185
SIM,1933,29,30-34,1962,30
STAT,1830,51,35-39,1881,0.006602568499903238
SIM,1864,31,35-39,1895,2
STAT,1892,47,50-100,1939,0.17072444524867136
STAT,1868,57,na,1925,1941.0440174084229
STAT,1834,85,na,1919,120.81248701644647
SIM,1916,35,na,1951,4643
STAT,1858,44,45-49,1902,1.1275032543355128
SIM,1930,39,na,1969,5209
STAT,1886,47,25-29,1933,0.059369604669450786
STAT,1828,43,20-24,1871,0.19530130716728594
STAT,1832,59,na,1891,1649.7569815541103
SIM,1849,62,na,1911,1234
SIM,1920,25,35-39,1945,21
STAT,1855,3,na,1858,2224.0639827124205
STAT,1871,52,35-39,1923,0.008542194279165319
STAT,1882,21,na,1903,2271.157985279273
STAT,1925,29,30-34,1954,45.527999629745096
STAT,1893,36,15-19,1929,0.07056082799885781
STAT,1914,38,15-19,1952,0.018812976556057046
STAT,1867,15,50-100,1882,0.04792926472516798
STAT,1817,100,na,1917,0.3363179244054184
STAT,1858,41,40-44,1899,1.7254638056398293
STAT,1836,34,15-19,1870,0.13509894498925087
STAT,1855,28,na,1883,1634.53213298072
SIM,1921,50,na,1971,5139
STAT,1826,49,30-34,1875,0.13489582748877935
STAT,1850,47,na,1897,1034.0468499516344
STAT,1932,17,50-100,1949,0.4926488859969771
STAT,1871,34,35-39,1905,10.015699257601444
STAT,1939,23,na,1962,3625.93499868228
STAT,1887,24,na,1911,2586.849447165461
STAT,1826,45,15-19,1871,5.878590306092773E-4
STAT,1904,49,15-19,1953,3.1563046937301085E-4
STAT,1847,21,15-19,1868,3.6829473136265864
STAT,1884,16,15-19,1900,5.69493423614519
STAT,1807,52,na,1859,1332.6258300205839
STAT,1879,34,40-44,1913,4.410687926007719
SIM,1801,79,na,1880,1570
STAT,1854,19,45-49,1873,0.04293763505355897
SIM,1854,18,na,1872,2299
STAT,1856,31,35-39,1887,7.439708910033624
SIM,1848,77,na,1925,1297
STAT,1841,70,na,1911,1562.4143616090391
STAT,1929,21,35-39,1950,11.859443671618996
STAT,1930,20,25-29,1950,118.20160218465925
STAT,1909,24,15-19,1933,4.866416359442356
STAT,1876,25,20-24,1901,11.939876529247625
SIM,1893,27,20-24,1920,6
SIM,1828,26,na,1854,1631
STAT,1917,47,35-39,1964,0.13287026517680545
STAT,1943,1,na,1944,4340.17503329962
STAT,1866,39,25-29,1905,2.6017335533912767
SIM,1928,20,na,1948,4546
SIM,1865,80,na,1945,1165
STAT,1812,53,40-44,1865,0.0025386068755959505
STAT,1893,64,na,1957,2223.6559295456627
SIM,1961,5,na,1966,4644
STAT,1920,17,40-44,1937,1.54909624638632
SIM,1912,7,na,1919,4883
STAT,1927,33,30-34,1960,19.21091941150654
STAT,1944,19,na,1963,3913.8638949165233
STAT,1935,32,15-19,1967,0.17650592149117553
SIM,1846,11,na,1857,1516
SIM,1956,2,na,1958,4927
STAT,1865,25,45-49,1890,1.0205740856819552
STAT,1927,38,na,1965,4634.760058117849
STAT,1880,23,20-24,1903,71.32074816029838
STAT,1893,24,na,1917,2939.0442402981657
STAT,1904,49,45-49,1953,0.18622213367008975
STAT,1816,41,40-44,1857,7.5933982437937475
STAT,1894,49,na,1943,2801.813956285881
SIM,1874,39,25-29,1913,17
SIM,1882,21,na,1903,2116
STAT,1848,37,45-49,1885,1.9223871728126916
STAT,1879,20,15-19,1899,3.4044627771009752
STAT,1840,85,na,1925,107.94169130879986
STAT,1883,32,40-44,1915,4.172108599457414
STAT,1870,37,25-29,1907,2.8703670598652993
STAT,1868,49,50-100,1917,0.23226495390152435
SIM,1878,27,25-29,1905,304
STAT,1818,54,20-24,1872,0.001213299727468189
STAT,1810,78,na,1888,23.279732292185646
STAT,1899,45,45-49,1944,0.18364200430063699
SIM,1876,49,50-100,1925,1
STAT,1855,49,20-24,1904,0.007776214270862626
STAT,1944,21,30-34,1965,30.693121593786756
STAT,1938,23,35-39,1961,9.216117300025639
SIM,1859,58,na,1917,1535
SIM,1937,0,na,1937,3036
STAT,1885,27,20-24,1912,11.531422531669785
STAT,1966,5,na,1971,4861.444603957796
SIM,1896,26,30-34,1922,360
STAT,1916,35,na,1951,3836.245798326986
SIM,1884,25,20-24,1909,24
STAT,1900,51,na,1951,2997.105286773967
STAT,1937,29,50-100,1966,0.9592785097128665
SIM,1819,52,na,1871,1842
STAT,1921,37,45-49,1958,0.7521695536142345
SIM,1824,41,40-44,1865,2
STAT,1830,30,30-34,1860,16.744145258409525
STAT,1926,22,25-29,1948,111.25575696262267
STAT,1823,34,50-100,1857,1.8694692134941555
STAT,1858,98,na,1956,2.906725784313531
STAT,1911,54,na,1965,3349.066602116218
STAT,1915,34,50-100,1949,0.8230545315828633
STAT,1835,70,na,1905,1061.643277852422
STAT,1911,15,40-44,1926,0.278028879649027
STAT,1821,41,15-19,1862,0.015847720929564588
SIM,1879,42,35-39,1921,5
STAT,1809,47,35-39,1856,1.2316580526925494
STAT,1874,30,40-44,1904,4.511756823694767
STAT,1856,69,na,1925,1054.0682537745595
SIM,1828,66,na,1894,931
STAT,1888,26,30-34,1914,29.163774742759934
STAT,1839,35,45-49,1874,2.2597041955851003
SIM,1783,71,na,1854,1623
STAT,1843,33,15-19,1876,0.16740724445511906
STAT,1886,29,50-100,1915,0.6576989806389866
STAT,1837,18,30-34,1855,1.693273230024802
STAT,1910,18,30-34,1928,2.381892255635767
STAT,1878,50,25-29,1928,0.0036966377438287217
STAT,1841,20,35-39,1861,8.351404076872596
SIM,1837,26,25-29,1863,6
STAT,1798,73,na,1871,759.8838613664949
STAT,1785,107,na,1892,0.0015360356639807023
STAT,1880,41,20-24,1921,0.16561846490628845
STAT,1946,15,40-44,1961,1.5354244971452082
STAT,1822,39,15-19,1861,0.10551161534023848
SIM,1843,24,20-24,1867,3
STAT,1905,17,45-49,1922,0.09395470037725398
STAT,1853,32,25-29,1885,8.178614714245985
STAT,1904,30,25-29,1934,14.751193851354083
STAT,1814,48,20-24,1862,0.040473459727873855
STAT,1896,17,25-29,1913,7.4700436752061385
STAT,1933,38,na,1971,5084.460436680674
STAT,1818,36,20-24,1854,2.1843305656326004
STAT,1947,17,45-49,1964,0.5567870022626389
STAT,1864,36,na,1900,2152.142097309731
STAT,1845,46,25-29,1891,0.028663249497339404
STAT,1899,27,15-19,1926,0.6196974598112495
STAT,1869,46,50-100,1915,0.24853414696590348
STAT,1830,44,50-100,1874,0.9103050578160309
STAT,1882,2,na,1884,3035.304471737838
STAT,1838,33,40-44,1871,2.276618447751956
SIM,1844,59,na,1903,1796
STAT,1862,32,na,1894,2032.519019346028
STAT,1875,40,35-39,1915,1.8782005601094418
STAT,1888,49,na,1937,2542.940477887016
STAT,1852,35,15-19,1887,0.05802378865146503
STAT,1858,16,50-100,1874,0.04396270258104542
STAT,1804,78,na,1882,604.7788979836081
STAT,1843,33,45-49,1876,2.049948995770958
STAT,1918,31,30-34,1949,16.58370655467828
STAT,1853,95,na,1948,10.30921016633726
STAT,1835,24,20-24,1859,68.31753204121861
STAT,1829,26,25-29,1855,36.18140427603409
STAT,1886,42,30-34,1928,1.1890733050605076
STAT,1874,94,na,1968,82.14565070969293
STAT,1813,50,20-24,1863,0.002670860343331681
STAT,1844,49,45-49,1893,0.22892095961922504
STAT,1864,50,30-34,1914,0.005489264881596551
SIM,1846,51,na,1897,901
STAT,1887,15,25-29,1902,6.266195085604471
STAT,1844,44,20-24,1888,0.1570601562393031
STAT,1881,39,20-24,1920,0.7206229371132925
STAT,1951,15,15-19,1966,53.56802781503014
STAT,1835,42,20-24,1877,0.14397840885571966
SIM,1860,17,15-19,1877,42
STAT,1870,36,na,1906,2360.0563680722335
STAT,1843,51,45-49,1894,0.014407520559466801
STAT,1881,39,na,1920,2202.469530838114
SIM,1861,32,25-29,1893,1
STAT,1823,106,na,1929,0.00959165555154944
SIM,1834,26,na,1860,1154
STAT,1909,42,15-19,1951,0.0014217621060053562
STAT,1899,45,15-19,1944,3.1125737242758444E-4
SIM,1865,58,na,1923,1665
STAT,1791,63,na,1854,1099.0
STAT,1819,77,na,1896,201.0510128246342
STAT,1840,40,50-100,1880,0.48922321297055493
STAT,1858,64,na,1922,1327.5222589637074
STAT,1900,36,30-34,1936,1.6012226118899602
STAT,1939,26,20-24,1965,18.157192464586632
STAT,1865,43,45-49,1908,1.3565484082543464
STAT,1907,39,20-24,1946,0.24032260589046447
STAT,1886,17,30-34,1903,1.650531662718036
STAT,1882,40,40-44,1922,2.1752091539927862
SIM,1881,11,na,1892,3268
SIM,1857,32,35-39,1889,1
STAT,1854,74,na,1928,617.0620669134576
STAT,1895,17,40-44,1912,0.23793355478863662
STAT,1954,16,45-49,1970,0.6122618932884266
STAT,1809,50,50-100,1859,0.12990841900696526
SIM,1924,39,30-34,1963,8
STAT,1916,39,30-34,1955,1.8224300435932785
STAT,1863,46,45-49,1909,0.20204812982841183
STAT,1892,44,15-19,1936,0.001171284344193954
SIM,1909,28,40-44,1937,82
STAT,1871,54,25-29,1925,0.003436148628807099
STAT,1963,8,na,1971,4945.150579408081
STAT,1937,29,20-24,1966,17.59240740312081
STAT,1807,106,na,1913,0.004922885152428502
STAT,1873,40,30-34,1913,1.1912058733196638
STAT,1840,27,35-39,1867,4.73718481402687
SIM,1852,4,na,1856,2713
STAT,1945,16,35-39,1961,4.534423289685622
SIM,1873,16,na,1889,2400
STAT,1952,19,45-49,1971,0.5927697346803611
SIM,1904,19,na,1923,4172
SIM,1804,50,na,1854,875
STAT,1890,13,na,1903,3121.5583882940814
STAT,1840,34,40-44,1874,2.0370997201563963
SIM,1873,43,45-49,1916,11
STAT,1870,17,35-39,1887,0.5522373005422534
STAT,1847,27,na,1874,2350.831276732187
SIM,1865,49,25-29,1914,1
STAT,1923,16,15-19,1939,52.85971209146321
STAT,1823,37,45-49,1860,3.745570177325026
STAT,1849,32,35-39,1881,8.991635351765193
STAT,1887,20,50-100,1907,0.45152202851097356
STAT,1891,60,na,1951,2345.313673195382
SIM,1823,57,na,1880,1119
STAT,1892,14,na,1906,3187.0374515555177
STAT,1846,79,na,1925,414.05267974793037
STAT,1881,76,na,1957,964.0988689248387
STAT,1922,29,45-49,1951,1.9192741550798706
STAT,1817,109,na,1926,2.25382931491485E-4
STAT,1834,37,20-24,1871,0.42257186559560395
STAT,1943,19,35-39,1962,4.395962566880628
STAT,1889,56,na,1945,2456.178303861254
STAT,1926,42,15-19,1968,0.0018769508647057875
STAT,1824,30,na,1854,585.554912826089
SIM,1875,8,na,1883,3271
STAT,1831,34,30-34,1865,18.037869093986515
STAT,1844,27,35-39,1871,11.701935280048122
STAT,1924,36,50-100,1960,0.4907747441831554
SIM,1890,35,50-100,1925,2
STAT,1857,49,25-29,1906,0.043277154940060104
SIM,1912,14,na,1926,4823
STAT,1858,32,45-49,1890,1.3316947521590827
STAT,1940,4,na,1944,4035.5229019944577
STAT,1854,46,35-39,1900,0.07806348440847759
SIM,1808,74,na,1882,1101
STAT,1846,39,50-100,1885,0.7437355946859557
STAT,1896,20,15-19,1916,4.374815746789205
SIM,1831,37,45-49,1868,5
STAT,1809,52,20-24,1861,0.006093581709402428
STAT,1874,46,20-24,1920,0.012419961352359206
STAT,1924,45,15-19,1969,4.363821560240663E-4
STAT,1942,12,na,1954,4063.782413678917
STAT,1846,24,35-39,1870,4.203365921568315
SIM,1887,30,25-29,1917,7
STAT,1786,85,na,1871,165.9767453911604
STAT,1827,32,15-19,1859,0.1466026850973262
SIM,1909,56,na,1965,3677
SIM,1884,53,na,1937,3654
SIM,1959,8,na,1967,5267
STAT,1869,22,50-100,1891,0.4114939138095277
STAT,1897,51,na,1948,2873.278980918713
STAT,1919,26,35-39,1945,16.06151416433544
STAT,1936,23,30-34,1959,27.196329786040668
STAT,1851,43,15-19,1894,0.010828111845696521
SIM,1851,66,na,1917,979
STAT,1918,18,30-34,1936,13.053569004552424
SIM,1839,32,na,1871,986
STAT,1899,33,45-49,1932,2.371778375591407
STAT,1875,43,50-100,1918,1.0769834730683685
STAT,1866,93,na,1959,44.16364097622249
STAT,1880,51,50-100,1931,0.015754004629355455
STAT,1863,21,30-34,1884,15.621779931389623
STAT,1894,23,15-19,1917,4.182268803516483
STAT,1917,29,35-39,1946,15.423762797496671
STAT,1826,30,50-100,1856,2.1901652254579504
STAT,1823,82,na,1905,368.5893813996998
STAT,1890,28,45-49,1918,1.3394096525957242
SIM,1907,49,40-44,1956,1
STAT,1929,20,20-24,1949,140.46238695531113
STAT,1811,54,50-100,1865,0.0652780751769492
STAT,1896,39,35-39,1935,9.229888404521887
STAT,1876,43,20-24,1919,0.15938562560493993
STAT,1880,36,35-39,1916,7.378126137740379
STAT,1856,50,40-44,1906,0.007670183921038733
STAT,1813,45,35-39,1858,0.536228031876951
STAT,1898,25,40-44,1923,4.055513615767444
STAT,1879,32,na,1911,2447.9729555643216
STAT,1879,30,25-29,1909,10.591730563369822
SIM,1875,17,na,1892,2976
STAT,1861,17,25-29,1878,5.416697667186014
STAT,1879,49,45-49,1928,0.23704337729419006
STAT,1896,46,40-44,1942,0.12766416864230992
STAT,1860,27,20-24,1887,9.672970178019032
STAT,1878,22,20-24,1900,70.90194467614454
STAT,1905,20,35-39,1925,8.443369978884558
STAT,1877,33,25-29,1910,10.353598720113782
STAT,1883,31,na,1914,2305.116132250504
STAT,1875,22,35-39,1897,5.992175688123934
STAT,1903,23,35-39,1926,8.257933293858096
STAT,1818,37,35-39,1855,18.008020047418064
SIM,1890,33,35-39,1923,278
STAT,1902,33,30-34,1935,24.482329877538536
STAT,1781,101,na,1882,0.14782289117686156
STAT,1878,19,na,1897,2584.5831178288367
STAT,1815,42,35-39,1857,0.19238533700232066
STAT,1815,87,na,1902,12.421731189470343
SIM,1928,23,na,1951,4614
STAT,1900,29,25-29,1929,58.18071981661176
STAT,1925,37,15-19,1962,0.02283737266274777
SIM,1917,51,na,1968,1988
STAT,1919,33,40-44,1952,4.148376244981724
STAT,1895,15,15-19,1910,7.755962456646799
STAT,1873,41,na,1914,2381.550063569525
STAT,1882,33,35-39,1915,9.654840802726804
STAT,1874,39,15-19,1913,0.057371948936292765
STAT,1867,47,na,1914,2117.822414564057
STAT,1910,28,40-44,1938,4.434911524832035
SIM,1845,66,na,1911,1416
STAT,1821,87,na,1908,88.9743119814873
STAT,1834,21,35-39,1855,3.4643997430091926
STAT,1866,99,na,1965,7.063337494234832
STAT,1815,48,50-100,1863,0.024566514139730596
STAT,1855,51,35-39,1906,0.005725051116630727
SIM,1924,39,na,1963,5158
STAT,1838,48,45-49,1886,0.10232540629128167
STAT,1853,22,15-19,1875,3.022415353509983
STAT,1885,25,30-34,1910,24.920461522132033
STAT,1826,54,50-100,1880,0.020053802432706727
STAT,1845,91,na,1936,28.754692457306188
STAT,1914,34,35-39,1948,8.99311498152003
STAT,1895,28,50-100,1923,0.8292290261076016
STAT,1872,35,30-34,1907,5.387508304417346
STAT,1929,37,15-19,1966,0.024481107327157366
SIM,1909,22,na,1931,4247
SIM,1822,44,40-44,1866,6
STAT,1876,28,25-29,1904,42.61232090830202
SIM,1916,45,50-100,1961,1
SIM,1930,33,na,1963,5334
STAT,1872,93,na,1965,87.84151007857919
STAT,1887,61,na,1948,2056.7570736397543
SIM,1883,38,20-24,1921,3
STAT,1829,48,35-39,1877,0.06392028955012355
STAT,1891,39,15-19,1930,0.06835987234770224
SIM,1840,29,na,1869,2689
STAT,1904,28,50-100,1932,0.9107088955374473
SIM,1903,31,na,1934,2902
STAT,1890,19,na,1909,3041.1202989480917
STAT,1917,44,30-34,1961,0.1311989734565048
STAT,1850,32,45-49,1882,0.842351525550836
STAT,1859,38,35-39,1897,5.578139854222005
SIM,1848,49,na,1897,2306
SIM,1853,61,na,1914,2608
SIM,1946,20,30-34,1966,41
STAT,1917,17,na,1934,4100.74657786713
SIM,1936,24,na,1960,3827
STAT,1850,45,20-24,1895,0.005596382912953243
STAT,1924,15,20-24,1939,160.6397731246149
STAT,1945,21,15-19,1966,5.771616995085592
STAT,1854,16,40-44,1870,0.12237506341825337
STAT,1867,103,na,1970,1.2891896602499189
SIM,1861,54,50-100,1915,1
SIM,1817,37,25-29,1854,7
STAT,1833,100,na,1933,0.4368002615705538
STAT,1928,21,15-19,1949,6.615641329171546
STAT,1953,17,50-100,1970,0.4491545117697803
SIM,1898,33,35-39,1931,6
STAT,1887,25,35-39,1912,10.692368554108949
STAT,1920,31,25-29,1951,10.034514293099992
STAT,1906,47,20-24,1953,0.00975629724811509
SIM,1935,23,20-24,1958,8
STAT,1841,42,45-49,1883,1.7318123732622057
STAT,1918,20,45-49,1938,1.204303792632341
STAT,1908,47,25-29,1955,0.047601565565908374
STAT,1927,23,20-24,1950,135.46205252636793
STAT,1942,29,30-34,1971,40.61428572460998
SIM,1893,25,30-34,1918,21
STAT,1937,21,25-29,1958,89.04925944883718
SIM,1897,26,na,1923,2854
STAT,1919,28,50-100,1947,1.0574487701945472
STAT,1895,22,20-24,1917,89.64636674343072
SIM,1895,25,35-39,1920,9
STAT,1830,53,25-29,1883,0.0026109893749905536
STAT,1877,31,na,1908,2432.292334614579
SIM,1834,29,na,1863,1141
STAT,1871,26,50-100,1897,0.6403109300446336
STAT,1836,55,na,1891,1582.4976588229026
SIM,1829,42,na,1871,2103
STAT,1828,31,20-24,1859,4.229741624815297
STAT,1860,51,45-49,1911,0.011895759385044008
STAT,1873,47,na,1920,2297.0815508369838
STAT,1891,33,45-49,1924,2.13537879537529
STAT,1891,46,20-24,1937,0.008347666895103197
STAT,1881,28,35-39,1909,9.07986997106294
SIM,1891,35,na,1926,2229
STAT,1854,21,20-24,1875,45.3462028280741
STAT,1857,24,40-44,1881,1.6558178939300587
SIM,1884,25,na,1909,3769
STAT,1797,57,na,1854,42.0
STAT,1822,35,na,1857,1680.9241500432167
STAT,1933,29,20-24,1962,24.049153517615174
STAT,1914,44,45-49,1958,0.1620783109640441
SIM,1835,42,na,1877,1269
SIM,1875,11,na,1886,3165
STAT,1859,12,na,1871,2196.3394462124875
SIM,1797,63,na,1860,1587
STAT,1875,76,na,1951,972.843550016665
STAT,1884,19,na,1903,2404.727442938534
STAT,1885,18,25-29,1903,5.5555134157352235
STAT,1835,27,25-29,1862,41.71365240581466
STAT,1934,37,25-29,1971,1.3495302044569157
STAT,1837,21,20-24,1858,72.85751864223269
STAT,1938,20,30-34,1958,28.16009069360542
SIM,1901,33,20-24,1934,29
STAT,1833,38,15-19,1871,0.030011576116761893
STAT,1845,19,35-39,1864,0.34009465742447254
SIM,1880,63,na,1943,3194
STAT,1875,38,20-24,1913,0.7876218169431183
SIM,1864,43,35-39,1907,1
SIM,1884,28,25-29,1912,142
SIM,1912,4,na,1916,4905
STAT,1893,61,na,1954,2336.780765342614
STAT,1913,55,na,1968,3429.672657118339
SIM,1845,21,20-24,1866,125
STAT,1839,91,na,1930,53.83735196816018
STAT,1944,18,40-44,1962,1.4878174874833758
SIM,1878,30,15-19,1908,1
STAT,1857,100,na,1957,1.1389969489419176
STAT,1848,40,na,1888,2216.2019554749045
STAT,1918,34,35-39,1952,9.497790490329304
SIM,1817,57,na,1874,2170
SIM,1941,29,20-24,1970,97
STAT,1808,47,20-24,1855,0.021932857125040124
STAT,1857,4,na,1861,2403.97322355298
STAT,1928,26,45-49,1954,2.119465408834065
SIM,1831,34,40-44,1865,16
SIM,1846,14,na,1860,1516
STAT,1864,37,50-100,1901,1.1161484986071453
STAT,1852,79,na,1931,703.710906302816
STAT,1814,44,40-44,1858,7.6533317376131516
STAT,1932,37,20-24,1969,0.35172219521681436
STAT,1828,26,40-44,1854,6.80245813811198
STAT,1833,45,20-24,1878,0.006183030762484595
STAT,1860,37,30-34,1897,4.3478278186696615
STAT,1930,27,na,1957,4729.948964740529
STAT,1940,16,15-19,1956,45.57521999584476
SIM,1862,21,20-24,1883,4
STAT,1868,27,20-24,1895,11.331066924448617
STAT,1824,42,45-49,1866,0.2548716195094241
STAT,1898,39,na,1937,3160.9835360009215
SIM,1814,74,na,1888,871
STAT,1859,24,45-49,1883,0.5652316274255705
STAT,1895,56,na,1951,2653.3037573568017
STAT,1843,19,30-34,1862,1.9888668554380864
SIM,1925,19,25-29,1944,389
STAT,1850,38,15-19,1888,0.026068541136166735
SIM,1852,14,na,1866,2610
SIM,1878,49,35-39,1927,2
STAT,1919,31,15-19,1950,0.1373593683348425
SIM,1860,49,na,1909,1985
STAT,1923,34,45-49,1957,1.7826690965707068
SIM,1910,19,na,1929,4408
STAT,1828,26,na,1854,1895.5535287047305
STAT,1881,35,40-44,1916,4.173145005864964
STAT,1927,18,40-44,1945,1.7204490635791372
STAT,1913,36,40-44,1949,1.4658035614064784
SIM,1832,42,45-49,1874,1
STAT,1842,107,na,1949,0.0011707094411564686
SIM,1918,39,na,1957,4369
STAT,1886,26,50-100,1912,0.6647068142973829
SIM,1915,56,na,1971,2498
STAT,1861,22,na,1883,2020.6482879579503
SIM,1799,58,na,1857,1587
STAT,1909,28,30-34,1937,36.93492654152149
STAT,1874,49,50-100,1923,0.2481831590355028
STAT,1844,29,50-100,1873,0.7646995313673942
STAT,1917,4,na,1921,4271.364261538032
STAT,1865,40,40-44,1905,2.074290001918499
SIM,1821,39,40-44,1860,1
SIM,1858,70,na,1928,1695
STAT,1918,28,40-44,1946,4.8762531455180405
STAT,1844,24,30-34,1868,21.717465250552667
STAT,1851,37,20-24,1888,0.6153303818758361
SIM,1912,42,na,1954,4586
STAT,1779,113,na,1892,3.012668072964493E-4
STAT,1919,16,25-29,1935,9.50360159768044
STAT,1886,14,na,1900,2665.65979854467
STAT,1900,39,35-39,1939,2.0935307841798667
STAT,1869,32,20-24,1901,2.7276076077421587
STAT,1905,29,45-49,1934,1.585557926519472
STAT,1926,19,35-39,1945,5.073219517509412
STAT,1831,39,50-100,1870,1.2163391426553154
STAT,1840,40,35-39,1880,0.8385541700172848
SIM,1917,28,30-34,1945,4
SIM,1829,46,50-100,1875,1
STAT,1803,68,na,1871,543.3141851095864
STAT,1806,79,na,1885,256.72476731035175
STAT,1877,23,15-19,1900,3.3385582988773463
STAT,1904,44,na,1948,3268.737149130545
STAT,1920,47,40-44,1967,0.17204094073221274
STAT,1814,50,35-39,1864,0.0295366739334676
STAT,1865,49,15-19,1914,3.5757110352880147E-4
STAT,1913,15,45-49,1928,0.10132244159379407
SIM,1866,68,na,1934,2225
STAT,1845,26,40-44,1871,1.8223591232800376
STAT,1899,30,40-44,1929,5.9709921885684585
STAT,1905,20,na,1925,3421.9944484191005
STAT,1895,47,35-39,1942,0.10225311590348382
STAT,1823,34,40-44,1857,8.84845547849387
SIM,1833,47,na,1880,2123
STAT,1928,23,40-44,1951,4.1532789722316235
SIM,1922,44,45-49,1966,1
STAT,1890,25,40-44,1915,3.651054466040345
STAT,1893,43,20-24,1936,0.01369157482363156
STAT,1871,51,20-24,1922,7.396287732966844E-4
STAT,1851,23,50-100,1874,0.3818526729327497
STAT,1875,44,15-19,1919,0.01398924203555794
STAT,1952,16,40-44,1968,1.6613334297909828
SIM,1906,25,20-24,1931,256
STAT,1851,111,na,1962,2.525035410180135E-4
STAT,1905,44,35-39,1949,0.17842262772782314
STAT,1953,16,25-29,1969,51.96676637471386
SIM,1915,7,na,1922,3758
STAT,1911,18,45-49,1929,0.09857784173917507
STAT,1901,30,na,1931,3363.3962291853786
STAT,1836,19,25-29,1855,10.262376839008978
STAT,1881,41,35-39,1922,1.717775463639717
STAT,1851,91,na,1942,45.76675534591545
SIM,1854,21,30-34,1875,16
SIM,1871,52,na,1923,1773
SIM,1886,82,na,1968,1187
STAT,1935,18,30-34,1953,16.499595899078738
STAT,1793,67,na,1860,663.6176743973447
STAT,1900,26,20-24,1926,16.307179022420605
SIM,1875,42,na,1917,2857
SIM,1903,22,30-34,1925,1
STAT,1855,38,35-39,1893,4.657899048979149
STAT,1914,26,15-19,1940,0.7041832209869286
SIM,1871,36,35-39,1907,14
STAT,1845,24,15-19,1869,2.0031907792363386
STAT,1834,47,30-34,1881,0.04524319872618909
STAT,1853,16,20-24,1869,16.634123252038176
STAT,1856,43,35-39,1899,1.291228021299745
STAT,1928,31,25-29,1959,11.475697490534893
STAT,1855,45,40-44,1900,0.11443602011834961
STAT,1842,38,25-29,1880,0.8297883658351278
STAT,1864,64,na,1928,1580.3523264682183
STAT,1938,27,15-19,1965,0.6919022988003111
STAT,1908,34,na,1942,3512.014936118328
STAT,1906,16,15-19,1922,8.614759332330399
SIM,1928,21,25-29,1949,2
STAT,1867,53,20-24,1920,6.866674551105738E-4
STAT,1856,38,na,1894,1683.79571926546
SIM,1899,21,na,1920,2165
STAT,1837,109,na,1946,5.70472352760545E-4
SIM,1927,41,na,1968,1569
STAT,1893,18,50-100,1911,0.061105191049163815
STAT,1858,0,na,1858,3001.7579547179507
STAT,1869,25,15-19,1894,0.46092903496267074
STAT,1871,16,40-44,1887,0.18472013584337146
SIM,1854,5,na,1859,2723
SIM,1896,10,na,1906,4109
STAT,1879,46,40-44,1925,0.17612240958841835
SIM,1860,43,na,1903,1994
STAT,1937,15,30-34,1952,11.789640055631999
STAT,1834,43,15-19,1877,0.007243763299105007
SIM,1842,40,50-100,1882,10
STAT,1901,18,20-24,1919,24.723356512776636
SIM,1936,31,25-29,1967,1
STAT,1873,50,40-44,1923,0.010954235206692791
SIM,1878,53,na,1931,3611
SIM,1943,18,30-34,1961,9
STAT,1846,21,30-34,1867,13.110783525038919
STAT,1944,24,35-39,1968,10.045217599718763
STAT,1854,31,30-34,1885,10.045255005910386
STAT,1825,77,na,1902,532.3036180070781
STAT,1931,19,45-49,1950,0.6457726277280759
STAT,1842,16,45-49,1858,0.020946788149888002
STAT,1848,74,na,1922,1038.511907304431
SIM,1957,1,na,1958,6087
STAT,1880,28,50-100,1908,0.6617618710577704
STAT,1931,34,35-39,1965,11.87477895837624
STAT,1946,21,35-39,1967,10.36830259428821
STAT,1883,39,25-29,1922,2.7420341205518697
STAT,1790,84,na,1874,148.62131323398907
STAT,1887,22,30-34,1909,19.60550247327566
STAT,1885,28,35-39,1913,9.451022913977294
STAT,1809,53,na,1862,2798.2428175069313
STAT,1831,40,na,1871,2057.695722585174
SIM,1922,38,na,1960,3333
SIM,1935,26,25-29,1961,2
STAT,1936,33,40-44,1969,3.761008776349411
SIM,1887,36,na,1923,3651
STAT,1908,44,20-24,1952,0.016013695407627655
STAT,1843,21,45-49,1864,0.8710713612221248
STAT,1902,23,50-100,1925,0.5724599332999742
SIM,1829,73,na,1902,1463
STAT,1843,45,15-19,1888,4.0358490692798287E-4
STAT,1850,48,25-29,1898,0.026263273202434503
STAT,1846,45,30-34,1891,0.057902415631628006
STAT,1860,33,15-19,1893,0.11568480634683906
STAT,1852,42,20-24,1894,0.15966246773121098
STAT,1910,44,na,1954,3428.0638478223996
STAT,1911,31,15-19,1942,0.12422917797520809
STAT,1940,27,50-100,1967,1.0035979080986603
STAT,1865,46,na,1911,2059.916459436808
STAT,1911,20,na,1931,3599.8088385995393
SIM,1826,37,35-39,1863,22
STAT,1901,28,30-34,1929,35.08577647431651
SIM,1876,27,20-24,1903,72
STAT,1840,54,na,1894,824.5051888752386
STAT,1867,31,40-44,1898,4.1181239324741465
SIM,1934,23,na,1957,5205
STAT,1915,47,30-34,1962,0.08855977989580599
SIM,1940,23,na,1963,4269
STAT,1917,45,na,1962,3803.8930944528333
STAT,1860,43,50-100,1903,0.8556193993321465
STAT,1903,17,40-44,1920,0.25963294243291923
SIM,1926,24,25-29,1950,1
STAT,1914,31,30-34,1945,15.702513128486403
STAT,1914,41,40-44,1955,0.24475043059908588
STAT,1822,45,45-49,1867,0.4057441102012817
SIM,1854,45,30-34,1899,5
STAT,1841,32,35-39,1873,13.682544854377191
STAT,1875,48,30-34,1923,0.09815033980544813
STAT,1922,18,20-24,1940,154.7464875819351
STAT,1862,22,25-29,1884,49.91346749883771
STAT,1845,16,30-34,1861,1.0055577794166948
STAT,1837,37,50-100,1874,1.1985708560025723
STAT,1856,2,na,1858,2543.4759429205615
STAT,1918,24,25-29,1942,97.6639533034703
STAT,1878,25,25-29,1903,43.81790221457183
SIM,1870,22,25-29,1892,1
STAT,1859,35,30-34,1894,4.26430159461918
SIM,1913,6,na,1919,3719
STAT,1859,21,40-44,1880,1.896698440496486
STAT,1787,67,na,1854,340.00000000000006
STAT,1898,28,45-49,1926,1.4877877428882698
STAT,1838,45,40-44,1883,0.07713782932166142
STAT,1826,52,20-24,1878,0.0010194795070004618
STAT,1855,22,na,1877,1653.1773624958955
STAT,1828,41,30-34,1869,1.461909909531513
STAT,1880,29,na,1909,2459.872000498858
STAT,1913,39,45-49,1952,0.6576340453540545
STAT,1944,20,50-100,1964,0.7029344877924593
STAT,1868,23,na,1891,2277.2729417020796
STAT,1789,110,na,1899,1.1750775757843259E-4
SIM,1901,36,25-29,1937,4
STAT,1863,24,35-39,1887,5.0084007010288865
STAT,1885,15,20-24,1900,17.50721347780811
STAT,1837,24,25-29,1861,59.22842181973769
STAT,1957,14,na,1971,5131.7816671036135
STAT,1836,32,25-29,1868,9.920833247146287
STAT,1934,34,20-24,1968,3.3034716958043036
STAT,1871,46,na,1917,2250.6863556767066
STAT,1916,49,40-44,1965,0.15857071255414157
STAT,1946,25,50-100,1971,1.0977303024270613
STAT,1815,53,na,1868,194.4384406432427
STAT,1860,9,na,1869,2292.261595567078
STAT,1891,30,40-44,1921,5.375852245739978
STAT,1817,82,na,1899,147.80838114013963
STAT,1830,50,20-24,1880,6.343447393485734E-4
SIM,1887,67,na,1954,2486
STAT,1842,89,na,1931,26.078955814741594
STAT,1908,21,50-100,1929,0.6020480759798913
STAT,1895,32,30-34,1927,22.712865846194735
SIM,1903,37,na,1940,2704
STAT,1860,74,na,1934,905.3568275365399
STAT,1927,26,25-29,1953,79.63907080115979
STAT,1864,35,40-44,1899,4.017409617437408
STAT,1919,2,na,1921,4459.593137761732
STAT,1871,29,50-100,1900,0.6335602959441703
STAT,1906,38,50-100,1944,0.38183195498984596
SIM,1918,33,30-34,1951,77
STAT,1884,22,45-49,1906,0.6675266936361643
SIM,1845,24,25-29,1869,9
SIM,1835,26,20-24,1861,23
SIM,1836,41,30-34,1877,16
STAT,1832,25,na,1857,2453.798525474891
SIM,1876,4,na,1880,4307
SIM,1928,31,35-39,1959,2
STAT,1940,31,40-44,1971,4.007018544675452
SIM,1905,66,na,1971,2064
STAT,1894,17,20-24,1911,22.54463831520257
STAT,1802,83,na,1885,200.35200215109413
SIM,1872,68,na,1940,2049
STAT,1816,48,25-29,1864,0.1726950190199648
SIM,1841,41,40-44,1882,2
SIM,1921,20,25-29,1941,12
STAT,1931,28,50-100,1959,1.2753964216282503
STAT,1857,27,45-49,1884,0.8775771681717696
STAT,1851,49,20-24,1900,0.00927962803862259
STAT,1897,44,35-39,1941,0.16474388757084887
SIM,1848,15,na,1863,2793
SIM,1827,47,na,1874,1980
SIM,1919,25,30-34,1944,18
STAT,1799,83,na,1882,27.682444222555596
STAT,1891,49,25-29,1940,0.03912112113916783
STAT,1800,54,na,1854,1903.655963589886
STAT,1864,38,45-49,1902,1.8033020633696655
STAT,1874,29,na,1903,2445.446830105689
SIM,1959,2,na,1961,5267
STAT,1887,46,30-34,1933,0.10684766629089507
STAT,1904,37,45-49,1941,0.6147344175284369
STAT,1926,28,na,1954,4436.588929583965
STAT,1913,20,25-29,1933,88.91098915889378
SIM,1893,36,na,1929,3029
STAT,1833,41,40-44,1874,1.186799210345615
STAT,1926,29,45-49,1955,2.0385735667919764
STAT,1857,88,na,1945,105.3461312186636
STAT,1862,107,na,1969,0.049686294141718206
STAT,1856,47,15-19,1903,2.859617672444009E-4
SIM,1875,48,na,1923,2638
STAT,1781,73,na,1854,514.0000000000001
STAT,1855,50,na,1905,1445.5234031451498
SIM,1812,48,na,1860,1720
STAT,1838,19,na,1857,1277.8687576651662
STAT,1899,18,na,1917,3440.604743614998
STAT,1884,46,15-19,1930,3.839957853996946E-4
STAT,1937,25,40-44,1962,4.500493065307046
STAT,1827,29,25-29,1856,45.68434374224522
STAT,1858,33,na,1891,1814.6502792454642
SIM,1958,3,na,1961,4201
STAT,1890,15,30-34,1905,1.9385149037348073
SIM,1881,42,na,1923,2938
STAT,1879,3,na,1882,3125.8330092989495
STAT,1853,30,50-100,1883,0.7469652906109213
SIM,1882,42,40-44,1924,2
STAT,1887,47,45-49,1934,0.25854786335488145
STAT,1921,15,35-39,1936,4.74830442618498
STAT,1862,26,40-44,1888,2.579370365660884
STAT,1937,26,50-100,1963,0.9606611988005406
STAT,1930,27,45-49,1957,2.1813098890854725
STAT,1878,35,35-39,1913,7.346222887456598
SIM,1902,52,na,1954,2972
SIM,1952,11,na,1963,6372
STAT,1861,54,30-34,1915,0.004814263240668936
SIM,1860,42,20-24,1902,4
SIM,1895,62,na,1957,4339
STAT,1882,35,50-100,1917,1.1866169423656245
STAT,1795,93,na,1888,8.648231178519813
STAT,1848,52,40-44,1900,0.009799061884151618
STAT,1837,100,na,1937,0.8512626769980165
STAT,1843,68,na,1911,1509.9275419240698
SIM,1826,68,na,1894,971
STAT,1874,42,40-44,1916,2.318544243373657
STAT,1901,24,15-19,1925,4.583868912220799
STAT,1832,28,na,1860,2403.7504162822206
STAT,1909,26,40-44,1935,4.46187614035439
SIM,1826,31,na,1857,1937
STAT,1855,48,45-49,1903,0.15423083179351255
STAT,1871,12,na,1883,2633.7947571688937
STAT,1910,36,25-29,1946,0.9356205779648781
STAT,1941,27,20-24,1968,18.668460157042738
STAT,1893,41,50-100,1934,1.3271002404161782
STAT,1806,73,na,1879,453.3681453954759
STAT,1842,35,20-24,1877,0.22918910387160935
STAT,1851,47,30-34,1898,0.07609549841256381
STAT,1877,27,50-100,1904,0.6493647601053633
STAT,1905,42,45-49,1947,0.14930027481889221
STAT,1920,21,50-100,1941,0.7242811371568247
STAT,1882,52,na,1934,2050.4906031807377
STAT,1833,46,50-100,1879,0.1249263051057849
STAT,1876,18,15-19,1894,5.983566918649052
SIM,1919,18,na,1937,4208
STAT,1901,38,40-44,1939,1.3145447187789367
SIM,1932,36,50-100,1968,11
STAT,1928,25,30-34,1953,48.230512450951906
STAT,1836,29,35-39,1865,9.430368665030585
SIM,1868,60,na,1928,573
STAT,1824,98,na,1922,0.628669769323047
SIM,1831,24,30-34,1855,1
STAT,1852,54,20-24,1906,7.223547651996489E-4
STAT,1849,59,na,1908,1637.547108540337
STAT,1901,36,15-19,1937,0.017028590533934535
SIM,1914,5,na,1919,5124
STAT,1855,35,30-34,1890,3.560808237373826
STAT,1856,40,30-34,1896,0.8340854440117401
STAT,1917,44,50-100,1961,0.1205612185873638
STAT,1902,41,15-19,1943,0.00135651201879346
STAT,1807,51,40-44,1858,0.03428578085444513
STAT,1965,6,na,1971,4858.888257939783
STAT,1868,28,35-39,1896,9.286813734269362
STAT,1846,48,na,1894,1315.7498235703815
STAT,1886,25,15-19,1911,0.47301920308479034
SIM,1851,35,na,1886,1164
SIM,1906,42,na,1948,3370
STAT,1819,39,50-100,1858,0.2798152687107848
SIM,1814,49,50-100,1863,3
SIM,1894,20,20-24,1914,173
STAT,1787,98,na,1885,0.28014870590124213
STAT,1902,15,na,1917,3572.9824381527956
STAT,1923,24,35-39,1947,10.772696821029495
STAT,1855,53,na,1908,1402.164284148057
STAT,1886,20,20-24,1906,71.78812831326894
STAT,1919,48,45-49,1967,0.23195643000409258
STAT,1871,24,25-29,1895,56.74750796193156
STAT,1768,91,na,1859,46.74522999344568
STAT,1859,29,50-100,1888,0.508387226770063
STAT,1837,46,35-39,1883,0.11803071604839571
STAT,1860,49,30-34,1909,0.07731987618381722
STAT,1940,21,30-34,1961,28.959607809983513
STAT,1844,52,50-100,1896,0.01488247512986146
STAT,1954,15,30-34,1969,14.942928965770099
SIM,1874,0,na,1874,2995
STAT,1888,40,na,1928,2694.4655720039773
STAT,1831,35,45-49,1866,2.0769974341096855
STAT,1914,34,na,1948,3721.9363546933905
STAT,1933,23,15-19,1956,7.010700757783859
SIM,1850,50,na,1900,1227
STAT,1894,15,30-34,1909,2.0362747629497933
SIM,1845,34,35-39,1879,23
SIM,1868,63,na,1931,502
STAT,1869,73,na,1942,1198.539689191144
STAT,1909,19,35-39,1928,0.8101361027353163
STAT,1870,40,15-19,1910,0.013906395489200214
STAT,1882,37,15-19,1919,0.05376295355857018
STAT,1881,3,na,1884,2841.4619082045856
SIM,1932,37,30-34,1969,1
STAT,1872,38,35-39,1910,7.047408378840573
STAT,1930,15,45-49,1945,0.6442731495891397
SIM,1941,23,15-19,1964,5
STAT,1851,60,na,1911,1506.2763423067868
SIM,1895,47,45-49,1942,2
SIM,1909,24,25-29,1933,340
STAT,1898,47,20-24,1945,0.00905995165490873
SIM,1837,32,50-100,1869,19
STAT,1890,31,35-39,1921,12.310001417929703
STAT,1836,22,15-19,1858,3.3362910809340023
STAT,1869,35,25-29,1904,2.932938130183232
STAT,1871,15,na,1886,2565.809758049564
STAT,1933,35,15-19,1968,0.02602377378651496
STAT,1843,65,na,1908,1669.7585672665773
STAT,1830,27,40-44,1857,2.880421007852281
STAT,1924,37,30-34,1961,2.12849306427042
SIM,1919,15,na,1934,5211
STAT,1910,43,30-34,1953,0.11875588855869781
STAT,1853,19,25-29,1872,5.22351544365035
SIM,1863,35,30-34,1898,18
STAT,1823,40,35-39,1863,3.172491652346975
STAT,1926,22,na,1948,4398.463456615507
STAT,1909,30,45-49,1939,1.4982816773416763
STAT,1867,22,45-49,1889,0.662194746217061
STAT,1902,49,na,1951,3102.5652153927804
STAT,1820,53,30-34,1873,0.008851888937337675
STAT,1907,55,na,1962,3149.0958006514006
STAT,1919,36,45-49,1955,0.723308355862538
STAT,1887,24,20-24,1911,75.37529938834267
SIM,1824,36,na,1860,2243
STAT,1826,110,na,1936,2.2030669536037952E-4
SIM,1960,6,na,1966,6451
STAT,1902,44,50-100,1946,0.10191129453453003
STAT,1837,34,35-39,1871,9.97173380213683
STAT,1868,51,50-100,1919,0.014657100331643736
STAT,1936,36,45-49,1972,0.6632191636512368
SIM,1895,24,20-24,1919,61
STAT,1811,53,20-24,1864,0.003253948373779296
SIM,1845,35,na,1880,2422
STAT,1848,49,15-19,1897,3.664942095010762E-4
STAT,1895,25,na,1920,3125.6247724758614
STAT,1920,34,na,1954,4054.3659594153864
STAT,1894,40,na,1934,2968.764432365133
STAT,1877,37,40-44,1914,4.443692177923964
SIM,1876,25,30-34,1901,1
STAT,1919,5,na,1924,4384.273243453014
STAT,1946,23,25-29,1969,101.64513371525197
STAT,1872,33,40-44,1905,4.324286844828006
STAT,1935,20,45-49,1955,1.5222293543805294
STAT,1925,47,25-29,1972,0.06369014806931517
SIM,1794,80,na,1874,275
STAT,1916,35,15-19,1951,0.01958129066012638
SIM,1844,50,na,1894,2325
STAT,1931,16,40-44,1947,1.8223777169102477
STAT,1858,22,35-39,1880,5.113030610801238
SIM,1907,46,50-100,1953,2
SIM,1836,21,na,1857,2355
STAT,1916,47,15-19,1963,3.7267641675391524E-4
STAT,1941,15,20-24,1956,138.13077971653829
SIM,1952,17,na,1969,6372
STAT,1857,85,na,1942,210.3601864854186
STAT,1883,48,20-24,1931,0.011399461506617081
STAT,1858,9,na,1867,2173.3484303080236
STAT,1873,53,45-49,1926,0.01464751927062043
STAT,1866,48,20-24,1914,0.010816189802331417
STAT,1927,24,35-39,1951,11.434390444477438
SIM,1813,42,40-44,1855,10
SIM,1838,56,na,1894,1518
STAT,1859,52,50-100,1911,0.011906603565638548
SIM,1885,27,30-34,1912,2
SIM,1918,30,na,1948,3978
SIM,1830,35,35-39,1865,2
STAT,1877,27,30-34,1904,25.56265882766132
SIM,1899,55,na,1954,1506
STAT,1822,35,35-39,1857,15.58423337573381
STAT,1886,39,40-44,1925,4.4874996035312344
SIM,1937,6,na,1943,2988
STAT,1851,94,na,1945,15.784855762474418
STAT,1864,33,na,1897,2160.255145379203
SIM,1857,20,na,1877,1495
STAT,1916,45,25-29,1961,0.053918028756071525
STAT,1907,33,15-19,1940,0.11880757443924488
STAT,1874,26,na,1900,2471.5032557811337
STAT,1819,48,40-44,1867,0.031189127694413964
STAT,1836,24,50-100,1860,0.4064962068495339
STAT,1835,20,40-44,1855,2.126228859765971
STAT,1911,22,50-100,1933,0.6170108867924595
STAT,1825,47,20-24,1872,0.015244797080761754
STAT,1945,26,45-49,1971,1.8752731701612584
STAT,1842,47,20-24,1889,0.0029794315072144387
STAT,1901,31,20-24,1932,3.7949030439378606
SIM,1862,78,na,1940,1477
STAT,1929,21,50-100,1950,0.8287522753101094
STAT,1831,32,40-44,1863,4.611889959763842
STAT,1886,27,40-44,1913,3.1020564967583395
STAT,1862,19,35-39,1881,0.4813705884303968
STAT,1907,45,15-19,1952,3.325027681512351E-4
SIM,1937,30,30-34,1967,140
SIM,1883,77,na,1960,1493
STAT,1864,41,35-39,1905,1.6536707108249233
STAT,1887,30,15-19,1917,0.1580042415321492
STAT,1802,80,na,1882,377.97673183803903
STAT,1942,5,na,1947,4123.782028859591
STAT,1881,9,na,1890,2450.2359653154917
STAT,1819,36,40-44,1855,2.3104565185927366
STAT,1929,42,30-34,1971,0.16440415093704572
SIM,1835,29,25-29,1864,3
SIM,1814,43,na,1857,2437
STAT,1841,36,15-19,1877,0.07444370551425852
STAT,1877,17,20-24,1894,17.996592968659257
STAT,1831,37,35-39,1868,7.183571647652531
STAT,1827,103,na,1930,0.10120558064379184
STAT,1859,25,20-24,1884,9.596063646124149
STAT,1867,78,na,1945,738.9298283903901
STAT,1932,18,15-19,1950,59.51986211944384
STAT,1827,72,na,1899,890.5828224709694
STAT,1910,33,20-24,1943,2.31574539548733
SIM,1859,21,15-19,1880,15
STAT,1850,13,na,1863,1340.9198743194734
SIM,1940,18,15-19,1958,60
STAT,1946,19,20-24,1965,148.6479849000863
STAT,1816,45,20-24,1861,0.037565724427821134
STAT,1915,37,20-24,1952,0.26253753760806914
SIM,1958,0,na,1958,4201
STAT,1853,17,35-39,1870,0.5118041386966538
STAT,1844,13,na,1857,2992.6839709555393
STAT,1847,53,35-39,1900,0.007658622399999786
STAT,1845,38,40-44,1883,2.2587254069322964
STAT,1892,38,20-24,1930,0.9496495109828736
STAT,1897,41,30-34,1938,0.10650519252802806
SIM,1925,18,na,1943,3754
STAT,1882,55,na,1937,1979.6501818170727
STAT,1835,53,50-100,1888,0.011417127944059823
STAT,1846,46,45-49,1892,0.14017040689533677
STAT,1904,22,40-44,1926,2.9771292146361894
STAT,1847,103,na,1950,0.1297543636346776
STAT,1931,32,45-49,1963,2.047408559814105
STAT,1840,20,na,1860,1086.18491969914
STAT,1846,23,20-24,1869,49.99747346969287
STAT,1899,42,50-100,1941,0.10007964462112903
SIM,1861,17,35-39,1878,20
SIM,1900,57,na,1957,3924
STAT,1908,45,50-100,1953,0.20595144591696588
SIM,1946,17,na,1963,3777
STAT,1812,73,na,1885,99.39186002120596
STAT,1888,77,na,1965,1318.6020099492773
SIM,1820,43,na,1863,567
STAT,1964,7,na,1971,4902.137002181272
STAT,1878,47,35-39,1925,0.14337016291092614
STAT,1915,25,20-24,1940,18.48013090331878
STAT,1935,16,40-44,1951,1.9030324853288225
STAT,1836,36,40-44,1872,4.160292710088236
STAT,1883,36,20-24,1919,0.7451592396601402
STAT,1831,25,35-39,1856,12.960828521977803
STAT,1807,58,na,1865,1183.4850719869298
STAT,1911,41,25-29,1952,0.06777667411293335
STAT,1929,30,30-34,1959,19.894748013318527
STAT,1832,52,45-49,1884,0.0011612445291902885
STAT,1865,12,na,1877,2468.0903793437597
STAT,1905,26,40-44,1931,4.323366992895219
STAT,1924,39,20-24,1963,0.30720136619838684
SIM,1854,23,20-24,1877,19
STAT,1837,34,na,1871,2134.0105639207723
STAT,1880,4,na,1884,2965.3612917718665
STAT,1884,42,50-100,1926,1.0100671399894083
SIM,1892,42,50-100,1934,26
STAT,1806,52,35-39,1858,0.022773910428815176
SIM,1854,49,na,1903,1275
SIM,1876,7,na,1883,4087
STAT,1862,29,45-49,1891,0.9389316900151774
STAT,1887,44,40-44,1931,2.442300071732634
STAT,1933,39,30-34,1972,2.460372367225809
STAT,1920,9,na,1929,4408.872237982195
STAT,1899,23,35-39,1922,7.945862545535915
STAT,1847,50,30-34,1897,0.005459139671265164
SIM,1836,44,35-39,1880,1
STAT,1842,45,50-100,1887,0.06256171198016242
SIM,1940,25,20-24,1965,80
STAT,1827,106,na,1933,0.008562217165464965
STAT,1897,48,15-19,1945,2.958873608931122E-4
SIM,1904,24,40-44,1928,8
STAT,1913,27,45-49,1940,1.6998097970682413
SIM,1895,49,35-39,1944,2
STAT,1887,49,35-39,1936,0.08510712316207827
STAT,1836,26,30-34,1862,25.14933605504825
STAT,1815,52,45-49,1867,0.0014201630563969025
STAT,1910,26,15-19,1936,0.6763894555317301
STAT,1932,25,20-24,1957,23.763188834832274
STAT,1844,17,25-29,1861,7.136312195431252
STAT,1853,27,na,1880,1943.1645709610361
SIM,1817,54,na,1871,2447
STAT,1926,43,50-100,1969,0.14335986362316452
STAT,1861,53,na,1914,1761.9156707917346
SIM,1889,62,na,1951,2369
STAT,1859,18,15-19,1877,5.4278289081290225
STAT,1882,43,45-49,1925,1.422547721263681
STAT,1868,26,na,1894,2312.9836528890137
STAT,1891,42,40-44,1933,2.762593766607446
STAT,1863,23,20-24,1886,59.57306259975904
STAT,1876,16,25-29,1892,5.7426106996789485
STAT,1891,66,na,1957,2067.7454627659695
STAT,1803,100,na,1903,0.26780161095437177
STAT,1848,71,na,1919,1249.0724490107848
SIM,1805,69,na,1874,2097
STAT,1904,15,35-39,1919,0.7875808145991331
SIM,1921,27,45-49,1948,13
STAT,1909,29,45-49,1938,1.622581776807854
SIM,1847,61,na,1908,1382
STAT,1922,26,40-44,1948,5.233316546563438
STAT,1935,19,45-49,1954,0.6743532239772274
STAT,1964,4,na,1968,4904.6379487021
STAT,1810,46,30-34,1856,5.15111251453483E-4
STAT,1873,43,35-39,1916,1.844077742646153
SIM,1890,43,45-49,1933,2
SIM,1960,9,na,1969,6451
STAT,1909,16,30-34,1925,2.3717513765522438
STAT,1872,23,30-34,1895,17.781385805605016
STAT,1884,81,na,1965,794.2963349946435
SIM,1874,63,na,1937,2153
STAT,1895,35,35-39,1930,9.288351598196671
STAT,1834,20,na,1854,1278.4917170684223
STAT,1932,22,na,1954,4758.144664320617
STAT,1938,20,50-100,1958,0.6446907909259478
STAT,1789,90,na,1879,52.3775572604087
SIM,1919,41,35-39,1960,2
STAT,1873,36,50-100,1909,1.265455039810001
STAT,1896,49,45-49,1945,0.17182336856023897
SIM,1869,48,na,1917,3592
STAT,1866,17,45-49,1883,0.061202893485987286
STAT,1828,44,35-39,1872,2.190048372816237
SIM,1835,27,35-39,1862,99
STAT,1831,46,na,1877,1912.5043453085673
STAT,1935,19,50-100,1954,0.5057649179829204
SIM,1876,21,15-19,1897,15
STAT,1941,3,na,1944,4106.532234233586
STAT,1882,30,30-34,1912,16.850479053750394
STAT,1910,41,na,1951,3490.6928241161772
SIM,1858,31,40-44,1889,4
STAT,1857,46,20-24,1903,0.009234481607064603
STAT,1919,40,na,1959,3982.286892012065
STAT,1936,26,35-39,1962,14.232049012231048
SIM,1830,25,25-29,1855,177
STAT,1878,37,25-29,1915,2.9623173886498684
STAT,1800,88,na,1888,83.05469757338365
STAT,1803,99,na,1902,0.47773090060897266
STAT,1894,18,35-39,1912,0.6959425072435025
STAT,1929,40,40-44,1969,0.322542387662223
STAT,1896,30,25-29,1926,13.61062601889756
STAT,1850,16,na,1866,1302.9127915327776
STAT,1868,21,15-19,1889,3.209475200504636
STAT,1881,25,30-34,1906,23.941805273288935
STAT,1832,42,35-39,1874,0.1593482785288787
STAT,1865,37,15-19,1902,0.051268613335617004
STAT,1928,35,40-44,1963,1.880747506727588
STAT,1889,25,na,1914,2893.408540533758
STAT,1836,86,na,1922,169.81004871824152
STAT,1824,47,50-100,1871,0.04262577423565415
STAT,1827,27,35-39,1854,15.071633983454781
STAT,1923,21,30-34,1944,33.18974682010921
STAT,1790,87,na,1877,78.77886430721804
STAT,1947,21,na,1968,4085.081591366645
SIM,1851,38,na,1889,1173
STAT,1868,25,30-34,1893,24.487474682322297
STAT,1892,48,30-34,1940,0.0667545150635219
STAT,1846,33,30-34,1879,12.093903191572714
SIM,1867,18,15-19,1885,13
SIM,1840,42,35-39,1882,4
SIM,1888,15,na,1903,639
STAT,1856,53,45-49,1909,0.010256231007708783
SIM,1924,30,na,1954,5203
STAT,1906,28,15-19,1934,0.6546810484685697
STAT,1818,98,na,1916,1.9772449725707695
SIM,1844,26,30-34,1870,372
SIM,1893,30,na,1923,3419
STAT,1925,40,na,1965,4467.647402039171
SIM,1868,30,20-24,1898,7
STAT,1807,48,15-19,1855,0.0013599990156341435
STAT,1840,37,45-49,1877,0.9283973568051439
STAT,1871,28,40-44,1899,2.977687199712518
STAT,1846,48,35-39,1894,0.0818746720436124
STAT,1876,52,na,1928,2165.0670651104756
STAT,1865,52,40-44,1917,0.009560482213983852
SIM,1866,34,na,1900,3155
SIM,1858,26,25-29,1884,195
SIM,1904,16,na,1920,4172
STAT,1883,50,35-39,1933,0.008401306756659217
STAT,1838,31,50-100,1869,0.49108909105400816
STAT,1925,44,20-24,1969,0.021115144407382474
STAT,1857,1,na,1858,2863.1362150511645
SIM,1865,89,na,1954,254
STAT,1850,41,40-44,1891,1.0433288961779705
SIM,1853,6,na,1859,3646
STAT,1795,90,na,1885,37.69553220203962
STAT,1829,45,30-34,1874,0.045951985117098006
STAT,1881,38,45-49,1919,1.873207294360333
STAT,1898,16,45-49,1914,0.08805600665502264
STAT,1904,41,na,1945,3328.4553079838415
STAT,1895,49,50-100,1944,0.17645849631532365
SIM,1862,75,na,1937,2633
STAT,1922,20,35-39,1942,10.741156838913096
STAT,1837,31,30-34,1868,17.735891718274566
STAT,1910,46,35-39,1956,0.11924149463202759
SIM,1854,33,30-34,1887,2
STAT,1905,18,20-24,1923,25.43250261503151
STAT,1900,19,15-19,1919,8.176958893863658
SIM,1887,42,25-29,1929,3
STAT,1822,32,na,1854,1654.5510533436154
STAT,1871,18,30-34,1889,1.5907975079155685
STAT,1814,47,45-49,1861,0.8067935816696642
STAT,1854,34,35-39,1888,5.647790958844766
STAT,1825,46,na,1871,1607.7792408066211
STAT,1791,104,na,1895,0.016818595251260178
STAT,1828,34,25-29,1862,14.519483401343447
STAT,1904,30,50-100,1934,1.3195585161130003
STAT,1857,45,50-100,1902,0.1903428700709898
STAT,1845,22,25-29,1867,35.26452179689576
STAT,1824,61,na,1885,382.1929146623907
STAT,1839,97,na,1936,4.991168171086023
STAT,1916,42,20-24,1958,0.01785105842690693
STAT,1946,20,20-24,1966,122.48570734846349
STAT,1896,36,30-34,1932,7.059416622971252
STAT,1880,1,na,1881,3531.7503631070804
STAT,1833,72,na,1905,519.6019428893383
STAT,1823,49,45-49,1872,0.35782967887400585
SIM,1818,49,45-49,1867,3
STAT,1837,31,na,1868,2201.5337519147924
SIM,1818,39,35-39,1857,9
SIM,1897,1,na,1898,3185
STAT,1846,43,40-44,1889,1.3311215965929128
SIM,1898,73,na,1971,2608
SIM,1915,49,30-34,1964,1
STAT,1931,22,35-39,1953,12.126409439411434
SIM,1810,84,na,1894,805
STAT,1847,30,50-100,1877,0.9930495322138696
STAT,1846,45,na,1891,1345.7770196626925
SIM,1845,31,30-34,1876,4
STAT,1833,48,25-29,1881,0.025983675902045065
STAT,1876,24,45-49,1900,0.7005150072017724
STAT,1879,66,na,1945,1681.361910632156
STAT,1840,19,15-19,1859,2.989928555969852
SIM,1900,28,20-24,1928,54
SIM,1894,15,na,1909,1658
SIM,1927,44,na,1971,1555
SIM,1801,70,na,1871,1783
STAT,1879,52,35-39,1931,0.008784501238318827
STAT,1839,60,na,1899,1771.8959753462364
STAT,1854,24,25-29,1878,36.86351222326298
STAT,1863,36,35-39,1899,6.067302402154866
STAT,1886,23,25-29,1909,59.097521485225904
SIM,1842,24,na,1866,3343
STAT,1907,49,30-34,1956,0.0784272815947719
STAT,1843,52,20-24,1895,7.252160056224169E-4
STAT,1802,54,25-29,1856,0.01725434066818703
STAT,1887,34,30-34,1921,19.052910750765115
SIM,1831,30,25-29,1861,36
SIM,1863,23,na,1886,1331
STAT,1810,47,na,1857,91.39070888700786
STAT,1920,37,na,1957,4066.207343515586
STAT,1937,31,35-39,1968,8.95280214611532
STAT,1940,24,35-39,1964,9.477874746786508
STAT,1824,51,40-44,1875,0.0018105756139814952
STAT,1890,21,25-29,1911,69.51118213642515
STAT,1830,61,na,1891,1352.466714999788
SIM,1912,45,na,1957,4550
STAT,1895,25,25-29,1920,55.40208734467809
STAT,1901,34,25-29,1935,14.198751121704992
STAT,1906,38,25-29,1944,0.8954395983194198
STAT,1838,51,35-39,1889,0.003728594409752924
STAT,1945,23,40-44,1968,3.643201724346839
SIM,1789,68,na,1857,303
STAT,1819,46,na,1865,635.6998598760212
STAT,1835,23,45-49,1858,0.6963006262623491
STAT,1891,34,50-100,1925,1.1170868551152904
SIM,1904,39,45-49,1943,7
SIM,1837,45,30-34,1882,3
STAT,1874,49,25-29,1923,0.05820582190389621
STAT,1919,23,30-34,1942,30.958181695609312
STAT,1836,39,45-49,1875,1.836462289152977
STAT,1923,31,40-44,1954,4.457190273247516
SIM,1874,44,50-100,1918,1
STAT,1840,24,30-34,1864,8.791677967958416
STAT,1868,28,50-100,1896,0.6156853681302278
SIM,1937,9,na,1946,2988
STAT,1904,25,45-49,1929,1.5970474384619004
STAT,1864,67,na,1931,1441.1312822668517
STAT,1878,32,30-34,1910,17.96376603050229
STAT,1876,21,40-44,1897,2.1128989176638555
STAT,1905,22,25-29,1927,82.33753885093346
STAT,1870,67,na,1937,1580.3561782437926
STAT,1866,44,50-100,1910,0.9513321524323615
SIM,1844,39,45-49,1883,25
STAT,1872,36,45-49,1908,2.0058048423076764
SIM,1899,8,na,1907,2284
SIM,1928,29,na,1957,4610
SIM,1802,55,na,1857,1007
STAT,1890,81,na,1971,1112.9809026758498
STAT,1936,16,25-29,1952,41.17803428836369
SIM,1886,32,30-34,1918,441
STAT,1920,40,20-24,1960,0.01930738984262036
SIM,1857,23,na,1880,1433
STAT,1885,66,na,1951,1611.0639718121065
SIM,1897,29,na,1926,2802
STAT,1837,36,25-29,1873,2.8401242012472356
STAT,1862,16,30-34,1878,1.5640310917220817
STAT,1935,36,na,1971,5227.657227665615
STAT,1781,107,na,1888,0.008953134726931981
SIM,1880,36,45-49,1916,1
STAT,1859,28,25-29,1887,33.86163195192064
STAT,1880,35,30-34,1915,5.585471762432204
STAT,1958,12,na,1970,5113.674345288398
STAT,1843,36,na,1879,2496.2621561870023
STAT,1914,48,30-34,1962,0.08693921206316695
STAT,1866,27,20-24,1893,10.70868829178201
STAT,1885,44,20-24,1929,0.15399804122462452
STAT,1879,33,40-44,1912,4.43000273794516
SIM,1926,11,na,1937,6307
SIM,1934,30,na,1964,5204
SIM,1888,20,na,1908,517
STAT,1882,43,40-44,1925,2.1379235085811317
STAT,1827,73,na,1900,837.5931445339467
STAT,1877,25,30-34,1902,25.73608429870795
STAT,1926,20,45-49,1946,1.3633172895595622
STAT,1843,34,15-19,1877,0.16567792761989775
STAT,1845,42,25-29,1887,0.3244864301244683
STAT,1866,39,15-19,1905,0.05074303652595879
STAT,1865,46,45-49,1911,0.21607763978348643
SIM,1945,20,20-24,1965,112
STAT,1929,21,25-29,1950,116.34023225528547
STAT,1861,18,30-34,1879,1.514570111263635
STAT,1856,48,45-49,1904,0.16737796705856117
STAT,1824,50,40-44,1874,0.0018466087104485824
STAT,1870,16,30-34,1886,1.613622136315337
SIM,1890,43,40-44,1933,14
STAT,1836,44,25-29,1880,0.5705709361140868
STAT,1820,34,20-24,1854,7.563941884373529
SIM,1887,33,40-44,1920,52
STAT,1815,52,40-44,1867,0.001030219978955118
STAT,1818,37,na,1855,1867.9693626985122
SIM,1909,31,na,1940,4013
STAT,1896,45,35-39,1941,0.10514056135346231
STAT,1873,45,40-44,1918,0.1773642623987684
SIM,1826,76,na,1902,32
STAT,1863,38,35-39,1901,6.00829035313125
STAT,1852,72,na,1924,1271.2147658916385
STAT,1863,26,40-44,1889,2.575844296048681
STAT,1854,28,40-44,1882,1.733540793195103
STAT,1847,50,35-39,1897,0.007895449941358226
STAT,1838,52,35-39,1890,0.003655476673377668
STAT,1813,44,30-34,1857,4.676459947462903
SIM,1951,10,na,1961,2373
SIM,1900,18,na,1918,4093
STAT,1872,36,35-39,1908,7.116626406648576
STAT,1881,53,na,1934,2000.691658370446
STAT,1885,67,na,1952,1558.1888522572333
STAT,1845,22,30-34,1867,10.972747584670847
SIM,1812,46,30-34,1858,1
SIM,1917,50,na,1967,1988
STAT,1822,42,30-34,1864,2.049722029715878
STAT,1846,29,45-49,1875,0.7841375746833056
STAT,1856,86,na,1942,159.36335772290005
STAT,1872,24,40-44,1896,2.073579229326344
STAT,1895,16,35-39,1911,0.7155537296754079
STAT,1835,28,30-34,1863,24.653709285823073
STAT,1886,18,35-39,1904,0.5667270826483994
STAT,1837,36,40-44,1873,4.318096647122673
STAT,1892,37,na,1929,2916.9207984129193
STAT,1875,37,15-19,1912,0.05766243665549363
STAT,1879,53,35-39,1932,0.008689716469957372
STAT,1889,19,15-19,1908,7.108209097954355
STAT,1880,22,25-29,1902,59.42978658194556
STAT,1858,28,25-29,1886,32.8321073403109
STAT,1825,38,15-19,1863,0.07885474488744568
STAT,1853,19,35-39,1872,0.5057928415031677
STAT,1859,37,30-34,1896,4.2241840072434425
STAT,1861,38,25-29,1899,2.382587512476073
STAT,1899,46,15-19,1945,3.090598953782456E-4
SIM,1842,16,20-24,1858,51
STAT,1877,48,na,1925,2255.1623803792754
STAT,1894,37,25-29,1931,3.661355671204682
STAT,1843,47,20-24,1890,0.011801261499847388
STAT,1857,29,20-24,1886,9.139796603352814
STAT,1871,37,30-34,1908,5.316486361905864
SIM,1919,25,25-29,1944,211
STAT,1792,70,na,1862,853.3967334600973
STAT,1881,85,na,1966,499.7416710389818
SIM,1910,28,na,1938,4276
STAT,1844,43,20-24,1887,0.1590853122644293
STAT,1856,53,40-44,1909,0.0074401133343998
STAT,1816,51,45-49,1867,0.04332173853180807
SIM,1827,32,30-34,1859,28
STAT,1827,46,25-29,1873,0.05341801974510129
STAT,1848,67,na,1915,1483.406509234799
STAT,1873,34,na,1907,2426.8719157597434
STAT,1833,43,45-49,1876,0.7686462435335448
STAT,1886,23,30-34,1909,18.388514946320026
STAT,1827,51,20-24,1878,6.661009724137481E-4
STAT,1859,49,25-29,1908,0.044700127599752386
STAT,1878,54,30-34,1932,0.00595597820165506
SIM,1823,47,45-49,1870,6
STAT,1917,22,45-49,1939,1.1798853762675894
STAT,1831,35,35-39,1866,7.369218816482932
STAT,1881,17,45-49,1898,0.06168716157501526
SIM,1851,47,20-24,1898,1
STAT,1871,43,na,1914,2288.9076294509937
SIM,1876,27,30-34,1903,485
STAT,1876,46,20-24,1922,0.012165338716026855
STAT,1823,100,na,1923,0.8386751465242872
STAT,1882,38,45-49,1920,1.8991180446150693
STAT,1808,46,15-19,1854,7.766210415620057E-4
SIM,1821,39,35-39,1860,3
STAT,1867,38,na,1905,2217.0669689113115
STAT,1833,26,na,1859,1173.0814091997763
SIM,1840,44,40-44,1884,1
STAT,1892,29,15-19,1921,0.5577115524605226
STAT,1894,42,20-24,1936,0.014006969202887522
STAT,1895,49,35-39,1944,0.10058709103891592
STAT,1928,22,20-24,1950,137.77652990686528
STAT,1818,108,na,1926,0.0011148900608863358
STAT,1850,40,40-44,1890,1.0491094894649222
STAT,1859,41,15-19,1900,0.010995095104215258
STAT,1902,64,na,1966,2699.487264847647
SIM,1866,28,25-29,1894,13
STAT,1877,45,25-29,1922,0.05905386163242763
STAT,1882,30,35-39,1912,9.773692768649031
STAT,1830,39,35-39,1869,6.318825143930089
STAT,1837,53,30-34,1890,0.004696319365035237
SIM,1901,67,na,1968,2671
STAT,1873,22,50-100,1895,0.41830309228147644
STAT,1894,17,30-34,1911,2.0268576865408447
STAT,1899,26,20-24,1925,16.078594410955954
STAT,1818,48,25-29,1866,0.10117423401155794
SIM,1830,38,na,1868,542
STAT,1847,18,na,1865,2574.9825859346106
SIM,1938,12,na,1950,4240
STAT,1865,51,40-44,1916,0.009657638052794973
STAT,1835,48,25-29,1883,0.04535316575130862
STAT,1832,44,40-44,1876,0.20120456469967785
SIM,1855,57,na,1912,2860
SIM,1861,36,25-29,1897,2
STAT,1855,37,na,1892,1559.2716173919966
STAT,1896,28,45-49,1924,1.4584813737133187
SIM,1831,55,na,1886,2133
SIM,1837,60,na,1897,1516
STAT,1805,50,30-34,1855,0.007264112330628843
STAT,1861,30,15-19,1891,0.11938431495489495
STAT,1876,33,15-19,1909,0.1433535456764015
STAT,1850,35,45-49,1885,0.9547151452035849
STAT,1854,15,35-39,1869,0.369300348048656
STAT,1829,37,45-49,1866,1.0110645199312174
STAT,1869,39,40-44,1908,4.37280103674829
STAT,1895,46,30-34,1941,0.0712335527961412
STAT,1865,18,15-19,1883,5.550462044388631
STAT,1872,92,na,1964,109.61280550872142
SIM,1896,71,na,1967,1165
STAT,1838,32,40-44,1870,2.3003813874846726
STAT,1864,25,45-49,1889,1.0201721722860249
STAT,1805,62,na,1867,368.32740414832125
STAT,1813,81,na,1894,396.12408448275414
STAT,1855,32,40-44,1887,2.9224528386449156
STAT,1876,29,30-34,1905,25.274641737777596
STAT,1844,108,na,1952,0.0018146682292400555
STAT,1849,53,50-100,1902,0.012521133264009904
STAT,1948,21,35-39,1969,10.704246700526422
STAT,1860,26,15-19,1886,0.376798183271021
STAT,1814,43,35-39,1857,6.150930760805381
STAT,1844,30,15-19,1874,0.17225045996535976
STAT,1884,18,na,1902,2411.358679306627
STAT,1859,54,20-24,1913,5.687859335617352E-4
SIM,1879,16,na,1895,1848
STAT,1809,76,na,1885,950.2432379883044
STAT,1937,15,25-29,1952,41.91603579140794
STAT,1869,43,25-29,1912,0.6433081007350604
STAT,1857,52,45-49,1909,0.011076982626779964
STAT,1871,15,35-39,1886,0.5574437189495003
STAT,1849,35,20-24,1884,0.6785683465427664
STAT,1830,31,25-29,1861,9.721349897151795
SIM,1910,45,50-100,1955,2
STAT,1839,28,15-19,1867,0.5272073768391556
STAT,1853,36,25-29,1889,2.2557993578403583
STAT,1862,16,50-100,1878,0.048074716405897645
STAT,1840,46,40-44,1886,0.06885492137838005
SIM,1850,26,na,1876,1463
STAT,1881,34,35-39,1915,9.481593526629272
STAT,1879,28,45-49,1907,1.1349839251050267
STAT,1829,54,35-39,1883,0.003365540866225418
STAT,1821,33,25-29,1854,14.289268705582629
SIM,1835,26,30-34,1861,124
SIM,1945,15,25-29,1960,19
STAT,1864,47,40-44,1911,0.15491337608116207
STAT,1844,38,25-29,1882,2.9830540536437002
STAT,1932,29,50-100,1961,1.2933503472850552
SIM,1827,27,35-39,1854,2
SIM,1863,41,30-34,1904,1
STAT,1823,46,40-44,1869,0.2709607648637889
STAT,1930,28,na,1958,4727.678589237456
SIM,1832,50,40-44,1882,2
STAT,1867,104,na,1971,0.7342579709953412
STAT,1854,40,25-29,1894,0.3606534334667149
STAT,1855,27,45-49,1882,0.7659472101679071
STAT,1841,45,45-49,1886,0.270844539098622
STAT,1891,41,40-44,1932,2.778514655583942
STAT,1891,36,45-49,1927,2.463246865060201
SIM,1836,38,40-44,1874,6
STAT,1818,40,15-19,1858,0.02851355750199728
STAT,1777,81,na,1858,505.47073441386436
STAT,1801,80,na,1881,234.00937016698958
STAT,1892,69,na,1961,1976.2810065497367
STAT,1881,51,25-29,1932,0.0033608959925009413
STAT,1885,31,15-19,1916,0.14055157669868953
STAT,1853,41,20-24,1894,0.12369901759766869
STAT,1860,91,na,1951,47.27337512727986
STAT,1890,37,40-44,1927,5.299436718800544
SIM,1884,29,30-34,1913,7
STAT,1845,25,35-39,1870,5.912401866366746
STAT,1819,52,25-29,1871,6.221091661139727E-4
STAT,1848,18,15-19,1866,6.843715366379904
STAT,1890,24,35-39,1914,7.020249743109131
STAT,1851,36,15-19,1887,0.04529327725092357
STAT,1918,15,15-19,1933,9.82224963743533
SIM,1817,38,30-34,1855,76
STAT,1856,54,na,1910,1503.9920591607163
STAT,1892,40,45-49,1932,1.8716782184841225
STAT,1895,29,40-44,1924,3.8689951434317025
STAT,1797,58,na,1855,41.17638
STAT,1834,36,15-19,1870,0.031104696323484626
STAT,1875,40,45-49,1915,1.5523354481060845
SIM,1851,75,na,1926,592
STAT,1880,36,na,1916,2457.640284271933
STAT,1929,31,na,1960,4773.146258278835
STAT,1885,39,25-29,1924,2.801621272513943
SIM,1916,33,na,1949,4643
STAT,1881,47,40-44,1928,0.1609186125628762
STAT,1947,1,na,1948,4586.613730097332
STAT,1828,38,40-44,1866,5.757799691994472
STAT,1838,27,45-49,1865,0.6029081727414386
STAT,1851,23,na,1874,2002.1309706640639
STAT,1840,33,35-39,1873,4.806672049155894
SIM,1901,7,na,1908,4179
STAT,1844,26,30-34,1870,30.760725868881696
STAT,1939,31,35-39,1970,9.226922556880803
SIM,1882,41,40-44,1923,11
STAT,1805,94,na,1899,2.6813909231482813
STAT,1854,4,na,1858,1772.8452642272373
STAT,1829,42,40-44,1871,1.0821118259283353
SIM,1908,14,na,1922,2858
SIM,1832,45,45-49,1877,5
STAT,1874,41,40-44,1915,2.3319060651268337
STAT,1942,29,na,1971,3883.032065196252
STAT,1871,2,na,1873,3304.1443116615037
STAT,1937,20,20-24,1957,107.23645618070016
SIM,1873,0,na,1873,3629
STAT,1891,26,50-100,1917,0.7893476897823631
STAT,1824,45,45-49,1869,0.041888005409787515
STAT,1835,40,15-19,1875,0.012844809630375209
SIM,1856,2,na,1858,2567
STAT,1807,50,40-44,1857,0.03501498552241009
SIM,1919,47,50-100,1966,1
STAT,1818,53,20-24,1871,0.0012377641284816432
STAT,1946,17,50-100,1963,0.4110563722667312
STAT,1868,87,na,1955,170.16788472198695
SIM,1829,41,na,1870,2071
SIM,1842,39,na,1881,2931
STAT,1954,15,25-29,1969,53.12701171555065
SIM,1831,48,50-100,1879,3
STAT,1864,73,na,1937,1079.793247878208
STAT,1886,43,25-29,1929,0.6601820715684191
STAT,1940,3,na,1943,4055.3943342321954
SIM,1868,33,30-34,1901,20
SIM,1942,1,na,1943,3748
STAT,1854,45,30-34,1899,0.05435909871777742
STAT,1840,30,30-34,1870,8.54922691285819
STAT,1809,50,15-19,1859,2.1157705191955019E-4
STAT,1813,47,35-39,1860,0.5148969235888075
SIM,1881,48,45-49,1929,2
STAT,1888,43,35-39,1931,2.074878019683331
STAT,1909,20,45-49,1929,1.0412805075764333
SIM,1871,20,na,1891,1978
STAT,1896,33,40-44,1929,5.692659019989325
STAT,1886,35,25-29,1921,3.0098690943794026
STAT,1849,27,20-24,1876,11.717533317360921
SIM,1905,49,na,1954,2850
STAT,1825,41,45-49,1866,2.0228763841796487
STAT,1834,109,na,1943,3.135440645587201E-4
STAT,1834,75,na,1909,453.68935850865347
SIM,1901,35,na,1936,3755
SIM,1945,23,25-29,1968,240
SIM,1896,43,35-39,1939,1
STAT,1830,44,30-34,1874,0.9906260945030404
STAT,1870,28,25-29,1898,42.02324365332696
STAT,1882,46,45-49,1928,0.2265903319186239
STAT,1869,51,25-29,1920,0.0035912821329260893
SIM,1893,27,30-34,1920,11
STAT,1876,41,15-19,1917,0.014023635477959697
STAT,1937,23,25-29,1960,88.99049663506527
SIM,1810,93,na,1903,258
STAT,1867,43,15-19,1910,0.012966025815232115
STAT,1868,55,na,1923,1997.1442758364353
STAT,1873,15,45-49,1888,0.0678028600120347
STAT,1864,17,45-49,1881,0.06143255971551766
STAT,1864,41,na,1905,2110.6695455763593
STAT,1873,48,45-49,1921,0.23904219748217653
SIM,1844,73,na,1917,719
STAT,1833,58,na,1891,813.6571692288188
STAT,1910,27,50-100,1937,0.9504055607516396
SIM,1870,34,25-29,1904,21
STAT,1892,32,45-49,1924,2.1590154983443917
SIM,1873,30,35-39,1903,4
STAT,1928,30,20-24,1958,3.0301428773239585
SIM,1886,29,na,1915,3094
STAT,1819,44,25-29,1863,0.12202237299584155
STAT,1893,25,15-19,1918,0.5712168558083515
STAT,1844,51,20-24,1895,7.345463301742693E-4
STAT,1862,47,30-34,1909,0.0820641519483613
STAT,1793,76,na,1869,336.0118831972013
SIM,1859,35,30-34,1894,2
SIM,1880,24,na,1904,3300
SIM,1884,38,na,1922,3671
STAT,1863,24,na,1887,2029.8434673880486
SIM,1922,29,na,1951,3330
STAT,1841,50,40-44,1891,0.011891689904879843
STAT,1935,15,15-19,1950,61.881506768642225
STAT,1909,0,na,1909,4358.699340925771
STAT,1873,40,35-39,1913,1.8762386822437809
STAT,1853,16,30-34,1869,1.4954775543915597
STAT,1878,29,40-44,1907,3.0600155876586994
STAT,1861,35,20-24,1896,0.6471593774340395
STAT,1836,41,20-24,1877,0.14663806378237296
SIM,1867,37,30-34,1904,22
STAT,1835,53,20-24,1888,5.578401496462767E-4
STAT,1917,30,na,1947,3938.9450673613533
STAT,1838,89,na,1927,44.80241115676483
STAT,1883,19,20-24,1902,16.964147250240398
STAT,1943,20,45-49,1963,1.1842573041173252
SIM,1846,21,na,1867,1309
SIM,1817,40,na,1857,2763
STAT,1826,34,15-19,1860,0.25100671087981036
SIM,1815,45,45-49,1860,4
SIM,1935,9,na,1944,5881
STAT,1876,49,25-29,1925,0.05701253962204388
SIM,1833,41,45-49,1874,2
SIM,1819,38,40-44,1857,2
STAT,1910,51,na,1961,3346.125084245557
STAT,1867,18,25-29,1885,5.44643596395667
STAT,1919,32,20-24,1951,2.5966247428659495
SIM,1881,40,35-39,1921,7
SIM,1936,30,20-24,1966,4
STAT,1894,45,25-29,1939,0.04172962735885252
STAT,1852,24,15-19,1876,3.8884593781195713
SIM,1814,75,na,1889,26
STAT,1821,46,30-34,1867,0.10492566342770929
SIM,1810,61,na,1871,3098
SIM,1842,19,25-29,1861,6
STAT,1804,54,30-34,1858,0.03611033675765063
STAT,1815,40,na,1855,233.60918428618086
STAT,1814,40,30-34,1854,4.652260349163271
STAT,1923,38,30-34,1961,2.0874619915494295
STAT,1878,65,na,1943,1738.750434666928
SIM,1835,69,na,1904,796
STAT,1875,17,20-24,1892,18.20458190554067
STAT,1812,64,na,1876,165.19716232844968
STAT,1885,27,30-34,1912,24.752532216025738
SIM,1919,33,25-29,1952,4
STAT,1840,16,45-49,1856,0.03349904791468983
STAT,1877,42,20-24,1919,0.16101585890272674
STAT,1872,27,45-49,1899,1.11181268291382
SIM,1861,10,na,1871,2632
STAT,1833,40,40-44,1873,1.2029501256896045
SIM,1850,58,na,1908,1110
STAT,1945,22,20-24,1967,120.52208910717776
STAT,1877,50,20-24,1927,7.598415350747632E-4
STAT,1890,45,40-44,1935,0.209322217071096
STAT,1818,36,30-34,1854,15.102259139088401
STAT,1832,31,35-39,1863,0.6499555325598777
STAT,1800,63,na,1863,1511.7504505746451
STAT,1871,45,30-34,1916,0.09752490729560066
STAT,1816,45,50-100,1861,0.7688451295154822
STAT,1920,22,50-100,1942,0.7221010509339825
STAT,1823,54,40-44,1877,0.01519004322896781
STAT,1804,77,na,1881,664.9063821185927
STAT,1827,54,25-29,1881,0.0027416625040837207
STAT,1871,75,na,1946,1026.9333358251758
SIM,1890,35,40-44,1925,3
STAT,1845,17,35-39,1862,0.344136648318649
STAT,1847,25,45-49,1872,1.2240838449967895
STAT,1881,31,30-34,1912,16.555425693634692
SIM,1876,51,na,1927,3357
STAT,1817,95,na,1912,4.211885984827341
STAT,1875,89,na,1964,241.17285146927122
STAT,1895,41,25-29,1936,0.05827189741816756
SIM,1838,34,na,1872,2113
STAT,1870,20,15-19,1890,3.3085298458367145
STAT,1934,10,na,1944,5339.198600041069
STAT,1840,49,45-49,1889,0.09133790602036666
STAT,1893,33,15-19,1926,0.17733324006362633
STAT,1854,48,35-39,1902,0.0768643817629141
SIM,1836,22,30-34,1858,1
STAT,1836,32,30-34,1868,16.911220946281784
STAT,1860,34,15-19,1894,0.11518042059116679
STAT,1871,41,15-19,1912,0.013838240254018731
SIM,1839,44,50-100,1883,43
SIM,1865,35,na,1900,1586
STAT,1819,54,na,1873,558.0951784137169
STAT,1849,52,na,1901,1804.58347161703
STAT,1938,24,na,1962,3573.058024547238
STAT,1870,33,20-24,1903,2.6833968952620815
SIM,1869,49,na,1918,3591
STAT,1820,37,25-29,1857,5.3568840076050135
STAT,1866,42,45-49,1908,1.3644791957821778
STAT,1804,50,15-19,1854,1.6177296696734194E-4
SIM,1855,25,45-49,1880,4
STAT,1835,45,20-24,1880,0.010789887735196551
STAT,1846,76,na,1922,561.1101065817768
STAT,1880,27,30-34,1907,26.14270133269571
STAT,1880,18,40-44,1898,0.18938413445676622
STAT,1865,90,na,1955,71.98073352111844
SIM,1869,49,35-39,1918,2
STAT,1842,62,na,1904,453.72414749046226
STAT,1826,42,15-19,1868,0.02074896143067484
STAT,1832,47,45-49,1879,0.02136378087550461
STAT,1828,50,25-29,1878,0.00424871982437071
SIM,1925,30,45-49,1955,4
SIM,1852,60,na,1912,1806
STAT,1924,20,35-39,1944,11.069573103609459
STAT,1872,53,25-29,1925,0.0034898804475083523
STAT,1913,16,na,1929,3908.954755976612
STAT,1827,29,35-39,1856,10.42057109865745
STAT,1863,43,30-34,1906,0.9743958711786321
STAT,1882,35,40-44,1917,4.2308691661057
STAT,1891,20,35-39,1911,7.218874050410703
STAT,1813,101,na,1914,0.41799664323299945
STAT,1840,41,35-39,1881,0.75337029902013
SIM,1899,9,na,1908,2248
SIM,1930,16,na,1946,4826
SIM,1898,28,20-24,1926,38
STAT,1815,44,40-44,1859,0.23103421691656098
SIM,1797,78,na,1875,564
SIM,1837,34,40-44,1871,17
STAT,1867,35,15-19,1902,0.05361142139912616
STAT,1799,92,na,1891,2.769632639396864
STAT,1839,74,na,1913,1031.066938834545
SIM,1899,68,na,1967,1469
SIM,1871,43,30-34,1914,8
STAT,1830,40,15-19,1870,0.012525116982582594
STAT,1819,86,na,1905,51.60670611642157
STAT,1849,38,25-29,1887,2.456783982630322
STAT,1890,15,50-100,1905,0.0595854869758668
SIM,1857,38,25-29,1895,29
STAT,1831,27,35-39,1858,11.454831232215342
SIM,1860,32,15-19,1892,1
STAT,1887,47,35-39,1934,0.15337585135654633
STAT,1836,24,30-34,1860,17.75575238952701
SIM,1891,40,na,1931,2059
STAT,1851,28,15-19,1879,0.41654328096200943
STAT,1818,69,na,1887,964.4071385081492
STAT,1918,23,15-19,1941,5.64625952042729
STAT,1834,44,15-19,1878,0.007151550192307399
SIM,1895,54,na,1949,4395
SIM,1840,31,35-39,1871,62
STAT,1869,40,20-24,1909,0.16187238763459647
STAT,1814,55,na,1869,1815.1308593420251
SIM,1839,19,na,1858,1219
STAT,1884,18,50-100,1902,0.04677569891675369
STAT,1876,38,20-24,1914,0.7753922154393065
STAT,1884,48,20-24,1932,0.011342931268399678
STAT,1856,24,50-100,1880,0.33530502709378507
STAT,1829,34,40-44,1863,2.2787963095102466
STAT,1946,11,na,1957,4310.443104591805
STAT,1848,54,45-49,1902,0.013206897164576988
SIM,1926,23,15-19,1949,7
STAT,1896,25,40-44,1921,3.9756283096907925
SIM,1926,43,na,1969,5889
STAT,1833,51,45-49,1884,0.0065385085985622616
STAT,1868,27,30-34,1895,24.322463106270792
STAT,1888,32,na,1920,2754.193597591011
STAT,1838,57,na,1895,857.0518414139723
SIM,1858,22,na,1880,1821
STAT,1875,45,15-19,1920,4.1483545095935797E-4
STAT,1880,30,25-29,1910,10.718878108297302
SIM,1895,47,35-39,1942,1
STAT,1851,31,45-49,1882,1.4484409363836404
STAT,1872,28,35-39,1900,9.628036655964118
STAT,1846,46,35-39,1892,0.08315193640976526
STAT,1962,7,na,1969,4988.978765337721
SIM,1964,5,na,1969,5113
STAT,1872,19,45-49,1891,0.06506052949988865
SIM,1821,77,na,1898,965
STAT,1896,42,30-34,1938,0.10511163620563188
SIM,1872,37,na,1909,2360
STAT,1857,37,20-24,1894,0.5915196991797572
STAT,1874,44,45-49,1918,1.5237825729182806
STAT,1863,88,na,1951,117.20068901475712
STAT,1891,28,45-49,1919,1.3605655609694087
STAT,1888,26,45-49,1914,1.285869234779505
STAT,1834,43,na,1877,1102.7761572138493
SIM,1851,43,na,1894,1178
SIM,1869,41,25-29,1910,1
STAT,1882,47,50-100,1929,0.2340437247831233
STAT,1914,25,50-100,1939,0.9961718366768307
STAT,1807,53,45-49,1860,0.04531535868726803
SIM,1880,19,45-49,1899,37
STAT,1931,18,50-100,1949,0.48566504968268415
STAT,1862,22,30-34,1884,15.530846642265539
SIM,1951,6,na,1957,2373
SIM,1882,44,45-49,1926,1
STAT,1851,87,na,1938,139.14627459864838
STAT,1917,30,45-49,1947,1.6388518185994192
STAT,1829,51,30-34,1880,0.002713795542447273
STAT,1791,103,na,1894,0.03618769956807854
SIM,1880,88,na,1968,1627
STAT,1852,32,15-19,1884,0.14841750649688568
STAT,1901,15,na,1916,3547.7479736597807
STAT,1905,29,na,1934,3408.0520570290714
STAT,1869,33,50-100,1902,0.920665116277739
STAT,1877,15,50-100,1892,0.04996371811613572
STAT,1878,37,40-44,1915,4.5038779564727465
SIM,1814,41,35-39,1855,16
SIM,1949,16,20-24,1965,1121
STAT,1841,42,40-44,1883,2.6027122534490124
STAT,1855,24,40-44,1879,1.5881250792549404
STAT,1822,42,na,1864,1588.5530115546385
STAT,1826,56,na,1882,1741.4227512735094
STAT,1859,16,25-29,1875,5.244472546168022
STAT,1856,45,40-44,1901,0.12419091684161988
STAT,1845,34,25-29,1879,5.9189722604901345
STAT,1848,51,40-44,1899,0.009898642224934457
SIM,1793,64,na,1857,938
SIM,1878,27,40-44,1905,6
STAT,1897,68,na,1965,2277.384534601145
STAT,1863,34,40-44,1897,3.670610512986372
SIM,1906,30,35-39,1936,94
STAT,1842,18,20-24,1860,5.618187847810998
STAT,1893,54,na,1947,2618.6232429598476
STAT,1895,30,20-24,1925,3.544599525976951
SIM,1867,16,25-29,1883,15
STAT,1868,47,25-29,1915,0.05537479161444484
STAT,1873,32,35-39,1905,10.38813796239961
STAT,1880,38,35-39,1918,7.306364700369444
STAT,1814,51,35-39,1865,0.0289557272654669
SIM,1930,3,na,1933,5792
STAT,1881,42,35-39,1923,1.707932610233061
STAT,1853,44,25-29,1897,0.49120030339687726
STAT,1850,110,na,1960,3.0229407040701305E-4
SIM,1898,39,25-29,1937,6
STAT,1831,52,25-29,1883,0.0029381642856637514
STAT,1889,17,na,1906,3041.3980808301953
STAT,1900,45,25-29,1945,0.04545830724510528
STAT,1842,19,na,1861,723.1432190161165
SIM,1894,32,20-24,1926,1
STAT,1877,16,na,1893,2570.0908964055307
STAT,1924,32,na,1956,4370.04789910907
STAT,1835,37,20-24,1872,0.721060692608283
STAT,1830,47,35-39,1877,0.11964366255555932
SIM,1850,26,20-24,1876,36
SIM,1837,71,na,1908,1470
STAT,1809,46,30-34,1855,0.8709617305430452
SIM,1848,9,na,1857,2793
STAT,1896,17,40-44,1913,0.24110804790076115
SIM,1861,28,25-29,1889,3
STAT,1833,48,15-19,1881,1.804420434583595E-4
STAT,1847,106,na,1953,0.010977507688208392
STAT,1899,18,20-24,1917,24.151378364079726
STAT,1916,13,na,1929,4126.529902259987
STAT,1901,49,35-39,1950,0.10811390100529165
SIM,1852,34,30-34,1886,166
STAT,1919,35,25-29,1954,1.0495457209310992
STAT,1853,28,25-29,1881,34.32935346074011
SIM,1866,73,na,1939,1684
STAT,1839,53,40-44,1892,0.009623839675344604
STAT,1863,51,30-34,1914,0.0051060790052355545
STAT,1846,30,25-29,1876,7.31928161369963
STAT,1896,36,45-49,1932,2.6405193359357764
SIM,1837,26,40-44,1863,2
STAT,1893,49,25-29,1942,0.03978279789157377
STAT,1844,22,15-19,1866,4.080693626852447
SIM,1875,27,15-19,1902,4
SIM,1879,43,35-39,1922,17
STAT,1814,52,25-29,1866,0.011678893010977512
SIM,1923,46,na,1969,4224
SIM,1857,3,na,1860,1831
SIM,1835,37,35-39,1872,16
STAT,1883,50,45-49,1933,0.014162202798624983
SIM,1858,54,na,1912,2290
STAT,1895,38,30-34,1933,6.898712878917145
STAT,1952,15,15-19,1967,53.91781371614009
STAT,1869,72,na,1941,1274.3643691559207
SIM,1828,47,45-49,1875,1
STAT,1850,27,45-49,1877,0.6033400255970363
SIM,1895,38,45-49,1933,43
STAT,1869,47,40-44,1916,0.17194942641538785
SIM,1874,17,na,1891,2705
SIM,1963,4,na,1967,5559
STAT,1829,45,45-49,1874,0.11203169914701662
SIM,1865,7,na,1872,2035
STAT,1907,49,50-100,1956,0.19898492055700506
STAT,1946,17,40-44,1963,1.5346108296414365
STAT,1842,26,20-24,1868,3.6275001884887814
STAT,1922,20,na,1942,4165.768800594684
STAT,1864,34,35-39,1898,9.127754959144418
STAT,1841,77,na,1918,962.556861802963
STAT,1883,31,40-44,1914,4.18915847444842
STAT,1836,35,35-39,1871,6.792128356530594
STAT,1875,32,45-49,1907,1.790647696805931
STAT,1893,41,15-19,1934,0.017347716828654602
SIM,1845,32,25-29,1877,21
STAT,1894,71,na,1965,1967.8345112709446
STAT,1887,38,45-49,1925,2.1832942495949426
STAT,1851,24,20-24,1875,64.06595615558196
STAT,1859,51,na,1910,1714.7501774281793
SIM,1831,30,30-34,1861,19
STAT,1827,41,na,1868,1916.807162479038
STAT,1890,21,30-34,1911,21.62878204581851
SIM,1882,33,40-44,1915,1
SIM,1854,30,25-29,1884,21
STAT,1870,40,50-100,1910,1.0638391771853328
STAT,1910,27,40-44,1937,4.450577557835616
STAT,1827,37,35-39,1864,6.974427302776916
STAT,1816,89,na,1905,88.68896264479181
STAT,1844,34,30-34,1878,20.259365061024134
STAT,1834,27,25-29,1861,24.445953161265386
STAT,1849,39,15-19,1888,0.04742103320623359
STAT,1870,41,20-24,1911,0.15904236078561315
STAT,1894,28,35-39,1922,12.226951329181622
STAT,1847,17,45-49,1864,0.0737116789914748
STAT,1839,40,35-39,1879,1.9990774989009534
STAT,1880,26,40-44,1906,3.120530213665447
STAT,1837,32,25-29,1869,10.29714007316974
STAT,1844,10,na,1854,3044.0
SIM,1895,39,35-39,1934,3
STAT,1821,42,15-19,1863,0.015556944665835966
STAT,1841,88,na,1929,152.8742046062091
STAT,1809,47,20-24,1856,0.10557069409005225
STAT,1874,52,45-49,1926,0.01489804214024453
SIM,1838,42,35-39,1880,3
STAT,1899,16,na,1915,3458.1151899868255
SIM,1861,27,35-39,1888,5
STAT,1857,40,50-100,1897,0.8188604819127348
SIM,1815,42,40-44,1857,4
STAT,1853,27,35-39,1880,8.667180653666955
STAT,1812,52,50-100,1864,0.003715815505938801
STAT,1855,52,35-39,1907,0.005667457102397421
STAT,1847,22,40-44,1869,2.309608771810142
STAT,1835,28,50-100,1863,0.6262748379981616
STAT,1884,50,na,1934,2090.7878490814132
STAT,1885,23,15-19,1908,3.232753384738655
STAT,1826,40,50-100,1866,1.6443494686023088
STAT,1939,20,30-34,1959,28.56682437853799
SIM,1794,81,na,1875,275
STAT,1888,64,na,1952,2006.3501816221526
STAT,1860,59,na,1919,1585.4628329525713
STAT,1871,51,50-100,1922,0.015137734960796276
STAT,1870,36,25-29,1906,2.8841822930490033
STAT,1853,42,50-100,1895,0.818152332260606
STAT,1862,39,na,1901,1986.4860413584477
SIM,1819,74,na,1893,915
STAT,1853,20,15-19,1873,3.0662891917363897
STAT,1887,39,35-39,1926,7.706622716684579
STAT,1937,31,25-29,1968,9.054943447158758
STAT,1886,32,20-24,1918,2.799152752541822
STAT,1870,24,30-34,1894,17.646489202551578
STAT,1825,34,20-24,1859,4.2059924314039
STAT,1926,42,50-100,1968,0.14358673065760352
STAT,1898,38,20-24,1936,0.22262554442154056
STAT,1781,86,na,1867,74.38292555197958
STAT,1844,21,na,1865,2663.8615516702484
STAT,1853,33,20-24,1886,2.136068831214271
SIM,1815,60,na,1875,642
SIM,1898,8,na,1906,4435
STAT,1870,69,na,1939,1463.042624189487
SIM,1859,27,30-34,1886,8
SIM,1895,31,25-29,1926,7
STAT,1890,40,35-39,1930,2.214304253913482
STAT,1890,48,45-49,1938,0.15913547609877457
STAT,1831,26,45-49,1857,1.3908117325534692
SIM,1896,28,na,1924,3682
STAT,1920,41,35-39,1961,0.21985341883765283
STAT,1834,54,50-100,1888,0.006559707857747263
STAT,1876,37,30-34,1913,5.387712989103526
STAT,1799,81,na,1880,42.26543593483017
STAT,1829,26,40-44,1855,2.5621765486714456
SIM,1894,16,na,1910,1764
STAT,1855,53,25-29,1908,0.0023065941327178215
STAT,1841,21,35-39,1862,8.291440995600652
STAT,1906,38,30-34,1944,1.6575158613069925
STAT,1855,35,45-49,1890,1.331892350955706
STAT,1885,29,50-100,1914,0.6242911778089388
STAT,1838,44,35-39,1882,0.8018343974416555
SIM,1847,70,na,1917,1382
SIM,1892,19,15-19,1911,13
STAT,1862,53,50-100,1915,0.012657091932957533
STAT,1876,41,50-100,1917,1.0728080356700471
STAT,1909,43,na,1952,3417.7849295925466
STAT,1819,41,20-24,1860,0.03789175055656589
STAT,1848,35,na,1883,2319.6250088956317
SIM,1927,28,na,1955,1694
SIM,1914,38,30-34,1952,9
SIM,1815,81,na,1896,339
STAT,1887,31,25-29,1918,11.319831682088195
STAT,1903,19,50-100,1922,0.06917156822939818
STAT,1822,50,30-34,1872,0.009980837799425976
STAT,1892,25,20-24,1917,14.623177382264329
STAT,1855,41,30-34,1896,0.7643352248992307
SIM,1923,14,na,1937,4291
STAT,1821,45,50-100,1866,0.2698099497942588
STAT,1863,18,40-44,1881,0.16118691410571923
STAT,1866,19,20-24,1885,16.415373563401566
STAT,1882,51,40-44,1933,0.010127505160300192
STAT,1846,37,45-49,1883,1.2329450362165046
STAT,1875,28,25-29,1903,43.28440878007132
STAT,1911,43,35-39,1954,0.18888763140218293
STAT,1906,14,na,1920,3727.5508755868063
STAT,1911,38,50-100,1949,0.39896805053553425
STAT,1845,31,20-24,1876,1.6114623959524321
STAT,1920,49,45-49,1969,0.23576915344624225
STAT,1879,71,na,1950,1369.291653200221
SIM,1904,32,na,1936,4172
STAT,1846,18,40-44,1864,0.13527823013152798
STAT,1863,46,35-39,1909,0.11985906023479646
STAT,1832,51,50-100,1883,0.0012325470702473384
STAT,1862,31,20-24,1893,2.311714702250643
SIM,1864,18,na,1882,2555
SIM,1908,46,na,1954,2223
STAT,1875,7,na,1882,2772.975472865781
STAT,1894,21,15-19,1915,4.207897843122482
STAT,1861,26,30-34,1887,21.247054068644406
STAT,1845,50,25-29,1895,0.0017828646016304088
STAT,1887,44,30-34,1931,1.248328354326676
STAT,1941,20,35-39,1961,9.626629154128983
STAT,1795,100,na,1895,0.25879684179142787
STAT,1919,40,20-24,1959,0.01893646676454581
SIM,1905,17,na,1922,3542
STAT,1898,53,na,1951,2848.9900678119534
STAT,1831,78,na,1909,611.510074773279
STAT,1892,42,50-100,1934,1.3063762187231722
STAT,1786,111,na,1897,1.0571752413186624E-4
SIM,1841,22,na,1863,1163
STAT,1892,5,na,1897,3244.596380427299
SIM,1876,38,35-39,1914,64
STAT,1884,1,na,1885,3182.1162616961383
STAT,1811,44,20-24,1855,0.7801863541764159
SIM,1845,36,na,1881,2521
STAT,1880,68,na,1948,1586.505086893838
STAT,1865,30,35-39,1895,9.320240839653549
STAT,1867,3,na,1870,3001.7375813667604
STAT,1830,93,na,1923,21.1525311759946
STAT,1838,20,50-100,1858,0.22912658767644964
SIM,1853,31,20-24,1884,1
STAT,1828,49,45-49,1877,0.2744197113518993
SIM,1933,38,40-44,1971,7
STAT,1855,50,50-100,1905,0.01013919070916641
STAT,1827,43,20-24,1870,0.1487060302812604
STAT,1872,20,25-29,1892,57.665466683242
STAT,1867,30,50-100,1897,0.8734861832128675
STAT,1873,41,25-29,1914,0.6616921143773612
SIM,1809,48,25-29,1857,1
STAT,1842,33,45-49,1875,0.5175448935066455
STAT,1899,27,na,1926,3259.674036500409
STAT,1897,33,35-39,1930,13.392513739361041
STAT,1901,29,40-44,1930,4.158507355234054
STAT,1868,39,25-29,1907,2.7529437975782485
STAT,1855,16,40-44,1871,0.14483223987849259
SIM,1861,21,na,1882,2540
STAT,1894,34,20-24,1928,3.40793835820394
STAT,1900,37,25-29,1937,0.8608848172537558
STAT,1886,20,na,1906,2463.73920299073
STAT,1807,96,na,1903,3.481486458049392
STAT,1947,16,45-49,1963,0.5569429462875991
SIM,1839,18,15-19,1857,1
STAT,1936,27,50-100,1963,0.943113696150931
STAT,1871,21,20-24,1892,68.9507610297088
STAT,1806,50,25-29,1856,0.009794757995922353
STAT,1888,18,45-49,1906,0.07519533483156939
STAT,1835,36,30-34,1871,5.037382984201268
STAT,1892,37,15-19,1929,0.06952461650249735
STAT,1895,34,na,1929,3077.7087112413637
STAT,1945,25,25-29,1970,71.47602240169105
STAT,1852,40,15-19,1892,0.014041071935684196
STAT,1936,15,30-34,1951,11.607367902085436
STAT,1899,48,na,1947,3034.9359492254584
STAT,1827,38,25-29,1865,2.804457418811459
STAT,1924,20,50-100,1944,0.7735551641669502
STAT,1941,12,na,1953,4011.5713923765657
STAT,1852,36,30-34,1888,5.450097237483327
STAT,1837,47,45-49,1884,0.19643322592480775
STAT,1955,15,40-44,1970,1.841563399053284
STAT,1816,40,40-44,1856,7.779426243283195
STAT,1945,26,na,1971,4066.339420268579
STAT,1842,46,15-19,1888,1.0059486889460411E-4
STAT,1894,29,25-29,1923,53.40849460861603
SIM,1899,16,20-24,1915,19
STAT,1909,25,15-19,1934,0.6780453569374231
STAT,1802,97,na,1899,2.721938766582093
STAT,1968,4,na,1972,4861.695921095473
STAT,1868,38,35-39,1906,6.797644344559037
SIM,1914,6,na,1920,5124
STAT,1856,32,35-39,1888,7.362856716992978
SIM,1855,42,35-39,1897,7
STAT,1900,42,20-24,1942,0.015258538115426318
STAT,1817,48,30-34,1865,0.06692165809935365
STAT,1879,45,35-39,1924,0.1450493839264598
STAT,1846,38,35-39,1884,4.329319269979559
STAT,1919,15,30-34,1934,2.678899127788045
STAT,1837,28,40-44,1865,3.060737799943135
STAT,1888,21,50-100,1909,0.47207784239046136
STAT,1970,0,na,1970,4907.301138212038
SIM,1849,18,na,1867,2569
STAT,1901,48,50-100,1949,0.19127319174790366
STAT,1915,36,50-100,1951,0.4201601017110776
STAT,1864,50,35-39,1914,0.007939019460452284
SIM,1826,44,na,1870,1920
STAT,1874,49,15-19,1923,4.042067598559349E-4
STAT,1836,48,40-44,1884,0.13554208926935343
STAT,1827,30,15-19,1857,0.1514900006838598
SIM,1835,38,25-29,1873,3
SIM,1885,29,25-29,1914,2
STAT,1866,21,na,1887,2192.2281481887585
STAT,1898,45,45-49,1943,0.1807983020212775
STAT,1826,88,na,1914,109.44743248137925
STAT,1862,25,35-39,1887,8.368424186631087
STAT,1888,23,40-44,1911,2.3976248984801862
STAT,1861,27,20-24,1888,9.827261025791469
SIM,1912,51,na,1963,4476
STAT,1846,43,30-34,1889,0.6803737392124338
STAT,1847,42,35-39,1889,1.6463183996213933
STAT,1877,29,25-29,1906,42.634125467071584
SIM,1886,33,25-29,1919,16
SIM,1932,28,na,1960,6271
STAT,1926,25,15-19,1951,0.8447099584417026
STAT,1893,17,15-19,1910,7.42132083415405
SIM,1854,43,30-34,1897,2
STAT,1878,33,25-29,1911,10.493828820400084
STAT,1883,27,20-24,1910,11.286162890948637
STAT,1887,19,40-44,1906,0.20023687335192775
SIM,1886,38,30-34,1924,76
STAT,1893,20,45-49,1913,0.8772229932211286
STAT,1936,12,na,1948,3755.8122433072954
SIM,1835,34,30-34,1869,18
STAT,1847,38,15-19,1885,0.052132288633983226
STAT,1821,37,40-44,1858,5.402143639768284
STAT,1860,109,na,1969,0.007475699846389341
STAT,1896,21,25-29,1917,75.69063296975503
STAT,1880,51,30-34,1931,0.006209233110997693
STAT,1850,48,15-19,1898,1.823836897603649E-4
STAT,1928,16,35-39,1944,5.2599457321158765
STAT,1849,73,na,1922,1000.7907439083065
STAT,1922,20,25-29,1942,105.36992425033405
SIM,1879,40,30-34,1919,3
STAT,1829,29,45-49,1858,0.677392757820855
SIM,1886,72,na,1958,1682
STAT,1776,96,na,1872,2.8867233898606837
SIM,1900,39,40-44,1939,1
STAT,1861,22,15-19,1883,2.8186174431516196
SIM,1891,34,45-49,1925,1
STAT,1844,18,30-34,1862,1.995393839557112
STAT,1865,43,40-44,1908,2.0387342295687434
STAT,1794,101,na,1895,0.0013505316015279595
STAT,1834,24,20-24,1858,40.03694455055861
SIM,1933,13,na,1946,4529
SIM,1898,36,20-24,1934,4
SIM,1852,37,35-39,1889,30
STAT,1825,43,50-100,1868,1.3822190812816382
STAT,1833,27,45-49,1860,0.6824432646237153
SIM,1923,30,35-39,1953,72
STAT,1863,27,50-100,1890,0.5461132575263392
STAT,1878,30,20-24,1908,2.8034488024393083
STAT,1902,32,na,1934,3360.3087947397225
STAT,1879,50,na,1929,2240.546667671447
SIM,1897,31,35-39,1928,226
STAT,1889,48,20-24,1937,0.00804897604903468
SIM,1860,36,na,1896,2028
STAT,1823,33,35-39,1856,23.41352000474115
SIM,1837,30,25-29,1867,8
STAT,1820,50,20-24,1870,0.0011646267763727113
STAT,1868,44,20-24,1912,0.1513223634428338
STAT,1894,25,30-34,1919,32.24003083107791
STAT,1905,16,40-44,1921,0.2637193374057842
STAT,1828,42,25-29,1870,0.8030013960448262
STAT,1906,46,na,1952,3267.7873758224187
STAT,1844,37,35-39,1881,7.40454105684289
STAT,1883,34,45-49,1917,1.6632690566219215
STAT,1934,2,na,1936,5494.477448869968
SIM,1833,78,na,1911,1615
STAT,1857,17,na,1874,2070.291886376084
STAT,1895,33,25-29,1928,13.268093439091318
STAT,1895,42,15-19,1937,0.0012459785659248042
STAT,1878,86,na,1964,430.3426322714323
STAT,1857,41,40-44,1898,1.7338172846830722
STAT,1922,38,15-19,1960,0.02158536152998134
SIM,1831,33,35-39,1864,17
STAT,1876,8,na,1884,2701.270448333194
STAT,1816,43,45-49,1859,4.7903113440800835
STAT,1810,103,na,1913,0.004468279011089428
STAT,1829,30,25-29,1859,5.951288542463308
SIM,1837,38,35-39,1875,13
STAT,1851,20,50-100,1871,0.39019732082837405
STAT,1885,47,25-29,1932,0.05635392712503994
STAT,1904,16,50-100,1920,0.07016640560905688
STAT,1874,72,na,1946,1303.3915391652952
STAT,1831,23,40-44,1854,5.232661067713154
SIM,1937,27,na,1964,2780
STAT,1836,77,na,1913,661.5512760218434
STAT,1864,31,30-34,1895,15.937602529723954
SIM,1871,8,na,1879,2177
STAT,1833,110,na,1943,1.1369576855193378E-4
STAT,1915,30,35-39,1945,9.249358252579889
SIM,1824,43,45-49,1867,7
STAT,1858,49,30-34,1907,0.07237925455150808
STAT,1825,46,15-19,1871,5.149364245344084E-4
STAT,1917,15,20-24,1932,28.918994697992098
SIM,1801,57,na,1858,1904
STAT,1893,46,20-24,1939,0.008488855515482186
STAT,1872,38,50-100,1910,1.2233141109785948
STAT,1897,32,50-100,1929,1.2168216838323378
STAT,1896,29,35-39,1925,12.628585115142549
SIM,1852,92,na,1944,293
STAT,1866,50,45-49,1916,0.01343757101158853
STAT,1877,49,40-44,1926,0.1701600299590618
SIM,1836,22,na,1858,2090
STAT,1844,46,25-29,1890,0.05722569421256199
STAT,1829,38,35-39,1867,3.5273705136423956
STAT,1835,32,15-19,1867,0.1371784394853829
SIM,1830,26,30-34,1856,83
STAT,1852,16,15-19,1868,7.267706644247281
STAT,1925,38,40-44,1963,1.7784787118747205
STAT,1938,15,40-44,1953,1.371318683523281
STAT,1886,26,35-39,1912,10.026238549449621
STAT,1858,45,15-19,1903,3.0851082211064086E-4
STAT,1854,36,40-44,1890,2.44568377857444
STAT,1875,29,15-19,1904,0.46255569154612625
SIM,1857,42,45-49,1899,3
SIM,1868,32,na,1900,1203
STAT,1831,32,30-34,1863,18.567571890485894
STAT,1885,19,30-34,1904,1.5582910961854
STAT,1812,51,25-29,1863,8.891655025926234E-4
SIM,1842,24,20-24,1866,2
SIM,1897,13,na,1910,3016
SIM,1806,56,na,1862,47
STAT,1902,45,50-100,1947,0.19702984398412068
STAT,1838,41,30-34,1879,0.5813453072480634
STAT,1859,83,na,1942,314.64896167589404
STAT,1948,20,45-49,1968,1.2795845709799294
STAT,1931,13,na,1944,5141.7909359433015
STAT,1935,27,na,1962,5069.7523215838555
STAT,1874,28,45-49,1902,1.1418730785713525
SIM,1861,24,30-34,1885,14
STAT,1822,45,35-39,1867,0.24069565892953257
SIM,1878,39,35-39,1917,45
SIM,1869,17,na,1886,3761
SIM,1873,54,na,1927,1967
STAT,1838,16,40-44,1854,0.10374303954972164
STAT,1928,25,25-29,1953,81.01927284062212
STAT,1915,50,na,1965,3616.74908801374
STAT,1804,56,na,1860,2028.8301788853846
SIM,1862,36,40-44,1898,19
STAT,1819,35,35-39,1854,5.355297366059888
SIM,1835,37,na,1872,1252
STAT,1903,41,35-39,1944,0.17930640724131933
SIM,1911,49,45-49,1960,4
STAT,1888,39,15-19,1927,0.06415925741576718
SIM,1831,23,na,1854,2258
STAT,1850,92,na,1942,19.232102444587422
STAT,1853,24,30-34,1877,16.085304709145557
SIM,1860,25,na,1885,2134
STAT,1843,33,50-100,1876,1.0770918385867312
SIM,1936,25,25-29,1961,2
STAT,1849,42,45-49,1891,1.2595042921273525
STAT,1864,22,40-44,1886,1.9248670077410948
STAT,1885,28,20-24,1913,11.490831924358304
STAT,1887,35,40-44,1922,4.8639590084140405
STAT,1840,17,35-39,1857,0.2797346554169395
STAT,1931,31,30-34,1962,20.51121978216176
STAT,1861,51,20-24,1912,6.166217118528261E-4
STAT,1808,59,na,1867,637.4946519203351
STAT,1818,37,20-24,1855,1.9626207186589888
STAT,1860,47,20-24,1907,0.009743867215925985
STAT,1854,32,25-29,1886,5.832094574640968
STAT,1854,53,50-100,1907,0.008262566528582689
SIM,1873,43,40-44,1916,34
STAT,1832,40,25-29,1872,0.054967725917580486
SIM,1848,55,na,1903,2307
STAT,1921,35,na,1956,4158.188910366475
STAT,1859,38,50-100,1897,0.9682732757718384
STAT,1852,45,20-24,1897,0.01219947859660951
STAT,1837,37,30-34,1874,5.202943804892896
STAT,1903,49,45-49,1952,0.18502495933438298
STAT,1842,30,40-44,1872,1.3278091068282531
STAT,1860,21,45-49,1881,0.590664129519678
SIM,1909,23,15-19,1932,10
STAT,1875,25,20-24,1900,12.128194040114924
STAT,1922,44,50-100,1966,0.13289532075751084
STAT,1848,105,na,1953,0.02743753784075809
STAT,1909,16,25-29,1925,8.432353754548593
STAT,1866,47,15-19,1913,3.634249369342817E-4
STAT,1871,40,25-29,1911,0.6470433376258071
STAT,1860,38,30-34,1898,4.326262592689063
STAT,1825,37,25-29,1862,4.144135999361619
STAT,1920,50,na,1970,3972.6953181004565
SIM,1867,38,20-24,1905,1
STAT,1855,44,35-39,1899,1.182285608507784
STAT,1791,96,na,1887,2.0814965235690877
STAT,1869,18,35-39,1887,0.5580533139125998
STAT,1884,35,15-19,1919,0.05426573173140235
STAT,1847,31,50-100,1878,0.9827913305461
STAT,1834,28,15-19,1862,0.26031173564761784
STAT,1932,28,30-34,1960,50.93954224151003
STAT,1892,28,25-29,1920,52.1887747989415
STAT,1916,42,45-49,1958,0.16822681962444563
STAT,1846,34,40-44,1880,2.9729028396592194
STAT,1919,29,50-100,1948,1.0535996566710386
SIM,1917,16,25-29,1933,15
SIM,1904,30,25-29,1934,2
STAT,1924,6,na,1930,4727.090328629679
STAT,1822,74,na,1896,639.9599238745546
SIM,1849,40,45-49,1889,1
STAT,1872,17,na,1889,2537.3588867903804
STAT,1889,39,45-49,1928,2.3764455216041
STAT,1850,32,40-44,1882,2.0948464672805205
STAT,1890,15,45-49,1905,0.07944731596782238
STAT,1852,40,na,1892,2349.940924563803
STAT,1944,17,30-34,1961,12.96941637302307
STAT,1862,34,25-29,1896,8.649354500394116
STAT,1908,40,45-49,1948,0.15452015581367107
STAT,1832,27,15-19,1859,0.5508734848548746
STAT,1838,35,45-49,1873,1.0483865756068906
STAT,1897,30,30-34,1927,23.373795265317252
STAT,1838,47,50-100,1885,0.10786086432774424
STAT,1859,29,30-34,1888,20.01298812112219
STAT,1870,27,35-39,1897,9.6193364532596
SIM,1867,29,30-34,1896,60
STAT,1842,36,50-100,1878,0.3612621858390102
STAT,1828,46,40-44,1874,0.20712620330308065
STAT,1870,58,na,1928,1971.5324509548561
STAT,1811,47,25-29,1858,0.2707278345856706
STAT,1907,22,50-100,1929,0.5950057065555431
STAT,1791,85,na,1876,113.90772175292406
SIM,1883,25,20-24,1908,4
SIM,1817,42,50-100,1859,4
STAT,1848,47,20-24,1895,0.011176943520121647
STAT,1875,44,50-100,1919,1.0701769375185766
STAT,1901,47,na,1948,3131.6779931384917
STAT,1939,23,35-39,1962,9.349231407895383
SIM,1853,55,na,1908,3004
STAT,1895,37,40-44,1932,5.694572933053218
STAT,1871,48,35-39,1919,0.13790132438877842
STAT,1880,31,15-19,1911,0.14844533316451433
STAT,1882,22,35-39,1904,5.586948487108515
SIM,1947,7,na,1954,4409
STAT,1821,89,na,1910,53.053827016972015
STAT,1868,35,30-34,1903,5.196572042957513
SIM,1840,59,na,1899,2500
STAT,1885,35,na,1920,2337.79974119617
STAT,1851,55,na,1906,1633.0648187386762
SIM,1855,25,na,1880,2926
SIM,1821,45,na,1866,1937
STAT,1881,21,na,1902,2240.1712819974637
STAT,1857,44,45-49,1901,1.13296183003875
SIM,1832,42,40-44,1874,6
STAT,1855,69,na,1924,971.2737369423693
STAT,1837,40,na,1877,2040.892389034172
SIM,1851,11,na,1862,1456
STAT,1898,42,40-44,1940,0.20977854698179163
STAT,1855,19,45-49,1874,0.05081716557431129
STAT,1900,18,50-100,1918,0.06768992196240345
STAT,1911,48,40-44,1959,0.14716782737159395
SIM,1854,40,na,1894,1622
SIM,1872,69,na,1941,1751
STAT,1877,17,30-34,1894,1.6179693051663049
STAT,1877,26,20-24,1903,11.949702902392966
STAT,1806,54,40-44,1860,0.02664664107228256
STAT,1872,52,35-39,1924,0.008574871256367987
SIM,1880,33,30-34,1913,1
STAT,1840,42,25-29,1882,0.26376179393219856
STAT,1881,22,50-100,1903,0.3850959614621381
STAT,1936,18,35-39,1954,3.9670779539461707
SIM,1846,47,50-100,1893,6
STAT,1940,27,na,1967,3777.1933090523844
STAT,1890,57,na,1947,2432.8738932360548
STAT,1888,48,50-100,1936,0.15788741037700052
SIM,1886,30,20-24,1916,7
STAT,1847,51,25-29,1898,0.003217716148316736
SIM,1900,29,na,1929,3760
STAT,1836,19,35-39,1855,0.9937056371276419
STAT,1889,49,na,1938,2653.239336985926
STAT,1867,27,15-19,1894,0.42908013156901365
STAT,1891,33,40-44,1924,5.310479758284354
STAT,1858,17,20-24,1875,15.81493795064471
SIM,1883,21,na,1904,2234
STAT,1905,41,30-34,1946,0.11534835433172713
STAT,1831,51,35-39,1882,0.007284240468559576
STAT,1889,31,35-39,1920,12.245103793474069
STAT,1872,33,30-34,1905,17.40967533200594
STAT,1896,35,50-100,1931,1.6338162352465682
STAT,1881,43,25-29,1924,0.6020389202733673
STAT,1824,42,40-44,1866,0.38304235343001347
STAT,1878,38,30-34,1916,5.456240745121247
STAT,1934,30,45-49,1964,2.13633137534309
SIM,1896,27,35-39,1923,72
STAT,1862,43,15-19,1905,0.011677429471601664
STAT,1851,27,25-29,1878,39.11770443504504
STAT,1860,18,15-19,1878,5.55075225710673
STAT,1817,44,15-19,1861,0.009801277993695418
STAT,1862,38,40-44,1900,3.710005375721857
SIM,1887,35,na,1922,3539
STAT,1852,48,25-29,1900,0.057250950175053654
SIM,1905,1,na,1906,3894
STAT,1823,59,na,1882,1658.2806037529788
SIM,1842,31,45-49,1873,7
STAT,1827,34,30-34,1861,17.483190664340896
SIM,1891,72,na,1963,675
SIM,1907,4,na,1911,4894
STAT,1852,39,35-39,1891,7.047862591386323
SIM,1887,42,30-34,1929,18
STAT,1803,82,na,1885,128.01023243827365
STAT,1883,0,na,1883,3407.5728811057197
STAT,1846,34,50-100,1880,0.6281040060562375
STAT,1911,40,30-34,1951,0.12201440900254634
STAT,1879,42,50-100,1921,1.0824161646156458
SIM,1790,67,na,1857,1247
SIM,1820,60,na,1880,37
SIM,1824,74,na,1898,1466
STAT,1835,92,na,1927,31.514242127253638
STAT,1853,52,25-29,1905,0.002731816068308006
SIM,1913,5,na,1918,3719
SIM,1829,36,35-39,1865,17
STAT,1868,31,15-19,1899,0.13810952790392733
SIM,1903,47,na,1950,2571
STAT,1879,42,30-34,1921,1.177923475843038
STAT,1834,31,45-49,1865,0.9947020605315561
STAT,1879,36,45-49,1915,2.054840777695932
STAT,1923,41,50-100,1964,0.13606123874159506
STAT,1918,5,na,1923,4317.348583751904
STAT,1913,43,45-49,1956,0.160010282273617
SIM,1845,58,na,1903,1890
STAT,1888,27,35-39,1915,11.136442973190558
STAT,1820,40,na,1860,1926.523324335632
STAT,1883,18,45-49,1901,0.06267842254992616
STAT,1903,17,na,1920,3585.1262252475685
STAT,1886,19,25-29,1905,5.836711357335061
STAT,1841,38,20-24,1879,1.0009053283433622
STAT,1911,35,35-39,1946,2.3318151362781645
STAT,1882,9,na,1891,2484.128344633896
STAT,1892,23,50-100,1915,0.5033227017554863
STAT,1858,88,na,1946,104.83857675649725
STAT,1858,51,50-100,1909,0.011588613694763559
STAT,1914,36,15-19,1950,0.018997753294456125
STAT,1788,76,na,1864,147.80392357021907
STAT,1916,44,25-29,1960,0.07194020472120798
STAT,1796,95,na,1891,5.206795686937059
STAT,1861,37,35-39,1898,5.882145324684404
STAT,1873,28,15-19,1901,0.46376061678890845
STAT,1859,53,30-34,1912,0.004642195089819322
STAT,1859,38,20-24,1897,0.6079387306681279
STAT,1931,9,na,1940,5173.9494541530985
STAT,1887,40,15-19,1927,0.015353483775122984
STAT,1845,54,40-44,1899,0.005080342249871105
STAT,1857,45,20-24,1902,0.009300140599698473
SIM,1928,13,na,1941,4638
STAT,1828,26,25-29,1854,96.05992533709218
SIM,1924,19,20-24,1943,89
STAT,1872,35,45-49,1907,2.015155162260565
SIM,1879,70,na,1949,463
STAT,1798,96,na,1894,3.6447608833411733
STAT,1845,38,na,1883,1215.6486741046351
STAT,1804,52,50-100,1856,0.09539584574082428
SIM,1910,49,na,1959,3788
STAT,1862,18,na,1880,2226.0140587144197
STAT,1901,31,45-49,1932,2.448202859296877
STAT,1834,48,30-34,1882,0.0446672528064047
STAT,1836,25,20-24,1861,11.801012167868741
STAT,1843,25,na,1868,2668.646398705738
SIM,1870,57,na,1927,1021
STAT,1818,40,50-100,1858,2.181286989508453
STAT,1826,49,35-39,1875,0.19509727124987122
STAT,1933,26,50-100,1959,1.3132420207749422
SIM,1921,43,45-49,1964,2
STAT,1853,18,50-100,1871,0.04542763554045786
STAT,1920,33,35-39,1953,9.839245899245444
STAT,1866,38,25-29,1904,2.615149269141974
STAT,1922,41,45-49,1963,0.18916927967229263
STAT,1881,74,na,1955,1048.0263597864723
STAT,1848,56,na,1904,1908.6376108018462
SIM,1874,38,25-29,1912,1
STAT,1850,60,na,1910,880.6624506833077
SIM,1912,45,45-49,1957,1
STAT,1904,45,45-49,1949,0.1920893678914086
STAT,1843,46,30-34,1889,0.09642432084663861
STAT,1894,49,40-44,1943,0.12024132622791416
STAT,1938,31,40-44,1969,3.8949900387845524
SIM,1839,40,na,1879,857
STAT,1935,31,15-19,1966,0.17660835433669075
STAT,1864,24,50-100,1888,0.3712965336715196
STAT,1863,27,30-34,1890,21.4980974347044
SIM,1868,21,na,1889,1315
SIM,1855,26,35-39,1881,127
SIM,1858,27,15-19,1885,1
STAT,1883,35,20-24,1918,0.7486328962989676
STAT,1865,36,na,1901,2161.3389255317347
STAT,1900,34,20-24,1934,3.712448894580165
STAT,1879,17,40-44,1896,0.18762924471506237
STAT,1850,36,20-24,1886,0.36535926406554387
STAT,1921,42,40-44,1963,0.2783808498999913
STAT,1803,60,na,1863,732.1463609811653
STAT,1940,26,15-19,1966,0.7121233907810036
STAT,1883,87,na,1970,423.3781596726866
STAT,1838,48,15-19,1886,1.7343274604359604E-4
STAT,1894,18,20-24,1912,22.485571362816746
STAT,1929,20,35-39,1949,11.894293952900993
STAT,1871,54,na,1925,2088.8134648381383
STAT,1923,34,15-19,1957,0.1455800714300028
STAT,1895,48,45-49,1943,0.17100092386530613
SIM,1802,63,na,1865,485
STAT,1913,30,25-29,1943,9.15335421352277
STAT,1827,27,20-24,1854,18.324536349731872
STAT,1879,29,35-39,1908,9.827510560532374
STAT,1873,55,na,1928,2121.0184439263157
STAT,1909,41,15-19,1950,0.0014299557524669918
STAT,1875,36,na,1911,2430.884332070389
STAT,1924,43,20-24,1967,0.020771749428930043
STAT,1907,46,25-29,1953,0.04754240260172593
STAT,1923,47,na,1970,4252.48323032219
STAT,1812,43,na,1855,252.86277843543112
STAT,1822,41,40-44,1863,4.1014467322154715
SIM,1862,38,na,1900,3669
SIM,1835,27,20-24,1862,61
STAT,1895,17,25-29,1912,7.371691080173839
STAT,1932,30,35-39,1962,12.077286901068327
STAT,1917,18,25-29,1935,9.176780943347781
STAT,1845,18,25-29,1863,3.5330970870704252
STAT,1847,26,35-39,1873,10.561344478371876
STAT,1934,37,50-100,1971,0.5754645620461111
STAT,1920,49,50-100,1969,0.24535976267499104
STAT,1870,32,30-34,1902,17.406170750859875
SIM,1862,44,40-44,1906,14
SIM,1856,38,45-49,1894,22
STAT,1843,109,na,1952,7.029540747659526E-4
STAT,1777,101,na,1878,0.34874834435239377
STAT,1916,19,20-24,1935,28.219822114686046
SIM,1835,45,35-39,1880,1
SIM,1936,32,na,1968,3792
STAT,1860,42,15-19,1902,0.011252080612502147
SIM,1921,30,25-29,1951,8
STAT,1939,19,15-19,1958,44.89821163389268
STAT,1862,15,20-24,1877,17.499714191152375
SIM,1833,37,25-29,1870,19
STAT,1911,24,50-100,1935,0.6131482914046467
STAT,1839,105,na,1944,0.027240841392042404
STAT,1905,19,45-49,1924,0.09345084057984432
STAT,1871,36,40-44,1907,4.387767446589827
SIM,1777,79,na,1856,215
SIM,1910,17,na,1927,4467
STAT,1815,48,20-24,1863,0.001200318327966605
STAT,1881,18,35-39,1899,0.5168146419316352
STAT,1848,38,45-49,1886,1.9025289133175358
STAT,1880,54,35-39,1934,0.008691756859844716
STAT,1920,46,40-44,1966,0.17246866301649363
STAT,1882,39,20-24,1921,0.7305908039946525
STAT,1894,36,35-39,1930,9.03763122340829
STAT,1895,9,na,1904,3375.2867848715514
STAT,1902,42,30-34,1944,0.11228253085158262
STAT,1837,19,na,1856,2424.237251992392
STAT,1845,49,45-49,1894,0.11466210538859346
SIM,1890,39,20-24,1929,10
STAT,1926,18,50-100,1944,0.4542150357736105
STAT,1920,20,15-19,1940,5.876652316329214
STAT,1861,54,25-29,1915,0.0028646855370861386
SIM,1869,70,na,1939,3598
STAT,1854,29,50-100,1883,0.3675337096573788
STAT,1851,40,35-39,1891,1.4445981798522136
STAT,1868,17,50-100,1885,0.04817659307770044
SIM,1852,42,30-34,1894,6
STAT,1855,28,35-39,1883,6.6085606569314574
STAT,1929,42,na,1971,4775.9522754272275
STAT,1835,38,na,1873,1982.7731074422925
STAT,1900,52,na,1952,2966.9544075890212
SIM,1916,12,na,1928,4860
STAT,1824,46,20-24,1870,0.002106178495881045
SIM,1907,61,na,1968,4004
STAT,1937,24,50-100,1961,0.6337039411156837
STAT,1896,21,50-100,1917,0.5391839355769982
STAT,1838,28,35-39,1866,5.201866626354156
STAT,1844,45,35-39,1889,0.14088367963417284
STAT,1851,47,50-100,1898,0.193068743407512
STAT,1923,47,20-24,1970,0.01279188586356518
STAT,1842,22,50-100,1864,0.12768301555077483
STAT,1848,88,na,1936,128.4664904396002
STAT,1885,15,50-100,1900,0.04838027807044141
STAT,1828,36,na,1864,1892.8899783339093
STAT,1878,53,40-44,1931,0.010657662104427095
SIM,1864,6,na,1870,2555
STAT,1903,46,40-44,1949,0.1374729049338825
SIM,1812,45,40-44,1857,5
STAT,1786,95,na,1881,4.954395031530926
STAT,1842,34,20-24,1876,0.7939473751760112
SIM,1936,0,na,1936,4709
STAT,1818,91,na,1909,35.27030221153742
STAT,1883,55,na,1938,1989.2297666322786
STAT,1859,48,35-39,1907,0.10956871313254814
STAT,1840,60,na,1900,750.9607581425184
SIM,1948,8,na,1956,5824
STAT,1832,41,na,1873,2206.582625957575
STAT,1891,74,na,1965,1666.182571936526
STAT,1939,30,45-49,1969,1.5896970294164892
STAT,1870,17,20-24,1887,17.842524492051773
STAT,1912,44,40-44,1956,0.23658958754703355
STAT,1874,37,20-24,1911,0.7955673220845838
STAT,1825,93,na,1918,17.997367121097962
SIM,1810,82,na,1892,1252
STAT,1915,48,25-29,1963,0.05255023112124815
STAT,1838,68,na,1906,651.733836573645
STAT,1928,41,25-29,1969,0.09047190100140927
STAT,1852,18,na,1870,2778.080363484816
SIM,1924,31,na,1955,5148
STAT,1903,49,na,1952,3127.5741208760896
STAT,1873,16,35-39,1889,0.566189514700574
SIM,1920,44,40-44,1964,1
STAT,1844,50,45-49,1894,0.01458389508710102
STAT,1891,49,15-19,1940,2.7167422605428517E-4
STAT,1915,28,na,1943,3753.756427428303
SIM,1856,42,na,1898,645
STAT,1885,43,30-34,1928,1.1219023109262036
SIM,1882,36,na,1918,1878
STAT,1820,62,na,1882,1300.2718686551173
STAT,1818,47,35-39,1865,0.24968803133118425
SIM,1821,43,40-44,1864,31
STAT,1835,47,35-39,1882,0.11165475512397195
STAT,1844,27,20-24,1871,14.227557452420193
STAT,1875,49,30-34,1924,0.09732391394428627
SIM,1861,35,35-39,1896,41
SIM,1884,48,35-39,1932,1
STAT,1825,50,35-39,1875,0.010986979749158403
STAT,1830,38,45-49,1868,1.7995355874886612
STAT,1940,32,35-39,1972,9.351730806931645
STAT,1880,34,40-44,1914,4.463635660835172
SIM,1944,3,na,1947,2673
SIM,1841,36,20-24,1877,2
STAT,1870,44,25-29,1914,0.631546291862557
STAT,1856,49,20-24,1905,0.008439083942770426
STAT,1828,58,na,1886,1386.9001043272656
STAT,1911,46,na,1957,3447.353529417636
SIM,1869,92,na,1961,836
STAT,1833,36,20-24,1869,0.4224770638409774
STAT,1922,30,50-100,1952,0.931179848785327
STAT,1813,43,40-44,1856,10.104258007659585
STAT,1876,85,na,1961,428.9915490622843
STAT,1903,33,35-39,1936,8.21956968559298
STAT,1876,48,35-39,1924,0.1397488314740373
STAT,1898,46,20-24,1944,0.009128230821453198
STAT,1818,52,30-34,1870,0.01018595533050301
STAT,1853,35,35-39,1888,5.599348406283966
SIM,1883,49,30-34,1932,3
STAT,1892,41,35-39,1933,2.252101696038295
SIM,1896,50,na,1946,3031
STAT,1820,53,25-29,1873,0.005267239647485623
SIM,1919,30,na,1949,5075
STAT,1833,80,na,1913,254.51352530885387
STAT,1913,18,40-44,1931,0.28165101216125615
SIM,1856,20,na,1876,849
STAT,1833,90,na,1923,32.437942103031936
STAT,1938,7,na,1945,3900.9064399053555
STAT,1885,38,35-39,1923,6.917840101005328
STAT,1940,29,50-100,1969,1.0026045918504105
STAT,1798,109,na,1907,3.0199186451031315E-4
STAT,1854,16,25-29,1870,3.791441540212428
STAT,1883,33,na,1916,2286.046310805766
STAT,1891,52,na,1943,2633.7887269709718
SIM,1855,68,na,1923,2860
STAT,1830,43,40-44,1873,1.9631071753528284
STAT,1868,66,na,1934,1583.072134772224
STAT,1891,42,na,1933,2838.6987684199107
STAT,1828,68,na,1896,1034.4830936259743
STAT,1837,52,40-44,1889,0.008472023507050237
STAT,1929,10,na,1939,5036.438613722321
SIM,1893,38,35-39,1931,1
SIM,1901,44,30-34,1945,1
STAT,1853,17,20-24,1870,16.53614826608367
STAT,1882,33,50-100,1915,0.8735210120735039
STAT,1903,27,na,1930,3387.6965022840122
SIM,1861,17,20-24,1878,48
SIM,1882,58,na,1940,1326
STAT,1891,37,20-24,1928,0.9479350377672505
SIM,1870,35,na,1905,1922
STAT,1832,63,na,1895,1514.6502142560525
STAT,1933,36,25-29,1969,1.3332155582129135
STAT,1861,46,25-29,1907,0.048038638378255394
SIM,1914,31,na,1945,4933
SIM,1920,7,na,1927,4900
STAT,1793,65,na,1858,714.9977255547049
STAT,1863,35,na,1898,2030.42849032322
STAT,1857,28,45-49,1885,0.871276164104296
STAT,1883,44,50-100,1927,1.0026335012466516
STAT,1813,92,na,1905,30.50928040557146
STAT,1807,54,20-24,1861,0.0022562006536384145
STAT,1863,54,35-39,1917,0.007147548888454304
STAT,1924,47,50-100,1971,0.26668370410264924
SIM,1876,40,na,1916,3675
STAT,1897,0,na,1897,3899.6073836277446
STAT,1846,20,50-100,1866,0.30232603395815516
STAT,1826,46,30-34,1872,0.1403833965668351
STAT,1912,40,50-100,1952,0.11325885652856658
SIM,1875,88,na,1963,283
STAT,1931,34,na,1965,4914.556480146146
STAT,1861,76,na,1937,787.9015767622227
SIM,1909,27,30-34,1936,50
SIM,1922,42,35-39,1964,3
STAT,1913,40,40-44,1953,0.2435876028999729
STAT,1872,17,30-34,1889,1.6012864203829866
SIM,1879,27,35-39,1906,133
STAT,1840,82,na,1922,183.71897551062347
STAT,1874,45,20-24,1919,0.012508269736700309
STAT,1931,36,15-19,1967,0.02527658621218704
STAT,1803,53,25-29,1856,0.007570386460731689
STAT,1932,24,15-19,1956,6.912041682559949
STAT,1821,79,na,1900,353.06012047095965
STAT,1820,49,40-44,1869,0.26194769673897134
STAT,1901,46,30-34,1947,0.07656387311447027
STAT,1898,2,na,1900,3584.557687645542
STAT,1915,22,50-100,1937,0.6705546798994974
SIM,1812,63,na,1875,655
STAT,1843,49,35-39,1892,0.13543811643024917
STAT,1920,30,30-34,1950,17.17231907988678
STAT,1843,18,15-19,1861,7.449144050428492
STAT,1881,40,20-24,1921,0.15148803094854787
STAT,1885,46,35-39,1931,0.13800361910422065
STAT,1908,58,na,1966,3127.399658863019
STAT,1883,23,na,1906,2268.248306939565
STAT,1802,65,na,1867,1175.088505852778
STAT,1925,28,na,1953,4368.72232750364
STAT,1927,29,50-100,1956,1.1953679829562376
STAT,1866,53,na,1919,1933.8943290155728
STAT,1830,35,40-44,1865,4.07663954244682
STAT,1901,68,na,1969,2472.954150542998
STAT,1840,100,na,1940,0.41802761143186207
STAT,1946,20,35-39,1966,10.37203652743809
SIM,1848,33,na,1881,2618
STAT,1891,20,na,1911,2925.721244730483
STAT,1836,28,25-29,1864,41.64223429780063
SIM,1939,29,na,1968,3921
STAT,1914,42,35-39,1956,0.19675632495632722
STAT,1925,7,na,1932,4784.573597266171
STAT,1919,32,na,1951,4026.2074130965566
SIM,1851,6,na,1857,1504
STAT,1872,32,40-44,1904,4.342612670296662
STAT,1795,78,na,1873,378.02647779623584
STAT,1870,16,50-100,1886,0.049599030991273274
STAT,1908,17,20-24,1925,26.095025705035184
STAT,1811,43,30-34,1854,5.895647207043842
SIM,1854,19,na,1873,2267
SIM,1880,2,na,1882,3342
SIM,1933,34,25-29,1967,6
STAT,1879,26,30-34,1905,25.921246754364027
STAT,1922,41,30-34,1963,0.1453134258098974
STAT,1816,47,25-29,1863,0.1751979727913449
SIM,1890,55,na,1945,3139
SIM,1837,39,na,1876,1974
SIM,1838,23,na,1861,2363
STAT,1871,86,na,1957,265.862766044814
STAT,1850,39,25-29,1889,1.322797905966365
STAT,1849,20,na,1869,2209.7695323074167
SIM,1920,27,na,1947,3494
STAT,1846,27,30-34,1873,18.042560073800246
SIM,1914,34,15-19,1948,3
SIM,1928,30,35-39,1958,70
STAT,1821,101,na,1922,0.28817468296829707
STAT,1920,29,na,1949,4027.598329016506
STAT,1925,34,25-29,1959,10.861139642121124
SIM,1875,66,na,1941,2443
STAT,1928,29,40-44,1957,5.6930561776145545
SIM,1878,21,na,1899,4355
STAT,1859,40,na,1899,1850.355818201777
STAT,1833,44,20-24,1877,0.08047111545595823
SIM,1897,34,na,1931,2677
STAT,1842,41,na,1883,601.2632781274339
STAT,1883,38,25-29,1921,2.756173289527143
STAT,1881,25,45-49,1906,1.055625723952169
SIM,1876,15,15-19,1891,79
STAT,1898,29,45-49,1927,1.4823721955041564
STAT,1862,18,25-29,1880,5.495331851995935
STAT,1910,29,na,1939,3551.430363959255
STAT,1912,31,35-39,1943,8.923962151007569
STAT,1832,48,20-24,1880,0.0010741495507124892
STAT,1864,38,15-19,1902,0.050797247262714985
STAT,1923,20,40-44,1943,3.894184968948275
STAT,1836,87,na,1923,134.8376691847197
STAT,1861,54,na,1915,1741.424591540426
STAT,1866,51,35-39,1917,0.007896110329542069
STAT,1811,52,20-24,1863,0.0033197171952106274
STAT,1817,42,na,1859,974.2001442647294
STAT,1871,39,45-49,1910,1.9685756890950235
STAT,1844,42,30-34,1886,1.166488707561431
STAT,1860,37,na,1897,1921.9877243526282
STAT,1893,37,30-34,1930,6.664785278819183
STAT,1931,31,45-49,1962,2.0485967459267433
STAT,1926,46,35-39,1972,0.1581122281397454
STAT,1878,54,na,1932,2154.407930879924
STAT,1907,31,na,1938,3525.826681851762
SIM,1863,22,na,1885,1460
STAT,1883,47,15-19,1930,3.8302291794418204E-4
STAT,1926,41,15-19,1967,0.0018796575716089046
STAT,1851,48,30-34,1899,0.07549130015516804
STAT,1846,87,na,1933,104.34498310237055
STAT,1927,17,30-34,1944,15.031867592324108
STAT,1859,45,30-34,1904,0.07748786052717237
SIM,1867,37,na,1904,2184
STAT,1869,27,25-29,1896,42.68559743105955
SIM,1835,58,na,1893,1190
STAT,1812,75,na,1887,82.22863359146301
STAT,1903,41,20-24,1944,0.015725633677600343
STAT,1906,34,15-19,1940,0.11739573359575357
STAT,1907,43,20-24,1950,0.015975121530754283
STAT,1821,50,50-100,1871,0.016218778462475658
STAT,1884,19,15-19,1903,5.6505157072935805
STAT,1822,44,45-49,1866,2.551958030820574
STAT,1868,19,30-34,1887,1.5489365248689166
SIM,1873,22,na,1895,2297
STAT,1878,48,45-49,1926,0.23976218324367504
STAT,1812,96,na,1908,0.6800167264620046
STAT,1914,44,15-19,1958,0.0014955323860966277
STAT,1933,33,20-24,1966,3.2627518229508854
SIM,1925,30,50-100,1955,3
STAT,1861,108,na,1969,0.019814025562223423
SIM,1846,25,30-34,1871,2
STAT,1919,10,na,1929,4333.561045516214
SIM,1883,75,na,1958,1493
STAT,1858,29,15-19,1887,0.34961135654416964
SIM,1844,19,na,1863,3007
SIM,1842,35,50-100,1877,66
STAT,1866,75,na,1941,939.7122498602056
STAT,1826,54,30-34,1880,0.007903941695849502
SIM,1920,49,na,1969,3595
SIM,1943,19,30-34,1962,149
SIM,1875,47,30-34,1922,1
STAT,1845,15,20-24,1860,11.251038317343676
STAT,1887,28,30-34,1915,27.619477901279815
STAT,1893,45,30-34,1938,0.06896364865007748
STAT,1842,17,45-49,1859,0.02082341156768517
STAT,1932,30,na,1962,4998.367448377803
STAT,1901,30,20-24,1931,3.8098376073587055
STAT,1930,35,45-49,1965,0.8844968138948567
SIM,1824,64,na,1888,1811
SIM,1935,20,25-29,1955,710
STAT,1845,46,40-44,1891,0.08519354778031679
SIM,1907,29,na,1936,4709
STAT,1877,36,35-39,1913,7.214423591743636
STAT,1910,40,15-19,1950,0.0014513755462999074
STAT,1855,50,20-24,1905,4.954002171304644E-4
SIM,1926,32,na,1958,5860
STAT,1915,45,20-24,1960,0.011030156497247468
STAT,1908,16,na,1924,3726.6269300402855
STAT,1862,42,25-29,1904,0.5462781027804455
STAT,1838,25,30-34,1863,13.87257450335283
SIM,1865,88,na,1953,254
STAT,1879,49,15-19,1928,4.017680979301651E-4
SIM,1899,15,na,1914,1995
STAT,1823,69,na,1892,1159.3254987434198
STAT,1811,79,na,1890,423.5395388046293
STAT,1910,23,25-29,1933,85.50802279794526
STAT,1938,18,45-49,1956,0.48733559922605
STAT,1925,40,45-49,1965,0.20020575577113053
STAT,1870,40,45-49,1910,1.507105505331359
STAT,1842,37,25-29,1879,0.8384495496833566
SIM,1936,10,na,1946,4041
STAT,1830,52,30-34,1882,0.004475680843263367
STAT,1853,48,40-44,1901,0.13107858002592632
STAT,1838,19,45-49,1857,0.03640023258912121
SIM,1892,36,na,1928,3657
STAT,1870,37,na,1907,2348.7516980691676
STAT,1897,17,35-39,1914,0.7287142418488036
STAT,1899,41,45-49,1940,0.1425965753295251
STAT,1841,100,na,1941,1.1822107838866258
STAT,1916,3,na,1919,4230.769704165678
STAT,1918,44,35-39,1962,0.21050624535311097
SIM,1886,40,na,1926,2964
STAT,1832,110,na,1942,2.3457633030755232E-4
STAT,1867,47,30-34,1914,0.09111987490528084
SIM,1902,40,30-34,1942,1
STAT,1870,35,35-39,1905,7.118196136368237
STAT,1935,19,30-34,1954,16.45422201035627
STAT,1820,45,25-29,1865,0.09295207833926544
STAT,1822,36,45-49,1858,4.197943308485596
SIM,1878,46,45-49,1924,1
STAT,1858,66,na,1924,1251.6535334900416
STAT,1852,53,20-24,1905,7.308546042470418E-4
STAT,1866,35,20-24,1901,0.7103278952201754
SIM,1824,42,na,1866,2122
STAT,1818,58,na,1876,1403.4692218198072
STAT,1830,46,45-49,1876,0.20428558639877467
STAT,1852,44,30-34,1896,1.1416215680544926
STAT,1927,20,25-29,1947,113.55061232723261
SIM,1866,20,na,1886,3273
STAT,1819,51,50-100,1870,0.00269455045940764
STAT,1913,27,na,1940,3685.864915447464
SIM,1880,35,na,1915,3289
SIM,1883,53,na,1936,1967
STAT,1858,40,45-49,1898,1.154463255681631
SIM,1790,77,na,1867,1197
STAT,1871,27,50-100,1898,0.6381210666638811
SIM,1855,1,na,1856,3430
STAT,1863,37,45-49,1900,1.7018641117841034
SIM,1851,18,15-19,1869,9
STAT,1885,35,30-34,1920,5.288457683919421
STAT,1909,29,30-34,1938,36.80048340891037
STAT,1840,24,45-49,1864,0.3441797248817126
STAT,1865,35,50-100,1900,1.131563672917624
SIM,1914,53,na,1967,4713
STAT,1812,47,40-44,1859,0.0442615328301238
STAT,1803,92,na,1895,10.506129365267789
STAT,1818,44,30-34,1862,2.1196901449645686
STAT,1871,53,30-34,1924,0.005842588022209811
SIM,1893,35,30-34,1928,4
STAT,1876,17,15-19,1893,5.999285045468177
SIM,1906,44,na,1950,3317
STAT,1912,47,45-49,1959,0.20644614207796852
STAT,1906,40,35-39,1946,0.18392744271714925
STAT,1851,76,na,1927,748.2523706377502
STAT,1941,4,na,1945,4086.4102262858414
STAT,1849,26,45-49,1875,1.1170059821429064
STAT,1869,40,na,1909,2355.763215026014
STAT,1877,91,na,1968,187.50408441926638
STAT,1916,45,na,1961,3734.2279290405572
STAT,1845,107,na,1952,0.002340136481970293
STAT,1824,49,25-29,1873,0.009774796135141964
SIM,1942,28,na,1970,3640
STAT,1905,41,45-49,1946,0.15016069560470713
SIM,1828,37,30-34,1865,65
STAT,1823,37,15-19,1860,0.10550903162718095
STAT,1886,16,20-24,1902,18.40387195575739
STAT,1853,35,na,1888,1865.1326843772022
STAT,1898,49,25-29,1947,0.04277921343050205
STAT,1886,47,40-44,1933,0.1764596596968136
STAT,1940,17,na,1957,3695.2885919415426
STAT,1928,32,35-39,1960,11.339668847645797
SIM,1929,30,na,1959,4674
STAT,1919,18,35-39,1937,4.563512234397481
STAT,1890,28,15-19,1918,0.547322212398451
SIM,1851,21,na,1872,1433
STAT,1821,41,25-29,1862,0.7369189740076785
STAT,1907,63,na,1970,2920.870865418212
SIM,1917,29,na,1946,2259
STAT,1879,17,na,1896,2590.8673974419185
SIM,1877,5,na,1882,515
SIM,1922,31,45-49,1953,1
SIM,1896,40,30-34,1936,1
SIM,1921,33,na,1954,5167
STAT,1836,107,na,1943,0.00360929381676029
STAT,1862,49,45-49,1911,0.19681392789300284
STAT,1858,34,na,1892,1806.738404027954
STAT,1918,26,na,1944,3946.458579769871
STAT,1864,15,30-34,1879,1.6667798871601847
SIM,1889,69,na,1958,1966
STAT,1855,17,30-34,1872,1.254675643857251
SIM,1881,41,na,1922,3007
STAT,1884,43,15-19,1927,0.013124272032886115
STAT,1929,24,50-100,1953,0.8210852139620135
SIM,1915,16,na,1931,3720
STAT,1846,54,35-39,1900,0.004958594948885635
STAT,1896,73,na,1969,1951.5913396853798
STAT,1937,19,40-44,1956,1.3426544990979372
SIM,1854,42,40-44,1896,16
SIM,1926,4,na,1930,6370
STAT,1840,37,15-19,1877,0.026152041329980124
SIM,1807,62,na,1869,566
STAT,1820,34,50-100,1854,2.563920643768068
STAT,1820,94,na,1914,13.744667373358617
STAT,1875,16,45-49,1891,0.067241300675508
SIM,1838,47,50-100,1885,1
SIM,1864,61,na,1925,1986
STAT,1910,47,35-39,1957,0.11894577572534012
SIM,1840,69,na,1909,2500
SIM,1864,71,na,1935,793
STAT,1932,21,45-49,1953,1.4704804185576938
SIM,1940,15,na,1955,4270
STAT,1882,47,20-24,1929,0.011435361598511079
SIM,1911,13,na,1924,2607
STAT,1839,52,na,1891,1989.7857610324131
STAT,1949,18,20-24,1967,156.07373295335384
STAT,1831,40,50-100,1871,1.060619949588042
STAT,1940,20,40-44,1960,3.389123041984651
STAT,1843,47,50-100,1890,0.24153247580064047
SIM,1828,35,na,1863,1953
STAT,1874,48,25-29,1922,0.05870007654843402
STAT,1851,34,50-100,1885,0.7377032332869793
STAT,1853,32,30-34,1885,13.94140562809176
STAT,1878,45,40-44,1923,0.17789847662902078
STAT,1922,30,na,1952,4259.553980250074
SIM,1876,19,na,1895,3982
STAT,1846,42,40-44,1888,1.3482852680552564
STAT,1913,48,15-19,1961,3.5404810637687935E-4
STAT,1917,31,20-24,1948,2.5303884190486325
STAT,1882,20,50-100,1902,0.3927522055469512
STAT,1909,30,50-100,1939,0.7872327408623326
STAT,1921,21,35-39,1942,10.540775384863835
STAT,1830,39,na,1869,1911.4783562113714
SIM,1836,54,na,1890,1555
STAT,1883,51,35-39,1934,0.008321914407808786
STAT,1920,36,50-100,1956,0.4541947784855816
STAT,1918,18,50-100,1936,0.4012366706135689
STAT,1865,22,50-100,1887,0.3768347319877081
STAT,1861,43,20-24,1904,0.13112165375159585
SIM,1900,50,na,1950,4006
SIM,1832,61,na,1893,729
STAT,1840,28,50-100,1868,0.31180490538311584
STAT,1856,22,na,1878,1783.5926699784015
STAT,1814,47,15-19,1861,0.001367445597635902
STAT,1878,17,25-29,1895,5.830322545385416
STAT,1866,46,50-100,1912,0.2248247881422415
STAT,1914,31,45-49,1945,1.5683181029470146
STAT,1837,44,40-44,1881,1.8876480426760662
STAT,1821,54,30-34,1875,0.00590465113297365
STAT,1899,17,50-100,1916,0.06691640473538175
STAT,1854,53,30-34,1907,0.003256581604368609
STAT,1833,47,25-29,1880,0.028923673754367114
STAT,1849,16,50-100,1865,0.051113655304447544
STAT,1873,49,20-24,1922,0.012052345991934497
STAT,1823,50,25-29,1873,0.0055341220545861896
STAT,1910,20,20-24,1930,103.87002294110431
STAT,1807,47,50-100,1854,0.8639402849032335
STAT,1829,27,30-34,1856,18.783125434268403
SIM,1817,72,na,1889,1947
STAT,1877,52,50-100,1929,0.015249492970383702
STAT,1811,46,35-39,1857,0.6686608918810402
STAT,1894,27,50-100,1921,0.8134702872209457
STAT,1936,31,30-34,1967,15.160091917718898
SIM,1845,44,40-44,1889,22
STAT,1896,18,30-34,1914,2.0955794927075155
STAT,1880,39,50-100,1919,1.261758468850962
STAT,1920,41,20-24,1961,0.019281711014129666
STAT,1827,42,30-34,1869,1.0911075493471802
STAT,1896,49,15-19,1945,2.9122580328715624E-4
STAT,1805,53,35-39,1858,0.009878466188738753
STAT,1897,14,na,1911,3418.6029877213305
STAT,1937,30,35-39,1967,8.957728897008678
STAT,1799,60,na,1859,195.63570291632652
STAT,1904,40,25-29,1944,0.06435226275137453
STAT,1940,21,45-49,1961,1.133720989900749
STAT,1856,16,35-39,1872,0.468773125608212
SIM,1925,26,na,1951,4883
STAT,1914,30,40-44,1944,3.9156040351455665
STAT,1875,14,na,1889,2650.280233059083
STAT,1881,22,40-44,1903,1.9678402199036829
STAT,1920,42,25-29,1962,0.07785290846507636
STAT,1841,53,45-49,1894,0.01590104226861476
STAT,1912,17,50-100,1929,0.07487964444517752
STAT,1872,44,35-39,1916,1.7887999323228099
STAT,1840,54,40-44,1894,0.0040313170544756995
STAT,1810,47,30-34,1857,5.083105515795481E-4
STAT,1888,54,na,1942,2416.835396934626
STAT,1872,50,20-24,1922,7.495412855394199E-4
STAT,1949,18,50-100,1967,0.4313016808383853
SIM,1885,8,na,1893,1887
STAT,1888,40,30-34,1928,1.3402942979627497
STAT,1873,23,na,1896,2418.522271848144
STAT,1801,59,na,1860,894.1423756422288
SIM,1914,31,45-49,1945,10
STAT,1888,19,35-39,1907,0.6299039170567734
STAT,1933,15,na,1948,4916.52142549162
STAT,1840,39,na,1879,976.9703995143115
STAT,1916,48,40-44,1964,0.159062214797867
STAT,1877,33,30-34,1910,17.648920325855634
STAT,1886,73,na,1959,1354.4611450237358
STAT,1849,19,20-24,1868,18.171422852753466
SIM,1830,33,40-44,1863,9
SIM,1885,33,30-34,1918,7
STAT,1872,49,na,1921,2205.8608172520035
STAT,1831,31,40-44,1862,4.680930795361541
STAT,1953,2,na,1955,4717.7287236595075
SIM,1874,71,na,1945,1948
STAT,1912,42,25-29,1954,0.06807199037960372
STAT,1894,33,30-34,1927,22.109102878147983
STAT,1936,32,35-39,1968,8.788126535101137
STAT,1821,57,na,1878,1100.121504462336
SIM,1857,19,20-24,1876,11
STAT,1820,42,20-24,1862,0.2621986339070517
STAT,1853,67,na,1920,1229.1599906937943
STAT,1918,41,30-34,1959,0.13428792694243677
STAT,1890,29,50-100,1919,0.7688813567859608
STAT,1841,46,20-24,1887,0.013596442284593712
STAT,1914,33,na,1947,3738.235059553042
SIM,1949,19,25-29,1968,84
STAT,1904,40,50-100,1944,0.1058698509577423
SIM,1931,33,na,1964,4944
STAT,1912,8,na,1920,3973.170719448895
STAT,1937,28,na,1965,3612.2327538359154
SIM,1859,15,15-19,1874,10
STAT,1890,41,25-29,1931,0.7809175226547344
SIM,1895,43,40-44,1938,2
STAT,1831,43,35-39,1874,1.7461531114078805
STAT,1901,42,15-19,1943,0.0013392136300968555
SIM,1826,54,na,1880,1370
STAT,1822,53,35-39,1875,0.013599655459812995
STAT,1876,54,20-24,1930,7.254549889434608E-4
STAT,1925,31,20-24,1956,2.871659016422139
STAT,1854,41,na,1895,1290.9048960334371
STAT,1868,34,na,1902,2285.134940069457
STAT,1904,5,na,1909,3744.095593959422
SIM,1866,52,na,1918,2713
STAT,1824,32,50-100,1856,0.40892823018205376
STAT,1953,13,na,1966,4708.442954578629
STAT,1887,43,40-44,1930,2.457833579957968
STAT,1793,97,na,1890,0.8931995813207958
SIM,1901,13,na,1914,4147
SIM,1866,40,45-49,1906,11
SIM,1834,42,na,1876,796
STAT,1926,43,30-34,1969,0.156009263696967
STAT,1880,46,35-39,1926,0.14575427538427443
STAT,1927,42,35-39,1969,0.25048630309899905
STAT,1861,86,na,1947,184.52176554973192
SIM,1829,28,35-39,1857,1
STAT,1839,20,na,1859,2589.418680693381
SIM,1837,17,na,1854,2382
STAT,1930,30,25-29,1960,11.857602489057436
SIM,1958,10,na,1968,4197
STAT,1821,48,45-49,1869,0.24904190374130855
STAT,1840,21,40-44,1861,1.050989811567515
STAT,1836,39,50-100,1875,1.1310350249512078
SIM,1897,66,na,1963,1419
STAT,1877,53,25-29,1930,0.00353783863226929
STAT,1900,49,40-44,1949,0.13098528544774798
STAT,1897,46,50-100,1943,0.18450916531112013
STAT,1789,82,na,1871,284.62229564405163
STAT,1892,49,30-34,1941,0.06619244204668702
STAT,1910,6,na,1916,3914.1844598307766
STAT,1922,33,45-49,1955,1.7506943236930128
STAT,1929,42,45-49,1971,0.21402162005719888
STAT,1802,54,20-24,1856,0.003594654473552936
STAT,1911,30,15-19,1941,0.12471807282066513
SIM,1818,57,na,1875,672
STAT,1902,20,20-24,1922,97.6188419943192
STAT,1866,18,45-49,1884,0.06084240844335483
STAT,1922,46,15-19,1968,4.1950760666532107E-4
STAT,1853,89,na,1942,81.45731348467412
STAT,1898,32,na,1930,3208.9125472623314
STAT,1810,44,50-100,1854,0.0056221281666351585
SIM,1931,11,na,1942,5251
STAT,1842,50,35-39,1892,0.002167863096463807
STAT,1914,11,na,1925,4034.474753360857
STAT,1847,45,50-100,1892,0.22426487849043544
STAT,1884,30,45-49,1914,1.6827310245010079
SIM,1889,47,na,1936,3794
SIM,1857,37,na,1894,1161
SIM,1885,34,na,1919,1663
STAT,1836,52,25-29,1888,0.0027462331244543395
SIM,1841,43,na,1884,410
STAT,1847,18,35-39,1865,0.6155312585418946
STAT,1790,79,na,1869,380.89634487595197
STAT,1859,19,na,1878,2087.0801277085047
STAT,1869,20,50-100,1889,0.41572112761809016
STAT,1906,31,45-49,1937,1.4558833242458034
SIM,1889,26,40-44,1915,4
STAT,1839,42,na,1881,2263.1542345216817
STAT,1864,51,25-29,1915,0.003235472494846018
STAT,1822,33,40-44,1855,10.057842157288192
STAT,1808,91,na,1899,13.571595086938176
STAT,1874,33,50-100,1907,0.9416358084115718
STAT,1837,107,na,1944,0.003781410243002506
STAT,1857,48,25-29,1905,0.04364464283271154
SIM,1923,0,na,1923,4744
STAT,1812,43,25-29,1855,0.21262555547382822
STAT,1821,47,na,1868,1312.2034841620546
STAT,1929,41,40-44,1970,0.3221134062866322
STAT,1905,46,15-19,1951,3.254541616183285E-4
STAT,1916,41,20-24,1957,0.01787680102037626
SIM,1916,44,na,1960,4552
SIM,1876,43,30-34,1919,20
STAT,1863,30,25-29,1893,8.814524674797022
STAT,1921,20,30-34,1941,32.26932709947905
STAT,1853,57,na,1910,1558.24516395774
STAT,1867,16,45-49,1883,0.06352928180791569
STAT,1868,43,30-34,1911,1.1024095364544413
STAT,1893,48,35-39,1941,0.09751538091394917
STAT,1860,45,50-100,1905,0.2023560451737902
SIM,1872,42,35-39,1914,3
STAT,1912,52,na,1964,3430.94883994994
STAT,1846,45,45-49,1891,0.14116704624180393
SIM,1867,15,na,1882,2518
STAT,1927,41,30-34,1968,0.15926067731570312
SIM,1837,49,na,1886,1797
SIM,1946,10,na,1956,3798
SIM,1859,17,15-19,1876,24
STAT,1872,60,na,1932,1909.7726619092757
STAT,1842,94,na,1936,4.961433267114454
STAT,1911,32,30-34,1943,15.168975278053232
STAT,1822,49,15-19,1871,6.505786970309933E-4
STAT,1900,20,na,1920,3295.815436347873
STAT,1871,32,25-29,1903,10.21744468973954
SIM,1895,22,na,1917,3896
SIM,1842,61,na,1903,2414
STAT,1832,52,40-44,1884,8.423943356612824E-4
STAT,1861,34,30-34,1895,14.395934411760898
STAT,1954,4,na,1958,4818.672265447292
STAT,1918,41,50-100,1959,0.12339971637901838
STAT,1850,43,45-49,1893,0.6860987647348685
STAT,1820,36,35-39,1856,13.881293322450006
STAT,1824,45,50-100,1869,0.04359192420232196
STAT,1840,51,50-100,1891,0.005975230068694428
STAT,1844,53,na,1897,2098.8698016613207
STAT,1924,46,25-29,1970,0.06270020843853559
STAT,1858,16,45-49,1874,0.05861693677472723
STAT,1848,16,35-39,1864,0.6402910049350355
STAT,1831,57,na,1888,1582.5097743407837
STAT,1864,42,35-39,1906,1.6441951776518957
STAT,1923,40,35-39,1963,0.23352666873295572
STAT,1810,62,na,1872,66.96314213073583
STAT,1824,53,45-49,1877,0.0023994317815615785
STAT,1854,47,45-49,1901,0.1306084170510921
STAT,1901,34,50-100,1935,1.2701401086322897
STAT,1929,17,40-44,1946,1.772539657606788
STAT,1910,44,30-34,1954,0.11800535134300687
SIM,1926,41,50-100,1967,2
STAT,1879,50,30-34,1929,0.006194113436535515
STAT,1864,18,35-39,1882,0.5129941593314685
STAT,1862,46,40-44,1908,0.1462320678044376
STAT,1858,27,50-100,1885,0.5000857388721133
STAT,1888,6,na,1894,3015.0879716373956
STAT,1912,40,25-29,1952,0.06884361910697054
SIM,1833,24,na,1857,2533
STAT,1842,109,na,1951,1.766159518215148E-4
STAT,1891,44,45-49,1935,1.815618679539978
STAT,1933,25,na,1958,4944.662762186165
SIM,1859,49,na,1908,1707
SIM,1889,15,na,1904,3885
STAT,1776,101,na,1877,0.25407423340092317
STAT,1856,40,35-39,1896,1.313747194672662
SIM,1846,42,na,1888,1033
STAT,1806,58,na,1864,910.0776601964324
STAT,1839,16,35-39,1855,0.6708266977505378
SIM,1848,23,na,1871,2622
SIM,1827,39,na,1866,2182
STAT,1867,19,15-19,1886,5.670251115836881
SIM,1860,57,na,1917,1854
SIM,1926,30,25-29,1956,9
STAT,1881,49,20-24,1930,0.01109556647626984
SIM,1894,48,na,1942,1272
STAT,1852,47,35-39,1899,0.14026532307823555
STAT,1872,41,30-34,1913,1.156440363253125
STAT,1902,45,35-39,1947,0.11231342932220771
STAT,1837,40,25-29,1877,0.6233534317800511
STAT,1868,28,20-24,1896,11.291181568874558
STAT,1901,37,40-44,1938,1.3210973616929336
STAT,1877,29,50-100,1906,0.6447236286038074
STAT,1861,50,45-49,1911,0.01224258564052283
STAT,1825,61,na,1886,1208.0894989353244
STAT,1864,106,na,1970,0.1393758349470147
STAT,1809,54,na,1863,2743.3695530024725
STAT,1865,47,20-24,1912,0.010904816297124198
SIM,1862,16,na,1878,3854
STAT,1938,14,na,1952,3854.18038641609
STAT,1931,40,35-39,1971,0.2678612196927419
STAT,1948,24,na,1972,4147.262295002851
STAT,1855,48,15-19,1903,2.614079694576877E-4
STAT,1908,48,na,1956,3287.6004654850317
STAT,1921,45,45-49,1966,0.24324410988076947
STAT,1815,61,na,1876,163.07730486172807
STAT,1873,53,40-44,1926,0.010625658037471097
STAT,1840,50,25-29,1890,0.0014147260402694417
SIM,1881,53,40-44,1934,1
STAT,1882,70,na,1952,1343.3176387285957
STAT,1828,54,40-44,1882,0.010615295007930644
SIM,1865,56,na,1921,1665
SIM,1890,23,na,1913,3961
STAT,1827,45,35-39,1872,0.1315189333662831
STAT,1847,71,na,1918,1206.8158683413747
STAT,1895,45,40-44,1940,0.12687907428201833
STAT,1923,15,na,1938,4296.489906159713
STAT,1890,49,20-24,1939,0.008023503120936044
STAT,1901,33,25-29,1934,14.260928771147197
STAT,1834,53,na,1887,953.8760959788383
STAT,1924,34,50-100,1958,0.9541029068791953
SIM,1852,38,na,1890,2150
STAT,1845,41,50-100,1886,0.5407158231488075
STAT,1809,54,30-34,1863,0.047189988385953126
STAT,1880,43,30-34,1923,1.184911377269748
SIM,1915,48,na,1963,2882
STAT,1858,56,na,1914,1557.5956809878396
STAT,1868,52,20-24,1920,7.08940577041486E-4
STAT,1930,32,40-44,1962,5.014834807533326
SIM,1866,19,na,1885,3080
STAT,1794,61,na,1855,11.5608
STAT,1823,41,35-39,1864,3.1101576498232406
STAT,1821,45,40-44,1866,0.18807599119915014
SIM,1875,56,na,1931,2579
STAT,1928,14,na,1942,4938.5729491183565
SIM,1840,80,na,1920,1449
SIM,1891,42,45-49,1933,29
SIM,1945,14,na,1959,6340
STAT,1857,71,na,1928,1024.2744988583122
SIM,1878,17,25-29,1895,27
STAT,1810,48,35-39,1858,7.254540210736813E-4
STAT,1916,47,50-100,1963,0.22882351210797108
STAT,1843,42,15-19,1885,0.01404879153433208
STAT,1820,47,50-100,1867,0.38592314529783944
STAT,1888,22,na,1910,2729.6532550415523
STAT,1823,80,na,1903,488.67683220546314
STAT,1884,47,30-34,1931,0.09223196397269014
STAT,1888,16,30-34,1904,1.8441043144859783
STAT,1908,41,20-24,1949,0.01630625744689575
STAT,1926,32,25-29,1958,11.080135564380642
STAT,1849,50,45-49,1899,0.012403764320613112
STAT,1844,75,na,1919,1019.8766467694217
SIM,1924,47,50-100,1971,2
STAT,1883,42,45-49,1925,1.4380598300471807
STAT,1851,44,15-19,1895,0.01075967817883172
STAT,1908,26,na,1934,3524.832373445854
STAT,1886,40,20-24,1926,0.16611830019896692
STAT,1870,49,45-49,1919,0.23036383120734014
STAT,1866,15,40-44,1881,0.17340483663078876
STAT,1798,64,na,1862,1262.9873067084877
STAT,1831,34,45-49,1865,1.8015661828912832
STAT,1841,49,25-29,1890,0.06280212251315449
SIM,1906,34,na,1940,3358
STAT,1924,11,na,1935,4680.052995325273
STAT,1846,51,30-34,1897,0.0035423300993254734
STAT,1922,30,40-44,1952,4.407402579819687
SIM,1884,48,na,1932,3653
STAT,1876,45,30-34,1921,0.09883147891858135
STAT,1899,40,50-100,1939,0.10121409549267965
STAT,1890,32,35-39,1922,12.259899712158726
SIM,1884,45,30-34,1929,1
STAT,1878,41,25-29,1919,0.6636851051792593
STAT,1827,51,50-100,1878,0.013632866028973869
STAT,1942,24,50-100,1966,0.6815586050540678
STAT,1831,40,30-34,1871,1.1542040653197725
STAT,1816,44,20-24,1860,0.49511749132071114
STAT,1918,30,25-29,1948,9.766986120129452
STAT,1847,93,na,1940,26.423173979691057
STAT,1862,60,na,1922,1624.4231683864884
STAT,1869,29,na,1898,2390.985527608804
SIM,1832,53,45-49,1885,1
STAT,1904,42,40-44,1946,0.22287946311668458
STAT,1854,44,40-44,1898,1.233755878674313
SIM,1777,80,na,1857,215
STAT,1879,23,50-100,1902,0.4170350168580376
STAT,1843,57,na,1900,1985.6053308680214
STAT,1813,46,45-49,1859,0.8857325157320332
STAT,1866,85,na,1951,250.23503826190466
STAT,1892,45,15-19,1937,2.821400253411271E-4
STAT,1844,54,25-29,1898,0.00341253674322802
STAT,1870,1,na,1871,3510.904056032932
SIM,1911,30,30-34,1941,3
SIM,1875,34,na,1909,2982
STAT,1835,44,30-34,1879,1.0159109584739339
STAT,1944,20,25-29,1964,98.67793308853828
SIM,1843,24,na,1867,556
STAT,1881,38,15-19,1919,0.05276640893325326
STAT,1919,42,35-39,1961,0.21531920767939317
STAT,1868,46,35-39,1914,0.1356058404408851
STAT,1896,51,na,1947,2852.025964095575
SIM,1899,47,na,1946,1709
STAT,1878,16,20-24,1894,18.285139081892503
STAT,1880,37,45-49,1917,2.069547099148546
STAT,1899,17,45-49,1916,0.08922187298050897
STAT,1897,36,na,1933,3143.919422898269
STAT,1845,18,50-100,1863,0.03054550179243502
STAT,1873,47,20-24,1920,0.012251969103524123
STAT,1851,49,35-39,1900,0.1082623231596054
STAT,1845,16,na,1861,1448.1737326115976
STAT,1897,41,35-39,1938,0.16775367428639504
STAT,1768,98,na,1866,1.5062298850367573
STAT,1887,46,45-49,1933,0.26049637624922584
SIM,1941,11,na,1952,3904
STAT,1903,3,na,1906,3752.6788808573215
SIM,1868,29,25-29,1897,6
STAT,1918,19,30-34,1937,13.017671689789907
STAT,1813,52,30-34,1865,0.02068932448321106
SIM,1878,19,40-44,1897,15
STAT,1859,17,15-19,1876,5.459988238855882
SIM,1893,2,na,1895,3684
STAT,1934,31,20-24,1965,3.3096569038952177
STAT,1849,19,na,1868,2352.7866877440433
STAT,1842,41,45-49,1883,0.38934722172104097
STAT,1870,48,40-44,1918,0.16853041536315438
SIM,1906,12,na,1918,3664
STAT,1847,15,30-34,1862,1.819941101657578
STAT,1893,33,na,1926,2971.5552473740854
STAT,1865,54,45-49,1919,0.012885346264428024
STAT,1903,30,30-34,1933,24.98348409026828
SIM,1845,68,na,1913,1416
SIM,1813,58,na,1871,35
STAT,1891,3,na,1894,3250.9620620394194
STAT,1918,33,30-34,1951,16.44651245913355
STAT,1896,29,na,1925,3123.4983283587094
STAT,1930,18,na,1948,4712.85189162359
SIM,1872,59,na,1931,2110
STAT,1832,46,20-24,1878,0.0010985442060141648
STAT,1812,48,45-49,1860,0.059924051402580614
STAT,1892,15,na,1907,3141.4655759909924
SIM,1857,33,40-44,1890,11
STAT,1854,15,20-24,1869,11.93191857650917
STAT,1900,28,20-24,1928,16.19420351234895
STAT,1873,56,na,1929,2092.215013457796
STAT,1921,43,30-34,1964,0.14206347750977513
STAT,1925,36,25-29,1961,1.1720007571053361
STAT,1911,16,30-34,1927,2.417541243364587
STAT,1845,9,na,1854,1528.0
STAT,1844,30,50-100,1874,1.1082529028260717
STAT,1936,24,35-39,1960,8.906668110769578
STAT,1903,16,na,1919,3593.9313570723966
STAT,1792,103,na,1895,0.03474159349561746
STAT,1845,37,na,1882,1228.3373994408587
STAT,1916,38,25-29,1954,0.9896078558718538
STAT,1904,46,35-39,1950,0.11314682377457323
STAT,1892,47,30-34,1939,0.06728878804056398
STAT,1838,21,15-19,1859,1.8403247896414376
SIM,1845,57,na,1902,1890
STAT,1928,26,50-100,1954,1.2211132823887807
STAT,1902,23,25-29,1925,80.36191704215017
STAT,1913,37,45-49,1950,0.6643201319929694
STAT,1907,45,20-24,1952,0.009975091818959973
STAT,1881,49,50-100,1930,0.2270892515565984
STAT,1867,24,45-49,1891,0.6553495281415763
STAT,1927,31,30-34,1958,19.23399328690684
STAT,1930,34,40-44,1964,5.008367753793986
STAT,1933,35,20-24,1968,0.3572353952144939
STAT,1805,72,na,1877,226.1306460896448
STAT,1809,86,na,1895,215.9689660563681
STAT,1861,48,40-44,1909,0.1405882987114719
SIM,1837,23,15-19,1860,12
STAT,1822,64,na,1886,1022.9760337850662
STAT,1812,101,na,1913,0.04519029502517351
SIM,1840,38,na,1878,2504
STAT,1792,80,na,1872,330.75944432850656
STAT,1796,94,na,1890,7.826943188829683
STAT,1803,81,na,1884,158.17401759331975
STAT,1922,35,45-49,1957,0.7683836991348535
STAT,1828,69,na,1897,993.4244596399593
SIM,1867,19,15-19,1886,65
SIM,1930,35,45-49,1965,3
STAT,1815,49,25-29,1864,0.005685518531433852
STAT,1876,22,45-49,1898,0.704927978865956
SIM,1926,33,30-34,1959,1
SIM,1909,36,35-39,1945,1
STAT,1865,37,na,1902,2150.986112078436
STAT,1904,31,35-39,1935,14.527625469948076
STAT,1837,18,na,1855,2438.6006095828347
SIM,1830,28,na,1858,1024
STAT,1894,18,na,1912,3203.2939208498346
SIM,1838,20,25-29,1858,421
STAT,1843,26,na,1869,2649.4855175630305
STAT,1852,44,50-100,1896,1.0490576548291037
STAT,1927,26,35-39,1953,18.165623746217655
STAT,1921,45,na,1966,4111.683017553097
STAT,1938,6,na,1944,3911.388962324385
STAT,1898,19,50-100,1917,0.06552690006072992
STAT,1913,26,na,1939,3698.5138327554882
SIM,1926,26,40-44,1952,8
STAT,1851,45,na,1896,1794.6225411030928
STAT,1903,17,35-39,1920,0.7788987822014447
STAT,1944,23,30-34,1967,30.672867476015796
STAT,1869,5,na,1874,2826.9489155445904
SIM,1908,37,30-34,1945,3
STAT,1904,39,45-49,1943,0.6085473890498819
SIM,1855,67,na,1922,2860
STAT,1863,51,50-100,1914,0.012955092979817352
STAT,1823,81,na,1904,427.19151317737163
STAT,1938,21,50-100,1959,0.6444587022412147
STAT,1934,29,30-34,1963,52.30150274084884
SIM,1942,29,30-34,1971,6
STAT,1883,30,50-100,1913,0.8885531632170615
SIM,1808,89,na,1897,198
SIM,1900,28,na,1928,3545
SIM,1793,86,na,1879,591
STAT,1902,18,30-34,1920,2.2385434908610833
SIM,1912,29,na,1941,4660
STAT,1930,41,30-34,1971,0.16727223949403913
STAT,1879,22,15-19,1901,3.384270293183565
STAT,1841,39,25-29,1880,3.699862333378269
STAT,1842,49,50-100,1891,0.05969585876933831
STAT,1913,44,35-39,1957,0.19326072351337792
STAT,1835,20,35-39,1855,5.954272727139576
STAT,1924,39,15-19,1963,0.022378910287025246
STAT,1945,22,35-39,1967,10.205758187169232
STAT,1914,40,35-39,1954,0.1981317686920313
STAT,1942,28,25-29,1970,68.26008600573071
STAT,1818,59,na,1877,1375.947190379921
STAT,1853,49,45-49,1902,0.17917100494248223
SIM,1902,17,40-44,1919,6
STAT,1835,52,50-100,1887,0.011645496123032494
STAT,1930,21,35-39,1951,12.013883130086171
STAT,1939,32,50-100,1971,0.8343209532478055
STAT,1788,75,na,1863,162.49867912334298
STAT,1904,44,40-44,1948,0.22014203972032842
SIM,1953,11,na,1964,4654
STAT,1846,16,25-29,1862,4.241021380022377
STAT,1910,24,15-19,1934,4.9120964566569185
STAT,1814,45,na,1859,2133.2830001258835
STAT,1910,42,15-19,1952,0.0014351079084236572
STAT,1817,108,na,1925,5.802706714334981E-4
STAT,1849,33,40-44,1882,3.810715120879917
STAT,1929,29,20-24,1958,22.662730426650878
STAT,1881,75,na,1956,1006.7550817380811
SIM,1854,16,25-29,1870,3
STAT,1952,18,40-44,1970,1.6603367785885832
STAT,1833,24,50-100,1857,0.28841975777805273
SIM,1907,30,na,1937,4711
STAT,1939,25,15-19,1964,0.7025069218088121
STAT,1820,47,40-44,1867,0.2690148311206914
STAT,1907,47,15-19,1954,3.276857369744991E-4
STAT,1884,41,50-100,1925,1.0158881792565486
STAT,1918,26,40-44,1944,4.910271316645343
STAT,1918,42,50-100,1960,0.12322202078743262
STAT,1852,94,na,1946,20.117744567408394
STAT,1930,36,35-39,1966,3.1356349582599954
STAT,1864,49,20-24,1913,0.010681496907017592
STAT,1902,31,50-100,1933,1.295493389426777
STAT,1877,38,na,1915,2379.738025677854
STAT,1899,27,45-49,1926,1.516526719650064
STAT,1859,30,45-49,1889,1.4022743917583076
STAT,1899,32,40-44,1931,5.923379224579568
SIM,1927,32,35-39,1959,1
STAT,1860,38,na,1898,1912.4546652398392
STAT,1892,47,na,1939,2773.0432611266897
STAT,1920,32,30-34,1952,17.035386224486007
STAT,1935,34,50-100,1969,1.1341678862731597
STAT,1912,38,40-44,1950,1.4369479241306053
SIM,1864,5,na,1869,2555
STAT,1929,37,50-100,1966,0.5352459607297263
SIM,1934,27,30-34,1961,66
STAT,1895,16,20-24,1911,23.119200630917167
STAT,1925,43,15-19,1968,0.0018393184200899194
STAT,1852,19,na,1871,2761.7174701438917
STAT,1908,39,30-34,1947,1.6761737064674747
STAT,1825,92,na,1917,25.648235885845747
STAT,1810,45,30-34,1855,5.22002938065017E-4
SIM,1860,58,na,1918,1743
STAT,1834,22,40-44,1856,1.228230281727285
STAT,1915,16,15-19,1931,9.38730564270307
STAT,1877,28,50-100,1905,0.6470789961497926
SIM,1869,71,na,1940,3598
STAT,1823,35,50-100,1858,2.341398279263523
STAT,1869,29,25-29,1898,42.380515475475924
STAT,1943,27,30-34,1970,41.253477638820435
SIM,1836,76,na,1912,570
STAT,1917,41,15-19,1958,0.0015835051108946242
STAT,1903,22,30-34,1925,25.28473565949021
STAT,1888,34,50-100,1922,1.0484434893114716
STAT,1874,18,na,1892,2599.7642333816575
STAT,1927,19,45-49,1946,0.6127562183695102
STAT,1912,30,30-34,1942,15.446036924578518
STAT,1926,27,30-34,1953,46.568092353087316
STAT,1776,102,na,1878,0.15922069984535656
STAT,1929,41,na,1970,4782.839564399967
STAT,1935,28,35-39,1963,20.308444920220804
STAT,1947,17,20-24,1964,151.11202279710113
STAT,1874,46,50-100,1920,0.25419519894736525
SIM,1907,50,na,1957,4381
STAT,1938,29,15-19,1967,0.6912174849021815
STAT,1880,43,50-100,1923,1.0888374794260989
STAT,1875,67,na,1942,1627.7844566574768
SIM,1920,48,na,1968,3607
STAT,1918,28,35-39,1946,15.706764813322865
STAT,1884,28,na,1912,2276.511196997267
STAT,1928,40,35-39,1968,0.2554607947334092
STAT,1868,65,na,1933,1632.2855439214554
STAT,1887,17,25-29,1904,6.237216070106072
STAT,1908,44,25-29,1952,0.06475102842962052
SIM,1902,24,30-34,1926,5
SIM,1910,18,na,1928,4400
STAT,1859,19,15-19,1878,5.395858995860141
STAT,1919,32,35-39,1951,9.728308803498717
SIM,1919,31,na,1950,5092
SIM,1943,28,35-39,1971,310
STAT,1908,43,15-19,1951,0.0014013518718773306
STAT,1883,86,na,1969,480.74552292310017
STAT,1841,38,50-100,1879,1.5941571611129532
STAT,1849,18,45-49,1867,0.06735107958000312
SIM,1957,2,na,1959,6087
STAT,1834,41,50-100,1875,0.5685305065678841
SIM,1888,30,na,1918,411
STAT,1934,34,25-29,1968,12.517727764734014
SIM,1948,9,na,1957,5824
STAT,1917,34,25-29,1951,9.467529206236136
SIM,1901,25,25-29,1926,4
STAT,1883,22,na,1905,2275.278918798652
STAT,1895,67,na,1962,2238.6261141510145
SIM,1812,46,45-49,1858,1
SIM,1828,26,25-29,1854,258
STAT,1903,15,40-44,1918,0.2608392349483763
SIM,1901,45,na,1946,3325
STAT,1828,39,50-100,1867,1.5807256186783747
STAT,1944,26,35-39,1970,16.051347983299948
STAT,1927,24,40-44,1951,4.0831403046194845
STAT,1839,45,50-100,1884,0.23851854755374383
SIM,1823,58,na,1881,1119
STAT,1858,26,45-49,1884,0.8742674920107787
SIM,1862,15,20-24,1877,47
STAT,1823,48,20-24,1871,0.018456885250796726
STAT,1907,36,50-100,1943,0.38851800675214354
SIM,1919,1,na,1920,5533
STAT,1933,37,15-19,1970,0.025978772076804293
STAT,1947,19,15-19,1966,50.55022370367968
STAT,1868,20,45-49,1888,0.6832995413329426
SIM,1882,69,na,1951,1035
STAT,1944,24,40-44,1968,3.5870764645696096
STAT,1869,16,20-24,1885,18.244727054288088
STAT,1861,55,na,1916,1719.5994241120022
STAT,1950,22,15-19,1972,6.254846896412614
STAT,1930,37,45-49,1967,0.8829672944183412
STAT,1890,39,20-24,1929,0.923803070034376
STAT,1909,38,35-39,1947,2.2548873030447485
SIM,1920,8,na,1928,4867
STAT,1944,19,45-49,1963,0.5311772820319229
STAT,1845,92,na,1937,20.667147656764246
STAT,1840,48,20-24,1888,0.004704184754295024
STAT,1927,15,50-100,1942,0.4641917450125917
STAT,1910,25,25-29,1935,63.81167049411678
STAT,1953,16,35-39,1969,5.031940407173269
STAT,1837,73,na,1910,952.3800049921724
STAT,1858,31,40-44,1889,3.3463635006337364
SIM,1851,7,na,1858,1504
STAT,1911,15,na,1926,3839.145443045848
STAT,1938,27,20-24,1965,17.890616439817936
SIM,1884,21,35-39,1905,1
STAT,1851,110,na,1961,6.404817903257242E-4
STAT,1922,32,40-44,1954,4.372257750670646
STAT,1925,33,20-24,1958,2.8682140582510165
SIM,1831,77,na,1908,187
SIM,1863,21,15-19,1884,1
SIM,1861,43,na,1904,2179
STAT,1878,39,50-100,1917,1.2504733414124551
STAT,1863,50,50-100,1913,0.013078686567883847
STAT,1870,54,50-100,1924,0.01464238943140768
STAT,1896,49,50-100,1945,0.17881279342834103
STAT,1835,21,45-49,1856,0.7064082314259158
STAT,1838,35,na,1873,1125.29877523346
STAT,1882,37,20-24,1919,0.7380186332678048
STAT,1798,108,na,1906,7.775079542501818E-4
STAT,1898,30,50-100,1928,1.2419945036511182
STAT,1904,33,na,1937,3423.8037159792298
STAT,1922,34,35-39,1956,10.160163325072238
STAT,1874,73,na,1947,1225.8397425849603
STAT,1878,24,20-24,1902,70.45808617971387
STAT,1915,49,15-19,1964,3.6380421714396526E-4
STAT,1940,23,45-49,1963,1.1329728575096303
STAT,1862,29,50-100,1891,0.5409580893155507
STAT,1879,19,40-44,1898,0.1866230275396507
SIM,1886,24,20-24,1910,17
SIM,1842,60,na,1902,2485
SIM,1846,74,na,1920,319
STAT,1912,46,40-44,1958,0.15013326053491496
STAT,1859,22,45-49,1881,0.5734366151858795
STAT,1863,66,na,1929,1399.2431132817446
SIM,1935,26,na,1961,5675
STAT,1804,55,na,1859,2069.4113351680303
STAT,1904,21,35-39,1925,8.362297163108673
STAT,1808,69,na,1877,446.8226668662924
STAT,1901,34,15-19,1935,0.1974118158179094
SIM,1829,51,na,1880,1785
STAT,1830,36,45-49,1866,1.8372981103889654
STAT,1855,21,15-19,1876,2.5692168124680754
STAT,1911,17,40-44,1928,0.27674309088849824
SIM,1837,24,25-29,1861,1021
STAT,1934,23,50-100,1957,0.8779920481439021
SIM,1910,20,20-24,1930,469
STAT,1815,46,20-24,1861,0.0012326267486398933
STAT,1841,54,20-24,1895,7.991244276336454E-4
STAT,1857,18,na,1875,2058.097867165329
SIM,1869,16,na,1885,3761
STAT,1849,36,45-49,1885,1.7367131657544916
STAT,1814,101,na,1915,0.38618923004781736
SIM,1799,59,na,1858,1493
STAT,1880,58,na,1938,2053.051629937906
STAT,1924,47,15-19,1971,4.3433791543563417E-4
STAT,1896,15,25-29,1911,7.504750587553621
SIM,1942,26,25-29,1968,1
STAT,1917,3,na,1920,4292.3970068717035
STAT,1847,20,25-29,1867,64.36973332564231
STAT,1910,32,15-19,1942,0.1225195289481375
STAT,1826,30,35-39,1856,24.20742751599139
STAT,1921,46,35-39,1967,0.1439784563689845
STAT,1912,20,30-34,1932,27.38689633404349
STAT,1852,39,na,1891,2347.6301027172385
STAT,1815,62,na,1877,157.10867550378885
STAT,1859,25,50-100,1884,0.5232540051301233
STAT,1854,18,25-29,1872,3.746909891937782
STAT,1893,32,na,1925,2984.1483534255394
STAT,1917,29,30-34,1946,40.253138026112936
STAT,1853,56,na,1909,1581.509163756599
STAT,1887,24,50-100,1911,0.44603412851000324
STAT,1923,16,na,1939,4287.123558164285
STAT,1924,32,15-19,1956,0.14848314329326895
SIM,1906,13,na,1919,3624
STAT,1901,19,25-29,1920,7.880814714009786
SIM,1930,34,35-39,1964,21
STAT,1938,19,20-24,1957,132.2166162052353
SIM,1865,57,na,1922,1666
STAT,1840,93,na,1933,11.507633029040019
STAT,1948,19,30-34,1967,13.797088705434481
STAT,1902,40,15-19,1942,0.0013640278120377882
STAT,1897,46,na,1943,2996.9457316839307
STAT,1930,33,30-34,1963,20.177319140318385
STAT,1824,39,25-29,1863,0.46605938785819756
STAT,1871,37,45-49,1908,1.9885899625432055
STAT,1896,22,15-19,1918,4.348867924065793
STAT,1798,65,na,1863,1216.7619712829571
STAT,1913,36,35-39,1949,2.368362494238964
STAT,1768,99,na,1867,0.9220838110218023
STAT,1850,47,25-29,1897,0.026473472574677442
STAT,1830,54,45-49,1884,0.01048801985006592
SIM,1847,60,na,1907,1382
SIM,1878,25,25-29,1903,22
STAT,1921,39,45-49,1960,0.7505682833192352
SIM,1867,68,na,1935,827
STAT,1810,63,na,1873,64.5122911287509
STAT,1914,33,45-49,1947,1.555343682364329
STAT,1768,111,na,1879,0.0033042848944578244
STAT,1846,23,15-19,1869,2.393511785745639
SIM,1946,19,20-24,1965,534
STAT,1887,48,na,1935,2445.2241288460255
STAT,1916,37,15-19,1953,0.019397074295135083
STAT,1904,47,45-49,1951,0.18930653249127863
SIM,1899,46,na,1945,1776
STAT,1831,54,50-100,1885,0.01204139141554159
STAT,1817,73,na,1890,376.26748497154665
STAT,1860,15,45-49,1875,0.0621904210560896
STAT,1908,46,50-100,1954,0.20449742870879214
STAT,1876,84,na,1960,476.7102445408205
STAT,1934,33,15-19,1967,0.174156454010145
STAT,1918,29,45-49,1947,1.800800075557434
STAT,1843,20,40-44,1863,2.6218509138937587
STAT,1917,31,50-100,1948,0.8577161490034072
SIM,1854,23,15-19,1877,5
SIM,1884,16,na,1900,3801
STAT,1928,22,35-39,1950,11.666856743964422
STAT,1943,19,30-34,1962,12.76922482931511
STAT,1921,31,35-39,1952,10.090098404380559
STAT,1852,20,35-39,1872,7.079239551850865
STAT,1891,48,25-29,1939,0.03945331807737936
STAT,1916,46,25-29,1962,0.05379886991252059
SIM,1902,21,25-29,1923,28
SIM,1925,16,na,1941,3225
SIM,1833,56,na,1889,2017
STAT,1867,32,45-49,1899,1.6491850717565175
SIM,1835,27,na,1862,874
SIM,1857,36,45-49,1893,1
SIM,1846,43,na,1889,1031
SIM,1933,33,20-24,1966,15
STAT,1832,49,25-29,1881,0.004639301938886359
STAT,1907,35,50-100,1942,0.3903291339335954
STAT,1918,36,35-39,1954,2.527135197553403
STAT,1908,36,25-29,1944,0.9191280517451635
STAT,1841,36,20-24,1877,1.021908919850741
STAT,1831,88,na,1919,107.44500776929145
STAT,1828,80,na,1908,418.746519850092
STAT,1834,21,na,1855,1269.3121465398701
STAT,1829,31,15-19,1860,0.08055568419993808
STAT,1851,33,50-100,1884,0.7454032488475746
SIM,1917,32,25-29,1949,12
STAT,1901,27,25-29,1928,59.14648911073758
STAT,1932,39,20-24,1971,0.3509734248091497
STAT,1872,24,50-100,1896,0.40578852841234836
STAT,1871,54,35-39,1925,0.008351750223739475
STAT,1818,90,na,1908,47.98680572998289
STAT,1918,25,30-34,1943,41.41560461023873
STAT,1877,18,20-24,1895,17.949441895081375
SIM,1817,62,na,1879,2170
STAT,1895,19,25-29,1914,7.332158212107541
SIM,1810,83,na,1893,1014
SIM,1893,1,na,1894,3684
STAT,1913,28,50-100,1941,0.9758847621596427
STAT,1855,27,50-100,1882,0.4412944453097645
SIM,1847,48,na,1895,1426
SIM,1876,29,na,1905,3852
STAT,1828,28,25-29,1856,78.91897831339607
STAT,1926,28,40-44,1954,5.520102371365248
STAT,1850,29,25-29,1879,22.65773880891778
SIM,1904,45,45-49,1949,1
STAT,1886,74,na,1960,1305.1587593448717
STAT,1922,42,35-39,1964,0.22854996873847233
STAT,1833,36,na,1869,1112.406290452443
STAT,1879,15,25-29,1894,5.84016459333277
STAT,1882,60,na,1942,1825.9533857434415
STAT,1924,28,50-100,1952,1.143747527005673
SIM,1917,43,50-100,1960,1
STAT,1901,26,15-19,1927,0.6365507855059586
SIM,1870,24,na,1894,2472
STAT,1849,15,40-44,1864,0.19195497433917375
STAT,1888,20,15-19,1908,3.8303321785541846
STAT,1869,51,na,1920,2183.118160954779
STAT,1828,89,na,1917,71.11390309119817
STAT,1870,0,na,1870,3721.5434132212554
STAT,1875,23,40-44,1898,2.1331518702565275
STAT,1927,30,na,1957,4619.698310967111
SIM,1871,41,na,1912,1863
STAT,1904,36,40-44,1940,1.3563940864309934
SIM,1918,34,35-39,1952,52
STAT,1944,16,40-44,1960,1.4887105804431737
STAT,1948,15,15-19,1963,51.43322945653479
STAT,1924,37,20-24,1961,0.30785675283436537
STAT,1856,47,20-24,1903,0.008578860563583446
STAT,1898,1,na,1899,3660.139569761109
STAT,1826,34,na,1860,2288.4902674366904
STAT,1869,19,25-29,1888,5.729283839566467
STAT,1936,17,45-49,1953,0.4735116981421167
STAT,1909,32,25-29,1941,8.730210174423316
SIM,1862,18,25-29,1880,87
STAT,1920,44,25-29,1964,0.07759387354317955
STAT,1967,2,na,1969,4865.751899263945
SIM,1824,75,na,1899,1465
STAT,1869,26,20-24,1895,11.878619843471375
STAT,1820,39,40-44,1859,7.50712701513539
STAT,1940,30,35-39,1970,9.362307227522738
STAT,1837,22,50-100,1859,0.42803958414496857
STAT,1837,23,20-24,1860,71.8150406544743
SIM,1876,73,na,1949,801
STAT,1906,16,20-24,1922,25.73523037723125
STAT,1867,31,35-39,1898,9.61661037986458
STAT,1896,0,na,1896,3870.762839857971
STAT,1846,47,50-100,1893,0.14478112925812006
STAT,1902,30,15-19,1932,0.20214476273269477
SIM,1969,0,na,1969,4554
STAT,1843,108,na,1951,0.001809824862300025
STAT,1923,18,15-19,1941,52.59205265765141
STAT,1869,82,na,1951,470.8198775266098
SIM,1941,10,na,1951,3905
SIM,1945,24,na,1969,4083
STAT,1934,26,25-29,1960,87.98449923134766
SIM,1907,3,na,1910,4894
STAT,1916,45,15-19,1961,3.7443044335487563E-4
STAT,1845,47,45-49,1892,0.11656125483836921
SIM,1869,27,25-29,1896,1
STAT,1940,28,na,1968,3775.3802562640367
STAT,1939,31,na,1970,3818.7011482633825
STAT,1779,82,na,1861,250.7695700216254
STAT,1869,19,na,1888,2553.486464340127
STAT,1791,95,na,1886,3.4001380697982424
STAT,1846,54,na,1900,1240.1687812058535
STAT,1886,48,45-49,1934,0.2413190569941641
SIM,1912,36,40-44,1948,1
STAT,1863,21,20-24,1884,60.43783418322723
STAT,1910,22,20-24,1932,103.25395106572748
STAT,1903,25,35-39,1928,13.789685463711558
STAT,1914,32,35-39,1946,9.070775338918336
STAT,1862,92,na,1954,35.474514399393584
SIM,1852,39,na,1891,1789
STAT,1858,55,na,1913,1579.0390310292164
STAT,1830,53,35-39,1883,0.006346154794919067
STAT,1888,35,50-100,1923,1.4304737072189033
SIM,1918,14,na,1932,4462
STAT,1834,25,45-49,1859,0.6509573673899323
STAT,1884,21,40-44,1905,2.000795075214028
SIM,1782,79,na,1861,514
SIM,1839,41,na,1880,889
STAT,1803,61,na,1864,705.3498041692551
STAT,1933,0,na,1933,5989.84668704171
STAT,1903,18,45-49,1921,0.0924830861260442
STAT,1926,35,30-34,1961,2.212151224902954
SIM,1853,56,na,1909,2912
STAT,1906,49,20-24,1955,0.009597336480437193
SIM,1827,60,na,1887,1305
STAT,1904,43,30-34,1947,0.1132364511986574
SIM,1840,58,na,1898,2500
SIM,1906,33,na,1939,3392
STAT,1903,43,35-39,1946,0.1772093076386596
STAT,1908,33,20-24,1941,2.2749249041976545
SIM,1902,51,na,1953,2972
STAT,1808,60,na,1868,624.9933817961772
STAT,1852,21,45-49,1873,0.8398730324980853
STAT,1838,18,40-44,1856,0.10252454560772829
STAT,1824,54,20-24,1878,1.19624291026046E-4
STAT,1841,78,na,1919,870.0647729523164
SIM,1828,34,na,1862,2096
STAT,1905,32,40-44,1937,3.5816234722923577
STAT,1837,31,20-24,1868,2.74581518679438
STAT,1837,33,15-19,1870,0.14168700575751808
STAT,1870,68,na,1938,1523.5107665123628
SIM,1807,63,na,1870,566
STAT,1834,30,40-44,1864,2.499547785985669
STAT,1909,39,45-49,1948,0.6322745248284685
STAT,1878,27,25-29,1905,43.52263039918463
STAT,1877,90,na,1967,225.44948769284994
SIM,1887,68,na,1955,2054
STAT,1935,17,30-34,1952,16.54293839768065
STAT,1926,24,25-29,1950,110.55927658778617
SIM,1914,7,na,1921,5124
SIM,1858,55,na,1913,2290
STAT,1935,36,35-39,1971,3.360901508194215
SIM,1904,36,35-39,1940,1
STAT,1821,53,40-44,1874,0.010652225899994972
STAT,1943,21,20-24,1964,116.99156859167552
SIM,1930,31,30-34,1961,1
STAT,1871,47,45-49,1918,0.23432275489084323
SIM,1917,39,45-49,1956,1
STAT,1931,18,20-24,1949,175.74602798117937
STAT,1847,49,20-24,1896,0.010622876609415126
SIM,1900,18,20-24,1918,67
SIM,1850,49,50-100,1899,3
STAT,1844,48,40-44,1892,0.1674748340820727
SIM,1871,21,20-24,1892,125
STAT,1950,19,20-24,1969,158.67280478352916
SIM,1891,50,na,1941,1897
STAT,1917,45,30-34,1962,0.09230269132462249
SIM,1928,39,20-24,1967,2
STAT,1915,24,15-19,1939,5.39082662807404
SIM,1895,64,na,1959,4126
STAT,1912,23,35-39,1935,8.891442458285386
STAT,1836,49,45-49,1885,0.18446686161460055
STAT,1918,18,40-44,1936,1.4979506012214459
SIM,1847,17,na,1864,1776
STAT,1836,108,na,1944,0.0014018858113678647
STAT,1922,31,30-34,1953,17.67474347532453
SIM,1900,37,25-29,1937,2
STAT,1864,20,25-29,1884,53.646824296789
STAT,1929,37,20-24,1966,0.3360587946640262
STAT,1945,27,na,1972,4064.509567529459
STAT,1910,16,15-19,1926,8.913779547129485
SIM,1911,43,35-39,1954,1
SIM,1877,19,25-29,1896,1
STAT,1891,45,20-24,1936,0.008407020459547603
SIM,1845,26,na,1871,2638
STAT,1912,41,35-39,1953,0.1930619376126281
STAT,1854,16,50-100,1870,0.03277902687313355
STAT,1923,23,45-49,1946,1.2914101796996873
SIM,1805,61,na,1866,2097
SIM,1923,36,na,1959,4234
STAT,1805,49,15-19,1854,4.784616003493848E-4
STAT,1920,40,30-34,1960,0.1397687110682707
SIM,1918,1,na,1919,4571
STAT,1891,45,50-100,1936,0.1720636785929563
STAT,1912,49,45-49,1961,0.20523607663762053
SIM,1815,82,na,1897,339
SIM,1920,49,45-49,1969,4
STAT,1944,27,45-49,1971,1.8461989897598123
STAT,1826,31,45-49,1857,3.7484469860247325
STAT,1903,44,25-29,1947,0.062445411318214225
SIM,1845,26,25-29,1871,59
SIM,1866,83,na,1949,637
STAT,1839,21,30-34,1860,21.41700449913216
SIM,1929,19,20-24,1948,3
STAT,1860,20,40-44,1880,1.9536801516485638
STAT,1940,16,20-24,1956,136.14875829256394
STAT,1863,23,15-19,1886,2.851920658189249
STAT,1891,27,20-24,1918,14.42650292051515
STAT,1911,42,30-34,1953,0.12064681932088306
SIM,1844,49,45-49,1893,6
STAT,1829,54,na,1883,797.6394745997507
STAT,1869,102,na,1971,2.8693071252361464
STAT,1850,44,20-24,1894,0.07234390092935784
STAT,1944,15,30-34,1959,12.97629289991952
SIM,1943,22,25-29,1965,1179
SIM,1838,55,na,1893,1620
STAT,1813,54,45-49,1867,0.048437813564437854
STAT,1934,23,20-24,1957,148.37186049082024
STAT,1924,42,na,1966,4375.15453411913
STAT,1931,22,40-44,1953,4.330255414383993
SIM,1832,36,20-24,1868,4
STAT,1915,42,15-19,1957,0.0015242459156701645
STAT,1847,16,40-44,1863,0.20761560729263828
SIM,1796,62,na,1858,1195
STAT,1819,35,20-24,1854,0.5836520360113662
STAT,1824,36,20-24,1860,0.12040723619219694
STAT,1858,35,na,1893,1816.2626424877665
STAT,1876,18,50-100,1894,0.04939652483081355
SIM,1841,23,na,1864,228
SIM,1932,29,20-24,1961,100
STAT,1923,30,35-39,1953,10.449356891483811
STAT,1860,48,25-29,1908,0.046399202204717424
STAT,1924,29,20-24,1953,20.899072403526535
STAT,1854,21,na,1875,1406.9433628516008
STAT,1921,47,50-100,1968,0.2519529516220328
STAT,1880,45,45-49,1925,0.24744703997892828
STAT,1886,26,20-24,1912,12.190196029983346
STAT,1831,39,15-19,1870,0.055632982371264426
SIM,1845,37,na,1882,2422
STAT,1870,17,50-100,1887,0.049306892698734665
STAT,1934,25,15-19,1959,0.9440714492664909
STAT,1927,18,35-39,1945,5.161346891901567
SIM,1904,65,na,1969,3720
STAT,1889,15,35-39,1904,0.6638393067376966
STAT,1837,26,25-29,1863,43.84917829822638
STAT,1872,50,35-39,1922,0.008744648011622216
STAT,1844,11,na,1855,3020.0437199999997
STAT,1935,22,25-29,1957,124.87901842127377
STAT,1848,25,na,1873,2451.752341291655
STAT,1959,9,na,1968,5094.312872315424
SIM,1837,70,na,1907,1470
SIM,1848,8,na,1856,2793
SIM,1871,23,15-19,1894,3
STAT,1871,18,25-29,1889,5.655806705211333
SIM,1879,49,na,1928,1085
STAT,1902,27,40-44,1929,4.218234548379111
STAT,1933,29,15-19,1962,0.9300777678071365
SIM,1917,28,na,1945,2235
STAT,1862,54,40-44,1916,0.008720249029522661
SIM,1894,26,20-24,1920,2
STAT,1923,19,25-29,1942,50.08050714461804
STAT,1909,27,30-34,1936,37.065396738039404
STAT,1847,105,na,1952,0.02650931583725765
SIM,1834,41,na,1875,854
STAT,1838,30,25-29,1868,5.5471306868071215
SIM,1878,30,20-24,1908,37
SIM,1931,30,35-39,1961,6
SIM,1902,32,30-34,1934,1
SIM,1794,71,na,1865,657
STAT,1860,69,na,1929,1197.2104016820786
SIM,1845,31,20-24,1876,3
SIM,1837,18,na,1855,2361
SIM,1931,19,25-29,1950,2
STAT,1880,27,45-49,1907,1.152666129616433
SIM,1909,44,35-39,1953,1
STAT,1942,27,15-19,1969,0.7324729615583913
SIM,1886,32,20-24,1918,28
SIM,1857,41,40-44,1898,1
STAT,1827,63,na,1890,1258.2762875474293
STAT,1888,21,25-29,1909,66.27028059226659
STAT,1936,16,35-39,1952,3.9872678074579264
STAT,1868,15,15-19,1883,5.905150297492084
STAT,1899,26,na,1925,3270.860378996579
SIM,1925,27,na,1952,4790
SIM,1885,47,40-44,1932,9
STAT,1919,16,35-39,1935,0.9202334535926364
STAT,1878,32,20-24,1910,2.781093973851391
STAT,1911,24,30-34,1935,26.78231446393865
STAT,1900,36,20-24,1936,0.23159445625460423
STAT,1799,91,na,1890,3.853455546368456
SIM,1846,30,25-29,1876,20
STAT,1942,25,20-24,1967,18.956146118562884
STAT,1888,17,40-44,1905,0.21110007091395067
STAT,1914,32,na,1946,3754.077265613932
STAT,1926,13,na,1939,4808.826073516779
STAT,1918,46,na,1964,3866.346196970344
STAT,1878,34,15-19,1912,0.14526443793119395
SIM,1903,42,25-29,1945,2
STAT,1867,91,na,1958,78.4818686451008
STAT,1925,27,15-19,1952,0.8261833120663461
STAT,1884,72,na,1956,1240.393076257556
STAT,1905,28,20-24,1933,16.814192295074257
STAT,1907,39,15-19,1946,0.017506947002617432
STAT,1850,26,20-24,1876,6.420987151367927
SIM,1913,46,na,1959,2906
STAT,1785,78,na,1863,134.0454611940116
SIM,1908,34,25-29,1942,16
STAT,1893,22,45-49,1915,0.8720200251341395
STAT,1909,32,na,1941,3572.3725208243627
STAT,1810,94,na,1904,0.6222580131646454
STAT,1887,30,20-24,1917,2.999099241281885
SIM,1864,17,na,1881,2476
STAT,1858,24,na,1882,1858.764196242803
SIM,1874,61,na,1935,2153
SIM,1878,75,na,1953,1359
STAT,1935,29,45-49,1964,2.3357028902309467
STAT,1878,32,na,1910,2455.2020187408634
STAT,1849,41,40-44,1890,1.9037969846868665
STAT,1897,48,20-24,1945,0.008876628634971491
SIM,1821,54,45-49,1875,1
STAT,1797,80,na,1877,10.565099853021291
STAT,1859,72,na,1931,1000.9611789233471
STAT,1877,47,40-44,1924,0.17297839201665158
STAT,1907,53,na,1960,3181.9758896922426
STAT,1890,2,na,1892,3227.067295095473
SIM,1890,24,na,1914,3947
STAT,1847,23,30-34,1870,19.600658029550676
SIM,1829,30,25-29,1859,22
STAT,1876,53,na,1929,2141.7059914779325
STAT,1790,78,na,1868,418.7652900556878
STAT,1902,34,30-34,1936,13.996462832998963
STAT,1863,45,45-49,1908,0.20348473203659012
STAT,1898,31,na,1929,3222.0261938713875
SIM,1869,24,20-24,1893,238
STAT,1920,48,40-44,1968,0.17156266691697714
STAT,1839,21,na,1860,2570.8266545660017
STAT,1920,15,40-44,1935,0.3122379237597497
STAT,1943,22,50-100,1965,0.6920703814969099
STAT,1880,52,35-39,1932,0.00888995404975338
STAT,1909,43,30-34,1952,0.11765151681395919
SIM,1814,42,na,1856,2401
SIM,1854,62,na,1916,633
SIM,1881,40,na,1921,2984
STAT,1847,40,na,1887,2155.8232960438745
STAT,1818,53,50-100,1871,0.02533290482659497
SIM,1908,24,na,1932,2780
STAT,1898,52,na,1950,2880.0659797332764
SIM,1905,29,25-29,1934,3
STAT,1879,31,25-29,1910,10.550210979561415
STAT,1885,13,na,1898,2534.541051916772
SIM,1885,54,na,1939,1103
STAT,1790,103,na,1893,0.04172993712775905
STAT,1904,28,40-44,1932,4.264685245522677
SIM,1869,2,na,1871,3989
STAT,1920,22,30-34,1942,31.541370484047203
STAT,1896,20,20-24,1916,91.3844400255368
STAT,1936,21,30-34,1957,27.214288252651443
STAT,1947,20,50-100,1967,0.7363315704638753
STAT,1898,44,40-44,1942,0.2072020300854775
SIM,1889,16,na,1905,3885
STAT,1811,45,25-29,1856,0.27955730335151197
STAT,1821,78,na,1899,394.5863924079748
STAT,1879,72,na,1951,1295.5279118423248
STAT,1887,24,15-19,1911,3.6084156842338238
STAT,1915,21,45-49,1936,1.1501102909132002
STAT,1845,25,20-24,1870,7.188472267399464
STAT,1826,78,na,1904,622.9066292604444
SIM,1903,49,45-49,1952,6
STAT,1827,40,na,1867,1941.5171445905432
STAT,1925,8,na,1933,4773.903998144268
SIM,1906,2,na,1908,3770
STAT,1926,31,15-19,1957,0.1541416608812821
SIM,1901,14,na,1915,4147
STAT,1891,21,na,1912,2917.148881483424
SIM,1909,28,35-39,1937,475
SIM,1924,35,20-24,1959,4
STAT,1922,31,na,1953,4242.856528647493
SIM,1881,51,na,1932,2701
STAT,1906,13,na,1919,3733.861100847238
STAT,1832,38,20-24,1870,0.060737826160660924
STAT,1863,52,35-39,1915,0.007310533671308863
STAT,1813,59,na,1872,1820.6048547602888
STAT,1916,35,20-24,1951,0.2687976834245642
SIM,1886,27,25-29,1913,31
SIM,1958,11,na,1969,4197
STAT,1914,43,na,1957,3623.1633495533924
SIM,1840,38,20-24,1878,6
STAT,1862,108,na,1970,0.02328697233834049
STAT,1821,35,40-44,1856,5.7046536958211504
STAT,1899,24,40-44,1923,2.8283885900126378
STAT,1935,33,30-34,1968,21.626874056680016
SIM,1920,17,na,1937,4656
STAT,1789,92,na,1881,19.629241326990986
STAT,1896,20,na,1916,3136.2766062345577
STAT,1890,48,50-100,1938,0.1656087833291126
STAT,1901,69,na,1970,2416.249311871047
STAT,1876,21,35-39,1897,5.916943673708462
STAT,1889,45,50-100,1934,0.29870624027336057
STAT,1836,46,40-44,1882,0.13906002235870887
STAT,1839,47,20-24,1886,0.0113591788514673
STAT,1849,104,na,1953,0.0562009128648865
STAT,1931,35,na,1966,4956.097005724811
STAT,1905,35,45-49,1940,0.624753195896052
SIM,1820,38,na,1858,681
SIM,1921,34,40-44,1955,16
SIM,1893,21,na,1914,3488
STAT,1903,40,30-34,1943,0.11447064469374033
STAT,1833,30,50-100,1863,0.5336019541194152
STAT,1842,40,na,1882,609.0160524754461
STAT,1900,46,15-19,1946,3.1345370831354827E-4
STAT,1911,20,15-19,1931,5.021400332237918
STAT,1830,50,30-34,1880,0.005117047374699809
STAT,1876,20,na,1896,2405.1117850270243
STAT,1902,3,na,1905,3722.671473258527
STAT,1920,43,35-39,1963,0.2191899617232617
SIM,1897,35,na,1932,2631
STAT,1952,17,30-34,1969,14.47327994335041
STAT,1836,88,na,1924,105.06820858211726
STAT,1925,45,50-100,1970,0.2728458683089784
STAT,1832,74,na,1906,942.0711201690896
STAT,1855,18,40-44,1873,0.14313114062727308
STAT,1815,93,na,1908,2.0605538048543344
STAT,1889,27,na,1916,2873.91098475766
STAT,1854,37,45-49,1891,1.108413851196182
SIM,1863,4,na,1867,1920
STAT,1793,66,na,1859,688.8288087994027
STAT,1842,32,40-44,1874,1.300518259730382
STAT,1873,39,20-24,1912,0.7827628257095782
SIM,1916,43,na,1959,4552
SIM,1862,69,na,1931,2633
STAT,1919,42,na,1961,3971.263584197045
STAT,1834,22,na,1856,1260.1984853277136
SIM,1863,55,na,1918,154
SIM,1867,69,na,1936,547
STAT,1909,36,40-44,1945,1.409279608967318
STAT,1862,39,45-49,1901,1.6808454542734277
STAT,1920,28,na,1948,4042.3123459557837
STAT,1922,19,45-49,1941,0.5686105516318005
STAT,1881,15,30-34,1896,1.5121602740671616
STAT,1855,50,35-39,1905,0.005779668988572738
STAT,1871,15,20-24,1886,18.01074139419865
STAT,1854,31,20-24,1885,1.5551749068264131
STAT,1908,9,na,1917,3819.099041928519
STAT,1914,39,50-100,1953,0.40920995461681686
STAT,1812,74,na,1886,90.40385411948833
STAT,1943,24,25-29,1967,97.08677730282709
STAT,1839,24,35-39,1863,6.866371234167728
STAT,1804,53,40-44,1857,0.06516769538009563
STAT,1889,71,na,1960,1757.7370569017364
STAT,1911,19,35-39,1930,0.8257768754616918
SIM,1907,39,na,1946,4475
STAT,1868,4,na,1872,2880.2821135363915
STAT,1933,38,25-29,1971,1.3306570096995642
SIM,1870,39,45-49,1909,60
STAT,1768,112,na,1880,0.0020706962148098846
STAT,1930,18,40-44,1948,1.7909180023274902
STAT,1931,32,35-39,1963,11.890112264044223
STAT,1921,32,25-29,1953,10.163679738725566
STAT,1907,29,20-24,1936,16.851936324816492
STAT,1927,15,30-34,1942,15.101707841408247
STAT,1871,44,40-44,1915,2.2134643607283544
STAT,1889,16,na,1905,3048.8678069572393
SIM,1873,21,na,1894,2296
STAT,1886,29,25-29,1915,43.492156353647296
STAT,1931,25,45-49,1956,2.2166748905107068
SIM,1919,47,35-39,1966,2
SIM,1824,42,40-44,1866,10
SIM,1908,31,20-24,1939,2
STAT,1819,38,25-29,1857,0.7052457660726046
STAT,1815,47,50-100,1862,0.024894941606573077
SIM,1823,47,50-100,1870,1
STAT,1903,48,40-44,1951,0.13536123742059356
STAT,1926,19,50-100,1945,0.4529659444252331
STAT,1817,74,na,1891,351.5692872580142
STAT,1806,48,20-24,1854,0.03841088040656003
STAT,1847,19,45-49,1866,0.07284591262589396
STAT,1883,33,40-44,1916,4.154502301167706
STAT,1831,89,na,1920,82.22014329529489
STAT,1925,27,na,1952,4384.154551525008
STAT,1872,39,na,1911,2335.4362390798656
STAT,1923,16,20-24,1939,157.91002579057874
SIM,1875,87,na,1962,361
STAT,1938,34,45-49,1972,1.563274106838215
SIM,1878,20,na,1898,3973
STAT,1828,41,20-24,1869,0.20194551643484657
STAT,1838,99,na,1937,0.8076817200572115
STAT,1913,34,40-44,1947,3.8117084522221796
STAT,1813,60,na,1873,1784.90279355844
STAT,1902,54,na,1956,2968.6970127196605
SIM,1841,44,na,1885,376
STAT,1870,38,40-44,1908,4.342431764360406
STAT,1918,22,25-29,1940,98.27919816490727
STAT,1895,38,50-100,1933,1.5892149734202066
STAT,1789,81,na,1870,351.6894793575332
STAT,1933,19,20-24,1952,179.28882373296648
STAT,1816,42,40-44,1858,7.392849686926664
SIM,1899,18,20-24,1917,2
STAT,1893,47,25-29,1940,0.04044172071939268
SIM,1933,35,na,1968,4321
STAT,1802,75,na,1877,607.1338216967633
STAT,1953,17,45-49,1970,0.5988726823597071
SIM,1846,22,na,1868,1257
STAT,1871,51,30-34,1922,0.005966338550449513
SIM,1892,35,na,1927,3671
STAT,1912,16,45-49,1928,0.10008473352403724
STAT,1913,41,30-34,1954,0.12381846480551938
SIM,1896,49,na,1945,3237
STAT,1944,18,35-39,1962,4.463452204021554
STAT,1873,87,na,1960,281.4559766684728
STAT,1915,47,20-24,1962,0.010978485517357105
SIM,1825,37,na,1862,584
SIM,1871,10,na,1881,2073
STAT,1925,47,30-34,1972,0.10703483320362984
SIM,1844,46,40-44,1890,8
SIM,1886,28,na,1914,2861
STAT,1919,39,40-44,1958,1.583491158419245
STAT,1836,33,na,1869,2074.8339421319265
STAT,1848,20,40-44,1868,2.4087601563752536
STAT,1872,22,25-29,1894,57.32344238019386
SIM,1883,31,40-44,1914,4
STAT,1941,5,na,1946,4070.800139221429
STAT,1849,10,na,1859,2506.977851773094
STAT,1885,20,45-49,1905,0.6895214695323061
SIM,1868,54,na,1922,848
STAT,1922,26,35-39,1948,16.856891908102618
STAT,1819,44,na,1863,650.7565340291814
STAT,1939,17,15-19,1956,44.928308568663134
STAT,1845,28,25-29,1873,25.365963710920557
STAT,1943,28,40-44,1971,4.905035461532522
STAT,1861,18,50-100,1879,0.046554399692705355
STAT,1901,24,20-24,1925,95.75129969786776
SIM,1832,30,na,1862,2304
STAT,1871,21,na,1892,2366.3619182775087
STAT,1910,36,30-34,1946,1.731893419782402
STAT,1870,80,na,1950,616.6991373392707
STAT,1857,43,40-44,1900,1.7135392165719876
STAT,1903,42,50-100,1945,0.10401023483833337
SIM,1869,39,na,1908,3461
STAT,1890,35,na,1925,2879.2504215955673
STAT,1839,17,45-49,1856,0.07938992916007473
SIM,1921,9,na,1930,5353
STAT,1866,33,50-100,1899,0.832836623232668
STAT,1885,57,na,1942,1975.3655032264737
STAT,1869,48,45-49,1917,0.23515104531281206
STAT,1882,34,50-100,1916,0.8697124604608631
STAT,1935,26,40-44,1961,6.310738142507211
SIM,1865,43,40-44,1908,2
STAT,1896,19,40-44,1915,0.2398150348670193
STAT,1858,23,40-44,1881,1.649573176987502
STAT,1875,31,40-44,1906,4.4713654405034005
STAT,1921,36,40-44,1957,1.6531955512191625
STAT,1862,40,50-100,1902,0.9089029558631257
SIM,1935,15,30-34,1950,42
SIM,1925,18,25-29,1943,145
SIM,1909,25,30-34,1934,237
SIM,1802,64,na,1866,351
STAT,1899,41,50-100,1940,0.10065640582651499
STAT,1917,25,15-19,1942,0.7354176328010443
STAT,1853,36,na,1889,1845.8658637475864
STAT,1940,19,25-29,1959,43.47711116265535
STAT,1887,33,25-29,1920,11.226184700080756
STAT,1893,53,na,1946,2649.4361858007114
STAT,1841,55,na,1896,2302.533507979832
STAT,1863,16,25-29,1879,5.553041768890133
STAT,1932,20,na,1952,4786.53446516026
STAT,1936,34,na,1970,3632.408445968311
STAT,1920,18,45-49,1938,0.5517990137522433
STAT,1818,107,na,1925,0.0028703948427855498
STAT,1820,48,50-100,1868,0.38081995574610505
STAT,1829,28,40-44,1857,1.9966178140084767
STAT,1861,109,na,1970,0.008788312897868576
STAT,1843,15,45-49,1858,0.0834599318336511
STAT,1909,46,35-39,1955,0.11755839483530292
STAT,1849,51,na,1900,1822.9220676172586
SIM,1884,17,na,1901,3801
STAT,1862,36,40-44,1898,3.7464441971240023
STAT,1828,47,45-49,1875,0.2817736882659303
STAT,1917,38,40-44,1955,1.526506499199974
SIM,1895,33,25-29,1928,23
STAT,1927,34,35-39,1961,11.135340618189177
STAT,1906,18,15-19,1924,8.571137800655643
SIM,1915,29,20-24,1944,26
STAT,1863,42,40-44,1905,1.917870317663068
SIM,1819,41,na,1860,1871
STAT,1906,25,50-100,1931,0.9326047051761113
STAT,1885,49,40-44,1934,0.16476735271699897
SIM,1886,50,na,1936,2887
STAT,1852,46,25-29,1898,0.058144078620783975
STAT,1820,93,na,1913,20.09865670365077
STAT,1884,16,45-49,1900,0.06268500917712569
STAT,1840,27,50-100,1867,0.31405985514304297
STAT,1923,49,20-24,1972,0.012716907378404
STAT,1821,38,45-49,1859,2.394993704145784
STAT,1910,29,40-44,1939,4.4187684468816455
STAT,1857,39,na,1896,1789.6904247549408
SIM,1829,74,na,1903,1137
STAT,1873,35,50-100,1908,1.2713541229404441
STAT,1846,32,25-29,1878,7.168846288050384
STAT,1912,21,na,1933,3625.6756362133633
SIM,1915,17,na,1932,3371
STAT,1853,25,na,1878,1971.3718416575082
STAT,1900,39,25-29,1939,0.8522203944896634
STAT,1811,49,40-44,1860,0.7792706399698694
SIM,1855,36,na,1891,3106
STAT,1926,21,20-24,1947,134.33446742253116
SIM,1914,32,na,1946,5031
STAT,1927,27,45-49,1954,2.083171173699397
SIM,1887,42,50-100,1929,5
SIM,1858,31,35-39,1889,30
STAT,1898,40,25-29,1938,0.06056961904967568
STAT,1895,38,45-49,1933,2.5804093628040947
STAT,1905,42,35-39,1947,0.18064127835994226
STAT,1855,25,30-34,1880,19.367044255907857
STAT,1891,4,na,1895,3235.032347935426
STAT,1854,73,na,1927,660.4114762120143
SIM,1898,20,na,1918,3190
STAT,1907,48,25-29,1955,0.04681212235394873
STAT,1862,40,na,1902,1988.4413814850527
STAT,1890,68,na,1958,1930.5942998808414
STAT,1866,54,na,1920,1911.403137969121
STAT,1900,31,15-19,1931,0.19808146633971482
STAT,1920,25,35-39,1945,16.368020723053288
STAT,1824,46,50-100,1870,0.043106451509001484
SIM,1881,35,50-100,1916,3
SIM,1840,37,na,1877,2558
SIM,1853,28,25-29,1881,1
STAT,1919,31,na,1950,4042.6610435437788
SIM,1871,42,40-44,1913,10
SIM,1964,6,na,1970,5114
STAT,1795,77,na,1872,415.6100990536581
STAT,1865,37,20-24,1902,0.7037781490607131
STAT,1850,23,50-100,1873,0.22438716190446958
SIM,1880,3,na,1883,3342
STAT,1867,39,na,1906,2205.6934153607967
STAT,1915,20,35-39,1935,9.262920140924447
STAT,1918,21,15-19,1939,5.680859928883364
STAT,1840,47,45-49,1887,0.09370853970052892
STAT,1947,24,45-49,1971,1.2574028192062416
SIM,1867,23,20-24,1890,171
STAT,1865,22,35-39,1887,5.392504383587482
STAT,1922,16,40-44,1938,1.6046254585602744
STAT,1819,46,40-44,1865,0.03256891707473716
SIM,1854,47,50-100,1901,1
STAT,1827,45,20-24,1872,0.01127305184349551
STAT,1920,1,na,1921,4625.0707240607435
STAT,1880,23,15-19,1903,3.414313553130816
STAT,1929,35,35-39,1964,3.088847783762864
STAT,1843,48,25-29,1891,0.056196282899584754
STAT,1868,23,15-19,1891,3.176585096254146
STAT,1871,44,na,1915,2274.4417332328626
STAT,1847,31,30-34,1878,18.727795007150196
SIM,1853,36,25-29,1889,8
STAT,1812,102,na,1914,0.023217869778033636
SIM,1953,12,na,1965,4654
STAT,1880,49,40-44,1929,0.17402113262054927
STAT,1925,17,20-24,1942,162.27617762012474
STAT,1852,61,na,1913,1880.9460086182771
STAT,1845,36,25-29,1881,1.5167974848023973
STAT,1888,25,40-44,1913,3.4808270624324806
STAT,1848,23,45-49,1871,0.7888244003914476
STAT,1875,19,20-24,1894,18.106954464720555
SIM,1955,13,na,1968,3822
STAT,1841,24,na,1865,2973.025486110049
STAT,1862,33,20-24,1895,2.2925902919936827
STAT,1941,18,30-34,1959,12.407984553243978
SIM,1868,31,na,1899,1156
STAT,1794,82,na,1876,2.0981088906877745
STAT,1862,8,na,1870,2395.4831714200463
STAT,1908,32,50-100,1940,0.7743905801746281
SIM,1844,38,25-29,1882,4
STAT,1909,21,20-24,1930,102.60257351238693
SIM,1827,46,40-44,1873,2
STAT,1829,75,na,1904,375.92812469447483
STAT,1878,42,15-19,1920,0.014191015776312956
STAT,1839,25,45-49,1864,1.318379001399853
STAT,1887,79,na,1966,1108.7756402158373
SIM,1876,23,15-19,1899,19
STAT,1854,34,25-29,1888,5.712225837125644
STAT,1912,31,20-24,1943,2.3819331184647203
STAT,1875,41,35-39,1916,1.867851675023239
SIM,1872,36,na,1908,2362
SIM,1878,36,30-34,1914,1
SIM,1910,37,35-39,1947,10
STAT,1905,38,15-19,1943,0.01734665095042999
SIM,1836,39,45-49,1875,4
STAT,1856,22,40-44,1878,1.7382806615521804
STAT,1889,38,20-24,1927,0.9236712666048944
STAT,1892,16,na,1908,3134.617181035332
STAT,1811,89,na,1900,63.64466594702012
SIM,1899,26,20-24,1925,19
STAT,1874,20,35-39,1894,6.058537840608075
STAT,1929,33,40-44,1962,4.932896773330952
STAT,1881,16,40-44,1897,0.17314830776625
STAT,1822,41,na,1863,1608.8852281761012
STAT,1854,3,na,1857,1879.2084632470182
STAT,1897,18,45-49,1915,0.08652438998517789
SIM,1917,21,20-24,1938,1
STAT,1859,25,15-19,1884,0.3711184865273966
SIM,1883,41,35-39,1924,24
STAT,1837,37,45-49,1874,1.9461202609720087
STAT,1807,74,na,1881,536.2551309980191
STAT,1828,39,45-49,1867,2.5666251921120438
STAT,1872,18,40-44,1890,0.18267187455378409
SIM,1919,37,40-44,1956,25
STAT,1794,92,na,1886,0.14469803095510383
SIM,1813,59,na,1872,35
STAT,1930,40,40-44,1970,0.32769668996144385
STAT,1867,49,na,1916,2083.3164264557504
STAT,1864,19,45-49,1883,0.06071101538657377
STAT,1832,50,50-100,1882,0.0012570916651572254
STAT,1879,34,30-34,1913,17.75752801284097
STAT,1826,57,na,1883,1707.2734511210365
STAT,1883,36,45-49,1919,1.9270508946526665
STAT,1825,42,50-100,1867,1.4050035414969684
STAT,1875,68,na,1943,1569.233049751507
SIM,1851,74,na,1925,865
STAT,1893,29,50-100,1922,0.7942357125015419
STAT,1863,27,45-49,1890,0.9478794271801626
STAT,1869,44,15-19,1913,0.01374714916627746
STAT,1809,75,na,1884,1044.7169959302798
STAT,1818,38,na,1856,1852.9211250583003
STAT,1877,49,na,1926,2236.173913136483
STAT,1889,31,50-100,1920,1.1078748657978503
STAT,1829,35,30-34,1864,2.8006367138983657
STAT,1887,38,50-100,1925,1.3446408786348594
STAT,1934,15,20-24,1949,182.98412230076016
STAT,1889,7,na,1896,3137.4350875179734
STAT,1877,69,na,1946,1489.7331525830436
SIM,1800,62,na,1862,216
SIM,1894,37,40-44,1931,3
STAT,1896,26,30-34,1922,33.30941940095615
STAT,1850,51,45-49,1901,0.0067333394505664805
STAT,1902,37,35-39,1939,2.149737085011312
STAT,1907,21,50-100,1928,0.5968020808188079
SIM,1861,74,na,1935,1395
STAT,1892,48,20-24,1940,0.008275353413313745
STAT,1816,45,45-49,1861,0.7387925523764298
STAT,1816,57,na,1873,2109.073227837126
STAT,1927,45,25-29,1972,0.06635388621208174
STAT,1792,102,na,1894,0.07097073356679492
SIM,1872,23,30-34,1895,29
SIM,1891,19,na,1910,2586
STAT,1872,91,na,1963,134.16007430415218
STAT,1894,17,na,1911,3211.7085973749568
STAT,1929,28,45-49,1957,2.145969764869018
STAT,1842,49,20-24,1891,0.0029167358859700445
STAT,1824,31,50-100,1855,0.4242866633384687
STAT,1859,23,20-24,1882,56.26273028341174
STAT,1930,22,25-29,1952,117.50052712307253
STAT,1862,50,25-29,1912,0.003060231485887064
STAT,1892,36,na,1928,2930.960097278884
STAT,1849,51,35-39,1900,0.00728863062325282
STAT,1854,96,na,1950,4.774333389740356
STAT,1831,49,45-49,1880,0.21689243083603477
STAT,1850,18,20-24,1868,9.944675426686725
STAT,1886,37,40-44,1923,4.533123474973518
SIM,1823,35,na,1858,1721
STAT,1864,23,30-34,1887,16.335519864486855
STAT,1833,26,20-24,1859,7.444373295859172
STAT,1877,39,25-29,1916,2.8933156465997762
STAT,1894,36,20-24,1930,0.9849745968715549
SIM,1881,19,na,1900,2976
SIM,1837,35,30-34,1872,21
SIM,1907,27,20-24,1934,18
STAT,1884,17,na,1901,2417.69303505848
STAT,1792,81,na,1873,267.6836182950604
STAT,1848,30,35-39,1878,11.283370406876896
STAT,1828,44,25-29,1872,0.7766425140115866
STAT,1897,25,35-39,1922,12.901214403777509
STAT,1906,20,40-44,1926,3.0355081016154437
SIM,1855,31,30-34,1886,18
STAT,1909,23,15-19,1932,4.881940931604861
STAT,1923,15,45-49,1938,0.5831060792879676
SIM,1885,39,25-29,1924,2
SIM,1821,44,na,1865,1934
STAT,1865,15,45-49,1880,0.06833754930983765
STAT,1881,54,na,1935,1977.4236143835976
STAT,1855,26,40-44,1881,2.081446960247619
STAT,1906,39,50-100,1945,0.3798731570607481
STAT,1834,40,35-39,1874,0.9870562444572331
STAT,1854,29,45-49,1883,0.6379219646808046
STAT,1782,81,na,1863,615.3427416543851
STAT,1908,25,20-24,1933,17.384938411363862
STAT,1854,41,15-19,1895,0.00771325283876951
SIM,1850,37,na,1887,1568
STAT,1831,24,na,1855,2140.9925396353624
STAT,1917,45,50-100,1962,0.23418947242527047
STAT,1904,66,na,1970,2681.9510020130824
SIM,1831,29,15-19,1860,3
STAT,1876,47,25-29,1923,0.05795683881214311
STAT,1777,80,na,1857,624.5777022289192
STAT,1840,29,15-19,1869,0.2195601343086959
SIM,1849,40,na,1889,2179
STAT,1859,18,25-29,1877,5.182874601340184
STAT,1829,36,50-100,1865,0.6336308130183552
STAT,1937,27,40-44,1964,4.496578486933416
SIM,1938,11,na,1949,4240
STAT,1946,25,40-44,1971,5.140472710065167
SIM,1863,26,40-44,1889,3
SIM,1943,12,na,1955,4986
STAT,1862,54,50-100,1916,0.012509889953777237
STAT,1865,105,na,1970,0.3049908916180512
STAT,1846,77,na,1923,511.9456390430814
SIM,1830,27,na,1857,1017
STAT,1868,16,25-29,1884,5.6054431172880035
STAT,1869,15,30-34,1884,1.6499960786908319
STAT,1914,24,35-39,1938,9.426625437700649
STAT,1889,23,35-39,1912,7.005516931228668
SIM,1887,34,30-34,1921,8
STAT,1887,69,na,1956,1643.4767504108688
SIM,1925,15,20-24,1940,515
STAT,1847,24,40-44,1871,2.276561855722197
STAT,1830,25,40-44,1855,2.9222336346891877
STAT,1845,43,15-19,1888,0.006889370736877082
STAT,1851,24,na,1875,1987.7556702946974
SIM,1881,29,na,1910,3115
STAT,1857,46,45-49,1903,0.18161146471339745
STAT,1830,25,25-29,1855,41.26589816011622
STAT,1849,29,20-24,1878,11.549873605888212
SIM,1866,49,30-34,1915,1
SIM,1856,1,na,1857,2567
STAT,1869,47,50-100,1916,0.2466751115465984
STAT,1912,41,50-100,1953,0.11263480022909418
STAT,1838,26,40-44,1864,1.6383914802509916
STAT,1881,48,45-49,1929,0.22006575272333342
STAT,1868,86,na,1954,214.30373996849937
STAT,1940,16,50-100,1956,0.3762400449100044
STAT,1857,34,50-100,1891,0.6970719027876053
STAT,1888,49,50-100,1937,0.15655799838162623
STAT,1908,20,50-100,1928,0.6038172605533129
STAT,1911,14,na,1925,3894.8382571711177
STAT,1861,44,na,1905,1896.1811731639991
SIM,1942,0,na,1942,3749
STAT,1878,35,40-44,1913,4.5466518311757955
STAT,1858,27,20-24,1885,9.171176009522254
STAT,1848,37,20-24,1885,0.7433558542747797
STAT,1947,0,na,1947,4948.016883249906
SIM,1927,5,na,1932,2101
STAT,1808,50,35-39,1858,0.011576504723868104
SIM,1847,69,na,1916,1382
SIM,1850,27,na,1877,1873
SIM,1862,34,25-29,1896,15
STAT,1809,55,na,1864,2690.030707297967
STAT,1955,5,na,1960,5173.910341225632
STAT,1829,36,40-44,1865,2.259203432701222
STAT,1886,44,15-19,1930,0.014107736875041802
SIM,1957,3,na,1960,6081
STAT,1826,53,50-100,1879,0.020455550181809088
STAT,1867,17,20-24,1884,17.140296049628976
SIM,1912,32,25-29,1944,61
STAT,1878,25,50-100,1903,0.6626249888813777
SIM,1861,35,20-24,1896,1
STAT,1938,26,45-49,1964,1.6939890574343224
STAT,1853,35,20-24,1888,0.6102501643282388
STAT,1902,31,na,1933,3374.0411421884314
STAT,1914,22,40-44,1936,3.387387192305686
STAT,1845,39,45-49,1884,1.0179835324742579
STAT,1879,27,40-44,1906,3.0729688029932873
STAT,1891,19,20-24,1910,21.68436892275541
SIM,1924,21,na,1945,5281
STAT,1820,35,25-29,1855,6.045454130607127
STAT,1872,71,na,1943,1336.6154002453368
STAT,1863,31,15-19,1894,0.12207201526288544
STAT,1864,24,40-44,1888,1.8973251490238627
STAT,1860,90,na,1950,64.31751717997261
STAT,1938,33,35-39,1971,9.084638490080152
STAT,1873,21,30-34,1894,18.32664027649474
SIM,1912,20,na,1932,4760
STAT,1833,59,na,1892,799.6134464879293
SIM,1875,17,20-24,1892,153
SIM,1896,70,na,1966,1671
STAT,1869,37,25-29,1906,2.9053457099253093
STAT,1904,32,25-29,1936,8.402594757306316
SIM,1847,32,35-39,1879,7
STAT,1847,49,na,1896,1991.6483358814878
STAT,1910,39,35-39,1949,2.264377334113099
STAT,1838,33,30-34,1871,9.16571667247789
STAT,1895,34,15-19,1929,0.18366815095185446
STAT,1956,10,na,1966,5153.846022432732
SIM,1842,40,35-39,1882,36
STAT,1954,17,50-100,1971,0.45906784496872943
STAT,1837,94,na,1931,16.025508906554112
STAT,1910,50,na,1960,3358.75399928286
SIM,1916,25,20-24,1941,89
STAT,1884,46,20-24,1930,0.01151988369526413
STAT,1829,85,na,1914,100.10552558045525
SIM,1827,46,25-29,1873,1
STAT,1896,27,40-44,1923,3.9488380954409474
SIM,1950,5,na,1955,4871
STAT,1937,34,30-34,1971,15.406364591515239
STAT,1886,37,25-29,1923,2.9815529249659485
STAT,1875,34,45-49,1909,1.775316886052439
STAT,1917,48,35-39,1965,0.13250088583961384
STAT,1909,24,25-29,1933,84.44345313027262
STAT,1839,32,35-39,1871,11.578507845497658
STAT,1852,71,na,1923,1343.594184616954
STAT,1928,37,40-44,1965,1.877495216954739
STAT,1890,38,45-49,1928,2.4013593798067054
STAT,1882,16,na,1898,2423.979971494633
SIM,1894,37,25-29,1931,23
STAT,1914,17,45-49,1931,0.10189676269959361
SIM,1832,28,20-24,1860,3
STAT,1819,46,25-29,1865,0.010957766407129628
STAT,1828,43,15-19,1871,0.016982723279624284
STAT,1848,22,35-39,1870,6.648953685423765
SIM,1845,34,40-44,1879,4
SIM,1859,40,na,1899,1874
STAT,1823,47,45-49,1870,0.3682154011578732
STAT,1929,32,30-34,1961,19.87227329448808
STAT,1797,79,na,1876,11.615488475896624
STAT,1895,27,25-29,1922,55.028754207313455
STAT,1932,20,35-39,1952,12.341759676583566
STAT,1830,32,15-19,1862,0.13376422473241117
SIM,1948,11,na,1959,5824
SIM,1829,33,30-34,1862,2
STAT,1880,35,na,1915,2469.0968938594388
STAT,1900,17,30-34,1917,2.207964108199277
STAT,1912,34,25-29,1946,8.912078950647635
SIM,1895,23,na,1918,4546
STAT,1884,39,30-34,1923,5.0505097728957615
SIM,1896,24,30-34,1920,271
STAT,1794,102,na,1896,6.93876126233035E-4
STAT,1894,39,40-44,1933,5.510662576316833
STAT,1879,19,50-100,1898,0.04998829879221371
SIM,1846,36,35-39,1882,2
STAT,1888,24,30-34,1912,20.429592169493798
SIM,1892,39,30-34,1931,6
SIM,1866,41,35-39,1907,3
STAT,1947,21,40-44,1968,3.761299495864569
STAT,1864,42,na,1906,2098.5754090802066
STAT,1887,36,30-34,1923,5.894357345260792
STAT,1839,31,50-100,1870,1.0584989404489675
SIM,1894,47,na,1941,1388
SIM,1867,26,25-29,1893,41
STAT,1942,17,20-24,1959,140.0631497589129
SIM,1928,38,45-49,1966,2
STAT,1854,33,15-19,1887,0.08024869154966999
STAT,1861,36,25-29,1897,2.4059887402506313
STAT,1906,23,45-49,1929,1.0066512233613234
SIM,1918,45,na,1963,4367
STAT,1906,47,na,1953,3243.344326251269
STAT,1929,36,45-49,1965,0.8698707891774662
STAT,1844,52,na,1896,2121.7636312424265
SIM,1833,79,na,1912,1615
STAT,1837,34,25-29,1871,10.08549995574841
SIM,1867,14,na,1881,2743
STAT,1845,33,20-24,1878,1.5783415402317182
STAT,1787,80,na,1867,117.83115112534591
STAT,1880,90,na,1970,263.2596528727763
STAT,1802,98,na,1900,1.6459291527645257
STAT,1850,37,50-100,1887,0.575902100593713
STAT,1867,105,na,1972,0.39983283552580307
STAT,1832,27,50-100,1859,0.7766973830041813
STAT,1872,47,40-44,1919,0.17063353388538532
STAT,1857,20,35-39,1877,5.244545123432073
STAT,1813,51,40-44,1864,0.037339984025461445
STAT,1834,33,45-49,1867,0.9742576595236815
STAT,1885,15,15-19,1900,5.860465536165686
SIM,1902,45,50-100,1947,4
STAT,1842,95,na,1937,3.3005438666152194
STAT,1859,26,25-29,1885,34.353172520828664
STAT,1840,15,40-44,1855,0.09435309670992431
SIM,1901,34,na,1935,3710
STAT,1921,14,na,1935,4448.473105393466
STAT,1856,25,45-49,1881,0.8383667260196843
STAT,1828,36,25-29,1864,3.9548168621094586
SIM,1863,45,na,1908,621
SIM,1882,27,20-24,1909,35
STAT,1776,97,na,1873,1.767194324804913
STAT,1926,23,15-19,1949,6.391778613196479
STAT,1838,36,35-39,1874,3.6812672672667133
STAT,1843,45,20-24,1888,0.01210755785805054
SIM,1869,39,40-44,1908,9
STAT,1826,41,50-100,1867,1.6154951387432241
STAT,1835,46,25-29,1881,0.046530286477155555
STAT,1819,107,na,1926,0.0010968948345243406
STAT,1868,49,40-44,1917,0.1619045608183261
SIM,1854,35,30-34,1889,5
STAT,1836,20,15-19,1856,5.243855871410932
STAT,1813,50,na,1863,2175.6208336736704
STAT,1864,105,na,1969,0.2683865801679434
SIM,1841,54,na,1895,77
STAT,1791,64,na,1855,1058.7766000000004
STAT,1831,46,40-44,1877,0.16353348480718238
SIM,1833,25,na,1858,2439
SIM,1878,37,40-44,1915,4
STAT,1927,42,20-24,1969,0.021968293851818987
SIM,1862,26,25-29,1888,183
STAT,1867,69,na,1936,1387.8998988315902
STAT,1900,24,50-100,1924,0.5613696988332121
SIM,1878,31,na,1909,4262
STAT,1864,16,40-44,1880,0.1901432514385985
SIM,1803,59,na,1862,1154
STAT,1906,30,35-39,1936,8.48816458707908
SIM,1831,44,na,1875,2099
STAT,1961,11,na,1972,5029.051345331058
STAT,1814,49,45-49,1863,0.7852421089068192
STAT,1836,23,na,1859,2143.8803666649496
STAT,1868,36,50-100,1904,1.1915484734807469
SIM,1830,26,45-49,1856,3
STAT,1846,28,50-100,1874,0.4550418810925824
SIM,1929,33,35-39,1962,3
STAT,1865,68,na,1933,1395.2307104510135
STAT,1860,23,45-49,1883,0.582212642773246
STAT,1887,29,40-44,1916,3.2735716162437853
STAT,1923,26,15-19,1949,0.8047367953975446
STAT,1927,39,na,1966,4629.569126852755
SIM,1911,44,na,1955,2353
SIM,1886,18,na,1904,3155
STAT,1875,30,50-100,1905,0.948411460271116
STAT,1864,48,45-49,1912,0.2118532354415697
STAT,1901,38,30-34,1939,1.6004486184582036
SIM,1901,68,na,1969,2474
STAT,1863,24,40-44,1887,1.7884646202485104
STAT,1823,60,na,1883,1625.761721113383
STAT,1888,20,50-100,1908,0.47346509511916046
SIM,1851,38,30-34,1889,1
SIM,1854,41,na,1895,1609
STAT,1854,26,25-29,1880,27.291537922390408
STAT,1864,26,35-39,1890,8.802003051343194
STAT,1937,35,40-44,1972,1.4840110874175156
STAT,1871,23,20-24,1894,68.53080269156081
STAT,1853,38,40-44,1891,3.3774306454138343
SIM,1818,58,na,1876,672
STAT,1806,57,na,1863,928.2812556191232
STAT,1843,38,30-34,1881,5.536370689259659
STAT,1819,49,45-49,1868,0.041975953151498956
STAT,1866,29,20-24,1895,10.632151291894191
SIM,1881,21,30-34,1902,107
SIM,1861,38,40-44,1899,2
STAT,1796,63,na,1859,1548.7184000450486
STAT,1809,49,35-39,1858,1.1778645559342307
SIM,1817,49,35-39,1866,1
SIM,1827,49,45-49,1876,1
SIM,1937,28,na,1965,2958
STAT,1859,33,15-19,1892,0.11239495426957712
STAT,1934,18,25-29,1952,58.06582227360154
STAT,1929,25,40-44,1954,5.814511419808585
STAT,1862,36,25-29,1898,2.4641335529079154
STAT,1901,48,na,1949,3106.8124698729744
SIM,1942,18,25-29,1960,8
SIM,1844,41,na,1885,2767
STAT,1917,23,20-24,1940,116.2413478121022
STAT,1860,30,35-39,1890,8.327988907615465
STAT,1888,5,na,1893,3024.645852531395
STAT,1837,41,15-19,1878,0.013234799649372322
STAT,1880,19,45-49,1899,0.06745117220006148
SIM,1952,6,na,1958,6372
SIM,1867,15,20-24,1882,5
STAT,1840,39,45-49,1879,0.9093157356742573
STAT,1922,24,40-44,1946,3.7889728270365084
STAT,1854,52,40-44,1906,0.005822397738069418
STAT,1872,26,40-44,1898,3.0099306120181812
STAT,1862,28,25-29,1890,35.90303044913266
STAT,1878,35,25-29,1913,2.9904508758440937
STAT,1836,25,50-100,1861,0.643485402883993
STAT,1931,28,15-19,1959,0.9045763340109115
STAT,1898,21,35-39,1919,7.870759036190337
STAT,1862,61,na,1923,1591.5935761533974
STAT,1926,16,25-29,1942,52.80493179069726
STAT,1854,37,30-34,1891,2.963339468784042
STAT,1876,18,25-29,1894,5.713532525249659
STAT,1899,20,25-29,1919,78.65643410096408
SIM,1923,28,30-34,1951,322
STAT,1919,43,25-29,1962,0.07623659626850819
STAT,1888,32,30-34,1920,20.151372071291163
STAT,1906,15,45-49,1921,0.0950311369383314
STAT,1871,26,40-44,1897,2.9984604183499672
STAT,1908,28,25-29,1936,61.52301112057756
STAT,1839,39,20-24,1878,0.8382414273191071
STAT,1929,40,30-34,1969,0.16486049877783313
STAT,1922,23,30-34,1945,32.49125313932565
STAT,1959,0,na,1959,5134.911833205334
SIM,1886,38,45-49,1924,6
SIM,1829,41,30-34,1870,9
STAT,1830,28,45-49,1858,1.0599599592059836
STAT,1872,25,30-34,1897,25.387211437587993
SIM,1903,15,na,1918,2994
STAT,1856,46,45-49,1902,0.16998910317265925
STAT,1819,38,40-44,1857,1.0722486631177
STAT,1838,29,45-49,1867,0.5942814927441562
STAT,1844,15,25-29,1859,7.221126550147599
SIM,1891,36,45-49,1927,5
STAT,1832,95,na,1927,11.286242261653445
STAT,1849,44,45-49,1893,1.2440349596511013
SIM,1873,55,na,1928,1829
STAT,1793,102,na,1895,0.04874385101809411
STAT,1855,68,na,1923,1011.4168726165188
STAT,1859,15,20-24,1874,16.504703747616936
STAT,1878,16,35-39,1894,0.5659364991272489
STAT,1890,16,35-39,1906,0.6659027382556297
STAT,1886,29,40-44,1915,3.0798855182710323
STAT,1904,24,25-29,1928,81.27457442433678
STAT,1825,30,50-100,1855,1.7992702963692058
STAT,1811,48,na,1859,1800.4142736609815
STAT,1864,38,50-100,1902,1.110612402054054
STAT,1868,46,20-24,1914,0.011623358176981551
STAT,1916,27,20-24,1943,18.61648246766607
SIM,1890,36,45-49,1926,19
STAT,1825,49,20-24,1874,0.014846103659821974
STAT,1914,21,30-34,1935,27.869318161230513
STAT,1857,70,na,1927,1076.6650186666304
STAT,1882,15,45-49,1897,0.06283100839444998
SIM,1887,0,na,1887,5050
SIM,1877,14,na,1891,213
SIM,1801,78,na,1879,1570
STAT,1870,90,na,1960,135.618788587799
SIM,1901,36,30-34,1937,4
STAT,1867,25,20-24,1892,11.170056842561396
STAT,1871,33,15-19,1904,0.14145838355919024
STAT,1937,25,50-100,1962,0.9610648460358748
STAT,1861,29,35-39,1890,7.967111039217074
STAT,1846,35,30-34,1881,3.365443984297508
STAT,1898,47,45-49,1945,0.17817904245125996
STAT,1915,28,30-34,1943,39.26213678497118
SIM,1912,24,25-29,1936,93
STAT,1845,36,40-44,1881,2.30612384156054
STAT,1854,52,na,1906,1190.8259960361863
STAT,1864,27,45-49,1891,1.0093833981995866
SIM,1887,14,na,1901,3965
STAT,1874,27,20-24,1901,12.107638011306113
SIM,1820,34,20-24,1854,2
STAT,1872,16,na,1888,2552.3924784886785
STAT,1897,15,na,1912,3369.719925526718
STAT,1896,30,15-19,1926,0.1892348400065771
STAT,1933,27,50-100,1960,1.3126510618655933
SIM,1859,24,25-29,1883,2
STAT,1880,42,40-44,1922,2.332220842416014
STAT,1810,49,25-29,1859,2.94531957915459E-4
SIM,1916,28,25-29,1944,1
SIM,1884,39,25-29,1923,2
STAT,1870,52,25-29,1922,0.0035123518777562686
STAT,1877,21,15-19,1898,3.3590170610680774
SIM,1933,12,na,1945,4529
STAT,1906,22,35-39,1928,8.45019171764098
STAT,1896,50,na,1946,2879.234732315961
STAT,1828,47,30-34,1875,0.11557497055002618
STAT,1846,28,40-44,1874,2.1308789294796395
STAT,1878,38,45-49,1916,2.0408639918108924
STAT,1835,39,35-39,1874,6.480107624885012
SIM,1840,27,na,1867,2787
STAT,1856,24,35-39,1880,4.798214376113122
STAT,1954,3,na,1957,4820.021871571332
SIM,1956,1,na,1957,4927
STAT,1819,43,20-24,1862,0.033330241660458615
STAT,1939,22,45-49,1961,1.1175726403086055
SIM,1894,34,20-24,1928,4
STAT,1827,48,40-44,1875,0.1547319014685031
STAT,1886,34,20-24,1920,2.7751875240963395
STAT,1885,34,na,1919,2325.5406319211243
STAT,1836,38,25-29,1874,2.680091819966046
STAT,1842,19,25-29,1861,1.7852142260544284
SIM,1839,43,50-100,1882,12
STAT,1879,37,35-39,1916,7.255684653116474
SIM,1837,32,25-29,1869,75
SIM,1852,91,na,1943,906
SIM,1902,30,na,1932,3438
STAT,1912,31,na,1943,3693.3164121658942
STAT,1884,49,25-29,1933,0.05398763165980175
SIM,1943,2,na,1945,4986
STAT,1928,15,na,1943,4623.979701723276
STAT,1880,16,25-29,1896,5.897387967675449
STAT,1910,21,45-49,1931,1.0479752131776026
SIM,1852,15,25-29,1867,64
STAT,1811,102,na,1913,0.17761445712615673
STAT,1893,40,50-100,1933,1.3344530768697307
STAT,1851,48,50-100,1899,0.19153577758485635
STAT,1871,29,45-49,1900,1.09965975395624
STAT,1847,94,na,1941,18.069751757751526
STAT,1829,32,25-29,1861,5.647192619954869
STAT,1856,17,45-49,1873,0.055477614947314347
STAT,1896,23,25-29,1919,75.22962409964772
STAT,1816,88,na,1904,115.89843922061578
STAT,1851,47,20-24,1898,0.009433326598612804
STAT,1908,35,15-19,1943,0.018009824112911722
SIM,1866,102,na,1968,4
STAT,1842,35,45-49,1877,0.5927042760173838
STAT,1865,29,20-24,1894,10.634158796149766
SIM,1864,72,na,1936,702
STAT,1882,18,15-19,1900,5.666913481761806
STAT,1839,22,40-44,1861,2.4875254408830005
STAT,1919,47,40-44,1966,0.16873578370107606
SIM,1819,48,40-44,1867,1
STAT,1893,36,20-24,1929,0.9686076079363862
STAT,1875,26,45-49,1901,1.1440298125090138
STAT,1855,22,25-29,1877,44.261690155984766
STAT,1837,45,30-34,1882,0.08266209785068926
SIM,1876,18,na,1894,3982
STAT,1936,32,20-24,1968,2.345676650012751
STAT,1857,53,50-100,1910,0.011403189232664568
SIM,1875,39,30-34,1914,13
STAT,1822,95,na,1917,7.666876294117942
STAT,1932,28,50-100,1960,1.294010292534248
STAT,1887,25,40-44,1912,3.319505729836014
STAT,1916,20,35-39,1936,9.790082652332908
SIM,1913,15,na,1928,3593
STAT,1905,34,35-39,1939,8.29217142096977
STAT,1897,29,15-19,1926,0.5982340680049678
STAT,1908,47,30-34,1955,0.07999707623592964
STAT,1899,42,35-39,1941,0.1715417443528927
SIM,1913,34,35-39,1947,13
STAT,1895,24,20-24,1919,89.08516490707831
STAT,1901,16,20-24,1917,24.849182360442505
STAT,1867,70,na,1937,1326.9294562759183
SIM,1886,39,40-44,1925,16
STAT,1910,28,30-34,1938,37.281627462776555
STAT,1914,12,na,1926,4028.4633859783494
SIM,1894,3,na,1897,1821
STAT,1855,36,35-39,1891,4.703647864510704
STAT,1878,39,40-44,1917,4.458548428165765
SIM,1951,7,na,1958,2373
STAT,1919,21,15-19,1940,5.768920832508571
SIM,1856,53,na,1909,258
STAT,1818,80,na,1898,376.5125129040628
SIM,1895,25,40-44,1920,175
SIM,1904,22,25-29,1926,737
STAT,1826,45,20-24,1871,0.01763578643130332
STAT,1926,38,35-39,1964,2.9277253226888647
STAT,1851,18,20-24,1869,16.92343207560894
STAT,1905,20,25-29,1925,82.82881149910088
STAT,1877,15,na,1892,2575.7059353445825
STAT,1919,21,30-34,1940,31.147894146454007
STAT,1858,48,20-24,1906,0.009048826311370469
STAT,1943,23,15-19,1966,5.597001121668241
STAT,1860,16,20-24,1876,16.779069399453483
STAT,1811,58,na,1869,1501.4284617503322
STAT,1817,42,50-100,1859,0.7753675869345366
STAT,1880,16,40-44,1896,0.19034797685576138
STAT,1825,32,40-44,1857,7.516283400782094
STAT,1884,38,20-24,1922,0.7342523170609498
SIM,1863,22,25-29,1885,20
SIM,1887,45,na,1932,3572
STAT,1884,24,45-49,1908,0.6633478605178625
STAT,1830,51,40-44,1881,0.008073998032690682
STAT,1859,41,na,1900,1840.1603576434857
SIM,1907,49,30-34,1956,1
SIM,1934,8,na,1942,5336
STAT,1829,39,45-49,1868,0.9780978328517788
STAT,1881,23,30-34,1904,16.769012913986504
SIM,1921,34,na,1955,5019
STAT,1907,18,30-34,1925,2.319516809102833
STAT,1846,31,15-19,1877,0.10071214810831682
STAT,1873,38,45-49,1911,2.034735448120726
STAT,1815,45,45-49,1860,0.024565742971227447
STAT,1843,19,25-29,1862,7.071073748096626
SIM,1832,40,na,1872,1980
STAT,1858,37,15-19,1895,0.042883234054246634
STAT,1867,60,na,1927,1803.6771523546138
STAT,1859,0,na,1859,3095.884830597258
SIM,1822,32,30-34,1854,4
STAT,1882,36,45-49,1918,1.9177707462262772
SIM,1815,39,25-29,1854,2
STAT,1926,44,na,1970,4524.149063788988
SIM,1885,9,na,1894,1887
SIM,1915,27,na,1942,3425
SIM,1918,49,40-44,1967,2
STAT,1869,48,30-34,1917,0.09645178477838104
STAT,1818,39,35-39,1857,15.301782912573302
STAT,1892,23,40-44,1915,2.571978818849317
SIM,1881,38,45-49,1919,3
STAT,1799,61,na,1860,188.47543618958898
STAT,1867,28,25-29,1895,39.864905267089426
STAT,1846,23,na,1869,1551.2569756774253
SIM,1849,19,na,1868,2569
STAT,1951,11,na,1962,4634.813108500759
STAT,1917,26,25-29,1943,68.33908652482795
STAT,1835,24,15-19,1859,3.2705416247249532
STAT,1885,37,25-29,1922,2.8301050207167435
STAT,1889,20,30-34,1909,21.57797982296609
STAT,1940,18,15-19,1958,45.547878947386955
STAT,1817,47,20-24,1864,0.008406762251148722
STAT,1869,34,20-24,1903,2.7042549202656265
STAT,1814,46,40-44,1860,0.5931693009185266
STAT,1879,30,15-19,1909,0.14726173768709627
STAT,1854,42,na,1896,1283.5080109791656
SIM,1845,38,40-44,1883,2
STAT,1925,31,50-100,1956,0.9733953468466182
STAT,1849,37,20-24,1886,0.6646215337850274
SIM,1891,71,na,1962,675
SIM,1929,30,30-34,1959,626
STAT,1914,25,45-49,1939,1.7290383943420446
SIM,1854,31,15-19,1885,3
STAT,1881,37,40-44,1918,4.133884999111304
STAT,1927,16,40-44,1943,1.729205033331017
STAT,1843,30,35-39,1873,12.28155278755088
STAT,1899,38,15-19,1937,0.016472839373890248
STAT,1877,18,40-44,1895,0.18518216441678842
SIM,1912,21,20-24,1933,637
STAT,1841,17,15-19,1858,8.523240051137217
SIM,1833,42,50-100,1875,6
SIM,1836,43,na,1879,1882
SIM,1833,28,20-24,1861,15
STAT,1869,23,30-34,1892,17.918512384548215
SIM,1877,4,na,1881,515
SIM,1925,26,25-29,1951,1
SIM,1869,35,40-44,1904,103
STAT,1940,22,35-39,1962,9.48432299098107
STAT,1852,30,na,1882,2539.206256996627
STAT,1841,35,45-49,1876,2.6703358002853728
SIM,1886,27,40-44,1913,31
STAT,1930,26,40-44,1956,5.887756925879809
SIM,1950,14,na,1964,4854
STAT,1821,49,35-39,1870,0.1457691941383504
STAT,1917,33,15-19,1950,0.1322078716419907
STAT,1818,46,25-29,1864,0.1043061985495922
SIM,1896,18,na,1914,3972
STAT,1887,25,25-29,1912,46.87591839449377
STAT,1925,32,45-49,1957,1.8515166525642415
STAT,1939,29,30-34,1968,38.91884213318407
STAT,1848,42,50-100,1890,0.9873836639736178
SIM,1895,25,25-29,1920,24
STAT,1855,29,45-49,1884,0.7549876946468536
SIM,1861,20,na,1881,2534
SIM,1836,53,na,1889,1555
SIM,1878,44,30-34,1922,8
SIM,1864,39,20-24,1903,5
STAT,1843,23,45-49,1866,0.8586076822942176
STAT,1878,27,40-44,1905,3.0820435297241864
STAT,1892,19,20-24,1911,21.831874235719486
SIM,1857,37,20-24,1894,10
SIM,1940,14,na,1954,4298
STAT,1856,23,na,1879,1770.786474607958
STAT,1929,39,15-19,1968,0.02442899026157913
STAT,1852,35,20-24,1887,0.7965082712749876
STAT,1913,29,45-49,1942,1.6876609382442005
STAT,1911,27,35-39,1938,14.476513469874734
SIM,1815,61,na,1876,642
STAT,1912,9,na,1921,3965.661426789137
SIM,1885,23,na,1908,1803
SIM,1910,15,25-29,1925,16
STAT,1888,35,35-39,1923,8.240837164790971
STAT,1937,29,na,1966,3610.3905151314625
STAT,1925,39,30-34,1964,2.162859756163448
STAT,1801,58,na,1859,912.027229614979
SIM,1818,44,25-29,1862,13
STAT,1835,108,na,1943,0.0013859830370444135
STAT,1857,27,20-24,1884,9.272471272680468
STAT,1904,4,na,1908,3758.452883976211
STAT,1925,25,20-24,1950,21.507671596004457
STAT,1929,43,35-39,1972,0.258539741409938
STAT,1843,26,15-19,1869,0.5556763842731233
STAT,1840,36,40-44,1876,2.0599495283069267
STAT,1940,15,45-49,1955,0.5017788379228196
STAT,1877,35,25-29,1912,2.950489177078277
STAT,1804,76,na,1880,731.0117771239075
STAT,1848,15,45-49,1863,0.07667673146072694
STAT,1862,25,20-24,1887,10.17457651680218
STAT,1931,14,na,1945,5133.101309261558
STAT,1882,29,20-24,1911,11.151535965078974
STAT,1900,38,15-19,1938,0.016707028849149
SIM,1825,29,25-29,1854,3
STAT,1840,22,30-34,1862,8.919299294543102
STAT,1873,49,50-100,1922,0.24667133820189555
STAT,1868,49,25-29,1917,0.054472562094250956
STAT,1888,49,45-49,1937,0.15043846774732997
STAT,1961,6,na,1967,5032.170518709937
STAT,1897,47,45-49,1944,0.1759708987991167
SIM,1933,25,20-24,1958,46
STAT,1846,24,40-44,1870,1.5009923697077292
STAT,1921,21,20-24,1942,124.47838238911619
SIM,1822,40,na,1862,1538
SIM,1848,43,40-44,1891,18
STAT,1878,46,30-34,1924,0.09987730915453577
STAT,1852,17,25-29,1869,6.898844929445055
STAT,1904,21,20-24,1925,98.75224411057968
SIM,1896,49,50-100,1945,2
STAT,1893,29,30-34,1922,31.26559646403843
STAT,1872,17,45-49,1889,0.06562647929610865
STAT,1934,37,30-34,1971,2.498066562388358
SIM,1823,38,20-24,1861,1
SIM,1878,85,na,1963,570
STAT,1905,27,45-49,1932,1.5969717828042922
SIM,1851,30,35-39,1881,1
SIM,1905,27,na,1932,3452
STAT,1867,46,20-24,1913,0.011380982427595982
STAT,1934,32,na,1966,5128.8259830631605
SIM,1851,19,25-29,1870,1
SIM,1865,27,20-24,1892,157
SIM,1875,46,20-24,1921,1
STAT,1826,38,30-34,1864,8.491034229289877
STAT,1941,11,na,1952,4017.5575531307304
SIM,1837,43,30-34,1880,3
STAT,1833,38,50-100,1871,0.6561621039833402
STAT,1906,26,15-19,1932,0.6592482953435755
STAT,1951,18,25-29,1969,51.107072662372175
SIM,1932,29,na,1961,5909
SIM,1860,17,25-29,1877,20
STAT,1836,35,20-24,1871,0.7402463902870562
STAT,1909,31,15-19,1940,0.1218761932932281
SIM,1834,38,30-34,1872,3
STAT,1895,24,50-100,1919,0.5271624022052493
SIM,1893,52,na,1945,2792
STAT,1857,39,20-24,1896,0.5855663165154755
STAT,1859,47,25-29,1906,0.045440496202337116
STAT,1797,89,na,1886,1.5734736322635041
STAT,1893,21,35-39,1914,7.3194617404250755
STAT,1931,17,45-49,1948,0.6492544462260244
STAT,1832,23,35-39,1855,7.63865010268126
SIM,1848,39,20-24,1887,13
STAT,1919,15,50-100,1934,0.08234319415390592
STAT,1932,16,50-100,1948,0.4938588401553576
STAT,1808,90,na,1898,18.46475522032405
STAT,1856,28,15-19,1884,0.33525497750249483
SIM,1881,20,na,1901,2385
STAT,1831,24,30-34,1855,28.798972597431156
STAT,1918,25,na,1943,3959.644194939019
STAT,1821,58,na,1879,1078.54812175983
STAT,1867,21,40-44,1888,1.9931500194300602
STAT,1846,24,25-29,1870,41.23469709961959
STAT,1896,48,40-44,1944,0.1257031692900181
SIM,1899,29,25-29,1928,10
STAT,1866,52,50-100,1918,0.013712682050393598
STAT,1829,43,30-34,1872,0.5450956110293268
STAT,1859,82,na,1941,369.80978994393075
STAT,1887,15,na,1902,2792.782620317236
SIM,1851,26,15-19,1877,4
STAT,1902,22,15-19,1924,4.645555092474264
STAT,1880,89,na,1969,311.28096777077354
SIM,1857,38,na,1895,1389
SIM,1885,33,na,1918,1659
STAT,1832,37,45-49,1869,0.15204776255609231
SIM,1890,29,20-24,1919,4
STAT,1896,34,30-34,1930,22.81884639689892
SIM,1834,30,35-39,1864,25
STAT,1840,38,na,1878,987.1678433359717
STAT,1902,15,25-29,1917,8.01673744029563
STAT,1830,83,na,1913,287.32820095493753
STAT,1921,28,40-44,1949,5.115093892087899
SIM,1885,28,35-39,1913,8
STAT,1822,34,30-34,1856,38.98846489442267
STAT,1902,29,35-39,1931,13.490128676418186
SIM,1872,15,na,1887,2546
STAT,1927,23,15-19,1950,6.484928072209411
SIM,1908,45,na,1953,2224
SIM,1825,40,35-39,1865,1
STAT,1851,22,40-44,1873,1.9653784338795277
STAT,1837,36,50-100,1873,1.2110813261011981
STAT,1857,49,15-19,1906,3.0053554785271436E-4
STAT,1914,18,20-24,1932,27.582331415193863
STAT,1898,28,20-24,1926,15.719949887161816
SIM,1818,37,35-39,1855,5
STAT,1863,24,25-29,1887,49.132026503035014
STAT,1872,21,15-19,1893,3.313482943327237
SIM,1871,24,25-29,1895,5
STAT,1884,31,35-39,1915,9.733978048335363
STAT,1889,16,45-49,1905,0.07885619218137083
STAT,1918,15,na,1933,4180.119917912228
SIM,1862,60,na,1922,3085
STAT,1822,48,40-44,1870,0.2823370501623052
STAT,1867,39,30-34,1906,4.989613132931071
STAT,1916,49,30-34,1965,0.08965914137665222
STAT,1931,24,35-39,1955,12.05049600875076
STAT,1817,40,35-39,1857,1.3746154729221811
STAT,1876,36,20-24,1912,0.7830079398368783
STAT,1922,27,45-49,1949,1.9330903134244213
STAT,1898,21,na,1919,3189.922245980503
STAT,1925,35,15-19,1960,0.022876932685526565
STAT,1816,48,15-19,1864,0.001199269966440358
SIM,1814,44,40-44,1858,7
STAT,1826,48,25-29,1874,0.08134252777244846
STAT,1873,35,40-44,1908,4.532998616408352
STAT,1877,28,35-39,1905,9.760345818921687
STAT,1838,22,25-29,1860,31.70455884851458
STAT,1834,76,na,1910,417.52577974192866
STAT,1884,27,15-19,1911,0.4343169179875253
SIM,1859,71,na,1930,581
SIM,1814,65,na,1879,2293
SIM,1907,38,25-29,1945,3
STAT,1909,11,na,1920,3839.198217064127
STAT,1865,49,50-100,1914,0.21954884199665073
STAT,1827,48,25-29,1875,0.052059330929919725
STAT,1850,38,na,1888,1093.7114600500695
STAT,1825,35,45-49,1860,3.021048421104967
STAT,1936,35,25-29,1971,0.95867499150535
STAT,1863,49,40-44,1912,0.143103928594223
STAT,1828,90,na,1918,53.3695619918824
STAT,1848,19,50-100,1867,0.05616459416204899
STAT,1830,29,40-44,1859,2.8392066547954866
STAT,1866,33,40-44,1899,3.941930537470429
STAT,1877,36,20-24,1913,0.786270627034778
STAT,1882,0,na,1882,3410.4408208635004
STAT,1887,28,45-49,1915,1.2177791533225621
SIM,1881,35,40-44,1916,2
STAT,1935,21,15-19,1956,7.199065022231844
STAT,1892,26,45-49,1918,1.3793769149458122
SIM,1822,35,35-39,1857,3
SIM,1837,38,na,1875,1939
SIM,1838,31,30-34,1869,22
STAT,1855,33,30-34,1888,11.644319004418358
STAT,1813,91,na,1904,42.44828506215245
STAT,1928,44,30-34,1972,0.16120249508491488
SIM,1838,24,na,1862,2317
STAT,1916,20,50-100,1936,0.6841428230745416
STAT,1938,30,30-34,1968,15.689946281743723
STAT,1894,39,25-29,1933,3.62450575494501
STAT,1847,34,35-39,1881,9.581768679251425
STAT,1883,39,15-19,1922,0.05347939544125316
STAT,1893,39,25-29,1932,3.5642785716500747
STAT,1843,16,20-24,1859,22.517615486916945
STAT,1913,22,25-29,1935,88.38364201597665
SIM,1864,21,30-34,1885,80
STAT,1869,26,35-39,1895,9.769972188792817
STAT,1923,22,35-39,1945,10.840560614566119
SIM,1854,21,20-24,1875,383
STAT,1814,76,na,1890,641.1881546460743
STAT,1923,17,50-100,1940,0.4353070593828254
STAT,1841,28,20-24,1869,16.10928615258229
STAT,1837,48,35-39,1885,0.11504478123762826
STAT,1842,16,20-24,1858,5.684959446914015
STAT,1910,17,25-29,1927,8.490653416466616
SIM,1850,16,20-24,1866,36
STAT,1920,17,35-39,1937,4.647288470086485
STAT,1869,37,40-44,1906,4.417258781588268
STAT,1836,34,25-29,1870,9.716927473463132
STAT,1897,69,na,1966,2225.164107222741
STAT,1845,47,30-34,1892,0.04780987067360431
STAT,1876,74,na,1950,1121.894183239452
STAT,1938,25,na,1963,3674.7866430848053
STAT,1857,49,na,1906,1690.3942470865343
STAT,1934,22,45-49,1956,1.5018619595663736
STAT,1945,9,na,1954,4251.836098758747
STAT,1856,21,30-34,1877,14.96618452111281
STAT,1849,47,15-19,1896,3.354651865340071E-4
STAT,1846,21,20-24,1867,50.72324435362873
STAT,1852,38,25-29,1890,2.883790222268535
STAT,1842,38,15-19,1880,0.016183817632479607
SIM,1925,37,30-34,1962,6
STAT,1886,84,na,1970,691.5800380250508
STAT,1897,15,40-44,1912,0.24403333229332075
STAT,1951,15,20-24,1966,160.02600693672633
STAT,1941,29,20-24,1970,18.649982951526308
STAT,1895,27,40-44,1922,3.8968466358276537
SIM,1793,65,na,1858,938
STAT,1908,32,45-49,1940,1.4738401455593615
STAT,1913,26,40-44,1939,4.601772961786488
STAT,1849,41,na,1890,1956.243520519056
STAT,1846,27,45-49,1873,0.7955202342700987
STAT,1836,27,35-39,1863,9.567261322336751
STAT,1861,75,na,1936,856.144885592827
STAT,1906,19,25-29,1925,8.161821153044329
SIM,1860,38,25-29,1898,35
STAT,1909,1,na,1910,4040.339941064553
SIM,1890,34,na,1924,3679
STAT,1852,28,30-34,1880,29.31164255888485
STAT,1923,26,na,1949,4270.348278395723
STAT,1862,28,40-44,1890,2.5424635799428335
SIM,1895,22,20-24,1917,646
SIM,1855,34,35-39,1889,5
STAT,1828,36,40-44,1864,6.012864305286224
STAT,1862,24,25-29,1886,49.19928326459629
STAT,1935,18,40-44,1953,1.8933963261937294
SIM,1865,67,na,1932,1523
STAT,1921,33,50-100,1954,0.9053486424763845
STAT,1899,47,na,1946,3059.2262052955057
STAT,1905,31,30-34,1936,14.47862402171017
STAT,1907,37,20-24,1944,0.24276593706473212
STAT,1932,16,15-19,1948,59.82277960964241
SIM,1810,62,na,1872,3098
STAT,1917,37,30-34,1954,1.867774704481731
STAT,1871,85,na,1956,298.62825857574467
STAT,1876,15,20-24,1891,18.005182626079215
SIM,1836,36,40-44,1872,6
STAT,1830,43,50-100,1873,0.92204266088915
SIM,1874,36,45-49,1910,1
STAT,1887,22,20-24,1909,75.85013441251843
SIM,1846,53,na,1899,900
STAT,1946,21,25-29,1967,101.71225272558652
STAT,1897,22,30-34,1919,23.655637160423137
STAT,1834,42,na,1876,1116.9955100568732
STAT,1899,28,20-24,1927,15.967202526294887
STAT,1824,35,45-49,1859,0.30874766604066417
STAT,1860,19,25-29,1879,5.269032025922196
STAT,1819,75,na,1894,239.44501816485342
STAT,1870,19,35-39,1889,0.5457511034135197
STAT,1870,38,na,1908,2337.1018896467435
STAT,1881,26,35-39,1907,9.143213805205999
STAT,1927,29,na,1956,4498.949141525985
SIM,1850,68,na,1918,719
STAT,1855,46,50-100,1901,0.1630085384679083
STAT,1888,28,45-49,1916,1.2769607820983317
SIM,1935,23,30-34,1958,74
STAT,1891,26,45-49,1917,1.3700572650917653
STAT,1881,23,50-100,1904,0.38390601494121995
STAT,1927,23,30-34,1950,35.01380223529817
STAT,1875,48,20-24,1923,0.01216739794685083
STAT,1844,42,na,1886,2345.054864019906
SIM,1808,58,na,1866,1261
STAT,1866,36,45-49,1902,1.8284502494452746
SIM,1894,37,na,1931,1441
STAT,1844,29,35-39,1873,11.53449875227496
STAT,1884,17,20-24,1901,16.971033759764964
STAT,1877,70,na,1947,1424.2891751900704
SIM,1940,16,15-19,1956,240
STAT,1848,89,na,1937,98.30641247909527
STAT,1907,30,na,1937,3539.7023149262736
STAT,1855,5,na,1860,1979.4248622818327
STAT,1915,39,20-24,1954,0.2598952140687406
SIM,1887,23,25-29,1910,1
SIM,1862,26,40-44,1888,5
SIM,1938,31,35-39,1969,3
SIM,1832,39,na,1871,2113
STAT,1878,55,na,1933,2127.4068686295145
STAT,1905,24,40-44,1929,2.978422147483202
STAT,1873,17,45-49,1890,0.06700649454469278
STAT,1935,25,30-34,1960,53.07286153809462
STAT,1858,41,35-39,1899,1.3891109221969877
STAT,1860,37,20-24,1897,0.6288524856421659
STAT,1827,94,na,1921,14.094013237822818
SIM,1855,2,na,1857,3430
STAT,1854,23,20-24,1877,44.697369061049635
SIM,1831,54,na,1885,2133
STAT,1833,29,25-29,1862,24.689773527565336
STAT,1881,19,45-49,1900,0.06135634597335659
SIM,1884,7,na,1891,3855
STAT,1830,36,30-34,1866,4.912008272507873
STAT,1883,17,20-24,1900,17.055613006393017
STAT,1914,28,15-19,1942,0.6993046666725666
STAT,1798,75,na,1873,628.6652809902151
STAT,1919,17,45-49,1936,0.5447022853312946
STAT,1878,49,35-39,1927,0.14103421202927086
SIM,1875,49,25-29,1924,3
SIM,1855,48,45-49,1903,1
STAT,1887,32,15-19,1919,0.15674430850517837
STAT,1863,45,25-29,1908,0.049664069760055884
STAT,1850,49,50-100,1899,0.11104077700161959
STAT,1888,46,40-44,1934,0.19815382836568177
STAT,1904,12,na,1916,3689.6202862770347
STAT,1933,27,20-24,1960,24.072979874625574
STAT,1851,25,45-49,1876,1.0416430780748624
STAT,1931,21,30-34,1952,37.12653555852624
STAT,1879,23,25-29,1902,58.54336955116791
STAT,1837,38,40-44,1875,4.2293455497364265
STAT,1838,90,na,1928,33.62331352492888
SIM,1923,39,20-24,1962,2
STAT,1925,28,25-29,1953,76.758901299716
STAT,1870,26,25-29,1896,42.31641011767205
STAT,1863,56,na,1919,1741.2606376962408
SIM,1902,20,na,1922,3630
STAT,1928,25,na,1953,4611.20078875132
STAT,1862,17,35-39,1879,0.5352655300261492
STAT,1870,89,na,1959,160.35707446560843
STAT,1930,29,45-49,1959,2.1791509262799393
STAT,1856,39,20-24,1895,0.548092562050903
SIM,1880,34,na,1914,3290
STAT,1799,108,na,1907,1.2180727182167932E-4
SIM,1883,52,na,1935,1967
STAT,1869,41,na,1910,2342.7829597112227
SIM,1847,38,na,1885,1502
SIM,1871,19,na,1890,1984
STAT,1844,44,50-100,1888,1.0447914541971208
STAT,1836,38,40-44,1874,4.0747850029565855
SIM,1878,6,na,1884,4386
STAT,1823,91,na,1914,45.777441558908315
STAT,1840,25,35-39,1865,4.805950504995794
STAT,1876,30,na,1906,2431.731748986574
STAT,1871,26,25-29,1897,42.34232362257025
STAT,1899,35,45-49,1934,2.7486974152873436
STAT,1928,40,15-19,1968,0.0019482235468617024
STAT,1861,6,na,1867,2384.685302907867
STAT,1866,3,na,1869,2908.950218360133
SIM,1923,15,na,1938,4291
SIM,1911,34,na,1945,2508
STAT,1919,11,na,1930,4326.930697116574
STAT,1902,26,30-34,1928,35.58184466103643
STAT,1865,36,45-49,1901,1.828795487352082
SIM,1840,34,40-44,1874,5
STAT,1847,27,45-49,1874,1.2065691054426462
STAT,1866,105,na,1971,0.3436350777661262
STAT,1820,102,na,1922,0.20161998580106175
SIM,1830,37,35-39,1867,6
STAT,1834,47,20-24,1881,0.00560866120668734
STAT,1862,71,na,1933,1136.9044424429244
STAT,1913,33,30-34,1946,15.413224946158673
STAT,1916,44,na,1960,3741.5379680683372
STAT,1938,23,40-44,1961,3.2910105862276553
STAT,1863,35,30-34,1898,4.593137282924229
STAT,1911,30,50-100,1941,0.8024313332235627
SIM,1895,33,na,1928,4400
SIM,1928,7,na,1935,4662
SIM,1948,21,na,1969,5761
SIM,1805,51,na,1856,2285
SIM,1850,5,na,1855,2608
STAT,1858,34,45-49,1892,1.3202933133036419
STAT,1909,35,30-34,1944,1.7237860242572491
STAT,1886,15,30-34,1901,1.6582002735368506
STAT,1886,48,30-34,1934,0.0989817149958245
STAT,1839,75,na,1914,956.4383138017007
SIM,1844,72,na,1916,1211
STAT,1821,44,50-100,1865,1.146972117953097
STAT,1928,33,25-29,1961,11.461930780207076
STAT,1893,22,na,1915,2957.55907412596
STAT,1840,83,na,1923,156.3154531234589
SIM,1936,33,25-29,1969,2
SIM,1926,33,na,1959,5854
STAT,1822,37,35-39,1859,14.268962353885247
STAT,1939,8,na,1947,3939.854506445812
STAT,1832,34,40-44,1866,0.29492471354266153
STAT,1855,47,40-44,1902,0.11277816361472812
STAT,1828,33,20-24,1861,3.9604841572849683
STAT,1912,15,35-39,1927,0.8425486734739899
STAT,1812,95,na,1907,1.0529345593453454
STAT,1902,19,40-44,1921,0.2561756245374354
SIM,1859,38,35-39,1897,12
STAT,1876,25,15-19,1901,0.4617631843915593
STAT,1941,27,50-100,1968,1.0179534970810846
SIM,1898,51,na,1949,4037
STAT,1844,36,25-29,1880,3.346870566578785
STAT,1863,28,40-44,1891,2.548347862939363
SIM,1900,6,na,1906,4181
SIM,1900,29,25-29,1929,151
STAT,1867,49,25-29,1916,0.05333667452565721
STAT,1924,18,30-34,1942,14.33773664015224
STAT,1822,44,25-29,1866,1.0949577747545665
SIM,1828,37,45-49,1865,10
STAT,1873,24,35-39,1897,5.948443671981478
STAT,1911,7,na,1918,3942.057225275992
STAT,1946,10,na,1956,4310.960419842187
STAT,1919,24,35-39,1943,10.10995419977007
STAT,1943,16,25-29,1959,45.44193705925261
STAT,1854,26,40-44,1880,1.9326430203883411
STAT,1824,76,na,1900,183.34507794145966
STAT,1896,37,35-39,1933,9.323727575373999
SIM,1951,16,25-29,1967,193
STAT,1853,38,25-29,1891,2.2214237655995186
STAT,1840,18,45-49,1858,0.03310559128257496
STAT,1871,52,40-44,1923,0.010445883265861329
STAT,1921,24,25-29,1945,102.44757113951414
SIM,1879,32,30-34,1911,9
STAT,1909,28,40-44,1937,4.39366901435206
STAT,1877,39,40-44,1916,4.398968392707441
STAT,1879,20,20-24,1899,71.11497774540382
STAT,1962,8,na,1970,4988.330198098227
STAT,1829,46,35-39,1875,0.06560203446822215
STAT,1843,29,20-24,1872,14.060929258927604
STAT,1881,27,45-49,1908,1.048512272414612
STAT,1820,47,25-29,1867,0.09050966210235133
STAT,1894,16,na,1910,3219.596609067172
STAT,1883,64,na,1947,1672.3758827394497
SIM,1823,56,na,1879,1119
SIM,1870,58,na,1928,1021
SIM,1856,11,na,1867,1291
STAT,1911,49,45-49,1960,0.20224466486473042
SIM,1871,28,35-39,1899,19
SIM,1862,38,40-44,1900,16
STAT,1853,51,20-24,1904,5.74911988718937E-4
STAT,1863,28,35-39,1891,8.208413171189084
STAT,1871,31,15-19,1902,0.14263840607386286
SIM,1844,39,30-34,1883,1
STAT,1854,22,25-29,1876,37.39862854004003
STAT,1856,30,35-39,1886,7.517363272639997
STAT,1963,7,na,1970,4945.793532567315
STAT,1879,59,na,1938,1993.682958245166
STAT,1946,9,na,1955,4311.434677656729
STAT,1824,52,35-39,1876,0.0014517194798626017
SIM,1858,33,15-19,1891,1
STAT,1827,50,50-100,1877,0.013905616251620642
STAT,1831,33,40-44,1864,4.545053837308564
SIM,1817,38,50-100,1855,7
STAT,1950,20,35-39,1970,11.071526655622106
STAT,1844,19,40-44,1863,0.2276309400399404
STAT,1903,18,na,1921,3575.733194537421
SIM,1862,22,25-29,1884,9
STAT,1845,40,30-34,1885,0.5960132933540474
STAT,1883,49,15-19,1932,3.7678226992718974E-4
STAT,1794,81,na,1875,2.5924983203852396
STAT,1862,19,na,1881,2215.6592872915003
SIM,1845,59,na,1904,1890
STAT,1858,65,na,1923,1290.5640392741575
STAT,1927,20,na,1947,4489.189884937285
STAT,1884,17,15-19,1901,5.680981647266635
STAT,1849,17,20-24,1866,18.38738839088126
STAT,1852,38,30-34,1890,5.338079802438024
STAT,1875,69,na,1944,1506.9501900068694
STAT,1868,45,30-34,1913,0.0944284171157587
STAT,1790,91,na,1881,25.56333279185199
SIM,1857,40,45-49,1897,2
STAT,1843,32,20-24,1875,3.2107458785167866
STAT,1826,35,25-29,1861,4.957470418377304
STAT,1862,70,na,1932,1195.0558606207292
STAT,1923,48,25-29,1971,0.061230354363923475
STAT,1796,96,na,1892,3.3627048584945616
STAT,1840,20,30-34,1860,9.04877319159939
SIM,1816,39,25-29,1855,3
STAT,1812,103,na,1915,0.011365611613743025
STAT,1845,48,40-44,1893,0.08388492302057925
STAT,1877,38,35-39,1915,7.144254364885599
STAT,1850,42,35-39,1892,0.8351349207710785
STAT,1803,83,na,1886,103.5986811122949
STAT,1874,26,45-49,1900,1.1498391198397802
SIM,1864,30,35-39,1894,7
STAT,1879,48,40-44,1927,0.17341706215381736
SIM,1833,36,20-24,1869,10
STAT,1828,67,na,1895,1073.0818476872857
STAT,1864,18,na,1882,2361.216702406426
STAT,1960,6,na,1966,5073.7550289820465
STAT,1894,35,30-34,1929,6.841768906526501
SIM,1840,36,na,1876,2622
SIM,1860,38,30-34,1898,63
STAT,1816,44,50-100,1860,3.293607596870244
STAT,1883,24,45-49,1907,0.6666538148332649
STAT,1944,23,15-19,1967,5.680940847659413
SIM,1870,34,na,1904,2100
STAT,1833,30,40-44,1863,2.525611601508053
STAT,1885,46,15-19,1931,3.9429572216149745E-4
SIM,1874,48,na,1922,2477
STAT,1893,26,25-29,1919,53.08063934345152
STAT,1859,39,25-29,1898,2.2590628069554683
SIM,1869,61,na,1930,3598
STAT,1938,25,40-44,1963,4.572251066013457
STAT,1827,44,30-34,1871,1.0620972610646326
STAT,1922,49,20-24,1971,0.012480443574937173
STAT,1837,95,na,1932,10.660809544996061
STAT,1849,40,45-49,1889,1.2830966637485162
STAT,1872,34,40-44,1906,4.305432954184556
SIM,1865,87,na,1952,254
STAT,1811,54,20-24,1865,0.003189482626782361
STAT,1923,46,na,1969,4263.055608230601
STAT,1845,24,25-29,1869,34.75994123462583
STAT,1828,32,25-29,1860,15.513520787621053
STAT,1867,26,50-100,1893,0.6070524423219615
STAT,1891,32,50-100,1923,1.1267334975291226
STAT,1843,16,15-19,1859,7.5376763803664515
SIM,1836,43,35-39,1879,10
STAT,1864,52,35-39,1916,0.007784883929541912
SIM,1835,44,30-34,1879,4
STAT,1880,53,30-34,1933,0.006080444596743582
STAT,1889,6,na,1895,3145.8660084205408
STAT,1911,45,na,1956,3454.9890552296943
STAT,1813,51,20-24,1864,0.0026172887016293915
SIM,1840,28,na,1868,1719
STAT,1895,34,35-39,1929,13.061230747967866
STAT,1841,19,15-19,1860,8.423131972430998
SIM,1874,37,20-24,1911,2
STAT,1846,47,45-49,1893,0.13912193225175964
STAT,1886,49,40-44,1935,0.1735845768394308
SIM,1858,49,30-34,1907,3
STAT,1845,39,na,1884,1203.0910233011343
STAT,1895,23,25-29,1918,74.23913072702354
STAT,1812,44,na,1856,249.86420359572136
SIM,1855,43,45-49,1898,5
SIM,1922,20,25-29,1942,68
STAT,1864,41,25-29,1905,0.5864304159413922
STAT,1877,16,50-100,1893,0.049854797210642544
STAT,1817,42,20-24,1859,0.11655852836240144
SIM,1910,48,na,1958,3876
STAT,1817,39,20-24,1856,0.5829468671671467
STAT,1792,101,na,1893,0.13813448084159546
STAT,1847,43,45-49,1890,1.3433629971272014
STAT,1866,106,na,1972,0.17845313223472697
SIM,1870,29,30-34,1899,15
STAT,1896,32,30-34,1928,23.01589933909322
STAT,1947,18,45-49,1965,0.5566088304219149
STAT,1854,75,na,1929,572.3991145102617
STAT,1858,89,na,1947,80.22562409137437
SIM,1881,10,na,1891,3267
SIM,1886,36,30-34,1922,3
STAT,1838,17,45-49,1855,0.036832845702733
STAT,1874,31,40-44,1905,4.494070736945883
SIM,1840,26,50-100,1866,11
STAT,1828,43,35-39,1871,2.2268594344519332
STAT,1845,90,na,1935,39.12203055415809
STAT,1880,40,25-29,1920,0.6733850052699283
STAT,1840,15,50-100,1855,0.025273144758645796
SIM,1838,40,35-39,1878,1
SIM,1869,39,35-39,1908,61
SIM,1844,18,na,1862,3028
STAT,1866,37,20-24,1903,0.7036452906319175
SIM,1886,41,na,1927,3001
STAT,1865,53,35-39,1918,0.007733793508052863
STAT,1837,18,40-44,1855,0.19431005053585343
SIM,1836,32,25-29,1868,47
STAT,1823,36,40-44,1859,8.260027750828947
STAT,1879,35,35-39,1914,7.324592769463454
STAT,1889,37,15-19,1926,0.0676227280090069
STAT,1949,15,45-49,1964,0.5755579941887711
STAT,1862,29,30-34,1891,21.295160943124213
STAT,1848,44,45-49,1892,1.3816134339570256
STAT,1882,50,30-34,1932,0.00578092944053533
STAT,1862,44,25-29,1906,0.539568671419848
SIM,1853,54,na,1907,3151
SIM,1860,42,45-49,1902,2
STAT,1807,73,na,1880,589.5699407390516
STAT,1821,80,na,1901,312.4017169975238
STAT,1829,41,30-34,1870,0.5612493111349218
STAT,1911,13,na,1924,3901.4316767047485
STAT,1897,31,35-39,1928,13.50423188107087
STAT,1812,50,20-24,1862,1.890061725479334E-4
SIM,1849,41,na,1890,2297
STAT,1938,8,na,1946,3892.2074185443666
STAT,1834,29,25-29,1863,24.096169521425363
STAT,1914,26,50-100,1940,0.9928545844606971
SIM,1932,30,35-39,1962,5
STAT,1900,38,50-100,1938,0.36527635730684715
STAT,1890,27,40-44,1917,3.626451428793465
STAT,1867,36,25-29,1903,2.7360490026407707
STAT,1911,44,50-100,1955,0.10950299610468249
STAT,1894,19,25-29,1913,7.167498537564135
STAT,1925,32,50-100,1957,0.9728307775454474
SIM,1870,66,na,1936,364
STAT,1853,43,50-100,1896,0.8132434182670424
STAT,1914,20,25-29,1934,89.83039396777788
STAT,1883,32,na,1915,2295.734309592245
STAT,1884,20,45-49,1904,0.6715095380481013
STAT,1939,24,45-49,1963,1.116812819992836
STAT,1800,54,45-49,1854,0.08461087215874574
STAT,1899,28,15-19,1927,0.6175161247527137
STAT,1850,93,na,1943,13.49516628536699
STAT,1886,41,30-34,1927,1.1959259608159825
STAT,1887,46,na,1933,2483.3702071029074
STAT,1879,18,45-49,1897,0.06683486092382547
STAT,1828,59,na,1887,1359.7029932814078
STAT,1870,23,20-24,1893,68.48886183571514
STAT,1866,45,50-100,1911,0.22642333690076086
STAT,1844,28,25-29,1872,50.933565442784804
STAT,1861,40,15-19,1901,0.011600733783410472
SIM,1852,28,25-29,1880,129
SIM,1919,18,35-39,1937,16
STAT,1894,48,na,1942,2825.6055550594797
STAT,1870,41,50-100,1911,1.0579774233190415
STAT,1880,42,20-24,1922,0.16466947110237543
STAT,1830,37,40-44,1867,3.9928511832211395
STAT,1838,34,35-39,1872,5.261423555631585
STAT,1890,34,na,1924,2864.15201734538
STAT,1840,40,25-29,1880,0.29737097445918786
STAT,1869,41,30-34,1910,1.165358605762364
SIM,1936,9,na,1945,4041
STAT,1835,22,15-19,1857,3.318017301418187
STAT,1833,25,45-49,1858,0.7311010544512804
STAT,1824,45,na,1869,515.4233288548527
STAT,1878,36,30-34,1914,5.509830689583227
STAT,1865,50,30-34,1915,0.005512722359726932
STAT,1904,48,15-19,1952,3.18310645003944E-4
STAT,1830,30,15-19,1860,0.13657121262129662
STAT,1843,52,45-49,1895,0.01426258090263856
STAT,1819,50,30-34,1869,0.001078071748390491
SIM,1875,36,25-29,1911,10
STAT,1903,26,na,1929,3399.3221841538175
SIM,1933,8,na,1941,4589
STAT,1835,35,20-24,1870,0.7361918581747992
SIM,1890,78,na,1968,2452
STAT,1900,53,na,1953,2934.940969531137
STAT,1946,23,50-100,1969,0.7240714085551291
SIM,1907,60,na,1967,4214
STAT,1928,18,35-39,1946,5.233311570845706
STAT,1835,37,na,1872,2003.4689416091132
STAT,1823,40,25-29,1863,1.1250399411914114
STAT,1879,51,40-44,1930,0.010851354689115376
STAT,1895,36,30-34,1931,6.966470453648592
STAT,1930,38,15-19,1968,0.024847200066234563
STAT,1815,60,na,1875,169.27268513777048
SIM,1950,6,na,1956,4870
STAT,1869,29,40-44,1898,3.001164964285187
SIM,1815,69,na,1884,482
STAT,1887,48,45-49,1935,0.25649499331984377
STAT,1850,25,45-49,1875,0.6120982006267587
STAT,1890,42,35-39,1932,2.189485384777691
STAT,1841,57,na,1898,2237.8547932771976
STAT,1830,30,50-100,1860,0.878693983519503
STAT,1864,24,35-39,1888,5.313252774958699
STAT,1861,48,25-29,1909,0.04730073564684237
STAT,1886,30,20-24,1916,2.8216527401592186
SIM,1882,59,na,1941,1326
STAT,1890,31,25-29,1921,12.450444548488484
STAT,1840,26,45-49,1866,0.5490504938542005
STAT,1823,51,35-39,1874,0.013185953423301588
SIM,1873,23,na,1896,2296
STAT,1851,29,25-29,1880,38.55799081090388
STAT,1828,45,30-34,1873,0.11867238821256615
STAT,1870,30,15-19,1900,0.14311211083424474
STAT,1928,23,30-34,1951,35.501999810320804
STAT,1844,44,30-34,1888,1.1369789379447948
STAT,1869,49,40-44,1918,0.16914782944374535
STAT,1860,28,na,1888,1953.6388907536614
SIM,1861,41,na,1902,2173
STAT,1885,26,20-24,1911,11.570995335717939
SIM,1846,34,35-39,1880,12
STAT,1937,30,na,1967,3707.2912895892887
SIM,1802,62,na,1864,856
STAT,1838,47,40-44,1885,0.0751864005960732
STAT,1880,20,30-34,1900,18.602234249451573
STAT,1896,15,40-44,1911,0.242228271054548
STAT,1868,17,30-34,1885,1.5673454801185827
STAT,1948,22,na,1970,4150.083872701597
SIM,1876,17,30-34,1893,17
SIM,1893,26,20-24,1919,23
STAT,1848,36,15-19,1884,0.05471698423394054
STAT,1825,39,25-29,1864,3.946814809940832
STAT,1862,9,na,1871,2376.6307188609703
STAT,1918,33,15-19,1951,0.13414361350019038
STAT,1854,35,30-34,1889,3.008681866927127
STAT,1848,87,na,1935,164.8654942629812
STAT,1907,30,35-39,1937,8.552792655452851
SIM,1845,35,30-34,1880,8
STAT,1889,37,45-49,1926,2.4006065588289154
SIM,1926,33,15-19,1959,2
SIM,1869,18,na,1887,3761
SIM,1828,79,na,1907,713
STAT,1839,51,40-44,1890,0.009827680034957643
STAT,1837,63,na,1900,1430.7151208630557
STAT,1891,43,35-39,1934,2.2107237875815704
STAT,1924,30,35-39,1954,10.606818677295578
SIM,1821,37,40-44,1858,81
STAT,1858,27,15-19,1885,0.354686367853029
STAT,1870,14,na,1884,2616.2869944414647
STAT,1870,18,25-29,1888,5.669573430932197
STAT,1886,25,25-29,1911,44.10242974446186
STAT,1844,45,15-19,1889,4.025244595953232E-4
STAT,1840,51,35-39,1891,0.003406075782399382
STAT,1854,33,35-39,1887,5.706741599568304
STAT,1817,75,na,1892,326.1227022462791
STAT,1899,44,20-24,1943,0.014859873117575747
STAT,1821,40,15-19,1861,0.016144573354328284
STAT,1855,34,35-39,1889,6.684223011507565
STAT,1849,37,15-19,1886,0.04841614431426428
STAT,1837,35,30-34,1872,5.312125465954379
STAT,1913,38,15-19,1951,0.018620427683108016
STAT,1838,50,40-44,1888,0.004650739293820579
SIM,1897,42,40-44,1939,1
SIM,1861,34,30-34,1895,4
SIM,1846,84,na,1930,319
STAT,1809,45,20-24,1854,0.11043560784208942
STAT,1853,34,30-34,1887,13.654863859874409
STAT,1879,52,25-29,1931,0.003614194758723079
SIM,1924,32,na,1956,5231
STAT,1870,38,25-29,1908,2.856130039248366
STAT,1877,51,50-100,1928,0.015404461856661725
STAT,1831,36,45-49,1867,2.0504857643834287
SIM,1842,70,na,1912,1595
STAT,1851,21,50-100,1872,0.3873957040648264
STAT,1880,28,40-44,1908,3.098911300173534
STAT,1910,45,35-39,1955,0.1195056020124752
SIM,1827,34,25-29,1861,2
STAT,1881,21,30-34,1902,16.871773811555943
STAT,1786,86,na,1872,134.32498004506607
STAT,1839,46,45-49,1885,0.22627769060223749
STAT,1865,59,na,1924,1774.3654091475476
STAT,1865,104,na,1969,0.5600890506079464
STAT,1889,42,40-44,1931,2.7052994605654646
SIM,1898,18,20-24,1916,188
STAT,1852,92,na,1944,41.923797172187065
STAT,1853,54,25-29,1907,0.0026709115613717752
STAT,1810,85,na,1895,8.535058665753738
STAT,1850,30,40-44,1880,2.350336256761273
STAT,1868,46,15-19,1914,3.8744493175628847E-4
STAT,1832,29,15-19,1861,0.5366577777607657
STAT,1870,51,20-24,1921,7.391761204377979E-4
STAT,1822,41,20-24,1863,0.2895879549077519
SIM,1937,31,25-29,1968,21
STAT,1918,16,25-29,1934,9.358531875164973
STAT,1832,32,na,1864,2426.3333634782257
STAT,1859,27,30-34,1886,20.303499682424793
STAT,1871,22,25-29,1893,57.10499515645915
STAT,1896,35,35-39,1931,9.412276145945558
STAT,1862,52,50-100,1914,0.012795151618925745
STAT,1850,69,na,1919,677.6552691885723
STAT,1807,52,35-39,1859,0.027453606046087875
STAT,1895,39,40-44,1934,5.637259589428079
STAT,1816,46,20-24,1862,0.037028738249926293
STAT,1895,57,na,1952,2614.273659086083
STAT,1820,44,20-24,1864,0.2530536622357101
SIM,1867,46,na,1913,2095
STAT,1834,26,15-19,1860,0.2640904601584549
STAT,1822,52,30-34,1874,0.009591925886924882
STAT,1872,46,35-39,1918,0.14058836969129562
SIM,1899,48,na,1947,1709
STAT,1887,14,na,1901,2833.296303810876
SIM,1867,27,30-34,1894,66
STAT,1779,84,na,1863,164.24566507587323
STAT,1814,75,na,1889,704.9354691184561
STAT,1861,77,na,1938,718.8656406063169
STAT,1882,20,35-39,1902,5.62028340356024
STAT,1833,33,45-49,1866,0.973059239835313
STAT,1864,40,40-44,1904,2.065463580201428
STAT,1832,47,50-100,1879,0.022232815993248698
STAT,1845,41,15-19,1886,0.007068181211252566
STAT,1867,53,45-49,1920,0.013504459438009899
STAT,1883,21,40-44,1904,2.0107665208262526
STAT,1911,46,40-44,1957,0.14794499806944453
SIM,1833,34,na,1867,2359
SIM,1897,8,na,1905,3016
STAT,1901,39,35-39,1940,2.113071060180811
SIM,1836,23,na,1859,2355
STAT,1829,44,35-39,1873,0.8461911735575742
STAT,1894,38,35-39,1932,8.949729038637717
STAT,1874,43,35-39,1917,1.8553798873154395
STAT,1849,72,na,1921,1064.1049908647594
STAT,1848,41,50-100,1889,1.000115129573083
STAT,1853,18,25-29,1871,5.254464238012239
STAT,1842,108,na,1950,4.54715254039584E-4
STAT,1882,53,40-44,1935,0.009917445992061569
STAT,1855,51,25-29,1906,0.0023554495785020114
STAT,1839,30,35-39,1869,11.821478126667335
STAT,1871,30,30-34,1901,17.556828805383436
STAT,1871,38,40-44,1909,4.345090960319677
STAT,1936,13,na,1949,3749.990734330169
STAT,1903,22,15-19,1925,4.683001605330397
STAT,1835,29,50-100,1864,0.6217781846613348
STAT,1844,33,20-24,1877,3.169229564727646
STAT,1845,54,50-100,1899,0.007288154530707419
SIM,1969,2,na,1971,4554
STAT,1846,28,35-39,1874,6.8637154783001355
STAT,1861,19,40-44,1880,0.17277943398876092
SIM,1854,28,35-39,1882,4
STAT,1933,20,35-39,1953,12.478989829934852
SIM,1808,59,na,1867,1261
STAT,1866,49,15-19,1915,3.5750360166751064E-4
STAT,1881,24,40-44,1905,1.9555211981164557
SIM,1862,30,30-34,1892,25
SIM,1884,23,15-19,1907,12
STAT,1862,17,50-100,1879,0.047791556326266894
STAT,1878,85,na,1963,483.37897321228417
STAT,1875,30,45-49,1905,1.805041177464913
STAT,1860,16,15-19,1876,5.6167223909775865
STAT,1915,51,na,1966,3603.1501114428092
STAT,1895,20,20-24,1915,90.18124802119594
SIM,1939,30,45-49,1969,134
STAT,1881,52,35-39,1933,0.008086665932892619
SIM,1906,35,na,1941,3438
STAT,1905,49,20-24,1954,0.009532711082213914
STAT,1824,40,40-44,1864,0.3782622368042538
STAT,1840,23,35-39,1863,2.9010703130694018
SIM,1893,34,20-24,1927,1
SIM,1881,33,45-49,1914,1
STAT,1822,43,40-44,1865,3.9215051478252523
STAT,1838,51,25-29,1889,0.001534050255961053
SIM,1896,25,35-39,1921,16
SIM,1830,43,40-44,1873,18
SIM,1927,25,30-34,1952,1
STAT,1900,21,na,1921,3286.1586971193738
STAT,1853,26,na,1879,1957.2173918344079
SIM,1842,62,na,1904,2267
STAT,1938,28,45-49,1966,1.6924140135125452
SIM,1829,34,35-39,1863,42
STAT,1862,41,20-24,1903,0.13587962816705945
STAT,1848,41,40-44,1889,2.1293300953673326
STAT,1861,45,20-24,1906,0.0100792093469739
STAT,1872,18,35-39,1890,0.5480155919319013
STAT,1857,16,na,1873,2082.5581539025698
STAT,1847,40,35-39,1887,1.6890478425926723
SIM,1929,36,50-100,1965,6
STAT,1875,27,20-24,1902,12.046466853494794
SIM,1931,34,na,1965,4972
STAT,1858,57,na,1915,1534.6834485205084
STAT,1818,43,20-24,1861,0.30190910029797524
STAT,1821,88,na,1909,69.33056338221454
STAT,1855,17,45-49,1872,0.05142112249052613
STAT,1845,24,50-100,1869,0.24761322742273525
STAT,1883,37,20-24,1920,0.7415899269021682
STAT,1891,31,40-44,1922,5.354778904936677
STAT,1874,34,45-49,1908,1.7843318271735622
STAT,1823,36,na,1859,2303.5309945479603
STAT,1882,48,50-100,1930,0.23218541760834518
STAT,1885,41,15-19,1926,0.013635783937675445
SIM,1881,31,25-29,1912,13
STAT,1828,48,40-44,1876,0.20172026602539953
STAT,1863,42,20-24,1905,0.13541371602071814
SIM,1818,44,30-34,1862,1
SIM,1926,16,25-29,1942,93
STAT,1836,50,30-34,1886,0.004801672480065488
STAT,1886,42,15-19,1928,0.014283163835927782
SIM,1918,12,na,1930,4480
SIM,1883,27,20-24,1910,6
STAT,1864,39,50-100,1903,1.1049149604315165
STAT,1923,45,20-24,1968,0.012852091734053519
STAT,1942,4,na,1946,4139.59528284004
STAT,1877,35,30-34,1912,5.461543825848687
SIM,1881,18,na,1899,3187
STAT,1881,41,25-29,1922,0.6091634646740786
STAT,1919,25,30-34,1944,42.05760170430873
STAT,1863,53,30-34,1916,0.005000171509576606
STAT,1893,43,45-49,1936,0.1290282084763061
SIM,1868,38,35-39,1906,7
STAT,1818,54,30-34,1872,0.0097872841060222
STAT,1868,3,na,1871,3053.086828001263
SIM,1824,30,40-44,1854,1
SIM,1831,36,40-44,1867,1
SIM,1849,40,50-100,1889,41
STAT,1828,40,30-34,1868,1.4866563839684042
STAT,1861,85,na,1946,227.98196813537933
STAT,1906,37,50-100,1943,0.3837352819885089
STAT,1861,28,30-34,1889,20.94304170884884
STAT,1868,48,35-39,1916,0.13352285217487747
SIM,1827,62,na,1889,1305
STAT,1826,52,45-49,1878,0.020049762876781608
STAT,1814,50,25-29,1864,0.012152231438569543
STAT,1885,34,20-24,1919,2.634221945084276
STAT,1885,45,30-34,1930,0.0960980977359781
STAT,1873,33,45-49,1906,1.7812286323556974
STAT,1890,30,40-44,1920,5.292261244465252
SIM,1832,40,40-44,1872,6
SIM,1911,33,na,1944,2502
STAT,1827,28,25-29,1855,49.42892793395479
STAT,1895,31,30-34,1926,22.805684984079942
STAT,1836,54,na,1890,1602.5826748390766
STAT,1859,23,15-19,1882,2.6934462621037176
STAT,1859,44,20-24,1903,0.1241749735011026
STAT,1920,23,50-100,1943,0.7198697586865964
STAT,1787,71,na,1858,276.52536275783996
STAT,1883,56,na,1939,1962.2160264014117
STAT,1828,48,35-39,1876,0.16495816184978127
STAT,1886,21,na,1907,2456.5204471259685
STAT,1832,40,na,1872,2235.05548968284
STAT,1855,31,30-34,1886,11.888670306009697
SIM,1819,51,na,1870,1842
STAT,1853,37,35-39,1890,5.4842633685192865
STAT,1825,48,15-19,1873,5.0147091997043E-4
STAT,1898,48,20-24,1946,0.008988015638768753
STAT,1824,33,50-100,1857,0.38872945153290056
SIM,1850,4,na,1854,2608
STAT,1886,28,35-39,1914,9.956777153786593
STAT,1900,27,25-29,1927,58.59954171105489
SIM,1852,69,na,1921,1563
STAT,1848,53,35-39,1901,0.007926788574933279
SIM,1907,20,na,1927,4839
STAT,1884,33,20-24,1917,2.576644005879146
SIM,1892,33,20-24,1925,20
STAT,1829,52,na,1881,829.867760306983
STAT,1819,37,35-39,1856,1.897334414322273
STAT,1881,24,35-39,1905,5.476224482518648
STAT,1855,4,na,1859,2098.1819612908976
SIM,1855,26,na,1881,2629
STAT,1813,54,25-29,1867,0.01182211032647034
SIM,1914,22,na,1936,5055
STAT,1844,16,30-34,1860,2.019108895215041
STAT,1865,41,40-44,1906,2.062860664007928
SIM,1867,23,15-19,1890,1
SIM,1863,31,30-34,1894,17
STAT,1812,53,25-29,1865,8.54110717850391E-4
STAT,1869,33,25-29,1902,10.292010120473785
STAT,1869,49,na,1918,2222.871985605331
STAT,1891,46,45-49,1937,0.16417077604003552
STAT,1896,35,40-44,1931,5.825353141349055
STAT,1861,25,20-24,1886,9.969915032612052
STAT,1900,38,35-39,1938,2.1043259764389983
STAT,1810,96,na,1906,0.26734192310124594
SIM,1872,0,na,1872,3761
STAT,1832,32,45-49,1864,0.11395396852335818
STAT,1935,17,50-100,1952,0.508491855563477
SIM,1884,39,30-34,1923,1
STAT,1833,25,15-19,1858,0.29874941235016783
STAT,1820,44,15-19,1864,0.02200466746985723
STAT,1876,39,30-34,1915,5.333488054322934
STAT,1934,30,na,1964,5134.6264730318435
STAT,1824,77,na,1901,167.28038221222891
STAT,1880,45,25-29,1925,0.060393853300123854
STAT,1874,95,na,1969,63.01721448543381
STAT,1837,54,40-44,1891,0.008209289658800703
STAT,1871,34,25-29,1905,10.12996700710991
STAT,1869,44,35-39,1913,1.8025948084823453
STAT,1829,27,45-49,1856,0.8281727362788036
STAT,1809,48,30-34,1857,0.8327576400350158
SIM,1837,44,40-44,1881,7
SIM,1845,67,na,1912,1416
SIM,1869,34,35-39,1903,14
STAT,1854,38,35-39,1892,3.913163338545044
STAT,1844,40,15-19,1884,0.014375549244576624
STAT,1850,45,45-49,1895,0.11006219311118913
STAT,1904,11,na,1915,3695.1260240528736
SIM,1832,49,na,1881,1753
STAT,1832,29,45-49,1861,1.3133115948710132
STAT,1838,37,na,1875,1102.1701819316136
STAT,1845,27,35-39,1872,5.827804574071699
STAT,1866,52,45-49,1918,0.013176681470715795
STAT,1831,45,35-39,1876,0.1354631880634181
STAT,1842,36,20-24,1878,0.22682158042861547
STAT,1870,34,30-34,1904,17.25714606543438
STAT,1945,15,30-34,1960,13.174713947965056
STAT,1854,30,30-34,1884,10.150105596724549
SIM,1893,3,na,1896,3684
STAT,1827,47,35-39,1874,0.12817362404920057
STAT,1836,39,30-34,1875,4.9097737081754484
SIM,1828,38,35-39,1866,3
STAT,1866,44,na,1910,2081.265339969502
STAT,1860,44,15-19,1904,0.01111388165825295
STAT,1874,26,15-19,1900,0.4698581123059507
SIM,1860,56,na,1916,1854
STAT,1864,37,40-44,1901,3.979614734084168
STAT,1849,29,na,1878,2129.7876782808657
STAT,1919,41,na,1960,3976.9904504456895
STAT,1889,45,45-49,1934,0.28703042679270707
STAT,1910,42,30-34,1952,0.1194727249081467
SIM,1874,16,na,1890,2711
STAT,1854,38,40-44,1892,2.4218964672668237
SIM,1876,29,25-29,1905,1
STAT,1831,47,na,1878,1888.1582195691205
STAT,1811,70,na,1881,993.9597762704502
STAT,1892,39,15-19,1931,0.0688248821619491
STAT,1920,39,45-49,1959,0.7352366854338113
STAT,1854,50,25-29,1904,0.001997723203634581
SIM,1884,18,na,1902,3801
STAT,1865,20,35-39,1885,5.470782792505021
STAT,1858,97,na,1955,4.102589637850603
STAT,1835,38,30-34,1873,4.933848185344792
STAT,1840,23,40-44,1863,1.0359517789205672
SIM,1879,71,na,1950,463
SIM,1892,69,na,1961,3096
STAT,1843,48,30-34,1891,0.09444097633867736
STAT,1880,23,35-39,1903,6.039409994002924
STAT,1895,39,35-39,1934,9.108365222608466
STAT,1852,25,25-29,1877,50.314721000182736
STAT,1768,113,na,1881,0.0012976431969349105
STAT,1888,44,45-49,1932,1.7040515470388555
STAT,1830,33,25-29,1863,9.521544162830677
STAT,1834,26,20-24,1860,6.828624700773742
STAT,1929,31,25-29,1960,11.664676565819214
STAT,1857,20,50-100,1877,0.3664951598372503
STAT,1887,29,35-39,1916,10.544411444916467
STAT,1826,29,50-100,1855,2.01997907366095
STAT,1861,45,15-19,1906,3.359733493655244E-4
STAT,1939,21,40-44,1960,3.340749227416148
STAT,1858,43,20-24,1901,0.1204037441416257
STAT,1849,54,50-100,1903,0.012375512484149474
STAT,1875,27,15-19,1902,0.46588546215792764
STAT,1898,27,45-49,1925,1.4930432551463846
SIM,1963,5,na,1968,5558
STAT,1870,35,20-24,1905,0.7757831888196777
STAT,1838,37,45-49,1875,1.0268387811331106
STAT,1872,69,na,1941,1469.5386481971154
STAT,1921,35,45-49,1956,0.7534724987959728
STAT,1843,67,na,1910,1566.2661347925582
STAT,1885,17,30-34,1902,1.566692949300444
STAT,1864,43,45-49,1907,1.3507760869686052
SIM,1828,33,35-39,1861,4
STAT,1849,53,20-24,1902,6.117817797925571E-4
STAT,1855,34,40-44,1889,2.8623868147262255
STAT,1890,35,40-44,1925,5.349766111470015
STAT,1894,72,na,1966,1910.2753518162697
STAT,1943,15,na,1958,3860.664645093117
STAT,1855,46,35-39,1901,0.09292017693323305
STAT,1876,39,25-29,1915,2.8813096227257233
SIM,1796,60,na,1856,1195
STAT,1887,24,35-39,1911,6.382747631920168
SIM,1886,15,25-29,1901,14
STAT,1797,70,na,1867,27.259151198395745
STAT,1844,48,25-29,1892,0.0563466727104544
STAT,1835,54,30-34,1889,0.0044116671315081474
SIM,1923,47,na,1970,4224
STAT,1906,45,20-24,1951,0.009899716331434345
STAT,1809,48,25-29,1857,0.49552520251776283
STAT,1939,21,35-39,1960,9.355404956362982
STAT,1893,35,15-19,1928,0.0708897564688734
STAT,1871,18,40-44,1889,0.1825505409725612
SIM,1889,46,na,1935,3794
SIM,1857,36,na,1893,1402
STAT,1901,36,30-34,1937,1.6161678575064657
SIM,1854,25,30-34,1879,9
SIM,1792,70,na,1862,853
STAT,1824,85,na,1909,53.05151423709221
SIM,1843,22,20-24,1865,96
STAT,1846,25,30-34,1871,18.304468603661583
STAT,1908,27,20-24,1935,17.267788067196747
STAT,1927,28,50-100,1955,1.1959779317014054
STAT,1916,21,40-44,1937,3.4857263807211702
STAT,1826,44,15-19,1870,0.02003632334191318
STAT,1816,49,25-29,1865,0.17022852061211657
STAT,1859,113,na,1972,1.3291314562638467E-4
SIM,1847,15,na,1862,1776
STAT,1846,44,35-39,1890,1.0579977458228382
SIM,1838,54,na,1892,1618
SIM,1921,32,na,1953,5245
SIM,1894,17,na,1911,1764
STAT,1919,33,30-34,1952,16.70145533165026
STAT,1886,45,25-29,1931,0.06024234706978755
SIM,1843,19,20-24,1862,91
STAT,1840,50,50-100,1890,0.0060322346864816806
STAT,1842,100,na,1942,0.2635475097445139
STAT,1872,31,30-34,1903,17.55490397344812
STAT,1837,50,25-29,1887,0.002965569635148068
STAT,1869,25,25-29,1894,42.97519053994922
STAT,1823,44,40-44,1867,3.595586014542939
SIM,1805,49,45-49,1854,1
STAT,1926,46,na,1972,4505.331161311801
SIM,1872,43,45-49,1915,1
SIM,1809,52,na,1861,612
STAT,1853,15,20-24,1868,16.732678729756447
STAT,1885,16,25-29,1901,5.583787375397327
STAT,1835,22,20-24,1857,69.3092396651634
STAT,1862,24,30-34,1886,15.308624336901046
STAT,1932,35,20-24,1967,0.3523314657428097
STAT,1862,109,na,1971,0.01032870371094754
SIM,1884,23,20-24,1907,515
STAT,1816,100,na,1916,0.8962688311947927
STAT,1815,49,na,1864,208.91294665523233
STAT,1883,43,50-100,1926,1.0090104472734194
STAT,1896,18,45-49,1914,0.08588438797765302
SIM,1943,1,na,1944,4986
STAT,1864,45,40-44,1909,0.1571906267456745
STAT,1836,109,na,1945,5.445064679933922E-4
STAT,1835,38,25-29,1873,2.6654122234284188
STAT,1815,49,50-100,1864,0.024242419464773377
STAT,1896,20,50-100,1916,0.5407683869507637
STAT,1829,44,40-44,1873,1.0510839842193929
STAT,1871,52,20-24,1923,7.321881078373202E-4
SIM,1917,27,na,1944,2251
STAT,1926,23,20-24,1949,133.51627660270174
SIM,1831,42,45-49,1873,1
STAT,1919,17,25-29,1936,47.25293278946616
SIM,1921,43,na,1964,5169
STAT,1904,6,na,1910,3732.26425188251
STAT,1890,33,45-49,1923,2.1021750458214066
STAT,1914,10,na,1924,4040.6569585073735
STAT,1875,80,na,1955,635.2069767655124
SIM,1856,51,na,1907,258
STAT,1910,45,40-44,1955,0.14613827869538662
SIM,1900,41,na,1941,4148
STAT,1917,46,35-39,1963,0.1332006026714305
SIM,1820,38,30-34,1858,3
STAT,1869,48,50-100,1917,0.24471651116091844
STAT,1924,31,na,1955,4372.583997827811
STAT,1896,74,na,1970,1880.5534149208318
STAT,1835,43,20-24,1878,0.14214556371098638
STAT,1919,28,35-39,1947,15.950240610967063
STAT,1857,26,45-49,1883,0.8839237406294895
STAT,1874,46,45-49,1920,0.24425923066002422
STAT,1920,22,15-19,1942,5.841796829529993
SIM,1872,45,40-44,1917,5
SIM,1883,76,na,1959,1493
STAT,1892,60,na,1952,2361.267387532005
SIM,1917,38,na,1955,2041
STAT,1883,16,15-19,1899,5.723316316701262
STAT,1838,80,na,1918,263.8141479694745
STAT,1874,40,30-34,1914,1.198506639876199
SIM,1858,36,25-29,1894,4
STAT,1867,33,15-19,1900,0.13411087207356806
SIM,1879,39,na,1918,1055
SIM,1866,72,na,1938,1684
STAT,1874,23,40-44,1897,2.1439838736379273
STAT,1901,28,50-100,1929,0.8912792279143121
SIM,1831,39,45-49,1870,16
SIM,1843,25,na,1868,547
SIM,1903,45,45-49,1948,2
STAT,1811,59,na,1870,1471.985449615407
STAT,1938,34,50-100,1972,0.8213813053022583
STAT,1878,32,50-100,1910,0.9426968584393256
STAT,1841,101,na,1942,0.6354264742312226
STAT,1885,49,25-29,1934,0.05543574440780147
STAT,1910,26,50-100,1936,0.953667102241305
STAT,1872,15,30-34,1887,1.6203175488904786
SIM,1946,19,na,1965,3142
STAT,1858,30,45-49,1888,1.359639825279199
STAT,1938,22,30-34,1960,28.14066357644561
SIM,1832,60,na,1892,749
SIM,1935,0,na,1935,5974
STAT,1870,54,25-29,1924,0.0034340457056157027
STAT,1919,40,50-100,1959,0.1259686678150286
STAT,1825,30,na,1855,1834.0888719713673
STAT,1867,45,15-19,1912,3.820631127931486E-4
SIM,1844,26,50-100,1870,81
SIM,1927,17,25-29,1944,945
STAT,1813,53,40-44,1866,0.03585712237065028
STAT,1887,45,35-39,1932,0.15563050016904695
STAT,1845,28,40-44,1873,1.7962839932562036
STAT,1842,19,30-34,1861,0.5021236562568645
SIM,1893,54,na,1947,2792
STAT,1872,40,na,1912,2337.735058249157
STAT,1876,54,na,1930,2116.7979507970435
STAT,1897,13,na,1910,3424.39020717145
STAT,1825,62,na,1887,1163.8734232742916
STAT,1846,21,na,1867,1573.775256468786
STAT,1886,25,30-34,1911,26.254034531904683
STAT,1867,2,na,1869,3181.8291089323307
STAT,1847,37,40-44,1884,4.106367148404012
STAT,1836,42,25-29,1878,0.5853798444524513
STAT,1899,44,15-19,1943,0.0012921629495800354
STAT,1882,53,35-39,1935,0.008110060993519436
SIM,1892,13,na,1905,3699
SIM,1863,21,na,1884,1476
SIM,1919,23,25-29,1942,2
STAT,1902,35,35-39,1937,2.170153398598722
STAT,1909,43,15-19,1952,0.0014132315333693247
STAT,1931,17,50-100,1948,0.48694083466951826
SIM,1878,86,na,1964,482
STAT,1836,53,35-39,1889,0.006543978000128033
STAT,1836,34,30-34,1870,16.563639699316433
STAT,1878,51,25-29,1929,0.0036617045171495398
STAT,1831,30,30-34,1861,19.132800509346353
STAT,1910,28,na,1938,3564.4047974218715
STAT,1845,44,25-29,1889,0.31627758958051166
SIM,1889,49,na,1938,3784
SIM,1848,27,20-24,1875,10
STAT,1894,16,20-24,1910,22.600008335624846
STAT,1926,43,15-19,1969,0.0018739852823395524
STAT,1863,44,40-44,1907,1.8943148809919053
STAT,1846,32,na,1878,1516.8701380147388
STAT,1927,22,25-29,1949,112.87712312692415
STAT,1915,20,40-44,1935,3.307723551118311
STAT,1847,40,40-44,1887,2.098026062438812
STAT,1893,40,40-44,1933,2.8411639954364007
STAT,1879,38,45-49,1917,2.034854899842529
STAT,1861,28,25-29,1889,35.18084142372127
SIM,1894,25,30-34,1919,5
STAT,1857,72,na,1929,969.0968316048151
STAT,1851,42,20-24,1893,0.1252749290743456
STAT,1852,34,15-19,1886,0.14536703828151903
STAT,1934,17,20-24,1951,182.1378831327048
SIM,1871,44,40-44,1915,2
STAT,1904,3,na,1907,3776.9599879170046
STAT,1851,39,20-24,1890,0.6026833174144681
STAT,1853,35,15-19,1888,0.044455315577355596
SIM,1958,12,na,1970,4190
SIM,1889,78,na,1967,986
SIM,1835,25,20-24,1860,27
STAT,1835,19,20-24,1854,17.940219076503404
STAT,1852,22,15-19,1874,3.9449048423432242
STAT,1877,36,15-19,1913,0.05727799990437274
STAT,1830,51,20-24,1881,5.659344635372562E-4
STAT,1888,25,35-39,1913,11.2119962589982
STAT,1904,41,50-100,1945,0.10528650807896511
STAT,1848,36,na,1884,2295.663282553739
SIM,1828,35,30-34,1863,5
SIM,1858,33,20-24,1891,2
STAT,1823,39,15-19,1862,0.09957184006348192
SIM,1889,38,na,1927,3846
STAT,1826,39,40-44,1865,6.804129051743561
STAT,1862,41,15-19,1903,0.011815620478785756
SIM,1918,22,25-29,1940,36
STAT,1842,15,45-49,1857,0.02107089572571245
STAT,1945,23,30-34,1968,31.141887600491458
SIM,1855,40,40-44,1895,10
STAT,1879,19,na,1898,2576.9731067172506
STAT,1893,23,15-19,1916,4.112773460744732
STAT,1894,36,15-19,1930,0.07175312535606533
SIM,1939,30,na,1969,3937
STAT,1843,32,15-19,1875,0.16915461159287343
SIM,1925,17,na,1942,5072
SIM,1932,27,na,1959,4337
STAT,1887,26,30-34,1913,27.812159474129665
STAT,1935,33,15-19,1968,0.17639648781985096
STAT,1810,93,na,1903,0.9099201783473888
SIM,1935,22,25-29,1957,15
STAT,1847,24,35-39,1871,6.375263935917479
STAT,1826,32,15-19,1858,0.2824606299684078
STAT,1786,110,na,1896,2.72180232568333E-4
STAT,1797,100,na,1897,0.010612687728703
SIM,1935,24,na,1959,4879
STAT,1836,35,15-19,1871,0.053925240514165716
STAT,1916,48,50-100,1964,0.22818738274431088
STAT,1929,22,35-39,1951,11.823746746167417
SIM,1931,10,na,1941,5250
STAT,1890,17,45-49,1907,0.07907989922300596
STAT,1926,35,na,1961,4566.381181078229
STAT,1899,31,45-49,1930,2.391563359786709
SIM,1893,43,na,1936,3181
STAT,1862,32,25-29,1894,8.72404630219422
STAT,1814,86,na,1900,150.16237285761062
STAT,1888,38,40-44,1926,5.027295171943374
STAT,1845,24,30-34,1869,10.81574460082756
STAT,1852,29,40-44,1881,3.150229250157492
STAT,1872,61,na,1933,1871.1761564120893
STAT,1827,45,15-19,1872,3.75768064244791E-4
STAT,1857,26,15-19,1883,0.3611972605806433
STAT,1861,33,20-24,1894,2.238493291905934
STAT,1835,29,40-44,1864,2.9116749195122305
SIM,1850,39,25-29,1889,2
STAT,1945,18,35-39,1963,4.531703041996138
STAT,1920,36,40-44,1956,1.6194262993328765
STAT,1842,39,25-29,1881,0.7473071570005081
STAT,1897,15,35-39,1912,0.7320999544922456
SIM,1876,26,20-24,1902,10
STAT,1900,35,30-34,1935,7.453103531894126
SIM,1921,35,na,1956,5173
SIM,1900,70,na,1970,3379
STAT,1797,81,na,1878,8.55033531105013
STAT,1801,57,na,1858,930.2698208008841
STAT,1946,22,35-39,1968,10.364881054432095
STAT,1846,23,35-39,1869,4.233764349598431
STAT,1859,50,na,1909,1731.1091589805453
STAT,1843,53,50-100,1896,0.01468260034874261
STAT,1793,96,na,1889,1.459047308505335
STAT,1867,50,40-44,1917,0.01009939104978128
STAT,1841,52,35-39,1893,0.009535712030733293
STAT,1900,24,20-24,1924,94.86585535157798
SIM,1833,23,na,1856,2542
SIM,1910,35,35-39,1945,1
SIM,1846,44,na,1890,1030
SIM,1812,64,na,1876,655
SIM,1880,34,35-39,1914,1
STAT,1844,45,20-24,1889,0.012075744410086584
STAT,1838,53,45-49,1891,0.006095600297909131
STAT,1825,70,na,1895,864.0308438016789
STAT,1860,29,20-24,1889,9.534564991090487
SIM,1871,25,30-34,1896,3
STAT,1842,15,15-19,1857,1.9142912640490342
STAT,1876,35,15-19,1911,0.05730622154257952
STAT,1904,35,45-49,1939,0.6205726247811943
SIM,1880,25,na,1905,3324
STAT,1888,41,40-44,1929,2.6077789629910537
STAT,1883,24,na,1907,2261.0352773234963
SIM,1851,52,45-49,1903,1
STAT,1855,37,45-49,1892,1.3193622081928293
STAT,1921,48,20-24,1969,0.012276182363075002
SIM,1822,71,na,1893,205
SIM,1878,24,35-39,1902,1
STAT,1840,44,40-44,1884,0.9005031644465621
STAT,1854,18,40-44,1872,0.12093773061912398
STAT,1836,22,na,1858,2159.384749163947
SIM,1826,29,35-39,1855,2
STAT,1870,15,20-24,1885,18.054581106149016
STAT,1884,50,40-44,1934,0.010222650902646837
STAT,1903,58,na,1961,2933.4290613585163
STAT,1898,24,40-44,1922,2.784590902708124
SIM,1846,53,45-49,1899,1
SIM,1913,30,25-29,1943,11
STAT,1917,43,50-100,1960,0.12077257058588915
STAT,1910,46,25-29,1956,0.04905935729640324
STAT,1931,24,40-44,1955,4.303147262891557
SIM,1844,74,na,1918,719
SIM,1881,23,25-29,1904,185
STAT,1832,26,40-44,1858,3.689376695500121
STAT,1860,32,20-24,1892,2.2051341551570194
SIM,1845,35,50-100,1880,12
STAT,1863,25,30-34,1888,21.810167067334607
STAT,1932,38,25-29,1970,1.3123904879215338
STAT,1848,98,na,1946,3.039902178900408
STAT,1876,23,20-24,1899,69.44893124538231
STAT,1868,24,na,1892,2270.0312137474693
STAT,1891,40,30-34,1931,1.4280456290719241
STAT,1900,41,50-100,1941,0.10208740811621785
STAT,1854,54,40-44,1908,0.005692590220082538
STAT,1895,15,25-29,1910,7.405941032021045
STAT,1853,39,30-34,1892,4.090902660038005
STAT,1833,29,30-34,1862,14.6977427441853
STAT,1848,36,45-49,1884,1.9424527092997574
STAT,1863,40,25-29,1903,0.5537490663314363
STAT,1846,41,30-34,1887,0.6980325292104798
STAT,1910,48,45-49,1958,0.1999511791972668
STAT,1905,30,25-29,1935,14.850567256596344
SIM,1878,54,na,1932,3571
SIM,1829,29,na,1858,2102
STAT,1845,43,35-39,1888,0.903368674755396
STAT,1861,44,30-34,1905,0.9432077517345517
SIM,1841,29,30-34,1870,22
STAT,1912,48,50-100,1960,0.21424668471090985
STAT,1874,28,na,1902,2454.3807761308085
STAT,1859,28,na,1887,1910.3748746309657
STAT,1867,49,30-34,1916,0.08963524555284327
SIM,1914,48,25-29,1962,2
SIM,1840,22,25-29,1862,42
STAT,1845,32,25-29,1877,6.04317948766976
STAT,1898,27,15-19,1925,0.6101014249297438
STAT,1860,36,na,1896,1931.238356078242
STAT,1928,15,30-34,1943,15.312271010107557
STAT,1943,23,20-24,1966,116.9143668967868
SIM,1840,26,40-44,1866,73
SIM,1853,43,35-39,1896,10
STAT,1828,28,40-44,1856,5.588626520326366
STAT,1876,26,25-29,1902,42.90959694823085
STAT,1814,54,40-44,1868,0.033360157441785686
STAT,1885,29,25-29,1914,41.2829733886614
STAT,1912,54,na,1966,3398.6028273039838
STAT,1882,90,na,1972,259.28923387474043
STAT,1837,108,na,1945,0.0014687375524846035
STAT,1865,44,45-49,1909,1.3479750223141789
STAT,1862,27,35-39,1889,8.248685027662106
STAT,1887,42,30-34,1929,1.2638510743296785
SIM,1873,44,45-49,1917,2
SIM,1910,40,na,1950,4060
SIM,1907,28,na,1935,4686
STAT,1896,47,35-39,1943,0.10361736993825936
STAT,1906,17,45-49,1923,0.09459165033560932
STAT,1832,22,25-29,1854,88.03687759224297
STAT,1791,102,na,1893,0.07392486429171134
STAT,1912,7,na,1919,3982.0506924931547
STAT,1881,45,40-44,1926,0.16328414113543305
STAT,1895,19,40-44,1914,0.23665756591068396
STAT,1929,3,na,1932,5140.101498160812
SIM,1869,36,30-34,1905,1
STAT,1837,35,50-100,1872,1.2237223782687137
STAT,1861,21,na,1882,2035.2614652786524
SIM,1890,54,na,1944,3139
SIM,1875,49,30-34,1924,3
STAT,1906,48,25-29,1954,0.046458392623077306
STAT,1834,42,20-24,1876,0.08437739771331591
SIM,1894,68,na,1962,1042
STAT,1859,9,na,1868,2241.49866128203
STAT,1874,32,50-100,1906,0.9456263516153888
SIM,1859,62,na,1921,1535
SIM,1874,45,50-100,1919,2
STAT,1863,87,na,1950,150.4077013099729
STAT,1842,51,45-49,1893,0.0036198637270087545
SIM,1846,34,40-44,1880,2
STAT,1917,17,20-24,1934,28.785254208891068
STAT,1916,24,45-49,1940,1.155665148143527
STAT,1947,15,40-44,1962,1.5598305864688546
STAT,1896,42,na,1938,3053.5005062153095
SIM,1852,25,20-24,1877,1
STAT,1829,47,45-49,1876,0.1091595828769354
STAT,1838,88,na,1926,58.54764078350932
STAT,1834,39,20-24,1873,0.4138866230313474
STAT,1880,44,40-44,1924,2.3035763194517935
SIM,1842,39,20-24,1881,11
STAT,1844,25,20-24,1869,14.434086827444533
SIM,1944,20,na,1964,2509
STAT,1896,38,45-49,1934,2.614837006924993
STAT,1838,34,40-44,1872,2.253100979186678
STAT,1866,17,20-24,1883,16.610468631845876
STAT,1844,19,35-39,1863,0.6828927805811413
STAT,1893,31,na,1924,2996.343471353951
SIM,1856,43,na,1899,573
STAT,1836,37,35-39,1873,6.652527765230256
STAT,1895,35,25-29,1930,3.7810395352150588
SIM,1866,10,na,1876,3337
STAT,1851,45,25-29,1896,0.04594558808047512
STAT,1893,39,30-34,1932,6.597707179484362
STAT,1942,23,50-100,1965,0.6817972340859981
SIM,1896,34,25-29,1930,2
STAT,1899,18,50-100,1917,0.06674108375497505
STAT,1931,20,25-29,1951,119.668923960997
SIM,1876,28,na,1904,3849
SIM,1930,17,na,1947,3777
SIM,1879,6,na,1885,2178
STAT,1800,86,na,1886,126.80755251063873
STAT,1851,26,20-24,1877,10.926966969975506
SIM,1836,44,25-29,1880,4
STAT,1886,44,35-39,1930,1.8498768684905114
SIM,1832,43,45-49,1875,1
STAT,1915,23,45-49,1938,1.1431053151994344
STAT,1819,42,25-29,1861,0.15049834635279688
STAT,1886,33,25-29,1919,10.561969535551988
SIM,1808,67,na,1875,1261
STAT,1873,27,40-44,1900,3.072788411057434
STAT,1888,34,25-29,1922,11.720429949996383
STAT,1830,54,25-29,1884,0.0025597878733469876
STAT,1819,53,35-39,1872,0.0014872804720895314
STAT,1895,23,50-100,1918,0.5288441265276073
STAT,1821,44,30-34,1865,1.2481755428644261
STAT,1823,42,45-49,1865,2.5136739998421533
STAT,1823,39,45-49,1862,3.534799901879454
STAT,1885,46,20-24,1931,0.011828882069923477
SIM,1887,35,40-44,1922,38
STAT,1840,35,35-39,1875,3.363090671554827
SIM,1833,26,na,1859,2362
SIM,1939,32,40-44,1971,1
STAT,1879,15,40-44,1894,0.18850099754989044
STAT,1879,54,45-49,1933,0.014478018522024717
SIM,1836,74,na,1910,570
STAT,1873,30,40-44,1903,4.4842732184866625
SIM,1815,40,40-44,1855,13
STAT,1948,1,na,1949,4651.344966737245
SIM,1866,21,na,1887,3273
STAT,1859,105,na,1964,0.11750990695094223
STAT,1862,62,na,1924,1556.7535927713996
SIM,1827,53,35-39,1880,3
STAT,1824,43,45-49,1867,0.256105282462939
STAT,1879,35,40-44,1914,4.533264731833905
SIM,1858,21,na,1879,2443
STAT,1880,13,na,1893,2676.88772839239
SIM,1843,33,na,1876,352
STAT,1808,49,20-24,1857,0.016656744859221893
STAT,1905,34,40-44,1939,3.550959041906681
STAT,1818,38,25-29,1856,6.738965327719024
STAT,1889,24,45-49,1913,0.8344752127943499
SIM,1777,78,na,1855,550
SIM,1829,43,25-29,1872,1
STAT,1793,99,na,1892,0.3148780612766841
STAT,1809,53,20-24,1862,0.005970546982973198
STAT,1850,29,na,1879,1158.7037999685651
STAT,1854,52,20-24,1906,4.081120068463471E-4
STAT,1878,39,35-39,1917,7.203870391666802
STAT,1882,79,na,1961,860.7949543139288
STAT,1873,65,na,1938,1733.529112693534
SIM,1865,36,na,1901,1753
STAT,1857,23,40-44,1880,1.8327391783760154
STAT,1938,23,na,1961,3574.3090327086857
STAT,1839,54,45-49,1893,0.013112218488017064
STAT,1852,95,na,1947,13.383128396022755
STAT,1891,34,45-49,1925,2.1260685438274534
STAT,1831,33,35-39,1864,10.613573711135334
STAT,1861,15,25-29,1876,5.481074575700474
STAT,1825,36,20-24,1861,1.138013802742559
STAT,1876,44,20-24,1920,0.15837830845111678
STAT,1882,39,na,1921,2232.9347324893265
STAT,1815,101,na,1916,0.040232156537359114
STAT,1901,14,na,1915,3599.2136113626284
STAT,1905,28,na,1933,3420.502686809056
STAT,1862,45,30-34,1907,0.08327050771494884
STAT,1883,52,45-49,1935,0.013887244580157268
STAT,1875,43,20-24,1918,0.1618994794298456
SIM,1876,5,na,1881,4171
STAT,1837,38,35-39,1875,6.833537343544866
STAT,1904,43,na,1947,3289.526959514678
STAT,1833,45,45-49,1878,0.12159960038079118
STAT,1892,27,20-24,1919,14.524637472451982
STAT,1873,23,50-100,1896,0.41701053572632657
STAT,1918,17,50-100,1935,0.0807112529211733
STAT,1881,36,35-39,1917,6.71144540823638
SIM,1906,43,na,1949,3372
STAT,1873,54,na,1927,2147.9384242475303
STAT,1830,32,35-39,1862,9.512402645742492
STAT,1904,22,30-34,1926,25.4483364878626
STAT,1869,45,25-29,1914,0.05870257849507655
STAT,1847,62,na,1909,1652.4827142174606
STAT,1859,36,20-24,1895,0.6139097653666835
SIM,1880,87,na,1967,2194
STAT,1871,33,35-39,1904,10.059558934556108
STAT,1835,25,25-29,1860,42.319174090767696
STAT,1808,52,20-24,1860,9.490374903905219E-4
SIM,1868,76,na,1944,328
STAT,1849,21,na,1870,2193.903387065448
STAT,1921,32,50-100,1953,0.9091854048849993
STAT,1872,34,35-39,1906,10.054012923342768
SIM,1879,79,na,1958,63
STAT,1826,48,30-34,1874,0.13670063826842124
STAT,1880,24,25-29,1904,59.057745789045676
STAT,1827,49,30-34,1876,0.086368827044319
STAT,1811,54,15-19,1865,1.0631599404024122E-4
STAT,1897,16,na,1913,3362.3739360890704
STAT,1911,22,30-34,1933,26.951032612180352
SIM,1919,20,20-24,1939,5
SIM,1845,38,35-39,1883,36
SIM,1871,51,na,1922,1771
SIM,1891,28,na,1919,2114
STAT,1847,73,na,1920,1073.867318011752
STAT,1856,30,50-100,1886,0.6801328896263197
STAT,1908,34,50-100,1942,0.7677605571638922
STAT,1813,102,na,1915,0.2147583153602504
STAT,1834,44,na,1878,1088.7378167325176
STAT,1850,33,45-49,1883,0.833650034291896
STAT,1886,39,50-100,1925,1.258593175385408
STAT,1820,43,30-34,1863,1.8645249762765137
STAT,1875,19,50-100,1894,0.05003763123825674
STAT,1913,17,na,1930,3899.3778168244685
STAT,1814,45,35-39,1859,0.49157529160957275
SIM,1877,13,na,1890,213
SIM,1822,45,35-39,1867,1
STAT,1845,47,na,1892,1111.2045078553983
SIM,1808,56,na,1864,1309
STAT,1822,65,na,1887,985.5351109485325
STAT,1834,42,15-19,1876,0.0073371654148358684
STAT,1873,57,na,1930,2061.4385306098316
STAT,1910,43,20-24,1953,0.01640471761515777
STAT,1865,20,40-44,1885,1.9535780089339831
SIM,1891,17,na,1908,2619
STAT,1826,55,na,1881,1776.2551140602302
STAT,1845,25,15-19,1870,0.2780072169903715
STAT,1847,33,25-29,1880,10.760702991251149
STAT,1829,53,30-34,1882,0.0023736007252752873
STAT,1875,58,na,1933,2030.7003722581478
STAT,1873,51,40-44,1924,0.010850717683989543
SIM,1866,42,45-49,1908,15
STAT,1830,60,na,1890,1380.3638687879932
STAT,1836,30,15-19,1866,0.14082842913950247
STAT,1865,17,40-44,1882,0.1720789756417129
STAT,1858,42,45-49,1900,1.141523537748017
SIM,1813,49,na,1862,187
STAT,1860,92,na,1952,33.97726563898113
STAT,1856,54,45-49,1910,0.010136951041089134
STAT,1894,43,25-29,1937,0.0562970535004157
STAT,1861,47,35-39,1908,0.11588721142716545
SIM,1817,39,na,1856,2812
SIM,1919,42,35-39,1961,1
STAT,1864,82,na,1946,424.1729575623591
SIM,1858,23,na,1881,2440
STAT,1922,21,35-39,1943,10.709685249375074
SIM,1901,46,50-100,1947,1
SIM,1926,12,na,1938,6307
STAT,1934,19,na,1953,4918.370952492992
SIM,1837,40,25-29,1877,1
SIM,1926,10,na,1936,6337
SIM,1896,40,na,1936,3385
SIM,1900,28,35-39,1928,246
STAT,1833,42,40-44,1875,1.1708789911710842
STAT,1827,74,na,1901,782.6135305267385
STAT,1896,28,na,1924,3134.909398569501
SIM,1821,78,na,1899,965
STAT,1896,31,25-29,1927,13.557272364903485
STAT,1902,35,40-44,1937,1.3431299423978378
SIM,1855,33,25-29,1888,7
STAT,1813,50,30-34,1863,0.021544939305511004
SIM,1887,12,na,1899,3965
STAT,1880,21,20-24,1901,71.75780334857149
STAT,1911,8,na,1919,3933.2664376636267
STAT,1863,44,35-39,1907,1.525047052662095
STAT,1848,58,na,1906,1850.5854004152925
STAT,1940,2,na,1942,4089.170885748478
STAT,1880,41,30-34,1921,1.1989336496411644
STAT,1918,4,na,1922,4333.904097403987
STAT,1856,42,35-39,1898,1.2990221542250953
STAT,1866,103,na,1969,1.1079900143085597
STAT,1805,61,na,1866,382.3203281589385
STAT,1831,54,40-44,1885,0.008393673501002634
STAT,1829,40,25-29,1869,0.3181293897094128
STAT,1873,23,25-29,1896,58.53993289025732
SIM,1850,35,na,1885,1678
STAT,1865,48,50-100,1913,0.2214131406408466
STAT,1859,39,50-100,1898,0.9633060338671294
STAT,1886,27,50-100,1913,0.6624335169924859
STAT,1882,44,45-49,1926,1.4135572196652948
STAT,1805,93,na,1898,3.9209647049809626
STAT,1839,30,40-44,1869,5.06231510559898
STAT,1839,27,40-44,1866,3.5060518861321475
STAT,1871,15,15-19,1886,6.029019372802489
STAT,1921,22,30-34,1943,32.07793188938463
SIM,1950,3,na,1953,4871
SIM,1871,44,35-39,1915,1
STAT,1836,26,50-100,1862,0.6388651776912861
STAT,1827,96,na,1923,6.055238379416417
STAT,1844,50,50-100,1894,0.015177138252158854
STAT,1930,40,25-29,1970,0.09355577053573887
STAT,1852,63,na,1915,1796.0591153819894
STAT,1827,52,25-29,1879,0.0031345717244824407
STAT,1879,36,50-100,1915,1.2655293299510169
SIM,1873,32,35-39,1905,24
STAT,1871,15,50-100,1886,0.04977175139896874
STAT,1917,49,45-49,1966,0.2226684576335739
SIM,1842,48,na,1890,3042
STAT,1944,22,25-29,1966,98.6098570376456
SIM,1869,72,na,1941,3598
STAT,1894,27,na,1921,3034.8426521387805
STAT,1877,16,20-24,1893,18.04079291129193
STAT,1815,53,45-49,1868,0.0013922717290121374
STAT,1875,43,15-19,1918,0.014078216362971928
SIM,1935,27,25-29,1962,3
STAT,1938,5,na,1943,3923.788132824109
STAT,1809,110,na,1919,2.6898087883427195E-4
STAT,1869,20,na,1889,2411.04413410316
STAT,1896,44,30-34,1940,0.10382064668082341
STAT,1884,32,45-49,1916,1.6693128505791017
STAT,1913,25,na,1938,3710.8710332963656
STAT,1850,82,na,1932,215.4498773150363
STAT,1866,16,45-49,1882,0.06156551436560066
STAT,1922,34,40-44,1956,4.350889772391433
SIM,1870,32,25-29,1902,94
STAT,1811,104,na,1915,0.04040894351039167
SIM,1855,66,na,1921,2860
STAT,1850,29,30-34,1879,13.48807901403443
STAT,1946,12,na,1958,4309.7965381261165
STAT,1955,3,na,1958,5176.446495633438
STAT,1817,49,40-44,1866,0.11679901957177845
STAT,1847,44,50-100,1891,0.9422632511718413
SIM,1827,49,na,1876,1978
STAT,1904,32,40-44,1936,3.5576568375781714
STAT,1904,17,50-100,1921,0.0699944979153147
SIM,1880,79,na,1959,2851
STAT,1885,68,na,1953,1502.140799241541
STAT,1927,27,25-29,1954,79.36670517901983
STAT,1902,22,20-24,1924,97.03984700272615
STAT,1930,29,na,1959,4725.267473156942
SIM,1912,32,40-44,1944,8
STAT,1864,40,35-39,1904,1.6628329202153096
STAT,1845,41,20-24,1886,0.08128407953918076
STAT,1832,50,40-44,1882,8.76278881238153E-4
STAT,1877,31,15-19,1908,0.14515169484406576
STAT,1856,87,na,1943,126.54247419986876
STAT,1822,38,50-100,1860,2.3891593913867712
STAT,1788,96,na,1884,0.6418014589831998
STAT,1928,22,40-44,1950,4.166152383095385
SIM,1894,26,15-19,1920,1
SIM,1877,26,15-19,1903,1
STAT,1908,27,15-19,1935,0.6678150134781823
STAT,1940,17,50-100,1957,0.37613469769742963
STAT,1850,21,35-39,1871,3.2575909808813814
SIM,1880,33,na,1913,3289
STAT,1937,32,35-39,1969,8.947609520870579
STAT,1797,59,na,1856,40.3689111882
STAT,1880,27,na,1907,2477.579726607848
SIM,1851,84,na,1935,149
STAT,1924,39,35-39,1963,2.818725140573625
SIM,1928,5,na,1933,4662
STAT,1853,42,25-29,1895,0.49730828351972933
STAT,1881,20,25-29,1901,54.38231677069455
STAT,1932,23,45-49,1955,1.4615241647958164
STAT,1872,18,na,1890,2522.413842947187
STAT,1843,53,20-24,1896,7.173909249217512E-4
STAT,1881,40,35-39,1921,1.7272928472279423
STAT,1815,71,na,1886,106.04481307607527
STAT,1834,41,45-49,1875,0.8054182199458652
STAT,1917,33,20-24,1950,2.509454959487971
STAT,1920,19,na,1939,4054.629646028016
STAT,1855,15,30-34,1870,1.269587338048572
STAT,1869,15,15-19,1884,6.1435304756556475
SIM,1900,27,na,1927,4149
STAT,1922,28,20-24,1950,20.35311619381747
SIM,1932,39,35-39,1971,6
STAT,1889,21,40-44,1910,2.516950751666975
STAT,1897,43,35-39,1940,0.16579169105833758
STAT,1923,49,na,1972,4227.557683441643
STAT,1814,42,30-34,1856,4.023634794874071
STAT,1895,32,20-24,1927,3.516334727723073
STAT,1880,47,45-49,1927,0.24386222739887947
SIM,1870,55,na,1925,1021
SIM,1925,20,15-19,1945,2
STAT,1840,32,30-34,1872,8.373512163438258
STAT,1831,49,15-19,1880,3.6761398013788484E-4
STAT,1814,78,na,1892,528.7939020241625
SIM,1916,27,15-19,1943,5
STAT,1926,41,50-100,1967,0.1437937937205612
STAT,1921,12,na,1933,4462.921279717459
SIM,1883,45,50-100,1928,1
STAT,1855,38,na,1893,1551.537630169732
STAT,1927,43,30-34,1970,0.15878007242010264
STAT,1907,39,35-39,1946,2.205079291978672
SIM,1915,39,35-39,1954,3
STAT,1879,19,35-39,1898,0.5598690502032
STAT,1923,30,40-44,1953,4.4747312196284605
STAT,1908,30,15-19,1938,0.1213273018255172
STAT,1817,107,na,1924,0.0014939642940024667
SIM,1825,36,na,1861,576
SIM,1804,66,na,1870,674
STAT,1934,33,20-24,1967,3.3056865057631657
STAT,1871,50,50-100,1921,0.015282151290491415
STAT,1877,39,na,1916,2367.529969606125
STAT,1953,17,25-29,1970,51.95221568012895
STAT,1860,32,15-19,1892,0.1161750651216524
STAT,1841,31,35-39,1872,13.825360831769368
STAT,1917,20,15-19,1937,5.615335957533372
STAT,1833,44,50-100,1877,0.5353078447852438
STAT,1843,31,45-49,1874,2.0929663422660556
SIM,1829,40,na,1869,2118
STAT,1845,93,na,1938,14.50213751075147
STAT,1886,42,20-24,1928,0.16425637524153996
SIM,1920,47,na,1967,3607
STAT,1929,32,na,1961,4770.377833449037
STAT,1934,17,15-19,1951,60.96988468681365
STAT,1820,46,35-39,1866,0.22293705400143388
SIM,1888,31,40-44,1919,1
STAT,1889,18,40-44,1907,0.21967936632227258
SIM,1822,42,30-34,1864,3
STAT,1934,20,15-19,1954,7.128531721472676
STAT,1860,31,45-49,1891,1.4284101174896817
STAT,1793,100,na,1893,0.17651119480987082
STAT,1917,17,15-19,1934,9.635741887468827
STAT,1897,33,50-100,1930,1.2116866963265653
STAT,1933,29,35-39,1962,19.780038769423687
SIM,1876,20,na,1896,3692
STAT,1843,39,40-44,1882,4.500380095262924
STAT,1881,33,30-34,1914,16.41846556069292
SIM,1916,34,na,1950,4631
STAT,1915,23,50-100,1938,0.6684826659386078
STAT,1908,43,20-24,1951,0.01611554565617468
SIM,1815,39,30-34,1854,1
STAT,1819,51,20-24,1870,1.3165556511849884E-4
STAT,1890,30,35-39,1920,12.35844652832072
STAT,1856,53,na,1909,1521.6893057870184
STAT,1843,35,na,1878,2522.317698007419
STAT,1860,108,na,1968,0.01685462381383718
STAT,1860,39,na,1899,1902.64377280716
STAT,1824,39,30-34,1863,0.8627056801327925
SIM,1810,60,na,1870,3098
STAT,1886,26,15-19,1912,0.47144404913851784
SIM,1951,19,na,1970,1843
STAT,1796,93,na,1889,12.785362456842243
STAT,1860,39,40-44,1899,3.5351906529625703
SIM,1830,37,na,1867,576
SIM,1889,60,na,1949,2729
STAT,1817,41,50-100,1858,0.7885359259532211
STAT,1879,48,na,1927,2278.9765056719352
STAT,1839,107,na,1946,0.00438143275642495
STAT,1850,49,25-29,1899,0.026042136442070013
STAT,1814,49,15-19,1863,0.0013309177084438082
SIM,1855,58,na,1913,2860
STAT,1819,35,15-19,1854,0.04251770333698004
STAT,1896,16,30-34,1912,2.10624463301259
STAT,1860,48,30-34,1908,0.07797643779000912
STAT,1891,22,35-39,1913,7.1760576039671715
STAT,1899,43,45-49,1942,0.14092881997116954
STAT,1849,15,50-100,1864,0.05141649848049768
STAT,1885,50,20-24,1935,7.357607908790929E-4
SIM,1926,32,25-29,1958,11
STAT,1829,25,30-34,1854,25.18933579018102
STAT,1869,42,20-24,1911,0.16005805268116777
SIM,1942,20,15-19,1962,22
STAT,1824,31,35-39,1855,4.68954968756763
STAT,1856,85,na,1941,196.89802898909036
STAT,1860,100,na,1960,1.9160553461648573
STAT,1847,32,50-100,1879,0.9726390961015589
STAT,1918,32,25-29,1950,9.689103727432974
STAT,1914,40,40-44,1954,0.24610647728894805
STAT,1846,53,30-34,1899,0.0034688570274767606
SIM,1884,71,na,1955,2918
STAT,1858,19,20-24,1877,15.629186634994994
STAT,1882,36,15-19,1918,0.0540217175858062
STAT,1884,49,na,1933,2108.742640267219
STAT,1871,84,na,1955,331.8460479783805
STAT,1942,30,na,1972,3987.2503797484055
STAT,1950,17,na,1967,4310.72006191036
STAT,1926,39,45-49,1965,0.8242484788313956
SIM,1837,25,30-34,1862,26
STAT,1857,47,50-100,1904,0.18758533651871456
STAT,1834,49,40-44,1883,0.07799263355077653
STAT,1882,46,50-100,1928,0.2358075653721066
SIM,1892,58,na,1950,3403
STAT,1921,32,40-44,1953,4.30329984508541
SIM,1900,59,na,1959,3838
SIM,1933,14,na,1947,4530
STAT,1831,29,50-100,1860,0.7055931561235127
STAT,1902,33,na,1935,3346.1282916259183
STAT,1868,56,na,1924,1970.0230565705765
STAT,1877,43,25-29,1920,0.6471577321090644
STAT,1936,33,30-34,1969,15.141905258986702
SIM,1935,24,20-24,1959,730
STAT,1768,102,na,1870,0.22168042401793167
STAT,1850,46,20-24,1896,0.005556872449587797
STAT,1927,24,20-24,1951,135.03128319933415
STAT,1850,15,na,1865,1310.6324164657613
STAT,1889,26,na,1915,2883.773490093781
STAT,1885,36,na,1921,2326.9523503970217
STAT,1868,50,20-24,1918,7.229771295726717E-4
SIM,1921,31,50-100,1952,31
STAT,1922,19,50-100,1941,0.4264579137238504
SIM,1905,48,na,1953,2896
STAT,1895,16,15-19,1911,7.739054458491309
STAT,1883,40,45-49,1923,1.4543609293737714
STAT,1865,23,45-49,1888,0.6397606658498692
STAT,1875,46,25-29,1921,0.05931461603353594
SIM,1896,48,na,1944,3238
STAT,1933,24,15-19,1957,7.008247012518636
STAT,1884,33,15-19,1917,0.13574765257627155
STAT,1951,17,15-19,1968,53.53964051005013
SIM,1941,24,15-19,1965,21
STAT,1834,22,35-39,1856,3.4395253528543868
STAT,1817,64,na,1881,625.3864328577828
SIM,1860,67,na,1927,1639
STAT,1832,43,na,1875,2150.7251548610175
STAT,1911,32,15-19,1943,0.12372356522084897
SIM,1899,70,na,1969,1469
STAT,1918,17,30-34,1935,2.625806628888896
STAT,1817,42,15-19,1859,0.01013552475285468
STAT,1852,43,20-24,1895,0.15870449292482378
STAT,1876,51,na,1927,2187.068979039614
STAT,1849,83,na,1932,334.49801804488754
STAT,1954,15,45-49,1969,0.6124149970376862
SIM,1948,13,na,1961,5824
STAT,1840,39,15-19,1879,0.025614530811665818
STAT,1854,19,30-34,1873,1.0476785083106137
SIM,1922,1,na,1923,3868
STAT,1863,33,na,1896,2028.6260041698752
STAT,1863,55,na,1918,1765.2324949780425
STAT,1860,50,na,1910,1781.7795213615825
STAT,1921,1,na,1922,4703.7494374268
STAT,1856,23,25-29,1879,47.41052233692234
STAT,1850,37,na,1887,1105.127426364413
STAT,1877,19,25-29,1896,5.721562350238273
STAT,1928,42,35-39,1970,0.2547536575905118
STAT,1886,83,na,1969,761.0820509145692
STAT,1915,46,30-34,1961,0.08877995418217781
SIM,1878,26,30-34,1904,39
STAT,1938,25,35-39,1963,14.727552081119171
STAT,1949,16,20-24,1965,156.16741941240048
STAT,1940,30,40-44,1970,4.009223617665167
SIM,1864,23,25-29,1887,5
STAT,1837,54,35-39,1891,0.0067132041757156395
SIM,1828,30,30-34,1858,13
STAT,1839,33,45-49,1872,1.973156622251717
STAT,1789,91,na,1880,32.06449300367701
STAT,1910,42,na,1952,3470.6911542339917
STAT,1826,53,20-24,1879,9.994568888451714E-4
STAT,1891,47,20-24,1938,0.008285226346727823
STAT,1887,21,30-34,1908,19.66469319980707
SIM,1814,44,na,1858,2424
STAT,1937,17,40-44,1954,1.3466528231019106
SIM,1908,47,na,1955,2054
SIM,1946,25,35-39,1971,13
STAT,1849,16,45-49,1865,0.06815154040593009
STAT,1909,12,na,1921,3833.4778117207015
STAT,1882,21,50-100,1903,0.3916014415846988
STAT,1865,14,na,1879,2445.7309899909815
STAT,1929,23,50-100,1952,0.8237045945727552
STAT,1856,46,15-19,1902,2.881168815181568E-4
STAT,1917,43,30-34,1960,0.13142897416128713
STAT,1854,15,15-19,1869,3.9941591896737343
STAT,1892,78,na,1970,1412.9209472336772
STAT,1844,52,25-29,1896,0.0034903524488297906
STAT,1862,25,15-19,1887,0.3934919126446116
STAT,1863,47,45-49,1910,0.20053680981729521
STAT,1893,44,20-24,1937,0.01360504407074621
SIM,1879,34,25-29,1913,5
STAT,1860,32,50-100,1892,0.7474659468716173
STAT,1874,43,40-44,1917,2.3046329779134154
SIM,1915,36,30-34,1951,2
SIM,1835,60,na,1895,1160
STAT,1828,29,30-34,1857,42.98540492273581
STAT,1878,15,25-29,1893,5.857411074226536
SIM,1846,52,na,1898,901
STAT,1817,41,45-49,1858,1.1170925649682362
STAT,1807,52,40-44,1859,0.03357183817322409
STAT,1834,45,25-29,1879,0.030351971137284207
STAT,1834,84,na,1918,146.60642066893968
STAT,1854,51,30-34,1905,0.0033255585187538703
STAT,1818,60,na,1878,1348.9648659765705
STAT,1822,33,na,1855,1658.9684754144214
SIM,1883,22,na,1905,2089
STAT,1819,45,na,1864,643.9073600615069
STAT,1849,33,35-39,1882,8.898751758581458
STAT,1860,44,50-100,1904,0.8502118847283674
SIM,1839,50,na,1889,674
SIM,1956,3,na,1959,4927
STAT,1902,32,30-34,1934,24.586083148424905
STAT,1855,30,25-29,1885,7.047191352786843
STAT,1846,20,30-34,1866,13.205599731108276
SIM,1930,34,40-44,1964,2
STAT,1893,23,na,1916,2948.4202165869083
STAT,1858,43,15-19,1901,0.010469891360411876
SIM,1820,59,na,1879,208
STAT,1901,39,40-44,1940,1.3078011043716007
STAT,1939,7,na,1946,3948.660018286591
STAT,1897,45,50-100,1942,0.18582106200890297
STAT,1869,21,50-100,1890,0.4127362499217923
STAT,1787,82,na,1869,77.17545546522736
STAT,1841,35,15-19,1876,0.07522073571418605
STAT,1881,20,na,1901,2246.754272014463
SIM,1812,61,na,1873,655
SIM,1836,29,30-34,1865,121
STAT,1841,43,45-49,1884,1.7097664017505767
STAT,1852,48,40-44,1900,0.17016254767833297
STAT,1884,17,50-100,1901,0.04689857317848128
STAT,1838,18,35-39,1856,0.30757361901503816
STAT,1907,36,30-34,1943,1.6865397203651535
STAT,1911,42,25-29,1953,0.06738831377026623
STAT,1869,101,na,1970,4.63996365600373
SIM,1854,20,30-34,1874,51
STAT,1862,20,15-19,1882,2.918233144685375
STAT,1902,33,50-100,1935,1.2847759998455894
STAT,1868,26,20-24,1894,11.369952160838682
SIM,1832,38,na,1870,2179
SIM,1908,49,45-49,1957,1
STAT,1928,25,45-49,1953,2.1265468097103994
STAT,1913,29,50-100,1942,0.9723325416253814
STAT,1850,46,15-19,1896,1.8522891871925842E-4
SIM,1857,33,35-39,1890,101
STAT,1890,80,na,1970,1193.814052146703
SIM,1898,21,na,1919,4059
STAT,1883,16,45-49,1899,0.06299741506389281
STAT,1819,54,25-29,1873,6.013513172627072E-4
SIM,1913,4,na,1917,3719
STAT,1951,13,na,1964,4633.330086493773
STAT,1788,98,na,1886,0.240524308145214
STAT,1875,23,35-39,1898,5.973659865247636
STAT,1907,34,15-19,1941,0.11828957341468983
SIM,1920,16,25-29,1936,229
STAT,1842,23,50-100,1865,0.12676625149912027
SIM,1876,42,na,1918,3660
STAT,1906,33,45-49,1939,1.443839056866252
SIM,1840,90,na,1930,327
STAT,1901,46,na,1947,3155.2794836763924
STAT,1917,24,30-34,1941,29.950150054714886
STAT,1812,54,30-34,1866,0.0014068027733992589
STAT,1935,20,50-100,1955,0.8901926388197815
STAT,1854,72,na,1926,702.1918938990052
STAT,1830,62,na,1892,1322.861218608442
SIM,1901,16,15-19,1917,10
STAT,1909,34,na,1943,3541.7872933921767
STAT,1798,74,na,1872,691.1675637831228
STAT,1879,16,30-34,1895,1.6390705043573055
STAT,1856,31,na,1887,1753.0703930847371
STAT,1943,13,na,1956,4117.261536849311
STAT,1782,113,na,1895,1.4244839706930386E-4
SIM,1821,46,na,1867,1899
STAT,1912,16,25-29,1928,8.682352385554154
STAT,1908,46,25-29,1954,0.04796030867479585
STAT,1913,31,35-39,1944,9.01462641924561
STAT,1857,50,45-49,1907,0.011296299525209845
STAT,1835,69,na,1904,1110.4242135538423
STAT,1897,24,25-29,1921,75.54921493068466
STAT,1905,21,35-39,1926,8.418630904846431
STAT,1868,40,50-100,1908,1.0306922557478482
SIM,1847,37,na,1884,1517
STAT,1822,43,35-39,1865,3.157067458900297
SIM,1863,24,na,1887,1274
SIM,1899,37,na,1936,1799
SIM,1909,40,na,1949,3844
STAT,1853,41,50-100,1894,0.822867362246277
STAT,1867,54,20-24,1921,6.786815126076375E-4
SIM,1941,26,30-34,1967,16
SIM,1859,70,na,1929,581
SIM,1878,7,na,1885,4386
STAT,1841,54,na,1895,2331.7572787118834
STAT,1860,35,25-29,1895,2.371133599815353
STAT,1933,26,30-34,1959,51.69661151580111
STAT,1848,53,40-44,1901,0.00969333000642162
STAT,1889,72,na,1961,1706.3232479873607
STAT,1843,80,na,1923,611.2008086959736
STAT,1911,28,45-49,1939,1.6599501301313715
SIM,1921,31,35-39,1952,92
SIM,1838,33,25-29,1871,8
STAT,1904,29,50-100,1933,0.9073939151576914
STAT,1865,36,15-19,1901,0.05151537196734058
STAT,1904,48,20-24,1952,0.009549327750024986
STAT,1872,43,30-34,1915,1.1429150762118547
STAT,1896,19,35-39,1915,0.7194450629460444
STAT,1877,52,20-24,1929,7.450892625806693E-4
STAT,1844,12,na,1856,3006.3327215112
STAT,1901,35,25-29,1936,0.8771722503431161
SIM,1853,46,na,1899,3151
SIM,1898,7,na,1905,4434
STAT,1891,47,15-19,1938,2.7617396862556143E-4
SIM,1895,63,na,1958,4215
SIM,1837,28,35-39,1865,2
STAT,1892,42,45-49,1934,1.8506996484945777
SIM,1891,73,na,1964,675
SIM,1834,64,na,1898,44
SIM,1902,31,25-29,1933,42
STAT,1916,14,na,1930,4119.5560667251675
STAT,1914,43,45-49,1957,0.16236244524321972
STAT,1899,40,40-44,1939,0.21549340994365684
SIM,1887,69,na,1956,2002
STAT,1866,40,45-49,1906,1.3799462232554247
STAT,1869,71,na,1940,1346.923117495398
SIM,1884,19,15-19,1903,76
SIM,1885,56,na,1941,1103
SIM,1845,30,30-34,1875,51
STAT,1829,28,35-39,1857,6.431250694100357
STAT,1867,71,na,1938,1262.3610689335324
SIM,1902,50,na,1952,3110
STAT,1865,81,na,1946,493.71316324453056
STAT,1872,51,25-29,1923,0.0035637988116358314
STAT,1878,31,30-34,1909,18.037177342285393
STAT,1849,28,50-100,1877,0.634345927146968
STAT,1836,18,25-29,1854,13.740707216095284
STAT,1867,17,15-19,1884,5.737641481658777
SIM,1949,8,na,1957,4496
STAT,1805,52,30-34,1857,0.006971910157521652
STAT,1820,84,na,1904,228.7765007115883
STAT,1799,82,na,1881,34.205417302058066
STAT,1909,63,na,1972,3002.027789433949
STAT,1921,47,45-49,1968,0.242104628177746
STAT,1831,110,na,1941,2.162760154163519E-4
STAT,1878,34,na,1912,2434.1815591730488
STAT,1853,46,40-44,1899,0.13312343706478996
STAT,1846,24,na,1870,1540.1189505920615
STAT,1912,35,35-39,1947,2.3554721678431223
STAT,1915,49,35-39,1964,0.127331583350735
STAT,1833,46,20-24,1879,0.006103891370616167
STAT,1852,41,na,1893,2336.9927500694557
SIM,1849,27,na,1876,2476
STAT,1808,50,na,1858,761.8008574710856
STAT,1926,43,na,1969,4532.080204146246
SIM,1854,47,45-49,1901,4
STAT,1831,50,25-29,1881,0.0030569009031672107
STAT,1873,30,35-39,1903,10.471639291617725
STAT,1884,49,30-34,1933,0.09072921519160192
STAT,1867,93,na,1960,51.386121328057335
STAT,1871,19,30-34,1890,1.5814277105939454
STAT,1879,81,na,1960,725.8301218670852
STAT,1837,30,30-34,1867,17.921015811608477
SIM,1887,34,na,1921,3458
STAT,1915,48,50-100,1963,0.22406834816714694
STAT,1916,36,na,1952,3818.445617822749
STAT,1831,52,50-100,1883,0.012528006139751968
STAT,1859,42,na,1901,1829.6162387941888
STAT,1821,40,20-24,1861,0.1856625835469778
STAT,1851,46,50-100,1897,0.19452378129157297
STAT,1862,48,40-44,1910,0.1439858542168786
SIM,1883,44,na,1927,2156
STAT,1885,48,35-39,1933,0.1358837994981765
SIM,1874,19,na,1893,2705
STAT,1907,19,20-24,1926,25.728921688900865
STAT,1796,101,na,1897,0.22346748061416144
SIM,1929,25,35-39,1954,1
SIM,1829,75,na,1904,1137
STAT,1806,51,35-39,1857,0.023283952701890105
SIM,1870,26,na,1896,2468
STAT,1918,48,na,1966,3846.0358721115
STAT,1922,30,25-29,1952,10.409553113543513
SIM,1902,53,na,1955,2972
STAT,1825,51,45-49,1876,0.018157197590900932
STAT,1951,10,na,1961,4635.369352823098
STAT,1855,18,35-39,1873,0.42939339702045237
STAT,1837,51,30-34,1888,0.004886072166076543
STAT,1856,33,45-49,1889,1.2547445390793175
STAT,1908,0,na,1908,4322.0599994640625
STAT,1862,106,na,1968,0.10058361500813437
STAT,1897,47,15-19,1944,2.98255509639651E-4
STAT,1920,21,25-29,1941,101.6745754132826
STAT,1932,20,40-44,1952,4.4071554675417515
STAT,1871,28,50-100,1899,0.6358748805092239
STAT,1920,52,na,1972,3941.372865651863
STAT,1859,1,na,1860,2920.657749185453
STAT,1926,36,40-44,1962,1.815482946171413
SIM,1880,30,25-29,1910,73
STAT,1949,19,25-29,1968,49.869777285723444
STAT,1827,42,na,1869,1892.4116340636183
STAT,1860,52,45-49,1912,0.011776088045630463
STAT,1882,20,40-44,1902,2.006963624330702
STAT,1892,36,50-100,1928,1.527376876648672
SIM,1821,50,50-100,1871,2
STAT,1892,30,45-49,1922,2.1763699717415292
SIM,1915,26,na,1941,3395
STAT,1891,43,40-44,1934,2.7460182040078016
SIM,1893,51,na,1944,2792
STAT,1884,36,25-29,1920,2.769441609762935
STAT,1912,42,40-44,1954,0.2384349548803298
STAT,1872,30,25-29,1902,10.338973551151302
STAT,1830,94,na,1924,14.465369970015665
STAT,1945,22,40-44,1967,3.6444043777915107
SIM,1873,31,na,1904,2226
SIM,1865,34,na,1899,1769
SIM,1836,20,na,1856,2355
STAT,1841,86,na,1927,247.0735580463788
SIM,1924,46,25-29,1970,1
STAT,1878,52,30-34,1930,0.006091791727247216
STAT,1831,79,na,1910,547.154754504139
SIM,1849,49,na,1898,2146
STAT,1865,99,na,1964,6.269015416499627
STAT,1868,29,25-29,1897,40.56569196232703
SIM,1838,57,na,1895,1518
STAT,1838,50,35-39,1888,0.0038031746649322454
STAT,1863,23,35-39,1886,5.044621080386062
STAT,1894,47,40-44,1941,0.1222328843610231
STAT,1874,47,20-24,1921,0.012327060041443554
SIM,1904,31,na,1935,4041
STAT,1898,54,na,1952,2815.8563133233015
STAT,1815,49,30-34,1864,0.009554829846303294
STAT,1897,28,40-44,1925,3.9642609574739907
SIM,1841,21,na,1862,1162
STAT,1891,11,na,1902,3180.524696337986
SIM,1886,19,na,1905,3126
STAT,1873,42,35-39,1915,1.8552089966259082
STAT,1841,52,40-44,1893,0.011660813542119826
STAT,1911,25,40-44,1936,4.524805629312323
STAT,1910,20,na,1930,3564.7767054019173
SIM,1940,25,na,1965,3411
STAT,1790,69,na,1859,927.8441063105209
SIM,1881,30,35-39,1911,8
STAT,1892,43,15-19,1935,0.016974353677118758
STAT,1836,51,20-24,1887,5.835758500355488E-4
STAT,1875,45,50-100,1920,0.25470918085512867
STAT,1888,41,35-39,1929,2.099432180684387
STAT,1852,49,na,1901,2217.378137039415
STAT,1941,30,35-39,1971,9.496226831580229
SIM,1917,42,25-29,1959,1
STAT,1915,40,35-39,1955,0.2004215154783179
STAT,1945,25,na,1970,4068.0480004287588
STAT,1868,41,15-19,1909,0.013398865572810541
SIM,1913,48,na,1961,2905
SIM,1859,29,25-29,1888,186
STAT,1858,15,50-100,1873,0.04422317709412985
STAT,1841,40,40-44,1881,2.670264462566016
SIM,1903,42,40-44,1945,7
STAT,1872,37,45-49,1909,1.9961970371130224
SIM,1865,5,na,1870,2114
STAT,1857,47,20-24,1904,0.00916540768464376
STAT,1851,41,45-49,1892,1.1873837277627284
SIM,1876,71,na,1947,1427
STAT,1935,18,na,1953,4982.526528796121
STAT,1930,40,na,1970,4865.741888668323
SIM,1819,65,na,1884,1387
STAT,1845,61,na,1906,927.2487588577684
SIM,1890,32,35-39,1922,64
STAT,1822,40,30-34,1862,2.1443690409833662
SIM,1869,31,30-34,1900,9
SIM,1810,44,50-100,1854,10
STAT,1822,46,45-49,1868,0.4001530383578053
SIM,1860,19,20-24,1879,9
SIM,1899,18,15-19,1917,9
STAT,1881,53,50-100,1934,0.014033252059648208
STAT,1870,37,35-39,1907,7.051229752982338
STAT,1852,19,20-24,1871,21.329743240744094
SIM,1838,40,40-44,1878,1
STAT,1894,70,na,1964,2021.87934619473
STAT,1847,104,na,1951,0.06030463804285277
STAT,1909,42,25-29,1951,0.06611193351378944
STAT,1858,46,25-29,1904,0.044111950686384245
STAT,1850,42,40-44,1892,1.0373506216028703
STAT,1830,103,na,1933,0.10387220036901673
SIM,1840,41,35-39,1881,4
STAT,1930,38,20-24,1968,0.34108424890453193
STAT,1897,31,40-44,1928,5.782921247964862
STAT,1852,22,20-24,1874,82.40413787395433
STAT,1853,17,50-100,1870,0.04569678963138673
STAT,1917,19,50-100,1936,0.39435919898851807
STAT,1919,32,40-44,1951,4.165956581756738
STAT,1925,38,50-100,1963,0.4988036472632469
STAT,1841,16,40-44,1857,0.26424294147383215
SIM,1847,45,50-100,1892,2
STAT,1867,4,na,1871,2831.839234261402
STAT,1906,23,na,1929,3414.1767096166204
STAT,1887,41,25-29,1928,0.7100031552783445
SIM,1904,63,na,1967,3873
STAT,1831,42,30-34,1873,1.123589153548336
STAT,1902,47,35-39,1949,0.11068632319728923
STAT,1821,47,40-44,1868,0.18309946181068432
STAT,1925,43,20-24,1968,0.021152160688587496
STAT,1899,29,50-100,1928,0.8674901640780164
STAT,1921,48,15-19,1969,4.092057188178739E-4
STAT,1899,17,na,1916,3449.6428077713563
STAT,1906,30,40-44,1936,3.6348892539121596
STAT,1877,40,20-24,1917,0.16284105105001273
STAT,1832,41,35-39,1873,0.15738027964521437
STAT,1934,33,na,1967,5125.646110953664
STAT,1852,46,50-100,1898,0.2479198925348198
STAT,1932,40,35-39,1972,0.27177054081010754
STAT,1843,44,15-19,1887,0.01369338594927762
SIM,1927,26,na,1953,1694
SIM,1952,18,na,1970,6372
STAT,1912,32,30-34,1944,15.322869521802646
STAT,1830,30,20-24,1860,2.5922761071584155
STAT,1839,46,15-19,1885,3.8352118669176416E-4
STAT,1880,59,na,1939,2017.615958805178
STAT,1931,0,na,1931,5855.3391073492285
SIM,1810,51,na,1861,3098
STAT,1873,54,45-49,1927,0.014477168621503117
STAT,1851,42,15-19,1893,0.010893472681787244
STAT,1815,41,35-39,1856,0.19566099778760215
STAT,1826,29,20-24,1855,37.044814878901875
STAT,1921,15,na,1936,4165.099828417728
STAT,1812,45,40-44,1857,0.04608457579164729
STAT,1935,32,25-29,1967,12.6951045983593
STAT,1802,53,25-29,1855,0.017620041171504598
STAT,1901,32,20-24,1933,3.7794577885490326
STAT,1868,53,50-100,1921,0.014353090779861504
STAT,1879,51,35-39,1930,0.008873771378385388
STAT,1870,60,na,1930,1901.3306048894801
SIM,1896,47,50-100,1943,1
SIM,1861,12,na,1873,2632
STAT,1899,47,25-29,1946,0.04417176713442633
SIM,1860,22,20-24,1882,115
STAT,1882,17,40-44,1899,0.1751132645199651
SIM,1916,43,20-24,1959,1
STAT,1813,53,35-39,1866,0.029322413221189995
STAT,1865,67,na,1932,1447.2897217420762
STAT,1833,57,na,1890,826.8369502152497
SIM,1869,15,na,1884,3761
SIM,1799,57,na,1856,1587
STAT,1917,5,na,1922,4255.047650058957
SIM,1848,64,na,1912,2308
STAT,1833,49,25-29,1882,0.025651269982405557
STAT,1914,46,15-19,1960,3.6114979771948135E-4
STAT,1882,32,35-39,1914,9.695756896831428
STAT,1878,88,na,1966,330.0319376610488
STAT,1894,40,20-24,1934,0.2039937562172624
STAT,1933,25,50-100,1958,1.3137938141768966
STAT,1837,33,35-39,1870,10.075816991660687
STAT,1890,4,na,1894,3184.7297018137183
STAT,1913,40,25-29,1953,0.06954304568942045
SIM,1948,10,na,1958,5824
STAT,1838,34,na,1872,1124.8751029936427
STAT,1822,41,50-100,1863,1.926389402446852
STAT,1925,46,25-29,1971,0.06384849233029431
SIM,1810,101,na,1911,43
SIM,1918,27,25-29,1945,125
STAT,1932,8,na,1940,5244.512007828346
STAT,1875,42,45-49,1917,1.5349362084698404
STAT,1888,22,50-100,1910,0.4706568880848661
STAT,1882,37,na,1919,2255.636712695394
STAT,1902,38,45-49,1940,0.6028932140717506
STAT,1834,48,50-100,1882,0.11332931054663248
STAT,1791,87,na,1878,74.60574070040936
STAT,1868,6,na,1874,2695.873324301918
STAT,1908,34,30-34,1942,14.630229105858342
STAT,1808,51,45-49,1859,0.019084448737677798
SIM,1878,52,na,1930,3678
STAT,1841,39,30-34,1880,6.8486813781036
STAT,1828,27,na,1855,1897.1969499059817
STAT,1922,40,35-39,1962,0.229184370510881
STAT,1883,9,na,1892,2496.1491139535683
STAT,1917,46,40-44,1963,0.16288530803400283
STAT,1897,34,45-49,1931,2.2960587495768685
STAT,1884,45,15-19,1929,3.86726071464232E-4
STAT,1923,33,45-49,1956,1.7838642856420868
STAT,1836,54,25-29,1890,0.00263958193102834
STAT,1915,24,20-24,1939,112.6076390857967
STAT,1856,27,40-44,1883,2.2295237089719606
STAT,1936,17,25-29,1953,41.077148104357214
SIM,1913,45,na,1958,2898
SIM,1921,38,20-24,1959,1
SIM,1904,34,na,1938,4085
STAT,1846,40,25-29,1886,0.39491936849902437
STAT,1878,34,35-39,1912,10.330219656812107
STAT,1846,44,40-44,1890,1.3141764186682845
STAT,1913,38,20-24,1951,0.25560765694500753
STAT,1876,19,15-19,1895,5.967112109622765
SIM,1916,34,30-34,1950,1
SIM,1797,79,na,1876,564
SIM,1911,21,25-29,1932,381
SIM,1912,5,na,1917,4905
STAT,1832,72,na,1904,1072.0391667696972
STAT,1912,45,45-49,1957,0.207417794719755
SIM,1956,0,na,1956,4937
STAT,1864,23,50-100,1887,0.37398172243862904
STAT,1858,50,50-100,1908,0.011699170859384746
STAT,1894,31,15-19,1925,0.18183399862390215
SIM,1850,57,na,1907,1110
SIM,1886,34,35-39,1920,38
STAT,1857,19,na,1876,2045.975670727725
STAT,1802,52,20-24,1854,0.003748649824769059
STAT,1882,41,40-44,1923,2.1632237515542863
STAT,1820,39,na,1859,1920.8163757557277
STAT,1915,35,50-100,1950,0.4221187326304831
SIM,1903,38,na,1941,2747
STAT,1827,40,15-19,1867,0.013464552109116004
STAT,1917,2,na,1919,4328.147505265194
STAT,1921,44,40-44,1965,0.2774546113928742
SIM,1852,83,na,1935,1138
STAT,1863,41,30-34,1904,0.9859268975198028
STAT,1893,23,20-24,1916,85.91070376801315
STAT,1842,35,50-100,1877,0.36503297648611166
SIM,1887,37,na,1924,3655
SIM,1814,76,na,1890,26
SIM,1906,49,35-39,1955,1
STAT,1850,25,15-19,1875,0.250121343177498
STAT,1871,31,20-24,1902,2.7074383021973345
STAT,1847,52,35-39,1899,0.0077421603097419
STAT,1826,32,20-24,1858,5.361422280919532
STAT,1903,21,25-29,1924,81.50612110897352
STAT,1873,34,50-100,1907,0.931819261045829
STAT,1890,66,na,1956,2010.446245261284
SIM,1852,16,na,1868,2417
STAT,1856,30,40-44,1886,3.219162717352067
STAT,1888,47,50-100,1935,0.28214108756478323
STAT,1817,45,25-29,1862,0.04143650623381421
SIM,1825,50,na,1875,14
STAT,1824,52,40-44,1876,0.001775245531280919
STAT,1819,108,na,1927,4.2604492267759914E-4
SIM,1834,29,20-24,1863,2
SIM,1897,44,na,1941,2306
SIM,1915,6,na,1921,3823
STAT,1878,19,40-44,1897,0.18717414051384218
STAT,1893,77,na,1970,1520.5409564948507
STAT,1791,65,na,1856,1020.0253764400004
STAT,1863,20,30-34,1883,15.73475547570518
SIM,1904,31,35-39,1935,53
SIM,1859,26,20-24,1885,73
STAT,1818,68,na,1886,1001.0454001537771
SIM,1932,36,30-34,1968,19
STAT,1874,41,na,1915,2396.1463155241645
STAT,1854,54,35-39,1908,0.004655155564541137
STAT,1833,101,na,1934,0.23477577259155702
STAT,1867,33,20-24,1900,2.545576060384757
SIM,1875,33,20-24,1908,1
STAT,1947,15,35-39,1962,4.679491488469572
STAT,1902,42,15-19,1944,0.0013487392049257732
SIM,1829,72,na,1901,1463
STAT,1815,50,40-44,1865,0.0010719101428933596
STAT,1945,25,45-49,1970,1.876061115829907
STAT,1832,94,na,1926,16.965669926122068
STAT,1835,83,na,1918,300.38224151015845
SIM,1903,16,na,1919,2994
STAT,1838,21,50-100,1859,0.22748145877693268
SIM,1861,75,na,1936,1395
STAT,1845,29,30-34,1874,14.991856598886573
STAT,1851,46,30-34,1897,0.07666898240092271
STAT,1885,33,na,1918,2335.7243902626697
STAT,1793,103,na,1896,0.023861089950377425
STAT,1910,35,25-29,1945,0.9399820948851451
SIM,1863,6,na,1869,1723
SIM,1872,38,na,1910,2262
SIM,1898,29,na,1927,4247
SIM,1852,61,na,1913,1806
STAT,1821,43,25-29,1864,0.7101532489952012
STAT,1899,24,35-39,1923,7.920594702641111
STAT,1832,53,45-49,1885,0.0011385711268264269
STAT,1895,39,50-100,1934,1.5810623006065612
STAT,1924,36,30-34,1960,2.1304317571694433
STAT,1902,44,30-34,1946,0.11090346782506101
SIM,1863,53,na,1916,356
STAT,1882,23,45-49,1905,0.6655598733533284
STAT,1842,31,na,1873,656.7113853332069
STAT,1916,43,20-24,1959,0.017822853754592406
STAT,1889,58,na,1947,2381.4723571505324
STAT,1897,40,30-34,1937,0.10709528756249743
STAT,1839,23,25-29,1862,67.84570701795492
STAT,1935,36,40-44,1971,2.080096020871379
SIM,1928,22,na,1950,2643
SIM,1927,29,na,1956,1659
STAT,1807,76,na,1883,443.65329986751436
SIM,1947,9,na,1956,4379
STAT,1816,87,na,1903,148.7364790696026
STAT,1913,44,40-44,1957,0.24005597979655913
STAT,1849,52,45-49,1901,0.01216294606738061
SIM,1918,15,na,1933,4461
STAT,1803,69,na,1872,523.4288859345753
STAT,1858,23,35-39,1881,4.619450316481337
STAT,1924,34,15-19,1958,0.1482916617183184
STAT,1889,40,na,1929,2811.336761502003
STAT,1880,26,50-100,1906,0.6663785158264811
STAT,1912,33,35-39,1945,8.850135777395245
SIM,1887,66,na,1953,2486
STAT,1891,26,15-19,1917,0.5598457290414406
SIM,1920,33,35-39,1953,3
SIM,1930,15,na,1945,5546
SIM,1874,40,45-49,1914,1
STAT,1880,44,35-39,1924,1.8545292083239289
STAT,1865,53,40-44,1918,0.00945732461089497
STAT,1857,30,na,1887,1881.1316801729279
STAT,1876,22,na,1898,2390.84663242633
STAT,1887,45,40-44,1932,0.19031386833926317
STAT,1934,24,30-34,1958,38.337265762710764
STAT,1890,37,na,1927,2852.1630831880916
STAT,1844,97,na,1941,5.322220768797929
STAT,1843,35,25-29,1878,3.3907139442249425
STAT,1909,46,40-44,1955,0.14375712249564998
STAT,1861,23,na,1884,2006.1400332504134
STAT,1863,89,na,1952,89.68548325476257
SIM,1929,19,15-19,1948,76
STAT,1804,51,50-100,1855,0.09734239711018697
STAT,1805,95,na,1900,1.7837684977151624
STAT,1939,10,na,1949,3925.8803838474582
SIM,1886,81,na,1967,1187
STAT,1824,35,15-19,1859,0.008697118387558097
SIM,1920,32,30-34,1952,32
STAT,1856,51,40-44,1907,0.007597700682984921
SIM,1801,77,na,1878,1570
STAT,1841,19,45-49,1860,0.09271469750094523
STAT,1844,47,35-39,1891,0.13804983546909444
SIM,1805,62,na,1867,2097
STAT,1853,30,15-19,1883,0.11609725050824649
SIM,1876,74,na,1950,348
STAT,1868,53,25-29,1921,0.0033661971624092514
STAT,1819,39,30-34,1858,1.2146658760824183
STAT,1881,52,na,1933,2022.5145908052348
STAT,1932,29,na,1961,4867.720666417963
STAT,1841,22,45-49,1863,0.983687250833798
STAT,1902,46,50-100,1948,0.1956388132855928
STAT,1953,19,50-100,1972,0.44885362855219985
SIM,1825,39,na,1864,520
STAT,1919,35,45-49,1954,0.7266801517667361
STAT,1854,109,na,1963,0.0019281478708960426
STAT,1956,11,na,1967,5153.22756091004
SIM,1821,55,na,1876,1823
STAT,1916,25,20-24,1941,18.742782797492985
SIM,1898,52,na,1950,4037
STAT,1941,17,25-29,1958,44.12857435685554
STAT,1829,74,na,1903,405.2609093103585
STAT,1916,27,15-19,1943,0.7199744658482502
STAT,1825,84,na,1909,204.85820185379308
SIM,1936,31,na,1967,3797
SIM,1928,36,na,1964,4585
STAT,1848,17,45-49,1865,0.07577613964095506
SIM,1910,26,na,1936,4320
STAT,1911,47,na,1958,3438.804092664681
STAT,1861,38,40-44,1899,3.622462406602224
SIM,1919,45,35-39,1964,1
SIM,1903,35,30-34,1938,4
STAT,1920,27,35-39,1947,16.257722992013484
STAT,1841,23,na,1864,2994.52618411197
STAT,1856,76,na,1932,680.4760427796455
STAT,1931,15,45-49,1946,0.6522709770705725
SIM,1924,25,20-24,1949,12
STAT,1865,16,35-39,1881,0.5192955478122505
STAT,1922,24,35-39,1946,10.610606409688002
SIM,1933,18,25-29,1951,650
STAT,1830,42,50-100,1872,0.9339316102881177
STAT,1850,21,50-100,1871,0.22764439987146382
STAT,1876,16,50-100,1892,0.049647921100789
STAT,1920,2,na,1922,4529.5630136088885
STAT,1860,81,na,1941,441.15144852812995
STAT,1872,15,na,1887,2567.515142679059
SIM,1893,29,na,1922,3379
SIM,1907,28,25-29,1935,3
SIM,1912,28,35-39,1940,145
STAT,1844,106,na,1950,0.012028637315189725
STAT,1883,78,na,1961,942.7209570413327
SIM,1855,30,25-29,1885,4
STAT,1926,8,na,1934,4848.0649584259545
STAT,1900,33,15-19,1933,0.1964427731121756
STAT,1911,21,25-29,1932,86.8774804563077
STAT,1877,15,15-19,1892,6.052272945847479
SIM,1837,30,na,1867,2223
STAT,1807,54,50-100,1861,0.0461769048828684
STAT,1862,51,30-34,1913,0.0050942887727063145
SIM,1866,101,na,1967,6
STAT,1816,48,na,1864,2482.7025072789834
SIM,1903,33,35-39,1936,1
STAT,1904,28,35-39,1932,13.736860280898421
STAT,1908,47,50-100,1955,0.20296778794205034
STAT,1847,30,25-29,1877,11.101187234070974
STAT,1911,36,25-29,1947,0.9448152028792608
STAT,1903,4,na,1907,3734.2907543411206
STAT,1931,33,45-49,1964,2.0461391665070203
STAT,1925,18,25-29,1943,51.733881644293774
STAT,1870,53,50-100,1923,0.014814684208755508
SIM,1906,29,20-24,1935,1
STAT,1859,17,20-24,1876,16.310850920302894
STAT,1813,50,50-100,1863,0.05466360619591317
STAT,1921,25,30-34,1946,43.44415678535364
STAT,1835,31,45-49,1866,1.6973220772633266
STAT,1902,29,40-44,1931,4.18808603640834
STAT,1928,42,30-34,1970,0.1617406442172771
STAT,1777,100,na,1877,0.5565103552944828
SIM,1920,32,25-29,1952,19
STAT,1896,25,25-29,1921,56.14125818096154
SIM,1888,22,na,1910,517
STAT,1848,18,50-100,1866,0.056497363633852396
STAT,1904,26,40-44,1930,4.294436939734782
STAT,1923,16,50-100,1939,0.43637618102634
STAT,1850,51,na,1901,999.0073962315901
SIM,1907,26,30-34,1933,15
STAT,1926,45,30-34,1971,0.10956545162660465
STAT,1929,41,35-39,1970,0.2593223047602061
SIM,1851,53,na,1904,1100
STAT,1798,97,na,1895,2.280344646662406
STAT,1839,24,40-44,1863,2.451932813458459
STAT,1889,18,45-49,1907,0.07845689746490889
STAT,1909,48,35-39,1957,0.11694084817306657
STAT,1862,17,na,1879,2239.2029641733984
SIM,1800,61,na,1861,216
STAT,1873,20,25-29,1893,59.07174716722886
SIM,1852,47,na,1899,1950
STAT,1843,54,25-29,1897,0.003403428649871079
STAT,1870,46,40-44,1916,0.1711595299450319
STAT,1811,43,25-29,1854,3.293064219209754
STAT,1903,28,45-49,1931,1.570539904568651
STAT,1867,48,na,1915,2101.00690459242
STAT,1856,37,50-100,1893,0.8818306042999041
STAT,1892,49,25-29,1941,0.039387237863048215
STAT,1907,32,15-19,1939,0.11931106714258666
STAT,1912,32,25-29,1944,8.989039518581146
SIM,1806,49,50-100,1855,1
SIM,1867,60,na,1927,1495
STAT,1936,19,40-44,1955,1.3187229062100894
STAT,1871,0,na,1871,3712.5068484686776
SIM,1842,37,na,1879,3114
STAT,1915,27,25-29,1942,66.18686485438042
SIM,1851,73,na,1924,865
SIM,1797,76,na,1873,564
SIM,1869,31,50-100,1900,9
STAT,1888,19,40-44,1907,0.20996798450915377
STAT,1900,15,15-19,1915,8.259242863747147
STAT,1826,58,na,1884,1673.793818744552
STAT,1855,35,na,1890,1574.0802088846883
STAT,1898,20,30-34,1918,24.09539038510565
STAT,1911,5,na,1916,3965.180297896803
STAT,1854,2,na,1856,1991.9530032298264
STAT,1835,48,40-44,1883,0.13479968814357166
STAT,1914,28,20-24,1942,18.082020521837297
STAT,1927,44,35-39,1971,0.24965287630430735
STAT,1922,22,40-44,1944,3.8128418798764527
STAT,1942,17,15-19,1959,46.88554595449475
STAT,1905,25,45-49,1930,1.6078061637483165
STAT,1925,44,50-100,1969,0.1404616101193637
STAT,1940,5,na,1945,4020.1072045088385
STAT,1864,71,na,1935,1213.475449164411
STAT,1835,94,na,1929,15.122567995156514
STAT,1918,39,45-49,1957,0.7073464429994227
STAT,1912,21,50-100,1933,0.6251523738385304
STAT,1940,20,35-39,1960,9.490870564154912
SIM,1893,39,40-44,1932,76
STAT,1937,35,35-39,1972,2.3977811850190878
STAT,1930,26,na,1956,4732.078400020541
STAT,1906,24,50-100,1930,0.5868129302370492
SIM,1904,31,30-34,1935,37
SIM,1814,73,na,1887,871
SIM,1854,42,na,1896,1592
SIM,1942,21,20-24,1963,282
SIM,1921,31,30-34,1952,125
STAT,1796,62,na,1858,1607.5549097415908
STAT,1874,81,na,1955,558.1049364555867
STAT,1874,21,25-29,1895,59.25965024026225
STAT,1913,19,45-49,1932,0.10031300127702837
SIM,1925,21,20-24,1946,15
STAT,1874,10,na,1884,2731.928158400364
STAT,1930,19,45-49,1949,0.6378544798258091
SIM,1916,11,na,1927,4884
STAT,1937,33,40-44,1970,3.8292618797567717
STAT,1864,18,40-44,1882,0.1709980630110734
STAT,1816,56,na,1872,2151.2594251646046
STAT,1810,47,25-29,1857,3.024657798429566E-4
STAT,1782,82,na,1864,497.9968808208938
STAT,1905,43,45-49,1948,0.14840447316997882
SIM,1865,65,na,1930,1523
SIM,1943,13,na,1956,4985
STAT,1837,23,50-100,1860,0.42496625993080767
STAT,1799,106,na,1905,8.074068149136518E-4
STAT,1908,33,15-19,1941,0.11985191389555723
STAT,1934,21,20-24,1955,148.46983441316803
STAT,1829,34,25-29,1863,5.3821385247190925
STAT,1920,45,35-39,1965,0.141349841549308
SIM,1842,17,na,1859,3413
SIM,1881,3,na,1884,4260
STAT,1885,39,40-44,1924,4.259557176421136
SIM,1879,14,na,1893,1848
STAT,1917,21,20-24,1938,116.95367747021169
STAT,1805,64,na,1869,341.8592348221651
STAT,1871,53,na,1924,2113.392216313869
STAT,1864,51,na,1915,1966.8236861727448
STAT,1942,15,20-24,1957,140.13741277806633
STAT,1821,53,35-39,1874,0.008710932414944111
STAT,1807,51,na,1858,1359.2810992105753
STAT,1873,88,na,1961,245.09749360243947
STAT,1841,15,na,1856,3335.9103128125525
SIM,1929,30,50-100,1959,7
STAT,1847,18,40-44,1865,0.20517709806014087
STAT,1890,12,na,1902,3126.4043149823037
STAT,1889,15,40-44,1904,0.221279781724401
STAT,1869,21,15-19,1890,3.339035877467043
STAT,1887,68,na,1955,1682.046066720776
SIM,1892,1,na,1893,3840
SIM,1847,26,35-39,1873,24
STAT,1847,48,na,1895,2008.5604145721854
SIM,1905,59,na,1964,2506
STAT,1842,96,na,1938,2.131590245376107
STAT,1859,24,50-100,1883,0.3305448239546864
STAT,1914,30,35-39,1944,9.143687520156215
STAT,1891,73,na,1964,1729.1226358826545
STAT,1891,53,na,1944,2605.3701466069547
STAT,1824,43,na,1867,527.5078424499953
SIM,1848,22,na,1870,2685
STAT,1876,49,40-44,1925,0.16945393852914858
STAT,1903,41,15-19,1944,0.001367446480604824
STAT,1875,35,na,1910,2442.216215309424
STAT,1889,17,35-39,1906,0.6607692763132383
STAT,1860,54,30-34,1914,0.00472250527430112
STAT,1902,30,na,1932,3387.319434371166
SIM,1874,30,na,1904,2501
STAT,1876,32,45-49,1908,1.7628438608854788
STAT,1928,43,40-44,1971,0.3159385551818602
STAT,1891,39,50-100,1930,1.4945952019710347
STAT,1917,23,15-19,1940,5.564781911387526
STAT,1913,31,30-34,1944,15.54179952761903
STAT,1908,31,20-24,1939,2.2939019527019546
SIM,1882,37,na,1919,1874
STAT,1820,61,na,1881,1349.6697827020114
STAT,1839,26,35-39,1865,11.374919164031843
SIM,1927,6,na,1933,2045
STAT,1831,33,na,1864,2172.1302635864045
STAT,1897,1,na,1898,3614.780060327574
STAT,1903,45,35-39,1948,0.11321875628342355
STAT,1933,22,15-19,1955,7.01301505275127
STAT,1904,57,na,1961,2993.444023108846
STAT,1834,49,35-39,1883,0.06377902291056722
STAT,1858,20,30-34,1878,15.83362510515515
STAT,1922,21,30-34,1943,32.690360287306206
SIM,1803,58,na,1861,1450
SIM,1916,19,35-39,1935,18
STAT,1908,19,35-39,1927,0.803326077317901
STAT,1934,23,15-19,1957,7.102954851769784
SIM,1817,41,45-49,1858,3
STAT,1915,29,na,1944,3740.0927540324656
SIM,1868,22,na,1890,1258
SIM,1930,21,30-34,1951,54
SIM,1902,37,35-39,1939,1
STAT,1909,49,45-49,1958,0.19651972990261898
STAT,1934,22,50-100,1956,0.8782818811646866
STAT,1938,32,45-49,1970,1.5652926841782235
STAT,1920,41,15-19,1961,0.0016766706135262293
STAT,1859,49,40-44,1908,0.13285871362244694
STAT,1852,43,50-100,1895,1.0557298675922866
STAT,1923,20,35-39,1943,10.905241572912209
STAT,1836,56,na,1892,1561.0073406160873
STAT,1912,35,30-34,1947,1.7748920568971107
STAT,1933,25,20-24,1958,24.093937046101583
STAT,1927,43,25-29,1970,0.08868796874166246
SIM,1862,37,na,1899,3686
STAT,1907,22,na,1929,3450.835002705364
STAT,1818,82,na,1900,283.98832331426325
STAT,1878,63,na,1941,1835.8157406185405
SIM,1900,5,na,1905,4181
STAT,1908,47,na,1955,3296.765473501367
STAT,1779,100,na,1879,0.3411477637531981
STAT,1937,6,na,1943,3858.8809566229156
STAT,1841,37,50-100,1878,1.610796690930263
STAT,1941,16,15-19,1957,46.22713359666464
STAT,1823,38,na,1861,2256.5859504667446
SIM,1902,18,25-29,1920,19
SIM,1907,48,50-100,1955,2
STAT,1920,26,25-29,1946,71.51932745594158
STAT,1862,54,35-39,1916,0.007131044783578028
STAT,1838,33,50-100,1871,0.4809955940095407
STAT,1856,43,50-100,1899,0.7533189194501916
SIM,1839,30,40-44,1869,14
SIM,1849,63,na,1912,1234
STAT,1887,35,25-29,1922,3.1991520390995025
SIM,1924,45,50-100,1969,2
STAT,1902,25,50-100,1927,0.9069007604084317
STAT,1837,41,20-24,1878,0.1522001877473173
SIM,1879,34,30-34,1913,7
SIM,1920,16,na,1936,4394
SIM,1858,27,20-24,1885,3
STAT,1936,11,na,1947,3761.4167542711593
SIM,1881,20,25-29,1901,90
SIM,1919,42,30-34,1961,2
STAT,1913,31,50-100,1944,0.8155976627786545
SIM,1923,44,45-49,1967,1
STAT,1904,29,45-49,1933,1.5749480765625885
STAT,1849,74,na,1923,935.0988394781651
STAT,1914,15,45-49,1929,0.10237018991973763
STAT,1826,54,25-29,1880,0.004703171872862944
STAT,1903,42,25-29,1945,0.06322190784815791
STAT,1916,40,15-19,1956,0.0015565747649519796
STAT,1885,22,45-49,1907,0.6854317930999805
STAT,1919,37,40-44,1956,1.5868693951642856
SIM,1923,9,na,1932,4292
STAT,1919,19,40-44,1938,1.5169876130827358
SIM,1918,44,35-39,1962,1
STAT,1879,29,40-44,1908,3.051005719698535
STAT,1893,45,25-29,1938,0.041036220288842455
SIM,1790,66,na,1856,1351
STAT,1855,15,na,1870,1828.4210732124727
STAT,1882,17,na,1899,2418.0412205644716
SIM,1908,27,30-34,1935,524
STAT,1876,76,na,1952,957.7379642059082
STAT,1931,28,20-24,1959,23.389759306171253
STAT,1826,41,45-49,1867,2.288618119777898
STAT,1830,31,na,1861,2054.8148818823133
STAT,1915,44,45-49,1959,0.16464051309925826
STAT,1910,38,30-34,1948,1.7150486059561485
SIM,1886,27,na,1913,2770
STAT,1893,32,45-49,1925,2.180698162030575
STAT,1835,51,50-100,1886,0.011878432178043933
SIM,1926,41,na,1967,5886
STAT,1819,76,na,1895,220.3588557669329
STAT,1888,30,15-19,1918,0.16568293133550113
STAT,1921,28,35-39,1949,16.476088169239954
STAT,1876,17,20-24,1893,17.92191479620088
STAT,1908,18,25-29,1926,8.319132180259553
STAT,1905,38,20-24,1943,0.23812217854183074
STAT,1910,23,30-34,1933,26.606285944553072
STAT,1922,25,45-49,1947,1.9462050328454905
SIM,1808,81,na,1889,985
STAT,1868,33,na,1901,2295.141758134925
STAT,1860,53,20-24,1913,5.923232795441627E-4
STAT,1936,34,35-39,1970,8.776793502458625
STAT,1822,100,na,1922,0.6121979396402285
STAT,1911,33,20-24,1944,2.3385029222136344
SIM,1793,66,na,1859,938
STAT,1909,2,na,1911,3956.90692128157
STAT,1852,31,45-49,1883,1.836384138604958
STAT,1868,10,na,1878,2612.0038302710777
STAT,1931,30,40-44,1961,5.097464831896418
STAT,1839,76,na,1915,880.2006158085672
STAT,1925,15,20-24,1940,163.030136407734
SIM,1810,91,na,1901,258
STAT,1848,31,25-29,1879,11.294213842255756
SIM,1921,47,45-49,1968,2
SIM,1892,67,na,1959,3096
STAT,1902,31,25-29,1933,14.482172550312004
STAT,1913,47,45-49,1960,0.20947088764797922
STAT,1795,69,na,1864,837.5804962391206
STAT,1858,21,40-44,1879,1.839031470160693
STAT,1905,22,40-44,1927,2.9971850467868486
STAT,1884,71,na,1955,1277.7677839377343
STAT,1815,94,na,1909,1.4091303249876852
STAT,1860,61,na,1921,1524.4182659533292
STAT,1790,77,na,1867,460.3991886888175
STAT,1895,43,na,1938,2995.2175172103525
SIM,1884,60,na,1944,3654
STAT,1875,47,30-34,1922,0.09893589077822726
SIM,1941,25,20-24,1966,113
STAT,1921,40,25-29,1961,0.07969695209181998
SIM,1840,81,na,1921,1449
STAT,1852,44,25-29,1896,0.6376625000808719
STAT,1867,43,50-100,1910,0.9919009023835569
STAT,1923,21,45-49,1944,1.2993239710407132
STAT,1899,21,30-34,1920,24.40266696563676
STAT,1838,28,40-44,1866,1.6149486416075338
STAT,1846,34,25-29,1880,7.021502903440932
SIM,1860,31,45-49,1891,3
SIM,1895,32,na,1927,4508
STAT,1916,28,25-29,1944,66.8912675373956
SIM,1868,2,na,1870,1405
STAT,1901,16,15-19,1917,8.318158512767623
STAT,1842,17,na,1859,731.7377036474946
SIM,1908,16,na,1924,2858
STAT,1902,22,na,1924,3330.3678606793887
STAT,1880,47,40-44,1927,0.1769034461551353
SIM,1903,24,na,1927,2924
STAT,1818,54,50-100,1872,0.024832200105677132
STAT,1863,31,20-24,1894,2.3170649395647946
STAT,1856,24,40-44,1880,1.7134085637922678
STAT,1801,54,20-24,1855,0.001834358094449375
STAT,1928,25,50-100,1953,1.2251931756637406
STAT,1945,27,40-44,1972,5.05715297456239
STAT,1903,25,40-44,1928,4.281085119520702
SIM,1907,44,30-34,1951,1
STAT,1951,21,20-24,1972,131.65560403935768
SIM,1943,21,na,1964,4975
STAT,1917,52,na,1969,3722.367426465
STAT,1887,22,50-100,1909,0.44884396976984453
SIM,1859,23,20-24,1882,3
STAT,1930,16,40-44,1946,1.800032613267411
STAT,1918,43,50-100,1961,0.12302732999458849
STAT,1938,22,50-100,1960,0.644246030869475
STAT,1844,21,45-49,1865,0.8687825608093562
STAT,1908,27,na,1935,3512.777446728668
STAT,1924,47,20-24,1971,0.013030148924821903
SIM,1848,21,25-29,1869,2
SIM,1904,2,na,1906,4312
SIM,1925,24,25-29,1949,8
STAT,1897,24,30-34,1921,23.507548760449144
STAT,1895,0,na,1895,3819.7993399632915
STAT,1917,30,50-100,1947,0.8610916281858959
STAT,1919,19,na,1938,3991.9962458332507
STAT,1834,46,30-34,1880,0.050358840150760906
STAT,1857,20,40-44,1877,1.872790130515761
STAT,1823,58,na,1881,1691.4499370178992
STAT,1913,32,40-44,1945,3.8446245932151513
SIM,1950,15,na,1965,4844
STAT,1851,48,25-29,1899,0.04492044263460126
STAT,1884,40,50-100,1924,1.0215167364745228
STAT,1812,66,na,1878,153.32602155677583
STAT,1937,32,30-34,1969,15.426258056340329
STAT,1821,50,30-34,1871,0.006392417586414043
STAT,1918,36,40-44,1954,1.5640695973442005
STAT,1799,59,na,1858,199.54885598213622
SIM,1836,45,na,1881,1917
STAT,1900,33,45-49,1933,2.4054972458239545
SIM,1911,42,30-34,1953,1
STAT,1924,7,na,1931,4714.4217265489515
STAT,1915,44,15-19,1959,0.0015191743913109393
STAT,1921,23,35-39,1944,10.476574693713943
STAT,1829,31,20-24,1860,1.5290380120322289
STAT,1968,2,na,1970,4864.9062415888975
STAT,1874,22,35-39,1896,6.02260355789764
SIM,1838,33,30-34,1871,21
STAT,1843,20,50-100,1863,0.5130824079536909
STAT,1926,17,30-34,1943,14.815949957064678
STAT,1909,47,25-29,1956,0.04824693209119591
SIM,1827,40,na,1867,2067
STAT,1923,18,20-24,1941,157.110435584276
STAT,1896,22,20-24,1918,90.84242239857703
SIM,1891,42,na,1933,2027
STAT,1831,25,na,1856,2250.153181028788
STAT,1843,58,na,1901,1953.954781893985
STAT,1924,19,20-24,1943,159.03937482274426
STAT,1901,37,na,1938,3320.1564264379113
SIM,1921,8,na,1929,5353
SIM,1884,40,na,1924,3681
STAT,1872,24,25-29,1896,56.964587668079545
SIM,1875,55,na,1930,2579
SIM,1796,82,na,1878,66
STAT,1866,86,na,1952,202.53273291803777
SIM,1839,17,na,1856,1320
STAT,1917,24,25-29,1941,96.25462640736346
SIM,1903,32,25-29,1935,2
STAT,1917,42,25-29,1959,0.0735269512436834
STAT,1932,29,20-24,1961,23.719020069799114
SIM,1820,61,na,1881,37
STAT,1881,12,na,1893,2438.7867210512536
STAT,1905,40,40-44,1945,0.22692438623152458
STAT,1917,32,na,1949,3907.535739778314
STAT,1909,29,25-29,1938,61.81871712446321
SIM,1882,14,na,1896,2250
SIM,1964,7,na,1971,5106
STAT,1843,89,na,1932,103.79757924776898
SIM,1819,73,na,1892,915
SIM,1940,29,20-24,1969,45
STAT,1854,15,50-100,1869,0.03297323925232976
STAT,1938,19,15-19,1957,44.25895209202861
STAT,1878,42,20-24,1920,0.16319667261320495
STAT,1901,44,15-19,1945,0.0013227653011549155
STAT,1903,42,30-34,1945,0.11318760874891814
STAT,1850,91,na,1941,26.75808003532212
STAT,1907,35,20-24,1942,0.24507151458582188
STAT,1896,48,50-100,1944,0.1803311819806178
STAT,1855,53,40-44,1908,0.0068557103922824375
STAT,1925,19,na,1944,4382.034229018119
SIM,1866,44,50-100,1910,15
STAT,1806,66,na,1872,699.3845775622981
STAT,1905,5,na,1910,3769.318198480349
STAT,1904,25,30-34,1929,36.22135944234739
STAT,1949,17,50-100,1966,0.43143974155568293
SIM,1892,27,na,1919,3662
STAT,1819,84,na,1903,77.37491832638798
SIM,1844,32,na,1876,2926
SIM,1844,71,na,1915,1211
STAT,1942,18,25-29,1960,44.75530618218395
SIM,1915,18,na,1933,3611
SIM,1933,34,30-34,1967,21
SIM,1837,31,20-24,1868,3
STAT,1864,20,na,1884,2216.368092169471
STAT,1883,15,40-44,1898,0.17677818150890787
SIM,1920,35,30-34,1955,9
STAT,1868,25,15-19,1893,0.441191076583487
SIM,1946,19,15-19,1965,44
SIM,1888,21,25-29,1909,30
SIM,1915,49,na,1964,2882
STAT,1889,32,25-29,1921,12.334400353349617
STAT,1898,21,40-44,1919,2.810592624475093
SIM,1838,32,na,1870,2252
STAT,1848,33,na,1881,2345.280870504833
SIM,1889,22,25-29,1911,2
STAT,1788,67,na,1855,291.91020000000003
STAT,1888,31,25-29,1919,11.869952838773884
STAT,1931,41,50-100,1972,0.15606581278263118
STAT,1878,15,30-34,1893,1.647502367987743
SIM,1831,53,na,1884,2133
STAT,1856,23,30-34,1879,14.75204165412054
STAT,1925,34,30-34,1959,18.514083206585894
STAT,1958,9,na,1967,5115.61803613728
SIM,1897,32,25-29,1929,2
SIM,1926,36,40-44,1962,1
STAT,1929,38,50-100,1967,0.5347053623093891
STAT,1943,24,na,1967,3838.2970350965143
SIM,1923,26,15-19,1949,6
STAT,1818,106,na,1924,0.007390115709651013
STAT,1925,16,30-34,1941,14.625141629525546
STAT,1877,78,na,1955,793.1467274494241
SIM,1924,27,15-19,1951,17
STAT,1899,22,40-44,1921,2.846206336348842
STAT,1923,36,15-19,1959,0.022036623972086472
STAT,1911,34,30-34,1945,15.03910456717747
STAT,1858,44,50-100,1902,0.7958846478384758
STAT,1861,7,na,1868,2365.917829573982
STAT,1901,21,50-100,1922,0.5719001626024569
STAT,1921,41,35-39,1962,0.22443793465158535
STAT,1862,48,na,1910,1892.203540031815
STAT,1808,92,na,1900,9.754448252785943
STAT,1915,26,15-19,1941,0.7123212458875089
STAT,1781,97,na,1878,1.028171061926561
SIM,1940,16,na,1956,3805
STAT,1867,29,15-19,1896,0.4260134155448894
STAT,1898,24,45-49,1922,0.931829864701861
STAT,1820,100,na,1920,0.73010613334765
STAT,1944,16,35-39,1960,4.466131482745821
STAT,1814,109,na,1923,4.8150497504345256E-4
STAT,1779,109,na,1888,0.005085020057777297
STAT,1857,25,40-44,1882,2.402045935542522
SIM,1898,31,30-34,1929,20
SIM,1850,7,na,1857,2440
SIM,1879,25,na,1904,1596
STAT,1905,21,30-34,1926,25.697120970136748
STAT,1905,40,35-39,1945,0.1826889340690452
STAT,1901,33,30-34,1934,24.309421531445366
STAT,1935,19,25-29,1954,58.50015398700771
STAT,1955,16,45-49,1971,0.6575366287476125
SIM,1925,27,30-34,1952,2
STAT,1848,50,35-39,1898,0.008171908617549514
STAT,1814,52,40-44,1866,0.03471226560841525
STAT,1928,27,40-44,1955,5.698696492100834
STAT,1811,56,na,1867,1562.093044806882
STAT,1949,18,na,1967,4237.269761720759
STAT,1888,53,na,1941,2445.2739327727736
STAT,1907,34,50-100,1941,0.761070612741768
STAT,1918,40,50-100,1958,0.1235640565742622
STAT,1912,38,35-39,1950,2.3217391874938444
STAT,1942,19,35-39,1961,4.332138156884076
SIM,1828,33,na,1861,2092
SIM,1955,1,na,1956,3837
SIM,1906,3,na,1909,3770
STAT,1869,22,25-29,1891,57.765509586472334
SIM,1920,38,35-39,1958,1
STAT,1822,96,na,1918,4.95149871703019
STAT,1829,43,na,1872,940.3681750560226
STAT,1881,43,40-44,1924,2.108754599227843
STAT,1953,19,45-49,1972,0.5984715047362665
STAT,1925,45,15-19,1970,4.443740050608136E-4
STAT,1903,26,25-29,1929,60.253407964261974
STAT,1864,46,45-49,1910,0.2151581963254384
STAT,1837,44,25-29,1881,0.5389141011879524
STAT,1848,32,35-39,1880,11.051460010315232
STAT,1912,15,40-44,1927,0.2808495740855186
STAT,1893,16,50-100,1909,0.06141617683527959
STAT,1811,47,40-44,1858,0.8046632923938688
STAT,1803,51,25-29,1854,0.00790854356520035
STAT,1857,61,na,1918,1433.9188517002142
SIM,1896,17,na,1913,3653
STAT,1929,26,45-49,1955,2.1479669101345915
STAT,1893,49,40-44,1942,0.1182433168760253
STAT,1928,24,na,1952,4496.459288717469
STAT,1919,34,35-39,1953,9.645018907064037
SIM,1934,7,na,1941,5336
SIM,1904,54,na,1958,3873
STAT,1892,30,50-100,1922,1.1435164187714018
STAT,1889,33,35-39,1922,12.143802197581865
STAT,1860,36,30-34,1896,4.36875415105321
STAT,1924,34,na,1958,4364.412352637115
SIM,1897,33,35-39,1930,1
STAT,1927,29,45-49,1956,2.0747797335782816
STAT,1873,24,40-44,1897,2.1241473452183053
SIM,1889,5,na,1894,3895
STAT,1802,96,na,1898,4.350577426008298
SIM,1894,2,na,1896,1821
SIM,1951,5,na,1956,2373
STAT,1841,15,35-39,1856,0.7974256153981382
STAT,1863,34,25-29,1897,8.66937258443635
STAT,1924,35,20-24,1959,0.30839003747855714
STAT,1890,36,45-49,1926,2.4249449805542844
STAT,1961,8,na,1969,5030.811924255389
STAT,1942,30,45-49,1972,1.6589499026548458
SIM,1916,15,20-24,1931,114
STAT,1823,45,45-49,1868,0.3789022291092529
STAT,1857,23,45-49,1880,0.6133041298666232
STAT,1934,36,25-29,1970,1.3507593955068262
STAT,1812,97,na,1909,0.42545246491095307
STAT,1869,24,20-24,1893,69.10302697344576
SIM,1857,39,na,1896,1416
STAT,1858,47,30-34,1905,0.07357807277476347
SIM,1875,35,na,1910,2972
STAT,1912,36,40-44,1948,1.4510612968804744
SIM,1943,4,na,1947,4986
STAT,1905,15,50-100,1920,0.07079342071318247
STAT,1858,106,na,1964,0.050461889815785504
SIM,1943,19,25-29,1962,649
STAT,1944,26,40-44,1970,4.983230921429479
STAT,1835,44,25-29,1879,0.567445762910746
SIM,1900,42,20-24,1942,1
STAT,1870,42,25-29,1912,0.6393994470228473
STAT,1908,15,20-24,1923,26.2162670001639
SIM,1915,17,25-29,1932,185
SIM,1913,14,na,1927,3593
STAT,1896,40,15-19,1936,0.0012769145303893829
STAT,1875,91,na,1966,169.63741043416616
STAT,1918,17,na,1935,4160.788288712778
STAT,1859,73,na,1932,941.4039887774078
STAT,1902,46,25-29,1948,0.045882718101601126
STAT,1905,50,na,1955,3141.535810360149
STAT,1868,26,25-29,1894,40.997922556988364
SIM,1860,81,na,1941,1638
STAT,1922,43,45-49,1965,0.1885984188456275
STAT,1858,24,45-49,1882,0.5480463992439782
STAT,1935,37,25-29,1972,1.366888121522836
STAT,1823,36,50-100,1859,2.3166608298988427
STAT,1900,30,40-44,1930,6.055880014867024
STAT,1907,17,25-29,1924,8.268305702393745
SIM,1880,24,25-29,1904,4
STAT,1866,30,30-34,1896,16.065665142577465
STAT,1913,35,45-49,1948,0.670629260784468
STAT,1785,70,na,1855,286.12979999999993
STAT,1847,34,40-44,1881,4.103203660624145
STAT,1930,31,50-100,1961,1.0601307773806476
STAT,1844,27,50-100,1871,0.7758000253786024
STAT,1826,89,na,1915,83.75245875772583
STAT,1895,12,na,1907,3359.5150455742414
STAT,1945,24,35-39,1969,10.198819450367028
STAT,1833,21,35-39,1854,6.5007612846326275
STAT,1867,17,na,1884,2441.8061365403964
STAT,1802,53,30-34,1855,0.029611458365280657
SIM,1899,45,na,1944,1776
STAT,1822,33,25-29,1855,23.754953228759025
STAT,1851,45,20-24,1896,0.009571997963272752
STAT,1817,49,35-39,1866,0.09551321715980289
SIM,1908,23,15-19,1931,4
STAT,1887,17,na,1904,2779.866953037143
STAT,1897,25,40-44,1922,4.005254300622192
STAT,1916,47,35-39,1963,0.13043685583220174
STAT,1800,61,na,1861,1628.7964824758087
STAT,1840,42,40-44,1882,0.923875313248109
STAT,1925,30,15-19,1955,0.15137344899347474
STAT,1888,15,25-29,1903,6.570719621421152
STAT,1897,27,35-39,1924,12.814278133322365
SIM,1879,43,50-100,1922,27
STAT,1926,12,na,1938,4816.291325070639
STAT,1902,16,30-34,1918,2.249936225182127
STAT,1793,74,na,1867,406.1461877881103
STAT,1789,69,na,1858,1163.8095508727783
STAT,1884,2,na,1886,3002.008481284137
STAT,1935,35,30-34,1970,2.5345801072878387
STAT,1846,106,na,1952,0.007191047727125073
STAT,1954,17,40-44,1971,1.713853704649614
STAT,1808,81,na,1889,135.02452437987324
STAT,1911,37,35-39,1948,2.3098779455335543
STAT,1936,15,50-100,1951,0.3567837769115353
STAT,1904,41,30-34,1945,0.11457649433735932
STAT,1916,22,15-19,1938,5.5018874078887015
STAT,1854,10,na,1864,1607.717035382332
SIM,1924,22,15-19,1946,15
SIM,1919,39,na,1958,4881
STAT,1951,20,15-19,1971,6.304973068274825
STAT,1901,15,30-34,1916,2.238926737064289
STAT,1877,19,30-34,1896,1.6092924674664055
STAT,1861,34,25-29,1895,8.44526040961792
STAT,1849,30,30-34,1879,17.39282217437655
STAT,1941,26,50-100,1967,1.0184117823831567
SIM,1844,40,na,1884,2931
STAT,1843,39,35-39,1882,7.2714596335221975
STAT,1800,72,na,1872,963.3827285732955
STAT,1844,43,na,1887,2315.202315600934
STAT,1947,22,45-49,1969,1.2582582895142795
SIM,1923,13,na,1936,4291
STAT,1854,36,50-100,1890,0.6859322974518812
STAT,1898,26,40-44,1924,4.042008755426938
STAT,1820,46,50-100,1866,0.39109528783212644
STAT,1900,18,20-24,1918,24.494731352443367
STAT,1921,21,15-19,1942,5.959110623849933
STAT,1881,24,50-100,1905,0.3826851938137069
STAT,1813,90,na,1903,57.752768792044186
STAT,1901,48,30-34,1949,0.07538780541134606
SIM,1826,55,na,1881,1370
STAT,1899,25,45-49,1924,1.526815334871322
SIM,1924,29,35-39,1953,650
STAT,1878,45,25-29,1923,0.059853692605490214
STAT,1921,41,30-34,1962,0.14249348362916125
STAT,1853,88,na,1941,106.44814432873005
STAT,1875,20,30-34,1895,18.399714583084815
STAT,1904,20,30-34,1924,25.600175756224537
SIM,1834,33,na,1867,1013
SIM,1865,25,na,1890,1601
STAT,1939,25,20-24,1964,18.16482168969631
STAT,1915,41,40-44,1956,0.24861954838631822
STAT,1831,23,25-29,1854,143.7496942067319
STAT,1876,42,20-24,1918,0.16034771187619723
STAT,1942,30,15-19,1972,0.13547665452431853
SIM,1897,67,na,1964,1420
STAT,1836,25,na,1861,2173.263220986501
STAT,1888,35,40-44,1923,5.10033767825014
STAT,1896,8,na,1904,3426.7962738074348
STAT,1930,31,30-34,1961,20.201553740328052
STAT,1916,40,45-49,1956,0.16869377830803475
STAT,1922,39,na,1961,4224.134677721716
STAT,1892,19,50-100,1911,0.06033125418056268
STAT,1840,30,na,1870,1061.2046972548071
SIM,1838,34,40-44,1872,23
STAT,1898,63,na,1961,2539.3633841492087
SIM,1871,65,na,1936,1577
SIM,1905,28,na,1933,3203
STAT,1931,30,35-39,1961,11.903559489031352
SIM,1903,38,35-39,1941,4
STAT,1833,88,na,1921,56.483575915161225
STAT,1895,35,na,1930,3093.932881608449
SIM,1885,65,na,1950,489
SIM,1894,39,na,1933,1473
SIM,1909,39,45-49,1948,2
STAT,1946,25,35-39,1971,16.557835181405526
STAT,1827,27,50-100,1854,0.9992000252126795
STAT,1916,29,35-39,1945,15.202318952189358
STAT,1933,27,15-19,1960,0.9309992291353688
STAT,1886,21,15-19,1907,3.4266187851648295
STAT,1870,54,20-24,1924,7.154262220425828E-4
STAT,1938,16,45-49,1954,0.48868888430348534
STAT,1920,24,30-34,1944,31.34391602292687
SIM,1860,0,na,1860,3986
STAT,1918,19,25-29,1937,46.282090877691495
STAT,1878,18,35-39,1896,0.5630708338230618
STAT,1881,46,45-49,1927,0.22349883083098548
STAT,1893,19,15-19,1912,7.381521811891255
STAT,1853,15,25-29,1868,5.348415183925266
STAT,1849,43,na,1892,1933.3640396756036
STAT,1929,29,15-19,1958,0.876459194798492
STAT,1864,43,40-44,1907,2.030059103109782
SIM,1872,43,40-44,1915,4
STAT,1944,27,25-29,1971,70.33830573887113
STAT,1833,99,na,1932,0.7792073453280659
STAT,1807,48,50-100,1855,0.8350400970670457
STAT,1820,37,40-44,1857,8.144553277672184
STAT,1916,43,15-19,1959,0.001549813453671324
STAT,1899,48,30-34,1947,0.07364369848350148
STAT,1916,26,30-34,1942,40.0979534309346
STAT,1924,17,25-29,1941,51.10926084085764
SIM,1890,32,na,1922,3531
STAT,1839,19,50-100,1858,0.058843102498447875
SIM,1918,46,na,1964,4369
STAT,1877,29,40-44,1906,3.019124288583872
STAT,1855,91,na,1946,38.351978610644004
STAT,1897,21,25-29,1918,76.25467211810496
STAT,1936,36,30-34,1972,1.773113464777335
SIM,1859,29,30-34,1888,138
STAT,1847,38,50-100,1885,1.1398012574366576
STAT,1839,23,30-34,1862,21.11056041250737
STAT,1874,40,35-39,1914,1.8877379376875354
STAT,1908,24,na,1932,3459.3757292471482
SIM,1902,22,na,1924,2832
STAT,1927,26,40-44,1953,5.639619678882258
STAT,1912,18,45-49,1930,0.09957794636897488
STAT,1889,30,30-34,1919,21.194433833176003
SIM,1878,4,na,1882,4423
STAT,1845,37,50-100,1882,0.6401090695061123
SIM,1831,45,na,1876,2133
STAT,1856,26,35-39,1882,7.233393226198431
STAT,1821,43,50-100,1864,1.1683166280998025
STAT,1826,28,15-19,1854,1.6153525557139463
STAT,1901,36,35-39,1937,2.1448281275055634
SIM,1924,26,30-34,1950,5
SIM,1912,41,35-39,1953,1
STAT,1942,16,30-34,1958,12.595792340639031
SIM,1897,30,30-34,1927,2
STAT,1798,66,na,1864,1172.228483134001
STAT,1874,25,40-44,1899,3.112595758205666
STAT,1874,47,15-19,1921,4.10901639938369E-4
SIM,1841,52,na,1893,77
STAT,1901,18,35-39,1919,0.7652033582490816
SIM,1859,73,na,1932,136
STAT,1817,41,na,1858,986.7358763747696
STAT,1851,49,40-44,1900,0.13238935487272666
STAT,1860,39,35-39,1899,5.711961120101902
STAT,1835,41,20-24,1876,0.14583488696680713
STAT,1865,21,50-100,1886,0.3795599725909109
STAT,1836,28,40-44,1864,2.948883778476757
STAT,1777,109,na,1886,0.008295133721235444
STAT,1851,25,na,1876,2029.4959618012317
SIM,1901,69,na,1970,2332
SIM,1923,29,20-24,1952,3
STAT,1820,51,25-29,1871,0.005480409565695206
STAT,1872,21,20-24,1893,69.2145225847193
SIM,1910,25,25-29,1935,2
STAT,1918,37,25-29,1955,1.0238015425433242
SIM,1875,24,na,1899,3098
STAT,1902,25,25-29,1927,59.97131032589453
STAT,1864,43,na,1907,2085.983956625724
SIM,1880,21,20-24,1901,62
STAT,1953,16,40-44,1969,1.677313566172211
STAT,1864,40,na,1904,2122.363769948777
STAT,1892,46,20-24,1938,0.00840445089570142
SIM,1912,21,na,1933,4039
STAT,1919,31,30-34,1950,16.840776118607366
STAT,1852,18,15-19,1870,7.182345191983726
SIM,1927,31,30-34,1958,13
STAT,1915,29,20-24,1944,18.22440956972307
STAT,1961,5,na,1966,5032.975794837111
STAT,1861,52,25-29,1913,0.0029300086509948496
STAT,1848,35,40-44,1883,4.309958998644985
STAT,1877,61,na,1938,1896.8899919371827
SIM,1928,35,35-39,1963,1
STAT,1922,37,45-49,1959,0.7670549687032665
STAT,1874,50,na,1924,2254.1463931835256
STAT,1806,89,na,1895,31.63354937399745
STAT,1909,45,30-34,1954,0.08186117284385144
SIM,1900,8,na,1908,4181
STAT,1909,18,40-44,1927,0.2707900558673797
STAT,1882,16,35-39,1898,0.5266300066596635
STAT,1920,35,50-100,1955,0.4545675238551428
STAT,1839,42,35-39,1881,1.7731396558744301
STAT,1798,107,na,1905,0.0020017712063288323
STAT,1856,20,25-29,1876,48.44658714278249
STAT,1816,49,20-24,1865,0.03546427678183422
STAT,1823,42,40-44,1865,3.7777591969974984
STAT,1911,18,30-34,1929,2.4052998274579704
STAT,1857,21,25-29,1878,51.07918432222624
STAT,1894,16,25-29,1910,7.223842021429458
STAT,1883,46,50-100,1929,0.23694864504027072
STAT,1933,37,20-24,1970,0.3566176445498247
SIM,1817,41,na,1858,2785
STAT,1934,24,25-29,1958,123.20937246485055
SIM,1844,63,na,1907,1796
STAT,1848,17,40-44,1865,0.2121732425899004
STAT,1890,33,40-44,1923,5.227905256614241
STAT,1840,92,na,1932,16.39964803910506
STAT,1898,23,na,1921,3170.4933894278433
SIM,1857,47,na,1904,1397
STAT,1861,31,20-24,1892,2.2571664339066526
SIM,1858,32,na,1890,2430
STAT,1902,43,20-24,1945,0.015417437018797346
STAT,1817,46,30-34,1863,0.06871939051159984
SIM,1835,25,25-29,1860,33
SIM,1912,23,35-39,1935,84
STAT,1902,19,35-39,1921,0.7685268291155171
SIM,1876,23,20-24,1899,544
STAT,1912,32,na,1944,3678.2846143683782
STAT,1871,76,na,1947,945.0764796265512
STAT,1836,18,30-34,1854,3.8648214013786895
SIM,1854,21,15-19,1875,12
SIM,1859,25,15-19,1884,1
SIM,1864,40,na,1904,2415
STAT,1913,16,40-44,1929,0.28308443311818904
STAT,1863,58,na,1921,1688.2992854179004
SIM,1875,32,na,1907,2843
STAT,1862,18,40-44,1880,0.17737094895433145
STAT,1906,36,15-19,1942,0.01763577948093665
SIM,1879,31,25-29,1910,5
STAT,1945,26,50-100,1971,1.0804238496399576
SIM,1793,63,na,1856,1150
SIM,1898,60,na,1958,3708
STAT,1847,37,45-49,1884,1.8700132634245625
STAT,1839,73,na,1912,1103.500726523551
STAT,1881,83,na,1964,611.139484455664
STAT,1874,47,50-100,1921,0.2522938188592389
STAT,1846,31,20-24,1877,1.911630498337378
STAT,1910,34,15-19,1944,0.1214705656510795
STAT,1891,50,na,1941,2685.935994343437
SIM,1848,25,na,1873,2575
STAT,1863,52,50-100,1915,0.012824764744440382
STAT,1855,33,50-100,1888,0.6110669068775212
STAT,1952,19,30-34,1971,14.463584466795721
SIM,1837,20,30-34,1857,11
STAT,1904,65,na,1969,2729.2211116671583
STAT,1889,9,na,1898,3124.5220783050636
STAT,1882,68,na,1950,1463.1120096504935
STAT,1881,43,na,1924,2166.8473867147854
STAT,1874,20,50-100,1894,0.42337795595523847
STAT,1923,24,na,1947,4178.001028039298
STAT,1901,15,50-100,1916,0.06881945538527287
STAT,1922,40,40-44,1962,0.2846780122565297
STAT,1907,47,20-24,1954,0.00983058075654115
STAT,1927,16,50-100,1943,0.4631798070084643
STAT,1916,21,50-100,1937,0.6821382846029332
STAT,1823,89,na,1912,82.98986437144323
STAT,1921,46,na,1967,4102.596198084302
SIM,1889,24,na,1913,3091
STAT,1884,37,30-34,1921,5.101857701353575
STAT,1868,23,20-24,1891,66.35489744401305
STAT,1810,44,20-24,1854,8.451565378926871E-4
STAT,1936,32,15-19,1968,0.12357939172647142
STAT,1916,44,30-34,1960,0.12879617244164543
SIM,1859,17,na,1876,2111
STAT,1930,31,35-39,1961,11.717398601992516
STAT,1897,67,na,1964,2326.283003331166
SIM,1854,31,20-24,1885,2
SIM,1892,37,30-34,1929,1
STAT,1906,21,45-49,1927,1.0128200052557965
STAT,1839,84,na,1923,309.0660936770221
STAT,1879,40,15-19,1919,0.014309620288359207
STAT,1933,1,na,1934,5552.3482850201835
STAT,1945,21,30-34,1966,31.16245142484089
STAT,1828,81,na,1909,366.0598327225536
STAT,1943,17,30-34,1960,12.777784513827502
STAT,1840,45,45-49,1885,0.09614070209631843
STAT,1861,21,45-49,1882,0.6000856482068183
STAT,1917,36,25-29,1953,1.0138842137604118
SIM,1911,36,na,1947,2517
STAT,1939,28,25-29,1967,65.41056832238824
STAT,1907,37,50-100,1944,0.38665700549980075
STAT,1894,26,50-100,1920,0.816261902928963
STAT,1950,7,na,1957,4603.3485913241975
SIM,1883,20,30-34,1903,29
SIM,1853,20,15-19,1873,18
STAT,1885,27,50-100,1912,0.6287852235099585
STAT,1921,44,35-39,1965,0.2233690616053487
STAT,1907,37,15-19,1944,0.0176849380377065
STAT,1834,42,50-100,1876,0.5612931132192749
SIM,1925,36,25-29,1961,3
STAT,1876,45,25-29,1921,0.058808813335174896
STAT,1971,1,na,1972,4936.217474505553
SIM,1922,28,na,1950,3411
STAT,1887,22,15-19,1909,3.631147297409004
STAT,1928,16,na,1944,4613.899425973516
STAT,1810,71,na,1881,45.1986108817351
STAT,1855,43,30-34,1898,0.7553958505561951
STAT,1932,26,15-19,1958,0.9186323723857828
STAT,1898,22,25-29,1920,76.97913535508295
STAT,1917,27,30-34,1944,40.542905763234714
SIM,1895,24,na,1919,4495
STAT,1920,42,30-34,1962,0.13938181942364708
SIM,1878,83,na,1961,762
STAT,1904,41,35-39,1945,0.18046658060252058
STAT,1843,36,30-34,1879,6.211592472794608
SIM,1884,9,na,1893,3855
STAT,1939,19,na,1958,3641.4156112324545
STAT,1842,39,20-24,1881,0.2000769155363274
STAT,1908,34,25-29,1942,8.58270752820358
STAT,1800,64,na,1864,1456.420384083614
STAT,1929,39,20-24,1968,0.3353433695811004
SIM,1862,14,na,1876,3854
STAT,1844,51,na,1895,2143.3254856278404
STAT,1939,31,50-100,1970,0.8348051402291387
STAT,1833,46,15-19,1879,2.034628667143356E-4
STAT,1946,22,30-34,1968,31.63787619474913
STAT,1845,36,na,1881,1241.1585674425394
STAT,1904,23,35-39,1927,8.311364927303398
STAT,1874,50,45-49,1924,0.015193013479007558
SIM,1851,22,na,1873,1406
STAT,1845,20,15-19,1865,2.061770129305832
STAT,1809,54,25-29,1863,0.028079992818531286
STAT,1846,21,15-19,1867,2.4282563646993043
STAT,1940,18,20-24,1958,136.0670812365171
STAT,1843,107,na,1950,0.0046595732918823535
SIM,1929,38,na,1967,6177
STAT,1854,53,25-29,1907,0.0019378006054108635
STAT,1941,19,20-24,1960,137.96509695624349
STAT,1905,24,35-39,1929,8.340747366499249
STAT,1886,75,na,1961,1253.7616074018702
STAT,1870,91,na,1961,112.79279028058657
STAT,1810,48,40-44,1858,8.871266294385717E-4
STAT,1865,32,35-39,1897,9.24592081419517
SIM,1916,34,25-29,1950,11
STAT,1927,40,20-24,1967,0.022029272746864628
STAT,1901,32,15-19,1933,0.19911657242366518
STAT,1815,63,na,1878,151.35849798035014
STAT,1887,32,20-24,1919,2.975184287172978
STAT,1926,29,30-34,1955,46.23526147949292
STAT,1927,16,35-39,1943,5.187614799636326
STAT,1866,33,35-39,1899,9.205164959804492
STAT,1883,31,50-100,1914,0.8850700348172508
SIM,1829,47,45-49,1876,1
STAT,1843,54,30-34,1897,0.005719650980602958
STAT,1967,3,na,1970,4863.902913542224
SIM,1853,77,na,1930,1339
STAT,1867,30,45-49,1897,1.662441455731854
STAT,1862,93,na,1955,24.892466754054478
STAT,1826,29,25-29,1855,133.57667913276072
STAT,1853,54,20-24,1907,5.564399345754961E-4
STAT,1813,52,25-29,1865,0.012311002879622685
SIM,1851,76,na,1927,592
STAT,1834,100,na,1934,0.46787255940013883
STAT,1948,15,20-24,1963,153.64863463351756
SIM,1860,26,30-34,1886,20
SIM,1839,42,na,1881,841
STAT,1944,24,20-24,1968,118.62622927675869
STAT,1835,29,35-39,1864,9.378715954413567
STAT,1843,28,15-19,1871,0.5477255178461938
SIM,1860,9,na,1869,2608
STAT,1831,52,45-49,1883,0.012038312108457672
STAT,1927,25,30-34,1952,47.56728166546226
SIM,1815,41,45-49,1856,10
STAT,1836,38,50-100,1874,1.1428405680188423
STAT,1878,19,45-49,1897,0.06684789107063303
STAT,1815,40,25-29,1855,0.07056738309105538
STAT,1845,23,20-24,1868,42.14676866638898
STAT,1846,55,na,1901,1224.6258220557365
STAT,1911,15,25-29,1926,8.61393011153945
STAT,1852,26,30-34,1878,29.73713479385688
STAT,1857,47,15-19,1904,3.0551332074819877E-4
STAT,1816,59,na,1875,2027.1664243801724
STAT,1792,104,na,1896,0.016146502993023167
STAT,1868,35,25-29,1903,2.8073435020492803
STAT,1888,38,45-49,1926,2.2893979790234367
STAT,1820,48,30-34,1868,0.15009516209873897
STAT,1831,36,40-44,1867,4.502667198046785
STAT,1877,47,na,1924,2273.2116811274286
STAT,1882,31,25-29,1913,9.846449517030244
STAT,1942,27,20-24,1969,18.939657854151356
STAT,1871,54,40-44,1925,0.010212997392906214
STAT,1865,107,na,1972,0.07823893334712953
STAT,1843,35,20-24,1878,0.9077975248483802
STAT,1859,42,20-24,1901,0.12571906511638728
STAT,1902,24,15-19,1926,4.6164731101979015
SIM,1830,29,na,1859,1025
SIM,1869,32,15-19,1901,2
SIM,1890,31,25-29,1921,19
STAT,1931,27,45-49,1958,2.2147468023075163
STAT,1939,30,na,1969,3820.802589687711
SIM,1882,32,45-49,1914,1
STAT,1833,24,40-44,1857,1.4738248550195001
STAT,1850,36,50-100,1886,0.5819132646172092
STAT,1916,37,20-24,1953,0.2662688954596633
SIM,1851,26,20-24,1877,75
SIM,1884,69,na,1953,2918
SIM,1935,25,30-34,1960,7
STAT,1942,28,na,1970,3885.013422041489
STAT,1801,71,na,1872,549.1716354813852
STAT,1843,26,20-24,1869,14.368203535286277
STAT,1900,36,15-19,1936,0.016871121452458553
STAT,1850,48,50-100,1898,0.11198367958371447
STAT,1835,91,na,1926,43.84651212852163
STAT,1820,64,na,1884,1206.833760053939
STAT,1851,20,40-44,1871,1.9939081643686074
SIM,1857,67,na,1924,121
STAT,1874,32,45-49,1906,1.7997404867648406
SIM,1909,19,25-29,1928,13
STAT,1837,17,35-39,1854,0.5863839191403365
STAT,1915,26,na,1941,3779.943732456927
STAT,1834,23,45-49,1857,0.40806142627291014
SIM,1881,33,40-44,1914,13
STAT,1839,30,50-100,1869,1.0695473647265938
STAT,1816,47,50-100,1863,0.7470246948108382
STAT,1937,15,45-49,1952,0.4831818712572697
STAT,1927,31,na,1958,4617.157476896075
SIM,1905,50,na,1955,2850
STAT,1876,54,50-100,1930,0.014847644852519054
SIM,1907,51,na,1958,4381
STAT,1914,18,15-19,1932,9.233068578888526
SIM,1909,32,na,1941,4083
STAT,1893,29,25-29,1922,52.5210237610636
SIM,1879,17,na,1896,1796
SIM,1938,19,20-24,1957,608
STAT,1857,40,30-34,1897,0.8911128793310811
STAT,1872,37,40-44,1909,4.383454436002731
STAT,1833,31,45-49,1864,1.0010473343130162
STAT,1851,22,35-39,1873,5.5038285994505864
STAT,1861,19,35-39,1880,0.5183382719551135
STAT,1796,85,na,1881,160.51954921379908
STAT,1841,46,na,1887,2549.1524231787803
STAT,1826,38,25-29,1864,4.587110420528015
STAT,1864,29,na,1893,2154.0963989510055
STAT,1801,53,45-49,1854,0.03680402807659136
STAT,1861,24,15-19,1885,2.778287403161838
STAT,1933,24,45-49,1957,1.4813477520921612
STAT,1950,21,40-44,1971,3.95214091786116
STAT,1847,46,45-49,1893,0.2139774032577626
SIM,1834,38,25-29,1872,33
STAT,1914,49,20-24,1963,0.010744285922171236
STAT,1943,26,25-29,1969,69.33020850675565
STAT,1898,41,30-34,1939,0.10784165649113786
STAT,1945,23,25-29,1968,100.08466572385406
SIM,1889,42,40-44,1931,31
SIM,1835,34,25-29,1869,1
STAT,1872,28,40-44,1900,2.989077928319455
STAT,1862,6,na,1868,2433.63789997846
STAT,1879,47,35-39,1926,0.14294802576807494
STAT,1833,82,na,1915,191.96936844348846
STAT,1905,37,45-49,1942,0.6188756587733828
STAT,1919,19,45-49,1938,0.5417811586390315
STAT,1936,16,40-44,1952,1.32908934610533
STAT,1884,27,20-24,1911,11.230194503633559
SIM,1872,9,na,1881,2546
STAT,1920,15,35-39,1935,0.936713717044639
SIM,1893,0,na,1893,3684
SIM,1874,30,30-34,1904,2
STAT,1880,43,25-29,1923,0.6618423936153515
STAT,1845,16,50-100,1861,0.030908532017720158
STAT,1813,110,na,1923,2.024248459707269E-4
STAT,1910,41,25-29,1951,0.06711709423475853
SIM,1826,75,na,1901,32
STAT,1898,0,na,1898,3948.5410047478954
SIM,1841,31,45-49,1872,29
STAT,1865,50,35-39,1915,0.00797294556520169
STAT,1934,28,40-44,1962,6.224805868756164
SIM,1844,49,na,1893,2491
STAT,1866,83,na,1949,362.3771586214418
STAT,1842,52,20-24,1894,1.8220922206311376E-4
STAT,1862,47,25-29,1909,0.04883156101930244
STAT,1812,53,20-24,1865,1.779397411858925E-4
STAT,1892,46,25-29,1938,0.04034136241755433
STAT,1894,25,25-29,1919,54.15791210905157
STAT,1899,70,na,1969,2268.1131526880445
SIM,1932,38,25-29,1970,3
STAT,1934,35,15-19,1969,0.026366221675209116
STAT,1874,19,na,1893,2592.614881739858
STAT,1825,30,40-44,1855,8.516194327395471
STAT,1902,17,40-44,1919,0.2575568491201125
SIM,1894,24,20-24,1918,396
STAT,1813,82,na,1895,341.7837825734099
STAT,1833,37,na,1870,1100.9440334100195
STAT,1871,38,35-39,1909,7.020552231844513
STAT,1943,21,50-100,1964,0.6922988401141476
SIM,1915,31,40-44,1946,3
SIM,1913,37,45-49,1950,15
SIM,1873,39,20-24,1912,5
STAT,1868,23,50-100,1891,0.3926558049385117
STAT,1917,35,15-19,1952,0.019866520585474973
STAT,1839,45,40-44,1884,0.16626374336735647
STAT,1825,32,35-39,1857,17.5519654471736
STAT,1926,33,30-34,1959,18.875677197080403
STAT,1861,30,50-100,1891,0.7681141381408907
STAT,1934,20,45-49,1954,1.506772581282947
SIM,1837,61,na,1898,1516
STAT,1809,77,na,1886,864.3127419770223
STAT,1837,72,na,1909,1012.6315842553668
SIM,1877,24,20-24,1901,22
SIM,1827,33,20-24,1860,1
STAT,1875,66,na,1941,1683.021212863662
STAT,1889,43,45-49,1932,1.7892721896323733
STAT,1947,2,na,1949,4491.900156570822
STAT,1876,42,50-100,1918,1.0666608456256577
SIM,1919,2,na,1921,5318
SIM,1934,33,30-34,1967,55
SIM,1806,55,na,1861,47
STAT,1892,21,40-44,1913,2.58773996432104
STAT,1850,24,50-100,1874,0.22277606208199557
STAT,1910,19,25-29,1929,8.445119782778056
SIM,1860,59,na,1919,1743
STAT,1867,39,25-29,1906,2.6955381144878188
STAT,1844,74,na,1918,1099.4552152491556
STAT,1890,23,30-34,1913,21.497047642477938
SIM,1965,6,na,1971,4968
SIM,1926,34,20-24,1960,25
STAT,1892,23,35-39,1915,7.202547019110986
SIM,1874,39,na,1913,2418
STAT,1810,44,25-29,1854,0.003417372044337907
STAT,1844,34,25-29,1878,11.884995359112324
STAT,1902,53,na,1955,2983.4052003574225
SIM,1942,2,na,1944,3672
SIM,1861,52,na,1913,1782
STAT,1865,39,20-24,1904,0.6966949350309374
STAT,1928,23,25-29,1951,114.09731578018454
STAT,1907,31,40-44,1938,3.648207696308669
STAT,1920,48,35-39,1968,0.1402965737369559
STAT,1849,49,15-19,1898,3.2999940354026347E-4
STAT,1835,110,na,1945,2.0909262767562875E-4
STAT,1851,49,50-100,1900,0.1899230463375919
SIM,1875,39,25-29,1914,6
STAT,1849,34,45-49,1883,1.5164847834038349
STAT,1879,54,40-44,1933,0.010502698172500246
STAT,1924,31,40-44,1955,4.524355855533293
SIM,1949,15,na,1964,4479
STAT,1879,28,na,1907,2439.572995696296
STAT,1903,22,50-100,1925,0.5788630586467481
STAT,1768,110,na,1878,0.005272766997714624
STAT,1818,109,na,1927,4.330344485488617E-4
STAT,1816,109,na,1925,6.006331566664333E-4
STAT,1851,22,na,1873,2016.6102321307637
STAT,1821,47,35-39,1868,0.14973086864842627
STAT,1854,5,na,1859,1672.5022222719756
STAT,1886,24,20-24,1910,70.91559930125318
STAT,1948,13,na,1961,4448.6821562550795
STAT,1824,74,na,1898,214.77041127700824
SIM,1861,24,25-29,1885,496
STAT,1928,24,35-39,1952,11.593820193047506
STAT,1915,20,na,1935,3754.148092250302
STAT,1864,74,na,1938,1008.9156190874824
STAT,1844,24,15-19,1868,4.0223052359209746
STAT,1865,36,50-100,1901,1.1263132174752863
STAT,1872,53,45-49,1925,0.014298815846785993
STAT,1911,16,na,1927,3830.7761059800077
STAT,1861,46,na,1907,1876.3765331834595
STAT,1953,15,30-34,1968,14.620244126416997
STAT,1870,24,25-29,1894,56.71277848325106
SIM,1837,47,na,1884,1802
STAT,1834,21,50-100,1855,0.24209644643564246
STAT,1838,46,35-39,1884,0.062276992349316114
STAT,1855,53,45-49,1908,0.0094506288204104
STAT,1895,15,30-34,1910,2.083054310652668
STAT,1827,53,50-100,1880,0.013103310155905367
STAT,1853,24,25-29,1877,51.69540027675659
STAT,1918,34,20-24,1952,2.5350961084702
STAT,1808,51,50-100,1859,0.01986076526388058
STAT,1904,68,na,1972,2575.4278828645083
STAT,1880,29,45-49,1909,1.144427809008965
STAT,1908,38,40-44,1946,1.3838413948494066
STAT,1871,16,25-29,1887,5.723025400661623
STAT,1908,30,45-49,1938,1.4856870820993524
SIM,1955,15,na,1970,3822
SIM,1892,44,na,1936,3564
STAT,1840,50,30-34,1890,0.0023775257294781724
STAT,1943,25,15-19,1968,0.7439113820585451
STAT,1885,32,20-24,1917,2.656969860366365
STAT,1923,32,35-39,1955,10.366033243140443
STAT,1919,33,25-29,1952,9.797775917911753
STAT,1891,40,35-39,1931,2.249279078692794
SIM,1882,68,na,1950,1035
SIM,1931,32,35-39,1963,6
STAT,1885,25,15-19,1910,0.44899220481252594
SIM,1901,26,30-34,1927,28
STAT,1794,84,na,1878,1.3741910157715655
SIM,1847,8,na,1855,1827
STAT,1818,41,20-24,1859,0.31910612161121377
SIM,1868,34,20-24,1902,2
SIM,1828,32,25-29,1860,25
SIM,1912,38,na,1950,4587
STAT,1899,47,20-24,1946,0.009202451915607623
SIM,1787,77,na,1864,50
STAT,1850,24,40-44,1874,1.138385594417126
SIM,1901,66,na,1967,2671
STAT,1903,48,35-39,1951,0.1106926009496805
STAT,1889,36,40-44,1925,5.296870400285292
SIM,1911,20,15-19,1931,7
STAT,1810,54,na,1864,81.25082259913455
STAT,1870,20,50-100,1890,0.4089654173949347
STAT,1868,29,30-34,1897,24.148625909285183
STAT,1849,16,15-19,1865,6.191568698778964
STAT,1823,32,30-34,1855,48.260913408394465
STAT,1925,36,na,1961,4478.232510575584
STAT,1862,48,35-39,1910,0.11774544180402866
STAT,1892,38,na,1930,2902.4528712527876
STAT,1895,66,na,1961,2282.2164483138085
STAT,1847,17,na,1864,2590.239094199443
STAT,1861,49,30-34,1910,0.07882219628434652
STAT,1835,34,15-19,1869,0.13435897108599612
STAT,1858,39,15-19,1897,0.04245163337795315
STAT,1911,36,na,1947,3610.1530927933445
STAT,1899,38,20-24,1937,0.22612713022758787
STAT,1838,53,40-44,1891,0.004421893093433418
STAT,1856,22,50-100,1878,0.3401723655613882
STAT,1903,20,15-19,1923,4.710943059885991
SIM,1862,68,na,1930,2633
STAT,1869,28,35-39,1897,9.702286196635795
STAT,1824,54,na,1878,446.7591478442728
STAT,1888,7,na,1895,3007.0075358734075
STAT,1948,17,15-19,1965,51.40597344524888
SIM,1897,36,40-44,1933,36
STAT,1831,56,na,1887,1614.163520987346
STAT,1895,32,na,1927,3104.2863719266797
STAT,1905,28,15-19,1933,0.6502726354101382
STAT,1831,39,45-49,1870,1.9749706393075785
SIM,1911,23,20-24,1934,3
STAT,1881,43,45-49,1924,1.4031390916444642
STAT,1916,45,50-100,1961,0.2299004853456621
STAT,1837,18,45-49,1855,0.06939642974446743
STAT,1856,41,25-29,1897,0.46331853576363474
STAT,1952,16,25-29,1968,51.47166752694475
STAT,1839,15,45-49,1854,0.08033347050584144
STAT,1849,97,na,1946,4.526607719280047
SIM,1820,39,na,1859,719
STAT,1824,38,20-24,1862,0.12320310798807246
STAT,1888,44,40-44,1932,2.5609909655699568
STAT,1929,16,35-39,1945,5.330678828065327
STAT,1848,42,45-49,1890,1.3987935279710482
STAT,1843,29,25-29,1872,50.70108305488976
STAT,1893,17,20-24,1910,22.170021703744506
STAT,1891,29,20-24,1920,14.323394003500882
STAT,1851,56,na,1907,1610.8877985002048
STAT,1860,35,20-24,1895,0.6348247738985345
STAT,1889,19,20-24,1908,21.234649936053554
SIM,1855,80,na,1935,891
SIM,1896,44,40-44,1940,2
STAT,1894,19,30-34,1913,2.0159880642737535
SIM,1851,29,25-29,1880,7
SIM,1819,42,na,1861,1880
STAT,1953,18,35-39,1971,5.028921693790824
STAT,1863,43,25-29,1906,0.544257155497773
STAT,1879,44,30-34,1923,1.1634561254788556
STAT,1842,93,na,1935,7.255042358252352
STAT,1887,37,na,1924,2593.1609032767037
STAT,1839,22,na,1861,2552.3681191862183
SIM,1874,33,35-39,1907,3
SIM,1853,26,25-29,1879,29
SIM,1908,13,na,1921,2858
STAT,1866,55,na,1921,1887.447639860249
STAT,1885,35,25-29,1920,2.8569828710320775
SIM,1935,15,na,1950,5238
STAT,1903,15,35-39,1918,0.7825176595382871
STAT,1847,31,na,1878,2324.6574495434243
STAT,1911,25,35-39,1936,14.574726890651968
STAT,1897,37,45-49,1934,2.647453886256348
STAT,1925,30,45-49,1955,1.8536106412871018
STAT,1881,51,30-34,1932,0.005648172486278131
STAT,1908,37,30-34,1945,1.6932151639505322
STAT,1818,44,25-29,1862,1.1839710768064031
STAT,1901,26,20-24,1927,16.459384464682465
STAT,1845,26,25-29,1871,25.734179875193735
STAT,1870,39,30-34,1909,5.259757348378903
SIM,1880,4,na,1884,3342
STAT,1848,18,20-24,1866,20.444516764270475
STAT,1883,22,45-49,1905,0.67085347417594
STAT,1898,44,35-39,1942,0.16681115080614234
STAT,1935,34,20-24,1969,3.3459615841639816
SIM,1914,32,35-39,1946,2
SIM,1918,43,na,1961,4369
SIM,1918,23,na,1941,4443
STAT,1876,7,na,1883,2722.698082240426
SIM,1920,39,45-49,1959,1
SIM,1835,38,na,1873,1266
STAT,1803,52,na,1855,857.712343739581
SIM,1836,49,45-49,1885,2
STAT,1868,103,na,1971,1.4714211211940673
SIM,1916,42,na,1958,4553
STAT,1926,26,25-29,1952,78.49513577538653
SIM,1849,9,na,1858,2802
STAT,1825,52,20-24,1877,9.05116757785831E-4
STAT,1921,20,50-100,1941,0.7387667261716372
STAT,1934,0,na,1934,6052.39792382189
STAT,1908,45,15-19,1953,3.35425525911019E-4
STAT,1912,39,45-49,1951,0.6510199155257618
SIM,1893,20,na,1913,2231
STAT,1916,33,50-100,1949,0.8384077871782704
STAT,1893,26,20-24,1919,14.720851505655158
STAT,1918,31,15-19,1949,0.13526261740895154
STAT,1910,47,50-100,1957,0.20866487449600124
SIM,1875,37,30-34,1912,1
STAT,1858,37,20-24,1895,0.588669775226169
STAT,1838,43,30-34,1881,0.5156410487361092
STAT,1832,32,40-44,1864,0.28339245689339715
SIM,1900,23,45-49,1923,34
STAT,1805,49,45-49,1854,0.28229258180701816
STAT,1892,43,20-24,1935,0.19520505674367097
STAT,1822,42,25-29,1864,1.1448897870481345
SIM,1943,10,na,1953,4986
SIM,1914,33,na,1947,5010
STAT,1918,35,30-34,1953,1.9131202180972728
STAT,1903,23,20-24,1926,97.51978775420615
STAT,1842,73,na,1915,294.853028833942
SIM,1848,40,30-34,1888,1
STAT,1826,35,20-24,1861,1.3272660122146298
STAT,1807,110,na,1917,1.1204211929505252E-4
STAT,1819,36,25-29,1855,1.5196471989012075
SIM,1877,25,30-34,1902,3
STAT,1814,52,45-49,1866,0.047851020391690334
STAT,1948,18,25-29,1966,49.070348532750174
SIM,1929,32,na,1961,6214
STAT,1855,46,na,1901,1493.2543038573099
SIM,1852,34,25-29,1886,167
STAT,1857,92,na,1949,31.960153467783616
STAT,1898,48,15-19,1946,2.9960025775369693E-4
STAT,1909,44,50-100,1953,0.10742893527078845
SIM,1871,7,na,1878,2177
STAT,1846,47,40-44,1893,0.10092235076177537
STAT,1878,32,15-19,1910,0.14651887404039335
STAT,1817,39,25-29,1856,2.177364464147466
STAT,1868,64,na,1932,1679.0297316506083
STAT,1876,20,45-49,1896,0.7091339806456759
STAT,1887,49,50-100,1936,0.14930220989384363
SIM,1834,26,20-24,1860,3
STAT,1941,31,40-44,1972,4.064335435043718
STAT,1842,54,45-49,1896,0.003503556674678569
SIM,1901,12,na,1913,4179
STAT,1863,8,na,1871,2392.208480615758
STAT,1834,45,20-24,1879,0.006323327615233199
STAT,1817,48,25-29,1865,0.0398211515430976
STAT,1844,31,20-24,1875,3.235734559041965
STAT,1848,50,30-34,1898,0.005650291098716517
STAT,1882,14,na,1896,2464.516240679278
STAT,1846,38,40-44,1884,2.6794595927938363
STAT,1846,22,50-100,1868,0.29800021774314894
STAT,1931,18,15-19,1949,58.83023825620601
STAT,1933,21,40-44,1954,4.443102841893754
STAT,1878,16,40-44,1894,0.1886455106314329
STAT,1924,38,25-29,1962,1.1487141828316354
SIM,1909,38,35-39,1947,7
STAT,1822,73,na,1895,684.9179372774465
STAT,1887,39,40-44,1926,4.769706939715006
STAT,1932,15,50-100,1947,0.49493780456931874
STAT,1853,18,30-34,1871,1.4779127100576919
STAT,1892,20,30-34,1912,22.184860271986174
SIM,1831,35,35-39,1866,49
SIM,1909,18,na,1927,4248
STAT,1907,34,45-49,1941,1.4484892396435565
SIM,1922,42,na,1964,3326
STAT,1830,53,40-44,1883,0.00776044070274742
SIM,1827,36,25-29,1863,22
STAT,1811,81,na,1892,327.6118277514792
STAT,1779,93,na,1872,10.587381671824783
STAT,1863,22,25-29,1885,49.84523442795715
STAT,1876,19,50-100,1895,0.049260684387528814
STAT,1867,36,20-24,1903,0.732523755562317
STAT,1886,27,25-29,1913,43.80524060861813
STAT,1930,34,35-39,1964,11.695500698148708
SIM,1802,65,na,1867,351
STAT,1926,36,35-39,1962,2.93335466760439
SIM,1820,50,na,1870,514
STAT,1867,37,30-34,1904,5.040341932537975
SIM,1924,47,30-34,1971,1
STAT,1951,20,45-49,1971,1.3326952752959478
STAT,1839,48,45-49,1887,0.22055332955547194
STAT,1866,31,40-44,1897,3.974813472143188
STAT,1917,21,na,1938,3840.9319268483464
STAT,1928,21,30-34,1949,35.71955688328221
SIM,1894,27,25-29,1921,148
STAT,1823,35,35-39,1858,13.488596022394264
STAT,1837,41,na,1878,2014.911828921767
STAT,1936,30,20-24,1966,2.3483295132456043
STAT,1873,33,40-44,1906,4.429742684289892
SIM,1864,63,na,1927,1934
STAT,1840,42,45-49,1882,0.6147351466587757
SIM,1899,30,35-39,1929,2
STAT,1821,46,25-29,1867,0.062435104908962515
SIM,1871,11,na,1882,2075
STAT,1891,76,na,1967,1532.752223287178
STAT,1839,20,25-29,1859,69.3283430617106
SIM,1926,26,35-39,1952,166
SIM,1859,48,na,1907,1707
SIM,1899,17,na,1916,2174
STAT,1854,39,45-49,1893,1.097258158806374
SIM,1902,28,na,1930,3499
STAT,1882,26,45-49,1908,1.0666635897996175
STAT,1841,30,25-29,1871,14.129045531957393
STAT,1842,36,15-19,1878,0.016523428467747233
STAT,1875,24,45-49,1899,0.7115636342255347
STAT,1877,25,25-29,1902,43.23235913710715
STAT,1897,28,45-49,1925,1.469349833384441
STAT,1958,0,na,1958,5156.386787837931
STAT,1874,64,na,1938,1794.101503114651
STAT,1899,40,35-39,1939,0.17348625247065394
SIM,1875,27,20-24,1902,42
STAT,1916,47,30-34,1963,0.09018776884882286
STAT,1947,21,35-39,1968,10.533110254789458
SIM,1857,61,na,1918,1273
SIM,1813,57,na,1870,35
STAT,1890,35,50-100,1925,1.5004300195382576
STAT,1889,32,50-100,1921,1.1033658150940533
SIM,1901,16,20-24,1917,3
STAT,1839,49,20-24,1888,0.011071814945783444
STAT,1857,17,50-100,1874,0.04418646852590272
STAT,1863,107,na,1970,0.056875810661371796
STAT,1863,21,15-19,1884,2.8933195696415193
SIM,1924,37,20-24,1961,1
SIM,1814,42,40-44,1856,12
STAT,1890,26,35-39,1916,11.721149228285068
STAT,1852,111,na,1963,3.9437489224227563E-4
STAT,1910,22,15-19,1932,4.943040750857769
SIM,1828,56,na,1884,1596
STAT,1831,27,40-44,1858,3.5562165405373194
STAT,1883,37,15-19,1920,0.05402311405473291
STAT,1887,20,20-24,1907,76.30269951121724
SIM,1829,41,50-100,1870,3
STAT,1853,28,40-44,1881,2.4310240613414495
STAT,1872,50,40-44,1922,0.010693455258123407
STAT,1898,31,50-100,1929,1.2371258851968057
STAT,1904,44,35-39,1948,0.17722870268891863
STAT,1817,38,15-19,1855,0.043414244188027674
SIM,1851,38,25-29,1889,8
STAT,1850,28,20-24,1878,6.329112793172303
SIM,1839,28,na,1867,1000
SIM,1925,25,na,1950,4913
SIM,1884,49,na,1933,3654
STAT,1924,37,15-19,1961,0.022426653690355045
STAT,1943,29,30-34,1972,41.212646794809345
STAT,1847,21,30-34,1868,19.88518414490439
STAT,1870,21,20-24,1891,68.90856315933198
STAT,1928,20,20-24,1948,138.5985831482818
STAT,1843,38,25-29,1881,2.9909128846760953
STAT,1835,19,25-29,1854,5.734392063661711
STAT,1814,44,na,1858,2135.0166615829844
STAT,1884,29,15-19,1913,0.43121277367054145
SIM,1902,22,30-34,1924,93
STAT,1933,17,na,1950,4893.784190432527
STAT,1859,45,25-29,1904,0.04610847854698843
SIM,1875,86,na,1961,432
STAT,1796,65,na,1861,1437.426814381716
STAT,1875,46,20-24,1921,0.012357212250082922
STAT,1874,6,na,1880,2819.6483331253235
SIM,1827,71,na,1898,974
SIM,1889,41,30-34,1930,2
STAT,1864,36,35-39,1900,6.460984531345425
STAT,1918,26,35-39,1944,15.81633980816639
STAT,1827,28,30-34,1855,29.424881766656753
STAT,1844,49,30-34,1893,0.0938963936948782
SIM,1843,19,25-29,1862,6
STAT,1887,48,40-44,1935,0.1860675543063922
STAT,1935,26,na,1961,5072.034737215605
STAT,1897,42,25-29,1939,0.05914851287299891
STAT,1927,28,35-39,1955,18.039773002463818
SIM,1886,10,na,1896,3155
STAT,1837,31,15-19,1868,0.1446602499860807
STAT,1816,46,15-19,1862,0.0012342901892738376
STAT,1934,27,30-34,1961,52.35331971127032
STAT,1838,26,na,1864,1181.9963300196946
STAT,1853,3,na,1856,2635.30054116
STAT,1853,19,40-44,1872,0.16859762359599043
STAT,1841,16,45-49,1857,0.09437245614877056
STAT,1875,12,na,1887,2674.5096548014794
STAT,1920,45,30-34,1965,0.09773331896980257
STAT,1944,21,15-19,1965,5.684692125399206
STAT,1893,46,50-100,1939,0.17373856933810428
SIM,1908,36,25-29,1944,1
SIM,1873,20,na,1893,2296
STAT,1907,16,15-19,1923,8.680351280912662
STAT,1920,27,na,1947,4056.59154820547
SIM,1900,19,na,1919,4167
STAT,1826,36,30-34,1862,8.936457248960545
STAT,1841,25,45-49,1866,1.557953759018864
STAT,1864,33,30-34,1897,15.805753539451041
STAT,1871,35,30-34,1906,5.366977677101873
STAT,1893,27,30-34,1920,31.490666150065636
SIM,1844,43,na,1887,2618
SIM,1860,87,na,1947,295
SIM,1865,11,na,1876,1987
STAT,1866,53,20-24,1919,6.627714697784706E-4
STAT,1894,19,na,1913,3194.484862567496
STAT,1828,98,na,1926,2.199035683486222
STAT,1917,39,30-34,1956,1.8564290101405199
SIM,1855,35,na,1890,3121
SIM,1893,74,na,1967,1380
STAT,1884,40,na,1924,2234.810809649729
STAT,1841,22,40-44,1863,2.939556536598186
SIM,1782,88,na,1870,514
SIM,1851,45,na,1896,1183
STAT,1892,45,45-49,1937,0.1664627550601442
STAT,1897,20,15-19,1917,4.407416443218745
STAT,1938,29,20-24,1967,17.872909109165427
SIM,1875,15,20-24,1890,131
STAT,1924,16,15-19,1940,53.65625725207506
STAT,1903,24,30-34,1927,25.12644881977474
STAT,1818,38,30-34,1856,12.474255036806651
STAT,1906,39,20-24,1945,0.2385066392897365
STAT,1878,23,na,1901,2425.806766460137
SIM,1869,1,na,1870,3989
STAT,1866,34,45-49,1900,1.5781652316054207
SIM,1857,4,na,1861,1543
STAT,1839,41,25-29,1880,0.6998952148835901
SIM,1927,37,na,1964,1639
STAT,1825,54,45-49,1879,0.017108360445264398
STAT,1921,29,45-49,1950,1.8890039529267877
STAT,1820,95,na,1915,9.143502523453089
STAT,1935,16,25-29,1951,58.96002188443545
SIM,1824,42,35-39,1866,6
STAT,1837,53,25-29,1890,0.002794504058046619
STAT,1927,42,15-19,1969,0.0019102865250735328
SIM,1902,44,50-100,1946,1
STAT,1829,38,40-44,1867,2.1831253762353904
SIM,1925,39,30-34,1964,1
STAT,1901,29,25-29,1930,58.72375808084039
STAT,1830,34,30-34,1864,16.062924034443903
STAT,1949,17,30-34,1966,14.036175778976567
SIM,1780,76,na,1856,615
STAT,1863,26,50-100,1889,0.5500627077681143
STAT,1803,54,50-100,1857,0.031581866849573016
STAT,1860,17,25-29,1877,5.331653943100156
STAT,1829,49,50-100,1878,0.11068789574024715
SIM,1941,28,25-29,1969,1
STAT,1855,28,40-44,1883,2.0516646854847376
STAT,1833,49,20-24,1882,0.005344014828951263
STAT,1859,32,45-49,1891,1.3821405964794689
STAT,1933,28,25-29,1961,86.76100113899317
STAT,1785,76,na,1861,162.02418955015204
STAT,1827,110,na,1937,1.9487128530917E-4
STAT,1800,95,na,1895,9.17359303353729
SIM,1862,82,na,1944,661
STAT,1881,40,40-44,1921,2.145531535320934
STAT,1888,30,na,1918,2776.332197131689
STAT,1923,17,45-49,1940,0.5804094125104338
STAT,1828,41,15-19,1869,0.017560480638443406
STAT,1856,15,45-49,1871,0.056136960836914156
SIM,1852,28,30-34,1880,87
STAT,1920,41,na,1961,4054.8908084002283
STAT,1844,28,30-34,1872,30.32058763464883
STAT,1920,23,20-24,1943,121.6507776274328
STAT,1824,37,45-49,1861,0.31477193654371616
STAT,1832,22,30-34,1854,27.393152855606907
STAT,1841,34,40-44,1875,5.738852772792671
STAT,1922,28,15-19,1950,0.7871370966799092
SIM,1845,28,na,1873,2645
STAT,1895,32,15-19,1927,0.18525422366135696
STAT,1857,32,45-49,1889,1.3464032661191578
STAT,1887,25,50-100,1912,0.7088690543160294
STAT,1852,4,na,1856,3244.9529797599994
SIM,1848,7,na,1855,2793
STAT,1909,26,25-29,1935,63.00773635113551
SIM,1821,37,35-39,1858,17
STAT,1946,23,40-44,1969,3.700004628527334
SIM,1866,75,na,1941,1197
STAT,1869,50,50-100,1919,0.015458914836681334
STAT,1877,92,na,1969,153.19646209307322
STAT,1851,38,15-19,1889,0.044362351338712344
SIM,1837,38,40-44,1875,1
SIM,1906,0,na,1906,3770
SIM,1829,43,30-34,1872,4
SIM,1874,70,na,1944,1948
SIM,1884,15,na,1899,3819
STAT,1820,92,na,1912,28.642805620137914
STAT,1921,22,25-29,1943,103.09295092989008
STAT,1801,54,25-29,1855,0.008804918442632006
STAT,1853,21,20-24,1874,63.59106782964008
SIM,1813,42,25-29,1855,4
STAT,1912,17,35-39,1929,0.8386521731682706
STAT,1880,28,35-39,1908,9.981817907446496
STAT,1869,42,15-19,1911,0.013918092289221062
STAT,1813,68,na,1881,1324.5480117970214
STAT,1896,29,40-44,1925,3.9206150103503403
STAT,1856,27,45-49,1883,0.8263709996508484
STAT,1867,15,20-24,1882,17.34400674911702
STAT,1873,26,35-39,1899,9.931640398374793
SIM,1857,1,na,1858,2188
STAT,1878,38,50-100,1916,1.2569213479273218
SIM,1848,56,na,1904,2307
STAT,1869,49,35-39,1918,0.13832182346223568
STAT,1888,33,na,1921,2742.570900609178
STAT,1886,46,30-34,1932,0.10052585330269337
STAT,1894,29,40-44,1923,3.782108382031017
STAT,1869,27,50-100,1896,0.645502000178928
STAT,1906,15,na,1921,3674.250126146361
STAT,1871,17,35-39,1888,0.5508963708335173
STAT,1888,22,30-34,1910,20.558290641943277
SIM,1868,53,na,1921,928
STAT,1808,61,na,1869,602.1186240224373
STAT,1874,29,20-24,1903,12.021102455889475
STAT,1916,22,na,1938,3774.3912340019433
STAT,1906,18,20-24,1924,25.604917953662486
SIM,1921,12,na,1933,5331
SIM,1896,34,30-34,1930,104
STAT,1926,18,40-44,1944,1.6957365459155298
STAT,1826,86,na,1912,176.88770078557044
SIM,1892,39,25-29,1931,10
STAT,1836,36,25-29,1872,2.7363324575116614
STAT,1970,2,na,1972,4875.420792081999
STAT,1886,52,na,1938,2217.903893175302
STAT,1892,24,45-49,1916,0.8579448191241213
STAT,1907,62,na,1969,2959.4022831447564
STAT,1851,26,15-19,1877,0.42258988620506466
STAT,1825,33,45-49,1858,2.8585694778467228
STAT,1910,29,35-39,1939,14.233173440450786
SIM,1869,100,na,1969,111
STAT,1867,27,20-24,1894,11.094786170183468
SIM,1858,63,na,1921,2126
STAT,1882,23,40-44,1905,1.9888952251387837
SIM,1883,30,na,1913,2159
STAT,1875,21,40-44,1896,2.146223874074753
SIM,1858,46,na,1904,2325
STAT,1832,26,50-100,1858,0.7878537294418125
STAT,1857,43,35-39,1900,1.3795108501104532
STAT,1888,34,30-34,1922,19.97884406804449
STAT,1855,21,20-24,1876,53.667732151669654
SIM,1882,29,20-24,1911,10
STAT,1909,33,30-34,1942,14.818863998532928
STAT,1872,33,25-29,1905,10.213247547555827
STAT,1901,36,50-100,1937,0.3723068641628821
STAT,1838,24,25-29,1862,31.250915829549495
SIM,1865,43,35-39,1908,3
STAT,1889,21,35-39,1910,7.048446900421466
STAT,1914,24,40-44,1938,3.366181559753959
STAT,1827,38,40-44,1865,4.263869225102907
STAT,1865,31,25-29,1896,9.389622027877328
STAT,1900,19,30-34,1919,2.196123249319647
SIM,1829,31,30-34,1860,3
STAT,1884,39,25-29,1923,2.7284362991157387
STAT,1845,45,30-34,1890,0.04851268319061173
SIM,1876,39,40-44,1915,23
SIM,1899,28,20-24,1927,8
SIM,1881,23,30-34,1904,12
STAT,1842,32,35-39,1874,3.0369599363204984
STAT,1880,67,na,1947,1645.7009500677766
STAT,1870,18,30-34,1888,1.5946696474900577
STAT,1878,54,25-29,1932,0.00354405311062941
STAT,1917,20,45-49,1937,1.1869252443693346
SIM,1824,40,na,1864,2139
STAT,1912,31,15-19,1943,0.12548952384865453
STAT,1953,14,na,1967,4707.501265987713
SIM,1926,35,30-34,1961,6
STAT,1851,53,na,1904,1673.251604535851
STAT,1882,50,35-39,1932,0.00836084836819954
STAT,1827,31,20-24,1858,2.8261588451606388
STAT,1826,106,na,1932,0.009679793334809695
STAT,1871,22,na,1893,2359.2391689034935
SIM,1866,41,na,1907,3052
STAT,1951,17,20-24,1968,159.94120435487034
STAT,1911,19,40-44,1930,0.2752589744243969
STAT,1881,18,40-44,1899,0.17227155728486265
STAT,1906,20,35-39,1926,8.500610373828454
STAT,1865,38,45-49,1903,1.8110081806051053
STAT,1898,43,50-100,1941,0.09793872869119126
STAT,1894,22,20-24,1916,87.63316119808435
STAT,1926,44,20-24,1970,0.0215131156311557
STAT,1935,29,na,1964,5064.734507860857
SIM,1857,16,na,1873,1436
STAT,1879,70,na,1949,1439.3294229194828
STAT,1868,39,40-44,1907,4.18554842665663
SIM,1905,20,25-29,1925,2
STAT,1933,14,na,1947,5251.017798941632
STAT,1925,33,15-19,1958,0.15110869976816618
STAT,1851,44,45-49,1895,1.166080040762856
SIM,1808,49,35-39,1857,4
STAT,1907,38,25-29,1945,0.9022573892553853
STAT,1922,22,na,1944,4141.060873083933
SIM,1817,61,na,1878,2170
STAT,1881,36,50-100,1917,1.1649964684335194
STAT,1840,16,na,1856,1177.161403922512
STAT,1863,47,40-44,1910,0.1454741602093621
SIM,1918,3,na,1921,4571
STAT,1799,90,na,1889,6.294644624732033
STAT,1821,43,20-24,1864,0.17562930038257235
STAT,1861,42,50-100,1903,0.8775090823885252
SIM,1912,52,na,1964,4423
STAT,1831,32,25-29,1863,10.892518353053157
STAT,1939,27,15-19,1966,0.7018958735606466
STAT,1822,49,45-49,1871,0.38384175432138423
STAT,1936,33,25-29,1969,8.882878273287709
STAT,1847,43,40-44,1890,2.018918092649281
STAT,1891,22,na,1913,2908.368263350158
STAT,1906,12,na,1918,3739.6575700808635
STAT,1842,21,45-49,1863,0.21991695198779637
SIM,1910,28,30-34,1938,2
STAT,1833,68,na,1901,628.7573186886704
STAT,1906,32,35-39,1938,8.420479575601405
STAT,1932,36,50-100,1968,0.5607035375765884
STAT,1836,54,20-24,1890,5.499129279494803E-4
SIM,1859,26,25-29,1885,222
STAT,1902,28,30-34,1930,35.335335007567586
SIM,1855,43,40-44,1898,8
STAT,1880,81,na,1961,764.3467708996266
STAT,1816,42,35-39,1858,5.95172626206571
SIM,1843,16,20-24,1859,114
STAT,1897,34,40-44,1931,5.710075205329888
STAT,1839,53,na,1892,1968.3159726708739
SIM,1913,37,na,1950,3060
STAT,1833,42,35-39,1875,0.9426339688438836
STAT,1802,76,na,1878,552.2307102007251
STAT,1877,34,20-24,1911,2.7204374999229666
STAT,1841,25,50-100,1866,0.8976027731124946
STAT,1834,98,na,1932,1.4316492080610561
STAT,1931,36,na,1967,4952.03300618012
STAT,1884,74,na,1958,1156.1463773312835
STAT,1866,52,40-44,1918,0.009558677397157456
STAT,1880,21,15-19,1901,3.435236545265351
SIM,1819,49,45-49,1868,3
STAT,1858,49,25-29,1907,0.04306864692134515
STAT,1835,60,na,1895,1443.0772601788583
STAT,1879,25,25-29,1904,43.688885383795906
SIM,1923,44,na,1967,4223
STAT,1872,37,50-100,1909,1.2294119944711719
STAT,1851,23,45-49,1874,0.65296804583505
STAT,1872,25,50-100,1897,0.6449078938171511
STAT,1935,23,30-34,1958,38.84396243580761
SIM,1870,26,25-29,1896,1
STAT,1859,39,30-34,1898,4.1816694741275855
STAT,1790,104,na,1894,0.019394405579497294
STAT,1929,23,40-44,1952,4.2091301720365895
SIM,1853,23,na,1876,3553
STAT,1826,39,35-39,1865,10.99372690611335
STAT,1894,15,15-19,1909,7.581785329402943
STAT,1909,23,20-24,1932,101.97765211023733
SIM,1819,76,na,1895,45
SIM,1869,30,20-24,1899,8
STAT,1932,22,35-39,1954,12.26855846978577
STAT,1789,83,na,1872,230.344823864731
SIM,1835,24,15-19,1859,12
STAT,1852,16,20-24,1868,21.711123618034083
SIM,1855,36,35-39,1891,1
SIM,1917,23,20-24,1940,1
STAT,1868,32,20-24,1900,2.610805667849785
STAT,1915,22,35-39,1937,9.595636346256663
STAT,1883,33,35-39,1916,9.701560858217672
STAT,1929,35,40-44,1964,1.9117192123653357
STAT,1887,37,50-100,1924,1.3513435426061862
SIM,1870,8,na,1878,2671
SIM,1933,37,na,1970,4321
STAT,1862,26,25-29,1888,36.42420426726247
SIM,1822,62,na,1884,516
STAT,1872,38,na,1910,2347.4788053513203
STAT,1875,8,na,1883,2751.152155894327
SIM,1848,44,45-49,1892,2
STAT,1887,44,25-29,1931,0.6972644890533396
STAT,1823,48,50-100,1871,0.3777509031768263
STAT,1905,27,50-100,1932,0.9200826998423006
STAT,1909,44,20-24,1953,0.016149448093656225
STAT,1946,16,35-39,1962,4.605121656431699
STAT,1826,80,na,1906,493.1672866937162
STAT,1882,17,45-49,1899,0.06254043640599954
STAT,1872,16,40-44,1888,0.18484291146203816
STAT,1901,17,25-29,1918,7.923305778622859
STAT,1897,46,40-44,1943,0.12861550946389588
STAT,1898,33,45-49,1931,2.335051311984743
STAT,1847,36,35-39,1883,6.704089037621828
STAT,1860,67,na,1927,1293.2082932335395
STAT,1944,25,30-34,1969,41.908619678569764
SIM,1815,83,na,1898,339
STAT,1814,100,na,1914,0.7185049583207452
STAT,1852,37,20-24,1889,0.7801374049119151
SIM,1843,26,30-34,1869,9
STAT,1946,0,na,1946,4879.23438382281
STAT,1852,29,35-39,1881,10.147116743878062
STAT,1897,49,45-49,1946,0.17310377939400828
STAT,1865,17,45-49,1882,0.061456762070146324
STAT,1873,85,na,1958,358.9803327341259
STAT,1923,39,20-24,1962,0.3015840291782979
STAT,1860,28,15-19,1888,0.3714067862099123
STAT,1850,49,20-24,1899,0.005425445345179865
SIM,1896,37,35-39,1933,12
STAT,1903,27,35-39,1930,13.696762132043375
STAT,1832,25,35-39,1857,12.066334724409929
SIM,1846,75,na,1921,319
STAT,1844,38,40-44,1882,4.535405776116353
STAT,1863,29,45-49,1892,0.9411047554710774
SIM,1875,89,na,1964,283
STAT,1861,54,50-100,1915,0.01221470091791218
STAT,1846,26,40-44,1872,2.1618110901846443
STAT,1804,54,na,1858,2110.446235815625
STAT,1854,17,35-39,1871,0.3649628017532475
STAT,1905,15,35-39,1920,0.7928864588906286
STAT,1879,32,30-34,1911,17.910873763987418
STAT,1917,28,40-44,1945,4.8058870126947
SIM,1897,36,na,1933,2480
SIM,1929,29,20-24,1958,133
STAT,1882,48,na,1930,2126.955295687324
STAT,1898,23,35-39,1921,7.822820611212294
STAT,1936,19,45-49,1955,0.4709723519748785
SIM,1919,22,na,1941,5211
STAT,1838,48,50-100,1886,0.10648779552485203
SIM,1860,37,20-24,1897,1
STAT,1809,46,na,1855,3117.5829024147683
STAT,1866,16,15-19,1882,5.593228111937311
STAT,1873,23,30-34,1896,18.21501822505667
STAT,1837,51,35-39,1888,0.007066633301247017
STAT,1887,23,25-29,1910,62.81401298090985
STAT,1925,19,35-39,1944,4.995614362800338
STAT,1835,26,30-34,1861,25.01158625717677
SIM,1891,30,30-34,1921,80
SIM,1831,76,na,1907,736
SIM,1895,23,25-29,1918,17
STAT,1838,106,na,1944,0.005178093722038348
STAT,1875,49,25-29,1924,0.05791174988804178
STAT,1884,15,20-24,1899,17.04988365767137
STAT,1919,16,40-44,1935,0.3067445022910195
STAT,1862,23,20-24,1885,59.65461208085969
SIM,1789,72,na,1861,303
STAT,1925,9,na,1934,4764.881319587776
SIM,1870,23,20-24,1893,23
STAT,1892,42,40-44,1934,2.78138597861913
STAT,1918,23,30-34,1941,30.485614029340407
STAT,1831,87,na,1918,137.88789785848854
STAT,1880,25,30-34,1905,26.32006200255483
STAT,1819,53,na,1872,569.2583588404392
STAT,1825,39,na,1864,1723.216396646943
STAT,1812,53,50-100,1865,0.0036418332254148913
STAT,1825,51,40-44,1876,0.013171661969183072
STAT,1877,37,25-29,1914,2.922731640530684
STAT,1886,49,35-39,1935,0.14195000475212122
STAT,1883,30,30-34,1913,16.93201901204951
STAT,1921,26,40-44,1947,5.15077828626526
STAT,1838,21,20-24,1859,38.44208764447424
STAT,1846,86,na,1932,131.40858019314973
STAT,1885,1,na,1886,3252.0317427102445
SIM,1832,34,40-44,1866,120
STAT,1814,49,50-100,1863,0.8171841594524647
STAT,1910,26,30-34,1936,37.54171502285305
STAT,1856,45,na,1901,1632.066523240191
SIM,1920,9,na,1929,4867
STAT,1839,27,45-49,1866,1.299515044541383
SIM,1868,56,na,1924,719
STAT,1872,30,20-24,1902,2.728490915589374
SIM,1848,53,na,1901,2307
STAT,1879,73,na,1952,1218.444001087707
SIM,1899,14,na,1913,2176
SIM,1860,31,50-100,1891,45
STAT,1875,5,na,1880,2817.1428156919105
STAT,1891,21,25-29,1912,70.60910777655678
STAT,1822,46,40-44,1868,0.29028050891685203
STAT,1866,52,na,1918,1954.9886566205075
STAT,1889,80,na,1969,1172.0159101771812
SIM,1926,23,30-34,1949,57
STAT,1826,47,20-24,1873,0.017173106235588643
STAT,1946,26,45-49,1972,1.9045114529291503
STAT,1818,48,40-44,1866,0.30071230898648427
SIM,1903,36,40-44,1939,2
SIM,1881,36,45-49,1917,1
SIM,1840,25,35-39,1865,14
STAT,1834,20,40-44,1854,1.2460594581912998
STAT,1945,20,20-24,1965,120.60529243104641
STAT,1861,19,50-100,1880,0.04628019427851529
SIM,1897,33,na,1930,2260
STAT,1888,37,35-39,1925,8.163309227877482
STAT,1908,49,30-34,1957,0.07952818058930902
STAT,1877,16,25-29,1893,5.76653937454816
SIM,1866,25,20-24,1891,4
STAT,1938,31,35-39,1969,9.095549879175431
SIM,1907,2,na,1909,4894
STAT,1891,25,40-44,1916,3.7087226884554894
STAT,1884,18,25-29,1902,5.410390266674064
STAT,1923,37,50-100,1960,0.4813622337007059
SIM,1833,57,na,1890,2017
STAT,1929,40,na,1969,4789.209212652788
STAT,1862,44,20-24,1906,0.13344171614212008
SIM,1914,30,na,1944,5033
STAT,1824,34,40-44,1858,1.7783404876486972
STAT,1893,38,20-24,1931,0.959186696325999
STAT,1854,19,na,1873,1508.8347253772358
STAT,1914,27,45-49,1941,1.7173870765068937
SIM,1964,4,na,1968,5113
STAT,1848,39,20-24,1887,0.7280774450109809
STAT,1824,30,25-29,1854,5.220212606063333
STAT,1861,16,30-34,1877,1.5325706251343332
STAT,1896,11,na,1907,3409.417496161701
STAT,1858,25,20-24,1883,9.30430618705407
STAT,1836,33,20-24,1869,2.591096832326716
STAT,1869,46,30-34,1915,0.09795645557185488
STAT,1904,34,na,1938,3408.8759317775575
SIM,1790,69,na,1859,1197
SIM,1854,22,25-29,1876,69
STAT,1837,39,45-49,1876,1.9061210847326426
SIM,1936,11,na,1947,4041
SIM,1839,32,35-39,1871,3
SIM,1858,3,na,1861,2651
STAT,1873,36,45-49,1909,2.054720152746729
STAT,1852,31,50-100,1883,0.9648797956837182
SIM,1904,23,na,1927,3246
STAT,1904,22,25-29,1926,81.78657258321402
STAT,1925,6,na,1931,4797.430711573188
STAT,1947,19,20-24,1966,151.01079466637373
STAT,1830,37,35-39,1867,6.451423121352517
SIM,1912,22,25-29,1934,3
STAT,1896,36,50-100,1932,1.626235327915024
STAT,1919,33,na,1952,4009.216817813289
STAT,1914,41,na,1955,3634.130154246287
SIM,1880,1,na,1881,3954
STAT,1925,27,20-24,1952,21.362739755000167
SIM,1844,36,25-29,1880,6
STAT,1905,39,50-100,1944,0.37731521256235245
STAT,1838,31,30-34,1869,9.35805551153646
STAT,1857,22,35-39,1879,5.169503824347611
SIM,1855,33,30-34,1888,14
SIM,1882,34,na,1916,1871
SIM,1895,55,na,1950,4395
STAT,1844,20,na,1864,2683.126399216624
STAT,1808,48,15-19,1856,6.204772272670636E-4
STAT,1840,61,na,1901,735.7838412204583
STAT,1857,41,na,1898,1781.581153981644
STAT,1959,8,na,1967,5094.924263227012
STAT,1884,36,20-24,1920,0.7414639748177234
STAT,1909,36,35-39,1945,2.277034288667814
STAT,1815,47,45-49,1862,0.023921849465799262
SIM,1871,42,na,1913,1852
STAT,1876,23,15-19,1899,3.324704708209373
STAT,1924,34,45-49,1958,1.8158732855923174
STAT,1929,38,45-49,1967,0.868201436760488
STAT,1785,79,na,1864,121.92373013823715
STAT,1845,48,35-39,1893,0.06859748393670473
STAT,1846,22,25-29,1868,41.833266196935284
STAT,1878,52,35-39,1930,0.008810442584722121
STAT,1910,16,20-24,1926,26.628505954463407
STAT,1827,34,25-29,1861,10.25637473248945
STAT,1792,72,na,1864,706.0301244877568
STAT,1816,79,na,1895,590.2031502043708
STAT,1851,41,40-44,1892,1.7844994212465497
STAT,1897,16,45-49,1913,0.08696474300553055
SIM,1864,49,na,1913,2413
SIM,1949,22,20-24,1971,4
STAT,1840,17,40-44,1857,0.0932448905377478
STAT,1847,33,30-34,1880,18.342877184707103
STAT,1869,18,na,1887,2568.615610284702
STAT,1878,26,50-100,1904,0.6604184476684026
STAT,1806,80,na,1886,233.50914660247653
STAT,1807,65,na,1872,944.0472679769632
STAT,1849,31,40-44,1880,4.275474147000163
STAT,1868,22,45-49,1890,0.6735225856506761
STAT,1915,47,15-19,1962,3.65949195343856E-4
STAT,1795,86,na,1881,87.87224410681226
STAT,1837,27,na,1864,2226.321302435046
STAT,1848,20,35-39,1868,6.745470902367616
STAT,1912,42,50-100,1954,0.11198940282378152
STAT,1834,48,25-29,1882,0.026578860917895766
STAT,1877,22,50-100,1899,0.4139563418109824
STAT,1870,35,15-19,1905,0.05651401424291287
STAT,1943,18,40-44,1961,1.4658339823610358
STAT,1861,107,na,1968,0.042276234450421224
SIM,1884,27,30-34,1911,199
STAT,1938,21,25-29,1959,90.46910317033817
STAT,1892,27,15-19,1919,0.5617263155932335
STAT,1843,27,na,1870,2630.4622115469256
STAT,1832,35,45-49,1867,0.14176363691571345
STAT,1855,24,25-29,1879,43.628374081700414
STAT,1859,20,45-49,1879,0.6392974838467863
STAT,1817,72,na,1889,413.67622609754784
STAT,1899,25,na,1924,3281.7887354857476
STAT,1817,45,20-24,1862,0.008632605868065028
SIM,1851,42,na,1893,1154
SIM,1828,36,40-44,1864,3
STAT,1859,35,15-19,1894,0.044930386055325684
STAT,1954,16,50-100,1970,0.45919641996631994
STAT,1903,43,50-100,1946,0.10338617342930337
STAT,1858,26,na,1884,1879.1802397793933
STAT,1853,34,na,1887,1866.2817839794523
SIM,1894,70,na,1964,856
STAT,1855,60,na,1915,1262.2410661459453
STAT,1887,27,40-44,1914,3.297136870682576
SIM,1853,57,na,1910,2774
STAT,1927,21,15-19,1948,6.524667860877454
STAT,1836,19,40-44,1855,0.3312352315540053
SIM,1930,2,na,1932,5851
STAT,1865,35,40-44,1900,4.034577362167269
STAT,1918,38,35-39,1956,2.512490039434967
SIM,1873,35,40-44,1908,1
STAT,1850,111,na,1961,1.1917641431726084E-4
STAT,1871,50,25-29,1921,0.003584087573788581
STAT,1889,18,na,1907,3033.4296178584173
STAT,1899,29,25-29,1928,57.365176109405986
SIM,1840,35,45-49,1875,2
STAT,1836,79,na,1915,535.0511025731313
STAT,1889,44,50-100,1933,1.2550334006815853
STAT,1834,38,15-19,1872,0.030465392445370942
STAT,1935,26,35-39,1961,20.32734496032739
STAT,1829,37,50-100,1866,0.6226914602505235
STAT,1864,21,30-34,1885,16.57264874058472
STAT,1833,28,20-24,1861,7.014173662066545
STAT,1852,19,25-29,1871,6.81781587159437
STAT,1876,27,30-34,1903,25.456584714202663
SIM,1893,29,30-34,1922,52
SIM,1920,19,na,1939,4501
STAT,1866,37,15-19,1903,0.05125893490581152
STAT,1841,37,45-49,1878,2.615451611247357
STAT,1855,50,40-44,1905,0.007067709489727141
STAT,1895,18,35-39,1913,0.7119304654053441
SIM,1879,48,na,1927,1085
STAT,1870,28,40-44,1898,2.975864854946492
STAT,1848,103,na,1951,0.13429770440270422
STAT,1822,40,35-39,1862,3.377542231626753
SIM,1834,50,na,1884,727
STAT,1842,42,na,1884,593.6091965968712
STAT,1903,45,30-34,1948,0.07828268288049132
SIM,1946,21,25-29,1967,1
STAT,1867,48,20-24,1915,0.011206163608766001
STAT,1869,25,30-34,1894,25.58299266023301
SIM,1857,31,40-44,1888,74
STAT,1815,91,na,1906,4.085645368235667
STAT,1908,16,30-34,1924,2.3518143720124183
STAT,1952,20,50-100,1972,0.7844429796253403
STAT,1888,84,na,1972,796.4091556065722
SIM,1821,34,30-34,1855,88
STAT,1786,72,na,1858,1020.4941521958045
STAT,1825,36,15-19,1861,0.08290167817979553
STAT,1944,28,35-39,1972,16.03642369676664
SIM,1824,43,na,1867,2103
STAT,1850,20,25-29,1870,32.18782610724947
STAT,1925,37,30-34,1962,2.1674740239879253
STAT,1843,32,50-100,1875,1.088334332238758
STAT,1843,17,25-29,1860,7.1551127504094
STAT,1887,41,20-24,1928,0.17559218043061742
STAT,1914,38,50-100,1952,0.41132002635200265
STAT,1885,29,30-34,1914,24.575621234603766
STAT,1913,48,na,1961,3530.953079590847
SIM,1835,35,na,1870,1267
SIM,1945,25,na,1970,6253
STAT,1875,39,15-19,1914,0.05708208987880791
STAT,1888,47,45-49,1935,0.27111277188373023
STAT,1802,73,na,1875,733.8582338608804
STAT,1854,31,15-19,1885,0.08193267772556599
STAT,1860,38,25-29,1898,2.3371763303472437
SIM,1880,56,na,1936,3193
STAT,1828,27,35-39,1855,20.189192786389658
STAT,1870,18,50-100,1888,0.04901647510073913
STAT,1913,34,35-39,1947,8.901071378061904
SIM,1840,50,na,1890,2572
SIM,1921,34,35-39,1955,84
SIM,1930,26,na,1956,5355
STAT,1919,30,20-24,1949,2.6174967815599626
SIM,1878,39,40-44,1917,45
STAT,1890,26,na,1916,2899.057153844751
STAT,1879,22,20-24,1901,70.69318196191936
STAT,1940,17,45-49,1957,0.5015129302632395
SIM,1836,27,35-39,1863,13
SIM,1896,47,45-49,1943,3
SIM,1887,22,20-24,1909,2
STAT,1897,47,na,1944,2974.5285776109354
STAT,1858,46,20-24,1904,0.009189990155017548
STAT,1815,41,30-34,1856,0.12422328350327347
STAT,1925,16,15-19,1941,54.45467687599634
STAT,1857,44,15-19,1901,0.01045408913108763
STAT,1921,43,na,1964,4126.954123729668
SIM,1878,24,30-34,1902,13
STAT,1843,45,25-29,1888,0.05811627500767977
STAT,1927,24,25-29,1951,112.1704927181056
STAT,1924,23,45-49,1947,1.3108704924464682
STAT,1847,26,na,1873,2367.8323127376425
STAT,1856,51,45-49,1907,0.010473465904320974
STAT,1922,15,35-39,1937,4.8243932743011015
SIM,1871,28,na,1899,1333
STAT,1833,32,35-39,1865,5.731218806468537
STAT,1944,21,20-24,1965,118.74612250320588
STAT,1863,49,45-49,1912,0.19726943445699735
STAT,1878,43,20-24,1921,0.16221749257752577
STAT,1870,27,40-44,1897,2.9863769016402646
STAT,1904,42,50-100,1946,0.1046832163876727
STAT,1814,47,na,1861,2079.318973544011
STAT,1851,31,na,1882,1982.1003706989818
STAT,1889,29,50-100,1918,0.7648278581835194
SIM,1837,43,25-29,1880,2
SIM,1789,67,na,1856,303
STAT,1880,46,40-44,1926,0.17823665634459285
SIM,1888,44,na,1932,100
STAT,1799,100,na,1899,0.07059803442305926
STAT,1823,83,na,1906,313.6105892701206
SIM,1926,35,na,1961,5872
STAT,1861,29,40-44,1890,2.4734342639879943
STAT,1868,95,na,1963,35.30835600045013
STAT,1888,28,40-44,1916,3.4452011751604354
STAT,1864,81,na,1945,491.6123381033808
STAT,1845,53,35-39,1898,0.004203370695476792
STAT,1911,36,40-44,1947,1.4364876570932452
SIM,1827,29,30-34,1856,8
STAT,1820,45,30-34,1865,0.15621113315902815
STAT,1843,54,50-100,1897,0.014511841706686726
SIM,1883,13,na,1896,2241
STAT,1820,41,50-100,1861,1.7760121430833224
STAT,1887,35,50-100,1922,1.3641774159772748
STAT,1894,26,15-19,1920,0.5789346647229896
SIM,1922,21,na,1943,3621
STAT,1882,32,30-34,1914,16.71611256539395
STAT,1906,36,50-100,1942,0.3855822208262668
SIM,1884,30,na,1914,3791
STAT,1877,17,25-29,1894,5.752411353080515
SIM,1896,28,40-44,1924,8
STAT,1879,22,30-34,1901,18.272549739468793
STAT,1871,40,30-34,1911,1.1584162932678397
STAT,1847,53,45-49,1900,0.012910249170572994
STAT,1941,20,40-44,1961,3.437601478427159
STAT,1918,31,20-24,1949,2.5674374897236385
STAT,1829,43,25-29,1872,0.3044678200188662
STAT,1909,33,20-24,1942,2.2942100946797344
STAT,1860,101,na,1961,1.2301266927913004
STAT,1832,48,50-100,1880,0.021984259934167912
STAT,1896,34,25-29,1930,13.386494725305624
SIM,1938,20,na,1958,4231
STAT,1876,29,50-100,1905,0.642048300978811
STAT,1917,42,50-100,1959,0.12096369322117856
STAT,1864,50,40-44,1914,0.009708286632107519
STAT,1802,100,na,1902,0.5379006819262655
SIM,1919,36,35-39,1955,1
STAT,1877,22,20-24,1899,69.95447478859488
STAT,1934,18,na,1952,4931.933770361484
STAT,1874,49,20-24,1923,0.012126213462299196
SIM,1872,45,na,1917,2318
STAT,1871,53,50-100,1924,0.014823756348635557
STAT,1909,20,15-19,1929,4.926291612560139
STAT,1805,86,na,1891,29.767560870596558
STAT,1847,47,50-100,1894,0.22101591031629972
STAT,1826,32,na,1858,2327.747202933234
STAT,1889,44,35-39,1933,2.1511928783229246
STAT,1860,47,50-100,1907,0.19942447445688163
SIM,1939,6,na,1945,4904
STAT,1852,48,30-34,1900,0.09621340330481161
STAT,1827,35,15-19,1862,0.05674504137360128
STAT,1847,27,40-44,1874,3.2552865822179835
STAT,1915,38,50-100,1953,0.4160735230511549
SIM,1880,64,na,1944,3193
STAT,1861,27,15-19,1888,0.3800598217243438
STAT,1880,33,35-39,1913,10.469091871055904
STAT,1893,62,na,1955,2285.6286343892634
SIM,1968,2,na,1970,3309
STAT,1901,29,35-39,1930,13.394853600488267
STAT,1933,21,45-49,1954,1.4868309438172003
STAT,1792,105,na,1897,0.0070978412507030535
STAT,1836,18,50-100,1854,0.11879571564408507
STAT,1871,48,40-44,1919,0.16863361914938912
STAT,1919,18,40-44,1937,1.5211708328731373
SIM,1890,32,30-34,1922,129
STAT,1865,35,35-39,1900,6.518841921419485
SIM,1837,23,30-34,1860,1
STAT,1847,52,30-34,1899,0.00535315084030991
SIM,1823,41,30-34,1864,2
STAT,1815,50,45-49,1865,0.0014776331422520325
SIM,1869,41,na,1910,3597
STAT,1909,18,50-100,1927,0.07253303304053856
STAT,1870,39,35-39,1909,6.980262261905562
SIM,1918,16,na,1934,4461
STAT,1898,22,40-44,1920,2.802132740675423
STAT,1922,20,30-34,1942,32.78642451112382
STAT,1834,101,na,1935,0.2514768219519807
STAT,1884,40,40-44,1924,2.1748959350561194
SIM,1842,47,na,1889,3042
STAT,1826,64,na,1890,1385.8820607887924
SIM,1851,67,na,1918,979
STAT,1822,40,50-100,1862,1.9705012765795649
STAT,1880,28,na,1908,2468.858645970189
SIM,1839,43,na,1882,823
SIM,1956,4,na,1960,4927
STAT,1843,50,20-24,1893,7.395748008290004E-4
SIM,1793,72,na,1865,740
STAT,1845,53,50-100,1898,0.007373913140531801
STAT,1831,24,25-29,1855,92.55494023293706
STAT,1910,44,25-29,1954,0.06591289921802848
SIM,1890,41,45-49,1931,38
STAT,1882,41,45-49,1923,1.4393821883736682
STAT,1868,38,40-44,1906,4.207131008731424
STAT,1913,44,50-100,1957,0.11275077446252507
STAT,1920,29,45-49,1949,1.8574069466370593
STAT,1835,39,40-44,1874,4.010604313300418
STAT,1801,72,na,1873,499.51004448480313
STAT,1858,30,50-100,1888,0.7143870224317228
STAT,1889,57,na,1946,2420.0479210114545
SIM,1876,38,40-44,1914,14
STAT,1858,17,15-19,1875,5.2939834733743085
STAT,1867,43,45-49,1910,1.4051929490701334
SIM,1876,59,na,1935,3039
SIM,1834,28,na,1862,1139
SIM,1840,19,20-24,1859,62
SIM,1935,24,25-29,1959,135
STAT,1928,33,30-34,1961,19.538201990324367
SIM,1892,40,40-44,1932,2
STAT,1885,43,na,1928,2255.420437539139
SIM,1839,31,40-44,1870,5
STAT,1866,102,na,1968,1.8646752176179053
STAT,1874,36,15-19,1910,0.05823418441869353
SIM,1936,33,30-34,1969,4
STAT,1856,62,na,1918,1312.7743879561144
STAT,1916,49,50-100,1965,0.22748228373163099
SIM,1821,69,na,1890,1505
STAT,1903,15,25-29,1918,8.081358105780486
STAT,1838,22,50-100,1860,0.22584814190291433
STAT,1903,6,na,1909,3708.270482246373
STAT,1848,31,40-44,1879,4.7819677446699025
STAT,1818,100,na,1918,0.6461769130795972
STAT,1850,24,35-39,1874,3.1879250752680193
SIM,1912,59,na,1971,4354
STAT,1870,25,15-19,1895,0.45537972103373653
STAT,1890,40,40-44,1930,2.7504656278702933
SIM,1822,32,25-29,1854,16
STAT,1838,29,40-44,1867,1.603353310360791
STAT,1776,88,na,1864,83.73581817500751
STAT,1921,11,na,1932,4469.580955340916
SIM,1835,37,40-44,1872,4
STAT,1814,79,na,1893,473.1436317751398
SIM,1859,63,na,1922,1535
STAT,1891,36,15-19,1927,0.06938724388733787
STAT,1837,42,20-24,1879,0.15026267935729395
STAT,1853,25,15-19,1878,0.4134556576243041
STAT,1809,49,40-44,1858,1.4403600822207954
STAT,1881,23,25-29,1904,53.89272074788574
STAT,1880,12,na,1892,2681.0433455780358
STAT,1829,26,35-39,1855,8.252956370237484
STAT,1831,70,na,1901,1098.1160860615037
STAT,1913,56,na,1969,3408.8545440896305
SIM,1817,49,40-44,1866,3
STAT,1798,99,na,1897,0.8038858463434954
STAT,1794,85,na,1879,1.112132789063928
STAT,1862,15,na,1877,2265.8156668249007
STAT,1876,44,25-29,1920,0.6403992390331548
STAT,1866,29,na,1895,2162.8931929806904
STAT,1944,16,25-29,1960,46.123441969175666
STAT,1905,23,35-39,1928,8.36735555717105
SIM,1892,65,na,1957,3279
STAT,1834,27,30-34,1861,14.552597264593565
STAT,1858,53,20-24,1911,5.544747294342403E-4
STAT,1897,46,35-39,1943,0.10517623461722969
STAT,1818,37,15-19,1855,0.14297238822161581
STAT,1835,84,na,1919,251.71130691826744
STAT,1813,42,35-39,1855,9.065788369707155
SIM,1842,27,30-34,1869,2
STAT,1809,53,25-29,1862,0.028658624181426135
STAT,1839,98,na,1937,3.018109481374007
STAT,1894,28,40-44,1922,3.795925551036791
STAT,1849,22,45-49,1871,0.7103746597027744
STAT,1855,29,40-44,1884,2.0369337330429573
STAT,1896,37,50-100,1933,1.6184456606943112
STAT,1933,37,30-34,1970,2.4656213515938306
STAT,1855,109,na,1964,0.002741409017557132
STAT,1830,42,35-39,1872,1.6008076181887851
SIM,1856,31,40-44,1887,6
SIM,1907,26,15-19,1933,3
STAT,1869,54,35-39,1923,0.008448352132618582
STAT,1818,47,40-44,1865,0.30533279189514445
STAT,1896,17,35-39,1913,0.7233241018226787
STAT,1871,51,na,1922,2158.1554962426144
STAT,1822,34,na,1856,1644.7974460957098
STAT,1826,48,na,1874,2010.6963745324267
STAT,1928,36,35-39,1964,3.036313632963599
STAT,1875,53,20-24,1928,7.455679280771902E-4
STAT,1839,53,35-39,1892,0.007869962369482241
STAT,1844,27,15-19,1871,0.5502370329584464
STAT,1847,10,na,1857,2727.574877855675
STAT,1875,65,na,1940,1735.3417671430238
STAT,1823,51,50-100,1874,0.02313192964949641
STAT,1865,40,30-34,1905,1.0602280425984714
STAT,1900,42,15-19,1942,0.0013268294730046275
SIM,1864,42,30-34,1906,2
STAT,1850,48,20-24,1898,0.00547151550573818
SIM,1904,22,30-34,1926,50
STAT,1893,78,na,1971,1442.810902798834
STAT,1926,44,50-100,1970,0.143108983861824
SIM,1837,26,35-39,1863,37
STAT,1874,30,30-34,1904,18.16443365024098
STAT,1937,31,30-34,1968,15.435210478417803
STAT,1824,34,35-39,1858,4.152766617244892
STAT,1874,21,40-44,1895,2.157122256222492
STAT,1796,92,na,1888,20.884972486592577
STAT,1862,51,50-100,1913,0.012925178918849367
STAT,1867,30,na,1897,2274.946629096583
STAT,1929,15,45-49,1944,0.6359909651155525
SIM,1854,32,na,1886,1840
STAT,1864,27,40-44,1891,2.72328556868465
STAT,1900,39,50-100,1939,0.36340248959386323
STAT,1857,21,40-44,1878,1.8593434973786578
STAT,1858,1,na,1859,2831.8584544809146
STAT,1913,22,30-34,1935,27.50105049037104
STAT,1821,52,50-100,1873,0.01558772347929722
STAT,1885,28,15-19,1913,0.44439681831736927
STAT,1918,26,25-29,1944,69.33968375625045
SIM,1921,22,30-34,1943,1189
STAT,1859,41,45-49,1900,1.1915933482600607
SIM,1846,13,na,1859,1516
SIM,1926,31,20-24,1957,11
STAT,1838,21,30-34,1859,9.936389041747452
STAT,1855,16,35-39,1871,0.434496694478636
STAT,1841,34,35-39,1875,13.401323526996375
STAT,1827,37,40-44,1864,4.3165437740416595
STAT,1891,30,30-34,1921,21.643301101338135
STAT,1834,52,20-24,1886,3.3345685770084555E-4
STAT,1863,32,20-24,1895,2.307634485260766
STAT,1869,26,50-100,1895,0.6477171929789157
STAT,1881,50,40-44,1931,0.010084629582812595
STAT,1937,26,35-39,1963,14.490325865781315
STAT,1833,35,15-19,1868,0.031171024812163012
STAT,1891,49,20-24,1940,0.008150233950845725
STAT,1850,7,na,1857,1396.6284101682759
SIM,1852,5,na,1857,2713
STAT,1834,47,50-100,1881,0.11479059481867418
SIM,1900,28,30-34,1928,15
STAT,1835,37,15-19,1872,0.05252760673258288
SIM,1832,34,35-39,1866,10
STAT,1873,58,na,1931,2028.5792004319112
SIM,1840,83,na,1923,1449
STAT,1875,28,30-34,1903,25.767069283700216
SIM,1909,55,na,1964,3677
SIM,1833,54,na,1887,2017
STAT,1907,47,30-34,1954,0.07930001516792193
STAT,1849,19,15-19,1868,6.082806810269619
STAT,1833,48,20-24,1881,0.0054132660654398704
STAT,1788,73,na,1861,196.4163243828362
STAT,1859,11,na,1870,2206.3563038318844
STAT,1897,30,50-100,1927,1.2266026694516268
STAT,1924,47,30-34,1971,0.10510986410351386
SIM,1909,23,na,1932,4235
STAT,1867,46,na,1913,2133.7831122436396
STAT,1861,46,30-34,1907,0.08073160138598098
SIM,1926,26,25-29,1952,2
STAT,1854,42,20-24,1896,0.08819413808659665
SIM,1852,37,40-44,1889,6
STAT,1868,24,20-24,1892,66.14388887014108
SIM,1829,49,na,1878,1785
STAT,1817,52,20-24,1869,4.991244121925785E-4
STAT,1838,33,na,1871,1136.6163498879855
STAT,1849,18,50-100,1867,0.05051330968500234
STAT,1829,39,40-44,1868,2.147807658536282
STAT,1873,17,40-44,1890,0.18761823034920097
STAT,1881,77,na,1958,919.4514503049292
STAT,1848,43,35-39,1891,1.682272669977672
SIM,1857,19,15-19,1876,5
STAT,1939,20,25-29,1959,91.80885582134401
STAT,1884,43,20-24,1927,0.15092912022637744
STAT,1902,38,50-100,1940,0.37130810986326473
SIM,1825,35,na,1860,600
STAT,1850,35,15-19,1885,0.02689338757021307
STAT,1891,25,35-39,1916,11.946064588329799
STAT,1838,16,35-39,1854,0.3112291006293702
STAT,1867,27,50-100,1894,0.6049763229692207
STAT,1840,22,25-29,1862,28.665092490131084
STAT,1844,37,40-44,1881,4.5827455375189246
STAT,1859,48,40-44,1907,0.1339868831788126
SIM,1848,63,na,1911,2307
STAT,1941,23,45-49,1964,1.1491790418185077
STAT,1861,9,na,1870,2328.824820552506
STAT,1873,51,45-49,1924,0.01495776504530965
SIM,1857,38,30-34,1895,2
STAT,1826,45,25-29,1871,0.08465177092148592
STAT,1947,20,na,1967,4086.552750356774
STAT,1885,31,45-49,1916,1.7210937581900632
STAT,1855,20,50-100,1875,0.31987608087182823
STAT,1870,17,15-19,1887,5.972709477519497
SIM,1887,34,25-29,1921,24
STAT,1944,24,25-29,1968,98.54281372429855
STAT,1908,16,15-19,1924,8.7566530939923
STAT,1869,40,15-19,1909,0.01407586055456215
STAT,1836,29,30-34,1865,24.61149957338667
SIM,1904,24,na,1928,2756
STAT,1876,38,15-19,1914,0.05648553273479911
SIM,1908,38,na,1946,2514
STAT,1928,41,30-34,1969,0.16197388661400128
STAT,1855,29,na,1884,1622.796192265919
SIM,1901,59,na,1960,2787
STAT,1942,16,15-19,1958,46.898677584218326
SIM,1878,27,35-39,1905,52
STAT,1874,44,15-19,1918,0.014060278476584604
STAT,1827,105,na,1932,0.02067668960508323
STAT,1865,33,50-100,1898,0.8329938748574275
STAT,1851,15,na,1866,2230.3793461803702
STAT,1926,33,20-24,1959,2.922273203515811
SIM,1826,40,45-49,1866,7
STAT,1856,42,30-34,1898,0.824736657616912
STAT,1893,36,25-29,1929,3.617845645988964
STAT,1840,39,50-100,1879,0.5600267165089549
SIM,1848,32,45-49,1880,171
STAT,1906,22,na,1928,3424.7592155928014
SIM,1889,61,na,1950,2369
STAT,1926,21,50-100,1947,0.794925626722364
SIM,1913,44,na,1957,2903
STAT,1856,46,na,1902,1620.544133586115
SIM,1838,26,na,1864,2315
STAT,1809,47,15-19,1856,0.003519020040885145
STAT,1866,19,15-19,1885,5.494976750785845
STAT,1867,54,25-29,1921,0.003257671108555352
SIM,1928,31,30-34,1959,1
STAT,1921,40,50-100,1961,0.1311143397139845
SIM,1943,26,25-29,1969,4
STAT,1863,46,40-44,1909,0.14657050760625695
STAT,1853,27,40-44,1880,2.6907747984720425
STAT,1882,35,35-39,1917,6.83599911670438
SIM,1918,24,25-29,1942,1279
STAT,1919,43,30-34,1962,0.13648809921259844
STAT,1811,50,na,1861,1758.9173972741723
SIM,1862,67,na,1929,2633
STAT,1812,72,na,1884,109.27345891048076
SIM,1831,29,20-24,1860,12
SIM,1863,21,30-34,1884,1
STAT,1896,43,na,1939,3035.1795031780193
STAT,1818,40,45-49,1858,3.0901565773255504
SIM,1831,47,na,1878,2133
STAT,1844,49,35-39,1893,0.13580056945496047
STAT,1815,44,35-39,1859,0.18599761587060146
STAT,1935,26,25-29,1961,89.11617278389242
STAT,1935,35,na,1970,5231.947424553742
STAT,1884,51,20-24,1935,7.097696667153053E-4
SIM,1859,24,20-24,1883,16
STAT,1928,15,50-100,1943,0.4706639722428066
STAT,1815,64,na,1879,145.81877695426934
STAT,1819,78,na,1897,181.73202100231512
STAT,1885,27,na,1912,2345.8314892629087
STAT,1897,18,40-44,1915,0.24226835087210183
STAT,1878,89,na,1967,283.62614690652873
STAT,1871,52,25-29,1923,0.0035145027536773433
STAT,1837,32,na,1869,2178.791908257512
STAT,1966,4,na,1970,4862.465721759366
STAT,1859,106,na,1965,0.06102406977869382
STAT,1916,26,15-19,1942,0.7224452285298221
STAT,1885,38,40-44,1923,4.28152138110621
STAT,1798,106,na,1904,0.005153758158463563
STAT,1857,49,20-24,1906,0.009016074366420664
SIM,1824,39,30-34,1863,15
STAT,1855,21,30-34,1876,13.871865403853539
STAT,1904,2,na,1906,3808.417516604155
SIM,1843,32,na,1875,362
STAT,1875,17,15-19,1892,6.093906662700027
STAT,1800,87,na,1887,102.62535224685983
SIM,1906,30,40-44,1936,5
STAT,1895,30,15-19,1925,0.1867433234379467
STAT,1918,34,25-29,1952,9.606149489208901
STAT,1865,41,45-49,1906,1.3726018377600901
STAT,1884,30,50-100,1914,0.8841468040257678
STAT,1846,43,25-29,1889,0.38002857661047873
STAT,1852,35,25-29,1887,2.975037525635111
STAT,1825,45,50-100,1870,0.3203872934566214
STAT,1923,27,20-24,1950,20.73703009028282
SIM,1897,37,na,1934,2579
STAT,1872,16,35-39,1888,0.5545287022795621
SIM,1769,90,na,1859,178
SIM,1820,38,35-39,1858,30
STAT,1910,41,20-24,1951,0.016598851474439257
SIM,1847,78,na,1925,1382
STAT,1832,42,45-49,1874,0.13170158001691062
SIM,1873,30,na,1903,2273
SIM,1890,58,na,1948,3139
STAT,1889,41,30-34,1930,1.3907235955699702
STAT,1839,45,35-39,1884,0.13596334185227318
STAT,1844,30,45-49,1874,2.1092555377538638
SIM,1822,70,na,1892,205
STAT,1830,53,na,1883,1585.5851123791033
STAT,1924,31,45-49,1955,1.8192732100270819
STAT,1820,48,35-39,1868,0.2170797799932457
STAT,1881,20,20-24,1901,65.4656482195719
STAT,1842,43,50-100,1885,0.26788061309287836
STAT,1872,25,25-29,1897,42.64631051175797
STAT,1836,21,20-24,1857,70.19495589205307
STAT,1838,37,40-44,1875,2.254838037795725
STAT,1880,30,30-34,1910,18.271581778458014
STAT,1916,21,45-49,1937,1.1664564222256866
STAT,1821,49,na,1870,1279.008621047874
STAT,1873,43,45-49,1916,1.5241328906888774
STAT,1852,32,45-49,1884,1.8174142904531687
STAT,1888,40,25-29,1928,0.7486328541773558
STAT,1831,30,35-39,1861,11.097495411596794
STAT,1897,43,30-34,1940,0.10525954826819342
STAT,1876,82,na,1958,571.9532472527636
STAT,1906,40,40-44,1946,0.2284627816261094
STAT,1929,24,35-39,1953,11.74972803656923
STAT,1861,49,35-39,1910,0.11399904426455951
SIM,1863,52,na,1915,416
STAT,1866,22,45-49,1888,0.6417255004443018
STAT,1922,23,35-39,1945,10.644455779065426
STAT,1876,41,20-24,1917,0.16127179928610655
STAT,1856,45,35-39,1901,0.1015579929785197
SIM,1901,43,na,1944,3324
STAT,1817,71,na,1888,454.80416691134036
STAT,1851,22,50-100,1873,0.3846142029096409
STAT,1826,53,25-29,1879,0.00479739284267177
STAT,1898,49,30-34,1947,0.07189284548581994
STAT,1845,25,50-100,1870,0.39197290090951165
STAT,1862,31,na,1893,2040.8251778197553
STAT,1831,103,na,1934,0.11232203700412281
STAT,1918,23,na,1941,3873.4330346790507
STAT,1939,33,na,1972,3814.1200800903957
SIM,1854,35,25-29,1889,28
STAT,1880,38,40-44,1918,4.521983195050341
SIM,1832,40,45-49,1872,3
STAT,1820,37,30-34,1857,9.915934281275478
SIM,1875,46,25-29,1921,1
STAT,1848,34,45-49,1882,1.69613499466673
STAT,1893,44,25-29,1937,0.05501169923536313
STAT,1876,23,na,1899,2383.458916332131
STAT,1825,47,na,1872,1587.3127432373385
STAT,1840,52,45-49,1892,0.0056839093904097705
STAT,1821,33,na,1854,1478.237407480567
STAT,1905,20,30-34,1925,25.772634790071663
STAT,1809,50,20-24,1859,0.006347317140898019
STAT,1832,50,45-49,1882,0.0012079545336496035
STAT,1884,58,na,1942,1893.0994818986337
STAT,1819,48,50-100,1867,0.04474328128594537
STAT,1858,50,40-44,1908,0.008155122363963386
STAT,1866,16,50-100,1882,0.0461741357742005
STAT,1823,99,na,1922,1.4961113625850235
STAT,1931,29,20-24,1960,23.377830528925102
STAT,1794,69,na,1863,8.57908604885695
STAT,1908,40,50-100,1948,0.10907305085002851
STAT,1879,38,40-44,1917,4.468343340613625
STAT,1849,27,15-19,1876,0.45316427557561356
STAT,1892,24,15-19,1916,4.058931609435076
SIM,1945,23,30-34,1968,23
SIM,1872,23,25-29,1895,306
STAT,1824,40,45-49,1864,0.251690989339048
STAT,1859,38,15-19,1897,0.044286932971659004
STAT,1848,11,na,1859,2781.899502696063
STAT,1924,39,30-34,1963,2.1239617817948777
STAT,1937,23,30-34,1960,27.689876602751138
SIM,1932,39,30-34,1971,15
STAT,1869,51,30-34,1920,0.006035349198224168
SIM,1782,72,na,1854,514
SIM,1825,51,na,1876,14
SIM,1829,65,na,1894,1687
SIM,1926,34,25-29,1960,1
STAT,1913,30,30-34,1943,15.60296314314014
SIM,1950,17,na,1967,4844
STAT,1887,36,25-29,1923,3.1843079736380813
STAT,1925,41,na,1966,4461.7054309944615
STAT,1864,97,na,1961,11.331360325738872
STAT,1874,24,45-49,1898,0.7151769070541051
STAT,1891,31,45-49,1922,2.1531917732455144
STAT,1905,53,na,1958,3102.67879492037
STAT,1816,39,30-34,1855,18.665617363850558
SIM,1865,59,na,1924,1665
STAT,1848,40,30-34,1888,1.1023940609668799
SIM,1861,45,na,1906,2181
STAT,1826,42,45-49,1868,2.2486685371750896
SIM,1883,29,na,1912,2194
STAT,1918,23,20-24,1941,117.94331335937878
STAT,1862,5,na,1867,2452.942557909206
STAT,1847,24,50-100,1871,0.4455111587770469
SIM,1872,61,na,1933,2049
STAT,1860,17,30-34,1877,1.4996237049503305
SIM,1851,19,20-24,1870,34
STAT,1862,19,30-34,1881,1.3982669725618626
SIM,1810,85,na,1895,611
SIM,1960,8,na,1968,6451
STAT,1866,34,15-19,1900,0.12887944688525174
STAT,1795,103,na,1898,0.03498460665631123
STAT,1888,15,35-39,1903,0.6362425810531758
SIM,1830,31,20-24,1861,3
STAT,1825,33,15-19,1858,0.2334425102073595
STAT,1833,34,na,1867,1122.783548279167
STAT,1852,43,25-29,1895,0.641718158844771
SIM,1921,30,30-34,1951,37
STAT,1837,48,na,1885,1848.8031382339063
STAT,1878,33,50-100,1911,0.938718677696712
STAT,1943,20,15-19,1963,5.602713948775256
SIM,1926,23,20-24,1949,354
STAT,1829,40,20-24,1869,0.07867716190111587
STAT,1843,19,20-24,1862,22.122068170197775
STAT,1846,35,25-29,1881,1.818113406824119
STAT,1811,51,15-19,1862,1.128937484483673E-4
STAT,1896,31,20-24,1927,3.5778111148848897
SIM,1831,26,40-44,1857,2
STAT,1833,43,15-19,1876,0.007092468719710119
STAT,1874,33,35-39,1907,10.407699069287732
SIM,1948,15,20-24,1963,37
STAT,1868,27,25-29,1895,40.857709661843444
STAT,1937,34,35-39,1971,8.936070821425647
STAT,1854,45,25-29,1899,0.03234590966908101
STAT,1870,20,45-49,1890,0.6993308370988316
SIM,1949,20,na,1969,4457
STAT,1830,51,25-29,1881,0.0027164852982623365
STAT,1901,27,50-100,1928,0.8944276131124679
STAT,1842,29,30-34,1871,7.620013560584349
STAT,1879,17,35-39,1896,0.5628877015546587
STAT,1830,69,na,1899,1062.1672904935594
STAT,1867,46,25-29,1913,0.05462871310418296
STAT,1900,34,15-19,1934,0.19558628262140645
STAT,1898,41,50-100,1939,0.09909773817980172
STAT,1924,20,40-44,1944,3.9528666013070723
STAT,1893,33,45-49,1926,2.171495615786805
STAT,1872,31,35-39,1903,10.182276567468298
SIM,1882,33,35-39,1915,8
STAT,1806,52,45-49,1858,0.038390306097911664
STAT,1862,18,50-100,1880,0.04751006405950519
STAT,1867,14,na,1881,2513.317756996611
STAT,1872,39,45-49,1911,1.976106201842923
STAT,1948,24,45-49,1972,1.2778324401001042
STAT,1890,17,40-44,1907,0.22142377166914012
STAT,1881,53,45-49,1934,0.0134847210566618
SIM,1859,32,20-24,1891,1
STAT,1868,36,15-19,1904,0.054499105467369136
STAT,1880,49,45-49,1929,0.23988894471907418
STAT,1895,26,50-100,1921,0.835013970832996
STAT,1852,96,na,1948,8.643225812003378
STAT,1841,31,30-34,1872,23.835817087840823
SIM,1873,46,na,1919,2117
STAT,1883,8,na,1891,2500.8757691572755
SIM,1813,50,na,1863,187
STAT,1849,38,30-34,1887,4.547663992811391
STAT,1906,38,na,1944,3421.488165549332
STAT,1863,23,30-34,1886,15.398256511822606
STAT,1932,30,40-44,1962,5.171860173391614
STAT,1905,39,20-24,1944,0.23690061176591112
SIM,1792,71,na,1863,853
SIM,1885,31,na,1916,1652
STAT,1901,38,25-29,1939,0.8646101684439059
STAT,1855,37,40-44,1892,2.897191017055782
STAT,1844,23,20-24,1867,84.62856860223472
STAT,1893,38,15-19,1931,0.06987453633824485
STAT,1872,22,20-24,1894,69.00618687173932
STAT,1886,40,15-19,1926,0.01444507036270962
STAT,1895,41,30-34,1936,0.10432549333793666
SIM,1852,33,25-29,1885,23
SIM,1939,25,20-24,1964,67
SIM,1788,66,na,1854,481
SIM,1852,52,na,1904,1883
SIM,1902,48,35-39,1950,2
SIM,1948,19,na,1967,5817
SIM,1904,40,na,1944,4089
STAT,1883,20,30-34,1903,17.238430027424492
STAT,1850,30,45-49,1880,0.9450856482148023
SIM,1828,36,35-39,1864,82
SIM,1908,54,na,1962,1972
STAT,1910,11,na,1921,3875.2360187703407
STAT,1854,44,na,1898,1267.7438629076787
STAT,1808,52,50-100,1860,0.01942363320096022
STAT,1893,33,20-24,1926,3.3659854986909745
STAT,1918,17,35-39,1935,0.9039662002005578
STAT,1887,27,35-39,1914,10.620316837477226
STAT,1830,104,na,1934,0.04827564384350421
STAT,1829,34,35-39,1863,5.3214270874231175
STAT,1949,17,15-19,1966,52.26174460258207
SIM,1812,49,na,1861,1720
STAT,1860,24,50-100,1884,0.3380306304227028
STAT,1791,93,na,1884,9.07273610209636
STAT,1834,52,45-49,1886,0.006557984619239261
STAT,1853,17,15-19,1870,5.535405570803739
STAT,1867,6,na,1873,2650.5319789607574
STAT,1835,40,20-24,1875,0.14771530277108305
STAT,1839,42,30-34,1881,1.1257492942037064
STAT,1901,15,15-19,1916,8.336331715908301
SIM,1833,70,na,1903,1813
SIM,1828,59,na,1887,1596
STAT,1850,30,na,1880,1174.5688992866214
STAT,1899,29,30-34,1928,34.14930477145107
SIM,1881,65,na,1946,1140
SIM,1889,45,na,1934,3846
STAT,1894,17,25-29,1911,7.206143608476956
STAT,1835,45,15-19,1880,3.59662608135067E-4
STAT,1842,38,20-24,1880,0.2221596504583042
SIM,1840,67,na,1907,2500
SIM,1803,72,na,1875,118
STAT,1826,42,20-24,1868,0.23861304356506302
SIM,1852,23,20-24,1875,6
STAT,1863,80,na,1943,528.103259159373
STAT,1826,47,15-19,1873,5.724363709850853E-4
STAT,1835,48,30-34,1883,0.07621851539997673
STAT,1891,28,na,1919,2924.445825176078
STAT,1806,71,na,1877,547.9977141429619
STAT,1870,52,30-34,1922,0.005902702518118678
STAT,1864,23,25-29,1887,52.49954871190093
STAT,1795,70,na,1865,806.9250500767689
STAT,1857,33,35-39,1890,7.738325659841499
STAT,1865,32,30-34,1897,15.940566037842187
STAT,1799,84,na,1883,22.403402109314243
STAT,1882,33,45-49,1915,1.662507742918636
SIM,1916,44,50-100,1960,1
STAT,1910,16,30-34,1926,2.394014542185299
STAT,1862,105,na,1967,0.19368703666044246
SIM,1893,50,na,1943,2792
STAT,1945,1,na,1946,4460.333981660988
SIM,1897,64,na,1961,1419
STAT,1815,42,45-49,1857,0.15900675607675016
SIM,1902,25,25-29,1927,49
SIM,1860,32,20-24,1892,15
STAT,1927,15,35-39,1942,5.198948507382418
SIM,1824,34,na,1858,2260
SIM,1871,30,30-34,1901,11
STAT,1843,17,30-34,1860,2.012504338544377
STAT,1874,43,na,1917,2368.1218987533957
STAT,1855,24,35-39,1879,4.447371600315348
STAT,1940,19,20-24,1959,136.01945775808437
STAT,1829,47,40-44,1876,0.07918695157409894
STAT,1894,21,45-49,1915,0.8894321218713416
STAT,1887,42,35-39,1929,1.9906603277940367
STAT,1853,16,25-29,1869,5.316913018491945
STAT,1878,57,na,1935,2067.647502941395
STAT,1862,17,40-44,1879,0.1784218536724622
STAT,1920,49,15-19,1969,3.9960839831074954E-4
STAT,1861,22,45-49,1883,0.5957770332526937
STAT,1854,52,25-29,1906,0.0019589375414834705
STAT,1939,31,40-44,1970,3.9512477997586775
STAT,1842,37,30-34,1879,1.5520236430398748
SIM,1879,24,na,1903,1596
STAT,1847,19,40-44,1866,0.20396860495256652
STAT,1879,50,25-29,1929,0.003685753414316556
STAT,1909,24,30-34,1933,26.27503930758048
SIM,1893,34,25-29,1927,5
STAT,1946,20,40-44,1966,3.7037812021385315
SIM,1855,33,na,1888,3084
STAT,1870,66,na,1936,1633.9835172809533
SIM,1824,66,na,1890,1811
STAT,1885,34,25-29,1919,9.981763495153759
STAT,1823,51,30-34,1874,0.009117144934265433
STAT,1861,35,15-19,1896,0.0471440665392442
SIM,1845,43,35-39,1888,12
STAT,1933,26,15-19,1959,0.9314183674006992
STAT,1924,9,na,1933,4695.018178908821
STAT,1876,49,30-34,1925,0.09581274112158647
SIM,1862,6,na,1868,4008
STAT,1910,48,40-44,1958,0.14504932986166114
STAT,1837,43,35-39,1880,1.6915105969372741
STAT,1831,38,45-49,1869,1.9995150895596028
STAT,1868,31,na,1899,2314.2874523018
STAT,1836,24,25-29,1860,57.06393155671431
STAT,1876,30,40-44,1906,4.4192609306442305
STAT,1853,39,35-39,1892,5.429066697115489
STAT,1887,20,15-19,1907,3.652812790130539
STAT,1827,30,45-49,1857,1.8550378496581488
STAT,1842,51,40-44,1893,0.002625935040248726
STAT,1858,10,na,1868,2156.2441781614993
STAT,1815,48,na,1863,211.6066549761454
STAT,1854,40,30-34,1894,0.645685983080846
STAT,1816,70,na,1886,1368.8463334785902
STAT,1841,32,45-49,1873,2.3560550844928603
STAT,1853,65,na,1918,1310.3778338884258
STAT,1856,50,30-34,1906,0.004336879701707407
SIM,1866,76,na,1942,1197
STAT,1827,29,40-44,1856,3.2351246868369508
STAT,1818,43,25-29,1861,1.2207628682161515
SIM,1884,30,40-44,1914,2
STAT,1924,35,na,1959,4401.30275845563
SIM,1891,64,na,1955,1025
STAT,1899,19,na,1918,3431.143080570056
STAT,1821,53,25-29,1874,0.003583926443125775
SIM,1933,21,na,1954,4385
STAT,1855,30,20-24,1885,1.859778196681597
STAT,1949,16,25-29,1965,49.917183656574345
STAT,1920,42,na,1962,4049.0517656361317
STAT,1875,53,45-49,1928,0.014662835362392658
STAT,1919,46,35-39,1965,0.1383279234172947
STAT,1867,48,15-19,1915,3.735384583817115E-4
STAT,1876,48,40-44,1924,0.17089285637986706
STAT,1816,86,na,1902,187.31374481405783
STAT,1852,32,20-24,1884,2.817132165639937
STAT,1882,46,15-19,1928,3.8405108678200395E-4
STAT,1906,27,20-24,1933,16.98797894627634
STAT,1917,30,15-19,1947,0.1338353625324263
STAT,1843,49,40-44,1892,0.1656214677099055
STAT,1838,33,25-29,1871,5.376994776845756
STAT,1853,16,50-100,1869,0.04596753843275566
STAT,1936,20,na,1956,3459.03104586791
SIM,1869,30,15-19,1899,1
STAT,1912,19,45-49,1931,0.09930410701646016
STAT,1836,26,na,1862,2157.659191059821
STAT,1862,51,20-24,1913,6.31523424947444E-4
STAT,1841,45,15-19,1886,4.590581544633293E-4
STAT,1864,22,50-100,1886,0.37668633029011217
STAT,1883,39,20-24,1922,0.7341261541470971
STAT,1916,21,na,1937,3785.786451220116
SIM,1873,8,na,1881,2483
STAT,1926,41,20-24,1967,0.021616060906000174
STAT,1946,21,30-34,1967,31.648320140395455
SIM,1876,27,25-29,1903,6
STAT,1857,48,30-34,1905,0.07334724768966154
STAT,1806,48,50-100,1854,0.7861426545288172
SIM,1818,37,40-44,1855,2
SIM,1838,58,na,1896,1518
STAT,1836,85,na,1921,209.80521729028936
STAT,1863,38,40-44,1901,3.718591819878466
STAT,1937,20,15-19,1957,5.133693843263681
STAT,1920,15,25-29,1935,9.673799559361996
STAT,1863,26,35-39,1889,8.29698117518008
STAT,1880,27,50-100,1907,0.6640995013023546
STAT,1898,34,35-39,1932,13.501443555231564
SIM,1923,43,na,1966,4222
SIM,1865,48,30-34,1913,1
STAT,1916,49,25-29,1965,0.053350893528117234
STAT,1935,18,50-100,1953,0.5071596069019009
SIM,1903,39,na,1942,2716
STAT,1920,38,35-39,1958,2.6115560021005693
STAT,1856,17,40-44,1873,0.15533735962664114
SIM,1852,84,na,1936,1138
STAT,1941,31,45-49,1972,1.6342959770716898
STAT,1897,12,na,1909,3429.7062518618363
STAT,1845,62,na,1907,906.9512835263719
STAT,1859,34,20-24,1893,2.1240818235456778
STAT,1849,76,na,1925,798.2746253903849
STAT,1885,0,na,1885,3447.1398587134245
STAT,1802,53,15-19,1855,1.2236129509899258E-4
STAT,1839,17,40-44,1856,0.22229185570402907
STAT,1853,81,na,1934,419.3026855801848
STAT,1897,44,45-49,1941,0.13616105860394928
STAT,1921,42,35-39,1963,0.22411474402568704
STAT,1953,18,50-100,1971,0.44901078232601394
STAT,1845,99,na,1944,0.9397690357521065
STAT,1861,37,40-44,1898,3.640519382740619
STAT,1852,37,15-19,1889,0.056831208832586605
STAT,1835,47,40-44,1882,0.13653781452244243
SIM,1891,80,na,1971,78
SIM,1839,43,35-39,1882,3
SIM,1874,39,20-24,1913,3
STAT,1891,33,50-100,1924,1.1219786821695499
STAT,1822,32,35-39,1854,28.34906324109147
STAT,1866,39,20-24,1905,0.6965634137631329
SIM,1921,36,na,1957,5169
STAT,1867,43,20-24,1910,0.14910928882164715
STAT,1925,27,30-34,1952,45.8557391818723
STAT,1801,56,na,1857,948.8773047469723
STAT,1864,52,30-34,1916,0.0053826911717011015
STAT,1817,54,50-100,1871,0.009818136361792977
STAT,1877,28,40-44,1905,3.030154049323409
STAT,1884,18,30-34,1902,1.5217697141497604
STAT,1865,50,na,1915,1994.0725721988852
STAT,1907,36,15-19,1943,0.017770056608862952
SIM,1935,1,na,1936,5974
STAT,1901,18,30-34,1919,2.2227336045227095
STAT,1859,44,25-29,1903,0.5020987994805645
STAT,1937,17,50-100,1954,0.3607104899007922
STAT,1804,85,na,1889,173.7067067675801
STAT,1846,32,20-24,1878,1.8918833552895535
STAT,1873,52,35-39,1925,0.008783985563319994
SIM,1815,45,50-100,1860,5
SIM,1890,35,35-39,1925,1
SIM,1958,1,na,1959,4201
STAT,1862,50,30-34,1912,0.005142889074459963
SIM,1934,36,25-29,1970,3
SIM,1859,35,25-29,1894,5
STAT,1883,38,30-34,1921,5.101852712875306
STAT,1883,52,40-44,1935,0.01007413673709573
SIM,1871,44,na,1915,1828
STAT,1856,43,45-49,1899,1.0672018056126422
SIM,1818,49,35-39,1867,2
STAT,1930,20,na,1950,4673.065393796149
STAT,1946,15,45-49,1961,0.5483657584887044
STAT,1846,49,45-49,1895,0.1368551984090772
STAT,1892,29,20-24,1921,14.420827169424236
STAT,1900,22,na,1922,3276.267359441046
STAT,1920,47,50-100,1967,0.2468063961038167
STAT,1904,36,na,1940,3408.8634747368346
STAT,1882,30,40-44,1912,4.185391370695197
STAT,1893,32,50-100,1925,1.1457905526380479
SIM,1835,26,25-29,1861,38
STAT,1808,67,na,1875,481.41754335554043
STAT,1827,49,35-39,1876,0.12491359288930058
STAT,1846,41,35-39,1887,1.099453639461454
STAT,1902,42,25-29,1944,0.06271636884037056
SIM,1890,40,30-34,1930,14
STAT,1867,20,35-39,1887,5.621965618191347
SIM,1819,66,na,1885,1387
STAT,1825,63,na,1888,1121.2756559824527
SIM,1854,48,na,1902,1275
STAT,1816,47,30-34,1863,0.2944299293342391
SIM,1902,44,na,1946,3286
STAT,1816,48,20-24,1864,0.03597813064077246
STAT,1886,18,40-44,1904,0.1889090384870744
STAT,1926,36,25-29,1962,1.194090237838667
STAT,1879,34,25-29,1913,10.4173125557595
SIM,1815,52,na,1867,1685
SIM,1823,71,na,1894,535
SIM,1899,23,na,1922,1125
SIM,1928,30,40-44,1958,34
STAT,1825,38,20-24,1863,1.0824604527188815
STAT,1894,18,15-19,1912,7.5269497455902314
STAT,1882,40,30-34,1922,1.1118106636232357
STAT,1861,38,30-34,1899,4.410321589857051
STAT,1924,48,20-24,1972,0.012993925110810892
SIM,1919,38,na,1957,4932
STAT,1878,44,35-39,1922,1.8379423583276469
STAT,1911,32,25-29,1943,8.898758684643532
SIM,1867,39,na,1906,2178
STAT,1817,44,na,1861,949.6032281654556
SIM,1915,24,na,1939,3489
STAT,1902,49,45-49,1951,0.18354545108255277
STAT,1827,27,15-19,1854,0.7086837319149617
STAT,1861,30,20-24,1891,2.266049347348258
STAT,1836,27,40-44,1863,2.97020988545432
SIM,1891,38,30-34,1929,6
STAT,1843,47,15-19,1890,3.9337503730216034E-4
STAT,1846,26,35-39,1872,6.963350209898923
STAT,1852,47,40-44,1899,0.17152445182583007
STAT,1884,42,na,1926,2209.7620942665912
STAT,1935,19,na,1954,4968.8245808419315
SIM,1909,25,35-39,1934,25
SIM,1919,17,na,1936,5211
STAT,1800,71,na,1871,1059.162822623102
STAT,1863,104,na,1967,0.40715686465904233
STAT,1921,17,45-49,1938,0.5626600311555294
STAT,1929,21,30-34,1950,36.19989545956644
STAT,1907,23,45-49,1930,1.014315768908775
SIM,1836,51,na,1887,1555
STAT,1828,53,35-39,1881,0.008854578228336511
SIM,1873,51,na,1924,2117
STAT,1846,84,na,1930,197.0233894969735
STAT,1883,23,35-39,1906,5.596636683124064
STAT,1904,40,30-34,1944,0.11521130864800985
STAT,1851,45,50-100,1896,0.1959068838918495
STAT,1878,46,25-29,1924,0.05943112553569546
STAT,1948,21,40-44,1969,3.822411115462571
STAT,1833,30,45-49,1863,1.0155650157221336
STAT,1950,17,50-100,1967,0.43877801340895833
STAT,1878,41,30-34,1919,1.1882104253787298
SIM,1939,28,25-29,1967,3
STAT,1885,39,30-34,1924,5.185979830780763
STAT,1951,17,30-34,1968,14.37938612759494
SIM,1863,25,na,1888,1232
STAT,1840,28,45-49,1868,0.5411944336331334
STAT,1844,26,25-29,1870,51.67292477932859
STAT,1905,21,na,1926,3411.9680046852336
SIM,1912,43,na,1955,4588
STAT,1927,21,20-24,1948,136.29216710589682
SIM,1847,62,na,1909,1382
STAT,1857,30,30-34,1887,13.76351482169371
SIM,1886,41,30-34,1927,3
STAT,1818,45,15-19,1863,7.354626048366598E-4
STAT,1866,24,na,1890,2145.3457862989444
STAT,1836,47,na,1883,1801.9536715156173
STAT,1864,65,na,1929,1536.3553176993432
STAT,1909,36,25-29,1945,0.9269197636924992
STAT,1850,14,na,1864,1334.832098090063
STAT,1910,19,35-39,1929,0.8177406916559027
STAT,1827,70,na,1897,989.4360810075345
STAT,1829,41,35-39,1870,0.8840098017644928
STAT,1844,29,40-44,1873,3.5809497685383413
STAT,1832,33,na,1865,2401.1765631764715
STAT,1934,30,15-19,1964,0.17446158393550618
SIM,1909,39,na,1948,3804
STAT,1821,50,20-24,1871,7.924484904537234E-4
STAT,1864,20,20-24,1884,64.58025946778578
STAT,1930,32,35-39,1962,11.710602510803366
SIM,1875,10,na,1885,3165
STAT,1833,47,30-34,1880,0.04860784108345343
STAT,1912,33,50-100,1945,0.800715384045983
SIM,1832,48,na,1880,1753
STAT,1795,108,na,1903,4.465186249489151E-4
STAT,1923,42,45-49,1965,0.19247585717512444
SIM,1875,20,35-39,1895,84
STAT,1843,42,20-24,1885,0.16156109391876386
STAT,1865,46,15-19,1911,3.662329795162706E-4
STAT,1941,28,15-19,1969,0.7216381001130203
SIM,1817,42,45-49,1859,3
SIM,1900,58,na,1958,3924
STAT,1856,49,50-100,1905,0.1727199111902681
SIM,1879,51,40-44,1930,1
STAT,1851,19,30-34,1870,1.512526070756139
STAT,1903,29,45-49,1932,1.5648231393160206
SIM,1829,81,na,1910,1137
STAT,1876,33,45-49,1909,1.7554046597925426
SIM,1905,25,na,1930,2829
STAT,1856,41,40-44,1897,1.622860350549161
SIM,1837,49,45-49,1886,3
STAT,1881,27,40-44,1908,2.828854075813579
STAT,1835,43,25-29,1878,0.5747624894008182
SIM,1824,32,35-39,1856,1
STAT,1822,37,40-44,1859,8.83120547921902
SIM,1851,42,20-24,1893,1
STAT,1882,26,50-100,1908,0.6145498161545065
STAT,1895,44,35-39,1939,0.1613722949772183
SIM,1861,66,na,1927,1395
SIM,1852,30,20-24,1882,1
SIM,1952,19,na,1971,5355
STAT,1857,47,na,1904,1718.39226171725
STAT,1934,34,na,1968,5122.211928059323
STAT,1896,32,35-39,1928,13.349788348265534
STAT,1838,24,35-39,1862,3.1856432532625534
STAT,1939,21,50-100,1960,0.6537670196611214
STAT,1861,31,50-100,1892,0.7651031307193786
STAT,1915,41,45-49,1956,0.16542835634623967
SIM,1872,29,na,1901,2405
STAT,1948,17,45-49,1965,0.5658333851727998
SIM,1891,43,na,1934,1960
STAT,1870,16,25-29,1886,5.736955742536968
SIM,1850,22,35-39,1872,89
SIM,1906,10,na,1916,3664
STAT,1848,32,na,1880,2365.078418329509
STAT,1822,34,25-29,1856,22.87227279499464
STAT,1860,50,20-24,1910,6.106396892921893E-4
SIM,1890,79,na,1969,2001
STAT,1864,19,40-44,1883,0.16999088441993818
STAT,1818,51,50-100,1869,0.02636480348724185
SIM,1895,57,na,1952,4395
STAT,1854,43,35-39,1897,0.999571255319408
SIM,1826,40,20-24,1866,1
STAT,1911,30,20-24,1941,2.367290105275366
STAT,1897,42,40-44,1939,0.20717879585224805
SIM,1882,28,na,1910,1350
STAT,1908,15,25-29,1923,8.379738997806982
STAT,1868,31,45-49,1899,1.6911901808942271
SIM,1895,33,20-24,1928,10
STAT,1930,30,30-34,1960,20.21267070921813
STAT,1818,39,40-44,1857,9.47042859514885
STAT,1842,22,35-39,1864,1.8271437386766174
STAT,1785,92,na,1877,5.0093115920421045
STAT,1887,33,20-24,1920,2.9626290094811085
SIM,1808,82,na,1890,985
STAT,1834,99,na,1933,0.8346371718075152
STAT,1904,42,35-39,1946,0.17943250709566824
STAT,1874,31,45-49,1905,1.8070953648999837
SIM,1894,15,25-29,1909,8
STAT,1860,51,na,1911,1764.941704884716
STAT,1866,27,15-19,1893,0.4141481693011662
SIM,1849,30,35-39,1879,13
STAT,1818,48,30-34,1866,0.17002892268591588
STAT,1910,34,50-100,1944,0.7815369957084959
STAT,1898,45,15-19,1943,3.064375421125616E-4
STAT,1832,51,35-39,1883,7.025919802873888E-4
SIM,1893,4,na,1897,3684
STAT,1936,28,45-49,1964,1.6361605544003484
SIM,1868,24,na,1892,1238
SIM,1873,32,30-34,1905,215
STAT,1886,24,50-100,1910,0.41964380624391895
SIM,1864,10,na,1874,2555
SIM,1950,7,na,1957,4861
SIM,1887,75,na,1962,1759
STAT,1840,20,35-39,1860,2.964467565462804
SIM,1911,58,na,1969,2132
SIM,1916,15,25-29,1931,10
STAT,1818,40,20-24,1858,0.32790589356248634
STAT,1844,35,15-19,1879,0.06595719017149942
STAT,1885,31,20-24,1916,2.6678279200007693
STAT,1886,15,25-29,1901,5.895445635907263
STAT,1887,24,30-34,1911,19.482768620356623
SIM,1893,39,30-34,1932,31
STAT,1846,23,30-34,1869,12.923188565975957
STAT,1942,3,na,1945,4159.979180826088
STAT,1855,33,25-29,1888,6.8310471187362936
SIM,1856,41,45-49,1897,2
STAT,1861,14,na,1875,2261.2335803611613
SIM,1799,66,na,1865,1026
STAT,1897,41,40-44,1938,0.2083727718348618
SIM,1899,60,na,1959,1469
SIM,1859,38,40-44,1897,2
STAT,1840,15,na,1855,1184.1359647549182
STAT,1810,49,na,1859,89.07871626717126
STAT,1835,32,45-49,1867,1.679788740205197
SIM,1859,47,na,1906,1707
STAT,1954,15,50-100,1969,0.4593112477782646
STAT,1820,41,15-19,1861,0.02321584670408886
STAT,1946,24,35-39,1970,10.357834132458843
SIM,1878,61,na,1939,2399
STAT,1923,40,40-44,1963,0.29007173445377094
STAT,1881,21,35-39,1902,5.527359916879734
STAT,1850,21,30-34,1871,9.94350630798469
STAT,1837,48,40-44,1885,0.14068333216043927
STAT,1903,38,35-39,1941,2.156316866021503
STAT,1909,3,na,1912,3924.222870111784
STAT,1932,17,20-24,1949,178.27324605690796
STAT,1915,38,15-19,1953,0.019030392232977963
STAT,1892,17,15-19,1909,7.3475307028300545
STAT,1957,15,20-24,1972,177.2769886637421
STAT,1859,41,20-24,1900,0.12644358686914747
STAT,1910,43,na,1953,3449.8670073085887
STAT,1914,57,na,1971,3435.098099496376
SIM,1844,70,na,1914,1211
STAT,1841,30,40-44,1871,5.98223488066153
STAT,1907,39,30-34,1946,1.6615682297554166
STAT,1912,16,40-44,1928,0.2802373220140123
STAT,1875,50,40-44,1925,0.010965689437857851
SIM,1833,29,30-34,1862,3
STAT,1870,19,40-44,1889,0.18191704500395323
SIM,1837,63,na,1900,1516
SIM,1859,26,50-100,1885,6
STAT,1862,54,25-29,1916,0.0029339155384944396
STAT,1896,38,40-44,1934,5.741927607510268
STAT,1946,19,na,1965,4035.666986616565
STAT,1968,1,na,1969,4867.778230745037
STAT,1909,27,35-39,1936,14.20231851021807
SIM,1929,16,na,1945,4592
STAT,1900,30,45-49,1930,2.4351091350853435
STAT,1852,19,50-100,1871,0.05894364117204534
STAT,1914,29,20-24,1943,18.016201967137818
SIM,1908,2,na,1910,3194
STAT,1829,77,na,1906,315.6496251137438
STAT,1838,30,20-24,1868,1.463906993441808
STAT,1842,33,15-19,1875,0.042264839116731845
STAT,1881,29,45-49,1910,1.0410183589221673
STAT,1915,4,na,1919,4151.0415728237185
STAT,1858,28,30-34,1886,19.544847865801884
SIM,1908,17,na,1925,2858
STAT,1898,31,30-34,1929,23.574322703000508
STAT,1830,37,na,1867,1951.589952615306
STAT,1832,52,35-39,1884,6.888738742088298E-4
STAT,1859,46,15-19,1905,3.179369066102966E-4
STAT,1863,35,25-29,1898,2.481350012786315
STAT,1883,57,na,1940,1933.351828653047
SIM,1890,33,45-49,1923,1
STAT,1916,17,25-29,1933,9.068787216685086
STAT,1845,19,30-34,1864,0.9878940227153935
SIM,1858,62,na,1920,2126
STAT,1880,42,25-29,1922,0.665837418124096
STAT,1898,25,45-49,1923,1.5031725508335994
SIM,1846,30,20-24,1876,2
SIM,1904,40,35-39,1944,4
STAT,1820,36,40-44,1856,8.591273184940992
STAT,1860,41,45-49,1901,1.2264718343762826
SIM,1829,44,na,1873,2004
STAT,1926,42,na,1968,4539.252222658044
SIM,1957,0,na,1957,6087
STAT,1944,28,40-44,1972,4.978597593050428
STAT,1837,40,30-34,1877,1.1160037200723552
STAT,1853,20,45-49,1873,0.6481279260462013
SIM,1894,13,na,1907,1764
STAT,1840,51,30-34,1891,0.0023550581113346036
STAT,1813,51,25-29,1864,0.01256298518179271
STAT,1935,23,20-24,1958,150.28024789912754
SIM,1941,29,30-34,1970,13
STAT,1815,40,40-44,1855,0.24717553739078282
STAT,1859,49,30-34,1908,0.0751210484958119
SIM,1878,48,40-44,1926,1
STAT,1895,42,na,1937,3013.297301016453
STAT,1903,49,15-19,1952,3.136013620373067E-4
SIM,1865,32,na,1897,1402
STAT,1811,71,na,1882,904.0759937023134
STAT,1899,56,na,1955,2785.8693914235037
STAT,1889,42,45-49,1931,1.8000726253846808
STAT,1913,25,35-39,1938,14.872168568488908
STAT,1922,30,35-39,1952,10.2921315852366
SIM,1898,38,na,1936,4190
STAT,1851,16,15-19,1867,5.732375702804774
SIM,1956,9,na,1965,4927
STAT,1896,27,na,1923,3145.983259643447
STAT,1857,24,45-49,1881,0.5540995492627645
STAT,1827,33,na,1860,2048.496848379002
STAT,1892,13,na,1905,3192.4326627555747
SIM,1880,80,na,1960,2623
STAT,1885,36,15-19,1921,0.055462757120097884
SIM,1846,77,na,1923,319
SIM,1809,45,na,1854,801
STAT,1824,31,30-34,1855,8.085087249248858
SIM,1842,63,na,1905,2187
STAT,1922,49,25-29,1971,0.05990612636524401
STAT,1877,37,30-34,1914,5.41016285365939
STAT,1844,77,na,1921,856.3436999470705
SIM,1844,33,na,1877,2926
STAT,1891,22,30-34,1913,21.90427664807784
SIM,1848,47,na,1895,2304
STAT,1861,33,25-29,1894,8.482242989050176
STAT,1884,46,25-29,1930,0.05529543915788916
STAT,1840,26,40-44,1866,1.4813214572969156
SIM,1943,23,20-24,1966,572
STAT,1933,29,30-34,1962,51.622204075694405
STAT,1879,25,35-39,1904,9.96540825740155
SIM,1879,52,40-44,1931,1
STAT,1907,20,40-44,1927,3.058620168202721
SIM,1904,3,na,1907,4312
STAT,1816,43,15-19,1859,0.04420126118014107
STAT,1836,51,50-100,1887,0.01194385192450588
STAT,1809,52,na,1861,2854.213664417018
STAT,1837,45,25-29,1882,0.04918736353626679
STAT,1856,40,40-44,1896,1.6318518542661673
STAT,1920,20,50-100,1940,0.726409517041757
STAT,1935,17,35-39,1952,5.695109837479215
STAT,1859,37,25-29,1896,2.282030428167842
STAT,1825,29,30-34,1854,59.15713518808121
SIM,1829,25,25-29,1854,2
STAT,1902,46,40-44,1948,0.1363736354191941
STAT,1879,31,20-24,1910,2.784237204289887
STAT,1883,34,15-19,1917,0.13582937435563977
STAT,1876,50,na,1926,2207.9339549135457
STAT,1821,51,20-24,1872,7.768788848681128E-4
STAT,1888,16,25-29,1904,6.5563954526464565
SIM,1865,30,30-34,1895,227
STAT,1846,25,na,1871,1572.4594514459332
STAT,1907,47,50-100,1954,0.20119921151787223
STAT,1924,43,15-19,1967,0.0018062391783330671
STAT,1881,13,na,1894,2435.006601633624
STAT,1861,42,15-19,1903,0.01147070779753217
STAT,1911,37,30-34,1948,1.7405359629799597
STAT,1878,49,40-44,1927,0.17246469316949922
STAT,1868,28,15-19,1896,0.4366755337892378
SIM,1889,26,35-39,1915,58
STAT,1934,17,30-34,1951,16.37496079007218
STAT,1790,92,na,1882,15.649361068515953
SIM,1875,80,na,1955,766
STAT,1929,34,na,1963,4764.226027658834
STAT,1882,42,35-39,1924,1.731557232798274
STAT,1866,53,50-100,1919,0.013564722211069854
STAT,1858,30,35-39,1888,7.895966871752733
STAT,1913,21,40-44,1934,3.2269836654894095
STAT,1912,39,15-19,1951,0.01833859135064651
STAT,1916,22,20-24,1938,114.9275601429546
STAT,1918,16,20-24,1934,29.27845013228665
STAT,1927,18,50-100,1945,0.46083445853811256
STAT,1828,36,50-100,1864,1.686406829584267
SIM,1928,37,na,1965,4600
SIM,1924,22,20-24,1946,56
STAT,1866,26,15-19,1892,0.41556941670630165
STAT,1873,53,35-39,1926,0.008689206359091772
STAT,1904,43,35-39,1947,0.1783559120530942
STAT,1877,24,25-29,1901,57.747399074174275
SIM,1914,39,na,1953,4878
STAT,1840,25,40-44,1865,1.4920342633074626
STAT,1900,27,15-19,1927,0.6285075149352256
SIM,1903,45,35-39,1948,1
STAT,1865,33,45-49,1898,1.5853754490312577
STAT,1919,28,45-49,1947,1.8353957182884024
STAT,1915,40,45-49,1955,0.1656486690761109
STAT,1825,85,na,1910,168.8154498196368
STAT,1889,5,na,1894,3155.8384579476556
SIM,1890,42,35-39,1932,38
STAT,1804,50,20-24,1854,0.00485319327805067
SIM,1848,30,30-34,1878,390
STAT,1933,38,20-24,1971,0.35625746072882924
STAT,1963,6,na,1969,4946.486040613001
SIM,1854,11,na,1865,2439
STAT,1836,63,na,1899,1365.5940264170529
STAT,1883,33,50-100,1916,0.8777480056604917
STAT,1922,38,45-49,1960,0.7662802431848768
SIM,1822,39,45-49,1861,5
SIM,1823,55,na,1878,1119
STAT,1907,48,20-24,1955,0.009752525945334212
STAT,1875,24,15-19,1899,3.366403133048907
STAT,1891,20,40-44,1911,2.5778090867484544
STAT,1894,21,20-24,1915,87.89773337554473
STAT,1929,22,30-34,1951,36.09093377423316
SIM,1833,39,20-24,1872,3
STAT,1796,71,na,1867,1085.0633128083557
SIM,1926,16,20-24,1942,109
SIM,1938,28,20-24,1966,6
STAT,1878,53,25-29,1931,0.0035857554464718794
SIM,1849,58,na,1907,1764
STAT,1912,42,30-34,1954,0.12187082098743088
STAT,1952,17,35-39,1969,4.982604480805049
STAT,1882,31,40-44,1913,4.168984636522072
STAT,1883,21,45-49,1904,0.6728788394827833
SIM,1930,0,na,1930,5852
STAT,1885,43,15-19,1928,0.013476304990338289
STAT,1876,45,15-19,1921,4.0839419686284603E-4
SIM,1878,39,na,1917,3952
STAT,1935,0,na,1935,6114.484626597658
STAT,1890,27,na,1917,2889.142378378603
STAT,1902,35,25-29,1937,0.8834114116843053
STAT,1865,20,25-29,1885,53.667959334501
STAT,1911,12,na,1923,3907.488283544242
STAT,1918,2,na,1920,4391.51874171541
STAT,1945,18,45-49,1963,0.5394883574261247
STAT,1853,53,50-100,1906,0.011522476613089382
STAT,1825,39,20-24,1864,1.0566826852502904
STAT,1905,49,25-29,1954,0.04575701106018929
SIM,1853,53,na,1906,3151
STAT,1902,48,45-49,1950,0.18510402698980685
STAT,1883,15,35-39,1898,0.530334513820986
STAT,1859,36,25-29,1895,2.293013965060482
STAT,1862,95,na,1957,14.985782410711732
STAT,1911,33,25-29,1944,8.861205922994337
STAT,1827,30,20-24,1857,2.8754515809647607
STAT,1868,52,50-100,1920,0.014509649902307402
STAT,1886,19,40-44,1905,0.1883895386312349
SIM,1893,28,na,1921,3404
SIM,1835,50,na,1885,1206
SIM,1937,22,30-34,1959,30
STAT,1822,109,na,1931,4.1026349259587334E-4
STAT,1908,44,50-100,1952,0.10652588481137812
SIM,1908,34,30-34,1942,147
STAT,1929,17,35-39,1946,5.317618664936569
STAT,1881,52,30-34,1933,0.005591351871066175
STAT,1817,40,50-100,1857,0.8019682237680202
STAT,1879,23,20-24,1902,70.47474002965703
SIM,1919,4,na,1923,5211
STAT,1836,20,45-49,1856,1.1084047256802092
STAT,1896,37,40-44,1933,5.770549533194915
STAT,1907,16,45-49,1923,0.09554594963558287
STAT,1918,38,40-44,1956,1.5550055604919093
STAT,1791,106,na,1897,0.0030615598512402555
STAT,1863,30,30-34,1893,15.02538855340837
STAT,1828,34,na,1862,1898.281679011132
STAT,1862,52,20-24,1914,6.251702992924728E-4
SIM,1862,30,na,1892,3763
STAT,1877,45,na,1922,2306.6282455480005
STAT,1840,68,na,1908,601.7348047289847
SIM,1932,36,15-19,1968,4
STAT,1822,38,40-44,1860,8.518520544446748
STAT,1813,42,50-100,1855,5.2890967249591085
STAT,1847,51,40-44,1898,0.009563767515283433
STAT,1848,41,45-49,1889,1.4168297709553088
STAT,1900,49,35-39,1949,0.10711413554307311
STAT,1924,36,15-19,1960,0.022447080533640657
STAT,1843,33,na,1876,2547.712305339287
STAT,1846,33,35-39,1879,7.014761645124121
SIM,1898,43,na,1941,4193
STAT,1813,43,25-29,1856,2.8847152643187375
STAT,1815,51,35-39,1866,8.593467730528712E-4
SIM,1888,41,40-44,1929,1
STAT,1885,64,na,1949,1708.7182882243399
STAT,1925,39,25-29,1964,1.1684414710536117
STAT,1898,23,30-34,1921,23.8784631190181
STAT,1948,22,40-44,1970,3.8211497197944673
STAT,1879,32,35-39,1911,10.38874781119695
SIM,1878,20,15-19,1898,5
SIM,1906,17,20-24,1923,15
STAT,1920,43,50-100,1963,0.1278782232076154
STAT,1880,34,25-29,1914,10.542366314281995
STAT,1905,22,45-49,1927,1.0029719388645764
SIM,1838,54,50-100,1892,2
STAT,1830,40,20-24,1870,0.14403883752003704
STAT,1916,22,50-100,1938,0.6800850483662785
STAT,1930,33,35-39,1963,11.703341937246664
SIM,1815,41,50-100,1856,3
STAT,1847,20,20-24,1867,77.48853980702398
SIM,1837,33,35-39,1870,1
STAT,1839,30,25-29,1869,11.956347761493145
STAT,1853,20,20-24,1873,64.05095367704119
STAT,1874,22,30-34,1896,18.383460913267683
SIM,1919,35,45-49,1954,2
STAT,1861,30,na,1891,2000.5109444292182
SIM,1902,21,30-34,1923,2
STAT,1870,20,20-24,1890,69.11105856091541
STAT,1896,24,35-39,1920,7.644340526662461
STAT,1899,25,15-19,1924,0.6239016908577424
STAT,1838,31,35-39,1869,5.427902624605995
STAT,1913,48,20-24,1961,0.01062145253428971
STAT,1815,85,na,1900,19.328011430975753
STAT,1857,22,30-34,1879,15.779449964170674
SIM,1883,9,na,1892,2246
STAT,1918,25,35-39,1943,15.869184191524168
STAT,1885,20,40-44,1905,2.0604997586076643
STAT,1855,31,35-39,1886,6.895721517949232
SIM,1869,78,na,1947,3268
SIM,1887,23,20-24,1910,5
STAT,1859,33,45-49,1892,1.3763079631623254
STAT,1957,15,45-49,1972,0.6531943736916628
SIM,1855,3,na,1858,3430
STAT,1917,46,25-29,1963,0.054802533117517295
SIM,1838,64,na,1902,1388
STAT,1939,27,45-49,1966,1.7176830884397316
STAT,1854,66,na,1920,911.3186165765419
STAT,1935,25,35-39,1960,20.335886032461026
SIM,1878,45,na,1923,3943
SIM,1941,2,na,1943,4031
STAT,1844,42,15-19,1886,0.014011877360253876
STAT,1833,22,45-49,1855,0.6516495746574137
STAT,1906,43,na,1949,3334.13832363412
SIM,1783,73,na,1856,1623
STAT,1828,50,na,1878,1624.9323350901398
SIM,1847,30,25-29,1877,10
STAT,1851,52,45-49,1903,0.011400779806079822
SIM,1846,83,na,1929,319
STAT,1839,28,na,1867,2513.7442389510934
STAT,1835,32,20-24,1867,2.6038019599438087
STAT,1928,35,45-49,1963,0.8564803524936145
STAT,1842,97,na,1939,1.3336294370195616
STAT,1821,109,na,1930,3.592993608693436E-4
STAT,1844,25,25-29,1869,52.04661950739166
STAT,1866,51,na,1917,1974.8557050129364
SIM,1823,49,na,1872,1226
STAT,1834,51,45-49,1885,0.006689159027773908
STAT,1818,49,30-34,1867,0.16745440722252705
STAT,1892,35,50-100,1927,1.534496942461694
STAT,1850,22,45-49,1872,0.38647693664158356
STAT,1903,27,40-44,1930,4.25223655052993
STAT,1904,17,45-49,1921,0.0933259972204196
STAT,1886,28,na,1914,2462.6651768297943
STAT,1953,17,40-44,1970,1.676843918373683
STAT,1828,51,30-34,1879,0.007000005878613967
STAT,1840,29,45-49,1869,0.5373086575996476
SIM,1865,22,30-34,1887,1
STAT,1809,54,15-19,1863,1.949997876964381E-4
STAT,1885,23,20-24,1908,67.52818287760343
STAT,1926,24,30-34,1950,34.40111968988547
STAT,1848,44,50-100,1892,0.9752565388220008
STAT,1851,15,15-19,1866,5.766339442118856
STAT,1864,21,35-39,1885,5.429363586091579
STAT,1865,103,na,1968,0.9833887290105281
STAT,1883,3,na,1886,2861.0982322184227
STAT,1895,42,30-34,1937,0.10372770826111029
STAT,1849,23,35-39,1872,5.902030743234757
STAT,1929,28,15-19,1957,0.876906417071198
SIM,1833,33,na,1866,2354
STAT,1845,54,25-29,1899,0.00170927401468746
STAT,1828,54,25-29,1882,0.0035715010963597413
SIM,1886,74,na,1960,1682
STAT,1868,23,45-49,1891,0.6714414008610154
STAT,1861,20,na,1881,2049.9803240050064
STAT,1899,72,na,1971,2142.91750833928
STAT,1949,18,15-19,1967,52.24502084430925
STAT,1856,52,35-39,1908,0.006150569488342637
SIM,1893,23,20-24,1916,39
STAT,1848,39,15-19,1887,0.05303876094543507
SIM,1901,28,25-29,1929,1
SIM,1866,24,15-19,1890,11
STAT,1844,30,20-24,1874,3.269508582701269
STAT,1907,24,20-24,1931,99.92054319543092
STAT,1854,41,30-34,1895,0.6421282533140704
SIM,1826,32,20-24,1858,1
STAT,1871,41,20-24,1912,0.15913975432593902
STAT,1943,24,30-34,1967,30.209078327750028
STAT,1886,12,na,1898,2674.317582135884
STAT,1833,98,na,1931,1.3365706878815522
SIM,1928,15,na,1943,4614
SIM,1931,19,na,1950,5007
SIM,1896,58,na,1954,2543
STAT,1879,58,na,1937,2028.6982907433976
STAT,1881,26,40-44,1907,2.838561957708944
STAT,1873,79,na,1952,717.1279215950639
STAT,1889,34,45-49,1923,2.0819753357384965
STAT,1924,24,20-24,1948,129.134235786384
STAT,1944,17,na,1961,3916.487502896863
SIM,1853,63,na,1916,2608
STAT,1908,27,30-34,1935,37.065806864584665
STAT,1894,47,na,1941,2848.220425235853
SIM,1936,8,na,1944,4041
STAT,1875,52,45-49,1927,0.014822773083968687
SIM,1878,23,na,1901,4344
STAT,1859,27,50-100,1886,0.5157670526162287
SIM,1861,20,20-24,1881,6
STAT,1824,38,50-100,1862,0.1962274665833142
STAT,1837,49,40-44,1886,0.1388924333420368
STAT,1890,36,50-100,1926,1.4934680242476002
SIM,1916,27,30-34,1943,17
SIM,1878,34,35-39,1912,191
STAT,1938,15,35-39,1953,4.113955812376695
STAT,1849,34,15-19,1883,0.12384236845477063
STAT,1923,43,45-49,1966,0.1921717453207878
STAT,1870,15,25-29,1885,5.770946618117679
STAT,1895,45,25-29,1940,0.04268828634199915
STAT,1806,49,na,1855,1077.33306220028
STAT,1874,80,na,1954,638.4325155638276
STAT,1892,16,15-19,1908,7.365576364924119
STAT,1927,27,40-44,1954,5.6203321795804815
SIM,1863,31,35-39,1894,1
STAT,1910,28,25-29,1938,62.62695944648852
SIM,1878,55,na,1933,3439
STAT,1876,33,20-24,1909,2.72101246083122
STAT,1918,49,35-39,1967,0.1345575350975041
STAT,1945,27,50-100,1972,1.0799376589076202
STAT,1839,43,45-49,1882,1.4468466142323113
STAT,1825,79,na,1904,430.51785710553156
STAT,1894,57,na,1951,2555.564417220341
STAT,1820,48,na,1868,1750.6176585920614
SIM,1846,22,20-24,1868,1
STAT,1937,25,45-49,1962,1.6681037920042436
STAT,1841,16,na,1857,3316.2618010700858
STAT,1838,22,20-24,1860,38.16607345518692
STAT,1909,35,35-39,1944,2.2876489799347124
SIM,1873,24,na,1897,2296
STAT,1913,24,45-49,1937,1.1149230634215714
STAT,1848,31,50-100,1879,1.0103166027461468
STAT,1887,47,40-44,1934,0.18755675494062063
SIM,1900,38,35-39,1938,10
STAT,1868,25,na,1893,2320.7116225922455
STAT,1870,29,30-34,1899,24.925242403077966
SIM,1817,42,20-24,1859,6
STAT,1920,27,30-34,1947,42.429618257228626
SIM,1878,37,50-100,1915,7
STAT,1931,10,na,1941,5165.360698059204
STAT,1838,25,25-29,1863,23.303627549717604
STAT,1792,89,na,1881,49.26042077342067
SIM,1871,50,na,1921,1773
STAT,1935,16,20-24,1951,184.45821241716314
STAT,1901,44,na,1945,3198.999742736246
STAT,1845,83,na,1928,196.99170025071058
STAT,1824,49,30-34,1873,0.016427088107657712
STAT,1872,20,30-34,1892,17.94292331289063
SIM,1871,34,25-29,1905,69
STAT,1806,50,40-44,1856,0.02911219760340526
STAT,1911,16,35-39,1927,0.8322682818868327
STAT,1904,58,na,1962,2970.065225288366
STAT,1854,44,25-29,1898,0.35223114977436465
STAT,1842,18,15-19,1860,1.8806645786056548
SIM,1945,24,30-34,1969,206
STAT,1859,81,na,1940,428.6059548271144
STAT,1822,39,50-100,1861,2.3068672983710528
STAT,1882,1,na,1883,3217.4098704026264
STAT,1914,17,15-19,1931,9.2573227645316
STAT,1830,43,25-29,1873,0.5604573072006941
STAT,1869,52,30-34,1921,0.0059746335852900335
STAT,1861,52,na,1913,1781.134107815058
STAT,1898,26,35-39,1924,13.019603166672365
STAT,1937,24,30-34,1961,27.68018514594018
STAT,1873,50,30-34,1923,0.006193749824606676
SIM,1942,4,na,1946,3672
STAT,1912,45,35-39,1957,0.12304445466630513
SIM,1840,40,40-44,1880,3
STAT,1916,29,30-34,1945,39.67521098021495
STAT,1916,35,50-100,1951,0.42811816441329037
STAT,1835,31,50-100,1866,0.8918132893281357
SIM,1916,19,30-34,1935,184
STAT,1804,53,25-29,1857,0.02192557958336205
STAT,1819,51,na,1870,592.2590805575011
SIM,1893,26,25-29,1919,95
SIM,1950,19,30-34,1969,28
STAT,1877,36,50-100,1913,1.252305203265208
STAT,1942,19,30-34,1961,12.583830111219806
STAT,1944,16,50-100,1960,0.39876166564981963
STAT,1855,23,35-39,1878,4.479534659168178
SIM,1858,2,na,1860,2651
STAT,1868,101,na,1969,4.004440824644285
STAT,1900,46,30-34,1946,0.07585586132984527
STAT,1845,15,15-19,1860,3.766237407709235
STAT,1857,31,45-49,1888,1.3604567847051618
STAT,1848,33,45-49,1881,1.713838951030879
STAT,1909,48,40-44,1957,0.1430019511504282
STAT,1844,22,45-49,1866,0.8625447020227449
STAT,1889,33,30-34,1922,20.936701143259494
SIM,1869,46,na,1915,3598
STAT,1844,82,na,1926,462.2380321373107
SIM,1833,49,na,1882,2009
STAT,1865,30,40-44,1895,3.9912095158357364
SIM,1880,0,na,1880,3954
STAT,1932,40,45-49,1972,0.2246187405172047
STAT,1831,39,20-24,1870,0.7636890255577766
STAT,1884,20,35-39,1904,5.619474111640794
STAT,1872,29,40-44,1901,2.9781976846603726
SIM,1901,25,20-24,1926,61
STAT,1871,44,25-29,1915,0.6319330349223322
STAT,1911,25,25-29,1936,63.896385996317775
STAT,1933,20,50-100,1953,0.8720469105882084
STAT,1944,15,35-39,1959,4.467248294819526
STAT,1946,23,45-49,1969,1.2381620614517512
STAT,1953,16,na,1969,4413.898572077174
STAT,1931,28,45-49,1959,2.2136837238424096
SIM,1805,68,na,1873,2097
STAT,1832,97,na,1929,4.560358995898176
STAT,1885,26,25-29,1911,41.722846672562014
STAT,1861,106,na,1967,0.08558288685862024
STAT,1946,17,35-39,1963,4.6038322223679
SIM,1835,34,na,1869,1228
STAT,1858,52,45-49,1910,0.011023614060753653
SIM,1803,67,na,1870,965
SIM,1906,34,20-24,1940,8
STAT,1845,30,na,1875,1305.5208592190802
STAT,1916,43,na,1959,3748.097138059943
STAT,1864,44,na,1908,2072.8005380198492
STAT,1820,39,45-49,1859,3.4186974961486882
STAT,1872,95,na,1967,52.88241497606977
SIM,1787,71,na,1858,1329
STAT,1879,74,na,1953,1138.46533685631
STAT,1848,32,30-34,1880,19.053432497338214
STAT,1894,41,na,1935,2952.4065403428
STAT,1928,32,40-44,1960,4.855989774276298
STAT,1941,2,na,1943,4140.73470287937
SIM,1845,34,na,1879,2494
STAT,1807,66,na,1873,909.4951379690061
SIM,1920,28,35-39,1948,17
STAT,1923,19,20-24,1942,156.67838188641923
STAT,1822,54,50-100,1876,0.023388245680376153
STAT,1853,36,30-34,1889,4.175628621477092
SIM,1830,33,25-29,1863,5
STAT,1857,36,15-19,1893,0.04329824301866159
STAT,1912,28,35-39,1940,14.571908154545644
STAT,1873,41,40-44,1914,2.317701136053585
SIM,1830,35,na,1865,765
STAT,1829,33,35-39,1862,5.448038126617671
SIM,1821,48,na,1869,1900
STAT,1903,45,50-100,1948,0.19861804613411682
SIM,1856,32,30-34,1888,4
STAT,1917,34,30-34,1951,16.138511174763444
SIM,1876,6,na,1882,4089
STAT,1874,23,45-49,1897,0.7174584248451125
SIM,1895,47,40-44,1942,2
STAT,1837,52,25-29,1889,0.002850400410088453
STAT,1909,48,30-34,1957,0.0808562435573068
STAT,1824,32,45-49,1856,0.7782827654733867
STAT,1933,17,25-29,1950,57.6166705146547
STAT,1940,19,na,1959,3692.8131624572666
STAT,1847,96,na,1943,7.763342669242913
STAT,1844,22,20-24,1866,85.24059608210423
STAT,1846,30,30-34,1876,12.476571821518807
SIM,1852,39,30-34,1891,40
STAT,1864,15,25-29,1879,5.925948975281082
STAT,1877,21,45-49,1898,0.7100024248238045
STAT,1844,39,30-34,1883,5.464783054646083
SIM,1908,60,na,1968,1851
SIM,1908,37,35-39,1945,3
STAT,1891,23,45-49,1914,0.8548666595178178
STAT,1811,54,30-34,1865,0.025728492237182512
SIM,1859,34,25-29,1893,4
STAT,1897,34,50-100,1931,1.2064037423305813
SIM,1852,22,20-24,1874,12
STAT,1874,27,na,1901,2463.0507146463638
STAT,1830,40,50-100,1870,0.9581713791506037
STAT,1879,30,50-100,1909,0.9474764148656369
STAT,1935,22,30-34,1957,38.85678517491536
SIM,1921,1,na,1922,5527
STAT,1931,39,25-29,1970,1.2920634908488597
STAT,1898,32,45-49,1930,2.344946988275264
STAT,1885,23,45-49,1908,0.6833138088593014
STAT,1797,87,na,1884,2.4023727263718544
SIM,1829,30,20-24,1859,6
STAT,1851,29,20-24,1880,10.693285990982648
STAT,1888,21,20-24,1909,79.776426130553
STAT,1915,17,20-24,1932,27.974384667061923
STAT,1875,38,na,1913,2407.2409637550186
STAT,1932,38,15-19,1970,0.025596271523699744
STAT,1857,25,35-39,1882,7.737164059056726
SIM,1921,42,na,1963,5165
STAT,1886,16,15-19,1902,6.160618162646961
STAT,1899,31,35-39,1930,13.888755469997939
STAT,1905,16,50-100,1921,0.07063909105602774
STAT,1868,47,30-34,1915,0.09306041458228934
STAT,1883,19,15-19,1902,5.678676417380434
STAT,1845,18,40-44,1863,0.11403656775593196
STAT,1927,37,na,1964,4639.445898475306
STAT,1919,4,na,1923,4401.085389641445
STAT,1901,27,20-24,1928,16.40309336981324
STAT,1904,35,35-39,1939,2.2018012099721624
STAT,1805,49,20-24,1854,0.014353860636615342
STAT,1835,44,15-19,1879,0.012203135501271093
SIM,1878,29,na,1907,4315
SIM,1912,22,na,1934,4745
STAT,1837,38,50-100,1875,1.1861896190600658
STAT,1926,27,35-39,1953,17.843458811086787
SIM,1826,32,45-49,1858,3
STAT,1863,42,25-29,1905,0.5475424099575179
STAT,1786,71,na,1857,1121.9522985540466
SIM,1845,12,na,1857,2993
STAT,1843,98,na,1941,3.2097040199384623
STAT,1926,44,25-29,1970,0.08698781426672847
STAT,1879,26,25-29,1905,43.54340139546786
STAT,1846,46,40-44,1892,0.10168293914659186
STAT,1795,91,na,1886,23.076450903444616
STAT,1866,20,30-34,1886,16.630095818021566
STAT,1907,24,45-49,1931,1.0110902447636452
SIM,1902,37,30-34,1939,7
SIM,1943,22,30-34,1965,47
STAT,1879,35,50-100,1914,1.2714287593946079
STAT,1870,32,15-19,1902,0.14197092833654026
STAT,1870,23,25-29,1893,56.893700450684236
STAT,1904,42,na,1946,3309.3832590690936
SIM,1888,23,na,1911,453
STAT,1925,5,na,1930,4812.63864970626
STAT,1924,19,na,1943,4317.784428599508
STAT,1887,23,na,1910,2595.1018711156084
SIM,1903,61,na,1964,1936
STAT,1906,48,15-19,1954,3.226274578047308E-4
STAT,1841,41,35-39,1882,2.12237093093282
STAT,1859,30,40-44,1889,3.487320277376943
STAT,1855,83,na,1938,262.7404722101284
STAT,1841,32,na,1873,2928.1462822747835
STAT,1863,33,35-39,1896,8.609116335477943
STAT,1870,50,na,1920,2177.4112411630927
STAT,1925,15,25-29,1940,52.11077503388028
STAT,1930,25,35-39,1955,18.972860405194357
SIM,1886,58,na,1944,2614
SIM,1891,27,na,1918,2452
STAT,1832,40,40-44,1872,0.19253480287480532
SIM,1924,29,30-34,1953,416
STAT,1902,23,30-34,1925,25.005047174676108
SIM,1897,33,30-34,1930,31
STAT,1859,50,50-100,1909,0.012142346407604985
SIM,1895,31,30-34,1926,1
STAT,1917,46,50-100,1963,0.2336719136912106
STAT,1940,18,50-100,1958,0.37601433459416633
STAT,1907,60,na,1967,3027.4979365590457
STAT,1880,31,30-34,1911,18.19995717788645
STAT,1927,17,25-29,1944,53.44321769268697
STAT,1895,49,40-44,1944,0.12300364247249954
SIM,1912,35,35-39,1947,1
SIM,1894,45,na,1939,1457
STAT,1845,51,20-24,1896,3.679201278176601E-4
SIM,1896,74,na,1970,1165
SIM,1805,52,na,1857,2285
STAT,1909,32,30-34,1941,14.881664623243008
STAT,1786,93,na,1879,13.220027464733136
STAT,1908,19,30-34,1927,2.333471028576801
STAT,1842,20,45-49,1862,0.22150737493986464
STAT,1840,84,na,1924,130.98766025386485
STAT,1859,33,20-24,1892,2.133383375060944
STAT,1887,31,30-34,1918,19.295977452859532
SIM,1865,25,35-39,1890,2
STAT,1911,22,na,1933,3578.45772189235
STAT,1908,17,15-19,1925,8.735199293912022
SIM,1808,66,na,1874,1261
STAT,1839,40,40-44,1879,2.4831248634682064
SIM,1846,25,25-29,1871,12
STAT,1844,33,25-29,1877,12.009048833563027
STAT,1850,39,30-34,1889,2.4485833712937923
SIM,1938,15,na,1953,4240
SIM,1821,40,30-34,1861,9
STAT,1907,27,25-29,1934,61.72187049884137
STAT,1841,36,50-100,1877,1.62760990120976
STAT,1894,63,na,1957,2317.5118070229414
STAT,1905,38,45-49,1943,0.6158060355058668
SIM,1867,36,25-29,1903,3
STAT,1854,110,na,1964,8.07296232065464E-4
SIM,1898,28,15-19,1926,1
STAT,1822,41,25-29,1863,1.170942585318313
STAT,1950,6,na,1956,4603.993150365249
STAT,1894,37,30-34,1931,6.777403088156967
STAT,1855,61,na,1916,1236.7311741991357
STAT,1913,40,35-39,1953,0.19610391049301787
SIM,1833,27,na,1860,2348
SIM,1941,19,na,1960,3840
STAT,1833,21,30-34,1854,19.842994783512662
STAT,1827,46,30-34,1873,0.08977195071461543
STAT,1836,23,25-29,1859,57.47661364266866
SIM,1869,25,na,1894,3625
STAT,1861,34,15-19,1895,0.11741836857533262
SIM,1923,16,na,1939,4291
STAT,1873,38,50-100,1911,1.2531469183588717
STAT,1816,49,na,1865,2451.1021706798783
STAT,1884,80,na,1964,851.9841841000585
SIM,1842,69,na,1911,1595
STAT,1933,39,35-39,1972,3.265178077173987
STAT,1824,84,na,1908,64.37821789322648
STAT,1853,29,30-34,1882,20.28942208075203
SIM,1925,23,na,1948,4906
STAT,1855,20,30-34,1875,13.972185697159144
STAT,1931,17,15-19,1948,58.98477837554993
STAT,1908,36,20-24,1944,0.2460786088469927
SIM,1911,23,25-29,1934,714
STAT,1901,60,na,1961,2799.542174599808
STAT,1855,25,25-29,1880,32.53342672403709
SIM,1870,9,na,1879,2671
STAT,1869,96,na,1965,30.62464125660487
STAT,1826,52,50-100,1878,0.020865346417162475
STAT,1876,36,25-29,1912,2.9246124464672634
STAT,1921,18,35-39,1939,4.713962113125734
STAT,1952,16,20-24,1968,161.0306692348285
STAT,1879,4,na,1883,2948.910860972629
STAT,1839,52,35-39,1891,0.007955805510945338
STAT,1900,22,45-49,1922,0.9659894100239582
STAT,1809,45,25-29,1854,0.5300908929147612
SIM,1838,40,25-29,1878,3
SIM,1927,36,na,1963,1639
SIM,1891,30,35-39,1921,17
STAT,1843,41,45-49,1884,1.542169493288629
STAT,1937,22,40-44,1959,3.2404300216529083
SIM,1861,29,30-34,1890,104
STAT,1924,27,25-29,1951,75.90062522805461
STAT,1920,20,20-24,1940,122.75593127474298
STAT,1830,91,na,1921,41.941026156204764
STAT,1844,46,30-34,1890,0.09617095925632627
STAT,1854,41,20-24,1895,0.08870240285495552
SIM,1863,25,25-29,1888,5
STAT,1897,31,25-29,1928,13.658299824426825
STAT,1887,7,na,1894,2867.6456962548323
SIM,1913,38,na,1951,3105
STAT,1940,29,25-29,1969,66.29998974193028
SIM,1851,46,na,1897,1185
STAT,1860,19,20-24,1879,16.484326118049882
STAT,1829,34,50-100,1863,0.4814557246524835
STAT,1894,73,na,1967,1847.7902450583597
SIM,1828,49,40-44,1877,1
SIM,1932,27,25-29,1959,28
SIM,1946,18,na,1964,3777
STAT,1823,50,40-44,1873,0.016448640679182475
STAT,1889,31,40-44,1920,5.24372445130148
STAT,1903,23,25-29,1926,81.00969185049058
STAT,1914,28,45-49,1942,1.7113418739975883
STAT,1837,30,15-19,1867,0.14617018802841422
STAT,1815,46,50-100,1861,0.025227759789996793
STAT,1926,21,na,1947,4411.742802450887
SIM,1939,30,50-100,1969,86
STAT,1883,26,15-19,1909,0.4379793305817993
SIM,1939,21,na,1960,4711
STAT,1846,42,25-29,1888,0.38492871920597066
STAT,1848,35,35-39,1883,6.963787995100846
STAT,1941,16,45-49,1957,0.5088291055842951
STAT,1890,41,40-44,1931,2.7353105622607266
SIM,1940,18,na,1958,4204
STAT,1830,40,30-34,1870,1.0427159148932044
STAT,1934,26,20-24,1960,24.400737519449013
SIM,1848,57,na,1905,2307
STAT,1922,38,20-24,1960,0.29630810735860064
STAT,1926,26,20-24,1952,21.769052746126338
STAT,1929,23,45-49,1952,1.4085348030502027
STAT,1906,16,na,1922,3666.240260871361
SIM,1882,32,35-39,1914,18
STAT,1869,74,na,1943,1119.8675439926374
STAT,1875,9,na,1884,2729.5005884274383
SIM,1807,65,na,1872,371
STAT,1863,53,40-44,1916,0.00884327852121224
STAT,1829,30,30-34,1859,10.144667584814227
STAT,1889,36,35-39,1925,8.558383621911137
SIM,1843,35,25-29,1878,11
SIM,1908,44,na,1952,2366
STAT,1881,15,25-29,1896,5.376225556594964
STAT,1945,18,na,1963,3975.102240406117
STAT,1860,8,na,1868,2310.4447961124833
STAT,1933,33,50-100,1966,1.1059625896436314
SIM,1902,37,40-44,1939,18
STAT,1863,20,15-19,1883,2.9142438404157027
STAT,1874,59,na,1933,2005.7842643154474
STAT,1895,26,na,1921,3115.216441983518
SIM,1884,14,na,1898,3855
STAT,1875,18,50-100,1893,0.050175614177244164
STAT,1917,29,25-29,1946,67.61860504271915
STAT,1910,17,20-24,1927,26.56326611487498
STAT,1827,39,30-34,1866,5.127943341820734
STAT,1907,49,35-39,1956,0.11342788665541176
STAT,1947,21,50-100,1968,0.7360664910985084
STAT,1926,36,na,1962,4562.636748509739
SIM,1897,36,35-39,1933,67
STAT,1876,40,45-49,1916,1.528231946244925
SIM,1942,26,20-24,1968,27
SIM,1925,37,35-39,1962,1
SIM,1868,77,na,1945,328
SIM,1914,4,na,1918,5181
STAT,1787,72,na,1859,251.51917420364853
STAT,1813,47,40-44,1860,0.6296453793937078
SIM,1943,0,na,1943,4986
SIM,1830,30,20-24,1860,2
STAT,1874,32,35-39,1906,10.451805689296561
SIM,1891,70,na,1961,675
SIM,1925,29,25-29,1954,4
STAT,1905,27,15-19,1932,0.6525696806861537
SIM,1877,8,na,1885,365
STAT,1875,30,35-39,1905,10.482588899222467
SIM,1862,83,na,1945,661
STAT,1874,20,40-44,1894,2.163461197531258
STAT,1928,15,40-44,1943,1.7571459236670877
STAT,1840,29,20-24,1869,5.677197713033561
STAT,1845,67,na,1912,786.612054989693
SIM,1926,24,20-24,1950,6
SIM,1958,13,na,1971,4190
STAT,1807,49,30-34,1856,0.3182931517681912
SIM,1909,27,25-29,1936,440
STAT,1935,34,25-29,1969,12.678733186973867
STAT,1941,10,na,1951,4023.7138352987376
STAT,1949,20,50-100,1969,0.7607521994808162
STAT,1835,35,25-29,1870,2.749749730321285
STAT,1882,78,na,1960,912.1972705069982
SIM,1865,40,35-39,1905,6
STAT,1894,19,50-100,1913,0.061966833639428016
STAT,1937,27,35-39,1964,14.483805219141711
STAT,1851,23,15-19,1874,3.089187768388985
STAT,1910,26,35-39,1936,14.384829007568863
SIM,1832,64,na,1896,729
SIM,1815,49,30-34,1864,2
STAT,1870,34,na,1904,2358.624566007873
SIM,1883,30,35-39,1913,2
STAT,1816,102,na,1918,0.24750608269905167
STAT,1855,67,na,1922,1049.1549771444033
STAT,1836,25,15-19,1861,0.45639273943329356
STAT,1919,17,40-44,1936,1.5251667698100393
SIM,1908,43,20-24,1951,1
STAT,1826,49,40-44,1875,0.23857609114965866
STAT,1840,31,na,1871,1050.2424527321655
STAT,1948,0,na,1948,5017.848630725431
STAT,1856,30,25-29,1886,7.6031278469656725
STAT,1848,46,15-19,1894,3.7537224064367974E-4
STAT,1869,19,40-44,1888,0.1849221373379894
STAT,1833,24,35-39,1857,4.127286250732646
SIM,1926,38,30-34,1964,1
SIM,1899,44,na,1943,1776
STAT,1884,42,45-49,1926,1.4309284524188381
STAT,1950,17,25-29,1967,50.75200046082323
SIM,1921,26,na,1947,5259
STAT,1863,86,na,1949,189.41842618219624
STAT,1820,91,na,1911,39.85141444769723
STAT,1918,24,20-24,1942,117.56825362289594
STAT,1925,28,20-24,1953,21.28754291106256
STAT,1864,51,40-44,1915,0.009616543323434102
SIM,1951,3,na,1954,2395
STAT,1886,28,50-100,1914,0.6601017510126722
STAT,1900,49,25-29,1949,0.04406981532158303
STAT,1867,42,45-49,1909,1.4136749990645208
STAT,1921,32,30-34,1953,17.32518120272575
STAT,1940,18,45-49,1958,0.5013524461255552
STAT,1872,36,40-44,1908,4.404552241238261
STAT,1836,20,20-24,1856,109.53760343740517
STAT,1831,28,40-44,1859,3.4122177711089927
STAT,1845,51,30-34,1896,0.002967888921222769
STAT,1911,38,45-49,1949,0.6478046773281805
SIM,1919,37,35-39,1956,11
STAT,1842,47,50-100,1889,0.06097902910000284
STAT,1936,17,40-44,1953,1.325833077207372
STAT,1900,35,15-19,1935,0.07852887784036296
SIM,1841,24,35-39,1865,1
SIM,1912,32,30-34,1944,228
STAT,1927,39,35-39,1966,2.9763860144435745
SIM,1934,26,20-24,1960,5
STAT,1861,25,25-29,1886,35.94965032611293
STAT,1857,107,na,1964,0.0213775117343666
STAT,1811,43,15-19,1854,0.0708185900891553
STAT,1864,59,na,1923,1766.8152125179374
SIM,1910,39,40-44,1949,8
STAT,1898,37,15-19,1935,0.07551198229171684
STAT,1942,28,20-24,1970,18.930566818381358
SIM,1829,33,25-29,1862,14
STAT,1914,36,20-24,1950,0.26078730786728604
SIM,1856,45,na,1901,461
SIM,1867,12,na,1879,2793
STAT,1806,50,na,1856,1066.156617145039
STAT,1922,27,50-100,1949,1.1137347408175886
STAT,1906,43,45-49,1949,0.1494105561293817
STAT,1863,96,na,1959,12.840774843762539
STAT,1888,24,25-29,1912,65.65719231245912
STAT,1911,22,20-24,1933,104.26865870826614
STAT,1850,46,na,1896,1041.8398117434756
STAT,1853,32,15-19,1885,0.11371106992264086
SIM,1887,59,na,1946,3006
SIM,1896,24,25-29,1920,132
STAT,1902,39,40-44,1941,1.317103247809413
STAT,1887,40,20-24,1927,0.1765650538774823
STAT,1840,16,50-100,1856,0.025124285936017367
SIM,1837,32,20-24,1869,19
SIM,1890,26,na,1916,3916
SIM,1942,25,na,1967,3636
STAT,1905,16,35-39,1921,0.791157966410247
SIM,1861,32,15-19,1893,5
STAT,1913,7,na,1920,4022.506905329166
STAT,1888,22,35-39,1910,6.735099280196048
STAT,1904,32,30-34,1936,14.323205815776653
SIM,1828,64,na,1892,1083
STAT,1846,31,na,1877,1532.7029595872768
STAT,1831,54,na,1885,1679.3360687961988
STAT,1854,48,40-44,1902,0.09399415805331648
STAT,1874,21,50-100,1895,0.4221374585442897
STAT,1829,32,20-24,1861,1.490313684032436
STAT,1847,21,35-39,1868,6.514582936563241
STAT,1876,44,na,1920,2304.9131390426382
STAT,1923,18,na,1941,4265.415360770513
STAT,1930,22,30-34,1952,36.56092751272581
STAT,1831,35,40-44,1866,4.560884244814608
STAT,1855,45,na,1900,1503.8716376189002
SIM,1863,31,na,1894,1012
STAT,1911,37,40-44,1948,1.4296068812157685
SIM,1834,41,45-49,1875,2
STAT,1824,107,na,1931,9.126489072994558E-4
SIM,1863,46,na,1909,505
STAT,1950,21,45-49,1971,1.3225364390839822
STAT,1862,15,15-19,1877,5.857955181731072
STAT,1866,38,30-34,1904,4.840808248176178
STAT,1846,39,40-44,1885,2.6517807752002773
STAT,1929,25,35-39,1954,18.72896271992276
STAT,1890,49,50-100,1939,0.16421435737348156
STAT,1847,40,25-29,1887,0.5989759765306737
STAT,1932,33,45-49,1965,2.0760017015237358
SIM,1908,36,20-24,1944,3
STAT,1866,21,45-49,1887,0.6463664112772729
STAT,1956,3,na,1959,5159.776899334905
SIM,1822,39,50-100,1861,2
STAT,1909,26,20-24,1935,17.473932906706114
STAT,1794,103,na,1897,3.3966624131359527E-4
STAT,1902,26,35-39,1928,13.633867043935284
STAT,1896,23,20-24,1919,90.56171931336547
STAT,1929,39,45-49,1968,0.867229051151316
STAT,1892,48,50-100,1940,0.1693688931533969
STAT,1922,16,35-39,1938,4.813876096963123
SIM,1923,33,45-49,1956,3
STAT,1916,38,20-24,1954,0.2649482017381834
STAT,1944,28,30-34,1972,41.85206845997044
STAT,1817,51,45-49,1868,0.01001274093382812
STAT,1842,25,15-19,1867,0.14130463091304374
SIM,1881,49,na,1930,2699
STAT,1878,31,15-19,1909,0.1471176428467797
STAT,1883,30,35-39,1913,9.820987952260243
STAT,1925,37,35-39,1962,2.8764705539061715
STAT,1827,42,15-19,1869,0.013106397918125326
STAT,1909,41,20-24,1950,0.016444490265189203
STAT,1902,18,25-29,1920,7.958756046901774
STAT,1925,15,15-19,1940,54.573647427388046
SIM,1831,29,45-49,1860,30
STAT,1901,28,35-39,1929,13.443788992420675
STAT,1857,29,15-19,1886,0.3534727996489001
SIM,1881,59,na,1940,1753
STAT,1962,4,na,1966,4991.52401633338
SIM,1848,79,na,1927,502
STAT,1813,51,na,1864,2132.957004771086
STAT,1822,45,40-44,1867,0.29433640509791203
SIM,1895,1,na,1896,4648
STAT,1894,33,15-19,1927,0.18032971784696994
STAT,1812,99,na,1911,0.1499840014685734
STAT,1915,33,45-49,1948,1.573318302092276
STAT,1872,50,50-100,1922,0.015340611036665197
STAT,1920,27,40-44,1947,5.0473011992592
SIM,1891,15,35-39,1906,4
STAT,1862,100,na,1962,2.647293012154882
STAT,1869,15,25-29,1884,5.866277033372944
STAT,1790,76,na,1866,506.1723547267583
STAT,1902,32,20-24,1934,3.806340361402595
STAT,1854,30,15-19,1884,0.08278787648970466
STAT,1917,17,30-34,1934,2.5879152699903885
STAT,1868,43,15-19,1911,0.013242157532639864
STAT,1801,66,na,1867,700.8828000150108
STAT,1831,32,na,1863,2194.5893661632986
STAT,1916,25,25-29,1941,67.58297192143947
SIM,1911,20,20-24,1931,863
STAT,1855,22,20-24,1877,53.282397834820685
SIM,1907,27,15-19,1934,4
STAT,1920,23,25-29,1943,101.05530616832002
STAT,1906,26,45-49,1932,1.6133157219602017
STAT,1872,0,na,1872,3714.974393888369
SIM,1833,37,30-34,1870,40
STAT,1894,24,25-29,1918,72.34114968528473
STAT,1837,64,na,1901,1393.8742065008319
STAT,1861,44,50-100,1905,0.8667314456379029
STAT,1880,31,20-24,1911,2.8176603472695136
STAT,1889,47,15-19,1936,2.70446309325623E-4
STAT,1834,23,15-19,1857,1.930536072682612
STAT,1823,53,45-49,1876,0.02136043054436865
STAT,1912,5,na,1917,4005.4083562916103
STAT,1840,18,40-44,1858,0.09269567813248045
STAT,1920,28,45-49,1948,1.8641926077291937
STAT,1921,15,30-34,1936,13.792694058132671
STAT,1872,32,25-29,1904,10.256530104597232
STAT,1905,29,50-100,1934,0.9135066965470461
SIM,1918,22,na,1940,3954
STAT,1827,33,25-29,1860,10.397073463381082
STAT,1872,27,50-100,1899,0.6405621101319249
STAT,1903,16,25-29,1919,8.063740745109886
SIM,1839,27,na,1866,988
STAT,1929,20,40-44,1949,4.247368608751526
STAT,1955,15,35-39,1970,5.524689877286879
STAT,1888,42,50-100,1930,1.2178172408878536
STAT,1940,26,20-24,1966,18.41347609969783
STAT,1877,26,15-19,1903,0.46214320987536534
STAT,1915,46,15-19,1961,3.6685900567793716E-4
STAT,1818,50,na,1868,1644.3117324699094
STAT,1926,20,15-19,1946,6.449845627521757
SIM,1835,33,25-29,1868,1
STAT,1865,42,35-39,1907,1.6512213775627724
STAT,1920,26,na,1946,4070.512701645092
STAT,1825,37,30-34,1862,7.671060296246686
STAT,1952,19,25-29,1971,51.4227848620916
STAT,1934,29,25-29,1963,87.85786227846194
SIM,1868,3,na,1871,1405
SIM,1903,23,na,1926,2940
STAT,1905,59,na,1964,2980.996013171618
SIM,1828,80,na,1908,163
STAT,1800,55,na,1855,1866.6625600000004
STAT,1892,28,30-34,1920,31.067809725863558
STAT,1887,34,35-39,1921,11.051157384455614
STAT,1870,36,30-34,1906,5.338805550482452
SIM,1952,5,na,1957,6381
STAT,1816,65,na,1881,1649.382897860318
STAT,1913,33,35-39,1946,8.940049996044658
STAT,1880,53,40-44,1933,0.01075384414290954
STAT,1871,30,50-100,1901,0.9213417348505313
STAT,1928,18,45-49,1946,0.623013166814007
SIM,1860,39,40-44,1899,8
SIM,1913,7,na,1920,3719
STAT,1809,79,na,1888,715.0611302907266
STAT,1868,34,25-29,1902,9.808332829447334
STAT,1852,39,40-44,1891,4.361993618750155
STAT,1866,23,35-39,1889,5.331670521474809
STAT,1911,45,50-100,1956,0.2127089389707767
SIM,1933,11,na,1944,4542
STAT,1926,29,25-29,1955,77.66758166780811
STAT,1797,101,na,1898,0.005704213527300575
SIM,1832,32,na,1864,2182
STAT,1891,32,35-39,1923,12.453544214031876
STAT,1847,23,25-29,1870,62.99314068631463
STAT,1868,31,20-24,1899,2.621475071390343
STAT,1903,20,20-24,1923,98.40572002051304
STAT,1812,52,30-34,1864,0.001464539665733093
SIM,1893,44,na,1937,3107
SIM,1916,39,25-29,1955,5
STAT,1935,31,20-24,1966,3.352226347591058
STAT,1905,37,na,1942,3415.389288022386
STAT,1897,8,na,1905,3452.3324224167277
STAT,1918,38,30-34,1956,1.8932079414505028
STAT,1831,52,40-44,1883,0.008732877250374204
STAT,1860,20,50-100,1880,0.38232491072137126
STAT,1880,34,na,1914,2456.1492798704785
SIM,1925,26,20-24,1951,3
STAT,1813,104,na,1917,0.04885951726111622
STAT,1856,31,50-100,1887,0.6731071168764797
STAT,1895,58,na,1953,2572.602136960251
STAT,1908,39,25-29,1947,0.9055191238105573
STAT,1893,49,30-34,1942,0.06685720265658823
STAT,1924,16,45-49,1940,0.5906026020299054
SIM,1814,51,na,1865,2442
SIM,1832,69,na,1901,362
SIM,1885,21,20-24,1906,4
SIM,1903,45,na,1948,2596
STAT,1834,46,na,1880,1065.0253992837327
STAT,1898,41,35-39,1939,0.16985870536555125
STAT,1872,63,na,1935,1786.7301755663548
STAT,1888,9,na,1897,2994.631338460271
STAT,1893,45,15-19,1938,2.849735146266713E-4
STAT,1917,26,20-24,1943,18.95247602906315
STAT,1849,40,35-39,1889,1.5524433687752324
SIM,1918,37,na,1955,4400
STAT,1921,29,15-19,1950,0.7719026219810066
STAT,1939,18,20-24,1957,134.17326357767564
STAT,1918,22,30-34,1940,30.58010655860649
SIM,1872,67,na,1939,2049
STAT,1939,24,40-44,1963,3.3373762060897874
SIM,1855,27,na,1882,3295
STAT,1918,27,25-29,1945,69.10254203780399
SIM,1920,41,na,1961,3736
SIM,1934,22,na,1956,5222
STAT,1851,27,30-34,1878,23.286643593043244
SIM,1899,1,na,1900,2393
STAT,1854,82,na,1936,259.42807998052047
STAT,1804,50,30-34,1854,0.03914909099405905
STAT,1881,19,40-44,1900,0.17179781050232934
STAT,1914,39,25-29,1953,0.9596441382181718
STAT,1838,27,na,1865,1173.5095963701538
STAT,1884,44,50-100,1928,0.9976614145706871
STAT,1885,47,30-34,1932,0.09470590622012069
SIM,1857,40,35-39,1897,3
SIM,1913,23,na,1936,3448
STAT,1834,29,20-24,1863,6.682589693105444
SIM,1934,29,25-29,1963,3
SIM,1837,35,25-29,1872,1
STAT,1796,86,na,1882,129.9084711787276
STAT,1831,37,50-100,1868,1.2469498135206478
STAT,1875,81,na,1956,592.1971123687198
STAT,1869,52,20-24,1921,7.406570834389384E-4
SIM,1910,15,20-24,1925,107
STAT,1917,22,na,1939,3829.370721748533
STAT,1824,41,35-39,1865,0.30658121889153933
STAT,1853,23,25-29,1876,52.06925754593641
STAT,1928,29,50-100,1957,1.2157326051649933
STAT,1901,25,30-34,1926,35.448588935469246
STAT,1930,40,35-39,1970,0.26381721233755123
STAT,1882,20,25-29,1902,55.13454885539854
STAT,1909,44,25-29,1953,0.0652999414574184
SIM,1922,39,25-29,1961,4
STAT,1887,43,25-29,1930,0.7016992281754082
SIM,1841,46,na,1887,242
STAT,1874,25,35-39,1899,10.0258965386197
SIM,1902,38,45-49,1940,1
STAT,1896,21,30-34,1917,23.551551751772138
STAT,1830,47,40-44,1877,0.14630710701625446
SIM,1922,37,na,1959,3333
STAT,1822,48,45-49,1870,0.3892029433357097
STAT,1849,20,30-34,1869,18.40911518923963
SIM,1902,60,na,1962,2727
STAT,1917,43,20-24,1960,0.018155354094294897
STAT,1895,1,na,1896,3540.801196172373
STAT,1886,22,na,1908,2449.126320580119
SIM,1901,38,na,1939,3756
STAT,1861,22,20-24,1883,58.8774000088265
STAT,1899,18,15-19,1917,8.084571581479754
STAT,1930,42,50-100,1972,0.1534882832835015
SIM,1923,30,40-44,1953,72
STAT,1793,68,na,1861,639.3292675144019
SIM,1802,66,na,1868,351
STAT,1806,65,na,1871,725.9545127281483
STAT,1907,31,45-49,1938,1.4669682797810464
SIM,1878,20,25-29,1898,320
STAT,1917,37,35-39,1954,2.4787374055295373
STAT,1867,101,na,1968,3.508501836662968
STAT,1852,44,15-19,1896,0.013713172960620247
STAT,1925,17,15-19,1942,54.32126291765015
STAT,1930,19,50-100,1949,0.47839085986935675
SIM,1897,31,40-44,1928,27
STAT,1836,53,na,1889,1634.6379245392918
SIM,1837,30,30-34,1867,1
STAT,1841,23,50-100,1864,0.5711253880614015
SIM,1819,50,na,1869,1883
STAT,1906,19,20-24,1925,25.534504429289914
STAT,1938,21,na,1959,3576.6692449110446
SIM,1853,31,na,1884,3332
STAT,1923,48,15-19,1971,4.2521043999922475E-4
STAT,1831,31,25-29,1862,11.055581343588294
STAT,1858,107,na,1965,0.024927164331201717
SIM,1940,16,45-49,1956,23
STAT,1872,53,40-44,1925,0.010372700299733768
STAT,1895,42,20-24,1937,0.01432875273422686
SIM,1859,27,25-29,1886,4
SIM,1929,5,na,1934,6274
STAT,1954,17,na,1971,4510.054990472441
STAT,1944,17,25-29,1961,46.110527405424314
SIM,1878,31,30-34,1909,35
STAT,1850,31,35-39,1881,4.942929333266611
STAT,1942,15,25-29,1957,44.79336981503871
STAT,1821,54,na,1875,1167.4069126383695
STAT,1811,47,30-34,1858,0.45497317084143996
STAT,1857,40,35-39,1897,1.4035696867303293
SIM,1861,23,25-29,1884,1
STAT,1902,15,20-24,1917,25.080605644161825
STAT,1848,30,40-44,1878,4.831881076186913
STAT,1856,21,35-39,1877,4.903070024206063
STAT,1915,30,40-44,1945,3.960855444422496
STAT,1833,39,30-34,1872,2.8131610107467404
STAT,1865,45,na,1910,2074.5628733224657
SIM,1862,44,25-29,1906,3
STAT,1824,68,na,1892,295.74247144885305
STAT,1912,26,45-49,1938,1.688488654773725
STAT,1800,101,na,1901,0.39371618297358824
STAT,1871,41,30-34,1912,1.1520334194919337
STAT,1932,16,45-49,1948,0.6584784535404768
SIM,1823,65,na,1888,708
STAT,1806,87,na,1893,53.05127734109442
STAT,1862,32,15-19,1894,0.12129445801490128
SIM,1935,6,na,1941,5881
STAT,1872,23,35-39,1895,5.825357799732821
STAT,1868,20,40-44,1888,2.04190674574389
STAT,1921,35,35-39,1956,2.67333200544362
STAT,1915,15,50-100,1930,0.0776649376029956
STAT,1928,44,35-39,1972,0.2539060323045987
SIM,1890,20,25-29,1910,28
STAT,1871,45,na,1916,2266.6891812966587
STAT,1828,51,20-24,1879,8.677693559107129E-4
STAT,1936,14,na,1950,3743.653249989151
STAT,1886,44,na,1930,2361.098097602132
STAT,1829,35,25-29,1864,1.512987641731711
SIM,1856,30,40-44,1886,23
STAT,1943,27,35-39,1970,15.807062129174387
STAT,1925,19,30-34,1944,14.511070553637293
STAT,1811,48,50-100,1859,1.1359895829083764
STAT,1896,26,25-29,1922,55.95430779121892
STAT,1877,49,50-100,1926,0.24410808018355667
STAT,1861,100,na,1961,2.252483949026338
STAT,1903,27,30-34,1930,35.74598908519669
SIM,1854,16,na,1870,2271
SIM,1904,30,30-34,1934,1
STAT,1829,47,50-100,1876,0.11359997250230942
SIM,1854,10,na,1864,2511
STAT,1900,39,30-34,1939,1.5775143559063707
STAT,1925,47,35-39,1972,0.1548024447861463
STAT,1842,21,35-39,1863,1.8403575055665853
STAT,1875,39,25-29,1914,2.926754067218979
STAT,1880,20,15-19,1900,3.445331366168223
STAT,1845,22,15-19,1867,2.0322693994474155
STAT,1872,38,45-49,1910,1.9862958998089428
STAT,1921,17,50-100,1938,0.42199502336664724
SIM,1872,35,na,1907,2405
STAT,1874,25,45-49,1899,1.153680877160726
STAT,1932,23,50-100,1955,0.8546925265988723
STAT,1856,34,40-44,1890,3.0881938364318717
STAT,1859,35,20-24,1894,0.6167715855235125
STAT,1796,70,na,1866,1192.940964201057
SIM,1860,8,na,1868,2608
STAT,1831,42,40-44,1873,2.1982532566836115
STAT,1915,34,45-49,1949,1.5664586342951532
STAT,1889,40,30-34,1929,1.3984289390239926
SIM,1924,22,na,1946,5208
STAT,1849,27,na,1876,2160.7039982184865
STAT,1839,37,45-49,1876,2.213259837453348
STAT,1941,31,35-39,1972,9.491003906822856
STAT,1871,51,25-29,1922,0.003550217946216279
STAT,1911,18,25-29,1929,8.551629496833785
STAT,1841,47,na,1888,2516.7017128317148
STAT,1920,25,40-44,1945,5.081543747888321
STAT,1857,48,20-24,1905,0.009092634347627688
STAT,1918,44,40-44,1962,0.2614772524021825
STAT,1869,21,45-49,1890,0.705778960474066
SIM,1907,39,35-39,1946,15
STAT,1934,27,35-39,1961,20.060179764477247
STAT,1822,44,40-44,1866,3.8352956357464967
STAT,1858,63,na,1921,1362.6094523620297
STAT,1935,34,15-19,1969,0.17627830217301163
SIM,1864,21,35-39,1885,4
SIM,1883,39,25-29,1922,3
STAT,1825,45,20-24,1870,0.01565410290594101
STAT,1930,29,15-19,1959,0.890465216381163
STAT,1932,31,40-44,1963,5.169015650296247
STAT,1814,45,45-49,1859,0.8286554904152011
STAT,1833,21,40-44,1854,2.321376075172713
STAT,1920,16,25-29,1936,48.11219409613078
STAT,1808,48,25-29,1856,0.08934879515276313
STAT,1861,16,20-24,1877,17.046707652733456
STAT,1902,41,25-29,1943,0.06307780466107854
SIM,1912,37,na,1949,4584
STAT,1948,18,20-24,1966,153.5180701048502
SIM,1908,26,20-24,1934,6
STAT,1904,20,25-29,1924,82.27455785285194
STAT,1936,19,na,1955,3470.2570050569543
STAT,1862,28,50-100,1890,0.5429343704238936
STAT,1868,28,25-29,1896,40.71389052383377
STAT,1892,36,20-24,1928,0.9589767505474812
STAT,1836,42,15-19,1878,0.012588814699969596
STAT,1853,32,na,1885,1905.4449486847955
STAT,1883,38,20-24,1921,0.7379116408647334
STAT,1885,65,na,1950,1661.147571080174
STAT,1844,19,25-29,1863,7.05249401142539
SIM,1835,24,20-24,1859,50
SIM,1901,65,na,1966,2671
STAT,1848,35,45-49,1883,1.9627276862992278
STAT,1926,34,20-24,1960,2.9203152804694548
STAT,1909,37,25-29,1946,0.9224798180244125
STAT,1946,20,30-34,1966,31.65971763874541
STAT,1853,53,30-34,1906,0.004541432162167538
STAT,1954,15,40-44,1969,1.7147624086928526
STAT,1912,21,15-19,1933,5.057482122120546
STAT,1909,44,15-19,1953,0.0014042999100784303
STAT,1906,41,40-44,1947,0.2272039516993496
SIM,1920,21,15-19,1941,88
STAT,1865,27,45-49,1892,1.013696833513634
STAT,1883,22,35-39,1905,5.613983893354531
STAT,1902,34,35-39,1936,8.118293084795123
SIM,1896,73,na,1969,1165
STAT,1937,18,45-49,1955,0.4796872378896695
STAT,1944,18,na,1962,3915.234226895936
STAT,1866,46,20-24,1912,0.010984924936985828
STAT,1850,54,45-49,1904,0.006516995708676212
STAT,1866,40,35-39,1906,1.6696235163613462
STAT,1934,18,20-24,1952,181.6606818788971
SIM,1868,30,na,1898,1057
STAT,1907,29,15-19,1936,0.6517323492792766
STAT,1923,7,na,1930,4644.434552569897
SIM,1824,31,35-39,1855,3
STAT,1897,22,35-39,1919,7.749820624030475
STAT,1841,46,15-19,1887,4.532143441570113E-4
SIM,1922,43,na,1965,3315
SIM,1886,59,na,1945,2614
SIM,1924,38,na,1962,5194
SIM,1851,77,na,1928,592
STAT,1822,108,na,1930,0.001056263980319439
STAT,1854,6,na,1860,1659.339629782695
STAT,1943,29,25-29,1972,69.23042085751148
STAT,1805,92,na,1897,5.587807759699247
SIM,1847,68,na,1915,1382
STAT,1826,54,na,1880,1811.7058487291647
SIM,1793,62,na,1855,1150
SIM,1924,29,40-44,1953,107
SIM,1839,33,na,1872,1000
STAT,1905,27,na,1932,3432.5853873726087
STAT,1916,36,30-34,1952,1.8498191052673767
STAT,1851,21,na,1872,2031.1942065336752
STAT,1877,25,15-19,1902,0.46368728854622426
SIM,1921,19,15-19,1940,29
SIM,1859,41,na,1900,1874
STAT,1913,19,15-19,1932,9.113438010175622
SIM,1910,16,35-39,1926,33
STAT,1805,52,40-44,1857,0.012330485710289834
STAT,1822,40,na,1862,1629.473942715985
STAT,1915,41,35-39,1956,0.20015495486273172
STAT,1900,46,20-24,1946,0.009403619521143304
SIM,1829,43,na,1872,2032
STAT,1876,13,na,1889,2614.0954484864114
STAT,1835,90,na,1925,59.65511854220631
STAT,1902,25,20-24,1927,16.631841003173044
STAT,1929,23,35-39,1952,11.787211368721763
STAT,1883,2,na,1885,3032.7519951435474
STAT,1872,43,40-44,1915,2.2360635829041278
STAT,1891,38,50-100,1929,1.502302011288947
SIM,1783,72,na,1855,1623
STAT,1881,54,45-49,1935,0.013327893750772823
STAT,1903,23,15-19,1926,4.668531130369926
SIM,1902,26,25-29,1928,25
STAT,1933,19,15-19,1952,60.01617412380369
STAT,1882,47,15-19,1929,3.8117838465287447E-4
SIM,1861,51,na,1912,1907
SIM,1863,43,40-44,1906,1
SIM,1898,44,na,1942,4194
STAT,1865,47,15-19,1912,3.6349355682948893E-4
STAT,1928,25,40-44,1953,5.737358320283785
STAT,1919,35,na,1954,4010.329976592927
STAT,1932,26,45-49,1958,2.2480817311771673
SIM,1874,40,50-100,1914,3
SIM,1872,39,na,1911,2362
STAT,1904,39,15-19,1943,0.017142182011860546
SIM,1951,16,20-24,1967,16
STAT,1941,25,50-100,1966,1.0188396950550807
SIM,1879,32,35-39,1911,31
STAT,1917,36,20-24,1953,0.2714477230679321
STAT,1869,27,30-34,1896,25.41059881424665
STAT,1926,16,20-24,1942,165.2018268245172
STAT,1804,53,35-39,1857,0.05329133980288066
STAT,1858,43,50-100,1901,0.800946630543511
STAT,1896,47,45-49,1943,0.17466928050956076
SIM,1836,29,na,1865,1928
STAT,1850,16,45-49,1866,0.037077615598660824
STAT,1892,20,35-39,1912,7.267979573372753
STAT,1842,37,20-24,1879,0.22447851350278797
STAT,1923,40,na,1963,4307.074902759772
STAT,1877,43,15-19,1920,0.013917371512498881
STAT,1943,16,20-24,1959,142.16647502527027
STAT,1920,23,15-19,1943,5.823745677326743
STAT,1835,26,20-24,1861,11.652107622834523
STAT,1916,29,40-44,1945,4.7196451013834935
SIM,1852,19,25-29,1871,11
STAT,1839,20,20-24,1859,83.45773383765638
SIM,1919,25,40-44,1944,25
STAT,1942,26,30-34,1968,40.67282652283123
STAT,1923,15,40-44,1938,1.6326974190374879
STAT,1851,38,25-29,1889,2.2745784621347007
SIM,1925,18,20-24,1943,1143
STAT,1815,86,na,1901,15.643512611888848
SIM,1893,17,20-24,1910,99
SIM,1942,18,20-24,1960,326
STAT,1869,41,15-19,1910,0.013998302562906512
STAT,1918,42,15-19,1960,0.0016107454874732103
STAT,1946,13,na,1959,4309.063872714635
SIM,1906,41,35-39,1947,2
SIM,1852,15,na,1867,2426
STAT,1845,40,15-19,1885,0.007159319346533943
SIM,1840,34,na,1874,2656
STAT,1903,33,40-44,1936,3.5198687791026133
STAT,1937,20,na,1957,3521.803992622919
SIM,1844,48,na,1892,2507
STAT,1910,18,35-39,1928,0.8199956797752851
STAT,1878,20,50-100,1898,0.42206635668482084
STAT,1934,36,20-24,1970,0.3616394824444804
STAT,1830,50,25-29,1880,0.0030448546068391406
SIM,1918,38,na,1956,4395
STAT,1794,75,na,1869,5.145508554573457
SIM,1917,52,na,1969,1988
STAT,1894,15,20-24,1909,22.649383992728993
STAT,1885,17,20-24,1902,17.426248585433044
STAT,1846,78,na,1924,462.7527825874317
SIM,1897,28,45-49,1925,12
STAT,1917,16,na,1933,4110.818082168445
STAT,1942,19,40-44,1961,1.4440461359032408
SIM,1904,18,na,1922,4172
STAT,1917,18,20-24,1935,28.709836842863794
STAT,1912,23,40-44,1935,3.1750714866628105
STAT,1828,40,15-19,1868,0.017857735607703474
STAT,1923,33,40-44,1956,4.436297298139922
STAT,1921,21,na,1942,4088.0543772774413
STAT,1810,55,na,1865,79.65777583468518
STAT,1850,83,na,1933,183.31337361472546
SIM,1823,50,na,1873,1228
STAT,1925,35,na,1960,4481.907674868975
STAT,1814,69,na,1883,1175.3361177649251
STAT,1840,35,45-49,1875,0.9478793979999292
SIM,1892,43,na,1935,3564
STAT,1889,20,35-39,1909,7.069159537867416
STAT,1881,36,45-49,1917,1.8916055065287218
SIM,1905,25,40-44,1930,12
SIM,1931,33,40-44,1964,1
STAT,1887,60,na,1947,2099.181532409756
STAT,1914,48,15-19,1962,3.5925263969464216E-4
SIM,1854,53,40-44,1907,1
STAT,1898,49,20-24,1947,0.008912336547090319
STAT,1870,47,25-29,1917,0.05715563731016539
STAT,1886,41,15-19,1927,0.014365478025011091
STAT,1871,44,35-39,1915,1.781983203201047
STAT,1906,44,na,1950,3313.066569428754
SIM,1901,36,35-39,1937,2
STAT,1908,46,20-24,1954,0.009991731440002302
SIM,1878,24,na,1902,4330
STAT,1844,24,20-24,1868,84.02093547967071
SIM,1941,19,15-19,1960,9
STAT,1889,28,45-49,1917,1.332348361400436
STAT,1895,31,15-19,1926,0.18601128961006994
STAT,1910,36,35-39,1946,2.298408363548485
SIM,1911,23,15-19,1934,19
STAT,1840,53,45-49,1893,0.005622580008087251
STAT,1908,37,35-39,1945,2.247078168701617
STAT,1821,86,na,1907,112.05127130720645
STAT,1835,47,na,1882,1794.3244313321397
SIM,1916,28,20-24,1944,12
STAT,1900,43,na,1943,3189.5756384418332
SIM,1884,24,na,1908,2727
STAT,1876,27,20-24,1903,11.85941834115304
STAT,1899,41,na,1940,3182.0824374246145
STAT,1858,59,na,1917,1484.1541868925917
STAT,1938,29,45-49,1967,1.691550882365653
STAT,1889,33,40-44,1922,5.200344038665135
STAT,1900,23,45-49,1923,0.9630045027469839
SIM,1897,33,40-44,1930,212
SIM,1886,43,na,1929,2969
STAT,1917,45,35-39,1962,0.13349562800933118
STAT,1927,32,15-19,1959,0.156788309976463
STAT,1886,23,15-19,1909,3.405748281213983
SIM,1881,12,na,1893,3228
STAT,1834,38,25-29,1872,1.5620435663483778
STAT,1882,36,50-100,1918,1.181111039753048
SIM,1842,38,25-29,1880,5
STAT,1908,28,20-24,1936,17.062174120148846
STAT,1844,83,na,1927,393.2906072637095
STAT,1915,21,na,1936,3732.734351481493
STAT,1937,27,50-100,1964,0.96022890126108
STAT,1820,69,na,1889,1001.5685076588659
STAT,1938,21,35-39,1959,9.222202949674521
SIM,1884,27,20-24,1911,144
SIM,1902,23,na,1925,2188
STAT,1846,48,45-49,1894,0.13801730410968063
SIM,1906,37,na,1943,3447
SIM,1907,36,30-34,1943,8
SIM,1964,3,na,1967,5113
STAT,1916,39,35-39,1955,2.418560176008461
STAT,1875,36,20-24,1911,0.7953576576801255
STAT,1814,42,40-44,1856,7.872066282951105
STAT,1907,17,20-24,1924,25.867644563829543
STAT,1910,41,30-34,1951,0.12016124886413827
SIM,1810,102,na,1912,20
STAT,1882,24,40-44,1906,1.982570538322843
SIM,1814,41,na,1855,2415
STAT,1869,19,30-34,1888,1.611464275418995
STAT,1839,46,50-100,1885,0.23548220644338466
STAT,1827,71,na,1898,941.2901213057081
STAT,1840,50,40-44,1890,0.004204880207979927
STAT,1892,49,50-100,1941,0.16794280707304532
SIM,1825,29,na,1854,612
STAT,1921,20,25-29,1941,103.70806218676665
STAT,1820,53,20-24,1873,0.0010973416444141086
STAT,1902,4,na,1906,3704.43038303956
STAT,1853,28,na,1881,1936.7623629848042
STAT,1804,79,na,1883,550.0887422389503
SIM,1873,52,na,1925,2116
STAT,1842,45,20-24,1887,0.0030567612926943473
STAT,1827,34,15-19,1861,0.14259913018367892
STAT,1881,33,40-44,1914,4.078086080436154
STAT,1922,45,45-49,1967,0.24805790422559404
STAT,1911,15,20-24,1926,26.9489409853898
STAT,1809,54,50-100,1863,0.11972997022366298
STAT,1950,18,na,1968,4309.340631490547
STAT,1886,15,15-19,1901,6.174077651928165
STAT,1829,33,50-100,1862,0.4929108491187169
STAT,1850,36,15-19,1886,0.026615578876612776
STAT,1900,15,45-49,1915,0.09091074510116619
STAT,1875,75,na,1950,1057.105423308593
SIM,1802,56,na,1858,1007
STAT,1969,3,na,1972,4863.524507982843
STAT,1847,31,35-39,1878,10.862582247677185
SIM,1935,7,na,1942,5881
SIM,1835,27,25-29,1862,300
STAT,1894,25,15-19,1919,0.5808689583543099
SIM,1915,17,20-24,1932,32
STAT,1874,22,40-44,1896,2.150629318231262
STAT,1854,51,25-29,1905,0.0019788447193602354
STAT,1937,15,40-44,1952,1.3529095685141257
SIM,1895,2,na,1897,4648
SIM,1888,21,20-24,1909,231
STAT,1903,31,15-19,1934,0.20297539996032044
STAT,1951,18,20-24,1969,159.8900231694768
STAT,1868,25,20-24,1893,11.407940603046828
STAT,1883,46,20-24,1929,0.011577295818649233
STAT,1943,26,20-24,1969,19.227343847168076
SIM,1863,15,na,1878,1516
STAT,1931,29,50-100,1960,1.2747459694532197
STAT,1835,78,na,1913,591.1993899939306
SIM,1901,37,na,1938,3738
SIM,1855,31,35-39,1886,3
STAT,1830,43,35-39,1873,1.5804293372092417
STAT,1891,37,15-19,1928,0.06905487898911754
STAT,1922,27,15-19,1949,0.7899176066553358
SIM,1834,34,na,1868,1046
SIM,1882,29,na,1911,1943
STAT,1848,42,35-39,1890,1.6924272333779395
STAT,1876,52,50-100,1928,0.01518621408932392
STAT,1851,53,20-24,1904,5.734457196593189E-4
STAT,1863,15,50-100,1878,0.04829344535100915
STAT,1848,32,40-44,1880,4.732570017867464
STAT,1908,29,35-39,1937,13.982280085083406
SIM,1910,28,25-29,1938,21
STAT,1923,36,45-49,1959,0.7823000579744613
STAT,1822,52,40-44,1874,0.016964232528912805
SIM,1856,32,40-44,1888,5
STAT,1902,28,25-29,1930,59.35751047232346
STAT,1876,29,na,1905,2395.312526042512
STAT,1899,57,na,1956,2766.646892622682
SIM,1924,39,35-39,1963,3
STAT,1911,35,40-44,1946,1.4431840309970714
SIM,1948,16,20-24,1964,553
STAT,1866,23,na,1889,2160.8607666031576
SIM,1838,48,na,1886,1872
SIM,1856,4,na,1860,1594
STAT,1867,102,na,1969,2.169622450774013
SIM,1876,28,25-29,1904,2
SIM,1912,53,na,1965,4423
STAT,1893,56,na,1949,2550.619076338589
SIM,1789,73,na,1862,215
STAT,1885,25,20-24,1910,11.609655488494628
STAT,1867,40,na,1907,2207.8645259310406
SIM,1883,36,20-24,1919,2
STAT,1902,16,35-39,1918,0.774568194700651
STAT,1861,54,20-24,1915,5.968095147324505E-4
STAT,1925,44,30-34,1969,0.1528552819359097
SIM,1835,19,25-29,1854,104
STAT,1841,23,40-44,1864,2.9184505206654126
STAT,1868,89,na,1957,127.34922052689866
STAT,1816,64,na,1880,1712.043697176996
SIM,1907,38,na,1945,4541
STAT,1864,75,na,1939,935.8903065779305
SIM,1861,67,na,1928,1395
STAT,1918,47,45-49,1965,0.22816291519527046
STAT,1908,47,35-39,1955,0.11569825080687536
STAT,1838,20,30-34,1858,10.008248264285026
SIM,1828,65,na,1893,931
SIM,1893,25,20-24,1918,30
SIM,1895,49,45-49,1944,1
STAT,1943,19,25-29,1962,45.398780832025636
STAT,1894,43,15-19,1937,0.0012106894034486612
STAT,1855,46,45-49,1901,0.15663686946908384
STAT,1923,18,45-49,1941,0.5788887398496566
SIM,1848,32,35-39,1880,67
STAT,1866,30,35-39,1896,9.31848137531723
STAT,1819,38,50-100,1857,0.3007297980938241
SIM,1861,17,25-29,1878,48
STAT,1829,78,na,1907,285.3188526365643
STAT,1922,28,50-100,1950,1.1098143945299104
STAT,1882,84,na,1966,580.6306884916268
STAT,1909,19,25-29,1928,8.366584294708979
STAT,1881,51,40-44,1932,0.00998932983325501
STAT,1853,17,25-29,1870,5.285596400813027
STAT,1929,16,45-49,1945,0.6346045048116006
STAT,1910,33,30-34,1943,14.95796577241812
STAT,1834,35,20-24,1869,0.43143936444504183
STAT,1927,36,30-34,1963,2.2495940435948847
SIM,1865,81,na,1946,254
STAT,1791,105,na,1896,0.007393286286501462
SIM,1901,49,50-100,1950,6
STAT,1879,21,30-34,1900,18.327716165125814
SIM,1887,35,50-100,1922,41
STAT,1915,26,45-49,1941,1.7431961116830448
SIM,1917,19,25-29,1936,14
STAT,1935,27,25-29,1962,89.0760705061397
STAT,1837,26,na,1863,2242.421891616856
STAT,1889,36,45-49,1925,2.412160809104526
SIM,1890,64,na,1954,3139
STAT,1904,29,15-19,1933,0.6435701460015539
SIM,1943,27,25-29,1970,564
STAT,1900,59,na,1959,2780.7710340857084
STAT,1831,37,45-49,1868,2.024673205054629
SIM,1841,47,na,1888,244
SIM,1841,31,35-39,1872,31
STAT,1917,39,25-29,1956,1.0028984252602957
STAT,1892,30,35-39,1922,12.639042250781188
STAT,1873,49,15-19,1922,4.0174451300965434E-4
STAT,1920,36,na,1956,4069.9109624914563
STAT,1812,105,na,1917,0.002322038192107435
STAT,1828,65,na,1893,1143.9866883104157
STAT,1829,53,40-44,1882,0.0041979384650223965
STAT,1860,25,20-24,1885,9.813384475566329
SIM,1895,48,50-100,1943,2
STAT,1816,47,20-24,1863,0.036499579367467436
STAT,1897,35,40-44,1932,5.868763099698817
STAT,1915,16,45-49,1931,0.10332750405202813
STAT,1896,44,40-44,1940,0.20312057477270826
STAT,1824,90,na,1914,15.257519683863272
STAT,1886,43,na,1929,2376.115145320558
SIM,1925,39,25-29,1964,2
SIM,1859,57,na,1916,1535
STAT,1926,46,40-44,1972,0.19334866710786164
STAT,1805,96,na,1901,1.1520112088793844
SIM,1897,36,45-49,1933,7
STAT,1833,31,35-39,1864,5.813478276990633
STAT,1795,109,na,1904,1.7343229911640813E-4
STAT,1827,27,25-29,1854,66.07485339706207
STAT,1863,45,40-44,1908,0.14761265293598502
STAT,1938,26,40-44,1964,4.57033072056573
STAT,1910,15,30-34,1925,2.399244896058708
STAT,1833,23,50-100,1856,0.3258710637519185
STAT,1802,72,na,1874,806.8188637057963
SIM,1899,7,na,1906,2312
STAT,1942,29,35-39,1971,15.56214347313162
SIM,1842,35,20-24,1877,25
STAT,1768,90,na,1858,76.35863633807979
STAT,1894,18,25-29,1912,7.187263512222747
SIM,1928,30,30-34,1958,67
STAT,1820,54,50-100,1874,0.022017803687746067
STAT,1887,48,50-100,1935,0.2669286875249767
SIM,1907,22,na,1929,4782
STAT,1934,37,35-39,1971,3.315202317943788
STAT,1871,36,35-39,1907,7.089506484739861
SIM,1881,44,na,1925,2887
SIM,1919,23,na,1942,5146
STAT,1912,20,50-100,1932,0.6269894529356319
STAT,1876,60,na,1936,1927.9832503341781
SIM,1832,70,na,1902,362
STAT,1887,49,45-49,1936,0.14346629313035536
STAT,1920,37,35-39,1957,2.6141963404043778
SIM,1936,21,25-29,1957,65
STAT,1870,99,na,1969,11.81144224064453
STAT,1934,19,35-39,1953,5.60704989686021
SIM,1951,19,25-29,1970,1
STAT,1852,5,na,1857,3061.2886411055833
STAT,1853,42,15-19,1895,0.01069480251040372
STAT,1833,24,45-49,1857,0.4931977670082234
STAT,1911,23,20-24,1934,103.94646855285762
STAT,1903,36,45-49,1939,0.6137221768503799
STAT,1847,63,na,1910,1613.2197249276533
SIM,1913,22,na,1935,3505
STAT,1853,24,15-19,1877,2.9791692817988507
STAT,1873,21,35-39,1894,6.003988555488398
SIM,1861,24,15-19,1885,8
STAT,1846,46,na,1892,1336.2758339038735
STAT,1932,21,na,1953,4772.509919177342
STAT,1936,31,25-29,1967,8.893547331966445
STAT,1845,54,35-39,1899,0.0041544854942884004
STAT,1889,43,35-39,1932,2.164874887612636
STAT,1849,11,na,1860,2487.2479360796397
STAT,1941,24,45-49,1965,1.1487768291538707
STAT,1840,32,40-44,1872,2.079847429825179
SIM,1894,14,na,1908,1764
STAT,1857,46,na,1903,1731.342705151786
STAT,1928,21,25-29,1949,114.79650676059444
STAT,1924,17,20-24,1941,159.89686895207618
SIM,1824,44,na,1868,2108
SIM,1853,20,45-49,1873,17
SIM,1818,36,50-100,1854,1
STAT,1818,37,25-29,1855,7.3305833688996636
STAT,1907,31,35-39,1938,8.519265708243479
SIM,1868,62,na,1930,502
STAT,1897,21,20-24,1918,91.79567617598761
STAT,1859,112,na,1971,3.8303500180514305E-4
STAT,1883,23,50-100,1906,0.3910997441071284
STAT,1900,28,na,1928,3294.3786803811863
STAT,1826,85,na,1911,218.54986073806833
SIM,1906,31,40-44,1937,116
STAT,1821,42,30-34,1863,1.2951155516341817
SIM,1908,27,35-39,1935,63
SIM,1866,36,20-24,1902,8
STAT,1835,62,na,1897,1382.962120431692
STAT,1896,39,45-49,1935,2.6014228930794676
STAT,1874,58,na,1932,2041.012133743867
STAT,1908,44,30-34,1952,0.115925227843239
STAT,1882,27,45-49,1909,1.0630156003225029
STAT,1864,31,35-39,1895,9.244201906514704
STAT,1838,23,35-39,1861,3.208681587057628
STAT,1853,87,na,1940,136.60858849712537
STAT,1829,48,45-49,1877,0.10775134509142154
STAT,1906,38,15-19,1944,0.01746424962890073
SIM,1828,58,na,1886,1596
STAT,1896,23,50-100,1919,0.535899928465845
STAT,1848,21,25-29,1869,65.6974329428156
STAT,1926,35,35-39,1961,2.9357619924381892
STAT,1893,27,20-24,1920,14.670506193505817
STAT,1923,38,50-100,1961,0.480876057844668
STAT,1903,37,35-39,1940,2.167065510955844
STAT,1844,34,15-19,1878,0.16524259737486352
STAT,1867,32,15-19,1899,0.13467921837511104
STAT,1863,39,50-100,1902,1.0375900392702213
STAT,1914,36,na,1950,3721.9227536373037
STAT,1885,28,25-29,1913,41.4337923929718
STAT,1889,25,40-44,1914,3.6318063154057687
STAT,1851,27,20-24,1878,10.848511347131074
STAT,1779,108,na,1887,0.008114350547780005
STAT,1870,24,15-19,1894,3.2683172320600287
STAT,1800,93,na,1893,20.1647997194884
STAT,1888,78,na,1966,1251.1950752006703
STAT,1871,14,na,1885,2609.9341874978168
STAT,1922,42,40-44,1964,0.2838899993779082
STAT,1904,47,15-19,1951,3.208582595850492E-4
SIM,1881,21,35-39,1902,572
STAT,1843,66,na,1909,1619.4153464634896
SIM,1829,42,50-100,1871,12
SIM,1919,16,na,1935,3584
STAT,1861,46,20-24,1907,0.010008050128984265
STAT,1847,34,50-100,1881,0.8669098170722828
STAT,1875,20,35-39,1895,6.027928420834573
SIM,1832,63,na,1895,729
STAT,1848,45,50-100,1893,0.232117498909051
STAT,1868,24,50-100,1892,0.3914071594788074
STAT,1961,9,na,1970,5030.2082268244785
STAT,1905,22,35-39,1927,8.393290825822838
STAT,1880,65,na,1945,1754.4421088427346
STAT,1884,79,na,1963,908.2212434974188
SIM,1892,28,na,1920,3659
STAT,1855,38,45-49,1893,1.3128181716401925
STAT,1913,17,45-49,1930,0.1008538598523754
SIM,1920,25,30-34,1945,207
STAT,1795,92,na,1887,14.126941714070723
SIM,1942,19,na,1961,3642
STAT,1858,31,na,1889,1841.3618240357341
STAT,1939,17,45-49,1956,0.49453274053006685
STAT,1853,47,25-29,1900,0.04445417026327034
SIM,1877,7,na,1884,365
STAT,1830,54,40-44,1884,0.007608258460566543
SIM,1958,2,na,1960,4201
STAT,1858,32,na,1890,1822.340556393445
STAT,1821,55,na,1876,1144.5714493514524
STAT,1826,105,na,1931,0.023375497065466537
STAT,1852,42,50-100,1894,1.0621024824872098
STAT,1841,26,45-49,1867,1.5467676510291093
STAT,1873,37,50-100,1910,1.259393510169312
STAT,1806,81,na,1887,188.97895234538436
STAT,1895,27,na,1922,3104.5624017519317
SIM,1846,23,35-39,1869,11
STAT,1874,45,50-100,1919,0.2560025771419877
STAT,1880,48,45-49,1928,0.24192596131333247
SIM,1893,28,25-29,1921,24
STAT,1870,39,25-29,1909,2.841478092147022
SIM,1881,43,na,1924,2937
STAT,1855,98,na,1953,2.150003037718005
STAT,1889,22,25-29,1911,68.93659753726675
STAT,1857,18,20-24,1875,15.895434469867146
STAT,1791,71,na,1862,769.9815413452153
STAT,1795,85,na,1880,108.57808489659243
STAT,1913,30,50-100,1943,0.8188073877385896
STAT,1845,40,50-100,1885,0.5476878899883593
STAT,1914,35,na,1949,3739.272980265734
STAT,1923,44,45-49,1967,0.19183544476647627
STAT,1845,20,45-49,1865,0.4358006418612715
STAT,1838,41,35-39,1879,0.9156625043830761
STAT,1857,22,40-44,1879,1.8459934110674792
STAT,1881,25,40-44,1906,2.848045950724857
STAT,1932,28,15-19,1960,0.9177782427040564
STAT,1820,45,20-24,1865,0.01936501722400454
STAT,1930,37,15-19,1967,0.024872321110556237
STAT,1785,71,na,1856,260.255082186
STAT,1789,85,na,1874,150.86814077635105
SIM,1915,31,35-39,1946,13
STAT,1861,39,30-34,1900,4.387696640101084
STAT,1825,37,20-24,1862,1.1095115850934685
STAT,1818,44,15-19,1862,0.025461745287764095
STAT,1928,28,50-100,1956,1.2163529451670283
SIM,1822,64,na,1886,516
SIM,1879,31,20-24,1910,20
STAT,1866,39,na,1905,2128.935419757099
STAT,1909,16,20-24,1925,26.380873858593244
STAT,1908,26,30-34,1934,37.19300694834803
SIM,1801,71,na,1872,1783
STAT,1849,46,20-24,1895,0.010139810229132372
STAT,1852,112,na,1964,1.4604096634623708E-4
STAT,1912,25,30-34,1937,38.423214055734036
SIM,1939,29,25-29,1968,597
STAT,1824,99,na,1923,0.36650818881764313
STAT,1862,43,30-34,1905,0.9721459346059809
SIM,1853,32,na,1885,3271
SIM,1829,41,35-39,1870,13
STAT,1832,25,45-49,1857,1.3884742950767248
STAT,1885,35,15-19,1920,0.055721303970521115
STAT,1878,79,na,1957,796.3302793753975
STAT,1911,24,35-39,1935,8.77415102304472
STAT,1866,16,20-24,1882,16.708883958360627
STAT,1921,39,15-19,1960,0.021142771058596053
SIM,1936,19,na,1955,3845
STAT,1888,32,35-39,1920,11.688291998303677
STAT,1896,47,50-100,1943,0.18177447128260166
STAT,1916,19,15-19,1935,9.446465889587666
STAT,1868,35,15-19,1903,0.054753160130374075
STAT,1849,16,20-24,1865,18.49633178509546
STAT,1876,5,na,1881,2766.06461785788
STAT,1874,65,na,1939,1744.153717267939
STAT,1836,84,na,1920,254.59944335399047
STAT,1825,35,50-100,1860,1.8605944682475508
STAT,1911,21,30-34,1932,27.032400136591498
STAT,1920,33,40-44,1953,4.213463207370929
STAT,1860,7,na,1867,2328.7722335908434
SIM,1896,32,35-39,1928,16
SIM,1857,16,20-24,1873,57
STAT,1932,23,40-44,1955,4.367478493169605
STAT,1846,15,40-44,1861,0.13769703385852886
SIM,1871,34,35-39,1905,1
SIM,1880,46,45-49,1926,5
STAT,1897,38,45-49,1935,2.6343225149805165
STAT,1872,46,45-49,1918,0.23699182286351
SIM,1853,25,na,1878,3434
STAT,1866,40,50-100,1906,0.9740796842124781
STAT,1911,26,25-29,1937,63.68361103095
SIM,1840,89,na,1929,327
STAT,1897,30,35-39,1927,13.557376798119494
STAT,1916,25,15-19,1941,0.7248590090298918
STAT,1934,34,30-34,1968,21.337931472209277
STAT,1925,26,30-34,1951,46.0131039975439
STAT,1886,19,30-34,1905,1.6416801997698696
STAT,1843,28,25-29,1871,51.06774949627304
STAT,1887,21,50-100,1908,0.45019906896743644
STAT,1822,40,25-29,1862,1.1977556854498785
SIM,1821,43,35-39,1864,19
STAT,1906,15,40-44,1921,0.26608724813309176
STAT,1852,10,na,1862,2942.7081369387456
STAT,1856,20,20-24,1876,58.32019339487452
STAT,1924,21,40-44,1945,3.9412847021652446
SIM,1827,28,30-34,1855,30
SIM,1866,43,50-100,1909,6
STAT,1934,16,30-34,1950,16.41517797611365
STAT,1851,52,na,1903,1691.502921054025
STAT,1852,29,25-29,1881,44.48550515429441
STAT,1880,34,35-39,1914,10.423446630498097
SIM,1862,77,na,1939,1477
STAT,1802,54,15-19,1856,1.198217103858388E-4
STAT,1838,35,50-100,1873,0.6456772587728741
STAT,1930,19,15-19,1949,57.949091218513
STAT,1879,24,35-39,1903,5.948792882901906
SIM,1851,28,25-29,1879,121
STAT,1838,32,50-100,1870,0.4860161407434203
STAT,1935,24,20-24,1959,150.22764981236284
STAT,1877,33,15-19,1910,0.14395088033222805
STAT,1902,45,40-44,1947,0.1373432789687132
STAT,1873,80,na,1953,634.5434701441764
STAT,1926,17,35-39,1943,5.100572844054644
STAT,1877,94,na,1971,96.3438714624453
STAT,1818,99,na,1917,1.1527140465590329
STAT,1863,105,na,1968,0.22171319908143494
STAT,1824,48,50-100,1872,0.04214985202789223
STAT,1813,43,35-39,1856,8.134586835874867
STAT,1898,23,40-44,1921,2.7934741505067366
STAT,1947,19,45-49,1966,0.5564140173312672
STAT,1840,24,40-44,1864,1.028513645147918
STAT,1804,86,na,1890,140.58083778700257
SIM,1928,33,35-39,1961,2
STAT,1915,23,40-44,1938,3.415946174423242
SIM,1889,30,30-34,1919,1
STAT,1820,38,na,1858,1939.9454996253376
STAT,1879,42,35-39,1921,1.855317909019978
STAT,1863,41,25-29,1904,0.5506979089759503
STAT,1884,29,25-29,1913,40.204564490610395
STAT,1912,30,25-29,1942,9.061294695679537
STAT,1878,50,20-24,1928,7.701328992222097E-4
STAT,1916,18,25-29,1934,9.045026994177372
STAT,1925,19,40-44,1944,1.6652048840134897
STAT,1796,108,na,1904,7.173391777840027E-4
STAT,1826,36,20-24,1862,1.2925335565756824
STAT,1813,50,25-29,1863,0.012820129049968657
STAT,1882,39,50-100,1921,1.163623101056967
STAT,1942,15,15-19,1957,46.91040518551471
SIM,1838,21,35-39,1859,177
STAT,1912,49,15-19,1961,3.4785746422693855E-4
SIM,1887,42,35-39,1929,19
STAT,1836,32,15-19,1868,0.1379339414402426
STAT,1859,45,15-19,1904,3.2019750096712454E-4
STAT,1883,15,45-49,1898,0.0631350494717412
SIM,1892,29,25-29,1921,15
STAT,1867,37,20-24,1904,0.7290149667731733
SIM,1939,31,na,1970,4673
SIM,1902,54,na,1956,2948
STAT,1898,30,30-34,1928,23.66709772608677
SIM,1857,0,na,1857,2189
STAT,1880,41,25-29,1921,0.6696746538908908
STAT,1817,38,25-29,1855,2.2259664287400387
STAT,1886,50,na,1936,2261.816917078651
STAT,1905,15,45-49,1920,0.09439122761757661
STAT,1869,75,na,1944,1038.8115311584502
STAT,1927,41,50-100,1968,0.1463476491040954
STAT,1831,45,45-49,1876,0.22835223098856083
STAT,1907,54,na,1961,3166.2887485560605
STAT,1917,27,35-39,1944,15.534792870253595
STAT,1939,28,20-24,1967,18.140310197548153
STAT,1898,19,20-24,1917,23.712005669580673
STAT,1867,42,50-100,1909,0.9978882317742023
STAT,1812,46,25-29,1858,0.015165143662339295
STAT,1881,1,na,1882,3192.6410588791186
SIM,1903,30,25-29,1933,4
STAT,1911,33,15-19,1944,0.12320145177561702
SIM,1903,35,35-39,1938,15
SIM,1868,61,na,1929,573
SIM,1874,62,na,1936,2153
STAT,1877,54,30-34,1931,0.005876387860053775
STAT,1865,46,50-100,1911,0.22486723832062608
STAT,1906,33,40-44,1939,3.5906875643396363
SIM,1839,28,20-24,1867,22
STAT,1951,16,30-34,1967,14.383413483370273
STAT,1887,16,40-44,1903,0.20181092920751245
STAT,1894,78,na,1972,1482.235977132903
STAT,1871,13,na,1884,2621.837328971347
STAT,1834,34,50-100,1868,0.5066101818714364
STAT,1880,50,50-100,1930,0.01590430026687745
SIM,1869,47,na,1916,3595
STAT,1896,36,40-44,1932,5.798323502773196
SIM,1822,49,na,1871,1485
STAT,1931,36,20-24,1967,0.34697854889373814
STAT,1833,67,na,1900,652.2175852293708
STAT,1926,42,25-29,1968,0.08727820937971399
SIM,1890,57,na,1947,3139
STAT,1845,18,30-34,1863,0.9937471936862056
STAT,1826,31,15-19,1857,0.3061135580500119
STAT,1939,32,40-44,1971,3.9489560760348166
SIM,1925,27,35-39,1952,9
SIM,1887,28,na,1915,3785
STAT,1839,34,40-44,1873,4.856359146718144
STAT,1924,31,35-39,1955,10.565239948080576
STAT,1867,50,45-49,1917,0.01392205776823685
STAT,1833,45,50-100,1878,0.12654602459522976
STAT,1861,49,25-29,1910,0.04690246345269595
SIM,1906,34,45-49,1940,1
SIM,1929,29,45-49,1958,2
STAT,1857,50,35-39,1907,0.006701194642941142
STAT,1847,30,20-24,1877,2.929641745436759
SIM,1890,36,50-100,1926,1
STAT,1941,1,na,1942,4228.043807504335
STAT,1790,106,na,1896,0.0035304454726330335
STAT,1865,21,25-29,1886,53.282623386479294
STAT,1867,79,na,1946,661.1648532505851
STAT,1899,37,20-24,1936,0.2272543116131892
STAT,1849,49,25-29,1898,0.04751995369325964
STAT,1858,24,15-19,1882,2.5928041101751047
STAT,1893,42,50-100,1935,1.3194959560385937
STAT,1887,19,45-49,1906,0.07151315166404572
STAT,1847,36,45-49,1883,1.8895321303308794
STAT,1826,39,25-29,1865,4.475252215844463
STAT,1879,64,na,1943,1783.2773223706902
STAT,1946,23,35-39,1969,10.361460643684135
STAT,1893,22,15-19,1915,4.125521321628565
STAT,1916,15,20-24,1931,28.503795535996144
STAT,1921,43,35-39,1964,0.2237606427301264
STAT,1871,33,30-34,1904,17.34333082992291
SIM,1815,67,na,1882,482
STAT,1964,6,na,1970,4902.823397456916
STAT,1835,99,na,1934,1.4330041778500753
STAT,1863,7,na,1870,2411.1845026516266
STAT,1923,38,15-19,1961,0.021994333907921153
STAT,1831,85,na,1916,214.551323430766
STAT,1857,25,45-49,1882,0.8903162110246462
STAT,1856,37,45-49,1893,1.431828912891196
STAT,1860,66,na,1926,1337.091640887466
STAT,1865,13,na,1878,2456.885249021539
SIM,1919,21,25-29,1940,1
STAT,1837,33,na,1870,2156.2849878452134
STAT,1879,17,45-49,1896,0.06701042824582952
STAT,1852,21,15-19,1873,3.9734340991753023
STAT,1921,25,35-39,1946,16.646462910788784
STAT,1888,37,45-49,1925,2.3008099966066062
STAT,1929,20,30-34,1949,36.30627283898469
STAT,1818,66,na,1884,1078.5505147025265
STAT,1946,2,na,1948,4429.458146521945
STAT,1935,34,na,1969,5188.0948031129465
STAT,1891,17,45-49,1908,0.08032896227023717
STAT,1840,47,15-19,1887,1.5882789970786344E-4
STAT,1924,35,50-100,1959,0.4911775097411433
SIM,1891,40,35-39,1931,8
STAT,1837,19,35-39,1856,0.5794966594624242
STAT,1865,24,40-44,1889,1.8980726310808569
STAT,1926,37,25-29,1963,1.1930036157222346
STAT,1894,48,25-29,1942,0.040798549115387404
STAT,1872,94,na,1966,68.9345034492658
STAT,1881,28,45-49,1909,1.0448215092157127
STAT,1908,19,40-44,1927,0.26777537460984174
STAT,1898,26,45-49,1924,1.498166986239323
STAT,1905,46,20-24,1951,0.009763633436966937
SIM,1845,33,na,1878,2518
STAT,1825,48,na,1873,1567.106778994758
SIM,1871,29,na,1900,1878
STAT,1909,34,20-24,1943,2.28420733866693
SIM,1932,31,35-39,1963,2
STAT,1918,48,35-39,1966,0.13497460663199695
STAT,1878,17,30-34,1895,1.6398832313341074
SIM,1860,11,na,1871,2608
STAT,1850,51,40-44,1901,0.00488452420714258
STAT,1911,31,25-29,1942,8.935124641936213
STAT,1859,38,25-29,1897,2.27071155724413
STAT,1881,48,15-19,1929,3.729924872842704E-4
STAT,1913,37,15-19,1950,0.01871324538019379
STAT,1849,98,na,1947,2.7371944217714517
STAT,1836,53,30-34,1889,0.004524693358038045
STAT,1857,32,35-39,1889,7.819096931140175
STAT,1860,28,25-29,1888,34.62849201177753
STAT,1846,53,40-44,1899,0.006135003326483675
STAT,1943,17,35-39,1960,4.3989093434629
SIM,1864,47,na,1911,2415
SIM,1899,6,na,1905,2347
STAT,1873,20,20-24,1893,71.11080309563478
STAT,1907,21,40-44,1928,3.0496584111098874
STAT,1874,18,20-24,1892,18.24908536045083
STAT,1847,32,na,1879,2300.643738089642
SIM,1813,56,na,1869,35
SIM,1865,32,35-39,1897,289
STAT,1893,40,45-49,1933,1.8904751976495175
STAT,1864,36,50-100,1900,1.1215205821958636
STAT,1923,41,40-44,1964,0.28968593904694734
STAT,1954,18,45-49,1972,0.6118945910111195
SIM,1880,58,na,1938,3193
STAT,1870,36,20-24,1906,0.7721835548235543
SIM,1897,27,na,1924,2853
STAT,1839,31,25-29,1870,11.832838689116919
STAT,1883,40,35-39,1923,1.7596593026872842
SIM,1845,19,35-39,1864,1
SIM,1898,31,35-39,1929,1
STAT,1911,29,40-44,1940,4.462193013858317
STAT,1862,22,15-19,1884,2.8764777586500627
SIM,1847,31,25-29,1878,4
STAT,1926,44,15-19,1970,0.0018707058080954585
STAT,1831,48,na,1879,1864.1220191632049
STAT,1892,28,20-24,1920,14.473510748548957
SIM,1940,24,na,1964,2399
STAT,1846,18,45-49,1864,0.04831364186973062
STAT,1849,30,35-39,1879,10.088265132988466
STAT,1947,16,40-44,1963,1.559440628822237
SIM,1917,16,20-24,1933,155
SIM,1835,44,na,1879,1244
STAT,1946,16,45-49,1962,0.5482286670490818
STAT,1836,41,50-100,1877,0.975461883957409
STAT,1913,57,na,1970,3385.333447735412
STAT,1926,19,25-29,1945,52.3930714795868
STAT,1852,26,20-24,1878,13.853591349622356
STAT,1958,1,na,1959,5125.912541921809
SIM,1814,45,na,1859,2441
STAT,1906,18,45-49,1924,0.09434382021173002
STAT,1860,14,na,1874,2225.731557446559
SIM,1879,46,na,1925,1107
STAT,1822,49,20-24,1871,0.01951737807906546
STAT,1830,63,na,1893,1291.4300360543054
SIM,1844,11,na,1855,3028
STAT,1873,26,45-49,1899,1.142834814054383
STAT,1864,28,na,1892,2161.9659550273054
STAT,1828,104,na,1932,0.04515127308874245
STAT,1862,46,35-39,1908,0.11958229871397877
STAT,1951,19,35-39,1970,4.946964247458212
SIM,1931,2,na,1933,5411
STAT,1852,47,na,1899,2254.104590427232
STAT,1870,17,25-29,1887,5.703165073213426
SIM,1914,3,na,1917,5181
STAT,1927,41,25-29,1968,0.08895641472048355
SIM,1896,42,na,1938,3239
STAT,1827,29,50-100,1856,0.6908497722237217
STAT,1833,28,15-19,1861,0.27126638689582366
STAT,1854,44,35-39,1898,0.9932539649857898
STAT,1892,46,na,1938,2793.941946889423
SIM,1859,17,20-24,1876,150
SIM,1901,33,30-34,1934,196
SIM,1879,61,na,1940,798
STAT,1918,40,25-29,1958,0.07510756427215998
STAT,1928,28,45-49,1956,2.1112029730540263
STAT,1846,47,na,1893,1326.2804906662725
STAT,1838,16,45-49,1854,0.03705107654357467
SIM,1827,48,na,1875,1988
STAT,1835,54,50-100,1889,0.01119323806507681
SIM,1858,47,na,1905,2325
STAT,1925,29,35-39,1954,17.444927311708376
STAT,1871,30,15-19,1901,0.1431997490902968
STAT,1820,48,25-29,1868,0.08931282286739113
STAT,1882,13,na,1895,2468.688323946748
STAT,1933,34,50-100,1967,1.1052215947085702
SIM,1865,10,na,1875,1988
STAT,1884,26,20-24,1910,11.268733572451344
SIM,1902,23,20-24,1925,664
SIM,1910,58,na,1968,3426
STAT,1880,45,40-44,1925,0.17950395426168037
STAT,1844,27,25-29,1871,51.30191317941301
STAT,1898,33,35-39,1931,13.56056763009879
STAT,1884,43,50-100,1927,1.0040067371494714
STAT,1866,38,20-24,1904,0.7001552099903833
SIM,1924,15,20-24,1939,22
STAT,1906,36,45-49,1942,0.6260700971182056
STAT,1883,79,na,1962,889.5986311120537
STAT,1910,24,50-100,1934,0.6071813377197565
SIM,1859,10,na,1869,2403
SIM,1927,42,na,1969,1555
STAT,1817,81,na,1898,171.30847817637473
STAT,1836,36,30-34,1872,5.06512606617696
STAT,1908,23,15-19,1931,4.840903207550471
STAT,1886,21,45-49,1907,0.7242915418953623
STAT,1919,43,40-44,1962,0.2670330232764599
STAT,1836,28,50-100,1864,0.6297240087728256
STAT,1878,24,na,1902,2418.09270094279
STAT,1890,49,15-19,1939,2.674498687731842E-4
STAT,1828,54,35-39,1882,0.008680731919027464
STAT,1919,3,na,1922,4422.756898443819
STAT,1840,27,45-49,1867,0.5451083113083273
STAT,1813,54,40-44,1867,0.0351379392994439
STAT,1894,42,na,1936,2945.6271091664507
STAT,1874,29,15-19,1903,0.46490451859626564
STAT,1843,25,20-24,1868,14.472113308843776
STAT,1930,22,40-44,1952,4.277159941839248
STAT,1861,51,na,1912,1799.2344059388026
STAT,1924,24,45-49,1948,1.3067019242804885
STAT,1895,45,35-39,1940,0.10375625257270002
STAT,1918,46,30-34,1964,0.09381813597587872
STAT,1874,47,45-49,1921,0.24243217161468722
STAT,1920,36,45-49,1956,0.7374763506151754
STAT,1821,45,35-39,1866,0.15380046044744447
STAT,1936,36,35-39,1972,2.353111785294901
SIM,1909,61,na,1970,3677
STAT,1870,28,na,1898,2370.829289616019
STAT,1855,51,na,1906,1431.8632069854289
SIM,1909,17,na,1926,4248
STAT,1885,17,50-100,1902,0.04815653578204043
STAT,1829,99,na,1928,0.6915824250965218
STAT,1925,42,na,1967,4455.280575173828
SIM,1826,30,na,1856,1888
SIM,1942,20,na,1962,2300
STAT,1819,35,50-100,1854,0.9295914872844874
STAT,1926,32,30-34,1958,18.887387377254292
SIM,1857,62,na,1919,1115
STAT,1908,49,25-29,1957,0.047322553283005026
STAT,1950,21,35-39,1971,11.067540906026084
STAT,1866,19,25-29,1885,5.246992106540029
STAT,1926,20,na,1946,4424.70719453086
SIM,1833,48,na,1881,2017
STAT,1896,40,25-29,1936,0.059376521697488895
SIM,1909,54,na,1963,3730
SIM,1844,27,na,1871,2978
STAT,1921,40,30-34,1961,0.14268325235479315
SIM,1882,66,na,1948,1084
STAT,1843,31,15-19,1874,0.17092021743901847
STAT,1884,50,45-49,1934,0.014091972051547608
STAT,1809,85,na,1894,266.8358921832636
STAT,1840,30,35-39,1870,4.958762121195861
SIM,1895,45,50-100,1940,3
SIM,1809,48,30-34,1857,1
STAT,1936,30,50-100,1966,0.7960043333779401
STAT,1927,38,35-39,1965,2.979723304544665
STAT,1914,18,50-100,1932,0.0762223448859905
STAT,1938,24,50-100,1962,0.6438080179789003
SIM,1881,20,20-24,1901,712
STAT,1863,34,35-39,1897,8.571580588255252
SIM,1876,39,30-34,1915,3
STAT,1823,84,na,1907,262.79626549068297
STAT,1946,8,na,1954,4319.598719236085
SIM,1880,65,na,1945,3193
STAT,1868,39,30-34,1907,5.095874717107302
STAT,1940,25,na,1965,3780.4816135451406
SIM,1926,36,na,1962,5894
STAT,1811,53,30-34,1864,0.02624851591037872
STAT,1868,96,na,1964,26.430069884136955
STAT,1911,46,45-49,1957,0.2039428713564965
SIM,1852,46,na,1898,1950
SIM,1855,33,40-44,1888,25
STAT,1877,7,na,1884,2726.23797956421
SIM,1844,36,30-34,1880,17
STAT,1921,42,na,1963,4133.485030077191
STAT,1824,53,40-44,1877,0.0017406047484266902
STAT,1883,63,na,1946,1716.5777600610215
STAT,1853,44,20-24,1897,0.12147964647822629
STAT,1884,11,na,1895,2475.853722851512
STAT,1875,44,na,1919,2341.26657235048
STAT,1857,37,15-19,1894,0.04309084443460218
STAT,1927,45,40-44,1972,0.19721849666568364
STAT,1820,51,30-34,1871,0.00921013283111482
STAT,1913,32,35-39,1945,8.977936889719274
STAT,1819,39,35-39,1858,1.6119919254936275
STAT,1847,25,na,1872,2384.9562989642054
STAT,1888,34,40-44,1922,4.962427554262756
STAT,1856,31,25-29,1887,7.524587536306514
STAT,1887,42,25-29,1929,0.7059348371985998
STAT,1854,76,na,1930,526.7731810926487
STAT,1859,10,na,1869,2223.85806681774
STAT,1920,19,40-44,1939,1.540788760781681
SIM,1870,34,20-24,1904,4
STAT,1910,48,50-100,1958,0.20808478614490233
STAT,1900,16,20-24,1916,24.6193936463425
STAT,1901,45,20-24,1946,0.00955887523952793
STAT,1899,15,50-100,1914,0.06722730811088248
SIM,1830,30,30-34,1860,4
STAT,1786,87,na,1873,108.70920635047199
STAT,1864,30,20-24,1894,2.4771199993117725
STAT,1855,34,50-100,1889,0.6047545857294764
STAT,1856,61,na,1917,1342.154142127281
SIM,1852,6,na,1858,2713
SIM,1922,36,na,1958,3332
STAT,1950,18,25-29,1968,50.73575982067577
STAT,1871,78,na,1949,779.413461948369
STAT,1895,37,35-39,1932,9.200968881812962
STAT,1896,42,35-39,1938,0.1655587184550587
STAT,1901,38,na,1939,3303.688450562778
STAT,1904,25,35-39,1929,13.878909412707486
STAT,1941,18,15-19,1959,46.19940145845783
STAT,1879,50,35-39,1929,0.00895842852797475
STAT,1894,45,20-24,1939,0.00869367277196328
SIM,1835,38,30-34,1873,2
STAT,1837,70,na,1907,1125.0320587254996
STAT,1803,54,35-39,1857,0.01800269288422502
SIM,1844,17,na,1861,3028
STAT,1831,23,35-39,1854,14.653498348846055
STAT,1942,23,15-19,1965,5.515738988766596
STAT,1828,46,35-39,1874,0.16937890496088337
STAT,1917,16,30-34,1933,2.59427123451495
STAT,1833,51,40-44,1884,0.00474318928412266
STAT,1899,43,15-19,1942,0.0013003813597738056
STAT,1853,30,45-49,1883,1.4216436263900984
STAT,1843,17,50-100,1860,0.06185975192771388
STAT,1867,18,30-34,1885,1.5319082157635822
SIM,1899,0,na,1899,2393
STAT,1847,15,25-29,1862,6.4704873088039445
SIM,1823,49,50-100,1872,2
STAT,1870,45,35-39,1915,0.14096209806399268
STAT,1860,53,25-29,1913,0.002843151609186854
STAT,1856,77,na,1933,620.852731911293
STAT,1847,33,40-44,1880,4.55607936354236
SIM,1821,54,na,1875,1822
STAT,1900,40,50-100,1940,0.10265302629108171
STAT,1845,43,30-34,1888,0.5735400731929959
STAT,1850,43,40-44,1893,1.0311265178732536
STAT,1798,72,na,1870,835.4319748523969
SIM,1856,12,na,1868,1237
STAT,1838,49,50-100,1887,0.10513220588782067
SIM,1814,72,na,1886,871
SIM,1814,82,na,1896,16
STAT,1816,54,45-49,1870,0.04081044907920608
STAT,1907,35,15-19,1942,0.01785289403719555
STAT,1863,59,na,1922,1659.1592397515876
STAT,1868,29,50-100,1897,0.6134442733902334
STAT,1834,52,na,1886,972.9557584010829
STAT,1878,42,30-34,1920,1.1814019796413104
STAT,1925,40,15-19,1965,0.0018473427435031736
STAT,1863,49,na,1912,1880.6136321598929
SIM,1864,31,na,1895,2406
STAT,1827,54,20-24,1881,5.711797149947213E-4
STAT,1859,51,50-100,1910,0.012027601234053123
STAT,1960,7,na,1967,5073.044703277988
STAT,1852,54,30-34,1906,0.005826994890290445
STAT,1845,29,35-39,1874,5.7444177377005525
STAT,1831,30,25-29,1861,11.224105226173775
STAT,1864,96,na,1960,15.543917372993963
STAT,1895,64,na,1959,2359.4371024283146
STAT,1932,27,20-24,1959,23.742519351788648
STAT,1881,16,50-100,1897,0.04637899973060142
STAT,1811,44,15-19,1855,0.06784229533173555
STAT,1912,24,30-34,1936,28.19300538260258
SIM,1882,50,na,1932,1573
STAT,1869,44,30-34,1913,1.1444500869749727
SIM,1861,29,na,1890,1858
STAT,1920,35,30-34,1955,1.9732577930649626
STAT,1918,16,50-100,1934,0.08090948114999078
SIM,1874,45,45-49,1919,1
STAT,1903,35,30-34,1938,1.6484322176540693
SIM,1917,53,na,1970,1988
STAT,1866,45,45-49,1911,0.21757291366587622
STAT,1862,26,30-34,1888,21.683211609218496
STAT,1865,54,40-44,1919,0.009347335925670261
SIM,1898,20,30-34,1918,82
SIM,1872,1,na,1873,3761
STAT,1897,32,25-29,1929,13.602710544141406
STAT,1850,52,na,1902,988.9573818255004
SIM,1827,53,30-34,1880,2
SIM,1846,12,na,1858,1516
STAT,1788,72,na,1860,215.94415425182908
SIM,1822,40,35-39,1862,5
STAT,1872,31,25-29,1903,10.298444774830784
STAT,1924,28,25-29,1952,75.63345502725187
SIM,1874,31,na,1905,2515
STAT,1840,54,35-39,1894,0.0032966377857951696
SIM,1845,41,30-34,1886,15
STAT,1881,44,na,1925,2153.152911230748
STAT,1909,17,35-39,1926,0.8145041213648516
STAT,1904,27,45-49,1931,1.5862855563867408
STAT,1848,54,40-44,1902,0.009580596578446936
STAT,1823,54,35-39,1877,0.012421764351400062
STAT,1890,11,na,1901,3131.0696086992657
STAT,1907,33,50-100,1940,0.7644034116164156
SIM,1869,19,na,1888,3713
SIM,1806,53,na,1859,129
SIM,1870,65,na,1935,364
SIM,1898,27,15-19,1925,2
STAT,1818,101,na,1919,0.34731362901115254
STAT,1849,15,45-49,1864,0.06855533130733026
STAT,1889,21,25-29,1910,69.14472315396019
STAT,1827,38,30-34,1865,5.191229718636897
SIM,1879,47,50-100,1926,3
STAT,1835,49,30-34,1884,0.07524825369893505
SIM,1823,59,na,1882,919
STAT,1908,40,15-19,1948,0.0014257916185670763
SIM,1901,44,na,1945,3324
STAT,1915,28,15-19,1943,0.7073863116491359
SIM,1915,28,25-29,1943,4
STAT,1855,35,40-44,1890,2.9247059912073894
STAT,1866,61,na,1927,1705.7255211386735
STAT,1814,40,35-39,1854,7.327659326127832
STAT,1870,42,15-19,1912,0.013750526660791906
STAT,1888,31,20-24,1919,3.1325216501267055
STAT,1870,28,30-34,1898,25.016301741416726
STAT,1922,46,20-24,1968,0.012585239270355169
STAT,1819,53,30-34,1872,0.0010283482116644534
STAT,1829,51,35-39,1880,0.003924910910276796
SIM,1862,46,na,1908,3490
STAT,1881,78,na,1959,872.4490921653412
STAT,1890,45,35-39,1935,0.1711747106164392
SIM,1851,40,50-100,1891,6
SIM,1869,40,na,1909,3589
STAT,1881,31,35-39,1912,9.602554554540713
STAT,1899,20,40-44,1919,2.8631884242713435
STAT,1928,43,35-39,1971,0.2543511468115187
SIM,1808,72,na,1880,1101
STAT,1886,44,30-34,1930,1.1744690116018888
STAT,1907,28,25-29,1935,61.50460951468544
STAT,1919,46,45-49,1965,0.2331813562926491
STAT,1894,29,30-34,1923,31.793905004241388
STAT,1857,25,na,1882,1913.675901485023
SIM,1852,38,30-34,1890,6
STAT,1799,105,na,1904,0.0019497870439837037
STAT,1838,40,20-24,1878,0.08134143619598802
STAT,1933,18,25-29,1951,57.465714837906326
STAT,1822,67,na,1889,914.7141242403227
SIM,1882,60,na,1942,1327
STAT,1857,46,50-100,1903,0.18899904940828857
STAT,1891,44,40-44,1935,2.7286633689584714
STAT,1869,22,20-24,1891,69.53834912473162
SIM,1880,31,na,1911,3291
STAT,1837,41,30-34,1878,1.1017969927158342
STAT,1875,0,na,1875,3769.8971731643483
SIM,1909,24,na,1933,3541
STAT,1870,42,30-34,1912,1.1447312633733713
STAT,1854,23,50-100,1877,0.26449715248386246
STAT,1880,23,30-34,1903,18.434761062490963
SIM,1842,34,50-100,1876,9
STAT,1848,20,25-29,1868,66.17255186520781
STAT,1944,1,na,1945,4399.361859809864
SIM,1941,18,25-29,1959,139
STAT,1811,49,45-49,1860,1.0742282196297732
STAT,1841,20,25-29,1861,81.92663305836648
SIM,1900,25,na,1925,4149
STAT,1938,15,na,1953,3608.664295775874
STAT,1913,25,45-49,1938,1.7113418648681389
SIM,1873,14,na,1887,2414
STAT,1844,38,30-34,1882,5.521823491311325
STAT,1851,33,15-19,1884,0.11585446981122735
STAT,1803,53,50-100,1856,0.032279286942226385
STAT,1915,42,na,1957,3686.2641375898716
SIM,1870,0,na,1870,4030
STAT,1810,86,na,1896,6.908020432301103
STAT,1933,25,15-19,1958,0.9318097274862435
SIM,1842,15,15-19,1857,80
SIM,1932,20,na,1952,5652
STAT,1912,17,40-44,1929,0.27955074057507795
SIM,1861,28,30-34,1889,1
STAT,1913,23,na,1936,3630.0762745742327
STAT,1875,34,na,1909,2429.4095600047867
STAT,1854,36,35-39,1890,3.951597530835917
STAT,1807,53,40-44,1860,0.03287283644146113
STAT,1853,28,30-34,1881,20.436153664059976
SIM,1902,45,30-34,1947,1
STAT,1890,21,35-39,1911,7.085802848370459
STAT,1912,18,50-100,1930,0.07468345977673117
SIM,1882,44,40-44,1926,5
STAT,1829,45,40-44,1874,0.08127045286642713
STAT,1874,44,40-44,1918,2.290067697493003
STAT,1930,25,45-49,1955,2.183208868174308
SIM,1856,20,25-29,1876,20
STAT,1873,23,40-44,1896,2.130923682528745
STAT,1807,50,na,1857,1386.4695280973021
STAT,1830,32,30-34,1862,16.39999796669275
SIM,1938,21,na,1959,4231
STAT,1861,52,30-34,1913,0.004924042363712442
SIM,1905,24,na,1929,3604
STAT,1858,22,45-49,1880,0.6109911275100491
STAT,1817,101,na,1918,0.18076752118866837
SIM,1897,9,na,1906,3016
STAT,1863,31,30-34,1894,14.96648903027901
STAT,1848,42,na,1890,2160.136595642384
STAT,1905,58,na,1963,3007.2492995567486
SIM,1891,33,na,1924,2319
STAT,1822,33,35-39,1855,23.48699331899584
STAT,1875,42,50-100,1917,1.0834843793444355
SIM,1849,7,na,1856,2894
STAT,1941,17,20-24,1958,138.05758007244307
STAT,1877,26,50-100,1903,0.6515932088797319
STAT,1893,48,40-44,1941,0.11924737981405967
STAT,1805,55,na,1860,438.1536000227722
STAT,1903,57,na,1960,2956.519478485489
STAT,1864,33,25-29,1897,9.27231958641416
STAT,1882,50,25-29,1932,0.00343989186534718
STAT,1850,46,45-49,1896,0.10928515402782417
STAT,1883,27,15-19,1910,0.4364814412712094
STAT,1931,20,35-39,1951,12.198762504139875
STAT,1848,21,50-100,1869,0.4679971492056066
STAT,1900,19,25-29,1919,7.807938180169565
STAT,1839,49,15-19,1888,3.6906017355487793E-4
STAT,1907,23,na,1930,3440.1719225470033
STAT,1919,36,35-39,1955,2.5663091627392287
STAT,1837,36,35-39,1873,6.976936347276611
SIM,1879,40,na,1919,1221
SIM,1810,52,na,1862,3098
SIM,1898,37,na,1935,4190
STAT,1803,51,30-34,1854,0.013290746952944892
STAT,1840,52,na,1892,843.3062913606456
SIM,1831,30,35-39,1861,190
STAT,1933,33,15-19,1966,0.1718944875170728
SIM,1913,8,na,1921,3719
SIM,1815,85,na,1900,339
STAT,1836,39,35-39,1875,6.515796425520646
STAT,1849,26,15-19,1875,0.45644152573035734
SIM,1819,44,na,1863,1864
STAT,1836,30,45-49,1866,1.7244838945301497
STAT,1900,17,15-19,1917,8.221046681904138
STAT,1820,38,30-34,1858,9.442098327320293
STAT,1930,17,45-49,1947,0.6412936059694341
STAT,1845,46,35-39,1891,0.06966762100905143
SIM,1944,21,na,1965,2509
SIM,1851,4,na,1855,1504
SIM,1844,39,35-39,1883,17
STAT,1925,23,15-19,1948,6.294003429916657
STAT,1945,26,35-39,1971,16.29678982974669
STAT,1798,68,na,1866,1087.9916285554589
STAT,1856,53,35-39,1909,0.006084204843563422
STAT,1825,43,15-19,1868,0.01806822460503614
SIM,1915,5,na,1920,3823
STAT,1836,57,na,1893,1538.0449226356243
SIM,1854,17,na,1871,2181
STAT,1813,84,na,1897,243.68445266786196
SIM,1933,9,na,1942,4542
SIM,1799,56,na,1855,1587
STAT,1917,6,na,1923,4241.6016994847705
STAT,1878,37,35-39,1915,7.277111279839288
STAT,1860,49,40-44,1909,0.13674754936096967
STAT,1820,70,na,1890,964.9111002785515
STAT,1878,45,35-39,1923,0.14547772655080904
SIM,1846,46,na,1892,977
SIM,1928,41,35-39,1969,1
STAT,1846,105,na,1951,0.017365485938481223
STAT,1893,45,50-100,1938,0.1749738849659639
STAT,1820,34,15-19,1854,0.3984979503121965
STAT,1840,20,25-29,1860,29.081199306554065
STAT,1850,25,50-100,1875,0.352655551629305
SIM,1887,38,na,1925,3653
STAT,1891,47,45-49,1938,0.1629427786352561
STAT,1915,35,20-24,1950,0.2650308884153118
STAT,1822,71,na,1893,769.7131864935097
SIM,1829,71,na,1900,1463
STAT,1868,58,na,1926,1910.103775770933
SIM,1874,8,na,1882,2819
STAT,1884,48,15-19,1932,3.78097376359321E-4
STAT,1869,10,na,1879,2717.445674602858
STAT,1881,21,25-29,1902,54.22297658255642
STAT,1808,66,na,1874,499.70681270037426
STAT,1863,25,50-100,1888,0.5540407201387103
STAT,1903,35,50-100,1938,0.37973941066167793
STAT,1868,17,20-24,1885,17.43350665361521
STAT,1938,9,na,1947,3884.851146523318
STAT,1923,19,na,1942,4253.685468528396
SIM,1872,66,na,1938,2049
STAT,1878,52,25-29,1930,0.003624867769707018
STAT,1927,35,30-34,1962,2.2514402245790395
SIM,1828,27,na,1855,2238
STAT,1862,20,45-49,1882,0.6168330113420105
STAT,1930,25,na,1955,4734.066708037915
STAT,1850,28,15-19,1878,0.244772319930578
SIM,1932,36,na,1968,6159
STAT,1919,27,50-100,1946,1.0611841383615788
SIM,1878,42,25-29,1920,10
STAT,1924,18,15-19,1942,53.38456444732235
SIM,1893,38,na,1931,3146
STAT,1853,59,na,1912,1506.9401357801296
STAT,1828,37,50-100,1865,1.650121343866504
STAT,1800,56,na,1856,1830.0573071983993
STAT,1828,28,na,1856,1903.4900098107385
STAT,1866,17,50-100,1883,0.04590217011449046
SIM,1889,39,na,1928,3838
STAT,1923,24,50-100,1947,0.7528090902796438
STAT,1845,26,30-34,1871,15.319474482659858
STAT,1896,32,25-29,1928,13.50209426637833
STAT,1834,20,50-100,1854,0.2438472698330436
STAT,1849,19,25-29,1868,5.8082937865984965
STAT,1844,40,45-49,1884,1.5579500400005897
STAT,1842,26,15-19,1868,0.14029006366308822
STAT,1927,28,40-44,1955,5.60054861030836
STAT,1816,71,na,1887,1245.0615595421207
SIM,1886,80,na,1966,1187
STAT,1876,46,15-19,1922,4.055109338329944E-4
STAT,1929,22,50-100,1951,0.8262577309614259
STAT,1911,23,50-100,1934,0.615104323152271
STAT,1921,24,40-44,1945,3.7292143120148955
STAT,1793,69,na,1862,615.9298163233748
STAT,1815,52,35-39,1867,8.424696109014563E-4
STAT,1941,25,20-24,1966,18.684712325355175
STAT,1859,44,na,1903,1807.1447457800193
SIM,1916,40,na,1956,4578
STAT,1883,45,45-49,1928,0.22930570742037737
STAT,1893,63,na,1956,2255.869749569515
SIM,1887,65,na,1952,2486
STAT,1893,17,50-100,1910,0.06126570720203316
SIM,1879,5,na,1884,2233
STAT,1847,50,40-44,1897,0.009655007334595362
SIM,1912,6,na,1918,4905
SIM,1916,36,na,1952,4599
STAT,1833,102,na,1935,0.12062309644209018
STAT,1866,44,15-19,1910,0.012435715319602088
STAT,1886,47,35-39,1933,0.14430112391661787
STAT,1930,15,35-39,1945,5.411895459244163
STAT,1877,31,45-49,1908,1.7774235042726452
STAT,1907,25,20-24,1932,17.233453328327403
STAT,1884,32,15-19,1916,0.13632293536350554
STAT,1829,41,25-29,1870,0.3134906075021509
SIM,1853,26,30-34,1879,13
STAT,1910,38,25-29,1948,0.92652050617766
STAT,1941,15,50-100,1956,0.38171725850284705
SIM,1837,41,25-29,1878,4
STAT,1890,42,30-34,1932,1.390083188550247
SIM,1857,19,25-29,1876,1
STAT,1913,22,40-44,1935,3.2172704446562865
SIM,1904,55,na,1959,3873
SIM,1871,13,na,1884,2040
SIM,1934,21,na,1955,5222
STAT,1899,21,35-39,1920,7.994554974322925
STAT,1940,28,50-100,1968,1.0031161811027731
SIM,1830,25,35-39,1855,17
STAT,1844,76,na,1920,938.5822792554312
STAT,1855,41,35-39,1896,1.203885362956566
STAT,1901,48,40-44,1949,0.1333304985796249
STAT,1928,40,30-34,1968,0.1621895987803792
STAT,1899,23,45-49,1922,0.9495056621568078
SIM,1866,66,na,1932,2408
STAT,1810,70,na,1880,49.69228413616885
STAT,1907,43,15-19,1950,0.0013891410777029975
STAT,1862,29,35-39,1891,8.159649836695737
STAT,1866,42,40-44,1908,2.0506532793439236
STAT,1933,39,na,1972,5078.765840991593
STAT,1902,47,30-34,1949,0.07653168629030052
SIM,1858,31,na,1889,2368
STAT,1911,41,15-19,1952,0.0014575629814962804
STAT,1830,50,50-100,1880,0.01298292181797295
STAT,1915,27,20-24,1942,18.355600482540197
STAT,1858,42,15-19,1900,0.010533089899810739
STAT,1839,51,45-49,1890,0.013547502864283223
STAT,1874,52,40-44,1926,0.010807393271541135
STAT,1902,24,50-100,1926,0.5706395107120801
SIM,1834,27,na,1861,1128
STAT,1940,6,na,1946,4007.4036657425904
SIM,1865,41,50-100,1906,3
STAT,1856,4,na,1860,2263.7026439736564
STAT,1870,35,na,1905,2371.0580775520743
STAT,1923,37,20-24,1960,0.3022274317282082
STAT,1861,24,na,1885,1991.7359478116741
STAT,1891,29,15-19,1920,0.5539434189415611
STAT,1905,30,35-39,1935,14.683050333970206
STAT,1844,28,50-100,1872,0.7702297811963841
STAT,1837,51,25-29,1888,0.0029074148146028145
STAT,1818,50,45-49,1868,0.025845083197834986
SIM,1863,31,25-29,1894,8
SIM,1889,23,na,1912,3885
SIM,1829,43,40-44,1872,5
STAT,1898,38,15-19,1936,0.01621775693208479
STAT,1819,36,30-34,1855,2.8129639793648873
STAT,1900,50,na,1950,3025.698134141606
STAT,1953,18,40-44,1971,1.6763073283198036
SIM,1878,51,na,1929,3678
SIM,1927,36,35-39,1963,4
SIM,1883,14,na,1897,2241
STAT,1851,51,45-49,1902,0.011516637176071098
STAT,1817,41,15-19,1858,0.01030765991600424
STAT,1830,35,35-39,1865,6.5868036134380405
SIM,1850,44,45-49,1894,2
STAT,1858,20,35-39,1878,5.187252136179753
SIM,1837,69,na,1906,1470
SIM,1872,7,na,1879,2625
STAT,1812,43,20-24,1855,0.052584815466466484
STAT,1848,24,40-44,1872,2.340322068914328
STAT,1865,44,na,1909,2081.658313029446
STAT,1844,52,30-34,1896,0.005865731255260914
SIM,1804,52,na,1856,875
STAT,1939,29,15-19,1968,0.7012011684699313
STAT,1837,44,35-39,1881,1.5196798129142761
SIM,1917,3,na,1920,2494
STAT,1882,43,35-39,1925,1.7211678894014837
STAT,1919,38,45-49,1957,0.7219202686119919
SIM,1827,36,30-34,1863,15
SIM,1864,41,na,1905,2415
STAT,1896,25,35-39,1921,12.805786939690906
SIM,1852,40,45-49,1892,1
STAT,1862,40,15-19,1902,0.01188108525856043
STAT,1817,40,na,1857,999.4324814532573
STAT,1860,35,na,1895,1940.2410746646872
STAT,1859,3,na,1862,2599.3957943166406
SIM,1854,3,na,1857,2723
STAT,1886,27,30-34,1913,26.077118795511986
STAT,1842,44,45-49,1886,0.37466653266528055
SIM,1920,27,35-39,1947,24
SIM,1928,21,na,1949,4600
STAT,1832,22,40-44,1854,3.2046478042412745
SIM,1821,85,na,1906,60
STAT,1811,46,40-44,1857,0.8176767459003014
STAT,1830,38,na,1868,1931.4300284047927
STAT,1915,5,na,1920,4135.184594015532
STAT,1925,24,50-100,1949,0.7755240075761072
STAT,1844,51,50-100,1895,0.01503371429567595
SIM,1845,44,35-39,1889,6
STAT,1868,62,na,1930,1765.3522434123918
STAT,1859,75,na,1934,815.944042437604
STAT,1933,15,20-24,1948,181.0929903386665
STAT,1824,38,15-19,1862,0.00897506197601746
SIM,1903,34,40-44,1937,1
STAT,1838,43,25-29,1881,0.28801572209407933
SIM,1907,53,na,1960,4381
STAT,1875,16,15-19,1891,6.108873402536239
STAT,1904,17,35-39,1921,0.7839385218966698
SIM,1846,43,25-29,1889,2
SIM,1894,27,30-34,1921,23
STAT,1851,52,20-24,1903,5.797006901055579E-4
STAT,1912,27,35-39,1939,14.623382460807681
STAT,1875,22,45-49,1897,0.716046207936045
SIM,1918,35,30-34,1953,24
STAT,1865,82,na,1947,425.98559151064575
STAT,1865,39,15-19,1904,0.0507526175466732
STAT,1920,31,15-19,1951,0.1395145016961016
STAT,1830,90,na,1920,57.062620620686765
SIM,1840,68,na,1908,2500
STAT,1949,17,na,1966,4238.626122079826
SIM,1929,37,na,1966,6204
STAT,1812,53,30-34,1865,0.0014353805257770087
STAT,1928,22,na,1950,4524.785230669132
SIM,1942,29,na,1971,3620
STAT,1899,17,15-19,1916,8.105808800537163
STAT,1874,50,35-39,1924,0.009012804618755602
STAT,1928,33,40-44,1961,4.852979060616247
STAT,1827,43,na,1870,1868.3265716734193
STAT,1823,32,25-29,1855,28.311880957650065
SIM,1831,32,25-29,1863,2
SIM,1866,97,na,1963,52
SIM,1878,82,na,1960,866
SIM,1850,8,na,1858,2440
STAT,1869,23,15-19,1892,3.318698814653288
STAT,1917,42,30-34,1959,0.13163696055897026
STAT,1923,40,50-100,1963,0.13624244118837558
STAT,1929,39,50-100,1968,0.534106492303603
STAT,1804,70,na,1874,1290.944606276613
STAT,1901,46,35-39,1947,0.11073287438929136
STAT,1846,45,40-44,1891,0.10240592497692899
STAT,1846,31,30-34,1877,12.347688834602515
SIM,1911,27,na,1938,2507
STAT,1887,45,50-100,1932,0.27302036232469323
SIM,1923,22,na,1945,4291
STAT,1914,46,45-49,1960,0.21307855999910613
STAT,1888,42,25-29,1930,0.7402418569574646
STAT,1910,44,35-39,1954,0.18586728781356718
SIM,1936,33,40-44,1969,11
STAT,1915,38,25-29,1953,0.9757399910706261
STAT,1916,37,na,1953,3800.155263313379
SIM,1909,23,20-24,1932,2
SIM,1834,65,na,1899,44
STAT,1854,45,na,1899,1263.4226925759035
SIM,1831,32,40-44,1863,30
SIM,1878,92,na,1970,70
STAT,1858,40,50-100,1898,0.8149152369694365
SIM,1833,80,na,1913,1615
STAT,1845,68,na,1913,758.3176193717135
STAT,1803,53,20-24,1856,0.0015771639195560812
STAT,1871,16,30-34,1887,1.6097039767503554
STAT,1878,34,30-34,1912,17.809967436884527
STAT,1914,20,35-39,1934,9.15709446859734
SIM,1896,30,25-29,1926,106
STAT,1898,62,na,1960,2572.8620480143554
STAT,1911,45,30-34,1956,0.08383642241677888
STAT,1866,22,35-39,1888,5.37022876400033
STAT,1817,49,na,1866,895.7357714990326
SIM,1860,82,na,1942,1638
SIM,1927,35,40-44,1962,5
STAT,1862,18,30-34,1880,1.545661064984633
STAT,1870,44,20-24,1914,0.1561888698755756
STAT,1853,50,na,1903,1693.5339120189901
STAT,1865,50,25-29,1915,0.0032802975708671072
STAT,1891,48,20-24,1939,0.008219441649534805
STAT,1854,19,35-39,1873,0.360676201274609
STAT,1915,45,15-19,1960,3.676715598251508E-4
STAT,1811,55,na,1866,1593.338411047523
STAT,1937,26,45-49,1963,1.6674031884116025
STAT,1841,42,35-39,1883,2.0953531489820443
SIM,1822,33,na,1855,1544
SIM,1910,33,20-24,1943,5
STAT,1860,45,25-29,1905,0.047458094950260134
STAT,1872,21,30-34,1893,17.89035054758386
STAT,1916,4,na,1920,4210.038932615266
STAT,1866,30,na,1896,2195.778625901421
STAT,1822,98,na,1920,1.8732722786440967
STAT,1850,47,20-24,1897,0.005515307043664877
SIM,1883,45,na,1928,2154
STAT,1879,44,25-29,1923,0.6498583790524873
SIM,1846,50,na,1896,901
STAT,1795,102,na,1897,0.07146716509297114
SIM,1859,26,na,1885,1615
STAT,1796,102,na,1898,0.11481312218994388
STAT,1830,27,50-100,1857,0.6151040191062237
STAT,1838,46,45-49,1884,0.10498121552820801
STAT,1897,31,50-100,1928,1.2217943869873762
SIM,1963,7,na,1970,5558
SIM,1954,14,na,1968,5552
STAT,1893,25,na,1918,3004.66094319156
STAT,1909,18,30-34,1927,2.3597418213452106
STAT,1856,30,na,1886,1771.3686310434139
STAT,1837,33,30-34,1870,17.371360772870794
STAT,1851,41,15-19,1892,0.010956252005780369
STAT,1869,30,20-24,1899,2.749532505318248
SIM,1849,26,na,1875,2530
STAT,1855,43,40-44,1898,1.4778990908966687
STAT,1793,90,na,1883,27.720084612363852
SIM,1807,66,na,1873,371
STAT,1886,77,na,1963,1145.038102288116
SIM,1891,74,na,1965,488
STAT,1878,58,na,1936,2034.689201744509
STAT,1806,54,35-39,1860,0.02179047756263194
STAT,1833,36,15-19,1869,0.030776478721508745
SIM,1955,2,na,1957,3825
STAT,1853,97,na,1950,4.165575949259619
STAT,1876,39,50-100,1915,1.228643549203378
STAT,1872,41,35-39,1913,1.8214803938103996
STAT,1835,29,25-29,1864,41.11679479616145
STAT,1937,33,35-39,1970,8.942062002967639
SIM,1841,13,na,1854,1206
SIM,1841,36,15-19,1877,1
SIM,1843,29,25-29,1872,1
SIM,1942,26,na,1968,3614
STAT,1890,23,25-29,1913,69.08781044194686
STAT,1855,39,50-100,1894,0.8043868343726537
STAT,1942,27,30-34,1969,40.65452375089598
SIM,1911,37,na,1948,2516
STAT,1805,50,35-39,1855,0.010505947590381268
STAT,1913,15,35-39,1928,0.8511086670780444
STAT,1874,48,50-100,1922,0.2502906059374965
SIM,1897,65,na,1962,1419
STAT,1917,47,25-29,1964,0.05466662283538587
SIM,1890,27,na,1917,3878
STAT,1811,48,30-34,1859,0.447735309078155
STAT,1873,31,25-29,1904,10.549591652420693
SIM,1839,64,na,1903,127
STAT,1877,18,25-29,1895,5.7373400353354445
STAT,1946,24,50-100,1970,0.7238179835621346
STAT,1900,17,50-100,1917,0.06786773542922804
STAT,1857,17,45-49,1874,0.05891529136787029
STAT,1811,65,na,1876,1197.6656663683796
SIM,1878,32,30-34,1910,49
STAT,1785,105,na,1890,0.009550050456362764
STAT,1829,50,20-24,1879,3.4315389975275186E-4
STAT,1873,40,40-44,1913,2.330542424814311
SIM,1859,16,na,1875,2302
STAT,1945,25,40-44,1970,5.061555571275396
STAT,1862,30,na,1892,2048.856696068341
STAT,1945,24,na,1969,3955.4327812549063
STAT,1941,28,25-29,1969,67.28266718054678
STAT,1883,44,15-19,1927,0.013106321235459096
STAT,1916,37,30-34,1953,1.8409584717531455
STAT,1828,29,35-39,1857,16.470683325422364
STAT,1873,45,35-39,1918,0.14504086911852046
STAT,1860,45,na,1905,1853.7006601454511
STAT,1941,21,40-44,1962,3.436363941894926
STAT,1896,41,20-24,1937,0.01460360462150641
SIM,1948,14,na,1962,5824
STAT,1802,52,25-29,1854,0.017993518319543864
SIM,1827,79,na,1906,783
STAT,1883,49,25-29,1932,0.054256692064586554
STAT,1887,32,30-34,1919,19.217442824626385
STAT,1843,40,50-100,1883,1.1026266648811205
SIM,1836,29,35-39,1865,50
SIM,1848,18,20-24,1866,2
STAT,1924,25,na,1949,4349.181104106007
SIM,1889,30,na,1919,3856
STAT,1817,43,na,1860,961.8232611964559
STAT,1887,46,40-44,1933,0.18897025242878804
STAT,1888,30,25-29,1918,11.916666170160914
SIM,1873,9,na,1882,2485
SIM,1890,21,25-29,1911,1194
STAT,1842,16,na,1858,736.0731746461609
SIM,1848,78,na,1926,966
STAT,1929,31,35-39,1960,11.533097031652439
STAT,1962,5,na,1967,4990.47579628995
STAT,1936,28,35-39,1964,14.218816280772256
STAT,1902,31,30-34,1933,24.68655743719428
STAT,1916,32,50-100,1948,0.8419608620159778
SIM,1937,31,35-39,1968,84
STAT,1902,48,50-100,1950,0.19263368200861652
STAT,1927,16,25-29,1943,53.57447515682119
SIM,1886,20,20-24,1906,14
STAT,1879,47,45-49,1926,0.24096952881596415
STAT,1844,45,na,1889,2264.0417603611145
SIM,1836,50,na,1886,1695
STAT,1936,10,na,1946,3767.1805404981214
SIM,1923,12,na,1935,4291
STAT,1827,49,na,1876,1736.6702310312921
STAT,1857,18,50-100,1875,0.043926210226285164
SIM,1948,18,25-29,1966,106
SIM,1815,51,na,1866,1752
SIM,1840,30,25-29,1870,49
STAT,1857,108,na,1965,0.010019212199662939
SIM,1819,43,30-34,1862,5
STAT,1874,37,15-19,1911,0.057955242675328
STAT,1902,36,25-29,1938,0.8793123827340904
STAT,1855,40,20-24,1895,0.10616883695360488
STAT,1872,30,na,1902,2408.7630504603344
STAT,1855,2,na,1857,2357.498391681599
STAT,1863,48,45-49,1911,0.198944547547346
SIM,1840,44,35-39,1884,14
STAT,1836,28,30-34,1864,24.789488097929798
STAT,1873,70,na,1943,1439.244930222817
STAT,1842,43,15-19,1885,0.003501707616573337
STAT,1849,41,50-100,1890,0.8941855338274769
SIM,1860,72,na,1932,1638
STAT,1919,35,40-44,1954,1.5957188972807212
STAT,1922,22,35-39,1944,10.677449096774458
STAT,1898,18,45-49,1916,0.0876101279327884
STAT,1831,40,35-39,1871,1.8179580566715778
STAT,1886,25,50-100,1911,0.6669276834833827
STAT,1939,5,na,1944,3971.821821157512
SIM,1889,19,20-24,1908,209
SIM,1828,31,na,1859,2091
STAT,1861,19,25-29,1880,5.3530768852837
STAT,1922,15,45-49,1937,0.5743324262447473
STAT,1890,26,45-49,1916,1.3487537669006675
STAT,1915,52,na,1967,3588.233069981435
STAT,1832,30,25-29,1862,1.6576835145652633
SIM,1852,53,na,1905,1883
STAT,1853,54,30-34,1907,0.004488615306121526
STAT,1925,46,20-24,1971,0.013301769855968572
SIM,1892,12,na,1904,3699
STAT,1832,44,35-39,1876,0.16198279993278197
STAT,1866,15,45-49,1881,0.06193028373681048
STAT,1867,18,na,1885,2427.423898396173
SIM,1854,31,30-34,1885,16
SIM,1919,43,35-39,1962,1
STAT,1900,12,na,1912,3577.5122456957274
SIM,1895,30,na,1925,4356
STAT,1912,34,50-100,1946,0.7972242649715424
STAT,1850,45,na,1895,1049.2474990870292
STAT,1900,38,30-34,1938,1.5856487339113357
STAT,1936,35,40-44,1971,1.4575599421608703
SIM,1809,51,na,1860,612
STAT,1823,35,45-49,1858,3.801729874758411
STAT,1840,90,na,1930,31.043835478347614
STAT,1914,43,40-44,1957,0.24401184115485636
STAT,1842,48,25-29,1890,0.01411921539319029
STAT,1896,22,30-34,1918,23.4806615809993
STAT,1897,22,na,1919,3140.9073886372134
STAT,1829,31,30-34,1860,9.876430411250471
STAT,1885,37,na,1922,2315.806248638619
STAT,1850,32,35-39,1882,4.891868873253967
SIM,1845,22,25-29,1867,91
STAT,1840,32,25-29,1872,4.912254303240417
SIM,1878,3,na,1881,4422
STAT,1842,41,40-44,1883,0.585143518123054
STAT,1879,40,25-29,1919,0.665397298968392
STAT,1886,81,na,1967,896.6709055705799
STAT,1832,41,30-34,1873,0.09991922415429236
STAT,1932,34,45-49,1966,2.0746107803837157
SIM,1880,35,40-44,1915,2
STAT,1928,18,na,1946,4590.536572504248
STAT,1890,20,20-24,1910,83.92373277666444
STAT,1857,41,50-100,1898,0.8143485606573954
STAT,1921,47,15-19,1968,4.1034648203793937E-4
SIM,1903,37,45-49,1940,27
STAT,1878,20,20-24,1898,71.32498605687279
SIM,1865,26,na,1891,1803
SIM,1876,41,45-49,1917,9
STAT,1860,31,15-19,1891,0.11664982992946533
SIM,1867,45,na,1912,2095
SIM,1849,64,na,1913,905
STAT,1842,20,50-100,1862,0.12953648150873082
SIM,1837,31,30-34,1868,1
STAT,1888,40,35-39,1928,2.1110641441184805
STAT,1825,48,25-29,1873,0.07221187262722932
STAT,1849,22,35-39,1871,5.944713788234279
STAT,1937,30,30-34,1967,15.443704515901555
SIM,1910,42,na,1952,3950
STAT,1917,44,20-24,1961,0.018123582224629866
STAT,1832,102,na,1934,0.24886874572464668
SIM,1827,31,20-24,1858,22
SIM,1822,39,na,1861,1526
SIM,1909,26,25-29,1935,5
STAT,1834,21,45-49,1855,0.4139849076309384
STAT,1945,21,25-29,1966,100.15075431528497
STAT,1931,11,na,1942,5157.457696191173
STAT,1882,39,15-19,1921,0.05322185334476492
STAT,1846,35,50-100,1881,0.7752770793516589
STAT,1892,39,25-29,1931,3.5288389794595623
SIM,1866,40,50-100,1906,18
STAT,1901,49,50-100,1950,0.18966267147338634
STAT,1900,30,35-39,1930,14.141643030931364
STAT,1852,40,20-24,1892,0.16147231853910796
SIM,1879,30,na,1909,1465
STAT,1902,43,15-19,1945,0.0013406467696962187
STAT,1911,43,40-44,1954,0.23462400742054323
STAT,1901,43,30-34,1944,0.11082058964246291
STAT,1852,49,30-34,1901,0.09540328644898512
STAT,1852,16,na,1868,2811.097569981188
STAT,1841,53,40-44,1894,0.011534993364000354
STAT,1867,20,45-49,1887,0.6718072652694688
SIM,1842,53,na,1895,3011
STAT,1862,64,na,1926,1480.631175376417
SIM,1892,59,na,1951,3403
STAT,1854,33,30-34,1887,9.838791955600183
SIM,1933,15,na,1948,4513
STAT,1864,33,40-44,1897,3.9258981457046342
SIM,1859,19,na,1878,2288
STAT,1872,35,40-44,1907,4.425084633939742
STAT,1936,18,40-44,1954,1.3223593945450887
STAT,1846,34,35-39,1880,6.942299157329988
SIM,1837,79,na,1916,503
STAT,1882,21,25-29,1903,54.973004627252244
STAT,1837,22,25-29,1859,60.08819054553733
STAT,1914,41,50-100,1955,0.11495568918329015
STAT,1924,35,15-19,1959,0.022465502245481953
STAT,1848,27,45-49,1875,1.2403617753851273
SIM,1840,41,30-34,1881,2
SIM,1881,71,na,1952,382
STAT,1814,42,25-29,1856,2.2474356603862935
STAT,1824,42,35-39,1866,0.3083740818407744
STAT,1843,97,na,1940,5.308015710427596
STAT,1871,82,na,1953,465.4363307480977
SIM,1897,58,na,1955,1702
STAT,1915,49,30-34,1964,0.08804069473403889
STAT,1820,54,35-39,1874,0.012550865332427573
SIM,1838,27,na,1865,2317
SIM,1908,48,na,1956,2047
STAT,1878,46,50-100,1924,0.25340771761350417
SIM,1885,29,30-34,1914,1
STAT,1901,22,15-19,1923,4.612745500750665
SIM,1852,16,20-24,1868,97
STAT,1776,94,na,1870,7.702769410628403
STAT,1835,31,na,1866,2109.461431132589
STAT,1806,51,30-34,1857,0.01609919014658253
STAT,1854,16,30-34,1870,1.0664112244182724
STAT,1913,19,na,1932,3878.466252965292
STAT,1816,51,40-44,1867,0.031426617075768465
STAT,1874,96,na,1970,47.17153590307149
STAT,1844,16,20-24,1860,22.458448890567443
STAT,1906,44,45-49,1950,0.14846628141464396
SIM,1880,27,na,1907,3316
STAT,1823,108,na,1931,0.0014470194868400385
STAT,1864,36,45-49,1900,1.8210136824016088
STAT,1845,31,na,1876,1292.0348287433474
STAT,1868,41,45-49,1909,1.4521019545043121
SIM,1894,44,na,1938,1457
STAT,1877,29,30-34,1906,25.379957719690292
STAT,1878,23,25-29,1901,58.71625288147228
SIM,1787,72,na,1859,903
STAT,1844,54,20-24,1898,7.109451880027878E-4
SIM,1836,43,30-34,1879,2
STAT,1832,98,na,1930,2.7576034812296686
STAT,1872,24,35-39,1896,5.806833161929667
STAT,1857,15,na,1872,2094.8970978086622
STAT,1955,17,na,1972,4843.558592180067
STAT,1966,3,na,1969,4863.827593485542
STAT,1833,47,20-24,1880,0.006025765646578367
SIM,1803,66,na,1869,965
STAT,1921,0,na,1921,5074.382322243462
SIM,1877,11,na,1888,213
SIM,1886,23,25-29,1909,38
STAT,1838,43,40-44,1881,1.0088292603076847
STAT,1915,31,40-44,1946,3.9453288910803574
STAT,1828,43,30-34,1871,1.4138116128189853
STAT,1852,45,15-19,1897,4.0664892885139707E-4
SIM,1879,77,na,1956,63
STAT,1883,42,40-44,1925,2.1612364010347167
STAT,1879,41,20-24,1920,0.1636538953874699
STAT,1873,42,30-34,1915,1.1778543284127447
STAT,1911,48,35-39,1959,0.12034752266084797
STAT,1884,48,na,1932,2126.649025058209
SIM,1932,26,na,1958,6270
SIM,1859,28,25-29,1887,5
STAT,1826,50,20-24,1876,0.0010607361598916581
STAT,1901,48,25-29,1949,0.04485885898597839
STAT,1832,34,50-100,1866,0.06231061156454349
SIM,1907,59,na,1966,4311
STAT,1856,49,15-19,1905,2.8130255064903937E-4
STAT,1805,65,na,1870,329.34718682767374
STAT,1903,19,40-44,1922,0.25824058418740464
STAT,1843,105,na,1948,0.028970134669448575
STAT,1831,34,40-44,1865,4.480320198071628
STAT,1866,49,25-29,1915,0.051480561522714574
STAT,1928,36,45-49,1964,0.8557780386045695
STAT,1901,26,30-34,1927,35.330545134314136
STAT,1846,51,35-39,1897,0.005123204691428802
STAT,1937,23,40-44,1960,3.239360679745762
SIM,1962,5,na,1967,4676
SIM,1824,72,na,1896,1465
STAT,1830,32,na,1862,2033.5886441524685
STAT,1841,31,na,1872,2958.7097540339532
STAT,1822,47,45-49,1869,0.3946396796207477
STAT,1895,34,30-34,1929,22.51840735579566
STAT,1967,5,na,1972,4861.51988711208
SIM,1906,38,25-29,1944,6
STAT,1847,41,25-29,1888,0.5913510123494381
STAT,1874,17,45-49,1891,0.06741716979856738
STAT,1879,44,40-44,1923,2.2762512514164888
STAT,1837,97,na,1934,4.307644438686494
STAT,1921,27,45-49,1948,1.9026022070678346
STAT,1910,35,20-24,1945,0.2516618721528814
SIM,1828,44,35-39,1872,3
STAT,1858,96,na,1954,6.557323803805007
STAT,1900,20,40-44,1920,2.9038935255248557
STAT,1853,50,50-100,1903,0.011878786098544383
STAT,1893,41,20-24,1934,0.19949873275442806
STAT,1835,68,na,1903,1156.3184946047031
STAT,1834,83,na,1917,174.95425930396036
STAT,1812,45,50-100,1857,0.06611198484908085
STAT,1887,35,35-39,1922,7.858909878749488
STAT,1803,91,na,1894,14.617426837615527
STAT,1846,41,25-29,1887,0.38989204493803187
STAT,1859,27,20-24,1886,9.458758872277317
SIM,1894,0,na,1894,1883
STAT,1875,37,na,1912,2419.2403961197715
STAT,1877,15,20-24,1892,18.08020776421792
STAT,1954,16,35-39,1970,5.143000856498404
STAT,1918,22,na,1940,3885.4390413167202
STAT,1906,37,20-24,1943,0.2409315077488945
STAT,1899,0,na,1899,4010.6459854352925
STAT,1876,81,na,1957,618.0806026268018
STAT,1893,46,15-19,1939,2.829616016134071E-4
SIM,1824,65,na,1889,1811
STAT,1936,25,30-34,1961,37.15859440097527
STAT,1858,16,15-19,1874,5.32534978359971
STAT,1823,50,na,1873,1981.7458693472825
STAT,1841,38,15-19,1879,0.0729136423642613
STAT,1849,82,na,1931,393.1385666457707
STAT,1776,87,na,1863,103.4669692017886
STAT,1909,17,50-100,1926,0.07272356879077037
STAT,1917,19,35-39,1936,4.416823847003711
SIM,1826,29,25-29,1855,22
STAT,1855,43,25-29,1898,0.42193281915412056
SIM,1832,42,35-39,1874,3
STAT,1876,15,50-100,1891,0.049756390031056696
SIM,1939,5,na,1944,4904
STAT,1829,53,25-29,1882,0.001412390500600978
STAT,1845,21,20-24,1866,42.75857753246276
STAT,1895,17,30-34,1912,2.073420894787419
STAT,1940,18,na,1958,3694.1060995921225
STAT,1889,48,15-19,1937,2.682989656295776E-4
STAT,1867,15,na,1882,2470.8267575756804
STAT,1823,52,45-49,1875,0.021789775340936193
STAT,1839,50,30-34,1889,0.005667920283265565
STAT,1924,25,20-24,1949,21.192324080377677
STAT,1904,24,40-44,1928,2.958491868327509
STAT,1891,33,35-39,1924,12.400990257448658
STAT,1828,83,na,1911,268.73249188491314
STAT,1890,43,45-49,1933,1.7987551239194262
STAT,1834,41,15-19,1875,0.0074317718707505205
STAT,1843,53,25-29,1896,0.0034434762789958017
STAT,1902,33,20-24,1935,3.7902776050774736
STAT,1828,26,30-34,1854,57.18416449036796
STAT,1878,30,15-19,1908,0.1476966135719819
STAT,1919,31,25-29,1950,9.879507349347316
STAT,1906,37,na,1943,3438.543340518301
STAT,1892,77,na,1969,1489.0407082388472
STAT,1869,47,35-39,1916,0.1406128490284417
STAT,1874,31,50-100,1905,0.94949077908627
SIM,1873,45,na,1918,2115
SIM,1903,27,35-39,1930,12
STAT,1833,54,45-49,1887,0.006161266601516008
STAT,1867,51,20-24,1918,7.012116023227205E-4
STAT,1921,17,35-39,1938,4.726345137385684
STAT,1823,32,40-44,1855,11.987244390918702
STAT,1905,19,50-100,1924,0.07008813043488325
STAT,1896,44,25-29,1940,0.05798991099592356
STAT,1891,40,25-29,1931,0.7976471113938329
SIM,1938,14,na,1952,4240
STAT,1872,17,50-100,1889,0.049219859472081504
STAT,1860,42,20-24,1902,0.12939892005482664
STAT,1930,32,50-100,1962,1.0595159015297673
STAT,1928,26,35-39,1954,18.418907105793394
STAT,1950,15,20-24,1965,158.86335550150235
SIM,1922,46,45-49,1968,3
STAT,1864,53,45-49,1917,0.012981491892890804
STAT,1890,23,40-44,1913,2.5148790607736253
STAT,1875,42,15-19,1917,0.01416319553618906
SIM,1839,24,40-44,1863,3
STAT,1836,24,15-19,1860,3.288553934824111
STAT,1848,47,15-19,1895,3.7256445628366496E-4
STAT,1841,40,45-49,1881,1.77676077331488
STAT,1857,52,40-44,1909,0.008035506033793173
STAT,1871,19,35-39,1890,0.5444259233370853
STAT,1839,43,50-100,1882,1.0213034894726016
SIM,1867,27,20-24,1894,104
STAT,1860,47,15-19,1907,3.247952881631974E-4
SIM,1873,43,35-39,1916,23
SIM,1872,30,20-24,1902,3
STAT,1910,12,na,1922,3869.461917102373
STAT,1880,26,35-39,1906,10.05145399474626
STAT,1934,30,50-100,1964,1.1224791902851345
SIM,1885,30,na,1915,1399
STAT,1817,50,na,1867,884.9378676476551
STAT,1883,47,50-100,1930,0.23517626917536943
STAT,1816,43,50-100,1859,3.381396233190233
SIM,1855,64,na,1919,2860
STAT,1856,108,na,1964,0.007956595341543476
STAT,1851,35,20-24,1886,0.6282428398446539
STAT,1874,48,20-24,1922,0.012229183184714493
STAT,1887,22,na,1909,2603.145590991773
SIM,1872,60,na,1932,2049
SIM,1949,19,20-24,1968,1259
STAT,1890,22,50-100,1912,0.4936740327495756
STAT,1916,33,15-19,1949,0.13030972137472582
SIM,1894,22,20-24,1916,3
SIM,1835,40,45-49,1875,3
STAT,1865,43,35-39,1908,1.6413140492973959
SIM,1936,26,35-39,1962,62
STAT,1888,32,50-100,1920,1.0574973595510007
STAT,1894,31,45-49,1925,2.2266086756837944
STAT,1855,82,na,1937,308.80126958080064
STAT,1870,33,50-100,1903,0.9095808508787111
STAT,1910,38,40-44,1948,1.4086725818044186
SIM,1903,60,na,1963,1936
STAT,1849,32,45-49,1881,1.5483076002235723
STAT,1827,40,45-49,1867,1.4592207323766218
STAT,1898,15,40-44,1913,0.2470955468827342
STAT,1905,52,na,1957,3116.766579861343
STAT,1841,33,50-100,1874,1.2251394517520215
STAT,1886,22,20-24,1908,71.36233995212815
STAT,1818,38,50-100,1856,2.8736190699195014
STAT,1842,66,na,1908,406.87520433713325
STAT,1845,37,30-34,1882,2.778685549513674
STAT,1887,78,na,1965,1174.9861073659063
STAT,1847,45,40-44,1892,0.15632796101629573
SIM,1887,46,45-49,1933,1
STAT,1829,44,50-100,1873,0.4936787383773044
SIM,1933,34,50-100,1967,1
STAT,1846,56,na,1902,1207.9954033922197
SIM,1864,27,35-39,1891,44
STAT,1920,46,50-100,1966,0.24741999769810796
STAT,1884,39,35-39,1923,6.70256828140466
SIM,1945,18,na,1963,6339
STAT,1947,21,45-49,1968,1.2586736518193797
STAT,1913,15,50-100,1928,0.07599183119534558
SIM,1842,34,20-24,1876,10
STAT,1850,50,40-44,1900,0.00493112332254059
SIM,1901,3,na,1904,4179
STAT,1924,21,50-100,1945,0.7712886475359414
STAT,1886,36,35-39,1922,7.3596171005289355
SIM,1848,19,20-24,1867,87
STAT,1840,31,40-44,1871,2.101556508558589
STAT,1819,45,35-39,1864,0.025416443805281547
STAT,1863,17,25-29,1880,5.52033435287137
STAT,1895,73,na,1968,1908.470936980972
STAT,1936,28,50-100,1964,0.9426610015767786
STAT,1836,31,20-24,1867,2.6454699462278395
SIM,1862,39,na,1901,3652
STAT,1892,47,15-19,1939,2.780526088488372E-4
STAT,1852,32,50-100,1884,0.9549125873943054
STAT,1920,47,45-49,1967,0.23715924094527954
STAT,1854,51,na,1905,1202.9274461443977
STAT,1899,63,na,1962,2599.7491002177344
STAT,1817,48,35-39,1865,0.09678752208838153
STAT,1823,34,45-49,1857,3.558022073452442
SIM,1875,81,na,1956,716
STAT,1856,27,35-39,1883,7.181457462834323
STAT,1836,42,30-34,1878,1.048018749489812
SIM,1885,49,45-49,1934,6
STAT,1883,88,na,1971,368.68616900616905
SIM,1855,32,35-39,1887,2
SIM,1892,28,25-29,1920,11
STAT,1834,45,30-34,1879,0.05100817420843427
STAT,1841,26,50-100,1867,0.8911579852015471
STAT,1844,104,na,1948,0.06607898988041211
SIM,1808,51,na,1859,1372
STAT,1825,31,45-49,1856,3.2089858190856995
STAT,1911,37,na,1948,3592.860459478865
STAT,1817,37,25-29,1854,2.2765812934053717
STAT,1852,27,20-24,1879,13.754122563732059
STAT,1939,29,20-24,1968,18.131058639347398
STAT,1877,49,45-49,1926,0.23456639665282353
STAT,1884,28,25-29,1912,40.35144374584528
STAT,1892,43,50-100,1935,1.2985379614108326
STAT,1894,44,15-19,1938,0.001203037846418865
STAT,1824,53,na,1877,455.6953342932754
STAT,1834,34,20-24,1868,1.494574328195973
SIM,1901,34,25-29,1935,30
SIM,1853,78,na,1931,1079
STAT,1858,35,45-49,1893,1.536812614250502
STAT,1847,32,35-39,1879,10.750371773058681
STAT,1812,68,na,1880,142.30794618425642
STAT,1894,46,40-44,1940,0.12315407685590526
SIM,1831,34,45-49,1865,6
STAT,1884,22,40-44,1906,1.9947726820376344
STAT,1831,42,25-29,1873,0.6275903405857718
STAT,1919,23,35-39,1942,10.1422064161735
SIM,1906,19,na,1925,3567
STAT,1893,15,15-19,1908,7.455801373076258
SIM,1898,50,na,1948,4037
STAT,1833,50,35-39,1883,0.003956376669075003
STAT,1862,21,20-24,1883,60.52056744892489
STAT,1899,36,45-49,1935,2.735943459280412
STAT,1819,47,30-34,1866,0.018032305698877364
STAT,1851,46,15-19,1897,3.1681370990826763E-4
SIM,1851,27,25-29,1878,3
STAT,1927,42,25-29,1969,0.08882831748328611
STAT,1829,52,40-44,1881,0.004281949541526273
SIM,1838,37,35-39,1875,2
STAT,1825,94,na,1919,12.307679479434048
STAT,1843,27,25-29,1870,51.43706764194217
STAT,1832,37,20-24,1869,0.058794396895648436
SIM,1865,63,na,1928,1523
SIM,1857,42,40-44,1899,3
STAT,1896,43,40-44,1939,0.20441246152957526
STAT,1936,20,30-34,1956,27.224088924664304
SIM,1910,24,na,1934,4315
SIM,1894,60,na,1954,1169
STAT,1874,12,na,1886,2698.122541201329
STAT,1881,37,50-100,1918,1.1594161353497232
SIM,1914,38,na,1952,4960
SIM,1851,38,35-39,1889,4
SIM,1907,44,na,1951,4402
STAT,1873,30,na,1903,2467.505252045524
STAT,1949,20,40-44,1969,3.88744345652071
STAT,1890,25,45-49,1915,1.353260123110626
STAT,1923,22,na,1945,4204.320807002085
SIM,1861,73,na,1934,1395
STAT,1841,25,na,1866,3035.4551661261003
STAT,1923,37,15-19,1960,0.022016570644271868
STAT,1816,58,na,1874,2067.71430183924
STAT,1927,31,15-19,1958,0.15687929997044586
STAT,1897,20,25-29,1917,76.4787548698737
STAT,1860,24,20-24,1884,57.1237901809346
STAT,1897,39,45-49,1936,0.5656784771433973
STAT,1821,39,40-44,1860,5.121466686817136
SIM,1853,37,30-34,1890,31
STAT,1878,25,20-24,1903,12.15201700221434
STAT,1843,38,35-39,1881,7.347357840009496
SIM,1880,9,na,1889,3342
STAT,1849,42,40-44,1891,1.8928882279646113
STAT,1879,46,45-49,1925,0.24278556484097472
SIM,1933,34,15-19,1967,6
STAT,1817,99,na,1916,0.5999570515821726
STAT,1855,40,15-19,1895,0.00923207327720661
STAT,1865,32,50-100,1897,0.8365240061634369
STAT,1853,43,15-19,1896,0.010630633695341304
STAT,1831,53,35-39,1884,0.007001304881984513
STAT,1851,21,45-49,1872,0.6624466287097398
SIM,1902,29,na,1931,3524
STAT,1850,61,na,1911,862.864262554998
SIM,1818,49,50-100,1867,3
STAT,1863,28,50-100,1891,0.5441909388598467
STAT,1885,9,na,1894,2550.3929380760815
SIM,1815,44,50-100,1859,9
SIM,1855,34,30-34,1889,2
STAT,1939,16,15-19,1955,44.94089201842831
STAT,1948,14,na,1962,4447.792419823829
STAT,1897,28,35-39,1925,12.769171874293072
STAT,1845,35,35-39,1880,4.13735920554986
STAT,1821,37,45-49,1858,2.4601015672009807
STAT,1847,34,30-34,1881,16.51958949901852
STAT,1925,34,15-19,1959,0.15100745693932152
STAT,1820,63,na,1883,1252.68191826234
SIM,1852,37,na,1889,2070
STAT,1898,40,40-44,1938,0.21215648763452924
STAT,1915,27,na,1942,3767.016324891921
STAT,1862,32,30-34,1894,14.871157581893343
STAT,1902,60,na,1962,2838.5674188358503
STAT,1919,36,40-44,1955,1.5883147615973383
STAT,1880,51,35-39,1931,0.00898029582576053
STAT,1917,28,30-34,1945,40.40019473494814
STAT,1838,45,45-49,1883,0.10633485827403645
STAT,1855,54,35-39,1909,0.005541103910318299
STAT,1873,22,35-39,1895,5.985916549936376
SIM,1819,35,na,1854,1917
STAT,1851,49,25-29,1900,0.04454221250761791
SIM,1925,39,40-44,1964,8
STAT,1805,52,25-29,1857,0.004148574599203075
SIM,1860,32,na,1892,2023
STAT,1861,51,25-29,1912,0.0029597840788278575
STAT,1936,29,na,1965,3546.038594341472
SIM,1872,32,40-44,1904,8
STAT,1870,43,20-24,1913,0.15718226176996183
STAT,1879,27,na,1906,2448.1906267022887
SIM,1823,40,na,1863,1605
STAT,1860,21,40-44,1881,1.7650839750051897
STAT,1888,49,20-24,1937,0.007649413904568422
STAT,1933,23,50-100,1956,0.8665885741505147
STAT,1843,30,50-100,1873,1.111172585858242
SIM,1922,31,35-39,1953,2
STAT,1899,39,25-29,1938,0.8402744615058633
SIM,1879,38,35-39,1917,18
STAT,1917,39,40-44,1956,1.5247968119208697
STAT,1872,54,35-39,1926,0.008383698683671975
SIM,1891,12,na,1903,2686
STAT,1862,38,45-49,1900,1.6895126541894194
STAT,1839,38,15-19,1877,0.06170132743166792
STAT,1841,27,45-49,1868,1.5356618592947204
SIM,1846,45,45-49,1891,1
SIM,1890,70,na,1960,2631
STAT,1895,25,20-24,1920,15.364658583468216
SIM,1895,26,na,1921,4557
STAT,1938,27,50-100,1965,0.9755392472998661
SIM,1886,65,na,1951,2499
STAT,1869,38,30-34,1907,5.351305603476422
STAT,1878,16,30-34,1894,1.6439108128255298
STAT,1831,23,na,1854,2018.529952608542
STAT,1860,38,35-39,1898,5.741414576881304
STAT,1879,40,30-34,1919,1.1912758045693121
STAT,1820,52,20-24,1872,0.0011193266104472922
STAT,1886,38,30-34,1924,5.491670344057603
STAT,1912,47,40-44,1959,0.14976093004878846
STAT,1890,20,15-19,1910,4.01765188447927
STAT,1904,67,na,1971,2630.725737874633
STAT,1947,23,40-44,1970,3.758817447802813
STAT,1828,34,20-24,1862,3.831741938754143
STAT,1891,18,45-49,1909,0.08011850038908916
STAT,1841,16,35-39,1857,0.7927287785234431
STAT,1840,99,na,1939,0.7457188423066914
STAT,1881,33,25-29,1914,9.631762219833194
SIM,1856,27,na,1883,841
STAT,1883,36,50-100,1919,1.1868264704313618
STAT,1892,22,45-49,1914,0.8633495372776291
STAT,1832,64,na,1896,1475.6479712389598
STAT,1860,27,25-29,1887,34.87892267659548
STAT,1903,41,30-34,1944,0.11383991144147783
STAT,1837,24,20-24,1861,71.29940866257517
STAT,1896,41,15-19,1937,0.0012698787313269377
STAT,1928,29,45-49,1957,2.1101262595377697
STAT,1829,84,na,1913,121.478442808115
STAT,1854,24,20-24,1878,44.37644195119129
STAT,1882,28,45-49,1910,1.0592737854093675
STAT,1879,41,15-19,1920,0.014230774280570346
STAT,1875,46,30-34,1921,0.09968150846151945
STAT,1943,18,30-34,1961,12.773695622783078
SIM,1902,13,na,1915,3754
SIM,1879,30,25-29,1909,7
SIM,1915,18,20-24,1933,35
STAT,1880,19,50-100,1899,0.0505883791500461
SIM,1903,54,na,1957,2235
SIM,1898,30,35-39,1928,4
STAT,1820,79,na,1899,480.78313658512377
SIM,1896,30,30-34,1926,125
STAT,1875,35,20-24,1910,0.799065320768491
STAT,1835,19,15-19,1854,6.005412325746859
STAT,1924,18,20-24,1942,159.47793915542178
STAT,1834,31,40-44,1865,2.4737274573564374
STAT,1830,24,35-39,1854,13.705820696088875
STAT,1870,41,25-29,1911,0.6430843201774641
STAT,1891,18,15-19,1909,7.278767233249961
STAT,1850,17,15-19,1867,3.3486615816482908
SIM,1894,36,35-39,1930,61
STAT,1844,73,na,1917,1176.693367919384
SIM,1847,9,na,1856,1827
STAT,1873,24,30-34,1897,18.157094467100993
STAT,1913,15,40-44,1928,0.2837029054520746
STAT,1927,31,50-100,1958,1.009355444511051
SIM,1845,24,20-24,1869,63
SIM,1864,7,na,1871,2555
STAT,1861,53,20-24,1914,6.038320818442996E-4
STAT,1872,43,25-29,1915,0.6383850001356874
STAT,1820,50,25-29,1870,0.005590208265821327
STAT,1807,81,na,1888,245.75239982510715
STAT,1862,86,na,1948,188.98104805159556
STAT,1853,10,na,1863,2254.575613210342
SIM,1920,26,na,1946,3455
STAT,1782,72,na,1854,1623.0
STAT,1853,45,40-44,1898,0.13406997106047688
STAT,1803,52,20-24,1855,0.0016119999857595547
SIM,1917,18,25-29,1935,11
STAT,1922,41,40-44,1963,0.2842993905002284
SIM,1892,25,20-24,1917,30
STAT,1830,26,30-34,1856,24.389076428993608
STAT,1959,3,na,1962,5099.61422114531
SIM,1849,57,na,1906,1844
STAT,1922,17,50-100,1939,0.428757250965542
STAT,1854,26,50-100,1880,0.4127092831560911
STAT,1819,106,na,1925,0.0028240643508775274
STAT,1847,48,20-24,1895,0.010713080749324437
STAT,1861,40,45-49,1901,1.257229435509671
STAT,1843,21,40-44,1864,2.6030260243320016
STAT,1881,32,40-44,1913,4.0953685356566245
STAT,1869,36,35-39,1905,7.171508441346507
STAT,1849,48,25-29,1897,0.047923469304806114
STAT,1909,18,25-29,1927,8.389655848291785
STAT,1861,45,na,1906,1889.7179418529404
SIM,1841,53,na,1894,77
STAT,1943,29,40-44,1972,4.902533893447142
STAT,1814,41,40-44,1855,8.334043578477342
STAT,1907,18,20-24,1925,25.79987133507231
SIM,1849,33,na,1882,2288
STAT,1936,32,25-29,1968,8.888389074513901
STAT,1862,37,30-34,1899,4.539420040396929
STAT,1821,34,40-44,1855,5.776450052876386
STAT,1835,41,50-100,1876,0.97011901219919
SIM,1890,28,20-24,1918,57
STAT,1880,17,25-29,1897,5.882939367154644
STAT,1934,24,15-19,1958,7.100468817571665
SIM,1826,29,na,1855,1905
SIM,1870,32,30-34,1902,310
STAT,1892,1,na,1893,3369.9260992804097
STAT,1919,37,50-100,1956,0.44506365848146584
STAT,1891,43,na,1934,2821.6665758093905
STAT,1857,19,20-24,1876,15.801810360839626
SIM,1875,39,35-39,1914,20
STAT,1910,23,15-19,1933,4.927766754937622
STAT,1867,39,35-39,1906,6.62175190725132
STAT,1897,36,40-44,1933,5.841532038916216
STAT,1858,38,25-29,1896,2.187834343446192
STAT,1859,16,20-24,1875,16.407491042543473
STAT,1847,48,50-100,1895,0.2192610439883884
STAT,1819,82,na,1901,108.52351051688277
STAT,1915,15,45-49,1930,0.10355325013732747
STAT,1811,86,na,1897,134.41944026026076
STAT,1815,92,na,1907,2.936516751965704
STAT,1834,37,25-29,1871,1.5783479001569998
SIM,1864,24,30-34,1888,2
SIM,1837,48,na,1885,1802
STAT,1838,40,15-19,1878,0.007073168746896493
SIM,1903,43,50-100,1946,1
STAT,1863,50,20-24,1913,6.390237989757299E-4
STAT,1926,29,40-44,1955,5.50000919873348
STAT,1927,6,na,1933,4942.957760093325
STAT,1832,88,na,1920,116.53652664104547
STAT,1847,37,35-39,1884,6.634835797863199
STAT,1823,47,20-24,1870,0.018722817718563656
STAT,1872,40,50-100,1912,1.0685627065760641
STAT,1882,47,na,1929,2143.9784848570866
STAT,1919,20,30-34,1939,31.239425663648504
STAT,1873,86,na,1959,319.59301062653765
STAT,1956,16,15-19,1972,59.54484437668103
STAT,1814,51,na,1865,1964.574835881155
STAT,1863,16,40-44,1879,0.17923363222793248
STAT,1839,27,35-39,1866,11.293247244434093
SIM,1854,17,25-29,1871,107
STAT,1864,34,30-34,1898,15.736840454019028
STAT,1870,2,na,1872,3312.1868864614685
STAT,1940,21,35-39,1961,9.487453850751818
STAT,1874,54,45-49,1928,0.01456589755650293
STAT,1926,18,30-34,1944,14.777132168177163
STAT,1858,46,30-34,1904,0.07413258450687488
STAT,1916,52,na,1968,3654.19533643752
STAT,1847,48,45-49,1895,0.21069058007428026
STAT,1833,89,na,1922,43.22292679755882
STAT,1890,38,20-24,1928,0.9285666167784491
STAT,1906,22,40-44,1928,3.0175039545484474
STAT,1930,15,40-44,1945,1.803965257528824
SIM,1864,35,40-44,1899,8
STAT,1874,34,50-100,1908,0.9375302762868973
STAT,1899,49,20-24,1948,0.009052515030350611
SIM,1845,43,na,1888,2336
STAT,1890,42,na,1932,2794.558851338375
STAT,1882,28,20-24,1910,11.192275849169953
STAT,1934,35,25-29,1969,1.3518679272071363
STAT,1869,25,na,1894,2424.535366652367
STAT,1898,22,na,1920,3180.320580020106
STAT,1791,89,na,1880,48.864260120397255
STAT,1896,46,45-49,1942,0.17598565319546283
STAT,1846,17,25-29,1863,4.2160417640940455
STAT,1936,23,35-39,1959,8.909786536057199
STAT,1874,71,na,1945,1377.6030135026847
STAT,1938,31,45-49,1969,1.56620108080509
STAT,1839,38,45-49,1877,2.1903968633324564
STAT,1877,46,40-44,1923,0.174282021537754
STAT,1865,28,15-19,1893,0.4127682896677736
STAT,1916,25,50-100,1941,1.02200616083172
STAT,1830,27,45-49,1857,1.067625510370444
STAT,1864,35,45-49,1899,1.8295025743465765
SIM,1900,7,na,1907,4181
STAT,1856,24,30-34,1880,14.646121995043954
STAT,1836,47,30-34,1883,0.07762646921469686
STAT,1818,84,na,1902,202.47753889854684
STAT,1893,18,25-29,1911,7.067835191175366
STAT,1848,63,na,1911,1669.7065107184135
SIM,1869,93,na,1962,836
STAT,1867,25,15-19,1892,0.4319911520710588
STAT,1908,34,15-19,1942,0.11932935955097253
SIM,1828,71,na,1899,830
SIM,1882,18,15-19,1900,11
SIM,1836,47,na,1883,1859
STAT,1938,20,35-39,1958,9.225524138364335
STAT,1871,17,50-100,1888,0.0491871668540656
STAT,1903,44,35-39,1947,0.17608934481438326
STAT,1858,81,na,1939,412.96254682139363
STAT,1812,45,25-29,1857,0.015505090799848383
STAT,1897,25,30-34,1922,33.669758211272466
STAT,1841,84,na,1925,370.4420958648512
SIM,1911,44,35-39,1955,1
STAT,1812,42,15-19,1854,0.00669291175289678
STAT,1918,19,50-100,1937,0.40013326976938146
STAT,1908,45,25-29,1953,0.04830131596551238
SIM,1882,35,na,1917,1881
STAT,1903,42,na,1945,3288.10808287659
SIM,1889,14,na,1903,3886
SIM,1886,49,na,1935,2887
STAT,1834,48,35-39,1882,0.06460139871622475
STAT,1849,45,45-49,1894,0.20083414936622543
STAT,1826,38,35-39,1864,11.268513330472908
STAT,1901,47,35-39,1948,0.10990459248885943
STAT,1971,0,na,1971,4965.563957494344
STAT,1861,17,20-24,1878,16.946302544658852
STAT,1936,21,15-19,1957,5.040375240278876
SIM,1858,29,30-34,1887,2
SIM,1927,36,40-44,1963,2
STAT,1931,19,50-100,1950,0.48432947079605687
STAT,1788,69,na,1857,270.933404587512
SIM,1944,2,na,1946,2673
STAT,1832,24,45-49,1856,0.8815944147912101
STAT,1895,28,30-34,1923,32.64313062036672
STAT,1893,29,35-39,1922,11.980013664294846
STAT,1850,17,45-49,1867,0.03685922844278472
STAT,1877,76,na,1953,961.7287275631849
STAT,1914,31,35-39,1945,9.107844265077198
STAT,1810,48,25-29,1858,2.98472508515562E-4
STAT,1951,18,na,1969,4340.878811294535
SIM,1878,14,na,1892,4356
STAT,1828,37,30-34,1865,7.163104776321494
SIM,1870,50,na,1920,1330
STAT,1881,30,15-19,1911,0.13556335699267505
STAT,1840,34,45-49,1874,0.8191311791935432
STAT,1881,35,45-49,1916,1.9004234714361856
STAT,1888,45,50-100,1933,0.2862886053285592
STAT,1927,30,30-34,1957,19.24457780469943
STAT,1876,19,30-34,1895,1.60261459123557
STAT,1860,24,45-49,1884,0.5780323559981341
STAT,1864,48,20-24,1912,0.010772198821091176
STAT,1900,16,15-19,1916,8.241237714304184
STAT,1821,51,50-100,1872,0.015900120547439996
STAT,1876,28,20-24,1904,11.817673188592186
STAT,1855,51,30-34,1906,0.003958463913133651
STAT,1865,28,45-49,1893,1.010128620659666
STAT,1886,39,45-49,1925,2.043578539117576
STAT,1879,43,na,1922,2353.8345357411345
STAT,1893,15,45-49,1908,0.08206714215026033
STAT,1905,26,50-100,1931,0.9232401812622171
STAT,1890,58,na,1948,2394.0938833778714
STAT,1860,35,30-34,1895,4.389119666304862
STAT,1814,44,45-49,1858,5.092431782389674
STAT,1932,39,na,1971,5009.047358945693
STAT,1888,63,na,1951,2059.3791959170157
STAT,1864,30,15-19,1894,0.13050433986575347
STAT,1828,37,25-29,1865,3.869723248724473
SIM,1965,5,na,1970,4974
STAT,1894,42,50-100,1936,0.09317679335605424
SIM,1869,5,na,1874,3913
STAT,1908,41,50-100,1949,0.10847205833984484
STAT,1889,17,45-49,1906,0.07866299451052645
STAT,1789,67,na,1856,1253.91654556
STAT,1865,35,na,1900,2171.4142878272532
STAT,1871,25,35-39,1896,9.690527793950633
SIM,1884,28,20-24,1912,1
STAT,1804,92,na,1896,26.38908507371741
STAT,1857,40,na,1897,1791.4520548036112
STAT,1880,17,30-34,1897,1.6546826601879614
SIM,1851,12,na,1863,1456
STAT,1854,27,25-29,1881,24.656981847019868
STAT,1877,32,20-24,1909,2.74392993262931
STAT,1918,41,15-19,1959,0.0016130683058336109
STAT,1838,44,30-34,1882,0.5090769381856984
STAT,1944,24,na,1968,3895.861004514246
STAT,1837,26,40-44,1863,3.105167932595882
SIM,1862,27,25-29,1889,133
SIM,1922,6,na,1928,3756
STAT,1877,43,30-34,1920,1.1586210962934778
STAT,1873,48,50-100,1921,0.2487659474796743
SIM,1946,20,35-39,1966,593
SIM,1837,32,na,1869,1916
STAT,1858,54,50-100,1912,0.011216268877091394
STAT,1911,18,40-44,1929,0.27601802399037056
STAT,1919,17,na,1936,4013.519930448661
SIM,1885,32,20-24,1917,11
SIM,1823,34,40-44,1857,12
STAT,1937,16,35-39,1953,4.049880442481035
SIM,1924,16,na,1940,5281
STAT,1861,61,na,1922,1554.0376124343175
STAT,1865,75,na,1940,939.8896811522185
STAT,1876,78,na,1954,789.8555073723561
SIM,1886,25,na,1911,3126
STAT,1879,45,30-34,1924,0.10029128826941691
STAT,1877,60,na,1937,1936.016893351823
STAT,1834,34,45-49,1868,0.9641935779008021
STAT,1808,47,25-29,1855,0.1052777092892798
STAT,1926,15,20-24,1941,165.562753627425
SIM,1862,15,na,1877,3747
STAT,1845,15,na,1860,1456.754013752601
SIM,1866,29,na,1895,3174
STAT,1875,49,35-39,1924,0.14075772684271443
STAT,1922,44,45-49,1966,0.18826837161264764
STAT,1854,27,30-34,1881,14.678221962260396
STAT,1849,45,20-24,1894,0.01021190628752228
SIM,1862,27,30-34,1889,105
STAT,1891,5,na,1896,3222.674524366313
STAT,1894,49,45-49,1943,0.16575323023170663
STAT,1895,28,25-29,1923,54.8350529925037
STAT,1844,51,25-29,1895,0.003525822220366679
STAT,1882,25,40-44,1907,2.887440953918267
STAT,1841,24,40-44,1865,2.897496045927036
STAT,1881,41,30-34,1922,1.0905991016478636
STAT,1870,81,na,1951,539.1060518792438
STAT,1866,32,45-49,1898,1.5917935323857295
SIM,1798,56,na,1854,42
SIM,1850,73,na,1923,644
STAT,1945,26,40-44,1971,5.059429717935458
STAT,1837,28,50-100,1865,0.6536100511151088
SIM,1824,81,na,1905,857
STAT,1855,92,na,1947,27.56510110661427
SIM,1833,58,na,1891,1984
STAT,1881,30,20-24,1911,2.5731458672242824
STAT,1846,53,25-29,1899,0.002064113252654528
SIM,1842,34,45-49,1876,14
STAT,1887,18,25-29,1905,6.220874564002395
STAT,1874,51,35-39,1925,0.008927633615108363
STAT,1819,48,45-49,1867,0.042994358309548834
STAT,1929,42,35-39,1971,0.2589488806413514
STAT,1910,39,30-34,1949,1.706250406607593
STAT,1875,38,25-29,1913,2.9418457358438586
STAT,1900,37,na,1937,3289.4538276652243
SIM,1882,75,na,1957,953
SIM,1953,13,na,1966,4654
STAT,1803,54,40-44,1857,0.022014721533369534
STAT,1788,103,na,1891,0.01732868062608523
SIM,1844,31,20-24,1875,3
STAT,1956,16,45-49,1972,0.6554191780675044
STAT,1855,42,40-44,1897,1.4868200109624423
STAT,1903,44,40-44,1947,0.21872680300829378
STAT,1894,32,na,1926,3034.572821167927
STAT,1810,61,na,1871,69.50710206636477
STAT,1835,27,20-24,1862,11.568445490102572
STAT,1865,17,35-39,1882,0.5162368970356364
STAT,1821,64,na,1885,893.0254592322142
STAT,1947,20,30-34,1967,32.16295950969986
SIM,1879,35,30-34,1914,11
STAT,1866,41,35-39,1907,1.6604238907861952
SIM,1896,33,35-39,1929,1
SIM,1883,38,25-29,1921,21
STAT,1870,45,40-44,1915,0.17237650809216254
STAT,1921,21,25-29,1942,103.40419756455945
STAT,1828,43,na,1871,1766.9229833327747
STAT,1848,16,45-49,1864,0.07622510551242324
STAT,1888,33,35-39,1921,11.63896740607083
STAT,1836,78,na,1914,597.9828139089043
STAT,1906,3,na,1909,3828.181740880046
STAT,1843,37,20-24,1880,0.8891392980603123
STAT,1907,16,na,1923,3694.154661425632
SIM,1849,17,na,1866,2604
STAT,1917,24,15-19,1941,5.547085904909315
STAT,1823,33,30-34,1856,40.366424211735314
STAT,1825,41,40-44,1866,3.0401475550145274
STAT,1858,35,20-24,1893,0.5942604434126391
STAT,1853,45,35-39,1898,0.10963665883032753
STAT,1874,19,20-24,1893,18.198900375709584
STAT,1876,15,15-19,1891,6.027158598726205
SIM,1826,45,na,1871,1920
STAT,1915,28,20-24,1943,18.290988768841647
STAT,1901,47,40-44,1948,0.13439761564786892
STAT,1891,27,na,1918,2934.77623753219
SIM,1875,36,30-34,1911,18
STAT,1886,53,na,1939,2193.972710167941
STAT,1891,25,50-100,1916,0.7919849998318034
STAT,1853,34,25-29,1887,8.010517265229343
SIM,1934,18,25-29,1952,104
STAT,1855,42,35-39,1897,1.1969870998268248
STAT,1946,16,50-100,1962,0.41117150028681154
STAT,1908,30,20-24,1938,2.3029294360914334
SIM,1853,22,na,1875,3553
SIM,1875,25,20-24,1900,13
STAT,1791,92,na,1883,14.820373259656247
STAT,1937,16,40-44,1953,1.3499602256547647
STAT,1863,53,25-29,1916,0.0029753086381799055
STAT,1874,51,40-44,1925,0.010917220509870434
SIM,1938,23,35-39,1961,77
SIM,1780,74,na,1854,615
SIM,1869,101,na,1970,111
SIM,1893,75,na,1968,1146
STAT,1828,99,na,1927,1.2820158131156332
STAT,1820,101,na,1921,0.3924247456130284
STAT,1817,59,na,1876,740.496507795103
STAT,1885,41,45-49,1926,1.4777779804938864
STAT,1892,32,40-44,1924,5.369261943881516
STAT,1919,22,20-24,1941,120.14283333434415
SIM,1872,32,35-39,1904,99
SIM,1817,71,na,1888,1947
STAT,1842,47,na,1889,558.6038529297412
STAT,1862,47,35-39,1909,0.11868782311959822
STAT,1855,45,45-49,1900,0.1577505886247747
STAT,1862,35,40-44,1897,3.76390873364813
STAT,1901,5,na,1906,3664.2165752122232
STAT,1921,24,35-39,1945,10.44325918618793
STAT,1819,43,15-19,1862,0.002898282040056863
STAT,1918,16,na,1934,4171.007256491176
STAT,1861,0,na,1861,3216.496873097946
SIM,1834,40,na,1874,986
STAT,1868,37,50-100,1905,1.1858409562927736
SIM,1916,30,20-24,1946,2
STAT,1910,36,na,1946,3575.0202927806226
STAT,1890,24,30-34,1914,21.42868703097486
STAT,1909,17,40-44,1926,0.2715013895078903
SIM,1852,77,na,1929,1138
SIM,1908,28,25-29,1936,1
STAT,1886,34,15-19,1920,0.14620769923802307
SIM,1841,37,na,1878,695
STAT,1877,17,na,1894,2563.794173709338
STAT,1917,23,25-29,1940,96.561692589799
STAT,1908,17,na,1925,3717.4966940616882
STAT,1910,34,30-34,1944,14.89274904165038
STAT,1839,24,30-34,1863,20.958986588745567
STAT,1853,46,25-29,1899,0.04478919343012768
STAT,1890,22,35-39,1912,7.064474581796863
STAT,1901,33,15-19,1934,0.1982763004880373
SIM,1854,63,na,1917,347
STAT,1919,20,25-29,1939,100.39813626782559
SIM,1913,13,na,1926,3634
STAT,1908,49,40-44,1957,0.1406531455750157
STAT,1863,19,45-49,1882,0.057227672934242316
STAT,1920,44,35-39,1964,0.21880637929024596
SIM,1918,2,na,1920,4571
STAT,1823,31,35-39,1854,44.05112337741811
SIM,1900,65,na,1965,3568
STAT,1839,35,40-44,1874,4.962090513127368
SIM,1861,34,25-29,1895,46
STAT,1812,49,40-44,1861,0.042699800930170846
STAT,1864,6,na,1870,2578.2395827607834
STAT,1941,18,20-24,1959,138.0134016468199
STAT,1867,29,30-34,1896,23.64506736688513
STAT,1821,46,35-39,1867,0.15175199262950692
STAT,1875,35,45-49,1910,2.0664570192743588
STAT,1908,38,30-34,1946,1.684816816737337
STAT,1817,46,15-19,1863,2.8396418432642386E-4
STAT,1886,22,15-19,1908,3.4163046626214846
STAT,1808,82,na,1890,109.27534758063143
STAT,1828,26,50-100,1854,1.4526415857779025
STAT,1949,23,15-19,1972,6.148209143286929
STAT,1907,18,15-19,1925,8.636397619093309
STAT,1884,37,15-19,1921,0.05375521196962239
STAT,1912,37,45-49,1949,0.6576387570982367
SIM,1925,23,25-29,1948,5
SIM,1942,20,20-24,1962,41
SIM,1875,25,na,1900,3086
SIM,1828,55,na,1883,1714
STAT,1855,44,30-34,1899,0.7506217487806797
SIM,1833,41,40-44,1874,12
SIM,1824,41,na,1865,2105
STAT,1865,91,na,1956,59.865656262179
STAT,1933,39,50-100,1972,0.5667811771285541
STAT,1821,35,25-29,1856,3.7520987474961114
SIM,1890,28,15-19,1918,5
STAT,1848,101,na,1949,0.533975037104322
SIM,1838,30,na,1868,2256
SIM,1879,36,45-49,1915,2
STAT,1870,43,15-19,1913,0.013668023500827155
STAT,1917,35,25-29,1952,1.018610566790318
STAT,1859,51,45-49,1910,0.011557467002843345
STAT,1868,42,20-24,1910,0.15320402756571816
STAT,1930,18,45-49,1948,0.6396134167217938
SIM,1847,35,40-44,1882,13
STAT,1854,11,na,1865,1595.064302313873
STAT,1858,25,na,1883,1892.7703307542074
STAT,1867,61,na,1928,1767.2248371055273
STAT,1829,44,na,1873,928.4041367205037
STAT,1830,24,40-44,1854,4.894252051635791
SIM,1860,29,na,1889,2134
STAT,1873,25,45-49,1898,1.146653169107511
STAT,1873,21,50-100,1894,0.41956598589903255
STAT,1938,33,40-44,1971,3.890317451376429
SIM,1925,35,25-29,1960,2
STAT,1945,0,na,1945,4811.786896587758
STAT,1816,41,45-49,1857,5.0525527807706
STAT,1856,23,40-44,1879,1.7257998064022348
SIM,1812,56,na,1868,1143
SIM,1897,68,na,1965,1419
STAT,1845,33,15-19,1878,0.08315318630016519
STAT,1839,43,na,1882,2234.34428111622
STAT,1853,66,na,1919,1270.8699421966896
STAT,1870,30,45-49,1900,1.7524482219523874
STAT,1866,20,na,1886,2208.082178228441
STAT,1816,54,20-24,1870,0.002075107659049535
STAT,1844,43,50-100,1887,1.0582631440205021
STAT,1826,35,30-34,1861,9.176594229072062
STAT,1837,29,45-49,1866,1.1263143494384333
SIM,1865,3,na,1868,2114
SIM,1896,27,na,1923,2671
STAT,1903,32,50-100,1935,1.3006208377219668
STAT,1883,45,20-24,1928,0.011659612684199681
STAT,1846,50,20-24,1896,4.433212323929978E-4
STAT,1894,35,25-29,1929,3.6961280096732088
STAT,1931,38,na,1969,4942.529654221789
STAT,1837,18,35-39,1855,0.5829301178565996
SIM,1873,39,na,1912,2102
STAT,1919,39,45-49,1958,0.721111717911147
STAT,1936,35,35-39,1971,2.355042920489702
STAT,1882,28,15-19,1910,0.43285045067606953
SIM,1872,34,30-34,1906,3
STAT,1901,45,15-19,1946,3.1862889437409903E-4
SIM,1844,45,40-44,1889,1
STAT,1833,37,50-100,1870,0.6644380970953854
SIM,1864,65,na,1929,1565
STAT,1893,26,30-34,1919,31.598733819729116
STAT,1916,44,15-19,1960,0.0015471012801273993
STAT,1831,63,na,1894,1396.485794876789
STAT,1877,47,25-29,1924,0.05819833704786029
STAT,1831,41,40-44,1872,2.227981083375471
STAT,1822,50,35-39,1872,0.014435095997446974
SIM,1874,24,na,1898,2582
STAT,1827,58,na,1885,1464.058198116915
STAT,1861,41,50-100,1902,0.8825661866379609
SIM,1860,19,15-19,1879,69
STAT,1925,45,30-34,1970,0.10753859983931827
STAT,1805,51,40-44,1856,0.012586222984584698
STAT,1941,19,na,1960,3745.6356200583946
STAT,1862,21,15-19,1883,2.897280230706534
STAT,1893,15,20-24,1908,22.273026857859943
STAT,1828,35,35-39,1863,9.928306429844001
SIM,1942,28,30-34,1970,1
SIM,1860,51,na,1911,2000
STAT,1934,20,20-24,1954,148.9061293722287
STAT,1886,36,40-44,1922,4.554941645455252
STAT,1887,15,20-24,1902,19.60398092140025
SIM,1834,24,20-24,1858,9
SIM,1912,50,na,1962,4528
STAT,1822,52,25-29,1874,0.0057075922082851956
SIM,1870,10,na,1880,2671
STAT,1852,19,15-19,1871,7.140041178802939
SIM,1885,64,na,1949,489
STAT,1909,42,na,1951,3438.4154221252993
STAT,1888,36,45-49,1924,2.311883920586214
SIM,1857,45,45-49,1902,4
SIM,1881,50,na,1931,2701
SIM,1894,36,40-44,1930,52
STAT,1949,23,45-49,1972,1.2995597583150034
STAT,1856,35,40-44,1891,3.174017395611804
STAT,1948,20,50-100,1968,0.7482950992606813
SIM,1935,33,35-39,1968,8
SIM,1885,24,na,1909,1801
SIM,1801,53,na,1854,1904
STAT,1927,33,35-39,1960,11.142806298409116
STAT,1819,45,40-44,1864,0.03108067978164011
STAT,1934,28,30-34,1962,52.328190117808894
STAT,1836,46,25-29,1882,0.046786549214401625
STAT,1872,42,40-44,1914,2.2495609485957027
SIM,1851,15,na,1866,1433
STAT,1876,15,45-49,1891,0.06634185337474229
SIM,1819,35,35-39,1854,17
SIM,1876,50,na,1926,3357
STAT,1922,21,na,1943,4153.563098008944
STAT,1871,23,15-19,1894,3.2807514569369176
STAT,1907,32,na,1939,3511.476567256627
SIM,1910,8,na,1918,4577
STAT,1785,77,na,1862,147.3723420891318
STAT,1842,44,20-24,1886,0.039757002956754856
SIM,1831,75,na,1906,736
STAT,1863,25,na,1888,2066.9795011725523
SIM,1794,66,na,1860,745
SIM,1872,14,na,1886,2546
STAT,1878,26,35-39,1904,9.961554111311129
STAT,1926,18,25-29,1944,52.537549741375585
SIM,1905,18,na,1923,3792
STAT,1842,26,na,1868,668.9082035033052
STAT,1846,19,45-49,1865,0.04802907451911792
STAT,1885,12,na,1897,2538.4756892350865
SIM,1867,16,20-24,1883,195
STAT,1817,45,30-34,1862,0.06963635142519399
STAT,1847,35,45-49,1882,1.9092547317094386
STAT,1855,76,na,1931,627.0262922762297
STAT,1836,45,40-44,1881,0.14085308209376252
STAT,1843,29,15-19,1872,0.543792848628058
STAT,1894,46,35-39,1940,0.10071010981067625
STAT,1933,24,na,1957,4807.780335861383
STAT,1894,47,25-29,1941,0.04112508226860007
STAT,1899,20,35-39,1919,8.018047854536718
STAT,1841,27,15-19,1868,0.6275166411532461
STAT,1869,65,na,1934,1705.3105569800937
STAT,1827,44,25-29,1871,0.5932435176165067
STAT,1826,29,15-19,1855,1.4326724101187533
SIM,1910,24,25-29,1934,9
SIM,1954,3,na,1957,5556
STAT,1883,32,45-49,1915,1.6776322744449148
STAT,1865,25,40-44,1890,2.753477701603372
STAT,1867,25,45-49,1892,1.057170905570141
STAT,1921,37,40-44,1958,1.651691143267553
STAT,1852,18,30-34,1870,1.9289952983121414
STAT,1862,34,20-24,1896,2.28259459832059
SIM,1848,32,na,1880,2316
SIM,1918,33,35-39,1951,39
STAT,1858,47,15-19,1905,3.0404136684345477E-4
SIM,1905,5,na,1910,3894
STAT,1902,24,25-29,1926,80.10636614595613
STAT,1892,47,20-24,1939,0.008341585603001574
STAT,1807,97,na,1904,2.178192002478603
STAT,1867,36,30-34,1903,5.064601373115197
STAT,1876,75,na,1951,1040.6914822565805
STAT,1897,26,45-49,1923,1.4796004484748169
STAT,1865,51,na,1916,1975.228586391606
STAT,1851,31,40-44,1882,3.602131991941933
STAT,1839,32,50-100,1871,1.04756464639413
SIM,1892,36,30-34,1928,11
STAT,1825,48,50-100,1873,0.30790340351323986
STAT,1853,31,20-24,1884,2.180893367453604
STAT,1898,43,45-49,1941,0.13874653271011697
SIM,1820,44,35-39,1864,2
STAT,1912,20,15-19,1932,5.0723440903051396
STAT,1863,51,35-39,1914,0.007384825010918706
STAT,1809,45,na,1854,3157.6956597895696
STAT,1850,53,45-49,1903,0.0065936802095128465
SIM,1884,39,na,1923,3657
STAT,1908,33,25-29,1941,8.620292001329384
SIM,1881,34,35-39,1915,17
STAT,1853,4,na,1857,2486.142530530344
STAT,1897,47,50-100,1944,0.18312903675459297
STAT,1806,56,na,1862,946.8489637992258
STAT,1887,38,na,1925,2580.298825196451
STAT,1833,33,na,1866,1134.4078814826235
STAT,1912,31,25-29,1943,9.025774420472471
STAT,1921,39,na,1960,4142.161415523622
STAT,1901,49,30-34,1950,0.07475304008978251
STAT,1947,23,35-39,1970,10.526159549076997
STAT,1904,24,35-39,1928,8.284934786834569
STAT,1892,68,na,1960,2022.6606144388188
STAT,1888,30,30-34,1918,20.313351663746708
SIM,1907,0,na,1907,5303
STAT,1862,44,30-34,1906,0.9660019722992714
STAT,1939,16,45-49,1955,0.4946712484796411
STAT,1932,27,15-19,1959,0.9182189878182091
STAT,1942,25,50-100,1967,1.0336404325930149
STAT,1885,40,50-100,1925,1.04891692727573
STAT,1840,33,30-34,1873,8.287013782789947
STAT,1884,36,30-34,1920,5.1264132206806385
STAT,1838,42,35-39,1880,0.9040061207022794
STAT,1873,34,35-39,1907,10.299198872110226
STAT,1884,25,20-24,1909,11.306383830607274
SIM,1800,68,na,1868,216
STAT,1843,51,na,1894,2137.604929312619
STAT,1906,20,45-49,1926,1.0157962883807516
STAT,1836,44,20-24,1880,0.1411089429924211
STAT,1880,80,na,1960,819.859454568457
SIM,1872,76,na,1948,767
STAT,1929,25,50-100,1954,1.2416689552372249
STAT,1864,10,na,1874,2498.0297126058404
SIM,1862,36,na,1898,3659
STAT,1875,52,50-100,1927,0.015425733319677271
STAT,1831,50,30-34,1881,0.005137291845112931
STAT,1897,39,15-19,1936,0.015934606884969085
SIM,1831,78,na,1909,187
STAT,1910,35,15-19,1945,0.01833298637069579
STAT,1930,35,na,1965,4881.2728383176
STAT,1845,17,50-100,1862,0.03072648076413578
STAT,1903,47,45-49,1950,0.18808952934662718
STAT,1917,53,na,1970,3705.542325697379
STAT,1937,7,na,1944,3848.539155659166
STAT,1864,46,50-100,1910,0.22391039377433067
STAT,1899,23,na,1922,3220.36077854275
STAT,1910,7,na,1917,3903.69444547843
STAT,1849,52,50-100,1901,0.012657709954418079
STAT,1892,35,45-49,1927,2.491563661145697
STAT,1853,42,30-34,1895,0.8903422458844266
STAT,1875,47,15-19,1922,4.088256504647716E-4
STAT,1825,44,45-49,1869,1.9260872934771232
STAT,1928,26,40-44,1954,5.718252917077238
SIM,1920,31,25-29,1951,22
STAT,1878,61,na,1939,1922.5816457275369
STAT,1799,69,na,1868,139.86462746231498
STAT,1821,48,na,1869,1295.4997374788147
SIM,1814,43,35-39,1857,4
SIM,1842,31,40-44,1873,44
STAT,1929,19,na,1948,4639.474055442587
SIM,1874,40,na,1914,2473
SIM,1833,44,45-49,1877,3
STAT,1913,18,45-49,1931,0.10058962273956218
SIM,1836,35,35-39,1871,26
STAT,1855,14,na,1869,1862.1812696573481
STAT,1942,20,na,1962,3787.7558600314
SIM,1887,50,na,1937,3252
STAT,1905,41,35-39,1946,0.18168231804232482
STAT,1920,30,50-100,1950,0.9011635545263392
STAT,1877,45,20-24,1922,0.012302888413984633
SIM,1884,61,na,1945,3459
STAT,1821,43,30-34,1864,1.271403392192694
STAT,1868,45,25-29,1913,0.05618880964304403
STAT,1895,26,35-39,1921,12.595100702471838
SIM,1886,28,25-29,1914,226
STAT,1954,2,na,1956,4821.854176158272
STAT,1845,106,na,1951,0.006024913060864275
STAT,1929,16,na,1945,4675.944817203671
SIM,1906,19,30-34,1925,1
SIM,1840,33,35-39,1873,1
STAT,1845,21,15-19,1866,2.046966619777417
SIM,1861,14,na,1875,2602
STAT,1840,46,45-49,1886,0.09491683095863225
STAT,1789,102,na,1891,0.1246673447534907
STAT,1792,74,na,1866,584.1111374578572
STAT,1897,2,na,1899,3540.1348520818096
STAT,1810,107,na,1917,1.468292107596559E-4
STAT,1823,49,50-100,1872,0.3723854618098416
SIM,1851,24,20-24,1875,2
SIM,1914,54,na,1968,4713
STAT,1888,60,na,1948,2201.1975521823624
STAT,1842,31,45-49,1873,0.5284053627459642
STAT,1877,23,50-100,1900,0.41267721671478663
SIM,1901,34,30-34,1935,15
STAT,1876,51,45-49,1927,0.014740909720215677
STAT,1892,22,50-100,1914,0.5048827895752739
SIM,1903,14,na,1917,2994
SIM,1869,23,25-29,1892,52
SIM,1873,28,15-19,1901,1
STAT,1881,34,30-34,1915,16.346881050848296
SIM,1925,28,30-34,1953,3
SIM,1927,4,na,1931,2100
STAT,1920,41,30-34,1961,0.13958281868254988
STAT,1908,22,15-19,1930,4.855907963156627
STAT,1917,20,20-24,1937,117.29735873129432
SIM,1816,41,40-44,1857,6
SIM,1896,24,na,1920,2816
STAT,1821,100,na,1921,0.5361489199209231
STAT,1843,24,20-24,1867,84.24228793364712
SIM,1905,32,40-44,1937,1
STAT,1834,74,na,1908,489.08966873143464
STAT,1875,32,40-44,1907,4.453166983160552
STAT,1816,108,na,1924,0.0015463895282470405
STAT,1894,16,50-100,1910,0.06245395299816242
STAT,1895,24,15-19,1919,4.264743342869872
STAT,1814,43,30-34,1857,3.905166713592974
STAT,1867,38,20-24,1905,0.7253990525379787
SIM,1840,52,na,1892,2550
STAT,1832,48,na,1880,2017.9016353275924
STAT,1906,37,15-19,1943,0.01755130409722296
STAT,1856,38,15-19,1894,0.04013316087093362
SIM,1935,16,na,1951,5802
STAT,1812,44,35-39,1856,0.5454268227448779
STAT,1864,32,35-39,1896,9.20657800475519
SIM,1822,43,30-34,1865,4
SIM,1926,42,na,1968,5889
STAT,1834,46,15-19,1880,2.0809420544295603E-4
STAT,1843,35,30-34,1878,6.2764279737635835
STAT,1879,22,50-100,1901,0.41832764929435706
STAT,1897,24,40-44,1921,2.7500819243173997
STAT,1842,40,35-39,1882,0.47715285915391725
STAT,1828,33,15-19,1861,0.2086537473512994
STAT,1872,51,30-34,1923,0.005989161949499563
STAT,1880,83,na,1963,648.767127819367
SIM,1838,33,na,1871,2181
SIM,1828,26,40-44,1854,23
STAT,1821,33,20-24,1854,3.770987483496966
STAT,1877,79,na,1956,748.452909357649
SIM,1899,16,na,1915,2080
STAT,1880,43,na,1923,2382.0909458333663
STAT,1827,52,50-100,1879,0.013365465641734051
SIM,1815,45,na,1860,2075
STAT,1887,17,40-44,1904,0.201316492430954
SIM,1859,32,na,1891,1943
STAT,1879,43,35-39,1922,1.8441860015658589
STAT,1877,44,20-24,1921,0.1590382492424147
STAT,1860,36,15-19,1896,0.04603093993992159
STAT,1826,37,20-24,1863,1.2595357403399738
STAT,1922,24,na,1946,4115.137112302052
SIM,1827,70,na,1897,974
STAT,1868,53,30-34,1921,0.005657081396904348
STAT,1931,31,35-39,1962,11.897012531312386
STAT,1893,28,20-24,1921,14.618866011704679
SIM,1891,41,35-39,1932,1
SIM,1856,29,20-24,1885,1
SIM,1827,30,na,1857,2507
STAT,1809,48,na,1857,3038.8747573071532
STAT,1854,25,35-39,1879,6.270203306688634
STAT,1908,22,45-49,1930,1.0264033691648315
STAT,1857,51,35-39,1908,0.0066378683535653505
SIM,1845,22,30-34,1867,21
STAT,1866,76,na,1942,864.8077864238487
STAT,1948,19,15-19,1967,51.37153720050962
STAT,1863,28,na,1891,2030.2325703885697
STAT,1843,29,na,1872,2592.824380829227
STAT,1899,36,20-24,1935,1.0579448386795127
STAT,1832,33,35-39,1865,0.6746485711404715
STAT,1883,41,35-39,1924,1.7499635799294773
STAT,1943,23,na,1966,3839.6409094148075
STAT,1831,44,45-49,1875,1.42398870803369
SIM,1855,48,50-100,1903,4
SIM,1885,7,na,1892,1916
STAT,1851,34,15-19,1885,0.11465769313807742
SIM,1834,37,20-24,1871,2
STAT,1830,29,35-39,1859,9.1452904212495
SIM,1827,31,15-19,1858,19
STAT,1779,92,na,1871,17.294556620315568
STAT,1899,47,30-34,1946,0.07423310937191448
STAT,1910,37,35-39,1947,2.2873989874870877
STAT,1810,45,50-100,1855,0.0013244206741486097
STAT,1878,28,25-29,1906,43.36943074017952
STAT,1882,17,35-39,1899,0.5253397631433475
STAT,1934,36,50-100,1970,0.5759887117738253
SIM,1866,103,na,1969,2
STAT,1869,23,20-24,1892,69.32347562593623
SIM,1860,88,na,1948,295
SIM,1870,47,35-39,1917,1
STAT,1816,50,35-39,1866,0.02621601995817327
STAT,1852,25,na,1877,2573.066046393114
STAT,1912,34,40-44,1946,3.773372336948489
STAT,1846,52,40-44,1898,0.006201922065571187
SIM,1864,62,na,1926,1986
STAT,1848,29,20-24,1877,12.918128174654962
STAT,1934,23,25-29,1957,123.25251084364577
STAT,1932,37,50-100,1969,0.5601932973573936
STAT,1827,41,20-24,1868,0.15276879000150104
STAT,1908,57,na,1965,3152.0169109374397
STAT,1805,54,45-49,1859,0.016313939081564643
STAT,1897,23,40-44,1920,2.7588550834828744
STAT,1923,22,40-44,1945,3.8710878542182194
STAT,1788,66,na,1854,303.0
STAT,1835,50,45-49,1885,0.011642436845424526
STAT,1875,13,na,1888,2662.3673809686807
SIM,1929,31,na,1960,6220
STAT,1858,49,35-39,1907,0.10468074010127276
STAT,1831,26,na,1857,2241.6118789399857
STAT,1829,54,30-34,1883,0.002327031112164163
STAT,1881,47,45-49,1928,0.2218270595763697
SIM,1847,47,na,1894,1415
SIM,1879,34,40-44,1913,6
STAT,1818,81,na,1899,329.13970853047346
STAT,1819,85,na,1904,63.76157519604331
STAT,1896,45,30-34,1941,0.0726971881028779
STAT,1851,34,45-49,1885,1.4040158397615223
STAT,1856,38,45-49,1894,1.4247270414832554
STAT,1909,15,20-24,1924,26.43850980997899
STAT,1847,21,50-100,1868,0.4552469391370833
SIM,1866,49,35-39,1915,1
STAT,1878,19,35-39,1897,0.561522389030048
STAT,1862,15,50-100,1877,0.048359554180017944
STAT,1836,54,30-34,1890,0.0044359641212869194
STAT,1943,25,25-29,1968,69.35933942931601
STAT,1891,15,40-44,1906,0.22596616551289692
STAT,1894,32,20-24,1926,3.437367728498143
STAT,1843,88,na,1931,135.64232877405357
STAT,1838,58,na,1896,843.3904350618336
STAT,1869,34,15-19,1903,0.14247069310168
STAT,1820,54,40-44,1874,0.015347915285403094
SIM,1826,48,na,1874,1919
STAT,1822,89,na,1911,60.57914579891304
STAT,1880,15,35-39,1895,0.572291492959173
SIM,1875,65,na,1940,2443
STAT,1859,19,25-29,1878,5.152347469938289
STAT,1932,3,na,1935,5333.473147271216
SIM,1918,30,30-34,1948,214
STAT,1888,45,35-39,1933,0.16319383089454195
STAT,1836,48,45-49,1884,0.18684540360245994
STAT,1872,40,20-24,1912,0.16063361254739442
STAT,1914,47,20-24,1961,0.010807633893388756
SIM,1896,64,na,1960,2219
STAT,1878,23,30-34,1901,18.269881148446814
STAT,1837,27,25-29,1864,43.53434119804513
STAT,1954,16,40-44,1970,1.7143337180906795
STAT,1827,52,30-34,1879,0.005267821976636832
STAT,1871,27,30-34,1898,25.12004364885057
STAT,1902,28,40-44,1930,4.203386362768814
STAT,1836,43,20-24,1879,0.14292842180196008
STAT,1857,42,45-49,1899,1.1470499897771929
STAT,1873,38,20-24,1911,0.786799105118838
STAT,1902,17,30-34,1919,2.244423881430431
SIM,1867,19,25-29,1886,1
SIM,1881,38,20-24,1919,4
SIM,1902,69,na,1971,2054
STAT,1872,45,45-49,1917,0.23867688164794448
SIM,1845,27,25-29,1872,33
STAT,1863,108,na,1971,0.026656554940771727
STAT,1898,44,50-100,1942,0.09731975592586292
STAT,1894,43,30-34,1937,0.10078988569320169
STAT,1846,16,40-44,1862,0.13688599832910214
SIM,1846,28,na,1874,1215
SIM,1905,40,na,1945,3097
SIM,1953,4,na,1957,4660
STAT,1831,41,35-39,1872,1.793670111913766
STAT,1844,18,35-39,1862,0.6869388504100565
STAT,1939,28,15-19,1967,0.7015589635413376
SIM,1881,31,30-34,1912,13
STAT,1809,61,na,1870,2347.244032043393
SIM,1908,32,20-24,1940,1
STAT,1871,1,na,1872,3502.3789608453503
STAT,1850,29,15-19,1879,0.24301485467347655
STAT,1948,17,na,1965,4169.219828631758
SIM,1827,33,na,1860,2333
STAT,1805,71,na,1876,248.6126918100254
STAT,1828,35,40-44,1863,6.144729516279786
STAT,1943,17,40-44,1960,1.4663031993848392
STAT,1852,15,20-24,1867,21.83975980327537
SIM,1855,22,30-34,1877,43
STAT,1876,52,20-24,1928,7.419974604520785E-4
STAT,1926,7,na,1933,4858.900306108577
SIM,1838,36,45-49,1874,5
STAT,1861,15,30-34,1876,1.54165094922527
SIM,1884,79,na,1963,1604
SIM,1909,30,na,1939,4083
SIM,1928,40,35-39,1968,1
STAT,1897,27,45-49,1924,1.4745402149410332
SIM,1808,88,na,1896,278
STAT,1834,39,15-19,1873,0.030150684941410256
STAT,1819,35,30-34,1854,4.035316098022675
STAT,1863,49,50-100,1912,0.20529395348757837
STAT,1916,48,30-34,1964,0.0899370468514231
STAT,1827,98,na,1925,2.2908438121429926
SIM,1829,34,na,1863,1786
STAT,1873,33,na,1906,2437.4994132012994
STAT,1889,29,20-24,1918,14.026336604213313
SIM,1880,89,na,1969,1627
STAT,1873,31,30-34,1904,17.98301320894135
STAT,1864,48,15-19,1912,3.590729781835465E-4
STAT,1879,24,na,1903,2410.9729019330116
SIM,1934,31,na,1965,5202
STAT,1834,46,20-24,1880,0.006242831654691281
STAT,1841,22,na,1863,3016.1823735540893
STAT,1828,28,35-39,1856,18.00137108651683
STAT,1877,23,na,1900,2393.3904642736
SIM,1838,70,na,1908,1075
STAT,1874,15,40-44,1889,0.19035291778623178
STAT,1843,11,na,1854,3028.0
SIM,1965,2,na,1967,4974
STAT,1836,47,25-29,1883,0.046190956442902296
SIM,1880,55,na,1935,3193
STAT,1834,44,50-100,1878,0.5470935497334594
STAT,1895,19,35-39,1914,0.7099726566254796
STAT,1861,48,na,1909,1847.5542472957275
STAT,1837,28,45-49,1865,1.1344597705912784
STAT,1854,23,15-19,1877,2.139781717256082
STAT,1896,48,35-39,1944,0.10279464802094959
STAT,1845,25,30-34,1870,15.430263776575673
STAT,1900,27,30-34,1927,34.88411864266992
STAT,1911,6,na,1917,3952.6503281554487
STAT,1823,38,50-100,1861,2.2483257973505664
STAT,1918,45,30-34,1963,0.09402593328844616
STAT,1923,25,15-19,1948,0.8074255223870939
SIM,1892,74,na,1966,2903
SIM,1842,38,na,1880,3057
STAT,1835,93,na,1928,22.11354370069388
STAT,1820,40,20-24,1860,0.27193987225984284
STAT,1855,30,na,1885,1641.847138512728
SIM,1842,16,na,1858,3359
STAT,1932,38,30-34,1970,2.4293185760837797
STAT,1854,25,40-44,1879,1.946619750194739
STAT,1910,30,15-19,1940,0.12350435833328587
SIM,1797,71,na,1868,802
SIM,1881,2,na,1883,4260
STAT,1840,52,50-100,1892,0.005915119254203361
STAT,1917,27,40-44,1944,4.822863492187199
STAT,1856,20,15-19,1876,2.7919424832979396
STAT,1823,47,15-19,1870,6.240933749783244E-4
STAT,1822,43,na,1865,1568.4742607423693
STAT,1947,22,35-39,1969,10.52963432840537
SIM,1921,7,na,1928,5353
STAT,1913,47,na,1960,3540.7964938437335
SIM,1933,22,15-19,1955,109
SIM,1922,12,na,1934,3724
STAT,1916,46,50-100,1962,0.22939240527304822
STAT,1886,26,30-34,1912,26.166608596913427
STAT,1792,71,na,1863,776.2240668533007
STAT,1866,41,40-44,1907,2.062471239546525
STAT,1919,24,40-44,1943,3.6101934485607594
SIM,1914,17,na,1931,5124
STAT,1825,44,15-19,1869,0.01777243302148714
STAT,1890,38,15-19,1928,0.0676439342362553
STAT,1812,42,50-100,1854,0.5120077116823931
STAT,1841,15,45-49,1856,0.09493160329216141
STAT,1865,52,45-49,1917,0.013179169419146977
STAT,1859,20,na,1879,1960.2142861989237
SIM,1910,27,na,1937,4296
SIM,1916,18,na,1934,4819
SIM,1915,17,15-19,1932,99
STAT,1871,34,30-34,1905,17.267713907504447
STAT,1852,87,na,1939,177.34145005853756
SIM,1943,14,na,1957,4981
STAT,1847,22,30-34,1869,19.742408522743972
STAT,1849,30,40-44,1879,4.320100788141665
STAT,1943,15,15-19,1958,47.60152555731236
STAT,1956,12,na,1968,5152.454576775904
STAT,1858,28,50-100,1886,0.49649512326701134
STAT,1843,39,25-29,1882,2.960016754577391
STAT,1845,47,35-39,1892,0.06914650720390374
STAT,1885,74,na,1959,1214.523744090788
STAT,1925,22,15-19,1947,6.3135121825607685
SIM,1898,53,na,1951,4038
STAT,1851,33,45-49,1884,1.41867070817699
STAT,1930,19,na,1949,4699.891548921628
SIM,1840,30,30-34,1870,62
STAT,1885,19,35-39,1904,0.5364608595040152
STAT,1892,35,15-19,1927,0.07018490020995914
STAT,1945,25,35-39,1970,16.303637357436816
STAT,1826,33,na,1859,2308.625120954144
STAT,1808,49,15-19,1857,5.552243402464822E-4
STAT,1860,36,20-24,1896,0.6318791869476451
SIM,1930,41,na,1971,5212
SIM,1843,25,30-34,1868,10
STAT,1839,83,na,1922,368.82715810473184
SIM,1817,49,na,1866,2632
STAT,1877,48,25-29,1925,0.057736242251700286
STAT,1899,24,45-49,1923,0.9464862341511492
STAT,1860,82,na,1942,380.63429281904104
STAT,1927,30,25-29,1957,11.289678487355646
STAT,1835,25,30-34,1860,25.192468178699833
STAT,1860,60,na,1920,1555.8622418613465
STAT,1820,60,na,1880,1400.9443457567065
STAT,1925,46,15-19,1971,4.4339193850962923E-4
STAT,1832,30,30-34,1862,2.825715489360318
SIM,1833,55,na,1888,2017
SIM,1879,15,na,1894,1848
STAT,1892,34,45-49,1926,2.140530869526554
STAT,1896,12,na,1908,3404.33746409242
STAT,1880,18,45-49,1898,0.0676371744297433
SIM,1852,44,25-29,1896,2
STAT,1880,27,35-39,1907,10.01707802208423
STAT,1830,36,35-39,1866,6.518761932111224
STAT,1850,41,45-49,1891,0.6942180755435573
STAT,1875,47,20-24,1922,0.0122647803024523
STAT,1777,107,na,1884,0.021122512811941205
STAT,1849,31,50-100,1880,0.9033064934703703
STAT,1879,52,30-34,1931,0.00607385513917078
STAT,1912,35,40-44,1947,1.457825607700203
STAT,1858,47,20-24,1905,0.009121249028658018
STAT,1926,22,20-24,1948,133.93012067558928
SIM,1920,35,40-44,1955,8
STAT,1898,16,40-44,1914,0.24655687859052988
STAT,1914,35,45-49,1949,0.6775640589818173
SIM,1867,29,35-39,1896,7
STAT,1885,58,na,1943,1943.8781771050433
STAT,1920,40,25-29,1960,0.07806901010529989
STAT,1816,55,na,1871,2194.2894411046677
STAT,1863,18,45-49,1881,0.0575667410389618
STAT,1825,43,45-49,1868,1.9581437040936343
STAT,1869,36,40-44,1905,4.438519288982494
SIM,1946,22,25-29,1968,2
STAT,1827,80,na,1907,436.22888025818924
STAT,1842,63,na,1905,442.9436617460888
STAT,1872,42,35-39,1914,1.811043311153866
STAT,1924,17,15-19,1941,53.52479942180747
STAT,1844,44,25-29,1888,0.6350693192882684
STAT,1860,29,15-19,1889,0.3687400854849252
STAT,1860,37,50-100,1897,1.0015829318537046
STAT,1865,28,20-24,1893,10.6730085472618
STAT,1814,46,35-39,1860,0.48506835467349335
STAT,1868,80,na,1948,597.4841297569851
STAT,1897,21,15-19,1918,4.394502713040115
SIM,1892,2,na,1894,3783
STAT,1848,25,40-44,1873,3.3950358660459004
STAT,1907,17,15-19,1924,8.659084420274427
SIM,1905,58,na,1963,2506
SIM,1925,27,40-44,1952,1
STAT,1876,26,30-34,1902,25.54394500612361
STAT,1848,28,20-24,1876,13.011551111636512
STAT,1864,44,40-44,1908,2.017229129578128
SIM,1889,70,na,1959,1690
STAT,1824,39,15-19,1863,0.009089811871983752
STAT,1870,53,25-29,1923,0.0034744536009952785
STAT,1858,36,20-24,1894,0.5915030749552046
STAT,1787,104,na,1891,0.01200859924401823
STAT,1855,36,na,1891,1566.7764767154638
SIM,1862,23,15-19,1885,1
STAT,1919,35,35-39,1954,2.578272346426649
SIM,1836,22,20-24,1858,232
STAT,1881,37,35-39,1918,6.679297584730929
STAT,1821,36,25-29,1857,3.6507549453010317
STAT,1843,46,50-100,1889,0.24464682994585113
STAT,1906,38,20-24,1944,0.23973648747046003
STAT,1871,18,35-39,1889,0.5476515912093082
STAT,1940,25,45-49,1965,1.7434441662277402
SIM,1879,37,45-49,1916,2
STAT,1864,72,na,1936,1148.1055267179245
STAT,1908,46,15-19,1954,3.330574216980873E-4
STAT,1823,43,40-44,1866,3.687589359513094
STAT,1901,22,na,1923,3306.8468803824794
SIM,1901,37,40-44,1938,5
STAT,1885,45,25-29,1930,0.05718233859756606
SIM,1928,3,na,1931,4662
STAT,1919,22,15-19,1941,5.751556380802721
STAT,1844,107,na,1951,0.004672043019592842
STAT,1880,37,na,1917,2445.8681873102687
SIM,1884,45,na,1929,3646
STAT,1888,42,30-34,1930,1.3252717062273114
STAT,1805,51,35-39,1856,0.010292472090568903
STAT,1866,45,15-19,1911,3.6876733989566564E-4
STAT,1869,48,35-39,1917,0.13949638300715592
STAT,1790,70,na,1860,893.8850120195559
SIM,1917,43,na,1960,1999
STAT,1886,48,35-39,1934,0.14315537299271994
STAT,1873,27,50-100,1900,0.6561834177545293
STAT,1814,48,na,1862,2052.8514593951145
STAT,1870,31,20-24,1901,2.705781349774719
STAT,1901,35,50-100,1936,0.37404242099630497
STAT,1858,23,45-49,1881,0.5520098298221011
STAT,1815,95,na,1910,0.9374098573948078
STAT,1818,54,25-29,1872,0.005823838420181414
STAT,1890,34,40-44,1924,5.205111589695403
STAT,1923,38,20-24,1961,0.30192218202216253
STAT,1938,22,25-29,1960,90.43924836629192
STAT,1918,19,40-44,1937,1.493831237068087
SIM,1836,35,40-44,1871,12
STAT,1848,66,na,1914,1533.7439868843428
SIM,1888,21,15-19,1909,2
STAT,1841,51,45-49,1892,0.01623783862886174
STAT,1867,26,20-24,1893,11.132860553275671
STAT,1928,19,40-44,1947,1.7396400887317127
STAT,1890,27,35-39,1917,11.681062897924335
STAT,1895,26,40-44,1921,3.9102195868145593
STAT,1798,90,na,1888,47.17321970626267
STAT,1917,37,na,1954,3855.5100415494826
STAT,1932,26,50-100,1958,1.2952145623108513
SIM,1904,39,na,1943,4082
STAT,1811,106,na,1917,0.007355810472529264
STAT,1861,41,20-24,1902,0.13267335084723178
STAT,1838,51,30-34,1889,0.0025780567050037095
SIM,1835,68,na,1903,796
STAT,1796,61,na,1857,1668.6266449466382
SIM,1831,43,40-44,1874,2
STAT,1854,18,35-39,1872,0.36281317085092085
SIM,1873,43,50-100,1916,17
STAT,1903,40,25-29,1943,0.06393855855900879
STAT,1884,37,20-24,1921,0.7379123623783463
STAT,1853,7,na,1860,2308.6551129430377
STAT,1840,36,35-39,1876,3.3283499449176652
STAT,1868,18,20-24,1886,17.33082329942542
STAT,1824,51,45-49,1875,0.002495886946783507
STAT,1879,40,na,1919,2394.8856956657446
STAT,1835,54,25-29,1889,0.0026251242182414695
STAT,1857,15,40-44,1872,0.1669234229430659
STAT,1873,89,na,1962,210.63433502700047
STAT,1875,23,45-49,1898,0.713833625153523
STAT,1897,43,na,1940,3057.7973621506794
STAT,1865,38,na,1903,2140.3172209625277
STAT,1817,46,20-24,1863,0.00851893302332987
STAT,1913,27,40-44,1940,4.586034898257176
SIM,1863,42,35-39,1905,3
STAT,1839,38,20-24,1877,0.8469908427244505
SIM,1921,27,40-44,1948,219
STAT,1891,42,45-49,1933,1.8381955442703501
STAT,1867,55,na,1922,1955.4988810102132
STAT,1932,28,20-24,1960,23.7311229424998
STAT,1899,21,40-44,1920,2.8547992821882278
STAT,1861,18,35-39,1879,0.5214093731630437
STAT,1810,104,na,1914,0.0020766773531939228
STAT,1908,48,40-44,1956,0.1410891109277826
SIM,1872,20,na,1892,2464
STAT,1846,53,na,1899,1254.7616593035532
STAT,1906,25,15-19,1931,0.6614509269302531
SIM,1852,15,30-34,1867,9
STAT,1836,54,50-100,1890,0.011254884146422383
SIM,1949,0,na,1949,4615
STAT,1851,30,40-44,1881,3.639730407046724
STAT,1849,42,na,1891,1945.0342451464817
STAT,1869,29,35-39,1898,9.666969874880042
STAT,1850,39,na,1889,1082.4134206677513
STAT,1845,35,40-44,1880,2.5606535625626896
SIM,1910,16,40-44,1926,128
STAT,1881,32,35-39,1913,9.56347215750373
STAT,1803,54,na,1857,824.4032052288786
STAT,1841,47,50-100,1888,0.27473141507689275
SIM,1940,28,20-24,1968,3
SIM,1890,33,na,1923,3284
STAT,1859,52,20-24,1911,5.817558975758375E-4
STAT,1902,57,na,1959,2914.405727188988
STAT,1819,54,30-34,1873,0.0010106043068065526
SIM,1894,23,na,1917,1709
SIM,1897,12,na,1909,3016
STAT,1814,41,35-39,1855,6.709448742470524
STAT,1823,36,35-39,1859,13.346085683995273
STAT,1925,41,15-19,1966,0.0018448857776543139
STAT,1859,15,15-19,1874,5.524879651472873
STAT,1856,23,50-100,1879,0.33772992797665735
STAT,1876,19,25-29,1895,5.697820310805223
STAT,1810,49,30-34,1859,4.949773229339998E-4
STAT,1845,28,35-39,1873,5.785960937229861
SIM,1814,66,na,1880,2292
SIM,1874,77,na,1951,1456
STAT,1873,22,40-44,1895,2.137528646045025
SIM,1899,13,na,1912,2176
STAT,1845,52,na,1897,1062.7505908584023
SIM,1860,35,na,1895,2029
STAT,1929,43,40-44,1972,0.3211413566720684
STAT,1851,46,20-24,1897,0.009504419657652046
STAT,1866,30,40-44,1896,3.990456059897988
STAT,1945,15,25-29,1960,46.84042759394168
STAT,1909,19,30-34,1928,2.3532525313365102
SIM,1822,41,35-39,1863,4
SIM,1934,37,na,1971,5179
SIM,1882,38,na,1920,1853
SIM,1930,25,na,1955,5349
STAT,1895,38,35-39,1933,9.155332076159159
STAT,1883,45,15-19,1928,3.8865341426720375E-4
STAT,1904,33,25-29,1937,8.367135807430486
STAT,1845,44,30-34,1889,0.5662389080612491
STAT,1828,47,50-100,1875,0.2932356683239702
STAT,1829,28,na,1857,1041.9407480436448
SIM,1915,42,na,1957,3099
STAT,1822,49,na,1871,1464.710185664485
STAT,1866,44,45-49,1910,1.3477205531412453
STAT,1941,28,30-34,1969,40.0531552976068
STAT,1873,8,na,1881,2768.0805424916616
STAT,1923,44,15-19,1967,0.0017701080344621934
STAT,1828,47,35-39,1875,0.16715388310264753
STAT,1844,15,30-34,1859,2.031071908757623
SIM,1874,44,45-49,1918,4
SIM,1917,19,30-34,1936,1
STAT,1935,10,na,1945,5393.969162174271
STAT,1817,39,15-19,1856,0.042466333414712856
STAT,1914,42,na,1956,3628.897006824174
STAT,1887,18,30-34,1905,1.7497330211713062
STAT,1889,26,40-44,1915,3.6197124003754677
SIM,1842,32,na,1874,3114
STAT,1901,22,50-100,1923,0.5701787431130234
STAT,1886,29,35-39,1915,9.920534484946815
SIM,1836,69,na,1905,816
SIM,1875,26,20-24,1901,54
SIM,1932,27,50-100,1959,23
SIM,1933,36,na,1969,4317
STAT,1915,38,30-34,1953,1.8061570146624042
STAT,1825,49,15-19,1874,4.94869686689828E-4
STAT,1884,27,na,1911,2284.552822933995
STAT,1921,30,50-100,1951,0.9164935663753834
STAT,1806,96,na,1902,2.5856006563775273
STAT,1852,25,30-34,1877,29.952191529035343
STAT,1777,82,na,1859,409.0774653611403
STAT,1822,51,35-39,1873,0.01415106361217258
STAT,1903,34,30-34,1937,14.109284382842457
SIM,1832,79,na,1911,167
STAT,1837,23,15-19,1860,3.4379766470496063
STAT,1843,36,20-24,1879,0.8984199764166969
STAT,1882,16,45-49,1898,0.06269403679615007
SIM,1943,9,na,1952,4986
STAT,1842,47,25-29,1889,0.014301270567514755
STAT,1910,37,50-100,1947,0.3970548190782527
STAT,1923,25,na,1948,4284.616049841696
STAT,1924,0,na,1924,5313.334387256833
SIM,1865,66,na,1931,1523
SIM,1918,47,na,1965,4368
STAT,1804,52,na,1856,2195.717630918663
STAT,1885,16,30-34,1901,1.5705407741972273
STAT,1927,15,na,1942,4560.394109660972
STAT,1928,22,25-29,1950,114.45096927524504
STAT,1928,38,40-44,1966,1.8755989467856153
SIM,1917,22,20-24,1939,2
STAT,1841,109,na,1950,7.922567094343112E-4
STAT,1926,15,15-19,1941,55.421430311346825
STAT,1911,40,15-19,1951,0.0014656386504603176
STAT,1840,29,50-100,1869,0.30956614616246514
SIM,1864,36,50-100,1900,1
STAT,1842,44,15-19,1886,0.00345713087861436
STAT,1850,35,50-100,1885,0.587987172105054
SIM,1859,72,na,1931,136
STAT,1875,6,na,1881,2794.971901732415
SIM,1867,15,15-19,1882,82
SIM,1810,76,na,1886,2853
STAT,1854,22,30-34,1876,11.636786494545625
STAT,1838,25,50-100,1863,0.3524031312683936
STAT,1864,50,na,1914,1985.5874879337175
STAT,1909,22,20-24,1931,102.29373976611463
STAT,1864,37,35-39,1901,6.430036415440282
STAT,1889,42,50-100,1931,1.2706394966303587
STAT,1837,57,na,1894,1611.3896844986648
STAT,1862,24,na,1886,2032.6221172384544
STAT,1825,38,na,1863,1740.7494403736125
STAT,1871,37,35-39,1908,7.055547748677957
STAT,1819,38,35-39,1857,1.7324787475540973
STAT,1871,25,40-44,1896,3.0084786522620006
STAT,1906,21,35-39,1927,8.475703585433138
STAT,1827,53,20-24,1880,6.402269059299526E-4
STAT,1867,19,50-100,1886,0.04680998873220969
STAT,1813,66,na,1879,1427.1000492609346
STAT,1877,20,15-19,1897,3.3688879026227636
STAT,1816,46,50-100,1862,0.7578548128430361
STAT,1948,9,na,1957,4451.129777815911
STAT,1871,15,30-34,1886,1.619241308054798
STAT,1912,16,na,1928,3869.64058963805
STAT,1890,25,50-100,1915,0.7796701488827344
STAT,1867,22,40-44,1889,1.9788392022905523
STAT,1910,49,35-39,1959,0.11824858578983506
STAT,1923,48,30-34,1971,0.10290101318667205
SIM,1858,29,25-29,1887,10
STAT,1814,104,na,1918,0.04514155713221974
SIM,1854,17,30-34,1871,13
STAT,1898,19,45-49,1917,0.08736920008097324
STAT,1881,84,na,1965,555.3302267351727
STAT,1812,81,na,1893,42.825617224811204
SIM,1820,35,na,1855,721
STAT,1852,65,na,1917,1701.0958662473035
STAT,1830,33,30-34,1863,16.230585987696813
STAT,1900,17,20-24,1917,24.559076131908963
STAT,1854,37,35-39,1891,3.932669378663213
STAT,1909,43,50-100,1952,0.10811220440261293
STAT,1939,18,na,1957,3642.6905529259793
SIM,1900,43,na,1943,4149
SIM,1862,52,na,1914,3426
STAT,1899,48,20-24,1947,0.009129384447397701
STAT,1930,23,25-29,1953,117.13745049426223
STAT,1888,33,40-44,1921,4.984158485258483
STAT,1894,44,20-24,1938,0.013834934486580118
STAT,1915,28,50-100,1943,0.9973707432580595
STAT,1846,17,30-34,1863,1.1858376852605255
SIM,1868,39,35-39,1907,5
STAT,1828,32,30-34,1860,26.444611169093108
STAT,1862,37,25-29,1899,2.4523303531894864
STAT,1890,37,45-49,1927,2.4133294940974297
STAT,1926,25,25-29,1951,78.75739791042824
STAT,1840,62,na,1902,719.6775329361424
STAT,1838,54,40-44,1892,0.004370466476756786
STAT,1870,34,25-29,1904,10.123767466621832
STAT,1848,104,na,1952,0.062416201098200806
SIM,1887,10,na,1897,3965
STAT,1878,24,15-19,1902,3.373015633969055
SIM,1927,21,na,1948,1831
SIM,1886,24,15-19,1910,33
STAT,1818,51,20-24,1869,0.0012881826318123812
STAT,1823,46,45-49,1869,0.3735206808771907
STAT,1874,49,na,1923,2273.5040376282395
STAT,1858,20,40-44,1878,1.8523312082358256
SIM,1889,76,na,1965,986
SIM,1923,38,30-34,1961,4
STAT,1840,31,35-39,1871,4.907538108483908
SIM,1882,18,20-24,1900,1
SIM,1935,19,na,1954,5368
STAT,1895,23,30-34,1918,23.099908941476656
STAT,1936,24,40-44,1960,3.1805084599430398
STAT,1850,21,na,1871,1193.5857349914668
SIM,1867,26,30-34,1893,182
STAT,1888,23,30-34,1911,20.49476552385967
STAT,1914,32,40-44,1946,3.884380830017772
STAT,1885,42,20-24,1927,0.15591297687969918
STAT,1907,44,50-100,1951,0.1055976627996375
STAT,1940,22,40-44,1962,3.3867849497134994
STAT,1797,65,na,1862,32.84574513383519
SIM,1826,51,na,1877,1726
SIM,1921,11,na,1932,5331
STAT,1858,39,25-29,1897,2.1766107532643133
STAT,1915,19,30-34,1934,2.501527183790297
STAT,1901,37,30-34,1938,1.6084264134690094
STAT,1838,54,35-39,1892,0.0035739796037206873
STAT,1838,107,na,1945,0.002011223382576915
SIM,1855,32,40-44,1887,1
STAT,1918,15,25-29,1933,9.378978047308104
STAT,1853,43,20-24,1896,0.12225228089347306
SIM,1853,47,35-39,1900,3
STAT,1886,45,30-34,1931,0.10124061202357981
STAT,1844,41,20-24,1885,0.16321429896562525
SIM,1942,10,na,1952,3646
STAT,1902,29,30-34,1931,35.20671438814005
STAT,1794,100,na,1894,0.002512663680306535
STAT,1919,25,25-29,1944,70.64980516159434
STAT,1846,21,50-100,1867,0.30015533303433556
STAT,1871,20,na,1891,2373.3157333763015
STAT,1889,48,na,1937,2675.769314614986
SIM,1836,32,30-34,1868,3
STAT,1864,47,45-49,1911,0.21354881301692413
STAT,1904,64,na,1968,2772.697000637149
STAT,1952,15,25-29,1967,51.48453866161014
STAT,1902,16,40-44,1918,0.25818941318240946
STAT,1817,49,25-29,1866,0.0392968660920587
STAT,1934,38,40-44,1972,2.0497399982120883
STAT,1857,18,45-49,1875,0.05856828030171352
STAT,1847,32,40-44,1879,4.603634912185235
SIM,1868,55,na,1923,848
SIM,1910,29,30-34,1939,13
STAT,1857,77,na,1934,663.3011876014137
SIM,1834,25,20-24,1859,18
SIM,1848,54,na,1902,2307
STAT,1833,50,40-44,1883,0.004838083458454542
SIM,1901,28,na,1929,3776
STAT,1829,52,35-39,1881,0.0035015942593232003
SIM,1937,26,na,1963,2978
SIM,1885,27,na,1912,1688
STAT,1904,28,45-49,1932,1.5807018312282597
STAT,1918,19,na,1937,3931.0595807475497
STAT,1955,1,na,1956,5181.471361167891
STAT,1800,96,na,1896,5.924581588849391
STAT,1825,40,40-44,1865,3.0891206096232198
STAT,1878,29,45-49,1907,1.1341920832439554
SIM,1891,49,na,1940,1897
SIM,1901,10,na,1911,4179
STAT,1823,90,na,1913,62.28223341348071
STAT,1856,26,45-49,1882,0.8323472529268634
SIM,1929,32,35-39,1961,4
STAT,1883,48,25-29,1931,0.05471741267934667
SIM,1889,54,na,1943,3556
STAT,1892,31,40-44,1923,5.391204144750652
STAT,1893,16,20-24,1909,22.224471659309817
STAT,1896,43,35-39,1939,0.16456536614432832
STAT,1912,38,45-49,1950,0.6543768688630291
SIM,1893,78,na,1971,229
SIM,1873,28,20-24,1901,14
STAT,1825,54,na,1879,1412.1402671101707
STAT,1852,31,na,1883,2512.976256361851
STAT,1869,33,30-34,1902,17.543935352281597
SIM,1913,45,45-49,1958,3
SIM,1943,3,na,1946,4986
STAT,1906,44,15-19,1950,0.0013699311818975773
STAT,1866,33,45-49,1899,1.5850761636790616
SIM,1887,44,na,1931,3571
STAT,1919,32,25-29,1951,9.839297754435467
STAT,1851,37,25-29,1888,2.298320108859217
STAT,1832,33,40-44,1865,0.28890495892817764
STAT,1888,31,15-19,1919,0.16503345424466603
STAT,1936,8,na,1944,3780.5897729698104
SIM,1870,35,35-39,1905,24
STAT,1864,25,35-39,1889,8.865658479224022
SIM,1820,54,na,1874,390
STAT,1915,27,15-19,1942,0.7098851072265736
STAT,1856,38,20-24,1894,0.550918775368544
STAT,1914,28,50-100,1942,0.9859761260251689
STAT,1851,86,na,1937,175.236162204708
SIM,1857,12,na,1869,1495
STAT,1880,50,20-24,1930,7.77083105695618E-4
STAT,1878,28,30-34,1906,25.81768258300333
SIM,1782,87,na,1869,514
STAT,1895,35,30-34,1930,6.998945561051874
STAT,1879,43,50-100,1922,1.0759216676279517
STAT,1954,18,50-100,1972,0.4589209432583395
STAT,1840,46,na,1886,904.8633748738785
STAT,1943,26,15-19,1969,0.7435989392780807
STAT,1845,38,50-100,1883,0.6334967428181139
STAT,1814,50,30-34,1864,0.020422500253314043
STAT,1844,17,20-24,1861,22.32616862660201
STAT,1873,27,35-39,1900,9.89767418821235
STAT,1874,34,na,1908,2441.7459402389836
SIM,1886,28,30-34,1914,23
STAT,1905,45,45-49,1950,0.1933834038040647
STAT,1920,34,30-34,1954,16.889536048158135
STAT,1870,43,50-100,1913,1.045603721407323
SIM,1875,59,na,1934,2579
STAT,1909,29,40-44,1938,4.377676059139821
SIM,1875,29,25-29,1904,9
SIM,1906,1,na,1907,3770
STAT,1901,21,15-19,1922,4.626671782816944
STAT,1910,33,25-29,1943,8.774971636646326
STAT,1902,19,45-49,1921,0.09149127222926087
STAT,1847,37,50-100,1884,1.1516983008847979
STAT,1833,31,50-100,1864,0.5259740198667965
STAT,1925,34,50-100,1959,0.9715762299563186
STAT,1928,22,30-34,1950,35.61204101706351
SIM,1862,61,na,1923,2897
STAT,1862,49,na,1911,1876.271186224747
SIM,1794,72,na,1866,657
STAT,1812,42,20-24,1854,0.07696848100117844
STAT,1869,45,30-34,1914,0.09865294536613985
STAT,1836,94,na,1930,15.296084394412636
STAT,1845,38,45-49,1883,1.028609064106477
STAT,1849,67,na,1916,1335.6916714226857
SIM,1827,32,20-24,1859,2
STAT,1929,36,50-100,1965,0.535733478194884
STAT,1838,35,35-39,1873,3.719691682345339
STAT,1835,21,15-19,1856,3.342012954431003
SIM,1868,52,na,1920,1019
STAT,1932,34,15-19,1966,0.16942122695609088
SIM,1918,34,40-44,1952,8
STAT,1888,45,40-44,1933,0.19956274131939666
STAT,1855,32,30-34,1887,11.765860341748624
STAT,1824,39,20-24,1863,0.12477831090724269
STAT,1837,27,30-34,1864,25.915853247988508
STAT,1919,44,25-29,1963,0.0761031822250383
STAT,1871,27,25-29,1898,42.19751287578106
STAT,1871,28,45-49,1899,1.1036771387412574
STAT,1889,29,45-49,1918,1.327498613364939
STAT,1903,30,15-19,1933,0.203774194803952
STAT,1926,11,na,1937,4823.478307749185
STAT,1870,50,20-24,1920,7.462279747996542E-4
STAT,1916,45,20-24,1961,0.011232923181499542
STAT,1847,48,15-19,1895,3.5710237752472945E-4
STAT,1889,19,50-100,1908,0.05868085574766029
STAT,1923,21,35-39,1944,10.873289215103574
STAT,1886,23,20-24,1909,71.1418303216761
STAT,1937,15,35-39,1952,4.058728470546826
SIM,1845,27,30-34,1872,6
SIM,1937,32,25-29,1969,4
STAT,1823,43,35-39,1866,2.9687499900802266
STAT,1869,26,30-34,1895,25.497801294674442
STAT,1805,50,50-100,1855,0.01843043371687763
STAT,1868,54,20-24,1922,6.931350926266656E-4
SIM,1862,34,30-34,1896,1
STAT,1926,19,30-34,1945,14.73649505471468
SIM,1906,4,na,1910,3770
SIM,1922,9,na,1931,3724
SIM,1927,32,25-29,1959,1
STAT,1862,46,na,1908,1921.7223655106345
STAT,1882,63,na,1945,1708.3111925079727
STAT,1870,59,na,1929,1937.503800851375
STAT,1857,54,45-49,1911,0.010830026701360336
SIM,1914,29,30-34,1943,20
STAT,1886,35,20-24,1921,0.8058337444386878
STAT,1899,25,50-100,1924,0.8796626155799705
STAT,1825,32,50-100,1857,1.588012783904635
STAT,1917,36,15-19,1953,0.01977433992995837
SIM,1845,27,na,1872,2661
SIM,1863,32,30-34,1895,8
STAT,1838,47,35-39,1885,0.06148420623670932
STAT,1933,2,na,1935,5437.692292934516
STAT,1890,34,35-39,1924,12.15493534497519
STAT,1847,30,15-19,1877,0.1543449498359395
STAT,1903,21,50-100,1924,0.5806106968442493
STAT,1863,15,40-44,1878,0.18029557315380842
STAT,1869,38,25-29,1907,2.8909351952040803
STAT,1871,43,50-100,1914,1.0462440228194914
STAT,1787,87,na,1874,26.79334296112505
STAT,1891,18,20-24,1909,21.744165377543666
STAT,1840,40,30-34,1880,0.5323899682244688
STAT,1819,44,20-24,1863,0.030177576502822923
STAT,1910,46,30-34,1956,0.08244697625106749
STAT,1939,23,45-49,1962,1.1172038413373029
SIM,1966,4,na,1970,5081
STAT,1970,1,na,1971,4878.298988485205
SIM,1870,22,20-24,1892,25
SIM,1819,75,na,1894,812
STAT,1888,38,35-39,1926,8.12281921410721
SIM,1854,57,na,1911,986
STAT,1841,27,20-24,1868,16.22578730543531
STAT,1857,96,na,1953,6.589069741793282
STAT,1839,23,40-44,1862,2.46966500821746
SIM,1858,26,20-24,1884,24
STAT,1833,41,45-49,1874,0.7896814387878378
SIM,1903,35,40-44,1938,1
STAT,1884,73,na,1957,1199.8198187331711
SIM,1857,15,na,1872,1495
STAT,1893,19,25-29,1912,7.048398644399635
STAT,1799,75,na,1874,83.88709857799577
STAT,1925,44,25-29,1969,0.08537862629550999
STAT,1882,44,na,1926,2182.9359509995575
STAT,1800,62,na,1862,1569.1825312171943
STAT,1916,32,15-19,1948,0.13086195884103505
SIM,1857,31,na,1888,1248
STAT,1935,28,na,1963,5067.318840469493
STAT,1845,34,20-24,1879,1.562037272121124
SIM,1832,54,na,1886,1207
STAT,1929,32,25-29,1961,11.65791105341104
STAT,1815,79,na,1894,49.29083251719644
STAT,1920,11,na,1931,4394.819133196741
SIM,1914,33,35-39,1947,2
STAT,1862,22,20-24,1884,60.08602977464163
SIM,1792,62,na,1854,1158
STAT,1861,20,50-100,1881,0.35346517296634267
STAT,1865,29,na,1894,2163.3015785623115
STAT,1896,40,30-34,1936,0.10630312712024305
STAT,1879,36,35-39,1915,7.290606659013144
SIM,1860,28,35-39,1888,1
SIM,1869,24,15-19,1893,21
STAT,1902,38,na,1940,3327.1869655420446
STAT,1841,39,15-19,1880,0.07216044443863849
STAT,1866,45,20-24,1911,0.011063029928279478
STAT,1900,23,15-19,1923,4.555968319988824
STAT,1821,34,35-39,1855,13.489120397570519
STAT,1850,29,20-24,1879,6.283669763317329
STAT,1871,22,30-34,1893,17.768529551727408
STAT,1886,59,na,1945,2012.5544935817913
SIM,1882,1,na,1883,3334
STAT,1870,75,na,1945,1026.3048525547433
STAT,1850,50,35-39,1900,0.0040324606702554075
SIM,1907,18,25-29,1925,128
STAT,1895,36,na,1931,3079.577033037785
STAT,1852,28,35-39,1880,11.231318704642739
STAT,1832,37,15-19,1869,0.004283036074318021
STAT,1842,43,45-49,1885,0.37949753630241007
SIM,1844,64,na,1908,1796
STAT,1836,32,20-24,1868,2.618142241683306
SIM,1906,59,na,1965,3009
STAT,1871,24,20-24,1895,68.31287473900166
STAT,1915,15,15-19,1930,9.407814678702644
STAT,1945,19,40-44,1964,1.5100390694066064
SIM,1864,16,na,1880,2555
STAT,1832,26,35-39,1858,11.883749742819893
STAT,1936,22,15-19,1958,5.038711916449582
STAT,1793,75,na,1868,369.4183880264315
SIM,1891,3,na,1894,2852
STAT,1830,84,na,1914,240.77241255420898
STAT,1877,14,na,1891,2613.070581729194
STAT,1837,25,40-44,1862,3.1276242748895897
STAT,1883,44,45-49,1927,1.4203974641697548
STAT,1907,23,50-100,1930,0.5931671389222867
STAT,1897,39,20-24,1936,0.21873866699107347
STAT,1851,83,na,1934,313.537380514025
SIM,1780,77,na,1857,615
STAT,1859,28,20-24,1887,9.39084498357437
STAT,1922,43,50-100,1965,0.13312829527424078
SIM,1887,36,35-39,1923,4
STAT,1850,17,20-24,1867,10.003596610723882
STAT,1892,35,20-24,1927,0.9634471453016812
SIM,1822,61,na,1883,516
STAT,1856,15,na,1871,1972.6609484249504
STAT,1864,44,35-39,1908,1.6240010409443615
STAT,1807,51,45-49,1858,0.04726310916488687
STAT,1945,22,25-29,1967,100.11770456636096
SIM,1919,25,35-39,1944,164
STAT,1825,44,20-24,1869,0.20438296870820033
STAT,1932,15,15-19,1947,59.95347819210121
SIM,1883,60,na,1943,1967
STAT,1904,37,40-44,1941,1.3498969587569891
STAT,1871,23,na,1894,2351.9491198715814
STAT,1919,29,40-44,1948,4.933816867837959
SIM,1866,42,na,1908,3032
STAT,1833,53,45-49,1886,0.00628453139980744
STAT,1813,69,na,1882,1276.0695545652504
SIM,1814,43,40-44,1857,1
STAT,1883,20,50-100,1903,0.3946527448942322
SIM,1841,41,45-49,1882,1
STAT,1879,48,35-39,1927,0.14181301844347652
STAT,1902,25,15-19,1927,0.6432203754458113
STAT,1934,1,na,1935,5610.3307794659395
STAT,1921,25,40-44,1946,5.167987685257167
STAT,1926,14,na,1940,4800.6991574525355
SIM,1934,15,na,1949,5257
STAT,1845,22,20-24,1867,42.451570945779686
SIM,1840,26,35-39,1866,195
STAT,1847,47,45-49,1894,0.2123768522813945
SIM,1913,16,na,1929,3593
SIM,1945,21,na,1966,6322
STAT,1826,28,25-29,1854,150.60904956144253
STAT,1877,46,35-39,1923,0.14252034504412134
STAT,1896,3,na,1899,3484.924027295547
STAT,1941,17,15-19,1958,46.21418999925758
STAT,1876,16,20-24,1892,17.96593132795437
STAT,1816,53,45-49,1869,0.041630938447909833
STAT,1931,35,45-49,1966,0.8980551090088884
SIM,1881,34,40-44,1915,1
STAT,1904,25,40-44,1929,4.3087851944322395
STAT,1888,49,15-19,1937,2.5498023919630786E-4
STAT,1935,19,40-44,1954,1.888189486296696
STAT,1880,53,25-29,1933,0.0036181157582327412
SIM,1786,68,na,1854,297
SIM,1915,36,50-100,1951,14
STAT,1825,32,na,1857,1805.4598027717645
STAT,1901,34,20-24,1935,3.7470995797230233
SIM,1843,17,na,1860,682
STAT,1947,13,na,1960,4377.557893732475
SIM,1834,28,25-29,1862,16
STAT,1890,15,35-39,1905,0.6673575777751797
STAT,1873,34,40-44,1907,4.41042900618639
STAT,1832,36,45-49,1868,0.14691232857393227
SIM,1882,42,45-49,1924,6
STAT,1836,45,35-39,1881,0.11518359543575947
STAT,1930,27,40-44,1957,5.885107435263159
SIM,1866,45,na,1911,2991
STAT,1857,51,40-44,1908,0.008117164710783659
STAT,1829,90,na,1919,28.790168366945167
STAT,1842,30,50-100,1872,0.2805346371065331
STAT,1886,33,30-34,1919,18.004112758874903
STAT,1885,28,50-100,1913,0.626571899523203
SIM,1829,50,na,1879,1781
STAT,1901,40,15-19,1941,0.0013543942602400512
STAT,1851,39,15-19,1890,0.04390408824938346
STAT,1830,53,50-100,1883,0.011132968663567867
STAT,1886,38,25-29,1924,2.9667644224581187
STAT,1854,37,50-100,1891,0.6826466817470868
STAT,1883,48,na,1931,2137.2476942334556
STAT,1886,37,na,1923,2439.732392875739
STAT,1926,17,40-44,1943,1.7001910464572483
STAT,1852,18,25-29,1870,6.8582107328106225
SIM,1918,49,45-49,1967,3
SIM,1888,29,na,1917,414
SIM,1893,22,na,1915,3456
STAT,1851,34,20-24,1885,2.176332718432575
STAT,1850,22,50-100,1872,0.22600991308038676
STAT,1869,35,20-24,1904,0.7852369792646655
STAT,1849,33,45-49,1882,1.5323135827132623
STAT,1890,31,30-34,1921,21.223239358395965
SIM,1866,26,na,1892,3214
STAT,1840,43,35-39,1883,0.7343115770488076
SIM,1894,38,25-29,1932,15
STAT,1935,25,na,1960,5074.165886888091
SIM,1908,31,50-100,1939,4
SIM,1855,82,na,1937,891
STAT,1819,47,25-29,1866,0.010729966924017285
STAT,1874,42,45-49,1916,1.542730512491138
STAT,1857,93,na,1950,22.426439688343763
STAT,1913,41,na,1954,3596.9352072763018
STAT,1814,53,35-39,1867,0.027827863644555605
STAT,1954,15,35-39,1969,5.144286928230465
STAT,1852,50,45-49,1902,0.014817944180667082
STAT,1860,39,25-29,1899,2.325186615772562
STAT,1932,36,na,1968,5024.305831739409
STAT,1878,26,40-44,1904,3.0926202911198173
STAT,1920,44,40-44,1964,0.2717871423192805
STAT,1952,19,40-44,1971,1.6597556607160775
STAT,1823,31,40-44,1854,18.86402570834648
SIM,1835,65,na,1900,1160
STAT,1872,85,na,1957,325.06601251934995
STAT,1936,20,25-29,1956,87.49353522226782
SIM,1937,29,na,1966,2988
STAT,1830,110,na,1940,2.000058600033692E-4
STAT,1932,23,35-39,1955,12.230648624114131
STAT,1834,49,25-29,1883,0.026240512018410957
STAT,1899,33,40-44,1932,5.8983825642518415
STAT,1896,34,50-100,1930,1.1974802374424294
STAT,1874,18,45-49,1892,0.06724053681369517
SIM,1817,65,na,1882,2170
STAT,1890,22,40-44,1912,2.522674123816217
SIM,1819,35,40-44,1854,3
STAT,1864,22,30-34,1886,16.453657122627327
SIM,1844,42,na,1886,2768
STAT,1921,28,45-49,1949,1.8959050472989554
STAT,1921,43,50-100,1964,0.13054481688467712
SIM,1844,45,35-39,1889,3
SIM,1931,26,na,1957,4955
STAT,1942,22,15-19,1964,5.517559783495149
STAT,1881,44,35-39,1925,1.6869556452795693
STAT,1837,79,na,1916,560.5660892456502
STAT,1888,48,45-49,1936,0.1517159157580124
STAT,1911,37,50-100,1948,0.400956796244909
SIM,1852,90,na,1942,906
STAT,1842,72,na,1914,313.5066760594811
STAT,1875,96,na,1971,50.05303756172626
STAT,1934,20,50-100,1954,0.8811535898802904
SIM,1918,30,25-29,1948,39
STAT,1830,26,25-29,1856,40.9696090113266
STAT,1905,42,40-44,1947,0.2243809206550816
STAT,1855,35,35-39,1890,4.725574530331442
STAT,1900,29,20-24,1929,16.135256611564
STAT,1862,35,35-39,1897,6.081510859447763
STAT,1906,33,35-39,1939,8.384945151792365
STAT,1928,40,na,1968,4711.619377800248
SIM,1900,49,na,1949,4006
STAT,1814,91,na,1905,39.2181870127247
STAT,1823,40,30-34,1863,2.0141844026016638
STAT,1876,22,15-19,1898,3.335009888765659
SIM,1847,53,na,1900,1382
STAT,1820,43,25-29,1863,1.0414463874065125
STAT,1881,81,na,1962,720.0156596759748
SIM,1890,30,na,1920,3744
STAT,1796,64,na,1860,1492.0353066034002
SIM,1899,27,20-24,1926,4
STAT,1835,28,35-39,1863,9.446542126884596
STAT,1858,32,40-44,1890,3.311795565672189
STAT,1934,36,15-19,1970,0.026344601373435448
STAT,1873,38,15-19,1911,0.05731649831269103
STAT,1849,45,na,1894,1914.596856532747
SIM,1869,56,na,1925,3598
SIM,1943,11,na,1954,4986
STAT,1910,37,40-44,1947,1.4156944261581628
STAT,1838,32,30-34,1870,9.26138679810229
SIM,1890,48,na,1938,3488
STAT,1895,33,na,1928,3091.186283437148
SIM,1918,44,na,1962,4368
STAT,1895,16,30-34,1911,2.078513252255445
STAT,1927,34,40-44,1961,4.768490235606497
STAT,1928,25,35-39,1953,18.480446994284357
STAT,1869,22,15-19,1891,3.328985379475867
STAT,1847,19,na,1866,2559.8159385034537
STAT,1928,34,25-29,1962,11.454251286584332
STAT,1905,12,na,1917,3714.4759105466987
STAT,1919,48,40-44,1967,0.16826669822238702
SIM,1881,24,30-34,1905,25
STAT,1854,28,45-49,1882,0.6425353686275502
STAT,1879,43,40-44,1922,2.290728656525732
STAT,1892,22,na,1914,2928.152088852685
SIM,1908,23,25-29,1931,590
SIM,1880,71,na,1951,3193
SIM,1893,59,na,1952,2127
STAT,1925,38,30-34,1963,2.1652848752236986
STAT,1848,52,45-49,1900,0.013508052609631463
STAT,1935,9,na,1944,5402.9380393195415
STAT,1910,52,na,1962,3332.27212639678
SIM,1935,34,40-44,1969,5
SIM,1839,21,25-29,1860,2
SIM,1933,38,30-34,1971,2
SIM,1930,9,na,1939,5630
STAT,1837,42,na,1879,1989.2620013395933
STAT,1913,23,25-29,1936,91.81999299150199
STAT,1833,83,na,1916,163.33521744645768
STAT,1854,15,30-34,1869,1.0727296017727137
SIM,1871,17,30-34,1888,114
STAT,1859,26,na,1885,1938.1061651380812
STAT,1880,24,30-34,1904,18.376138522312228
STAT,1906,48,30-34,1954,0.0780759105773782
STAT,1854,34,30-34,1888,9.737157234698829
STAT,1936,36,40-44,1972,1.4563647430082987
STAT,1834,68,na,1902,673.4847064392611
STAT,1880,15,40-44,1895,0.19076384203138988
STAT,1838,46,50-100,1884,0.10925163767535144
STAT,1832,24,50-100,1856,0.5155523089956031
STAT,1859,19,30-34,1878,1.4491905297153627
STAT,1858,41,na,1899,1772.9975500661117
STAT,1888,35,30-34,1923,6.209623966545695
STAT,1843,24,45-49,1867,0.8524428791353453
STAT,1848,28,45-49,1876,1.2314559778378615
STAT,1839,26,45-49,1865,1.3089130401698021
STAT,1812,65,na,1877,159.15094618722836
SIM,1820,51,na,1871,390
STAT,1931,32,40-44,1963,5.091706322727655
STAT,1901,44,30-34,1945,0.11012020351592257
SIM,1899,69,na,1968,1469
STAT,1873,37,45-49,1910,2.044878043215072
STAT,1909,25,25-29,1934,63.21825313407197
STAT,1851,103,na,1954,0.11334709751319247
SIM,1855,44,40-44,1899,3
STAT,1906,29,30-34,1935,36.20456495965868
STAT,1875,20,40-44,1895,2.152530789287365
STAT,1904,45,50-100,1949,0.1999031723586835
SIM,1832,27,20-24,1859,15
STAT,1835,51,20-24,1886,5.803794453587369E-4
STAT,1892,38,25-29,1930,3.547035270396698
STAT,1904,21,25-29,1925,82.03349339834305
STAT,1929,30,35-39,1959,11.539443725701583
SIM,1863,35,35-39,1898,4
STAT,1854,52,50-100,1906,0.008352692076083634
SIM,1912,45,50-100,1957,1
STAT,1793,72,na,1865,490.9193219157819
STAT,1811,80,na,1891,374.7647255158883
STAT,1845,32,30-34,1877,10.301306451594497
STAT,1866,48,25-29,1914,0.05191770862937389
STAT,1869,81,na,1950,545.6756652912657
STAT,1816,50,40-44,1866,0.03205844718920714
STAT,1827,64,na,1891,1225.8756731430828
STAT,1876,29,35-39,1905,9.684464319335824
STAT,1856,36,50-100,1892,0.8860749030856844
STAT,1895,11,na,1906,3364.5281925811873
SIM,1864,19,na,1883,2555
STAT,1862,25,25-29,1887,36.6876213888343
STAT,1902,23,na,1925,3320.0770239898898
STAT,1869,39,45-49,1908,1.991345547417537
STAT,1870,46,25-29,1916,0.05758638345843448
STAT,1938,32,35-39,1970,9.090274460245505
STAT,1920,30,15-19,1950,0.1400635508152976
SIM,1841,50,na,1891,206
STAT,1838,42,40-44,1880,1.1228979748295838
STAT,1909,15,15-19,1924,8.8501791427495
STAT,1841,106,na,1947,0.013520561179571566
SIM,1817,38,35-39,1855,54
STAT,1878,22,25-29,1900,58.89824846924224
SIM,1937,30,35-39,1967,25
STAT,1836,35,25-29,1871,2.7648938105749004
SIM,1909,48,na,1957,3812
STAT,1837,21,25-29,1858,60.522743846354146
STAT,1885,18,20-24,1903,17.380591814139212
STAT,1887,84,na,1971,747.9007168140049
SIM,1901,33,25-29,1934,94
STAT,1781,87,na,1868,60.19810164921708
STAT,1891,77,na,1968,1461.7704678267485
STAT,1932,19,30-34,1951,15.941561412751145
STAT,1911,0,na,1911,4442.849924443581
STAT,1844,27,na,1871,2623.5504896564116
STAT,1863,71,na,1934,1139.5356964487312
STAT,1825,47,25-29,1872,0.07317502257424482
SIM,1912,21,25-29,1933,71
STAT,1883,26,na,1909,2303.817499681487
STAT,1913,19,20-24,1932,27.22495402051362
STAT,1832,23,30-34,1855,23.31629904621985
STAT,1888,19,50-100,1907,0.05624141074558694
STAT,1873,20,15-19,1893,3.404262925533882
STAT,1883,41,40-44,1924,2.1736916542133584
STAT,1884,25,45-49,1909,1.0700733399478204
STAT,1933,18,na,1951,4880.962475853594
SIM,1810,92,na,1902,258
STAT,1828,44,30-34,1872,1.3904406242349883
STAT,1865,16,45-49,1881,0.061820887095136674
STAT,1874,7,na,1881,2797.457700743627
STAT,1847,44,40-44,1891,2.006158530303738
STAT,1861,44,25-29,1905,0.52683676438566
STAT,1864,32,40-44,1896,3.9425356461313075
STAT,1839,53,50-100,1892,0.013806162514827448
SIM,1844,79,na,1923,719
STAT,1842,40,40-44,1882,0.5926884419895814
SIM,1921,19,20-24,1940,2
STAT,1848,82,na,1930,436.6159655487014
STAT,1884,70,na,1954,1343.124207893849
STAT,1846,52,35-39,1898,0.005071665252233028
STAT,1895,29,45-49,1924,1.4340396432905318
STAT,1845,37,25-29,1882,1.5011289667843886
STAT,1914,26,na,1940,3736.759177180603
STAT,1949,8,na,1957,4525.772206143627
SIM,1862,15,30-34,1877,4
STAT,1868,104,na,1972,0.8380478995760811
SIM,1839,49,na,1888,674
SIM,1914,48,30-34,1962,2
STAT,1928,15,25-29,1943,54.4401437769765
SIM,1819,72,na,1891,992
STAT,1828,38,45-49,1866,2.6220650524043636
STAT,1803,51,na,1854,874.8682458600972
STAT,1925,21,50-100,1946,0.7827656312735011
STAT,1865,5,na,1870,2599.7150797956983
SIM,1845,21,25-29,1866,379
STAT,1834,22,45-49,1856,0.4110124959941482
STAT,1878,36,50-100,1914,1.2692665409594894
STAT,1879,33,30-34,1912,17.835289876703392
STAT,1830,87,na,1917,127.51477570063764
SIM,1887,33,30-34,1920,4
STAT,1824,50,na,1874,483.5907290734026
STAT,1898,25,na,1923,3230.9701325031815
SIM,1836,44,30-34,1880,3
STAT,1864,41,30-34,1905,1.0498996113413497
STAT,1867,29,25-29,1896,39.71979701191723
STAT,1935,15,25-29,1950,59.088835545925555
SIM,1878,30,na,1908,3799
SIM,1881,34,na,1915,3074
STAT,1863,17,30-34,1880,1.5526934686995002
STAT,1819,42,30-34,1861,0.26944058672275395
STAT,1852,53,50-100,1905,0.014958156974690216
STAT,1910,27,30-34,1937,37.41332235747489
STAT,1949,20,35-39,1969,10.886362700394436
SIM,1886,36,50-100,1922,1
STAT,1844,53,20-24,1897,7.193107722844559E-4
SIM,1876,17,15-19,1893,1
SIM,1947,19,na,1966,4360
STAT,1927,39,40-44,1966,1.8421154830412658
STAT,1862,40,20-24,1902,0.13663247309380636
SIM,1919,34,25-29,1953,5
STAT,1844,67,na,1911,1570.457701487527
SIM,1942,16,25-29,1958,32
STAT,1836,53,25-29,1889,0.00269237949288379
STAT,1901,38,50-100,1939,0.3686857176526955
SIM,1836,29,40-44,1865,1
SIM,1901,49,40-44,1950,1
STAT,1912,44,50-100,1956,0.11112266084062683
STAT,1934,16,25-29,1950,58.36133964415825
STAT,1889,79,na,1968,1249.377356064708
STAT,1860,34,50-100,1894,0.7410664418229083
SIM,1881,30,25-29,1911,4
STAT,1871,69,na,1940,1463.9385546831834
STAT,1897,74,na,1971,1911.0116032760238
SIM,1940,19,25-29,1959,5
SIM,1829,59,na,1888,1785
STAT,1897,17,40-44,1914,0.24290476134683053
STAT,1829,103,na,1932,0.052407304549642764
STAT,1852,62,na,1914,1839.772100489623
STAT,1860,43,20-24,1903,0.12862252653449768
SIM,1928,12,na,1940,4638
SIM,1955,14,na,1969,3822
STAT,1840,24,35-39,1864,2.880240628221564
STAT,1932,20,30-34,1952,37.67212210371979
STAT,1945,19,35-39,1964,4.5301169459314385
STAT,1859,40,15-19,1899,0.01105601373992223
STAT,1838,50,25-29,1888,0.0015647347034966218
STAT,1868,17,15-19,1885,5.835792489052263
STAT,1911,29,35-39,1940,14.373047118102217
SIM,1891,18,na,1909,2619
STAT,1831,31,30-34,1862,18.84553183522081
STAT,1932,19,25-29,1951,56.677477479780855
SIM,1833,64,na,1897,1984
SIM,1879,18,na,1897,1779
STAT,1857,30,50-100,1887,0.7222773978163955
SIM,1841,31,50-100,1872,7
STAT,1859,22,15-19,1881,2.7129250640636964
STAT,1837,51,50-100,1888,0.012396893810831085
STAT,1913,26,35-39,1939,14.822644247155838
STAT,1839,106,na,1945,0.011280432420444762
STAT,1866,82,na,1948,425.905174441072
STAT,1854,37,40-44,1891,2.433968953275068
STAT,1929,36,40-44,1965,1.9101516026111953
STAT,1930,23,30-34,1953,36.44795424671149
STAT,1932,37,25-29,1969,1.313717342437396
STAT,1798,81,na,1879,316.7449179737593
SIM,1844,53,25-29,1897,1
SIM,1846,32,25-29,1878,2
STAT,1911,47,35-39,1958,0.12068302146050817
STAT,1839,80,na,1919,574.7168412694156
STAT,1846,24,50-100,1870,0.29373629724278255
STAT,1955,4,na,1959,5174.997090614661
SIM,1874,46,na,1920,2477
STAT,1927,20,20-24,1947,136.69267664847692
STAT,1838,32,25-29,1870,5.433118895031432
STAT,1865,106,na,1971,0.15838481992617015
STAT,1906,30,30-34,1936,14.63414524734771
STAT,1936,26,30-34,1962,37.14298779132687
STAT,1887,44,na,1931,2509.581498930686
STAT,1855,26,50-100,1881,0.44448585373961497
STAT,1911,9,na,1920,3925.8325640964426
STAT,1929,34,45-49,1963,1.982221218149092
STAT,1883,49,30-34,1932,0.09118138615400101
STAT,1847,16,na,1863,2605.5859957142015
STAT,1932,0,na,1932,5923.976965965275
SIM,1871,24,30-34,1895,1
STAT,1793,101,na,1894,0.09487300209835747
STAT,1827,95,na,1922,9.37590136632925
STAT,1879,33,25-29,1912,10.462930934634505
STAT,1869,1,na,1870,3568.900770217093
STAT,1894,20,15-19,1914,4.2202632143405
STAT,1809,70,na,1879,1678.1007107138519
STAT,1863,24,30-34,1887,15.287697030067717
STAT,1898,16,na,1914,3404.566166246299
STAT,1926,4,na,1930,4906.1428050220175
STAT,1904,33,30-34,1937,14.262761887234072
STAT,1856,52,na,1908,1538.2874271257047
SIM,1859,1,na,1860,3746
STAT,1896,36,35-39,1932,9.368603184628366
STAT,1924,42,15-19,1966,0.0018090975524659638
STAT,1886,35,50-100,1921,1.2834636783177427
STAT,1846,27,35-39,1873,6.913353355391848
SIM,1887,33,25-29,1920,62
STAT,1896,30,20-24,1926,3.591891328894154
STAT,1901,13,na,1914,3605.3065794819527
SIM,1905,43,na,1948,3096
STAT,1819,100,na,1919,0.24693052941039167
SIM,1835,48,35-39,1883,3
SIM,1830,26,40-44,1856,34
STAT,1885,30,45-49,1915,1.7278669968175877
STAT,1902,36,30-34,1938,1.6276633556979356
STAT,1904,15,30-34,1919,2.2877347884260466
STAT,1914,39,30-34,1953,1.7763625634740958
STAT,1916,18,30-34,1934,2.5440767606340544
STAT,1811,50,15-19,1861,1.1517556402192234E-4
STAT,1918,15,30-34,1933,2.638006509434812
STAT,1894,39,35-39,1933,8.9038169286695
STAT,1848,57,na,1905,1880.561551546951
STAT,1815,39,50-100,1854,0.13436771577250564
STAT,1865,21,30-34,1886,16.579177804713144
STAT,1848,24,35-39,1872,6.553817480021052
SIM,1879,27,40-44,1906,4
SIM,1922,39,30-34,1961,3
STAT,1900,26,25-29,1926,58.800639899511204
STAT,1899,30,45-49,1929,2.4009751825021186
STAT,1922,45,15-19,1967,4.2043677193128945E-4
STAT,1940,15,40-44,1955,1.4049810878401578
STAT,1844,48,35-39,1892,0.13695371977546988
SIM,1905,36,20-24,1941,5
SIM,1857,46,na,1903,1397
STAT,1950,19,15-19,1969,53.115049127569144
STAT,1872,32,30-34,1904,17.48345551427618
SIM,1936,35,na,1971,3800
STAT,1864,54,45-49,1918,0.012830517142176489
STAT,1840,26,50-100,1866,0.3163311125310156
STAT,1846,48,50-100,1894,0.14363156709181055
STAT,1890,46,40-44,1936,0.11724155196769014
STAT,1877,54,25-29,1931,0.0034966935689759978
STAT,1829,45,35-39,1874,0.06645948263749098
STAT,1866,51,45-49,1917,0.013310585965529018
STAT,1912,41,40-44,1953,0.2398090607987064
STAT,1920,34,25-29,1954,9.90811197415545
STAT,1860,97,na,1957,5.918720673760965
STAT,1815,70,na,1885,116.58785258537027
SIM,1884,76,na,1960,1955
STAT,1870,35,30-34,1905,5.363693086403363
STAT,1864,22,25-29,1886,52.879221522432
STAT,1923,44,20-24,1967,0.02035624129685695
STAT,1839,31,30-34,1870,20.170457915007113
STAT,1917,47,30-34,1964,0.09187029759490062
STAT,1786,96,na,1882,3.0329815504026016
STAT,1830,32,25-29,1862,9.620928352714218
STAT,1933,18,30-34,1951,16.163267367411247
STAT,1860,49,35-39,1909,0.11182626725867711
STAT,1919,47,35-39,1966,0.13798487016721978
STAT,1854,19,40-44,1873,0.12022540738577737
STAT,1801,100,na,1901,0.3521987657187403
SIM,1850,36,na,1886,1634
SIM,1889,30,25-29,1919,3
SIM,1828,37,35-39,1865,13
STAT,1792,96,na,1888,2.0983719867401525
STAT,1906,44,20-24,1950,0.01575420774092369
SIM,1909,33,na,1942,3986
SIM,1935,20,20-24,1955,1115
STAT,1821,42,25-29,1863,0.7233978786473394
STAT,1887,28,35-39,1915,10.58293332220931
SIM,1886,38,40-44,1924,59
SIM,1950,4,na,1954,4871
STAT,1921,46,50-100,1967,0.25257934840608
STAT,1940,31,45-49,1971,1.6112484789396588
STAT,1927,37,45-49,1964,0.8406772682785183
STAT,1915,49,50-100,1964,0.22337597697131048
SIM,1945,24,25-29,1969,2013
STAT,1919,29,35-39,1948,15.892181735143142
SIM,1837,45,35-39,1882,1
SIM,1927,29,35-39,1956,1
STAT,1937,24,25-29,1961,88.959349961243
STAT,1878,38,40-44,1916,4.481538721808645
STAT,1803,85,na,1888,67.85366453674905
STAT,1877,54,na,1931,2125.618358896668
STAT,1881,25,35-39,1906,9.173762434111584
STAT,1894,26,na,1920,3045.257432558131
STAT,1883,54,na,1937,2014.532292222594
STAT,1927,44,50-100,1971,0.14565067665266776
SIM,1870,56,na,1926,1021
STAT,1832,42,na,1874,2178.4740167990367
STAT,1860,107,na,1967,0.035961901113418925
SIM,1856,21,na,1877,1074
STAT,1839,19,45-49,1858,0.07845746999793049
STAT,1879,49,na,1928,2259.7875234941775
STAT,1853,38,35-39,1891,5.457061422211434
STAT,1854,97,na,1951,2.9870616852910543
SIM,1815,39,na,1854,2258
SIM,1949,14,na,1963,4480
STAT,1871,33,25-29,1904,10.17432707314884
STAT,1914,25,40-44,1939,4.664892760681526
STAT,1895,38,40-44,1933,5.666327851305273
STAT,1865,69,na,1934,1339.8540035532126
STAT,1890,44,45-49,1934,1.7873869915362552
SIM,1926,17,na,1943,6203
SIM,1878,28,35-39,1906,2
STAT,1885,46,30-34,1931,0.0954196451659621
STAT,1914,41,45-49,1955,0.1628538934763398
SIM,1881,28,na,1909,3101
STAT,1895,37,50-100,1932,1.5971367718083764
STAT,1908,26,25-29,1934,62.478091659834504
STAT,1828,37,na,1865,1873.7007018262748
STAT,1828,47,40-44,1875,0.20440531943699825
STAT,1914,23,45-49,1937,1.1300457306751965
STAT,1932,34,20-24,1966,3.2158065397103464
STAT,1824,75,na,1899,199.22532890877838
STAT,1923,31,45-49,1954,1.7922654881789124
SIM,1948,1,na,1949,5825
STAT,1900,41,45-49,1941,0.14462382857908004
STAT,1884,49,20-24,1933,0.011247423787119754
SIM,1895,48,na,1943,4392
STAT,1855,32,25-29,1887,6.902348377475616
STAT,1875,29,50-100,1904,0.6521747824043715
SIM,1827,64,na,1891,1272
STAT,1903,34,25-29,1937,8.27709945032215
STAT,1851,49,na,1900,1739.8070617088197
STAT,1923,26,20-24,1949,20.808194114153224
SIM,1888,38,na,1926,246
SIM,1911,34,25-29,1945,8
STAT,1872,53,50-100,1925,0.014880462568657238
SIM,1804,67,na,1871,592
STAT,1828,29,40-44,1857,5.113415928039935
SIM,1862,21,na,1883,3815
STAT,1889,22,30-34,1911,21.449996925495125
SIM,1925,16,25-29,1941,96
STAT,1903,48,na,1951,3154.1319115715214
STAT,1840,77,na,1917,340.3583788028018
STAT,1880,54,30-34,1934,0.006009729026083454
STAT,1921,16,45-49,1937,0.5640419338935688
STAT,1831,24,50-100,1855,0.6593172097243513
STAT,1888,26,na,1914,2763.89100477741
STAT,1898,18,50-100,1916,0.06570759594959127
STAT,1848,97,na,1945,5.027207625230131
STAT,1908,23,na,1931,3470.411638256803
STAT,1811,45,50-100,1856,1.192001287977352
SIM,1868,46,na,1914,1116
STAT,1928,19,35-39,1947,5.218919964025878
STAT,1945,16,30-34,1961,13.171420269478071
STAT,1948,20,na,1968,4152.948914081985
SIM,1847,44,na,1891,1445
SIM,1878,43,30-34,1921,5
STAT,1930,10,na,1940,5102.025573249593
SIM,1895,46,35-39,1941,1
STAT,1904,18,35-39,1922,0.7818846029693007
STAT,1887,46,35-39,1933,0.1545317488378535
STAT,1851,40,45-49,1891,1.1939624609224109
STAT,1854,101,na,1955,0.3172768051654071
SIM,1821,39,na,1860,2011
STAT,1819,53,25-29,1872,6.119096737706076E-4
STAT,1852,54,25-29,1906,0.0034673027112182733
STAT,1930,26,35-39,1956,18.96489180382418
STAT,1906,26,20-24,1932,17.046277214349413
STAT,1836,23,30-34,1859,17.884160663087986
STAT,1862,43,25-29,1905,0.543000434163763
STAT,1850,104,na,1954,0.03079952161661851
STAT,1871,29,na,1900,2363.6460225262044
STAT,1836,50,20-24,1886,5.952486765833483E-4
STAT,1800,65,na,1865,1403.1153980261536
STAT,1907,28,30-34,1935,36.61349615941817
STAT,1933,36,30-34,1969,2.467867110664536
SIM,1939,29,30-34,1968,61
STAT,1888,23,25-29,1911,65.86664825390653
STAT,1813,75,na,1888,765.3527161114176
STAT,1910,30,20-24,1940,2.344252431331079
STAT,1931,39,30-34,1970,2.3916920068278156
STAT,1902,32,50-100,1934,1.2902207313318108
STAT,1918,41,na,1959,3901.0738268325467
STAT,1834,53,20-24,1887,3.269177687213319E-4
STAT,1859,29,na,1888,1896.6583830311147
STAT,1910,49,40-44,1959,0.14460112743238868
SIM,1891,58,na,1949,1305
SIM,1886,71,na,1957,1742
STAT,1915,19,25-29,1934,8.893749298041083
STAT,1906,47,50-100,1953,0.19967887577227963
STAT,1886,26,25-29,1912,43.955568653412826
SIM,1932,29,15-19,1961,1
STAT,1825,50,45-49,1875,0.018520908694190034
STAT,1849,21,45-49,1870,0.715512036122131
STAT,1788,91,na,1879,7.464573777852012
STAT,1924,29,15-19,1953,0.8082514254014884
STAT,1907,46,30-34,1953,0.07989764958683145
STAT,1904,19,50-100,1923,0.06961913177186696
STAT,1894,20,45-49,1914,0.892045816112551
STAT,1836,32,na,1868,2096.490690969643
SIM,1903,48,na,1951,2571
STAT,1879,89,na,1968,295.59502489431566
STAT,1911,26,30-34,1937,37.91064875134008
STAT,1875,54,20-24,1929,7.368969730736522E-4
STAT,1854,26,na,1880,1395.6736355886342
STAT,1870,53,30-34,1923,0.005839012357948181
STAT,1904,36,35-39,1940,2.191584852357892
STAT,1918,18,35-39,1936,4.493851543475679
SIM,1910,39,35-39,1949,16
STAT,1926,31,50-100,1957,0.9917415788176532
SIM,1796,67,na,1863,998
SIM,1792,77,na,1869,282
SIM,1860,26,na,1886,2094
SIM,1905,2,na,1907,3894
STAT,1861,47,50-100,1908,0.2032992788577813
STAT,1924,27,50-100,1951,1.1477877398499445
STAT,1915,34,15-19,1949,0.12792343812517984
STAT,1838,67,na,1905,676.0514056343111
SIM,1915,33,na,1948,3358
SIM,1907,18,30-34,1925,10
SIM,1885,18,na,1903,1854
STAT,1817,43,50-100,1860,0.7624568922885037
STAT,1902,39,35-39,1941,2.1281009374537287
STAT,1936,29,35-39,1965,14.211564684469058
STAT,1928,37,35-39,1965,3.0335505875576034
STAT,1881,22,30-34,1903,16.820989772383165
STAT,1832,48,45-49,1880,0.02112494036231484
STAT,1872,70,na,1942,1404.981815381816
STAT,1842,48,30-34,1890,0.023728126097799722
STAT,1905,49,30-34,1954,0.07689719988394224
STAT,1861,79,na,1940,581.4059583125196
STAT,1848,21,30-34,1869,20.442113260296985
STAT,1886,44,25-29,1930,0.6560097208761067
STAT,1896,33,25-29,1929,13.445115428574203
SIM,1869,31,na,1900,3136
STAT,1829,42,25-29,1871,0.308937529068335
STAT,1911,44,30-34,1955,0.11916502543423843
SIM,1886,9,na,1895,3155
STAT,1896,21,na,1917,3127.0873157782903
SIM,1875,31,na,1906,2878
STAT,1941,27,25-29,1968,67.31497837016445
STAT,1856,44,50-100,1900,0.7485579438792663
STAT,1829,50,na,1879,863.3957465737053
STAT,1902,20,15-19,1922,4.673273119808299
STAT,1913,21,35-39,1934,9.036816870439509
SIM,1827,53,25-29,1880,1
SIM,1829,32,25-29,1861,3
STAT,1867,21,35-39,1888,5.581599905052732
STAT,1888,41,25-29,1929,0.7445078871508386
STAT,1859,40,45-49,1899,1.1981954049412873
STAT,1908,30,50-100,1938,0.7806152417080634
SIM,1912,36,35-39,1948,2
STAT,1812,50,na,1862,233.75408394803225
STAT,1827,48,35-39,1875,0.1265330972870711
STAT,1846,45,35-39,1891,0.08374316314154459
SIM,1890,4,na,1894,4061
STAT,1943,21,15-19,1964,5.600696971753696
STAT,1909,21,15-19,1930,4.911857578135337
STAT,1847,54,45-49,1901,0.012760102972719229
SIM,1898,28,na,1926,3876
STAT,1837,34,30-34,1871,17.191914616087036
STAT,1866,4,na,1870,2744.3036360009496
STAT,1828,31,25-29,1859,16.02760945155019
STAT,1922,31,25-29,1953,10.368747665338423
STAT,1840,21,25-29,1861,28.872396295533015
STAT,1829,42,30-34,1871,0.5530978320367644
STAT,1852,45,50-100,1897,0.24968265205835177
STAT,1822,41,30-34,1863,2.096364942557132
STAT,1830,47,na,1877,1747.8063406984795
SIM,1859,34,30-34,1893,42
SIM,1884,8,na,1892,3855
STAT,1920,19,35-39,1939,4.622366014715549
SIM,1917,21,15-19,1938,4
STAT,1851,32,50-100,1883,0.7531836358054447
STAT,1920,51,na,1971,3957.757983704399
STAT,1845,25,25-29,1870,25.920287539728992
STAT,1941,24,15-19,1965,5.4348560421397725
STAT,1889,8,na,1897,3130.438607272809
STAT,1916,20,45-49,1936,1.1698841828815296
SIM,1880,86,na,1966,2623
STAT,1882,69,na,1951,1405.0410939874653
SIM,1854,26,na,1880,2119
STAT,1819,60,na,1879,495.5749013329308
STAT,1937,21,20-24,1958,107.19785105647512
STAT,1905,30,40-44,1935,6.287727025798119
STAT,1867,64,na,1931,1644.0178114075054
SIM,1922,27,na,1949,3366
STAT,1824,47,na,1871,502.3836428869441
SIM,1866,11,na,1877,3337
STAT,1907,38,na,1945,3447.5390472016243
SIM,1948,20,na,1968,5817
STAT,1877,51,20-24,1928,7.526610325683066E-4
SIM,1837,42,30-34,1879,6
SIM,1928,6,na,1934,4662
STAT,1841,20,50-100,1861,0.5836062232249242
STAT,1921,34,45-49,1955,1.715570269342296
STAT,1829,59,na,1888,722.4595939147957
STAT,1877,21,20-24,1898,70.16567346572674
SIM,1905,39,25-29,1944,1
SIM,1837,24,30-34,1861,28
STAT,1904,18,40-44,1922,0.2606282160798298
STAT,1923,29,30-34,1952,44.1944951396709
STAT,1910,21,50-100,1931,0.6128510252096249
STAT,1952,15,30-34,1967,14.480953835216308
STAT,1920,33,50-100,1953,0.8902050496287355
SIM,1920,28,40-44,1948,4
STAT,1819,35,25-29,1854,2.1799983398385536
STAT,1811,53,25-29,1864,0.015618951465559918
SIM,1904,23,25-29,1927,91
STAT,1860,85,na,1945,223.6367213719873
SIM,1897,43,na,1940,2431
STAT,1892,41,45-49,1933,1.8613652715002744
STAT,1912,28,40-44,1940,4.523930536893981
STAT,1854,21,25-29,1875,37.66909262508814
STAT,1896,33,30-34,1929,22.91877224388225
SIM,1808,57,na,1865,1261
STAT,1925,41,20-24,1966,0.021216185297120004
SIM,1863,5,na,1868,1800
SIM,1897,74,na,1971,1237
STAT,1867,17,25-29,1884,5.478705539584826
STAT,1845,43,25-29,1888,0.3203557178689837
STAT,1945,19,50-100,1964,0.40447465237576913
STAT,1825,60,na,1885,1253.9853632295246
STAT,1856,16,40-44,1872,0.1562577175832061
SIM,1931,29,25-29,1960,1
STAT,1861,39,na,1900,1939.6120159693648
STAT,1917,31,15-19,1948,0.1333107279112992
STAT,1914,21,25-29,1935,89.56719091345231
STAT,1850,67,na,1917,731.99281666514
STAT,1837,52,30-34,1889,0.004790256290899784
STAT,1878,53,30-34,1931,0.006026061294510217
STAT,1911,41,20-24,1952,0.016761973381878483
STAT,1825,106,na,1931,0.007477006210200637
STAT,1873,30,25-29,1903,10.591108798912432
STAT,1889,25,35-39,1914,11.698311375825606
STAT,1901,37,25-29,1938,0.8689200117019477
SIM,1848,26,na,1874,2589
STAT,1798,100,na,1898,0.45063428888477314
STAT,1868,49,35-39,1917,0.132398589759565
STAT,1849,29,50-100,1878,0.6297913233900526
SIM,1885,58,na,1943,1103
SIM,1836,31,25-29,1867,1
STAT,1923,29,25-29,1952,74.23943221453113
SIM,1856,52,na,1908,258
STAT,1925,23,20-24,1948,131.47387507322506
STAT,1890,36,na,1926,2865.8906996393657
STAT,1903,31,20-24,1934,3.8527027003640475
STAT,1919,26,30-34,1945,41.91754989063339
SIM,1837,54,na,1891,1678
SIM,1908,20,na,1928,2795
SIM,1903,26,45-49,1929,18
SIM,1875,17,25-29,1892,4
STAT,1878,35,30-34,1913,5.5355154814170024
STAT,1880,42,50-100,1922,1.0954099390604617
STAT,1840,21,30-34,1861,8.983803000083704
SIM,1878,25,30-34,1903,2
STAT,1858,29,20-24,1887,9.039950718159632
STAT,1915,37,25-29,1952,0.9806037858484348
SIM,1853,43,25-29,1896,7
SIM,1905,48,50-100,1953,1
SIM,1872,11,na,1883,2546
STAT,1895,22,25-29,1917,74.46924068072698
STAT,1868,49,na,1917,2127.683895018494
STAT,1881,22,25-29,1903,54.05976542304293
STAT,1919,44,30-34,1963,0.13624924503897642
STAT,1872,17,35-39,1889,0.5512625282231357
STAT,1865,97,na,1962,12.876805117565626
STAT,1873,49,45-49,1922,0.23702946217937668
STAT,1936,35,na,1971,3663.1115534758765
STAT,1831,53,50-100,1884,0.01228228909853
STAT,1873,64,na,1937,1783.1726389622427
STAT,1868,5,na,1873,2717.2581459102316
SIM,1916,27,na,1943,4341
STAT,1842,32,na,1874,649.9275567227149
STAT,1946,18,40-44,1964,1.534119754175951
SIM,1930,31,25-29,1961,11
STAT,1807,75,na,1882,487.7615795018684
STAT,1931,20,40-44,1951,4.356092184274782
STAT,1794,91,na,1885,0.23636517193489473
SIM,1936,32,35-39,1968,4
STAT,1860,46,25-29,1906,0.04712304079991128
STAT,1923,47,25-29,1970,0.06140104928092444
STAT,1908,1,na,1909,4006.3767371032072
STAT,1793,81,na,1874,186.1267045463765
SIM,1886,38,35-39,1924,135
STAT,1816,54,50-100,1870,0.042470535073694166
STAT,1905,35,40-44,1940,1.3718972210869862
STAT,1868,30,45-49,1898,1.697845736180053
STAT,1928,16,30-34,1944,15.278890259305523
STAT,1907,42,45-49,1949,0.1514568950969743
STAT,1870,44,na,1914,2273.0497747395107
STAT,1868,19,35-39,1887,0.5332404333711719
STAT,1884,44,20-24,1928,0.14997524818654667
SIM,1870,28,na,1898,2469
STAT,1808,85,na,1893,64.20330727093709
STAT,1909,28,35-39,1937,14.1523263490621
STAT,1851,38,30-34,1889,4.21038994238297
STAT,1878,38,35-39,1916,7.241016807891286
STAT,1910,27,25-29,1937,62.84818505789232
SIM,1906,65,na,1971,3009
STAT,1904,16,45-49,1920,0.09355520747874255
SIM,1926,5,na,1931,6370
STAT,1930,24,45-49,1954,1.422339959866285
SIM,1854,66,na,1920,347
STAT,1832,45,40-44,1877,0.0158488454403505
STAT,1872,9,na,1881,2689.735111687386
STAT,1912,25,na,1937,3673.54908659414
STAT,1941,13,na,1954,4005.353456718382
STAT,1857,62,na,1919,1402.5303680364968
STAT,1937,28,40-44,1965,4.49442012925969
SIM,1883,54,na,1937,1967
STAT,1853,23,30-34,1876,16.2016324299929
SIM,1843,26,na,1869,535
STAT,1875,90,na,1965,203.9671156731067
STAT,1911,31,50-100,1942,0.7992858023973263
SIM,1836,43,25-29,1879,3
STAT,1806,53,45-49,1859,0.03755131661007795
STAT,1941,24,20-24,1965,113.52735858529847
STAT,1841,20,30-34,1861,25.49191706579553
STAT,1852,51,20-24,1903,7.463346694164804E-4
STAT,1920,20,na,1940,4031.4865324628427
STAT,1935,18,35-39,1953,5.680188649705018
STAT,1853,111,na,1964,3.687561007013979E-4
SIM,1882,10,na,1892,2312
STAT,1873,44,45-49,1917,1.5145003708197233
STAT,1884,64,na,1948,1664.0825254624044
STAT,1910,21,na,1931,3554.3319096550904
STAT,1924,46,30-34,1970,0.10537118464142461
STAT,1840,37,na,1877,997.4717262683237
SIM,1852,62,na,1914,1806
STAT,1924,10,na,1934,4687.224448731832
STAT,1827,33,30-34,1860,17.723028112032548
STAT,1872,47,35-39,1919,0.13953676868600476
STAT,1909,21,45-49,1930,1.038229555689234
STAT,1909,28,50-100,1937,0.9382529366307942
STAT,1931,25,40-44,1956,5.980521128602716
SIM,1866,51,na,1917,2765
SIM,1909,33,25-29,1942,5
SIM,1910,32,15-19,1942,2
STAT,1838,95,na,1933,5.6701780701452025
SIM,1782,78,na,1860,514
SIM,1881,44,45-49,1925,24
SIM,1900,29,30-34,1929,201
STAT,1859,26,30-34,1885,20.45033307389535
STAT,1934,31,15-19,1965,0.17436563006434166
SIM,1946,9,na,1955,3798
STAT,1825,69,na,1894,903.7317809382984
STAT,1906,23,50-100,1929,0.5886849483728749
STAT,1845,77,na,1922,428.92608756975926
STAT,1940,30,30-34,1970,16.14122374893867
STAT,1836,38,35-39,1874,6.583807153415428
STAT,1861,45,30-34,1906,0.08130561905652002
STAT,1871,21,25-29,1892,57.27740013085302
SIM,1903,17,na,1920,2994
STAT,1919,45,45-49,1964,0.23369782849361992
STAT,1848,29,na,1877,2382.0927528424863
SIM,1900,40,na,1940,4149
SIM,1870,25,na,1895,2472
STAT,1938,30,na,1968,3766.4021041415726
STAT,1860,46,30-34,1906,0.07919288877421166
STAT,1885,17,15-19,1902,5.833362881479666
STAT,1861,70,na,1931,1166.8567806444094
STAT,1781,96,na,1877,1.6795240973677037
SIM,1937,20,na,1957,2988
STAT,1830,36,40-44,1866,4.034527855973344
STAT,1869,44,25-29,1913,0.6392423935384149
STAT,1871,15,25-29,1886,5.756933740392536
STAT,1902,32,15-19,1934,0.20053285117686312
STAT,1817,53,20-24,1870,4.893227248788077E-4
STAT,1844,36,na,1880,2489.703054249079
STAT,1915,39,15-19,1954,0.018932766320822785
STAT,1835,109,na,1944,5.383296714184207E-4
STAT,1923,33,35-39,1956,10.359606302529697
SIM,1928,21,20-24,1949,6
SIM,1904,61,na,1965,3873
SIM,1883,51,na,1934,1967
STAT,1933,32,15-19,1965,0.17200112821656713
STAT,1811,49,na,1860,1777.5090766899966
STAT,1820,85,na,1905,188.5255631763915
STAT,1869,32,25-29,1901,10.33562646415251
STAT,1934,31,na,1965,5131.802428471675
STAT,1870,31,15-19,1901,0.14255111135977452
SIM,1808,97,na,1905,6
SIM,1915,42,45-49,1957,3
STAT,1888,20,20-24,1908,80.01085794432991
SIM,1824,59,na,1883,1811
SIM,1896,20,20-24,1916,28
SIM,1813,44,35-39,1857,1
SIM,1901,33,50-100,1934,33
STAT,1924,28,30-34,1952,45.024352434960356
SIM,1844,67,na,1911,1600
SIM,1931,33,35-39,1964,5
STAT,1825,48,30-34,1873,0.12135606489037268
STAT,1894,24,30-34,1918,22.509341826702283
SIM,1882,13,na,1895,2283
STAT,1926,34,50-100,1960,0.989888175816823
STAT,1857,65,na,1922,1296.812040316431
STAT,1850,38,50-100,1888,0.5699530318945802
STAT,1892,39,30-34,1931,6.532106231877987
SIM,1876,72,na,1948,1427
STAT,1912,43,30-34,1955,0.12113959606150626
STAT,1881,52,50-100,1933,0.014186322479198762
STAT,1777,88,na,1865,114.93777846195728
STAT,1873,46,40-44,1919,0.17611207070623308
STAT,1822,44,35-39,1866,3.087663177898026
STAT,1781,93,na,1874,7.3206362537664855
STAT,1896,9,na,1905,3420.319628849939
SIM,1875,28,na,1903,3037
SIM,1869,31,15-19,1900,1
STAT,1878,39,na,1917,2399.5960148570093
STAT,1858,113,na,1971,1.0990824659829229E-4
STAT,1811,50,20-24,1861,0.003455269960028183
STAT,1877,36,30-34,1913,5.43620226249675
SIM,1810,67,na,1877,3098
STAT,1916,36,25-29,1952,0.9993275571300385
STAT,1819,50,50-100,1869,0.002735272941329813
SIM,1913,47,na,1960,2904
STAT,1837,37,35-39,1874,6.904864594809243
STAT,1832,70,na,1902,1191.0337871913857
STAT,1925,38,25-29,1963,1.1697515928375903
STAT,1856,31,30-34,1887,12.826539786133466
STAT,1872,35,35-39,1907,7.149801485541485
STAT,1833,52,na,1885,912.8787812399098
STAT,1834,37,na,1871,1174.0746343055166
SIM,1889,6,na,1895,3895
STAT,1931,23,45-49,1954,1.4445902891977969
SIM,1880,29,35-39,1909,8
SIM,1931,32,na,1963,4974
STAT,1936,27,45-49,1963,1.6369462886188852
STAT,1819,69,na,1888,354.298310182417
STAT,1872,29,35-39,1901,9.592990602536407
STAT,1846,22,na,1868,1562.475550127339
STAT,1886,48,40-44,1934,0.1750585699988209
SIM,1949,6,na,1955,4496
STAT,1919,27,45-49,1946,1.8418791328359847
SIM,1925,32,na,1957,4732
STAT,1820,44,30-34,1864,1.831888437022958
STAT,1831,46,35-39,1877,0.13373065377221566
STAT,1856,24,na,1880,1758.0722277202722
STAT,1905,1,na,1906,3914.9164593097107
STAT,1911,34,50-100,1945,0.7892173949018136
SIM,1847,84,na,1931,1018
SIM,1830,44,35-39,1874,10
STAT,1853,53,25-29,1906,0.0027023397729309634
STAT,1804,50,50-100,1854,0.09932868515808786
STAT,1907,24,15-19,1931,4.783461666744883
SIM,1967,3,na,1970,6509
STAT,1805,49,na,1854,488.85216965658435
SIM,1871,66,na,1937,1577
SIM,1883,0,na,1883,2589
STAT,1880,23,25-29,1903,59.246148541407365
STAT,1889,40,25-29,1929,0.7811044556237007
STAT,1897,20,50-100,1917,0.5447981397545506
STAT,1928,31,na,1959,4695.8166588684635
STAT,1907,42,15-19,1949,0.001397526235113679
STAT,1905,33,45-49,1938,1.434116705856626
SIM,1850,67,na,1917,719
STAT,1877,24,30-34,1901,17.968417021550188
SIM,1864,31,30-34,1895,7
STAT,1846,9,na,1855,1812.62151
SIM,1849,11,na,1860,2663
STAT,1888,57,na,1945,2319.443154252838
STAT,1916,48,25-29,1964,0.053516258767709456
STAT,1858,54,20-24,1912,5.480261883309197E-4
STAT,1888,0,na,1888,3456.8490306808444
SIM,1918,53,na,1971,4213
SIM,1927,27,na,1954,1695
SIM,1894,38,na,1932,1490
SIM,1924,36,25-29,1960,2
STAT,1922,17,40-44,1939,1.6006941261868017
STAT,1911,44,25-29,1955,0.06656064510947474
STAT,1845,47,40-44,1892,0.08455630004292003
STAT,1872,79,na,1951,700.0557500575228
STAT,1890,3,na,1893,3200.4117192379845
SIM,1923,8,na,1931,4291
STAT,1942,26,25-29,1968,68.32361220718316
STAT,1882,52,45-49,1934,0.01382036742019483
STAT,1936,29,40-44,1965,4.412059887507457
STAT,1905,17,40-44,1922,0.2630732250291399
SIM,1830,26,35-39,1856,28
STAT,1819,39,40-44,1858,0.9976781472830726
STAT,1821,70,na,1891,708.5764940255864
STAT,1910,42,20-24,1952,0.016503740055490716
STAT,1831,34,35-39,1865,10.462408229663692
STAT,1939,15,na,1954,3652.8403445877702
STAT,1887,16,na,1903,2786.694354204944
SIM,1861,11,na,1872,2632
SIM,1821,79,na,1900,446
STAT,1952,18,35-39,1970,4.981010047371193
STAT,1843,46,25-29,1889,0.05737645482683201
STAT,1904,31,40-44,1935,6.221169389900626
SIM,1849,70,na,1919,283
STAT,1823,34,na,1857,2300.275353387919
STAT,1950,18,30-34,1968,14.270346299240794
STAT,1901,22,20-24,1923,96.35449558665151
STAT,1945,17,45-49,1962,0.5396610489617926
STAT,1866,23,40-44,1889,1.9039019966035702
STAT,1868,34,30-34,1902,16.719450822456416
STAT,1915,34,20-24,1949,2.4281315647171073
STAT,1941,29,15-19,1970,0.7212700646819626
SIM,1855,11,na,1866,3381
SIM,1818,56,na,1874,672
STAT,1832,43,45-49,1875,0.13297161570497373
STAT,1865,43,50-100,1908,0.9575635795531641
SIM,1878,76,na,1954,1360
STAT,1799,66,na,1865,156.41844602219564
STAT,1910,58,na,1968,3215.1823889503457
STAT,1901,40,20-24,1941,0.015575533151512512
STAT,1881,90,na,1971,247.9909379432073
STAT,1893,3,na,1896,3305.9473476541384
SIM,1889,79,na,1968,986
STAT,1897,32,30-34,1929,23.187411556026543
STAT,1917,16,25-29,1933,9.223484805764034
SIM,1876,10,na,1886,4087
STAT,1890,64,na,1954,2104.469328600697
STAT,1915,16,20-24,1931,28.043090238145375
SIM,1876,34,30-34,1910,10
STAT,1862,28,35-39,1890,8.189459469163495
STAT,1893,16,na,1909,3166.0976637708372
STAT,1926,45,na,1971,4515.309996403856
STAT,1812,52,25-29,1864,8.714616108801745E-4
SIM,1903,24,25-29,1927,1
STAT,1831,28,35-39,1859,10.991000758832818
STAT,1931,41,45-49,1972,0.22109323540896528
SIM,1893,53,na,1946,2792
STAT,1868,16,30-34,1884,1.576631841665995
SIM,1855,41,30-34,1896,2
STAT,1922,35,40-44,1957,1.6872958289708946
STAT,1917,43,15-19,1960,0.0015787265282505513
STAT,1910,24,20-24,1934,102.60756338651929
STAT,1930,21,40-44,1951,4.290073061755132
STAT,1863,65,na,1928,1442.7417778849765
STAT,1870,84,na,1954,331.6429581747509
SIM,1872,51,na,1923,2251
STAT,1853,26,35-39,1879,8.729861056049389
STAT,1837,25,50-100,1862,0.6678934282503456
STAT,1892,31,na,1923,2966.5508531416444
SIM,1803,57,na,1860,1535
SIM,1894,32,25-29,1926,9
STAT,1866,79,na,1945,638.1563568994175
STAT,1823,37,na,1860,2279.463616831752
SIM,1849,29,20-24,1878,13
STAT,1887,13,na,1900,2838.092680440821
STAT,1839,77,na,1916,803.0774378514204
STAT,1880,27,40-44,1907,3.1098580003347114
STAT,1826,70,na,1896,1118.5813904355537
SIM,1827,41,25-29,1868,22
STAT,1845,29,40-44,1874,1.783386674184624
STAT,1833,29,15-19,1862,0.26480937821389444
STAT,1830,39,45-49,1869,1.780946384869904
SIM,1861,26,35-39,1887,74
SIM,1864,25,na,1889,2434
SIM,1911,43,na,1954,2463
STAT,1849,23,40-44,1872,2.107573615211324
STAT,1815,49,20-24,1864,0.001184483082634896
STAT,1887,21,15-19,1908,3.6421100486554576
STAT,1847,41,30-34,1888,1.0587090661648721
STAT,1851,35,50-100,1886,1.0006119397065703
STAT,1864,40,25-29,1904,0.5896795502633431
STAT,1819,41,25-29,1860,0.15321446768418115
STAT,1820,40,15-19,1860,0.02364694669109144
STAT,1890,6,na,1896,3162.538732004235
STAT,1838,36,na,1874,1113.6744388853006
STAT,1834,77,na,1911,380.94217092094067
STAT,1879,30,20-24,1909,2.7951943662054117
STAT,1875,50,na,1925,2242.7578180858536
SIM,1940,16,20-24,1956,33
STAT,1854,15,25-29,1869,3.813905443273306
SIM,1878,79,na,1957,1184
STAT,1866,26,45-49,1892,1.0169835527427435
SIM,1885,20,15-19,1905,25
SIM,1899,38,na,1937,1799
SIM,1835,59,na,1894,1190
STAT,1884,47,25-29,1931,0.05488182927298817
SIM,1887,30,20-24,1917,1
STAT,1924,42,45-49,1966,0.19606093348347228
STAT,1901,25,25-29,1926,59.547758313755125
STAT,1932,16,20-24,1948,178.71108822305445
STAT,1812,90,na,1902,6.243745500076474
SIM,1862,15,25-29,1877,56
SIM,1943,20,na,1963,4976
STAT,1909,25,30-34,1934,37.63362269256914
STAT,1886,32,25-29,1918,10.606729935881411
SIM,1911,40,na,1951,2467
STAT,1855,47,35-39,1902,0.0922251340097725
STAT,1817,96,na,1913,2.7201623255810414
STAT,1841,39,20-24,1880,0.9905659763015754
SIM,1840,74,na,1914,1993
SIM,1930,10,na,1940,5630
STAT,1923,30,30-34,1953,18.015367742058512
STAT,1861,41,15-19,1902,0.011536813740263888
STAT,1900,23,20-24,1923,95.16849115344594
STAT,1855,39,na,1894,1543.5782421269623
STAT,1827,36,35-39,1863,7.060472443317418
STAT,1868,30,15-19,1898,0.13865304785150517
SIM,1854,20,15-19,1874,11
STAT,1850,36,na,1886,1116.6625505111938
STAT,1905,4,na,1909,3783.772208316117
STAT,1905,43,na,1948,3311.6873011722573
SIM,1890,21,30-34,1911,106
STAT,1935,15,30-34,1950,16.61979930210131
STAT,1858,31,35-39,1889,7.814401533967526
STAT,1855,23,50-100,1878,0.3130353028279376
STAT,1916,38,50-100,1954,0.4219870363004303
STAT,1929,31,40-44,1960,4.938821583230586
SIM,1937,31,40-44,1968,7
STAT,1856,19,45-49,1875,0.05482601327820052
STAT,1836,35,30-34,1871,5.11799495405232
SIM,1880,32,30-34,1912,30
STAT,1894,27,35-39,1921,12.270142229830624
STAT,1913,23,30-34,1936,28.57028976955209
STAT,1879,49,50-100,1928,0.2466858193552538
SIM,1900,4,na,1904,4181
STAT,1869,48,40-44,1917,0.17058414796964974
STAT,1878,64,na,1942,1788.5434852976127
STAT,1899,28,50-100,1927,0.8706593641635719
STAT,1859,29,35-39,1888,7.668360698961259
STAT,1863,62,na,1925,1560.3565465238125
STAT,1846,62,na,1908,1082.4936227511164
STAT,1919,42,40-44,1961,0.2674556031294042
STAT,1945,22,30-34,1967,31.152167815870698
STAT,1883,51,45-49,1934,0.014028369982177973
STAT,1846,20,15-19,1866,2.4458173331513318
STAT,1911,42,35-39,1953,0.19002779819133092
STAT,1856,44,45-49,1900,1.0604570902011703
STAT,1921,18,40-44,1939,1.571320795352845
STAT,1882,32,na,1914,2284.6786829870066
STAT,1840,101,na,1941,0.2246856608685115
STAT,1859,27,15-19,1886,0.3658083571095279
STAT,1824,78,na,1902,151.20641028545583
SIM,1919,35,50-100,1954,1
STAT,1917,31,na,1948,3923.504402697293
STAT,1846,24,30-34,1870,12.83040007207225
SIM,1893,13,na,1906,3562
SIM,1898,20,25-29,1918,860
STAT,1835,44,50-100,1879,0.9335397976301905
STAT,1853,50,20-24,1903,5.803967378920166E-4
STAT,1871,19,40-44,1890,0.1814753182862329
STAT,1931,20,na,1951,4731.075526381792
STAT,1870,47,30-34,1917,0.09605322473866394
STAT,1924,24,15-19,1948,6.1819986861001075
STAT,1830,78,na,1908,565.5069896229797
STAT,1905,31,25-29,1936,8.49376961153682
SIM,1839,58,na,1897,334
STAT,1879,51,25-29,1930,0.003650923044551264
STAT,1895,16,25-29,1911,7.389796080571239
STAT,1901,43,25-29,1944,0.061899789062566275
STAT,1851,77,na,1928,682.6904979224705
STAT,1940,29,30-34,1969,39.46817058006068
SIM,1927,32,30-34,1959,1
SIM,1918,13,na,1931,4480
STAT,1811,103,na,1914,0.08694582905239623
SIM,1818,59,na,1877,530
SIM,1839,18,na,1857,1319
STAT,1916,33,20-24,1949,2.473425920196424
STAT,1916,46,na,1962,3725.9752853173773
STAT,1845,31,25-29,1876,6.106257123758181
STAT,1856,20,50-100,1876,0.3451103590500733
STAT,1854,33,25-29,1887,5.7718490376849285
STAT,1911,43,na,1954,3483.7698883308353
SIM,1797,77,na,1874,564
STAT,1807,49,25-29,1856,0.1893975760862644
STAT,1882,21,30-34,1903,17.10514911331875
SIM,1836,44,na,1880,1905
STAT,1893,40,15-19,1933,0.01744383234487486
STAT,1887,25,30-34,1912,27.905083401857862
STAT,1903,19,35-39,1922,0.7747217077067486
STAT,1898,15,35-39,1913,0.7412865977285904
STAT,1841,39,50-100,1880,1.5776895176386572
STAT,1877,39,35-39,1916,7.1076043399937365
STAT,1881,28,na,1909,2245.774836828137
STAT,1906,47,25-29,1953,0.04683022460645254
STAT,1829,46,40-44,1875,0.08022191625042498
STAT,1846,42,30-34,1888,0.6891465751136305
STAT,1887,75,na,1962,1355.8650529698673
STAT,1937,22,35-39,1959,9.074471928791292
STAT,1925,35,20-24,1960,0.3140378546267669
SIM,1887,13,na,1900,3965
STAT,1900,28,50-100,1928,0.8830372703031638
STAT,1910,45,25-29,1955,0.049168018617548034
SIM,1922,0,na,1922,3868
STAT,1925,37,50-100,1962,0.4993079482910207
SIM,1885,39,35-39,1924,8
SIM,1839,24,35-39,1863,157
STAT,1890,49,45-49,1939,0.157795555390023
SIM,1867,36,na,1903,2237
STAT,1867,19,20-24,1886,16.938977995028917
SIM,1848,36,45-49,1884,92
STAT,1863,27,35-39,1890,8.23740885034229
STAT,1833,39,25-29,1872,1.5197536411413934
STAT,1873,24,na,1897,2410.831371023667
SIM,1876,13,na,1889,4003
STAT,1868,37,35-39,1905,6.831528727045182
STAT,1828,43,25-29,1871,0.7896965797605628
SIM,1902,17,35-39,1919,60
SIM,1931,35,na,1966,4966
STAT,1860,48,20-24,1908,0.009666500910231527
STAT,1928,5,na,1933,5027.765176516771
STAT,1787,81,na,1868,95.36075060574247
STAT,1931,21,25-29,1952,119.31829401379129
STAT,1834,110,na,1944,1.2178365011525251E-4
SIM,1859,28,30-34,1887,1
STAT,1928,34,30-34,1962,19.52511139499084
STAT,1898,56,na,1954,2742.73011526194
SIM,1892,68,na,1960,3096
SIM,1823,34,na,1857,1754
SIM,1876,37,35-39,1913,10
SIM,1914,29,25-29,1943,158
STAT,1839,16,40-44,1855,0.22360891219686863
SIM,1906,38,30-34,1944,8
STAT,1922,46,na,1968,4183.786465701131
SIM,1809,46,35-39,1855,1
SIM,1895,25,30-34,1920,189
STAT,1866,49,30-34,1915,0.08651594450394579
STAT,1914,20,40-44,1934,3.2699339487743626
STAT,1862,25,30-34,1887,21.84002297417305
STAT,1867,50,50-100,1917,0.014488378738404264
STAT,1927,23,25-29,1950,112.52833281646195
SIM,1815,49,25-29,1864,3
STAT,1895,34,25-29,1929,13.210244551696881
STAT,1842,50,45-49,1892,0.0036543977860872792
STAT,1826,45,50-100,1871,0.36094574800322116
STAT,1935,33,50-100,1968,1.1349282882262712
SIM,1866,5,na,1871,3337
STAT,1951,12,na,1963,4634.117886534484
STAT,1920,31,20-24,1951,2.648143063295316
STAT,1933,8,na,1941,5302.826640907169
STAT,1829,81,na,1910,197.47068971750397
STAT,1843,43,20-24,1886,0.15950442119317798
STAT,1869,50,na,1919,2203.9454454139413
STAT,1890,30,25-29,1920,12.499442362549681
STAT,1858,87,na,1945,134.54297471381287
STAT,1835,22,na,1857,2150.4374930996655
STAT,1919,32,30-34,1951,16.772234159804622
STAT,1863,39,40-44,1902,3.69951544384249
STAT,1844,16,15-19,1860,7.517870612918769
STAT,1867,24,na,1891,2222.695451725589
STAT,1891,46,na,1937,2775.064901481886
STAT,1857,54,50-100,1911,0.011270570141888678
STAT,1942,23,20-24,1965,115.21690237706443
STAT,1890,28,50-100,1918,0.7716903095125867
STAT,1941,30,45-49,1971,1.6351953345056685
STAT,1900,28,15-19,1928,0.6262951684826535
STAT,1904,34,45-49,1938,1.4183093251198517
STAT,1814,85,na,1899,185.52994657277964
STAT,1875,28,na,1903,2441.980561188343
SIM,1863,36,40-44,1899,12
SIM,1860,66,na,1926,1638
STAT,1908,41,15-19,1949,0.001417935506748772
STAT,1936,25,25-29,1961,62.42028427975392
STAT,1855,36,40-44,1891,2.911135355408187
STAT,1864,104,na,1968,0.49286843972516875
STAT,1856,21,na,1877,1796.4914787961593
STAT,1887,43,30-34,1930,1.2562679678837008
SIM,1871,39,40-44,1910,2
STAT,1906,29,25-29,1935,60.81767282745761
STAT,1870,13,na,1883,2628.21910919722
STAT,1904,21,30-34,1925,25.525167241258785
SIM,1867,61,na,1928,1256
STAT,1841,49,30-34,1890,0.10554245690736541
STAT,1870,26,35-39,1896,9.652347481646832
STAT,1927,21,na,1948,4476.03655857442
STAT,1873,42,25-29,1915,0.6579006185619787
STAT,1925,20,na,1945,4357.022347622736
STAT,1872,14,na,1886,2611.6688997590777
STAT,1894,32,15-19,1926,0.18109393424950287
STAT,1919,16,50-100,1935,0.08216368599065044
STAT,1890,19,45-49,1909,0.07865580993485233
STAT,1901,16,na,1917,3540.0138830772025
STAT,1845,12,na,1857,1497.2155601882919
STAT,1928,17,45-49,1945,0.6246497491567979
SIM,1851,52,na,1903,1098
SIM,1894,63,na,1957,1150
STAT,1849,41,35-39,1890,1.5326807646907232
STAT,1900,38,25-29,1938,0.856614828560177
STAT,1801,81,na,1882,189.38378327614467
STAT,1902,24,30-34,1926,24.92553112466064
STAT,1859,44,30-34,1903,0.8989188147469597
SIM,1850,33,na,1883,1714
STAT,1855,47,50-100,1902,0.1617892346001684
STAT,1889,42,na,1931,2779.826096670354
STAT,1918,27,30-34,1945,41.13652094487427
STAT,1860,29,na,1889,1939.6117635180517
STAT,1812,59,na,1871,195.60373454679004
STAT,1919,17,35-39,1936,4.575500044514107
SIM,1858,25,na,1883,2433
SIM,1870,59,na,1929,1021
SIM,1850,22,40-44,1872,7
STAT,1871,52,30-34,1923,0.005906317184631992
STAT,1958,13,na,1971,5112.805020649699
STAT,1827,41,15-19,1868,0.013284243326319669
STAT,1939,17,20-24,1956,134.21621276576056
STAT,1943,28,35-39,1971,15.799474739352387
STAT,1892,16,45-49,1908,0.08107402173314882
STAT,1881,19,35-39,1900,0.5153934016663229
STAT,1806,51,25-29,1857,0.009579683300680179
STAT,1880,52,40-44,1932,0.010871143784342596
STAT,1846,15,35-39,1861,0.4130910776581046
STAT,1834,28,20-24,1862,6.730917682062656
STAT,1842,22,40-44,1864,0.6524601619955072
STAT,1832,49,20-24,1881,9.665212823535225E-4
STAT,1858,41,45-49,1899,1.1481021631428256
STAT,1782,75,na,1857,1221.3127839970311
SIM,1837,20,15-19,1857,20
STAT,1807,72,na,1879,648.1853411381773
STAT,1847,44,35-39,1891,1.6150884863506019
STAT,1821,49,45-49,1870,0.2457252126335128
SIM,1884,34,20-24,1918,2
SIM,1920,23,na,1943,4339
STAT,1833,27,na,1860,1166.103805572225
STAT,1830,51,30-34,1881,0.0045652045035785415
STAT,1860,31,50-100,1891,0.7505205655735011
STAT,1877,42,25-29,1919,0.6510641168099237
SIM,1953,10,na,1963,4654
STAT,1884,21,35-39,1905,5.603009052493686
STAT,1911,22,15-19,1933,4.991617499500375
SIM,1867,37,25-29,1904,10
STAT,1820,44,50-100,1864,1.6833569384352454
SIM,1841,34,50-100,1875,14
STAT,1902,17,25-29,1919,7.97966276334173
STAT,1876,34,20-24,1910,2.7091488465019964
STAT,1837,22,30-34,1859,18.696767007735968
STAT,1851,15,45-49,1866,0.06347097716308499
STAT,1900,45,30-34,1945,0.07639521152319903
STAT,1934,35,30-34,1969,2.5023938364391163
STAT,1881,29,50-100,1910,0.599774518608316
STAT,1899,42,45-49,1941,0.14177949695288683
STAT,1914,43,35-39,1957,0.19644544996289615
SIM,1886,34,na,1920,3026
STAT,1891,2,na,1893,3278.0386613824385
SIM,1793,87,na,1880,591
STAT,1926,40,20-24,1966,0.02164484855457777
STAT,1877,18,30-34,1895,1.6137302255867692
STAT,1884,29,30-34,1913,23.933647887262314
STAT,1906,53,na,1959,3141.0477542283315
STAT,1847,47,na,1894,2024.6360246075697
STAT,1919,26,na,1945,4007.6339498730895
SIM,1864,4,na,1868,2555
STAT,1909,9,na,1918,3851.474639187848
STAT,1851,46,na,1897,1781.952505962904
STAT,1826,36,15-19,1862,0.09415808550440208
SIM,1901,50,na,1951,3325
STAT,1869,4,na,1873,2996.5538642618085
STAT,1839,109,na,1948,6.609931460478682E-4
STAT,1884,33,50-100,1917,0.873395229538038
STAT,1941,28,50-100,1969,1.0174648794024859
STAT,1880,45,35-39,1925,0.146790617141292
STAT,1882,24,35-39,1906,5.551973218567569
STAT,1864,19,na,1883,2347.309136029253
STAT,1861,26,25-29,1887,35.69153183677145
STAT,1923,49,15-19,1972,4.238965397396271E-4
STAT,1957,15,15-19,1972,59.342720858234955
STAT,1912,46,35-39,1958,0.1227725264214926
STAT,1841,56,na,1897,2271.265102941466
STAT,1909,43,25-29,1952,0.06571526191270669
STAT,1813,54,35-39,1867,0.0287342962223519
SIM,1866,100,na,1966,18
SIM,1892,29,30-34,1921,1
STAT,1879,15,30-34,1894,1.6426514845937197
STAT,1897,45,45-49,1942,0.17855769831483573
SIM,1869,62,na,1931,3598
STAT,1910,19,40-44,1929,0.27258024633403877
STAT,1898,34,40-44,1932,5.781727202358686
STAT,1881,50,na,1931,2062.559036303613
STAT,1879,21,25-29,1900,58.902124668876716
STAT,1817,38,30-34,1855,4.120405965179747
SIM,1818,50,na,1868,699
STAT,1856,83,na,1939,285.1373204121402
STAT,1876,26,50-100,1902,0.6488893754313582
SIM,1879,86,na,1965,42
STAT,1869,26,25-29,1895,42.832083155451194
STAT,1824,33,45-49,1857,0.7398399284522085
STAT,1832,79,na,1911,593.4525572557162
STAT,1952,4,na,1956,4669.698342461689
SIM,1927,7,na,1934,1973
STAT,1856,55,na,1911,1485.1426190749028
STAT,1864,49,50-100,1913,0.21861462804143483
SIM,1837,39,35-39,1876,1
STAT,1903,16,30-34,1919,2.268072328210644
STAT,1876,27,15-19,1903,0.4586515417331178
STAT,1818,43,30-34,1861,2.1855593196383247
STAT,1814,53,40-44,1867,0.03402950174972348
SIM,1893,27,25-29,1920,122
STAT,1818,44,na,1862,1759.994138490635
STAT,1887,16,35-39,1903,0.6054327525687009
SIM,1925,35,30-34,1960,4
STAT,1927,32,20-24,1959,2.9760194848731487
SIM,1921,45,40-44,1966,1
STAT,1855,100,na,1955,0.7026354069916099
STAT,1857,33,40-44,1890,3.313785506356432
STAT,1913,18,50-100,1931,0.0754422170546716
STAT,1805,53,30-34,1858,0.006830253761689774
SIM,1884,27,15-19,1911,1
STAT,1835,43,30-34,1878,1.0290102590719195
STAT,1829,39,35-39,1868,3.47030614282014
STAT,1891,24,45-49,1915,0.852148183540551
STAT,1855,39,45-49,1894,1.3060834144196785
STAT,1838,20,25-29,1858,32.16478701812865
SIM,1935,32,20-24,1967,18
SIM,1849,42,na,1891,2283
STAT,1853,31,15-19,1884,0.11489796591049631
STAT,1912,47,50-100,1959,0.21484395089439626
SIM,1906,28,na,1934,3544
STAT,1880,16,50-100,1896,0.05098605283068589
STAT,1809,46,25-29,1855,0.5182582148323683
STAT,1810,64,na,1874,62.15114127343862
STAT,1828,40,20-24,1868,0.2053639483967046
STAT,1835,100,na,1935,0.8032991519774169
STAT,1825,91,na,1916,35.68499858898313
STAT,1886,38,50-100,1924,1.265083051439291
STAT,1908,54,na,1962,3210.7345591058943
STAT,1801,87,na,1888,53.21082965854468
SIM,1852,36,35-39,1888,23
STAT,1925,26,na,1951,4399.19981489194
STAT,1830,44,25-29,1874,0.5533226856800293
SIM,1863,8,na,1871,1702
STAT,1928,18,50-100,1946,0.46725987511050504
SIM,1901,6,na,1907,4179
STAT,1844,36,35-39,1880,8.221789348275427
STAT,1917,35,30-34,1952,1.8855131871748965
SIM,1910,33,na,1943,4031
STAT,1885,34,30-34,1919,17.01508368247509
SIM,1893,34,30-34,1927,29
STAT,1829,49,45-49,1878,0.10636133321498349
STAT,1908,38,25-29,1946,0.9101883902525532
STAT,1840,43,40-44,1883,0.9121143805104605
STAT,1841,33,45-49,1874,2.331717035470049
STAT,1881,50,35-39,1931,0.008246776547018966
STAT,1849,49,30-34,1898,0.07985992294862868
STAT,1843,20,35-39,1863,7.3422083984608655
STAT,1920,22,25-29,1942,101.36853494128864
STAT,1902,63,na,1965,2738.5943927764947
STAT,1852,93,na,1945,29.417928475723667
STAT,1837,49,50-100,1886,0.19925222899469558
STAT,1845,17,40-44,1862,0.1147122227479172
STAT,1840,18,35-39,1858,0.27808701829653376
SIM,1799,72,na,1871,245
STAT,1924,48,50-100,1972,0.26594232340524376
STAT,1843,28,30-34,1871,30.40046696996715
STAT,1928,30,15-19,1958,0.159639741318122
SIM,1895,17,na,1912,4448
STAT,1903,22,25-29,1925,81.2607876844355
STAT,1923,25,45-49,1948,1.9759357722724853
SIM,1925,28,25-29,1953,35
SIM,1863,20,25-29,1883,80
STAT,1864,13,na,1877,2455.9177003568234
STAT,1873,27,na,1900,2448.0469110075314
STAT,1878,16,25-29,1894,5.844641918084724
STAT,1860,28,30-34,1888,20.61422988104543
STAT,1876,37,25-29,1913,2.910603552848686
SIM,1942,28,25-29,1970,1
SIM,1846,20,25-29,1866,2
STAT,1913,45,40-44,1958,0.15267033939305394
STAT,1815,43,45-49,1858,0.15634474268948914
SIM,1840,43,na,1883,2559
STAT,1948,23,na,1971,4148.714345023609
SIM,1851,28,30-34,1879,85
SIM,1914,57,na,1971,4634
SIM,1902,32,25-29,1934,12
STAT,1902,35,50-100,1937,0.37670291443089776
STAT,1853,41,na,1894,1800.2180584946332
SIM,1912,28,na,1940,3218
STAT,1835,36,25-29,1871,2.7213448156070665
STAT,1890,33,na,1923,2876.694404950967
STAT,1934,28,25-29,1962,87.9026926517143
STAT,1824,44,na,1868,520.7684732895582
SIM,1930,35,40-44,1965,13
STAT,1882,34,45-49,1916,1.6552592091595095
STAT,1918,43,35-39,1961,0.21087527708801504
STAT,1860,20,35-39,1880,5.47106883207076
STAT,1899,32,35-39,1931,13.832228235235043
SIM,1874,49,na,1923,2467
STAT,1881,44,40-44,1925,2.0954272701607235
STAT,1821,54,25-29,1875,0.003513511384105075
STAT,1854,30,20-24,1884,1.5714075467846993
STAT,1855,20,25-29,1875,44.90419954215361
STAT,1931,1,na,1932,5427.6651389484405
STAT,1838,39,45-49,1877,1.0057338647517122
STAT,1917,28,25-29,1945,67.86563595760482
STAT,1944,27,40-44,1971,4.980988467514838
STAT,1875,29,20-24,1904,11.960368499794274
STAT,1860,42,45-49,1902,1.2194441507653064
STAT,1804,54,25-29,1858,0.021487142326388087
SIM,1911,22,25-29,1933,1
STAT,1887,47,na,1934,2464.7945979537767
STAT,1806,59,na,1865,892.2310372799799
STAT,1850,47,15-19,1897,1.8384340640723832E-4
SIM,1941,25,na,1966,3058
STAT,1844,17,50-100,1861,0.06169721113938248
STAT,1854,52,30-34,1906,0.0032921034000552058
SIM,1945,1,na,1946,6372
STAT,1845,103,na,1948,0.07121459463940401
STAT,1876,44,30-34,1920,1.1465212135780496
STAT,1818,36,25-29,1854,8.158691674031859
STAT,1809,53,30-34,1862,0.04816241054685682
SIM,1829,28,na,1857,2112
STAT,1833,54,20-24,1887,3.1328475433921104E-4
STAT,1907,20,50-100,1927,0.5985558494577188
STAT,1871,45,25-29,1916,0.05803134923643154
STAT,1883,85,na,1968,539.9936232680733
STAT,1859,15,45-49,1874,0.06081319244338023
STAT,1885,27,25-29,1912,41.58015453694184
STAT,1908,45,30-34,1953,0.08117304566882017
SIM,1901,24,20-24,1925,2
SIM,1885,1,na,1886,3539
STAT,1821,39,35-39,1860,8.274976221857056
STAT,1891,46,50-100,1937,0.17084890902209
STAT,1928,40,25-29,1968,0.09059238887861781
STAT,1890,16,40-44,1906,0.22196759227020216
SIM,1943,27,30-34,1970,40
STAT,1900,68,na,1968,2432.5214272970834
SIM,1889,17,na,1906,3885
STAT,1842,29,25-29,1871,12.800360733095198
SIM,1861,25,20-24,1886,64
SIM,1825,40,45-49,1865,1
STAT,1889,70,na,1959,1806.0117510061302
STAT,1867,44,20-24,1911,0.14816691811629432
STAT,1884,31,45-49,1915,1.6761347188849636
STAT,1877,32,15-19,1909,0.14456092744605034
STAT,1827,27,na,1854,2063.5828774024167
STAT,1870,23,30-34,1893,17.702784055849175
STAT,1813,48,40-44,1861,0.6170645035716033
STAT,1863,15,35-39,1878,0.5408866881447293
STAT,1869,41,20-24,1910,0.16098047077872982
STAT,1940,25,15-19,1965,0.7124226082764801
STAT,1954,5,na,1959,4817.660344271549
STAT,1926,43,25-29,1969,0.08714030980889408
STAT,1834,38,30-34,1872,2.8914423620915106
STAT,1909,36,na,1945,3541.774350654033
SIM,1892,19,20-24,1911,1
STAT,1869,56,na,1925,2058.1577337216518
SIM,1874,32,50-100,1906,16
SIM,1919,16,30-34,1935,22
STAT,1921,21,30-34,1942,32.17477797107758
STAT,1855,54,40-44,1909,0.006775978480420194
SIM,1885,32,15-19,1917,1
STAT,1865,66,na,1931,1496.4016230092393
SIM,1813,41,na,1854,259
STAT,1897,35,35-39,1932,9.482415501544745
SIM,1812,65,na,1877,529
STAT,1879,18,35-39,1897,0.5614129357765858
SIM,1821,70,na,1891,1430
STAT,1881,22,na,1903,2233.4283664386508
STAT,1932,39,15-19,1971,0.0255676036995932
STAT,1817,40,45-49,1857,1.136121653593731
STAT,1936,22,20-24,1958,105.25240229207105
STAT,1871,42,20-24,1913,0.15822788353365136
STAT,1853,25,20-24,1878,10.690781918566715
SIM,1880,18,na,1898,3337
STAT,1895,16,50-100,1911,0.06388871402681573
STAT,1885,80,na,1965,895.0034714184281
STAT,1884,19,20-24,1903,16.880021584773267
STAT,1909,37,30-34,1946,1.7075690342271643
STAT,1898,37,45-49,1935,2.680675052558126
STAT,1889,44,40-44,1933,2.672072756166843
STAT,1943,18,25-29,1961,45.414675968614624
STAT,1912,53,na,1965,3415.4409511933663
SIM,1892,34,na,1926,3628
STAT,1893,19,30-34,1912,1.9824890741006052
SIM,1897,44,40-44,1941,3
STAT,1890,67,na,1957,1972.0467219767934
STAT,1900,48,35-39,1948,0.10802369505543992
STAT,1888,15,40-44,1903,0.21208087263028816
STAT,1819,109,na,1928,1.654801084172063E-4
STAT,1847,72,na,1919,1141.8046975138247
STAT,1875,35,15-19,1910,0.058210063803567184
STAT,1857,18,15-19,1875,5.3209293421319135
STAT,1855,29,35-39,1884,6.561111191414693
STAT,1866,14,na,1880,2435.628045371898
STAT,1918,37,40-44,1955,1.5565777039729216
STAT,1835,26,15-19,1861,0.4506340000764041
STAT,1880,39,40-44,1919,4.498785421259734
STAT,1900,35,20-24,1935,1.077987187453553
STAT,1920,38,40-44,1958,1.616318489252869
STAT,1933,21,na,1954,4825.576279667403
STAT,1895,31,20-24,1926,3.5307046958351216
STAT,1861,48,35-39,1909,0.1149670669684337
STAT,1864,107,na,1971,0.06884887494712633
SIM,1875,62,na,1937,2443
SIM,1894,69,na,1963,1042
STAT,1844,33,30-34,1877,20.470828721719492
STAT,1851,28,20-24,1879,10.77061903565868
STAT,1826,28,30-34,1854,89.65708263499899
SIM,1926,37,40-44,1963,6
STAT,1812,46,30-34,1858,0.02548586667817154
STAT,1898,19,15-19,1917,7.937493433554738
STAT,1814,110,na,1924,1.870213473566275E-4
STAT,1828,110,na,1938,1.8706160053784613E-4
STAT,1808,48,30-34,1856,0.15015561552334952
STAT,1932,9,na,1941,5234.599880133551
STAT,1830,54,35-39,1884,0.006221706699390704
STAT,1912,22,35-39,1934,8.919002175006154
STAT,1885,37,35-39,1922,6.9523236261912364
STAT,1832,73,na,1905,1008.2528363469003
SIM,1875,29,30-34,1904,1
SIM,1893,37,35-39,1930,2
STAT,1864,52,25-29,1916,0.003202923641547868
SIM,1926,33,25-29,1959,21
SIM,1853,47,na,1900,3145
SIM,1886,6,na,1892,3155
STAT,1929,4,na,1933,5114.915000819824
SIM,1842,38,30-34,1880,4
SIM,1834,28,30-34,1862,2
STAT,1909,40,20-24,1949,0.016535601429063348
STAT,1848,43,40-44,1891,2.0896103809137876
SIM,1939,15,na,1954,4736
STAT,1891,48,15-19,1939,2.739811473146746E-4
STAT,1903,11,na,1914,3671.371006558359
STAT,1908,35,20-24,1943,0.24722573626325423
SIM,1856,43,40-44,1899,1
STAT,1872,44,30-34,1916,1.1356918529301951
SIM,1834,49,na,1883,727
STAT,1837,25,35-39,1862,10.074304480127916
STAT,1888,23,na,1911,2721.2186264834736
STAT,1854,29,na,1883,1371.1711364130613
STAT,1853,19,50-100,1872,0.045160066767124564
STAT,1863,45,35-39,1908,0.1207112818849039
STAT,1869,34,50-100,1903,0.9166510163707681
SIM,1852,33,30-34,1885,3
STAT,1858,39,30-34,1897,4.029045459010406
STAT,1938,18,15-19,1956,44.27444814888073
SIM,1904,33,na,1937,4093
STAT,1842,25,45-49,1867,0.3458013987263908
STAT,1856,34,35-39,1890,7.21152577956103
STAT,1844,41,15-19,1885,0.01419254850269316
SIM,1850,29,25-29,1879,12
STAT,1914,35,15-19,1949,0.01908631379044378
SIM,1851,18,20-24,1869,49
STAT,1926,28,35-39,1954,17.780649836071763
STAT,1791,86,na,1877,92.18551921464145
STAT,1869,28,na,1897,2399.720510266172
STAT,1843,82,na,1925,461.00431438813507
STAT,1874,40,na,1914,2409.422232022608
SIM,1919,32,na,1951,5092
STAT,1836,31,15-19,1867,0.1393736714664914
STAT,1879,37,40-44,1916,4.490616799941336
SIM,1828,40,na,1868,1884
STAT,1935,27,30-34,1962,53.02669817932734
STAT,1869,16,15-19,1885,6.107345081154037
STAT,1934,38,35-39,1972,3.3118539636026654
SIM,1873,61,na,1934,1269
STAT,1913,41,50-100,1954,0.11377912957161113
STAT,1876,38,na,1914,2369.863129524072
SIM,1836,75,na,1911,570
SIM,1883,39,30-34,1922,28
STAT,1887,32,50-100,1919,1.008486914561874
STAT,1904,46,45-49,1950,0.19073321695409523
STAT,1927,35,25-29,1962,1.216295287061417
STAT,1830,41,20-24,1871,0.14220522311840694
STAT,1950,20,45-49,1970,1.3230127236645008
STAT,1870,46,50-100,1916,0.2455419423119152
SIM,1896,45,50-100,1941,1
STAT,1863,31,na,1894,2045.5484678552402
STAT,1846,27,50-100,1873,0.4583327099500235
STAT,1896,52,na,1948,2823.3345828967736
SIM,1876,44,na,1920,3639
SIM,1831,38,na,1869,2042
SIM,1908,38,35-39,1946,2
STAT,1901,19,30-34,1920,2.216621087110272
SIM,1893,24,20-24,1917,7
STAT,1894,23,na,1917,2998.240970280884
STAT,1838,98,na,1936,1.385412648685589
SIM,1845,52,na,1897,2062
STAT,1868,36,20-24,1904,0.7481239900171772
STAT,1897,37,na,1934,3128.8600488625852
STAT,1820,47,35-39,1867,0.21998876427423986
STAT,1854,49,40-44,1903,0.09320272724250755
STAT,1939,24,50-100,1963,0.6531069371617552
SIM,1861,76,na,1937,1395
STAT,1818,46,35-39,1864,0.2535220129218909
STAT,1877,50,45-49,1927,0.01494354962269175
STAT,1906,49,15-19,1955,3.199109346100148E-4
STAT,1843,30,45-49,1873,2.1148123538816512
SIM,1860,33,20-24,1893,9
STAT,1839,22,35-39,1861,6.966044517120209
STAT,1834,34,15-19,1868,0.07874000296138596
STAT,1918,33,25-29,1951,9.648215709703207
STAT,1842,33,50-100,1875,0.2719303660960598
SIM,1945,15,na,1960,5880
STAT,1875,39,30-34,1914,5.417608622250942
SIM,1830,53,na,1883,157
STAT,1908,48,35-39,1956,0.1153766096696322
STAT,1849,100,na,1949,0.8945334880074725
STAT,1935,30,50-100,1965,1.1369167335345145
SIM,1902,48,40-44,1950,1
STAT,1826,43,20-24,1869,0.2344692080233693
STAT,1853,47,30-34,1900,0.07470770352357362
STAT,1831,43,30-34,1874,1.1086157969715142
SIM,1853,47,40-44,1900,3
STAT,1874,33,40-44,1907,4.456892077999137
SIM,1928,43,na,1971,4593
SIM,1845,80,na,1925,320
STAT,1862,31,25-29,1893,8.75969827417009
STAT,1897,44,50-100,1941,0.096113688150891
STAT,1926,33,15-19,1959,0.15395674631756584
STAT,1843,36,15-19,1879,0.06544782108591468
STAT,1868,40,na,1908,2254.88444028543
STAT,1914,40,30-34,1954,0.12579195215979191
SIM,1948,15,15-19,1963,393
STAT,1795,76,na,1871,456.9303066873996
STAT,1845,46,na,1891,1119.5789584647146
SIM,1825,38,na,1863,588
SIM,1886,16,25-29,1902,75
STAT,1859,97,na,1956,4.961302821743007
STAT,1936,32,30-34,1968,15.15129906440662
STAT,1862,53,35-39,1915,0.007214954706818324
STAT,1860,24,15-19,1884,2.734667485296189
STAT,1877,20,45-49,1897,0.7120888451400648
STAT,1882,38,na,1920,2244.448754600425
STAT,1816,39,25-29,1855,10.083724267646515
STAT,1822,54,45-49,1876,0.022474047189062877
SIM,1882,44,na,1926,1731
STAT,1857,31,na,1888,1861.6995899167425
STAT,1894,26,20-24,1920,14.969596210667989
STAT,1804,51,20-24,1855,0.004756143369587648
STAT,1903,26,40-44,1929,4.266829106072695
STAT,1924,30,45-49,1954,1.8264328267077765
STAT,1913,49,20-24,1962,0.01058863224595875
STAT,1873,95,na,1968,58.39966712226987
STAT,1838,36,40-44,1874,2.2783736374707986
STAT,1861,16,15-19,1877,5.706313162318499
STAT,1852,33,20-24,1885,2.7880311903688764
STAT,1933,32,45-49,1965,2.1062024000613184
SIM,1837,23,na,1860,2290
STAT,1871,37,40-44,1908,4.3667500405206585
STAT,1893,34,20-24,1927,3.3513098019166816
STAT,1885,24,20-24,1909,67.31344325605266
SIM,1903,21,20-24,1924,1
STAT,1793,104,na,1897,0.01108968016533741
STAT,1836,41,25-29,1877,0.5929278155443305
STAT,1915,36,na,1951,3764.9358490142245
STAT,1841,23,35-39,1864,8.172803346586608
STAT,1881,40,25-29,1921,0.6125385520961282
STAT,1844,98,na,1942,3.2182936766844197
STAT,1846,50,50-100,1896,0.009073307530407368
STAT,1885,42,15-19,1927,0.01355765089571257
STAT,1921,36,na,1957,4154.779195459975
STAT,1850,98,na,1948,1.500051768997324
STAT,1794,60,na,1854,12.0
STAT,1880,20,20-24,1900,71.96867155623126
STAT,1839,46,na,1885,2157.155824832001
STAT,1875,31,50-100,1906,0.9446936873468536
STAT,1913,48,45-49,1961,0.20888855858031774
STAT,1925,22,45-49,1947,1.3345002056486803
STAT,1891,80,na,1971,1227.838643052994
STAT,1826,42,50-100,1868,1.5872954334573466
STAT,1833,32,40-44,1865,2.4542815396350033
SIM,1843,23,na,1866,560
STAT,1827,35,20-24,1862,0.7789545608510284
STAT,1944,23,25-29,1967,98.57731578482321
SIM,1898,59,na,1957,3823
STAT,1955,15,50-100,1970,0.49327579050833636
STAT,1828,50,30-34,1878,0.0071402097736615365
STAT,1824,30,40-44,1854,2.210236909905036
STAT,1859,47,35-39,1906,0.11044565160630215
STAT,1823,51,25-29,1874,0.005425077925128019
STAT,1899,48,15-19,1947,3.043125472295715E-4
STAT,1890,42,25-29,1932,0.776442865249923
STAT,1891,21,40-44,1912,2.570256106124281
STAT,1876,40,15-19,1916,0.014101333827348388
STAT,1911,17,35-39,1928,0.8302292245962101
SIM,1801,56,na,1857,1904
STAT,1857,36,45-49,1893,1.5370874443651978
STAT,1930,41,25-29,1971,0.09343134136092633
STAT,1934,25,20-24,1959,24.41099013530585
SIM,1947,8,na,1955,4380
STAT,1837,17,na,1854,2453.0490685968703
SIM,1830,50,na,1880,320
SIM,1904,64,na,1968,3873
STAT,1926,25,30-34,1951,46.88402558235447
STAT,1848,26,na,1874,2434.1487594811797
STAT,1789,76,na,1865,634.8999975450785
STAT,1863,54,30-34,1917,0.004942019514920229
STAT,1953,6,na,1959,4712.871275335182
SIM,1847,16,na,1863,1776
STAT,1932,15,45-49,1947,0.6599170727590917
STAT,1864,26,40-44,1890,2.732631167276737
SIM,1949,9,na,1958,4491
STAT,1889,35,45-49,1924,2.42340541020789
SIM,1822,55,na,1877,1219
STAT,1815,103,na,1918,0.01011861208987937
STAT,1876,47,35-39,1923,0.14086731797878888
STAT,1917,25,20-24,1942,19.01579863852945
STAT,1825,29,25-29,1854,99.37418934013685
SIM,1874,18,na,1892,2705
SIM,1869,48,50-100,1917,4
STAT,1874,18,15-19,1892,6.108804005676501
STAT,1943,14,na,1957,4116.438084541941
STAT,1906,26,50-100,1932,0.9294991315078751
SIM,1796,61,na,1857,1195
STAT,1900,25,50-100,1925,0.8921685182766205
STAT,1838,17,35-39,1855,0.30939596122666324
STAT,1847,29,45-49,1876,1.1893049746216406
STAT,1825,40,35-39,1865,2.486943605994802
STAT,1940,15,50-100,1955,0.3763341284421149
STAT,1797,71,na,1868,24.79410615552482
STAT,1854,20,na,1874,1417.1182720448828
STAT,1840,51,25-29,1891,0.001401356879188895
STAT,1867,95,na,1962,30.935513171962892
STAT,1867,47,25-29,1914,0.054220090330163666
SIM,1930,41,35-39,1971,1
STAT,1823,65,na,1888,1349.242782826745
SIM,1885,55,na,1940,1103
SIM,1842,40,45-49,1882,66
STAT,1892,31,35-39,1923,12.589497205158127
STAT,1821,36,30-34,1857,6.757780467759517
STAT,1830,48,40-44,1878,0.1444446175439375
STAT,1840,47,20-24,1887,0.0047648411825488715
STAT,1853,35,30-34,1888,4.219213092724942
SIM,1951,15,20-24,1966,771
SIM,1886,0,na,1886,3180
STAT,1872,45,na,1917,2275.3600857835113
STAT,1816,80,na,1896,522.2353554268353
STAT,1912,24,25-29,1936,90.60746592072563
STAT,1785,86,na,1871,31.158863675680102
SIM,1871,35,na,1906,1873
STAT,1916,12,na,1928,4132.935952987117
STAT,1869,103,na,1972,1.704942293815319
STAT,1850,20,40-44,1870,1.1716754282864956
STAT,1849,45,15-19,1894,3.4039657682631547E-4
STAT,1872,40,15-19,1912,0.01396814097594395
STAT,1833,34,50-100,1867,0.50417840881654
STAT,1842,35,na,1877,636.8024995247397
STAT,1931,29,na,1960,4797.700261932838
SIM,1833,29,25-29,1862,22
STAT,1895,46,25-29,1941,0.04238690704042464
STAT,1863,42,30-34,1905,0.9802775363970141
STAT,1872,54,40-44,1926,0.010252065795247862
STAT,1845,52,20-24,1897,3.6421885133181437E-4
SIM,1897,47,45-49,1944,1
STAT,1875,41,45-49,1916,1.5437820797870196
SIM,1865,6,na,1871,2035
STAT,1896,15,30-34,1911,2.1108462778984074
STAT,1907,30,45-49,1937,1.472741426171639
SIM,1911,12,na,1923,2607
SIM,1874,15,na,1889,2570
STAT,1912,22,na,1934,3614.7623525483605
STAT,1921,36,35-39,1957,2.671139873199158
SIM,1861,35,30-34,1896,13
STAT,1922,41,35-39,1963,0.2288795552981015
SIM,1803,51,na,1854,1659
STAT,1823,68,na,1891,1207.2408896537784
STAT,1833,23,45-49,1856,0.5572394977833603
STAT,1848,28,15-19,1876,0.5032091630483059
STAT,1918,42,20-24,1960,0.018523572105467703
STAT,1879,46,50-100,1925,0.25266158740260186
STAT,1851,19,25-29,1870,5.377526083755693
STAT,1926,37,30-34,1963,2.2083258539911164
SIM,1858,56,na,1914,2290
STAT,1891,22,50-100,1913,0.5014715893694468
STAT,1808,50,45-49,1858,0.01951467936445811
STAT,1897,23,50-100,1920,0.5398934019960958
SIM,1858,53,na,1911,2290
STAT,1891,12,na,1903,3175.785714540442
SIM,1904,30,na,1934,4169
STAT,1916,15,na,1931,4060.6499825301876
STAT,1859,66,na,1925,1299.0673414900568
SIM,1932,20,35-39,1952,81
SIM,1883,20,na,1903,1937
STAT,1865,60,na,1925,1741.2380069587632
STAT,1867,92,na,1959,64.12204113910671
STAT,1868,16,50-100,1884,0.048462034460673827
SIM,1841,28,na,1869,1162
STAT,1935,23,15-19,1958,7.194314423295354
SIM,1866,82,na,1948,637
SIM,1883,41,45-49,1924,8
STAT,1835,46,35-39,1881,0.11309444743988166
STAT,1815,100,na,1915,0.07485191638422874
STAT,1870,25,20-24,1895,11.774818406604503
STAT,1808,51,na,1859,746.862135990123
STAT,1889,47,45-49,1936,0.15956345680397443
STAT,1838,29,35-39,1867,5.164517223976932
STAT,1879,18,na,1897,2584.0793248606174
STAT,1909,47,40-44,1956,0.1434006048318608
STAT,1900,41,15-19,1941,0.001334476020602681
SIM,1875,47,25-29,1922,1
STAT,1821,52,35-39,1873,0.00888551015361542
STAT,1924,41,na,1965,4381.463842051686
SIM,1929,22,na,1951,6274
STAT,1910,15,25-29,1925,8.530102230517894
STAT,1912,31,30-34,1943,15.38548845983417
STAT,1878,33,na,1911,2444.841066221776
STAT,1873,19,45-49,1892,0.06664715245078096
STAT,1873,24,50-100,1897,0.41568444222271683
STAT,1922,49,30-34,1971,0.10067557444522063
STAT,1855,50,25-29,1905,0.002377920931302823
SIM,1897,40,na,1937,2516
STAT,1839,41,40-44,1880,2.4515146839562565
STAT,1853,72,na,1925,979.234436099617
STAT,1819,50,20-24,1869,1.336452630110632E-4
STAT,1930,2,na,1932,5250.406766206848
STAT,1886,41,20-24,1927,0.16520298836487057
STAT,1908,4,na,1912,3872.168694135619
STAT,1879,80,na,1959,778.5454331453577
STAT,1884,25,15-19,1909,0.43726346656814485
SIM,1847,41,40-44,1888,4
STAT,1822,53,30-34,1875,0.009403190342237978
STAT,1951,21,50-100,1972,0.7790734244199217
SIM,1869,23,30-34,1892,1
STAT,1920,16,30-34,1936,13.532421183693035
STAT,1847,22,25-29,1869,63.4487023693264
SIM,1869,28,25-29,1897,3
STAT,1894,36,30-34,1930,6.810023098800221
STAT,1843,18,20-24,1861,22.253139159849283
STAT,1882,23,50-100,1905,0.38921631503688014
STAT,1865,31,40-44,1896,3.97556397453366
SIM,1835,28,na,1863,1342
STAT,1878,30,na,1908,2474.937281480528
STAT,1912,56,na,1968,3359.6309130790355
STAT,1921,43,40-44,1964,0.27794100815714906
STAT,1859,17,50-100,1876,0.045074192080313075
STAT,1918,30,20-24,1948,2.5775414522163267
STAT,1856,22,35-39,1878,4.867865981432265
STAT,1868,52,25-29,1920,0.003402914611062617
STAT,1810,95,na,1905,0.41395092067764877
SIM,1920,31,30-34,1951,5
STAT,1883,26,45-49,1909,1.0718252059384825
STAT,1768,106,na,1874,0.034188729485038406
STAT,1831,53,40-44,1884,0.008561595664511328
STAT,1922,40,50-100,1962,0.13370908894491118
STAT,1858,53,45-49,1911,0.010904669265038113
SIM,1926,8,na,1934,6370
SIM,1902,5,na,1907,3754
STAT,1813,44,25-29,1857,2.6120767380990086
STAT,1910,27,na,1937,3576.9958227178386
STAT,1920,32,35-39,1952,9.880943480734143
STAT,1918,47,na,1965,3856.757658401857
STAT,1938,21,40-44,1959,3.293183728860996
STAT,1898,40,35-39,1938,0.17079981233149785
STAT,1833,35,45-49,1868,1.106571249233403
STAT,1880,35,25-29,1915,3.0174387516466874
SIM,1838,22,25-29,1860,2
SIM,1847,13,na,1860,1776
STAT,1893,47,na,1940,2800.8925120766517
STAT,1841,87,na,1928,196.18875876672706
STAT,1930,41,na,1971,4859.2704519563895
STAT,1884,33,na,1917,2274.7097452626617
SIM,1849,48,na,1897,2153
STAT,1931,35,15-19,1966,0.025297330022805733
SIM,1903,43,30-34,1946,1
STAT,1852,46,35-39,1898,0.14132241474049445
STAT,1837,19,40-44,1856,0.19316556433819723
STAT,1827,45,30-34,1872,0.09093594817204861
STAT,1852,36,25-29,1888,2.9443053879953003
STAT,1865,24,35-39,1889,5.3153460171821525
STAT,1953,3,na,1956,4715.935986744516
STAT,1851,30,35-39,1881,8.499469609523219
STAT,1894,48,30-34,1942,0.06856422903528264
STAT,1935,30,20-24,1965,3.354071086688736
SIM,1900,71,na,1971,3379
STAT,1904,43,40-44,1947,0.22154218633798445
STAT,1812,47,45-49,1859,0.061014729891565145
STAT,1847,78,na,1925,706.4161470423525
STAT,1904,27,na,1931,3409.6160493780276
STAT,1804,53,50-100,1857,0.09348823582746911
STAT,1849,51,45-49,1900,0.01228654874778332
SIM,1829,39,45-49,1868,8
SIM,1835,45,30-34,1880,1
STAT,1868,2,na,1870,3236.2590926449675
STAT,1862,33,15-19,1895,0.12078259540207839
STAT,1820,88,na,1908,94.4115854253117
SIM,1828,49,na,1877,1712
STAT,1889,29,15-19,1918,0.5424550111421929
STAT,1925,26,25-29,1951,77.2943938924985
STAT,1893,37,25-29,1930,3.6005161653446778
STAT,1942,22,50-100,1964,0.682022301445475
SIM,1824,50,na,1874,2138
STAT,1842,19,15-19,1861,1.8695874642376675
STAT,1927,45,35-39,1972,0.16127680839292574
STAT,1943,17,na,1960,3858.6187630777436
STAT,1921,31,40-44,1952,4.320885850496931
STAT,1944,20,20-24,1964,118.78888650234674
STAT,1906,25,45-49,1931,1.6187060129834359
STAT,1897,20,30-34,1917,23.79678016365193
STAT,1848,110,na,1958,3.8409846492329467E-4
STAT,1948,23,50-100,1971,0.7475320975143511
STAT,1853,48,45-49,1901,0.1806924352472641
STAT,1860,20,na,1880,2004.6070091185177
STAT,1845,40,20-24,1885,0.08233216803830841
STAT,1861,36,35-39,1897,5.910456410892579
SIM,1790,73,na,1863,1197
STAT,1901,21,45-49,1922,0.9779492407875353
STAT,1877,85,na,1962,454.31701919813327
SIM,1930,19,na,1949,5518
STAT,1813,52,50-100,1865,0.05249274875981789
STAT,1930,33,40-44,1963,5.011725609952656
STAT,1874,36,45-49,1910,2.0673133010095115
SIM,1935,25,na,1960,5608
SIM,1889,48,na,1937,3787
STAT,1877,48,30-34,1925,0.09702896360814746
STAT,1870,48,45-49,1918,0.23231996531529484
STAT,1864,25,50-100,1889,0.587764152559194
STAT,1935,37,40-44,1972,2.078203133492387
STAT,1892,62,na,1954,2262.9026478892224
STAT,1859,40,50-100,1899,0.8457849892995563
SIM,1821,44,25-29,1865,2
STAT,1779,86,na,1865,107.57540675246027
STAT,1872,48,na,1920,2224.59188088909
SIM,1855,22,25-29,1877,877
STAT,1826,46,25-29,1872,0.08353392111897927
STAT,1862,41,50-100,1903,0.9038949005763198
STAT,1822,51,40-44,1873,0.01730472917726434
SIM,1834,43,na,1877,795
STAT,1937,19,45-49,1956,0.4795193473564081
STAT,1917,32,50-100,1949,0.8542252442769636
SIM,1855,42,na,1897,2984
STAT,1819,91,na,1910,13.478219696912353
STAT,1817,65,na,1882,602.497289415188
STAT,1868,46,30-34,1914,0.09376175249092143
STAT,1840,107,na,1947,0.0018569284598507043
SIM,1884,44,30-34,1928,8
STAT,1943,25,30-34,1968,41.289391605822495
STAT,1861,23,20-24,1884,58.45466027676314
STAT,1846,54,30-34,1900,0.003428514220247205
SIM,1833,26,20-24,1859,1
STAT,1847,26,40-44,1873,3.2788285713603504
STAT,1875,31,35-39,1906,10.441497150737511
STAT,1822,51,50-100,1873,0.02482500866140344
STAT,1871,60,na,1931,1902.49493191547
STAT,1855,17,35-39,1872,0.43193750894815686
SIM,1807,47,na,1854,1094
STAT,1802,66,na,1868,1132.0802665385677
STAT,1925,29,na,1954,4352.8201782315355
STAT,1919,40,15-19,1959,0.0016466493728105069
STAT,1871,43,35-39,1914,1.7933169664288775
STAT,1899,36,15-19,1935,0.07706883900425347
SIM,1868,15,na,1883,1326
STAT,1951,16,25-29,1967,51.13775073086822
STAT,1849,103,na,1952,0.12092459089613239
STAT,1867,40,40-44,1907,2.1486720763421827
STAT,1847,41,na,1888,2128.379665485238
SIM,1880,49,na,1929,3190
STAT,1922,39,20-24,1961,0.29597624227835884
STAT,1907,2,na,1909,3889.4560552966777
STAT,1889,32,40-44,1921,5.222382492784686
STAT,1863,52,40-44,1915,0.008939738297441633
STAT,1895,43,20-24,1938,0.014242780217821502
STAT,1824,35,50-100,1859,0.190150609803696
SIM,1883,31,35-39,1914,69
SIM,1884,70,na,1954,2918
STAT,1896,58,na,1954,2606.925617611278
STAT,1810,92,na,1902,1.2967367512432502
STAT,1838,64,na,1902,741.3616128197119
STAT,1884,43,45-49,1927,1.4223428817043244
STAT,1864,29,45-49,1893,1.0021691460960818
SIM,1879,55,na,1934,1050
STAT,1827,51,25-29,1878,0.0031972845184415487
STAT,1863,34,na,1897,2019.781194791696
STAT,1897,23,35-39,1920,7.725873678302221
STAT,1900,47,20-24,1947,0.009333280447125152
STAT,1885,30,15-19,1915,0.1411047071507204
STAT,1885,49,35-39,1934,0.13473965790640183
STAT,1839,44,45-49,1883,1.4284282568331335
STAT,1908,23,20-24,1931,101.12042528065366
STAT,1874,74,na,1948,1145.3756218816834
STAT,1937,14,na,1951,3802.440370873335
STAT,1845,50,30-34,1895,0.0029962030399502994
SIM,1925,6,na,1931,5349
STAT,1817,52,45-49,1869,0.009816113067263111
SIM,1864,56,na,1920,2415
STAT,1792,65,na,1857,1028.2950999196
STAT,1892,17,20-24,1909,21.949585362352774
STAT,1893,30,40-44,1923,5.46677695218491
STAT,1902,27,35-39,1929,13.587239218645026
STAT,1922,15,na,1937,4231.843158201993
STAT,1821,46,40-44,1867,0.18557100770184895
STAT,1867,37,15-19,1904,0.05310705724133985
STAT,1881,59,na,1940,1835.3060261524006
SIM,1827,61,na,1888,1305
STAT,1841,53,na,1894,2359.194713226712
STAT,1869,53,20-24,1922,7.326653935086327E-4
SIM,1951,18,na,1969,2365
STAT,1911,39,45-49,1950,0.644481439333487
SIM,1853,16,na,1869,3603
SIM,1932,11,na,1943,6513
STAT,1920,26,40-44,1946,5.064622207207853
STAT,1894,42,25-29,1936,0.05663687474890916
STAT,1898,30,25-29,1928,13.884114620124228
STAT,1903,48,50-100,1951,0.19418644793352097
STAT,1829,27,35-39,1856,7.197115193996666
STAT,1931,16,50-100,1947,0.4881367697554189
STAT,1850,23,45-49,1873,0.383702032236497
STAT,1899,32,na,1931,3259.3842155407247
STAT,1921,33,30-34,1954,17.252068938050247
STAT,1826,79,na,1905,557.3519355970753
SIM,1875,40,40-44,1915,6
STAT,1918,45,25-29,1963,0.05594931513653818
STAT,1866,45,na,1911,2074.1712397314614
STAT,1802,69,na,1871,1012.271818084594
STAT,1858,19,na,1877,2023.6248175530934
STAT,1909,33,na,1942,3557.2971087864835
STAT,1918,49,40-44,1967,0.1645446425397747
SIM,1908,23,na,1931,2145
STAT,1880,42,30-34,1922,1.19206375982872
SIM,1790,76,na,1866,1197
STAT,1836,43,15-19,1879,0.01242855908883898
STAT,1873,16,40-44,1889,0.18872984916075786
SIM,1946,0,na,1946,4109
STAT,1813,51,30-34,1864,0.021112794745105926
STAT,1912,34,35-39,1946,8.811549185405802
STAT,1858,35,15-19,1893,0.04329050132436918
SIM,1861,42,na,1903,2155
SIM,1876,41,na,1917,3627
STAT,1848,34,50-100,1882,0.8911895679676723
SIM,1902,22,15-19,1924,3
STAT,1908,33,50-100,1941,0.7711226519262915
STAT,1834,30,35-39,1864,5.836924186309253
STAT,1804,52,35-39,1856,0.05437873959392567
STAT,1892,4,na,1896,3257.038266605733
SIM,1837,27,35-39,1864,29
STAT,1851,16,20-24,1867,17.12456536851584
STAT,1859,46,20-24,1905,0.009538115588352976
STAT,1828,52,20-24,1880,8.507299919928549E-4
SIM,1864,22,35-39,1886,43
STAT,1846,93,na,1939,17.3090568995173
STAT,1871,40,50-100,1911,1.0644906455318257
SIM,1947,10,na,1957,4371
STAT,1795,79,na,1874,343.8415434091222
STAT,1844,45,30-34,1889,0.09741100130291237
SIM,1898,22,na,1920,4339
STAT,1896,18,35-39,1914,0.7214289926759031
STAT,1921,46,45-49,1967,0.24270654039793293
STAT,1879,25,40-44,1904,3.093816832369404
STAT,1889,16,50-100,1905,0.059142144136028106
SIM,1896,27,40-44,1923,3
SIM,1914,23,na,1937,5015
STAT,1893,27,15-19,1920,0.5673676473919294
STAT,1903,32,35-39,1935,14.375483771257134
STAT,1907,20,35-39,1927,8.565333203224919
STAT,1926,21,15-19,1947,6.430947579833118
SIM,1948,7,na,1955,5825
STAT,1860,18,20-24,1878,16.581994063081435
STAT,1881,48,20-24,1929,0.01118978446143513
SIM,1831,69,na,1900,1502
STAT,1914,47,15-19,1961,3.602541462211369E-4
SIM,1917,37,na,1954,2041
STAT,1817,68,na,1885,538.7347916699814
STAT,1815,39,na,1854,234.40539011854685
STAT,1862,47,40-44,1909,0.14513825193726032
STAT,1814,54,na,1868,1851.2505613325013
STAT,1872,50,25-29,1922,0.0035977980027619315
STAT,1928,39,50-100,1967,0.5254534490366637
SIM,1852,68,na,1920,1563
STAT,1857,33,50-100,1890,0.7001244453694161
SIM,1883,23,na,1906,2226
STAT,1870,8,na,1878,2715.8651056638896
SIM,1829,36,40-44,1865,1
SIM,1887,81,na,1968,1759
SIM,1935,22,na,1957,5635
STAT,1931,40,30-34,1971,0.17006250918512136
SIM,1824,32,40-44,1856,23
STAT,1888,27,40-44,1915,3.4573711215081437
SIM,1800,77,na,1877,167
SIM,1820,49,35-39,1869,3
STAT,1788,97,na,1885,0.39289801716033523
STAT,1935,33,25-29,1968,12.68723363350832
STAT,1822,80,na,1902,356.7137419845249
STAT,1869,59,na,1928,1961.114463190532
STAT,1839,34,35-39,1873,11.340531403245517
STAT,1860,30,45-49,1890,1.434031521052206
STAT,1924,24,50-100,1948,0.7641532012102764
STAT,1917,38,35-39,1955,2.4664428679981114
STAT,1905,45,15-19,1950,3.2776820514666385E-4
SIM,1821,76,na,1897,965
SIM,1851,83,na,1934,438
SIM,1867,67,na,1934,827
STAT,1881,52,25-29,1933,0.003327085378816383
STAT,1847,8,na,1855,2771.01909
STAT,1885,36,20-24,1921,0.761352297403942
SIM,1846,68,na,1914,319
STAT,1812,49,35-39,1861,0.03491806158884232
STAT,1866,32,50-100,1898,0.8363660881245537
STAT,1889,73,na,1962,1650.5094145456933
STAT,1818,45,20-24,1863,0.02206389755323877
SIM,1907,34,50-100,1941,83
STAT,1916,32,45-49,1948,1.60244165050288
SIM,1851,24,15-19,1875,2
STAT,1861,33,30-34,1894,14.458975545137697
STAT,1877,39,50-100,1916,1.2337631391523685
STAT,1870,38,35-39,1908,7.016255653407543
STAT,1938,24,45-49,1962,1.100911668796033
STAT,1915,25,50-100,1940,1.0076842825439314
SIM,1812,62,na,1874,655
SIM,1887,8,na,1895,3988
STAT,1943,15,20-24,1958,142.20202553165313
STAT,1929,18,40-44,1947,1.7678956037038582
STAT,1820,54,na,1874,1577.6256721347972
STAT,1820,35,35-39,1855,14.851022585950162
STAT,1843,24,15-19,1867,4.032901965528071
STAT,1843,42,45-49,1885,1.5225376756390645
STAT,1848,46,45-49,1894,0.22146980838715477
STAT,1948,19,20-24,1967,153.46433878031357
STAT,1868,42,15-19,1910,0.013322090073078335
SIM,1920,44,45-49,1964,1
STAT,1918,40,30-34,1958,0.13446676774353572
STAT,1871,30,20-24,1901,2.7180932276497214
STAT,1850,54,20-24,1904,3.313726757287139E-4
SIM,1869,96,na,1965,438
SIM,1902,38,na,1940,3310
STAT,1913,41,25-29,1954,0.06915986350767173
STAT,1805,106,na,1911,0.0016289647953423322
SIM,1815,76,na,1891,434
STAT,1779,83,na,1862,202.94781301850145
STAT,1768,103,na,1871,0.13892047131931728
STAT,1909,33,15-19,1942,0.12086793292319757
STAT,1829,53,na,1882,813.594053763037
STAT,1831,27,50-100,1858,0.7594178354252296
STAT,1844,35,20-24,1879,0.9054122238936244
STAT,1812,44,40-44,1856,0.6774939468354128
STAT,1849,39,20-24,1888,0.6509613739298152
STAT,1942,22,45-49,1964,1.1662580910339901
STAT,1853,41,25-29,1894,0.500174282156486
SIM,1888,35,35-39,1923,5
STAT,1880,74,na,1954,1152.1319489080663
STAT,1912,44,45-49,1956,0.1574237699753394
STAT,1883,23,40-44,1906,1.9985195469875467
SIM,1855,26,40-44,1881,14
SIM,1843,33,20-24,1876,10
STAT,1838,24,40-44,1862,1.137570771847989
SIM,1939,25,15-19,1964,2
STAT,1834,40,45-49,1874,0.815803397192121
STAT,1864,19,35-39,1883,0.5099726237330061
SIM,1867,30,na,1897,2393
STAT,1875,59,na,1934,1995.650483832972
STAT,1927,42,30-34,1969,0.15903134194036855
STAT,1912,21,20-24,1933,105.64448845836594
STAT,1852,26,15-19,1878,0.5357742553862139
STAT,1865,34,45-49,1899,1.578463212073481
SIM,1920,21,20-24,1941,2
STAT,1903,38,40-44,1941,1.3345663720919658
SIM,1906,19,25-29,1925,4
STAT,1869,18,40-44,1887,0.18601778207440764
SIM,1852,31,na,1883,2307
SIM,1969,1,na,1970,4554
STAT,1871,49,40-44,1920,0.16721372407615126
STAT,1877,44,15-19,1921,0.013829413724539889
STAT,1835,53,na,1888,1627.716265847592
SIM,1892,37,na,1929,3660
STAT,1869,100,na,1969,7.227245145720053
STAT,1898,15,50-100,1913,0.06618629110587779
STAT,1880,32,20-24,1912,2.8061924696561276
SIM,1851,42,45-49,1893,3
SIM,1923,37,na,1960,4244
STAT,1835,33,20-24,1868,2.5769046856975892
STAT,1813,41,20-24,1854,0.989318547748803
STAT,1831,50,50-100,1881,0.01303428588740083
STAT,1933,20,45-49,1953,1.491200160286841
STAT,1850,97,na,1947,2.480695511745397
STAT,1861,32,40-44,1893,3.6065997328733586
STAT,1864,33,20-24,1897,2.446997241341741
STAT,1882,29,30-34,1911,23.937094705853013
STAT,1910,46,20-24,1956,0.010220699913517914
STAT,1887,38,20-24,1925,0.8442443775081288
STAT,1879,23,na,1902,2418.664254261561
STAT,1842,27,35-39,1869,2.9621381174470383
STAT,1861,49,na,1910,1831.9978405334982
STAT,1884,37,40-44,1921,4.190462611500038
SIM,1841,29,35-39,1870,3
STAT,1940,25,50-100,1965,1.0044716085529675
SIM,1834,31,35-39,1865,1
SIM,1859,44,45-49,1903,4
SIM,1965,1,na,1966,4974
STAT,1875,31,30-34,1906,18.001817040195014
SIM,1846,38,25-29,1884,6
SIM,1949,22,30-34,1971,1161
STAT,1840,19,25-29,1859,2.8549950698242474
SIM,1936,5,na,1941,4057
SIM,1883,39,40-44,1922,5
STAT,1849,44,35-39,1893,1.5051818605721548
STAT,1861,44,35-39,1905,1.4856230218751243
STAT,1883,50,20-24,1933,7.201120340381989E-4
SIM,1919,7,na,1926,5212
STAT,1880,16,15-19,1896,6.1761117826628364
STAT,1866,53,25-29,1919,0.003181302906537714
STAT,1887,42,na,1929,2540.7876561869884
SIM,1890,29,30-34,1919,17
SIM,1879,2,na,1881,2986
SIM,1844,14,na,1858,3028
SIM,1823,38,30-34,1861,10
SIM,1848,28,na,1876,2624
SIM,1881,23,20-24,1904,423
SIM,1927,43,50-100,1970,2
STAT,1833,21,25-29,1854,63.77196929567955
SIM,1916,17,na,1933,4819
SIM,1948,3,na,1951,5825
STAT,1811,50,30-34,1861,0.027872509979350073
STAT,1916,21,15-19,1937,5.518498087130967
SIM,1878,26,na,1904,3956
STAT,1889,46,30-34,1935,0.11689994258296127
STAT,1824,36,30-34,1860,0.8324844745599906
SIM,1808,63,na,1871,1261
STAT,1828,31,na,1859,1953.4651118779518
STAT,1893,22,35-39,1915,7.297430160586395
SIM,1886,40,50-100,1926,24
STAT,1844,35,45-49,1879,2.3414799726289974
STAT,1888,17,30-34,1905,1.8395862589154874
STAT,1838,38,25-29,1876,1.4677454145966244
SIM,1855,6,na,1861,3430
STAT,1871,51,40-44,1922,0.010552036755622893
STAT,1874,52,20-24,1926,7.575275952014967E-4
SIM,1835,53,na,1888,1206
STAT,1854,54,45-49,1908,0.00784726222642954
STAT,1895,61,na,1956,2454.302014677138
STAT,1863,52,45-49,1915,0.012323471028740608
SIM,1827,34,na,1861,2236
SIM,1895,25,15-19,1920,2
STAT,1891,27,30-34,1918,30.966906062450253
SIM,1910,12,na,1922,4577
STAT,1847,36,25-29,1883,2.7290553583018315
STAT,1895,30,45-49,1925,2.2867247447656323
SIM,1836,70,na,1906,816
STAT,1856,111,na,1967,5.825233491521142E-4
SIM,1889,27,40-44,1916,7
STAT,1845,28,15-19,1873,0.27206183445083454
STAT,1864,45,15-19,1909,3.672675107110975E-4
STAT,1901,48,20-24,1949,0.009345596058024912
STAT,1871,23,50-100,1894,0.40553174717271817
SIM,1857,49,40-44,1906,3
STAT,1842,78,na,1920,193.96152306626152
STAT,1900,39,15-19,1939,0.016621321791152867
STAT,1855,35,20-24,1890,0.515021110392725
STAT,1908,15,30-34,1923,2.3569525285246016
STAT,1887,25,15-19,1912,0.5027661671093189
SIM,1827,41,45-49,1868,25
STAT,1882,11,na,1893,2476.2102844036835
STAT,1855,47,15-19,1902,2.63500160733915E-4
STAT,1853,30,na,1883,1945.4299364840065
STAT,1831,26,20-24,1857,14.695302366030555
STAT,1871,18,15-19,1889,5.923112846565488
STAT,1873,26,25-29,1899,43.54084527499449
STAT,1886,32,45-49,1918,1.8058152456170704
STAT,1919,37,na,1956,3988.0895784401287
STAT,1819,70,na,1889,341.33099202974074
SIM,1883,48,50-100,1931,2
STAT,1870,42,35-39,1912,1.8030376824196088
STAT,1873,43,15-19,1916,0.01406351093605581
STAT,1884,24,35-39,1908,5.551173762963615
STAT,1802,52,30-34,1854,0.030239107467340223
STAT,1835,42,40-44,1877,2.039172432772574
STAT,1812,48,na,1860,239.59291374096716
STAT,1856,34,25-29,1890,7.293801095558294
STAT,1915,23,na,1938,3709.9993897263867
STAT,1793,107,na,1900,7.84083759448332E-4
STAT,1853,33,45-49,1886,1.3780404294090174
STAT,1851,25,35-39,1876,9.052248275666797
STAT,1879,39,25-29,1918,2.923868560180991
STAT,1898,44,30-34,1942,0.10590679344584093
STAT,1866,80,na,1946,564.6662708388803
STAT,1949,19,35-39,1968,4.828889017479203
STAT,1823,44,15-19,1867,0.022075740689382457
SIM,1840,22,20-24,1862,337
SIM,1869,97,na,1966,438
SIM,1912,9,na,1921,4883
SIM,1890,21,20-24,1911,138
STAT,1869,40,45-49,1909,1.5254712805005364
SIM,1901,49,25-29,1950,1
SIM,1894,64,na,1958,1150
STAT,1803,51,35-39,1854,0.01922215469272223
STAT,1890,35,15-19,1925,0.06862674553419547
SIM,1872,4,na,1876,2660
STAT,1919,21,40-44,1940,3.6439044132425424
SIM,1865,83,na,1948,254
STAT,1896,36,20-24,1932,1.0210458821475208
STAT,1847,49,30-34,1896,0.08569120147790495
STAT,1852,34,40-44,1886,4.426837516969691
STAT,1889,2,na,1891,3210.0543806123646
STAT,1923,42,na,1965,4295.152554188988
STAT,1889,33,25-29,1922,12.282349183858484
STAT,1847,16,30-34,1863,1.809221648568815
STAT,1833,34,30-34,1867,9.607481867082285
STAT,1835,37,45-49,1872,1.8647298172447138
STAT,1875,51,25-29,1926,0.0036545260670276065
STAT,1882,21,20-24,1903,66.17672059973604
SIM,1890,50,na,1940,3400
STAT,1883,16,40-44,1899,0.17639280507321847
SIM,1822,46,50-100,1868,1
STAT,1834,30,30-34,1864,10.063235162785686
STAT,1832,22,20-24,1854,105.97914176964701
SIM,1886,45,na,1931,2972
STAT,1829,45,20-24,1874,0.005696527291456841
STAT,1821,84,na,1905,168.00060725061869
STAT,1833,29,35-39,1862,5.63172236653652
STAT,1912,49,35-39,1961,0.12175021512425167
STAT,1866,19,45-49,1885,0.060484046657623476
STAT,1919,16,45-49,1935,0.10955158132086723
STAT,1825,98,na,1923,2.0004927554372185
SIM,1897,33,25-29,1930,138
STAT,1948,18,na,1966,4167.885678286592
SIM,1838,19,35-39,1857,1
SIM,1876,41,40-44,1917,6
SIM,1892,37,40-44,1929,1
STAT,1950,20,50-100,1970,0.7736916807456569
STAT,1817,46,40-44,1863,0.12153677307630696
SIM,1920,49,35-39,1969,7
STAT,1865,31,na,1896,2187.5841433041296
SIM,1824,37,35-39,1861,18
STAT,1852,51,30-34,1903,0.006020432777147207
STAT,1892,43,25-29,1935,0.7893073932700486
SIM,1881,14,na,1895,3187
STAT,1878,81,na,1959,696.440682137531
SIM,1875,32,35-39,1907,103
SIM,1852,33,na,1885,2154
SIM,1827,66,na,1893,1208
SIM,1836,29,50-100,1865,9
STAT,1791,69,na,1860,878.6937640514238
STAT,1818,45,45-49,1863,0.4339233020795173
STAT,1868,41,40-44,1909,2.182340078288268
STAT,1825,52,25-29,1877,0.004344560234710322
SIM,1857,64,na,1921,957
SIM,1853,50,na,1903,3151
STAT,1850,26,30-34,1876,13.782834761836412
STAT,1885,36,45-49,1921,1.968927643609826
STAT,1877,19,20-24,1896,17.900080929869908
STAT,1836,50,na,1886,1734.7022916344301
STAT,1820,67,na,1887,1079.1141233747924
SIM,1882,31,na,1913,1880
STAT,1841,40,15-19,1881,0.016394564226597685
STAT,1803,87,na,1890,44.44187649527203
STAT,1833,51,20-24,1884,3.324665515271445E-4
STAT,1890,15,20-24,1905,21.562005888986352
STAT,1963,3,na,1966,4949.7026682947535
SIM,1896,34,20-24,1930,3
STAT,1798,91,na,1889,28.878501639779884
SIM,1953,17,na,1970,3792
STAT,1825,35,35-39,1860,10.718726226956472
STAT,1898,19,40-44,1917,0.24463381971555168
SIM,1876,45,50-100,1921,2
STAT,1854,39,20-24,1893,0.4242918843481887
STAT,1813,53,45-49,1866,0.04942921078966857
SIM,1894,29,15-19,1923,4
SIM,1823,52,na,1875,1228
STAT,1874,47,25-29,1921,0.059169885438818244
STAT,1865,37,30-34,1902,4.865856913220795
STAT,1834,38,40-44,1872,2.3749155348721698
STAT,1837,39,20-24,1876,0.7370660225637398
STAT,1882,41,15-19,1923,0.01328149748031991
STAT,1830,53,45-49,1883,0.01069780378223556
STAT,1827,40,40-44,1867,2.1930387721444276
STAT,1862,98,na,1960,5.793857271119293
STAT,1814,46,15-19,1860,0.0013859084163527211
STAT,1892,26,35-39,1918,11.987275260245541
SIM,1842,38,40-44,1880,35
STAT,1840,24,20-24,1864,34.013408046552684
STAT,1940,22,na,1962,3678.327893645189
STAT,1875,26,35-39,1901,9.942025359335071
STAT,1865,32,25-29,1897,9.351406266223867
SIM,1893,33,40-44,1926,10
STAT,1899,40,30-34,1939,0.1101447512190295
STAT,1860,23,35-39,1883,4.872200152278205
STAT,1894,31,40-44,1925,5.537359613876381
STAT,1946,5,na,1951,4354.647214417864
STAT,1857,12,na,1869,2153.0831576380983
SIM,1829,43,20-24,1872,6
STAT,1809,52,40-44,1861,0.08693509567564296
STAT,1876,43,40-44,1919,2.257385510069779
STAT,1888,34,20-24,1922,3.0930620421024018
SIM,1867,42,na,1909,2089
STAT,1843,23,35-39,1866,7.185190037259967
STAT,1848,51,na,1899,2024.5199687821255
STAT,1881,37,15-19,1918,0.053029434930508594
STAT,1864,14,na,1878,2444.7678339972035
STAT,1897,35,25-29,1932,3.8600377603748055
SIM,1864,39,30-34,1903,6
STAT,1792,86,na,1878,92.93290135859272
STAT,1848,45,30-34,1893,0.09148605029494755
STAT,1870,6,na,1876,2759.122807134798
STAT,1872,27,20-24,1899,11.747401296226926
SIM,1840,32,na,1872,2704
STAT,1855,18,30-34,1873,1.2472856043149319
SIM,1826,42,40-44,1868,1
STAT,1853,8,na,1861,2290.485997204176
STAT,1838,18,30-34,1856,0.8934281475367676
STAT,1899,48,40-44,1947,0.13024587972121873
STAT,1777,106,na,1883,0.03370595817885204
STAT,1880,44,45-49,1924,1.532771042013531
STAT,1923,10,na,1933,4617.641027476813
SIM,1879,27,50-100,1906,180
SIM,1897,36,50-100,1933,74
SIM,1903,42,na,1945,2707
STAT,1831,46,15-19,1877,3.820872600770244E-4
STAT,1845,102,na,1947,0.14547841689696847
STAT,1871,59,na,1930,1938.6902794324742
SIM,1844,46,na,1890,2536
STAT,1848,28,40-44,1876,3.32243060357248
STAT,1936,17,na,1953,3488.9676231817157
SIM,1907,56,na,1963,4312
STAT,1839,42,25-29,1881,0.6287969056414562
SIM,1889,10,na,1899,3895
STAT,1872,50,45-49,1922,0.014740978056184316
SIM,1862,26,15-19,1888,2
STAT,1868,28,na,1896,2296.9593909603723
STAT,1819,41,45-49,1860,0.3570885565264714
STAT,1865,54,20-24,1919,6.551871230557909E-4
STAT,1891,47,25-29,1938,0.03976908460917621
STAT,1854,26,15-19,1880,0.2927145192182644
SIM,1882,27,30-34,1909,261
STAT,1855,50,45-49,1905,0.009742870567154449
STAT,1870,25,45-49,1895,1.1144075283845745
STAT,1820,43,35-39,1863,2.9367668199541237
STAT,1875,21,50-100,1896,0.42000470258721784
STAT,1876,38,45-49,1914,2.0052361736137474
STAT,1908,53,na,1961,3226.641903691092
STAT,1840,87,na,1927,69.37199299384979
STAT,1875,39,40-44,1914,4.449807835537951
STAT,1877,64,na,1941,1764.6429970580762
STAT,1838,43,20-24,1881,0.07122969562152404
STAT,1863,29,20-24,1892,9.943703102335629
SIM,1836,27,na,1863,2219
STAT,1860,17,50-100,1877,0.04609498155926638
STAT,1881,25,20-24,1906,11.15373046958435
STAT,1849,25,na,1874,2192.0691041305167
STAT,1858,61,na,1919,1427.0102742029142
SIM,1862,11,na,1873,3854
STAT,1808,48,40-44,1856,0.26556447654922105
SIM,1866,25,na,1891,3257
STAT,1873,50,na,1923,2240.4151412627302
STAT,1874,18,40-44,1892,0.1882735488617648
STAT,1845,11,na,1856,1504.0439195831996
STAT,1832,68,na,1900,1297.247789873848
SIM,1895,38,na,1933,4427
STAT,1899,35,35-39,1934,9.752420672698728
STAT,1829,28,30-34,1857,16.7843622382583
STAT,1809,47,45-49,1856,2.0762235716444213
STAT,1860,36,40-44,1896,3.5883205687934003
STAT,1857,18,40-44,1875,0.1639912247233623
SIM,1891,24,na,1915,2485
SIM,1879,75,na,1954,463
STAT,1841,23,25-29,1864,80.17457360112898
STAT,1864,28,25-29,1892,38.32111510357831
STAT,1872,47,15-19,1919,3.9867614584498533E-4
SIM,1875,61,na,1936,2579
SIM,1883,80,na,1963,912
STAT,1843,36,40-44,1879,5.10195453083981
SIM,1852,40,40-44,1892,16
STAT,1819,38,15-19,1857,0.013754794998493853
STAT,1834,50,25-29,1884,0.0016652641202838713
STAT,1858,93,na,1951,22.31838978273597
STAT,1850,46,25-29,1896,0.02667298651380068
STAT,1908,21,na,1929,3491.678400749736
STAT,1902,44,20-24,1946,0.015319998816838551
STAT,1886,29,15-19,1915,0.4664737353030927
STAT,1848,32,25-29,1880,11.177544613265255
STAT,1865,41,15-19,1906,0.012665300430242988
STAT,1849,53,25-29,1902,0.00293655240602226
SIM,1883,31,30-34,1914,183
STAT,1896,19,30-34,1915,2.08981664910257
STAT,1844,40,40-44,1884,2.341417420255941
STAT,1859,43,40-44,1902,1.7698811701932362
STAT,1874,27,30-34,1901,25.98939542036152
STAT,1939,17,25-29,1956,42.90072389956097
SIM,1893,38,50-100,1931,19
STAT,1812,91,na,1903,4.589152942556207
SIM,1922,34,50-100,1956,15
STAT,1890,23,20-24,1913,83.16817971775416
STAT,1948,16,50-100,1964,0.4244938971708078
STAT,1922,21,50-100,1943,0.748405765399874
STAT,1818,44,50-100,1862,1.947823372179624
STAT,1847,33,20-24,1880,2.83978677493712
STAT,1856,39,30-34,1895,3.7894611898645545
STAT,1811,53,35-39,1864,0.03796272963965235
SIM,1896,23,na,1919,3830
STAT,1843,52,na,1895,2116.100623723731
SIM,1866,57,na,1923,2670
STAT,1893,47,35-39,1940,0.09829584996265263
STAT,1898,27,40-44,1925,4.028185085483378
STAT,1827,35,45-49,1862,2.0144487291956277
STAT,1849,41,30-34,1890,0.9730842595358258
SIM,1896,29,25-29,1925,50
STAT,1842,24,30-34,1866,5.497392533239938
STAT,1833,46,25-29,1879,0.029298677212255674
STAT,1837,47,20-24,1884,0.00998813051082224
STAT,1888,29,25-29,1917,48.473819076587674
SIM,1893,47,na,1940,3001
STAT,1824,40,15-19,1864,0.0023224083691787216
STAT,1865,24,25-29,1889,52.14313649771387
STAT,1803,55,na,1858,808.357634186894
SIM,1826,37,45-49,1863,4
STAT,1840,16,20-24,1856,9.091643432038978
STAT,1855,38,25-29,1893,1.896106135630146
STAT,1807,69,na,1876,813.242951108026
SIM,1800,67,na,1867,216
STAT,1936,16,45-49,1952,0.47467465103715767
STAT,1910,49,25-29,1959,0.04865084623402347
STAT,1925,15,30-34,1940,14.65709409465188
STAT,1868,44,45-49,1912,1.4260487715211236
STAT,1911,15,50-100,1926,0.07447200322482778
STAT,1857,43,30-34,1900,0.8758381556202566
STAT,1894,26,45-49,1920,1.416771803859712
STAT,1900,57,na,1957,2827.342507268234
STAT,1892,18,35-39,1910,0.67757349913794
STAT,1824,49,na,1873,489.67385538541964
SIM,1931,38,na,1969,4967
STAT,1860,28,40-44,1888,2.452207478503046
STAT,1843,44,40-44,1887,2.230310081266798
STAT,1859,51,40-44,1910,0.008384060801195832
STAT,1927,23,40-44,1950,4.096166112858374
STAT,1820,35,na,1855,1994.8796932615192
STAT,1841,36,30-34,1877,7.065383585685557
STAT,1826,47,45-49,1873,0.3377377431493338
STAT,1890,43,50-100,1933,1.2697094955987267
STAT,1853,30,40-44,1883,3.535489683511515
STAT,1916,40,na,1956,3764.448816644565
STAT,1862,66,na,1928,1396.0121797898018
STAT,1854,51,40-44,1905,0.005881566294997091
STAT,1883,33,30-34,1916,16.726118970555497
STAT,1850,30,15-19,1880,0.0771795710371896
STAT,1847,19,35-39,1866,0.6119057794290826
STAT,1867,32,35-39,1899,9.577470775618535
SIM,1855,19,35-39,1874,2
SIM,1891,33,30-34,1924,6
STAT,1823,32,20-24,1855,7.471603405697262
STAT,1818,37,45-49,1855,5.075519178264004
STAT,1875,34,35-39,1909,10.309968168411617
STAT,1882,24,25-29,1906,54.46443118314488
STAT,1861,103,na,1964,0.531371922966996
STAT,1907,36,na,1943,3481.3999845576723
STAT,1835,34,40-44,1869,4.091610732228496
STAT,1903,22,na,1925,3357.2130192079353
STAT,1851,38,50-100,1889,0.9699221953158229
STAT,1869,45,na,1914,2292.907218939409
SIM,1935,23,40-44,1958,670
SIM,1850,24,30-34,1874,2
STAT,1861,41,30-34,1902,0.9604396758018406
SIM,1881,26,25-29,1907,13
STAT,1885,28,45-49,1913,1.0875301139866496
STAT,1896,39,25-29,1935,3.7572407325639827
STAT,1840,44,15-19,1884,0.005528799552530698
STAT,1856,27,na,1883,1776.2298924085735
STAT,1844,52,35-39,1896,0.008483495620957408
STAT,1852,13,na,1865,2893.099695340677
STAT,1833,26,30-34,1859,15.97956274065984
STAT,1853,50,35-39,1903,0.00677129502787411
STAT,1858,34,35-39,1892,7.667466095810673
STAT,1873,35,15-19,1908,0.05814926037385877
SIM,1840,25,25-29,1865,182
STAT,1842,15,40-44,1857,0.05899852237895996
STAT,1873,23,20-24,1896,70.47060296364766
SIM,1828,51,na,1879,1714
STAT,1885,41,40-44,1926,2.220928154280045
STAT,1848,48,35-39,1896,0.12936231213767865
STAT,1899,11,na,1910,3532.6283627739667
SIM,1902,57,na,1959,2895
SIM,1910,44,na,1954,3895
STAT,1835,45,45-49,1880,0.21220111740577316
SIM,1907,24,na,1931,4692
STAT,1818,50,40-44,1868,0.018748636607770944
STAT,1832,25,25-29,1857,52.899459927868385
STAT,1891,31,15-19,1922,0.17583847319425577
STAT,1937,20,50-100,1957,0.6345728596131741
SIM,1903,10,na,1913,3057
SIM,1915,2,na,1917,3887
STAT,1790,109,na,1899,2.0687152521535641E-4
SIM,1824,34,30-34,1858,5
STAT,1881,45,15-19,1926,3.815046818945278E-4
STAT,1897,48,30-34,1945,0.07160480167205503
STAT,1829,48,25-29,1877,0.026298633149527618
SIM,1847,34,25-29,1881,14
STAT,1882,19,50-100,1901,0.04665378364975772
STAT,1856,31,20-24,1887,1.9857647023464082
STAT,1895,27,15-19,1922,0.5902091474939852
STAT,1857,52,20-24,1909,5.632364261265041E-4
STAT,1844,27,45-49,1871,1.346542816032549
STAT,1852,37,45-49,1889,2.0175076736258215
STAT,1880,41,40-44,1921,2.345661482711954
STAT,1836,18,20-24,1854,42.988218277741915
STAT,1889,30,20-24,1919,3.2812558409273427
SIM,1938,19,25-29,1957,55
STAT,1857,44,na,1901,1749.6165528321817
SIM,1944,24,na,1968,2500
STAT,1847,54,50-100,1901,0.013279157987088818
STAT,1820,51,35-39,1871,0.013320440051037274
STAT,1834,33,35-39,1867,5.657900026994767
STAT,1947,16,20-24,1963,151.15434601398502
STAT,1879,44,20-24,1923,0.16071766569008844
SIM,1940,10,na,1950,4327
SIM,1955,16,20-24,1971,809
STAT,1897,40,20-24,1937,0.014793943876799982
STAT,1839,34,25-29,1873,11.46991398236953
STAT,1883,25,30-34,1908,24.39043294822997
STAT,1886,25,na,1911,2488.130926873967
STAT,1840,27,25-29,1867,20.768072821117237
STAT,1887,74,na,1961,1411.4478700941759
STAT,1883,60,na,1943,1834.789227291612
STAT,1910,38,20-24,1948,0.24805779433617403
STAT,1889,38,30-34,1927,6.386177553468072
STAT,1828,36,15-19,1864,0.07713296245340681
SIM,1819,47,na,1866,1882
STAT,1880,48,50-100,1928,0.2517670169532706
STAT,1854,79,na,1933,388.71487911609245
SIM,1822,35,na,1857,1542
STAT,1827,43,45-49,1870,1.4013926757130426
STAT,1850,65,na,1915,780.3598952013921
STAT,1891,47,na,1938,2754.307416018801
SIM,1856,15,na,1871,1191
SIM,1859,29,20-24,1888,48
SIM,1826,49,na,1875,1860
STAT,1842,32,30-34,1874,5.235915534218418
STAT,1870,30,40-44,1900,4.358168597662777
SIM,1891,25,30-34,1916,81
STAT,1861,52,35-39,1913,0.007121548876365145
SIM,1812,68,na,1880,529
STAT,1833,54,25-29,1887,0.0015037667506816706
STAT,1824,44,30-34,1868,0.1974697922011181
STAT,1906,15,20-24,1921,25.791455750767938
STAT,1851,42,25-29,1893,0.5065464458720681
STAT,1884,45,40-44,1929,0.16551889775018508
STAT,1812,107,na,1919,3.7347797192274946E-4
STAT,1832,36,na,1868,2328.861389996902
STAT,1891,9,na,1900,3190.694909371952
STAT,1868,36,45-49,1904,1.9347180140063178
STAT,1888,37,25-29,1925,3.3230648735113832
SIM,1881,46,na,1927,2813
STAT,1829,37,20-24,1866,0.3909622060371605
STAT,1876,52,30-34,1928,0.005985445959462537
STAT,1933,17,50-100,1950,0.49812673388458256
STAT,1845,31,45-49,1876,1.039601486452295
STAT,1866,45,25-29,1911,0.05310254117865542
SIM,1861,42,35-39,1903,2
STAT,1917,16,35-39,1933,0.8931097531528539
STAT,1817,54,40-44,1871,0.00684391264807212
STAT,1929,15,na,1944,4686.160647415035
STAT,1831,51,na,1882,1782.1366324485293
STAT,1852,21,35-39,1873,7.0284106118685745
STAT,1831,41,45-49,1872,1.4824709118231236
STAT,1894,12,na,1906,3284.0697758425454
SIM,1957,8,na,1965,6080
STAT,1860,39,45-49,1899,1.6099031506093977
STAT,1898,26,na,1924,3220.2110019619417
SIM,1878,58,na,1936,3020
STAT,1878,48,20-24,1926,0.012191297915731402
STAT,1937,20,45-49,1957,1.0851195485923664
SIM,1903,49,35-39,1952,1
SIM,1874,44,na,1918,2466
STAT,1841,53,20-24,1894,8.08527603664261E-4
STAT,1849,16,40-44,1865,0.19082435954031596
STAT,1886,17,50-100,1903,0.05073354489184542
SIM,1870,30,na,1900,2434
STAT,1852,29,45-49,1881,1.1676296978166505
STAT,1858,47,40-44,1905,0.13012981441837643
STAT,1833,37,35-39,1870,3.8277712736797147
STAT,1897,32,20-24,1929,3.5898024077011668
STAT,1816,42,30-34,1858,3.7786936954551
STAT,1860,20,30-34,1880,16.699950289153552
STAT,1857,26,40-44,1883,2.3847992457253278
SIM,1849,13,na,1862,2604
STAT,1828,63,na,1891,1207.849457625377
STAT,1892,35,25-29,1927,3.5985708053607426
STAT,1811,45,35-39,1856,0.6794795636137969
SIM,1865,35,30-34,1900,33
SIM,1846,80,na,1926,319
STAT,1870,17,45-49,1887,0.06574252359831291
STAT,1921,47,35-39,1968,0.14362138979718939
STAT,1837,67,na,1904,1271.080941186333
SIM,1932,23,na,1955,6286
STAT,1825,44,25-29,1869,0.8264180803046438
STAT,1838,51,20-24,1889,3.195938182333827E-4
SIM,1851,44,40-44,1895,7
STAT,1851,17,35-39,1868,0.5268942219671175
STAT,1854,34,15-19,1888,0.07941972256596189
STAT,1829,80,na,1909,225.8924817743531
SIM,1837,37,20-24,1874,1
SIM,1922,49,45-49,1971,5
STAT,1902,47,25-29,1949,0.04553951537020114
STAT,1826,39,45-49,1865,3.0985567322586096
STAT,1876,35,40-44,1911,4.467279915410302
STAT,1896,28,20-24,1924,15.410299093890373
STAT,1850,51,20-24,1901,3.423732053948449E-4
STAT,1826,31,35-39,1857,21.76871600248607
SIM,1888,27,25-29,1915,1
STAT,1922,25,na,1947,4220.147960792398
STAT,1903,48,30-34,1951,0.07653602690766623
STAT,1790,95,na,1885,3.5903271398654217
STAT,1834,22,30-34,1856,10.498844773117389
STAT,1926,39,na,1965,4548.780333111033
STAT,1848,83,na,1931,371.4903281274572
SIM,1920,22,na,1942,4252
STAT,1914,49,45-49,1963,0.21130428178364388
SIM,1924,36,na,1960,5205
STAT,1869,37,15-19,1906,0.05666455094416278
STAT,1871,21,45-49,1892,0.6977087955758406
SIM,1893,7,na,1900,3638
STAT,1808,49,50-100,1857,0.3409080312879668
STAT,1912,26,50-100,1938,0.97280942397696
STAT,1832,42,15-19,1874,0.0012152395779783355
STAT,1848,37,30-34,1885,5.139493499952428
STAT,1841,28,30-34,1869,34.579048974561395
STAT,1880,52,45-49,1932,0.014985922520121086
STAT,1820,40,30-34,1860,1.9686081725001285
SIM,1857,41,30-34,1898,1
STAT,1846,24,15-19,1870,2.376326371123985
STAT,1796,105,na,1901,0.011482554481909326
STAT,1930,35,50-100,1965,0.5447413115323166
STAT,1841,20,20-24,1861,98.6236052102727
STAT,1849,49,40-44,1898,0.14123986346561787
STAT,1894,34,45-49,1928,2.198560631526639
STAT,1889,49,35-39,1938,0.09311403942095985
STAT,1860,40,25-29,1900,0.5291526831277076
STAT,1805,51,45-49,1856,0.017350167214199855
STAT,1819,102,na,1921,0.0681902637980792
STAT,1872,42,45-49,1914,1.4968298858327185
STAT,1867,34,50-100,1901,0.8591021579735905
STAT,1876,58,na,1934,1999.169178235681
STAT,1886,24,45-49,1910,0.7175908813348343
SIM,1861,26,na,1887,2296
SIM,1889,39,35-39,1928,2
STAT,1881,28,25-29,1909,39.80663794390042
STAT,1833,29,50-100,1862,0.3733647683331155
STAT,1855,41,50-100,1896,0.7023620970147864
STAT,1834,49,45-49,1883,0.10751320989935859
SIM,1900,29,15-19,1929,8
STAT,1908,37,50-100,1945,0.3900557885219176
SIM,1891,36,35-39,1927,3
STAT,1835,51,30-34,1886,0.004681727352626047
STAT,1872,44,na,1916,2283.142294029863
SIM,1867,31,na,1898,2305
STAT,1839,39,30-34,1878,5.7955235602475055
STAT,1856,43,15-19,1899,0.009847306856181227
STAT,1820,34,45-49,1854,4.8797199650357905
SIM,1886,13,na,1899,3155
STAT,1836,48,50-100,1884,0.19444589427711315
STAT,1917,41,25-29,1958,0.07363298273882732
SIM,1902,37,25-29,1939,6
STAT,1830,47,50-100,1877,0.20988916738872537
STAT,1827,32,40-44,1859,4.4644664577983955
STAT,1768,93,na,1861,17.518445846282724
STAT,1823,35,25-29,1858,5.490846712253991
STAT,1865,45,30-34,1910,0.0892586215918366
SIM,1870,32,35-39,1902,20
SIM,1822,67,na,1889,316
STAT,1821,52,na,1873,1214.5754913808055
STAT,1859,38,45-49,1897,1.5721859335225379
STAT,1867,41,25-29,1908,0.6100551331571376
STAT,1868,39,na,1907,2252.667092533568
STAT,1825,66,na,1891,1009.3231801186997
STAT,1938,26,20-24,1964,17.898670841696703
SIM,1880,19,20-24,1899,37
STAT,1842,40,30-34,1882,0.3029397558394256
STAT,1851,46,40-44,1897,0.13559638184624784
STAT,1863,37,20-24,1900,0.6580831731330563
STAT,1894,23,40-44,1917,2.64170512873435
STAT,1857,76,na,1933,727.0010166831952
SIM,1847,39,30-34,1886,24
STAT,1853,62,na,1915,1417.2020682210468
STAT,1881,17,20-24,1898,16.74189901763385
SIM,1831,35,25-29,1866,24
STAT,1864,52,50-100,1916,0.013656910623499609
STAT,1844,35,50-100,1879,1.4420638392126492
STAT,1818,54,35-39,1872,0.014155162969670027
STAT,1887,28,50-100,1915,0.7016138564659947
STAT,1797,104,na,1901,6.667640130853382E-4
STAT,1865,21,20-24,1886,64.14183297014102
STAT,1953,16,45-49,1969,0.5990404136755362
STAT,1872,33,na,1905,2379.471539998053
STAT,1872,19,20-24,1891,17.65743125652406
STAT,1914,38,na,1952,3685.722433718887
STAT,1898,34,50-100,1932,1.2215421134119846
STAT,1910,24,na,1934,3521.4496098235513
STAT,1866,28,35-39,1894,8.776719276942218
STAT,1874,31,15-19,1905,0.14757482070511233
STAT,1872,35,20-24,1907,0.7792277270279053
SIM,1948,22,15-19,1970,17
STAT,1854,21,45-49,1875,0.45885562518274914
STAT,1844,26,na,1870,2642.523810616635
STAT,1857,22,25-29,1879,50.71243577879267
STAT,1879,52,20-24,1931,7.529572765240055E-4
STAT,1899,32,30-34,1931,23.847656935991495
SIM,1847,26,25-29,1873,267
STAT,1834,41,35-39,1875,0.974491018465292
SIM,1871,47,na,1918,1773
STAT,1882,75,na,1957,1052.6221482461985
STAT,1883,17,30-34,1900,1.5333712538365512
STAT,1819,59,na,1878,505.4875114321146
STAT,1846,48,25-29,1894,0.033685579015164
STAT,1846,16,15-19,1862,4.441461585917269
STAT,1826,53,30-34,1879,0.008062285271637645
STAT,1815,105,na,1920,0.0020672713904291216
STAT,1894,42,45-49,1936,0.13200045763267448
STAT,1842,41,20-24,1883,0.041314815430810274
STAT,1886,37,15-19,1923,0.05815086205826911
SIM,1860,84,na,1944,1638
STAT,1893,44,30-34,1937,0.0984886869377648
STAT,1833,43,20-24,1876,0.08156338587135707
STAT,1824,41,50-100,1865,0.17886339881829733
STAT,1827,51,45-49,1878,0.013099985293655574
SIM,1843,29,na,1872,439
STAT,1880,49,15-19,1929,4.065910895061282E-4
STAT,1889,37,40-44,1926,5.271498391067926
STAT,1837,18,15-19,1855,6.304666918071169
STAT,1856,47,30-34,1903,0.06920280598508778
STAT,1842,48,40-44,1890,0.04196544607867976
STAT,1890,39,30-34,1929,6.387088830167107
STAT,1833,30,15-19,1863,0.08293520531379003
STAT,1876,46,45-49,1922,0.23925165233552712
STAT,1879,47,25-29,1926,0.05881290143681085
STAT,1847,7,na,1854,2793.0
STAT,1873,45,50-100,1918,0.25444312390960666
STAT,1815,45,na,1860,219.89797180755485
STAT,1921,39,35-39,1960,2.6630278042988227
STAT,1876,27,40-44,1903,3.02823960795708
STAT,1901,30,50-100,1931,1.2914061795068859
STAT,1839,31,20-24,1870,3.1227270975361767
SIM,1899,63,na,1962,1469
STAT,1843,47,45-49,1890,0.23209146735572864
SIM,1828,26,15-19,1854,7
SIM,1842,66,na,1908,2030
SIM,1882,38,35-39,1920,11
STAT,1843,20,30-34,1863,22.411437148834672
STAT,1885,45,35-39,1930,0.13898485216047363
STAT,1924,43,50-100,1967,0.13817728704537757
SIM,1851,48,na,1899,1151
STAT,1863,83,na,1946,338.9126788617802
STAT,1892,47,40-44,1939,0.1190066166446177
STAT,1836,21,50-100,1857,0.4153793912751241
STAT,1853,41,45-49,1894,1.1657287665227714
STAT,1874,38,35-39,1912,7.263518749142681
STAT,1900,25,na,1925,3328.444953301584
STAT,1843,28,40-44,1871,3.6163491376548893
STAT,1928,36,50-100,1964,0.5270540761783041
STAT,1850,33,na,1883,1140.7976676831022
STAT,1905,23,50-100,1928,0.5847209319716371
STAT,1938,31,50-100,1969,0.8229192068685809
SIM,1851,28,40-44,1879,4
STAT,1823,48,30-34,1871,0.1488855355129342
STAT,1824,81,na,1905,104.6507577499993
STAT,1867,97,na,1964,16.88105987478844
SIM,1832,44,30-34,1876,2
STAT,1807,53,20-24,1860,0.002304170868152476
STAT,1870,50,35-39,1920,0.008705992721071372
STAT,1862,20,40-44,1882,1.8432845489692211
STAT,1837,54,45-49,1891,0.011316544166144353
SIM,1889,42,na,1931,3795
STAT,1807,47,35-39,1854,0.4924741052675629
STAT,1897,44,15-19,1941,0.0012563881722125153
STAT,1942,0,na,1942,4620.557780199445
STAT,1920,27,25-29,1947,71.27473135604224
STAT,1855,27,20-24,1882,8.092990292201337
STAT,1876,51,40-44,1927,0.010693405685590266
SIM,1814,48,na,1862,2442
STAT,1949,20,15-19,1969,6.154484585276283
STAT,1823,40,20-24,1863,0.2782356879356235
STAT,1838,84,na,1922,141.87161801203413
STAT,1834,70,na,1904,618.3421908961876
STAT,1859,5,na,1864,2313.471510790838
STAT,1861,19,45-49,1880,0.061706925704687075
STAT,1891,35,30-34,1926,6.616178534135868
STAT,1942,15,30-34,1957,12.598942076158071
STAT,1828,29,50-100,1857,1.0919524194986876
STAT,1878,40,50-100,1918,1.0979185684533916
STAT,1874,44,20-24,1918,0.16169319374753308
STAT,1927,26,45-49,1953,2.0903200683330962
STAT,1894,18,45-49,1912,0.08285028313118141
SIM,1858,32,35-39,1890,1
STAT,1808,51,35-39,1859,0.01132128316525279
STAT,1895,22,45-49,1917,0.90712644261257
STAT,1852,43,30-34,1895,1.1488825054891847
STAT,1861,81,na,1942,449.72299211060806
STAT,1912,58,na,1970,3310.391789497917
SIM,1946,15,na,1961,3790
STAT,1822,36,20-24,1858,1.6232764025940876
STAT,1861,1,na,1862,3034.443150080602
STAT,1857,46,35-39,1903,0.10773561481068337
SIM,1851,20,30-34,1871,1
SIM,1916,23,30-34,1939,1
STAT,1865,95,na,1960,23.59748601580283
STAT,1890,26,25-29,1916,51.386148161122975
SIM,1897,61,na,1958,1515
STAT,1853,42,35-39,1895,1.402355881195259
STAT,1945,4,na,1949,4310.9190030053915
STAT,1887,17,15-19,1904,6.532000925280839
STAT,1908,23,30-34,1931,26.13728720843696
STAT,1888,1,na,1889,3261.191375544309
STAT,1962,2,na,1964,4994.82006612817
STAT,1828,31,45-49,1859,2.7287299359338753
SIM,1892,33,25-29,1925,22
STAT,1800,90,na,1890,54.39804374765062
STAT,1841,105,na,1946,0.032650473749267245
STAT,1887,46,20-24,1933,0.013245578956023905
STAT,1877,31,40-44,1908,4.420279700154951
STAT,1943,19,na,1962,3856.0339206717817
STAT,1842,35,35-39,1877,2.1029238802644286
STAT,1873,50,50-100,1923,0.015714720588778906
STAT,1833,25,40-44,1858,1.9724883076030353
SIM,1823,46,30-34,1869,2
STAT,1898,23,25-29,1921,76.74126982683572
STAT,1865,16,25-29,1881,5.36296303790051
STAT,1929,15,15-19,1944,57.77979087282731
STAT,1860,54,50-100,1914,0.011981893516241519
STAT,1878,22,45-49,1900,0.7174527109666424
STAT,1911,29,25-29,1940,63.012211034332466
STAT,1845,36,15-19,1881,0.029582933299794122
STAT,1884,29,40-44,1913,2.8470755723437606
STAT,1842,19,35-39,1861,0.1728622392005297
STAT,1883,42,20-24,1925,0.15259689331860696
STAT,1946,15,15-19,1961,49.81903923987336
STAT,1869,19,50-100,1888,0.04953270331327246
STAT,1909,48,50-100,1957,0.20514765874354965
SIM,1880,29,na,1909,3036
STAT,1827,27,45-49,1854,1.7342943693164588
STAT,1886,57,na,1943,2081.0735823966475
STAT,1838,19,50-100,1857,0.027300174441840908
STAT,1882,43,na,1925,2196.819852467149
STAT,1928,41,na,1969,4705.352924027774
STAT,1863,41,40-44,1904,1.9289230467207783
SIM,1881,27,15-19,1908,2
STAT,1867,48,45-49,1915,0.22038787594194928
STAT,1832,46,30-34,1878,0.00886158960055245
STAT,1866,33,30-34,1899,15.87030030645653
STAT,1816,51,20-24,1867,0.0022028003479261163
STAT,1928,41,50-100,1969,0.14884086845381714
SIM,1925,42,na,1967,4740
STAT,1840,42,50-100,1882,0.4339306905156517
STAT,1918,32,50-100,1950,0.866732514389862
STAT,1937,17,15-19,1954,43.69407285173436
STAT,1887,20,45-49,1907,0.7721026393344438
STAT,1828,95,na,1923,9.000151629769114
STAT,1868,53,35-39,1921,0.008181729296751242
SIM,1850,19,35-39,1869,2
STAT,1906,20,50-100,1926,0.594032939816081
SIM,1869,27,15-19,1896,1
STAT,1864,49,30-34,1913,0.08616407186106417
STAT,1868,33,40-44,1901,4.171031737461505
SIM,1847,11,na,1858,1827
SIM,1856,47,na,1903,461
STAT,1878,38,na,1916,2411.9694179711987
SIM,1830,43,45-49,1873,5
STAT,1857,51,30-34,1908,0.0045896118309567135
STAT,1916,25,30-34,1941,40.23192574366101
STAT,1897,19,25-29,1916,7.485350867183548
STAT,1799,65,na,1864,162.36085325118916
STAT,1846,28,na,1874,1538.83128499772
STAT,1842,14,na,1856,754.1058054275999
STAT,1817,38,40-44,1855,3.384337265366395
STAT,1849,25,50-100,1874,0.6482083242998016
STAT,1884,21,30-34,1905,17.102686059774232
STAT,1806,52,na,1858,1024.7526893581
SIM,1860,63,na,1923,1689
STAT,1884,51,50-100,1935,0.014526618603626402
STAT,1873,18,25-29,1891,5.7975850007558964
SIM,1890,24,25-29,1914,1
STAT,1919,24,45-49,1943,1.2081078299322927
STAT,1850,34,30-34,1884,8.260554249425992
STAT,1853,38,15-19,1891,0.04332564613717653
STAT,1866,42,20-24,1908,0.1447890288872058
STAT,1862,36,15-19,1898,0.048059348243813985
STAT,1864,101,na,1965,2.3550712342487294
STAT,1831,34,20-24,1865,2.7925663779647585
STAT,1864,41,20-24,1905,0.14503117998907245
SIM,1876,9,na,1885,4087
STAT,1893,38,45-49,1931,2.48054574501014
STAT,1892,32,20-24,1924,3.3466403551743458
SIM,1929,35,na,1964,6202
STAT,1822,43,45-49,1865,2.6093207682930086
STAT,1835,50,40-44,1885,0.008445699941181562
STAT,1870,34,35-39,1904,10.009569648983733
STAT,1867,54,30-34,1921,0.005474697332419864
STAT,1846,52,45-49,1898,0.008549378556131342
STAT,1847,66,na,1913,1481.8568633157074
SIM,1825,30,30-34,1855,2
SIM,1925,21,na,1946,5010
STAT,1909,48,25-29,1957,0.048112805619982414
STAT,1921,44,30-34,1965,0.14181486642413305
STAT,1865,29,30-34,1894,22.826529638396234
STAT,1871,26,15-19,1897,0.4541412410326794
STAT,1894,39,15-19,1933,0.07069072375685459
SIM,1864,66,na,1930,1421
SIM,1860,52,na,1912,1999
STAT,1834,50,50-100,1884,0.007100501229634964
STAT,1826,29,na,1855,2193.9928568681084
STAT,1819,81,na,1900,125.77769467198573
STAT,1858,43,25-29,1901,0.48684991574359804
SIM,1865,22,25-29,1887,5
STAT,1873,27,15-19,1900,0.4653988206375527
STAT,1849,52,35-39,1901,0.007215306999182894
STAT,1816,45,35-39,1861,0.4382667689698831
STAT,1886,21,40-44,1907,2.1644033045834608
STAT,1894,43,35-39,1937,0.15875163693536198
SIM,1910,39,25-29,1949,2
STAT,1913,37,50-100,1950,0.40913954046440476
STAT,1912,15,45-49,1927,0.10030339492497366
SIM,1899,30,30-34,1929,13
STAT,1902,39,25-29,1941,0.8662929793703105
STAT,1856,18,25-29,1874,4.784337358854478
STAT,1869,32,45-49,1901,1.7596593818072812
SIM,1855,28,25-29,1883,196
STAT,1827,52,35-39,1879,0.0076187507961092095
STAT,1848,28,50-100,1876,0.7094936510627462
STAT,1864,36,25-29,1900,2.6300940151934937
STAT,1868,52,45-49,1920,0.013942497486027505
STAT,1897,6,na,1903,3469.3461779499635
STAT,1836,30,40-44,1866,4.288624030183017
STAT,1883,36,35-39,1919,6.837206190041334
STAT,1883,49,40-44,1932,0.1612629471140509
STAT,1827,48,15-19,1875,3.615228303140265E-4
STAT,1813,106,na,1919,0.00889410406534431
STAT,1877,43,35-39,1920,1.824915212071121
STAT,1893,27,na,1920,2984.413700706636
STAT,1843,63,na,1906,1762.972419562812
STAT,1815,46,30-34,1861,0.009943188737704023
STAT,1814,71,na,1885,1029.9232253369862
STAT,1879,12,na,1891,2649.240756184793
STAT,1917,35,50-100,1952,0.4343543269929428
SIM,1885,43,35-39,1928,1
SIM,1879,43,na,1922,1021
STAT,1847,28,25-29,1875,45.638999192298904
SIM,1890,37,30-34,1927,37
STAT,1825,41,20-24,1866,0.2146535528937372
STAT,1902,30,25-29,1932,14.539166081350901
STAT,1843,84,na,1927,328.68611606832695
STAT,1847,98,na,1945,2.9370611693564426
STAT,1834,48,na,1882,1038.1262358465813
STAT,1893,31,25-29,1924,12.861005940195323
STAT,1848,54,20-24,1902,6.715371694465661E-4
STAT,1835,26,40-44,1861,2.9753039149654823
SIM,1886,19,15-19,1905,26
STAT,1861,35,45-49,1896,1.673614163109516
STAT,1883,41,30-34,1924,1.1110350267454132
STAT,1830,34,na,1864,1991.7917047715493
SIM,1891,41,30-34,1932,20
STAT,1847,77,na,1924,781.5115963340955
STAT,1846,29,20-24,1875,8.285189495332384
STAT,1816,50,30-34,1866,0.018126505220008162
STAT,1826,40,25-29,1866,0.9995065460214514
STAT,1811,74,na,1885,680.3201286589374
STAT,1924,16,na,1940,4351.726398173933
STAT,1882,37,30-34,1919,5.1025924484366385
STAT,1884,48,45-49,1932,0.22307763981266754
SIM,1911,18,na,1929,2404
SIM,1836,59,na,1895,1299
STAT,1876,22,35-39,1898,5.899133673250601
SIM,1874,36,35-39,1910,3
STAT,1928,30,45-49,1958,1.954833725776751
STAT,1799,103,na,1902,0.009543564936507107
STAT,1818,51,30-34,1869,0.010391339512042984
STAT,1847,52,25-29,1899,0.0031853459238646692
STAT,1868,49,15-19,1917,3.782813661066874E-4
SIM,1870,62,na,1932,804
STAT,1861,16,40-44,1877,0.17586876727228176
STAT,1844,51,45-49,1895,0.014446077278527918
STAT,1865,48,35-39,1913,0.12621270270293639
STAT,1930,29,35-39,1959,18.93759544900231
SIM,1874,76,na,1950,1456
STAT,1844,32,40-44,1876,5.137701181537777
STAT,1882,33,15-19,1915,0.13576720235550904
STAT,1835,33,na,1868,2066.1050562742985
STAT,1794,66,na,1860,9.594472400925463
SIM,1840,26,15-19,1866,3
STAT,1900,46,50-100,1946,0.19246073857937526
SIM,1865,27,30-34,1892,13
STAT,1932,35,na,1967,5028.429143637191
STAT,1788,92,na,1880,4.569662775325444
STAT,1891,79,na,1970,1308.8847892002752
STAT,1852,49,50-100,1901,0.24205627160477775
STAT,1880,37,20-24,1917,0.8002602043991871
STAT,1864,17,20-24,1881,16.672800059072962
STAT,1854,47,na,1901,1245.1192464621374
STAT,1855,0,na,1855,2648.8640019390473
STAT,1934,28,50-100,1962,1.3292859264635264
STAT,1850,43,20-24,1893,0.07280402235061376
STAT,1874,26,40-44,1900,3.1022308143308397
STAT,1925,40,50-100,1965,0.14132170955111667
SIM,1885,39,na,1924,1531
STAT,1828,28,15-19,1856,0.8464429838983227
SIM,1890,33,15-19,1923,3
STAT,1869,13,na,1882,2671.634728096726
STAT,1908,49,20-24,1957,0.009858865727181395
STAT,1874,22,25-29,1896,59.08127869303906
STAT,1895,19,15-19,1914,7.678692494771544
STAT,1848,41,15-19,1889,0.013073401341895764
STAT,1866,36,35-39,1902,6.487369585504971
SIM,1852,41,30-34,1893,9
STAT,1813,46,20-24,1859,0.04503724827182198
STAT,1896,43,45-49,1939,0.13601351038970627
STAT,1923,39,45-49,1962,0.7799242662629532
STAT,1915,16,25-29,1931,8.963662785633739
STAT,1835,54,35-39,1889,0.00638051031705617
STAT,1839,100,na,1939,0.9863384128244215
STAT,1873,61,na,1934,1916.8082940191282
STAT,1822,40,40-44,1862,4.195364660638309
STAT,1872,38,25-29,1910,2.868811480648027
STAT,1829,52,45-49,1881,0.005902687457487363
SIM,1845,63,na,1908,1538
STAT,1877,75,na,1952,1045.0279015996966
SIM,1885,28,na,1913,1658
STAT,1834,46,40-44,1880,0.08906439481234792
SIM,1817,67,na,1884,2170
STAT,1839,47,na,1886,2129.6952311818895
SIM,1813,53,na,1866,100
STAT,1851,22,30-34,1873,16.79994656109229
STAT,1902,69,na,1971,2449.931504761896
SIM,1906,39,na,1945,3440
SIM,1938,24,20-24,1962,955
STAT,1941,31,15-19,1972,0.13346331382394394
SIM,1902,25,na,1927,3562
STAT,1873,39,na,1912,2392.3902289375114
STAT,1854,18,15-19,1872,3.923997277949887
SIM,1916,26,35-39,1942,22
SIM,1885,3,na,1888,1920
STAT,1833,85,na,1918,112.78910222354295
STAT,1856,38,40-44,1894,3.128561937510392
STAT,1867,65,na,1932,1598.2483555379206
STAT,1808,52,25-29,1860,0.00455537974137869
STAT,1886,40,45-49,1926,1.5654843906492821
SIM,1878,53,45-49,1931,2
STAT,1898,47,35-39,1945,0.10569943210996657
STAT,1818,42,40-44,1860,4.398791932834749
STAT,1939,30,20-24,1969,2.464152867464673
STAT,1860,32,na,1892,1946.7338681253937
SIM,1927,0,na,1927,2703
STAT,1837,99,na,1936,1.5185662397167463
STAT,1942,18,35-39,1960,4.333654936111715
STAT,1863,51,na,1914,1846.9807531401111
SIM,1881,30,45-49,1911,33
STAT,1823,44,50-100,1867,1.6887940393316183
STAT,1824,53,20-24,1877,1.220050104722386E-4
STAT,1895,33,50-100,1928,1.186888726876085
SIM,1851,70,na,1921,979
STAT,1912,3,na,1915,4040.56646453931
STAT,1891,38,35-39,1929,8.654633905463077
STAT,1875,47,40-44,1922,0.17497752551495613
SIM,1830,40,40-44,1870,24
STAT,1885,33,40-44,1918,4.244783803535239
STAT,1841,29,na,1870,2949.2113175664067
STAT,1852,30,25-29,1882,10.898866257097762
SIM,1911,27,25-29,1938,10
STAT,1875,43,25-29,1918,0.6546370171565368
STAT,1843,53,30-34,1896,0.0057869532468639885
STAT,1903,27,25-29,1930,60.04734130902422
STAT,1839,58,na,1897,1837.3187735619872
STAT,1842,44,25-29,1886,0.1607565751190164
STAT,1918,20,na,1938,3908.621783402031
STAT,1905,48,40-44,1953,0.13715484999123756
STAT,1840,31,45-49,1871,0.845049677227043
STAT,1846,45,20-24,1891,0.007177985674532195
STAT,1888,27,na,1915,2754.4384975410712
STAT,1824,47,35-39,1871,0.024298079849803672
STAT,1891,44,20-24,1935,0.19266080879259534
STAT,1897,39,40-44,1936,1.242174887490878
STAT,1849,28,35-39,1877,9.56828401882735
STAT,1779,88,na,1867,70.4582865709812
SIM,1838,25,20-24,1863,33
STAT,1838,101,na,1939,0.24335512360278508
STAT,1849,19,45-49,1868,0.06695438172127695
STAT,1845,32,50-100,1877,0.5405887169343943
STAT,1878,35,15-19,1913,0.05832440367471456
STAT,1885,42,30-34,1927,1.128674357068615
STAT,1948,15,25-29,1963,49.112082036326306
STAT,1862,23,45-49,1885,0.6036415976256905
SIM,1915,43,na,1958,3065
STAT,1816,104,na,1920,0.056309939382695816
STAT,1863,44,45-49,1907,1.2604535693137742
SIM,1873,29,30-34,1902,2
STAT,1904,39,35-39,1943,2.159135488788056
SIM,1878,1,na,1879,4422
SIM,1857,28,35-39,1885,54
SIM,1935,4,na,1939,5974
STAT,1954,17,15-19,1971,55.60842953990375
STAT,1832,26,15-19,1858,0.5587861360042519
STAT,1873,30,45-49,1903,1.8031557183675813
SIM,1893,36,45-49,1929,43
STAT,1869,41,35-39,1910,1.8355272953143642
SIM,1822,41,45-49,1863,1
STAT,1892,23,30-34,1915,21.985133228330927
STAT,1832,49,35-39,1881,0.01127608121524719
STAT,1902,48,15-19,1950,3.13735374899805E-4
STAT,1810,89,na,1899,3.2707966341604573
STAT,1915,41,15-19,1956,0.001526443995022997
STAT,1916,28,35-39,1944,15.257857553684769
STAT,1837,51,40-44,1888,0.008641482988453813
STAT,1889,42,15-19,1931,0.016609667836346036
SIM,1838,29,na,1867,2233
STAT,1842,16,30-34,1858,0.5111017347694864
STAT,1867,45,40-44,1912,0.16352314976099425
STAT,1881,32,45-49,1913,1.6467745906847382
STAT,1848,16,25-29,1864,6.6125292377978715
STAT,1825,32,30-34,1857,30.260724694401336
STAT,1931,38,40-44,1969,1.9666431479816928
STAT,1892,42,35-39,1934,2.2391971533199952
STAT,1841,29,50-100,1870,0.8720999363402846
STAT,1883,28,na,1911,2287.856740510287
SIM,1857,32,na,1889,1424
STAT,1884,30,20-24,1914,2.608362727278878
STAT,1897,16,20-24,1913,23.60223599723492
STAT,1892,64,na,1956,2177.589617739046
STAT,1825,51,35-39,1876,0.010771218924872554
SIM,1833,32,30-34,1865,3
SIM,1833,30,na,1863,2343
SIM,1837,44,na,1881,1975
STAT,1887,49,25-29,1936,0.035015501747626805
STAT,1868,28,45-49,1896,1.068634547913975
STAT,1866,23,50-100,1889,0.3725835880860398
STAT,1874,35,30-34,1909,5.552717463882131
STAT,1908,26,35-39,1934,14.251214812738931
SIM,1818,43,45-49,1861,13
STAT,1841,32,15-19,1873,0.19240512339239263
STAT,1859,52,30-34,1911,0.004692830733433064
STAT,1916,20,25-29,1936,96.0399594709963
SIM,1792,74,na,1866,282
STAT,1827,42,50-100,1869,1.0026393674701894
STAT,1814,41,45-49,1855,5.545368977837427
SIM,1950,20,na,1970,4829
STAT,1841,27,40-44,1868,4.143168777350773
STAT,1839,49,50-100,1888,0.22660313691855657
STAT,1832,41,25-29,1873,0.0558107380442604
STAT,1877,34,45-49,1911,1.7550337357074544
STAT,1904,39,na,1943,3358.3906627292786
SIM,1895,49,25-29,1944,1
STAT,1838,27,20-24,1865,6.370321510820159
STAT,1818,85,na,1903,166.8536407047365
STAT,1834,42,25-29,1876,0.34117816900338505
SIM,1867,10,na,1877,2872
STAT,1858,31,30-34,1889,13.472534126312194
SIM,1840,49,35-39,1889,3
STAT,1842,104,na,1946,0.01655791630998785
STAT,1923,15,20-24,1938,158.2550217379675
STAT,1850,18,30-34,1868,0.8940680949022682
STAT,1840,40,20-24,1880,0.07354336021449911
STAT,1909,30,35-39,1939,8.701115007729822
SIM,1904,37,35-39,1941,52
STAT,1863,24,15-19,1887,2.8314438678634493
SIM,1924,28,35-39,1952,3
STAT,1853,17,45-49,1870,0.060929052841848956
STAT,1898,20,20-24,1918,93.22069668572023
SIM,1865,51,na,1916,1665
STAT,1888,38,15-19,1926,0.06449009158560132
STAT,1858,39,40-44,1897,3.309297386232023
STAT,1877,40,30-34,1917,1.178827588803366
STAT,1854,9,na,1863,1620.4701353475173
STAT,1789,66,na,1855,1301.5534
SIM,1924,20,25-29,1944,332
STAT,1840,48,30-34,1888,0.03794708894691547
STAT,1865,26,50-100,1891,0.5860376860727257
STAT,1898,28,30-34,1926,33.74332741234997
STAT,1851,50,25-29,1901,0.0028376560854845587
STAT,1870,22,40-44,1892,2.0774180715379997
SIM,1831,71,na,1902,1084
STAT,1882,28,40-44,1910,2.8578883090772753
SIM,1872,10,na,1882,2547
STAT,1870,31,30-34,1901,17.477303375598563
STAT,1836,33,45-49,1869,1.6715922910733576
STAT,1848,62,na,1910,1710.34429107434
STAT,1859,46,45-49,1905,0.18758293278544988
STAT,1899,31,50-100,1930,1.2565841304361591
STAT,1847,37,15-19,1884,0.052676436220137235
STAT,1895,48,20-24,1943,0.008694962560415565
STAT,1893,35,40-44,1928,5.526178079048947
SIM,1935,20,na,1955,3885
STAT,1837,34,15-19,1871,0.14022337898804288
STAT,1879,19,30-34,1898,1.6262863180140235
STAT,1909,21,50-100,1930,0.6071518100869902
SIM,1840,41,25-29,1881,2
STAT,1938,19,na,1957,3589.569232709532
STAT,1831,37,25-29,1868,2.924239905937407
STAT,1891,19,30-34,1910,1.9495158544742144
SIM,1866,31,30-34,1897,1
STAT,1861,40,40-44,1901,1.8894693834725096
STAT,1889,17,25-29,1906,6.824016151067354
STAT,1870,39,50-100,1909,1.211658650144136
STAT,1835,29,45-49,1864,1.0792097452083598
STAT,1903,54,na,1957,3011.595284055727
STAT,1857,27,30-34,1884,19.90362795820315
STAT,1934,16,35-39,1950,5.651126742323113
STAT,1815,42,15-19,1857,0.0014671904704985533
STAT,1937,34,na,1971,3698.3277681564123
SIM,1921,39,na,1960,5143
STAT,1826,44,40-44,1870,3.2634159371917564
STAT,1793,92,na,1885,10.388499558225742
STAT,1911,26,20-24,1937,17.661373203602395
STAT,1869,29,15-19,1898,0.45455086653246374
STAT,1848,36,40-44,1884,4.265437122188982
SIM,1901,62,na,1963,2787
STAT,1880,20,35-39,1900,6.094275865908115
SIM,1861,46,50-100,1907,1
STAT,1861,28,50-100,1889,0.5320132520967287
SIM,1920,38,30-34,1958,1
STAT,1850,37,35-39,1887,3.3177229402424793
STAT,1883,45,25-29,1928,0.05596613827349355
STAT,1877,43,50-100,1920,1.0646788429063232
SIM,1897,17,25-29,1914,31
STAT,1912,38,30-34,1950,1.7494736292481774
STAT,1933,20,na,1953,4839.756766994694
STAT,1935,20,35-39,1955,12.73865517053657
STAT,1818,96,na,1914,5.226322973201177
SIM,1834,44,40-44,1878,16
STAT,1865,100,na,1965,4.168581801201427
STAT,1878,52,40-44,1930,0.010773912621614316
STAT,1821,48,20-24,1869,0.012663148128433176
STAT,1844,103,na,1947,0.1421787371555472
STAT,1851,41,35-39,1892,1.4366384438812279
STAT,1816,54,25-29,1870,0.009960516298807343
STAT,1801,53,na,1854,1006.8131838353095
STAT,1874,24,na,1898,2425.6070848118843
STAT,1902,17,50-100,1919,0.06898842495233794
STAT,1835,21,35-39,1856,5.911521048958715
STAT,1805,67,na,1872,305.68015306947495
SIM,1888,32,20-24,1920,3
STAT,1857,39,50-100,1896,0.9326403909995432
STAT,1939,18,50-100,1957,0.37078086753982287
STAT,1860,32,25-29,1892,8.355836399031617
STAT,1856,15,20-24,1871,15.235574234447181
STAT,1830,25,15-19,1855,0.44259607407973817
STAT,1894,36,50-100,1930,1.5687840424588813
SIM,1843,21,35-39,1864,1
STAT,1838,46,25-29,1884,0.0256225337365894
STAT,1876,79,na,1955,706.7311137764896
STAT,1872,65,na,1937,1692.2601765860138
SIM,1837,33,na,1870,2121
STAT,1820,38,50-100,1858,2.175119374534492
SIM,1866,40,20-24,1906,1
STAT,1879,28,20-24,1907,11.992228401309754
STAT,1871,34,15-19,1905,0.14084162500687217
STAT,1867,16,35-39,1883,0.5336460660584035
STAT,1855,32,na,1887,1608.1017763331745
SIM,1884,43,na,1927,3651
STAT,1847,48,40-44,1895,0.1528399460839827
STAT,1912,42,15-19,1954,0.0014639138693757184
STAT,1950,21,na,1971,4292.351121678087
SIM,1831,50,na,1881,2133
SIM,1797,73,na,1870,802
STAT,1932,34,40-44,1966,5.1593556044514255
STAT,1847,13,na,1860,2681.593172319215
STAT,1862,49,20-24,1911,0.010007488238753238
SIM,1892,62,na,1954,3403
STAT,1844,16,40-44,1860,0.23170102999908598
STAT,1882,48,35-39,1930,0.1323532514815565
STAT,1810,48,45-49,1858,0.0012229082052479306
STAT,1921,48,25-29,1969,0.05892567259404106
SIM,1846,16,na,1862,1441
STAT,1832,54,30-34,1886,4.5788874185589615E-4
STAT,1915,37,45-49,1952,0.6789464181619546
SIM,1871,15,na,1886,2013
STAT,1791,108,na,1899,4.618740467755947E-4
SIM,1945,19,na,1964,6340
STAT,1903,44,15-19,1947,0.0013429121610493656
STAT,1875,27,25-29,1902,43.43730810459949
SIM,1939,9,na,1948,4763
STAT,1900,30,15-19,1930,0.1988610014654595
SIM,1806,51,na,1857,235
SIM,1892,6,na,1898,3699
STAT,1810,68,na,1878,53.53966825438284
SIM,1859,44,na,1903,1794
SIM,1867,63,na,1930,1256
STAT,1891,26,40-44,1917,3.6963726419029315
STAT,1850,45,35-39,1895,0.06529113159765945
STAT,1868,82,na,1950,450.6583723017005
SIM,1890,28,40-44,1918,28
STAT,1925,22,na,1947,4331.180060765053
SIM,1829,46,na,1875,1901
STAT,1952,20,35-39,1972,11.225377724583133
STAT,1824,35,40-44,1859,0.6779798292200411
SIM,1905,54,na,1959,2737
STAT,1924,19,50-100,1943,0.439497078608586
STAT,1858,18,35-39,1876,0.48659917771013056
SIM,1883,27,25-29,1910,1
STAT,1885,49,15-19,1934,3.8497012660136106E-4
STAT,1929,19,30-34,1948,15.363580435879506
STAT,1930,26,30-34,1956,49.49482285564806
STAT,1809,71,na,1880,1526.3500634439981
STAT,1909,45,20-24,1954,0.010148079653737384
SIM,1846,26,na,1872,1055
SIM,1880,8,na,1888,3342
STAT,1906,44,40-44,1950,0.2231275257226713
STAT,1855,42,na,1897,1527.779503811825
STAT,1867,29,40-44,1896,2.812746891898129
SIM,1884,33,na,1917,3707
STAT,1869,0,na,1869,3783.019684351381
SIM,1839,29,30-34,1868,3
STAT,1833,53,35-39,1886,0.0037281118525407256
STAT,1855,10,na,1865,1902.7508776800462
STAT,1919,40,45-49,1959,0.1784556132493447
STAT,1864,44,25-29,1908,0.5759088551886943
SIM,1889,28,30-34,1917,7
STAT,1856,52,50-100,1908,0.010789856155358482
STAT,1927,35,na,1962,4647.482575379219
SIM,1914,37,na,1951,4969
STAT,1862,25,50-100,1887,0.5547991456965752
SIM,1869,76,na,1945,3268
STAT,1823,86,na,1909,175.27707860656398
STAT,1896,40,40-44,1936,0.2079774396626672
STAT,1831,45,25-29,1876,0.05573342538368428
SIM,1852,2,na,1854,2713
STAT,1904,36,30-34,1940,1.6513999186956718
SIM,1855,62,na,1917,2860
STAT,1830,46,20-24,1876,0.010387403092447645
STAT,1881,49,30-34,1930,0.08950423292941509
SIM,1857,43,na,1900,1359
STAT,1868,60,na,1928,1842.0892669706232
STAT,1917,25,na,1942,3902.5050676132882
SIM,1864,0,na,1864,4117
STAT,1918,41,40-44,1959,0.2627284820276644
STAT,1917,35,na,1952,3892.1262875995276
SIM,1859,66,na,1925,1272
SIM,1906,18,na,1924,3306
STAT,1900,43,35-39,1943,0.17293661947690891
STAT,1813,54,20-24,1867,0.002462939766237282
SIM,1855,17,20-24,1872,120
STAT,1899,19,35-39,1918,0.7454446507892148
STAT,1909,5,na,1914,3890.0771002880915
STAT,1853,46,15-19,1899,3.1103580639827333E-4
SIM,1854,45,na,1899,1555
STAT,1938,1,na,1939,4075.3531368697754
SIM,1856,26,na,1882,875
STAT,1806,51,50-100,1857,0.04084670547300205
STAT,1948,19,40-44,1967,1.5832725375108891
SIM,1821,40,na,1861,1939
STAT,1891,40,50-100,1931,1.3122581427540403
STAT,1847,17,20-24,1864,20.005353700620617
STAT,1840,23,50-100,1863,0.20273030416633855
STAT,1871,48,na,1919,2216.114443035656
STAT,1840,43,25-29,1883,0.2604041062954417
SIM,1904,34,30-34,1938,8
STAT,1903,30,40-44,1933,6.205500650026717
SIM,1895,27,na,1922,4560
STAT,1942,28,50-100,1970,1.032245644921528
SIM,1839,46,na,1885,748
STAT,1907,18,40-44,1925,0.2661740706719442
STAT,1954,9,na,1963,4815.011175428293
STAT,1823,43,25-29,1866,1.0527883696024845
STAT,1929,31,15-19,1960,0.16217940310728338
SIM,1921,34,30-34,1955,31
SIM,1880,61,na,1941,3193
STAT,1834,104,na,1938,0.029395059318896046
STAT,1820,42,45-49,1862,2.470937086037002
STAT,1845,32,na,1877,1278.6881089624285
SIM,1894,43,na,1937,1455
SIM,1804,70,na,1874,592
STAT,1865,53,30-34,1918,0.005347365794573253
STAT,1877,43,na,1920,2329.238182767412
STAT,1834,26,25-29,1860,24.622744466535096
STAT,1913,34,30-34,1947,15.346023285393414
STAT,1880,45,20-24,1925,0.012582053357776953
STAT,1922,44,25-29,1966,0.0807795092035134
STAT,1857,19,30-34,1876,1.4206491292224925
SIM,1871,25,na,1896,1757
STAT,1885,17,40-44,1902,0.17978444397203133
SIM,1854,13,na,1867,2439
SIM,1862,32,na,1894,3728
SIM,1848,32,50-100,1880,49
STAT,1884,13,na,1897,2468.3328455182163
STAT,1831,83,na,1914,310.7018885258457
STAT,1910,41,50-100,1951,0.11041844465987885
STAT,1892,10,na,1902,3207.0666452277505
SIM,1872,32,na,1904,2293
STAT,1835,38,20-24,1873,0.7136121356536393
STAT,1895,39,30-34,1934,6.8633224818483
STAT,1903,24,20-24,1927,97.20967482914774
STAT,1850,28,45-49,1878,0.5990080442132496
STAT,1881,36,25-29,1917,2.732049940045994
STAT,1890,34,25-29,1924,12.293609347814991
STAT,1802,53,50-100,1855,0.07512989830295502
STAT,1851,49,45-49,1900,0.18249934450034255
STAT,1814,45,25-29,1859,0.20224811793561784
STAT,1830,33,15-19,1863,0.1323824402909253
STAT,1828,48,30-34,1876,0.11405678614158954
SIM,1884,65,na,1949,3459
SIM,1934,35,na,1969,5205
STAT,1839,18,25-29,1857,6.846512856727329
SIM,1875,82,na,1957,658
STAT,1854,47,20-24,1901,0.006641106203782295
STAT,1923,36,40-44,1959,1.7178547987290635
STAT,1935,25,50-100,1960,1.3482027136980337
SIM,1922,24,na,1946,3503
STAT,1854,38,30-34,1892,2.9486413050188722
STAT,1871,47,20-24,1918,0.01191471680254871
STAT,1888,80,na,1968,1107.5818935035172
SIM,1875,50,na,1925,2645
STAT,1894,22,50-100,1916,0.5185701549546261
STAT,1890,47,30-34,1937,0.0657949291136691
STAT,1865,36,40-44,1901,4.015856923206812
STAT,1872,12,na,1884,2635.545328536092
SIM,1932,35,45-49,1967,1
STAT,1858,82,na,1940,356.3123446484349
SIM,1839,24,na,1863,270
STAT,1885,30,na,1915,2364.477369344086
STAT,1891,46,35-39,1937,0.09738944354935022
STAT,1880,34,50-100,1914,0.9430605678547602
STAT,1800,68,na,1868,1254.6232073148112
STAT,1913,46,25-29,1959,0.05125220302107904
STAT,1875,18,35-39,1893,0.5619669829042382
SIM,1880,83,na,1963,2623
STAT,1851,54,40-44,1905,0.00808601174116506
STAT,1792,108,na,1900,4.4341697788958184E-4
STAT,1905,24,na,1929,3380.402760415017
STAT,1923,18,25-29,1941,50.21860831749114
STAT,1855,46,25-29,1901,0.038230015266749885
STAT,1935,22,na,1957,4937.055070404325
STAT,1849,50,20-24,1899,6.306999046443796E-4
STAT,1856,28,50-100,1884,0.4726886859219816
STAT,1924,35,45-49,1959,0.7975252348693546
SIM,1847,49,45-49,1896,4
STAT,1908,42,na,1950,3409.5120115239865
SIM,1864,45,na,1909,2415
STAT,1920,44,15-19,1964,0.0016686855639890497
SIM,1872,64,na,1936,2049
STAT,1860,44,40-44,1904,1.8101733491062053
STAT,1898,20,50-100,1918,0.551634455089689
STAT,1885,62,na,1947,1796.5671522154585
STAT,1904,18,15-19,1922,8.456454451547861
STAT,1922,24,30-34,1946,32.38793095434261
STAT,1872,46,25-29,1918,0.05784207151787546
STAT,1838,19,20-24,1857,9.879025110992899
STAT,1844,48,15-19,1892,3.912960123226271E-4
STAT,1907,35,45-49,1942,0.633777662948778
STAT,1928,19,na,1947,4577.912596929862
STAT,1900,26,45-49,1926,1.5433650389977445
STAT,1861,43,45-49,1904,1.2356790430577724
STAT,1809,48,20-24,1857,0.1032344220067994
STAT,1843,103,na,1946,0.1417992607399586
SIM,1930,24,30-34,1954,8
SIM,1846,19,20-24,1865,6
SIM,1866,14,na,1880,3337
STAT,1839,49,45-49,1888,0.2177456856702308
STAT,1874,19,30-34,1893,1.6361575908815646
STAT,1842,43,35-39,1885,0.4591613791419584
STAT,1891,29,45-49,1920,1.3556131023274804
SIM,1802,69,na,1871,141
STAT,1840,35,25-29,1875,1.3690242725232935
STAT,1873,29,na,1902,2430.550261460178
SIM,1895,59,na,1954,4395
STAT,1900,31,40-44,1931,6.032140965208744
STAT,1921,45,20-24,1966,0.012368345039590787
STAT,1953,18,na,1971,4411.2506284192405
STAT,1932,37,45-49,1969,0.9095862131037841
STAT,1813,86,na,1899,162.53008346869632
STAT,1821,43,15-19,1864,0.01527211390160552
STAT,1824,52,30-34,1876,0.001003760325621548
SIM,1809,48,na,1857,747
STAT,1907,30,25-29,1937,8.650370302665996
STAT,1872,97,na,1969,28.857165180098384
STAT,1917,47,20-24,1964,0.011388880288631668
STAT,1913,53,na,1966,3465.482282955593
STAT,1875,62,na,1937,1876.8097855926208
SIM,1857,37,25-29,1894,2
STAT,1824,38,45-49,1862,0.31861466225754465
SIM,1864,42,25-29,1906,2
STAT,1873,38,40-44,1911,4.468081036256845
STAT,1856,59,na,1915,1395.9000334500681
STAT,1830,49,25-29,1879,0.047979533759695596
STAT,1914,20,15-19,1934,5.176861942222362
SIM,1934,25,na,1959,5205
SIM,1793,69,na,1862,863
SIM,1881,47,30-34,1928,1
STAT,1829,29,20-24,1858,7.157324865573833
STAT,1852,18,40-44,1870,0.2213601250242205
SIM,1821,72,na,1893,1347
SIM,1942,6,na,1948,3672
STAT,1891,43,30-34,1934,1.4035672459888535
STAT,1845,40,35-39,1885,0.9387656837234922
STAT,1851,28,na,1879,1986.0937437366135
STAT,1831,73,na,1904,929.5946683599469
STAT,1899,16,30-34,1915,2.1823609276063345
STAT,1844,19,45-49,1863,0.08129674453063884
SIM,1904,59,na,1963,3873
SIM,1847,43,na,1890,1450
STAT,1803,66,na,1869,585.3798378226505
STAT,1878,19,15-19,1897,6.073132132700891
STAT,1880,28,30-34,1908,26.05067902400463
STAT,1947,6,na,1953,4402.079946408689
STAT,1910,45,45-49,1955,0.2014523002544723
STAT,1829,26,na,1855,1040.2168418037904
STAT,1838,50,45-49,1888,0.006411065854805313
SIM,1864,13,na,1877,2555
STAT,1849,37,25-29,1886,2.4824274582742962
SIM,1885,60,na,1945,976
STAT,1856,27,15-19,1883,0.33767951643046545
SIM,1800,56,na,1856,216
SIM,1873,5,na,1878,2562
STAT,1831,42,20-24,1873,0.15521051632150493
STAT,1853,46,50-100,1899,0.190976145556278
STAT,1873,47,30-34,1920,0.09883254711069797
SIM,1909,36,na,1945,3884
STAT,1923,40,25-29,1963,0.08281403339976902
SIM,1849,5,na,1854,3015
STAT,1844,21,50-100,1865,0.5080599964400345
STAT,1881,45,50-100,1926,0.23424407145779771
SIM,1905,7,na,1912,3894
STAT,1808,97,na,1905,1.258199204687001
STAT,1923,44,40-44,1967,0.28830632604791606
STAT,1876,54,45-49,1930,0.014267280907774058
STAT,1878,60,na,1938,1962.2384855198936
STAT,1906,47,45-49,1953,0.19187383859793045
STAT,1796,89,na,1885,68.85985327847743
STAT,1900,40,30-34,1940,0.11171064650307973
STAT,1921,36,30-34,1957,2.0127535398321448
SIM,1860,42,40-44,1902,26
STAT,1848,29,30-34,1877,27.72913601385439
SIM,1817,77,na,1894,1263
STAT,1904,40,15-19,1944,0.0013839197214905359
STAT,1882,17,15-19,1899,5.681799797230549
STAT,1836,46,15-19,1882,3.2490632112399764E-4
STAT,1831,44,50-100,1875,1.0051684969080479
STAT,1864,25,na,1889,2192.792714874362
STAT,1858,15,30-34,1873,1.4387276539704303
STAT,1875,84,na,1959,456.7469502422117
STAT,1826,28,40-44,1854,10.665339903891685
SIM,1964,0,na,1964,5114
STAT,1892,32,na,1924,2954.4769911693556
STAT,1891,58,na,1949,2431.908476349173
SIM,1908,40,35-39,1948,2
SIM,1881,38,40-44,1919,6
SIM,1904,37,na,1941,4028
STAT,1888,37,na,1925,2719.183331493545
STAT,1819,50,35-39,1869,0.0015591946781308525
STAT,1854,15,na,1869,1544.9125483204946
STAT,1869,49,30-34,1918,0.09563966075054708
STAT,1933,20,25-29,1953,122.41793252075644
STAT,1920,24,20-24,1944,121.26392815457756
SIM,1883,42,35-39,1925,4
STAT,1877,18,45-49,1895,0.06613647120897052
STAT,1934,32,35-39,1966,12.392506854055044
STAT,1881,58,na,1939,1867.5397624523282
STAT,1911,46,15-19,1957,3.456655927139637E-4
STAT,1903,9,na,1912,3683.1107755676726
SIM,1919,36,na,1955,4933
STAT,1846,101,na,1947,0.33795802131197683
STAT,1843,52,40-44,1895,0.010346414611460956
STAT,1893,19,40-44,1912,0.22749875527744767
STAT,1915,34,40-44,1949,3.895630549310655
STAT,1875,42,35-39,1917,1.857148884925356
STAT,1860,16,25-29,1876,5.363243447003004
STAT,1938,29,25-29,1967,64.44636997237862
STAT,1869,16,45-49,1885,0.06722447820910253
SIM,1867,27,40-44,1894,14
STAT,1890,31,20-24,1921,3.285715422090159
STAT,1805,52,20-24,1857,8.642864151505324E-4
STAT,1863,48,25-29,1911,0.04855595694519959
STAT,1886,41,35-39,1927,1.8836731744189148
STAT,1919,29,15-19,1948,0.7472667311783001
STAT,1781,81,na,1862,214.2523300149284
SIM,1840,64,na,1904,2500
STAT,1847,101,na,1948,0.5159104650703139
SIM,1913,44,25-29,1957,1
STAT,1829,48,na,1877,885.3948144352639
SIM,1846,48,na,1894,901
STAT,1863,61,na,1924,1595.2771636358
SIM,1876,14,na,1890,3983
STAT,1864,46,na,1910,2051.1511993448694
STAT,1923,31,20-24,1954,2.7781495846256434
STAT,1859,14,na,1873,2176.441954111008
STAT,1880,31,na,1911,2487.4835003011144
STAT,1817,90,na,1907,24.975858120709255
STAT,1802,54,45-49,1856,0.0706948686303175
SIM,1877,0,na,1877,2717
STAT,1898,37,na,1935,3168.122066062531
STAT,1809,46,50-100,1855,2.209795459388361
STAT,1868,50,30-34,1918,0.0058320152960470275
STAT,1900,23,40-44,1923,2.877750197965787
STAT,1913,23,50-100,1936,0.6540817964303868
SIM,1909,58,na,1967,3677
SIM,1829,27,20-24,1856,2
SIM,1821,50,na,1871,1898
STAT,1917,20,40-44,1937,3.546893443604037
STAT,1804,50,na,1854,2284.434368346246
STAT,1926,30,35-39,1956,10.967539573129988
SIM,1886,4,na,1890,3180
STAT,1850,25,40-44,1875,1.6514222438747617
SIM,1787,73,na,1860,903
STAT,1839,26,na,1865,2550.234130373271
STAT,1870,38,15-19,1908,0.055704670724470634
STAT,1908,42,35-39,1950,0.18486141988058283
STAT,1841,16,15-19,1857,8.573739376062218
STAT,1855,17,50-100,1872,0.03856584186789458
STAT,1841,47,35-39,1888,0.15660585597537952
STAT,1915,42,40-44,1957,0.248261536236642
STAT,1888,49,40-44,1937,0.10913163413073594
STAT,1801,85,na,1886,81.24206424445421
STAT,1883,44,35-39,1927,1.7185662519247913
STAT,1888,18,20-24,1906,20.408017976583135
STAT,1866,17,30-34,1883,1.4933509046716291
SIM,1901,30,na,1931,3790
STAT,1922,48,50-100,1970,0.25622480302847517
STAT,1902,36,20-24,1938,0.23541874004856567
STAT,1821,35,15-19,1856,0.07317923987451691
STAT,1857,54,35-39,1911,0.006424592119932943
STAT,1848,94,na,1942,18.70246296321245
SIM,1839,16,25-29,1855,25
STAT,1940,8,na,1948,3987.7512635910625
STAT,1942,24,na,1966,3782.5692985816004
STAT,1859,27,40-44,1886,2.415243938208248
STAT,1938,29,na,1967,3667.9562976747884
STAT,1922,36,na,1958,4237.002163181178
SIM,1869,44,na,1913,3598
STAT,1918,52,na,1970,3791.8620388322092
STAT,1888,59,na,1947,2243.075776937792
STAT,1916,41,30-34,1957,0.12941249216019507
SIM,1840,86,na,1926,1449
STAT,1896,47,25-29,1943,0.04263114605869161
SIM,1823,41,25-29,1864,2
STAT,1865,39,45-49,1904,1.8017177086386014
STAT,1786,69,na,1855,1280.3586000000005
SIM,1826,71,na,1897,506
STAT,1875,40,20-24,1915,0.16472302599646654
STAT,1797,85,na,1882,3.667932272950108
STAT,1816,53,35-39,1869,0.02469631945268054
STAT,1850,42,30-34,1892,0.5302191198015199
SIM,1847,65,na,1912,1382
STAT,1863,29,na,1892,2022.8425238323564
STAT,1882,32,25-29,1914,9.806374467495933
STAT,1849,79,na,1928,589.0604071119022
STAT,1839,15,20-24,1854,21.80250827896083
SIM,1861,15,na,1876,2602
STAT,1851,19,50-100,1870,0.04649157059151923
SIM,1912,24,na,1936,3736
STAT,1839,46,40-44,1885,0.16414720591429
STAT,1879,51,45-49,1930,0.014958643159853072
STAT,1789,87,na,1876,98.81357661711255
SIM,1821,37,30-34,1858,68
STAT,1815,41,25-29,1856,0.069385978456892
STAT,1927,42,45-49,1969,0.20702728761989278
STAT,1930,23,na,1953,4630.994471353193
STAT,1897,28,15-19,1925,0.6004195953319763
STAT,1832,37,40-44,1869,0.3338820902292806
STAT,1840,34,na,1874,1018.0304920872485
SIM,1849,39,40-44,1888,2
SIM,1834,47,na,1881,778
STAT,1776,107,na,1883,0.015388420725439653
STAT,1872,43,20-24,1915,0.15788016334107735
STAT,1822,47,25-29,1869,0.0963188362223
STAT,1810,45,40-44,1855,9.232118061068134E-4
SIM,1814,70,na,1884,871
STAT,1835,53,45-49,1888,0.010970855860029695
STAT,1930,30,15-19,1960,0.16486174161003977
SIM,1915,30,25-29,1945,2
STAT,1945,19,15-19,1964,48.99537280561901
STAT,1877,47,15-19,1924,4.0415478173231597E-4
SIM,1921,37,35-39,1958,2
STAT,1935,35,20-24,1970,0.3665915641100146
STAT,1913,37,35-39,1950,2.357018037891561
SIM,1890,32,25-29,1922,38
STAT,1913,43,20-24,1956,0.01697917671004427
STAT,1894,40,30-34,1934,1.4767373842280185
STAT,1806,84,na,1890,100.17101127547113
STAT,1839,27,15-19,1866,0.531020101165524
STAT,1901,30,30-34,1931,24.608672715227534
STAT,1828,44,15-19,1872,0.016701990664122642
STAT,1807,52,30-34,1859,0.01898220760040704
STAT,1849,57,na,1906,1693.298759552228
STAT,1858,23,50-100,1881,0.3228127782779274
STAT,1880,63,na,1943,1852.3833985608508
STAT,1825,43,35-39,1868,2.369195785801643
SIM,1908,41,na,1949,2423
SIM,1859,12,na,1871,2403
STAT,1864,40,45-49,1904,1.3743337858325266
STAT,1890,38,40-44,1928,5.27315151267529
STAT,1840,32,20-24,1872,1.2963609177589763
STAT,1878,59,na,1937,1999.5704661223992
STAT,1893,39,20-24,1932,0.9542660685738467
STAT,1931,18,na,1949,4771.355922714733
STAT,1787,75,na,1862,189.26899745859043
STAT,1884,6,na,1890,2500.737534400451
SIM,1824,69,na,1893,1465
STAT,1826,48,20-24,1874,0.01694636074309405
STAT,1888,45,25-29,1933,0.06714260403335909
SIM,1873,59,na,1932,1459
SIM,1925,40,35-39,1965,2
STAT,1895,47,50-100,1942,0.17938117992600527
STAT,1892,34,35-39,1926,12.430910392224675
STAT,1830,37,30-34,1867,4.861267227052869
STAT,1911,34,20-24,1945,2.3283070494727824
STAT,1885,44,45-49,1929,1.451264125860672
STAT,1871,30,35-39,1901,10.183393017386846
STAT,1910,42,40-44,1952,0.23374318431679372
STAT,1872,34,50-100,1906,0.9096360803502906
STAT,1859,47,50-100,1906,0.19375322822959556
STAT,1860,31,35-39,1891,8.295343191097611
SIM,1929,29,25-29,1958,1081
STAT,1843,16,25-29,1859,7.197506061109334
STAT,1931,20,15-19,1951,6.8964352793844474
STAT,1922,48,40-44,1970,0.1786062146193427
STAT,1900,34,45-49,1934,2.395009277832163
STAT,1838,94,na,1932,8.52350741107751
STAT,1895,35,15-19,1930,0.07374368793123598
SIM,1932,30,25-29,1962,4
STAT,1913,30,15-19,1943,0.12726332482536384
STAT,1907,32,40-44,1939,3.6333594909846925
STAT,1855,64,na,1919,1150.5089989774112
STAT,1927,25,50-100,1952,1.2083452138449984
SIM,1873,49,na,1922,2116
STAT,1815,48,45-49,1863,0.023606259554145675
SIM,1915,32,40-44,1947,68
STAT,1891,26,na,1917,2944.847616380212
STAT,1817,47,na,1864,918.9835907292546
STAT,1870,31,na,1901,2388.714619031155
STAT,1823,54,na,1877,1830.8107783674027
STAT,1902,41,50-100,1943,0.10377316185462847
STAT,1924,30,25-29,1954,10.72783042780107
STAT,1823,47,40-44,1870,0.2671121890709124
STAT,1847,17,50-100,1864,0.0552837592436061
STAT,1818,53,45-49,1871,0.02434269360299356
STAT,1925,2,na,1927,4895.317674099465
STAT,1851,71,na,1922,1054.215612312556
STAT,1912,26,na,1938,3661.316168135782
SIM,1854,67,na,1921,347
STAT,1836,82,na,1918,357.09278880099725
STAT,1916,8,na,1924,4160.201411570914
STAT,1912,31,45-49,1943,1.5366546664728813
STAT,1865,17,15-19,1882,5.583347963895981
STAT,1910,18,50-100,1928,0.07321388641514345
STAT,1920,45,na,1965,4027.695095256834
STAT,1852,38,20-24,1890,0.772078585519175
SIM,1790,72,na,1862,1197
STAT,1917,40,35-39,1957,0.2079136182709285
STAT,1911,29,50-100,1940,0.9528860015149303
STAT,1851,33,35-39,1884,8.238782584491625
STAT,1914,48,50-100,1962,0.2205813060697887
STAT,1896,44,20-24,1940,0.014341591074704098
SIM,1860,38,20-24,1898,9
STAT,1947,19,25-29,1966,48.26892574551987
STAT,1904,44,30-34,1948,0.1125207968270819
STAT,1861,71,na,1932,1110.0775296982524
STAT,1859,54,45-49,1913,0.011186122935530935
STAT,1888,69,na,1957,1750.0717697256296
STAT,1923,47,45-49,1970,0.2515737457694872
STAT,1950,20,25-29,1970,108.61082679773119
SIM,1884,11,na,1895,3855
STAT,1890,30,45-49,1920,2.1280530112911165
STAT,1947,19,50-100,1966,0.41731051299845034
STAT,1804,72,na,1876,1068.0211739044485
STAT,1823,64,na,1887,1400.5011239638204
STAT,1893,43,40-44,1936,0.1939143664906765
SIM,1841,49,na,1890,208
STAT,1841,31,25-29,1872,13.983092491612265
SIM,1841,27,na,1868,1161
STAT,1823,32,na,1855,2316.083468466459
STAT,1886,49,30-34,1935,0.09814828895555966
STAT,1897,43,25-29,1940,0.058793621795760934
STAT,1841,38,45-49,1879,2.5884339961031713
STAT,1899,28,25-29,1927,57.574748192827876
STAT,1883,40,50-100,1923,1.0266077119101973
STAT,1833,64,na,1897,715.2253169880607
STAT,1864,48,40-44,1912,0.15368336387507764
STAT,1906,29,50-100,1935,0.9196996602836832
STAT,1874,43,30-34,1917,1.177962825266046
STAT,1905,30,15-19,1935,0.20647431755946127
STAT,1866,15,15-19,1881,5.626367416017657
SIM,1902,40,40-44,1942,4
STAT,1902,26,na,1928,3372.140309664136
STAT,1876,3,na,1879,3107.9253411726577
STAT,1814,46,50-100,1860,0.8509484824719437
STAT,1925,18,35-39,1943,5.009390185811318
STAT,1894,76,na,1970,1637.9431669609844
STAT,1847,44,25-29,1891,0.5727482543125308
STAT,1922,41,20-24,1963,0.020073326426455766
SIM,1933,18,35-39,1951,39
SIM,1841,17,na,1858,1206
STAT,1906,19,na,1925,3637.644847465029
STAT,1892,28,50-100,1920,0.7892113627790486
STAT,1959,13,na,1972,5091.511572275592
STAT,1813,50,40-44,1863,0.03810427275071209
STAT,1862,44,50-100,1906,0.8876774861108703
STAT,1856,46,40-44,1902,0.12331412896871802
STAT,1915,45,45-49,1960,0.2169264028801153
STAT,1870,33,45-49,1903,1.7311377591328423
STAT,1873,34,25-29,1907,10.416701030131083
STAT,1845,48,30-34,1893,0.04743026030045589
STAT,1868,45,50-100,1913,0.2395828428070308
STAT,1888,39,50-100,1927,1.4027544962034053
STAT,1873,31,20-24,1904,2.784073761713226
STAT,1876,32,50-100,1908,0.9262399889848872
STAT,1858,42,35-39,1900,1.3811513166127987
STAT,1899,45,50-100,1944,0.19111218721255552
STAT,1866,59,na,1925,1774.0304464882465
STAT,1941,18,na,1959,3746.947051526427
STAT,1969,0,na,1969,4897.1879958238205
STAT,1911,41,45-49,1952,0.15796337702938232
STAT,1920,30,40-44,1950,4.265331321591472
STAT,1836,50,35-39,1886,0.006944567639605459
SIM,1906,60,na,1966,3009
SIM,1857,8,na,1865,1543
STAT,1826,52,40-44,1878,0.014544573734637602
STAT,1874,78,na,1952,806.3873192933688
STAT,1870,63,na,1933,1778.832021863578
STAT,1820,99,na,1919,1.3024352593746542
STAT,1846,53,20-24,1899,4.300236143624332E-4
SIM,1869,12,na,1881,3826
STAT,1912,46,30-34,1958,0.08488843251581978
SIM,1881,31,20-24,1912,5
STAT,1822,33,50-100,1855,2.1249839944309024
STAT,1869,45,15-19,1914,4.0765645553224745E-4
STAT,1852,54,35-39,1906,0.008427471952586297
STAT,1906,18,25-29,1924,8.184328055196124
STAT,1843,40,25-29,1883,0.6702240554152078
STAT,1807,47,na,1854,1437.624441785996
STAT,1842,27,50-100,1869,0.1963800663475288
STAT,1829,53,20-24,1882,2.9424803468439006E-4
STAT,1855,96,na,1951,5.6829631251348385
STAT,1902,42,40-44,1944,0.21967588271361105
STAT,1802,91,na,1893,29.360256034084696
STAT,1852,45,45-49,1897,0.23992306996150542
STAT,1848,53,30-34,1901,0.0054808080978986685
SIM,1874,41,30-34,1915,1
STAT,1859,34,50-100,1893,0.7199919459577321
STAT,1898,40,15-19,1938,0.0013025725396769296
SIM,1917,23,na,1940,2262
SIM,1855,48,40-44,1903,2
STAT,1867,49,20-24,1916,0.011111807711180198
STAT,1795,72,na,1867,667.5832836248239
STAT,1886,47,na,1933,2318.9610852201313
STAT,1906,40,25-29,1946,0.06522498465359455
STAT,1840,106,na,1946,0.004780846167325003
STAT,1845,46,50-100,1891,0.12221691191334759
SIM,1837,29,20-24,1866,23
STAT,1920,31,45-49,1951,1.7083944818414551
STAT,1905,56,na,1961,3051.9794491329594
STAT,1925,40,35-39,1965,0.242232800317251
SIM,1910,42,40-44,1952,3
SIM,1840,33,25-29,1873,5
STAT,1842,50,50-100,1892,0.0038030512491059646
STAT,1842,46,na,1888,565.8065705731372
STAT,1916,19,50-100,1935,0.07798401743015902
SIM,1824,47,na,1871,2138
STAT,1882,36,40-44,1918,4.21123793317497
STAT,1837,45,na,1882,1921.2454345998165
STAT,1932,32,25-29,1964,12.201275885213493
SIM,1899,26,25-29,1925,1
SIM,1837,65,na,1902,1470
STAT,1832,33,25-29,1865,0.682345544856492
STAT,1839,79,na,1918,649.5149871947649
STAT,1867,21,50-100,1888,0.3900489558589601
STAT,1791,91,na,1882,24.20917583007652
STAT,1880,24,15-19,1904,3.403456036031859
STAT,1866,41,30-34,1907,1.0541871402733465
STAT,1880,21,50-100,1901,0.4246275575699047
STAT,1902,43,45-49,1945,0.14529258346514037
SIM,1884,45,50-100,1929,5
SIM,1899,4,na,1903,2347
STAT,1815,45,40-44,1860,0.017820572851010526
STAT,1768,117,na,1885,2.0012940892119284E-4
STAT,1853,33,50-100,1886,0.7240551364063534
STAT,1850,54,25-29,1904,0.001590588769301278
SIM,1890,36,40-44,1926,17
SIM,1938,31,30-34,1969,14
STAT,1920,23,na,1943,3995.191650421979
STAT,1855,43,20-24,1898,0.10434897811329362
STAT,1930,34,30-34,1964,20.163800336494383
STAT,1833,45,35-39,1878,0.07213535625865979
STAT,1856,42,25-29,1898,0.4606637205537092
STAT,1901,63,na,1964,2700.943599516355
STAT,1914,46,40-44,1960,0.15457224338380182
STAT,1867,53,40-44,1920,0.009796455312198013
STAT,1901,31,35-39,1932,14.217683472436448
STAT,1834,27,na,1861,1250.1055170760173
STAT,1884,17,25-29,1901,5.424602725815702
STAT,1816,84,na,1900,280.8430686062665
STAT,1845,44,15-19,1889,0.0068016690473966385
STAT,1843,48,20-24,1891,0.011707559483538599
STAT,1814,50,na,1864,2003.8707290018874
STAT,1910,40,25-29,1950,0.06748895839551781
SIM,1865,15,15-19,1880,39
SIM,1863,19,20-24,1882,90
STAT,1892,31,30-34,1923,21.705108189326594
STAT,1959,4,na,1963,5098.186329163389
STAT,1881,40,45-49,1921,1.427610007663815
STAT,1884,41,25-29,1925,0.6175006618610148
STAT,1829,50,50-100,1879,0.007023216203538814
STAT,1894,44,na,1938,2909.4486813615003
SIM,1851,31,35-39,1882,18
STAT,1862,34,na,1896,2015.1174028839782
STAT,1876,45,50-100,1921,0.2507542475175652
STAT,1906,42,25-29,1948,0.06449391512887111
SIM,1810,88,na,1898,258
SIM,1951,0,na,1951,2477
SIM,1832,35,na,1867,2223
STAT,1878,30,45-49,1908,1.8085867529575552
SIM,1916,30,40-44,1946,2
STAT,1786,90,na,1876,57.62287810326419
STAT,1876,19,40-44,1895,0.1839065997682598
SIM,1845,31,na,1876,2498
STAT,1881,48,na,1929,2097.9360319160123
STAT,1911,37,25-29,1948,0.9402895380574693
STAT,1877,42,45-49,1919,1.5173994283428955
SIM,1894,11,na,1905,1764
STAT,1867,11,na,1878,2547.8623338462135
STAT,1855,19,20-24,1874,13.791781509883622
SIM,1826,28,na,1854,1936
STAT,1817,41,35-39,1858,1.3515918120514703
STAT,1817,50,25-29,1867,0.002492739437283383
STAT,1857,15,15-19,1872,5.416068698341287
STAT,1815,54,30-34,1869,5.598518956413572E-4
STAT,1870,85,na,1955,273.2936961134853
STAT,1899,21,na,1920,3240.0952236050753
STAT,1875,1,na,1876,3556.5209931632457
STAT,1825,40,30-34,1865,1.5789365490178502
SIM,1912,56,na,1968,4354
STAT,1795,106,na,1901,0.002959775515680346
STAT,1950,22,40-44,1972,3.9508367113582654
SIM,1815,65,na,1880,482
STAT,1882,45,30-34,1927,0.09360126625484734
STAT,1830,33,50-100,1863,0.8517435817885288
STAT,1903,41,45-49,1944,0.1481970019309474
SIM,1923,19,na,1942,4291
STAT,1865,39,50-100,1904,1.109636634294833
STAT,1822,44,20-24,1866,0.27079601227016614
STAT,1838,54,25-29,1892,0.0014704373078354247
STAT,1860,53,30-34,1913,0.0047780742781560765
STAT,1877,51,35-39,1928,0.008781045058962022
STAT,1864,78,na,1942,710.3143684275187
STAT,1832,30,20-24,1862,0.4374684187009965
STAT,1842,52,25-29,1894,8.746042251050884E-4
STAT,1858,51,25-29,1909,0.002717850749631118
STAT,1812,45,15-19,1857,1.0767415197446532E-4
STAT,1892,40,20-24,1932,0.19860945662004298
STAT,1864,15,50-100,1879,0.0512329779186503
STAT,1921,32,15-19,1953,0.14131034873527495
STAT,1898,16,15-19,1914,7.999889823433401
STAT,1928,41,15-19,1969,0.0019456324095443766
STAT,1852,42,40-44,1894,2.26130643707966
STAT,1874,46,35-39,1920,0.14489954381388206
SIM,1840,30,20-24,1870,15
STAT,1884,32,35-39,1916,9.69436075767864
SIM,1851,27,na,1878,1265
STAT,1831,49,40-44,1880,0.15733891578501666
STAT,1846,82,na,1928,276.3385131077375
STAT,1911,41,na,1952,3524.99691272322
STAT,1879,77,na,1956,926.8764495011491
SIM,1947,21,na,1968,4360
SIM,1900,24,na,1924,4149
STAT,1881,26,na,1907,2261.4420203054387
STAT,1812,49,30-34,1861,0.024143345430486948
SIM,1914,1,na,1915,5181
STAT,1908,18,35-39,1926,0.8055413159367273
SIM,1892,32,35-39,1924,14
SIM,1955,6,na,1961,3825
STAT,1869,77,na,1946,872.2424549652704
SIM,1904,27,na,1931,4164
STAT,1863,45,20-24,1908,0.010346681682655585
STAT,1849,15,15-19,1864,6.2282531095944735
STAT,1851,30,30-34,1881,14.653635837895862
STAT,1932,5,na,1937,5287.065093377381
STAT,1841,44,30-34,1885,1.2966651851202882
SIM,1865,2,na,1867,2114
SIM,1810,66,na,1876,3098
STAT,1892,0,na,1892,3635.460105377157
STAT,1841,35,40-44,1876,5.863797556931791
STAT,1899,43,na,1942,3144.86601042782
STAT,1822,46,50-100,1868,0.41643044940369645
STAT,1836,41,45-49,1877,1.3819043395663542
STAT,1850,21,25-29,1871,31.956717515799404
SIM,1942,22,na,1964,3642
STAT,1940,31,20-24,1971,2.4975592745710835
SIM,1828,61,na,1889,1168
STAT,1915,20,30-34,1935,28.274238660471802
SIM,1828,83,na,1911,163
STAT,1871,54,45-49,1925,0.014078664643248164
STAT,1856,49,na,1905,1582.2162027266836
STAT,1893,46,45-49,1939,0.1669474854687788
SIM,1903,20,na,1923,2983
STAT,1886,45,15-19,1931,4.183492839496444E-4
STAT,1949,13,na,1962,4522.740745604052
SIM,1883,59,na,1942,1967
STAT,1796,90,na,1886,55.72827925827178
STAT,1934,20,40-44,1954,4.502694516700175
SIM,1830,54,na,1884,157
STAT,1813,54,na,1867,2009.9200284675644
STAT,1830,50,40-44,1880,0.00904998459633638
STAT,1879,51,50-100,1930,0.015567130313670496
STAT,1930,37,35-39,1967,3.1327815304479802
STAT,1879,55,na,1934,2121.14296100068
SIM,1873,27,na,1900,1847
SIM,1871,3,na,1874,2244
SIM,1860,20,na,1880,2258
STAT,1914,42,25-29,1956,0.06977440715853286
STAT,1876,15,25-29,1891,5.7551569418121
STAT,1862,40,35-39,1902,1.5579071956790675
SIM,1870,40,35-39,1910,3
STAT,1882,4,na,1886,2701.431785530595
STAT,1932,30,25-29,1962,12.215075023380987
SIM,1910,40,40-44,1950,2
STAT,1858,27,25-29,1885,33.06954668551287
STAT,1849,17,30-34,1866,1.6531034552165849
STAT,1847,41,20-24,1888,0.14624810169693322
STAT,1897,18,50-100,1915,0.0648932924888834
STAT,1808,65,na,1873,518.6908996267117
STAT,1844,43,45-49,1887,1.4992061249918798
STAT,1925,42,35-39,1967,0.2415622793846314
STAT,1856,49,45-49,1905,0.1659686445759281
STAT,1868,92,na,1960,73.18591559900196
SIM,1927,33,na,1960,1663
STAT,1903,12,na,1915,3665.900663758587
STAT,1944,23,50-100,1967,0.7022177381541529
STAT,1899,43,35-39,1942,0.1705124938867753
STAT,1845,64,na,1909,862.6030164132683
SIM,1890,39,45-49,1929,3
SIM,1886,77,na,1963,1187
STAT,1936,36,50-100,1972,0.408461479301256
STAT,1897,47,40-44,1944,0.12765346545310588
STAT,1862,31,45-49,1893,1.4913547140471624
SIM,1864,49,45-49,1913,2
SIM,1892,30,na,1922,3669
STAT,1885,50,30-34,1935,0.005935136826769029
STAT,1860,40,50-100,1900,0.8705415054799024
STAT,1877,11,na,1888,2641.4238312536922
STAT,1820,47,15-19,1867,6.285387965906902E-4
STAT,1824,31,25-29,1855,4.74305212161883
STAT,1940,32,25-29,1972,9.45842343076478
STAT,1882,39,45-49,1921,1.8893755690461933
STAT,1880,48,25-29,1928,0.05904633580701971
STAT,1891,22,25-29,1913,70.39657436214934
STAT,1825,29,50-100,1854,1.502760693201467
SIM,1922,48,50-100,1970,5
STAT,1860,47,45-49,1907,0.1916293813074885
STAT,1833,42,30-34,1875,0.5984692303298137
STAT,1910,31,35-39,1941,8.74836213065308
SIM,1932,32,40-44,1964,12
STAT,1908,30,40-44,1938,3.6947595404245606
STAT,1904,47,35-39,1951,0.11230048553273943
STAT,1820,49,30-34,1869,0.148110613851148
STAT,1781,91,na,1872,19.53397169950918
STAT,1926,45,20-24,1971,0.013582494505977595
STAT,1847,40,50-100,1887,0.9854120842272339
STAT,1894,47,15-19,1941,2.855906111942882E-4
STAT,1897,41,50-100,1938,0.09786963616234172
STAT,1949,16,30-34,1965,14.040107008939069
SIM,1928,18,na,1946,4614
STAT,1928,19,15-19,1947,56.44510557498659
SIM,1897,18,na,1915,2983
STAT,1918,46,50-100,1964,0.23803444355530212
STAT,1814,42,20-24,1856,0.555817428487406
STAT,1841,83,na,1924,442.07083292343543
STAT,1822,51,45-49,1873,0.023854650055835355
STAT,1862,12,na,1874,2328.7490138089865
STAT,1914,41,20-24,1955,0.017280920925601184
STAT,1922,35,50-100,1957,0.47322990592087105
STAT,1828,53,na,1881,1531.2059331937037
STAT,1881,33,20-24,1914,2.5418553967579665
STAT,1890,43,15-19,1933,0.01659751095922719
STAT,1811,44,45-49,1855,7.352408240379693
STAT,1866,44,35-39,1910,1.63063305735186
STAT,1847,45,na,1892,2054.3984883086887
STAT,1924,32,40-44,1956,4.521731729137081
STAT,1883,81,na,1964,778.009694628514
STAT,1825,52,50-100,1877,0.018524722242574444
STAT,1868,17,40-44,1885,0.17985932456070444
STAT,1875,30,na,1905,2470.0853842979973
STAT,1920,48,30-34,1968,0.09700505951130631
STAT,1817,79,na,1896,221.46915249709585
STAT,1861,48,15-19,1909,3.284770572637934E-4
STAT,1902,40,40-44,1942,0.22216601442367598
SIM,1862,64,na,1926,2633
SIM,1868,26,na,1894,1238
STAT,1782,76,na,1858,1110.8694689401796
STAT,1834,54,40-44,1888,0.004572565089847261
STAT,1866,50,20-24,1916,6.832663485532957E-4
STAT,1871,38,30-34,1909,5.29011658955081
STAT,1888,42,20-24,1930,0.1830705691134762
STAT,1832,46,na,1878,2070.2756302925673
STAT,1843,31,35-39,1874,12.15468434725548
STAT,1831,30,50-100,1861,1.004045081787497
STAT,1914,31,20-24,1945,2.43101388438284
STAT,1846,19,50-100,1865,0.03602180588933843
STAT,1911,30,40-44,1941,3.79801810873703
STAT,1830,52,20-24,1882,5.548364887072908E-4
STAT,1811,51,50-100,1862,0.06931681977624848
SIM,1924,47,40-44,1971,2
STAT,1848,20,45-49,1868,0.8060626242912261
STAT,1894,49,50-100,1943,0.17249573422902276
STAT,1932,22,25-29,1954,120.3536170274313
STAT,1925,45,40-44,1970,0.19019223407414826
STAT,1915,18,40-44,1933,0.2878521012224837
STAT,1918,19,20-24,1937,144.79492166676653
SIM,1806,50,na,1856,252
SIM,1874,23,15-19,1897,8
STAT,1857,25,50-100,1882,0.5129486644494531
STAT,1874,14,na,1888,2673.679201149791
STAT,1833,105,na,1938,0.012063614770282909
SIM,1914,25,35-39,1939,7
STAT,1929,38,35-39,1967,3.0803920405493543
SIM,1865,61,na,1926,1665
STAT,1920,41,45-49,1961,0.18170916498348602
STAT,1840,65,na,1905,665.4305041276143
STAT,1921,29,20-24,1950,19.95919620833288
STAT,1844,79,na,1923,692.5958084360284
STAT,1911,43,45-49,1954,0.15611589739772988
STAT,1868,31,50-100,1899,0.8885914454930736
STAT,1888,22,40-44,1910,2.4050565231366776
SIM,1795,61,na,1856,12
STAT,1866,23,15-19,1889,3.0142008806118272
STAT,1915,23,35-39,1938,9.565985829946733
STAT,1923,20,na,1943,4229.406179305248
STAT,1839,22,45-49,1861,0.8324204797071428
STAT,1946,17,na,1963,4038.372243722166
STAT,1931,41,20-24,1972,0.023460874264223493
STAT,1885,24,50-100,1909,0.39832800988336037
STAT,1912,39,50-100,1951,0.40094824203552043
SIM,1842,13,na,1855,3413
STAT,1896,30,50-100,1926,1.217529757512937
SIM,1884,44,na,1928,3613
STAT,1912,36,15-19,1948,0.01861419963052792
SIM,1922,23,na,1945,3591
STAT,1847,12,na,1859,2693.8231293263566
STAT,1941,20,25-29,1961,94.43649319799637
STAT,1875,21,15-19,1896,3.3978376527608902
SIM,1876,25,na,1901,3882
SIM,1899,23,20-24,1922,19
STAT,1921,34,15-19,1955,0.14010050594049472
SIM,1894,74,na,1968,542
STAT,1902,32,40-44,1934,6.1067925677584425
SIM,1940,22,25-29,1962,70
STAT,1934,38,45-49,1972,0.9334384492916566
STAT,1862,48,30-34,1910,0.08141256258189132
STAT,1927,17,20-24,1944,167.19872358149038
STAT,1923,42,25-29,1965,0.08258479713268842
STAT,1910,29,45-49,1939,1.6378126341428094
SIM,1859,77,na,1936,136
STAT,1921,41,na,1962,4139.44583207538
STAT,1917,36,na,1953,3874.0668216250674
STAT,1897,15,45-49,1912,0.08715474033947057
STAT,1867,15,30-34,1882,1.5592990627469407
STAT,1917,46,45-49,1963,0.22453815847595604
SIM,1901,61,na,1962,2787
STAT,1927,40,45-49,1967,0.2076019474149825
STAT,1931,19,35-39,1950,5.424491077944896
SIM,1901,1,na,1902,4180
SIM,1922,26,25-29,1948,37
STAT,1859,20,20-24,1879,63.17828915892228
STAT,1904,25,50-100,1929,0.9201262882528537
STAT,1930,27,20-24,1957,23.047697703320335
SIM,1916,39,na,1955,4530
STAT,1814,49,na,1863,2026.7211125915571
SIM,1852,43,na,1895,2025
STAT,1914,20,50-100,1934,0.6399088427934371
STAT,1907,19,45-49,1926,0.09480072408168515
SIM,1892,63,na,1955,3403
STAT,1924,16,40-44,1940,1.6536876878192226
SIM,1818,43,50-100,1861,2
SIM,1808,85,na,1893,563
STAT,1846,30,35-39,1876,7.236718873127115
STAT,1923,45,50-100,1968,0.26303946707587444
STAT,1903,31,45-49,1934,2.4854911068464465
STAT,1857,25,15-19,1882,0.3638094121599516
SIM,1884,64,na,1948,3459
STAT,1855,31,na,1886,1624.8868575718918
STAT,1897,62,na,1959,2520.156237582207
SIM,1833,52,na,1885,2017
STAT,1829,27,50-100,1856,0.4771451915030911
STAT,1942,23,na,1965,3783.893661363077
SIM,1797,72,na,1869,802
STAT,1950,22,na,1972,4290.934645807934
STAT,1944,14,na,1958,4178.173409828616
STAT,1880,46,25-29,1926,0.059967472695824954
STAT,1915,30,25-29,1945,9.354882921875216
STAT,1932,15,35-39,1947,5.543304438218717
STAT,1929,37,na,1966,4796.187685086602
STAT,1867,20,50-100,1887,0.3928697607410812
STAT,1900,37,35-39,1937,2.114815461126185
STAT,1943,18,15-19,1961,47.561075664847905
SIM,1829,47,na,1876,1900
SIM,1825,33,na,1858,597
STAT,1916,47,40-44,1963,0.15950564047839694
STAT,1852,98,na,1950,3.2699423421032705
STAT,1920,23,45-49,1943,1.2309772404503225
STAT,1909,26,15-19,1935,0.6757874658988213
STAT,1811,47,15-19,1858,0.0018800528407857148
STAT,1928,39,30-34,1967,2.2809705022721207
STAT,1863,22,35-39,1885,5.081103402818297
STAT,1905,29,35-39,1934,13.77906147356376
STAT,1859,16,35-39,1875,0.5078221171024142
SIM,1906,30,25-29,1936,59
STAT,1890,48,35-39,1938,0.09440240120714989
STAT,1895,30,30-34,1925,22.895435089631288
STAT,1877,42,na,1919,2343.2979705909565
SIM,1862,33,na,1895,3802
SIM,1857,31,15-19,1888,2
STAT,1826,50,na,1876,1961.065922051452
STAT,1889,75,na,1964,1527.7997041225321
STAT,1849,47,na,1896,1886.859725801238
STAT,1908,15,45-49,1923,0.09659639546442639
STAT,1899,22,15-19,1921,4.506029018683762
STAT,1878,30,30-34,1908,18.10816133471748
STAT,1908,43,na,1951,3389.0549394548434
STAT,1800,69,na,1869,1208.7039979270894
STAT,1852,48,15-19,1900,3.9757571170699293E-4
SIM,1910,22,na,1932,4340
STAT,1925,15,45-49,1940,0.6007004555210854
STAT,1847,41,50-100,1888,0.9728677883950212
SIM,1876,45,na,1921,3634
SIM,1837,30,35-39,1867,6
SIM,1849,67,na,1916,283
STAT,1889,23,na,1912,2839.2502172618915
STAT,1914,26,25-29,1940,65.65524365241885
SIM,1923,30,25-29,1953,62
SIM,1821,51,na,1872,1900
SIM,1886,30,30-34,1916,103
STAT,1899,18,30-34,1917,2.171310366278165
SIM,1898,24,15-19,1922,3
STAT,1918,42,45-49,1960,0.17456452994910002
STAT,1919,18,25-29,1937,47.12913010555778
STAT,1807,91,na,1898,23.495118872373286
STAT,1847,21,40-44,1868,2.3263116897424934
STAT,1874,1,na,1875,3587.9210391640063
STAT,1940,17,35-39,1957,4.212709394725973
STAT,1897,42,na,1939,3076.2548914996796
STAT,1825,88,na,1913,84.54097149067654
STAT,1832,78,na,1910,663.2533386111537
SIM,1929,36,35-39,1965,39
STAT,1832,41,50-100,1873,0.09181766523759474
SIM,1866,24,20-24,1890,1
STAT,1840,97,na,1937,2.1153450800311013
STAT,1822,68,na,1890,881.235587293127
STAT,1903,8,na,1911,3690.0850362862534
STAT,1885,61,na,1946,1836.774138098433
SIM,1853,72,na,1925,2003
SIM,1817,46,na,1863,2726
STAT,1883,15,15-19,1898,5.735820405184564
STAT,1933,32,40-44,1965,5.237920895627239
STAT,1858,24,20-24,1882,54.16044135759552
STAT,1904,37,20-24,1941,0.23770780129861235
STAT,1913,35,20-24,1948,0.2593214281193476
STAT,1926,41,40-44,1967,0.3061492056688847
STAT,1839,22,50-100,1861,0.48679562071622595
STAT,1903,38,15-19,1941,0.01711980391435905
STAT,1886,41,50-100,1927,1.0989589886085356
STAT,1920,38,15-19,1958,0.020734117221751287
STAT,1844,49,50-100,1893,0.23823299826332506
STAT,1795,105,na,1900,0.00714748977464464
STAT,1908,23,50-100,1931,0.598381182305364
STAT,1914,27,35-39,1941,14.924703604514965
STAT,1909,17,na,1926,3749.0109790955353
SIM,1878,31,35-39,1909,6
STAT,1923,22,30-34,1945,33.08984568218068
STAT,1870,36,15-19,1906,0.05625178921682576
STAT,1913,28,30-34,1941,38.41632740611407
STAT,1935,21,na,1956,4938.6848364003345
STAT,1864,21,40-44,1885,1.938787502005494
STAT,1813,87,na,1900,129.0570127783183
STAT,1923,24,25-29,1947,105.67932905433267
STAT,1913,32,15-19,1945,0.12624852126999872
SIM,1918,18,na,1936,4461
STAT,1808,96,na,1904,2.011027259149686
STAT,1835,24,50-100,1859,0.404269715851661
STAT,1871,53,20-24,1924,7.242877981537552E-4
SIM,1835,31,na,1866,1267
STAT,1860,45,45-49,1905,0.19444636294562637
STAT,1849,31,15-19,1880,0.1403966175889967
STAT,1858,17,30-34,1875,1.4218293546903038
SIM,1883,70,na,1953,1622
STAT,1792,76,na,1868,483.2454155548263
STAT,1854,53,20-24,1907,4.0370847829247487E-4
STAT,1922,25,20-24,1947,20.563582226507705
STAT,1858,83,na,1941,303.1647953206744
STAT,1911,28,50-100,1939,0.9563671780430066
STAT,1859,21,30-34,1880,16.212873761899264
SIM,1840,54,na,1894,2500
STAT,1908,48,45-49,1956,0.19449199888624036
STAT,1893,38,50-100,1931,1.5277112604877738
SIM,1930,22,na,1952,4857
STAT,1860,50,40-44,1910,0.008711792562008226
SIM,1816,40,na,1856,237
STAT,1923,17,35-39,1940,4.875439968390604
STAT,1940,24,25-29,1964,92.97722387825279
STAT,1892,43,na,1935,2840.8606235046514
STAT,1904,29,20-24,1933,16.64088507032759
SIM,1898,24,na,1922,4337
STAT,1939,2,na,1941,4040.055980656893
STAT,1813,52,20-24,1865,0.002564792386228493
STAT,1896,57,na,1953,2649.1531183172556
SIM,1936,15,na,1951,3982
STAT,1922,18,30-34,1940,13.912359268551182
STAT,1926,17,na,1943,4474.101315082047
STAT,1867,12,na,1879,2536.2950388505515
SIM,1872,63,na,1935,2049
STAT,1852,16,50-100,1868,0.05999756610003504
SIM,1847,32,na,1879,1589
STAT,1932,18,40-44,1950,1.834404190833037
STAT,1910,17,50-100,1927,0.07340621068714376
SIM,1854,22,35-39,1876,59
STAT,1927,39,50-100,1966,0.5166516278693624
STAT,1931,31,20-24,1962,3.175482782154477
STAT,1848,35,15-19,1883,0.055288110414522536
STAT,1947,18,50-100,1965,0.41745662281643614
SIM,1870,20,na,1890,2486
STAT,1837,46,na,1883,1896.7879802173616
STAT,1833,32,na,1865,1146.1483869927215
STAT,1868,21,25-29,1889,55.69173466646033
STAT,1858,21,15-19,1879,2.911499797111369
STAT,1915,22,25-29,1937,94.13245613133888
STAT,1915,48,35-39,1963,0.12772625748636787
STAT,1845,96,na,1941,4.26084553729156
STAT,1841,82,na,1923,519.5698755623096
STAT,1896,4,na,1900,3467.847899561799
SIM,1883,27,na,1910,2227
SIM,1915,42,40-44,1957,3
STAT,1881,47,na,1928,2114.7269640102554
SIM,1906,49,na,1955,3175
STAT,1941,30,25-29,1971,9.604567990890004
STAT,1834,20,15-19,1854,1.9727241858431432
STAT,1846,22,35-39,1868,4.264382616786961
STAT,1799,102,na,1901,0.01949576102407891
STAT,1902,35,45-49,1937,0.611652761678365
SIM,1879,10,na,1889,1960
SIM,1875,51,na,1926,2641
SIM,1913,42,na,1955,2912
STAT,1830,99,na,1929,1.370728543447023
STAT,1933,10,na,1943,5284.0182434202525
STAT,1779,98,na,1877,0.9102993963232617
STAT,1923,25,35-39,1948,17.171583591223584
STAT,1919,49,30-34,1968,0.0948474639566366
STAT,1854,32,35-39,1886,5.766307556628274
STAT,1938,33,30-34,1971,15.662504870116745
STAT,1901,33,35-39,1934,14.100063070850666
STAT,1805,68,na,1873,294.4922594671323
STAT,1878,15,35-39,1893,0.5671729361280076
STAT,1883,38,na,1921,2255.309707411967
STAT,1880,43,20-24,1923,0.16368145427576117
STAT,1854,44,50-100,1898,0.5794770492120681
STAT,1876,20,20-24,1896,70.07984985654555
STAT,1911,40,40-44,1951,0.23871587857993268
STAT,1819,42,50-100,1861,0.24759405212083171
STAT,1917,43,40-44,1960,0.2571350653931059
STAT,1881,16,na,1897,2390.908230724243
STAT,1826,39,50-100,1865,1.9083300602917643
STAT,1838,63,na,1901,760.9562358939819
STAT,1863,3,na,1866,2752.3365395943474
STAT,1884,15,30-34,1899,1.5328561613195195
SIM,1919,39,30-34,1958,4
STAT,1874,25,15-19,1899,0.4714279674375177
STAT,1932,4,na,1936,5307.339128849587
STAT,1923,21,20-24,1944,128.40511284290113
SIM,1912,57,na,1969,4354
SIM,1865,1,na,1866,2114
STAT,1887,31,35-39,1918,11.192142056819035
STAT,1914,19,35-39,1933,0.8513427722341536
STAT,1898,68,na,1966,2325.0130886454576
STAT,1924,19,45-49,1943,0.585996104811448
STAT,1801,53,40-44,1854,0.026698515258330172
SIM,1866,79,na,1945,1197
SIM,1899,10,na,1909,2215
STAT,1848,17,15-19,1865,6.884263679451874
STAT,1905,41,20-24,1946,0.015934007173461995
STAT,1930,19,20-24,1949,173.11374063147463
SIM,1857,9,na,1866,1543
SIM,1934,2,na,1936,5471
STAT,1848,52,50-100,1900,0.014057532692698795
STAT,1961,0,na,1961,5070.296307825307
STAT,1885,47,15-19,1932,3.913463901597293E-4
STAT,1862,13,na,1875,2318.176493286294
STAT,1902,17,15-19,1919,8.356799566940577
STAT,1910,34,40-44,1944,3.6991223291648496
STAT,1875,95,na,1970,66.86665895628384
STAT,1902,27,45-49,1929,1.563484921231502
STAT,1907,24,40-44,1931,3.0214450126972365
STAT,1781,92,na,1873,11.958306795005528
STAT,1931,16,30-34,1947,15.88071947142261
STAT,1860,65,na,1925,1378.6581851703513
SIM,1918,40,45-49,1958,1
STAT,1916,19,na,1935,4020.1951361983843
STAT,1846,30,50-100,1876,0.6547416082054995
STAT,1911,1,na,1912,4118.344165962221
STAT,1921,26,15-19,1947,0.7801273042970224
STAT,1907,42,40-44,1949,0.22762206970243926
STAT,1838,31,40-44,1869,2.324392360569354
STAT,1953,15,20-24,1968,162.62025602427204
STAT,1867,18,35-39,1885,0.5273782287029238
STAT,1846,50,na,1896,1293.5626476854466
STAT,1899,25,20-24,1924,16.13231501997246
STAT,1836,34,50-100,1870,0.8692214696157392
SIM,1896,45,na,1941,3236
SIM,1857,42,na,1899,1413
STAT,1835,98,na,1933,2.4580253140706967
SIM,1838,21,40-44,1859,5
SIM,1817,66,na,1883,2170
STAT,1888,25,45-49,1913,1.2901654858473766
SIM,1813,52,na,1865,100
STAT,1905,34,30-34,1939,14.296240340944596
STAT,1864,79,na,1943,635.5608842942067
SIM,1824,79,na,1903,857
STAT,1828,42,35-39,1870,2.2643775856325368
STAT,1893,49,15-19,1942,2.76269199673996E-4
SIM,1854,30,35-39,1884,44
STAT,1951,20,40-44,1971,3.982498608647336
STAT,1915,15,35-39,1930,0.8698474623155776
STAT,1818,86,na,1904,135.0463311771926
STAT,1931,23,20-24,1954,142.76099204698664
SIM,1838,19,20-24,1857,25
STAT,1881,27,na,1908,2253.707888595996
STAT,1836,35,50-100,1871,1.1790017004078739
SIM,1893,25,na,1918,3172
STAT,1901,40,25-29,1941,0.062979328894922
SIM,1931,16,na,1947,5158
SIM,1909,27,20-24,1936,38
STAT,1821,47,30-34,1868,0.10352820056142395
STAT,1938,18,na,1956,3590.8260218171677
STAT,1916,17,45-49,1933,0.10453931281092453
STAT,1809,82,na,1891,454.1601687630386
STAT,1909,18,15-19,1927,8.786169846910205
SIM,1818,51,na,1869,699
STAT,1857,97,na,1954,4.1224514839529665
STAT,1931,24,30-34,1955,36.78306570118804
STAT,1853,83,na,1936,307.81922920071565
STAT,1889,36,15-19,1925,0.06794819988646306
STAT,1935,16,15-19,1951,61.746605083886585
STAT,1937,29,30-34,1966,37.762611664542135
STAT,1957,15,40-44,1972,1.828944691090263
SIM,1871,2,na,1873,2833
SIM,1860,43,45-49,1903,1
STAT,1928,43,15-19,1971,0.0019397610263704097
STAT,1860,53,45-49,1913,0.01164902405561811
STAT,1863,50,na,1913,1864.6012348090576
STAT,1855,11,na,1866,1887.7762282727042
STAT,1779,104,na,1883,0.05261361557320202
STAT,1889,21,45-49,1910,0.8422673061619643
STAT,1905,26,30-34,1931,36.34393983092788
STAT,1844,46,15-19,1890,3.9740032322467474E-4
STAT,1858,25,30-34,1883,19.971962523298032
STAT,1844,102,na,1946,0.29044520582519046
STAT,1909,44,45-49,1953,0.15219099206973977
STAT,1869,23,na,1892,2379.153330783003
STAT,1860,103,na,1963,0.45200677866890704
SIM,1841,16,na,1857,1206
SIM,1878,0,na,1878,4422
STAT,1857,66,na,1923,1257.7131573008903
STAT,1920,15,45-49,1935,0.11151351708260562
SIM,1900,31,40-44,1931,6
STAT,1906,28,40-44,1934,4.322521350435129
SIM,1862,32,35-39,1894,4
STAT,1911,31,na,1942,3656.222828919697
STAT,1940,16,25-29,1956,43.51844064450755
SIM,1889,43,na,1932,3846
SIM,1870,52,na,1922,1021
STAT,1887,23,35-39,1910,6.403109520194389
STAT,1881,47,30-34,1928,0.09098669231863028
STAT,1915,40,25-29,1955,0.07107416967367305
SIM,1892,5,na,1897,3699
SIM,1905,55,na,1960,2737
STAT,1913,36,30-34,1949,1.7846051574139132
STAT,1915,31,50-100,1946,0.8335546149167273
STAT,1917,28,15-19,1945,0.7278907131310572
STAT,1875,31,na,1906,2460.4026495915464
STAT,1843,30,na,1873,2628.325616190025
STAT,1879,32,40-44,1911,4.448776575092049
STAT,1903,46,15-19,1949,3.2119810595945564E-4
STAT,1781,110,na,1891,0.0013656623351341619
STAT,1925,30,40-44,1955,4.609749713547027
STAT,1933,22,40-44,1955,4.429729102339657
STAT,1919,15,20-24,1934,29.797263182284123
STAT,1936,23,50-100,1959,0.6226266651913487
STAT,1791,109,na,1900,1.7939649850810878E-4
STAT,1847,24,45-49,1871,0.7618240524810724
SIM,1828,32,35-39,1860,17
SIM,1848,25,15-19,1873,12
STAT,1910,26,40-44,1936,4.465850767460329
STAT,1850,51,50-100,1901,0.0070072379929796
STAT,1919,48,20-24,1967,0.011794395193571422
SIM,1921,36,30-34,1957,4
SIM,1923,40,na,1963,4224
STAT,1839,57,na,1896,1867.0800292278798
STAT,1833,52,50-100,1885,0.006671018707295481
STAT,1897,20,40-44,1917,2.783918291605136
STAT,1923,32,25-29,1955,10.484297905403
STAT,1949,16,45-49,1965,0.5754141046902238
STAT,1935,34,45-49,1969,2.1585776033285926
SIM,1898,2,na,1900,4491
STAT,1914,18,25-29,1932,8.816386337875322
STAT,1927,25,20-24,1952,22.160093310059914
STAT,1903,44,na,1947,3247.723276354052
STAT,1887,32,na,1919,2626.5485944285892
STAT,1821,54,20-24,1875,7.3198157250013E-4
STAT,1817,69,na,1886,519.01709829486
STAT,1912,39,20-24,1951,0.2517388132316156
STAT,1922,28,25-29,1950,73.38953319272042
STAT,1889,18,15-19,1907,7.12781057704122
STAT,1905,33,20-24,1938,2.222991379881192
STAT,1898,47,50-100,1945,0.1854270031955917
STAT,1872,20,35-39,1892,5.878279084288665
STAT,1929,37,25-29,1966,1.2552129852271359
SIM,1858,22,20-24,1880,220
STAT,1895,33,35-39,1928,13.11842709008062
STAT,1939,27,40-44,1966,4.634256492295373
STAT,1889,22,50-100,1911,0.4910714114424637
SIM,1913,33,20-24,1946,14
SIM,1935,10,na,1945,5881
STAT,1878,41,35-39,1919,1.8715206268485658
STAT,1908,38,15-19,1946,0.017751903407590416
STAT,1858,32,20-24,1890,2.064229460958959
STAT,1864,29,50-100,1893,0.5773918509815874
STAT,1911,48,15-19,1959,3.4384977485315074E-4
STAT,1851,20,15-19,1871,3.156695962092831
STAT,1838,34,45-49,1872,0.9059867043630134
STAT,1882,64,na,1946,1664.322179300892
STAT,1893,28,na,1921,2973.9085644801476
SIM,1883,79,na,1962,912
SIM,1902,18,20-24,1920,203
STAT,1842,36,na,1878,630.2243297046494
STAT,1922,22,15-19,1944,6.036377593205633
STAT,1915,45,30-34,1960,0.08897659245149558
STAT,1901,44,40-44,1945,0.21544538343136047
STAT,1823,49,35-39,1872,0.21227184369576044
STAT,1905,18,30-34,1923,2.2864888179858833
SIM,1831,49,35-39,1880,2
STAT,1924,42,40-44,1966,0.29465674335081343
STAT,1933,19,na,1952,4867.539829044998
STAT,1953,7,na,1960,4712.211473356635
STAT,1931,15,20-24,1946,177.02637877038978
STAT,1819,48,na,1867,619.6210741374147
STAT,1876,21,30-34,1897,18.060943528150244
SIM,1904,39,35-39,1943,2
STAT,1872,49,30-34,1921,0.09490775068968066
STAT,1785,74,na,1859,195.84279665678363
STAT,1927,43,20-24,1970,0.021933583947533104
STAT,1789,88,na,1877,79.96982755622916
STAT,1922,36,25-29,1958,1.1088682267788386
STAT,1876,23,25-29,1899,57.69123015027964
SIM,1857,11,na,1868,1495
SIM,1850,52,na,1902,1227
SIM,1900,32,30-34,1932,1
SIM,1930,17,20-24,1947,1047
STAT,1905,37,35-39,1942,2.195780348496685
SIM,1889,20,na,1909,3885
SIM,1906,40,na,1946,3448
STAT,1835,48,15-19,1883,3.1495227758855E-4
STAT,1872,43,na,1915,2297.6635275238114
STAT,1876,57,na,1933,2031.552119012744
SIM,1829,78,na,1907,1137
STAT,1931,34,25-29,1965,12.01025669513579
SIM,1859,13,na,1872,2403
STAT,1837,102,na,1939,0.23507756065869012
STAT,1922,17,20-24,1939,155.15298841157338
STAT,1793,70,na,1863,593.3867850459393
STAT,1910,30,25-29,1940,8.882992333334835
STAT,1860,42,40-44,1902,1.8326825022129853
STAT,1925,17,50-100,1942,0.4484418155648669
SIM,1930,22,15-19,1952,1
STAT,1911,17,45-49,1928,0.0988367941398214
STAT,1933,36,35-39,1969,3.275124405744474
STAT,1814,49,40-44,1863,0.5696332581450896
SIM,1906,34,40-44,1940,7
STAT,1872,21,50-100,1893,0.4095776668462001
SIM,1812,46,na,1858,1861
SIM,1838,51,na,1889,1642
SIM,1852,66,na,1918,1806
STAT,1825,44,na,1869,1639.736911840927
STAT,1907,46,35-39,1953,0.11555445193414753
STAT,1923,16,25-29,1939,50.474188459163386
STAT,1910,25,na,1935,3600.069015967097
SIM,1915,20,25-29,1935,8
STAT,1877,15,40-44,1892,0.18653125965997724
STAT,1905,0,na,1905,4223.3930906508485
STAT,1934,28,15-19,1962,0.942797525398076
STAT,1833,63,na,1896,734.1291424049896
SIM,1899,27,35-39,1926,3
STAT,1829,58,na,1887,736.9104069959873
STAT,1843,53,45-49,1896,0.014108687654699099
STAT,1857,29,30-34,1886,19.618837940513295
STAT,1924,43,30-34,1967,0.15036940093817563
STAT,1849,34,20-24,1883,2.3506682457994796
STAT,1880,22,35-39,1902,6.058129614511763
SIM,1858,33,25-29,1891,2
STAT,1953,8,na,1961,4711.598885865099
STAT,1861,38,15-19,1899,0.046468911089791565
STAT,1941,18,50-100,1959,0.38139289028402434
STAT,1927,32,45-49,1959,1.9199171435561357
STAT,1932,30,50-100,1962,1.0926916447906347
STAT,1868,22,35-39,1890,5.636320140248298
STAT,1844,15,na,1859,2925.0879934659843
STAT,1850,32,na,1882,1152.7051114847393
STAT,1886,40,30-34,1926,1.2025520224597355
STAT,1914,39,na,1953,3666.814677633913
STAT,1867,25,25-29,1892,40.27713739779799
STAT,1910,46,na,1956,3397.72848569467
SIM,1898,28,30-34,1926,41
STAT,1840,46,30-34,1886,0.038931988328138524
STAT,1884,76,na,1960,1063.5604765931073
STAT,1939,24,35-39,1963,9.345959176902618
STAT,1806,85,na,1891,82.54692355166476
STAT,1905,44,25-29,1949,0.06327284815946717
SIM,1900,0,na,1900,4181
STAT,1880,62,na,1942,1897.4672197009452
STAT,1869,43,35-39,1912,1.814059665568739
SIM,1867,32,na,1899,2329
STAT,1837,40,35-39,1877,1.7577896449523394
SIM,1875,39,na,1914,2868
STAT,1815,104,na,1919,0.004702726154892338
STAT,1870,46,15-19,1916,3.9990510756789257E-4
STAT,1909,41,40-44,1950,0.23290402697375437
SIM,1913,37,35-39,1950,12
STAT,1802,71,na,1873,887.0332835359521
STAT,1909,36,45-49,1945,0.6417768955868776
STAT,1904,45,20-24,1949,0.00976725636514853
STAT,1779,105,na,1884,0.032971374471258516
STAT,1942,15,45-49,1957,0.5163499801091828
STAT,1826,82,na,1908,371.976351546328
STAT,1922,29,35-39,1951,16.679174015117837
STAT,1907,20,25-29,1927,84.02526136970627
SIM,1860,85,na,1945,423
STAT,1840,105,na,1945,0.011545148918920556
SIM,1930,29,35-39,1959,89
STAT,1910,23,35-39,1933,8.716482339648014
SIM,1832,67,na,1899,538
STAT,1943,28,45-49,1971,1.8180470749685436
SIM,1861,47,na,1908,2100
STAT,1823,33,na,1856,2312.352080511895
STAT,1868,0,na,1868,3636.231626584693
STAT,1873,48,35-39,1921,0.14180469361931897
STAT,1911,15,15-19,1926,9.02104381609523
STAT,1855,95,na,1950,8.79947219103299
STAT,1908,37,40-44,1945,1.3907394625838223
STAT,1925,41,25-29,1966,0.08578718293140258
SIM,1887,35,45-49,1922,12
STAT,1926,28,45-49,1954,2.0460210835360466
STAT,1840,39,40-44,1879,1.9967688665809442
STAT,1875,24,20-24,1899,70.31995928963866
STAT,1831,52,na,1883,1747.188933256977
STAT,1925,37,40-44,1962,1.7802767914340683
STAT,1848,43,15-19,1891,0.012829535081156546
STAT,1879,13,na,1892,2645.1344330127067
SIM,1820,34,na,1854,711
STAT,1838,16,15-19,1854,3.366090985131998
STAT,1932,26,40-44,1958,6.065255825148656
STAT,1921,38,30-34,1959,2.0088909029574458
SIM,1906,61,na,1967,3009
STAT,1878,27,na,1905,2455.4203326793977
SIM,1824,48,na,1872,2138
SIM,1935,32,45-49,1967,4
STAT,1866,27,30-34,1893,22.986509357864044
SIM,1848,19,30-34,1867,1
SIM,1926,9,na,1935,6337
STAT,1920,27,50-100,1947,1.0778338461081018
STAT,1891,17,50-100,1908,0.060246721702677856
SIM,1943,8,na,1951,4986
STAT,1916,44,35-39,1960,0.20286364118279282
STAT,1936,30,45-49,1966,1.5149759986841111
STAT,1858,28,35-39,1886,7.488983770649831
STAT,1811,52,na,1863,1690.609161551061
STAT,1937,34,50-100,1971,0.8084903508390988
STAT,1838,62,na,1900,779.4765999077914
STAT,1866,31,15-19,1897,0.13052362097140244
SIM,1883,58,na,1941,1967
STAT,1941,24,40-44,1965,3.4328943822027376
STAT,1924,24,40-44,1948,3.9048225740938545
STAT,1879,35,45-49,1914,2.064419685034491
STAT,1932,19,50-100,1951,0.49000691101439675
STAT,1943,25,50-100,1968,1.0488688229096976
STAT,1829,47,na,1876,896.8111445280334
SIM,1895,60,na,1955,4395
STAT,1912,57,na,1969,3336.44945977879
STAT,1935,26,45-49,1961,2.3390695359607006
STAT,1912,32,20-24,1944,2.3722386506725694
STAT,1904,38,30-34,1942,1.6353380041082164
SIM,1858,31,30-34,1889,16
STAT,1924,38,na,1962,4389.2541602287965
SIM,1873,28,na,1901,2161
STAT,1847,76,na,1923,856.5637084702598
SIM,1942,23,na,1965,3642
STAT,1919,30,45-49,1949,1.6886236698595358
SIM,1890,38,35-39,1928,6
SIM,1904,27,20-24,1931,7
SIM,1863,0,na,1863,3132
STAT,1862,44,15-19,1906,0.011603628117341143
STAT,1900,33,50-100,1933,1.2639053247495187
SIM,1821,82,na,1903,446
STAT,1868,47,15-19,1915,3.845468436667513E-4
STAT,1849,27,30-34,1876,25.152024404081285
STAT,1905,25,20-24,1930,16.98806327932727
STAT,1906,36,40-44,1942,1.3747890080181868
STAT,1909,29,20-24,1938,17.144182253931206
SIM,1933,34,35-39,1967,2
STAT,1930,28,30-34,1958,49.44880336127404
SIM,1924,43,45-49,1967,1
SIM,1899,3,na,1902,2394
STAT,1848,51,50-100,1899,0.014200388602035265
SIM,1945,20,na,1965,6212
STAT,1846,81,na,1927,320.27365279865734
STAT,1945,20,45-49,1965,1.2203980357211854
STAT,1930,35,20-24,1965,0.3420205325934077
STAT,1877,20,35-39,1897,5.959058812603412
STAT,1878,28,na,1906,2446.7772531083647
SIM,1837,66,na,1903,1470
STAT,1917,38,45-49,1955,0.6951612695706514
STAT,1853,29,na,1882,1922.8564092185727
STAT,1916,25,45-49,1941,1.773878588283577
STAT,1947,23,na,1970,4082.385882381728
STAT,1934,27,40-44,1961,6.227795210457182
SIM,1886,41,35-39,1927,7
SIM,1832,66,na,1898,590
SIM,1917,29,20-24,1946,4
STAT,1889,44,15-19,1933,0.016405666567206607
STAT,1829,26,50-100,1855,0.5471440072306065
SIM,1914,22,30-34,1936,3
STAT,1875,17,30-34,1892,1.6366683842794647
STAT,1925,34,35-39,1959,10.738624141021138
STAT,1931,33,50-100,1964,1.0750900639010874
SIM,1925,20,na,1945,4510
SIM,1929,34,na,1963,6194
STAT,1799,87,na,1886,11.875245456962363
SIM,1922,15,20-24,1937,69
SIM,1851,26,na,1877,620
STAT,1832,47,35-39,1879,0.012673429350594385
STAT,1857,41,15-19,1898,0.010645080002153187
STAT,1931,27,35-39,1958,19.24693625313554
STAT,1935,31,40-44,1966,5.378223963494854
SIM,1860,62,na,1922,1689
STAT,1831,48,30-34,1879,0.09011515996784764
STAT,1921,24,50-100,1945,0.7297875896926388
STAT,1862,44,na,1906,1942.0056183217948
STAT,1916,43,45-49,1959,0.16796102124943899
STAT,1876,16,35-39,1892,0.5560568193529278
STAT,1876,39,20-24,1915,0.7714144533741029
STAT,1906,22,30-34,1928,25.793457539997608
STAT,1914,15,20-24,1929,27.783275130402558
SIM,1859,25,40-44,1884,3
STAT,1897,23,45-49,1920,0.9232176822360871
STAT,1809,47,50-100,1856,2.1606801201627546
STAT,1811,50,50-100,1861,0.07071785571533855
STAT,1870,32,na,1902,2378.992550531697
STAT,1943,20,na,1963,3843.5600089811082
SIM,1868,58,na,1926,573
STAT,1929,35,30-34,1964,2.3275042138940205
SIM,1864,44,na,1908,2401
SIM,1894,10,na,1904,1764
STAT,1853,36,15-19,1889,0.043996092167441506
STAT,1901,47,45-49,1948,0.1852677413657971
SIM,1821,71,na,1892,1347
STAT,1863,22,50-100,1885,0.35507365461408186
STAT,1899,29,35-39,1928,13.084961876825504
STAT,1935,19,20-24,1954,183.0195017858506
STAT,1837,77,na,1914,693.0986775872445
STAT,1858,35,25-29,1893,2.2196217954186106
STAT,1803,97,na,1900,1.3551564649433954
SIM,1881,8,na,1889,3275
STAT,1867,43,na,1910,2170.019129004623
STAT,1822,37,na,1859,1649.7106043585866
STAT,1883,16,50-100,1899,0.04724806129791961
STAT,1901,32,na,1933,3336.576354282988
SIM,1921,17,na,1938,5272
STAT,1890,37,30-34,1927,6.452025597949482
STAT,1914,34,25-29,1948,9.095716206215277
STAT,1918,42,na,1960,3895.456280521907
STAT,1904,34,15-19,1938,0.1158249577882877
STAT,1918,35,20-24,1953,0.2767060828206543
STAT,1892,27,50-100,1919,0.7919991999629177
STAT,1811,85,na,1896,166.07909887969737
STAT,1933,33,30-34,1966,21.07491185632854
STAT,1946,19,30-34,1965,13.364078259813072
STAT,1864,24,na,1888,2153.396279498109
STAT,1844,70,na,1914,1390.0100330328407
SIM,1867,23,25-29,1890,22
STAT,1840,49,35-39,1889,0.054183503646940745
STAT,1899,30,15-19,1929,0.19607348287055393
STAT,1916,40,40-44,1956,0.253527097196953
STAT,1810,90,na,1900,2.45466745800474
STAT,1818,63,na,1881,1206.2034449107898
STAT,1833,32,15-19,1865,0.08059289213984265
STAT,1872,98,na,1970,20.44559010175151
STAT,1896,56,na,1952,2688.7039534728406
STAT,1924,20,25-29,1944,108.59166260241419
SIM,1936,16,na,1952,3982
STAT,1926,26,15-19,1952,0.8418970742800915
SIM,1834,37,na,1871,951
STAT,1842,18,30-34,1860,0.505098687526395
STAT,1856,22,45-49,1878,0.5816947229457395
STAT,1931,18,25-29,1949,56.175268751052876
STAT,1921,18,15-19,1939,50.98374586810382
STAT,1922,33,20-24,1955,2.713711076987885
STAT,1932,24,na,1956,4741.781792608807
STAT,1859,23,25-29,1882,46.737452448258296
SIM,1891,46,na,1937,1897
STAT,1849,23,15-19,1872,3.3366477151959053
STAT,1886,43,35-39,1929,1.861642448766717
STAT,1823,46,30-34,1869,0.153206787893782
SIM,1874,65,na,1939,1948
STAT,1953,19,na,1972,4409.706690699291
STAT,1933,25,45-49,1958,2.280329420412899
STAT,1913,39,35-39,1952,2.3332956997418037
STAT,1911,33,45-49,1944,1.5086365776282709
STAT,1912,21,45-49,1933,1.0690105185315257
STAT,1902,21,35-39,1923,8.242100842901339
STAT,1939,21,30-34,1960,28.55654032176173
STAT,1854,14,na,1868,1573.4380077376823
STAT,1882,38,35-39,1920,6.738100008822916
STAT,1819,52,35-39,1871,0.0015120709051187058
STAT,1843,38,50-100,1881,1.2753804009824583
STAT,1942,30,40-44,1972,4.125647354528518
STAT,1835,20,30-34,1855,18.174887138763673
STAT,1846,102,na,1948,0.17363607218966742
SIM,1831,46,30-34,1877,1
STAT,1841,51,na,1892,2409.164279944798
STAT,1888,38,na,1926,2705.696182169336
SIM,1851,38,50-100,1889,2
SIM,1894,43,35-39,1937,1
SIM,1915,21,na,1936,3271
STAT,1815,47,35-39,1862,0.014190927668986412
STAT,1824,70,na,1894,271.528137147431
SIM,1791,67,na,1858,990
SIM,1870,51,na,1921,1158
SIM,1921,39,35-39,1960,21
STAT,1907,16,40-44,1923,0.26752872403592687
STAT,1907,43,30-34,1950,0.11564598652188768
STAT,1839,20,15-19,1859,3.995343278158656
STAT,1869,40,30-34,1909,1.1718153081100502
STAT,1820,37,15-19,1857,0.10447824701684429
SIM,1932,20,25-29,1952,1
SIM,1942,7,na,1949,3672
STAT,1929,15,50-100,1944,0.4769932238366645
STAT,1873,83,na,1956,439.0009242590123
STAT,1924,46,35-39,1970,0.15239634149261036
SIM,1915,54,na,1969,2719
SIM,1921,27,20-24,1948,129
SIM,1904,58,na,1962,3874
STAT,1913,27,20-24,1940,17.960172716402163
STAT,1920,7,na,1927,4427.093203109282
SIM,1891,15,15-19,1906,158
STAT,1827,46,15-19,1873,3.7095816144883624E-4
STAT,1901,32,45-49,1933,2.4382386736595385
SIM,1899,32,30-34,1931,6
STAT,1910,20,30-34,1930,26.847994501838688
STAT,1850,55,na,1905,954.7908474699901
STAT,1920,20,40-44,1940,3.7119523620247596
SIM,1886,5,na,1891,3167
STAT,1802,52,45-49,1854,0.07372344375596604
STAT,1837,45,50-100,1882,0.20972945433558496
SIM,1812,67,na,1879,529
SIM,1881,47,na,1928,2699
SIM,1883,24,20-24,1907,5
STAT,1900,34,30-34,1934,23.9796152051921
STAT,1830,31,35-39,1861,9.611691418091377
STAT,1863,4,na,1867,2596.5542914533075
STAT,1902,58,na,1960,2891.6442184596413
SIM,1840,85,na,1925,1449
SIM,1826,70,na,1896,804
SIM,1906,23,35-39,1929,2
SIM,1860,49,50-100,1909,11
SIM,1943,19,20-24,1962,13
STAT,1873,28,na,1901,2439.429785880783
STAT,1894,37,15-19,1931,0.07140942788560976
SIM,1796,66,na,1862,998
STAT,1867,76,na,1943,895.9881179887834
SIM,1842,33,na,1875,3070
STAT,1854,25,na,1879,1405.7670429570658
STAT,1851,52,40-44,1903,0.008270396190765963
SIM,1928,39,25-29,1967,4
STAT,1922,34,50-100,1956,0.9192400301455629
SIM,1900,55,na,1955,4006
STAT,1893,15,25-29,1908,7.119326018416138
STAT,1947,7,na,1954,4390.282372152314
STAT,1817,104,na,1921,0.02112986782251188
STAT,1820,89,na,1909,72.24657751501125
STAT,1869,24,na,1893,2371.5876231911116
STAT,1861,102,na,1963,0.8942644277465432
STAT,1883,19,30-34,1902,1.5251480981433332
SIM,1817,45,na,1862,2789
STAT,1865,10,na,1875,2499.013851981724
STAT,1936,29,15-19,1965,0.6682423888475943
STAT,1876,49,15-19,1925,3.959200842457631E-4
STAT,1823,39,40-44,1862,7.762076599755125
SIM,1803,53,na,1856,1659
SIM,1854,14,na,1868,2439
STAT,1901,29,15-19,1930,0.629839793646092
STAT,1856,48,35-39,1904,0.09929201449519576
STAT,1867,47,50-100,1914,0.23118844234428004
STAT,1939,31,25-29,1970,9.33219126037781
STAT,1922,40,45-49,1962,0.18942120988143502
STAT,1801,86,na,1887,65.74920259303681
SIM,1842,23,20-24,1865,5
SIM,1846,70,na,1916,319
STAT,1922,26,30-34,1948,43.99333713678808
STAT,1956,15,25-29,1971,56.87184313361394
STAT,1905,28,25-29,1933,60.628835004782985
STAT,1858,36,50-100,1894,0.9420959565885049
SIM,1913,28,25-29,1941,14
STAT,1879,17,15-19,1896,6.0878986380555835
STAT,1845,42,35-39,1887,0.9150168391173595
STAT,1926,44,45-49,1970,0.20273772771855497
STAT,1830,34,50-100,1864,0.8429450705886535
SIM,1864,48,35-39,1912,7
STAT,1850,11,na,1861,1353.1788470697425
STAT,1892,21,15-19,1913,4.096832764063227
STAT,1887,19,15-19,1906,6.4969711433787465
STAT,1863,30,35-39,1893,8.71509533836691
STAT,1884,51,40-44,1935,0.010126046851616825
STAT,1944,25,20-24,1969,19.523901515003555
SIM,1875,15,30-34,1890,5
STAT,1801,75,na,1876,375.8829347284141
STAT,1814,105,na,1919,0.01984377709975247
STAT,1914,24,30-34,1938,28.77393449727213
STAT,1880,47,15-19,1927,4.133254612613157E-4
STAT,1926,25,40-44,1951,5.577184246940555
STAT,1821,35,50-100,1856,1.599964087762324
STAT,1861,28,20-24,1889,9.756701291626289
STAT,1946,26,20-24,1972,20.123048292796934
STAT,1919,45,15-19,1964,3.960976810069814E-4
STAT,1908,5,na,1913,3857.3770097240204
STAT,1876,46,50-100,1922,0.2489839225300913
STAT,1824,59,na,1883,404.6477378019783
STAT,1867,22,20-24,1889,65.44110091640393
STAT,1824,48,na,1872,495.9880384897814
STAT,1843,50,40-44,1893,0.01055126674844719
STAT,1864,47,30-34,1911,0.08759120813342554
STAT,1853,84,na,1937,257.9432794933237
STAT,1940,21,20-24,1961,112.03947197554608
STAT,1907,57,na,1964,3108.3839216963706
STAT,1794,88,na,1882,0.5895019777098734
STAT,1903,15,45-49,1918,0.0931568469709993
STAT,1906,32,25-29,1938,8.51654768089677
STAT,1903,43,na,1946,3268.37943437933
STAT,1891,57,na,1948,2471.301014520632
STAT,1948,17,40-44,1965,1.5843338637542108
SIM,1856,25,na,1881,881
SIM,1826,59,na,1885,1370
STAT,1825,30,15-19,1855,0.2796519958226938
STAT,1932,40,25-29,1972,0.09637620733355406
STAT,1883,50,na,1933,2101.2077954227875
SIM,1818,52,na,1870,699
STAT,1881,32,50-100,1913,0.8652544406118078
STAT,1938,27,25-29,1965,64.51021929738134
SIM,1884,21,30-34,1905,2
SIM,1869,6,na,1875,3914
SIM,1889,64,na,1953,2369
STAT,1937,33,15-19,1970,0.12574404552476273
STAT,1885,30,50-100,1915,0.9078623147575757
SIM,1885,50,na,1935,1216
STAT,1846,18,15-19,1864,4.389295252064647
STAT,1906,25,35-39,1931,14.06713011708573
STAT,1836,29,na,1865,2111.516110964018
SIM,1904,36,30-34,1940,7
STAT,1874,36,35-39,1910,7.334859363413259
STAT,1872,48,50-100,1920,0.2428437475482791
STAT,1929,42,20-24,1971,0.022710483695711263
SIM,1853,42,35-39,1895,20
STAT,1947,23,30-34,1970,32.13016443420452
STAT,1898,26,15-19,1924,0.6121951322821486
SIM,1902,30,40-44,1932,1
STAT,1871,17,na,1888,2535.673532428448
SIM,1910,40,50-100,1950,1
STAT,1941,27,45-49,1968,1.7668444492262207
STAT,1925,31,30-34,1956,18.548747786091948
STAT,1864,24,45-49,1888,0.6349170483861415
STAT,1928,38,20-24,1966,0.3302803957488309
STAT,1800,54,35-39,1854,0.05019289033363627
STAT,1815,89,na,1904,7.406861183873013
STAT,1952,16,15-19,1968,53.90433426271105
STAT,1930,24,15-19,1954,6.729081514074226
STAT,1874,54,35-39,1928,0.00864078669810711
SIM,1885,61,na,1946,976
STAT,1916,22,40-44,1938,3.475234344315199
SIM,1869,43,na,1912,3488
STAT,1834,23,20-24,1857,40.326488739709696
STAT,1918,53,na,1971,3774.722822416687
SIM,1815,45,35-39,1860,3
SIM,1835,64,na,1899,1160
SIM,1842,31,20-24,1873,26
STAT,1877,19,50-100,1896,0.04946594693485939
STAT,1918,38,25-29,1956,1.022767502985356
STAT,1919,22,45-49,1941,1.2157184386501074
STAT,1836,36,15-19,1872,0.05336819277965438
STAT,1869,24,45-49,1893,0.6992495659259486
STAT,1881,24,45-49,1905,0.6543916564872433
STAT,1884,25,25-29,1909,40.76870703848502
STAT,1888,41,45-49,1929,1.7351836987957927
STAT,1942,30,20-24,1972,2.5715001562956155
SIM,1911,42,20-24,1953,1
STAT,1884,23,30-34,1907,16.99851874518238
STAT,1946,16,na,1962,4039.503304647468
STAT,1837,31,50-100,1868,0.9307385420210793
STAT,1861,20,25-29,1881,49.61943579783418
SIM,1956,7,na,1963,4927
STAT,1833,35,35-39,1868,3.926131798581308
SIM,1910,20,25-29,1930,176
SIM,1878,20,30-34,1898,58
SIM,1883,25,30-34,1908,57
SIM,1894,75,na,1969,542
SIM,1924,35,na,1959,5189
SIM,1945,25,15-19,1970,1
STAT,1841,34,15-19,1875,0.1884505648821774
STAT,1813,49,25-29,1862,0.20347774648048406
STAT,1898,38,30-34,1936,1.5392123865011411
SIM,1943,18,na,1961,3836
STAT,1939,20,20-24,1959,110.51986409450538
SIM,1907,36,35-39,1943,12
STAT,1897,73,na,1970,1983.200086421777
STAT,1849,38,35-39,1887,6.035237986526475
STAT,1811,108,na,1919,0.001109714692948126
STAT,1841,52,30-34,1893,0.006593263743976258
STAT,1873,37,30-34,1910,5.466972293579341
STAT,1925,33,25-29,1958,10.868421484515748
STAT,1840,66,na,1906,645.3677744281669
SIM,1916,16,na,1932,4819
STAT,1823,31,45-49,1854,7.585348655209102
STAT,1911,19,30-34,1930,2.398685252932461
STAT,1835,23,35-39,1858,5.826936359793392
STAT,1946,23,15-19,1969,5.8577370208499815
STAT,1858,36,35-39,1894,5.427334548460729
SIM,1948,2,na,1950,5825
SIM,1867,39,20-24,1906,1
STAT,1903,42,20-24,1945,0.01563552579662769
SIM,1808,62,na,1870,1261
STAT,1834,31,20-24,1865,1.5418648266780417
STAT,1919,38,na,1957,3984.0616079659058
SIM,1892,25,25-29,1917,2
STAT,1900,41,40-44,1941,0.2173527667286681
STAT,1828,32,na,1860,1934.9079324829572
STAT,1826,32,25-29,1858,20.315846698359522
STAT,1923,43,na,1966,4288.366213153366
SIM,1839,47,30-34,1886,1
STAT,1894,29,15-19,1923,0.5728311048644273
STAT,1847,22,15-19,1869,3.656503751914746
SIM,1858,37,na,1895,2375
SIM,1865,84,na,1949,254
STAT,1830,48,15-19,1878,3.3748714041842984E-4
SIM,1837,26,15-19,1863,2
SIM,1899,19,na,1918,2151
SIM,1901,2,na,1903,4179
STAT,1842,67,na,1909,393.5215601307886
STAT,1920,19,25-29,1939,47.73693552545062
STAT,1827,38,15-19,1865,0.05469687126598869
STAT,1893,23,25-29,1916,71.366025287574
STAT,1838,24,15-19,1862,1.8009681319623316
STAT,1866,52,35-39,1918,0.007816675459626873
STAT,1934,24,35-39,1958,12.559667315740946
STAT,1889,54,na,1943,2521.664506868516
STAT,1896,17,15-19,1913,7.823094734876639
STAT,1901,17,35-39,1918,0.767213457507752
STAT,1951,21,30-34,1972,34.02992348802255
SIM,1881,13,na,1894,3187
STAT,1822,105,na,1927,0.016907774002758266
SIM,1938,22,20-24,1960,120
SIM,1859,33,40-44,1892,6
STAT,1836,51,na,1887,1700.6847796954771
STAT,1874,29,45-49,1903,1.1377166605653533
STAT,1931,30,45-49,1961,2.0497240941785413
STAT,1921,40,15-19,1961,0.0017139130626793735
STAT,1943,22,35-39,1965,9.903526000079212
STAT,1897,63,na,1960,2487.343803368886
SIM,1833,33,20-24,1866,15
STAT,1819,101,na,1920,0.13272269025279146
STAT,1820,66,na,1886,1120.1101550496082
SIM,1835,54,na,1889,1206
STAT,1864,39,30-34,1903,4.796387647438593
STAT,1872,31,40-44,1903,4.360359332781078
SIM,1823,39,35-39,1862,57
SIM,1921,3,na,1924,5456
STAT,1902,28,20-24,1930,16.461615915262012
STAT,1944,28,25-29,1972,70.30454335211645
STAT,1926,37,20-24,1963,0.31940344933325493
STAT,1913,16,15-19,1929,9.185078463925679
STAT,1916,40,20-24,1956,0.01790060883012033
STAT,1859,24,na,1883,1917.0499306117752
SIM,1880,51,na,1931,3193
STAT,1777,105,na,1882,0.05378581738211824
SIM,1873,38,35-39,1911,2
STAT,1945,20,50-100,1965,0.7136830890186227
SIM,1827,35,na,1862,2243
STAT,1889,47,35-39,1936,0.09465628806652067
STAT,1890,22,45-49,1912,0.8441825638360017
STAT,1863,39,na,1902,1991.0835687835097
STAT,1849,24,na,1873,2146.985198997898
SIM,1922,38,40-44,1960,2
STAT,1828,53,50-100,1881,0.015533460044829845
STAT,1917,32,35-39,1949,9.441568810791816
STAT,1902,20,25-29,1922,81.09197621198108
SIM,1850,31,na,1881,1855
SIM,1848,27,na,1875,2611
STAT,1833,28,30-34,1861,15.056126775536766
STAT,1846,44,45-49,1890,0.8744366494925461
STAT,1937,25,15-19,1962,0.6816363135659564
STAT,1865,38,35-39,1903,6.425484857202228
SIM,1890,51,na,1941,3400
STAT,1879,25,15-19,1904,0.46858374623908244
STAT,1812,47,na,1859,242.68096583883522
STAT,1850,96,na,1946,3.9649892299934417
STAT,1815,39,35-39,1854,0.7740809637381788
STAT,1877,37,15-19,1914,0.05700363828483084
STAT,1843,24,25-29,1867,69.98007218274232
STAT,1860,21,20-24,1881,58.3721195742118
STAT,1916,33,30-34,1949,15.976462838706876
STAT,1879,43,45-49,1922,1.524222366840787
SIM,1933,33,25-29,1966,2
STAT,1833,28,45-49,1861,0.663844457254593
STAT,1926,3,na,1929,4930.30128130039
STAT,1838,52,na,1890,913.3778301194336
STAT,1877,42,50-100,1919,1.0711054757608889
STAT,1851,19,35-39,1870,0.520705687099383
SIM,1874,34,20-24,1908,1
STAT,1847,40,45-49,1887,1.3960004566556667
SIM,1852,12,na,1864,2630
STAT,1866,34,20-24,1900,2.4462776924361345
STAT,1850,86,na,1936,102.4539148103438
STAT,1884,18,35-39,1902,0.5238879249316015
STAT,1882,53,30-34,1935,0.005607527884406526
SIM,1827,45,na,1872,1987
STAT,1856,112,na,1968,2.1571422142451944E-4
STAT,1832,36,30-34,1868,0.3927694527132436
SIM,1909,31,40-44,1940,14
SIM,1928,1,na,1929,4662
STAT,1898,27,na,1925,3209.197880335236
STAT,1932,29,45-49,1961,2.2448460450874426
STAT,1918,23,40-44,1941,3.566426127545088
SIM,1842,12,na,1854,3413
STAT,1852,77,na,1929,870.0866997119873
SIM,1875,26,35-39,1901,265
STAT,1855,112,na,1967,1.6756856539135916E-4
SIM,1850,21,na,1871,1492
STAT,1867,33,25-29,1900,9.645860798139003
SIM,1933,18,na,1951,2869
STAT,1908,41,25-29,1949,0.06593399666024226
STAT,1838,42,45-49,1880,0.7471623511757683
SIM,1891,13,na,1904,2659
STAT,1850,27,35-39,1877,5.243239091499064
STAT,1905,40,45-49,1945,0.15099266518990348
SIM,1879,74,na,1953,463
STAT,1922,49,50-100,1971,0.25543306838711716
STAT,1851,26,25-29,1877,39.400600748418675
STAT,1834,24,30-34,1858,10.348622602820708
SIM,1886,76,na,1962,1187
STAT,1874,33,15-19,1907,0.14635396009804247
SIM,1941,25,30-34,1966,467
SIM,1852,28,20-24,1880,30
STAT,1836,20,50-100,1856,0.6481899227564928
STAT,1845,15,45-49,1860,0.04145554920846474
SIM,1902,29,25-29,1931,1
STAT,1878,53,50-100,1931,0.01528926291434398
STAT,1858,40,20-24,1898,0.12250360004960417
SIM,1875,33,25-29,1908,8
SIM,1926,16,na,1942,5545
STAT,1890,29,30-34,1919,30.26750604587746
STAT,1853,28,15-19,1881,0.3681983852251248
STAT,1899,34,30-34,1933,23.643482817290174
STAT,1798,92,na,1890,17.678841133840443
STAT,1870,28,15-19,1898,0.45071895900317893
STAT,1933,25,30-34,1958,51.71833321575174
STAT,1862,2,na,1864,2921.4587759052497
SIM,1884,75,na,1959,2272
STAT,1855,42,45-49,1897,0.989311549283429
STAT,1897,49,35-39,1946,0.10268868283451832
STAT,1856,45,15-19,1901,2.9016544959227833E-4
STAT,1860,46,35-39,1906,0.11453516976667355
STAT,1899,36,25-29,1935,3.9515290783928494
SIM,1858,27,na,1885,2439
SIM,1953,18,na,1971,4649
STAT,1840,38,30-34,1878,2.4564264333586507
STAT,1947,15,30-34,1962,13.592808854497463
STAT,1826,51,na,1877,1922.6094218687065
STAT,1874,51,30-34,1925,0.006172820953934695
STAT,1942,23,30-34,1965,29.780899955055148
SIM,1930,21,na,1951,3918
STAT,1917,29,50-100,1946,1.0225450135699485
STAT,1882,35,15-19,1917,0.05427354684315847
STAT,1887,45,45-49,1932,0.26234855706208404
STAT,1888,48,30-34,1936,0.06222924008133045
SIM,1876,56,na,1932,3199
STAT,1857,37,30-34,1894,4.089712392181428
STAT,1868,25,40-44,1893,2.9129571607648854
STAT,1862,38,50-100,1900,1.0405321134407097
SIM,1896,48,30-34,1944,1
SIM,1817,40,25-29,1857,1
STAT,1913,43,na,1956,3570.6741754043182
STAT,1839,16,30-34,1855,1.948591871464005
STAT,1860,24,25-29,1884,47.45273494188874
STAT,1829,26,15-19,1855,0.3880624971527197
STAT,1843,17,35-39,1860,0.6928293499551799
STAT,1840,23,45-49,1863,0.34666880691536484
STAT,1848,39,30-34,1887,5.03385999394135
SIM,1891,23,na,1914,2539
STAT,1833,50,30-34,1883,0.0027355518670921725
STAT,1927,21,40-44,1948,4.12126751319183
STAT,1825,99,na,1924,1.1662672714923439
STAT,1860,17,35-39,1877,0.5162638891151919
STAT,1885,29,20-24,1914,11.449005296153638
SIM,1946,24,20-24,1970,10
STAT,1858,62,na,1920,1395.7730193006125
STAT,1910,15,35-39,1925,0.8259695394852857
STAT,1815,44,15-19,1859,0.0014184757206184848
STAT,1813,49,50-100,1862,0.8676065084749078
STAT,1825,36,25-29,1861,4.250594613952186
SIM,1863,28,na,1891,1125
STAT,1938,17,30-34,1955,11.894797373835557
STAT,1817,47,50-100,1864,0.1720583939279351
STAT,1835,30,25-29,1865,10.073538496888439
STAT,1924,35,30-34,1959,2.132180144888252
STAT,1875,32,20-24,1907,2.7756418833612355
SIM,1911,19,25-29,1930,21
STAT,1830,66,na,1896,1186.2701855476923
STAT,1871,49,15-19,1920,3.9068594272826334E-4
STAT,1839,23,20-24,1862,81.6729306986612
STAT,1889,44,na,1933,2745.6840501649654
SIM,1876,46,na,1922,3638
STAT,1814,48,30-34,1862,0.3264858963884796
STAT,1909,38,na,1947,3507.326197626889
STAT,1843,22,30-34,1865,22.090764274749876
STAT,1928,27,15-19,1955,0.8631139772108162
STAT,1818,38,20-24,1856,1.8042265272662985
STAT,1876,31,25-29,1907,10.396645331866482
STAT,1881,39,30-34,1920,4.982320217042851
SIM,1878,27,15-19,1905,6
STAT,1934,31,25-29,1965,12.541165153693218
STAT,1944,21,40-44,1965,3.5907018530985395
STAT,1841,37,35-39,1878,9.27966251218142
STAT,1903,19,25-29,1922,8.00084633999714
STAT,1859,35,40-44,1894,3.5025274012779155
STAT,1939,16,35-39,1955,4.155239257095897
SIM,1808,52,na,1860,1372
STAT,1875,25,30-34,1900,26.033519531148908
STAT,1825,29,35-39,1854,22.667192315006638
STAT,1866,36,50-100,1902,1.126100593362694
STAT,1938,24,20-24,1962,108.79710542752063
STAT,1805,99,na,1904,0.2540867659878549
SIM,1826,30,25-29,1856,10
STAT,1908,34,35-39,1942,8.485893128586204
STAT,1928,20,45-49,1948,1.4024711123237636
STAT,1878,41,50-100,1919,1.0918690371412134
STAT,1904,60,na,1964,2915.5489899140857
STAT,1865,35,15-19,1900,0.05175551756886008
STAT,1917,39,20-24,1956,0.26850649246784014
STAT,1885,21,25-29,1906,56.43941992330132
STAT,1824,37,35-39,1861,1.116815668418504
STAT,1836,49,50-100,1885,0.19197059804296546
STAT,1839,49,30-34,1888,0.089312637257249
STAT,1892,27,25-29,1919,52.373128210241546
STAT,1831,33,45-49,1864,1.827596004464068
STAT,1917,31,25-29,1948,9.588310809175727
STAT,1849,45,25-29,1894,0.04901714789359312
STAT,1866,81,na,1947,493.61996064193244
SIM,1845,64,na,1909,1416
SIM,1903,43,na,1946,2705
STAT,1910,22,25-29,1932,85.77306155815995
STAT,1919,37,15-19,1956,0.020356344540830375
STAT,1899,41,20-24,1940,0.015131355412691226
STAT,1823,38,30-34,1861,9.759884215540199
STAT,1876,24,35-39,1900,5.862204071186618
STAT,1907,35,30-34,1942,1.694401744459446
STAT,1891,28,35-39,1919,11.82379791356113
STAT,1848,46,35-39,1894,0.13138039498909562
STAT,1869,44,na,1913,2300.7494420577805
SIM,1831,38,30-34,1869,20
STAT,1848,47,30-34,1895,0.09016067439219186
STAT,1870,26,50-100,1896,0.6399190597124808
STAT,1822,46,15-19,1868,6.782249178911453E-4
STAT,1898,15,25-29,1913,7.655549216352571
STAT,1919,0,na,1919,4912.429343691393
STAT,1851,16,30-34,1867,1.5395703608357318
STAT,1926,22,35-39,1948,11.341144479979436
SIM,1938,23,30-34,1961,684
STAT,1855,34,45-49,1889,1.150984541235288
SIM,1825,31,20-24,1856,1
STAT,1883,26,35-39,1909,9.314541685626722
STAT,1904,48,25-29,1952,0.045836771061961865
SIM,1853,20,40-44,1873,121
STAT,1908,31,30-34,1939,14.81687363414933
STAT,1918,31,40-44,1949,4.119129318916516
STAT,1916,41,na,1957,3759.442099718429
SIM,1886,29,15-19,1915,4
STAT,1848,39,45-49,1887,1.8828757896429662
STAT,1837,21,45-49,1858,0.7372410517501611
STAT,1900,44,45-49,1944,0.14202903070141573
STAT,1905,22,15-19,1927,4.745054011970028
STAT,1884,22,20-24,1906,65.96802824575506
STAT,1878,29,15-19,1907,0.46346427254937594
STAT,1920,16,20-24,1936,150.52045495903485
SIM,1947,22,na,1969,4355
STAT,1839,36,50-100,1875,1.3773237516219843
STAT,1786,91,na,1877,35.27557351725627
STAT,1816,51,na,1867,2375.014210412144
SIM,1843,22,25-29,1865,5
STAT,1818,48,15-19,1866,7.025982620474001E-4
STAT,1870,18,20-24,1888,17.737432022793588
STAT,1899,44,25-29,1943,0.060085573142498364
STAT,1867,35,50-100,1902,1.1721404742598895
STAT,1877,29,15-19,1906,0.4572709524056003
STAT,1891,78,na,1969,1387.0447615114451
STAT,1909,33,40-44,1942,3.680770457927196
STAT,1884,26,35-39,1910,9.268350621244538
STAT,1892,25,30-34,1917,31.38907348690689
STAT,1898,28,50-100,1926,0.8571771762085528
STAT,1920,42,20-24,1962,0.019253945350269322
STAT,1894,45,na,1939,2890.0897074122868
STAT,1932,34,na,1966,4986.282351671553
SIM,1833,34,30-34,1867,2
SIM,1874,75,na,1949,1948
SIM,1930,11,na,1941,5599
STAT,1943,21,25-29,1964,97.18490102341707
SIM,1824,35,35-39,1859,1
SIM,1893,58,na,1951,2326
SIM,1915,44,na,1959,3065
SIM,1868,27,na,1895,959
SIM,1828,82,na,1910,163
SIM,1889,74,na,1963,986
SIM,1916,31,30-34,1947,2
STAT,1811,75,na,1886,618.7987794243093
STAT,1845,20,40-44,1865,1.3023047969272008
SIM,1832,34,30-34,1866,363
SIM,1926,31,40-44,1957,4
STAT,1912,47,20-24,1959,0.010497261859965657
SIM,1891,26,35-39,1917,2
STAT,1812,92,na,1904,3.298407785932848
STAT,1825,34,30-34,1859,27.167533594404325
STAT,1930,16,50-100,1946,0.48215147559227634
STAT,1886,16,45-49,1902,0.06781086313714663
STAT,1909,37,20-24,1946,0.24697597889419315
STAT,1869,78,na,1947,788.4286774676576
SIM,1874,37,25-29,1911,11
SIM,1834,22,30-34,1856,553
STAT,1955,17,30-34,1972,16.039404712169453
STAT,1777,86,na,1863,175.4865023124424
SIM,1884,23,25-29,1907,186
SIM,1840,31,na,1871,2475
STAT,1897,31,45-49,1928,2.325350621846425
SIM,1848,44,20-24,1892,3
STAT,1888,25,50-100,1913,0.743318671152301
STAT,1870,86,na,1956,243.30791177591362
STAT,1945,27,15-19,1972,0.765946988629487
STAT,1822,47,na,1869,1502.7226731187582
STAT,1832,29,40-44,1861,3.543274557395941
STAT,1854,48,na,1902,1235.2329996452286
STAT,1948,21,25-29,1969,105.00783862546143
STAT,1938,21,15-19,1959,5.213670300917389
SIM,1951,1,na,1952,2477
SIM,1900,45,na,1945,4148
SIM,1914,0,na,1914,5181
STAT,1822,39,25-29,1861,5.409867613318303
STAT,1842,25,35-39,1867,3.0051369622015223
SIM,1845,30,na,1875,2386
SIM,1940,21,na,1961,4270
STAT,1855,18,50-100,1873,0.0383386890592927
SIM,1943,23,40-44,1966,3
STAT,1912,17,25-29,1929,8.661080622209544
STAT,1838,49,30-34,1887,0.041436472134488006
STAT,1852,67,na,1919,1595.6611330345675
SIM,1875,29,na,1904,3021
STAT,1893,20,20-24,1913,86.69117167347099
SIM,1938,17,na,1955,3434
SIM,1868,23,40-44,1891,3
STAT,1817,42,25-29,1859,0.47130186953060565
STAT,1896,46,na,1942,2974.7779789260185
STAT,1865,35,30-34,1900,4.91206854593832
STAT,1866,37,25-29,1903,2.628185067074665
STAT,1928,35,15-19,1963,0.024126209981692234
STAT,1848,21,20-24,1869,79.08682986233046
STAT,1844,38,15-19,1882,0.05818013939423073
STAT,1883,52,35-39,1935,0.008238195948866229
STAT,1851,31,20-24,1882,2.2451950407512924
STAT,1843,21,20-24,1864,86.0832393805207
STAT,1889,15,30-34,1904,1.9282951638701962
SIM,1898,57,na,1955,3899
STAT,1839,19,35-39,1858,0.6590428700875706
STAT,1855,45,15-19,1900,2.6737365398098E-4
SIM,1860,21,na,1881,2282
STAT,1858,33,30-34,1891,13.277096057565508
SIM,1885,29,na,1914,1657
STAT,1829,44,45-49,1873,0.6993782147053397
SIM,1923,18,na,1941,4291
STAT,1839,101,na,1940,0.5301470335089984
STAT,1883,19,45-49,1902,0.06250605688791387
STAT,1835,34,na,1869,2044.7621910429853
SIM,1839,24,25-29,1863,42
STAT,1862,102,na,1964,1.0510085861501635
SIM,1815,64,na,1879,482
STAT,1836,28,15-19,1864,0.4466324553170288
SIM,1848,37,30-34,1885,1
STAT,1859,20,50-100,1879,0.37385819193324593
STAT,1896,35,45-49,1931,2.6528284599901295
STAT,1879,40,40-44,1919,2.3306792422593694
STAT,1844,28,20-24,1872,14.125403589911818
STAT,1842,105,na,1947,0.007278694430707562
STAT,1855,49,30-34,1904,0.06272812613009698
STAT,1914,34,50-100,1948,0.8136514170313506
STAT,1846,41,40-44,1887,1.3656702503421112
STAT,1854,112,na,1966,1.1785799584053492E-4
SIM,1955,5,na,1960,3825
STAT,1851,24,30-34,1875,16.5595654060401
STAT,1937,33,na,1970,3700.807309053476
STAT,1842,51,35-39,1893,0.0021473767902022234
STAT,1933,28,35-39,1961,19.79013173660935
STAT,1847,25,20-24,1872,12.933657232367025
STAT,1825,34,na,1859,1775.0990652087648
STAT,1859,49,15-19,1908,3.104172942025463E-4
STAT,1855,16,15-19,1871,4.699288734236601
STAT,1894,15,40-44,1909,0.2336708837520935
STAT,1884,33,25-29,1917,9.763585458653665
STAT,1850,24,30-34,1874,9.730857336403082
STAT,1874,29,30-34,1903,25.80364434607738
STAT,1899,37,35-39,1936,2.0851712001638
STAT,1884,50,50-100,1934,0.014665204788881326
STAT,1947,18,35-39,1965,4.675515041805716
SIM,1829,28,30-34,1857,8
STAT,1877,30,50-100,1907,0.9375757765750301
STAT,1837,28,15-19,1865,0.4635736574794337
SIM,1928,17,na,1945,4614
STAT,1851,23,20-24,1874,64.52927635984562
STAT,1956,16,na,1972,4829.313195137934
SIM,1858,34,35-39,1892,3
STAT,1863,47,15-19,1910,3.398926119133248E-4
SIM,1844,78,na,1922,719
STAT,1888,19,30-34,1907,1.8297209349241077
SIM,1905,44,na,1949,3097
STAT,1901,22,30-34,1923,24.9054047981166
STAT,1860,96,na,1956,8.11906977292002
STAT,1889,1,na,1890,3277.7397055315923
STAT,1943,25,40-44,1968,4.911663227920888
SIM,1871,18,15-19,1889,65
SIM,1902,26,na,1928,3483
STAT,1949,14,na,1963,4521.836197454932
SIM,1949,4,na,1953,4543
STAT,1830,38,20-24,1868,0.6958511442719872
SIM,1830,55,na,1885,157
STAT,1950,17,45-49,1967,0.5850373512119446
STAT,1841,40,50-100,1881,1.2541840716870662
STAT,1887,42,40-44,1929,2.472669597543228
STAT,1925,26,35-39,1951,17.63080436547012
STAT,1841,29,35-39,1870,13.154494301295973
STAT,1914,38,40-44,1952,1.4665568598954515
STAT,1879,54,na,1933,2148.0645216934386
STAT,1899,33,20-24,1932,3.6764392063747575
STAT,1835,38,50-100,1873,1.1365809173903194
STAT,1889,48,30-34,1937,0.06492840439258732
STAT,1935,23,40-44,1958,4.54424576769601
STAT,1882,20,45-49,1902,0.6716062458951657
STAT,1887,63,na,1950,1963.9358457453454
STAT,1941,17,na,1958,3748.1464583931133
STAT,1951,16,35-39,1967,4.951666847599327
STAT,1825,33,20-24,1858,4.431002917750014
STAT,1903,20,40-44,1923,2.9756390674871316
STAT,1904,39,50-100,1943,0.3747903866163688
STAT,1934,15,na,1949,4967.864057764009
STAT,1863,18,15-19,1881,5.229939481698585
STAT,1928,35,50-100,1963,0.5274866152027701
STAT,1848,52,na,1900,2004.1532978961782
SIM,1869,30,30-34,1899,133
SIM,1902,26,20-24,1928,27
SIM,1848,45,30-34,1893,1
STAT,1884,45,na,1929,2175.18204110047
STAT,1839,26,25-29,1865,49.868256951563254
STAT,1782,77,na,1859,1010.4135428639191
STAT,1832,47,na,1879,2043.9208828370922
STAT,1899,44,na,1943,3124.9904572419177
STAT,1856,81,na,1937,388.4060281691788
STAT,1889,22,20-24,1911,82.9861490244722
STAT,1913,24,15-19,1937,5.274694086771217
STAT,1920,39,50-100,1959,0.4528154200423138
STAT,1859,39,20-24,1898,0.6048200049798003
STAT,1940,28,40-44,1968,4.697411871187925
SIM,1932,27,45-49,1959,407
STAT,1849,39,50-100,1888,1.036796094967081
STAT,1892,24,20-24,1916,84.78601470299768
STAT,1873,15,20-24,1888,18.401699907165302
STAT,1930,38,25-29,1968,1.2739835560900528
SIM,1900,42,45-49,1942,2
STAT,1824,34,30-34,1858,7.159638486229134
STAT,1881,35,15-19,1916,0.053533061899803155
STAT,1924,27,45-49,1951,1.9921955205800994
STAT,1897,46,15-19,1943,3.005032741301445E-4
STAT,1843,25,35-39,1868,11.90307850605833
STAT,1815,99,na,1914,0.1335282237440975
STAT,1835,22,25-29,1857,57.57518834862844
STAT,1911,42,na,1953,3504.798680413316
STAT,1891,25,30-34,1916,31.176995721235134
STAT,1885,39,15-19,1924,0.05464155634914018
STAT,1906,39,45-49,1945,0.6168002866521701
SIM,1853,28,na,1881,3315
STAT,1853,22,40-44,1875,1.9090906193833062
STAT,1868,38,na,1906,2264.2828636239583
STAT,1862,26,15-19,1888,0.3906666407118232
STAT,1871,39,20-24,1910,0.7612162023172094
STAT,1861,15,50-100,1876,0.0473868023296671
STAT,1884,27,50-100,1911,0.6123598664114711
STAT,1924,31,15-19,1955,0.14856931349509617
SIM,1878,27,na,1905,3907
STAT,1927,24,45-49,1951,1.3663738087745594
STAT,1934,21,30-34,1955,38.37601249278454
STAT,1907,38,35-39,1945,2.216449678831075
SIM,1865,29,na,1894,1769
SIM,1920,11,na,1931,4819
STAT,1843,32,25-29,1875,12.166365124320949
STAT,1833,84,na,1917,136.87001216360815
STAT,1892,17,30-34,1909,1.9733599264739146
STAT,1831,30,40-44,1861,4.752283771494791
SIM,1866,46,na,1912,2991
STAT,1844,48,na,1892,2200.886160935046
SIM,1902,19,30-34,1921,1
STAT,1847,18,30-34,1865,1.7879717832470285
STAT,1918,20,35-39,1938,10.078120416457127
SIM,1925,35,40-44,1960,3
STAT,1852,35,50-100,1887,1.2686108551748336
STAT,1891,18,40-44,1909,0.2243318556413464
SIM,1896,12,na,1908,4076
STAT,1920,49,20-24,1969,0.011988262494597366
STAT,1833,36,30-34,1869,2.9209672742915767
STAT,1871,27,na,1898,2380.6610527298135
STAT,1832,67,na,1899,1345.650850983732
STAT,1917,35,40-44,1952,1.5486853959588895
STAT,1845,65,na,1910,838.5881484363231
STAT,1909,22,35-39,1931,8.662189477862347
SIM,1865,30,na,1895,1465
SIM,1827,76,na,1903,974
STAT,1874,45,na,1919,2345.1345169326523
STAT,1793,93,na,1886,6.359631659554634
STAT,1897,38,30-34,1935,7.042849449890646
STAT,1823,53,na,1876,1867.4310939596542
STAT,1838,20,35-39,1858,3.2788010858882273
STAT,1901,32,25-29,1933,14.32136493115668
STAT,1919,43,50-100,1962,0.12542149629851418
SIM,1833,37,35-39,1870,41
STAT,1950,21,15-19,1971,6.256911677266112
SIM,1934,33,40-44,1967,1
STAT,1797,105,na,1902,2.9310279251218386E-4
STAT,1851,34,25-29,1885,8.24670013956019
SIM,1856,24,25-29,1880,6
STAT,1787,76,na,1863,172.15340201841008
STAT,1872,37,15-19,1909,0.05623090914111744
STAT,1897,24,20-24,1921,90.94644402097738
STAT,1899,26,30-34,1925,34.51316826285519
STAT,1900,15,40-44,1915,0.2545501481834951
SIM,1917,22,35-39,1939,237
STAT,1892,28,35-39,1920,11.904227877553925
STAT,1840,34,15-19,1874,0.06689361239667882
SIM,1882,25,30-34,1907,46
SIM,1820,55,na,1875,390
STAT,1851,48,35-39,1899,0.10918163250530002
STAT,1841,19,40-44,1860,0.25960121613116977
STAT,1952,19,20-24,1971,160.87773833879405
STAT,1850,17,40-44,1867,0.10320586473688236
STAT,1859,24,35-39,1883,4.730095877165436
STAT,1845,23,45-49,1868,0.42648073443264267
STAT,1848,38,35-39,1886,6.750201823399085
STAT,1828,38,15-19,1866,0.0738609961755499
STAT,1916,7,na,1923,4169.499395222259
STAT,1938,32,20-24,1970,2.4263242522098873
SIM,1882,25,15-19,1907,2
SIM,1937,32,na,1969,2984
SIM,1843,28,na,1871,433
SIM,1875,23,30-34,1898,59
STAT,1923,20,45-49,1943,1.3031421776211436
SIM,1835,20,25-29,1855,335
STAT,1853,18,20-24,1871,16.43875035279644
STAT,1929,34,20-24,1963,3.072595600461237
STAT,1910,19,15-19,1929,8.844255131644918
STAT,1834,80,na,1914,272.6186428095149
SIM,1897,62,na,1959,1515
STAT,1787,86,na,1873,33.10681201176949
STAT,1855,31,40-44,1886,2.9529568832488753
STAT,1902,27,na,1929,3360.607589805086
SIM,1879,27,30-34,1906,112
STAT,1861,82,na,1943,388.02999205287483
STAT,1859,78,na,1937,619.2785341430425
STAT,1876,2,na,1878,3294.387684092281
STAT,1848,24,25-29,1872,64.29244650059626
STAT,1857,36,35-39,1893,5.453609875281872
STAT,1944,24,45-49,1968,1.200372009189706
STAT,1924,38,35-39,1962,2.821885652504431
SIM,1844,68,na,1912,1211
STAT,1816,46,25-29,1862,0.17773793530866516
STAT,1845,49,20-24,1894,0.005830276766443359
SIM,1932,38,35-39,1970,18
STAT,1895,29,15-19,1924,0.585990812229693
STAT,1883,37,25-29,1920,2.769912053311569
STAT,1883,23,15-19,1906,3.163996565577485
STAT,1943,29,na,1972,3940.2398968913235
STAT,1829,41,40-44,1870,1.0980598398600507
STAT,1874,55,na,1929,2134.0179269443556
SIM,1891,37,25-29,1928,14
STAT,1941,19,45-49,1960,0.5083458703632334
SIM,1792,73,na,1865,853
STAT,1804,73,na,1877,971.4400191482686
STAT,1841,26,30-34,1867,35.08100367743538
SIM,1803,63,na,1866,965
SIM,1948,17,na,1965,5817
STAT,1802,92,na,1894,21.102390421938033
STAT,1869,39,15-19,1908,0.05609424744330205
STAT,1839,38,40-44,1877,4.809898356059673
STAT,1831,36,15-19,1867,0.057760169246093875
STAT,1867,23,30-34,1890,16.793558706987092
STAT,1889,39,35-39,1928,8.431665232970488
SIM,1867,35,40-44,1902,7
SIM,1833,25,35-39,1858,1
STAT,1882,74,na,1956,1095.7737172307452
STAT,1805,53,50-100,1858,0.017329652061338633
STAT,1865,85,na,1950,250.28228626378208
STAT,1861,27,50-100,1888,0.5358607321535914
STAT,1902,24,40-44,1926,2.9159676875910177
STAT,1907,27,45-49,1934,1.6200398028363954
STAT,1928,21,40-44,1949,4.178730361483452
STAT,1825,65,na,1890,1040.7002939822657
SIM,1889,49,35-39,1938,4
STAT,1929,20,45-49,1949,1.4213308361320591
STAT,1927,39,15-19,1966,0.023630638772829844
SIM,1946,25,30-34,1971,109
SIM,1897,39,35-39,1936,32
STAT,1914,16,30-34,1930,2.492387865627376
SIM,1852,87,na,1939,906
STAT,1896,46,15-19,1942,2.982805170700365E-4
STAT,1922,20,50-100,1942,0.7506050381616881
STAT,1884,7,na,1891,2494.0355578082576
STAT,1857,29,45-49,1886,0.8650204012460272
STAT,1896,32,40-44,1928,5.716783847827156
SIM,1922,16,30-34,1938,39
STAT,1825,37,35-39,1862,10.180319955481622
STAT,1856,30,45-49,1886,1.2944464753438985
STAT,1889,25,25-29,1914,51.28602578853753
SIM,1865,20,na,1885,1856
STAT,1947,25,25-29,1972,73.74428879619282
STAT,1926,33,40-44,1959,4.688418424466398
STAT,1827,46,na,1873,1804.7185972968614
STAT,1888,26,20-24,1914,13.586481021100168
STAT,1839,45,30-34,1884,0.09400893918096911
STAT,1833,24,15-19,1857,2.3333155718058594
STAT,1856,19,35-39,1875,0.4605385968637225
SIM,1769,87,na,1856,178
STAT,1867,30,20-24,1897,2.576912332557763
STAT,1808,86,na,1894,51.964230805878344
STAT,1877,26,45-49,1903,1.1309591720681056
STAT,1889,18,35-39,1907,0.6590380608092978
STAT,1912,37,na,1949,3629.3112106452068
STAT,1906,21,20-24,1927,100.09148600579707
STAT,1933,6,na,1939,5328.959986444147
STAT,1842,13,na,1855,757.54506
SIM,1926,27,20-24,1953,3
STAT,1890,62,na,1952,2212.664600516374
STAT,1938,25,30-34,1963,38.436158186008605
STAT,1817,46,na,1863,930.8327943450543
STAT,1953,18,25-29,1971,51.9355909711113
STAT,1869,42,50-100,1911,1.0647339823215407
STAT,1891,29,30-34,1920,30.74557978781711
STAT,1910,37,45-49,1947,0.6446981621945131
STAT,1892,74,na,1966,1697.266247730518
STAT,1892,16,35-39,1908,0.6810219087355969
STAT,1873,22,45-49,1895,0.7152982605464133
STAT,1888,58,na,1946,2282.471230374047
STAT,1863,102,na,1965,1.2030876196734122
SIM,1914,21,20-24,1935,2
STAT,1810,44,30-34,1854,0.006118198312411096
STAT,1910,56,na,1966,3263.0053576658925
STAT,1861,24,40-44,1885,1.754888656573109
SIM,1926,0,na,1926,6476
STAT,1935,27,20-24,1962,24.70346293577419
STAT,1898,48,25-29,1946,0.04314247305361347
STAT,1776,91,na,1867,33.57449475731119
STAT,1937,1,na,1938,4020.644012359925
SIM,1856,46,na,1902,461
STAT,1887,48,15-19,1935,4.347369109022975E-4
STAT,1918,27,20-24,1945,19.16420511478453
STAT,1806,51,na,1857,1045.2496690479568
SIM,1867,11,na,1878,2793
STAT,1768,118,na,1886,1.2541509668864397E-4
STAT,1921,37,20-24,1958,0.29085173319603086
STAT,1841,38,30-34,1879,6.920166700115798
SIM,1855,30,na,1885,3193
STAT,1865,28,40-44,1893,2.725296156113187
STAT,1865,25,50-100,1890,0.5879957117929965
STAT,1833,53,na,1886,894.9772284440629
SIM,1841,27,35-39,1868,1
STAT,1936,18,25-29,1954,40.969525976323794
STAT,1907,26,50-100,1933,0.9365762484520845
STAT,1833,27,35-39,1860,5.930674331218915
STAT,1898,37,35-39,1935,9.51107628433618
STAT,1911,22,40-44,1933,3.1529254021221833
STAT,1915,45,50-100,1960,0.22575052737227735
STAT,1854,30,50-100,1884,0.5326540460732165
STAT,1894,19,20-24,1913,22.423736041568993
STAT,1902,37,na,1939,3343.7720750342123
STAT,1851,15,35-39,1866,0.533156306951085
STAT,1893,59,na,1952,2430.3559823145047
STAT,1826,36,40-44,1862,7.340049874598088
STAT,1814,52,50-100,1866,0.04979750249533087
STAT,1906,17,35-39,1923,0.7945700100340252
STAT,1851,82,na,1933,368.50333848200023
STAT,1905,55,na,1960,3070.618101006067
SIM,1854,68,na,1922,347
STAT,1827,28,20-24,1855,13.708122532047945
STAT,1856,26,na,1882,1789.0754541695112
STAT,1856,37,30-34,1893,3.827988188290553
STAT,1831,29,25-29,1860,46.659290604909614
STAT,1850,53,35-39,1903,0.003911505214486043
SIM,1934,29,20-24,1963,11
STAT,1925,23,30-34,1948,33.982950760517525
STAT,1898,34,15-19,1932,0.18985846133650397
STAT,1882,33,na,1915,2275.037338944801
SIM,1891,77,na,1968,488
STAT,1862,15,45-49,1877,0.06447940557335724
STAT,1879,21,35-39,1900,6.0043410272415665
STAT,1888,33,45-49,1921,2.004162867885448
STAT,1915,26,40-44,1941,4.703089849507275
STAT,1863,41,50-100,1904,0.9059868768138828
STAT,1842,18,45-49,1860,0.020700761673551508
STAT,1893,27,40-44,1920,3.7460359897916056
STAT,1830,35,na,1865,1992.5432745668288
STAT,1856,23,20-24,1879,57.07297447996301
STAT,1882,16,25-29,1898,5.438708789751056
STAT,1956,16,35-39,1972,5.5055221158092165
SIM,1850,29,35-39,1879,7
STAT,1872,34,45-49,1906,1.731242873289078
STAT,1926,29,20-24,1955,21.53954719982474
STAT,1874,24,50-100,1898,0.41823212532420634
STAT,1930,16,15-19,1946,58.404627228596375
STAT,1882,43,50-100,1925,1.0041513297791913
STAT,1842,29,35-39,1871,2.919754519409584
STAT,1854,19,50-100,1873,0.03220322629016923
STAT,1851,27,35-39,1878,8.922724655552228
STAT,1857,44,20-24,1901,0.12022201851421208
STAT,1842,36,25-29,1878,0.8472011374330398
SIM,1887,62,na,1949,2675
SIM,1917,22,na,1939,833
SIM,1848,22,25-29,1870,10
STAT,1901,42,na,1943,3238.7786816060247
STAT,1833,39,35-39,1872,3.733366453878662
STAT,1853,25,45-49,1878,1.0118107509569676
STAT,1927,28,25-29,1955,79.08733437678967
STAT,1838,83,na,1921,169.30393452275632
STAT,1871,37,50-100,1908,1.2247269716276876
STAT,1852,26,40-44,1878,3.5374411147806066
STAT,1867,26,35-39,1893,9.156597266389658
STAT,1944,17,20-24,1961,144.25818015278753
SIM,1844,49,50-100,1893,2
SIM,1875,30,na,1905,3027
STAT,1889,36,50-100,1925,1.4855945461151816
STAT,1917,24,35-39,1941,9.811965283909737
SIM,1824,39,35-39,1863,5
STAT,1951,20,20-24,1971,131.70301712552282
STAT,1816,39,35-39,1855,24.771276667394535
STAT,1847,32,45-49,1879,1.8511518394913635
STAT,1821,49,50-100,1870,0.25572081408337155
STAT,1897,17,30-34,1914,2.1167414073532904
STAT,1892,46,30-34,1938,0.06779590138290814
STAT,1887,20,30-34,1907,19.722480066401637
STAT,1836,25,45-49,1861,1.1168865920729965
SIM,1937,27,30-34,1964,67
STAT,1885,38,50-100,1923,1.2008231903322277
STAT,1887,27,15-19,1914,0.4993782212841014
SIM,1850,36,25-29,1886,10
STAT,1851,72,na,1923,997.4250172772789
STAT,1926,28,50-100,1954,1.178798913508928
SIM,1937,22,na,1959,2563
STAT,1880,39,15-19,1919,0.057710373852756125
STAT,1842,22,15-19,1864,1.0329554768887024
STAT,1866,49,40-44,1915,0.15301167016147368
STAT,1835,65,na,1900,1278.7187856674566
STAT,1912,28,15-19,1940,0.6851861094438747
STAT,1873,60,na,1933,1956.3460476419725
STAT,1843,24,50-100,1867,0.4985046266759412
SIM,1850,22,15-19,1872,21
SIM,1918,28,25-29,1946,2
SIM,1833,83,na,1916,750
STAT,1901,39,45-49,1940,0.5955642354207654
STAT,1901,25,35-39,1926,13.582807553834831
SIM,1848,36,35-39,1884,102
STAT,1813,48,15-19,1861,0.0014417382821533796
STAT,1861,27,na,1888,1999.1547707314473
STAT,1929,27,30-34,1956,48.69440232186537
STAT,1844,20,25-29,1864,71.83724627838546
SIM,1931,37,na,1968,4963
STAT,1888,15,15-19,1903,6.88126660427751
STAT,1930,22,na,1952,4645.3485985226325
STAT,1936,22,45-49,1958,1.0650430211063753
SIM,1793,68,na,1861,863
SIM,1907,33,30-34,1940,68
STAT,1850,32,50-100,1882,0.44259147679460614
SIM,1913,36,25-29,1949,5
STAT,1908,45,40-44,1953,0.14356224579289306
STAT,1816,43,20-24,1859,0.5083144761171154
STAT,1921,38,50-100,1959,0.4627761089614635
STAT,1901,44,50-100,1945,0.10119153814392819
STAT,1817,49,45-49,1866,0.16100799441635066
STAT,1939,23,25-29,1962,91.71524259657552
STAT,1903,28,50-100,1931,0.9048541816237464
STAT,1929,23,15-19,1952,6.663769402939607
STAT,1851,27,na,1878,2000.457025177387
STAT,1891,25,15-19,1916,0.5617162441344085
STAT,1870,96,na,1966,33.2805231709022
STAT,1855,20,35-39,1875,4.5774261815187005
STAT,1898,58,na,1956,2681.278931889806
STAT,1865,20,45-49,1885,0.6537413915915156
STAT,1867,37,40-44,1904,4.13993601034237
STAT,1900,56,na,1956,2846.986715605915
STAT,1834,34,25-29,1868,5.663337327296936
STAT,1843,46,35-39,1889,0.13945666244470054
STAT,1843,94,na,1937,19.747138895596642
STAT,1883,34,20-24,1917,2.5781951776965784
STAT,1939,14,na,1953,3901.361960240918
STAT,1886,27,15-19,1913,0.46983171049046396
SIM,1842,34,25-29,1876,1
SIM,1880,82,na,1962,2623
STAT,1877,23,40-44,1900,2.1087804239907824
STAT,1847,47,30-34,1894,0.08711050559399329
STAT,1916,36,35-39,1952,2.4549083991164395
STAT,1824,34,15-19,1858,0.05839656159834914
SIM,1809,47,na,1856,802
SIM,1865,37,30-34,1902,1
SIM,1836,49,na,1885,1689
SIM,1875,37,40-44,1912,3
STAT,1865,41,na,1906,2119.68914761302
STAT,1926,36,45-49,1962,0.8267592901869824
STAT,1819,36,15-19,1855,0.029638512836913117
STAT,1874,28,35-39,1902,9.923282575478298
STAT,1924,15,na,1939,4361.233888049881
SIM,1916,45,40-44,1961,1
STAT,1908,22,na,1930,3481.1684487634834
STAT,1850,28,30-34,1878,13.58562379286721
STAT,1900,18,45-49,1918,0.09025322928320464
SIM,1866,56,na,1922,2670
SIM,1904,24,15-19,1928,1
SIM,1909,37,na,1946,3885
STAT,1843,53,na,1896,2093.2678979937536
STAT,1905,36,25-29,1941,0.8981455749446449
SIM,1851,16,na,1867,1433
STAT,1911,18,20-24,1929,26.754031627255205
SIM,1826,50,na,1876,1860
STAT,1866,24,50-100,1890,0.36990843792358213
STAT,1847,97,na,1944,4.857135341011829
STAT,1864,32,45-49,1896,1.5853194818465626
STAT,1881,21,40-44,1902,1.9737813016215633
STAT,1889,36,30-34,1925,6.44890112385318
STAT,1879,36,20-24,1915,0.7945735090751368
STAT,1933,21,15-19,1954,7.034187958506373
STAT,1806,49,35-39,1855,0.3991681019827753
STAT,1892,39,40-44,1931,5.365211760368948
SIM,1866,15,na,1881,3273
STAT,1951,17,na,1968,4342.268337162432
SIM,1905,6,na,1911,3894
STAT,1883,5,na,1888,2546.387612184103
SIM,1929,25,30-34,1954,71
STAT,1909,48,na,1957,3332.1726820438766
STAT,1875,28,35-39,1903,9.873147389419373
STAT,1886,26,na,1912,2479.845450887477
STAT,1825,48,40-44,1873,0.21462973420180628
STAT,1828,49,20-24,1877,0.013953545174552787
SIM,1847,42,na,1889,1520
STAT,1938,28,35-39,1966,14.707678818206672
STAT,1892,33,na,1925,2942.009098266622
SIM,1909,20,35-39,1929,17
STAT,1846,26,15-19,1872,0.32742388906201547
STAT,1856,26,25-29,1882,31.711584656914983
SIM,1890,27,30-34,1917,1
SIM,1880,27,20-24,1907,1
STAT,1941,22,50-100,1963,0.6722563975968908
STAT,1940,9,na,1949,3980.214413702876
SIM,1904,38,na,1942,4086
STAT,1903,23,45-49,1926,0.9867971381705598
SIM,1901,37,45-49,1938,6
SIM,1849,36,35-39,1885,1
STAT,1889,29,40-44,1918,3.581550699837044
STAT,1906,24,25-29,1930,82.37679054170577
STAT,1879,29,30-34,1908,25.647965690343565
SIM,1824,36,30-34,1860,7
SIM,1922,5,na,1927,3823
STAT,1883,59,na,1942,1869.696460203613
STAT,1862,67,na,1929,1350.1950600491002
SIM,1894,27,15-19,1921,1
STAT,1866,16,40-44,1882,0.1723834821430334
STAT,1943,29,20-24,1972,19.199669742545527
SIM,1926,16,15-19,1942,517
STAT,1810,47,35-39,1857,7.351598889812634E-4
STAT,1838,35,20-24,1873,0.40539403796594364
STAT,1856,16,30-34,1872,1.3616743417994122
STAT,1915,55,na,1970,3535.1038112721703
SIM,1810,105,na,1915,2
SIM,1893,48,na,1941,3003
STAT,1914,30,45-49,1944,1.5744901041553037
STAT,1848,35,30-34,1883,5.247343682153472
STAT,1854,49,15-19,1903,2.1776319831858602E-4
STAT,1875,35,50-100,1910,1.2726835068492288
SIM,1840,39,35-39,1879,7
STAT,1857,33,15-19,1890,0.10881700146270731
SIM,1859,22,35-39,1881,61
STAT,1890,52,na,1942,2592.835027581623
SIM,1898,36,30-34,1934,71
STAT,1832,39,35-39,1871,0.5743511151769822
SIM,1849,23,na,1872,2528
SIM,1861,57,na,1918,1737
SIM,1933,23,30-34,1956,10
SIM,1883,48,na,1931,2094
STAT,1875,85,na,1960,411.0265805229663
SIM,1896,15,15-19,1911,86
STAT,1882,27,30-34,1909,24.109409166447016
STAT,1941,16,40-44,1957,1.424721842092746
SIM,1898,47,na,1945,4080
STAT,1918,49,15-19,1967,3.8444977615749193E-4
STAT,1931,26,25-29,1957,84.41759086170033
SIM,1822,36,na,1858,1536
SIM,1824,43,20-24,1867,3
STAT,1896,44,50-100,1940,0.09540275620005349
STAT,1839,48,35-39,1887,0.13083672110513594
STAT,1851,45,30-34,1896,0.07721411404608809
STAT,1817,91,na,1908,18.3572557187213
STAT,1916,43,25-29,1959,0.0720663207825775
STAT,1812,108,na,1920,1.4506257907451515E-4
SIM,1906,8,na,1914,3684
STAT,1834,27,35-39,1861,5.5761070888679924
SIM,1836,49,20-24,1885,1
STAT,1799,64,na,1863,168.52901520779443
STAT,1839,30,45-49,1869,2.035590158335607
STAT,1829,27,na,1856,1042.4633328562913
STAT,1829,30,35-39,1859,5.884156996235615
STAT,1880,18,15-19,1898,6.144838540386272
STAT,1896,21,35-39,1917,7.715721215033209
STAT,1947,22,20-24,1969,124.3468151527963
STAT,1864,102,na,1966,1.4563525005470719
STAT,1925,30,20-24,1955,2.8732392980360597
STAT,1860,86,na,1946,181.00485317684542
STAT,1888,2,na,1890,3076.607943688501
STAT,1915,29,45-49,1944,1.7248180416499415
STAT,1839,27,na,1866,2531.92344931719
STAT,1864,25,20-24,1889,10.779128609757388
SIM,1810,55,na,1865,3098
SIM,1846,28,30-34,1874,1
STAT,1898,45,20-24,1943,0.00919313434996394
SIM,1867,31,25-29,1898,16
STAT,1884,47,35-39,1931,0.13339333638458925
STAT,1873,44,50-100,1917,1.0690590822209844
STAT,1844,24,40-44,1868,2.5406650959721344
STAT,1929,14,na,1943,5004.984386052102
STAT,1824,38,30-34,1862,0.8518148731019128
SIM,1934,18,15-19,1952,123
STAT,1876,26,na,1902,2420.834766819093
STAT,1888,30,40-44,1918,5.0455139282476225
STAT,1864,45,na,1909,2065.7352904957684
STAT,1880,29,20-24,1909,12.092012380859066
STAT,1857,47,25-29,1904,0.04399395483409424
SIM,1861,16,na,1877,2602
STAT,1851,38,40-44,1889,3.458246518461427
STAT,1901,36,40-44,1937,1.3274558753357923
SIM,1850,26,30-34,1876,203
STAT,1840,20,40-44,1860,1.058590491295013
STAT,1929,41,45-49,1970,0.2143302556252993
SIM,1831,27,25-29,1858,1
STAT,1871,16,15-19,1887,5.993508448696681
SIM,1910,45,na,1955,3892
STAT,1848,17,35-39,1865,0.6365196909159679
STAT,1904,26,15-19,1930,0.6504274358308726
STAT,1907,26,na,1933,3494.118458208053
SIM,1881,44,50-100,1925,3
STAT,1856,71,na,1927,958.7252860843485
STAT,1917,9,na,1926,4212.823471165711
STAT,1926,18,15-19,1944,55.02059246711605
SIM,1896,30,40-44,1926,68
STAT,1824,80,na,1904,119.71305423368109
STAT,1890,8,na,1898,3147.029567426573
STAT,1903,49,20-24,1952,0.009408049136752496
STAT,1819,54,50-100,1873,0.0025640952180838337
STAT,1879,46,15-19,1925,4.115006110042034E-4
STAT,1906,41,na,1947,3373.5946041584084
STAT,1841,15,25-29,1856,8.235318247714806
STAT,1887,73,na,1960,1464.7653280346362
STAT,1846,37,20-24,1883,0.47675979304917615
STAT,1797,86,na,1883,2.9684575884985227
SIM,1882,63,na,1945,1326
STAT,1863,18,50-100,1881,0.043175055779221344
STAT,1905,42,50-100,1947,0.10538842898191977
STAT,1849,78,na,1927,658.344591970922
SIM,1860,31,na,1891,1925
SIM,1908,46,45-49,1954,1
STAT,1918,16,15-19,1934,9.800837133225723
STAT,1861,27,45-49,1888,0.9300842944974491
STAT,1878,33,35-39,1911,10.3754566477965
STAT,1868,29,20-24,1897,11.250081667963858
STAT,1890,18,25-29,1908,6.8422089636518715
STAT,1872,16,15-19,1888,5.997492078875455
STAT,1950,21,50-100,1971,0.7734131517405884
STAT,1883,27,30-34,1910,24.226075298714086
STAT,1838,28,30-34,1866,13.575899607198911
STAT,1850,24,15-19,1874,1.802258134761749
STAT,1936,15,20-24,1951,129.10818203058597
STAT,1836,22,40-44,1858,2.1073483493082903
STAT,1892,49,35-39,1941,0.0957328707720634
STAT,1852,15,35-39,1867,0.675954235266688
SIM,1940,11,na,1951,4299
STAT,1914,23,20-24,1937,111.67626611919145
STAT,1917,21,30-34,1938,30.229816079567673
STAT,1913,38,25-29,1951,0.9547199930941174
STAT,1816,61,na,1877,1914.674349714868
SIM,1854,37,20-24,1891,1
STAT,1893,16,35-39,1909,0.6878613079994561
STAT,1854,0,na,1854,2238.1404892693085
STAT,1945,21,na,1966,3959.4304603603723
STAT,1849,42,20-24,1891,0.13364982324398803
SIM,1856,7,na,1863,1435
STAT,1842,33,20-24,1875,0.8022344571180403
STAT,1934,35,40-44,1969,2.0553665791313938
SIM,1878,42,40-44,1920,20
STAT,1843,39,45-49,1882,2.0494442324438644
SIM,1834,25,35-39,1859,33
SIM,1906,48,35-39,1954,1
STAT,1842,26,30-34,1868,7.786534144647821
SIM,1874,34,na,1908,2425
SIM,1921,38,25-29,1959,7
STAT,1866,26,na,1892,2185.9389877340313
STAT,1837,32,35-39,1869,10.180986583063726
STAT,1923,28,40-44,1951,5.276451989570598
STAT,1867,8,na,1875,2608.9767713460424
STAT,1864,18,30-34,1882,1.4901259182644222
SIM,1931,28,40-44,1959,9
STAT,1782,87,na,1869,172.89177162571627
STAT,1865,39,30-34,1904,4.816884227722381
STAT,1897,27,25-29,1924,56.17848403019465
STAT,1849,35,30-34,1884,4.691558674455358
STAT,1823,34,15-19,1857,0.29056267851344814
STAT,1948,22,20-24,1970,126.36713692568239
SIM,1896,22,na,1918,3834
STAT,1918,34,45-49,1952,1.6354645874981033
STAT,1885,25,40-44,1910,2.964463987495829
STAT,1854,28,15-19,1882,0.26255886600485123
SIM,1846,49,na,1895,900
SIM,1873,39,30-34,1912,12
STAT,1859,31,25-29,1890,8.151388729999912
STAT,1852,22,25-29,1874,68.4531208496858
STAT,1875,35,25-29,1910,2.9845883595340514
STAT,1879,44,na,1923,2338.958301475252
STAT,1940,20,45-49,1960,1.1341292764402677
STAT,1894,11,na,1905,3288.9703416516068
STAT,1903,16,20-24,1919,25.22765690545089
STAT,1907,31,15-19,1938,0.11979864763847521
SIM,1860,22,25-29,1882,17
STAT,1869,21,40-44,1890,2.1090820836566353
STAT,1839,45,15-19,1884,3.8846636349910784E-4
STAT,1833,24,30-34,1857,12.59817365343845
STAT,1845,26,15-19,1871,0.27601112517238074
STAT,1911,25,45-49,1936,1.6771152224457626
SIM,1927,22,na,1949,1766
STAT,1850,50,30-34,1900,0.0027881585193130685
STAT,1903,23,na,1926,3346.839230978584
STAT,1848,93,na,1941,27.34837973154221
STAT,1890,25,15-19,1915,0.5529819223686492
STAT,1933,17,45-49,1950,0.6641689785127768
SIM,1870,31,na,1901,2434
STAT,1942,26,35-39,1968,15.584574504102545
STAT,1841,72,na,1913,1406.3155960656343
STAT,1868,39,15-19,1907,0.053692172856186514
STAT,1860,16,45-49,1876,0.06182411947606923
STAT,1810,69,na,1879,51.58011639627242
STAT,1841,35,20-24,1876,1.0325754239804592
STAT,1925,45,na,1970,4431.781256271857
SIM,1901,63,na,1964,2787
SIM,1859,67,na,1926,1272
STAT,1815,43,25-29,1858,0.06708217356333736
STAT,1910,48,15-19,1958,3.389000184775399E-4
STAT,1849,39,40-44,1888,3.6966846444902877
STAT,1861,34,35-39,1895,8.349996436858415
STAT,1847,14,na,1861,2669.4187393168854
STAT,1877,41,35-39,1918,1.8465113066392773
STAT,1855,45,20-24,1900,0.008021216675158682
SIM,1892,7,na,1899,3699
STAT,1814,59,na,1873,1676.8855853683917
STAT,1865,27,50-100,1892,0.5840334371863571
STAT,1886,47,45-49,1933,0.24325046569175657
STAT,1864,35,15-19,1899,0.05153528991321619
STAT,1921,31,na,1952,4175.93949936913
STAT,1835,24,40-44,1859,2.065818097705883
SIM,1892,61,na,1953,3403
STAT,1872,32,45-49,1904,1.7461930813715034
STAT,1890,44,50-100,1934,1.2616849315865422
STAT,1832,40,20-24,1872,0.013594168949005099
STAT,1845,26,20-24,1871,7.136859036519537
STAT,1946,17,15-19,1963,49.792638636408974
STAT,1885,18,45-49,1903,0.06404048754438867
STAT,1856,50,na,1906,1568.7444964177746
STAT,1798,71,na,1869,918.4911275134374
SIM,1885,41,35-39,1926,12
STAT,1853,20,50-100,1873,0.3790221934162168
STAT,1839,70,na,1909,1303.5486755899283
STAT,1882,34,25-29,1916,9.722416204009916
STAT,1936,31,40-44,1967,3.765526053530478
STAT,1877,52,45-49,1929,0.014653421607985013
STAT,1850,44,30-34,1894,0.5237069261545879
STAT,1945,24,45-49,1969,1.2187269487664336
STAT,1882,23,15-19,1905,3.1487596261533013
STAT,1884,31,25-29,1915,9.845031678914768
SIM,1848,33,30-34,1881,6
SIM,1922,33,na,1955,3356
STAT,1946,15,na,1961,4040.5134330057203
STAT,1892,41,30-34,1933,1.4298376816459994
STAT,1872,13,na,1885,2623.579952744538
STAT,1896,49,25-29,1945,0.041936550605914946
STAT,1912,27,50-100,1939,0.9694824157469586
STAT,1861,42,40-44,1903,1.8682914024964952
STAT,1824,38,25-29,1862,0.4601758484600191
STAT,1875,44,35-39,1919,1.834339233748792
SIM,1890,34,25-29,1924,11
STAT,1858,24,35-39,1882,4.586282663209002
STAT,1856,16,25-29,1872,4.841198728526103
STAT,1817,40,25-29,1857,0.4874708841780855
STAT,1826,46,35-39,1872,0.2030338381018954
STAT,1926,15,50-100,1941,0.4575240982099249
STAT,1836,53,40-44,1889,0.008002350221702228
STAT,1810,45,na,1855,93.76270809064141
STAT,1852,41,30-34,1893,1.1624784112453133
STAT,1823,95,na,1918,10.503169290526666
STAT,1833,27,40-44,1860,1.841211077288121
SIM,1854,36,na,1890,1665
SIM,1857,37,45-49,1894,124
STAT,1866,35,25-29,1901,2.653145259122922
SIM,1821,41,na,1862,2015
STAT,1808,53,35-39,1861,0.010828809212767843
SIM,1891,32,20-24,1923,3
STAT,1893,37,35-39,1930,8.844885055350266
SIM,1815,39,50-100,1854,1
STAT,1820,41,40-44,1861,3.781280768764538
STAT,1851,23,40-44,1874,1.9512670167242725
STAT,1874,28,40-44,1902,3.080738678374819
STAT,1893,40,35-39,1933,2.287322356408421
SIM,1890,23,15-19,1913,2
SIM,1836,29,25-29,1865,131
STAT,1844,57,na,1901,1990.919113110604
STAT,1832,48,30-34,1880,0.008664806055068431
STAT,1879,37,30-34,1916,5.467293239112642
STAT,1831,28,15-19,1859,0.5168081605352493
STAT,1880,39,20-24,1919,0.7922059413976482
STAT,1869,47,15-19,1916,4.017506585170373E-4
STAT,1838,45,15-19,1883,1.8022842165048926E-4
SIM,1855,29,35-39,1884,52
STAT,1843,30,25-29,1873,12.421671351558057
STAT,1889,77,na,1966,1395.3122057310486
SIM,1806,52,na,1858,129
STAT,1883,32,20-24,1915,2.600459271879066
STAT,1834,26,45-49,1860,0.6462834934920725
STAT,1841,33,25-29,1874,13.69569392115394
STAT,1871,79,na,1950,697.3879892129223
STAT,1833,47,35-39,1880,0.07030059664015896
SIM,1943,19,na,1962,4044
SIM,1869,77,na,1946,3268
STAT,1919,34,45-49,1953,1.6608164692950582
STAT,1931,39,45-49,1970,0.8945936083559585
STAT,1849,54,35-39,1903,0.007054445248541336
SIM,1872,38,25-29,1910,13
STAT,1927,36,na,1963,4643.671639667404
STAT,1853,20,40-44,1873,1.9368032674470819
STAT,1864,38,25-29,1902,2.6045130853710092
STAT,1847,29,35-39,1876,10.335482597031138
STAT,1889,21,na,1910,2856.6492080222088
STAT,1831,31,15-19,1862,0.15371087000912878
STAT,1813,48,20-24,1861,0.0432521865106649
STAT,1841,22,15-19,1863,4.653818272699369
STAT,1899,25,35-39,1924,13.268567490405982
STAT,1877,44,na,1921,2314.5173974523223
STAT,1904,20,40-44,1924,2.9948924630113787
SIM,1908,31,30-34,1939,3
STAT,1896,18,20-24,1914,23.30902758371563
STAT,1897,72,na,1969,2050.264229364283
STAT,1881,89,na,1970,293.2270794972477
STAT,1864,26,30-34,1890,22.97158277028807
STAT,1845,46,45-49,1891,0.117439703822965
STAT,1870,35,45-49,1905,2.0062472670315423
STAT,1882,36,20-24,1918,0.7415707571947676
STAT,1836,23,45-49,1859,0.700135459828649
STAT,1887,43,15-19,1930,0.015090306990112679
STAT,1898,26,30-34,1924,33.97873075423202
STAT,1828,29,25-29,1857,72.20836090309922
STAT,1866,51,30-34,1917,0.005459596282523501
STAT,1823,104,na,1927,0.05269149725936659
SIM,1853,26,20-24,1879,2
STAT,1881,35,20-24,1916,0.7348628481672322
STAT,1821,40,45-49,1861,1.7496680144348093
STAT,1920,49,40-44,1969,0.1710325382762037
STAT,1847,23,20-24,1870,75.8313921380883
STAT,1880,26,15-19,1906,0.4726297053118522
STAT,1815,45,20-24,1860,0.0012491056222120847
STAT,1829,27,20-24,1856,8.750464556820967
STAT,1871,33,40-44,1904,4.307807924221319
SIM,1851,30,25-29,1881,7
STAT,1909,47,50-100,1956,0.20571955911789738
STAT,1897,17,25-29,1914,7.525709705563997
SIM,1905,53,na,1958,2737
STAT,1868,44,50-100,1912,1.006622659365598
STAT,1879,15,50-100,1894,0.05049132635120419
STAT,1931,41,na,1972,4933.757348677252
STAT,1889,40,15-19,1929,0.01679794640412514
STAT,1865,39,25-29,1904,2.6022247983930553
STAT,1934,29,50-100,1963,1.3286079906410309
STAT,1884,14,na,1898,2464.1613630092907
SIM,1855,61,na,1916,2860
SIM,1890,36,20-24,1926,13
STAT,1920,38,30-34,1958,1.9678559855431026
STAT,1874,25,30-34,1899,26.16571601257302
STAT,1857,25,30-34,1882,20.192552030846787
STAT,1878,17,15-19,1895,6.105876697726074
STAT,1899,42,25-29,1941,0.06083272554425089
STAT,1891,45,30-34,1936,0.06781662919716686
STAT,1847,53,50-100,1900,0.013435411826632559
SIM,1912,47,na,1959,4526
STAT,1839,48,40-44,1887,0.1599946185824575
STAT,1903,49,40-44,1952,0.1342214958015122
SIM,1827,36,20-24,1863,12
SIM,1812,42,40-44,1854,3
STAT,1867,47,35-39,1914,0.1317849431045494
STAT,1814,44,20-24,1858,0.5403733928122483
STAT,1839,49,25-29,1888,0.05314470926070744
SIM,1926,15,na,1941,6267
STAT,1874,45,30-34,1919,0.10090003880846932
STAT,1878,50,40-44,1928,0.010987228935247813
STAT,1917,31,30-34,1948,16.344397547679257
STAT,1809,54,35-39,1863,0.06824998323375399
STAT,1843,49,45-49,1892,0.2283099673784207
STAT,1851,52,25-29,1903,0.0027825631827078337
STAT,1827,77,na,1904,609.5620422411026
STAT,1867,50,35-39,1917,0.008258847840128676
STAT,1814,45,50-100,1859,0.8623635089480043
STAT,1825,33,40-44,1858,7.108984777141876
STAT,1886,18,50-100,1904,0.05060062300422881
STAT,1828,33,50-100,1861,1.3424702682020062
STAT,1862,41,45-49,1903,1.2805177794859415
STAT,1871,36,45-49,1907,1.9981611544731308
STAT,1834,43,35-39,1877,0.9498383962307321
SIM,1933,17,na,1950,4431
STAT,1825,51,50-100,1876,0.018895795427972165
SIM,1888,17,25-29,1905,18
SIM,1909,35,na,1944,3991
STAT,1834,28,40-44,1862,1.7187041502694007
STAT,1876,45,35-39,1921,0.14293808940983174
STAT,1873,19,35-39,1892,0.559836184310877
SIM,1922,25,na,1947,3451
SIM,1865,25,30-34,1890,78
STAT,1845,46,15-19,1891,1.990501779253507E-4
STAT,1935,31,na,1966,5197.808658386295
STAT,1865,36,20-24,1901,0.7071654716700125
SIM,1913,40,na,1953,2977
STAT,1807,54,30-34,1861,0.01820001793244541
STAT,1876,25,40-44,1901,3.0487841797871322
STAT,1849,37,45-49,1886,1.7187729187522478
STAT,1905,49,45-49,1954,0.18747664416874865
STAT,1890,28,25-29,1918,51.030146899890795
SIM,1810,97,na,1907,135
STAT,1868,31,40-44,1899,4.205825796574722
STAT,1860,18,40-44,1878,0.17107437484110338
STAT,1884,19,40-44,1903,0.17414908779570443
STAT,1927,20,35-39,1947,11.575076520542884
STAT,1938,0,na,1938,4396.471408550288
STAT,1881,57,na,1938,1897.7905437192126
SIM,1821,49,na,1870,1898
STAT,1850,28,50-100,1878,0.3451137612332653
SIM,1892,53,na,1945,3403
STAT,1809,80,na,1889,650.3981522785363
STAT,1886,27,20-24,1913,12.148505559560801
STAT,1928,21,35-39,1949,11.702080004778807
SIM,1833,22,30-34,1855,1
STAT,1851,43,35-39,1894,1.4198360665642016
SIM,1894,27,20-24,1921,5
STAT,1938,23,15-19,1961,5.210229846287477
STAT,1926,21,30-34,1947,34.7223476094979
STAT,1823,37,25-29,1860,5.409735139319613
STAT,1903,38,30-34,1941,1.6248248355060744
STAT,1881,22,15-19,1903,3.115425969571112
STAT,1897,24,50-100,1921,0.5381765409777484
STAT,1819,36,20-24,1855,0.40685589775419023
STAT,1869,30,50-100,1899,0.9319985873583514
STAT,1800,59,na,1859,1724.4924923735455
STAT,1881,19,15-19,1900,5.57422515965658
STAT,1877,24,45-49,1901,0.703433957610386
STAT,1885,46,45-49,1931,0.23263467187994355
STAT,1886,47,15-19,1933,4.1228857788468284E-4
STAT,1850,28,25-29,1878,22.82159788170843
STAT,1844,17,45-49,1861,0.08226294818584332
SIM,1858,26,na,1884,2206
STAT,1835,44,35-39,1879,1.60013603080401
SIM,1862,31,na,1893,3802
STAT,1846,100,na,1946,0.6287708074791657
STAT,1855,42,50-100,1897,0.6983375621988915
STAT,1861,17,45-49,1878,0.06244030632787832
STAT,1830,35,45-49,1865,1.8564755023280142
STAT,1880,26,45-49,1906,1.1566217760906627
STAT,1826,52,na,1878,1884.9070536041954
STAT,1883,15,30-34,1898,1.5404955203090076
SIM,1854,44,na,1898,1595
STAT,1882,30,50-100,1912,0.884274134955653
SIM,1872,33,na,1905,2405
STAT,1847,51,20-24,1898,6.70357562169637E-4
STAT,1858,24,50-100,1882,0.3204949825298919
STAT,1879,50,50-100,1929,0.015715643141356306
SIM,1829,69,na,1898,1463
STAT,1825,53,35-39,1878,0.010352325135402482
STAT,1782,110,na,1892,0.0024310078344210173
STAT,1851,59,na,1910,1534.9335517173495
SIM,1809,49,na,1858,612
STAT,1841,54,50-100,1895,0.01635541263801502
STAT,1943,21,30-34,1964,30.239610056616343
SIM,1879,27,25-29,1906,9
STAT,1923,33,50-100,1956,0.9372846188735706
STAT,1856,46,20-24,1902,0.008643514048667478
SIM,1884,45,35-39,1929,2
SIM,1841,44,30-34,1885,3
STAT,1891,29,25-29,1920,51.64748187167786
STAT,1848,50,25-29,1898,0.0033621566544355997
STAT,1944,20,35-39,1964,10.058991342972343
SIM,1880,84,na,1964,2623
STAT,1840,67,na,1907,624.1868040714344
STAT,1937,21,50-100,1958,0.6343444133837134
SIM,1868,37,20-24,1905,2
STAT,1885,31,na,1916,2355.2086180562555
STAT,1850,27,40-44,1877,1.6277929552328048
STAT,1856,44,25-29,1900,0.45500581188477085
STAT,1872,29,15-19,1901,0.45107228505507435
STAT,1901,11,na,1912,3616.2917545900996
SIM,1851,18,40-44,1869,3
SIM,1867,62,na,1929,1256
STAT,1871,19,25-29,1890,5.622494003717637
STAT,1892,44,35-39,1936,0.15358464890160164
STAT,1854,19,25-29,1873,3.7248405926742696
STAT,1950,20,na,1970,4293.896924570933
STAT,1838,36,30-34,1874,2.773903305327523
STAT,1870,52,35-39,1922,0.008536966455693282
STAT,1909,21,25-29,1930,85.23196219679298
STAT,1840,37,25-29,1877,1.3408863181271566
STAT,1905,25,na,1930,3455.873173738113
STAT,1889,39,40-44,1928,5.2184431045243125
STAT,1900,20,50-100,1920,0.5682766608207686
STAT,1830,65,na,1895,1223.148100786402
STAT,1879,49,25-29,1928,0.05785465429406761
STAT,1843,18,40-44,1861,0.22958287498722263
SIM,1884,66,na,1950,3459
STAT,1872,32,15-19,1904,0.14260129039408473
STAT,1896,23,na,1919,3108.041167878459
SIM,1813,54,na,1867,100
SIM,1913,1,na,1914,4026
SIM,1880,29,15-19,1909,3
STAT,1895,37,15-19,1932,0.07304992395175493
SIM,1939,30,20-24,1969,20
STAT,1918,1,na,1919,4484.11573157238
SIM,1846,36,30-34,1882,4
STAT,1866,34,40-44,1900,3.924743720327058
STAT,1824,54,30-34,1878,9.649692452305372E-4
STAT,1897,64,na,1961,2451.824533856779
SIM,1897,39,40-44,1936,1
STAT,1828,46,15-19,1874,4.839393204611446E-4
STAT,1902,42,50-100,1944,0.10317854163720144
STAT,1805,98,na,1903,0.4358338324634299
STAT,1832,43,25-29,1875,0.05705356541111327
STAT,1855,48,25-29,1903,0.037642778957819305
STAT,1883,80,na,1963,834.5146838735955
STAT,1916,22,25-29,1938,95.47032911695311
STAT,1940,29,45-49,1969,1.7402036173156494
SIM,1939,25,25-29,1964,292
STAT,1882,31,20-24,1913,2.598512117775438
STAT,1848,109,na,1957,9.173815111975318E-4
STAT,1894,41,35-39,1935,2.313156141588056
STAT,1813,105,na,1918,0.021478155192814073
STAT,1940,31,50-100,1971,0.8465881786236871
SIM,1912,55,na,1967,4354
SIM,1930,12,na,1942,5599
STAT,1857,33,30-34,1890,13.341374394386877
SIM,1945,10,na,1955,6355
STAT,1918,43,na,1961,3889.3014595986824
STAT,1939,13,na,1952,3907.966423496627
STAT,1846,42,45-49,1888,0.8971322537906458
STAT,1884,47,50-100,1931,0.23401002368983964
STAT,1961,2,na,1963,5037.357061440638
STAT,1834,40,25-29,1874,0.35003329272600653
STAT,1897,32,na,1929,3169.1450203184245
STAT,1862,11,na,1873,2339.3697524852696
STAT,1839,16,25-29,1855,6.927882975368198
STAT,1839,78,na,1917,725.9097268482775
STAT,1883,18,40-44,1901,0.17549962581691295
STAT,1835,52,40-44,1887,0.008117707401136771
STAT,1794,65,na,1859,9.958970729629918
STAT,1918,49,30-34,1967,0.09303692422525503
STAT,1898,43,20-24,1941,0.014722815704822029
STAT,1849,51,30-34,1900,0.005039567457222424
STAT,1818,65,na,1883,1119.525134629984
STAT,1858,41,25-29,1899,0.49261131043818496
STAT,1890,49,30-34,1939,0.06472292278019637
SIM,1873,34,25-29,1907,16
STAT,1878,29,50-100,1907,0.6534558251607804
STAT,1833,44,30-34,1877,0.5825408911916814
STAT,1827,50,35-39,1877,0.007926654239161899
STAT,1830,97,na,1927,3.8882802953855853
STAT,1858,5,na,1863,2243.133026750877
STAT,1888,44,15-19,1932,0.015723660130811886
STAT,1863,52,na,1915,1828.4001267635222
STAT,1855,36,30-34,1891,3.5442860871524107
STAT,1919,31,40-44,1950,4.182981315711685
STAT,1874,29,25-29,1903,43.34584882719732
SIM,1895,58,na,1953,4395
STAT,1788,93,na,1881,2.79745615779873
STAT,1815,40,20-24,1855,0.01745214872937204
SIM,1854,42,45-49,1896,1
SIM,1947,3,na,1950,4409
STAT,1860,30,25-29,1890,8.423001799469466
STAT,1822,38,20-24,1860,1.500054338074869
SIM,1870,26,20-24,1896,4
SIM,1842,40,25-29,1882,16
STAT,1862,43,40-44,1905,1.9019611928172635
STAT,1830,48,50-100,1878,0.2072172782878669
STAT,1862,26,20-24,1888,10.10152305741154
STAT,1834,47,na,1881,1051.5119833952024
STAT,1854,16,20-24,1870,11.861639576093534
SIM,1870,43,40-44,1913,1
STAT,1882,39,30-34,1921,5.051237125076244
STAT,1835,27,45-49,1862,1.0948757170340537
SIM,1890,39,30-34,1929,15
STAT,1904,23,45-49,1927,0.9931820508472964
STAT,1869,27,15-19,1896,0.45782301331308034
STAT,1860,87,na,1947,143.72690366507405
STAT,1847,35,15-19,1882,0.053781829824408996
SIM,1817,44,na,1861,2812
SIM,1882,29,25-29,1911,1
STAT,1848,38,40-44,1886,4.177768351347885
STAT,1868,51,35-39,1919,0.008355024644384578
STAT,1826,30,25-29,1856,24.4836067614437
SIM,1898,26,na,1924,4029
STAT,1876,33,50-100,1909,0.922331256231371
STAT,1891,28,40-44,1919,3.6707643141805373
SIM,1830,29,30-34,1859,3
SIM,1832,42,50-100,1874,9
STAT,1834,23,40-44,1857,1.2194115883044836
STAT,1845,98,na,1943,1.6119813989126852
SIM,1810,65,na,1875,3098
STAT,1826,60,na,1886,1608.7912861013565
SIM,1864,46,na,1910,2415
SIM,1906,9,na,1915,3684
STAT,1841,18,30-34,1859,2.2756426139556454
SIM,1872,41,na,1913,2362
STAT,1891,24,25-29,1915,69.95587957171767
STAT,1836,20,40-44,1856,3.312250264306906
STAT,1931,36,40-44,1967,1.970424552104528
STAT,1871,31,45-49,1902,1.7466475733544276
SIM,1814,79,na,1893,21
STAT,1824,37,40-44,1861,0.6912085410001539
STAT,1875,41,30-34,1916,1.1858810431926476
STAT,1881,38,25-29,1919,2.705477362265841
STAT,1838,48,25-29,1886,0.02497433623355319
STAT,1849,24,50-100,1873,0.4094797238526705
STAT,1820,44,45-49,1864,2.384755669617087
STAT,1833,54,na,1887,877.4267250964867
SIM,1832,33,na,1865,2223
STAT,1861,45,45-49,1906,0.19822444296781308
SIM,1876,23,na,1899,3164
STAT,1847,26,25-29,1873,46.30150180467234
STAT,1864,23,20-24,1887,63.19916457681454
STAT,1883,51,30-34,1934,0.005754009387934498
STAT,1808,50,30-34,1858,0.008004326119732865
STAT,1875,27,45-49,1902,1.1401172305502327
STAT,1815,48,25-29,1863,0.005761527705480438
STAT,1800,67,na,1867,1302.2869081532194
STAT,1830,30,45-49,1860,1.6723530757314733
STAT,1842,31,20-24,1873,0.8190690211405335
STAT,1852,44,35-39,1896,1.7981396788268191
STAT,1892,9,na,1901,3212.3992279461418
STAT,1844,45,45-49,1889,0.2374896310522376
STAT,1876,28,45-49,1904,1.1184634458539737
SIM,1842,43,na,1885,3114
STAT,1836,36,20-24,1872,0.7325996450753912
SIM,1875,35,50-100,1910,8
STAT,1841,30,20-24,1871,3.728704033254976
STAT,1814,47,25-29,1861,0.1969123300848072
STAT,1895,17,20-24,1912,23.062558589371424
SIM,1847,74,na,1921,1382
STAT,1893,21,25-29,1914,71.80335793512647
SIM,1924,22,25-29,1946,2
STAT,1904,38,50-100,1942,0.3767229754805841
STAT,1861,31,30-34,1892,14.579589935413297
STAT,1888,36,15-19,1924,0.0651234984655141
STAT,1859,28,45-49,1887,0.8887804453712708
STAT,1886,80,na,1966,961.7939756627017
SIM,1855,26,25-29,1881,342
STAT,1832,32,15-19,1864,0.009305948540464185
STAT,1945,21,40-44,1966,3.6456074282428284
STAT,1925,39,20-24,1964,0.3128274141672334
SIM,1840,43,25-29,1883,1
STAT,1828,26,20-24,1854,26.64029510613098
SIM,1809,57,na,1866,612
SIM,1824,38,na,1862,2129
STAT,1846,72,na,1918,747.9632269988942
SIM,1868,41,35-39,1909,3
STAT,1824,33,25-29,1857,4.345562114352887
STAT,1914,39,45-49,1953,0.6644344634970119
STAT,1860,18,50-100,1878,0.0458234821178823
STAT,1905,33,na,1938,3446.868631101792
STAT,1921,46,25-29,1967,0.05923685002262126
STAT,1890,16,30-34,1906,1.9342889412446658
SIM,1849,24,35-39,1873,3
STAT,1936,34,45-49,1970,1.5113130764118226
STAT,1863,39,20-24,1902,0.6514598587108679
STAT,1902,68,na,1970,2507.4268013160736
STAT,1808,55,na,1863,690.05078549345
STAT,1826,49,45-49,1875,0.32887825679129645
STAT,1918,30,35-39,1948,9.656812856717611
STAT,1900,41,35-39,1941,0.1749831559756002
SIM,1896,43,na,1939,3235
STAT,1847,46,na,1893,2039.894434981229
STAT,1843,51,30-34,1894,0.005909525387578953
STAT,1892,25,25-29,1917,52.72844470886096
STAT,1860,105,na,1965,0.1401866285190636
STAT,1905,46,40-44,1951,0.13929449828742296
STAT,1838,85,na,1923,116.91072553899681
STAT,1876,53,40-44,1929,0.010471608918430025
SIM,1792,75,na,1867,282
SIM,1805,54,50-100,1859,1
STAT,1854,24,na,1878,1376.8548759620503
STAT,1937,30,45-49,1967,1.5424691048284218
SIM,1930,20,na,1950,5518
SIM,1833,34,25-29,1867,11
SIM,1874,30,25-29,1904,8
STAT,1843,32,na,1875,2574.3048746948853
STAT,1809,51,30-34,1860,0.05016784279194274
STAT,1858,38,na,1896,1790.2517420557454
STAT,1913,20,na,1933,3673.2738982798032
STAT,1892,15,50-100,1907,0.060938361928866557
STAT,1909,4,na,1913,3904.994178048236
STAT,1886,42,45-49,1928,1.5479377720412115
STAT,1854,16,15-19,1870,3.9706335920465556
STAT,1819,40,35-39,1859,0.40630285301838254
STAT,1847,22,na,1869,2369.8136710788776
STAT,1819,51,45-49,1870,0.0025892260157352855
SIM,1885,51,na,1936,1131
STAT,1821,42,40-44,1863,2.5338371861018123
STAT,1850,23,25-29,1873,31.499466497756593
STAT,1855,17,20-24,1872,13.955695449901336
SIM,1853,30,35-39,1883,108
STAT,1825,34,25-29,1859,15.937617477914253
STAT,1913,38,50-100,1951,0.4071102083437012
STAT,1853,40,35-39,1893,1.4182522591017628
STAT,1898,34,30-34,1932,23.2773627336221
STAT,1912,27,na,1939,3648.794466840757
STAT,1816,82,na,1898,393.90123270852655
STAT,1853,23,45-49,1876,0.6342672482673409
STAT,1849,34,40-44,1883,3.7713504336812274
SIM,1890,38,na,1928,3679
STAT,1816,41,20-24,1857,0.536141710911003
STAT,1871,49,50-100,1920,0.23988137034527185
SIM,1940,19,na,1959,4229
SIM,1920,42,na,1962,3712
SIM,1891,15,30-34,1906,33
STAT,1861,34,50-100,1895,0.7554653139671355
SIM,1853,41,45-49,1894,1
STAT,1864,51,20-24,1915,6.740568012024634E-4
STAT,1932,23,20-24,1955,144.4344747622249
STAT,1890,41,20-24,1931,0.1931301424789643
SIM,1873,38,40-44,1911,2
STAT,1917,34,35-39,1951,9.360733867708088
STAT,1832,24,15-19,1856,4.170817699616846
STAT,1927,41,40-44,1968,0.31158658079358315
STAT,1849,88,na,1937,115.67403828205532
STAT,1828,26,15-19,1854,1.0302876642990777
STAT,1831,43,50-100,1874,1.0187280274140023
STAT,1898,45,40-44,1943,0.13115537829581858
STAT,1831,31,45-49,1862,1.8822330218736156
STAT,1909,24,35-39,1933,8.607962666242397
SIM,1940,23,20-24,1963,1
STAT,1838,33,20-24,1871,1.4190075377609854
STAT,1872,64,na,1936,1740.7218735455206
STAT,1840,34,20-24,1874,1.2697164344456133
SIM,1838,23,20-24,1861,1
STAT,1876,42,30-34,1918,1.1607779816104273
SIM,1905,22,15-19,1927,2
STAT,1815,48,30-34,1863,0.009682567487251588
STAT,1865,38,40-44,1903,3.9767977285406695
STAT,1947,17,30-34,1964,13.585605617301201
STAT,1823,50,20-24,1873,0.001152942148487003
STAT,1860,53,50-100,1913,0.012122882641360546
SIM,1875,31,25-29,1906,16
STAT,1897,47,20-24,1944,0.008947673159860779
STAT,1877,54,40-44,1931,0.010392950410920249
STAT,1895,17,15-19,1912,7.7200937750680065
STAT,1888,28,na,1916,2744.742874029726
STAT,1874,40,25-29,1914,0.6694361439311057
STAT,1866,38,35-39,1904,6.424271861567858
STAT,1937,27,15-19,1964,0.6810434188024175
STAT,1892,42,15-19,1934,0.01707681456450579
SIM,1871,48,na,1919,1769
STAT,1842,50,30-34,1892,0.0014989224831614134
STAT,1845,30,35-39,1875,6.100394581623515
SIM,1899,36,40-44,1935,1
STAT,1835,41,30-34,1876,1.0557177508863744
STAT,1886,31,35-39,1917,10.529941079701139
STAT,1881,49,na,1930,2080.271410527281
STAT,1866,18,35-39,1884,0.5110763256144565
STAT,1852,36,35-39,1888,7.232863714187458
STAT,1910,28,20-24,1938,17.36833206354704
STAT,1880,64,na,1944,1804.6845260479085
STAT,1851,24,25-29,1875,53.219592513385926
STAT,1929,17,15-19,1946,57.512579042949156
SIM,1909,27,na,1936,3677
SIM,1905,13,na,1918,3866
STAT,1864,77,na,1941,785.8242174857219
STAT,1943,24,35-39,1967,9.89679274625641
STAT,1846,39,15-19,1885,0.034017016946211016
STAT,1887,29,50-100,1916,0.6990599820284586
STAT,1929,32,50-100,1961,1.0428509018071312
STAT,1805,90,na,1895,10.577482172977403
STAT,1887,43,45-49,1930,1.6354119052346252
STAT,1818,40,40-44,1858,4.644145354921507
STAT,1925,21,na,1946,4344.256272144205
STAT,1854,8,na,1862,1633.3243983626312
SIM,1842,40,30-34,1882,38
SIM,1860,36,35-39,1896,9
STAT,1856,49,30-34,1905,0.06807527461892532
STAT,1879,34,20-24,1913,2.7491648501296146
STAT,1867,42,na,1909,2183.1178360207487
STAT,1875,41,25-29,1916,0.6623840088177457
SIM,1883,41,25-29,1924,5
SIM,1829,39,35-39,1868,28
STAT,1846,42,15-19,1888,0.008278037525041918
STAT,1929,35,na,1964,4804.495877840442
SIM,1825,31,na,1856,609
SIM,1844,69,na,1913,1211
STAT,1847,43,15-19,1890,0.012395507187468497
STAT,1834,40,30-34,1874,0.6266725053809198
STAT,1896,46,20-24,1942,0.00894842338343228
STAT,1856,29,30-34,1885,18.47408901335123
STAT,1874,48,35-39,1922,0.14267379860605856
STAT,1873,16,25-29,1889,5.8472549063405905
STAT,1808,50,25-29,1858,0.004762904752614538
STAT,1891,41,15-19,1932,0.017059185565365214
SIM,1824,32,30-34,1856,86
STAT,1884,5,na,1889,2520.574455364167
SIM,1923,10,na,1933,4291
STAT,1844,20,50-100,1864,0.5117342483431381
STAT,1879,46,20-24,1925,0.012345029189224853
STAT,1855,39,35-39,1894,4.634004026857885
STAT,1863,42,15-19,1905,0.011775106376915707
SIM,1891,34,40-44,1925,9
SIM,1829,77,na,1906,1137
STAT,1807,54,25-29,1861,0.010829762632286037
STAT,1859,25,40-44,1884,2.450303984372716
STAT,1883,23,30-34,1906,17.083234969875125
STAT,1894,36,45-49,1930,2.5472356472117057
STAT,1885,31,40-44,1916,4.280193090224801
STAT,1892,29,40-44,1921,3.682281774513084
STAT,1920,45,25-29,1965,0.058155362793439094
STAT,1839,44,25-29,1883,0.6128896347858949
SIM,1908,42,na,1950,2423
SIM,1850,34,30-34,1884,3
STAT,1825,38,40-44,1863,6.1470850561792725
STAT,1825,67,na,1892,976.1971933472042
SIM,1841,26,na,1867,1160
STAT,1926,21,25-29,1947,111.59164782256866
STAT,1867,7,na,1874,2629.672292286336
STAT,1863,39,15-19,1902,0.04745734667167376
STAT,1920,34,15-19,1954,0.1377570716874657
STAT,1881,44,50-100,1925,0.9841914695928051
STAT,1852,44,na,1896,2295.063118641662
STAT,1861,18,na,1879,2181.2378127122133
SIM,1887,34,20-24,1921,34
STAT,1916,18,40-44,1934,0.2919432464651039
STAT,1899,46,40-44,1945,0.1322777464371859
SIM,1824,43,40-44,1867,5
STAT,1897,26,15-19,1923,0.6046082984063771
STAT,1822,54,20-24,1876,0.0011427482055233547
STAT,1936,35,50-100,1971,0.40879669258917906
SIM,1941,22,25-29,1963,16
STAT,1827,45,45-49,1872,0.22170334450837376
STAT,1836,81,na,1917,413.86707401427566
STAT,1925,29,50-100,1954,1.156541608483036
STAT,1832,28,30-34,1860,30.16738310218528
STAT,1883,34,40-44,1917,4.136388671134614
STAT,1802,93,na,1895,14.807547359073913
STAT,1885,27,35-39,1912,9.484408030243753
STAT,1834,24,25-29,1858,33.2586915473064
SIM,1790,71,na,1861,1197
SIM,1929,12,na,1941,6274
STAT,1861,80,na,1941,514.4512481532499
STAT,1870,54,na,1924,2087.5351108574982
STAT,1837,36,15-19,1873,0.055392500086835085
SIM,1833,82,na,1915,1117
STAT,1913,22,50-100,1935,0.6296028725489076
SIM,1840,28,30-34,1868,306
STAT,1940,26,40-44,1966,4.701783514270958
STAT,1874,45,25-29,1919,0.06003969193547662
STAT,1891,42,20-24,1933,0.19505650843369876
STAT,1885,30,35-39,1915,10.034407871853091
STAT,1795,95,na,1890,3.2410487570234663
SIM,1801,72,na,1873,1783
STAT,1791,81,na,1872,265.53086126695445
STAT,1824,51,20-24,1875,1.269095105849045E-4
STAT,1874,47,na,1921,2311.1601047961285
SIM,1848,59,na,1907,2307
STAT,1933,22,25-29,1955,121.69184964205546
STAT,1797,103,na,1900,0.0014346415635711728
STAT,1863,26,15-19,1889,0.3901325887630785
SIM,1852,30,40-44,1882,2
STAT,1919,31,35-39,1950,9.768064827346015
STAT,1823,34,20-24,1857,5.515208327475218
STAT,1865,34,25-29,1899,9.271343258853836
STAT,1894,24,45-49,1918,0.8812036911972866
STAT,1920,47,20-24,1967,0.01205894491248507
STAT,1826,32,50-100,1858,1.8173409415540729
STAT,1866,39,40-44,1905,3.9556498721681956
STAT,1812,52,40-44,1864,0.0025901775858359474
STAT,1833,44,25-29,1877,0.3253832018167474
STAT,1849,45,50-100,1894,0.2090036737429536
STAT,1856,49,25-29,1905,0.040507601035730964
STAT,1823,53,25-29,1876,0.0052133931722680524
STAT,1838,39,50-100,1877,0.6194084319250471
SIM,1850,22,30-34,1872,44
STAT,1829,51,50-100,1880,0.006885415118835672
STAT,1827,33,45-49,1860,1.7701208462430833
STAT,1882,42,na,1924,2210.0803344739907
STAT,1891,16,na,1907,3113.4383906429507
STAT,1904,46,25-29,1950,0.046551835597496934
STAT,1850,41,20-24,1891,0.0736655870639911
SIM,1922,36,40-44,1958,2
STAT,1811,43,35-39,1854,9.286086976629386
STAT,1870,65,na,1935,1684.779622911742
STAT,1842,34,30-34,1876,5.1283002380686185
STAT,1890,25,20-24,1915,14.29853244945778
STAT,1907,32,25-29,1939,8.58139185541565
STAT,1823,63,na,1886,1453.7067925719534
SIM,1882,24,25-29,1906,5
SIM,1820,56,na,1876,318
SIM,1867,37,35-39,1904,1
STAT,1843,34,40-44,1877,5.045361550953435
STAT,1873,16,30-34,1889,1.644645762837491
STAT,1884,54,na,1938,2004.542172048068
STAT,1859,87,na,1946,139.6395885930899
STAT,1914,36,40-44,1950,1.4809610448175354
SIM,1831,34,20-24,1865,18
STAT,1908,41,30-34,1949,0.11804312257004151
STAT,1858,27,45-49,1885,0.8679902514181411
STAT,1906,33,20-24,1939,2.238061772965883
STAT,1842,22,30-34,1864,5.577193514395732
STAT,1844,30,40-44,1874,5.245513752665362
SIM,1898,4,na,1902,4491
STAT,1929,33,15-19,1962,0.1619848461432681
STAT,1785,96,na,1881,0.7035493966062105
STAT,1811,54,45-49,1865,0.06272648927956512
SIM,1908,50,na,1958,1972
STAT,1876,34,30-34,1910,17.49905486040492
STAT,1874,79,na,1953,721.5231178109349
SIM,1831,28,35-39,1859,1
SIM,1884,34,30-34,1918,12
SIM,1851,34,40-44,1885,4
STAT,1871,49,20-24,1920,0.011720588591667901
STAT,1939,23,30-34,1962,28.537696114956606
STAT,1836,39,25-29,1875,2.6524064714657976
SIM,1819,70,na,1889,1056
STAT,1861,29,na,1890,1970.5499694501461
STAT,1843,46,40-44,1889,0.17053557539624492
STAT,1944,22,50-100,1966,0.7024495465044992
SIM,1927,31,35-39,1958,2
STAT,1874,26,20-24,1900,12.149188235070053
SIM,1841,44,25-29,1885,9
STAT,1875,24,40-44,1899,2.1263684473091113
STAT,1842,33,40-44,1875,1.2870839061073664
SIM,1865,39,na,1904,1703
STAT,1867,49,50-100,1916,0.22742165548460289
STAT,1853,112,na,1965,1.3655407165073466E-4
STAT,1848,39,na,1887,2225.253050021973
STAT,1938,20,na,1958,3577.95730954248
SIM,1874,13,na,1887,2759
STAT,1897,7,na,1904,3460.0483301930576
STAT,1875,25,25-29,1900,43.732001065524436
STAT,1927,44,45-49,1971,0.20633845918256868
STAT,1859,6,na,1865,2295.2644900009136
STAT,1865,62,na,1927,1668.70220516224
STAT,1799,88,na,1887,9.61063614831964
STAT,1857,45,30-34,1902,0.07502113139441646
STAT,1795,74,na,1869,552.3033899281012
STAT,1814,70,na,1884,1132.318815854729
STAT,1827,101,na,1928,0.4023989383868055
STAT,1945,21,35-39,1966,10.209127199144943
SIM,1857,7,na,1864,1543
SIM,1833,74,na,1907,1813
STAT,1843,54,35-39,1897,0.008272222496356355
STAT,1822,38,15-19,1860,0.1092754953301923
STAT,1846,80,na,1926,366.37037314815865
STAT,1863,35,50-100,1898,1.058093397002421
STAT,1841,54,30-34,1895,0.006446270144339032
STAT,1861,23,30-34,1884,15.109175422125883
STAT,1826,46,40-44,1872,0.2482813785920383
STAT,1882,39,25-29,1921,2.728829236498441
STAT,1916,17,na,1933,4041.87086104263
SIM,1844,77,na,1921,719
STAT,1828,46,45-49,1874,0.28552443939315625
SIM,1890,39,25-29,1929,13
SIM,1860,41,30-34,1901,9
STAT,1873,29,30-34,1902,25.64646008241905
STAT,1893,37,40-44,1930,5.4741890423870325
STAT,1873,33,15-19,1906,0.14546243721302063
STAT,1912,25,50-100,1937,0.9760597027872411
STAT,1878,37,15-19,1915,0.05777570084292829
STAT,1884,35,40-44,1919,4.230259942694263
STAT,1836,73,na,1909,909.0310340131231
STAT,1890,44,25-29,1934,0.7669065318634941
STAT,1882,15,15-19,1897,5.70819826772316
SIM,1805,67,na,1872,2097
SIM,1871,42,45-49,1913,1
STAT,1822,41,15-19,1863,0.025181562656404234
STAT,1930,36,25-29,1966,1.2764331345386726
SIM,1822,45,50-100,1867,3
STAT,1873,44,25-29,1917,0.6498202305327512
STAT,1876,4,na,1880,2932.0167668622853
SIM,1875,34,35-39,1909,4
SIM,1871,4,na,1875,2244
SIM,1880,28,na,1908,3317
STAT,1898,49,35-39,1947,0.10397725591504137
STAT,1949,12,na,1961,4523.509742260236
STAT,1867,34,35-39,1901,9.495472294164019
STAT,1835,33,30-34,1868,16.644857488461884
STAT,1817,44,40-44,1861,1.5963830421204568
STAT,1847,54,25-29,1901,0.0031143301899853137
STAT,1890,33,15-19,1923,0.17167223794800962
SIM,1832,44,na,1876,1850
SIM,1841,18,na,1859,1206
STAT,1878,37,45-49,1915,2.051037136005479
STAT,1847,26,30-34,1873,27.563135054062702
STAT,1934,31,30-34,1965,21.377883243720706
STAT,1870,20,40-44,1890,2.089813130846282
STAT,1816,85,na,1901,231.43153911567995
SIM,1908,31,25-29,1939,27
STAT,1957,15,25-29,1972,56.66462335427307
SIM,1911,17,na,1928,2607
STAT,1918,47,50-100,1965,0.2374441181352849
STAT,1823,42,15-19,1865,0.023194225387053537
STAT,1827,37,na,1864,1988.200060231455
STAT,1887,40,40-44,1927,2.500698495833274
SIM,1874,35,30-34,1909,2
STAT,1863,42,45-49,1905,1.2761270640040372
SIM,1890,19,30-34,1909,25
SIM,1769,86,na,1855,178
STAT,1806,53,25-29,1859,0.009165067025124544
STAT,1830,48,20-24,1878,0.010124623118508523
SIM,1810,57,na,1867,3098
SIM,1960,4,na,1964,6451
STAT,1893,24,35-39,1917,7.251746979487759
SIM,1855,26,30-34,1881,86
STAT,1857,44,40-44,1901,1.7027096487232523
STAT,1899,28,45-49,1927,1.5111885455968952
STAT,1868,46,45-49,1914,0.22859270213881286
STAT,1877,50,25-29,1927,0.003647239198225285
STAT,1864,43,15-19,1907,0.012463909405340333
STAT,1816,43,40-44,1859,7.199279913670733
STAT,1826,33,35-39,1859,18.83325749869234
SIM,1881,69,na,1950,905
STAT,1837,44,na,1881,1939.649701206403
SIM,1883,25,na,1908,2172
STAT,1921,23,45-49,1944,1.2519178295223314
STAT,1933,16,50-100,1949,0.4993501417318255
SIM,1951,2,na,1953,2395
STAT,1863,84,na,1947,283.9986575058059
STAT,1866,35,30-34,1901,4.911141251292952
STAT,1894,67,na,1961,2167.4479898576465
SIM,1810,89,na,1899,258
STAT,1862,29,25-29,1891,35.772343418297815
STAT,1842,53,35-39,1895,0.002102837076293904
STAT,1882,19,30-34,1901,1.5178034033237673
SIM,1869,10,na,1879,3826
STAT,1873,25,15-19,1898,0.4685562390515668
STAT,1885,39,na,1924,2292.4986888166895
STAT,1902,23,35-39,1925,8.19190068671537
STAT,1853,53,40-44,1906,0.00803195438762846
STAT,1941,8,na,1949,4038.0361948557174
STAT,1912,35,na,1947,3663.7792189888587
STAT,1816,44,30-34,1860,3.58422003975342
STAT,1902,28,na,1930,3348.778251088972
STAT,1883,35,30-34,1918,5.17597847955718
STAT,1851,28,40-44,1879,2.7502204769029976
STAT,1873,45,15-19,1918,4.1440213382251234E-4
STAT,1856,25,15-19,1881,0.3425813233442757
STAT,1893,45,35-39,1938,0.09974081420853535
SIM,1887,31,na,1918,3785
STAT,1857,40,25-29,1897,0.49773872742863073
SIM,1824,44,30-34,1868,4
SIM,1855,21,na,1876,3262
STAT,1846,29,na,1875,1527.7824763714361
SIM,1891,76,na,1967,488
SIM,1875,47,40-44,1922,1
STAT,1841,38,25-29,1879,3.7384808404602237
STAT,1826,54,35-39,1880,0.011431320639673476
STAT,1869,47,45-49,1916,0.2370330880317844
STAT,1833,62,na,1895,751.9965811736758
STAT,1867,47,40-44,1914,0.16115415862478036
STAT,1868,34,45-49,1902,1.6698866723837784
SIM,1869,21,na,1890,3267
STAT,1823,55,na,1878,1794.992051684369
STAT,1864,54,25-29,1918,0.003131516021025417
STAT,1866,15,30-34,1881,1.511099230400132
STAT,1883,18,35-39,1901,0.5264988469670819
STAT,1859,79,na,1938,554.1056612098287
STAT,1852,52,40-44,1904,0.01054059159872966
STAT,1907,30,50-100,1937,0.7738132869405749
SIM,1831,59,na,1890,2133
SIM,1830,34,na,1864,843
STAT,1903,34,15-19,1937,0.11508034884108202
SIM,1931,33,20-24,1964,2
SIM,1829,36,30-34,1865,2
STAT,1916,18,50-100,1934,0.07819906485851996
STAT,1875,29,40-44,1904,3.054016695840564
STAT,1818,43,45-49,1861,2.8451650621596474
SIM,1834,48,na,1882,727
STAT,1888,27,30-34,1915,29.064034633139702
STAT,1824,35,20-24,1859,0.11938770102653239
STAT,1843,16,45-49,1859,0.08296835283515089
STAT,1901,38,20-24,1939,0.23148250892970304
STAT,1838,39,35-39,1877,3.568359208724486
STAT,1811,51,40-44,1862,0.04831856496075071
STAT,1809,46,35-39,1855,1.25965539598434
STAT,1871,24,50-100,1895,0.40424215621670895
STAT,1837,47,na,1884,1872.6418692291943
STAT,1807,51,20-24,1858,0.0024032090317899274
STAT,1858,45,40-44,1903,0.13204274288106685
STAT,1898,29,35-39,1927,12.882340825851001
STAT,1854,36,15-19,1890,0.03137320675935466
STAT,1845,95,na,1940,6.597472302760108
STAT,1835,88,na,1923,103.87633118661077
STAT,1874,42,20-24,1916,0.16370381712577728
SIM,1896,27,30-34,1923,150
SIM,1900,22,na,1922,4149
STAT,1824,54,25-29,1878,5.741965701403452E-4
SIM,1846,39,35-39,1885,1
STAT,1923,33,20-24,1956,2.7651270734564117
STAT,1831,107,na,1938,0.0036909414124099665
SIM,1854,27,20-24,1881,20
SIM,1907,25,na,1932,4714
SIM,1849,6,na,1855,2894
STAT,1840,22,20-24,1862,34.5071518201972
STAT,1884,47,40-44,1931,0.16312099383126485
STAT,1833,43,40-44,1876,1.1551857623258905
STAT,1898,30,15-19,1928,0.19303727875001866
STAT,1859,47,na,1906,1774.8937856838124
STAT,1816,47,35-39,1863,0.4258284103871224
STAT,1901,43,na,1944,3219.3460095163896
STAT,1822,70,na,1892,809.0831737270688
STAT,1889,35,50-100,1924,1.4925198381642633
STAT,1905,16,15-19,1921,8.556750294762068
STAT,1813,85,na,1898,200.81061006547841
STAT,1801,54,30-34,1855,0.014797154747591638
SIM,1867,34,30-34,1901,20
STAT,1891,26,20-24,1917,14.476010877716938
STAT,1833,32,30-34,1865,9.880992244879751
STAT,1903,45,25-29,1948,0.04658143068655385
STAT,1837,49,15-19,1886,3.2451475833014713E-4
SIM,1938,17,30-34,1955,43
SIM,1889,26,30-34,1915,107
STAT,1861,40,na,1901,1941.5212170037069
STAT,1885,34,45-49,1919,1.6994135616402608
SIM,1841,32,30-34,1873,15
STAT,1845,29,25-29,1874,25.183836091476145
STAT,1898,41,25-29,1939,0.060235880448711976
STAT,1854,111,na,1965,3.1826846652948857E-4
STAT,1886,24,na,1910,2433.7943641551324
STAT,1885,24,30-34,1909,17.398965584739088
STAT,1832,44,15-19,1876,0.0012353312583442088
SIM,1884,37,35-39,1921,14
STAT,1850,44,25-29,1894,0.2925209869768881
STAT,1847,18,50-100,1865,0.05495813790166125
STAT,1876,40,35-39,1916,1.8490372689203742
SIM,1868,36,na,1904,1174
STAT,1843,23,50-100,1866,0.5021097748594318
STAT,1848,34,25-29,1882,9.962506334406369
STAT,1866,54,35-39,1920,0.007642406492447114
SIM,1810,86,na,1896,418
STAT,1846,27,20-24,1873,8.405458558673127
STAT,1870,62,na,1932,1822.125729189111
SIM,1836,26,na,1862,2324
SIM,1891,68,na,1959,675
STAT,1858,24,40-44,1882,1.6377292415767315
STAT,1874,76,na,1950,977.7835848872633
STAT,1895,37,45-49,1932,2.593271991883839
STAT,1862,30,35-39,1892,8.69497167783434
SIM,1826,33,30-34,1859,1
SIM,1869,13,na,1882,3827
SIM,1883,28,na,1911,2234
STAT,1812,60,na,1872,191.76794531232753
STAT,1887,28,20-24,1915,12.867041925414407
STAT,1842,17,35-39,1859,0.17491668957645382
STAT,1864,69,na,1933,1334.1527195168778
STAT,1876,37,35-39,1913,7.150073124078379
STAT,1822,41,45-49,1863,2.7290516612868214
STAT,1935,23,na,1958,4935.425842231095
STAT,1860,55,na,1915,1686.8245345316293
STAT,1864,35,20-24,1899,0.7074388907108141
STAT,1891,45,25-29,1936,0.04035369632344063
SIM,1859,46,50-100,1905,1
STAT,1917,22,40-44,1939,3.525856177666379
STAT,1833,41,20-24,1874,0.08379549428512871
STAT,1867,52,30-34,1919,0.005599536262498431
STAT,1842,37,35-39,1879,2.059701873592212
STAT,1884,17,45-49,1901,0.06253143090464175
SIM,1831,48,na,1879,2130
STAT,1864,29,35-39,1893,8.709205788071996
STAT,1844,33,45-49,1877,2.0445626126150565
SIM,1878,57,na,1935,3366
STAT,1837,36,na,1873,2112.7395749636376
SIM,1868,28,na,1896,1204
STAT,1889,44,30-34,1933,1.3657716449152448
STAT,1852,23,35-39,1875,6.92784496691737
STAT,1881,23,20-24,1904,64.87627058908127
STAT,1936,16,na,1952,3497.5365878218777
SIM,1839,38,35-39,1877,1
STAT,1883,83,na,1966,660.3640313750302
SIM,1897,44,30-34,1941,1
SIM,1852,33,45-49,1885,3
STAT,1872,33,50-100,1905,0.9136194612011277
STAT,1946,20,45-49,1966,1.2394258464026167
STAT,1903,21,na,1924,3367.348738912062
STAT,1908,44,35-39,1952,0.1825909371326959
STAT,1812,71,na,1883,120.13749234306403
STAT,1833,22,na,1855,1122.7633025271628
STAT,1885,15,40-44,1900,0.1806197487185202
STAT,1872,17,20-24,1889,17.81103006210119
SIM,1841,23,25-29,1864,537
STAT,1849,35,25-29,1884,2.534520189528502
STAT,1914,47,50-100,1961,0.22119623159361892
STAT,1888,23,15-19,1911,3.795848259662604
SIM,1939,29,40-44,1968,3
STAT,1836,51,45-49,1887,0.011476991281810732
STAT,1857,48,35-39,1905,0.10608073017774901
SIM,1866,41,25-29,1907,7
STAT,1914,22,15-19,1936,5.36281041578581
STAT,1861,26,35-39,1887,8.141216763964263
SIM,1891,30,25-29,1921,9
STAT,1855,33,20-24,1888,1.8027369849843025
STAT,1922,45,35-39,1967,0.14715299423727685
STAT,1926,2,na,1928,4971.364754169833
STAT,1852,29,50-100,1881,0.6727206431266359
STAT,1847,39,30-34,1886,4.8967164825177525
SIM,1810,48,45-49,1858,3
SIM,1896,23,15-19,1919,2
STAT,1853,35,45-49,1888,1.578163515313886
STAT,1917,0,na,1917,4767.636452898635
SIM,1858,58,na,1916,2126
SIM,1922,22,15-19,1944,66
STAT,1898,46,30-34,1944,0.07363439256789359
STAT,1893,42,30-34,1935,1.4359220729576925
STAT,1819,39,25-29,1858,0.656198803017125
STAT,1883,30,25-29,1913,9.933034266989871
STAT,1870,23,45-49,1893,0.6930348641281531
STAT,1830,108,na,1938,0.0013257508519343149
STAT,1851,40,30-34,1891,0.9171614745566075
STAT,1902,36,na,1938,3359.8658323712716
STAT,1826,51,30-34,1877,0.008388552588807925
STAT,1839,46,20-24,1885,0.011505645721502023
STAT,1833,23,25-29,1856,45.7457751509508
SIM,1809,45,50-100,1854,1
STAT,1916,49,20-24,1965,0.01111477000349755
STAT,1834,39,50-100,1873,0.659203528356015
STAT,1894,75,na,1969,1710.4133819543915
SIM,1921,2,na,1923,5527
STAT,1878,53,45-49,1931,0.014691637026511226
STAT,1923,31,50-100,1954,0.9416988100097391
SIM,1879,20,na,1899,1758
STAT,1916,9,na,1925,4152.338630903046
STAT,1890,19,35-39,1909,0.6607089258663941
STAT,1850,66,na,1916,756.8320443610701
STAT,1950,12,na,1962,4600.449210330453
SIM,1862,36,45-49,1898,1
STAT,1838,45,20-24,1883,0.005406857405566492
STAT,1854,49,20-24,1903,0.006532901696115449
SIM,1891,38,35-39,1929,3
SIM,1891,79,na,1970,78
STAT,1894,21,40-44,1915,2.6578935586398535
STAT,1895,38,na,1933,3049.624322788649
STAT,1854,36,45-49,1890,1.1137487075051318
STAT,1860,34,40-44,1894,3.5075696190898364
STAT,1848,52,20-24,1900,6.868501587592817E-4
STAT,1890,18,50-100,1908,0.05915453241528124
STAT,1827,30,40-44,1857,4.613299042210261
STAT,1786,81,na,1867,386.90922332374254
SIM,1855,39,30-34,1894,2
STAT,1934,38,na,1972,5151.367056603436
STAT,1883,38,35-39,1921,6.7707058707679755
STAT,1900,58,na,1958,2805.2609622864693
SIM,1897,35,25-29,1932,1
SIM,1892,31,25-29,1923,2
STAT,1921,20,40-44,1941,3.7750976960843863
STAT,1825,50,30-34,1875,0.0075967117088325915
SIM,1886,34,40-44,1920,4
STAT,1835,36,35-39,1871,6.685147624580554
STAT,1850,25,20-24,1875,6.467423250305116
STAT,1871,28,na,1899,2372.281125824203
SIM,1912,0,na,1912,4905
STAT,1829,43,20-24,1872,0.07529849408501649
STAT,1841,52,50-100,1893,0.0167283633402634
STAT,1848,43,30-34,1891,1.0680587198032105
SIM,1963,8,na,1971,5558
STAT,1923,46,35-39,1969,0.1496096949962542
SIM,1855,22,15-19,1877,18
STAT,1934,34,35-39,1968,12.376525668060662
STAT,1860,95,na,1955,10.84639606294839
SIM,1846,45,20-24,1891,1
STAT,1837,52,45-49,1889,0.011678724004014901
STAT,1888,38,50-100,1926,1.409987733275106
SIM,1928,30,45-49,1958,8
STAT,1889,35,25-29,1924,3.5001296955492207
SIM,1908,10,na,1918,2908
STAT,1934,6,na,1940,5384.60966419388
STAT,1873,49,30-34,1922,0.09722225407013756
SIM,1880,17,20-24,1897,17
STAT,1896,34,20-24,1930,3.53274230453121
STAT,1878,34,40-44,1912,4.423713046075584
SIM,1822,34,na,1856,1545
SIM,1847,66,na,1913,1382
SIM,1932,24,na,1956,6285
STAT,1884,46,na,1930,2159.8252558903
SIM,1910,20,30-34,1930,11
SIM,1860,44,35-39,1904,1
STAT,1931,5,na,1936,5225.806781865033
STAT,1857,28,35-39,1885,7.571699289471837
STAT,1881,50,45-49,1931,0.013901709017023143
STAT,1915,46,na,1961,3658.717311413196
SIM,1923,23,15-19,1946,15
STAT,1899,25,40-44,1924,4.119301124744015
STAT,1915,23,15-19,1938,5.408024144854679
STAT,1873,41,20-24,1914,0.16364428844223494
SIM,1898,36,25-29,1934,10
STAT,1828,54,50-100,1882,0.015228483948853734
STAT,1871,16,20-24,1887,17.90465812738682
STAT,1806,50,20-24,1856,0.002040574677670962
STAT,1836,40,35-39,1876,1.6935515907539287
STAT,1902,20,30-34,1922,25.232209052513735
STAT,1915,44,50-100,1959,0.1162168324429127
SIM,1919,13,na,1932,5212
SIM,1819,43,40-44,1862,7
STAT,1846,26,45-49,1872,0.8012733771178046
SIM,1920,21,na,1941,3970
SIM,1875,92,na,1967,178
STAT,1821,83,na,1904,200.48522888721396
STAT,1835,43,45-49,1878,1.3395674102315198
SIM,1922,22,na,1944,3044
STAT,1834,27,50-100,1861,0.36967765737291
STAT,1831,28,na,1859,2218.5329285371354
STAT,1925,44,35-39,1969,0.24075854491398316
SIM,1841,46,45-49,1887,1
STAT,1850,32,30-34,1882,8.433898622930979
STAT,1875,45,40-44,1920,0.17754972228926763
STAT,1946,18,20-24,1964,148.70002991055497
STAT,1849,26,na,1875,2176.3300479628606
STAT,1946,21,20-24,1967,122.44161249381801
STAT,1852,40,40-44,1892,2.286939432361564
STAT,1904,62,na,1966,2849.9713354648084
SIM,1851,42,25-29,1893,3
SIM,1848,29,25-29,1877,32
STAT,1845,33,50-100,1878,0.5350044354884621
STAT,1888,26,50-100,1914,0.740843419977364
STAT,1921,46,30-34,1967,0.0995508183585838
STAT,1849,30,25-29,1879,10.203360776691664
STAT,1906,16,50-100,1922,0.07111797679485435
STAT,1813,88,na,1901,100.56380549712118
SIM,1884,3,na,1887,3913
STAT,1929,29,50-100,1958,1.235753002505248
STAT,1929,24,25-29,1953,115.26393029566891
SIM,1904,45,50-100,1949,1
STAT,1782,85,na,1867,263.9704080520459
STAT,1859,21,50-100,1880,0.37117389011516516
STAT,1873,48,40-44,1921,0.17340688208315663
STAT,1822,45,30-34,1867,0.1664238555272861
STAT,1887,65,na,1952,1860.0964301009503
STAT,1898,27,20-24,1925,15.775479575266754
STAT,1837,31,45-49,1868,1.7714056231685014
STAT,1853,16,35-39,1869,0.5148365258338152
STAT,1874,38,50-100,1912,1.2608273146001043
STAT,1793,108,na,1901,3.0454597300732665E-4
STAT,1908,32,40-44,1940,3.66529735936818
STAT,1889,32,20-24,1921,3.255090957226522
SIM,1869,98,na,1967,280
STAT,1908,52,na,1960,3241.292545999007
SIM,1852,32,na,1884,2088
STAT,1863,23,40-44,1886,1.8013986626463108
STAT,1917,22,50-100,1939,0.6899914744003507
SIM,1825,34,na,1859,563
SIM,1922,32,25-29,1954,16
STAT,1903,29,50-100,1932,0.901560512402636
STAT,1878,80,na,1958,747.0215084764727
STAT,1885,44,50-100,1929,1.0244217329660383
STAT,1852,97,na,1949,5.407634229279914
STAT,1877,33,na,1910,2412.170406754388
STAT,1857,21,na,1878,1907.811267908438
STAT,1899,32,50-100,1931,1.2514698330252843
STAT,1905,32,15-19,1937,0.11761217673132754
STAT,1846,43,20-24,1889,0.09398556315826162
STAT,1807,70,na,1877,783.4782590974725
SIM,1920,35,25-29,1955,5
STAT,1899,44,50-100,1943,0.09885045841952078
STAT,1827,49,25-29,1876,0.05139302055584651
SIM,1924,37,na,1961,5189
STAT,1837,33,40-44,1870,4.314770116866463
STAT,1857,26,20-24,1883,9.339529091557853
STAT,1914,32,25-29,1946,9.17426258006013
STAT,1889,16,15-19,1905,7.164086509372435
STAT,1847,11,na,1858,2706.1088635669507
STAT,1861,33,45-49,1894,1.4441174423455772
STAT,1859,34,30-34,1893,13.719963894271528
STAT,1914,43,20-24,1957,0.017228771861957155
SIM,1894,65,na,1959,1042
STAT,1858,25,25-29,1883,33.54958922493943
STAT,1911,39,25-29,1950,0.9308259420977076
STAT,1929,8,na,1937,5054.365754583976
STAT,1845,45,50-100,1890,0.1230858983557391
STAT,1870,27,50-100,1897,0.6377305365282641
STAT,1889,3,na,1892,3183.5393314285066
STAT,1844,46,20-24,1890,0.011922020183746182
STAT,1845,10,na,1855,1515.97464
STAT,1852,20,30-34,1872,21.60874816780044
STAT,1863,21,45-49,1884,0.6115669771508823
STAT,1910,27,15-19,1937,0.6740762035938116
STAT,1831,38,35-39,1869,7.094310267234567
STAT,1912,35,25-29,1947,0.9588497266234717
STAT,1920,40,40-44,1960,0.2734513975308498
STAT,1934,22,40-44,1956,4.488020086231058
SIM,1932,32,na,1964,6036
STAT,1827,36,50-100,1863,1.2255818175683308
STAT,1904,29,40-44,1933,4.249161791228975
STAT,1887,27,45-49,1914,1.2220808780131691
STAT,1877,53,35-39,1930,0.008598913429093094
STAT,1930,33,20-24,1963,3.123789330941689
STAT,1952,15,40-44,1967,1.6617488670077338
STAT,1927,25,na,1952,4547.790922968035
STAT,1930,39,35-39,1969,3.1261122495905918
SIM,1866,25,25-29,1891,1
SIM,1914,27,na,1941,5033
STAT,1925,41,50-100,1966,0.14113375167741363
STAT,1894,13,na,1907,3278.979467689989
SIM,1928,27,na,1955,4613
STAT,1875,20,25-29,1895,59.13351518978912
SIM,1869,66,na,1935,3598
STAT,1870,50,50-100,1920,0.015272798612876197
STAT,1856,29,50-100,1885,0.46929478115706175
STAT,1841,54,25-29,1895,0.003835797073712218
STAT,1935,18,45-49,1953,0.6762128092025346
STAT,1843,42,25-29,1885,0.6532687627161663
STAT,1845,101,na,1946,0.28315313343642895
STAT,1903,43,45-49,1946,0.1464637461112238
STAT,1860,102,na,1962,0.7606980455552123
STAT,1935,21,45-49,1956,1.5216813518129526
STAT,1833,46,45-49,1879,0.1200431923997782
STAT,1813,48,50-100,1861,0.8852280488697793
SIM,1836,71,na,1907,753
STAT,1877,3,na,1880,3111.9660890871983
STAT,1920,5,na,1925,4453.061369420573
STAT,1857,13,na,1870,2143.3081601024214
STAT,1899,23,20-24,1922,93.83447424322026
STAT,1864,15,na,1879,2400.445702912164
SIM,1882,62,na,1944,1326
STAT,1858,41,30-34,1899,0.8819331489502611
STAT,1796,99,na,1895,0.7416757717988391
STAT,1907,42,35-39,1949,0.18325061477571442
SIM,1875,60,na,1935,2579
STAT,1853,39,25-29,1892,2.2100278616819926
STAT,1883,16,20-24,1899,17.097501886013763
STAT,1854,70,na,1924,780.1340628679574
STAT,1872,10,na,1882,2668.566896358406
STAT,1909,28,45-49,1937,1.628509551575589
SIM,1915,17,30-34,1932,14
STAT,1832,47,40-44,1879,0.015497793570130012
STAT,1871,32,35-39,1903,10.102190177103486
STAT,1924,42,35-39,1966,0.23721789999288379
STAT,1858,60,na,1918,1456.445028223307
STAT,1834,44,40-44,1878,1.164808656505453
STAT,1871,52,45-49,1923,0.014399698907661318
STAT,1926,19,20-24,1945,163.9133093795624
STAT,1868,27,35-39,1895,9.319618792418673
STAT,1858,50,20-24,1908,5.71620748660531E-4
SIM,1836,28,na,1864,2280
SIM,1918,49,na,1967,4357
SIM,1880,46,50-100,1926,2
STAT,1915,42,25-29,1957,0.07087743034492675
STAT,1935,20,na,1955,4940.463403225502
STAT,1909,31,45-49,1940,1.4924084131664968
STAT,1907,17,30-34,1924,2.3256099070593286
STAT,1885,84,na,1969,643.5541815175383
STAT,1841,20,na,1861,3059.9657329011015
STAT,1865,15,15-19,1880,6.208467611118563
SIM,1880,39,35-39,1919,8
STAT,1904,43,20-24,1947,0.015642272801810592
STAT,1812,49,na,1861,236.5441131083686
STAT,1915,32,na,1947,3797.4619606134115
STAT,1839,25,15-19,1864,0.5387284692382478
STAT,1859,44,45-49,1903,1.1702141334966136
STAT,1932,26,na,1958,4874.736923093319
STAT,1854,78,na,1932,434.4347971702942
SIM,1920,25,50-100,1945,35
STAT,1821,41,35-39,1862,2.078032261698786
STAT,1848,31,20-24,1879,2.980582135630576
STAT,1878,82,na,1960,644.4653140296069
STAT,1875,50,20-24,1925,7.686231213090997E-4
STAT,1803,64,na,1867,630.7023890056473
STAT,1929,38,na,1967,4791.343535524665
STAT,1817,105,na,1922,0.009288478596097998
STAT,1865,43,30-34,1908,1.042054485918069
STAT,1924,17,30-34,1941,14.375400188646493
SIM,1827,65,na,1892,1272
SIM,1873,43,30-34,1916,13
STAT,1872,39,35-39,1911,7.011255173857118
SIM,1878,35,na,1913,4229
STAT,1791,68,na,1859,912.0757359886069
SIM,1882,40,na,1922,1783
STAT,1881,43,15-19,1924,0.012947074418970377
STAT,1874,33,30-34,1907,17.943546959785557
STAT,1821,85,na,1906,138.44258041094483
SIM,1887,4,na,1891,4012
STAT,1861,50,35-39,1911,0.007262550813824647
SIM,1887,18,na,1905,3884
STAT,1809,53,45-49,1862,0.11742075287565552
STAT,1954,7,na,1961,4816.215154083858
STAT,1859,15,30-34,1874,1.4838421972987992
SIM,1929,24,20-24,1953,4
SIM,1876,0,na,1876,5328
STAT,1899,21,25-29,1920,78.42597074904825
STAT,1870,94,na,1964,57.95550599518986
SIM,1827,43,na,1870,1987
SIM,1901,33,35-39,1934,18
SIM,1872,3,na,1875,3761
SIM,1931,39,na,1970,4954
SIM,1906,42,25-29,1948,1
STAT,1860,51,30-34,1911,0.004879277582863279
STAT,1824,42,30-34,1866,0.1957837352702873
SIM,1910,43,na,1953,3895
STAT,1857,35,na,1892,1825.0557054726023
SIM,1892,64,na,1956,3352
STAT,1923,41,na,1964,4301.346493139108
SIM,1903,33,na,1936,2797
STAT,1933,32,35-39,1965,12.231551376244235
STAT,1891,33,30-34,1924,21.380110008080926
STAT,1820,58,na,1878,1457.5489105334289
STAT,1876,44,45-49,1920,1.4925433826417311
STAT,1808,54,40-44,1862,0.012951582481572755
STAT,1904,49,35-39,1953,0.110470757415924
STAT,1919,19,15-19,1938,49.22082822247909
STAT,1891,0,na,1891,3610.897409805439
SIM,1863,39,35-39,1902,5
STAT,1868,30,35-39,1898,9.860062523154912
STAT,1819,40,50-100,1859,0.23704227383266005
STAT,1884,15,25-29,1899,5.4498062212048515
SIM,1898,55,na,1953,4037
STAT,1910,33,35-39,1943,8.675988465208906
STAT,1854,56,na,1910,1134.072571365236
STAT,1855,110,na,1965,0.001147800541560996
STAT,1908,16,35-39,1924,0.8096409987146396
SIM,1884,44,45-49,1928,8
STAT,1838,42,50-100,1880,0.5274087169656555
SIM,1907,57,na,1964,4311
STAT,1885,47,20-24,1932,0.011740402032040444
STAT,1862,42,35-39,1904,1.5404455055129884
STAT,1867,31,30-34,1898,16.579658846426515
STAT,1848,15,15-19,1863,6.9660824628346605
SIM,1867,15,30-34,1882,1
STAT,1923,43,30-34,1966,0.14761981810580913
STAT,1803,86,na,1889,54.91397070959105
STAT,1938,30,50-100,1968,0.8233720615024072
STAT,1884,40,20-24,1924,0.1535613423973138
STAT,1844,23,30-34,1867,21.874524335279983
SIM,1877,10,na,1887,213
SIM,1911,30,na,1941,2512
STAT,1883,37,45-49,1920,1.9178203208672802
STAT,1810,91,na,1901,1.804180581633484
SIM,1822,38,35-39,1860,51
STAT,1881,29,35-39,1910,9.046819244368267
STAT,1905,42,25-29,1947,0.0640596337054077
STAT,1936,24,50-100,1960,0.6224087458585318
SIM,1909,38,na,1947,3878
STAT,1850,35,35-39,1885,3.387344007688339
STAT,1927,24,50-100,1951,0.7990490414253296
SIM,1851,17,na,1868,1433
STAT,1863,26,45-49,1889,0.954734420318046
SIM,1847,63,na,1910,1382
STAT,1834,58,na,1892,871.5376242508709
STAT,1855,1,na,1856,2498.9382994292973
STAT,1896,17,45-49,1913,0.0861099961676122
STAT,1905,22,na,1927,3401.69798099113
STAT,1894,23,50-100,1917,0.516967773175816
SIM,1948,22,35-39,1970,2
STAT,1898,42,15-19,1940,0.0012879727495419557
STAT,1950,22,25-29,1972,108.53589823020693
SIM,1880,81,na,1961,2623
STAT,1829,26,45-49,1855,0.9496684817870266
STAT,1925,38,15-19,1963,0.022814306916358395
STAT,1793,106,na,1899,0.002018701267856986
STAT,1846,23,40-44,1869,1.511847434285902
STAT,1890,31,na,1921,2900.691315422198
STAT,1820,49,15-19,1869,6.120268142545262E-4
STAT,1864,19,15-19,1883,5.515596863983581
STAT,1868,47,20-24,1915,0.011536415457817722
STAT,1867,22,50-100,1889,0.3872484043558928
SIM,1928,41,na,1969,4591
SIM,1849,44,na,1893,2257
STAT,1825,54,40-44,1879,0.012410810616771163
STAT,1921,29,40-44,1950,5.096474950320702
STAT,1864,22,15-19,1886,3.0473920612216996
STAT,1912,33,45-49,1945,1.52394219194638
SIM,1819,56,na,1875,1842
SIM,1849,46,na,1895,2227
STAT,1869,23,35-39,1892,5.8702818228056275
STAT,1898,57,na,1955,2702.384555266437
SIM,1878,89,na,1967,263
STAT,1816,46,45-49,1862,0.7282318246119466
STAT,1925,16,35-39,1941,5.034884732479895
STAT,1894,33,40-44,1927,5.491550009043656
SIM,1891,37,45-49,1928,9
STAT,1857,29,25-29,1886,32.956398411375886
STAT,1929,21,20-24,1950,140.05083216153204
STAT,1892,45,40-44,1937,0.12075603237417576
STAT,1942,9,na,1951,4082.8604400964414
STAT,1868,43,40-44,1911,2.156816258021838
STAT,1859,40,35-39,1899,1.4497197003566031
STAT,1931,35,35-39,1966,3.186313328491788
STAT,1929,18,20-24,1947,171.3595880855541
STAT,1859,37,35-39,1896,5.605945343123901
STAT,1901,40,30-34,1941,0.11275331417312752
STAT,1934,25,45-49,1959,2.310336367212914
STAT,1836,59,na,1895,1487.4049848906354
STAT,1870,53,40-44,1923,0.010326848283351845
SIM,1865,29,25-29,1894,1
SIM,1898,23,na,1921,4338
STAT,1865,101,na,1966,2.6762712021893282
STAT,1937,35,na,1972,3729.588061912736
SIM,1854,47,na,1901,1410
STAT,1865,64,na,1929,1587.1057043678195
STAT,1880,47,50-100,1927,0.2537820464016999
STAT,1931,32,25-29,1963,12.02576493640099
SIM,1874,11,na,1885,2759
STAT,1872,33,20-24,1905,2.6953113879538275
STAT,1830,46,50-100,1876,0.21259550820821596
STAT,1918,21,45-49,1939,1.2007751825199278
SIM,1879,76,na,1955,67
STAT,1816,53,na,1869,2282.7795038597733
SIM,1856,48,na,1904,461
STAT,1914,46,25-29,1960,0.052005614191559926
SIM,1866,22,20-24,1888,309
SIM,1962,9,na,1971,4673
STAT,1837,36,45-49,1873,1.966433519225609
STAT,1952,18,45-49,1970,0.5929772767272157
SIM,1859,30,35-39,1889,8
STAT,1831,42,na,1873,2005.6508091591181
STAT,1818,62,na,1880,1252.0276571629533
STAT,1842,30,15-19,1872,0.04360215989923667
STAT,1838,29,20-24,1867,6.279172099287437
STAT,1865,31,20-24,1896,2.4779537617666403
SIM,1809,46,na,1855,801
STAT,1906,16,25-29,1922,8.225980976173433
STAT,1822,48,35-39,1870,0.2308831023006831
SIM,1861,78,na,1939,638
STAT,1832,77,na,1909,733.760372837068
SIM,1841,40,na,1881,558
STAT,1908,35,45-49,1943,0.639348679974172
SIM,1895,47,30-34,1942,2
SIM,1850,36,45-49,1886,7
STAT,1868,15,40-44,1883,0.18199693459437152
STAT,1918,18,45-49,1936,0.5349822274847583
STAT,1884,20,50-100,1904,0.39269565124826733
STAT,1935,15,40-44,1950,1.9071901598773553
STAT,1946,24,25-29,1970,101.60955791845164
STAT,1850,54,40-44,1904,0.004727583323338197
STAT,1840,42,15-19,1882,0.005672297022542468
STAT,1941,17,30-34,1958,12.411956379285348
STAT,1889,74,na,1963,1590.4308718562304
SIM,1896,14,na,1910,4047
STAT,1851,44,40-44,1895,1.7524824614105572
STAT,1858,22,20-24,1880,60.38092609890052
STAT,1831,35,30-34,1866,5.55284334133699
STAT,1915,54,na,1969,3554.404226220549
SIM,1834,45,na,1879,778
SIM,1844,39,25-29,1883,10
STAT,1924,32,25-29,1956,10.679579581671227
STAT,1926,40,35-39,1966,0.24679832362698367
SIM,1845,62,na,1907,1724
STAT,1848,36,20-24,1884,0.7511148708910845
SIM,1866,16,na,1882,3273
SIM,1864,35,na,1899,2397
STAT,1841,52,na,1893,2384.9280872885533
STAT,1921,36,50-100,1957,0.4636659213751556
STAT,1839,48,na,1887,2102.584210888944
STAT,1844,49,25-29,1893,0.05587223372623237
STAT,1853,32,40-44,1885,3.4628237348652564
SIM,1932,32,25-29,1964,12
STAT,1870,16,35-39,1886,0.5555092500249
STAT,1849,77,na,1926,728.3298027136794
STAT,1931,22,15-19,1953,6.855531275556564
SIM,1917,25,40-44,1942,21
STAT,1895,52,na,1947,2786.1618038681845
STAT,1830,39,30-34,1869,4.761352186620364
STAT,1870,7,na,1877,2737.4085106426473
STAT,1948,18,30-34,1966,13.801919377216507
STAT,1844,17,na,1861,2890.731934348132
SIM,1871,70,na,1941,843
SIM,1913,45,35-39,1958,1
STAT,1832,106,na,1938,0.010306769818778382
STAT,1889,37,20-24,1926,0.9282755131501189
STAT,1831,32,20-24,1863,2.8745733052858595
STAT,1940,21,na,1961,3679.5421425522322
STAT,1844,26,35-39,1870,11.786562800959002
STAT,1905,45,35-39,1950,0.11471896851827222
STAT,1917,8,na,1925,4220.800784648697
STAT,1902,46,20-24,1948,0.00955890005039635
STAT,1829,71,na,1900,487.42843767147957
STAT,1806,75,na,1881,375.07943911917715
STAT,1867,19,40-44,1886,0.1747573337635291
STAT,1858,53,25-29,1911,0.00266147857713377
STAT,1947,17,25-29,1964,48.30128219484679
STAT,1839,53,30-34,1892,0.005441516835861756
SIM,1875,31,30-34,1906,2
STAT,1850,40,15-19,1890,0.0064411945509088514
STAT,1891,36,35-39,1927,8.739637733556117
STAT,1892,12,na,1904,3197.388615108994
STAT,1842,50,25-29,1892,8.919208078304221E-4
SIM,1823,53,na,1876,1148
STAT,1914,48,40-44,1962,0.1537602590664778
SIM,1858,29,na,1887,2431
STAT,1867,51,40-44,1918,0.010003951804360851
STAT,1875,40,na,1915,2397.24916016074
SIM,1832,45,35-39,1877,1
SIM,1872,30,na,1902,2399
SIM,1890,30,45-49,1920,19
STAT,1915,22,30-34,1937,29.289825241447215
SIM,1913,11,na,1924,3635
STAT,1899,26,25-29,1925,57.97640651084097
STAT,1840,28,35-39,1868,4.7031718270621585
STAT,1887,24,40-44,1911,2.279234230863178
SIM,1844,23,na,1867,2978
STAT,1809,51,na,1860,2911.3040477156214
STAT,1927,24,15-19,1951,6.464306000939785
STAT,1802,53,35-39,1855,0.04282648939068159
STAT,1937,31,20-24,1968,2.3896309255958013
SIM,1885,20,35-39,1905,61
STAT,1890,40,45-49,1930,1.8301256315468795
STAT,1824,45,35-39,1869,0.02484881680315956
STAT,1840,56,na,1896,803.1152640900078
STAT,1848,92,na,1940,38.97446163822461
SIM,1899,16,25-29,1915,2
STAT,1827,45,na,1872,1827.988831851846
STAT,1829,49,35-39,1878,0.06309570623244294
STAT,1937,28,20-24,1965,17.601384109016404
STAT,1918,40,45-49,1958,0.17504908064849714
STAT,1818,36,35-39,1854,20.042318030239112
SIM,1799,76,na,1875,105
STAT,1880,53,na,1933,2199.4301555469387
STAT,1857,47,45-49,1904,0.18025301095734125
SIM,1876,43,40-44,1919,42
SIM,1906,23,15-19,1929,68
STAT,1827,42,40-44,1869,2.134704412346689
STAT,1893,21,30-34,1914,22.3420050012778
STAT,1836,52,35-39,1888,0.006674872244849533
STAT,1818,45,50-100,1863,0.4515744187106071
STAT,1855,16,45-49,1871,0.05172578737818362
STAT,1872,36,30-34,1908,5.362510265884849
STAT,1833,25,20-24,1858,7.724806171688154
STAT,1865,52,20-24,1917,6.701272840322125E-4
STAT,1824,40,na,1864,548.2601786769477
SIM,1819,41,45-49,1860,2
STAT,1878,32,45-49,1910,1.7941649997179157
STAT,1956,14,na,1970,5150.548343765952
STAT,1884,43,25-29,1927,0.6102786087701398
STAT,1898,35,na,1933,3198.210105216205
SIM,1841,25,20-24,1866,6
STAT,1914,35,50-100,1949,0.4172961714939441
SIM,1935,21,na,1956,5754
STAT,1816,40,50-100,1856,3.6538824591981482
STAT,1887,44,20-24,1931,0.17244175756052535
STAT,1864,50,45-49,1914,0.013382918500391123
STAT,1865,46,35-39,1911,0.12818165089771436
STAT,1817,52,25-29,1869,0.0023957970667670974
SIM,1889,27,20-24,1916,21
SIM,1869,34,40-44,1903,1
STAT,1852,46,na,1898,2271.092361289679
SIM,1900,31,35-39,1931,105
STAT,1872,75,na,1947,1030.861726600046
STAT,1933,21,35-39,1954,12.442426389733143
STAT,1910,40,50-100,1950,0.11103022117857277
SIM,1865,47,45-49,1912,1
STAT,1826,30,30-34,1856,41.73517215640662
STAT,1909,25,40-44,1934,4.476783830509989
SIM,1873,18,na,1891,2310
STAT,1887,43,na,1930,2525.5429302498674
STAT,1835,32,na,1867,2087.67069454899
STAT,1945,22,na,1967,3958.1238483084508
STAT,1851,42,50-100,1893,0.8333505992608546
STAT,1862,46,15-19,1908,3.416634225625039E-4
STAT,1822,99,na,1921,1.092099005726722
STAT,1837,98,na,1935,2.604789515629335
STAT,1848,19,30-34,1867,1.827221834898247
SIM,1852,10,na,1862,2630
SIM,1837,49,35-39,1886,2
STAT,1829,89,na,1918,38.36233925880127
STAT,1842,103,na,1945,0.03562681020308946
STAT,1883,31,15-19,1914,0.13756221184719458
STAT,1838,32,15-19,1870,0.0755391694261879
SIM,1891,31,15-19,1922,1
STAT,1862,31,50-100,1893,0.7835931500012419
STAT,1869,18,50-100,1887,0.04982617951058983
STAT,1893,41,40-44,1934,2.825509181821546
STAT,1838,29,15-19,1867,0.2428409118642959
STAT,1816,40,15-19,1856,0.04776317289150633
SIM,1915,20,na,1935,3495
STAT,1883,51,25-29,1934,0.0034238733218052006
STAT,1864,19,20-24,1883,16.476972888824015
STAT,1826,50,40-44,1876,0.015133168626344505
STAT,1916,39,50-100,1955,0.41982224280420927
SIM,1852,64,na,1916,1806
STAT,1844,49,na,1893,2182.3546994599724
STAT,1856,41,20-24,1897,0.11458415547007501
STAT,1887,11,na,1898,2846.740196090453
STAT,1910,23,na,1933,3532.6835434918557
STAT,1935,30,35-39,1965,12.566097342267769
SIM,1925,11,na,1936,5290
STAT,1899,45,35-39,1944,0.10894017219462337
STAT,1810,99,na,1909,0.05896474281690908
STAT,1936,35,20-24,1971,0.2566665306298878
STAT,1904,32,50-100,1936,0.751648685603315
STAT,1927,45,50-100,1972,0.2829256001502215
STAT,1866,37,45-49,1903,1.8196919727504315
STAT,1922,42,25-29,1964,0.08104917886816485
STAT,1928,21,na,1949,4538.445952987621
STAT,1912,30,40-44,1942,3.836550251737903
STAT,1863,43,20-24,1906,0.13460123372459387
STAT,1863,81,na,1944,461.65730709194065
SIM,1903,19,na,1922,2937
STAT,1872,48,25-29,1920,0.056953582085107764
STAT,1850,31,na,1881,1164.7368430736913
STAT,1867,96,na,1963,23.156778384872823
STAT,1901,43,35-39,1944,0.17455074872725704
STAT,1800,81,na,1881,365.2560501927133
STAT,1905,23,25-29,1928,82.0831158558841
SIM,1874,37,45-49,1911,2
STAT,1842,54,40-44,1896,0.002541563144736999
STAT,1832,91,na,1923,49.190418745180004
STAT,1872,54,50-100,1926,0.014707402788983751
SIM,1865,31,na,1896,1763
STAT,1892,20,25-29,1912,71.29832182738677
SIM,1792,72,na,1864,853
STAT,1859,18,35-39,1877,0.5018575899786166
STAT,1829,57,na,1886,751.6502687664982
STAT,1881,26,30-34,1907,23.86207906172888
STAT,1797,106,na,1903,1.2137386637929535E-4
STAT,1911,48,30-34,1959,0.0832117156306482
STAT,1870,47,20-24,1917,0.011907424995066066
STAT,1841,37,40-44,1878,5.743277218792703
STAT,1853,52,35-39,1905,0.006639830788584702
STAT,1910,21,40-44,1931,3.1316685109804174
STAT,1868,18,45-49,1886,0.06385711059263041
SIM,1801,74,na,1875,1570
STAT,1865,96,na,1961,17.663898157129207
STAT,1918,15,40-44,1933,0.30272207052767297
STAT,1856,0,na,1856,2857.826706806163
STAT,1845,41,45-49,1886,0.7660140849892562
STAT,1876,59,na,1935,1964.6635182193331
SIM,1852,42,40-44,1894,3
STAT,1962,1,na,1963,4997.768749690487
STAT,1865,19,na,1884,2348.2338965861372
SIM,1937,21,na,1958,2988
STAT,1849,51,25-29,1900,0.002998750854734956
STAT,1768,95,na,1863,6.565289012636614
STAT,1878,69,na,1947,1509.9102364196713
STAT,1925,35,45-49,1960,0.8121310137539542
STAT,1933,7,na,1940,5314.678373680476
STAT,1876,56,na,1932,2061.882409252854
STAT,1808,87,na,1895,41.2621974714077
STAT,1860,42,25-29,1902,0.5232217135366095
STAT,1793,91,na,1884,16.9696813979969
STAT,1878,37,na,1915,2423.9924203762666
STAT,1866,49,na,1915,2010.8171425619219
SIM,1788,68,na,1856,340
STAT,1860,49,45-49,1909,0.18850713597325947
STAT,1843,33,35-39,1876,11.904865581637726
STAT,1859,41,40-44,1900,1.7908259904638244
SIM,1859,22,na,1881,1345
STAT,1909,40,35-39,1949,0.18854180026099965
SIM,1829,29,20-24,1858,3
SIM,1871,56,na,1927,1742
STAT,1844,42,40-44,1886,2.282184366219288
STAT,1920,46,15-19,1966,4.029638271257912E-4
STAT,1813,51,45-49,1864,0.05147334251195014
STAT,1860,30,30-34,1890,14.357992006642265
STAT,1891,21,20-24,1912,84.99952347173361
STAT,1841,45,35-39,1886,0.16067048951978208
STAT,1879,33,15-19,1912,0.1454709767696489
STAT,1880,42,45-49,1922,1.551830751449291
SIM,1850,54,na,1904,1110
STAT,1821,45,15-19,1866,4.3942951651940594E-4
STAT,1821,51,na,1872,1238.8697243477493
STAT,1921,43,20-24,1964,0.019624384611658805
STAT,1853,36,20-24,1889,0.6039462801307279
STAT,1848,39,25-29,1887,2.7194415909943377
STAT,1824,30,20-24,1854,1.3776321800826024
STAT,1856,53,30-34,1909,0.004206793061357433
STAT,1874,44,na,1918,2353.155368353272
STAT,1922,49,45-49,1971,0.24544871432558302
STAT,1793,94,na,1887,3.8932393093461557
STAT,1906,32,30-34,1938,14.517451905828334
STAT,1902,49,25-29,1951,0.044797533433936845
STAT,1844,46,na,1890,2235.2205087517177
STAT,1893,29,na,1922,2963.083537305439
STAT,1910,43,45-49,1953,0.15459662980405645
STAT,1940,25,35-39,1965,15.151148968055773
STAT,1843,39,50-100,1882,1.2622057214403102
SIM,1803,52,na,1855,1659
STAT,1891,48,na,1939,2732.4382151356135
SIM,1929,26,na,1955,6254
STAT,1776,90,na,1866,54.84415491736286
SIM,1866,41,30-34,1907,8
STAT,1879,14,na,1893,2640.6641558209153
STAT,1892,27,45-49,1919,1.3746594458966974
SIM,1833,36,45-49,1869,4
SIM,1910,49,25-29,1959,1
SIM,1920,30,40-44,1950,1
STAT,1822,42,20-24,1864,0.2831447896618367
STAT,1909,19,20-24,1928,26.17511211350033
STAT,1799,85,na,1884,18.131073327068016
STAT,1846,27,na,1873,1549.9599977817932
STAT,1866,22,50-100,1888,0.3752780847344331
STAT,1834,51,50-100,1885,0.006961260400521824
STAT,1912,39,40-44,1951,1.429576381279815
STAT,1851,40,25-29,1891,0.5122883932898062
STAT,1825,36,45-49,1861,2.9430092253869717
STAT,1880,21,45-49,1901,0.7261130957775491
SIM,1920,39,40-44,1959,7
STAT,1900,33,40-44,1933,5.982238121041095
SIM,1949,5,na,1954,4496
STAT,1910,22,45-49,1932,1.044820807785938
SIM,1848,40,25-29,1888,3
SIM,1889,41,na,1930,3844
SIM,1940,25,35-39,1965,198
STAT,1847,50,45-49,1897,0.013309472739734951
SIM,1796,65,na,1861,998
STAT,1815,52,30-34,1867,5.825075592736E-4
SIM,1844,36,20-24,1880,3
STAT,1851,19,na,1870,2178.2940477372513
SIM,1847,12,na,1859,1827
STAT,1842,18,25-29,1860,1.7957914376220223
STAT,1817,43,35-39,1860,1.3068909845973034
STAT,1913,49,50-100,1962,0.21671399805368144
STAT,1937,34,25-29,1971,9.038021237063136
STAT,1920,43,45-49,1963,0.18116081672992806
STAT,1823,45,50-100,1868,0.3943152004932185
SIM,1934,4,na,1938,5392
STAT,1850,34,na,1884,1129.0132277759353
STAT,1883,52,50-100,1935,0.01445214942069959
STAT,1901,42,50-100,1943,0.10244983521603837
SIM,1902,56,na,1958,2948
STAT,1892,63,na,1955,2209.136080975374
SIM,1928,19,30-34,1947,209
SIM,1960,10,na,1970,6451
STAT,1854,45,50-100,1899,0.13791936581196498
STAT,1943,10,na,1953,4130.426060891266
STAT,1840,25,30-34,1865,12.542632531645339
SIM,1939,11,na,1950,4762
STAT,1921,18,na,1939,4134.97556733587
STAT,1921,24,20-24,1945,123.3267917115136
SIM,1805,65,na,1870,2097
STAT,1847,29,50-100,1876,0.685208682938801
STAT,1890,45,15-19,1935,4.890701894370107E-4
STAT,1831,47,25-29,1878,0.05431692295611486
STAT,1910,26,na,1936,3589.2711299823786
STAT,1842,36,45-49,1878,0.5865816408461242
STAT,1887,47,30-34,1934,0.10604844574703912
STAT,1921,25,25-29,1946,72.97898805248674
STAT,1852,12,na,1864,2906.2942713325265
STAT,1893,44,45-49,1937,0.12821275019873585
STAT,1897,42,20-24,1939,0.014628127026459006
STAT,1879,18,20-24,1897,18.13898490180308
SIM,1879,34,na,1913,1394
SIM,1915,23,na,1938,2039
SIM,1860,61,na,1921,1689
STAT,1827,46,20-24,1873,0.011128754632688238
SIM,1861,49,na,1910,2099
STAT,1867,54,45-49,1921,0.01334740257474584
SIM,1851,33,35-39,1884,4
STAT,1890,63,na,1953,2160.0916896081044
STAT,1906,35,35-39,1941,2.2316612344393865
STAT,1927,37,50-100,1964,0.5177538579035329
STAT,1936,19,15-19,1955,42.78784683528932
STAT,1850,20,20-24,1870,38.747832494430774
SIM,1837,75,na,1912,1243
SIM,1935,3,na,1938,5974
STAT,1861,26,na,1887,2013.6125085427834
STAT,1936,36,25-29,1972,0.9578888780123156
STAT,1900,31,25-29,1931,14.246915417536227
STAT,1892,41,na,1933,2874.4794427650418
STAT,1915,44,40-44,1959,0.2474355117641216
STAT,1939,4,na,1943,3987.052361177209
STAT,1877,37,20-24,1914,0.7825043907312819
SIM,1938,18,na,1956,4240
STAT,1826,53,45-49,1879,0.01965598473467154
SIM,1849,22,20-24,1871,2
SIM,1922,32,30-34,1954,21
SIM,1895,69,na,1964,4126
STAT,1912,46,15-19,1958,3.507783511850919E-4
STAT,1779,87,na,1866,87.0607766847661
STAT,1883,29,50-100,1912,0.611013247045905
STAT,1939,24,15-19,1963,5.283634513370062
SIM,1847,34,na,1881,1582
STAT,1825,64,na,1889,1080.236966973495
SIM,1897,70,na,1967,1237
STAT,1768,107,na,1875,0.02142505110638902
STAT,1849,15,30-34,1864,1.6727504239861577
SIM,1871,43,20-24,1914,1
STAT,1829,46,30-34,1875,0.0453591209546151
STAT,1812,51,35-39,1863,0.002161166173943246
STAT,1883,19,25-29,1902,5.422401529420297
SIM,1903,32,20-24,1935,7
STAT,1851,26,45-49,1877,1.034164080774285
SIM,1812,66,na,1878,529
STAT,1896,37,30-34,1933,7.025602017347221
STAT,1893,26,na,1919,2994.6554222507343
SIM,1902,34,na,1936,3436
SIM,1922,29,30-34,1951,4
SIM,1885,2,na,1887,2605
STAT,1943,18,na,1961,3857.3840050735575
STAT,1932,25,35-39,1957,19.544837455249002
STAT,1855,86,na,1941,146.8457506740448
SIM,1856,57,na,1913,158
SIM,1900,2,na,1902,4181
STAT,1874,18,50-100,1892,0.05043040261027137
STAT,1914,32,30-34,1946,15.638603900053461
STAT,1882,43,30-34,1925,1.0927529200988217
STAT,1898,48,45-49,1946,0.17676430085419698
STAT,1831,54,30-34,1885,0.004745955586463679
STAT,1901,19,50-100,1920,0.06813383103837585
SIM,1887,63,na,1950,2486
STAT,1836,19,45-49,1855,0.11829826821638618
STAT,1855,16,50-100,1871,0.03879434053363772
STAT,1882,34,na,1916,2265.118176147002
STAT,1897,49,40-44,1946,0.12557358900519525
STAT,1884,34,35-39,1918,9.611361510860208
STAT,1820,106,na,1926,0.008349986971912117
STAT,1870,40,35-39,1910,1.8234759811166406
SIM,1848,47,45-49,1895,3
STAT,1833,28,25-29,1861,25.291799343635923
STAT,1854,52,45-49,1906,0.00802620249671484
SIM,1907,42,40-44,1949,1
STAT,1846,46,30-34,1892,0.0574936245772687
SIM,1866,44,35-39,1910,15
STAT,1907,59,na,1966,3057.183185288193
STAT,1841,51,20-24,1892,8.25652842970795E-4
SIM,1839,68,na,1907,127
STAT,1830,35,15-19,1865,0.05229509079178458
STAT,1934,36,na,1970,5161.271955032043
STAT,1820,36,na,1856,1977.0087691528693
SIM,1875,15,25-29,1890,60
STAT,1874,41,15-19,1915,0.014317152585844073
STAT,1830,68,na,1898,1106.0670934318703
SIM,1933,33,45-49,1966,15
STAT,1921,23,50-100,1944,0.732115717674845
SIM,1903,34,20-24,1937,1
STAT,1839,41,20-24,1880,0.17309236718277088
SIM,1917,33,na,1950,2060
SIM,1876,27,35-39,1903,80
STAT,1799,56,na,1855,211.76424
STAT,1840,18,15-19,1858,3.007643576636241
STAT,1883,17,50-100,1900,0.04713230354773967
SIM,1909,19,20-24,1928,291
STAT,1830,43,na,1873,1833.0876323590223
STAT,1835,104,na,1939,0.050468927379433
STAT,1869,55,na,1924,2086.4922991440285
STAT,1816,50,na,1866,2422.5198060748103
STAT,1925,18,50-100,1943,0.44726689800808694
STAT,1901,37,15-19,1938,0.016947023585276992
STAT,1858,44,35-39,1902,1.3641879056500554
STAT,1827,90,na,1917,55.597702103705615
SIM,1906,44,40-44,1950,3
STAT,1866,30,25-29,1896,9.424794660910937
STAT,1839,29,30-34,1868,29.05154781229009
STAT,1881,45,30-34,1926,0.0923242108130683
STAT,1925,33,45-49,1958,1.8503687122396524
STAT,1856,16,50-100,1872,0.04185473560318855
STAT,1863,46,25-29,1909,0.04931344142754989
STAT,1865,19,30-34,1884,1.4819326781332247
STAT,1867,15,25-29,1882,5.543819405443757
STAT,1805,54,20-24,1859,8.295223576618595E-4
SIM,1863,27,na,1890,1140
STAT,1843,30,30-34,1873,21.174192077940827
STAT,1835,35,na,1870,2045.510923058975
STAT,1940,22,30-34,1962,28.950051139406224
STAT,1835,40,40-44,1875,2.0920982229446308
STAT,1872,45,20-24,1917,0.012136113086735574
STAT,1843,83,na,1926,392.24091085400073
STAT,1881,33,50-100,1914,0.8616030668724257
STAT,1814,54,30-34,1868,0.018862518962315902
STAT,1813,107,na,1920,0.003454558960020384
SIM,1857,41,na,1898,1405
STAT,1952,8,na,1960,4666.710443841946
STAT,1915,47,45-49,1962,0.2159102069808364
STAT,1845,42,na,1887,1167.885579258484
STAT,1856,51,50-100,1907,0.01089950517744357
STAT,1931,26,50-100,1957,1.2765833684188723
STAT,1921,49,35-39,1970,0.1427795659755425
SIM,1862,42,na,1904,3509
STAT,1894,37,20-24,1931,0.9802565685525401
SIM,1830,32,na,1862,827
STAT,1829,30,50-100,1859,0.5323686717961686
STAT,1841,42,30-34,1883,1.3303195384295765
STAT,1836,47,50-100,1883,0.19695310733346816
STAT,1822,45,25-29,1867,0.09902907010313072
SIM,1844,47,50-100,1891,10
STAT,1860,46,40-44,1906,0.14006015013453746
STAT,1860,33,35-39,1893,8.226717271880862
SIM,1828,28,na,1856,2192
STAT,1834,52,25-29,1886,0.001600592842300848
STAT,1930,36,30-34,1966,2.3627592194565197
STAT,1916,21,35-39,1937,9.761397710161573
SIM,1803,55,na,1858,1573
STAT,1904,48,na,1952,3174.540216426989
STAT,1814,72,na,1886,936.7872680697627
STAT,1816,53,50-100,1869,0.043324400279722494
STAT,1911,36,20-24,1947,0.25295584255161
SIM,1898,58,na,1956,3868
SIM,1914,35,35-39,1949,4
STAT,1886,48,50-100,1934,0.25113542500181735
STAT,1910,40,40-44,1950,0.2363927756514857
STAT,1867,45,na,1912,2148.9547326561933
STAT,1909,37,na,1946,3524.8092515144017
STAT,1827,79,na,1906,493.00311949978453
STAT,1821,49,30-34,1870,0.10078898561569852
STAT,1870,32,40-44,1902,4.3234163625325275
STAT,1858,29,40-44,1887,2.3083034961096973
STAT,1894,35,50-100,1929,1.5760971331567282
STAT,1925,32,40-44,1957,4.604542166880876
STAT,1903,40,40-44,1943,0.22395683217305307
SIM,1907,23,na,1930,4003
STAT,1876,88,na,1964,292.89836758179166
SIM,1849,25,25-29,1874,9
STAT,1940,19,30-34,1959,12.22872062179783
SIM,1884,74,na,1958,2272
STAT,1915,46,40-44,1961,0.15701578644448125
SIM,1861,46,na,1907,2180
SIM,1830,45,25-29,1875,1
STAT,1853,93,na,1946,22.66103995569835
STAT,1905,17,20-24,1922,25.499310809352004
STAT,1892,24,40-44,1916,2.563799926205375
STAT,1777,87,na,1864,142.02122632145964
STAT,1843,61,na,1904,1846.2955408767336
STAT,1861,30,40-44,1891,3.635590094066351
STAT,1838,31,na,1869,1160.4677820240997
STAT,1925,41,30-34,1966,0.15358673010362792
STAT,1918,34,15-19,1952,0.13355874734532955
STAT,1899,42,30-34,1941,0.10891020173845653
SIM,1838,38,na,1876,2059
STAT,1877,50,30-34,1927,0.006129388156091653
STAT,1831,44,20-24,1875,0.15110376385354485
STAT,1854,31,45-49,1885,1.0032887822209995
STAT,1843,86,na,1929,219.22359549297656
STAT,1818,94,na,1912,12.164651588255708
STAT,1840,21,15-19,1861,1.6638957368562919
STAT,1850,47,35-39,1897,0.06434524649053981
SIM,1950,18,na,1968,4835
STAT,1905,20,20-24,1925,99.70965118881085
SIM,1894,33,na,1927,1587
STAT,1921,22,20-24,1943,124.10370245812491
STAT,1830,51,45-49,1881,0.011130044027177727
STAT,1819,79,na,1898,162.60654311203146
SIM,1849,12,na,1861,2604
SIM,1926,34,15-19,1960,1
STAT,1852,43,45-49,1895,1.4956173167082898
STAT,1868,24,30-34,1892,17.09666287185377
STAT,1838,17,20-24,1855,9.996436333634177
STAT,1929,43,30-34,1972,0.16414439237856515
SIM,1855,19,20-24,1874,46
STAT,1873,40,45-49,1913,1.5507139532453103
STAT,1891,48,35-39,1939,0.095893482405739
SIM,1900,43,35-39,1943,1
STAT,1909,15,na,1924,3766.4294308608296
STAT,1797,75,na,1872,16.97043471215915
STAT,1878,54,20-24,1932,7.38344432489509E-4
STAT,1897,45,25-29,1942,0.04358018361647109
STAT,1910,30,30-34,1940,15.142099687681354
SIM,1904,60,na,1964,3873
SIM,1905,45,na,1950,3097
STAT,1892,41,25-29,1933,0.7986480777005653
STAT,1900,36,45-49,1936,0.5989247403354798
SIM,1812,69,na,1881,529
STAT,1817,40,30-34,1857,0.8727301277803176
STAT,1937,32,na,1969,3703.1032330579706
SIM,1915,52,na,1967,2800
STAT,1805,76,na,1881,154.7761125894661
SIM,1835,26,35-39,1861,14
SIM,1916,37,na,1953,4588
STAT,1882,38,40-44,1920,4.170278415601826
SIM,1940,22,30-34,1962,6
STAT,1855,32,15-19,1887,0.09596654768617705
STAT,1816,39,na,1855,2699.563515607822
SIM,1938,17,25-29,1955,763
STAT,1859,53,40-44,1912,0.008210163201492319
STAT,1884,31,30-34,1915,16.78200830491351
SIM,1885,59,na,1944,1103
STAT,1922,46,40-44,1968,0.17954940661269655
STAT,1815,47,40-44,1862,0.017353477223769988
STAT,1806,50,50-100,1856,0.041763760082795774
STAT,1868,59,na,1927,1877.1353846011268
SIM,1874,67,na,1941,1948
STAT,1839,16,na,1855,2806.30275216167
STAT,1918,26,50-100,1944,1.0485715850345763
STAT,1856,82,na,1938,335.12448922493087
STAT,1833,40,15-19,1873,0.0073857265351388035
STAT,1847,19,20-24,1866,19.77038466175842
STAT,1821,34,50-100,1855,1.2204271766282546
STAT,1825,50,25-29,1875,0.004520357336895817
STAT,1859,45,na,1904,1800.9849997231315
SIM,1838,20,na,1858,1872
STAT,1829,39,15-19,1868,0.02755205490624031
SIM,1842,57,na,1899,3011
STAT,1858,35,50-100,1893,0.9464876593277856
STAT,1911,44,15-19,1955,0.0014314118183850052
STAT,1840,36,50-100,1876,0.577746773710092
STAT,1863,30,na,1893,2053.5985742663624
SIM,1885,5,na,1890,1920
STAT,1858,111,na,1969,8.553332689349089E-4
SIM,1881,15,na,1896,3187
STAT,1865,30,na,1895,2196.1932207293876
STAT,1839,102,na,1941,0.2723789428762532
STAT,1829,42,15-19,1871,0.006643818273151436
STAT,1871,36,15-19,1907,0.05628623639727772
STAT,1869,42,45-49,1911,1.5083731459446206
SIM,1903,35,25-29,1938,3
STAT,1876,70,na,1946,1418.378983586544
STAT,1926,40,na,1966,4551.852135365802
SIM,1951,14,na,1965,2365
SIM,1820,38,25-29,1858,5
STAT,1862,103,na,1965,0.6245093018904271
STAT,1849,18,35-39,1867,0.5657491732918793
STAT,1955,9,na,1964,5171.065275136641
SIM,1927,9,na,1936,1973
STAT,1866,51,25-29,1917,0.003248685359943291
STAT,1896,33,15-19,1929,0.18693366958019494
SIM,1814,47,na,1861,2442
STAT,1859,4,na,1863,2452.2699923583186
STAT,1900,35,40-44,1935,6.12168224169699
SIM,1922,35,35-39,1957,2
SIM,1872,19,na,1891,2493
STAT,1838,18,50-100,1856,0.027461925181157934
SIM,1893,43,40-44,1936,2
STAT,1842,68,na,1910,379.366589612884
STAT,1894,22,na,1916,3007.534251116834
STAT,1828,41,45-49,1869,1.9031169555774583
STAT,1855,29,15-19,1884,0.3085101966877084
STAT,1872,16,45-49,1888,0.06601530946888036
SIM,1845,53,na,1898,2062
SIM,1885,37,na,1922,1575
SIM,1865,82,na,1947,254
STAT,1922,32,15-19,1954,0.143574765819163
STAT,1928,40,45-49,1968,0.21113871206753118
STAT,1809,50,40-44,1859,0.09055505435763352
STAT,1900,47,50-100,1947,0.19102113225480158
SIM,1851,30,30-34,1881,9
STAT,1876,41,40-44,1917,2.284099469507339
STAT,1895,32,45-49,1927,2.2684902973762235
STAT,1846,49,35-39,1895,0.08118528730500521
SIM,1935,29,na,1964,5722
STAT,1936,33,20-24,1969,2.3442223304897447
STAT,1939,28,30-34,1967,38.9387008706281
STAT,1918,29,na,1947,3904.8520779679993
STAT,1914,35,35-39,1949,2.404007694386818
SIM,1889,44,na,1933,3846
SIM,1883,20,25-29,1903,220
STAT,1930,22,50-100,1952,0.8370176620389159
STAT,1939,1,na,1940,4125.242232763459
STAT,1817,102,na,1919,0.09287473703631403
STAT,1901,18,40-44,1919,0.25506780085114866
STAT,1818,52,40-44,1870,0.01801483005527785
STAT,1875,53,25-29,1928,0.0035787258878328893
SIM,1881,40,45-49,1921,15
STAT,1867,74,na,1941,1049.560417767011
STAT,1894,20,35-39,1914,7.465014398176559
SIM,1928,28,20-24,1956,244
STAT,1842,15,20-24,1857,5.718642249765136
STAT,1882,52,20-24,1934,7.027305734583905E-4
STAT,1856,48,40-44,1904,0.12141994887411679
STAT,1910,24,45-49,1934,1.0382800479393417
STAT,1882,46,35-39,1928,0.13441799369843907
STAT,1932,22,30-34,1954,37.44868194017014
STAT,1844,50,35-39,1894,0.008651463199324251
STAT,1944,24,15-19,1968,5.678952518362731
STAT,1860,54,35-39,1914,0.006830069614687753
SIM,1836,41,45-49,1877,7
STAT,1916,48,15-19,1964,3.716403763153394E-4
SIM,1874,45,na,1919,2470
STAT,1871,6,na,1877,2752.423169608494
SIM,1950,9,na,1959,4854
SIM,1851,3,na,1854,1896
STAT,1904,46,30-34,1950,0.07823294668868021
STAT,1900,16,na,1916,3507.2781887477413
STAT,1837,53,20-24,1890,5.821883725838482E-4
STAT,1907,37,na,1944,3464.724078631637
SIM,1827,68,na,1895,974
STAT,1857,67,na,1924,1216.4350114782753
STAT,1874,41,50-100,1915,1.0952620927824046
STAT,1894,17,35-39,1911,0.6977706663894429
STAT,1789,97,na,1886,1.6877153468260486
STAT,1836,22,50-100,1858,0.41239696724576885
STAT,1885,43,40-44,1928,2.194953022540284
SIM,1864,48,40-44,1912,3
STAT,1949,17,35-39,1966,4.83212600070156
STAT,1918,11,na,1929,4260.881354756984
STAT,1919,39,na,1958,3979.599458964982
STAT,1909,35,50-100,1944,0.39709821365287906
STAT,1847,16,15-19,1863,6.736384697360932
SIM,1854,22,na,1876,1614
STAT,1913,15,25-29,1928,8.789723582276098
STAT,1831,39,40-44,1870,4.336843332043173
STAT,1923,37,30-34,1960,2.08957245973376
STAT,1889,43,na,1932,2763.147140090334
STAT,1927,34,na,1961,4608.528763826299
SIM,1855,48,35-39,1903,4
STAT,1878,91,na,1969,199.4984294439719
SIM,1872,6,na,1878,2625
STAT,1878,16,45-49,1894,0.06737338027055811
STAT,1882,42,50-100,1924,1.0102126054116614
SIM,1869,75,na,1944,3598
STAT,1811,107,na,1918,0.0028570703456350923
STAT,1912,34,20-24,1946,2.3519284903431794
SIM,1850,32,na,1882,1756
STAT,1885,53,na,1938,2082.529922702183
STAT,1937,31,15-19,1968,0.1258950743421045
SIM,1869,30,25-29,1899,27
STAT,1853,20,na,1873,1987.29019278406
STAT,1916,41,25-29,1957,0.07228445537622082
STAT,1893,15,30-34,1908,2.0024386755826513
STAT,1812,46,na,1858,245.8087727265692
SIM,1918,30,45-49,1948,104
STAT,1946,24,20-24,1970,122.31798807843649
SIM,1928,2,na,1930,4662
SIM,1921,15,25-29,1936,36
SIM,1846,27,na,1873,1261
STAT,1955,17,25-29,1972,57.025342488467736
STAT,1902,27,15-19,1929,0.6388859632911199
STAT,1899,73,na,1972,2072.822676641502
STAT,1906,38,40-44,1944,1.3614174779771788
SIM,1920,44,na,1964,3639
STAT,1865,50,50-100,1915,0.013986824463340996
STAT,1871,36,50-100,1907,1.230621649327968
STAT,1929,25,30-34,1954,48.87909204447404
SIM,1880,30,na,1910,3126
SIM,1882,65,na,1947,1204
SIM,1950,0,na,1950,5367
STAT,1927,28,30-34,1955,47.08043569924321
STAT,1864,45,30-34,1909,0.08887881248350296
SIM,1919,29,30-34,1948,22
STAT,1822,48,30-34,1870,0.15963917351841342
STAT,1932,28,40-44,1960,6.059616447326524
STAT,1908,35,40-44,1943,1.4039474837806785
SIM,1907,54,na,1961,4344
SIM,1929,30,20-24,1959,36
STAT,1914,44,25-29,1958,0.06954225130893074
STAT,1925,32,35-39,1957,10.752490387035904
SIM,1883,36,50-100,1919,18
STAT,1926,27,50-100,1953,1.1829629430685293
SIM,1890,60,na,1950,3139
SIM,1935,28,30-34,1963,1
STAT,1901,34,45-49,1935,2.4173634474805428
SIM,1875,46,50-100,1921,1
SIM,1937,27,25-29,1964,109
SIM,1855,63,na,1918,2860
SIM,1871,14,na,1885,2013
STAT,1805,49,40-44,1854,0.20478173712408843
STAT,1933,27,45-49,1960,2.2783459647994007
SIM,1868,30,35-39,1898,13
STAT,1868,81,na,1949,522.3086765509613
STAT,1859,33,25-29,1892,8.083953720790207
STAT,1884,12,na,1896,2472.1647008044633
SIM,1859,45,na,1904,1762
SIM,1903,19,25-29,1922,1
STAT,1859,31,30-34,1890,13.894995752671482
STAT,1938,2,na,1940,3991.1970945934145
STAT,1904,42,45-49,1946,0.14830122364084586
STAT,1928,28,20-24,1956,22.3069487544022
STAT,1842,76,na,1918,235.18771788241148
STAT,1902,45,45-49,1947,0.1893283520220662
STAT,1913,22,na,1935,3651.487047028514
STAT,1869,23,40-44,1892,2.0962362993078827
STAT,1875,31,15-19,1906,0.1468292316283741
STAT,1902,50,na,1952,3075.661024130201
SIM,1863,50,na,1913,416
STAT,1930,30,20-24,1960,3.1292623500773398
SIM,1839,15,20-24,1854,23
STAT,1900,32,50-100,1932,1.2692616087383946
SIM,1808,61,na,1869,1261
STAT,1850,50,25-29,1900,0.0016590695161633586
SIM,1883,31,15-19,1914,1
STAT,1900,31,20-24,1931,3.759810304146597
SIM,1804,71,na,1875,592
SIM,1907,42,35-39,1949,2
STAT,1937,33,50-100,1970,0.8090324025488063
SIM,1936,28,20-24,1964,30
SIM,1910,45,45-49,1955,1
STAT,1827,99,na,1926,1.3355390340412436
STAT,1904,22,20-24,1926,98.45499985580686
STAT,1929,27,25-29,1956,81.7985309929745
STAT,1899,53,na,1952,2893.800663150151
SIM,1886,55,na,1941,2794
STAT,1934,25,40-44,1959,6.233216931109248
STAT,1853,32,50-100,1885,0.7316126955513989
SIM,1893,9,na,1902,3561
STAT,1865,30,45-49,1895,1.604891564593617
SIM,1863,19,na,1882,1388
SIM,1879,73,na,1952,463
STAT,1912,18,15-19,1930,9.04665825826569
STAT,1913,33,25-29,1946,9.04204580954374
STAT,1788,79,na,1867,111.22293369145326
SIM,1867,31,30-34,1898,13
STAT,1945,26,25-29,1971,71.44600247228229
SIM,1880,50,na,1930,3193
SIM,1900,23,40-44,1923,328
STAT,1917,28,45-49,1945,1.7812977897063011
SIM,1921,33,25-29,1954,2
STAT,1876,17,na,1893,2553.155523172233
STAT,1848,53,na,1901,1982.528483811878
STAT,1935,24,45-49,1959,1.5201449708091137
STAT,1944,27,20-24,1971,19.506919410702885
STAT,1943,19,50-100,1962,0.39249658503691226
STAT,1833,53,50-100,1886,0.006540173344312693
SIM,1877,19,na,1896,77
STAT,1859,54,50-100,1913,0.011641151645993192
STAT,1919,47,na,1966,3931.811869759279
STAT,1937,19,30-34,1956,11.700274454282033
STAT,1902,30,45-49,1932,2.475319719364599
STAT,1867,20,na,1887,2278.513814124652
STAT,1913,45,20-24,1958,0.010701192429404807
SIM,1932,21,na,1953,5970
SIM,1872,55,na,1927,2166
SIM,1835,20,30-34,1855,42
STAT,1896,25,na,1921,3167.3266430679473
SIM,1932,36,35-39,1968,18
STAT,1868,24,35-39,1892,5.6010357965779045
STAT,1904,42,15-19,1946,0.0013684081573496053
STAT,1860,20,15-19,1880,3.0930081716591156
STAT,1934,23,45-49,1957,1.5013663451197166
STAT,1934,38,15-19,1972,0.02629404395212159
STAT,1912,1,na,1913,4160.12612217897
SIM,1928,16,na,1944,4614
SIM,1914,36,na,1950,5008
STAT,1910,21,35-39,1931,8.76989714429185
SIM,1852,22,25-29,1874,1
STAT,1845,33,na,1878,1265.4792607968463
SIM,1921,30,20-24,1951,1
STAT,1909,34,45-49,1943,1.4736089098994272
SIM,1867,15,25-29,1882,16
SIM,1894,42,na,1936,1457
STAT,1840,44,30-34,1884,0.46027253012446456
STAT,1907,34,40-44,1941,3.602252117459991
STAT,1902,8,na,1910,3660.5781455360498
SIM,1912,22,20-24,1934,12
STAT,1877,17,40-44,1894,0.18566861619120942
SIM,1891,14,na,1905,2659
SIM,1867,40,na,1907,2094
SIM,1875,83,na,1958,602
STAT,1864,32,50-100,1896,0.8329644683707352
STAT,1839,22,15-19,1861,3.938176118219112
STAT,1913,17,20-24,1930,27.371743067376617
STAT,1853,26,50-100,1879,0.5787612276733548
SIM,1840,22,na,1862,2452
STAT,1928,26,25-29,1954,80.74947866206283
STAT,1844,22,25-29,1866,70.80936680428289
STAT,1858,35,30-34,1893,4.108661643860721
STAT,1922,33,50-100,1955,0.9198563338892687
SIM,1886,75,na,1961,1187
STAT,1912,16,20-24,1928,27.16300213989559
STAT,1907,36,35-39,1943,2.2382191389300523
STAT,1947,20,20-24,1967,124.43265890484075
STAT,1915,45,25-29,1960,0.05294474871706237
STAT,1843,104,na,1947,0.06590262442150317
STAT,1924,34,40-44,1958,4.515900573533857
STAT,1933,29,40-44,1962,6.140823868837564
SIM,1874,42,na,1916,2477
SIM,1903,44,na,1947,2715
STAT,1927,45,20-24,1972,0.01382372693902213
STAT,1917,38,15-19,1955,0.019582009922319062
STAT,1930,32,15-19,1962,0.164675500432916
SIM,1936,26,25-29,1962,420
STAT,1885,20,20-24,1905,68.14165217931202
STAT,1904,40,20-24,1944,0.015915075937554077
SIM,1860,52,50-100,1912,1
SIM,1858,49,50-100,1907,1
SIM,1915,36,35-39,1951,27
STAT,1819,43,50-100,1862,0.22171855986259226
STAT,1869,25,35-39,1894,9.802614896397825
STAT,1918,39,15-19,1957,0.019925254285076435
STAT,1861,51,50-100,1912,0.012620190536254804
SIM,1808,53,na,1861,1372
STAT,1928,44,25-29,1972,0.09004103365907558
STAT,1846,58,na,1904,1171.2535918996473
STAT,1889,31,45-49,1920,2.1085360479215187
SIM,1819,45,na,1864,1882
STAT,1839,16,50-100,1855,0.059895229773421495
STAT,1904,24,15-19,1928,4.683796125380348
STAT,1918,37,20-24,1955,0.27410289441836994
SIM,1856,17,na,1873,1148
STAT,1923,19,30-34,1942,14.086044681724909
SIM,1893,20,20-24,1913,290
SIM,1917,34,45-49,1951,1
STAT,1953,18,30-34,1971,14.607820421592544
STAT,1919,36,25-29,1955,1.044675828785979
STAT,1940,24,na,1964,3675.827055524382
STAT,1928,29,30-34,1957,47.858091046477654
SIM,1897,31,45-49,1928,1
STAT,1943,18,45-49,1961,0.5235120092524543
STAT,1811,84,na,1895,201.5376293955506
STAT,1851,30,15-19,1881,0.11952027319443011
STAT,1943,28,15-19,1971,0.7429075528819228
SIM,1831,44,30-34,1875,7
SIM,1890,80,na,1970,2001
SIM,1879,0,na,1879,2986
STAT,1844,20,30-34,1864,22.352549543432254
STAT,1916,42,50-100,1958,0.11874834292402593
STAT,1946,3,na,1949,4392.870822231674
SIM,1835,63,na,1898,1160
SIM,1880,7,na,1887,3342
STAT,1862,96,na,1958,11.21760742353827
SIM,1828,81,na,1909,163
STAT,1908,33,45-49,1941,1.467620540145101
STAT,1907,18,35-39,1925,0.7985221657823492
SIM,1839,45,na,1884,746
SIM,1956,6,na,1962,4927
STAT,1839,40,45-49,1879,1.6522404108293836
SIM,1829,39,50-100,1868,4
STAT,1866,100,na,1966,4.696766266791451
STAT,1858,51,na,1909,1652.1646338740504
SIM,1934,36,na,1970,5176
STAT,1860,10,na,1870,2274.221496809965
STAT,1876,30,20-24,1906,2.754508371004832
STAT,1868,100,na,1968,6.237349612380314
SIM,1903,64,na,1967,1652
STAT,1868,9,na,1877,2632.7233631389818
SIM,1863,9,na,1872,1639
STAT,1924,36,35-39,1960,2.827311491987054
STAT,1938,18,35-39,1956,4.093619791949113
STAT,1868,32,50-100,1900,0.8849748783099166
STAT,1865,33,na,1898,2169.486643388831
SIM,1927,36,25-29,1963,3
STAT,1834,30,15-19,1864,0.08207933028917463
STAT,1890,35,30-34,1925,6.513301266867405
STAT,1922,36,30-34,1958,2.0525858778580024
STAT,1938,30,20-24,1968,2.4290683245438265
STAT,1880,45,15-19,1925,4.1940140967279527E-4
STAT,1886,27,na,1913,2471.36437944544
STAT,1849,15,na,1864,2409.044288471295
STAT,1823,44,30-34,1867,1.8378052821290523
STAT,1807,79,na,1886,333.8505525512409
STAT,1867,25,30-34,1892,23.976850305415315
SIM,1887,60,na,1947,3006
STAT,1904,0,na,1904,4195.132018474758
STAT,1906,37,30-34,1943,1.665778120786091
STAT,1888,49,35-39,1937,0.089243158957575
STAT,1915,32,50-100,1947,0.8301620476340167
STAT,1905,23,20-24,1928,98.81197982141511
STAT,1852,15,na,1867,2827.753035359454
STAT,1920,40,35-39,1960,0.22014621330134357
STAT,1840,47,40-44,1887,0.06797839822923325
STAT,1860,2,na,1862,2817.748547090021
STAT,1927,29,15-19,1956,0.8478160746570972
SIM,1915,39,40-44,1954,1
STAT,1916,42,35-39,1958,0.20354086948768263
SIM,1939,0,na,1939,4905
SIM,1902,59,na,1961,2895
SIM,1869,35,na,1904,3467
STAT,1844,71,na,1915,1322.3721448254626
STAT,1859,48,50-100,1907,0.1922148275974526
STAT,1930,15,25-29,1945,55.89070700718101
SIM,1822,39,40-44,1861,9
STAT,1879,27,50-100,1906,0.6562219398332308
SIM,1931,36,na,1967,4955
STAT,1905,47,na,1952,3221.504681565844
STAT,1942,17,45-49,1959,0.5160763507642235
SIM,1895,20,25-29,1915,1
SIM,1879,65,na,1944,798
STAT,1826,38,na,1864,2238.2217002360103
STAT,1860,41,na,1901,1894.0226988351433
SIM,1922,4,na,1926,3823
STAT,1878,51,na,1929,2225.927492064247
STAT,1937,24,na,1961,3516.981598177008
STAT,1839,110,na,1949,2.5673634785645244E-4
STAT,1933,26,35-39,1959,19.80854940891296
STAT,1900,55,na,1955,2864.373462523432
STAT,1914,43,15-19,1957,0.0014981541558693994
STAT,1801,54,na,1855,987.0696041091823
STAT,1893,18,35-39,1911,0.6843782665496349
STAT,1922,23,25-29,1945,104.42129427463524
SIM,1930,23,25-29,1953,39
STAT,1903,28,15-19,1931,0.641768837160992
STAT,1907,34,na,1941,3481.4127066692195
STAT,1843,24,30-34,1867,21.774679731680664
SIM,1824,71,na,1895,1465
STAT,1919,38,20-24,1957,0.27915482665605246
STAT,1873,20,na,1893,2440.4936785416535
STAT,1887,20,25-29,1907,63.38465574129269
STAT,1924,14,na,1938,4657.951179213542
SIM,1826,30,30-34,1856,1
STAT,1889,23,50-100,1912,0.48955400078110634
SIM,1866,55,na,1921,2670
STAT,1852,17,35-39,1869,0.6680149446471717
STAT,1828,61,na,1889,1284.2499822196162
STAT,1832,37,35-39,1869,0.5394677982896892
STAT,1916,27,45-49,1943,1.7619251098063526
SIM,1822,37,na,1859,1545
STAT,1908,32,35-39,1940,8.559173354021333
STAT,1885,21,30-34,1906,17.561432201191597
STAT,1901,15,35-39,1916,0.7707780431218779
STAT,1953,19,15-19,1972,54.371147207610136
STAT,1862,47,20-24,1909,0.01017324235357482
STAT,1897,10,na,1907,3440.0874736648902
STAT,1907,39,40-44,1946,1.364745931937515
SIM,1893,49,na,1942,2846
STAT,1881,48,40-44,1929,0.15964091877912703
STAT,1925,35,40-44,1960,1.783360674657491
STAT,1939,17,40-44,1956,1.3846920102066524
STAT,1866,27,na,1893,2178.4630763959817
STAT,1893,37,50-100,1930,1.5353264798277195
STAT,1922,38,25-29,1960,1.1067402189442102
SIM,1858,41,30-34,1899,9
STAT,1822,49,40-44,1871,0.27844791644020583
SIM,1869,7,na,1876,3913
STAT,1954,16,25-29,1970,53.11372996262177
STAT,1888,81,na,1969,1032.5875234943935
SIM,1891,22,na,1913,2535
STAT,1917,25,40-44,1942,4.855583381716889
STAT,1871,81,na,1952,539.4361868617993
STAT,1901,30,25-29,1931,14.436482097707378
STAT,1905,36,50-100,1941,0.38298583331609587
STAT,1794,87,na,1881,0.7284097092671116
STAT,1859,15,25-29,1874,5.275545509217312
STAT,1959,5,na,1964,5097.115710034264
SIM,1856,8,na,1864,1362
SIM,1879,45,na,1924,1106
STAT,1911,20,40-44,1931,3.171737550668171
STAT,1921,49,na,1970,4068.4343985061073
STAT,1904,25,25-29,1929,60.845884776823844
STAT,1921,42,45-49,1963,0.18523115634361395
SIM,1861,24,na,1885,1940
STAT,1831,84,na,1915,260.3588615280028
STAT,1869,26,45-49,1895,1.1242316376580297
STAT,1913,42,na,1955,3576.3247685386077
SIM,1912,25,25-29,1937,1
STAT,1883,6,na,1889,2526.347541676214
SIM,1904,15,25-29,1919,4
SIM,1855,83,na,1938,151
STAT,1899,36,30-34,1935,7.314532589517603
STAT,1798,104,na,1902,0.028312029390823282
SIM,1892,25,30-34,1917,212
STAT,1930,14,na,1944,5070.161733288748
STAT,1852,35,na,1887,2434.40099973934
STAT,1934,22,35-39,1956,12.568212248441371
STAT,1926,31,40-44,1957,4.6940495960013635
STAT,1924,37,45-49,1961,0.7961461113263611
SIM,1932,33,30-34,1965,126
SIM,1829,50,50-100,1879,3
SIM,1900,28,40-44,1928,23
STAT,1916,45,45-49,1961,0.22091414751907001
SIM,1814,61,na,1875,2442
SIM,1846,78,na,1924,319
SIM,1930,39,35-39,1969,5
SIM,1896,17,15-19,1913,27
STAT,1855,94,na,1949,13.227515169011168
STAT,1862,3,na,1865,2756.1042091890126
SIM,1910,46,na,1956,3890
STAT,1790,97,na,1887,1.3455266254758087
STAT,1863,49,30-34,1912,0.08091390370086769
STAT,1931,39,na,1970,4936.994021009059
SIM,1897,39,na,1936,2545
SIM,1840,37,35-39,1877,5
STAT,1900,19,35-39,1919,0.7560424164591378
STAT,1859,25,na,1884,1952.1224039987915
SIM,1932,32,20-24,1964,13
STAT,1872,35,na,1907,2381.585761394362
STAT,1924,33,30-34,1957,18.193305994575642
STAT,1936,35,15-19,1971,0.01869756418641356
STAT,1936,20,45-49,1956,1.065778281506154
STAT,1945,23,20-24,1968,120.48231681777236
SIM,1825,34,30-34,1859,33
STAT,1840,47,35-39,1887,0.05558981176425175
STAT,1815,43,50-100,1858,0.11036099452338576
SIM,1871,49,30-34,1920,1
STAT,1868,21,30-34,1889,17.32878587060054
STAT,1913,18,30-34,1931,2.4543872938474
SIM,1862,65,na,1927,2633
STAT,1850,45,50-100,1895,0.11453929908353247
SIM,1853,37,na,1890,3240
SIM,1921,38,na,1959,5141
STAT,1862,68,na,1930,1301.6285437391343
STAT,1810,46,45-49,1856,0.0012558497440975042
STAT,1844,48,50-100,1892,0.24025595339087627
STAT,1835,22,50-100,1857,0.41013815616795046
STAT,1943,15,40-44,1958,1.467080649433394
STAT,1895,63,na,1958,2393.617966997032
STAT,1861,101,na,1962,1.4461172201143992
STAT,1872,66,na,1938,1641.2385322619457
STAT,1877,19,na,1896,2550.045071133539
STAT,1912,17,30-34,1929,2.436084927897467
STAT,1836,28,na,1864,2126.786437585885
STAT,1895,20,50-100,1915,0.5336484855846491
STAT,1895,15,35-39,1910,0.7171170448331436
STAT,1806,86,na,1892,66.81100351501088
STAT,1890,7,na,1897,3154.063128202464
SIM,1938,26,na,1964,4231
STAT,1857,26,50-100,1883,0.5092656930387062
STAT,1918,21,40-44,1939,3.5882812690409818
SIM,1860,30,na,1890,2134
STAT,1879,45,na,1924,2330.9858414891996
SIM,1815,55,na,1870,1362
STAT,1938,33,25-29,1971,9.188283894026522
STAT,1835,63,na,1898,1350.102940450235
STAT,1928,25,15-19,1953,0.8689696258377406
STAT,1869,22,30-34,1891,17.974052205864318
STAT,1946,25,30-34,1971,43.21285497718632
STAT,1901,16,45-49,1917,0.09155923863004393
SIM,1881,24,na,1905,2652
SIM,1844,12,na,1856,3028
SIM,1926,21,40-44,1947,42
STAT,1817,38,na,1855,1008.7245081235172
STAT,1867,28,35-39,1895,9.093160712141449
STAT,1948,19,35-39,1967,4.749817337523893
STAT,1835,43,na,1878,1881.8030515541695
STAT,1888,17,15-19,1905,6.8494430927446395
STAT,1906,40,na,1946,3392.286100572564
STAT,1938,15,30-34,1953,11.950062337173724
SIM,1886,47,na,1933,2970
SIM,1915,0,na,1915,3887
STAT,1848,61,na,1909,1748.6216182989028
STAT,1884,25,30-34,1909,24.26948013094219
STAT,1914,16,na,1930,3949.37621382287
STAT,1922,39,35-39,1961,2.715729052401922
SIM,1938,23,25-29,1961,175
STAT,1790,107,na,1897,0.0013712603260253968
STAT,1832,40,50-100,1872,0.09043077432822631
STAT,1840,29,40-44,1869,1.4496423418300695
STAT,1919,33,20-24,1952,2.5856669864510553
STAT,1877,10,na,1887,2662.3767361673295
STAT,1883,58,na,1941,1902.5342005043174
STAT,1891,25,na,1916,2954.6867231683614
STAT,1881,48,35-39,1929,0.13054748061109128
STAT,1830,39,25-29,1869,2.572224730376187
STAT,1890,60,na,1950,2308.845573016278
STAT,1902,17,45-49,1919,0.09198456660311725
STAT,1914,47,na,1961,3592.846463866761
SIM,1944,26,na,1970,2484
STAT,1824,71,na,1895,258.315577993837
STAT,1873,38,35-39,1911,7.2192726406922665
SIM,1890,29,na,1919,3802
STAT,1922,20,15-19,1942,6.072394059655054
STAT,1950,22,20-24,1972,130.6559439660157
STAT,1925,0,na,1925,5392.398240393505
STAT,1851,73,na,1924,938.0782287492808
STAT,1903,29,25-29,1932,59.618171719826336
STAT,1863,45,15-19,1908,3.448890860456615E-4
STAT,1954,15,15-19,1969,55.637913739531726
STAT,1839,25,20-24,1864,13.929978878612475
STAT,1866,25,50-100,1891,0.5878847106394205
STAT,1878,17,50-100,1895,0.050406236616671464
STAT,1893,30,20-24,1923,3.4074210854561273
STAT,1952,18,15-19,1970,53.871996491981776
STAT,1929,40,20-24,1969,0.022773522737844342
SIM,1822,38,30-34,1860,3
STAT,1953,15,50-100,1968,0.4493926584212573
STAT,1904,9,na,1913,3706.9417533554124
STAT,1931,26,30-34,1957,50.25352023516553
STAT,1886,42,50-100,1928,1.0926619536038096
STAT,1886,78,na,1964,1086.5037544991471
STAT,1888,46,30-34,1934,0.11204024895642382
STAT,1904,17,na,1921,3608.323209711593
STAT,1905,24,30-34,1929,25.4593884065987
STAT,1905,26,25-29,1931,61.051799527520565
SIM,1846,58,na,1904,833
STAT,1927,45,15-19,1972,4.6079049264038686E-4
STAT,1852,22,50-100,1874,0.48762735432546506
STAT,1804,71,na,1875,1174.2044855310178
STAT,1860,24,30-34,1884,14.765176335539309
SIM,1868,50,na,1918,1047
STAT,1894,17,40-44,1911,0.23259023559651146
STAT,1892,48,45-49,1940,0.16274861095214785
STAT,1897,23,15-19,1920,4.367737119320853
STAT,1922,20,20-24,1942,126.84473195545338
SIM,1927,23,na,1950,1600
STAT,1797,84,na,1881,4.532228188496364
STAT,1804,82,na,1886,327.7086957825538
STAT,1858,31,15-19,1889,0.10988678695248191
STAT,1913,25,50-100,1938,0.9859761207653085
STAT,1872,54,25-29,1926,0.003449293137903829
STAT,1916,24,40-44,1940,3.453478773324056
STAT,1858,20,na,1878,1900.6161884304454
SIM,1941,25,25-29,1966,138
STAT,1859,76,na,1935,750.9051428149027
SIM,1826,33,35-39,1859,22
STAT,1876,15,30-34,1891,1.6187415514504542
STAT,1882,30,45-49,1912,1.682973364014221
SIM,1858,25,30-34,1883,9
STAT,1911,20,45-49,1931,1.0613838355338205
STAT,1902,19,50-100,1921,0.06861845417194563
SIM,1782,74,na,1856,514
STAT,1840,30,50-100,1870,0.44864363848603284
STAT,1933,25,25-29,1958,86.87823406252241
SIM,1850,63,na,1913,814
SIM,1848,50,na,1898,2307
STAT,1848,18,25-29,1866,6.534863045902181
STAT,1863,101,na,1964,1.9455159683588228
STAT,1920,26,20-24,1946,19.83445211447189
STAT,1881,29,30-34,1910,23.610507275173823
STAT,1841,104,na,1945,0.07427483279707736
STAT,1845,24,35-39,1869,3.543344869694492
STAT,1875,36,50-100,1911,1.2667782553774485
STAT,1903,40,35-39,1943,0.18029985946698243
STAT,1920,44,20-24,1964,0.019189882949411822
STAT,1880,61,na,1941,1939.9323385927405
STAT,1840,33,na,1873,1028.6565138755834
STAT,1831,53,25-29,1884,0.002880536836663183
SIM,1899,42,na,1941,1776
STAT,1903,47,25-29,1950,0.04590659659382819
STAT,1787,77,na,1864,156.58556987388525
STAT,1942,16,35-39,1958,4.336256301363969
STAT,1899,32,15-19,1931,0.19450998397719327
STAT,1921,39,50-100,1960,0.46225779971942654
STAT,1859,37,40-44,1896,3.469576413656874
STAT,1904,27,20-24,1931,16.760676764764046
SIM,1867,34,35-39,1901,1
STAT,1907,35,25-29,1942,0.9153664546257277
STAT,1924,32,20-24,1956,2.818378026284718
STAT,1849,45,30-34,1894,0.08237604100399464
SIM,1847,25,20-24,1872,70
SIM,1857,10,na,1867,1495
STAT,1904,43,25-29,1947,0.06324918921659238
STAT,1891,49,40-44,1940,0.11627666651328639
SIM,1878,80,na,1958,1100
SIM,1870,29,na,1899,2456
STAT,1924,39,40-44,1963,1.7445375696199972
SIM,1928,35,30-34,1963,1
STAT,1876,25,na,1901,2428.9230806777523
SIM,1933,31,na,1964,4370
STAT,1796,107,na,1903,0.0018468607342344502
STAT,1889,19,25-29,1908,6.787420351372491
STAT,1871,25,na,1896,2396.8122390072476
SIM,1833,29,na,1862,2343
STAT,1866,35,na,1901,2171.004370737715
STAT,1922,35,20-24,1957,0.2971214795641262
STAT,1872,36,25-29,1908,2.8969882886558658
STAT,1900,16,30-34,1916,2.2133869061192692
STAT,1923,22,25-29,1945,106.3450676606612
STAT,1868,23,25-29,1891,55.12101613939942
STAT,1888,50,na,1938,2520.88912610656
SIM,1932,39,40-44,1971,12
STAT,1841,74,na,1915,1235.8217404396626
STAT,1909,60,na,1969,3111.617512985422
STAT,1853,51,na,1904,1677.53001655041
STAT,1859,19,40-44,1878,0.1663005592198182
STAT,1841,16,50-100,1857,0.0707793421115779
STAT,1925,38,45-49,1963,0.8099077992128788
STAT,1828,84,na,1912,225.18976622480062
STAT,1924,18,40-44,1942,1.6453141062632473
STAT,1851,81,na,1932,427.09179027143574
STAT,1811,53,na,1864,1657.4563694041153
STAT,1856,25,na,1881,1802.0139140725526
STAT,1807,48,na,1855,1419.3934296208743
STAT,1843,20,15-19,1863,4.15083620248811
STAT,1832,52,30-34,1884,4.763070785228257E-4
SIM,1876,23,25-29,1899,224
SIM,1848,23,15-19,1871,1
STAT,1872,46,50-100,1918,0.24663216779527827
STAT,1810,100,na,1910,0.03305386588087473
STAT,1831,35,25-29,1866,2.9998119035655746
SIM,1827,31,30-34,1858,79
SIM,1851,25,na,1876,1355
STAT,1852,52,50-100,1904,0.015121315974050215
SIM,1887,49,na,1936,3310
STAT,1926,31,45-49,1957,1.8875081777883571
STAT,1921,36,15-19,1957,0.02120717579943071
STAT,1897,41,45-49,1938,0.13864865162729967
STAT,1921,42,15-19,1963,0.0017091688059820492
STAT,1911,35,45-49,1946,0.6572167519350914
STAT,1902,30,40-44,1932,6.15587983426499
STAT,1840,28,30-34,1868,12.274399392733502
SIM,1828,30,na,1858,2197
STAT,1848,48,50-100,1896,0.22693845546101718
STAT,1857,21,20-24,1878,61.48932430152569
STAT,1873,35,30-34,1908,5.518892791903354
STAT,1815,66,na,1881,135.34017548207376
STAT,1830,54,20-24,1884,5.332891651570797E-4
STAT,1930,33,25-29,1963,11.83686377236789
STAT,1906,34,25-29,1940,8.443632399458767
SIM,1859,27,35-39,1886,1
STAT,1923,46,50-100,1969,0.26245814985363686
STAT,1851,47,45-49,1898,0.18552208273210316
STAT,1905,42,30-34,1947,0.1146874082614063
STAT,1825,33,na,1858,1790.4331616282125
SIM,1913,36,30-34,1949,20
STAT,1921,27,20-24,1948,20.10287522079414
SIM,1948,16,na,1964,5209
SIM,1814,44,30-34,1858,7
STAT,1821,46,20-24,1867,0.01300731412945557
STAT,1855,66,na,1921,1084.756691768237
STAT,1880,49,35-39,1929,0.14230700130292454
SIM,1883,50,na,1933,2015
STAT,1916,42,40-44,1958,0.25282531269281405
STAT,1946,21,15-19,1967,5.8616050418488115
STAT,1917,23,45-49,1940,1.1762395304549222
SIM,1839,15,15-19,1854,82
STAT,1932,27,30-34,1959,50.96400496389271
STAT,1776,93,na,1869,12.582523784880927
STAT,1920,24,na,1944,3982.486940973638
STAT,1886,22,30-34,1908,18.44551157709325
SIM,1859,23,25-29,1882,2
STAT,1884,43,na,1927,2196.5035217009927
STAT,1847,99,na,1946,1.7122772911231128
STAT,1910,57,na,1967,3240.4906206979977
SIM,1914,34,25-29,1948,44
STAT,1869,86,na,1955,223.891237369302
STAT,1921,24,15-19,1945,5.903980920928694
SIM,1805,56,na,1861,2097
SIM,1815,63,na,1878,482
STAT,1865,15,20-24,1880,18.546814611766212
STAT,1877,17,35-39,1894,0.5570058163236539
STAT,1915,46,35-39,1961,0.12840076023902378
STAT,1926,28,15-19,1954,0.8360644436783269
STAT,1931,16,25-29,1947,56.46116443050103
STAT,1867,40,20-24,1907,0.15170977291206136
SIM,1907,26,35-39,1933,56
STAT,1829,49,30-34,1878,0.04362617400380451
STAT,1915,27,30-34,1942,39.40082769846978
STAT,1896,27,50-100,1923,0.8432608207911179
STAT,1905,36,30-34,1941,1.6625247967896921
STAT,1887,47,25-29,1934,0.0631032067784883
STAT,1768,116,na,1884,3.1935374107774884E-4
STAT,1926,46,45-49,1972,0.26653204134971503
SIM,1859,14,na,1873,2373
SIM,1864,22,15-19,1886,29
STAT,1832,34,30-34,1866,1.187373477849574
STAT,1850,48,40-44,1898,0.07806028484826204
STAT,1840,19,50-100,1859,0.02468294951244044
STAT,1901,45,50-100,1946,0.19563830548983918
SIM,1855,32,na,1887,3127
SIM,1913,24,30-34,1937,31
STAT,1822,44,15-19,1866,0.023547480599660345
STAT,1897,19,na,1916,3336.148575532287
SIM,1840,34,30-34,1874,19
STAT,1794,104,na,1898,1.578632823129065E-4
STAT,1931,16,na,1947,4795.639029386793
STAT,1791,99,na,1890,0.4775436790924729
STAT,1917,41,45-49,1958,0.1716123543446618
STAT,1916,26,35-39,1942,15.364300839914552
STAT,1856,22,15-19,1878,2.7519941205734573
STAT,1931,32,30-34,1963,20.4993232746881
STAT,1850,15,50-100,1865,0.027972972507062217
STAT,1804,74,na,1878,883.5926982166905
STAT,1857,23,15-19,1880,2.9015380283479146
STAT,1853,19,45-49,1872,0.060213422356166085
STAT,1845,21,30-34,1866,11.052101674695155
STAT,1827,48,na,1875,1759.0630436841664
STAT,1888,20,40-44,1908,2.41940646003791
STAT,1866,58,na,1924,1805.187991216646
STAT,1882,65,na,1947,1617.9874498291554
STAT,1915,25,35-39,1940,15.199607980543949
STAT,1814,81,na,1895,365.9810614902905
STAT,1930,17,20-24,1947,174.04711965452233
STAT,1776,82,na,1858,298.0259120834765
STAT,1917,44,45-49,1961,0.17079506015486723
STAT,1878,30,25-29,1908,10.623008804911438
STAT,1952,18,50-100,1970,0.44473295754541164
SIM,1880,39,na,1919,3279
SIM,1922,26,30-34,1948,2
STAT,1787,85,na,1872,40.90795997994499
SIM,1866,1,na,1867,3647
SIM,1911,39,na,1950,2465
STAT,1900,32,30-34,1932,24.186692006827112
STAT,1933,4,na,1937,5366.3523475173615
STAT,1863,49,35-39,1912,0.11702424094271725
STAT,1912,34,15-19,1946,0.12390876305103192
SIM,1873,29,na,1902,2271
STAT,1906,19,30-34,1925,2.295659209561043
STAT,1909,47,20-24,1956,0.010051444654537773
STAT,1936,18,30-34,1954,11.52341712165758
STAT,1898,22,20-24,1920,92.66778788869735
STAT,1951,16,na,1967,4343.484512826025
SIM,1886,30,25-29,1916,28
SIM,1895,47,25-29,1942,1
STAT,1864,100,na,1964,3.6682781175507078
STAT,1828,100,na,1928,0.7186596043582302
STAT,1904,26,50-100,1930,0.917062267712972
STAT,1922,36,50-100,1958,0.47284185739801604
STAT,1893,33,25-29,1926,12.754609093872528
STAT,1937,15,15-19,1952,43.89708188655476
STAT,1933,22,20-24,1955,146.49313035793443
STAT,1942,15,50-100,1957,0.38726248508188715
STAT,1875,48,45-49,1923,0.23929215054019498
STAT,1920,29,25-29,1949,70.76531750841087
SIM,1856,5,na,1861,1435
STAT,1934,28,45-49,1962,2.307218814357622
SIM,1881,53,30-34,1934,2
STAT,1862,65,na,1927,1439.4104034539378
STAT,1855,39,30-34,1894,3.491808161091833
STAT,1826,42,25-29,1868,0.9648266420878919
SIM,1900,47,na,1947,4063
STAT,1927,30,45-49,1957,1.922088490404064
STAT,1898,40,20-24,1938,0.014979583397224376
STAT,1916,42,na,1958,3754.0285030948335
STAT,1887,22,45-49,1909,0.7675231590616045
STAT,1901,31,40-44,1932,6.088442835822489
STAT,1860,41,50-100,1901,0.8657448217847082
SIM,1836,48,na,1884,1857
STAT,1896,5,na,1901,3454.6007205854726
SIM,1947,23,na,1970,4355
STAT,1830,36,20-24,1866,0.7104532977128342
STAT,1848,84,na,1932,311.2977502609653
STAT,1893,68,na,1961,2065.4494456238444
STAT,1862,76,na,1938,806.9425592933575
SIM,1883,48,45-49,1931,2
STAT,1893,57,na,1950,2513.099469725649
STAT,1884,21,15-19,1905,3.167599114026068
STAT,1856,28,na,1884,1763.4765617810813
STAT,1939,29,40-44,1968,4.6296697128339925
STAT,1876,18,35-39,1894,0.5532411806075317
STAT,1880,20,50-100,1900,0.42587537241106915
SIM,1802,68,na,1870,170
SIM,1840,30,na,1870,2538
STAT,1889,16,20-24,1905,21.40157486108666
STAT,1941,15,35-39,1956,4.275234087330986
STAT,1829,28,50-100,1857,0.4263708807385144
STAT,1855,54,25-29,1909,0.0022797684429543136
STAT,1869,41,50-100,1910,1.0708700678100926
STAT,1856,40,45-49,1896,1.0858139345999687
STAT,1931,29,35-39,1960,19.227886497894925
STAT,1929,24,20-24,1953,138.75517560163604
STAT,1859,34,35-39,1893,7.957916891966467
STAT,1864,48,35-39,1912,0.12567564831850747
STAT,1880,35,50-100,1915,1.286691519747132
STAT,1914,16,25-29,1930,8.861256025522293
STAT,1869,20,35-39,1889,5.948968639927825
SIM,1910,54,na,1964,3678
STAT,1835,74,na,1909,839.7272039988767
STAT,1873,53,30-34,1926,0.006007965536992219
STAT,1827,29,45-49,1856,1.1990961166720706
SIM,1922,16,25-29,1938,568
STAT,1899,38,50-100,1937,0.3601561244267515
STAT,1814,53,25-29,1867,0.011449178069654571
STAT,1803,89,na,1892,26.499914136794693
SIM,1848,73,na,1921,1928
STAT,1876,28,na,1904,2404.063316514626
STAT,1845,73,na,1918,589.3830743451964
STAT,1908,38,45-49,1946,0.63019249602416
STAT,1849,41,15-19,1890,0.011688700642729019
STAT,1811,52,50-100,1863,0.06794354257191483
STAT,1903,44,20-24,1947,0.015443489017951445
STAT,1851,25,50-100,1876,0.600134445621958
STAT,1913,30,20-24,1943,2.415601867555557
SIM,1815,86,na,1901,339
STAT,1862,22,40-44,1884,1.8169100085884058
SIM,1860,22,na,1882,2040
STAT,1918,24,45-49,1942,1.189666414237867
STAT,1858,20,25-29,1878,50.88654535575641
STAT,1879,53,na,1932,2173.340471375537
STAT,1831,46,50-100,1877,0.23460177476233582
STAT,1835,66,na,1901,1240.165414279583
STAT,1875,35,30-34,1910,5.524663589464375
STAT,1922,22,45-49,1944,1.275921690902426
STAT,1935,37,20-24,1972,0.36595763425472944
SIM,1853,29,na,1882,3333
SIM,1900,44,na,1944,4150
STAT,1852,32,25-29,1884,10.674858686255662
SIM,1927,17,20-24,1944,403
STAT,1919,17,20-24,1936,147.83222996248975
STAT,1911,17,15-19,1928,8.979324564621727
SIM,1931,34,25-29,1965,9
STAT,1915,43,30-34,1958,0.12669297181313605
STAT,1846,46,25-29,1892,0.034211082063364026
SIM,1860,32,25-29,1892,17
STAT,1848,15,20-24,1863,20.81006910257406
STAT,1872,26,15-19,1898,0.45587849524337015
STAT,1814,41,na,1855,2217.2214690236033
STAT,1923,38,40-44,1961,1.7145580963958489
SIM,1873,40,na,1913,2168
SIM,1831,28,30-34,1859,15
SIM,1846,47,na,1893,967
STAT,1903,26,20-24,1929,16.710075129511157
STAT,1911,32,40-44,1943,3.767732539148333
STAT,1846,21,45-49,1867,0.5132655999318249
SIM,1941,22,20-24,1963,112
STAT,1834,47,45-49,1881,0.11030366621212906
STAT,1881,44,25-29,1925,0.5982340342972394
STAT,1923,34,25-29,1957,10.470777516282386
STAT,1897,37,50-100,1934,1.6305061584902996
STAT,1839,28,25-29,1867,49.154719610068454
SIM,1917,24,na,1941,2263
STAT,1871,37,20-24,1908,0.768955396350113
STAT,1847,22,45-49,1869,0.7728828056060274
STAT,1913,48,25-29,1961,0.05098296978637667
STAT,1924,35,25-29,1959,1.1518674282717862
STAT,1868,27,40-44,1895,2.8933278744336435
STAT,1874,21,20-24,1895,71.33700155883102
STAT,1822,48,na,1870,1483.5946926808342
STAT,1858,91,na,1949,44.25267888054956
STAT,1861,21,50-100,1882,0.3509272930244443
SIM,1886,24,na,1910,2342
STAT,1891,20,45-49,1911,0.8626328162589063
STAT,1869,46,na,1915,2276.7192939736974
STAT,1866,8,na,1874,2528.330123130871
STAT,1890,19,30-34,1909,1.9192021526038574
SIM,1847,28,25-29,1875,352
STAT,1906,32,na,1938,3484.9425500269563
STAT,1933,24,40-44,1957,4.4267173981837775
STAT,1798,69,na,1867,1048.1711349503291
STAT,1907,37,45-49,1944,0.6278152256759968
STAT,1863,46,30-34,1909,0.08287397875335992
STAT,1836,32,40-44,1868,4.200478692072213
STAT,1906,31,20-24,1937,2.2567313153067428
STAT,1921,21,45-49,1942,1.259589610831392
STAT,1812,106,na,1918,9.615560153516885E-4
STAT,1842,99,na,1941,0.4701420157063594
SIM,1925,21,25-29,1946,1
STAT,1930,19,40-44,1949,1.7859929778210897
STAT,1901,40,na,1941,3275.491794567377
STAT,1880,49,30-34,1929,0.09839512657057468
STAT,1940,22,25-29,1962,93.04048065892533
STAT,1852,66,na,1918,1649.8078258799476
SIM,1859,20,20-24,1879,32
SIM,1839,22,na,1861,1134
STAT,1833,27,50-100,1860,0.393184305549581
STAT,1886,25,35-39,1911,10.059737475242184
SIM,1927,31,na,1958,1648
STAT,1844,23,35-39,1867,7.166310452124682
STAT,1887,16,50-100,1903,0.054056485749680826
STAT,1905,20,15-19,1925,4.7733657065226
STAT,1915,57,na,1972,3489.4015755928976
SIM,1829,55,na,1884,1785
STAT,1822,47,50-100,1869,0.41069281845624944
STAT,1823,47,35-39,1870,0.218432865398169
SIM,1787,74,na,1861,365
STAT,1868,50,na,1918,2109.5678293995943
STAT,1937,35,30-34,1972,1.8067726876877972
SIM,1919,25,15-19,1944,3
STAT,1870,40,na,1910,2327.40121430399
STAT,1917,21,25-29,1938,97.15342486719958
SIM,1819,48,na,1867,1880
STAT,1788,70,na,1858,261.017241979609
STAT,1900,35,35-39,1935,9.891067947039426
STAT,1890,38,35-39,1928,8.52005998476108
SIM,1827,34,35-39,1861,5
SIM,1835,55,na,1890,1206
SIM,1915,32,20-24,1947,13
STAT,1855,29,20-24,1884,7.977192164678061
STAT,1955,0,na,1955,5212.275911806668
STAT,1821,49,25-29,1870,0.059973610697439964
STAT,1920,47,25-29,1967,0.05788293287985028
STAT,1893,43,35-39,1936,0.15611371480679784
STAT,1864,91,na,1955,52.6807166878845
STAT,1915,19,45-49,1934,0.10252158504935209
STAT,1875,94,na,1969,87.16356721886989
SIM,1845,22,na,1867,2104
STAT,1937,33,45-49,1970,1.5397713562914013
STAT,1857,98,na,1955,2.49280518783152
STAT,1907,32,20-24,1939,2.264659021011513
STAT,1839,25,na,1864,2568.6772329055334
STAT,1866,15,35-39,1881,0.5202144797725666
STAT,1868,61,na,1929,1804.8606428851474
STAT,1790,74,na,1864,611.8235173109981
SIM,1866,47,na,1913,2895
STAT,1831,31,50-100,1862,0.9889698867439662
STAT,1926,43,40-44,1969,0.30522533161843746
SIM,1822,45,na,1867,1541
STAT,1888,23,45-49,1911,0.8023363441228576
SIM,1906,49,40-44,1955,1
STAT,1842,53,30-34,1895,0.0014539616349500274
SIM,1909,49,50-100,1958,1
STAT,1796,104,na,1900,0.02612105480540805
STAT,1865,18,25-29,1883,5.299973385764049
STAT,1874,13,na,1887,2685.873064864275
STAT,1821,74,na,1895,560.4622292254971
STAT,1885,24,35-39,1909,5.700073154275398
STAT,1786,92,na,1878,21.59500059579394
STAT,1828,33,na,1861,1916.5304452083885
STAT,1857,10,na,1867,2180.0598067388446
STAT,1928,23,20-24,1951,137.3508004294532
STAT,1899,45,na,1944,3104.1973051781433
STAT,1850,88,na,1938,63.3922984687967
SIM,1943,16,na,1959,4981
SIM,1769,89,na,1858,178
SIM,1906,6,na,1912,3742
SIM,1914,31,20-24,1945,1
STAT,1929,43,25-29,1972,0.09168425557756743
STAT,1928,41,20-24,1969,0.022374771501279474
STAT,1891,15,50-100,1906,0.06052663675810095
STAT,1894,53,na,1947,2694.2048747745894
STAT,1905,39,35-39,1944,2.173680795972165
STAT,1867,43,25-29,1910,0.6029201601406824
SIM,1901,18,na,1919,4034
STAT,1900,47,na,1947,3102.718317581355
STAT,1834,34,30-34,1868,9.653821050040591
SIM,1842,34,30-34,1876,189
SIM,1893,57,na,1950,2620
STAT,1917,41,40-44,1958,0.25791337698709155
STAT,1876,1,na,1877,3492.03697698991
SIM,1889,75,na,1964,986
STAT,1842,26,50-100,1868,0.19780027230266195
STAT,1853,16,40-44,1869,0.17161218521407925
STAT,1846,36,15-19,1882,0.035093364678077284
STAT,1887,40,45-49,1927,1.6639336873076618
STAT,1910,54,na,1964,3300.856409821486
STAT,1877,33,40-44,1910,4.383711501512628
SIM,1832,24,30-34,1856,2
SIM,1886,44,na,1930,2921
STAT,1870,41,45-49,1911,1.498801353996983
SIM,1833,51,na,1884,2017
SIM,1922,25,20-24,1947,5
STAT,1895,60,na,1955,2480.9975482968125
STAT,1847,19,15-19,1866,6.618052501264178
SIM,1921,5,na,1926,5397
SIM,1882,54,na,1936,1485
STAT,1927,41,35-39,1968,0.2508475235328865
SIM,1862,30,35-39,1892,5
STAT,1829,39,20-24,1868,0.37821452430940006
STAT,1949,18,45-49,1967,0.5750689077845138
STAT,1858,48,45-49,1906,0.1779602440366444
STAT,1859,22,na,1881,1944.8781172406998
STAT,1912,37,20-24,1949,0.2542982116197236
STAT,1924,15,35-39,1939,4.97190152153498
SIM,1878,49,na,1927,3806
STAT,1920,22,40-44,1942,3.6899361018158
STAT,1897,16,50-100,1913,0.0652235572541479
SIM,1899,22,15-19,1921,15
STAT,1879,30,40-44,1909,4.48453647342601
STAT,1879,53,50-100,1932,0.015244245418151477
SIM,1844,15,na,1859,3028
STAT,1868,42,30-34,1910,1.109063919974286
STAT,1844,29,45-49,1873,1.327275878708191
STAT,1828,40,35-39,1868,2.3415954179548097
SIM,1941,6,na,1947,3904
STAT,1865,19,35-39,1884,0.5101735357306122
SIM,1919,48,35-39,1967,3
STAT,1828,30,na,1858,1972.2506574717113
STAT,1856,28,25-29,1884,31.257841109538553
STAT,1850,47,30-34,1897,0.04449014183901139
STAT,1879,22,na,1901,2426.161092035956
STAT,1930,26,15-19,1956,0.891748719060705
SIM,1883,38,35-39,1921,4
STAT,1860,19,na,1879,2134.3459651593757
STAT,1922,27,35-39,1949,16.7992413377769
STAT,1877,18,15-19,1895,6.008499625190087
STAT,1891,70,na,1961,1892.031497556971
SIM,1965,0,na,1965,4976
STAT,1877,35,35-39,1912,7.248054564924889
STAT,1930,37,40-44,1967,1.938910253649608
STAT,1898,25,25-29,1923,57.26934693673941
STAT,1903,25,45-49,1928,1.5867804300856563
STAT,1892,44,30-34,1936,0.09750941474276427
STAT,1936,32,45-49,1968,1.5132645590829414
SIM,1830,27,30-34,1857,9
SIM,1859,42,na,1901,1801
SIM,1901,40,na,1941,3635
STAT,1848,15,50-100,1863,0.057507548595545216
STAT,1865,28,35-39,1893,8.778376448742614
SIM,1863,29,20-24,1892,2
SIM,1880,53,na,1933,3193
STAT,1875,47,35-39,1922,0.14308909829781785
STAT,1829,46,25-29,1875,0.026990551051706037
STAT,1894,32,30-34,1926,22.202798688613928
STAT,1880,27,20-24,1907,12.179058391099987
STAT,1896,37,25-29,1933,3.795440149456484
STAT,1901,37,45-49,1938,0.6016192657300895
STAT,1911,10,na,1921,3919.3156820400427
STAT,1818,103,na,1921,0.08735131765131113
STAT,1891,15,30-34,1906,1.96913364954193
STAT,1798,60,na,1858,1466.129789090973
STAT,1873,25,20-24,1898,12.115525512619465
SIM,1853,51,na,1904,3151
STAT,1868,84,na,1952,321.30968288684727
STAT,1923,2,na,1925,4751.934961223008
SIM,1799,62,na,1861,1246
SIM,1914,13,na,1927,5124
STAT,1927,11,na,1938,4893.772418687227
STAT,1870,23,na,1893,2350.5097268524023
SIM,1912,47,40-44,1959,1
SIM,1818,60,na,1878,372
STAT,1890,49,25-29,1939,0.03851281318397722
STAT,1884,38,45-49,1922,1.8988445813789259
STAT,1921,28,30-34,1949,42.999510554873446
STAT,1919,47,15-19,1966,3.9424215381522856E-4
SIM,1835,41,30-34,1876,8
SIM,1865,62,na,1927,1523
SIM,1910,23,na,1933,4322
STAT,1814,50,20-24,1864,0.0025317150011327895
STAT,1866,54,30-34,1920,0.0052841782009544844
STAT,1895,31,35-39,1926,13.227858846148361
STAT,1882,16,30-34,1898,1.529734808836822
STAT,1840,64,na,1904,684.486611388675
STAT,1929,37,30-34,1966,2.323479368387628
STAT,1931,32,50-100,1963,1.0757570332617095
STAT,1881,41,20-24,1922,0.15065333189802138
STAT,1946,6,na,1952,4340.886529220304
SIM,1907,23,30-34,1930,558
STAT,1833,48,40-44,1881,0.07722925953230175
SIM,1919,8,na,1927,5211
STAT,1875,22,20-24,1897,70.76294764046828
STAT,1923,21,na,1944,4217.014019199875
SIM,1869,52,na,1921,3598
STAT,1847,35,20-24,1882,0.7382777528844449
SIM,1859,76,na,1935,136
STAT,1812,69,na,1881,137.09947535391265
STAT,1817,47,45-49,1864,0.1653329846648247
SIM,1855,52,na,1907,3004
STAT,1849,18,40-44,1867,0.1885830686826946
STAT,1914,25,20-24,1939,18.26900177257131
STAT,1906,63,na,1969,2883.3011909151182
STAT,1887,46,15-19,1933,4.415189101590533E-4
STAT,1904,47,40-44,1951,0.13732745056334278
STAT,1906,26,40-44,1932,4.3526765262663245
SIM,1901,60,na,1961,2787
STAT,1835,36,40-44,1871,4.137505648090001
SIM,1886,39,30-34,1925,4
STAT,1875,32,na,1907,2450.38881080771
STAT,1913,36,25-29,1949,0.9640970337704114
STAT,1913,11,na,1924,3993.1823207473253
STAT,1845,47,20-24,1892,0.0059268436912831395
STAT,1818,39,45-49,1857,4.3127724441607045
STAT,1957,15,50-100,1972,0.489895780268747
STAT,1868,47,50-100,1915,0.23611196035504567
STAT,1889,34,15-19,1923,0.17002264675781503
SIM,1819,48,30-34,1867,2
STAT,1909,20,50-100,1929,0.6089359925451473
STAT,1919,16,na,1935,4235.663430491602
SIM,1873,26,na,1899,2296
STAT,1902,33,45-49,1935,2.4452188535100645
SIM,1903,41,na,1944,2711
STAT,1915,24,25-29,1939,93.54317059573582
STAT,1932,21,20-24,1953,145.31957255197955
STAT,1937,30,40-44,1967,3.83597091846682
STAT,1891,48,30-34,1939,0.06630349351906381
STAT,1895,38,20-24,1933,0.9978023331581889
STAT,1935,36,45-49,1971,0.947262387324025
SIM,1906,25,35-39,1931,16
STAT,1808,95,na,1903,3.1138647308884475
SIM,1898,30,15-19,1928,5
STAT,1876,37,40-44,1913,4.425252753784471
STAT,1873,37,na,1910,2416.7133740936542
STAT,1874,48,30-34,1922,0.0986487407057695
STAT,1911,2,na,1913,4033.300358935101
STAT,1943,19,20-24,1962,142.03145946261392
SIM,1835,32,na,1867,1243
SIM,1840,33,na,1873,2705
STAT,1819,35,45-49,1854,1.5093782889607998
STAT,1881,26,25-29,1907,40.08434071715016
STAT,1822,45,na,1867,1541.7216506072784
STAT,1813,96,na,1909,6.289950283463974
STAT,1874,24,25-29,1898,58.71141962009439
STAT,1904,21,45-49,1925,0.9992682933422143
STAT,1899,42,na,1941,3163.849105058169
STAT,1834,46,35-39,1880,0.07283303330890004
STAT,1859,21,25-29,1880,52.10538525150685
SIM,1847,38,35-39,1885,1
STAT,1849,46,na,1895,1901.0798027256258
STAT,1862,14,na,1876,2307.651972006774
SIM,1829,38,na,1867,2088
STAT,1815,97,na,1912,0.37877314494113623
SIM,1874,49,50-100,1923,10
SIM,1897,16,na,1913,3016
STAT,1897,29,25-29,1926,55.77696588821867
STAT,1845,49,15-19,1894,1.943423879312592E-4
SIM,1808,84,na,1892,684
SIM,1921,33,20-24,1954,11
STAT,1878,39,30-34,1917,5.428250230098774
STAT,1931,30,na,1961,4926.467737099126
STAT,1822,32,50-100,1854,2.564879413309442
STAT,1874,23,15-19,1897,3.3942913508497123
STAT,1949,23,25-29,1972,106.68548933732333
SIM,1884,37,40-44,1921,2
STAT,1869,40,25-29,1909,0.6545274720727984
STAT,1877,41,na,1918,2356.8024486215613
STAT,1919,36,na,1955,3991.7220455015354
STAT,1859,33,50-100,1892,0.7231448575365914
SIM,1912,58,na,1970,4354
STAT,1831,34,15-19,1865,0.1471232850200407
STAT,1864,22,45-49,1886,0.6441336002527575
STAT,1834,37,35-39,1871,3.877306784124852
STAT,1870,19,45-49,1889,0.06497035741652772
STAT,1886,26,45-49,1912,1.1537202323797573
STAT,1828,47,20-24,1875,0.014327476218270576
STAT,1917,28,50-100,1945,1.0262806752277776
STAT,1831,81,na,1912,423.22936293487214
STAT,1808,47,35-39,1855,0.2558833237713485
STAT,1776,99,na,1875,0.6622814367004684
STAT,1859,22,35-39,1881,4.798758664055115
STAT,1932,16,40-44,1948,1.8437401182648199
STAT,1809,46,40-44,1855,1.5403785949657025
STAT,1827,41,30-34,1868,1.1059131785299487
STAT,1849,32,20-24,1881,2.399996063532108
STAT,1929,39,25-29,1968,1.2525408014655308
STAT,1840,18,20-24,1858,8.984859280612671
STAT,1881,25,15-19,1906,0.43135974537627597
SIM,1880,59,na,1939,3193
STAT,1913,45,na,1958,3557.461490499239
STAT,1835,97,na,1932,4.064934617854929
STAT,1851,46,35-39,1897,0.11088489195241129
STAT,1889,12,na,1901,3109.9220899815264
STAT,1923,16,30-34,1939,14.19677464240667
STAT,1918,36,45-49,1954,0.7122672635566794
STAT,1843,37,45-49,1880,2.2993966773859515
SIM,1951,19,20-24,1970,521
STAT,1850,17,35-39,1867,0.3096175762841577
STAT,1852,50,25-29,1902,0.003616582955014693
STAT,1893,51,na,1944,2705.553291145785
SIM,1940,16,40-44,1956,160
STAT,1866,89,na,1955,95.89482075619348
STAT,1938,20,45-49,1958,1.1024212104779667
STAT,1873,43,50-100,1916,1.0758585079914913
STAT,1869,48,20-24,1917,0.011956833266281051
STAT,1875,38,35-39,1913,7.226821430371308
STAT,1832,69,na,1901,1245.7600250937542
STAT,1872,35,15-19,1907,0.056764940898923845
STAT,1909,46,45-49,1955,0.1981698653032436
SIM,1883,81,na,1964,43
STAT,1928,40,40-44,1968,0.3173168881109524
STAT,1837,38,30-34,1875,5.149197395388353
STAT,1948,19,na,1967,4166.426918299194
STAT,1818,54,na,1872,1519.07656642038
STAT,1919,44,50-100,1963,0.12520200867999176
SIM,1845,38,30-34,1883,45
STAT,1906,33,50-100,1939,0.7586272963823348
STAT,1848,33,15-19,1881,0.13995911938483555
STAT,1841,17,25-29,1858,8.138591899240906
STAT,1931,20,50-100,1951,0.8524642859485355
SIM,1866,24,na,1890,3261
STAT,1954,13,na,1967,4812.363459958986
SIM,1926,38,na,1964,5894
STAT,1844,41,30-34,1885,1.1815295791034177
STAT,1858,23,30-34,1881,14.100460625945784
STAT,1862,0,na,1862,3282.524820356055
STAT,1890,16,25-29,1906,6.877031369028488
STAT,1881,19,20-24,1900,16.652115645291584
STAT,1886,48,20-24,1934,0.01227046099079443
SIM,1868,59,na,1927,573
SIM,1867,37,40-44,1904,25
STAT,1864,53,50-100,1917,0.013509552557872048
SIM,1907,39,50-100,1946,9
SIM,1904,29,na,1933,4167
STAT,1852,69,na,1921,1477.211456208786
STAT,1860,37,45-49,1897,1.6262708432817572
SIM,1823,61,na,1884,838
SIM,1941,15,na,1956,3864
STAT,1892,47,35-39,1939,0.09731849514409159
SIM,1907,8,na,1915,4894
STAT,1839,38,35-39,1877,7.77156173414045
STAT,1940,18,25-29,1958,43.492333479373116
STAT,1922,42,30-34,1964,0.14510417447673118
STAT,1853,31,30-34,1884,14.086923548346176
STAT,1879,15,15-19,1894,6.116183902988193
STAT,1838,54,na,1892,893.0145168512885
STAT,1928,34,50-100,1962,1.0246326489379847
STAT,1824,54,50-100,1878,0.0024483103927313925
SIM,1894,73,na,1967,812
STAT,1855,51,20-24,1906,4.907186850785816E-4
STAT,1857,110,na,1967,0.0018606254421896296
STAT,1899,49,45-49,1948,0.17803278884050072
STAT,1840,98,na,1938,1.2791280164440064
STAT,1861,29,45-49,1890,0.9167762321060499
STAT,1904,36,15-19,1940,0.017399809612986854
STAT,1903,7,na,1910,3698.3323173539525
STAT,1907,15,35-39,1922,0.8043395859363398
STAT,1865,33,15-19,1898,0.1294682628185612
SIM,1941,16,50-100,1957,5
STAT,1839,29,35-39,1868,11.131658408003263
STAT,1880,42,15-19,1922,0.014319085217071011
STAT,1886,40,25-29,1926,0.6716957270050288
STAT,1840,25,25-29,1865,21.069545306085182
STAT,1854,30,35-39,1884,5.887311177046393
STAT,1918,18,15-19,1936,48.60314520212162
STAT,1940,13,na,1953,3955.4755176552508
SIM,1846,24,na,1870,1266
STAT,1914,26,30-34,1940,39.084355307377905
STAT,1853,31,na,1884,1925.3336452401265
SIM,1879,39,25-29,1918,29
SIM,1871,28,30-34,1899,276
STAT,1846,39,20-24,1885,0.4669608102378607
SIM,1840,84,na,1924,1449
STAT,1830,38,15-19,1868,0.05069114933795639
STAT,1839,43,15-19,1882,0.013350373386965396
STAT,1865,25,30-34,1890,23.146827016380467
SIM,1891,45,na,1936,1959
STAT,1899,22,na,1921,3230.3425369820256
STAT,1906,29,45-49,1935,1.5963069476031577
STAT,1891,18,35-39,1909,0.6729955279583986
SIM,1890,69,na,1959,2631
STAT,1875,2,na,1877,3355.221904950206
STAT,1802,79,na,1881,415.5554073221842
STAT,1914,28,25-29,1942,65.20038664555622
STAT,1935,26,50-100,1961,1.3476364685582805
STAT,1832,24,20-24,1856,87.12317546351933
SIM,1879,42,na,1921,1200
STAT,1877,36,45-49,1913,2.0333687547879604
SIM,1832,27,35-39,1859,13
STAT,1886,21,50-100,1907,0.4235623213409028
SIM,1858,31,25-29,1889,20
STAT,1834,21,20-24,1855,40.91187414716217
STAT,1879,76,na,1955,971.8844168452528
SIM,1903,37,20-24,1940,4
STAT,1846,83,na,1929,235.11986049258738
STAT,1822,79,na,1901,403.13925905759794
STAT,1840,15,15-19,1855,3.061420887927088
SIM,1873,25,30-34,1898,80
STAT,1858,47,35-39,1905,0.10641456811089894
SIM,1837,67,na,1904,1470
STAT,1916,23,30-34,1939,29.61431980580381
STAT,1923,26,40-44,1949,5.313262065128544
SIM,1874,37,50-100,1911,35
STAT,1860,52,40-44,1912,0.008542653693106934
STAT,1881,80,na,1961,772.3086804277369
STAT,1917,16,50-100,1933,0.079741927471507
SIM,1824,60,na,1884,1811
STAT,1839,26,30-34,1865,29.686412917343734
STAT,1912,4,na,1916,4020.767688863067
SIM,1906,38,na,1944,3422
STAT,1895,30,25-29,1925,13.43142487266922
STAT,1891,41,50-100,1932,1.3050276003874655
STAT,1837,78,na,1915,626.4988256578862
STAT,1848,19,35-39,1867,0.6290435711617474
STAT,1865,16,30-34,1881,1.508429951800599
SIM,1892,47,50-100,1939,1
STAT,1789,106,na,1895,0.005163033319234777
STAT,1866,37,50-100,1903,1.1207065715204865
STAT,1824,103,na,1927,0.027773560423579948
STAT,1949,15,40-44,1964,1.6115627756203212
STAT,1920,25,45-49,1945,1.8834697158920422
STAT,1872,51,20-24,1923,7.424581203910724E-4
SIM,1840,53,na,1893,2500
STAT,1911,38,15-19,1949,0.018248021249802796
SIM,1845,30,35-39,1875,4
SIM,1864,15,na,1879,2555
STAT,1934,13,na,1947,5314.835608132331
STAT,1863,28,30-34,1891,21.422424131734243
STAT,1896,36,15-19,1932,0.07438083521008734
SIM,1889,72,na,1961,986
STAT,1852,36,40-44,1888,4.476492689448048
STAT,1844,26,40-44,1870,3.65920446483487
SIM,1930,8,na,1938,5653
STAT,1837,32,50-100,1869,0.9211240128820011
STAT,1917,29,20-24,1946,18.75266492953829
SIM,1905,22,na,1927,3669
STAT,1876,43,35-39,1919,1.8173425935668124
SIM,1955,7,na,1962,3825
STAT,1824,42,50-100,1866,0.17990937796168713
STAT,1854,33,40-44,1887,2.4437996580203523
SIM,1839,48,na,1887,674
STAT,1860,36,35-39,1896,5.79780543327513
STAT,1915,21,20-24,1936,113.65913734986721
STAT,1898,24,15-19,1922,4.408481301064662
STAT,1903,47,20-24,1950,0.009563874736509045
STAT,1835,49,50-100,1884,0.190919122528073
SIM,1918,6,na,1924,4480
STAT,1871,50,na,1921,2178.744633024697
STAT,1908,38,50-100,1946,0.38812111181084896
STAT,1885,27,40-44,1912,2.9444876166748
STAT,1817,78,na,1895,247.51794056182203
STAT,1871,70,na,1941,1399.6277339759515
STAT,1792,75,na,1867,531.2899672975431
STAT,1873,51,na,1924,2219.2432181777963
STAT,1850,22,15-19,1872,1.8284199863268995
SIM,1860,39,na,1899,2007
STAT,1913,33,20-24,1946,2.386227194375189
SIM,1947,20,na,1967,4360
STAT,1944,26,45-49,1970,1.8470301533288105
SIM,1832,58,na,1890,843
STAT,1862,24,35-39,1886,5.0152566936619545
STAT,1932,24,25-29,1956,119.93973074729377
STAT,1830,29,15-19,1859,0.4300209620464535
SIM,1842,21,20-24,1863,13
SIM,1832,75,na,1907,167
STAT,1868,20,20-24,1888,67.52677289566442
STAT,1921,47,40-44,1968,0.17562844197554367
STAT,1915,49,40-44,1964,0.15570833585267468
STAT,1940,16,30-34,1956,12.240345282993083
STAT,1818,36,40-44,1854,12.404393845548524
STAT,1915,16,40-44,1931,0.2893170817003572
STAT,1901,34,40-44,1935,6.011748212572166
STAT,1884,23,na,1907,2257.00000217946
SIM,1887,71,na,1958,2002
SIM,1864,43,na,1907,2414
STAT,1860,27,35-39,1887,7.95586110740038
STAT,1875,60,na,1935,1958.3916892998104
STAT,1860,33,na,1893,1938.518651201905
STAT,1931,17,35-39,1948,5.453738358746486
STAT,1858,29,na,1887,1838.9926305972406
STAT,1890,46,20-24,1936,0.008217866111493024
SIM,1825,48,50-100,1873,8
STAT,1840,24,15-19,1864,1.6283121402554241
STAT,1876,21,25-29,1897,58.04476333810271
STAT,1800,98,na,1898,2.2414131735074596
STAT,1836,35,45-49,1871,1.9143458105903488
STAT,1857,24,25-29,1881,45.48800559301363
STAT,1897,41,na,1938,3093.9834164760878
STAT,1873,31,50-100,1904,0.9437069058101006
SIM,1914,29,45-49,1943,4
STAT,1934,21,25-29,1955,123.33389778512252
STAT,1809,52,35-39,1861,0.07109178401085019
STAT,1878,31,35-39,1909,10.462006996643703
STAT,1831,50,20-24,1881,6.36854384533989E-4
STAT,1908,17,45-49,1925,0.09614967007477428
STAT,1809,49,na,1858,3000.266683632934
SIM,1920,13,na,1933,4786
SIM,1853,26,na,1879,3332
SIM,1942,21,25-29,1963,25
STAT,1836,34,35-39,1870,9.607318880093548
SIM,1842,34,na,1876,2601
STAT,1906,33,15-19,1939,0.11790982041275312
STAT,1820,44,na,1864,1830.5684250281222
SIM,1876,20,20-24,1896,236
STAT,1810,45,35-39,1855,7.549629272956682E-4
STAT,1949,20,20-24,1969,128.55950056503508
STAT,1908,22,25-29,1930,84.26110842244536
SIM,1883,22,20-24,1905,132
STAT,1815,49,35-39,1864,0.013818968792238262
STAT,1880,46,30-34,1926,0.100778670362885
STAT,1920,47,na,1967,4008.82728025136
STAT,1855,36,25-29,1891,1.9147292549624997
SIM,1888,25,na,1913,421
STAT,1829,36,15-19,1865,0.028981038769817363
STAT,1848,50,50-100,1898,0.014335862502685644
SIM,1919,23,20-24,1942,16
SIM,1940,24,25-29,1964,220
STAT,1817,48,50-100,1865,0.169792966805197
STAT,1826,38,50-100,1864,1.9560284612292889
SIM,1824,49,na,1873,2135
STAT,1945,22,45-49,1967,1.2195561060598246
STAT,1855,35,15-19,1890,0.037518098854937454
STAT,1902,18,20-24,1920,24.89920910058777
STAT,1808,64,na,1872,538.3962005674814
STAT,1880,84,na,1964,589.5217137069025
STAT,1838,47,15-19,1885,1.7566901257365876E-4
STAT,1870,16,40-44,1886,0.18516976072940827
SIM,1849,24,40-44,1873,1
STAT,1851,43,30-34,1894,0.9014402472609357
STAT,1939,25,25-29,1964,65.49895218211178
SIM,1836,43,40-44,1879,1
STAT,1861,32,35-39,1893,8.422103121682701
STAT,1925,3,na,1928,4854.882350111403
SIM,1893,71,na,1964,1380
SIM,1874,39,40-44,1913,48
STAT,1899,27,35-39,1926,13.17915577025347
SIM,1872,72,na,1944,1216
STAT,1871,39,15-19,1910,0.05545284290723424
STAT,1908,31,25-29,1939,8.692201056054053
STAT,1838,32,45-49,1870,0.9249984671248852
STAT,1874,49,40-44,1923,0.17300063867226492
STAT,1878,50,45-49,1928,0.015145946443243843
STAT,1862,99,na,1961,3.9811910852769112
STAT,1822,90,na,1912,45.463437339168266
STAT,1843,21,na,1864,2670.8794727175396
STAT,1921,40,na,1961,4144.958627049358
STAT,1841,20,15-19,1861,4.721373802350312
STAT,1898,22,50-100,1920,0.5483626114562058
STAT,1828,43,40-44,1871,2.7660608616606273
STAT,1939,26,35-39,1965,14.933996351694713
STAT,1845,87,na,1932,87.42390196601734
STAT,1935,33,40-44,1968,5.371772028747997
STAT,1895,34,40-44,1929,5.593214740548853
SIM,1868,25,na,1893,1238
STAT,1866,18,40-44,1884,0.17035878506838936
STAT,1913,19,40-44,1932,0.2808764718778127
SIM,1882,49,40-44,1931,2
STAT,1848,27,50-100,1875,0.7146246560934977
STAT,1886,23,40-44,1909,2.1512205753241966
STAT,1829,45,15-19,1874,1.898840760200584E-4
SIM,1909,60,na,1969,3677
STAT,1847,45,30-34,1892,0.08839104354215602
SIM,1920,3,na,1923,4900
STAT,1946,18,na,1964,4037.079964604177
STAT,1900,38,40-44,1938,1.3023886833740856
STAT,1849,48,35-39,1897,0.11648065573570261
STAT,1891,18,50-100,1909,0.060088875291816855
STAT,1929,36,20-24,1965,0.3363648867109334
STAT,1862,25,45-49,1887,0.9629553745040694
SIM,1917,47,na,1964,2000
STAT,1825,53,30-34,1878,0.0071578933760916424
STAT,1839,35,30-34,1874,6.0413090501600255
STAT,1858,26,35-39,1884,7.597694991313829
STAT,1880,33,na,1913,2466.904985607728
STAT,1932,23,15-19,1955,6.914461744170408
SIM,1886,78,na,1964,1187
STAT,1888,36,20-24,1924,0.8939679119149738
STAT,1793,71,na,1864,539.726818074235
STAT,1841,46,50-100,1887,0.27827384107376174
STAT,1830,88,na,1918,99.36206352145079
STAT,1855,26,15-19,1881,0.31525208733311494
STAT,1906,19,35-39,1925,0.7903088939570645
SIM,1847,26,30-34,1873,368
STAT,1906,49,na,1955,3190.5000462100597
SIM,1873,57,na,1930,1460
SIM,1896,54,na,1950,2599
STAT,1932,19,45-49,1951,0.6533425480191957
SIM,1920,30,35-39,1950,7
SIM,1928,19,na,1947,4188
STAT,1842,52,50-100,1894,0.0037292152639090055
STAT,1785,73,na,1858,215.31360605207254
SIM,1857,33,na,1890,1131
SIM,1903,38,30-34,1941,2
STAT,1883,27,na,1910,2295.9384438325774
STAT,1909,43,40-44,1952,0.23018006997779963
STAT,1896,27,15-19,1923,0.5980836773184857
STAT,1891,23,15-19,1914,4.044368855460213
STAT,1896,48,na,1944,2929.083578124882
SIM,1887,33,45-49,1920,2
STAT,1835,42,35-39,1877,1.6416668314621643
SIM,1839,34,25-29,1873,3
STAT,1871,21,50-100,1892,0.40801685506464525
STAT,1940,15,20-24,1955,136.1828039935623
STAT,1891,56,na,1947,2508.1965863051805
STAT,1824,32,15-19,1856,0.063557763360746
STAT,1924,31,50-100,1955,0.9558893078423661
STAT,1928,43,45-49,1971,0.21022158647367686
SIM,1890,21,15-19,1911,5
STAT,1910,27,45-49,1937,1.6496026531102048
STAT,1814,106,na,1920,0.008217308097007499
STAT,1912,30,35-39,1942,8.959081751473343
STAT,1928,44,20-24,1972,0.02226821290987849
SIM,1815,66,na,1881,482
SIM,1873,28,35-39,1901,6
SIM,1902,48,na,1950,3107
STAT,1905,27,35-39,1932,13.878251938174662
STAT,1919,32,45-49,1951,1.6751585077148365
STAT,1844,44,35-39,1888,1.7908271878508553
STAT,1849,15,35-39,1864,0.5758648896756288
SIM,1881,55,na,1936,2349
STAT,1904,20,35-39,1924,8.386870694242806
STAT,1879,33,45-49,1912,1.781333201638774
STAT,1882,21,15-19,1903,3.168055297703776
STAT,1825,36,na,1861,1776.2684172693273
STAT,1802,70,na,1872,975.2226695426981
STAT,1884,77,na,1961,1014.3069909220808
STAT,1876,33,25-29,1909,10.310635708607547
STAT,1872,29,20-24,1901,11.663440420049268
STAT,1922,23,20-24,1945,125.7027674352308
STAT,1896,33,45-49,1929,2.289055587044416
STAT,1891,44,15-19,1935,0.016753114712902
STAT,1832,27,25-29,1859,51.36125342366714
STAT,1923,29,45-49,1952,1.9485934913423064
SIM,1822,68,na,1890,216
STAT,1852,27,45-49,1879,1.3017353815622188
STAT,1799,96,na,1895,0.571001720580865
STAT,1841,27,35-39,1868,13.345446929383632
SIM,1839,30,45-49,1869,3
SIM,1854,28,30-34,1882,36
STAT,1848,100,na,1948,0.9934604124808313
STAT,1857,28,40-44,1885,2.3506764706813463
STAT,1879,48,15-19,1927,4.0517971109760704E-4
STAT,1881,16,15-19,1897,5.618043970877645
SIM,1826,42,35-39,1868,2
SIM,1898,34,30-34,1932,4
STAT,1846,31,50-100,1877,0.6479781273927366
STAT,1854,15,45-49,1869,0.04396431900310635
STAT,1931,28,25-29,1959,84.33910073639859
SIM,1884,12,na,1896,3855
SIM,1899,65,na,1964,1469
SIM,1880,29,20-24,1909,26
STAT,1925,17,45-49,1942,0.5979224207531558
STAT,1847,68,na,1915,1381.6693141730968
SIM,1866,44,30-34,1910,8
STAT,1931,19,na,1950,4758.234693927266
STAT,1857,75,na,1932,789.9694842747343
STAT,1846,28,30-34,1874,17.91301449247036
STAT,1914,29,35-39,1943,14.818033953948982
SIM,1817,42,25-29,1859,11
STAT,1806,83,na,1889,123.77488110153364
STAT,1869,44,40-44,1913,2.239066764626214
STAT,1835,25,50-100,1860,0.6399608571867831
SIM,1956,14,na,1970,4927
STAT,1829,42,45-49,1871,0.7200237548014305
STAT,1898,21,45-49,1919,0.9405310282561073
STAT,1789,89,na,1878,64.71958144125628
STAT,1845,56,na,1901,1012.1010956315127
SIM,1884,33,25-29,1917,5
SIM,1842,68,na,1910,1844
STAT,1853,85,na,1938,212.56073889926833
STAT,1887,21,35-39,1908,6.442347922890219
SIM,1931,7,na,1938,5369
STAT,1914,17,35-39,1931,0.8559329652605879
STAT,1843,27,35-39,1870,11.73276393097571
SIM,1859,11,na,1870,2403
STAT,1863,27,20-24,1890,10.015284213470508
STAT,1919,39,30-34,1958,1.9278889494051872
STAT,1900,27,na,1927,3306.015856194992
STAT,1818,42,35-39,1860,3.5413144560902077
STAT,1851,50,na,1901,1724.9935553567066
SIM,1871,45,na,1916,1839
SIM,1826,58,na,1884,1370
SIM,1831,70,na,1901,1084
STAT,1851,21,20-24,1872,65.46599309157845
STAT,1895,32,50-100,1927,1.191918623467116
STAT,1928,10,na,1938,4969.609808761804
STAT,1884,26,50-100,1910,0.6144613241400297
STAT,1910,24,40-44,1934,3.1026964100150196
SIM,1902,17,15-19,1919,12
STAT,1863,92,na,1955,35.55661668928952
STAT,1885,33,35-39,1918,9.912385507260177
STAT,1826,83,na,1909,316.49235894967757
SIM,1893,33,35-39,1926,45
SIM,1916,39,20-24,1955,4
STAT,1908,39,20-24,1947,0.24243508382598133
STAT,1827,68,na,1895,1077.6720048683344
STAT,1913,3,na,1916,4081.6171767202504
STAT,1906,18,na,1924,3647.6759563449773
STAT,1889,17,30-34,1906,1.9193774562859476
STAT,1862,21,30-34,1883,15.643164563833862
STAT,1905,38,25-29,1943,0.8894099940907629
STAT,1940,19,35-39,1959,4.2098873512549595
STAT,1911,23,45-49,1934,1.051828352512712
SIM,1831,28,na,1859,2202
SIM,1897,17,30-34,1914,3
STAT,1880,23,40-44,1903,2.156630778210411
STAT,1902,16,50-100,1918,0.06915786171353609
STAT,1855,54,50-100,1909,0.009720679401727977
STAT,1860,33,30-34,1893,14.183393150603031
STAT,1908,17,50-100,1925,0.07211225255608072
STAT,1936,17,20-24,1953,128.51110071458461
STAT,1823,36,15-19,1859,0.10595955238980878
STAT,1929,21,15-19,1950,6.704605135403665
STAT,1939,17,50-100,1956,0.37089955539755004
STAT,1922,16,15-19,1938,52.06436319984929
STAT,1899,39,35-39,1938,2.0641848795183018
STAT,1841,39,35-39,1880,9.08893490725879
STAT,1826,37,45-49,1863,3.2572762251142082
STAT,1832,38,na,1870,2280.8388713262416
STAT,1909,21,30-34,1930,26.520388188390026
STAT,1837,49,20-24,1886,0.009735451313531564
STAT,1875,15,50-100,1890,0.05054115522502156
STAT,1873,46,20-24,1919,0.01234430450119305
STAT,1890,27,15-19,1917,0.5492555920825818
STAT,1867,31,25-29,1898,9.726324978690304
STAT,1869,27,20-24,1896,11.837994963606702
STAT,1821,48,15-19,1869,4.221045663168806E-4
STAT,1859,43,35-39,1902,1.4248697981784306
STAT,1934,29,20-24,1963,24.36561729856213
SIM,1857,33,30-34,1890,98
SIM,1897,30,na,1927,2786
SIM,1930,23,20-24,1953,726
STAT,1872,18,30-34,1890,1.5918548433669308
STAT,1920,28,15-19,1948,0.7617639759589988
STAT,1937,16,25-29,1953,41.824658833382706
STAT,1897,32,15-19,1929,0.18912478749341735
STAT,1897,4,na,1901,3493.6899608464164
STAT,1903,52,na,1955,3040.257974017604
STAT,1944,23,40-44,1967,3.588332380902926
STAT,1843,15,35-39,1858,0.7010635572930564
STAT,1858,44,30-34,1902,0.866109765724815
STAT,1895,16,45-49,1911,0.08518495203575434
STAT,1944,25,50-100,1969,1.0645989897761794
SIM,1925,22,na,1947,4999
STAT,1875,18,na,1893,2586.629500740667
STAT,1880,30,na,1910,2497.272809715196
STAT,1930,29,50-100,1959,1.2555006226188326
STAT,1862,46,45-49,1908,0.20158158897968384
STAT,1855,63,na,1918,1180.9176278957261
STAT,1845,22,40-44,1867,1.2836708369811394
STAT,1930,18,30-34,1948,15.606570540987462
STAT,1884,50,35-39,1934,0.008359644449012863
STAT,1857,20,45-49,1877,0.6267066994423782
SIM,1843,20,25-29,1863,8
SIM,1834,37,45-49,1871,10
STAT,1859,56,na,1915,1616.5988640444857
STAT,1910,40,45-49,1950,0.15729281378705415
STAT,1899,20,15-19,1919,4.532914554001203
STAT,1825,31,20-24,1856,4.974175243100245
STAT,1855,32,45-49,1887,1.1751374840270166
STAT,1837,37,20-24,1874,0.7525330534741664
STAT,1835,32,25-29,1867,9.86649412775483
STAT,1892,22,20-24,1914,85.32013356777114
SIM,1819,47,20-24,1866,1
STAT,1913,32,45-49,1945,1.5459488042907605
SIM,1914,22,25-29,1936,31
STAT,1872,89,na,1961,190.73485966598437
STAT,1941,18,40-44,1959,1.4238671366425677
STAT,1853,82,na,1935,361.7827431722951
STAT,1846,20,35-39,1866,4.3262850395784325
SIM,1881,28,25-29,1909,1
STAT,1838,36,25-29,1874,1.4985454555715692
STAT,1916,45,40-44,1961,0.160256364494795
STAT,1862,45,na,1907,1935.3861920263405
SIM,1831,73,na,1904,736
STAT,1877,95,na,1972,73.90923755370028
STAT,1878,38,20-24,1916,0.7891689132899978
SIM,1794,76,na,1870,438
SIM,1848,21,20-24,1869,20
STAT,1863,20,35-39,1883,5.154861468018699
STAT,1860,30,na,1890,1962.3819916111206
SIM,1887,40,na,1927,3651
STAT,1849,33,30-34,1882,15.342024111243676
SIM,1875,28,35-39,1903,2
STAT,1866,32,20-24,1898,2.467402608583706
SIM,1918,40,na,1958,4365
STAT,1909,49,15-19,1958,3.3308400761914147E-4
STAT,1820,37,50-100,1857,2.2842741119742405
STAT,1886,58,na,1944,2047.9012694932453
STAT,1904,37,na,1941,3392.5350186928454
STAT,1817,50,50-100,1867,0.0106287640645095
STAT,1951,21,25-29,1972,109.36631589580708
STAT,1835,20,25-29,1855,58.41095848741136
STAT,1900,24,na,1924,3255.757356355678
SIM,1837,64,na,1901,1470
SIM,1943,7,na,1950,4986
STAT,1873,28,25-29,1901,43.23919597089777
SIM,1886,38,20-24,1924,13
STAT,1820,98,na,1918,2.234061063439603
STAT,1893,28,45-49,1921,1.3835775446652516
STAT,1877,21,40-44,1898,2.121703079024665
SIM,1915,12,na,1927,3758
STAT,1906,22,25-29,1928,82.89573223276112
STAT,1921,40,20-24,1961,0.01970999915625862
STAT,1857,38,50-100,1895,0.9374495069703003
SIM,1838,60,na,1898,1518
STAT,1926,34,45-49,1960,1.883980733345647
SIM,1828,39,na,1867,1884
SIM,1829,36,25-29,1865,6
STAT,1835,37,50-100,1872,1.1484443474999941
STAT,1831,53,na,1884,1712.9265584431928
STAT,1861,22,25-29,1883,48.90945870077928
STAT,1832,48,25-29,1880,0.005155917602910712
SIM,1846,36,25-29,1882,14
STAT,1873,82,na,1955,478.6107499226074
STAT,1842,45,na,1887,573.1021610837325
STAT,1837,110,na,1947,2.2157716653572326E-4
STAT,1816,103,na,1919,0.1211591776028398
SIM,1860,20,25-29,1880,3
STAT,1840,19,30-34,1859,0.8030187874000092
STAT,1898,29,40-44,1927,3.9993948926011806
STAT,1866,49,50-100,1915,0.21950739581900158
SIM,1942,8,na,1950,3672
SIM,1896,27,25-29,1923,728
STAT,1877,39,15-19,1916,0.056429922020712314
STAT,1888,27,25-29,1915,48.82276451419211
STAT,1797,61,na,1858,38.128748507462745
SIM,1952,1,na,1953,6382
STAT,1857,42,20-24,1899,0.12171695590398125
STAT,1900,34,25-29,1934,14.067450513308465
STAT,1852,20,25-29,1872,69.44679670127381
STAT,1821,45,45-49,1866,0.25926363296425486
STAT,1936,31,35-39,1967,8.793226606532931
SIM,1821,80,na,1901,446
STAT,1882,15,20-24,1897,17.05233910684642
SIM,1875,35,40-44,1910,1
STAT,1846,49,30-34,1895,0.056133827196879385
SIM,1964,1,na,1965,5113
STAT,1919,18,30-34,1937,13.25591672945062
STAT,1888,39,25-29,1927,3.289619703658746
STAT,1852,39,45-49,1891,1.986423918573964
STAT,1855,97,na,1952,3.555545879240612
STAT,1875,48,50-100,1923,0.2490260681192866
STAT,1888,36,na,1924,2732.270909148367
STAT,1875,23,30-34,1898,18.23406465098133
STAT,1878,29,na,1907,2437.8709839070516
STAT,1897,39,35-39,1936,2.007035930514488
SIM,1875,38,na,1913,2983
STAT,1856,31,15-19,1887,0.10461782702510708
STAT,1781,83,na,1864,140.3280965641993
STAT,1929,28,35-39,1957,18.649239372445116
SIM,1894,8,na,1902,1764
SIM,1921,15,na,1936,4822
STAT,1882,25,30-34,1907,24.27297531461398
STAT,1909,28,15-19,1937,0.6654569413868401
SIM,1929,1,na,1930,6340
STAT,1887,29,30-34,1916,27.518943001719155
STAT,1837,30,35-39,1867,10.394630448549695
SIM,1860,39,45-49,1899,1
SIM,1824,46,na,1870,2133
STAT,1939,22,20-24,1961,110.44361851804004
SIM,1834,27,35-39,1861,6
SIM,1942,14,na,1956,3646
STAT,1914,47,30-34,1961,0.08718157684680106
STAT,1791,90,na,1881,39.545845715437494
SIM,1871,20,35-39,1891,5
STAT,1869,15,na,1884,2614.543007511504
STAT,1884,16,35-39,1900,0.5265541746458089
STAT,1902,59,na,1961,2866.400164432489
SIM,1830,26,20-24,1856,35
STAT,1833,31,na,1864,1158.0060570310438
STAT,1868,30,na,1898,2323.3951613342283
STAT,1817,37,35-39,1854,5.5925592150211925
SIM,1828,53,na,1881,1714
STAT,1864,37,15-19,1901,0.05105045753207407
STAT,1867,35,40-44,1902,4.179253484282917
STAT,1853,50,40-44,1903,0.008280326472133531
STAT,1856,38,35-39,1894,5.05495343904985
STAT,1836,38,15-19,1874,0.05227130077797322
STAT,1836,31,30-34,1867,17.08773727230469
STAT,1879,37,25-29,1916,2.9535951819279602
STAT,1893,37,na,1930,2946.214989547591
STAT,1847,48,35-39,1895,0.12498593750644205
STAT,1831,28,20-24,1859,13.363182329550956
STAT,1836,103,na,1939,0.10983735268238692
STAT,1857,45,25-29,1902,0.044640672796189274
STAT,1838,103,na,1941,0.061205172870478816
STAT,1924,37,na,1961,4393.69178893562
STAT,1800,92,na,1892,28.73706672294201
STAT,1855,19,50-100,1874,0.038112874180733475
SIM,1823,34,30-34,1857,1
SIM,1893,6,na,1899,3638
STAT,1859,110,na,1969,0.0026236888850958147
STAT,1906,16,30-34,1922,2.3137053154592575
STAT,1884,28,35-39,1912,9.20413984404522
STAT,1861,104,na,1965,0.3026428787258526
SIM,1890,25,30-34,1915,21
SIM,1890,30,50-100,1920,4
STAT,1842,17,40-44,1859,0.05830556656797404
STAT,1854,16,na,1870,1535.8130134108874
STAT,1896,48,15-19,1944,2.9369874673466196E-4
STAT,1927,27,20-24,1954,22.010765052655678
SIM,1837,28,30-34,1865,6
SIM,1942,5,na,1947,3672
STAT,1860,64,na,1924,1418.1391799398777
SIM,1879,11,na,1890,1851
STAT,1864,23,na,1887,2168.9694803671428
STAT,1928,22,50-100,1950,0.8152940677492717
STAT,1852,24,40-44,1876,2.456122158723212
STAT,1871,15,45-49,1886,0.06636233519862499
SIM,1827,53,40-44,1880,2
SIM,1875,52,na,1927,2646
STAT,1895,69,na,1964,2141.317488700761
SIM,1856,30,45-49,1886,2
STAT,1896,30,40-44,1926,5.762736168818081
STAT,1933,11,na,1944,5275.93369550782
STAT,1842,38,40-44,1880,1.2616019957016495
STAT,1935,18,15-19,1953,61.43394614756933
STAT,1856,25,20-24,1881,8.858174146877001
SIM,1828,50,na,1878,1714
STAT,1820,50,45-49,1870,0.022904325732771028
STAT,1924,1,na,1925,4925.248443611594
STAT,1841,24,30-34,1865,24.76763654949835
SIM,1929,33,25-29,1962,1
STAT,1893,25,50-100,1918,0.8053802719350424
STAT,1860,15,35-39,1875,0.522399633659368
STAT,1864,16,15-19,1880,6.169469174309251
SIM,1857,19,na,1876,1478
SIM,1936,14,na,1950,3982
STAT,1881,18,na,1899,2378.8016732344045
STAT,1854,37,20-24,1891,0.4286056091606154
STAT,1882,18,25-29,1900,5.41116944725874
STAT,1931,25,20-24,1956,23.421363942218665
SIM,1899,11,na,1910,2195
STAT,1850,29,35-39,1879,5.16821647970408
STAT,1929,15,20-24,1944,172.60798263742194
STAT,1953,17,na,1970,4412.662680476992
STAT,1801,77,na,1878,310.9745617646358
SIM,1835,44,35-39,1879,9
SIM,1935,27,20-24,1962,9
STAT,1867,17,45-49,1884,0.06315509433806706
STAT,1913,26,15-19,1939,0.696975978414408
STAT,1837,19,25-29,1856,5.984682861959411
STAT,1834,25,35-39,1859,5.657050702414026
SIM,1933,31,25-29,1964,1
STAT,1830,32,40-44,1862,4.0734990233964545
STAT,1922,26,25-29,1948,73.90152008605827
STAT,1938,27,30-34,1965,38.40272599282067
STAT,1839,31,15-19,1870,0.16451743902519225
STAT,1824,39,35-39,1863,1.1449029875909589
SIM,1791,65,na,1856,990
SIM,1813,51,na,1864,100
STAT,1849,54,30-34,1903,0.004877644998209579
STAT,1844,36,50-100,1880,1.427167319753583
STAT,1848,30,na,1878,2414.708627675811
STAT,1848,30,45-49,1878,1.9429311213866773
STAT,1870,50,40-44,1920,0.010646185360073094
STAT,1840,36,15-19,1876,0.0264250117008499
STAT,1877,32,30-34,1909,17.723714400626275
SIM,1870,60,na,1930,1021
SIM,1908,34,35-39,1942,25
STAT,1873,49,25-29,1922,0.05785125806268507
SIM,1901,28,20-24,1929,13
STAT,1935,21,40-44,1956,4.547246455161278
STAT,1837,75,na,1912,825.4572962020868
STAT,1923,19,35-39,1942,4.849293983305318
STAT,1808,53,30-34,1861,0.007487348080863539
STAT,1826,34,40-44,1860,7.643864371660486
STAT,1845,25,45-49,1870,0.6803406503390643
STAT,1883,35,25-29,1918,2.7962182437216665
STAT,1953,17,20-24,1970,162.53407867199707
STAT,1835,39,45-49,1874,1.8264034824880333
SIM,1826,32,25-29,1858,8
STAT,1948,10,na,1958,4450.640153540351
STAT,1796,68,na,1864,1285.30343454066
STAT,1925,31,25-29,1956,10.881475341947548
SIM,1860,53,na,1913,1914
SIM,1893,23,25-29,1916,5
STAT,1885,23,25-29,1908,56.09566439916993
STAT,1875,63,na,1938,1832.21678508694
STAT,1832,45,20-24,1877,0.0011109004245051287
STAT,1814,95,na,1909,8.998214916229255
STAT,1875,44,30-34,1919,1.1646043169140587
STAT,1905,35,20-24,1940,0.24158189994927662
SIM,1923,41,na,1964,4223
STAT,1816,44,25-29,1860,2.001996787152529
STAT,1897,36,30-34,1933,7.112022700944718
STAT,1781,111,na,1892,5.304369075894598E-4
STAT,1901,19,15-19,1920,8.253279736548125
STAT,1918,15,45-49,1933,0.10811499889758447
STAT,1860,15,50-100,1875,0.046642815792067194
STAT,1911,27,50-100,1938,0.9597454821401401
SIM,1898,48,50-100,1946,1
SIM,1878,25,15-19,1903,3
STAT,1878,17,20-24,1895,18.24034049114187
STAT,1881,22,45-49,1903,0.6585140690089849
STAT,1918,51,na,1969,3807.62560885286
STAT,1885,70,na,1955,1379.1508908173441
STAT,1853,47,50-100,1900,0.18954764398751703
STAT,1831,38,30-34,1869,5.345694640072212
STAT,1867,34,na,1901,2237.48422801936
STAT,1862,28,15-19,1890,0.3850768075541301
SIM,1861,47,50-100,1908,1
STAT,1830,57,na,1887,1464.8628485422987
STAT,1908,44,na,1952,3367.6361122374865
STAT,1870,22,35-39,1892,5.8175834221284575
STAT,1899,24,30-34,1923,24.176909824140324
STAT,1915,28,40-44,1943,4.670507023628535
STAT,1862,42,na,1904,1966.1540800249888
SIM,1923,28,40-44,1951,2
SIM,1898,37,35-39,1935,3
STAT,1816,48,40-44,1864,0.5132879771941333
STAT,1921,43,25-29,1964,0.07935077154633947
STAT,1847,38,25-29,1885,2.672964289094641
STAT,1903,22,40-44,1925,2.9579900144798876
STAT,1819,50,na,1869,604.1056426762002
SIM,1900,13,na,1913,4181
STAT,1883,39,40-44,1922,4.168961461985119
SIM,1907,34,na,1941,4484
STAT,1893,25,40-44,1918,3.7714503279661726
STAT,1868,45,35-39,1913,0.13657002481608668
STAT,1928,37,15-19,1965,0.024084489641401797
STAT,1809,49,45-49,1858,1.9855431058068174
SIM,1837,24,15-19,1861,44
STAT,1834,43,30-34,1877,0.6030432519073113
STAT,1858,38,35-39,1896,5.374546981398374
STAT,1853,34,35-39,1887,7.920157269026591
STAT,1928,22,45-49,1950,1.3941528027300416
STAT,1947,23,25-29,1970,103.26081733719556
STAT,1853,9,na,1862,2272.459872406179
STAT,1842,90,na,1932,19.571734759847274
STAT,1916,48,45-49,1964,0.2192680065802146
STAT,1896,15,15-19,1911,7.859441973936378
STAT,1917,22,35-39,1939,9.87377684300939
SIM,1890,28,35-39,1918,337
SIM,1842,65,na,1907,2187
STAT,1857,49,40-44,1906,0.12862932262876942
STAT,1849,36,35-39,1885,6.161885002711935
STAT,1918,33,40-44,1951,4.0850524845564
SIM,1847,47,30-34,1894,1
SIM,1861,34,35-39,1895,82
STAT,1845,43,40-44,1888,1.122106180674183
STAT,1846,43,50-100,1889,0.6252082995259551
STAT,1792,107,na,1899,0.001141620910608846
STAT,1874,20,45-49,1894,0.723976277097889
STAT,1888,24,20-24,1912,79.03838803220106
SIM,1873,71,na,1944,609
STAT,1839,56,na,1895,1894.9548145499086
STAT,1930,32,45-49,1962,2.016498018585082
SIM,1893,26,na,1919,3258
STAT,1790,101,na,1891,0.16592051833841684
STAT,1804,51,na,1855,2239.6367606234107
STAT,1919,20,45-49,1939,1.2229721072090236
SIM,1862,34,na,1896,3786
SIM,1934,33,na,1967,5049
STAT,1919,35,15-19,1954,0.020469865864416258
STAT,1879,27,15-19,1906,0.46542614246482106
STAT,1824,57,na,1881,420.9973587955191
SIM,1924,26,na,1950,4936
STAT,1921,20,35-39,1941,10.571750614163332
SIM,1853,43,40-44,1896,1
STAT,1859,30,20-24,1889,2.173633339864673
STAT,1907,33,30-34,1940,14.566256285109725
STAT,1917,49,50-100,1966,0.2317261572245373
STAT,1937,34,20-24,1971,2.385165095763744
SIM,1817,49,45-49,1866,2
STAT,1898,6,na,1904,3512.8807327667396
STAT,1829,49,na,1878,874.1238130086392
STAT,1882,28,35-39,1910,9.205465383740439
SIM,1891,48,na,1939,1897
STAT,1867,38,45-49,1905,1.8759492183322692
STAT,1915,42,20-24,1957,0.017528827083459708
SIM,1908,19,na,1927,2859
STAT,1842,34,25-29,1876,3.0084765413916217
STAT,1910,20,25-29,1930,86.28483249133528
SIM,1850,34,25-29,1884,26
STAT,1839,47,30-34,1886,0.09163070601064185
STAT,1861,51,45-49,1912,0.01212689320621989
STAT,1815,43,na,1858,224.81175073448145
STAT,1833,22,15-19,1855,3.0829500894383712
SIM,1848,24,25-29,1872,25
STAT,1850,43,15-19,1893,0.0063307848941584555
SIM,1939,25,na,1964,3933
STAT,1897,26,20-24,1923,15.633443019158548
SIM,1864,38,35-39,1902,7
STAT,1864,26,25-29,1890,38.588454434101095
SIM,1849,45,40-44,1894,1
STAT,1904,28,30-34,1932,35.85063775891175
SIM,1867,30,20-24,1897,1
STAT,1876,48,na,1924,2245.804419933265
STAT,1846,45,15-19,1891,2.39265978684566E-4
STAT,1838,26,15-19,1864,0.24814772794233037
STAT,1827,44,35-39,1871,1.6728829248979658
SIM,1901,49,na,1950,3314
SIM,1831,29,40-44,1860,132
STAT,1831,50,na,1881,1817.783364043209
STAT,1872,39,30-34,1911,5.283111083563682
SIM,1822,65,na,1887,516
SIM,1865,49,40-44,1914,1
STAT,1912,19,25-29,1931,8.614633022354159
SIM,1919,5,na,1924,5211
SIM,1859,42,30-34,1901,2
STAT,1840,21,45-49,1861,0.3517011037289323
STAT,1948,16,35-39,1964,4.754332529177681
STAT,1886,55,na,1941,2141.2209900458756
STAT,1789,86,na,1875,122.09758633030096
SIM,1853,20,na,1873,2662
STAT,1894,35,35-39,1929,9.079761315914126
SIM,1840,87,na,1927,1449
STAT,1863,2,na,1865,2917.46506210976
STAT,1921,49,30-34,1970,0.09872187128692242
STAT,1926,24,35-39,1950,11.27014694444386
SIM,1912,28,30-34,1940,1050
STAT,1813,65,na,1878,1481.316223023597
STAT,1911,19,na,1930,3800.897369557107
STAT,1926,18,na,1944,4462.3791696365315
STAT,1955,15,30-34,1970,16.047908980575528
SIM,1826,72,na,1898,427
SIM,1823,37,35-39,1860,1
SIM,1846,26,15-19,1872,3
STAT,1900,17,40-44,1917,0.25337294054974696
STAT,1844,32,35-39,1876,11.997519093927577
STAT,1867,21,15-19,1888,3.155495689628451
SIM,1896,24,20-24,1920,520
SIM,1851,79,na,1930,592
SIM,1866,78,na,1944,1197
STAT,1848,16,30-34,1864,1.8598929526384207
STAT,1861,26,40-44,1887,2.527486361796898
STAT,1933,23,30-34,1956,37.85258481367662
SIM,1864,12,na,1876,2555
STAT,1779,103,na,1882,0.08395745060909574
STAT,1828,64,na,1892,1176.7473340915242
STAT,1947,5,na,1952,4416.0346157946
SIM,1916,48,na,1964,4553
STAT,1886,44,40-44,1930,2.2977974836037527
STAT,1856,35,30-34,1891,3.8643430559652794
STAT,1919,23,50-100,1942,0.7087496578092954
SIM,1829,33,20-24,1862,19
STAT,1920,26,50-100,1946,1.0815326879007219
SIM,1889,25,25-29,1914,167
STAT,1862,49,15-19,1911,3.335826478611115E-4
STAT,1898,46,25-29,1944,0.04381550589910369
SIM,1852,32,35-39,1884,20
STAT,1816,106,na,1922,0.010250335837466377
STAT,1909,31,40-44,1940,3.7114748382715286
SIM,1845,44,50-100,1889,4
STAT,1819,53,40-44,1872,0.001818731544532423
STAT,1945,25,15-19,1970,0.766613797743516
STAT,1942,25,na,1967,3890.262917499555
STAT,1923,33,15-19,1956,0.1456776754725694
STAT,1837,44,50-100,1881,0.8866006125103274
STAT,1821,43,na,1864,1372.797092905855
STAT,1883,52,na,1935,2060.4129868555765
SIM,1856,23,na,1879,452
STAT,1819,43,40-44,1862,0.47205765442069714
STAT,1928,43,50-100,1971,0.1483917076738305
STAT,1908,26,40-44,1934,4.424369491999156
STAT,1938,4,na,1942,3938.8344805397714
STAT,1925,30,25-29,1955,10.887463446843315
STAT,1859,52,25-29,1911,0.002792428178105001
STAT,1845,39,25-29,1884,1.4702758261514266
SIM,1819,39,na,1858,1883
STAT,1886,47,50-100,1933,0.25314539947363796
STAT,1881,53,20-24,1934,6.856638085632594E-4
STAT,1854,87,na,1941,97.95963044533688
STAT,1858,45,45-49,1903,0.18202153824972148
STAT,1929,18,25-29,1947,54.773191885773834
SIM,1823,44,na,1867,1387
STAT,1846,41,50-100,1887,0.6414352957047672
STAT,1879,47,na,1926,2297.2164039190525
STAT,1926,17,45-49,1943,0.6072109403618958
STAT,1841,51,25-29,1892,0.003963133461390647
STAT,1903,49,50-100,1952,0.1925513980419207
STAT,1875,33,na,1908,2440.0481700261003
STAT,1909,8,na,1917,3858.7677101600502
SIM,1924,32,25-29,1956,3
STAT,1905,30,50-100,1935,1.3284478998797615
STAT,1835,35,50-100,1870,1.1725439853586241
STAT,1835,26,35-39,1861,9.58366956060828
STAT,1874,40,50-100,1914,1.1013304234154233
SIM,1912,27,na,1939,4614
STAT,1890,38,na,1928,2838.016354295478
SIM,1808,87,na,1895,348
STAT,1866,30,20-24,1896,2.4872359413983767
STAT,1873,52,50-100,1925,0.01540962034143404
STAT,1875,42,40-44,1917,2.306830312409458
STAT,1813,89,na,1902,76.954440880562
STAT,1862,48,15-19,1910,3.364152643872523E-4
STAT,1882,18,20-24,1900,16.929007341349184
STAT,1862,36,20-24,1898,0.6597236974341621
STAT,1894,40,25-29,1934,0.8248443080787844
STAT,1903,45,20-24,1948,0.009704465179051712
SIM,1827,43,40-44,1870,1
STAT,1874,3,na,1877,3193.262497854865
STAT,1852,23,30-34,1875,21.14662968235643
STAT,1837,29,50-100,1866,0.6489171309481023
STAT,1873,34,30-34,1907,17.756485595862596
SIM,1916,26,40-44,1942,1
SIM,1890,74,na,1964,2631
SIM,1891,16,na,1907,2619
SIM,1886,69,na,1955,1856
SIM,1921,6,na,1927,5397
SIM,1882,55,na,1937,1326
SIM,1920,46,na,1966,3607
STAT,1815,49,40-44,1864,0.016898624655538333
STAT,1895,27,45-49,1922,1.4443627744240524
STAT,1927,32,na,1959,4614.479525559478
STAT,1854,37,25-29,1891,1.6008845318196365
SIM,1950,2,na,1952,4943
STAT,1831,27,na,1858,2230.830396343826
STAT,1848,35,50-100,1883,1.2087989885541042
STAT,1916,32,25-29,1948,9.412184256470894
STAT,1895,6,na,1901,3398.3437143636525
SIM,1928,26,na,1954,4605
STAT,1944,28,na,1972,4001.37343118114
STAT,1899,47,50-100,1946,0.188343508415757
STAT,1932,20,15-19,1952,6.977277147119658
STAT,1940,14,na,1954,3948.7907640304134
STAT,1838,49,35-39,1887,0.05992878203984754
STAT,1886,21,35-39,1907,6.061176108968139
SIM,1924,12,na,1936,5281
STAT,1863,41,35-39,1904,1.5529088836979275
STAT,1849,52,40-44,1901,0.008823289681510419
STAT,1865,39,na,1904,2129.33739361899
STAT,1917,24,40-44,1941,3.5037837052003833
STAT,1880,24,20-24,1904,71.09394818114859
STAT,1847,47,35-39,1894,0.1259862684781586
STAT,1917,37,50-100,1954,0.4302680194749293
STAT,1923,22,15-19,1945,6.128590883315232
STAT,1866,44,40-44,1910,2.0254669917147607
STAT,1956,13,na,1969,5151.578659497852
SIM,1943,15,na,1958,4981
STAT,1934,16,40-44,1950,1.88370902317221
SIM,1787,76,na,1863,365
STAT,1841,21,na,1862,3037.995178938871
STAT,1864,36,30-34,1900,4.868471927189358
STAT,1833,93,na,1926,12.02441412883068
SIM,1898,54,na,1952,4037
SIM,1873,19,na,1892,2296
STAT,1890,46,25-29,1936,0.03944575549513158
STAT,1849,49,na,1898,1856.1168463167257
STAT,1866,72,na,1938,1152.7941041872512
STAT,1796,60,na,1856,1732.0185228841997
STAT,1858,31,25-29,1889,7.903554977384298
STAT,1850,54,30-34,1904,0.0026730728186162276
STAT,1825,41,15-19,1866,0.018665527346727138
STAT,1870,53,45-49,1923,0.014235608627884108
STAT,1912,38,25-29,1950,0.9451179324517254
STAT,1901,43,45-49,1944,0.14426644337013206
STAT,1907,19,50-100,1926,0.07110054306126386
SIM,1874,44,40-44,1918,6
STAT,1856,23,15-19,1879,2.7322348027877394
SIM,1869,73,na,1942,3598
SIM,1844,38,na,1882,2926
STAT,1914,46,35-39,1960,0.12640253576890684
STAT,1786,98,na,1884,1.1366533665777792
SIM,1894,40,na,1934,1456
STAT,1857,36,na,1893,1816.5874469992114
SIM,1861,18,na,1879,2602
STAT,1874,16,na,1890,2612.995346973682
STAT,1845,35,na,1880,1252.8654547375002
STAT,1858,39,35-39,1897,5.3469755553838
STAT,1929,31,50-100,1960,1.0434561063488135
SIM,1927,8,na,1935,1973
STAT,1850,15,20-24,1865,10.12248835314574
STAT,1896,47,30-34,1943,0.07164401003912914
STAT,1845,44,20-24,1889,0.07821918982037493
STAT,1869,37,45-49,1906,2.011591319290376
SIM,1919,27,20-24,1946,31
STAT,1817,44,45-49,1861,1.0622134279909663
SIM,1887,3,na,1890,4022
SIM,1835,61,na,1896,1160
STAT,1889,22,15-19,1911,3.9727672612121356
STAT,1851,36,45-49,1887,1.607911151187828
SIM,1799,77,na,1876,105
STAT,1892,32,15-19,1924,0.1763140624763689
STAT,1884,35,45-49,1919,1.926433247364758
STAT,1801,54,35-39,1855,0.021400843652909382
STAT,1886,34,40-44,1920,4.452438021081886
STAT,1875,23,25-29,1898,58.601144824368646
STAT,1912,43,20-24,1955,0.016733998537016032
STAT,1859,40,30-34,1899,0.9204130786104481
STAT,1884,26,30-34,1910,24.188662762106144
STAT,1909,23,50-100,1932,0.6034538311037299
STAT,1854,71,na,1925,742.1727393688027
STAT,1858,85,na,1943,209.3466774929413
STAT,1862,90,na,1952,67.1517453339898
STAT,1882,27,35-39,1909,9.237983084196811
STAT,1872,41,50-100,1913,1.0626749260628292
STAT,1826,39,15-19,1865,0.08728329861275451
STAT,1828,47,25-29,1875,0.06877188263968141
SIM,1853,20,35-39,1873,211
STAT,1874,50,25-29,1924,0.0037081252914406364
STAT,1927,32,50-100,1959,1.0087700183532347
STAT,1942,22,25-29,1964,95.74228067580304
SIM,1823,36,35-39,1859,13
STAT,1832,33,30-34,1865,1.1631378114432498
SIM,1840,33,30-34,1873,18
STAT,1867,17,40-44,1884,0.17683430714826862
SIM,1858,7,na,1865,2591
SIM,1866,31,25-29,1897,22
STAT,1875,51,50-100,1926,0.015582493201282169
STAT,1908,49,15-19,1957,3.2862856849982715E-4
STAT,1875,37,45-49,1912,2.0470162578297293
STAT,1848,17,30-34,1865,1.84893818314738
STAT,1948,18,35-39,1966,4.7514803556483685
STAT,1865,21,15-19,1886,3.0706398247588056
SIM,1870,54,na,1924,1021
STAT,1888,18,50-100,1906,0.05639650112367702
SIM,1866,49,na,1915,2838
STAT,1892,37,45-49,1929,2.4681235923184
STAT,1925,25,na,1950,4413.898095550124
STAT,1881,48,25-29,1929,0.05371096290942137
STAT,1848,21,15-19,1869,3.7860965012060834
SIM,1852,41,25-29,1893,1
STAT,1895,35,20-24,1930,1.0122995887837098
STAT,1834,41,40-44,1875,1.2104497592054149
SIM,1833,46,45-49,1879,3
STAT,1810,65,na,1875,59.87640950283077
STAT,1871,26,45-49,1897,1.1113767139385586
STAT,1916,26,50-100,1942,1.0186028803161502
STAT,1922,45,30-34,1967,0.10174578454080842
STAT,1825,46,45-49,1871,0.3038127461893398
STAT,1879,79,na,1958,829.9350088962108
STAT,1899,37,30-34,1936,1.5712152539803792
STAT,1844,37,50-100,1881,1.285306466324929
STAT,1890,26,30-34,1916,30.590008670737785
STAT,1829,40,45-49,1869,0.741446720254541
STAT,1854,26,45-49,1880,0.7163324338286434
STAT,1818,51,25-29,1869,0.006183276344266764
STAT,1886,17,na,1903,2615.3916807243354
STAT,1877,45,50-100,1922,0.2517991062368333
SIM,1898,34,25-29,1932,24
STAT,1845,30,50-100,1875,0.551932751442414
STAT,1849,46,30-34,1895,0.0817944661545064
STAT,1882,52,25-29,1934,0.003373106595254219
STAT,1949,22,35-39,1971,10.878852403431056
STAT,1840,35,30-34,1875,2.5341513268795226
STAT,1886,29,45-49,1915,1.141556855530085
STAT,1839,39,25-29,1878,3.130915009613651
STAT,1828,44,20-24,1872,0.192072882263387
STAT,1854,55,na,1909,1149.6852977081119
SIM,1876,1,na,1877,5328
STAT,1879,31,45-49,1910,1.796192789534377
STAT,1938,33,15-19,1971,0.12774896835802954
STAT,1819,38,45-49,1857,0.4882951643762951
SIM,1837,40,45-49,1877,7
STAT,1897,24,15-19,1921,4.353847715281414
SIM,1851,34,45-49,1885,1
SIM,1853,74,na,1927,2003
STAT,1830,28,25-29,1858,40.38339750759555
STAT,1888,45,30-34,1933,0.11283687731023403
STAT,1857,37,50-100,1894,0.9421224342441513
STAT,1843,34,45-49,1877,2.0287730226446437
STAT,1844,100,na,1944,1.051759949946765
STAT,1883,84,na,1967,600.0595880298625
STAT,1844,41,25-29,1885,0.6599534612985017
SIM,1836,44,20-24,1880,3
STAT,1820,54,45-49,1874,0.021157172959454282
STAT,1795,59,na,1854,1194.9999999999998
STAT,1834,24,50-100,1858,0.23691904132686692
STAT,1829,29,15-19,1858,0.2768026213299981
STAT,1869,45,20-24,1914,0.012229704423622664
STAT,1819,49,25-29,1868,0.010244978307198095
STAT,1828,36,45-49,1864,2.738219841454637
STAT,1866,40,na,1906,2131.030975812633
STAT,1859,18,45-49,1877,0.05974494011861343
STAT,1937,17,20-24,1954,130.52912885666464
STAT,1891,1,na,1892,3347.1574629932497
STAT,1907,12,na,1919,3768.1309629627126
STAT,1838,54,30-34,1892,0.00247115161059558
STAT,1881,36,30-34,1917,5.0571988529523155
STAT,1915,31,na,1946,3812.980792438639
SIM,1932,31,na,1963,6264
STAT,1881,40,15-19,1921,0.01317287296787374
STAT,1960,2,na,1962,5078.984431913662
STAT,1838,30,45-49,1868,0.9444091840011746
STAT,1860,25,30-34,1885,21.06471380374689
STAT,1845,36,45-49,1881,1.05019400724894
STAT,1874,91,na,1965,159.87155998137112
STAT,1855,30,45-49,1885,1.199797266506509
STAT,1899,24,25-29,1923,77.7004261599949
STAT,1819,54,20-24,1873,1.2528153027376588E-4
STAT,1843,25,30-34,1868,31.06481008109056
STAT,1808,51,40-44,1859,0.013844311953011126
STAT,1865,29,25-29,1894,38.34478919664208
STAT,1927,2,na,1929,5043.814062168516
STAT,1918,40,35-39,1958,0.21179525451265868
STAT,1885,42,25-29,1927,0.6304307245456577
STAT,1815,96,na,1911,0.6054074082012885
STAT,1866,42,15-19,1908,0.012590351018033658
STAT,1886,45,20-24,1931,0.01255048955831786
STAT,1954,17,20-24,1971,166.1213842335309
STAT,1891,16,20-24,1907,21.85482907480509
STAT,1814,45,30-34,1859,0.33988920147316104
STAT,1929,43,15-19,1972,0.0019717045527084297
STAT,1845,19,na,1864,1422.7349274054923
SIM,1906,24,30-34,1930,18
STAT,1807,61,na,1868,1095.8905244250723
STAT,1820,59,na,1879,1428.966376397869
STAT,1896,31,45-49,1927,2.3081505113754264
SIM,1904,8,na,1912,4201
STAT,1835,51,25-29,1886,0.002785821207771115
SIM,1882,71,na,1953,1035
STAT,1823,35,30-34,1858,10.16390779975289
STAT,1790,71,na,1861,813.0509903826272
STAT,1853,39,50-100,1892,0.9423966290879218
STAT,1788,107,na,1895,5.694265048175418E-4
STAT,1846,52,na,1898,1268.4482155493306
SIM,1884,27,35-39,1911,37
STAT,1860,34,45-49,1894,1.410416785079093
STAT,1808,46,45-49,1854,0.45820680018648025
STAT,1849,33,25-29,1882,9.00027640611077
STAT,1938,21,20-24,1959,108.90706454935523
SIM,1896,47,na,1943,3235
SIM,1892,33,na,1925,3558
STAT,1929,39,na,1968,4785.977230764878
STAT,1939,28,35-39,1967,14.92011096083086
STAT,1866,39,50-100,1905,1.1094271583684163
STAT,1848,29,25-29,1877,46.58035592356329
STAT,1817,106,na,1923,0.0038463589866441824
SIM,1883,20,20-24,1903,48
STAT,1899,46,45-49,1945,0.1823454917502745
STAT,1881,43,50-100,1924,0.9904511206754744
SIM,1831,35,30-34,1866,9
SIM,1878,34,na,1912,3612
STAT,1918,25,50-100,1943,1.0520749947671513
STAT,1936,34,50-100,1970,0.7940797471111605
SIM,1799,61,na,1860,1246
STAT,1884,48,50-100,1932,0.2321519841017422
STAT,1890,22,na,1912,2863.1450309963056
SIM,1881,38,na,1919,2982
SIM,1946,21,20-24,1967,3
STAT,1876,27,35-39,1903,9.754179264521715
SIM,1857,33,25-29,1890,68
STAT,1875,45,45-49,1920,0.2447531220705754
STAT,1943,17,45-49,1960,0.5236795867202048
STAT,1836,43,40-44,1879,2.024301420710339
STAT,1864,20,45-49,1884,0.6534839409797067
STAT,1885,17,35-39,1902,0.5393533006881793
SIM,1815,41,na,1856,2214
STAT,1871,18,45-49,1889,0.06519660592172688
SIM,1869,9,na,1878,3913
STAT,1902,15,50-100,1917,0.06930895523595047
SIM,1899,12,na,1911,2176
STAT,1876,52,25-29,1928,0.0035615876440318055
SIM,1819,55,na,1874,1842
SIM,1866,42,40-44,1908,11
STAT,1913,21,50-100,1934,0.6315036986819403
STAT,1925,26,40-44,1951,5.473582005392548
STAT,1873,37,35-39,1910,7.255258723963123
STAT,1942,30,25-29,1972,9.744094052436633
SIM,1893,30,30-34,1923,3
STAT,1909,17,45-49,1926,0.0969647583876938
STAT,1899,45,30-34,1944,0.07532434759757585
SIM,1938,22,25-29,1960,451
STAT,1847,42,na,1889,2101.2853923436114
STAT,1857,54,40-44,1911,0.007856358345686048
SIM,1888,28,na,1916,424
STAT,1894,68,na,1962,2121.888233110839
STAT,1847,44,30-34,1891,1.0254041285253856
STAT,1830,33,20-24,1863,2.5127684699196844
STAT,1890,34,30-34,1924,20.955895410093355
STAT,1898,16,30-34,1914,2.1485669992082363
STAT,1828,39,na,1867,1835.8751023677958
STAT,1885,30,30-34,1915,17.299968769615862
STAT,1813,50,35-39,1863,0.031160036199777395
STAT,1888,83,na,1971,876.4462248608661
SIM,1875,21,25-29,1896,2
SIM,1874,20,na,1894,2693
STAT,1910,38,15-19,1948,0.018070437622538633
SIM,1851,26,50-100,1877,5
STAT,1835,23,30-34,1858,17.786204219583905
STAT,1843,26,50-100,1869,0.7834691727372972
STAT,1808,54,45-49,1862,0.017853816988544595
STAT,1902,28,15-19,1930,0.6366370847003349
SIM,1942,20,25-29,1962,1171
STAT,1823,43,30-34,1866,1.8848307830281557
STAT,1867,29,35-39,1896,9.060061607149253
SIM,1838,69,na,1907,1075
SIM,1912,1,na,1913,4905
STAT,1854,34,20-24,1888,1.5074761752008414
STAT,1861,52,40-44,1913,0.008708636891586262
STAT,1869,34,40-44,1903,4.338635613320975
STAT,1828,32,50-100,1860,1.3877519797031401
SIM,1839,25,30-34,1864,1
STAT,1928,27,20-24,1955,22.31766123179346
SIM,1883,45,45-49,1928,1
STAT,1923,34,50-100,1957,0.9366566381789255
SIM,1911,53,na,1964,2221
STAT,1868,20,50-100,1888,0.3995903902740416
STAT,1903,48,25-29,1951,0.04554209821687321
STAT,1841,25,20-24,1866,16.46132328711566
SIM,1833,22,na,1855,2631
STAT,1858,23,25-29,1881,45.31645308095835
STAT,1867,21,25-29,1888,54.75506670383857
STAT,1853,53,45-49,1906,0.011072086665940969
STAT,1866,33,25-29,1899,9.310185433838068
STAT,1834,22,25-29,1856,33.741479742143305
STAT,1829,43,50-100,1872,0.5008986684953446
STAT,1877,40,na,1917,2369.860379311567
STAT,1894,43,50-100,1937,0.09261773259591793
STAT,1926,15,na,1941,4494.888642295636
SIM,1849,39,35-39,1888,14
STAT,1930,39,30-34,1969,2.355583681486591
SIM,1900,3,na,1903,4181
STAT,1820,40,25-29,1860,1.0995829476972074
STAT,1875,20,20-24,1895,71.18515968572268
STAT,1825,90,na,1915,48.55101848841246
STAT,1874,75,na,1949,1062.473334369887
SIM,1898,70,na,1968,3069
STAT,1904,31,na,1935,3423.2455061302376
STAT,1862,25,40-44,1887,2.598024179268028
STAT,1812,52,45-49,1864,0.003570571908964874
STAT,1895,24,40-44,1919,2.693799679284677
STAT,1871,38,15-19,1909,0.055738782863323094
STAT,1870,61,na,1931,1862.9047133646634
STAT,1901,35,45-49,1936,0.6073329167970096
STAT,1892,39,50-100,1931,1.5047620061702556
STAT,1810,44,35-39,1854,0.009636621675977786
STAT,1845,28,45-49,1873,0.6657910804852604
STAT,1846,29,15-19,1875,0.3204216957587964
SIM,1893,23,na,1916,3424
SIM,1840,28,35-39,1868,12
STAT,1841,80,na,1921,688.8471934134313
STAT,1828,33,40-44,1861,6.354096827935974
STAT,1917,1,na,1918,4419.408286378919
STAT,1832,28,35-39,1860,11.55921212620666
STAT,1903,46,na,1949,3203.3371199252097
STAT,1871,34,20-24,1905,2.6733333649975
SIM,1803,56,na,1859,1573
STAT,1882,24,30-34,1906,16.946903722594413
STAT,1870,37,50-100,1907,1.223977438638872
STAT,1834,44,45-49,1878,0.7750491976767373
STAT,1889,27,20-24,1916,14.127307112780247
SIM,1844,43,40-44,1887,1
STAT,1821,35,20-24,1856,1.0045512573436102
STAT,1916,32,na,1948,3851.43401212255
STAT,1845,94,na,1939,9.9174317581025
STAT,1856,28,20-24,1884,8.668735777344157
STAT,1916,40,25-29,1956,0.07238072173612989
STAT,1839,23,15-19,1862,3.9099000136902977
STAT,1868,7,na,1875,2674.6568012396615
STAT,1852,26,35-39,1878,11.394354225007097
SIM,1860,26,35-39,1886,2
STAT,1821,104,na,1925,0.03368466260351687
SIM,1939,26,na,1965,4691
STAT,1895,38,25-29,1933,3.7268908451636533
STAT,1824,73,na,1897,229.85831079777404
STAT,1844,16,35-39,1860,0.6951030497516182
SIM,1853,58,na,1911,2608
SIM,1845,23,na,1868,2226
STAT,1807,77,na,1884,403.5337319604952
STAT,1897,37,20-24,1934,1.0237273599738723
STAT,1873,46,25-29,1919,0.05925265884175468
STAT,1890,45,50-100,1935,0.300289348569604
STAT,1908,30,25-29,1938,8.72640857767855
STAT,1906,26,30-34,1932,36.59032740780088
STAT,1923,30,15-19,1953,0.1469397559792327
STAT,1873,29,35-39,1902,9.826933657944592
STAT,1872,19,15-19,1891,5.910750301139855
STAT,1843,87,na,1930,174.07449600119804
STAT,1900,44,50-100,1944,0.10025578609017409
STAT,1852,18,35-39,1870,0.6640803366231999
STAT,1817,43,30-34,1860,0.8297325022523722
STAT,1922,48,35-39,1970,0.14605648425450982
STAT,1851,31,15-19,1882,0.11828562877233165
SIM,1898,31,20-24,1929,1
STAT,1832,30,50-100,1862,0.14828700786573482
STAT,1901,21,25-29,1922,80.28333643984112
STAT,1881,45,20-24,1926,0.011445150524371343
STAT,1894,52,na,1946,2723.592437171672
SIM,1867,66,na,1933,827
STAT,1854,51,35-39,1905,0.004809692074757548
STAT,1836,35,40-44,1871,4.203717107811933
STAT,1933,28,na,1961,4937.990466441064
STAT,1810,81,na,1891,16.836472429797766
STAT,1924,17,35-39,1941,4.948908172416299
STAT,1859,41,50-100,1900,0.8411247140085153
STAT,1899,24,50-100,1923,0.5535007428157803
STAT,1849,49,35-39,1898,0.11549988861440802
STAT,1856,36,20-24,1892,0.5563297731514881
SIM,1838,38,20-24,1876,1
STAT,1845,20,35-39,1865,3.646962978209303
STAT,1875,34,40-44,1909,4.415040745154992
STAT,1884,34,30-34,1918,16.57060945646638
STAT,1870,100,na,1970,7.854018517916575
STAT,1820,51,40-44,1871,0.016288995224847003
SIM,1866,36,30-34,1902,57
STAT,1840,38,35-39,1878,3.2599413996171047
STAT,1872,42,15-19,1914,0.013811580077711674
STAT,1826,33,50-100,1859,1.7039375881011247
STAT,1840,52,20-24,1892,2.8901235285334274E-4
STAT,1842,43,40-44,1885,0.570340588355669
SIM,1832,26,35-39,1858,37
STAT,1816,53,40-44,1869,0.030200070575347366
STAT,1913,16,20-24,1929,27.43896854030035
SIM,1892,34,30-34,1926,17
STAT,1863,34,50-100,1897,0.7755131237801102
STAT,1832,36,35-39,1868,0.521247199597249
STAT,1838,48,20-24,1886,0.005202986958028462
STAT,1858,27,40-44,1885,2.3418111786484834
STAT,1938,24,25-29,1962,90.37776012313607
STAT,1877,47,20-24,1924,0.012124654117218971
STAT,1849,41,25-29,1890,0.5435245435861807
STAT,1873,23,15-19,1896,3.373614845644886
SIM,1879,51,na,1930,1084
STAT,1861,35,50-100,1896,1.0307405972405392
STAT,1910,3,na,1913,3961.0587815829613
STAT,1857,15,30-34,1872,1.4546183419444287
SIM,1849,31,25-29,1880,17
STAT,1915,47,na,1962,3649.643692480892
STAT,1897,29,20-24,1926,15.468623634386498
STAT,1903,26,50-100,1929,0.9111667095990467
STAT,1911,33,na,1944,3625.975538757529
STAT,1881,20,45-49,1901,0.6624431389696889
STAT,1867,35,45-49,1902,1.9032052333313318
SIM,1880,19,15-19,1899,20
SIM,1897,4,na,1901,3075
SIM,1807,49,50-100,1856,5
SIM,1808,55,na,1863,1309
STAT,1891,17,35-39,1908,0.674763408087588
STAT,1869,21,na,1890,2393.7328372202996
STAT,1923,49,40-44,1972,0.1814278715478584
STAT,1826,28,35-39,1854,34.35383285598015
STAT,1897,25,50-100,1922,0.855308307757469
SIM,1862,35,na,1897,3738
STAT,1876,24,30-34,1900,17.893855767235195
STAT,1919,36,50-100,1955,0.44546903530359216
STAT,1939,25,30-34,1964,38.99131549795565
STAT,1860,28,35-39,1888,7.898738024649246
SIM,1864,3,na,1867,3374
SIM,1891,7,na,1898,2765
STAT,1860,31,40-44,1891,3.5523172899749533
STAT,1862,33,40-44,1895,3.6781716890139577
SIM,1928,10,na,1938,4638
STAT,1860,24,na,1884,1960.4651158758825
STAT,1883,44,40-44,1927,2.134691922658295
STAT,1951,16,40-44,1967,1.6505557114316498
SIM,1921,31,na,1952,4939
SIM,1933,4,na,1937,4652
STAT,1931,6,na,1937,5209.293232434339
STAT,1855,72,na,1927,835.82990839558
SIM,1865,15,30-34,1880,45
STAT,1843,33,30-34,1876,20.524758949306413
STAT,1859,86,na,1945,175.8574253423461
SIM,1833,38,na,1871,2195
SIM,1903,50,na,1953,2415
SIM,1884,24,30-34,1908,60
STAT,1830,37,15-19,1867,0.05122025456764012
STAT,1880,41,35-39,1921,1.8884105101258246
SIM,1907,64,na,1971,3919
SIM,1794,62,na,1856,745
STAT,1934,20,25-29,1954,123.69632802623943
SIM,1828,75,na,1903,713
SIM,1869,14,na,1883,3761
STAT,1852,29,15-19,1881,0.47712786617048186
STAT,1816,38,na,1854,2719.2996340563636
STAT,1893,19,35-39,1912,0.6824962263166233
SIM,1851,33,30-34,1884,22
STAT,1861,41,25-29,1902,0.5364618030932561
STAT,1917,27,45-49,1944,1.7875901068825277
STAT,1804,96,na,1900,5.440509606692399
STAT,1869,48,25-29,1917,0.05739279700093447
STAT,1939,0,na,1939,4450.291525808512
STAT,1848,26,20-24,1874,13.200428754771695
SIM,1867,27,35-39,1894,4
STAT,1880,27,25-29,1907,43.91540840911728
STAT,1959,7,na,1966,5095.586689496646
STAT,1857,40,20-24,1897,0.12309667609813754
STAT,1870,18,na,1888,2526.8741119942943
STAT,1849,107,na,1956,0.005053657094755044
STAT,1888,48,35-39,1936,0.09000096710056173
STAT,1921,36,25-29,1957,1.0873496075036828
STAT,1904,49,30-34,1953,0.07638263795010984
STAT,1938,28,50-100,1966,0.9750709884611625
STAT,1915,20,15-19,1935,5.236689314044181
STAT,1841,39,40-44,1880,5.625233970246858
SIM,1872,44,30-34,1916,1
STAT,1831,41,15-19,1872,0.01367908665194274
STAT,1849,30,20-24,1879,2.6927022348929435
STAT,1899,28,40-44,1927,4.077140524726392
STAT,1881,39,35-39,1920,6.612073425492176
STAT,1864,44,30-34,1908,1.031062623619236
SIM,1885,6,na,1891,1916
STAT,1932,16,30-34,1948,16.06687753294845
STAT,1940,30,na,1970,3874.7321373662535
STAT,1952,9,na,1961,4666.150438588685
STAT,1868,50,25-29,1918,0.0034702900600694308
SIM,1906,27,35-39,1933,1
STAT,1861,41,na,1902,1930.8234350980163
STAT,1836,46,20-24,1882,0.009747198207680044
STAT,1850,41,na,1891,1072.0709242294304
STAT,1865,55,na,1920,1887.8040173294123
SIM,1954,7,na,1961,5556
STAT,1857,20,na,1877,1921.6084163377425
STAT,1877,36,40-44,1913,4.4650799106962
STAT,1786,82,na,1868,313.12563443590483
STAT,1814,48,35-39,1862,0.4721903462303815
STAT,1876,15,40-44,1891,0.18575723462079202
STAT,1814,54,20-24,1868,0.0023383288835213765
STAT,1841,17,20-24,1858,25.461831005919027
STAT,1854,23,40-44,1877,1.351580350859939
SIM,1831,46,35-39,1877,1
STAT,1854,18,45-49,1872,0.04319203614646163
STAT,1850,16,35-39,1866,0.31145202873339733
STAT,1851,35,30-34,1886,4.343612784113109
STAT,1897,3,na,1900,3510.893338203614
STAT,1857,19,25-29,1876,5.050873433500293
STAT,1874,16,20-24,1890,18.341961367534203
SIM,1819,71,na,1890,1056
STAT,1948,5,na,1953,4478.3584561148045
SIM,1854,27,25-29,1881,8
STAT,1920,48,25-29,1968,0.057722018326444274
STAT,1872,46,30-34,1918,0.09720681557107264
STAT,1894,39,45-49,1933,2.509520394924991
STAT,1853,31,25-29,1884,8.263981644635063
STAT,1899,48,35-39,1947,0.10650948132605893
STAT,1887,41,45-49,1928,1.6547654126905966
SIM,1869,102,na,1971,70
STAT,1858,21,na,1879,1886.9697641975151
STAT,1895,27,20-24,1922,15.26112211998055
STAT,1931,25,50-100,1956,1.2771197587175338
STAT,1806,60,na,1866,874.7343866389198
STAT,1839,28,20-24,1867,13.632076348967388
STAT,1886,49,15-19,1935,4.0557110022090614E-4
STAT,1942,26,40-44,1968,4.838318479355471
STAT,1879,49,20-24,1928,0.012053053540172198
STAT,1884,53,na,1937,2028.1293159930674
STAT,1919,24,15-19,1943,5.715550638238395
SIM,1824,45,na,1869,2138
STAT,1859,27,35-39,1886,7.779675782236377
STAT,1800,82,na,1882,295.60172142096303
STAT,1888,67,na,1955,1829.6008817092159
STAT,1899,43,40-44,1942,0.21179959923264607
STAT,1812,45,20-24,1857,0.003230227400649542
SIM,1889,34,na,1923,3857
SIM,1885,20,na,1905,656
STAT,1827,48,45-49,1875,0.21329864941513324
STAT,1842,52,30-34,1894,0.0014698210035786407
STAT,1840,31,15-19,1871,0.06901022327097614
STAT,1846,27,25-29,1873,30.30851266299755
STAT,1873,90,na,1963,178.1397761623851
SIM,1960,3,na,1963,6451
SIM,1872,18,na,1890,2500
STAT,1855,49,35-39,1904,0.0907224965102618
STAT,1872,68,na,1940,1530.275273814826
SIM,1901,33,45-49,1934,169
STAT,1849,42,15-19,1891,0.011621724388046182
SIM,1805,63,na,1868,2098
SIM,1887,49,20-24,1936,2
STAT,1814,41,15-19,1855,0.05116834479507399
STAT,1834,38,35-39,1872,3.8372542050448435
STAT,1859,101,na,1960,1.0311402359471018
STAT,1844,45,40-44,1889,0.17228061355534682
STAT,1864,2,na,1866,3095.0457566055516
STAT,1902,16,45-49,1918,0.09221048228471479
STAT,1843,16,40-44,1859,0.23231144443075566
SIM,1855,22,na,1877,1810
STAT,1943,29,15-19,1972,0.742528670029953
SIM,1892,17,na,1909,3699
STAT,1833,54,30-34,1887,0.002527163591474246
SIM,1859,36,na,1895,1918
SIM,1882,16,20-24,1898,3
SIM,1891,75,na,1966,488
STAT,1827,40,35-39,1867,1.7655392719510874
STAT,1886,48,25-29,1934,0.05889821000837534
STAT,1836,46,45-49,1882,0.19169489080949892
STAT,1920,19,50-100,1939,0.41271117484831854
STAT,1910,30,40-44,1940,3.7610570693491665
STAT,1899,21,20-24,1920,94.40949406374577
STAT,1900,17,na,1917,3498.68535718531
SIM,1847,37,35-39,1884,3
STAT,1865,18,20-24,1883,16.58112709850696
STAT,1793,95,na,1888,2.3833632403955294
STAT,1894,31,35-39,1925,12.930798298693704
STAT,1847,20,45-49,1867,0.7841020892633019
SIM,1910,16,45-49,1926,9
STAT,1901,32,40-44,1933,6.063662873480692
SIM,1881,54,na,1935,2349
SIM,1852,45,40-44,1897,1
STAT,1939,16,40-44,1955,1.3850798325597695
STAT,1882,19,35-39,1901,0.5225224736882613
STAT,1843,31,40-44,1874,5.205004104866997
STAT,1816,81,na,1897,456.52770300703094
SIM,1913,17,na,1930,3570
STAT,1898,41,20-24,1939,0.014897045892705674
STAT,1850,29,40-44,1879,1.6045017650292082
STAT,1853,30,35-39,1883,8.256047497806678
SIM,1943,5,na,1948,4986
STAT,1921,5,na,1926,4528.813970837768
SIM,1887,54,na,1941,3112
SIM,1933,32,na,1965,4355
STAT,1917,39,15-19,1956,0.01956007807120607
STAT,1882,17,50-100,1899,0.04690532730449965
SIM,1927,24,15-19,1951,8
STAT,1843,36,35-39,1879,8.243449583762317
SIM,1828,37,25-29,1865,1
STAT,1888,47,20-24,1935,0.013785395703688303
STAT,1823,37,20-24,1860,1.4483510701113436
STAT,1818,88,na,1906,83.55851847094323
STAT,1876,40,30-34,1916,1.1739359579191946
STAT,1940,32,50-100,1972,0.8460971574800856
SIM,1925,20,25-29,1945,476
STAT,1904,7,na,1911,3722.2617836874647
SIM,1894,30,25-29,1924,27
STAT,1841,18,35-39,1859,0.7834179349384949
SIM,1883,40,na,1923,2173
STAT,1821,39,15-19,1860,0.06569812282531386
SIM,1847,28,20-24,1875,42
SIM,1921,47,na,1968,5131
STAT,1884,17,40-44,1901,0.17508804911003145
STAT,1916,16,na,1932,4051.7977655682716
STAT,1919,37,20-24,1956,0.27943705808471814
STAT,1837,29,25-29,1866,42.91143235821239
SIM,1903,18,na,1921,2994
STAT,1890,28,20-24,1918,14.152188521401763
SIM,1862,26,20-24,1888,28
STAT,1847,46,20-24,1893,0.010880207358216891
STAT,1874,15,30-34,1889,1.6587896460099212
SIM,1861,31,25-29,1892,1
SIM,1914,50,na,1964,4713
STAT,1939,17,30-34,1956,12.06660132219731
STAT,1854,26,20-24,1880,7.568761079100107
STAT,1827,100,na,1927,0.7486631163125
SIM,1851,31,40-44,1882,4
STAT,1853,38,45-49,1891,1.5380602549567872
STAT,1892,36,30-34,1928,6.63027639817634
STAT,1925,44,45-49,1969,0.19898728157265552
STAT,1823,46,35-39,1869,0.22158006523604998
STAT,1906,49,40-44,1955,0.1369219951331329
STAT,1840,36,na,1876,1007.8831593039333
STAT,1895,19,45-49,1914,0.08452053870052957
STAT,1862,43,45-49,1905,1.2655413301338294
SIM,1879,35,na,1914,1306
STAT,1896,43,15-19,1939,0.0012550267122392559
STAT,1884,22,15-19,1906,3.158064640692851
SIM,1833,81,na,1914,1615
STAT,1910,49,30-34,1959,0.08176045070906267
STAT,1814,108,na,1922,0.0012396822302295318
STAT,1920,21,na,1941,4019.674276922725
STAT,1887,28,25-29,1915,46.396148456331794
STAT,1825,45,30-34,1870,0.12627642543451364
SIM,1862,62,na,1924,2897
STAT,1920,16,15-19,1936,50.386084564146415
SIM,1861,30,35-39,1891,2
STAT,1808,48,35-39,1856,0.21716721263218486
STAT,1845,48,15-19,1893,1.9599264601066903E-4
STAT,1890,37,35-39,1927,8.562530134226849
STAT,1828,28,45-49,1856,2.071419499013466
STAT,1947,23,15-19,1970,5.950847722959467
STAT,1875,39,35-39,1914,7.189747836433503
SIM,1885,32,25-29,1917,33
STAT,1847,39,35-39,1886,6.498468086309015
STAT,1821,42,45-49,1863,1.6859837597905922
STAT,1882,17,30-34,1899,1.5259869585551722
STAT,1908,34,40-44,1942,3.6339165465639747
STAT,1887,17,45-49,1904,0.07189872981279215
STAT,1893,15,40-44,1908,0.2297880538994366
STAT,1817,41,40-44,1858,1.678859991976398
STAT,1832,35,20-24,1867,0.054817692770179394
STAT,1882,26,20-24,1908,11.27035644584508
SIM,1924,36,40-44,1960,3
STAT,1866,53,30-34,1919,0.005346356325014404
SIM,1876,41,35-39,1917,15
SIM,1881,30,15-19,1911,1
STAT,1838,19,15-19,1857,3.3069617999047654
STAT,1825,74,na,1899,683.4218421295672
SIM,1883,39,35-39,1922,62
STAT,1911,18,15-19,1929,8.955798734262421
STAT,1817,46,35-39,1863,0.09938754830561837
STAT,1824,89,na,1913,20.330348155664733
STAT,1941,17,35-39,1958,4.272968512531087
STAT,1806,52,20-24,1858,0.0019520495366865058
SIM,1875,69,na,1944,2443
STAT,1901,48,15-19,1949,3.115195945775809E-4
STAT,1868,36,na,1904,2286.5221302868754
STAT,1845,47,25-29,1892,0.0284488483910993
SIM,1852,37,50-100,1889,86
STAT,1868,41,35-39,1909,1.7569261254798274
STAT,1873,30,15-19,1903,0.14725309300775138
STAT,1894,32,25-29,1926,13.025095237616611
STAT,1837,43,na,1880,1963.938696062539
STAT,1865,27,35-39,1892,8.80938548565211
SIM,1852,73,na,1925,1138
STAT,1877,13,na,1890,2617.494146837349
SIM,1825,41,40-44,1866,6
STAT,1873,43,20-24,1916,0.16173036702944416
SIM,1859,31,50-100,1890,1
SIM,1831,74,na,1905,736
STAT,1921,28,25-29,1949,72.23205602887482
SIM,1881,38,25-29,1919,1
STAT,1867,37,35-39,1904,6.6890744664558754
STAT,1884,32,40-44,1916,4.151418999965432
SIM,1839,29,25-29,1868,24
SIM,1834,44,na,1878,746
STAT,1868,20,na,1888,2317.4912279158793
STAT,1880,16,20-24,1896,18.45015669397281
STAT,1842,46,45-49,1888,0.05935102260256613
STAT,1868,42,25-29,1910,0.6194771470247293
STAT,1916,36,40-44,1952,1.5193676994567706
STAT,1806,92,na,1898,12.541405239662492
STAT,1872,17,25-29,1889,5.693098227965434
SIM,1851,36,35-39,1887,3
STAT,1864,38,20-24,1902,0.6973075792377034
SIM,1830,30,na,1860,930
STAT,1909,37,15-19,1946,0.017991629865194307
SIM,1902,33,na,1935,3414
STAT,1868,49,45-49,1917,0.22318619385498178
STAT,1873,38,25-29,1911,2.938772825444447
SIM,1868,72,na,1940,328
SIM,1843,37,na,1880,155
STAT,1856,35,na,1891,1708.2599003483876
STAT,1852,21,na,1873,2575.219140531642
STAT,1893,20,15-19,1913,4.150136531325529
SIM,1847,73,na,1920,1382
SIM,1943,27,15-19,1970,1
STAT,1875,17,na,1892,2593.424272334183
SIM,1892,37,35-39,1929,9
SIM,1872,38,20-24,1910,5
STAT,1939,21,15-19,1960,5.288974580175172
STAT,1892,43,30-34,1935,1.4131148434597867
STAT,1871,24,na,1895,2344.469921670391
STAT,1887,2,na,1889,3084.3602039659854
STAT,1856,29,35-39,1885,7.078701955035728
STAT,1870,45,45-49,1915,0.23762182211946392
STAT,1827,41,25-29,1868,0.6177172734179889
STAT,1934,24,40-44,1958,4.484968750938742
STAT,1883,47,45-49,1930,0.22598371179372712
SIM,1875,32,40-44,1907,5
SIM,1857,49,35-39,1906,1
STAT,1846,16,45-49,1862,0.048887844657803894
STAT,1893,27,35-39,1920,12.066253436407486
STAT,1873,15,50-100,1888,0.05085214500902601
STAT,1915,24,30-34,1939,29.106465844864125
SIM,1822,38,na,1860,1411
SIM,1929,0,na,1929,6342
SIM,1890,26,20-24,1916,2
STAT,1862,36,45-49,1898,1.7061066597575907
STAT,1910,15,40-44,1925,0.2753231957693132
SIM,1899,27,30-34,1926,11
STAT,1826,36,35-39,1862,11.85963746203564
SIM,1868,51,na,1919,1047
STAT,1864,47,35-39,1911,0.1266814994239335
STAT,1877,32,25-29,1909,10.397476069125489
SIM,1918,30,35-39,1948,30
STAT,1884,37,35-39,1921,6.770712491013795
STAT,1883,30,20-24,1913,2.6213621330622168
SIM,1876,49,45-49,1925,3
STAT,1803,54,45-49,1857,0.03034739653395797
STAT,1935,27,15-19,1962,0.9553825521377273
SIM,1822,59,na,1881,1154
STAT,1900,39,20-24,1939,0.2281653886081115
STAT,1888,21,45-49,1909,0.8072530797290349
STAT,1904,47,na,1951,3199.947801974668
STAT,1858,42,40-44,1900,1.7155768980335124
STAT,1867,28,45-49,1895,1.0463508760674953
STAT,1945,27,20-24,1972,19.805200547192605
SIM,1871,55,na,1926,1742
STAT,1821,60,na,1881,1036.6622223695829
STAT,1836,74,na,1910,849.362236940502
SIM,1907,36,40-44,1943,5
STAT,1831,45,30-34,1876,0.09366311856140325
STAT,1847,53,20-24,1900,6.564533725688439E-4
STAT,1846,8,na,1854,1827.0
SIM,1889,50,na,1939,3795
STAT,1900,33,na,1933,3291.771768455587
SIM,1902,65,na,1967,2613
STAT,1876,19,35-39,1895,0.5517197673608611
STAT,1877,54,45-49,1931,0.014326730719708707
STAT,1933,19,50-100,1952,0.4954553823267399
STAT,1846,40,45-49,1886,0.9204169121440101
STAT,1869,54,50-100,1923,0.014820823410505685
STAT,1912,28,50-100,1940,0.9660698376435297
STAT,1912,49,40-44,1961,0.14888311986574326
STAT,1834,35,30-34,1869,2.982931790255667
STAT,1906,22,15-19,1928,4.777222300977205
STAT,1830,26,50-100,1856,0.6195524053768292
STAT,1860,16,40-44,1876,0.1731075766284271
SIM,1823,60,na,1883,919
SIM,1875,21,na,1896,3062
STAT,1857,16,20-24,1873,16.084350114331365
STAT,1828,39,25-29,1867,3.706982337505569
STAT,1860,40,na,1900,1904.5165852197044
STAT,1852,51,25-29,1903,0.0035824062460898054
SIM,1864,27,30-34,1891,206
STAT,1819,46,45-49,1865,0.04489640441967302
STAT,1930,18,25-29,1948,55.486475099353356
STAT,1894,36,40-44,1930,5.593481600124352
SIM,1886,27,20-24,1913,34
SIM,1860,55,na,1915,1914
STAT,1841,32,50-100,1873,1.2379272401426957
STAT,1838,22,na,1860,1182.9518492872414
STAT,1814,74,na,1888,775.020580184545
STAT,1878,27,20-24,1905,12.070129281910226
STAT,1864,53,20-24,1917,6.600758840106148E-4
STAT,1922,41,15-19,1963,0.0017455067400550933
SIM,1833,59,na,1892,1984
STAT,1862,10,na,1872,2357.9266351035344
STAT,1893,17,45-49,1910,0.08168760960271088
STAT,1844,40,35-39,1884,1.884993762992177
STAT,1935,31,45-49,1966,2.162619185302468
STAT,1874,19,25-29,1893,5.817076672074795
SIM,1836,39,25-29,1875,13
SIM,1905,36,30-34,1941,2
STAT,1910,33,45-49,1943,1.493955032050746
STAT,1942,29,45-49,1971,1.7907373433812936
STAT,1930,28,50-100,1958,1.2561412546587083
SIM,1842,35,30-34,1877,171
STAT,1848,108,na,1956,0.0020683174261566756
STAT,1875,32,15-19,1907,0.14623163665564662
STAT,1851,33,40-44,1884,3.5280963245309267
STAT,1829,27,25-29,1856,31.552539814006987
SIM,1872,40,na,1912,2362
STAT,1872,49,35-39,1921,0.13726327585306486
SIM,1912,54,na,1966,4423
STAT,1856,27,30-34,1883,18.742261682541354
STAT,1862,40,40-44,1902,1.9351316268096261
STAT,1868,46,40-44,1914,0.16582657021386726
SIM,1870,40,40-44,1910,1
STAT,1866,47,45-49,1913,0.2144208932656575
STAT,1810,60,na,1870,72.14770818597131
STAT,1920,45,20-24,1965,0.012115701147130262
STAT,1880,17,na,1897,2621.9692487254692
STAT,1847,49,25-29,1896,0.050989805346659804
SIM,1838,37,30-34,1875,3
STAT,1896,18,25-29,1914,7.450472160777098
STAT,1900,21,50-100,1921,0.5666116102045639
STAT,1905,32,na,1937,3461.47606007531
STAT,1921,33,20-24,1954,2.6709112598444773
STAT,1850,25,na,1875,1192.587799550015
STAT,1912,46,25-29,1958,0.050512124646551776
SIM,1898,38,40-44,1936,3
STAT,1835,29,15-19,1864,0.4409968707069578
STAT,1888,41,15-19,1929,0.016010923373650735
STAT,1855,42,15-19,1897,0.009128596251357935
STAT,1841,15,30-34,1856,2.3163315912626827
STAT,1886,19,50-100,1905,0.05046147129096716
STAT,1834,26,40-44,1860,1.743653119563248
STAT,1908,13,na,1921,3795.361553347858
SIM,1900,69,na,1969,3491
SIM,1852,40,35-39,1892,8
STAT,1868,17,35-39,1885,0.5395779424411922
SIM,1858,73,na,1931,917
STAT,1828,48,15-19,1876,4.7130863650664566E-4
STAT,1925,41,40-44,1966,0.30048575012268747
STAT,1942,21,35-39,1963,9.76295976809608
SIM,1839,26,20-24,1865,8
STAT,1812,48,25-29,1860,0.014625531062585026
SIM,1861,77,na,1938,1395
STAT,1858,48,50-100,1906,0.18519930450685723
STAT,1895,39,15-19,1934,0.07231470895978669
SIM,1832,37,na,1869,2223
STAT,1897,28,30-34,1925,33.3251518895572
STAT,1903,16,15-19,1919,8.444851263167289
STAT,1825,48,35-39,1873,0.17551496996230956
STAT,1852,17,45-49,1869,0.0795255739142745
STAT,1930,16,20-24,1946,174.4745823813566
STAT,1805,97,na,1902,0.7207558128353863
SIM,1858,26,30-34,1884,18
STAT,1860,106,na,1966,0.07280031805623491
STAT,1904,28,25-29,1932,60.22313374864948
STAT,1886,37,45-49,1923,2.064355357566215
STAT,1954,6,na,1960,4816.889518616465
STAT,1832,37,25-29,1869,0.21960291357884795
STAT,1844,48,45-49,1892,0.23086484158537382
STAT,1869,29,45-49,1898,1.1123791515081136
SIM,1896,20,na,1916,3938
SIM,1861,35,40-44,1896,5
STAT,1864,54,na,1918,1903.6291897376618
STAT,1911,17,na,1928,3821.3907045203564
SIM,1863,36,na,1899,896
STAT,1826,37,na,1863,2261.0115852065596
SIM,1862,29,25-29,1891,34
STAT,1854,29,25-29,1883,24.304178714287637
STAT,1823,52,20-24,1875,0.0011079547203998812
STAT,1879,20,na,1899,2440.6369508143325
STAT,1785,81,na,1866,89.74988673263215
STAT,1836,58,na,1894,1513.5284865688132
STAT,1832,44,na,1876,2123.331521633353
STAT,1855,46,30-34,1901,0.06424766516471993
STAT,1890,43,20-24,1933,0.1908713657219845
STAT,1936,20,35-39,1956,8.918880704333107
SIM,1882,39,na,1921,1827
STAT,1853,35,40-44,1888,3.4654935025578033
STAT,1861,25,na,1886,2028.174803632868
SIM,1797,81,na,1878,564
STAT,1834,31,15-19,1865,0.08123145080728746
STAT,1876,16,30-34,1892,1.6152126948682914
STAT,1897,27,30-34,1924,33.44287079475475
SIM,1812,60,na,1872,655
SIM,1912,28,25-29,1940,53
STAT,1871,51,35-39,1922,0.008629002039684544
STAT,1852,16,45-49,1868,0.07999675480004674
SIM,1944,6,na,1950,2571
SIM,1889,13,na,1902,3885
STAT,1880,39,na,1919,2421.251611927162
STAT,1931,20,20-24,1951,144.05792441463277
STAT,1867,25,40-44,1892,2.852214803520262
STAT,1940,30,15-19,1970,0.1316535700427635
SIM,1883,36,30-34,1919,46
STAT,1855,19,15-19,1874,4.616740426650665
STAT,1914,32,50-100,1946,0.8206777321595503
SIM,1924,39,45-49,1963,10
STAT,1923,26,30-34,1949,44.66539091368403
SIM,1826,41,na,1867,1907
SIM,1899,22,25-29,1921,55
STAT,1908,37,45-49,1945,0.6333338318300373
STAT,1825,40,25-29,1865,0.8819285264832403
STAT,1869,21,35-39,1890,5.906255045093145
STAT,1916,31,35-39,1947,9.344043475327092
STAT,1832,38,25-29,1870,0.22686181496172309
STAT,1816,52,50-100,1868,0.044195433084077786
STAT,1855,43,50-100,1898,0.6941475368256984
STAT,1831,54,20-24,1885,5.883416234018788E-4
SIM,1864,23,15-19,1887,4
STAT,1892,39,35-39,1931,8.66880572640657
STAT,1867,34,30-34,1901,16.37080894454947
STAT,1871,23,40-44,1894,2.0722670772872975
STAT,1824,39,40-44,1863,0.7085920676239252
STAT,1811,82,na,1893,282.6700372205313
STAT,1899,67,na,1966,2431.409818204811
STAT,1925,22,25-29,1947,109.55387510997264
STAT,1916,39,45-49,1955,0.6816656425744327
STAT,1841,16,30-34,1857,2.302688398190145
SIM,1909,50,na,1959,3812
STAT,1849,37,40-44,1886,3.774258069274613
SIM,1898,27,na,1925,4261
SIM,1869,39,50-100,1908,3
SIM,1875,34,30-34,1909,34
SIM,1933,22,25-29,1955,1
STAT,1880,28,15-19,1908,0.46935534486243247
STAT,1914,46,na,1960,3601.778875477948
STAT,1830,25,45-49,1855,1.0831233236918256
STAT,1910,32,na,1942,3605.9056819812904
SIM,1840,38,25-29,1878,1
STAT,1914,43,30-34,1957,0.12472132463598858
STAT,1895,53,na,1948,2756.099118004446
STAT,1875,36,30-34,1911,5.499029150409263
SIM,1814,56,na,1870,2442
STAT,1834,106,na,1940,0.005350906665573914
SIM,1832,39,40-44,1871,18
STAT,1889,26,30-34,1915,30.428739892009887
STAT,1888,49,25-29,1937,0.03671718502917372
STAT,1900,16,35-39,1916,0.7619856424633029
STAT,1894,47,20-24,1941,0.008567725872285615
STAT,1813,109,na,1922,5.211628072673899E-4
SIM,1878,50,na,1928,3816
STAT,1831,59,na,1890,1521.0522984481313
SIM,1809,56,na,1865,612
STAT,1944,20,30-34,1964,30.70417509682162
SIM,1839,37,50-100,1876,2
SIM,1901,49,30-34,1950,3
STAT,1917,20,25-29,1937,97.4389209054525
SIM,1924,31,35-39,1955,5
STAT,1848,50,20-24,1898,7.004493356814311E-4
SIM,1880,91,na,1971,1627
STAT,1871,37,25-29,1908,2.872124800435887
STAT,1909,41,45-49,1950,0.15497144379339053
SIM,1825,30,na,1855,613
SIM,1904,26,25-29,1930,3
STAT,1837,26,20-24,1863,12.160690797195935
SIM,1931,26,30-34,1957,3
STAT,1811,50,25-29,1861,0.016585295034477338
STAT,1840,37,20-24,1877,0.3589961585441655
STAT,1898,17,20-24,1915,23.839853918978097
SIM,1857,37,40-44,1894,40
SIM,1909,28,na,1937,3536
STAT,1915,27,35-39,1942,15.097183728930728
STAT,1867,30,15-19,1897,0.13576178907190803
SIM,1905,14,na,1919,3866
STAT,1881,32,15-19,1913,0.13448236860232626
STAT,1893,24,30-34,1917,22.135311725026874
STAT,1858,20,20-24,1878,61.25742475106201
STAT,1860,21,15-19,1881,2.7944283273537955
SIM,1834,33,30-34,1867,5
SIM,1900,45,45-49,1945,1
SIM,1929,27,na,1956,6253
STAT,1851,30,25-29,1881,8.596438901363594
STAT,1840,63,na,1903,702.5779947535797
STAT,1810,97,na,1907,0.16726247418829454
STAT,1831,48,35-39,1879,0.13033184298776848
STAT,1889,28,35-39,1917,11.578580428302692
STAT,1824,102,na,1926,0.05673631398835584
STAT,1922,16,25-29,1938,49.71473313377975
STAT,1914,40,15-19,1954,0.001511014547457249
STAT,1829,88,na,1917,50.13177640552678
STAT,1845,33,40-44,1878,2.5322497391483267
STAT,1853,46,20-24,1899,0.009331082399878994
STAT,1905,30,20-24,1935,3.919116114428985
STAT,1846,36,na,1882,1472.3499454627836
STAT,1885,50,25-29,1935,0.003531651631477906
SIM,1902,0,na,1902,3827
STAT,1806,48,25-29,1854,0.18437221735103612
STAT,1877,51,40-44,1928,0.010737963647339154
STAT,1913,39,30-34,1952,1.7581816760144948
STAT,1926,31,na,1957,4536.585273986219
SIM,1930,16,25-29,1946,36
STAT,1827,45,40-44,1872,0.16082886671702204
SIM,1897,28,35-39,1925,12
SIM,1910,47,na,1957,3876
STAT,1847,48,25-29,1895,0.0514227851980272
STAT,1830,50,35-39,1880,0.007400688355192382
STAT,1880,19,25-29,1899,5.851390369331164
STAT,1856,26,30-34,1882,18.87780431754131
STAT,1861,19,15-19,1880,5.606075334693023
STAT,1825,43,40-44,1868,2.942861877732352
STAT,1872,30,45-49,1902,1.7602292295141013
STAT,1852,42,35-39,1894,1.8204991955869534
STAT,1879,9,na,1888,2695.4535054084517
STAT,1932,39,40-44,1971,1.9931106853292901
STAT,1888,30,35-39,1918,11.782244150429534
STAT,1847,40,15-19,1887,0.012881204656663698
SIM,1856,25,30-34,1881,2
STAT,1883,68,na,1951,1470.1920512251763
SIM,1879,38,30-34,1917,3
STAT,1864,17,na,1881,2375.206669690908
STAT,1892,34,40-44,1926,5.323292466527371
STAT,1851,38,35-39,1889,5.587639139242935
STAT,1869,49,15-19,1918,3.9520487670362383E-4
SIM,1928,42,na,1970,4588
SIM,1899,71,na,1970,1469
SIM,1842,74,na,1916,1595
STAT,1803,51,40-44,1854,0.023505949112892895
STAT,1863,91,na,1954,49.47076368268015
STAT,1830,36,25-29,1866,2.6536136498916325
STAT,1853,49,25-29,1902,0.04372987201242534
STAT,1934,27,45-49,1961,2.308326811227014
SIM,1844,22,na,1866,2978
SIM,1848,36,na,1884,2396
STAT,1870,42,40-44,1912,2.239616874006968
STAT,1826,33,30-34,1859,32.46975513836092
STAT,1893,18,45-49,1911,0.08147358806555173
STAT,1848,25,30-34,1873,28.54001972124618
STAT,1856,17,50-100,1873,0.04160821121048576
STAT,1904,26,20-24,1930,16.818194991635433
SIM,1868,8,na,1876,1405
STAT,1896,49,20-24,1945,0.008736781783778869
SIM,1896,30,35-39,1926,101
SIM,1827,53,45-49,1880,4
SIM,1919,37,25-29,1956,10
STAT,1841,32,20-24,1873,3.6520668938337417
STAT,1866,45,30-34,1911,0.08924177145200636
STAT,1868,53,40-44,1921,0.010005086088382928
SIM,1941,29,na,1970,3531
STAT,1923,34,30-34,1957,17.848665293124036
STAT,1880,46,50-100,1926,0.2556946423263007
STAT,1883,89,na,1972,316.8452067822116
STAT,1921,26,20-24,1947,20.17186299222755
SIM,1893,18,na,1911,3489
STAT,1906,37,35-39,1943,2.2106662690085543
STAT,1884,36,35-39,1920,6.8033002994481535
STAT,1886,44,45-49,1930,1.528925876489979
STAT,1860,19,45-49,1879,0.06073810907761066
STAT,1864,32,15-19,1896,0.12946369230866606
STAT,1869,17,50-100,1886,0.050121394524338184
SIM,1874,41,25-29,1915,3
STAT,1901,28,45-49,1929,1.546978089928992
SIM,1793,83,na,1876,591
SIM,1802,61,na,1863,935
STAT,1913,18,25-29,1931,8.726151533840843
STAT,1835,21,40-44,1856,2.1109625365528517
SIM,1876,48,na,1924,3639
STAT,1886,22,25-29,1908,59.2806988446559
STAT,1885,15,45-49,1900,0.06450703742725523
SIM,1840,34,20-24,1874,3
STAT,1908,50,na,1958,3267.0513957969542
STAT,1936,21,35-39,1957,8.915669907279549
STAT,1856,51,na,1907,1553.919860926626
STAT,1891,26,25-29,1917,52.19778979747111
STAT,1941,29,40-44,1970,4.762174285188871
STAT,1824,35,25-29,1859,0.44592492440121245
STAT,1812,45,na,1857,248.97586029597747
STAT,1863,40,45-49,1903,1.2905925776002256
STAT,1855,104,na,1959,0.09440582356139376
SIM,1861,72,na,1933,1395
STAT,1819,53,45-49,1872,0.0025071299351700407
STAT,1796,81,na,1877,374.187925954451
STAT,1817,45,35-39,1862,0.10071373144571495
STAT,1882,20,15-19,1902,3.1773649770866395
STAT,1869,40,50-100,1909,1.07680325373819
STAT,1814,53,50-100,1867,0.048818023502502354
STAT,1854,1,na,1855,2111.4617375766657
STAT,1935,37,50-100,1972,0.5828662979312242
STAT,1801,83,na,1884,124.04003179529725
STAT,1826,53,na,1879,1847.9440287319985
STAT,1889,68,na,1957,1895.3431076548168
SIM,1885,46,45-49,1931,1
STAT,1826,52,35-39,1878,0.01189392714687539
STAT,1836,50,40-44,1886,0.008492214122562082
STAT,1864,70,na,1934,1275.5433905485015
STAT,1851,20,na,1871,2045.8836511489249
STAT,1910,26,45-49,1936,1.6552636548096542
SIM,1888,33,na,1921,327
STAT,1944,17,15-19,1961,48.28981460510745
STAT,1818,105,na,1923,0.017846210358973706
STAT,1850,62,na,1912,843.9761638476692
STAT,1875,30,25-29,1905,10.602183329099887
SIM,1892,36,35-39,1928,3
STAT,1912,24,50-100,1936,0.6454443324224417
SIM,1842,42,30-34,1884,1
STAT,1877,46,45-49,1923,0.24024858131087581
STAT,1866,41,25-29,1907,0.5888252519312247
STAT,1938,28,40-44,1966,4.566081300187041
SIM,1886,28,20-24,1914,31
STAT,1927,23,35-39,1950,11.470867804094457
STAT,1859,51,35-39,1910,0.006856124502770221
STAT,1839,37,50-100,1876,1.36309599726773
SIM,1918,27,na,1945,4121
STAT,1815,42,20-24,1857,0.016872689499424744
SIM,1922,32,na,1954,3322
SIM,1851,78,na,1929,592
STAT,1924,41,50-100,1965,0.1385955302140738
STAT,1845,21,25-29,1866,35.51955218155935
STAT,1827,30,50-100,1857,0.9746808980409947
STAT,1932,27,35-39,1959,19.52783714063721
STAT,1869,26,40-44,1895,3.033142609789039
SIM,1793,61,na,1854,1150
SIM,1953,14,na,1967,4654
STAT,1838,42,15-19,1880,0.006894232098108133
STAT,1929,12,na,1941,5021.240050677987
STAT,1834,42,30-34,1876,0.6108189774907689
STAT,1867,32,40-44,1899,4.1013631680689775
STAT,1901,18,50-100,1919,0.06832171575670681
STAT,1832,34,20-24,1866,0.18382544163352615
SIM,1851,35,35-39,1886,20
STAT,1914,36,30-34,1950,1.8030592830423382
STAT,1895,20,25-29,1915,74.91356658100042
SIM,1935,23,35-39,1958,6
STAT,1934,29,na,1963,5000.418167581004
STAT,1851,41,50-100,1892,0.8381532171953845
STAT,1922,42,15-19,1964,0.0017429932103494139
STAT,1878,28,20-24,1906,12.0276424268379
STAT,1909,29,15-19,1938,0.6630346781201922
SIM,1900,35,40-44,1935,2
SIM,1837,24,20-24,1861,19
STAT,1845,29,20-24,1874,6.9842322178268095
STAT,1860,112,na,1972,4.5695198729306716E-4
SIM,1901,64,na,1965,2787
SIM,1905,31,25-29,1936,3
STAT,1892,31,25-29,1923,12.733129065108866
SIM,1866,104,na,1970,1
STAT,1826,43,na,1869,2132.494654542025
SIM,1901,54,na,1955,2931
STAT,1882,33,20-24,1915,2.577015082804106
STAT,1896,15,20-24,1911,23.478839284186797
STAT,1891,6,na,1897,3212.4908728693154
STAT,1870,30,35-39,1900,10.177160780176896
STAT,1851,42,na,1893,1823.1526327054803
STAT,1845,43,45-49,1888,0.7466355011893425
STAT,1855,20,40-44,1875,1.6345666543341164
STAT,1880,29,15-19,1909,0.46764689140713317
SIM,1853,43,45-49,1896,18
STAT,1801,53,50-100,1854,0.03830114102019349
STAT,1865,24,30-34,1889,16.22462026729701
STAT,1933,39,45-49,1972,0.9202829576769523
STAT,1864,92,na,1956,43.04172595550227
SIM,1890,33,20-24,1923,5
STAT,1902,39,30-34,1941,1.603563608913541
STAT,1871,30,40-44,1901,4.360837430462836
STAT,1821,34,45-49,1855,2.3227485117920343
STAT,1916,44,40-44,1960,0.25198410346353645
SIM,1910,39,30-34,1949,4
STAT,1831,33,50-100,1864,0.9602623015026018
STAT,1865,36,25-29,1901,2.641333292978958
STAT,1841,19,35-39,1860,0.7788036033017071
STAT,1937,16,30-34,1953,11.763938640310712
STAT,1899,35,40-44,1934,6.035872037810441
STAT,1901,12,na,1913,3610.9034798757602
STAT,1855,40,na,1895,1545.0976187611525
STAT,1946,24,na,1970,4017.1038294882587
SIM,1884,35,na,1919,3672
STAT,1918,49,20-24,1967,0.011533503429978423
STAT,1894,30,35-39,1924,12.981686509812167
STAT,1867,35,na,1902,2249.2791471345004
SIM,1905,20,na,1925,3709
STAT,1826,59,na,1885,1640.9707219589723
STAT,1909,15,40-44,1924,0.2727628245593542
SIM,1851,56,na,1907,1078
SIM,1873,33,20-24,1906,1
STAT,1912,0,na,1912,4487.9240983202835
STAT,1871,33,45-49,1904,1.7321978643420513
STAT,1801,61,na,1862,844.5243819380797
STAT,1889,46,na,1935,2717.0067882643543
STAT,1871,40,na,1911,2328.8264562514805
STAT,1888,46,20-24,1934,0.013889287574747411
STAT,1867,53,35-39,1920,0.00801112001676733
STAT,1914,23,25-29,1937,92.76947903261694
STAT,1843,35,35-39,1878,8.329493249024742
SIM,1813,45,na,1858,259
STAT,1849,53,30-34,1902,0.004935039507683941
STAT,1839,34,30-34,1873,19.55181029239587
STAT,1940,29,35-39,1969,15.122987447167157
SIM,1898,33,na,1931,4201
STAT,1819,39,20-24,1858,0.1756844307677454
STAT,1874,70,na,1944,1448.0659002067453
STAT,1937,27,25-29,1964,63.49778050190017
SIM,1783,83,na,1866,511
STAT,1851,37,35-39,1888,5.645961925937868
STAT,1843,55,na,1898,2042.9935050663887
STAT,1835,50,35-39,1885,0.006906530341659836
SIM,1821,74,na,1895,965
STAT,1835,95,na,1930,10.060137133097921
STAT,1889,29,35-39,1918,11.536434395543674
STAT,1834,29,45-49,1863,0.632462260218363
STAT,1924,46,40-44,1970,0.1863589543097698
STAT,1860,35,35-39,1895,5.824832656802694
STAT,1894,43,40-44,1937,0.19719102286289406
STAT,1928,29,25-29,1957,80.39366656261562
STAT,1938,26,15-19,1964,0.6922137950080649
STAT,1874,40,20-24,1914,0.16555947857139436
STAT,1782,79,na,1861,835.9328920324299
SIM,1813,55,na,1868,35
STAT,1866,18,na,1884,2352.3892705094495
STAT,1819,105,na,1924,0.00681976418951347
STAT,1954,16,30-34,1970,14.939193233528655
STAT,1827,52,40-44,1879,0.009316643809185439
STAT,1923,21,25-29,1944,106.66613272014882
SIM,1878,25,20-24,1903,15
STAT,1850,25,25-29,1875,23.320319541231616
STAT,1794,96,na,1890,0.020322595330323476
STAT,1880,23,45-49,1903,0.7216905593985988
STAT,1946,14,na,1960,4308.202059940092
STAT,1876,51,35-39,1927,0.008744607473335678
STAT,1944,23,35-39,1967,10.048734656848655
STAT,1919,39,25-29,1958,1.0415032198235454
STAT,1928,26,30-34,1954,48.06990484449023
SIM,1838,74,na,1912,191
STAT,1830,32,45-49,1862,1.6379807161439843
STAT,1887,31,50-100,1918,1.0126082300582113
STAT,1904,21,15-19,1925,4.727532088012024
SIM,1933,16,na,1949,2149
STAT,1901,18,na,1919,3522.0887360391175
STAT,1843,50,50-100,1893,0.015136630324334738
STAT,1900,54,na,1954,2900.8076060554886
STAT,1891,40,20-24,1931,0.19726756770386228
STAT,1899,47,35-39,1946,0.10736193509067894
STAT,1829,30,40-44,1859,2.519774306274256
SIM,1916,23,25-29,1939,14
STAT,1931,39,50-100,1970,0.5509596957826718
STAT,1947,16,15-19,1963,50.59827690908628
STAT,1841,26,na,1867,3013.660598033314
STAT,1794,64,na,1858,10.337316514043925
STAT,1853,42,40-44,1895,1.7419158376507466
STAT,1837,27,20-24,1864,12.073377037272069
STAT,1908,23,25-29,1931,84.00074159741997
STAT,1838,26,50-100,1864,0.34987287678588663
STAT,1923,30,50-100,1953,0.9454047968132469
STAT,1896,21,40-44,1917,2.7552297103450454
STAT,1844,72,na,1916,1251.1359573837149
STAT,1819,89,na,1908,24.434646990392995
STAT,1828,49,15-19,1877,4.6511776335166066E-4
STAT,1808,52,30-34,1860,0.007655568805822462
STAT,1917,27,na,1944,3876.2076024761136
SIM,1900,29,20-24,1929,1
STAT,1840,35,50-100,1875,0.5837771921045318
STAT,1907,46,40-44,1953,0.14130658661074547
STAT,1828,60,na,1888,1333.0392175831594
STAT,1844,52,40-44,1896,0.010374103192561185
SIM,1861,40,na,1901,2181
STAT,1858,34,40-44,1892,3.2834412941076954
SIM,1827,31,25-29,1858,62
STAT,1814,58,na,1872,1710.4270600152922
STAT,1918,27,15-19,1945,0.7411571098293038
STAT,1921,32,na,1953,4158.943425606696
STAT,1850,94,na,1944,9.22880441591107
SIM,1893,41,35-39,1934,3
STAT,1885,41,35-39,1926,1.7879920439021886
STAT,1859,24,30-34,1883,14.438196344478243
SIM,1912,21,15-19,1933,13
STAT,1825,47,35-39,1872,0.17785595944048413
STAT,1894,15,na,1909,3226.630663914505
STAT,1847,45,20-24,1892,0.010957567786791638
STAT,1875,43,30-34,1918,1.1720114291462627
STAT,1892,38,35-39,1930,8.713506012249411
SIM,1896,68,na,1964,1991
STAT,1889,25,30-34,1914,30.530406144470973
STAT,1818,50,35-39,1868,0.015331829037038799
STAT,1777,84,na,1861,267.9320316256827
STAT,1863,17,20-24,1880,17.270533051557745
STAT,1875,86,na,1961,365.92874410798646
STAT,1899,46,na,1945,3082.2816722035873
STAT,1897,33,na,1930,3155.771228332679
STAT,1836,31,25-29,1867,10.024385145701382
SIM,1864,39,25-29,1903,2
SIM,1913,33,25-29,1946,127
STAT,1824,32,20-24,1856,1.2063982461762097
STAT,1817,76,na,1893,300.1274616502284
STAT,1899,33,15-19,1932,0.19368915184480945
STAT,1852,21,40-44,1873,2.509795934124007
STAT,1929,30,45-49,1959,1.9870254657678572
STAT,1913,15,20-24,1928,27.498916177567445
STAT,1918,39,50-100,1957,0.4356384590810172
STAT,1818,40,na,1858,1851.4754630090117
STAT,1836,21,na,1857,2175.0012581978067
STAT,1866,48,35-39,1914,0.12618887641421525
STAT,1896,32,na,1928,3145.7035470472633
SIM,1891,41,25-29,1932,21
STAT,1883,41,25-29,1924,0.6205781255860796
STAT,1807,50,50-100,1857,0.050231778259482926
STAT,1835,89,na,1924,79.48928491393015
STAT,1901,25,40-44,1926,4.216858713206977
SIM,1831,58,na,1889,2133
STAT,1926,29,15-19,1955,0.8330211691033382
STAT,1956,16,40-44,1972,1.8351741448574665
STAT,1848,28,35-39,1876,10.701789784409423
STAT,1825,52,30-34,1877,0.007301274909256814
STAT,1862,110,na,1972,0.004324524956736625
SIM,1892,33,30-34,1925,1
STAT,1885,38,na,1923,2304.3198496453715
STAT,1816,75,na,1891,869.099123054801
STAT,1904,37,15-19,1941,0.017316464524940647
STAT,1843,19,45-49,1862,0.08151092012627366
SIM,1861,56,na,1917,1737
STAT,1914,39,35-39,1953,2.3574236878250048
STAT,1906,33,na,1939,3470.2360924658415
STAT,1854,39,15-19,1893,0.030908684205555023
STAT,1873,26,30-34,1899,25.91972510407027
STAT,1905,33,25-29,1938,8.423502145347769
SIM,1901,48,na,1949,3325
SIM,1949,2,na,1951,4543
SIM,1868,35,na,1903,1176
STAT,1837,50,45-49,1887,0.01215059791634913
SIM,1891,69,na,1960,675
STAT,1874,54,50-100,1928,0.015158408618651944
SIM,1945,11,na,1956,6354
STAT,1851,26,na,1877,2014.9241807954988
STAT,1884,33,30-34,1917,16.643173693771224
STAT,1816,107,na,1923,0.003981332942630314
STAT,1849,40,25-29,1889,0.5505328264671073
SIM,1940,24,30-34,1964,602
SIM,1834,23,na,1857,904
STAT,1870,39,na,1909,2325.1125569528563
STAT,1854,15,40-44,1869,0.12310012314356898
STAT,1924,16,35-39,1940,4.961062776218034
STAT,1900,28,40-44,1928,4.135104023208343
SIM,1927,3,na,1930,2101
STAT,1912,23,15-19,1935,5.026678520311083
SIM,1868,29,na,1897,1198
SIM,1909,27,15-19,1936,3
SIM,1848,74,na,1922,1297
STAT,1897,47,25-29,1944,0.04294882916388817
STAT,1891,23,20-24,1914,84.48181695062392
STAT,1864,103,na,1967,0.8653646558250703
STAT,1897,20,35-39,1917,7.796060467410816
STAT,1856,30,15-19,1886,0.10570980935575203
STAT,1906,32,50-100,1938,0.7618422707649631
STAT,1908,20,20-24,1928,102.03906804641325
STAT,1852,91,na,1943,58.32957282492566
STAT,1863,109,na,1972,0.011823248378429893
STAT,1862,21,25-29,1883,50.274437963415025
STAT,1878,51,45-49,1929,0.015002817249355187
SIM,1837,43,50-100,1880,2
SIM,1873,41,na,1914,2168
STAT,1790,66,na,1856,1037.66002808
STAT,1904,33,50-100,1937,0.7484767281500692
STAT,1868,31,30-34,1899,16.93274850832738
STAT,1869,30,25-29,1899,10.41870569848521
SIM,1849,34,40-44,1883,2
STAT,1906,21,25-29,1927,83.14600169787171
STAT,1854,92,na,1946,23.157810407533624
STAT,1832,42,20-24,1874,0.013975254391935223
STAT,1893,40,30-34,1933,1.4521989397802355
STAT,1834,78,na,1912,344.3374377171476
STAT,1846,24,20-24,1870,49.63849161018046
STAT,1825,101,na,1926,0.3513972261100553
STAT,1817,92,na,1909,13.194093975273747
SIM,1895,25,20-24,1920,85
SIM,1829,60,na,1889,1785
STAT,1821,38,na,1859,1438.1063507401614
SIM,1908,27,na,1935,1983
SIM,1883,24,na,1907,2228
STAT,1933,36,40-44,1969,2.0270077024387905
SIM,1833,75,na,1908,1615
STAT,1887,25,20-24,1912,13.000096502448834
SIM,1864,8,na,1872,2555
STAT,1816,50,25-29,1866,0.010786019531092083
STAT,1903,20,45-49,1923,0.9957618359527995
STAT,1923,17,40-44,1940,1.6251467502242594
STAT,1876,25,50-100,1901,0.6510573965619094
STAT,1913,37,40-44,1950,1.458782362347342
SIM,1947,24,na,1971,4355
SIM,1906,26,35-39,1932,11
STAT,1836,53,45-49,1889,0.011031277184837216
SIM,1903,13,na,1916,2994
STAT,1895,16,40-44,1911,0.23851792370170583
STAT,1907,6,na,1913,3811.6823408048062
STAT,1895,34,45-49,1929,2.249068389031414
STAT,1893,67,na,1960,2109.797386692114
STAT,1836,37,na,1873,2011.9606783897725
STAT,1903,38,20-24,1941,0.23500818780210067
SIM,1848,52,na,1900,2307
STAT,1885,16,na,1901,2488.64009570684
SIM,1886,20,25-29,1906,4
STAT,1850,42,25-29,1892,0.2961584284882552
STAT,1923,37,25-29,1960,1.1288494835445642
SIM,1812,42,45-49,1854,10
STAT,1869,8,na,1877,2760.7285510278443
STAT,1927,20,30-34,1947,35.331890060145824
SIM,1843,21,na,1864,626
STAT,1862,35,45-49,1897,1.7140598976828387
SIM,1937,24,na,1961,2988
STAT,1938,32,25-29,1970,9.193984164208329
STAT,1931,23,25-29,1954,118.59156218782798
STAT,1865,19,50-100,1884,0.04555120010782156
STAT,1893,22,40-44,1915,2.6058609204854624
STAT,1901,41,50-100,1942,0.10304025588224362
STAT,1851,42,30-34,1893,0.9068815364798144
SIM,1921,15,20-24,1936,277
STAT,1849,32,50-100,1881,0.8135175476380228
STAT,1826,31,40-44,1857,9.322023749321662
STAT,1835,73,na,1908,898.7191275299422
SIM,1935,20,30-34,1955,45
STAT,1906,11,na,1917,3745.237974663112
STAT,1874,18,35-39,1892,0.5648206138828527
SIM,1881,70,na,1951,905
STAT,1834,49,15-19,1883,1.8222562611408842E-4
SIM,1863,43,50-100,1906,1
STAT,1843,32,30-34,1875,20.7389927443556
STAT,1848,22,na,1870,2436.1856102000675
STAT,1884,69,na,1953,1404.8387752924461
SIM,1892,38,na,1930,3666
STAT,1914,20,20-24,1934,108.13818388276424
STAT,1867,50,30-34,1917,0.005710403361158295
STAT,1823,88,na,1911,108.4508766925542
SIM,1894,67,na,1961,1042
STAT,1845,40,40-44,1885,1.1660740574120332
STAT,1940,26,30-34,1966,39.52505938578179
STAT,1922,29,30-34,1951,43.529526653577875
SIM,1891,53,na,1944,1774
STAT,1910,37,15-19,1947,0.018160513770842
STAT,1870,88,na,1958,186.59406609991782
SIM,1936,26,20-24,1962,153
STAT,1897,31,15-19,1928,0.18989767101444613
STAT,1901,33,40-44,1934,6.038074216154602
STAT,1927,34,15-19,1961,0.1565861181864573
STAT,1877,30,35-39,1907,10.362824406292775
STAT,1847,36,30-34,1883,5.051655690969926
SIM,1885,30,35-39,1915,45
STAT,1860,39,15-19,1899,0.04534938991735927
STAT,1851,54,50-100,1905,0.01160002618095675
STAT,1925,37,45-49,1962,0.8107266331123222
SIM,1817,75,na,1892,1657
STAT,1872,20,40-44,1892,2.099092065065273
STAT,1876,20,15-19,1896,3.354908457056419
STAT,1851,10,na,1861,2321.049741046704
SIM,1897,32,na,1929,2709
STAT,1858,32,15-19,1890,0.10875165644326275
STAT,1919,32,15-19,1951,0.1368003157057197
SIM,1948,6,na,1954,5825
STAT,1905,42,15-19,1947,0.0013776266233075068
SIM,1825,40,na,1865,537
STAT,1862,37,50-100,1899,1.0457188790809517
STAT,1917,17,40-44,1934,0.2969738952803108
SIM,1840,88,na,1928,327
STAT,1879,43,15-19,1922,0.014064336552279027
SIM,1922,20,20-24,1942,705
STAT,1839,43,20-24,1882,0.15352928565785187
STAT,1825,44,30-34,1869,1.4795549441692377
STAT,1869,91,na,1960,103.79159969740317
SIM,1886,2,na,1888,3180
STAT,1839,37,35-39,1876,7.852679917690191
STAT,1882,73,na,1955,1137.1665807708027
STAT,1851,34,30-34,1885,14.057465201116157
SIM,1870,39,25-29,1909,3
STAT,1842,43,na,1885,586.0525515241928
STAT,1918,19,15-19,1937,48.469486552815766
SIM,1855,36,30-34,1891,13
STAT,1899,38,45-49,1937,0.5847857282277791
STAT,1921,39,40-44,1960,1.6481749095254141
STAT,1915,39,40-44,1954,1.4758950154360695
STAT,1821,44,na,1865,1355.3739325968863
SIM,1863,41,na,1904,889
STAT,1938,21,45-49,1959,1.1020243388421946
STAT,1842,40,25-29,1882,0.16920959404407138
SIM,1871,39,na,1910,1837
SIM,1883,18,na,1901,2144
STAT,1919,48,15-19,1967,3.931461606276223E-4
STAT,1821,38,50-100,1859,1.4750217197086515
STAT,1812,94,na,1906,1.5827890074940554
STAT,1845,34,50-100,1879,0.529477839669866
STAT,1854,33,45-49,1887,0.982667895822647
STAT,1833,23,na,1856,1134.8137259528348
STAT,1899,44,30-34,1943,0.10757255792788868
SIM,1878,71,na,1949,1639
SIM,1888,28,30-34,1916,3
STAT,1905,16,25-29,1921,8.170589847869659
SIM,1861,42,40-44,1903,24
STAT,1891,43,25-29,1934,0.7839745009671675
STAT,1825,95,na,1920,8.187560696898709
STAT,1889,38,50-100,1927,1.471145294640023
STAT,1913,48,50-100,1961,0.2173857199282598
STAT,1862,39,25-29,1901,2.427648738981176
STAT,1847,74,na,1921,1003.3786672574607
STAT,1875,4,na,1879,2986.1594399956653
STAT,1858,46,35-39,1904,0.10721654788910949
SIM,1913,33,na,1946,2952
STAT,1947,24,15-19,1971,5.9487649262564295
STAT,1843,21,15-19,1864,4.121033198554244
STAT,1878,52,50-100,1930,0.015456033515981418
STAT,1884,47,na,1931,2143.669762976239
STAT,1850,22,20-24,1872,38.19341116357063
SIM,1899,23,15-19,1922,58
STAT,1819,50,40-44,1869,0.0019066723448601518
STAT,1830,58,na,1888,1436.1368880823845
STAT,1907,49,45-49,1956,0.19120700866684823
STAT,1858,37,45-49,1895,1.522354627880559
STAT,1943,18,20-24,1961,142.08118787837125
STAT,1794,80,na,1874,3.2033835665207455
STAT,1843,52,35-39,1895,0.008460853089631643
STAT,1892,35,30-34,1927,6.661184293297239
STAT,1928,26,20-24,1954,22.394249565306815
SIM,1915,49,45-49,1964,2
SIM,1859,68,na,1927,989
SIM,1898,17,na,1915,4409
STAT,1827,35,50-100,1862,1.240652793224285
STAT,1882,29,25-29,1911,40.21035457497073
STAT,1844,56,na,1900,2020.6427682312863
STAT,1952,19,15-19,1971,53.85314129320959
SIM,1870,4,na,1874,2985
STAT,1828,36,20-24,1864,1.0588250786435045
STAT,1886,41,40-44,1927,2.339777070483368
SIM,1823,38,25-29,1861,2
STAT,1873,35,20-24,1908,0.7982306556111443
STAT,1806,55,na,1861,965.7880678089596
SIM,1908,49,na,1957,2046
STAT,1824,52,25-29,1876,5.972788656877393E-4
STAT,1871,19,20-24,1890,17.590142610271943
STAT,1928,29,35-39,1957,18.33774658172037
SIM,1904,39,30-34,1943,1
STAT,1836,45,45-49,1881,0.1941666320353084
SIM,1845,60,na,1905,1890
STAT,1915,15,40-44,1930,0.2899491708929036
STAT,1864,21,45-49,1885,0.6487919262834726
SIM,1921,48,50-100,1969,2
STAT,1906,15,15-19,1921,8.633580537903034
STAT,1918,31,45-49,1949,1.6563289577182492
STAT,1890,22,15-19,1912,3.99382246516273
STAT,1919,21,35-39,1940,10.204358090813294
SIM,1890,29,25-29,1919,11
STAT,1945,22,15-19,1967,5.769712361477216
STAT,1825,36,50-100,1861,1.8125319165701157
STAT,1913,2,na,1915,4115.612132938321
STAT,1860,38,50-100,1898,0.9966150805117105
SIM,1836,73,na,1909,570
STAT,1823,31,15-19,1854,0.619450688392532
STAT,1930,27,15-19,1957,0.8913474321371275
STAT,1853,86,na,1939,172.0402852429008
STAT,1882,50,20-24,1932,7.166441720434547E-4
STAT,1852,24,45-49,1876,0.8219117489138004
SIM,1843,27,na,1870,427
STAT,1897,17,na,1914,3354.1361199456505
STAT,1907,29,40-44,1936,4.303052610303511
STAT,1846,17,20-24,1863,13.190014223624086
STAT,1897,35,30-34,1932,7.1451763190651825
STAT,1899,31,25-29,1930,14.047210390639208
STAT,1851,52,35-39,1903,0.006763174470662283
STAT,1916,26,na,1942,3833.666803272584
SIM,1858,67,na,1925,2126
STAT,1876,34,na,1910,2391.6875084195203
SIM,1937,31,20-24,1968,6
SIM,1904,15,20-24,1919,29
STAT,1834,33,40-44,1867,2.4228842168233284
STAT,1871,15,40-44,1886,0.1858145837416095
SIM,1904,37,40-44,1941,4
STAT,1861,19,na,1880,2168.390321995338
SIM,1838,44,30-34,1882,2
STAT,1839,30,15-19,1869,0.16623464288620682
STAT,1931,39,35-39,1970,3.1740318709772426
SIM,1923,11,na,1934,4291
STAT,1811,44,na,1855,1857.6183096036077
SIM,1900,31,25-29,1931,10
STAT,1827,54,na,1881,1584.7119482384
STAT,1864,49,na,1913,2002.638863443987
STAT,1840,44,20-24,1884,0.06358119142002766
STAT,1924,42,25-29,1966,0.08412303057128911
STAT,1865,71,na,1936,1218.6610385692813
STAT,1902,48,20-24,1950,0.009412069526163915
SIM,1840,25,30-34,1865,75
STAT,1929,31,20-24,1960,3.078348530989508
STAT,1883,48,35-39,1931,0.13299371271545576
STAT,1920,38,20-24,1958,0.2846228460521783
SIM,1921,27,15-19,1948,2
SIM,1883,56,na,1939,1967
STAT,1853,20,30-34,1873,16.55568761291008
STAT,1842,19,50-100,1861,0.015434125640470716
SIM,1854,30,40-44,1884,6
STAT,1837,39,15-19,1876,0.053693558068086074
STAT,1859,111,na,1970,0.001034363106060174
STAT,1913,27,15-19,1940,0.6945923205682306
STAT,1917,28,20-24,1945,18.82117400290886
STAT,1941,15,na,1956,3750.133766780143
STAT,1797,82,na,1879,6.919786367232871
STAT,1944,21,45-49,1965,1.201585201870584
SIM,1923,3,na,1926,4291
STAT,1838,31,45-49,1869,0.9346534371304426
STAT,1862,32,40-44,1894,3.693759353485667
STAT,1876,0,na,1876,3701.544389431747
STAT,1919,36,30-34,1955,1.9337616511338438
STAT,1865,53,25-29,1918,0.003181903582633059
STAT,1878,20,25-29,1898,59.24966896227263
STAT,1832,25,30-34,1857,31.49087829655835
SIM,1849,36,30-34,1885,14
SIM,1808,92,na,1900,55
STAT,1932,18,45-49,1950,0.6551441945542199
SIM,1849,15,na,1864,2604
SIM,1911,16,na,1927,2607
STAT,1907,16,35-39,1923,0.8025861256389986
STAT,1892,46,35-39,1938,0.09805192353211181
STAT,1826,75,na,1901,820.724318893557
STAT,1924,30,na,1954,4389.79198239881
STAT,1815,69,na,1884,121.0170776265002
STAT,1817,49,15-19,1866,2.728946760994084E-4
STAT,1949,21,20-24,1970,128.51321914483177
STAT,1841,23,30-34,1864,24.946754244977274
STAT,1867,46,50-100,1913,0.23293076446245925
STAT,1869,37,20-24,1906,0.7778496469132059
STAT,1857,18,35-39,1875,0.4919736456853981
STAT,1880,20,40-44,1900,2.1762229946920835
STAT,1867,26,30-34,1893,23.897007393898278
STAT,1841,28,25-29,1869,58.087075195153396
STAT,1867,19,na,1886,2413.126371634619
STAT,1945,13,na,1958,4242.9106197207675
STAT,1916,11,na,1927,4139.1032167801195
STAT,1940,15,15-19,1955,45.58661665000726
STAT,1856,46,25-29,1902,0.04148886549826355
SIM,1866,71,na,1937,2022
STAT,1826,34,45-49,1860,3.0736480764294924
STAT,1823,47,25-29,1870,0.08986952085694194
SIM,1845,17,na,1862,2766
SIM,1835,30,30-34,1865,20
SIM,1929,11,na,1940,6274
SIM,1858,57,na,1915,2178
STAT,1947,22,25-29,1969,103.29490465573195
SIM,1927,36,30-34,1963,1
SIM,1858,52,na,1910,2325
SIM,1906,63,na,1969,3009
SIM,1911,48,na,1959,2293
STAT,1837,19,20-24,1856,18.72326141201933
STAT,1863,16,45-49,1879,0.06401199594385562
SIM,1931,30,na,1961,4975
STAT,1890,38,25-29,1928,3.4682885659754663
STAT,1939,27,35-39,1966,14.927276053336454
STAT,1937,31,50-100,1968,0.8100041162107792
STAT,1808,62,na,1870,580.0810823832157
STAT,1845,57,na,1902,997.2130885147732
STAT,1937,19,25-29,1956,41.59831177888255
STAT,1936,28,30-34,1964,37.10845283556628
STAT,1833,50,25-29,1883,0.001627766384565016
STAT,1851,45,35-39,1896,0.11167330548916478
STAT,1929,36,15-19,1965,0.024503405426095113
STAT,1821,38,25-29,1859,3.4590946067975343
SIM,1803,62,na,1865,965
STAT,1864,31,50-100,1895,0.8363684881173727
STAT,1930,29,40-44,1959,5.879282619576549
STAT,1954,16,20-24,1970,166.16791124868053
SIM,1866,86,na,1952,402
STAT,1914,27,40-44,1941,4.633457861144621
STAT,1910,20,50-100,1930,0.6146519554390613
SIM,1886,24,40-44,1910,260
STAT,1891,23,na,1914,2899.381405416408
STAT,1827,30,30-34,1857,18.5732448878583
SIM,1883,34,na,1917,2199
STAT,1865,20,15-19,1885,3.092846462358539
STAT,1843,26,45-49,1869,1.3598540237447498
STAT,1905,49,35-39,1954,0.11121495856023375
SIM,1851,26,45-49,1877,56
STAT,1820,81,na,1901,371.890290510511
STAT,1839,27,30-34,1866,29.4732644725972
STAT,1863,29,15-19,1892,0.38456310648867853
STAT,1837,34,20-24,1871,2.6615983561900354
STAT,1894,21,30-34,1915,22.719527690186318
SIM,1782,77,na,1859,514
STAT,1860,23,40-44,1883,1.7398283634392286
STAT,1925,21,35-39,1946,11.20137487247769
STAT,1878,24,40-44,1902,2.130545194049978
STAT,1888,37,30-34,1925,6.151205225159601
STAT,1845,25,40-44,1870,1.8355382881892366
STAT,1930,15,30-34,1945,15.720268046066565
STAT,1925,34,40-44,1959,4.598604220212415
SIM,1828,38,na,1866,1880
SIM,1828,54,na,1882,1714
STAT,1883,41,15-19,1924,0.01334576703296827
STAT,1901,36,45-49,1937,0.6045148920630716
STAT,1860,56,na,1916,1663.9174573526898
STAT,1913,18,35-39,1931,0.8449529875619953
SIM,1849,37,na,1886,2296
STAT,1927,30,35-39,1957,11.162328995247842
STAT,1949,15,35-39,1964,4.834688046938276
SIM,1881,28,20-24,1909,6
SIM,1919,29,25-29,1948,133
STAT,1878,35,20-24,1913,0.8006348951658547
SIM,1844,42,40-44,1886,11
SIM,1920,39,25-29,1959,2
SIM,1823,45,25-29,1868,1
STAT,1922,23,50-100,1945,0.7438474510781184
SIM,1868,19,na,1887,1315
STAT,1907,43,50-100,1950,0.10626928467880756
SIM,1890,36,25-29,1926,19
SIM,1908,48,50-100,1956,1
STAT,1894,47,50-100,1941,0.1753527825767701
STAT,1828,43,45-49,1871,1.840502506211464
STAT,1865,17,30-34,1882,1.4995452993844938
STAT,1830,109,na,1939,5.149348883998075E-4
STAT,1862,32,50-100,1894,0.780403925880737
STAT,1867,99,na,1966,8.218469071768391
STAT,1931,15,na,1946,4806.11636305826
STAT,1882,40,50-100,1922,1.0216638508172504
STAT,1906,37,25-29,1943,0.8999031177836265
STAT,1872,41,na,1913,2324.854138078203
SIM,1933,34,40-44,1967,6
STAT,1893,25,45-49,1918,1.3978847433257418
STAT,1856,34,30-34,1890,12.433137297282865
SIM,1926,1,na,1927,6476
STAT,1896,54,na,1950,2760.389715311366
STAT,1879,32,45-49,1911,1.7888822848809718
STAT,1954,1,na,1955,4824.700749600536
STAT,1832,45,25-29,1877,0.005332321788886615
STAT,1882,36,25-29,1918,2.769840452549935
STAT,1931,32,15-19,1963,0.16719978203330824
SIM,1859,15,na,1874,2147
STAT,1812,44,45-49,1856,0.4507960487698992
STAT,1815,107,na,1922,3.3250113152129794E-4
STAT,1849,44,40-44,1893,1.869639623317692
STAT,1950,1,na,1951,4782.597794860256
SIM,1937,17,25-29,1954,120
STAT,1840,48,50-100,1888,0.09627897749263481
STAT,1929,17,25-29,1946,54.9170746212816
STAT,1932,24,30-34,1956,37.31989897504548
SIM,1866,37,45-49,1903,1
STAT,1887,18,20-24,1905,19.462194298306425
STAT,1926,18,45-49,1944,0.6056200476981474
STAT,1846,30,40-44,1876,3.0989822824070563
STAT,1902,17,20-24,1919,24.9646163955441
STAT,1866,31,20-24,1897,2.477485976508096
STAT,1785,97,na,1882,0.43069886961438986
STAT,1940,17,40-44,1957,1.4042365462122786
STAT,1879,16,50-100,1895,0.05038125525975856
STAT,1893,16,30-34,1909,1.9980733592698816
STAT,1817,42,30-34,1859,0.8437823758685918
STAT,1892,31,15-19,1923,0.1770345932709818
STAT,1921,17,30-34,1938,13.72890755142249
STAT,1874,51,25-29,1925,0.003673083507436524
STAT,1916,48,na,1964,3706.402343680614
STAT,1926,25,50-100,1951,1.1909885521030004
STAT,1928,11,na,1939,4962.006305754398
STAT,1945,26,30-34,1971,42.53157540167936
STAT,1842,47,35-39,1889,0.03476003298014072
STAT,1906,28,45-49,1934,1.6021387325897845
STAT,1884,27,45-49,1911,1.062862531540412
STAT,1876,18,45-49,1894,0.06586203310775138
STAT,1836,49,25-29,1885,0.04502242007031134
STAT,1927,17,15-19,1944,55.96906432210225
STAT,1873,22,15-19,1895,3.3840716269722315
SIM,1862,19,na,1881,3819
STAT,1863,27,25-29,1890,36.11324311322382
STAT,1827,38,na,1865,1967.7057380090002
SIM,1815,62,na,1877,561
STAT,1856,39,25-29,1895,2.047180171792565
STAT,1880,60,na,1940,1979.9470688542851
STAT,1912,39,25-29,1951,0.9402694774582482
STAT,1852,15,30-34,1867,1.9634861473747587
STAT,1910,16,na,1926,3793.4962767413067
STAT,1835,57,na,1892,1520.5975805584999
SIM,1848,6,na,1854,2793
STAT,1884,20,25-29,1904,55.1266097637786
SIM,1854,17,20-24,1871,51
STAT,1842,40,15-19,1882,0.003638916243982363
STAT,1887,31,40-44,1918,4.792814332619966
STAT,1946,17,25-29,1963,47.54552998821596
SIM,1835,39,na,1874,1268
STAT,1865,93,na,1958,39.19712831995802
STAT,1915,9,na,1924,4094.149854004598
STAT,1869,44,45-49,1913,1.4898471862962763
STAT,1857,51,25-29,1908,0.00273100866647962
STAT,1929,38,40-44,1967,1.9064858671545202
SIM,1849,23,25-29,1872,5
STAT,1836,42,40-44,1878,2.0504030515566556
STAT,1837,26,45-49,1863,1.1509277601386068
STAT,1848,37,na,1885,2271.9490808449605
STAT,1892,16,50-100,1908,0.06080551629986161
STAT,1818,37,50-100,1855,3.1258959110322206
STAT,1898,19,35-39,1917,0.7339014166546359
SIM,1923,33,na,1956,3821
STAT,1841,35,25-29,1876,3.8567717940619946
SIM,1942,9,na,1951,3672
STAT,1864,48,25-29,1912,0.0517065519292706
STAT,1839,23,na,1862,2534.0421160904616
STAT,1906,34,30-34,1940,14.393159277977434
STAT,1924,29,40-44,1953,5.336467354584323
SIM,1853,36,20-24,1889,2
SIM,1842,42,na,1884,3092
STAT,1871,29,25-29,1900,41.895919351883435
STAT,1865,50,20-24,1915,6.833953591424745E-4
STAT,1881,23,na,1904,2226.5270727863553
SIM,1842,45,35-39,1887,1
SIM,1868,36,40-44,1904,2
STAT,1776,83,na,1859,241.19237064915748
STAT,1874,85,na,1959,387.36420494650827
STAT,1884,37,na,1921,2255.31191260371
SIM,1933,26,na,1959,4377
STAT,1832,27,20-24,1859,14.244014279895882
STAT,1835,24,45-49,1859,0.6913011877657858
SIM,1835,24,na,1859,1310
STAT,1837,40,40-44,1877,2.1834126863654753
STAT,1883,45,30-34,1928,0.09405420550499087
SIM,1840,49,40-44,1889,2
SIM,1913,25,15-19,1938,2
SIM,1818,54,na,1872,672
STAT,1900,16,25-29,1916,7.869316140216601
STAT,1816,54,30-34,1870,0.01673920116349235
STAT,1882,53,25-29,1935,0.0033367107750914278
STAT,1850,18,25-29,1868,3.1787052097470063
STAT,1877,39,45-49,1916,2.0032619934984455
STAT,1932,15,40-44,1947,1.8477682530564832
SIM,1837,68,na,1905,1470
STAT,1817,38,35-39,1855,5.468220748118594
STAT,1927,38,30-34,1965,2.245276890633069
SIM,1936,26,30-34,1962,795
STAT,1914,52,na,1966,3532.3915382679706
STAT,1940,22,15-19,1962,5.361856963268322
STAT,1855,31,45-49,1886,1.1874033607434966
STAT,1905,25,15-19,1930,0.6569969276727339
STAT,1897,38,35-39,1935,9.34661676864348
STAT,1951,15,50-100,1966,0.4422235853761068
SIM,1914,34,30-34,1948,23
SIM,1824,61,na,1885,1811
STAT,1876,22,40-44,1898,2.1065390919216873
STAT,1825,40,15-19,1865,0.01896620613731529
STAT,1916,47,45-49,1963,0.21987927095346535
SIM,1939,1,na,1940,4904
STAT,1832,49,40-44,1881,0.013789036425703175
STAT,1837,37,25-29,1874,2.810785718248351
STAT,1861,49,50-100,1910,0.19998689418829607
STAT,1834,36,45-49,1870,1.1042165881653472
SIM,1871,48,50-100,1919,3
STAT,1933,32,25-29,1965,12.37109948095593
STAT,1823,44,20-24,1867,0.25387100421610487
STAT,1911,29,30-34,1940,37.510966493513195
STAT,1860,26,45-49,1886,0.9221023965793764
STAT,1854,32,50-100,1886,0.5217062524086813
STAT,1886,70,na,1956,1482.0713669587876
STAT,1937,16,20-24,1953,130.84971064775172
STAT,1884,29,35-39,1913,9.170636775012893
SIM,1871,6,na,1877,2177
STAT,1845,36,20-24,1881,0.40609294238609384
STAT,1879,47,30-34,1926,0.09883834920056356
STAT,1820,50,50-100,1870,0.023836027079364146
STAT,1931,36,30-34,1967,2.398977537349296
STAT,1768,114,na,1882,8.131940622232005E-4
STAT,1890,35,20-24,1925,0.942057933807298
STAT,1923,37,35-39,1960,2.7730868209523383
STAT,1858,43,30-34,1901,0.8716183939747355
STAT,1863,48,50-100,1911,0.20703720676856963
STAT,1847,32,15-19,1879,0.15117265315214642
SIM,1867,34,na,1901,2290
STAT,1896,22,na,1918,3117.6747829578007
STAT,1854,19,20-24,1873,11.653276496577428
SIM,1902,49,na,1951,3106
SIM,1919,33,na,1952,5088
STAT,1906,25,40-44,1931,4.367219366757625
STAT,1885,48,na,1933,2183.692230493001
STAT,1832,44,50-100,1876,0.09450283435767631
STAT,1834,28,50-100,1862,0.3670233717929724
STAT,1843,23,40-44,1866,2.565780762861411
STAT,1863,30,40-44,1893,3.7320678772501177
STAT,1908,21,35-39,1929,8.615306958908109
SIM,1864,42,na,1906,2408
STAT,1901,40,40-44,1941,0.22059694978382094
STAT,1902,67,na,1969,2561.264582847529
SIM,1932,15,na,1947,6500
SIM,1929,36,40-44,1965,7
STAT,1877,43,40-44,1920,2.2667917273374667
SIM,1909,31,45-49,1940,3
SIM,1885,43,40-44,1928,1
STAT,1854,50,45-49,1904,0.008185115974966038
STAT,1878,27,45-49,1905,1.1423567205750838
STAT,1932,27,25-29,1959,85.61108753342614
STAT,1881,52,20-24,1933,6.93142819586599E-4
STAT,1908,48,15-19,1956,3.2964717828071465E-4
STAT,1928,38,15-19,1966,0.02406016430686399
STAT,1937,10,na,1947,3826.3371137805025
SIM,1875,26,30-34,1901,96
STAT,1926,16,45-49,1942,0.6087022609011035
STAT,1862,21,35-39,1883,5.124855379703238
STAT,1858,15,na,1873,2072.011812260556
SIM,1907,48,na,1955,4401
SIM,1870,21,35-39,1891,35
STAT,1841,42,na,1883,2674.412777485634
STAT,1854,30,40-44,1884,2.5211250220640316
STAT,1844,30,30-34,1874,21.11855541976848
STAT,1886,20,35-39,1906,6.078987542467571
SIM,1881,60,na,1941,1753
STAT,1867,22,15-19,1889,3.1328392305769195
STAT,1838,46,30-34,1884,0.043060091833441914
SIM,1914,34,na,1948,4850
STAT,1815,45,25-29,1860,0.005995706706934941
SIM,1836,29,20-24,1865,40
STAT,1950,19,40-44,1969,1.6370076348695999
STAT,1915,17,30-34,1932,2.51501469200551
STAT,1873,28,20-24,1901,11.991524423679257
STAT,1876,25,45-49,1901,1.130029171805533
SIM,1889,18,na,1907,3885
STAT,1908,38,20-24,1946,0.2436851888447551
SIM,1875,22,15-19,1897,2
SIM,1880,5,na,1885,3342
STAT,1871,26,20-24,1897,11.742794852548226
STAT,1905,46,30-34,1951,0.07875997347667658
STAT,1834,45,35-39,1879,0.0737721528142251
SIM,1897,69,na,1966,1419
STAT,1889,18,30-34,1907,1.9143486873504785
STAT,1936,24,15-19,1960,5.035286174317624
SIM,1903,27,30-34,1930,156
STAT,1856,43,20-24,1899,0.11324402272967607
STAT,1836,38,45-49,1874,1.8556309569381477
STAT,1948,17,35-39,1965,4.7530013160695095
SIM,1906,39,40-44,1945,1
STAT,1828,29,20-24,1857,20.0255417317692
SIM,1823,39,na,1862,1546
STAT,1888,33,15-19,1921,0.1636681614245677
SIM,1859,20,15-19,1879,10
STAT,1856,37,35-39,1893,5.080150987950083
STAT,1931,19,30-34,1950,15.756855320095173
STAT,1914,32,15-19,1946,0.1275540235331972
STAT,1836,42,50-100,1878,0.963044254174631
STAT,1879,84,na,1963,559.8147772634007
STAT,1896,32,45-49,1928,2.298756338794128
STAT,1866,56,na,1922,1861.816100910946
STAT,1829,41,45-49,1870,0.7306353649858843
STAT,1858,36,30-34,1894,4.089597453833208
STAT,1885,5,na,1890,2575.954950916747
SIM,1908,12,na,1920,2858
STAT,1811,76,na,1887,562.8408058009688
STAT,1921,48,30-34,1969,0.0990278673971797
STAT,1840,47,25-29,1887,0.022871236609354913
STAT,1931,15,15-19,1946,59.25883025823314
STAT,1880,16,45-49,1896,0.06798140377424788
STAT,1795,75,na,1870,502.358594376903
STAT,1849,47,45-49,1896,0.19792462664486757
STAT,1802,62,na,1864,1314.1672870330256
STAT,1892,8,na,1900,3218.4821592270805
STAT,1878,38,25-29,1916,2.9476242944021673
STAT,1866,41,15-19,1907,0.012662909489407966
STAT,1889,0,na,1889,3474.390190302727
SIM,1831,38,35-39,1869,42
SIM,1886,48,na,1934,2888
STAT,1922,27,40-44,1949,5.21541860397419
STAT,1819,35,40-44,1854,3.314447839237437
STAT,1823,61,na,1884,1566.258842120633
STAT,1819,44,50-100,1863,0.2007464833441906
STAT,1905,29,30-34,1934,35.96077498388907
STAT,1911,17,50-100,1928,0.07412759560486604
STAT,1839,36,20-24,1875,0.8647646013081114
STAT,1843,39,15-19,1882,0.05773083031472971
STAT,1854,7,na,1861,1646.2806268963052
SIM,1884,19,na,1903,3693
STAT,1871,89,na,1960,175.22231423179454
STAT,1893,23,50-100,1916,0.5083774949592188
STAT,1909,27,50-100,1936,0.9415672533626308
SIM,1851,72,na,1923,865
STAT,1823,38,35-39,1861,12.952413382967219
STAT,1792,100,na,1892,0.2569991643409096
SIM,1875,85,na,1960,489
STAT,1864,45,20-24,1909,0.011018035013163412
SIM,1866,34,40-44,1900,1
STAT,1798,101,na,1899,0.24221142393267672
SIM,1862,1,na,1863,4008
STAT,1865,42,50-100,1907,0.9633436414015736
STAT,1926,15,40-44,1941,1.7080903820152482
STAT,1860,32,30-34,1892,14.24350072365686
STAT,1830,25,20-24,1855,11.444269823730032
STAT,1856,56,na,1912,1464.9743823078654
STAT,1930,18,35-39,1948,5.372753695906422
STAT,1867,1,na,1868,3372.7253645668125
SIM,1873,56,na,1929,1646
STAT,1906,30,15-19,1936,0.11936130099580268
STAT,1884,50,30-34,1934,0.005780097016412351
SIM,1886,38,25-29,1924,48
STAT,1847,38,20-24,1885,0.7156340539375352
STAT,1861,40,35-39,1901,1.5211461110684958
STAT,1935,19,15-19,1954,61.26500279566349
SIM,1908,59,na,1967,1851
STAT,1838,41,50-100,1879,0.5342092000827086
STAT,1913,15,30-34,1928,2.4722680775260057
STAT,1861,16,35-39,1877,0.5276062712690698
STAT,1820,43,na,1863,1854.1047676902604
STAT,1821,47,15-19,1868,4.2780212118215336E-4
STAT,1851,20,20-24,1871,65.93943825827286
STAT,1813,95,na,1908,9.739328125766804
STAT,1848,6,na,1854,2894.0
STAT,1900,2,na,1902,3692.6998566893903
STAT,1911,25,15-19,1936,0.6853186493148207
STAT,1825,30,20-24,1855,5.308111227660649
STAT,1862,28,45-49,1890,0.942361887284894
STAT,1886,26,40-44,1912,3.112701937384194
SIM,1894,37,20-24,1931,7
STAT,1837,23,40-44,1860,2.17157743025593
STAT,1834,94,na,1928,8.807969702419676
STAT,1856,41,na,1897,1667.5675353016952
STAT,1866,34,na,1900,2159.619914084527
STAT,1954,18,20-24,1972,166.06822539057617
STAT,1851,26,50-100,1877,0.5958254803023924
STAT,1895,31,40-44,1926,5.664569940752922
STAT,1841,52,25-29,1893,0.003923264338769056
STAT,1919,17,15-19,1936,49.48621263617329
STAT,1876,18,na,1894,2546.466255701523
STAT,1934,17,40-44,1951,1.8790939360654384
SIM,1927,17,15-19,1944,191
STAT,1870,52,45-49,1922,0.014390886290963602
STAT,1828,40,40-44,1868,2.9085784846777987
STAT,1853,45,45-49,1898,0.18481608177061573
STAT,1890,29,35-39,1919,11.597576154697894
STAT,1891,19,25-29,1910,6.93116803790987
SIM,1866,30,25-29,1896,1
STAT,1875,46,35-39,1921,0.1441674709807539
STAT,1897,44,20-24,1941,0.014448463200069879
STAT,1849,71,na,1920,1124.692157382981
STAT,1865,26,20-24,1891,10.747466583046426
SIM,1943,19,15-19,1962,114
SIM,1871,49,na,1920,1772
STAT,1892,21,20-24,1913,85.57772251253384
SIM,1887,70,na,1957,2002
SIM,1891,37,50-100,1928,32
STAT,1825,49,50-100,1874,0.3038502428741302
STAT,1888,39,20-24,1927,0.8807315137156136
STAT,1906,48,na,1954,3217.592172300831
STAT,1908,27,40-44,1935,4.40923814833652
STAT,1923,15,15-19,1938,52.97519802315368
STAT,1854,49,na,1903,1224.8323377882155
STAT,1899,20,45-49,1919,0.9581315802655106
STAT,1859,15,40-44,1874,0.1702769802485676
STAT,1894,46,45-49,1940,0.16976847058703856
SIM,1873,29,25-29,1902,4
STAT,1819,46,20-24,1865,0.002282868107974792
STAT,1904,39,40-44,1943,1.3363108463012672
STAT,1928,22,15-19,1950,6.595728248770738
STAT,1816,91,na,1907,48.921080123962575
STAT,1892,66,na,1958,2106.3205449158286
STAT,1927,21,45-49,1948,1.379132620695864
SIM,1833,49,50-100,1882,1
STAT,1863,24,20-24,1887,59.14532801029276
STAT,1886,37,20-24,1923,0.7982526423671014
STAT,1883,37,50-100,1920,1.1811415716379958
STAT,1864,39,35-39,1903,6.365320958999072
STAT,1910,23,40-44,1933,3.11259446039909
STAT,1919,39,35-39,1958,2.558515457528738
SIM,1923,48,na,1971,4224
STAT,1853,25,50-100,1878,0.5829467855939191
STAT,1855,93,na,1948,19.342431446511238
SIM,1916,27,40-44,1943,62
STAT,1841,26,35-39,1867,13.44196020364581
SIM,1852,57,na,1909,1806
SIM,1938,24,15-19,1962,48
STAT,1858,30,25-29,1888,7.986050883005747
STAT,1884,24,40-44,1908,1.9822850583565863
SIM,1832,80,na,1912,167
SIM,1938,25,na,1963,4231
STAT,1869,41,40-44,1910,2.2799733712552133
SIM,1830,26,25-29,1856,175
STAT,1934,28,20-24,1962,24.378050104115225
STAT,1848,49,50-100,1897,0.2250276336660354
SIM,1917,26,na,1943,2263
STAT,1834,72,na,1906,556.5644352290569
STAT,1836,31,35-39,1867,9.911308377534084
STAT,1859,20,15-19,1879,3.024512424548627
STAT,1870,20,30-34,1890,17.863607494452943
STAT,1929,34,25-29,1963,11.642877190848393
STAT,1880,40,45-49,1920,1.5694214988499766
STAT,1838,60,na,1898,813.3591944060962
STAT,1869,48,na,1917,2241.747499551555
STAT,1843,28,35-39,1871,11.648522685951306
STAT,1912,36,20-24,1948,0.2555221627794372
SIM,1849,53,na,1902,2017
STAT,1840,103,na,1943,0.05650969871265799
STAT,1907,42,25-29,1949,0.06498496559259395
SIM,1851,28,35-39,1879,53
STAT,1842,44,30-34,1886,0.2878061252451979
STAT,1951,20,25-29,1971,109.40570194850852
SIM,1861,71,na,1932,1395
STAT,1870,23,35-39,1893,5.79960708935408
STAT,1831,28,30-34,1859,28.684457638457463
SIM,1870,37,20-24,1907,4
STAT,1911,32,35-39,1943,8.798379174266108
STAT,1914,33,15-19,1947,0.12701574555388706
SIM,1924,39,50-100,1963,2
STAT,1873,24,15-19,1897,3.362886750435736
SIM,1898,64,na,1962,3640
STAT,1860,18,na,1878,2146.9917465465337
STAT,1801,82,na,1883,153.26829580538393
STAT,1828,32,40-44,1860,6.5684214101840634
STAT,1871,37,15-19,1908,0.05601662532493478
STAT,1849,22,30-34,1871,18.145709329192034
STAT,1833,49,45-49,1882,0.10509895431417315
STAT,1881,21,45-49,1902,0.6605021805725076
STAT,1857,41,20-24,1898,0.1224184134128368
STAT,1863,38,na,1901,2001.3504968322584
STAT,1946,26,15-19,1972,0.7782394429779391
STAT,1889,26,20-24,1915,14.17578830879632
STAT,1958,5,na,1963,5118.432595734667
STAT,1923,48,40-44,1971,0.18199022133177353
STAT,1929,9,na,1938,5044.813003307812
STAT,1793,109,na,1902,1.1828870137577577E-4
SIM,1876,49,na,1925,3484
STAT,1927,42,40-44,1969,0.31113789611724046
STAT,1889,4,na,1893,3167.939988704507
SIM,1848,26,25-29,1874,33
SIM,1869,51,na,1920,3598
STAT,1838,36,15-19,1874,0.029226953962584293
SIM,1817,38,na,1855,2500
SIM,1922,47,na,1969,3231
STAT,1860,93,na,1953,23.841847298873052
STAT,1782,112,na,1894,3.6674750153009404E-4
STAT,1932,33,35-39,1965,12.05616396060453
STAT,1861,22,50-100,1883,0.3484076350605288
STAT,1813,44,15-19,1857,0.05617369704415991
STAT,1898,24,20-24,1922,92.08767143085252
SIM,1875,91,na,1966,236
STAT,1936,35,45-49,1971,0.6637634496799744
SIM,1839,53,na,1892,511
STAT,1887,40,na,1927,2569.5887054103173
STAT,1863,20,40-44,1883,1.84076472873662
STAT,1920,30,35-39,1950,9.96036790863034
SIM,1859,30,40-44,1889,1
STAT,1932,17,30-34,1949,16.02751368299273
SIM,1886,79,na,1965,1187
STAT,1859,21,na,1880,1946.1399476240158
SIM,1826,74,na,1900,427
STAT,1883,52,30-34,1935,0.005696124053491876
STAT,1856,88,na,1944,98.60442674602176
STAT,1846,23,45-49,1869,0.5059215659903178
STAT,1854,40,40-44,1894,1.2632565120622352
STAT,1906,27,30-34,1933,36.465188488066175
SIM,1914,28,na,1942,5031
STAT,1905,35,15-19,1940,0.0175986836674503
STAT,1875,53,35-39,1928,0.008698292176257458
STAT,1868,20,15-19,1888,3.2326858851600844
SIM,1903,40,na,1943,2713
STAT,1850,16,50-100,1866,0.027808211698995618
STAT,1839,17,na,1856,2789.7736289514373
SIM,1889,27,25-29,1916,5
STAT,1857,23,20-24,1880,60.60950752679791
STAT,1844,49,20-24,1893,0.011640049235941021
STAT,1846,41,45-49,1887,0.908700004852417
STAT,1854,22,40-44,1876,1.3613548788903718
STAT,1950,15,25-29,1965,50.77890972845563
STAT,1837,25,45-49,1862,1.1592511836371215
STAT,1847,36,na,1883,2233.119762472815
SIM,1922,15,15-19,1937,535
SIM,1899,18,na,1917,2165
STAT,1843,22,na,1865,2651.702558103427
STAT,1851,41,na,1892,1833.6595016499332
STAT,1916,21,30-34,1937,29.795797040019252
STAT,1940,23,15-19,1963,5.3600875504704435
STAT,1906,64,na,1970,2842.1276499088503
SIM,1864,20,na,1884,2555
SIM,1953,15,na,1968,4654
STAT,1839,72,na,1911,1173.3128405354075
SIM,1793,82,na,1875,591
STAT,1880,35,15-19,1915,0.058850763019169354
STAT,1904,19,20-24,1923,25.192848215859954
STAT,1914,15,15-19,1929,9.300333636185185
STAT,1937,28,15-19,1965,0.6807165179613925
STAT,1850,46,40-44,1896,0.07927804386652501
STAT,1899,16,35-39,1915,0.7513045680858992
STAT,1900,48,45-49,1948,0.1820970856967387
STAT,1927,10,na,1937,4901.271363873955
STAT,1945,23,50-100,1968,0.7129553795310346
STAT,1833,54,40-44,1887,0.004469528988209879
STAT,1874,17,50-100,1891,0.05056287734892553
STAT,1887,24,45-49,1911,0.7627183306903533
STAT,1822,44,na,1866,1548.6459708216985
STAT,1922,37,40-44,1959,1.684378066246922
SIM,1893,17,na,1910,3383
STAT,1901,17,na,1918,3531.340849063664
SIM,1874,31,20-24,1905,11
SIM,1940,24,20-24,1964,998
STAT,1914,42,30-34,1956,0.12491869617594661
STAT,1866,0,na,1866,3464.5646783279726
SIM,1858,20,na,1878,2443
STAT,1922,19,40-44,1941,1.592109931730358
STAT,1913,46,na,1959,3549.599500605233
STAT,1865,18,30-34,1883,1.490712977571119
STAT,1915,49,45-49,1964,0.21464466877771893
SIM,1880,54,na,1934,3193
STAT,1837,30,40-44,1867,4.451295698640935
SIM,1899,21,25-29,1920,11
SIM,1856,0,na,1856,2567
SIM,1789,77,na,1866,187
SIM,1884,68,na,1952,2918
STAT,1872,29,30-34,1901,25.035912434401247
STAT,1894,48,20-24,1942,0.008499698128859668
STAT,1942,27,na,1969,3886.879124021019
SIM,1922,42,30-34,1964,1
STAT,1798,61,na,1859,1412.4694388102437
STAT,1868,85,na,1953,264.77845727973533
STAT,1932,24,20-24,1956,144.38392269605808
SIM,1925,1,na,1926,5488
STAT,1923,3,na,1926,4712.683978443306
SIM,1930,41,25-29,1971,1
STAT,1860,52,35-39,1912,0.006985814952062025
STAT,1945,15,15-19,1960,49.054211517635295
SIM,1880,29,30-34,1909,68
STAT,1924,25,25-29,1949,76.41555999175242
SIM,1821,75,na,1896,965
STAT,1880,15,45-49,1895,0.0681299270151409
STAT,1866,48,45-49,1914,0.21271839137312817
STAT,1839,28,30-34,1867,29.26164643368395
STAT,1889,19,30-34,1908,1.9090842284602647
STAT,1891,7,na,1898,3203.8813973300257
STAT,1866,50,na,1916,1993.6961334742687
STAT,1898,5,na,1903,3524.0166253026964
STAT,1904,24,45-49,1928,0.9900237319256021
SIM,1900,9,na,1909,4181
STAT,1863,15,45-49,1878,0.06439126046801222
STAT,1842,51,30-34,1893,0.0014847576656955384
SIM,1829,39,na,1868,2037
STAT,1895,41,40-44,1936,0.2041082852758048
STAT,1841,27,na,1868,2992.022514939435
STAT,1865,25,20-24,1890,10.783375222537474
SIM,1832,74,na,1906,167
SIM,1847,28,30-34,1875,5
SIM,1873,72,na,1945,609
STAT,1854,105,na,1959,0.036157223385269846
STAT,1869,33,40-44,1902,4.357634901491479
STAT,1922,41,25-29,1963,0.08116605799167283
STAT,1936,21,50-100,1957,0.6230378022920449
STAT,1878,41,40-44,1919,2.3246819613427747
STAT,1914,38,45-49,1952,0.6678605883150682
STAT,1816,44,na,1860,2589.5363811257685
STAT,1869,18,15-19,1887,6.035612432724334
SIM,1929,38,30-34,1967,1
STAT,1887,42,45-49,1929,1.64528360687588
STAT,1872,19,na,1891,2515.477204879082
STAT,1874,18,25-29,1892,5.833117745875957
STAT,1821,39,25-29,1860,3.3685215204257153
STAT,1788,95,na,1883,1.048386845344833
SIM,1846,23,na,1869,273
STAT,1848,25,20-24,1873,13.29589326843909
SIM,1952,9,na,1961,6372
SIM,1869,67,na,1936,3598
STAT,1877,20,40-44,1897,2.1279379371806044
SIM,1873,25,na,1898,2196
SIM,1896,69,na,1965,1671
STAT,1919,43,45-49,1962,0.17768045359872792
STAT,1928,15,15-19,1943,57.01310737461508
STAT,1844,33,35-39,1877,11.873584721687305
STAT,1881,55,na,1936,1952.6406856995234
STAT,1830,36,15-19,1866,0.05175488250390546
STAT,1840,20,45-49,1860,0.3542445798119825
STAT,1940,28,45-49,1968,1.741091574018398
SIM,1823,38,na,1861,1640
STAT,1874,23,20-24,1897,70.9025093476399
STAT,1905,9,na,1914,3731.91406602228
SIM,1911,30,35-39,1941,1
STAT,1891,47,40-44,1938,0.11820255795302637
STAT,1858,15,35-39,1873,0.4952996752214928
SIM,1878,42,45-49,1920,1
STAT,1881,30,50-100,1911,0.8722094787682584
STAT,1874,47,40-44,1921,0.17586604975670128
SIM,1941,14,na,1955,3866
STAT,1919,25,15-19,1944,0.7577522310962829
SIM,1831,42,50-100,1873,3
STAT,1846,54,50-100,1900,0.008698792255346137
SIM,1907,7,na,1914,4894
STAT,1875,15,35-39,1890,0.5660610433978768
SIM,1939,32,30-34,1971,12
STAT,1923,35,35-39,1958,2.7778904986531194
STAT,1913,43,25-29,1956,0.06865493103733894
STAT,1828,50,40-44,1878,0.012628139576299748
STAT,1903,49,25-29,1952,0.04515863374988713
SIM,1867,72,na,1939,408
STAT,1913,22,45-49,1935,1.0766208710362943
STAT,1954,12,na,1966,4813.18170084813
SIM,1919,9,na,1928,5211
STAT,1850,44,50-100,1894,0.48124420135628154
SIM,1884,4,na,1888,3913
SIM,1921,43,25-29,1964,1
STAT,1890,32,na,1922,2888.88550176843
STAT,1923,40,30-34,1963,0.14826383338328833
STAT,1839,35,20-24,1874,0.873790860901221
STAT,1786,76,na,1862,698.4816986483748
STAT,1859,32,40-44,1891,3.437249483137871
STAT,1870,24,na,1894,2343.03510592101
STAT,1895,46,15-19,1941,2.943532759216634E-4
SIM,1905,51,na,1956,2842
SIM,1837,58,na,1895,1649
STAT,1920,49,25-29,1969,0.05754365728981557
SIM,1909,13,na,1922,4275
SIM,1838,75,na,1913,191
STAT,1875,55,na,1930,2123.236274300021
SIM,1931,28,45-49,1959,2
STAT,1831,30,45-49,1861,1.9109245222948659
STAT,1923,28,45-49,1951,1.9557122840562713
SIM,1836,32,40-44,1868,17
STAT,1834,52,35-39,1886,0.0038903298642942244
STAT,1859,92,na,1951,33.011017939979446
SIM,1905,33,15-19,1938,1
STAT,1794,95,na,1889,0.03319709126453572
STAT,1908,22,35-39,1930,8.589374884961797
STAT,1930,22,45-49,1952,1.431300147549913
SIM,1852,35,na,1887,2255
STAT,1895,23,40-44,1918,2.702393289946708
STAT,1866,19,na,1885,2338.53369770615
STAT,1850,63,na,1913,823.9232901946488
STAT,1864,26,15-19,1890,0.41387923682332634
SIM,1901,27,20-24,1928,5
STAT,1900,38,45-49,1938,0.5930994536107596
SIM,1917,32,na,1949,2122
SIM,1857,66,na,1923,658
SIM,1889,71,na,1960,1357
STAT,1807,71,na,1878,712.6283201272876
STAT,1870,23,50-100,1893,0.40528356171623703
SIM,1845,40,40-44,1885,2
STAT,1864,108,na,1972,0.03226809071021916
SIM,1853,52,na,1905,3151
STAT,1882,48,30-34,1930,0.09151281955434765
STAT,1856,29,na,1885,1750.8148000674926
STAT,1914,29,30-34,1943,38.67229896201112
STAT,1910,27,20-24,1937,17.429684553174205
STAT,1889,29,25-29,1918,50.57634840702537
STAT,1875,50,30-34,1925,0.006200226282426957
STAT,1853,23,35-39,1876,5.307814974393786
SIM,1923,33,35-39,1956,68
STAT,1917,46,15-19,1963,3.805728296372782E-4
STAT,1837,52,50-100,1889,0.012153790723200686
STAT,1929,26,15-19,1955,0.8777225094168937
STAT,1904,32,45-49,1936,1.430557184656452
STAT,1845,47,15-19,1892,1.9756128259446905E-4
STAT,1949,23,35-39,1972,10.87526238213792
STAT,1931,27,40-44,1958,5.975319205539322
SIM,1818,55,na,1873,672
SIM,1912,32,45-49,1944,2
STAT,1849,25,35-39,1874,9.777380266574472
STAT,1883,31,20-24,1914,2.6110863935006132
STAT,1797,102,na,1899,0.0029307108260564897
SIM,1902,1,na,1903,3830
STAT,1921,44,15-19,1965,0.0017034819997098773
STAT,1885,23,50-100,1908,0.3995987338570256
STAT,1816,40,20-24,1856,0.5492764585854238
STAT,1828,35,45-49,1863,2.798270412830865
STAT,1905,19,40-44,1924,0.26166241725331973
SIM,1853,80,na,1933,1079
STAT,1907,31,30-34,1938,14.687765593631761
STAT,1906,40,30-34,1946,0.11677376236978516
STAT,1892,67,na,1959,2066.089822507936
STAT,1840,49,50-100,1889,0.09505334610915356
STAT,1824,52,50-100,1876,0.0025467307369402897
STAT,1868,14,na,1882,2556.3118462121415
STAT,1845,72,na,1917,626.6699355079174
STAT,1855,36,15-19,1891,0.03734401487625054
STAT,1854,43,45-49,1897,0.8261470715618354
STAT,1881,19,30-34,1900,1.4970951461246829
STAT,1836,47,20-24,1883,0.009623116374496275
STAT,1915,33,35-39,1948,9.13688240155209
STAT,1833,56,na,1889,843.375544645753
STAT,1873,84,na,1957,398.9113598556794
STAT,1870,4,na,1874,2947.8581203360227
STAT,1887,16,45-49,1903,0.07207531433290777
SIM,1881,7,na,1888,3275
STAT,1833,46,40-44,1879,0.08708218016990969
STAT,1878,23,40-44,1901,2.137341941423705
STAT,1930,40,20-24,1970,0.02313744892273995
STAT,1830,36,50-100,1866,1.1315497880901435
STAT,1913,25,25-29,1938,65.20038629773346
SIM,1855,26,15-19,1881,7
SIM,1893,5,na,1898,3684
STAT,1824,79,na,1903,135.29344766701453
STAT,1860,28,50-100,1888,0.5236604897678616
SIM,1950,8,na,1958,4854
STAT,1892,38,45-49,1930,2.4558816993005013
SIM,1817,42,na,1859,2747
STAT,1842,44,40-44,1886,0.5630801526659015
SIM,1894,34,na,1928,1443
STAT,1955,16,15-19,1971,59.73721480989613
STAT,1910,53,na,1963,3317.2102563854664
STAT,1868,69,na,1937,1417.457389161759
STAT,1864,55,na,1919,1879.7711220444144
SIM,1892,9,na,1901,3699
STAT,1825,47,45-49,1872,0.2998143312102758
STAT,1877,48,20-24,1925,0.012028384363528256
SIM,1856,28,25-29,1884,9
STAT,1854,18,na,1872,1517.774416691549
SIM,1834,38,na,1872,950
STAT,1902,42,35-39,1944,0.17685341588929226
STAT,1874,15,20-24,1889,18.450635611284667
SIM,1941,30,na,1971,3820
STAT,1916,24,35-39,1940,9.671091792076501
STAT,1933,21,30-34,1954,37.97939827899213
STAT,1852,51,50-100,1903,0.015274982295947447
SIM,1833,47,45-49,1880,5
STAT,1827,33,35-39,1860,10.279792707649015
STAT,1830,29,25-29,1859,40.093444713491
SIM,1900,48,na,1948,4006
SIM,1930,14,na,1944,5558
SIM,1879,38,50-100,1917,13
SIM,1891,31,20-24,1922,11
SIM,1941,21,30-34,1962,1
STAT,1848,18,30-34,1866,1.8380479372486418
STAT,1815,90,na,1905,5.558701181273019
SIM,1830,24,na,1854,1128
SIM,1882,49,na,1931,1693
STAT,1894,24,35-39,1918,7.374282938942781
STAT,1939,33,20-24,1972,2.4598431119095125
STAT,1827,91,na,1918,40.864311046223634
STAT,1918,45,na,1963,3874.9097475123453
SIM,1882,15,20-24,1897,148
SIM,1936,33,45-49,1969,1
SIM,1805,57,na,1862,2097
STAT,1905,45,40-44,1950,0.1402849097502598
SIM,1910,42,35-39,1952,1
STAT,1816,54,40-44,1870,0.029604868118593256
STAT,1880,38,na,1918,2433.7366811012107
STAT,1822,38,30-34,1860,10.371236704165954
STAT,1829,46,15-19,1875,1.874342261732758E-4
SIM,1829,38,50-100,1867,1
SIM,1835,23,na,1858,1372
SIM,1835,33,35-39,1868,2
STAT,1925,15,50-100,1940,0.45052534164081404
STAT,1835,105,na,1940,0.02218563578672495
STAT,1841,47,30-34,1888,0.10828176322533463
STAT,1941,23,35-39,1964,9.61681332764137
SIM,1875,20,na,1895,2077
STAT,1870,39,20-24,1909,0.7607503379503133
SIM,1857,25,35-39,1882,2
STAT,1897,66,na,1963,2371.580184862031
STAT,1885,85,na,1970,579.1344079476329
STAT,1928,33,45-49,1961,1.9514147595184819
STAT,1845,41,na,1886,1182.944462263093
STAT,1883,45,40-44,1928,0.16634380116341177
STAT,1854,25,45-49,1879,0.7215128964249746
STAT,1819,104,na,1923,0.015513920220008349
STAT,1911,48,20-24,1959,0.010315502319453856
STAT,1832,23,15-19,1855,4.318426236852054
STAT,1888,27,15-19,1915,0.5236470030497483
STAT,1893,52,na,1945,2678.3354250368584
STAT,1886,48,15-19,1934,4.0901500657627846E-4
SIM,1913,45,40-44,1958,2
SIM,1837,39,30-34,1876,7
SIM,1864,52,na,1916,2415
STAT,1821,36,20-24,1857,0.977418430952251
STAT,1900,22,35-39,1922,8.083805477324367
STAT,1835,48,50-100,1883,0.19338086088716658
STAT,1875,23,na,1898,2421.0511853374855
STAT,1896,37,15-19,1933,0.07402455100943105
STAT,1825,54,35-39,1879,0.010149027396932644
STAT,1921,24,45-49,1945,1.2479367308244504
STAT,1875,28,50-100,1903,0.6545573712356694
STAT,1844,21,40-44,1865,2.5961863929261666
SIM,1860,4,na,1864,2680
STAT,1904,53,na,1957,3064.314752817754
STAT,1922,17,15-19,1939,51.936805510009656
STAT,1914,25,15-19,1939,0.7065359858197086
SIM,1851,41,na,1892,1178
STAT,1886,22,35-39,1908,6.042931968880147
SIM,1913,37,40-44,1950,18
SIM,1824,54,40-44,1878,1
STAT,1911,38,20-24,1949,0.25049553291282173
STAT,1892,45,35-39,1937,0.09874909212249662
SIM,1842,64,na,1906,2187
STAT,1906,34,20-24,1940,2.228303823635752
SIM,1928,32,na,1960,4591
STAT,1937,18,20-24,1955,130.18714253906018
STAT,1931,35,40-44,1966,1.9720416262380422
STAT,1905,27,40-44,1932,4.308581077779517
SIM,1848,18,25-29,1866,76
STAT,1870,24,50-100,1894,0.4039947599899794
STAT,1804,59,na,1863,1911.7993726353957
SIM,1827,31,35-39,1858,50
STAT,1874,38,na,1912,2419.4647733312663
STAT,1878,31,40-44,1909,4.480148377935753
STAT,1829,39,30-34,1868,2.614940177167461
STAT,1955,8,na,1963,5171.685877441933
SIM,1852,67,na,1919,1806
STAT,1848,28,25-29,1876,46.917221574467966
STAT,1857,42,na,1899,1771.3726939693279
SIM,1833,60,na,1893,1984
STAT,1797,76,na,1873,15.435798301138597
STAT,1876,49,na,1925,2226.8947467174307
STAT,1913,29,40-44,1942,4.553257648333602
STAT,1850,108,na,1958,0.0016278120084950612
STAT,1924,22,20-24,1946,129.9477311684139
STAT,1903,46,20-24,1949,0.009635951654887604
STAT,1913,47,40-44,1960,0.15195515225689665
SIM,1916,47,na,1963,4553
SIM,1863,35,na,1898,883
STAT,1927,26,na,1953,4532.646779194556
STAT,1879,85,na,1964,503.7773180593344
SIM,1898,26,35-39,1924,208
STAT,1898,42,20-24,1940,0.014811685819740468
SIM,1912,33,na,1945,4586
STAT,1869,36,45-49,1905,2.021273218004618
STAT,1904,21,40-44,1925,2.9861174280947553
STAT,1909,43,35-39,1952,0.18530997186560033
STAT,1785,82,na,1867,72.63458333271922
STAT,1925,38,20-24,1963,0.31317817372180173
STAT,1888,35,15-19,1923,0.06542708011725819
STAT,1912,31,40-44,1943,3.8215109747510905
STAT,1945,22,50-100,1967,0.7131907324727508
SIM,1778,77,na,1855,830
STAT,1868,34,35-39,1902,9.69769316812718
STAT,1923,32,30-34,1955,17.871712378182576
SIM,1918,45,45-49,1963,2
STAT,1905,37,40-44,1942,1.3589907215310129
SIM,1934,32,na,1966,5188
STAT,1949,21,50-100,1970,0.7604783286890034
STAT,1840,25,15-19,1865,0.22598073593201082
STAT,1886,23,na,1909,2441.5585202495263
SIM,1889,19,25-29,1908,14
STAT,1919,40,40-44,1959,0.2681979979308672
STAT,1868,15,45-49,1883,0.06499888940616744
STAT,1851,44,35-39,1895,1.410862702623516
STAT,1931,17,40-44,1948,1.8179128915038174
SIM,1836,35,45-49,1871,1
STAT,1837,49,30-34,1886,0.07853263768937811
SIM,1904,66,na,1970,3720
STAT,1810,59,na,1869,73.5908242495041
STAT,1923,25,40-44,1948,5.33101434289037
SIM,1921,47,40-44,1968,7
STAT,1834,73,na,1907,523.448851332928
STAT,1866,26,50-100,1892,0.585927054552991
SIM,1876,34,35-39,1910,1
SIM,1901,17,na,1918,4078
STAT,1876,40,na,1916,2360.0264711703544
STAT,1936,17,15-19,1953,43.01854648126633
STAT,1847,34,15-19,1881,0.13473965586591533
STAT,1885,22,40-44,1907,2.0482785622070563
STAT,1851,37,45-49,1888,1.5913014289960576
STAT,1923,43,35-39,1966,0.2325122963204063
STAT,1860,42,35-39,1902,1.4754289672273604
STAT,1867,20,25-29,1887,55.15105125182669
SIM,1850,30,20-24,1880,5
STAT,1922,35,15-19,1957,0.021644613817308925
STAT,1903,28,20-24,1931,16.594308370680793
STAT,1934,5,na,1939,5401.678969738254
STAT,1895,26,45-49,1921,1.4493194469325614
STAT,1928,36,25-29,1964,1.2360020791823554
STAT,1939,11,na,1950,3919.8737868601715
SIM,1882,33,na,1915,1872
STAT,1897,70,na,1967,2170.046792286834
STAT,1905,35,50-100,1940,0.3847711715520976
STAT,1899,34,50-100,1933,1.2407552479016786
SIM,1889,12,na,1901,3895
SIM,1914,34,20-24,1948,14
SIM,1871,61,na,1932,1634
STAT,1852,50,35-39,1902,0.008790305882141747
STAT,1920,22,35-39,1942,10.333264829425664
SIM,1888,34,na,1922,327
SIM,1875,20,25-29,1895,1
STAT,1842,30,20-24,1872,0.8276183183692883
STAT,1828,53,45-49,1881,0.014926288992672931
STAT,1895,44,45-49,1939,0.1333744325051052
STAT,1908,6,na,1914,3845.1876983732923
SIM,1865,37,na,1902,1760
STAT,1840,73,na,1913,467.6830658972614
STAT,1840,18,30-34,1858,0.8077765915240861
STAT,1911,11,na,1922,3913.3191290465215
SIM,1897,29,25-29,1926,2
STAT,1866,16,25-29,1882,5.340809449142039
STAT,1915,25,na,1940,3792.5730005487535
SIM,1931,6,na,1937,5369
STAT,1901,19,20-24,1920,24.655367282366498
SIM,1807,49,45-49,1856,3
STAT,1811,45,na,1856,1870.915600570229
STAT,1833,40,20-24,1873,0.08493585056663717
SIM,1875,36,na,1911,2957
STAT,1894,20,40-44,1914,2.6657040715695515
STAT,1909,25,35-39,1934,14.42004519608197
STAT,1924,31,30-34,1955,18.215157633565234
STAT,1813,42,45-49,1855,7.492887048497235
SIM,1915,39,45-49,1954,1
STAT,1828,47,15-19,1875,4.7758212051151363E-4
STAT,1865,48,30-34,1913,0.087267068686483
STAT,1942,22,35-39,1964,9.759737991372608
STAT,1858,50,30-34,1908,0.004611073868542027
STAT,1828,46,50-100,1874,0.29713899237199476
STAT,1859,22,40-44,1881,1.7136029251833769
STAT,1814,89,na,1903,71.09860032023892
STAT,1822,45,50-100,1867,0.42224895466853785
STAT,1886,54,na,1940,2168.4568075486873
STAT,1882,40,na,1922,2235.1326572628286
STAT,1865,33,20-24,1898,2.4574540849286346
SIM,1884,13,na,1897,3855
STAT,1795,81,na,1876,253.10691807044756
STAT,1928,30,40-44,1958,4.86148169778213
SIM,1853,21,na,1874,3554
STAT,1931,29,30-34,1960,50.181189850495976
STAT,1878,52,45-49,1930,0.014851888907826682
SIM,1864,35,20-24,1899,4
STAT,1869,26,15-19,1895,0.4593941412762451
STAT,1910,41,35-39,1951,0.18926298826694693
STAT,1935,33,35-39,1968,12.544119481826328
STAT,1825,44,40-44,1869,2.894684826914761
STAT,1821,37,50-100,1858,1.5151201600360706
SIM,1836,40,na,1876,2013
STAT,1848,36,25-29,1884,2.8054886654052993
SIM,1857,35,na,1892,1416
STAT,1922,33,25-29,1955,10.282968834581421
STAT,1910,22,na,1932,3543.633370607028
STAT,1892,35,40-44,1927,5.471231336375305
STAT,1856,35,20-24,1891,0.558923176691336
SIM,1852,63,na,1915,1806
SIM,1917,25,35-39,1942,180
STAT,1841,17,30-34,1858,2.2891255635248062
STAT,1916,41,50-100,1957,0.11891958712949237
STAT,1842,37,na,1879,623.7141123787998
STAT,1829,55,na,1884,782.020380510554
STAT,1905,48,45-49,1953,0.1890686017958699
SIM,1788,67,na,1855,340
STAT,1851,41,30-34,1892,0.9121079148318008
STAT,1895,38,15-19,1933,0.0726875963289542
STAT,1826,101,na,1927,0.4549217202107225
STAT,1852,48,20-24,1900,0.01192728184284406
STAT,1836,23,35-39,1859,5.8590278592096325
SIM,1869,20,na,1889,3713
STAT,1861,48,50-100,1909,0.20168508258365042
STAT,1855,62,na,1917,1209.6591287959163
STAT,1915,35,25-29,1950,0.9899166988257803
STAT,1861,49,20-24,1910,0.009771347008451168
SIM,1948,22,30-34,1970,10
STAT,1918,20,50-100,1938,0.7042712505963528
STAT,1845,35,45-49,1880,1.1661052097810294
STAT,1845,21,35-39,1866,3.62077778402576
STAT,1893,36,50-100,1929,1.5427160898983323
SIM,1900,20,30-34,1920,40
SIM,1840,78,na,1918,1993
STAT,1853,76,na,1929,734.6060862016341
STAT,1915,19,50-100,1934,0.07689118878701404
STAT,1807,50,20-24,1857,0.0024543215105027913
STAT,1831,23,50-100,1854,1.024004197340333
STAT,1857,15,20-24,1872,16.179648242479566
STAT,1909,24,45-49,1933,1.0286245507510616
SIM,1886,1,na,1887,3181
STAT,1768,108,na,1876,0.01342643677684081
SIM,1866,87,na,1953,402
STAT,1900,27,40-44,1927,4.149711005949282
STAT,1859,40,40-44,1899,1.8007481125640525
STAT,1940,27,30-34,1967,39.5072731090582
SIM,1796,63,na,1859,1109
STAT,1891,17,na,1908,3105.8104665858773
STAT,1916,48,20-24,1964,0.011149221096686307
STAT,1924,46,na,1970,4342.459746944634
STAT,1871,25,45-49,1896,1.1150899635170701
STAT,1884,75,na,1959,1110.6173329919777
STAT,1924,36,40-44,1960,1.7498517495700288
STAT,1854,22,na,1876,1396.8415095063247
STAT,1844,23,50-100,1867,0.5007904466033162
SIM,1801,82,na,1883,1570
STAT,1814,40,50-100,1854,4.275050041201293
STAT,1943,16,45-49,1959,0.5238262580724651
STAT,1870,53,35-39,1923,0.008444852587636357
STAT,1869,54,45-49,1923,0.01424150786084592
STAT,1885,20,15-19,1905,3.2621217888185674
STAT,1914,19,30-34,1933,2.472948097277443
SIM,1885,53,na,1938,1103
STAT,1912,34,45-49,1946,1.5172978039894935
SIM,1879,39,30-34,1918,40
STAT,1820,96,na,1916,5.905148234721708
STAT,1844,47,50-100,1891,0.2421788534875675
STAT,1943,12,na,1955,4117.961590319665
SIM,1892,39,na,1931,3655
STAT,1878,68,na,1946,1572.315436077591
STAT,1887,12,na,1899,2842.4985531982784
STAT,1820,48,20-24,1868,0.01860683896533047
STAT,1902,35,15-19,1937,0.01722965730757286
STAT,1825,39,45-49,1864,2.732679413469104
STAT,1861,53,40-44,1914,0.008614670699526044
SIM,1833,44,40-44,1877,33
STAT,1909,18,45-49,1927,0.0967107107207181
SIM,1913,18,na,1931,3570
STAT,1907,39,45-49,1946,0.6214965446817804
SIM,1874,14,na,1888,2743
SIM,1932,36,40-44,1968,23
STAT,1888,41,50-100,1929,1.224835548581224
STAT,1891,38,30-34,1929,6.521427501401876
STAT,1874,41,20-24,1915,0.16464724584446602
STAT,1799,95,na,1894,0.8841362596671956
STAT,1924,45,na,1969,4352.077838968758
SIM,1893,20,15-19,1913,48
STAT,1880,33,45-49,1913,1.8027170672810393
STAT,1858,102,na,1960,0.5272815007241982
STAT,1877,24,35-39,1901,5.886631075309367
STAT,1839,52,50-100,1891,0.013956755911108312
STAT,1857,27,50-100,1884,0.5056091653626881
STAT,1825,51,30-34,1876,0.0074475285103939816
STAT,1874,69,na,1943,1514.6023828869695
STAT,1895,16,na,1911,3293.560730166276
STAT,1837,51,45-49,1888,0.011912324691209524
STAT,1870,55,na,1925,2061.3721615523687
SIM,1909,19,15-19,1928,14
STAT,1845,88,na,1933,68.12245288996003
STAT,1791,82,na,1873,214.89412602334627
SIM,1900,39,20-24,1939,1
SIM,1903,28,na,1931,2940
SIM,1824,55,na,1879,1862
STAT,1922,15,25-29,1937,49.82334803249058
STAT,1846,15,45-49,1861,0.049177500133590735
SIM,1808,93,na,1901,32
STAT,1902,29,15-19,1931,0.6343197257120258
STAT,1841,24,20-24,1865,95.82149521138875
STAT,1861,21,40-44,1882,1.793238336890017
STAT,1808,89,na,1897,24.603927113745936
STAT,1941,25,25-29,1966,67.37358065172472
STAT,1856,28,30-34,1884,18.60769224366071
STAT,1888,34,na,1922,2730.6132914825207
STAT,1885,17,na,1902,2482.5429274723583
STAT,1897,40,50-100,1937,0.09841188565228584
STAT,1889,37,25-29,1926,3.4672012650027533
STAT,1941,20,30-34,1961,29.384428026876456
SIM,1844,39,20-24,1883,4
SIM,1859,34,35-39,1893,4
STAT,1832,49,30-34,1881,0.007796604722437683
STAT,1830,39,50-100,1869,1.0968440521461225
STAT,1911,40,35-39,1951,0.19218185461402415
STAT,1836,39,20-24,1875,0.7101300992345636
STAT,1916,16,50-100,1932,0.07859704737426035
STAT,1790,102,na,1892,0.08524664391191178
STAT,1811,47,20-24,1858,0.05640163483632755
STAT,1896,53,na,1949,2792.8708027473167
STAT,1902,0,na,1902,4134.832866032633
STAT,1814,96,na,1910,5.81131713934834
STAT,1843,42,35-39,1885,1.8421476612299819
STAT,1877,35,50-100,1912,1.2581429867236054
STAT,1886,33,40-44,1919,4.471935660561937
STAT,1916,10,na,1926,4145.445748775746
STAT,1800,60,na,1860,1690.6751945980993
SIM,1865,15,20-24,1880,11
STAT,1869,48,15-19,1917,3.985607582884123E-4
SIM,1891,54,na,1945,1774
STAT,1851,29,45-49,1880,1.0120477446035425
STAT,1887,3,na,1890,2909.78541642151
STAT,1946,18,15-19,1964,49.77670499204532
STAT,1801,53,35-39,1854,0.021832898041974337
SIM,1830,40,45-49,1870,1
STAT,1908,28,na,1936,3501.5737300387427
STAT,1934,16,50-100,1950,0.504564794223559
STAT,1872,31,50-100,1903,0.9212407241262008
STAT,1850,37,30-34,1887,2.499965898138302
STAT,1826,81,na,1907,431.11697868191266
SIM,1913,39,30-34,1952,2
STAT,1905,39,30-34,1944,1.6379088794471106
STAT,1917,26,45-49,1943,1.7937246451690068
STAT,1932,38,40-44,1970,1.9953454722582196
STAT,1886,34,50-100,1920,0.9406947716055226
STAT,1831,24,15-19,1855,5.333875612617551
SIM,1827,42,40-44,1869,21
STAT,1906,23,15-19,1929,4.762460684067187
SIM,1923,32,na,1955,4244
STAT,1872,31,45-49,1903,1.7533291309344061
STAT,1877,22,30-34,1899,18.081611049302815
SIM,1819,77,na,1896,45
STAT,1878,34,45-49,1912,1.7788040752209986
STAT,1819,42,40-44,1861,0.5271487762012796
STAT,1900,48,50-100,1948,0.18950442446469848
STAT,1935,15,35-39,1950,5.7215701483599615
STAT,1907,42,50-100,1949,0.10691074917385066
STAT,1836,36,na,1872,2032.9611672474387
STAT,1950,21,30-34,1971,33.782682804203205
STAT,1820,52,40-44,1872,0.015969059021786924
STAT,1851,34,40-44,1885,3.491651089498523
STAT,1904,17,30-34,1921,2.2771547951471383
STAT,1916,32,35-39,1948,9.306013218382512
STAT,1897,36,20-24,1933,1.0286546155825125
STAT,1833,25,25-29,1858,27.854207362931913
STAT,1912,16,15-19,1928,9.092699880619897
STAT,1873,91,na,1964,148.1570704364941
STAT,1853,22,45-49,1875,0.6388542215782727
STAT,1884,43,35-39,1927,1.7209200500729513
STAT,1870,47,50-100,1917,0.24370528858342208
STAT,1893,8,na,1901,3250.8048851602725
STAT,1835,21,50-100,1856,0.41310424464449813
STAT,1876,48,50-100,1924,0.24515937789861705
STAT,1915,30,30-34,1945,15.946492404147264
STAT,1936,30,na,1966,3641.212200800086
STAT,1932,35,25-29,1967,1.3159930283824992
STAT,1815,42,50-100,1857,0.11224006279136174
STAT,1922,43,15-19,1965,0.0017402392810770622
STAT,1806,82,na,1888,152.94066613311952
SIM,1919,27,na,1946,5089
STAT,1852,9,na,1861,2966.050957978033
STAT,1847,38,30-34,1885,4.947827541016453
STAT,1880,27,15-19,1907,0.47101331171968575
STAT,1871,34,50-100,1905,0.9061696542580905
STAT,1822,40,45-49,1862,2.791543483153911
STAT,1857,73,na,1930,911.4355701243284
STAT,1869,54,na,1923,2112.9740734040156
SIM,1915,13,na,1928,3758
STAT,1823,42,50-100,1865,1.774358112450986
SIM,1931,31,na,1962,4981
STAT,1915,38,40-44,1953,1.483505398128468
SIM,1869,36,na,1905,3591
STAT,1867,24,40-44,1891,1.9583836098030258
SIM,1918,42,na,1960,4369
STAT,1868,1,na,1869,3430.4209165199995
SIM,1838,38,30-34,1876,5
STAT,1898,16,20-24,1914,23.89840501125568
SIM,1964,2,na,1966,5113
STAT,1865,61,na,1926,1706.0475868381263
STAT,1817,52,35-39,1869,0.0058231179293757405
STAT,1897,29,30-34,1926,33.20384833667922
SIM,1924,32,35-39,1956,29
STAT,1825,102,na,1927,0.1805408668308242
STAT,1931,38,45-49,1969,0.8955966766337887
STAT,1906,48,40-44,1954,0.13808466803801298
STAT,1874,39,50-100,1913,1.2543592704762059
STAT,1936,31,na,1967,3639.2095340896453
STAT,1796,59,na,1855,1766.6627799999997
SIM,1947,4,na,1951,4409
STAT,1936,32,40-44,1968,3.7633420484194295
SIM,1952,0,na,1952,6382
SIM,1848,58,na,1906,2307
SIM,1923,30,30-34,1953,89
SIM,1863,1,na,1864,1920
STAT,1812,49,25-29,1861,0.014366288051581605
STAT,1901,37,20-24,1938,0.23263638540129356
SIM,1841,25,25-29,1866,1
SIM,1839,25,20-24,1864,2
STAT,1845,50,40-44,1895,0.005299069829432089
STAT,1887,36,15-19,1923,0.0621053049823656
STAT,1900,21,20-24,1921,95.75168586033901
SIM,1932,39,45-49,1971,1
STAT,1835,58,na,1893,1496.3592551243976
STAT,1837,22,na,1859,2244.2983088342494
STAT,1868,30,40-44,1898,4.222377516439163
STAT,1914,45,35-39,1959,0.1266825041029744
STAT,1930,23,50-100,1953,0.834431277463216
SIM,1913,43,na,1956,2898
STAT,1827,32,45-49,1859,1.795191289784115
STAT,1856,24,15-19,1880,2.712617356903724
STAT,1877,50,na,1927,2217.134114301467
STAT,1945,19,30-34,1964,13.158911365966526
SIM,1890,25,20-24,1915,9
SIM,1862,25,na,1887,3812
STAT,1908,16,50-100,1924,0.07228936149173547
STAT,1848,53,25-29,1901,0.003261307266491165
STAT,1863,23,45-49,1886,0.6028164031044284
STAT,1919,22,50-100,1941,0.7109464824400352
STAT,1830,42,45-49,1872,1.3230697850329267
STAT,1858,53,35-39,1911,0.006468871606922167
STAT,1870,3,na,1873,3124.7171086877493
STAT,1850,49,45-49,1899,0.10670042107255955
STAT,1937,26,25-29,1963,63.52636736721543
SIM,1919,29,35-39,1948,3
STAT,1862,51,35-39,1913,0.0073677730217158
STAT,1833,43,25-29,1876,0.32979977343997396
SIM,1899,49,na,1948,1549
SIM,1940,30,30-34,1970,5
STAT,1859,25,45-49,1884,0.9082030143326926
STAT,1796,66,na,1862,1384.8169929753453
SIM,1832,59,na,1891,827
SIM,1855,38,30-34,1893,6
SIM,1864,9,na,1873,2555
STAT,1845,32,40-44,1877,2.558680912979404
STAT,1960,12,na,1972,5069.849488077292
SIM,1915,36,40-44,1951,2
STAT,1901,21,35-39,1922,8.18389036897145
SIM,1843,31,40-44,1874,2
STAT,1924,39,45-49,1963,0.7944512207097167
SIM,1884,72,na,1956,2823
STAT,1882,49,45-49,1931,0.2212311822384641
STAT,1862,29,20-24,1891,9.920742515227989
STAT,1874,26,25-29,1900,43.807702208919004
SIM,1890,68,na,1958,2950
STAT,1836,20,30-34,1856,28.31293275538749
STAT,1846,20,40-44,1866,1.544885921129861
SIM,1887,17,na,1904,3722
SIM,1922,45,35-39,1967,1
STAT,1861,105,na,1966,0.16480115318137578
STAT,1882,25,20-24,1907,11.308012126225412
STAT,1886,18,15-19,1904,6.129423373570328
SIM,1881,39,na,1920,3003
STAT,1885,45,50-100,1930,0.24381913990689197
STAT,1846,35,15-19,1881,0.0354596629968346
SIM,1892,32,na,1924,3524
STAT,1894,23,45-49,1917,0.8840148584471487
STAT,1909,49,20-24,1958,0.009992529018335507
STAT,1878,16,15-19,1894,6.1208728361747005
SIM,1870,29,20-24,1899,1
STAT,1880,30,40-44,1910,4.538370716973123
STAT,1932,30,30-34,1962,20.822024466062263
STAT,1825,37,na,1862,1758.4346036537593
STAT,1839,88,na,1927,127.54552943372958
STAT,1813,46,50-100,1859,0.921762311468308
STAT,1808,56,na,1864,676.5188895899237
STAT,1903,47,na,1950,3179.376158268171
SIM,1844,44,na,1888,2605
STAT,1887,21,40-44,1908,2.300517075052254
STAT,1871,22,40-44,1893,2.0786902300983017
SIM,1849,43,na,1892,2257
STAT,1835,31,40-44,1866,4.221075227550867
STAT,1915,32,20-24,1947,2.4490997793472467
SIM,1906,49,45-49,1955,4
STAT,1864,76,na,1940,861.2904902406036
STAT,1860,62,na,1922,1491.0487501116108
SIM,1796,59,na,1855,1195
SIM,1849,47,na,1896,2155
STAT,1859,30,15-19,1889,0.11451547935023126
STAT,1837,33,45-49,1870,1.7349974077393433
STAT,1830,24,45-49,1854,1.6378026024064107
STAT,1870,50,30-34,1920,0.006019572107269997
STAT,1869,9,na,1878,2739.001617331255
SIM,1879,13,na,1892,1848
STAT,1858,17,25-29,1875,5.05506952199131
SIM,1905,47,na,1952,2898
STAT,1846,51,na,1897,1281.3384806648191
STAT,1923,27,30-34,1950,44.51263527675922
STAT,1907,36,40-44,1943,1.3852565192331514
SIM,1931,23,15-19,1954,9
STAT,1902,15,45-49,1917,0.0924119403146006
STAT,1923,23,15-19,1946,6.109653537485789
STAT,1918,15,35-39,1933,0.9081661590012785
SIM,1893,24,na,1917,3461
SIM,1927,28,30-34,1955,2
STAT,1793,105,na,1898,0.004874912503880672
SIM,1897,38,na,1935,2558
STAT,1848,51,20-24,1899,6.938300894592417E-4
SIM,1870,21,na,1891,2481
SIM,1919,0,na,1919,5533
STAT,1909,21,40-44,1930,3.1025455238225605
STAT,1818,55,na,1873,1489.382595852461
SIM,1874,10,na,1884,2818
STAT,1887,49,na,1936,2425.086146359394
STAT,1890,48,40-44,1938,0.1154406503528096
STAT,1807,53,25-29,1860,0.011060019651212687
STAT,1926,16,na,1942,4485.089785055432
STAT,1857,69,na,1926,1126.1361811024615
STAT,1929,28,40-44,1957,5.78976085987282
STAT,1841,42,50-100,1883,1.2224557893878638
STAT,1839,46,25-29,1885,0.05522709688701903
SIM,1822,60,na,1882,867
STAT,1847,43,na,1890,2074.5360292990763
STAT,1919,28,30-34,1947,41.627146714625
SIM,1945,24,20-24,1969,2
STAT,1857,18,25-29,1875,5.0807993416224475
STAT,1848,33,20-24,1881,2.6565824099863424
STAT,1815,108,na,1923,1.2914676449418732E-4
STAT,1859,18,50-100,1877,0.044808705088960045
STAT,1918,33,35-39,1951,9.539382196706947
STAT,1841,42,20-24,1883,0.18376786726729305
STAT,1853,47,20-24,1900,0.0092612859035279
STAT,1779,101,na,1880,0.21378706911121667
STAT,1947,3,na,1950,4454.797061277547
STAT,1869,51,40-44,1920,0.010674088644849434
STAT,1830,44,15-19,1874,0.011899413390003067
SIM,1778,78,na,1856,830
STAT,1904,46,50-100,1950,0.19849185596183125
SIM,1874,45,40-44,1919,3
STAT,1883,48,45-49,1931,0.22418940112208485
STAT,1849,16,25-29,1865,5.912147323452735
STAT,1871,45,15-19,1916,4.029951451189117E-4
STAT,1905,17,15-19,1922,8.5357862565399
STAT,1882,18,30-34,1900,1.5219888727237574
STAT,1892,42,30-34,1934,1.4216447117301683
STAT,1870,17,na,1887,2541.8455824750736
STAT,1931,25,15-19,1956,0.9057986127628771
STAT,1890,31,50-100,1921,1.11374647360102
STAT,1879,37,15-19,1916,0.05760558686115645
STAT,1849,108,na,1957,0.0023685480071697937
STAT,1941,22,20-24,1963,113.60459658964854
SIM,1807,54,40-44,1861,2
SIM,1843,22,na,1865,320
STAT,1917,23,40-44,1940,3.5149612820773894
STAT,1866,87,na,1953,160.8211165735679
STAT,1925,4,na,1929,4831.093426595857
STAT,1886,36,45-49,1922,2.074291212473966
STAT,1879,29,50-100,1908,0.6515317987844955
STAT,1921,21,40-44,1942,3.7640366598348605
STAT,1937,24,20-24,1961,107.0896176593718
STAT,1900,45,40-44,1945,0.13511219203034455
STAT,1804,54,15-19,1858,1.4921614186039466E-4
STAT,1889,34,20-24,1923,3.2272221678830593
SIM,1864,21,na,1885,2159
STAT,1900,24,25-29,1924,78.80507009033231
SIM,1911,47,na,1958,2320
STAT,1846,39,30-34,1885,3.2285237751862392
SIM,1859,31,30-34,1890,8
SIM,1894,36,45-49,1930,2
STAT,1824,47,30-34,1871,0.01680038663139359
STAT,1848,21,na,1869,2453.8039223626315
STAT,1931,31,na,1962,4923.758179843724
SIM,1858,51,na,1909,2323
STAT,1833,42,25-29,1875,0.3342801120023762
STAT,1868,33,45-49,1901,1.6771992611624469
STAT,1884,68,na,1952,1462.9013290421287
STAT,1888,28,50-100,1916,0.7357108852121482
STAT,1872,25,15-19,1897,0.4574016427136063
STAT,1927,27,15-19,1954,0.8512450641103225
STAT,1945,26,20-24,1971,19.814116899797504
STAT,1845,53,45-49,1898,0.00708568201963993
STAT,1863,69,na,1932,1252.8598328466471
STAT,1860,25,na,1885,1996.3318710942976
SIM,1867,65,na,1932,1139
SIM,1857,16,25-29,1873,2
STAT,1817,70,na,1887,500.02107249726816
STAT,1836,21,30-34,1857,18.143769843155233
STAT,1884,40,30-34,1924,1.111650568602857
STAT,1945,18,30-34,1963,13.163518597475639
STAT,1898,19,25-29,1917,7.5792796367371125
STAT,1923,34,20-24,1957,2.7632744383171954
STAT,1856,53,20-24,1909,5.215032913696091E-4
STAT,1866,45,40-44,1911,0.15783255417638364
STAT,1800,97,na,1897,3.706714471063621
STAT,1937,19,35-39,1956,4.02796326407953
STAT,1889,15,50-100,1904,0.05927135569143541
STAT,1842,54,35-39,1896,0.002078381081096606
STAT,1914,35,40-44,1949,1.4878647371981346
STAT,1938,16,15-19,1954,44.39739412304458
STAT,1856,40,50-100,1896,0.7664568928153617
STAT,1913,35,50-100,1948,0.4130251882570445
STAT,1854,37,15-19,1891,0.031222929098977358
STAT,1920,28,20-24,1948,19.697039791865794
STAT,1914,17,40-44,1931,0.2853110049393629
STAT,1868,40,35-39,1908,1.766660424418372
STAT,1901,47,15-19,1948,3.140128566594568E-4
STAT,1940,25,40-44,1965,4.703759093090056
STAT,1848,54,25-29,1902,0.0032233782629818727
STAT,1842,92,na,1934,10.339236651350081
SIM,1908,28,na,1936,2779
STAT,1843,77,na,1920,854.0581103837568
STAT,1874,43,25-29,1917,0.6579612204082146
SIM,1869,31,40-44,1900,227
STAT,1882,43,20-24,1925,0.15095085637374306
STAT,1812,46,20-24,1858,0.0031594050770314863
STAT,1925,31,na,1956,4452.662962397592
STAT,1890,16,15-19,1906,7.2020553337854
STAT,1940,32,30-34,1972,16.12298931515275
STAT,1833,22,20-24,1855,64.3989790328372
STAT,1866,52,30-34,1918,0.005404672743921315
SIM,1839,28,25-29,1867,11
SIM,1817,41,40-44,1858,21
SIM,1926,13,na,1939,6267
SIM,1948,5,na,1953,5825
STAT,1903,22,35-39,1925,8.283529399703179
STAT,1919,29,30-34,1948,41.47562390058376
SIM,1896,53,na,1949,2599
SIM,1882,43,25-29,1925,1
STAT,1865,65,na,1930,1542.9206815582197
STAT,1826,74,na,1900,884.763501103423
STAT,1876,32,40-44,1908,4.384021542464973
STAT,1897,25,15-19,1922,0.6066283708814121
STAT,1831,37,na,1868,2107.609833381833
SIM,1864,2,na,1866,4116
STAT,1819,45,45-49,1864,0.04284486235488778
SIM,1879,50,na,1929,1085
STAT,1807,52,25-29,1859,0.011295197802124525
STAT,1825,96,na,1921,5.287772324878093
STAT,1953,17,15-19,1970,54.40759420207497
STAT,1920,46,20-24,1966,0.012088925447595105
SIM,1905,37,30-34,1942,15
STAT,1919,36,20-24,1955,0.2796915774201704
SIM,1927,29,30-34,1956,30
SIM,1946,16,15-19,1962,227
STAT,1842,47,45-49,1889,0.05859548408483547
STAT,1895,31,na,1926,3116.972449797355
STAT,1927,45,45-49,1972,0.2718666194833535
STAT,1900,31,50-100,1931,1.274448614599816
SIM,1945,26,25-29,1971,4
SIM,1878,72,na,1950,1359
STAT,1845,17,15-19,1862,3.7220017897311912
STAT,1938,34,15-19,1972,0.12766337654922957
STAT,1878,35,na,1913,2447.013370116104
STAT,1906,17,na,1923,3657.257972232227
STAT,1832,43,50-100,1875,0.0938623166992422
STAT,1906,43,35-39,1949,0.18077470984176772
SIM,1920,4,na,1924,4900
SIM,1918,17,na,1935,4461
STAT,1930,15,20-24,1945,174.85576795549963
STAT,1812,45,45-49,1857,0.06352780313520963
STAT,1934,31,40-44,1965,5.309926665383664
STAT,1877,21,30-34,1898,18.136201014356022
STAT,1858,52,na,1910,1635.5438576572778
SIM,1839,54,na,1893,439
STAT,1855,48,20-24,1903,0.00784224598203133
SIM,1881,39,25-29,1920,6
STAT,1882,46,40-44,1928,0.16437400334359734
STAT,1911,48,na,1959,3429.2442172870747
STAT,1950,18,40-44,1968,1.6375807881454505
STAT,1952,17,50-100,1969,0.4448753176470586
STAT,1881,88,na,1969,341.20373694975245
STAT,1910,45,15-19,1955,3.4144428931438283E-4
STAT,1880,17,20-24,1897,18.40495381007258
STAT,1867,23,50-100,1890,0.3844679608126175
STAT,1824,42,na,1866,534.3356002347795
STAT,1826,41,40-44,1867,3.4395264266364656
SIM,1912,26,na,1938,4688
SIM,1938,31,na,1969,4199
SIM,1879,19,na,1898,1779
STAT,1882,28,25-29,1910,40.35725498310925
STAT,1896,28,50-100,1924,0.8402925427019331
STAT,1900,41,25-29,1941,0.06205313081364285
STAT,1918,30,30-34,1948,16.648970519113195
SIM,1860,31,40-44,1891,12
STAT,1829,42,20-24,1871,0.07640390601460016
SIM,1928,26,25-29,1954,8
STAT,1873,39,25-29,1912,2.9236969208499173
SIM,1904,7,na,1911,4201
STAT,1893,25,35-39,1918,12.14811486170307
STAT,1844,32,45-49,1876,2.0659033946821226
SIM,1890,28,25-29,1918,18
STAT,1858,38,45-49,1896,1.5148037489262716
STAT,1883,53,na,1936,2038.236988397659
STAT,1871,20,50-100,1891,0.40921585752719997
STAT,1846,67,na,1913,938.8624820009238
SIM,1854,21,na,1875,1516
STAT,1787,108,na,1895,3.297814262178325E-4
STAT,1920,44,45-49,1964,0.1808437853006507
STAT,1923,45,25-29,1968,0.06169003744578797
STAT,1854,51,45-49,1905,0.008107766629002608
STAT,1885,54,na,1939,2058.310099701156
SIM,1823,45,na,1868,1332
SIM,1949,19,na,1968,3136
STAT,1826,34,35-39,1860,17.849891519564835
STAT,1854,86,na,1940,123.36708071952256
SIM,1928,11,na,1939,4638
STAT,1861,45,40-44,1906,0.1437967144285558
STAT,1896,16,na,1912,3337.503190747611
STAT,1935,37,15-19,1972,0.026659168763428467
SIM,1831,64,na,1895,1553
STAT,1842,19,40-44,1861,0.05762074973634925
STAT,1835,32,35-39,1867,9.755198397104799
SIM,1851,31,30-34,1882,1
STAT,1914,47,25-29,1961,0.05187664026836485
SIM,1926,30,30-34,1956,14
STAT,1855,32,20-24,1887,1.8215536340237677
SIM,1804,62,na,1866,845
STAT,1867,27,45-49,1894,1.050047041654118
STAT,1871,49,30-34,1920,0.09454607780703064
SIM,1924,41,50-100,1965,3
SIM,1827,69,na,1896,974
STAT,1873,69,na,1942,1505.3761024013065
STAT,1920,20,45-49,1940,1.2421602268115433
STAT,1808,93,na,1901,6.8446963389798965
STAT,1857,43,25-29,1900,0.4892068997354244
STAT,1867,35,35-39,1902,6.752601417202033
SIM,1890,75,na,1965,2631
STAT,1922,37,50-100,1959,0.4724115713077836
STAT,1851,26,40-44,1877,2.790143093147805
STAT,1855,34,na,1889,1575.0499924057717
STAT,1873,46,15-19,1919,4.1147645475772543E-4
SIM,1904,49,30-34,1953,1
STAT,1884,25,40-44,1909,2.8870251772635878
STAT,1911,19,15-19,1930,8.931170287743198
SIM,1842,36,na,1878,3114
STAT,1902,29,50-100,1931,0.8943513973598737
STAT,1852,31,40-44,1883,4.566909073751556
STAT,1899,39,45-49,1938,0.5817857774419707
SIM,1797,75,na,1872,802
SIM,1835,30,na,1865,1317
STAT,1853,50,30-34,1903,0.004681866845722676
STAT,1912,24,15-19,1936,5.221644048165552
STAT,1870,43,40-44,1913,2.2261791727629268
STAT,1837,19,30-34,1856,1.683299850699955
SIM,1845,19,30-34,1864,77
STAT,1919,20,35-39,1939,10.234344720845375
STAT,1909,47,15-19,1956,3.3504786043174516E-4
STAT,1821,52,45-49,1873,0.014978431380927536
STAT,1861,22,35-39,1883,4.985712674171798
SIM,1804,72,na,1876,464
STAT,1904,25,20-24,1929,16.874386699344253
STAT,1873,59,na,1932,1993.5659234324557
STAT,1803,52,40-44,1855,0.02299786556975291
STAT,1863,16,20-24,1879,17.372859192199808
SIM,1875,35,35-39,1910,6
STAT,1870,38,45-49,1908,1.9775155755437441
STAT,1849,45,40-44,1894,0.1456898573734741
STAT,1841,43,15-19,1884,0.015776392357920985
STAT,1930,15,na,1945,4747.186116460343
SIM,1856,22,na,1878,979
STAT,1928,34,20-24,1962,3.0228165712681485
STAT,1796,91,na,1887,34.11573799632882
SIM,1872,56,na,1928,2166
STAT,1830,48,30-34,1878,0.08167195680000806
STAT,1896,33,20-24,1929,3.548212511079516
STAT,1847,15,50-100,1862,0.05594080117760979
STAT,1881,38,20-24,1919,0.724338795132321
STAT,1846,19,25-29,1865,4.166523055455502
STAT,1889,78,na,1967,1323.983845774077
STAT,1847,15,na,1862,2621.023826049633
STAT,1895,17,50-100,1912,0.06373218667745004
STAT,1885,33,45-49,1918,1.7068554514084011
SIM,1892,32,30-34,1924,103
STAT,1895,5,na,1900,3409.1165225749896
STAT,1818,42,45-49,1860,2.926901460810458
STAT,1884,32,30-34,1916,16.713705531112517
SIM,1880,75,na,1955,3193
STAT,1893,73,na,1966,1798.642019749387
STAT,1904,18,30-34,1922,2.271188649583853
STAT,1864,46,20-24,1910,0.010940247685970473
SIM,1951,13,na,1964,2365
STAT,1882,50,50-100,1932,0.014667316807105249
STAT,1917,34,45-49,1951,1.611864229814143
SIM,1858,42,40-44,1900,2
STAT,1820,44,40-44,1864,3.5840099647184185
STAT,1817,41,30-34,1858,0.8581126271850773
STAT,1900,49,20-24,1949,0.009181211953607816
STAT,1916,26,40-44,1942,4.769933286055803
SIM,1909,34,na,1943,3991
STAT,1933,26,40-44,1959,6.14967515661978
STAT,1839,16,15-19,1855,7.255310301375023
STAT,1859,19,35-39,1878,0.4989016487736425
STAT,1903,26,15-19,1929,0.6462460046654676
STAT,1813,50,45-49,1863,0.0525269180921117
STAT,1790,72,na,1862,739.5267893223265
SIM,1884,33,35-39,1917,4
STAT,1894,47,45-49,1941,0.16849860242704753
STAT,1910,22,40-44,1932,3.122242188762366
STAT,1913,23,20-24,1936,110.5332710640319
STAT,1882,44,15-19,1926,0.01304320478808009
STAT,1860,24,40-44,1884,1.7273363957897347
STAT,1830,50,45-49,1880,0.012475446067075239
SIM,1811,44,na,1855,97
STAT,1905,15,25-29,1920,8.18844064848335
SIM,1817,42,35-39,1859,11
SIM,1904,23,20-24,1927,828
STAT,1876,30,15-19,1906,0.1451182408250516
STAT,1804,50,35-39,1854,0.05662058617409158
STAT,1840,21,20-24,1861,34.7567049618231
STAT,1825,36,40-44,1861,6.462561863570715
SIM,1915,28,40-44,1943,2
STAT,1938,15,20-24,1953,132.9199553696819
STAT,1805,75,na,1880,170.16404739543538
STAT,1838,17,25-29,1855,3.1952500096037797
SIM,1880,85,na,1965,2623
STAT,1814,47,20-24,1861,0.04102340401462926
STAT,1871,44,50-100,1915,1.039631760595272
STAT,1934,26,45-49,1960,2.3093660259386843
STAT,1920,26,15-19,1946,0.7670782647211818
STAT,1913,49,30-34,1962,0.08541496362291356
STAT,1932,32,50-100,1964,1.0914572518006551
STAT,1926,35,50-100,1961,0.5095999662240543
STAT,1875,27,40-44,1902,3.076001454060205
STAT,1902,20,40-44,1922,2.9518450746623084
STAT,1876,40,40-44,1916,2.2967545872832695
STAT,1915,29,50-100,1944,0.9937403137526006
STAT,1880,41,45-49,1921,1.5607739863913137
STAT,1918,45,15-19,1963,3.885365870245515E-4
STAT,1924,28,40-44,1952,5.355963060123173
SIM,1912,25,20-24,1937,14
SIM,1814,62,na,1876,2442
SIM,1833,36,40-44,1869,22
STAT,1927,29,20-24,1956,21.92210118321891
SIM,1898,20,15-19,1918,24
STAT,1810,66,na,1876,57.68493291502717
STAT,1929,42,25-29,1971,0.09182934594415922
STAT,1828,37,20-24,1865,1.0360429233564559
STAT,1804,52,45-49,1856,0.09166701804482524
SIM,1852,36,na,1888,2180
STAT,1838,32,na,1870,1148.4801498357879
SIM,1817,69,na,1886,1947
STAT,1875,54,na,1929,2150.184403339218
STAT,1911,4,na,1915,3980.3853700102422
STAT,1925,24,na,1949,4304.066120825566
STAT,1824,53,25-29,1877,5.856240229490107E-4
STAT,1895,28,20-24,1923,15.207402970118217
STAT,1821,50,35-39,1871,0.009245232050656308
STAT,1871,43,45-49,1914,1.4821790365749876
SIM,1918,11,na,1929,4480
SIM,1833,69,na,1902,1813
STAT,1865,51,20-24,1916,6.769372729985783E-4
STAT,1891,44,25-29,1935,0.7790197821210547
SIM,1861,19,na,1880,2519
SIM,1909,44,na,1953,3842
STAT,1874,17,na,1891,2606.593508373596
STAT,1869,22,35-39,1891,5.888477217407412
STAT,1870,22,45-49,1892,0.6951829795349158
STAT,1885,49,45-49,1934,0.2271325658684337
SIM,1810,96,na,1906,135
STAT,1951,18,50-100,1969,0.44184780127540235
SIM,1844,37,na,1881,2931
SIM,1906,38,40-44,1944,6
STAT,1834,34,40-44,1868,2.3978558228635434
STAT,1908,41,40-44,1949,0.23094622958865504
STAT,1788,108,na,1896,2.2117094873618138E-4
STAT,1807,51,50-100,1858,0.049185676236577526
STAT,1907,28,40-44,1935,4.35543261205325
SIM,1888,27,na,1915,426
STAT,1843,31,30-34,1874,20.955462673775703
STAT,1786,97,na,1883,1.8567306455254649
STAT,1848,86,na,1934,207.62608684967094
STAT,1865,18,50-100,1883,0.04582108630616487
STAT,1881,22,20-24,1903,65.077359630339
STAT,1823,45,20-24,1868,0.01926621577061184
STAT,1871,41,35-39,1912,1.8145391265278799
STAT,1881,54,25-29,1935,0.003252909632915211
STAT,1943,24,45-49,1967,1.1826357045456661
SIM,1869,29,na,1898,3577
STAT,1858,21,50-100,1879,0.35988876789769264
STAT,1908,36,45-49,1944,0.6363821020990915
STAT,1846,57,na,1903,1190.2257910083201
SIM,1859,74,na,1933,136
STAT,1890,36,20-24,1926,0.9376867849944323
SIM,1862,27,20-24,1889,31
SIM,1831,29,30-34,1860,18
STAT,1899,43,30-34,1942,0.10825674052802581
STAT,1866,71,na,1937,1218.4309811413348
STAT,1922,39,30-34,1961,2.04635231508875
STAT,1923,29,35-39,1952,16.933969459653255
STAT,1850,43,25-29,1893,0.2943814779173257
STAT,1909,7,na,1916,3867.3919943073556
STAT,1953,19,20-24,1972,162.4251990431037
STAT,1841,58,na,1899,2202.1833878723587
STAT,1866,37,40-44,1903,3.9958664910390875
STAT,1942,16,40-44,1958,1.4454188508093506
STAT,1854,27,20-24,1881,6.838119752082331
SIM,1924,11,na,1935,5281
SIM,1853,73,na,1926,2003
STAT,1855,17,25-29,1872,4.460783276365188
STAT,1862,53,45-49,1915,0.012162352203109737
STAT,1865,44,15-19,1909,0.01243806336288513
SIM,1874,41,na,1915,2461
STAT,1840,45,20-24,1885,0.004888510461604333
STAT,1843,24,40-44,1867,2.5473584569840666
STAT,1940,21,25-29,1961,93.07119415299583
SIM,1864,38,25-29,1902,3
STAT,1823,94,na,1917,15.788541414416857
STAT,1876,33,35-39,1909,10.19432998544011
SIM,1867,40,40-44,1907,1
STAT,1860,31,30-34,1891,14.301708677976228
STAT,1853,39,na,1892,1808.412159366595
STAT,1927,35,15-19,1962,0.023722074113723485
STAT,1872,48,20-24,1920,0.011865330154548787
STAT,1815,75,na,1890,72.58283745266813
SIM,1882,70,na,1952,1035
STAT,1935,24,na,1959,4933.698443186308
STAT,1944,26,50-100,1970,1.0641518582004734
STAT,1850,40,20-24,1890,0.0740737333346651
SIM,1838,37,na,1875,2131
STAT,1911,30,45-49,1941,1.5272080307238691
STAT,1914,31,25-29,1945,9.211754420551776
STAT,1856,38,25-29,1894,2.057736359315855
STAT,1891,19,50-100,1910,0.05992363088476435
STAT,1851,49,15-19,1900,3.09320662531759E-4
STAT,1894,22,30-34,1916,22.651141911838874
STAT,1934,34,45-49,1968,2.1311661345851323
STAT,1924,34,35-39,1958,10.545495240545367
STAT,1932,10,na,1942,5225.91044433253
SIM,1862,56,na,1918,3426
SIM,1907,49,na,1956,4377
STAT,1846,42,20-24,1888,0.09519742639628637
STAT,1898,40,45-49,1938,0.14116628907649845
STAT,1932,7,na,1939,5256.23340832892
STAT,1936,19,20-24,1955,127.82192202622791
STAT,1840,46,35-39,1886,0.05630659471497334
SIM,1869,23,40-44,1892,27
SIM,1848,21,na,1869,2680
STAT,1812,61,na,1873,184.7492385138963
STAT,1869,38,20-24,1907,0.7739915126645166
STAT,1831,108,na,1939,0.0014335985539941554
STAT,1884,28,45-49,1912,1.0591212554293896
STAT,1912,51,na,1963,3445.212017703232
STAT,1916,43,40-44,1959,0.25242584869875934
STAT,1834,41,30-34,1875,0.6186949643874206
STAT,1881,24,na,1905,2219.4467166948957
SIM,1792,66,na,1858,879
STAT,1908,12,na,1920,3801.253496267072
STAT,1893,22,30-34,1915,22.27475556622396
STAT,1877,54,35-39,1931,0.008498908065912745
STAT,1831,53,30-34,1884,0.004840902230492652
STAT,1881,46,20-24,1927,0.011364347761669285
STAT,1925,36,45-49,1961,0.8114650663226759
SIM,1944,19,20-24,1963,899
STAT,1921,18,30-34,1939,13.692937813637762
SIM,1893,40,35-39,1933,11
STAT,1898,44,25-29,1942,0.059155146130700886
STAT,1903,44,45-49,1947,0.1455380952358008
STAT,1812,42,40-44,1854,1.0901079258853583
STAT,1811,54,40-44,1865,0.04550328370706585
STAT,1800,76,na,1876,659.3915342429805
STAT,1840,102,na,1942,0.11543899884102383
STAT,1899,36,40-44,1935,6.007865591555004
STAT,1920,41,40-44,1961,0.2730877071721338
STAT,1855,53,50-100,1908,0.009835061163054297
STAT,1922,30,20-24,1952,2.74711710646419
STAT,1865,34,na,1899,2160.0276816236556
SIM,1842,34,40-44,1876,8
STAT,1922,47,30-34,1969,0.10126915445960792
STAT,1866,9,na,1875,2508.432165061831
STAT,1827,60,na,1887,1407.2008422413771
STAT,1873,36,20-24,1909,0.7945268653691083
STAT,1857,21,15-19,1878,2.9436571930469895
SIM,1889,19,na,1908,3662
STAT,1884,35,35-39,1919,6.835014767971543
SIM,1922,16,na,1938,2017
STAT,1912,42,45-49,1954,0.1586516544549938
STAT,1926,24,45-49,1950,1.3467472254602095
STAT,1864,49,25-29,1913,0.05127118276202615
SIM,1802,67,na,1869,170
STAT,1881,47,35-39,1928,0.13159232366095927
STAT,1824,50,20-24,1874,1.294351950148636E-4
SIM,1875,32,30-34,1907,28
STAT,1826,31,30-34,1857,37.530675631994036
STAT,1885,30,40-44,1915,4.29703747713517
STAT,1844,53,40-44,1897,0.010262166619113451
STAT,1817,44,35-39,1861,1.2851924871279912
STAT,1846,16,20-24,1862,13.268163707863401
STAT,1879,78,na,1957,879.4945254026502
SIM,1845,54,na,1899,2062
STAT,1938,18,40-44,1956,1.3645400096549436
STAT,1928,18,30-34,1946,15.201524360887422
STAT,1830,42,na,1872,1856.7237253831502
STAT,1858,35,40-44,1893,3.3746909478354765
STAT,1865,54,25-29,1919,0.003144898043967037
STAT,1867,40,30-34,1907,1.0982468158161496
SIM,1883,31,25-29,1914,86
STAT,1870,35,40-44,1905,4.405523762877847
STAT,1885,40,35-39,1925,1.7978984644412606
STAT,1875,35,40-44,1910,4.537738519563936
STAT,1891,41,20-24,1932,0.19618062340581405
STAT,1906,45,25-29,1951,0.04751863617427245
STAT,1876,17,45-49,1893,0.06603504492545606
STAT,1892,27,40-44,1919,3.708789185104359
STAT,1891,54,na,1945,2575.0696918019157
STAT,1858,112,na,1970,3.1673846281928615E-4
STAT,1918,37,15-19,1955,0.01996776303280276
STAT,1853,21,30-34,1874,16.4368177758494
STAT,1928,37,25-29,1965,1.2348773172902996
STAT,1842,32,25-29,1874,3.071608198847684
STAT,1875,31,25-29,1906,10.560622770449816
STAT,1831,47,20-24,1878,0.011316026143718426
STAT,1857,112,na,1969,2.716345957237126E-4
SIM,1844,53,35-39,1897,1
STAT,1863,41,45-49,1904,1.2834814124976486
STAT,1840,53,25-29,1893,0.0013722907019035147
STAT,1921,25,20-24,1946,20.23925972711886
STAT,1941,28,40-44,1969,4.764604233347875
SIM,1882,18,na,1900,2193
SIM,1925,36,50-100,1961,2
STAT,1882,36,na,1918,2266.493215196185
STAT,1920,25,na,1945,4084.11279725997
STAT,1933,18,40-44,1951,1.85480124725068
STAT,1862,20,na,1882,2092.0621285438683
SIM,1897,48,na,1945,2249
STAT,1819,47,50-100,1866,0.04575138706822058
STAT,1935,30,30-34,1965,21.664765310864176
STAT,1934,35,na,1969,5165.5076713225235
STAT,1871,51,45-49,1922,0.014546031989475437
STAT,1875,42,30-34,1917,1.1790859448151543
STAT,1853,22,50-100,1875,0.37359897422248384
STAT,1872,54,30-34,1926,0.005796728801511971
STAT,1841,45,50-100,1886,0.28186194361599337
STAT,1913,26,25-29,1939,64.98326901136198
SIM,1905,9,na,1914,3866
STAT,1859,16,30-34,1875,1.4751023667567096
SIM,1866,22,na,1888,2529
STAT,1873,53,20-24,1926,7.447891437202335E-4
STAT,1861,72,na,1933,1050.2776531734075
STAT,1883,33,25-29,1916,9.812244645487604
STAT,1873,53,na,1926,2173.212890160092
STAT,1886,30,25-29,1916,10.691988338446851
STAT,1948,24,50-100,1972,0.7472704612802212
SIM,1829,54,na,1883,1785
STAT,1862,43,35-39,1905,1.531202832479911
STAT,1877,47,45-49,1924,0.23845152192267052
SIM,1782,83,na,1865,514
STAT,1906,27,na,1933,3455.8560179079514
STAT,1843,27,45-49,1870,1.3500902718542622
STAT,1864,86,na,1950,201.70900350711204
SIM,1854,16,20-24,1870,78
STAT,1903,13,na,1916,3660.218517729761
STAT,1908,44,45-49,1952,0.15091167058190905
SIM,1944,7,na,1951,2552
STAT,1802,61,na,1863,1364.093094283814
STAT,1863,19,25-29,1882,4.9645016290221555
STAT,1870,46,45-49,1916,0.23594421205530056
STAT,1939,25,50-100,1964,0.9904911067828442
STAT,1817,60,na,1877,725.975371277241
STAT,1896,26,na,1922,3156.7794453465303
STAT,1808,51,30-34,1859,0.007827858642141675
STAT,1927,15,45-49,1942,0.6189223266834557
SIM,1815,39,40-44,1854,11
SIM,1868,7,na,1875,1405
STAT,1871,5,na,1876,2774.2565688049895
STAT,1825,58,na,1883,1304.652112366978
STAT,1873,28,50-100,1901,0.6538736521240329
STAT,1934,23,40-44,1957,4.486539039602603
STAT,1936,29,30-34,1965,37.08952752462015
STAT,1946,16,25-29,1962,47.55884646522623
SIM,1848,37,na,1885,2574
STAT,1899,46,35-39,1945,0.10817105457892934
STAT,1921,26,50-100,1947,1.099931022850431
STAT,1867,42,40-44,1909,2.1245888407234923
STAT,1868,32,30-34,1900,16.863832221898495
STAT,1914,37,30-34,1951,1.794422629076566
STAT,1841,27,25-29,1868,58.50715657939344
STAT,1834,30,25-29,1864,5.903516859837751
STAT,1925,19,45-49,1944,0.5947158853847531
STAT,1831,58,na,1889,1551.4767576659608
STAT,1833,29,40-44,1862,1.7483997647443172
SIM,1906,34,25-29,1940,12
STAT,1841,17,50-100,1858,0.07036245178654074
STAT,1888,52,na,1940,2471.9462326227726
SIM,1895,17,20-24,1912,200
STAT,1918,12,na,1930,4254.532641538396
STAT,1885,46,40-44,1931,0.1687587109725557
STAT,1817,37,45-49,1854,1.5762499973164414
STAT,1821,75,na,1896,519.8959730741558
STAT,1858,86,na,1944,169.43892036246186
STAT,1886,20,50-100,1906,0.42480700586809644
STAT,1801,105,na,1906,0.009727078040024761
STAT,1900,70,na,1970,2317.8717692484556
STAT,1849,52,30-34,1901,0.004988869408602767
STAT,1821,35,45-49,1856,2.5978627065959405
STAT,1890,46,15-19,1936,2.7392862942614504E-4
STAT,1936,36,20-24,1972,0.2564560640747713
SIM,1851,19,na,1870,1319
STAT,1926,10,na,1936,4830.869538142543
STAT,1894,21,na,1915,3016.614260039551
STAT,1859,43,45-49,1902,1.1776569252642837
SIM,1892,60,na,1952,3403
SIM,1929,16,15-19,1945,600
STAT,1816,42,25-29,1858,2.110621712403312
STAT,1856,57,na,1913,1443.4246091441166
STAT,1887,17,20-24,1904,19.51331919459626
STAT,1944,27,15-19,1971,0.7544112539766173
STAT,1827,31,30-34,1858,18.254851053879957
SIM,1867,43,45-49,1910,10
STAT,1908,33,40-44,1941,3.6498298045116466
SIM,1928,19,35-39,1947,16
SIM,1921,26,25-29,1947,10
STAT,1893,30,30-34,1923,22.00936599843384
STAT,1893,32,40-44,1925,5.423184623483158
STAT,1914,44,20-24,1958,0.017198621511198733
STAT,1890,39,25-29,1929,3.4504962456320123
STAT,1926,41,45-49,1967,0.20370787502121276
STAT,1871,40,40-44,1911,2.2663910391351414
STAT,1901,15,40-44,1916,0.25692602924967
SIM,1936,30,na,1966,3796
SIM,1904,35,na,1939,4093
STAT,1933,29,45-49,1962,2.2760909600333425
STAT,1885,20,30-34,1905,17.61303840371447
SIM,1828,26,20-24,1854,60
SIM,1834,41,40-44,1875,12
SIM,1867,35,na,1902,2299
SIM,1923,4,na,1927,4291
SIM,1919,34,na,1953,4974
STAT,1927,31,35-39,1958,11.156189714300455
STAT,1859,50,35-39,1909,0.0069215329895211935
SIM,1893,20,30-34,1913,826
STAT,1876,71,na,1947,1349.360662245223
SIM,1854,37,na,1891,1614
SIM,1859,32,50-100,1891,5
STAT,1821,42,35-39,1863,2.0399042267813434
SIM,1866,18,na,1884,3273
STAT,1926,41,na,1967,4545.798172025762
STAT,1823,48,25-29,1871,0.0885930450712048
SIM,1850,62,na,1912,954
STAT,1843,34,35-39,1877,11.781888320179409
STAT,1897,39,25-29,1936,0.817010652713207
SIM,1873,35,na,1908,2225
SIM,1899,40,na,1939,1799
SIM,1824,46,40-44,1870,1
STAT,1869,52,35-39,1921,0.00864099899090561
STAT,1921,32,45-49,1953,1.7303851361079063
STAT,1840,35,na,1875,1018.4032650317105
STAT,1903,41,40-44,1944,0.22272283002777948
STAT,1906,42,20-24,1948,0.015950108246414817
STAT,1941,14,na,1955,3998.584409376528
STAT,1838,93,na,1931,12.463819218959301
SIM,1883,55,na,1938,1967
SIM,1827,47,20-24,1874,1
STAT,1876,50,35-39,1926,0.008828032379320252
STAT,1949,20,30-34,1969,33.229652469474026
STAT,1931,31,25-29,1962,12.032743927879164
SIM,1908,31,40-44,1939,3
STAT,1839,38,25-29,1877,3.163594945399629
STAT,1883,37,40-44,1920,4.211346794262314
STAT,1808,47,45-49,1855,0.43134617375608
STAT,1802,95,na,1897,6.736412718530108
STAT,1874,21,15-19,1895,3.4150916464672694
SIM,1891,37,40-44,1928,3
STAT,1860,20,25-29,1880,53.67076536068854
STAT,1860,34,35-39,1894,8.190848784575454
STAT,1879,26,50-100,1905,0.6584739206418256
STAT,1913,45,30-34,1958,0.08632294906910781
STAT,1839,24,15-19,1863,3.881826931592001
STAT,1897,17,15-19,1914,7.881391666988219
SIM,1906,64,na,1970,3009
STAT,1816,46,40-44,1862,0.5282766451689
STAT,1814,53,30-34,1867,0.019240979996944612
STAT,1892,23,25-29,1915,70.65643349175703
STAT,1844,31,30-34,1875,20.900400742282272
STAT,1869,85,na,1954,276.6240870915675
STAT,1913,45,15-19,1958,3.567061005426537E-4
SIM,1889,1,na,1890,3967
STAT,1840,48,25-29,1888,0.022580085767317824
STAT,1945,14,na,1959,4242.062037596824
STAT,1872,32,20-24,1904,2.7067338046092786
STAT,1922,45,40-44,1967,0.17994708968089135
STAT,1824,39,50-100,1863,0.1987363162643899
STAT,1891,42,50-100,1933,1.2975497922372454
SIM,1887,55,na,1942,3006
STAT,1841,102,na,1943,0.32646941393051754
STAT,1936,25,15-19,1961,0.6694867674505612
STAT,1924,24,25-29,1948,107.27181518042586
STAT,1933,3,na,1936,5392.776954594877
STAT,1825,32,25-29,1857,17.75221343181398
STAT,1834,44,35-39,1878,0.9377469534467148
STAT,1830,26,20-24,1856,11.362099966395654
SIM,1871,39,30-34,1910,1
STAT,1846,26,na,1872,1561.1691925845496
SIM,1902,64,na,1966,2613
STAT,1861,50,50-100,1911,0.012740589103280804
STAT,1856,20,na,1876,1809.4835708347523
SIM,1782,76,na,1858,514
STAT,1853,43,40-44,1896,1.7314643426248422
SIM,1833,32,25-29,1865,34
SIM,1906,30,na,1936,3301
STAT,1932,32,20-24,1964,3.2199589491838454
SIM,1927,25,na,1952,1732
STAT,1827,53,na,1880,1616.4051354403396
SIM,1906,5,na,1911,3742
STAT,1867,43,35-39,1910,1.7001700162328586
SIM,1851,44,45-49,1895,1
STAT,1798,102,na,1900,0.12444338538813068
STAT,1864,48,na,1912,2019.6442681820804
SIM,1851,23,na,1874,1433
STAT,1858,52,40-44,1910,0.007996791209660238
STAT,1851,75,na,1926,813.0615030455077
STAT,1912,28,30-34,1940,38.02995662925833
SIM,1857,41,25-29,1898,11
STAT,1814,80,na,1894,418.6564111399145
STAT,1926,40,30-34,1966,0.15668987928461867
STAT,1848,90,na,1938,73.77699643731142
SIM,1930,38,35-39,1968,1
STAT,1840,50,20-24,1890,2.947346054713504E-4
SIM,1883,38,45-49,1921,21
SIM,1913,49,na,1962,2906
STAT,1848,31,15-19,1879,0.15702868820816
STAT,1926,21,40-44,1947,4.062069657020301
STAT,1922,38,35-39,1960,2.718774079370818
SIM,1926,39,20-24,1965,2
SIM,1912,47,30-34,1959,1
STAT,1919,47,25-29,1966,0.056770917438778996
SIM,1794,61,na,1855,830
STAT,1851,22,25-29,1873,53.99213616450784
STAT,1876,43,45-49,1919,1.5020362517528085
STAT,1912,20,35-39,1932,8.9722180213707
STAT,1827,53,40-44,1880,0.009133903502969443
STAT,1904,33,20-24,1937,2.2081161081541243
STAT,1904,47,30-34,1951,0.07764776424744889
STAT,1843,44,45-49,1887,1.4840205980629908
STAT,1875,38,45-49,1913,2.0368630571908937
STAT,1894,44,40-44,1938,0.19594477559840048
SIM,1837,80,na,1917,503
STAT,1837,52,20-24,1889,5.938334464691073E-4
STAT,1870,21,30-34,1891,17.811267124494194
STAT,1880,36,50-100,1916,1.2807212710955052
STAT,1840,43,30-34,1883,0.46620734968596694
STAT,1882,27,50-100,1909,0.6124480557832578
SIM,1895,74,na,1969,3703
STAT,1834,25,50-100,1859,0.3750439541383958
STAT,1846,51,50-100,1897,0.008987564774245026
STAT,1840,32,na,1872,1039.393448195442
STAT,1852,20,na,1872,2593.8429327890667
STAT,1882,67,na,1949,1517.7038159087308
STAT,1916,47,na,1963,3716.734866609791
SIM,1919,18,30-34,1937,160
STAT,1891,15,20-24,1906,21.902576691993634
STAT,1842,36,40-44,1878,1.2880762008160027
STAT,1837,53,na,1890,1698.7617051998848
STAT,1853,39,20-24,1892,0.5916918547782318
STAT,1895,37,na,1932,3064.825859049534
SIM,1921,37,na,1958,5161
STAT,1795,71,na,1866,733.9548177983268
STAT,1907,34,35-39,1941,8.411950604614882
STAT,1833,60,na,1893,784.6846634419999
STAT,1874,48,na,1922,2292.809493564046
SIM,1782,73,na,1855,514
SIM,1850,36,40-44,1886,27
STAT,1935,27,50-100,1962,1.3470300321474296
STAT,1886,38,20-24,1924,0.794293309260961
STAT,1905,41,25-29,1946,0.0644288107912415
STAT,1865,28,25-29,1893,38.484874138506235
STAT,1863,35,15-19,1898,0.048395130303940236
STAT,1819,47,20-24,1866,0.002235409880112592
STAT,1839,15,50-100,1854,0.06025010287938108
STAT,1862,40,30-34,1902,0.9891002776685892
STAT,1918,39,20-24,1957,0.27351936531845306
SIM,1849,16,na,1865,2604
STAT,1930,23,20-24,1953,141.01052663367344
STAT,1873,16,15-19,1889,6.123609320130561
SIM,1878,17,20-24,1895,184
STAT,1887,43,20-24,1930,0.1735385210133295
STAT,1808,54,35-39,1862,0.010591247380850948
STAT,1937,18,50-100,1955,0.35976542841725206
STAT,1954,0,na,1954,5204.864017433909
SIM,1887,48,na,1935,3447
SIM,1910,40,45-49,1950,3
STAT,1884,45,45-49,1929,0.22816857420951828
STAT,1879,15,20-24,1894,18.27113163593573
STAT,1893,33,35-39,1926,12.61073493554663
SIM,1889,40,na,1929,3846
STAT,1929,18,15-19,1947,57.361896085856635
STAT,1850,35,na,1885,1128.3180762387394
STAT,1845,37,20-24,1882,0.4018980022912455
STAT,1895,40,50-100,1935,1.3881764610486185
STAT,1898,22,15-19,1920,4.43625301596538
STAT,1910,25,45-49,1935,1.6748916591549288
SIM,1890,37,na,1927,3655
SIM,1848,68,na,1916,2307
SIM,1821,40,35-39,1861,22
STAT,1840,42,na,1882,949.3265877855094
STAT,1846,20,na,1866,1585.156681441537
STAT,1833,54,50-100,1887,0.006411894384945508
STAT,1815,68,na,1883,125.61457092225471
STAT,1912,35,20-24,1947,0.2567133125496675
SIM,1879,29,na,1908,1550
STAT,1878,46,15-19,1924,4.127158057666179E-4
SIM,1899,43,na,1942,1776
STAT,1880,31,35-39,1911,10.556423309498733
STAT,1862,47,15-19,1909,3.391077801617363E-4
STAT,1920,22,na,1942,4007.5750573491873
STAT,1927,22,50-100,1949,0.8040827391218118
SIM,1866,0,na,1866,3647
STAT,1890,30,15-19,1920,0.17378553876687206
STAT,1842,53,50-100,1895,0.003688977031211428
STAT,1820,80,na,1900,425.4161505759809
STAT,1820,105,na,1925,0.020164180081893544
STAT,1863,39,30-34,1902,4.504133101354156
SIM,1905,17,25-29,1922,40
STAT,1858,45,35-39,1903,0.10797887877324862
STAT,1906,29,35-39,1935,13.87247428416846
SIM,1919,37,na,1956,4843
SIM,1865,47,40-44,1912,3
STAT,1822,48,50-100,1870,0.40503492680619674
SIM,1874,30,20-24,1904,16
STAT,1812,50,45-49,1862,0.0037171212523768892
STAT,1871,27,20-24,1898,11.702634494152507
SIM,1868,41,na,1909,1143
STAT,1842,15,25-29,1857,1.827900573127515
STAT,1877,44,40-44,1921,2.252465603620694
STAT,1832,51,25-29,1883,2.890664118298332E-4
STAT,1915,19,35-39,1934,0.8611814739709829
STAT,1909,40,30-34,1949,0.11970337354337963
STAT,1877,51,30-34,1928,0.006071465438016585
STAT,1844,93,na,1937,28.953272960060644
STAT,1900,45,50-100,1945,0.19382917253749
SIM,1856,56,na,1912,158
STAT,1852,33,30-34,1885,18.00857520832754
STAT,1878,53,20-24,1931,7.470324195286276E-4
STAT,1906,46,50-100,1952,0.20118373007322737
STAT,1925,16,40-44,1941,1.678295007997911
STAT,1865,92,na,1957,48.912037135888106
STAT,1827,49,20-24,1876,0.010706879781914199
STAT,1889,32,15-19,1921,0.17149088324096357
STAT,1921,47,30-34,1968,0.09930393232905453
STAT,1864,40,15-19,1904,0.012681281497777318
STAT,1857,47,40-44,1904,0.13075981121928992
STAT,1837,22,40-44,1859,2.187282115847717
STAT,1847,26,15-19,1873,0.4966052803026198
STAT,1806,61,na,1867,842.7191080879353
SIM,1900,23,35-39,1923,94
STAT,1853,51,45-49,1904,0.011306602015717026
SIM,1939,10,na,1949,4762
STAT,1852,42,45-49,1894,1.5046451878353013
SIM,1860,33,30-34,1893,77
STAT,1932,19,35-39,1951,5.488078420171523
STAT,1902,40,45-49,1942,0.14782650375100678
STAT,1838,16,50-100,1854,0.027788307407680995
STAT,1826,42,35-39,1868,2.720707377503698
SIM,1844,75,na,1919,719
STAT,1837,45,15-19,1882,3.415786289158043E-4
STAT,1841,53,25-29,1894,0.0038809323165537386
STAT,1870,51,45-49,1921,0.014537129816921839
STAT,1862,37,20-24,1899,0.6565636209234523
SIM,1899,33,na,1932,1845
STAT,1868,54,40-44,1922,0.009888726937175034
STAT,1817,54,45-49,1871,0.009434365574872
STAT,1876,33,na,1909,2402.160930074645
STAT,1909,62,na,1971,3041.6298095543466
STAT,1930,37,30-34,1967,2.3606091085668135
SIM,1874,37,40-44,1911,11
STAT,1950,2,na,1952,4683.837150396391
STAT,1861,32,45-49,1893,1.45023744436078
SIM,1869,27,20-24,1896,21
SIM,1876,70,na,1946,1427
STAT,1916,46,45-49,1962,0.22042592725305288
STAT,1905,43,15-19,1948,0.001369360863567662
STAT,1831,31,20-24,1862,2.9176061930423436
STAT,1856,16,15-19,1872,5.070004665344732
STAT,1907,33,na,1940,3496.6581361428025
STAT,1820,40,50-100,1860,1.8089912896791163
STAT,1931,33,15-19,1964,0.16709611816844758
STAT,1826,43,30-34,1869,1.6973531511899551
STAT,1854,49,30-34,1903,0.05269873839831771
SIM,1949,1,na,1950,4615
STAT,1826,46,50-100,1872,0.3561793606172416
STAT,1912,18,20-24,1930,27.025460078357064
SIM,1838,68,na,1906,1075
STAT,1821,46,15-19,1867,4.3357675625963133E-4
SIM,1873,28,25-29,1901,1
SIM,1927,2,na,1929,2100
STAT,1923,42,20-24,1965,0.020424197401297462
SIM,1966,0,na,1966,5088
STAT,1925,22,35-39,1947,11.16765873411153
SIM,1851,20,25-29,1871,22
SIM,1920,18,20-24,1938,293
STAT,1922,48,45-49,1970,0.2462095016857921
STAT,1920,15,na,1935,4311.519017958014
STAT,1853,46,45-49,1899,0.1835112802333153
STAT,1893,34,30-34,1927,21.64692949731197
STAT,1868,43,50-100,1911,1.0130249772216386
SIM,1903,12,na,1915,2994
STAT,1917,31,40-44,1948,4.059688762382281
STAT,1923,29,na,1952,4225.327090475379
STAT,1800,66,na,1866,1351.7613744583962
STAT,1877,40,25-29,1917,0.6584442414850902
STAT,1790,65,na,1855,1077.0811999999999
STAT,1867,40,15-19,1907,0.013192154878785917
STAT,1943,18,50-100,1961,0.39263400693934086
STAT,1903,30,35-39,1933,14.491035952735487
STAT,1919,44,20-24,1963,0.01882121734989234
STAT,1892,20,20-24,1912,85.82920207461247
SIM,1922,2,na,1924,3868
SIM,1876,43,50-100,1919,19
STAT,1904,1,na,1905,3888.7195758453618
STAT,1823,39,na,1862,2234.2041860106146
STAT,1833,87,na,1920,72.48732824511849
SIM,1912,36,25-29,1948,6
STAT,1860,89,na,1949,85.70184039544374
STAT,1821,105,na,1926,0.014807440833879987
STAT,1816,49,45-49,1865,0.6974640835737808
STAT,1843,41,40-44,1884,2.3177010968669483
STAT,1901,18,45-49,1919,0.09109562100894242
STAT,1836,32,50-100,1868,0.8874617288692993
SIM,1829,61,na,1890,1724
STAT,1904,36,25-29,1940,0.8921355833636251
STAT,1913,48,35-39,1961,0.12391694170344861
STAT,1852,23,50-100,1875,0.48412618992140816
STAT,1815,65,na,1880,140.48180971774315
STAT,1853,53,35-39,1906,0.006568187014375873
STAT,1905,48,na,1953,3195.9259343942126
STAT,1943,21,40-44,1964,3.5376468156060663
STAT,1806,54,na,1860,984.9566382397264
STAT,1895,47,na,1942,2913.6528834064825
STAT,1926,0,na,1926,5476.167296470944
STAT,1830,40,35-39,1870,1.6423558495911168
STAT,1835,42,45-49,1877,1.3568399832178837
STAT,1854,45,15-19,1899,2.2462418559296754E-4
SIM,1839,16,na,1855,1150
SIM,1937,25,na,1962,2988
STAT,1884,21,25-29,1905,54.96508879717073
STAT,1861,48,45-49,1909,0.19380162690518243
SIM,1860,32,35-39,1892,44
SIM,1817,76,na,1893,1657
SIM,1873,25,20-24,1898,11
STAT,1882,51,20-24,1933,7.09871884617644E-4
STAT,1820,47,45-49,1867,0.3708382021167361
SIM,1918,48,na,1966,4369
STAT,1896,7,na,1903,3434.4551086998354
STAT,1842,39,45-49,1881,0.5174174573202301
STAT,1816,54,na,1870,2238.0142144872084
STAT,1872,74,na,1946,1111.2974349410813
STAT,1828,38,na,1866,1854.6969240439169
SIM,1903,49,na,1952,2562
SIM,1867,42,30-34,1909,1
SIM,1893,55,na,1948,2793
STAT,1777,83,na,1860,331.06639271677085
STAT,1898,35,50-100,1933,1.6666457403860535
SIM,1832,27,25-29,1859,1
SIM,1848,23,20-24,1871,12
STAT,1813,48,30-34,1861,0.3489009582734267
STAT,1873,52,25-29,1925,0.003613982595297128
STAT,1893,30,15-19,1923,0.1795162283319536
SIM,1907,26,40-44,1933,294
STAT,1852,32,35-39,1884,10.554444465997776
STAT,1926,43,35-39,1969,0.24572630297808323
STAT,1849,48,45-49,1897,0.19635310510930726
STAT,1822,34,15-19,1856,0.31800380650662935
STAT,1875,45,35-39,1920,0.1451925302442785
SIM,1900,38,na,1938,4139
SIM,1902,19,15-19,1921,53
STAT,1787,83,na,1870,62.458096108008505
SIM,1820,62,na,1882,37
STAT,1801,55,na,1856,967.856980127268
STAT,1880,39,30-34,1919,5.477238476058163
SIM,1832,43,na,1875,1889
STAT,1951,14,na,1965,4632.403420476474
STAT,1938,28,na,1966,3669.827909908841
STAT,1865,102,na,1967,1.6549793487218583
STAT,1898,27,25-29,1925,56.883431062600934
STAT,1918,41,35-39,1959,0.21151356682415673
STAT,1858,42,30-34,1900,0.8768796720067763
SIM,1853,42,na,1895,3113
STAT,1860,27,45-49,1887,0.9154817013719367
STAT,1883,16,25-29,1899,5.4650268597894645
SIM,1943,25,na,1968,4975
STAT,1886,33,na,1919,2460.7164174912064
STAT,1938,18,25-29,1956,42.27637176542564
SIM,1922,26,na,1948,3334
STAT,1887,18,na,1905,2772.583701620184
STAT,1931,37,30-34,1968,2.396794467790308
STAT,1855,54,30-34,1909,0.0038312775591124106
SIM,1870,40,30-34,1910,6
STAT,1859,42,30-34,1901,0.9100966951647083
STAT,1849,46,50-100,1895,0.20752810780632835
STAT,1817,39,na,1856,998.515239105241
STAT,1889,47,na,1936,2697.1849632229773
STAT,1948,15,30-34,1963,13.813657676798831
SIM,1912,23,na,1935,3624
STAT,1884,42,40-44,1926,2.1505187712130196
STAT,1831,47,50-100,1878,0.23160132590506788
SIM,1820,58,na,1878,318
STAT,1891,18,25-29,1909,6.950281311516541
STAT,1930,26,25-29,1956,83.14310492176544
SIM,1866,42,30-34,1908,7
SIM,1955,10,na,1965,3825
STAT,1893,33,50-100,1926,1.1409553165059154
STAT,1809,52,45-49,1861,0.11984043573693592
STAT,1876,30,30-34,1906,17.792043120810717
STAT,1879,18,25-29,1897,5.797925355326942
STAT,1812,52,35-39,1864,0.0021181358811523778
SIM,1855,16,na,1871,3382
STAT,1870,31,25-29,1901,10.25292100137943
STAT,1922,35,30-34,1957,2.0542703795692483
SIM,1792,76,na,1868,282
STAT,1845,31,50-100,1876,0.546231286120014
SIM,1851,57,na,1908,1047
STAT,1834,79,na,1913,308.0993657717948
STAT,1859,17,45-49,1876,0.060098922773750785
SIM,1876,15,na,1891,3892
STAT,1838,38,na,1876,1090.7847639522606
STAT,1933,29,na,1962,4935.472091303181
STAT,1898,48,40-44,1946,0.1282290181298256
SIM,1833,28,na,1861,2232
STAT,1907,17,35-39,1924,0.8006197896311829
STAT,1852,28,50-100,1880,0.7445996860838204
STAT,1884,34,50-100,1918,0.869587226337252
STAT,1916,29,45-49,1945,1.7493323012141861
SIM,1819,42,50-100,1861,3
STAT,1841,50,20-24,1891,8.335296986227801E-4
STAT,1866,23,30-34,1889,16.27444936258903
SIM,1892,70,na,1962,3096
STAT,1935,14,na,1949,5360.282037782266
STAT,1924,44,50-100,1968,0.13793547679304816
SIM,1842,44,35-39,1886,1
STAT,1875,92,na,1967,138.59885344702678
STAT,1867,44,30-34,1911,1.0725996282707198
STAT,1850,17,25-29,1867,3.197538712765192
STAT,1885,32,30-34,1917,17.162018029768365
STAT,1856,19,na,1875,1926.594061013281
SIM,1819,61,na,1880,1842
STAT,1830,80,na,1910,447.7228762355801
STAT,1881,44,30-34,1925,1.0710318957306784
SIM,1884,41,na,1925,3681
STAT,1845,54,20-24,1899,3.560987696709054E-4
STAT,1871,34,na,1905,2360.0689283503843
STAT,1915,16,30-34,1931,2.5211916114535717
STAT,1899,32,25-29,1931,13.990038244349304
STAT,1905,47,30-34,1952,0.07817084887507102
SIM,1886,70,na,1956,1796
STAT,1796,97,na,1893,2.1038762947171223
STAT,1881,49,25-29,1930,0.05325871660172403
STAT,1910,2,na,1912,3994.0496315394776
SIM,1945,6,na,1951,6372
STAT,1825,68,na,1893,941.0833803025049
STAT,1902,23,45-49,1925,0.9789064486438172
STAT,1902,34,na,1936,3359.878110359466
STAT,1857,26,25-29,1883,33.6765964357571
SIM,1819,35,45-49,1854,5
STAT,1914,15,na,1929,3958.004663990368
SIM,1851,41,40-44,1892,1
STAT,1907,24,25-29,1931,83.0039994980031
STAT,1854,93,na,1947,16.249835562966343
SIM,1881,23,na,1904,2535
STAT,1904,63,na,1967,2812.8647086770566
STAT,1835,45,50-100,1880,0.22083302690366527
STAT,1864,45,50-100,1909,0.22550244100784608
STAT,1928,19,50-100,1947,0.4659749104539513
STAT,1942,19,45-49,1961,0.5157306374097629
STAT,1862,50,40-44,1912,0.009095688098306841
SIM,1889,24,20-24,1913,730
STAT,1933,24,35-39,1957,12.396540736287943
STAT,1894,20,50-100,1914,0.5216642398257605
STAT,1817,51,40-44,1868,0.007263479857237296
STAT,1881,51,20-24,1932,7.00186697766126E-4
STAT,1913,40,20-24,1953,0.017198817970892236
STAT,1929,16,25-29,1945,55.05195190344503
STAT,1798,105,na,1903,0.01244568499991201
STAT,1917,33,na,1950,3891.045938956452
STAT,1781,98,na,1879,0.6294257606902018
SIM,1893,32,30-34,1925,68
STAT,1845,51,35-39,1896,0.004292401334292193
SIM,1934,11,na,1945,5305
SIM,1949,10,na,1959,4491
SIM,1915,24,25-29,1939,4
STAT,1818,41,30-34,1859,2.3100507979146414
STAT,1927,39,30-34,1966,2.2427621805155584
STAT,1833,94,na,1927,8.223015846142152
SIM,1913,12,na,1925,3634
STAT,1863,60,na,1923,1628.182736745425
STAT,1925,33,40-44,1958,4.601687350737411
STAT,1793,79,na,1872,252.8500360589398
SIM,1933,33,40-44,1966,92
STAT,1834,37,45-49,1871,1.0928100308095987
SIM,1863,42,na,1905,784
STAT,1843,20,25-29,1863,72.02650090474556
STAT,1866,29,50-100,1895,0.5797497757197634
STAT,1928,42,50-100,1970,0.1486265376032437
STAT,1878,26,45-49,1904,1.1462769878736114
STAT,1910,43,50-100,1953,0.10912703249014584
STAT,1877,18,na,1895,2557.077032974219
STAT,1889,15,15-19,1904,7.179738338951347
STAT,1946,20,15-19,1966,5.863715979601469
STAT,1824,49,35-39,1873,0.023758185290436887
STAT,1917,26,na,1943,3889.5097257381376
SIM,1855,53,na,1908,2949
STAT,1903,2,na,1905,3783.9341771606687
STAT,1777,102,na,1879,0.21855012495531456
STAT,1882,45,35-39,1927,0.13537373224811072
STAT,1845,51,40-44,1896,0.005248993619543955
STAT,1863,31,35-39,1894,8.680932164640508
SIM,1859,43,na,1902,1824
STAT,1889,48,25-29,1937,0.038635083233147134
STAT,1913,12,na,1925,3987.2324790894118
SIM,1896,75,na,1971,891
STAT,1829,47,15-19,1876,1.8501608643926238E-4
STAT,1849,28,30-34,1877,24.971432868859974
STAT,1841,46,30-34,1887,0.10967796370327737
SIM,1837,40,na,1877,1967
STAT,1937,35,20-24,1972,0.2613243999139086
STAT,1840,28,40-44,1868,1.460126046846427
STAT,1851,39,50-100,1890,0.9599028990382105
STAT,1850,20,15-19,1870,1.8549616072847455
STAT,1955,15,15-19,1970,59.75215284810817
STAT,1839,94,na,1933,18.56838722841252
STAT,1840,17,30-34,1857,0.8125625851506233
STAT,1878,45,15-19,1923,4.1565029686246684E-4
STAT,1815,54,35-39,1869,8.097031552201406E-4
STAT,1836,28,20-24,1864,11.548639109171718
STAT,1798,95,na,1893,5.643529850488788
STAT,1828,54,45-49,1882,0.014633233785960513
STAT,1804,53,20-24,1857,0.004567829292943634
STAT,1809,72,na,1881,1388.3222272067576
SIM,1842,27,na,1869,3216
STAT,1882,8,na,1890,2488.83223756289
STAT,1850,31,25-29,1881,4.999322541205944
STAT,1911,21,40-44,1932,3.1624443596447147
SIM,1847,58,na,1905,1382
STAT,1824,41,25-29,1865,0.10872089016119663
STAT,1857,34,15-19,1891,0.10834255933632993
STAT,1939,32,20-24,1971,2.4613691607892028
STAT,1893,48,45-49,1941,0.16438307045434922
STAT,1792,82,na,1874,216.63635228619236
STAT,1866,15,50-100,1881,0.04644771280260786
STAT,1905,17,na,1922,3632.6311652694244
STAT,1871,55,na,1926,2062.6344940011
STAT,1929,11,na,1940,5028.7328626433255
STAT,1915,0,na,1915,4633.333967392851
STAT,1884,42,35-39,1926,1.731307897457698
SIM,1848,22,20-24,1870,7
STAT,1843,54,40-44,1897,0.010115746343644842
STAT,1849,15,25-29,1864,5.9471761912190155
SIM,1878,39,30-34,1917,40
STAT,1842,25,40-44,1867,0.9329616085050169
SIM,1874,23,30-34,1897,2
STAT,1876,48,15-19,1924,3.9928203901426316E-4
STAT,1875,18,30-34,1893,1.6323803131126529
STAT,1953,18,15-19,1971,54.39018377193029
STAT,1843,43,30-34,1886,1.15467329046459
STAT,1892,19,45-49,1911,0.08044167224075023
SIM,1850,22,na,1872,980
STAT,1817,51,35-39,1868,0.005939761579195561
STAT,1824,30,15-19,1854,0.0725790346408125
STAT,1910,33,50-100,1943,0.7849594187743517
STAT,1921,43,15-19,1964,0.0017064683192685973
STAT,1860,50,25-29,1910,0.002931070371876217
STAT,1909,48,20-24,1957,0.010023501638398154
STAT,1834,63,na,1897,786.3522781608303
SIM,1821,65,na,1886,1753
STAT,1847,18,25-29,1865,6.3568259002791505
STAT,1853,17,40-44,1870,0.17060138944316827
STAT,1885,63,na,1948,1753.8807166788192
STAT,1897,42,45-49,1939,0.13785419485347525
SIM,1814,71,na,1885,871
STAT,1882,47,30-34,1929,0.09224524681405123
STAT,1829,38,30-34,1867,2.65793924117126
STAT,1801,92,na,1893,13.817115519738895
STAT,1850,33,20-24,1883,1.2922217783953611
SIM,1872,49,na,1921,2251
STAT,1833,36,25-29,1869,1.577993806184996
STAT,1855,37,15-19,1892,0.037165137044993295
STAT,1948,17,50-100,1965,0.42437503887959976
STAT,1939,30,25-29,1969,9.337326790112371
SIM,1861,17,40-44,1878,1
STAT,1831,39,25-29,1870,2.8524543823170245
STAT,1851,18,45-49,1869,0.06235603785163845
SIM,1867,34,25-29,1901,6
STAT,1880,49,50-100,1929,0.24964713867052393
SIM,1897,17,na,1914,2909
STAT,1896,29,30-34,1925,32.9582467254264
SIM,1910,39,50-100,1949,6
STAT,1843,41,35-39,1884,1.8659005755568199
STAT,1895,45,45-49,1940,0.17490339695014856
STAT,1927,28,15-19,1955,0.8482486814846546
STAT,1877,21,50-100,1898,0.4152061122087307
STAT,1932,35,50-100,1967,0.5611636918038672
STAT,1895,30,50-100,1925,1.2014994347481722
STAT,1949,17,40-44,1966,1.6107087601586365
STAT,1864,15,20-24,1879,18.53951067043663
SIM,1817,40,20-24,1857,1
STAT,1817,53,30-34,1870,0.003947203167938894
STAT,1829,49,40-44,1878,0.07715703487202583
SIM,1868,20,na,1888,1315
STAT,1862,18,20-24,1880,17.192311971068985
SIM,1797,82,na,1879,398
STAT,1884,44,30-34,1928,1.0856903652975984
STAT,1832,51,30-34,1883,4.857921690071312E-4
SIM,1818,61,na,1879,96
STAT,1830,43,20-24,1873,0.13860772290661383
STAT,1853,15,45-49,1868,0.06165318852408105
STAT,1855,41,na,1896,1536.5841308817776
STAT,1900,46,35-39,1946,0.1097088904027994
STAT,1839,54,20-24,1893,6.667229992692945E-4
STAT,1805,82,na,1887,69.38530894063871
SIM,1956,8,na,1964,4927
STAT,1901,27,na,1928,3336.8730390851215
STAT,1826,68,na,1894,1218.334233790603
SIM,1851,63,na,1914,979
STAT,1889,53,na,1942,2551.3365509561363
STAT,1898,37,40-44,1935,5.88650154877094
SIM,1870,18,20-24,1888,3
SIM,1851,41,35-39,1892,1
STAT,1837,44,15-19,1881,0.011589551337220436
STAT,1861,23,25-29,1884,48.55828878730768
SIM,1869,30,40-44,1899,4
STAT,1933,25,35-39,1958,19.81687249536102
STAT,1950,22,30-34,1972,33.7715345188778
STAT,1856,66,na,1922,1177.2248629536018
STAT,1893,26,50-100,1919,0.8026983556294986
STAT,1917,42,40-44,1959,0.25754198172423004
SIM,1831,26,15-19,1857,3
SIM,1936,1,na,1937,4380
STAT,1841,30,45-49,1871,2.4054959428460454
SIM,1904,28,na,1932,4173
SIM,1826,32,40-44,1858,7
STAT,1824,43,20-24,1867,0.027176108844544116
STAT,1851,35,na,1886,1920.1244388194168
STAT,1868,91,na,1959,89.57555487436441
STAT,1918,22,35-39,1940,10.018345263150762
STAT,1805,49,25-29,1854,0.0688985278418286
STAT,1846,88,na,1934,81.30769773302919
STAT,1842,74,na,1916,275.49887602128194
STAT,1885,23,40-44,1908,2.0419493814498364
STAT,1914,17,25-29,1931,8.839545948259763
SIM,1867,19,na,1886,2412
STAT,1864,61,na,1925,1698.7880930079973
STAT,1839,52,25-29,1891,0.003273245662901371
STAT,1891,21,45-49,1912,0.8601053021072675
STAT,1834,54,45-49,1888,0.006303302349229794
STAT,1855,25,na,1880,1663.740829967719
STAT,1857,36,40-44,1893,3.3752944480225886
STAT,1854,44,15-19,1898,0.0075748639419150506
STAT,1859,36,45-49,1895,1.587627582965282
SIM,1926,31,na,1957,5849
STAT,1874,34,20-24,1908,2.7658517988500715
SIM,1808,83,na,1891,830
SIM,1800,63,na,1863,216
STAT,1843,56,na,1899,2015.2496532675873
SIM,1888,40,na,1928,136
STAT,1935,22,35-39,1957,12.729867011821137
STAT,1933,22,30-34,1955,37.86508029017239
STAT,1824,30,45-49,1854,0.8887507805305714
STAT,1840,26,15-19,1866,0.22435819424801895
STAT,1902,52,na,1954,3015.9472714160015
STAT,1808,48,50-100,1856,0.3809733375750924
STAT,1833,38,na,1871,1089.5985536536557
STAT,1929,25,15-19,1954,0.8806550908694891
STAT,1928,32,45-49,1960,1.9526253872585815
SIM,1880,20,na,1900,3253
STAT,1903,27,20-24,1930,16.65292667256823
STAT,1859,45,35-39,1904,0.11206921982149091
SIM,1884,34,na,1918,3638
STAT,1873,38,na,1911,2404.7264757581493
STAT,1860,71,na,1931,1088.9198880106817
STAT,1869,52,40-44,1921,0.010566707313082251
SIM,1916,13,na,1929,4860
STAT,1868,28,40-44,1896,2.883143360315639
SIM,1917,54,na,1971,1911
SIM,1863,29,na,1892,1140
STAT,1811,46,45-49,1857,1.127171216170945
STAT,1879,26,20-24,1905,12.075889701447217
STAT,1827,109,na,1936,5.017154174948379E-4
STAT,1839,41,15-19,1880,0.015051511002751301
STAT,1819,74,na,1893,258.12834799255444
SIM,1881,30,50-100,1911,3
STAT,1891,21,15-19,1912,4.0691528410066935
STAT,1930,36,50-100,1966,0.5442946236568603
STAT,1864,16,50-100,1880,0.05093121567870945
STAT,1905,38,35-39,1943,2.1848892779681415
SIM,1900,14,na,1914,4181
STAT,1849,26,35-39,1875,9.707178676260465
STAT,1890,17,15-19,1907,7.1844102982176254
STAT,1820,49,20-24,1869,0.018360820578424964
STAT,1850,39,35-39,1889,3.249532814862527
STAT,1891,32,25-29,1923,12.595625004812565
STAT,1913,49,25-29,1962,0.05082543240973674
SIM,1821,40,40-44,1861,15
STAT,1892,17,na,1909,3126.937368941795
STAT,1905,27,25-29,1932,60.843002373136464
STAT,1867,10,na,1877,2568.0730688984445
STAT,1907,21,20-24,1928,100.85357294872259
SIM,1872,65,na,1937,2049
STAT,1868,20,30-34,1888,17.454106354223875
SIM,1854,12,na,1866,2439
STAT,1791,107,na,1898,0.0011891404618202279
STAT,1863,34,15-19,1897,0.12053430398391769
STAT,1818,44,35-39,1862,3.3386711175879156
STAT,1868,26,45-49,1894,1.076089655727009
STAT,1871,44,20-24,1915,0.15628451600986037
SIM,1810,81,na,1891,1486
SIM,1884,34,25-29,1918,29
STAT,1871,47,50-100,1918,0.2438545275706581
STAT,1924,38,45-49,1962,0.7953420037539213
STAT,1815,40,45-49,1855,0.164467529383566
STAT,1818,92,na,1910,25.3501770115204
STAT,1926,32,40-44,1958,4.691327047235682
STAT,1838,53,na,1891,903.5224833324454
STAT,1880,31,40-44,1911,4.520580303762588
STAT,1876,34,25-29,1910,10.265681336918018
STAT,1835,33,25-29,1868,9.764573243415125
STAT,1924,32,30-34,1956,18.20459284213776
STAT,1907,38,45-49,1945,0.6247012621566439
STAT,1833,33,20-24,1866,1.5083167872140395
STAT,1851,51,40-44,1902,0.008354441876038916
STAT,1792,109,na,1901,1.7222758838209245E-4
STAT,1790,99,na,1889,0.5042554144333986
STAT,1862,1,na,1863,3096.7339155239024
STAT,1924,21,20-24,1945,130.34005473316077
STAT,1896,38,15-19,1934,0.07365738923642424
SIM,1932,32,30-34,1964,68
STAT,1913,48,40-44,1961,0.1515327169336224
STAT,1926,38,50-100,1964,0.5082049326200501
STAT,1844,22,40-44,1866,2.5775457746249564
STAT,1848,47,25-29,1895,0.05364932639399182
STAT,1885,24,25-29,1909,55.91728018638057
STAT,1860,41,40-44,1901,1.843244292006181
STAT,1809,56,na,1865,2637.2792051278534
STAT,1882,31,45-49,1913,1.676376108427285
STAT,1881,29,40-44,1910,2.8086357261722563
STAT,1879,38,15-19,1917,0.057319863150325084
SIM,1822,38,40-44,1860,10
SIM,1826,33,25-29,1859,18
STAT,1813,61,na,1874,1719.5753513142008
STAT,1922,29,na,1951,4161.751087407082
SIM,1930,38,40-44,1968,1
SIM,1893,35,35-39,1928,10
STAT,1922,38,40-44,1960,1.682676844400014
STAT,1885,35,35-39,1920,7.018350686106208
STAT,1830,40,40-44,1870,2.040028286559295
STAT,1887,70,na,1957,1602.7678313031915
STAT,1918,9,na,1927,4274.506173058262
SIM,1932,38,45-49,1970,18
STAT,1812,46,50-100,1858,0.06466248801642063
STAT,1820,36,15-19,1856,0.11020876546613993
STAT,1869,50,45-49,1919,0.014854657603617795
STAT,1874,20,na,1894,2455.451189269902
STAT,1907,32,30-34,1939,14.627986387665674
STAT,1937,22,45-49,1959,1.0843709450160404
SIM,1915,32,30-34,1947,27
STAT,1889,13,na,1902,3105.101710742055
STAT,1883,4,na,1887,2699.16007227486
STAT,1854,44,45-49,1898,0.820925822069565
STAT,1859,38,40-44,1897,3.452367314645136
STAT,1880,91,na,1971,218.95042069775943
SIM,1930,7,na,1937,5653
STAT,1838,25,20-24,1863,6.46279406099145
STAT,1909,32,35-39,1941,8.63173191988734
STAT,1891,34,20-24,1925,3.2955700374063497
STAT,1935,25,45-49,1960,2.340052357951039
STAT,1834,51,35-39,1885,0.003968145191499531
STAT,1855,25,20-24,1880,9.022493882861394
STAT,1828,51,40-44,1879,0.012380175663204008
STAT,1846,31,35-39,1877,7.161963567167712
STAT,1865,45,35-39,1910,0.1290930478152903
STAT,1936,18,15-19,1954,42.905837889485404
STAT,1807,49,35-39,1856,0.46034133541054506
STAT,1948,24,40-44,1972,3.8185517793278003
SIM,1860,24,na,1884,2217
STAT,1918,38,20-24,1956,0.2738260504950074
STAT,1795,107,na,1902,0.0011496064080454033
SIM,1841,31,25-29,1872,28
SIM,1899,5,na,1904,2347
SIM,1937,15,na,1952,2988
STAT,1844,34,35-39,1878,11.750930591512278
STAT,1940,18,35-39,1958,4.211361327719659
SIM,1852,34,35-39,1886,188
SIM,1934,26,na,1960,5200
STAT,1862,35,na,1897,2025.740113192676
SIM,1847,41,45-49,1888,2
SIM,1874,15,25-29,1889,13
SIM,1930,36,na,1966,5325
STAT,1889,45,20-24,1934,0.014594768017911505
STAT,1866,25,na,1891,2193.242485209778
STAT,1822,38,na,1860,1633.868456680272
SIM,1867,33,40-44,1900,18
STAT,1844,23,25-29,1867,70.30095555062812
SIM,1823,40,45-49,1863,12
STAT,1798,79,na,1877,430.29270907869926
SIM,1863,25,20-24,1888,37
STAT,1861,20,20-24,1881,59.73207324894847
STAT,1867,42,35-39,1909,1.7104326119042845
STAT,1900,49,15-19,1949,3.060401292502687E-4
STAT,1839,41,45-49,1880,1.6312073903995261
SIM,1873,50,na,1923,2117
STAT,1793,64,na,1857,742.1608112463201
STAT,1799,104,na,1903,0.004435467239891043
STAT,1902,46,15-19,1948,3.186297214023191E-4
SIM,1854,31,35-39,1885,1
STAT,1867,66,na,1933,1550.0611676184521
STAT,1822,49,30-34,1871,0.15744017734436683
STAT,1942,15,35-39,1957,4.3373406365231
STAT,1821,53,20-24,1874,7.466513771470813E-4
STAT,1873,18,50-100,1891,0.05012320314673924
SIM,1878,2,na,1880,4422
STAT,1847,51,45-49,1898,0.01318369822234445
SIM,1891,44,na,1935,1960
STAT,1915,42,50-100,1957,0.11660480402804296
STAT,1872,35,25-29,1907,2.910492976064805
SIM,1852,23,25-29,1875,1
SIM,1862,44,45-49,1906,3
STAT,1881,18,30-34,1899,1.501223510779326
STAT,1887,41,50-100,1928,1.1680696997284616
STAT,1804,50,40-44,1854,0.06923888807607345
STAT,1895,45,15-19,1940,2.964461859947867E-4
SIM,1871,31,40-44,1902,1
STAT,1889,37,na,1926,2837.12664229952
STAT,1882,42,30-34,1924,1.0993490141839257
SIM,1827,81,na,1908,606
SIM,1890,22,na,1912,3943
SIM,1890,42,30-34,1932,1
SIM,1957,4,na,1961,6080
SIM,1942,21,na,1963,3335
STAT,1830,33,na,1863,2012.5816734583739
STAT,1805,66,na,1871,317.2930797897811
STAT,1861,22,40-44,1883,1.7803628856311469
STAT,1933,28,45-49,1961,2.2772523587362983
STAT,1844,41,na,1885,2375.29233545019
SIM,1865,55,na,1920,1665
STAT,1815,51,30-34,1866,5.94176911384433E-4
STAT,1846,47,15-19,1893,2.3579968670370765E-4
STAT,1868,23,35-39,1891,5.618903911014932
STAT,1923,14,na,1937,4588.802329476631
STAT,1871,41,40-44,1912,2.253903224509507
STAT,1885,23,na,1908,2317.539617919356
STAT,1863,47,20-24,1910,0.010196787326833415
SIM,1883,49,na,1932,2002
STAT,1938,17,35-39,1955,4.094930169603385
STAT,1881,33,na,1914,2243.9977074291382
STAT,1893,32,35-39,1925,12.664177765717964
STAT,1866,26,35-39,1892,8.837948242992457
STAT,1875,52,40-44,1927,0.010752791312123035
STAT,1849,22,50-100,1871,0.4154237934327968
STAT,1838,37,15-19,1875,0.028925039528150814
SIM,1814,55,na,1869,2442
STAT,1874,32,25-29,1906,10.571048917722104
SIM,1935,5,na,1940,5881
STAT,1801,76,na,1877,341.8918409409236
STAT,1888,12,na,1900,2980.638292010576
STAT,1881,27,15-19,1908,0.4284529796785824
STAT,1847,15,15-19,1862,6.776297087204568
SIM,1839,23,na,1862,1136
STAT,1891,35,35-39,1926,8.780378690680879
STAT,1908,16,40-44,1924,0.26988034853063
STAT,1865,44,20-24,1909,0.1430377209475874
STAT,1867,33,50-100,1900,0.8628642460865276
STAT,1917,36,50-100,1953,0.4323389229156955
SIM,1882,32,25-29,1914,15
STAT,1866,15,25-29,1881,5.372453198481094
STAT,1926,19,na,1945,4450.107626920032
SIM,1834,41,35-39,1875,12
STAT,1872,21,35-39,1893,5.861055726571699
SIM,1946,11,na,1957,3798
STAT,1777,93,na,1870,17.271071839966798
STAT,1914,28,35-39,1942,14.87216864782707
SIM,1915,47,na,1962,2886
STAT,1823,79,na,1902,552.2770582313901
STAT,1873,3,na,1876,3184.7931663877735
STAT,1824,44,35-39,1868,0.3110297480903657
STAT,1842,98,na,1940,0.8064323842713585
SIM,1894,7,na,1901,1764
STAT,1895,42,40-44,1937,0.20293874480117444
SIM,1921,16,na,1937,5331
STAT,1826,41,35-39,1867,2.7690431470129724
STAT,1893,48,15-19,1941,2.7861513914560196E-4
STAT,1944,28,15-19,1972,0.7540491365747086
STAT,1909,47,na,1956,3341.4619462544642
STAT,1931,25,30-34,1956,50.27463558211003
SIM,1876,55,na,1931,3199
STAT,1832,54,35-39,1886,6.62235783975992E-4
STAT,1850,20,45-49,1870,0.3920870942847939
STAT,1881,15,20-24,1896,16.819684322111264
STAT,1866,24,15-19,1890,2.992558918289034
STAT,1848,31,na,1879,2389.764687551921
STAT,1885,38,15-19,1923,0.0549233129445457
STAT,1821,48,50-100,1869,0.25917242143395125
SIM,1894,12,na,1906,1764
STAT,1861,5,na,1866,2403.6016478766564
SIM,1871,24,na,1895,1942
STAT,1850,10,na,1860,1363.9128411294312
STAT,1768,97,na,1865,2.460436285139596
STAT,1906,42,na,1948,3354.2639070765817
STAT,1927,16,20-24,1943,167.60936652948763
SIM,1919,48,25-29,1967,2
STAT,1948,20,25-29,1968,105.04565506128344
STAT,1921,47,na,1968,4092.42175951305
SIM,1905,0,na,1905,3894
SIM,1945,26,na,1971,6272
STAT,1803,59,na,1862,746.7909311408374
SIM,1901,39,na,1940,3754
SIM,1866,77,na,1943,1197
STAT,1813,43,15-19,1856,0.06203689154800099
STAT,1898,23,20-24,1921,92.38144442412123
STAT,1806,54,50-100,1860,0.03822672337951597
STAT,1928,26,na,1954,4595.845490124779
SIM,1904,44,na,1948,3986
STAT,1855,28,30-34,1883,17.24710810001414
SIM,1863,28,30-34,1891,17
STAT,1865,31,45-49,1896,1.5986003896604102
SIM,1827,38,na,1865,2180
STAT,1916,25,35-39,1941,15.415634904145355
STAT,1900,30,25-29,1930,14.302983111332654
SIM,1927,32,na,1959,1660
STAT,1834,105,na,1939,0.012921774125993515
STAT,1844,27,40-44,1871,3.6329313767773566
STAT,1852,107,na,1959,0.0114933536482974
SIM,1889,65,na,1954,2045
STAT,1887,46,25-29,1933,0.06357877602314144
SIM,1963,0,na,1963,5558
STAT,1864,27,15-19,1891,0.4124637698333906
STAT,1868,51,na,1919,2089.6324134117667
STAT,1905,35,30-34,1940,1.6702748721966851
SIM,1828,41,35-39,1869,1
SIM,1885,29,20-24,1914,6
STAT,1902,39,50-100,1941,0.3694032992596663
STAT,1876,31,20-24,1907,2.743710698190493
STAT,1924,5,na,1929,4742.0752865351305
STAT,1887,35,15-19,1922,0.062394816932934416
STAT,1920,39,15-19,1959,0.02071089501046294
STAT,1859,55,na,1914,1638.8545082667479
SIM,1893,27,na,1920,3292
STAT,1918,38,15-19,1956,0.019947595592139628
SIM,1875,14,na,1889,3165
STAT,1863,20,na,1883,2089.2022225774704
STAT,1860,44,45-49,1904,1.2044668401500749
STAT,1848,44,20-24,1892,0.14660719490521987
SIM,1832,68,na,1900,503
SIM,1900,54,na,1954,4006
SIM,1862,63,na,1925,2897
STAT,1852,47,15-19,1899,4.0075772806785184E-4
STAT,1865,31,15-19,1896,0.13054826572271944
STAT,1901,31,50-100,1932,1.2863438672832188
STAT,1889,45,15-19,1934,4.864918393289191E-4
SIM,1841,36,25-29,1877,3
SIM,1876,46,50-100,1922,1
STAT,1917,45,45-49,1962,0.22503548690200953
SIM,1848,39,45-49,1887,18
STAT,1880,34,15-19,1914,0.1465754036591677
STAT,1900,49,45-49,1949,0.1805638282351721
STAT,1854,41,35-39,1895,1.0114002078179682
STAT,1870,24,35-39,1894,5.781164338809934
SIM,1838,27,50-100,1865,2
STAT,1897,48,na,1945,2950.9108207047025
STAT,1852,76,na,1928,953.6450817773157
STAT,1968,0,na,1968,4896.717833138888
SIM,1932,35,40-44,1967,6
STAT,1909,35,45-49,1944,0.644768621992925
STAT,1835,30,20-24,1865,2.658441685784105
STAT,1931,22,50-100,1953,0.8474081662282786
STAT,1880,34,45-49,1914,1.7948572208676936
STAT,1939,15,50-100,1954,0.37181399085980515
STAT,1929,39,35-39,1968,3.076942001463939
STAT,1834,23,na,1857,1251.150260203061
SIM,1843,12,na,1855,761
STAT,1873,51,50-100,1924,0.015566216479214945
STAT,1937,30,15-19,1967,0.12596435473721004
SIM,1913,24,20-24,1937,540
STAT,1866,29,45-49,1895,1.0062617556772515
STAT,1818,37,40-44,1855,11.145346197464873
STAT,1813,43,45-49,1856,6.723247649489503
STAT,1877,29,20-24,1906,11.823720245970605
STAT,1842,42,50-100,1884,0.27133470387318404
SIM,1822,66,na,1888,316
STAT,1848,44,15-19,1892,0.012748452419443638
STAT,1944,28,20-24,1972,19.49755608938575
STAT,1856,52,30-34,1908,0.004252679472869698
STAT,1895,42,35-39,1937,0.16337892804174126
STAT,1849,23,30-34,1872,18.01542313620843
STAT,1852,47,45-49,1899,0.23644725857368212
STAT,1901,70,na,1971,2356.398816416002
SIM,1815,46,25-29,1861,2
STAT,1831,34,25-29,1865,10.58177242102908
STAT,1802,53,40-44,1855,0.05237067833411786
STAT,1854,41,40-44,1895,1.2562959686807715
STAT,1894,16,45-49,1910,0.08327193733088323
STAT,1868,23,40-44,1891,2.0064710172574154
STAT,1905,24,20-24,1929,98.49775772558303
STAT,1874,37,25-29,1911,2.971522986926446
STAT,1887,32,35-39,1919,11.146590038647776
STAT,1794,89,na,1883,0.4770839505606006
STAT,1828,51,35-39,1879,0.010123975448864338
STAT,1876,27,na,1903,2412.5555119165724
SIM,1846,17,na,1863,1425
STAT,1822,46,20-24,1868,0.020346765434426754
STAT,1884,78,na,1962,962.4556175461439
STAT,1855,39,40-44,1894,2.868032078139679
STAT,1875,52,35-39,1927,0.008793170485799232
STAT,1806,101,na,1907,0.1718252683090603
STAT,1831,23,15-19,1854,8.284193002781082
STAT,1790,75,na,1865,556.4963166405647
STAT,1885,28,40-44,1913,2.9341230202641047
STAT,1834,51,40-44,1885,0.004852474680129063
STAT,1924,35,40-44,1959,1.7512878055705965
STAT,1883,26,40-44,1909,2.8917516581816893
SIM,1856,6,na,1862,1435
STAT,1822,34,50-100,1856,2.046024386475293
STAT,1840,43,50-100,1883,0.4284067528253875
STAT,1939,29,na,1968,3720.934869276611
STAT,1889,28,50-100,1917,0.7676220022717886
SIM,1895,34,na,1929,4508
SIM,1939,22,15-19,1961,1
SIM,1826,40,na,1866,1912
STAT,1850,34,35-39,1884,4.79132486827895
STAT,1859,34,25-29,1893,8.04870768256756
SIM,1857,23,30-34,1880,3
SIM,1821,43,45-49,1864,5
STAT,1858,54,30-34,1912,0.0044207444222604695
SIM,1908,18,na,1926,2858
STAT,1857,22,20-24,1879,61.04783095304072
STAT,1881,73,na,1954,1121.6515687598703
STAT,1867,100,na,1967,5.464871009272392
SIM,1937,28,25-29,1965,3
STAT,1929,28,25-29,1957,81.75926769809787
STAT,1888,19,25-29,1907,6.505257822517638
SIM,1829,45,na,1874,2014
STAT,1929,20,15-19,1949,6.7243073559566175
STAT,1843,40,20-24,1883,0.16575433840328563
SIM,1850,23,20-24,1873,1
STAT,1874,37,30-34,1911,5.500478750674988
STAT,1877,16,45-49,1893,0.06647306294752342
STAT,1894,25,35-39,1919,12.353386903648158
STAT,1919,19,20-24,1938,147.039436018808
SIM,1937,31,na,1968,2867
STAT,1851,108,na,1959,0.003448906384802321
STAT,1940,15,30-34,1955,12.243406134526715
STAT,1856,27,50-100,1883,0.4761071351523757
STAT,1857,51,na,1908,1660.1632500142123
STAT,1871,31,50-100,1902,0.9177300752499172
STAT,1918,27,na,1945,3932.9616914270596
SIM,1882,6,na,1888,2492
STAT,1821,53,na,1874,1190.7576682765136
SIM,1899,64,na,1963,1469
STAT,1871,44,45-49,1915,1.472811665063834
STAT,1907,23,40-44,1930,3.031083859370032
STAT,1915,16,50-100,1931,0.07749562803902106
SIM,1852,88,na,1940,906
STAT,1892,18,30-34,1910,1.968189723466554
STAT,1884,40,15-19,1924,0.013353160929677858
STAT,1910,47,na,1957,3389.302119050149
STAT,1804,53,45-49,1857,0.08983397268533348
STAT,1874,48,40-44,1922,0.17446967332163307
STAT,1930,21,45-49,1951,1.4356213678671936
STAT,1867,44,25-29,1911,0.5991097047285932
STAT,1795,104,na,1899,0.016259445789587205
STAT,1907,35,40-44,1942,1.3917140725296897
SIM,1886,40,45-49,1926,4
SIM,1927,19,20-24,1946,4
STAT,1842,23,20-24,1865,21.422226570426755
STAT,1925,1,na,1926,4998.537472915164
STAT,1874,34,15-19,1908,0.14571585683201493
STAT,1808,71,na,1879,391.54164945405586
STAT,1887,35,45-49,1922,2.215015737699629
STAT,1844,37,15-19,1881,0.058787413374388156
SIM,1826,56,na,1882,1370
SIM,1895,50,na,1945,4395
STAT,1882,44,20-24,1926,0.149996846961461
STAT,1874,22,20-24,1896,71.12227718413891
STAT,1926,32,35-39,1958,10.955149752057475
STAT,1845,66,na,1911,813.3047157609677
STAT,1856,52,25-29,1908,0.0025305199925254136
SIM,1925,46,na,1971,4696
STAT,1846,45,25-29,1891,0.03445432963055576
STAT,1855,28,25-29,1883,28.972285092093607
STAT,1827,34,35-39,1861,10.14068108235471
STAT,1941,21,20-24,1962,113.64209848214766
SIM,1854,52,na,1906,986
STAT,1924,47,35-39,1971,0.15201839856570867
STAT,1943,29,50-100,1972,1.0469192848695097
STAT,1922,32,na,1954,4225.588102575901
STAT,1870,33,na,1903,2368.9532019684543
SIM,1864,73,na,1937,702
STAT,1909,20,40-44,1929,3.111662695520436
STAT,1881,18,25-29,1899,5.337341777340306
SIM,1869,45,45-49,1914,4
SIM,1824,30,na,1854,2459
STAT,1846,34,15-19,1880,0.09762320827076729
SIM,1883,65,na,1948,1771
SIM,1884,10,na,1894,3856
SIM,1895,53,na,1948,4395
STAT,1860,54,40-44,1914,0.00835219939527132
SIM,1828,32,45-49,1860,10
STAT,1941,24,na,1965,3728.4065417446714
STAT,1953,12,na,1965,4709.243525978045
STAT,1860,43,30-34,1903,0.9311152307282224
STAT,1884,51,25-29,1935,0.0034068942413113105
STAT,1829,33,na,1862,1029.7891133788344
STAT,1919,42,45-49,1961,0.17796163297883452
STAT,1856,54,20-24,1910,5.154382080909808E-4
SIM,1899,67,na,1966,1469
STAT,1880,46,15-19,1926,4.1644043572050516E-4
STAT,1839,54,na,1893,1945.4244579087115
STAT,1914,25,30-34,1939,39.214941061111425
STAT,1944,15,45-49,1959,0.5318151746600911
STAT,1876,33,40-44,1909,4.365520971555774
STAT,1853,24,35-39,1877,5.269704862877639
STAT,1888,68,na,1956,1791.1426711756885
SIM,1815,44,35-39,1859,11
STAT,1882,31,15-19,1913,0.13689974997483476
STAT,1898,35,20-24,1933,1.0464179082873826
STAT,1885,37,50-100,1922,1.2068089627876544
STAT,1925,15,35-39,1940,5.045884761259438
STAT,1874,35,35-39,1909,7.369051763596349
STAT,1920,46,na,1966,4018.7938890963183
STAT,1781,82,na,1863,173.39441068108158
STAT,1831,23,45-49,1854,1.7510471107320613
STAT,1899,15,na,1914,3465.670351352774
SIM,1831,27,na,1858,2217
STAT,1818,47,15-19,1865,7.133937737854654E-4
STAT,1819,58,na,1877,515.5983959772277
STAT,1815,44,na,1859,221.95349166999785
STAT,1877,12,na,1889,2629.4317670598007
STAT,1809,54,40-44,1863,0.08345997930480806
STAT,1833,33,15-19,1866,0.0794640092843672
SIM,1817,42,40-44,1859,16
SIM,1887,79,na,1966,1759
STAT,1880,33,50-100,1913,0.9471903176396694
STAT,1938,19,30-34,1957,11.886829191812392
STAT,1859,48,45-49,1907,0.1847015447373759
STAT,1870,28,20-24,1898,11.654304417923518
STAT,1917,15,50-100,1932,0.0799161446668808
STAT,1844,25,na,1869,2661.634345215283
STAT,1896,63,na,1959,2447.6998860126264
STAT,1876,45,40-44,1921,0.17479286321807325
SIM,1815,46,30-34,1861,1
SIM,1927,16,na,1943,1973
STAT,1841,43,20-24,1884,0.18142850231698038
STAT,1883,29,45-49,1912,1.0605252273726944
SIM,1876,24,25-29,1900,1
STAT,1846,34,45-49,1880,1.1954237608411873
STAT,1869,76,na,1945,956.0078640098101
STAT,1946,24,30-34,1970,31.616366093111395
STAT,1822,49,25-29,1871,0.09368341040944327
SIM,1856,38,50-100,1894,7
STAT,1862,54,20-24,1916,6.112324323653021E-4
SIM,1948,15,na,1963,4384
STAT,1868,35,na,1903,2297.181050360549
STAT,1911,21,35-39,1932,8.856081562076753
SIM,1915,21,15-19,1936,5
STAT,1852,32,40-44,1884,4.519732903019703
STAT,1854,40,na,1894,1298.0571911567106
STAT,1928,42,na,1970,4698.577215817172
SIM,1874,72,na,1946,1948
STAT,1858,16,35-39,1874,0.49238236013443815
SIM,1905,29,na,1934,3398
STAT,1815,40,15-19,1855,0.001517578232345892
STAT,1867,50,na,1917,2065.578125585508
SIM,1871,31,35-39,1902,14
STAT,1835,32,40-44,1867,4.177471520450268
STAT,1820,90,na,1910,54.219611493465635
STAT,1906,40,50-100,1946,0.10730561923946627
STAT,1840,22,50-100,1862,0.20419643456652617
SIM,1885,35,na,1920,1666
SIM,1923,42,na,1965,4224
STAT,1807,49,na,1856,1401.3903471996089
STAT,1907,43,na,1950,3359.5241319955026
STAT,1815,51,25-29,1866,3.5355981163111223E-4
STAT,1869,17,na,1886,2583.83439487049
STAT,1846,47,20-24,1893,0.007073996823634388
STAT,1882,42,25-29,1924,0.6140508032277315
SIM,1883,49,50-100,1932,10
SIM,1848,36,40-44,1884,14
STAT,1858,31,50-100,1889,0.707007404490003
STAT,1777,77,na,1854,830.0
SIM,1859,26,45-49,1885,38
STAT,1907,21,15-19,1928,4.8281282779949235
STAT,1835,44,40-44,1879,1.987585556440515
SIM,1840,63,na,1903,2500
SIM,1935,19,25-29,1954,34
STAT,1861,34,40-44,1895,3.5757214657151084
STAT,1831,27,30-34,1858,29.894968478835146
STAT,1852,33,25-29,1885,10.564587396026644
STAT,1799,80,na,1879,52.22468297890791
STAT,1847,51,50-100,1898,0.013719984229195157
STAT,1809,96,na,1905,8.358046893683603
STAT,1847,15,20-24,1862,20.243115322943805
STAT,1898,38,25-29,1936,0.8315285260739863
SIM,1818,45,na,1863,874
STAT,1887,23,45-49,1910,0.7651515125001042
SIM,1860,33,25-29,1893,122
STAT,1863,22,45-49,1885,0.6071759262549387
STAT,1937,35,15-19,1972,0.019036879210059886
SIM,1897,60,na,1957,1686
STAT,1927,19,25-29,1946,53.1566126720607
SIM,1836,58,na,1894,1299
STAT,1844,22,na,1866,2644.735025729257
STAT,1955,15,20-24,1970,178.50010194836418
STAT,1826,42,40-44,1868,3.379486857820681
STAT,1962,3,na,1965,4992.922034503041
STAT,1862,101,na,1963,1.6995885867335556
STAT,1929,25,20-24,1954,22.771224309902465
STAT,1933,13,na,1946,5259.907041842345
STAT,1862,18,15-19,1880,5.755053590976889
STAT,1878,40,45-49,1918,1.5553846430994596
SIM,1851,43,25-29,1894,3
STAT,1883,24,20-24,1907,65.88176638675561
SIM,1880,39,40-44,1919,1
STAT,1831,38,40-44,1869,4.390740556283165
STAT,1900,46,40-44,1946,0.13415829995461026
STAT,1911,47,25-29,1958,0.04965244261413614
STAT,1841,30,15-19,1871,0.19644266670565425
SIM,1950,13,na,1963,4855
STAT,1946,25,20-24,1971,20.131503524277118
SIM,1834,43,25-29,1877,1
STAT,1870,17,40-44,1887,0.18407911083871206
SIM,1817,60,na,1877,2170
STAT,1851,51,na,1902,1708.692366258585
SIM,1842,67,na,1909,1844
STAT,1850,31,50-100,1881,0.4472111681617167
STAT,1872,28,30-34,1900,25.127376083344622
STAT,1855,65,na,1920,1118.4788284458803
STAT,1891,32,na,1923,2934.5153035688268
STAT,1818,89,na,1907,63.94148508951989
STAT,1833,78,na,1911,321.4693399762987
STAT,1928,21,50-100,1949,0.8177555118399102
STAT,1902,34,45-49,1936,1.3979231132369212
STAT,1857,37,25-29,1894,2.209384843418175
STAT,1873,30,50-100,1903,0.9474207953277857
STAT,1796,69,na,1865,1238.261328836472
SIM,1851,47,na,1898,1179
STAT,1896,43,50-100,1939,0.09600953647054733
SIM,1870,18,15-19,1888,26
STAT,1890,53,na,1943,2564.8583376340175
STAT,1868,35,35-39,1903,6.8964085831658295
SIM,1848,43,na,1891,2319
SIM,1857,17,na,1874,1494
STAT,1872,39,40-44,1911,4.339336916864899
SIM,1894,49,na,1943,1271
STAT,1846,22,45-49,1868,0.5095803529243145
STAT,1859,48,15-19,1907,3.130532021647738E-4
STAT,1843,43,25-29,1886,0.6449526513667895
STAT,1899,48,50-100,1947,0.18684806095893589
STAT,1899,17,35-39,1916,0.7494638718940889
STAT,1902,46,45-49,1948,0.1879916938567904
SIM,1812,45,na,1857,1859
STAT,1907,64,na,1971,2879.16082946004
STAT,1826,43,25-29,1869,0.9480711333725161
STAT,1903,50,na,1953,3100.4530624956005
STAT,1866,26,40-44,1892,2.743790553434815
SIM,1896,16,na,1912,3972
STAT,1776,92,na,1868,20.55363420053077
STAT,1911,36,15-19,1947,0.01842724912683377
STAT,1929,36,30-34,1965,2.3255956604386276
STAT,1837,32,45-49,1869,1.7531070030811706
SIM,1887,39,na,1926,3590
SIM,1861,22,na,1883,2524
STAT,1842,15,na,1857,740.4343328667459
STAT,1859,30,30-34,1889,14.04002925487434
STAT,1915,31,20-24,1946,2.4591083503331017
STAT,1893,34,25-29,1927,12.698998998223244
STAT,1872,24,15-19,1896,3.2828288169263744
STAT,1841,41,25-29,1882,0.7526425059484668
SIM,1860,32,40-44,1892,7
SIM,1907,22,30-34,1929,1
SIM,1794,77,na,1871,438
SIM,1872,25,na,1897,2454
STAT,1816,38,45-49,1854,7.764417486845594
STAT,1881,40,50-100,1921,1.00772470840434
STAT,1853,36,50-100,1889,0.9619144389924208
STAT,1926,22,50-100,1948,0.7925329005859294
STAT,1827,69,na,1896,1034.8992029951098
SIM,1931,21,na,1952,4996
STAT,1841,49,35-39,1890,0.15264404931536424
STAT,1915,42,30-34,1957,0.12689346348544303
STAT,1897,17,50-100,1914,0.06506375953887525
STAT,1851,17,30-34,1868,1.5305022914104098
STAT,1833,21,20-24,1854,76.76894910130137
STAT,1930,34,20-24,1964,3.1216963920899583
STAT,1859,45,40-44,1904,0.13704464563709673
STAT,1913,21,45-49,1934,1.07987128359993
STAT,1908,19,15-19,1927,8.688354210814621
SIM,1938,16,na,1954,4240
STAT,1891,37,30-34,1928,6.553935019096594
STAT,1861,10,na,1871,2310.496969214758
STAT,1831,74,na,1905,868.5760743288
STAT,1822,110,na,1932,1.5935044315916314E-4
SIM,1913,9,na,1922,3693
STAT,1857,91,na,1948,44.46691914709577
STAT,1897,42,15-19,1939,0.001272011114481466
SIM,1840,60,na,1900,2500
STAT,1878,50,na,1928,2247.163184154507
SIM,1916,32,na,1948,4643
STAT,1876,48,45-49,1924,0.23557660129924748
STAT,1865,24,na,1889,2154.2446449358167
SIM,1878,65,na,1943,1888
STAT,1915,45,35-39,1960,0.12868515443031478
STAT,1879,75,na,1954,1056.06321577465
STAT,1875,61,na,1936,1918.8125932590613
SIM,1874,51,na,1925,2445
STAT,1838,28,25-29,1866,22.805262860333453
STAT,1840,19,20-24,1859,8.931938459449864
STAT,1917,42,na,1959,3824.0630648838064
STAT,1909,23,45-49,1932,1.0319060118688048
STAT,1855,24,15-19,1879,2.514272279220001
SIM,1863,35,25-29,1898,3
STAT,1868,24,25-29,1892,54.94573130807614
STAT,1888,16,20-24,1904,20.51188155027536
STAT,1876,86,na,1962,381.9225962991705
STAT,1892,16,40-44,1908,0.22700731605531851
STAT,1904,36,50-100,1940,0.3804230620927097
STAT,1912,17,15-19,1929,9.070422765912381
STAT,1905,57,na,1962,3030.9207909339425
STAT,1824,43,15-19,1867,0.0023631400271608145
STAT,1887,27,na,1914,2626.7821443214366
STAT,1831,36,20-24,1867,0.7928894962565554
STAT,1891,48,40-44,1939,0.11726402964287937
STAT,1833,40,50-100,1873,0.565008038650987
STAT,1885,23,35-39,1908,5.718257212210224
STAT,1845,54,45-49,1899,0.007003275537751522
STAT,1787,92,na,1879,5.322477061817816
STAT,1850,33,15-19,1883,0.06807928166438873
STAT,1824,46,30-34,1870,0.016989839237990568
STAT,1853,28,20-24,1881,9.52055817019938
SIM,1886,42,35-39,1928,17
SIM,1829,25,20-24,1854,12
STAT,1856,8,na,1864,2085.5518716980678
SIM,1841,40,50-100,1881,1
SIM,1906,31,20-24,1937,17
SIM,1861,25,na,1886,2051
STAT,1804,53,15-19,1857,1.5226084249762942E-4
STAT,1889,33,20-24,1922,3.2413544733870263
STAT,1851,15,40-44,1866,0.1777187792734004
STAT,1940,24,50-100,1964,0.6623253568209951
STAT,1896,36,25-29,1932,3.8137078098657393
STAT,1846,38,30-34,1884,3.2622225339620683
STAT,1911,49,15-19,1960,3.427872790488546E-4
STAT,1864,21,na,1885,2200.4545692676934
STAT,1845,18,15-19,1863,3.700079199189676
STAT,1878,53,na,1931,2179.7585224965583
STAT,1862,45,50-100,1907,0.2112731058053798
STAT,1885,35,40-44,1920,4.343728401339937
STAT,1834,53,30-34,1887,0.0026371365700866584
STAT,1820,36,45-49,1856,3.9124107087666546
STAT,1803,56,na,1859,792.505740980489
STAT,1877,48,50-100,1925,0.2461809235599313
SIM,1906,33,40-44,1939,12
STAT,1865,47,30-34,1912,0.08796551487458722
STAT,1922,24,15-19,1946,5.998588820349743
STAT,1899,12,na,1911,3527.364746513433
STAT,1839,29,50-100,1868,0.7379925344621588
STAT,1848,45,35-39,1893,0.13231453561050574
STAT,1872,24,45-49,1896,0.6938983571456017
SIM,1895,39,30-34,1934,10
STAT,1823,52,50-100,1875,0.022676139046376546
STAT,1842,28,45-49,1870,0.33840618927682253
STAT,1860,51,50-100,1911,0.012379654661731214
STAT,1870,34,50-100,1904,0.9056150783688801
STAT,1877,28,na,1905,2414.080720178975
SIM,1886,17,na,1903,3155
STAT,1891,34,15-19,1925,0.17362347901295233
STAT,1895,40,45-49,1935,1.9665833254543739
STAT,1856,41,15-19,1897,0.009963840144249113
STAT,1890,21,50-100,1911,0.49516447782783746
SIM,1838,19,30-34,1857,39
SIM,1884,50,na,1934,3654
SIM,1839,47,na,1886,746
SIM,1916,19,15-19,1935,65
SIM,1835,33,na,1868,1267
STAT,1887,39,30-34,1926,5.807083451073618
STAT,1887,48,20-24,1935,0.013042118799350908
STAT,1920,27,20-24,1947,19.766618288240394
STAT,1941,24,25-29,1965,94.30718162323426
STAT,1829,45,25-29,1874,0.027343329723502455
SIM,1906,14,na,1920,3602
SIM,1883,18,30-34,1901,3
STAT,1830,89,na,1919,76.03483186851983
STAT,1866,28,30-34,1894,22.905596844924343
SIM,1897,33,20-24,1930,28
STAT,1842,26,25-29,1868,13.080087734701042
STAT,1938,15,15-19,1953,44.494391897380865
SIM,1862,66,na,1928,2633
SIM,1850,26,25-29,1876,164
STAT,1863,76,na,1939,808.8101488306402
STAT,1831,36,50-100,1867,1.2628471770858793
STAT,1871,44,15-19,1915,0.013589958647906337
SIM,1864,14,na,1878,2555
STAT,1896,25,15-19,1921,0.6021412733676114
SIM,1911,54,na,1965,2221
STAT,1892,57,na,1949,2488.1117426019423
STAT,1867,41,20-24,1908,0.1508738520633159
STAT,1865,42,25-29,1907,0.5855618249248739
STAT,1864,18,25-29,1882,5.297886197453373
SIM,1837,45,25-29,1882,1
STAT,1829,34,15-19,1863,0.0748303657160472
STAT,1844,22,35-39,1866,7.2181366734399806
STAT,1897,46,30-34,1943,0.07272185361667158
STAT,1857,39,45-49,1896,1.5143287958615035
STAT,1852,35,45-49,1887,2.059844252161151
SIM,1915,1,na,1916,3887
STAT,1948,22,15-19,1970,6.049530317684907
STAT,1840,24,25-29,1864,28.2549395162869
STAT,1842,16,50-100,1858,0.015710091112415996
STAT,1830,43,15-19,1873,0.01205284612112499
SIM,1827,41,na,1868,1874
STAT,1875,16,35-39,1891,0.5648270303232692
SIM,1829,85,na,1914,824
STAT,1932,31,na,1963,4995.618346281197
SIM,1796,81,na,1877,66
SIM,1888,24,na,1912,458
STAT,1850,47,40-44,1897,0.07868504409840336
STAT,1826,40,20-24,1866,0.24718979410982758
STAT,1887,20,40-44,1907,2.30727739782789
STAT,1849,24,15-19,1873,3.3126905846008
SIM,1866,40,na,1906,3055
SIM,1891,27,25-29,1918,1
STAT,1835,47,15-19,1882,3.190133171154294E-4
STAT,1832,37,na,1869,2304.725130941885
STAT,1863,42,50-100,1905,0.9007955720097397
SIM,1907,25,35-39,1932,1
STAT,1886,19,15-19,1905,6.112567459293009
STAT,1868,39,20-24,1907,0.7370470073846019
STAT,1790,96,na,1886,2.1979264684828133
STAT,1931,17,25-29,1948,56.32283457764629
SIM,1835,27,40-44,1862,7
SIM,1840,19,25-29,1859,3
SIM,1838,22,na,1860,2362
STAT,1861,37,45-49,1898,1.657869178630337
STAT,1935,4,na,1939,5478.016490937388
STAT,1894,18,40-44,1912,0.23198084917924872
SIM,1900,33,30-34,1933,2
STAT,1931,28,35-39,1959,19.23769772373403
STAT,1848,32,20-24,1880,2.9497927221695126
STAT,1879,29,25-29,1908,43.084334469513784
SIM,1797,66,na,1863,1152
SIM,1922,25,30-34,1947,2
STAT,1910,40,35-39,1950,0.19031160521166318
STAT,1879,52,50-100,1931,0.015410524982714967
STAT,1819,55,na,1874,547.1607538512329
STAT,1815,41,na,1856,230.63912064359315
STAT,1833,34,35-39,1867,5.57257605256804
SIM,1876,39,na,1915,3646
STAT,1849,19,40-44,1868,0.1874723144081536
STAT,1875,22,50-100,1897,0.4187404884324302
STAT,1846,44,50-100,1890,0.6172493978729895
STAT,1846,49,40-44,1895,0.09927800824688846
STAT,1878,42,35-39,1920,1.8607968136567241
SIM,1930,4,na,1934,5653
STAT,1914,19,50-100,1933,0.07601273343755403
STAT,1862,50,35-39,1912,0.007438062714366564
STAT,1827,27,40-44,1854,4.679073220576866
STAT,1875,54,30-34,1929,0.005944302029465944
STAT,1905,23,30-34,1928,25.540607538571354
STAT,1841,34,30-34,1875,23.1047493234636
STAT,1930,24,na,1954,4616.267908934295
SIM,1875,54,na,1929,2578
SIM,1871,40,na,1911,1862
STAT,1830,43,45-49,1873,1.3062271066694573
STAT,1894,29,20-24,1923,14.811775592733428
STAT,1873,52,30-34,1925,0.006073498586743175
STAT,1866,65,na,1931,1542.6294107681554
STAT,1857,34,20-24,1891,2.056464335091985
STAT,1921,29,50-100,1950,1.0883347318570955
STAT,1852,30,20-24,1882,2.8762485391408497
STAT,1911,44,20-24,1955,0.01646123502234196
STAT,1908,19,45-49,1927,0.09563403910484561
STAT,1827,38,20-24,1865,0.7508387747293916
STAT,1851,54,45-49,1905,0.01114660498046359
SIM,1873,10,na,1883,2483
SIM,1815,56,na,1871,1279
STAT,1837,41,35-39,1878,1.735412982772096
STAT,1877,68,na,1945,1551.3044252200264
STAT,1883,27,25-29,1910,40.695794109175665
STAT,1899,21,50-100,1920,0.5586691761028783
STAT,1826,45,45-49,1871,0.34683711998639855
STAT,1845,47,50-100,1892,0.12130272941223574
STAT,1933,25,40-44,1958,6.15225910544407
STAT,1822,78,na,1900,450.5557457391904
STAT,1856,10,na,1866,2052.8544578552624
STAT,1904,44,20-24,1948,0.015543413637703144
STAT,1893,31,20-24,1924,3.39406399480114
STAT,1913,45,50-100,1958,0.21901772971700004
STAT,1856,41,45-49,1897,1.079831099820323
STAT,1858,52,35-39,1910,0.006539432079055173
STAT,1893,36,45-49,1929,2.5049090960645013
SIM,1906,54,na,1960,3086
STAT,1902,31,40-44,1933,6.13174878531467
SIM,1865,34,20-24,1899,1
SIM,1902,40,na,1942,3323
STAT,1850,36,30-34,1886,2.526060098960565
STAT,1915,34,25-29,1949,9.200832549190682
SIM,1846,28,25-29,1874,6
STAT,1908,46,na,1954,3321.6111247142276
SIM,1948,23,30-34,1971,89
STAT,1904,32,na,1936,3438.3133985209865
SIM,1899,27,na,1926,2092
STAT,1859,33,35-39,1892,7.992765348887619
STAT,1880,32,na,1912,2477.3594424548864
STAT,1788,77,na,1865,134.43801476176418
SIM,1845,41,35-39,1886,14
STAT,1911,32,na,1943,3641.3420020059925
STAT,1924,23,40-44,1947,3.9172795229769224
STAT,1872,37,20-24,1909,0.7718969283658023
STAT,1856,110,na,1966,0.0014775856056009392
SIM,1898,25,15-19,1923,2
STAT,1835,47,45-49,1882,0.18821801551801662
STAT,1841,45,40-44,1886,0.19647705530252066
SIM,1930,34,25-29,1964,2
STAT,1889,46,35-39,1935,0.16907016496933114
STAT,1817,48,na,1865,907.2852231403126
STAT,1922,34,25-29,1956,10.276079245462252
STAT,1918,25,45-49,1943,1.8260685483218893
STAT,1861,37,15-19,1898,0.04670054579694443
STAT,1913,46,20-24,1959,0.01067754279413582
STAT,1940,7,na,1947,3996.6638239184003
SIM,1836,55,na,1891,1534
SIM,1873,4,na,1877,2562
STAT,1859,22,25-29,1881,47.07545420948238
STAT,1881,25,25-29,1906,40.21826754808525
STAT,1852,36,na,1888,2409.2536374120336
STAT,1941,21,50-100,1962,0.6724783154409866
SIM,1867,22,25-29,1889,530
SIM,1915,28,na,1943,3430
STAT,1849,27,25-29,1876,42.25123524782346
STAT,1842,24,35-39,1866,1.801000148234095
SIM,1862,49,50-100,1911,1
STAT,1864,42,50-100,1906,0.9592444666335301
SIM,1893,8,na,1901,3595
SIM,1945,23,20-24,1968,838
STAT,1924,26,45-49,1950,1.9990322107408325
SIM,1957,14,na,1971,6080
STAT,1817,52,40-44,1869,0.007120841337215142
STAT,1898,49,40-44,1947,0.12714932979717253
STAT,1854,62,na,1916,1016.2508257833452
STAT,1880,38,30-34,1918,5.505481596648971
STAT,1896,26,15-19,1922,0.6001361429272971
STAT,1943,20,40-44,1963,3.5389208271038237
SIM,1846,35,25-29,1881,7
SIM,1860,37,40-44,1897,7
STAT,1930,37,25-29,1967,1.2752715803862429
STAT,1828,108,na,1936,0.0012399490508581525
SIM,1919,6,na,1925,5211
STAT,1833,106,na,1939,0.0049955428763741525
STAT,1833,24,25-29,1857,40.48836136752208
SIM,1872,5,na,1877,2660
SIM,1897,36,25-29,1933,7
STAT,1878,90,na,1968,239.87114122325855
STAT,1850,72,na,1922,583.1564470720103
SIM,1874,35,na,1909,2522
SIM,1879,1,na,1880,2986
STAT,1889,49,30-34,1938,0.06438170722760171
STAT,1897,30,45-49,1927,2.3345018691735855
SIM,1837,35,15-19,1872,1
STAT,1911,33,40-44,1944,3.7518327078331275
STAT,1925,19,15-19,1944,54.02994912048168
STAT,1815,44,30-34,1859,0.11808809537150751
SIM,1885,13,na,1898,1861
STAT,1866,24,20-24,1890,62.5108202995701
STAT,1906,15,30-34,1921,2.318760212722994
STAT,1848,68,na,1916,1430.048377097623
STAT,1845,50,35-39,1895,0.00433335150602412
SIM,1851,42,40-44,1893,9
STAT,1887,67,na,1954,1744.8067660972958
STAT,1820,37,20-24,1857,1.4342012104224537
SIM,1939,29,35-39,1968,39
STAT,1882,35,30-34,1917,5.1510523872181695
STAT,1829,73,na,1902,433.73101300393705
SIM,1824,76,na,1900,1465
STAT,1836,27,15-19,1863,0.449862467836092
STAT,1865,49,45-49,1914,0.2109671286494491
STAT,1908,27,50-100,1935,0.9415776717517146
STAT,1829,35,15-19,1864,0.029508627840712034
STAT,1891,72,na,1963,1787.5948638801754
STAT,1844,21,35-39,1865,7.270337698112426
STAT,1939,31,30-34,1970,15.907811812339988
STAT,1919,33,50-100,1952,0.8764537149825694
SIM,1902,18,na,1920,3458
STAT,1809,45,50-100,1854,2.260248684345602
STAT,1866,101,na,1967,3.0153709109427793
STAT,1849,16,na,1865,2394.855017612199
STAT,1944,15,50-100,1959,0.39886138099506835
STAT,1909,36,20-24,1945,0.24816468774850847
SIM,1829,29,30-34,1858,3
STAT,1900,30,30-34,1930,24.381108074390838
STAT,1855,24,45-49,1879,0.5314469627450616
STAT,1813,47,30-34,1860,0.3560144441486384
SIM,1877,18,na,1895,116
STAT,1932,34,25-29,1966,12.18554130773157
STAT,1838,35,25-29,1873,1.5141870073575732
SIM,1882,30,na,1912,1954
STAT,1835,21,25-29,1856,57.99156780547174
STAT,1931,16,35-39,1947,5.467132834190254
STAT,1871,58,na,1929,1972.7397678251361
STAT,1822,75,na,1897,593.639624584515
STAT,1900,23,25-29,1923,79.05646966386342
SIM,1922,29,25-29,1951,77
STAT,1813,80,na,1893,453.13789434985233
STAT,1902,31,35-39,1933,14.318811182584358
SIM,1833,53,na,1886,2017
STAT,1875,17,25-29,1892,5.818892710074886
STAT,1840,29,30-34,1869,12.18626920509368
SIM,1831,40,na,1871,2133
STAT,1950,16,45-49,1966,0.5852012075500588
SIM,1839,44,na,1883,699
STAT,1879,36,25-29,1915,2.967810996601681
STAT,1898,30,20-24,1928,3.6640659176260413
STAT,1886,15,35-39,1901,0.5708558215784965
STAT,1901,26,35-39,1927,13.537576804680565
STAT,1942,16,50-100,1958,0.3871656694606167
STAT,1862,91,na,1953,49.3565328204825
STAT,1856,17,15-19,1873,5.040142337865851
STAT,1873,35,na,1908,2439.6651938489163
STAT,1831,29,20-24,1860,12.940019126556031
STAT,1833,37,30-34,1870,2.8842967970596476
SIM,1952,19,25-29,1971,980
STAT,1913,47,35-39,1960,0.12426239115084795
STAT,1889,36,25-29,1925,3.483889093761873
STAT,1880,30,35-39,1910,10.597967341477327
SIM,1808,86,na,1894,461
STAT,1854,48,30-34,1902,0.053146229651987446
STAT,1857,22,15-19,1879,2.9225217344009122
SIM,1844,13,na,1857,3028
STAT,1852,37,40-44,1889,4.430250519966051
SIM,1917,36,20-24,1953,2
SIM,1827,59,na,1886,1435
STAT,1792,106,na,1898,0.0029392160619161347
STAT,1847,19,30-34,1866,1.777440629443703
SIM,1890,35,30-34,1925,7
STAT,1811,49,50-100,1860,1.1179256368973498
STAT,1844,78,na,1922,774.0576338191563
STAT,1857,11,na,1868,2162.9027360598097
STAT,1898,21,50-100,1919,0.5500181661362761
STAT,1820,74,na,1894,763.2150245263658
STAT,1876,49,20-24,1925,0.011877612975316771
STAT,1947,19,35-39,1966,4.673878611541083
STAT,1869,30,na,1899,2427.3389612585984
STAT,1855,25,15-19,1880,0.3489362303117528
STAT,1907,27,50-100,1934,0.9333731576823782
STAT,1863,0,na,1863,3278.037519433922
STAT,1915,44,35-39,1959,0.1992017281425893
STAT,1874,25,50-100,1899,0.6646841400982711
SIM,1855,19,30-34,1874,9
SIM,1924,15,30-34,1939,398
STAT,1913,15,na,1928,3917.494894847379
SIM,1855,56,na,1911,2861
STAT,1851,53,30-34,1904,0.004625795300720753
STAT,1929,26,20-24,1955,22.695396132950492
STAT,1940,29,na,1969,3773.4548123333398
STAT,1842,77,na,1919,214.5805700415545
STAT,1884,43,40-44,1927,2.137615658585741
STAT,1875,38,50-100,1913,1.2544572640120213
SIM,1894,71,na,1965,812
STAT,1885,22,35-39,1907,5.735981394719908
STAT,1890,41,15-19,1931,0.016793926340007922
SIM,1848,32,25-29,1880,1
SIM,1875,46,45-49,1921,2
STAT,1819,71,na,1890,310.46443042049117
SIM,1907,55,na,1962,4311
STAT,1877,28,15-19,1905,0.458941499463648
SIM,1962,1,na,1963,4683
STAT,1867,46,45-49,1913,0.22382597924846184
STAT,1920,26,45-49,1946,1.8771977617381215
STAT,1967,1,na,1968,4868.6243876526605
SIM,1900,17,na,1917,4167
SIM,1886,20,na,1906,3124
STAT,1919,12,na,1931,4320.483570377871
STAT,1920,15,20-24,1935,30.26477462134241
SIM,1867,41,na,1908,2093
STAT,1922,31,20-24,1953,2.7363484074068514
STAT,1881,46,50-100,1927,0.23259030831330574
STAT,1891,33,15-19,1924,0.1743837923475878
STAT,1924,20,30-34,1944,33.788885906313936
STAT,1825,89,na,1914,64.6932876138104
STAT,1859,32,35-39,1891,8.026637760235815
STAT,1876,41,25-29,1917,0.652099006172976
STAT,1794,86,na,1880,0.9000490661894371
STAT,1862,97,na,1959,8.177523635685162
STAT,1807,92,na,1899,16.886881738329578
SIM,1890,81,na,1971,2001
SIM,1920,37,na,1957,3772
SIM,1929,26,30-34,1955,2
STAT,1920,37,25-29,1957,1.0641694181562342
STAT,1875,49,50-100,1924,0.24692926862572226
SIM,1925,30,40-44,1955,13
STAT,1944,19,25-29,1963,46.079638516441754
STAT,1908,18,45-49,1926,0.09589775793917839
SIM,1895,30,45-49,1925,6
STAT,1896,25,45-49,1921,1.4735631324747267
STAT,1887,30,45-49,1917,1.9348065689189278
STAT,1897,18,15-19,1915,7.860742420820712
STAT,1866,28,na,1894,2170.794886367066
STAT,1916,15,30-34,1931,2.5626109529893917
SIM,1849,68,na,1917,283
SIM,1852,26,na,1878,2391
STAT,1798,76,na,1874,571.8150796302699
STAT,1829,34,45-49,1863,0.916318965478879
STAT,1874,44,25-29,1918,0.6538029054952346
STAT,1946,4,na,1950,4371.3457552027385
STAT,1832,53,na,1885,1853.4714165358475
STAT,1907,20,30-34,1927,26.144916668824383
STAT,1905,26,35-39,1931,13.925878442447827
STAT,1864,25,25-29,1889,38.86752325104359
STAT,1895,49,30-34,1944,0.06954878862967548
STAT,1902,9,na,1911,3653.659652840987
STAT,1903,37,na,1940,3370.725281164218
STAT,1850,38,45-49,1888,0.9254331002772915
SIM,1932,20,30-34,1952,693
STAT,1914,29,25-29,1943,64.96305723816641
STAT,1938,26,30-34,1964,38.4200149995705
SIM,1856,32,na,1888,769
SIM,1861,62,na,1923,1529
SIM,1930,31,20-24,1961,3
STAT,1918,26,45-49,1944,1.8199877400559763
SIM,1819,46,na,1865,1881
STAT,1915,22,na,1937,3721.498821083534
STAT,1807,100,na,1907,0.4304472157435074
STAT,1903,15,20-24,1918,25.282773351356838
STAT,1927,16,45-49,1943,0.6175730760112857
STAT,1948,24,35-39,1972,10.69343904932435
SIM,1822,39,30-34,1861,3
STAT,1921,10,na,1931,4476.429893077325
STAT,1848,48,30-34,1896,0.08944479863751788
STAT,1824,42,15-19,1866,0.002351756746513729
STAT,1925,18,45-49,1943,0.5963558640107829
SIM,1837,34,45-49,1871,2
STAT,1887,15,50-100,1902,0.0541745863479193
SIM,1836,18,na,1854,2395
SIM,1879,40,45-49,1919,1
STAT,1917,30,40-44,1947,4.075665370635172
STAT,1933,34,30-34,1967,21.060791665384798
SIM,1936,12,na,1948,4041
SIM,1869,82,na,1951,3268
STAT,1926,44,40-44,1970,0.3046911872881051
SIM,1878,30,45-49,1908,15
STAT,1856,45,30-34,1901,0.07022009797046871
STAT,1933,15,30-34,1948,16.28102053866528
STAT,1879,25,45-49,1904,1.1467204848342252
SIM,1889,33,25-29,1922,18
STAT,1837,74,na,1911,889.8657814644861
SIM,1851,8,na,1859,1504
STAT,1906,41,20-24,1947,0.01604202907300313
STAT,1820,68,na,1888,1039.6185464592754
STAT,1894,37,na,1931,2995.998480549987
SIM,1898,28,25-29,1926,308
SIM,1874,29,na,1903,2547
SIM,1843,21,25-29,1864,1
STAT,1874,2,na,1876,3384.844708347324
SIM,1895,37,na,1932,4494
STAT,1899,52,na,1951,2925.365355334207
STAT,1843,42,40-44,1885,2.2881967619038326
SIM,1920,15,na,1935,4708
STAT,1814,40,na,1854,2243.2920423194723
SIM,1887,33,20-24,1920,5
SIM,1840,23,na,1863,2831
SIM,1865,35,35-39,1900,17
STAT,1841,48,45-49,1889,0.26063210084522537
STAT,1833,28,50-100,1861,0.38246874934358477
SIM,1956,5,na,1961,4927
STAT,1862,75,na,1937,876.8350838250522
SIM,1946,19,25-29,1965,57
STAT,1938,19,25-29,1957,42.261575035307736
STAT,1940,23,na,1963,3677.114045440285
SIM,1902,25,20-24,1927,15
SIM,1804,56,na,1860,875
STAT,1892,29,50-100,1921,0.7863386334185329
STAT,1869,51,35-39,1920,0.008728810827833616
STAT,1782,83,na,1865,403.0288756483494
SIM,1823,42,50-100,1865,21
SIM,1862,10,na,1872,3927
SIM,1870,45,na,1915,1670
STAT,1855,35,25-29,1890,1.9236550142285205
STAT,1907,44,30-34,1951,0.11491510388706934
STAT,1944,16,45-49,1960,0.531682220866426
SIM,1846,73,na,1919,319
STAT,1923,41,20-24,1964,0.02045365065824533
STAT,1886,44,50-100,1930,1.0792417920766908
STAT,1829,95,na,1924,4.85512473923808
STAT,1854,45,20-24,1899,0.00673873149540164
STAT,1856,104,na,1960,0.12153042356079473
STAT,1937,23,20-24,1960,107.12711214862381
STAT,1879,38,na,1917,2404.8676482718856
STAT,1883,43,na,1926,2207.450327635806
STAT,1838,24,45-49,1862,0.38067438106940205
STAT,1918,29,25-29,1947,68.60865323386399
STAT,1860,53,40-44,1913,0.008450478459758312
STAT,1899,18,25-29,1917,7.719720245716346
STAT,1848,35,25-29,1883,2.83477185870573
STAT,1891,39,45-49,1930,2.4267751797405124
SIM,1844,47,na,1891,2515
SIM,1865,15,na,1880,1764
STAT,1878,13,na,1891,2652.945730062874
STAT,1850,32,15-19,1882,0.06878988113652906
STAT,1903,37,25-29,1940,0.8821544152049414
STAT,1868,21,20-24,1889,67.04193066627354
SIM,1833,21,25-29,1854,79
SIM,1869,40,45-49,1909,3
SIM,1824,70,na,1894,1465
STAT,1824,48,45-49,1872,0.04050230087507926
SIM,1787,67,na,1854,1329
STAT,1904,47,25-29,1951,0.046203627867227655
STAT,1881,17,na,1898,2385.0505055589706
STAT,1913,24,50-100,1937,0.6520018163177383
STAT,1917,42,35-39,1959,0.2073380957444796
STAT,1876,9,na,1885,2680.011449904812
STAT,1851,18,50-100,1869,0.04676702838872883
SIM,1837,37,na,1874,2044
STAT,1821,53,45-49,1874,0.014684143193291883
STAT,1877,25,35-39,1902,9.861274897428945
STAT,1895,46,20-24,1941,0.008830606045345022
STAT,1924,45,45-49,1969,0.2574656887587052
STAT,1933,35,na,1968,5098.417391271478
STAT,1871,40,35-39,1911,1.8245926319298125
STAT,1941,31,30-34,1972,16.363105155502833
STAT,1858,92,na,1950,31.80617041860619
STAT,1834,52,40-44,1886,0.0047573176516517305
STAT,1923,15,30-34,1938,14.227791227282141
STAT,1851,27,40-44,1878,2.770109865739005
STAT,1854,46,na,1900,1254.5029283663177
STAT,1910,16,35-39,1926,0.8241689258892075
STAT,1926,42,45-49,1968,0.20341453568118217
STAT,1905,39,25-29,1944,0.8848473208210769
SIM,1909,29,25-29,1938,301
SIM,1913,39,25-29,1952,24
STAT,1850,56,na,1906,941.8247877613474
STAT,1936,24,na,1960,3454.2946062083597
STAT,1932,31,20-24,1963,3.2218276091971796
STAT,1869,14,na,1883,2659.505506431167
STAT,1832,99,na,1931,1.6076552535220843
STAT,1924,2,na,1926,4823.542063251014
SIM,1906,30,30-34,1936,49
STAT,1900,33,35-39,1933,13.969675063922212
SIM,1870,61,na,1931,1021
STAT,1909,39,25-29,1948,0.9131954689750197
STAT,1874,60,na,1934,1968.3362721006788
STAT,1912,29,15-19,1941,0.6826920320054992
STAT,1837,42,50-100,1879,0.999573456670079
SIM,1902,24,na,1926,3598
STAT,1835,40,25-29,1875,0.597283607921288
STAT,1874,25,25-29,1899,43.954069259553314
STAT,1918,22,40-44,1940,3.5774805424211693
STAT,1947,16,30-34,1963,13.589410652283837
STAT,1922,36,20-24,1958,0.2968778399508837
SIM,1908,6,na,1914,2941
STAT,1893,33,40-44,1926,5.400298784372057
STAT,1857,32,25-29,1889,7.908303943704159
STAT,1862,41,na,1903,1977.4850694730692
STAT,1832,44,30-34,1876,0.10284131996785215
STAT,1911,36,45-49,1947,0.6541672662061127
SIM,1889,49,40-44,1938,6
STAT,1828,50,35-39,1878,0.010326749677330816
STAT,1801,79,na,1880,257.27472340445456
STAT,1895,41,35-39,1936,0.16432048441745328
STAT,1879,33,20-24,1912,2.7612036982540014
STAT,1893,49,20-24,1942,0.008288083280693914
SIM,1840,44,30-34,1884,10
STAT,1857,29,na,1886,1859.3042288338181
SIM,1917,22,30-34,1939,57
SIM,1865,32,25-29,1897,12
STAT,1909,22,30-34,1931,26.440561819942975
STAT,1925,25,50-100,1950,1.1727699730480843
STAT,1903,26,45-49,1929,1.5814964512534708
STAT,1813,64,na,1877,1537.5920936512327
STAT,1893,21,na,1914,2966.488203618852
STAT,1920,23,40-44,1943,3.6785341992611875
STAT,1913,44,30-34,1957,0.12269937247846997
SIM,1831,24,na,1855,2209
SIM,1892,46,45-49,1938,1
STAT,1838,21,35-39,1859,3.255259294091549
STAT,1884,46,45-49,1930,0.22655770407559905
SIM,1891,47,na,1938,1897
SIM,1871,30,35-39,1901,1
STAT,1915,41,30-34,1956,0.12707645357859612
STAT,1828,91,na,1919,39.226628064033555
STAT,1877,65,na,1942,1715.5153360199795
STAT,1875,64,na,1939,1785.037202870951
STAT,1918,48,25-29,1966,0.05553240902535658
STAT,1900,20,20-24,1920,96.03306273415008
STAT,1838,32,20-24,1870,1.433818886862273
STAT,1896,20,45-49,1916,0.9247139064515588
STAT,1836,43,na,1879,1889.7956116875998
SIM,1886,14,na,1900,3155
STAT,1865,43,15-19,1908,0.012517171889225027
STAT,1873,54,20-24,1927,7.36127245978767E-4
SIM,1778,84,na,1862,124
STAT,1873,19,40-44,1892,0.18661207224157547
SIM,1849,22,na,1871,2529
STAT,1880,69,na,1949,1523.536699995022
STAT,1867,43,40-44,1910,2.11184130767915
SIM,1868,57,na,1925,719
SIM,1910,3,na,1913,4577
STAT,1930,21,na,1951,4659.373312192329
STAT,1924,30,50-100,1954,0.959651140312391
STAT,1806,54,30-34,1860,0.015066558765049138
STAT,1857,35,35-39,1892,5.479032586483151
STAT,1893,47,50-100,1940,0.17243900483945518
STAT,1873,45,30-34,1918,0.10028540088793006
STAT,1880,22,50-100,1902,0.4233494286216193
STAT,1933,37,35-39,1970,3.2721440425352455
STAT,1809,50,25-29,1859,0.030467120855103915
STAT,1937,20,40-44,1957,3.2426670767069874
STAT,1836,24,35-39,1860,5.816960039180509
STAT,1859,49,20-24,1908,0.009312527017685247
STAT,1895,68,na,1963,2191.5701932315606
STAT,1913,34,15-19,1947,0.12516763182929466
STAT,1945,20,na,1965,3960.8563686530874
STAT,1866,19,40-44,1885,0.1693553718243366
STAT,1835,67,na,1902,1199.4631853829267
STAT,1854,40,35-39,1894,1.017003899303129
STAT,1898,33,25-29,1931,13.71527830034707
STAT,1901,23,30-34,1924,24.82844709729041
STAT,1888,15,50-100,1903,0.056807362783265376
STAT,1838,105,na,1943,0.0125044523594261
STAT,1924,39,na,1963,4384.338195569338
STAT,1895,46,50-100,1941,0.18073306323903326
STAT,1906,18,35-39,1924,0.792488236607736
SIM,1940,8,na,1948,4338
STAT,1931,29,25-29,1960,84.29608779502301
SIM,1850,25,na,1875,1852
STAT,1865,46,40-44,1911,0.15674784702201222
STAT,1945,8,na,1953,4259.887285728773
STAT,1863,46,15-19,1909,3.4245416909817916E-4
SIM,1924,27,na,1951,5239
STAT,1813,44,20-24,1857,0.6459974811169538
STAT,1903,53,na,1956,3026.516007975043
SIM,1769,88,na,1857,178
STAT,1824,58,na,1882,412.741600589539
STAT,1908,15,40-44,1923,0.27046997307192683
STAT,1864,22,20-24,1886,63.656216209196565
STAT,1889,50,na,1939,2630.231518090287
STAT,1878,21,45-49,1899,0.7196187634446105
STAT,1879,22,40-44,1901,2.137654132371716
STAT,1878,30,35-39,1908,10.503179460127406
STAT,1911,37,15-19,1948,0.018338982603516234
STAT,1870,92,na,1962,92.15509344294765
STAT,1927,41,na,1968,4626.534000977104
STAT,1867,48,40-44,1915,0.1598745946052997
STAT,1900,48,na,1948,3078.08273413976
STAT,1924,18,50-100,1942,0.4407090284367872
STAT,1865,86,na,1951,202.57097403331733
STAT,1930,15,50-100,1945,0.48320486219185455
STAT,1906,44,25-29,1950,0.06370179570374512
SIM,1829,39,40-44,1868,8
STAT,1857,44,25-29,1901,0.48611511212909664
STAT,1853,49,50-100,1902,0.1864593167017106
STAT,1889,40,20-24,1929,0.19317637321381545
SIM,1905,25,30-34,1930,48
STAT,1907,27,na,1934,3482.168573080978
STAT,1942,15,40-44,1957,1.4457802958833212
SIM,1845,78,na,1923,320
SIM,1831,24,25-29,1855,8
STAT,1875,53,40-44,1928,0.010636768693865229
STAT,1850,35,40-44,1885,2.096461551918784
STAT,1862,54,45-49,1916,0.012020904046987576
STAT,1936,18,20-24,1954,128.1744016307124
SIM,1848,34,20-24,1882,21
SIM,1886,30,35-39,1916,9
STAT,1883,25,35-39,1908,9.345662742559446
STAT,1886,85,na,1971,622.3528762187434
SIM,1859,46,na,1905,1706
STAT,1866,38,40-44,1904,3.976046993243536
STAT,1877,71,na,1948,1354.9832639253216
STAT,1822,45,15-19,1867,6.877013028700708E-4
SIM,1922,26,20-24,1948,38
SIM,1864,11,na,1875,2555
SIM,1850,42,50-100,1892,4
SIM,1923,41,30-34,1964,1
STAT,1914,26,20-24,1940,18.20816599666865
STAT,1885,39,20-24,1924,0.7500794518754608
STAT,1890,15,25-29,1905,6.892056051220149
STAT,1807,47,30-34,1854,0.34051066691640347
STAT,1907,23,35-39,1930,8.488220764488373
STAT,1862,17,15-19,1879,5.78915169445724
STAT,1841,73,na,1914,1322.6398180997294
STAT,1843,50,25-29,1893,0.003549958878383481
STAT,1898,22,45-49,1920,0.9377000298610563
STAT,1818,48,20-24,1866,0.02107796640230313
SIM,1857,63,na,1920,1115
SIM,1907,33,na,1940,4625
STAT,1874,38,30-34,1912,5.47319637607164
STAT,1857,21,45-49,1878,0.6222069453403819
STAT,1882,18,na,1900,2411.7059525665936
STAT,1804,81,na,1885,404.92857504331386
STAT,1891,36,40-44,1927,5.409050407786279
STAT,1898,36,35-39,1934,9.556853613143137
STAT,1844,38,20-24,1882,0.7986545402920096
STAT,1876,22,25-29,1898,57.87004860045505
STAT,1893,38,40-44,1931,5.44703706473679
STAT,1900,26,na,1926,3317.361231607089
STAT,1904,31,45-49,1935,2.501573078573119
SIM,1882,64,na,1946,1204
SIM,1907,37,35-39,1944,2
STAT,1868,46,50-100,1914,0.2378913879368131
SIM,1832,45,40-44,1877,1
SIM,1882,38,30-34,1920,12
SIM,1918,28,20-24,1946,9
STAT,1935,26,20-24,1961,24.71458449879864
SIM,1901,41,35-39,1942,1
STAT,1842,21,na,1863,674.3094755666444
STAT,1915,56,na,1971,3513.6457311377485
STAT,1810,50,na,1860,87.949277320555
STAT,1881,15,15-19,1896,5.630318064257727
STAT,1939,9,na,1948,3932.4081814286296
STAT,1955,16,20-24,1971,178.4554769228771
SIM,1819,40,na,1859,1883
STAT,1933,18,35-39,1951,5.5644034195797
STAT,1807,86,na,1893,89.96037474405642
SIM,1837,43,na,1880,1966
STAT,1824,45,40-44,1869,0.03038655304921738
STAT,1855,40,50-100,1895,0.7062535540978655
STAT,1861,30,25-29,1891,8.586660169537911
STAT,1845,26,na,1871,1316.0312360351465
STAT,1826,84,na,1910,265.21110202906135
SIM,1904,22,20-24,1926,79
SIM,1943,26,20-24,1969,21
STAT,1826,47,40-44,1873,0.24500297277301752
STAT,1918,33,50-100,1951,0.8630749031791367
STAT,1918,37,45-49,1955,0.7088555033642426
STAT,1900,34,50-100,1934,1.2583946975336109
SIM,1855,29,40-44,1884,4
STAT,1879,22,35-39,1901,5.98626796074957
STAT,1838,21,40-44,1859,1.1624301697789206
STAT,1898,23,15-19,1921,4.422544994146044
STAT,1926,23,45-49,1949,1.351043543929906
SIM,1902,33,40-44,1935,3
STAT,1907,47,35-39,1954,0.11469010463368007
SIM,1821,44,20-24,1865,1
SIM,1833,37,40-44,1870,22
STAT,1948,21,30-34,1969,32.67375960136981
STAT,1870,70,na,1940,1398.771161708843
STAT,1843,45,45-49,1888,0.23811529550511792
SIM,1835,20,20-24,1855,1
STAT,1833,47,40-44,1880,0.08596758655028615
STAT,1848,39,40-44,1887,4.134612004278463
STAT,1892,28,40-44,1920,3.6957342471727928
STAT,1890,47,na,1937,2711.4797295053077
STAT,1916,25,40-44,1941,4.785870233934808
STAT,1911,31,45-49,1942,1.5212213752434305
STAT,1880,35,20-24,1915,0.8078603725306551
STAT,1920,34,20-24,1954,2.6147850536976214
STAT,1847,29,40-44,1876,3.208708484733335
STAT,1882,12,na,1894,2472.520731079922
STAT,1912,41,45-49,1953,0.15956596744847354
STAT,1825,37,40-44,1862,6.300703242557247
SIM,1897,63,na,1960,1515
SIM,1791,66,na,1857,990
STAT,1863,100,na,1963,3.0303515028719534
STAT,1907,45,45-49,1952,0.19617679832791465
STAT,1854,49,50-100,1903,0.1337067160866974
STAT,1865,32,15-19,1897,0.13001693428122793
SIM,1878,19,na,1897,4277
STAT,1877,32,50-100,1909,0.9300995045791653
STAT,1855,9,na,1864,1917.844312418782
STAT,1892,17,25-29,1909,7.0159415314716975
SIM,1878,81,na,1959,972
SIM,1869,0,na,1869,3989
STAT,1899,15,20-24,1914,24.3273267863808
STAT,1837,48,30-34,1885,0.07954524870539784
STAT,1829,31,35-39,1860,5.728572830635324
STAT,1859,52,na,1911,1697.4997906432523
STAT,1876,44,35-39,1920,1.8058569883754705
STAT,1913,34,20-24,1947,2.3758232438077127
SIM,1810,59,na,1869,3098
STAT,1926,22,30-34,1948,34.61783334319329
SIM,1871,46,na,1917,1839
STAT,1837,19,50-100,1856,0.051740763579954364
SIM,1884,44,35-39,1928,5
STAT,1922,39,25-29,1961,1.1055006698989924
STAT,1928,19,30-34,1947,15.159720168894982
STAT,1785,75,na,1860,178.1327325551107
SIM,1956,13,na,1969,4927
STAT,1864,29,40-44,1893,2.7038217369262014
STAT,1923,18,35-39,1941,4.862666315673421
STAT,1901,18,15-19,1919,8.276038843367381
STAT,1879,91,na,1970,207.91716088609425
STAT,1922,34,30-34,1956,17.516779312009962
STAT,1896,22,35-39,1918,7.692496894175963
SIM,1894,4,na,1898,1798
STAT,1880,88,na,1968,362.2115311683561
STAT,1821,50,40-44,1871,0.011305598024444852
STAT,1853,61,na,1914,1448.918903007889
STAT,1859,21,35-39,1880,5.3114977458726775
STAT,1881,26,15-19,1907,0.4299233174241731
STAT,1916,28,45-49,1944,1.7557231334198347
STAT,1883,22,25-29,1905,55.072751143741925
SIM,1909,5,na,1914,4331
SIM,1909,26,20-24,1935,19
STAT,1922,47,50-100,1969,0.2569390937089862
SIM,1822,69,na,1891,205
STAT,1789,65,na,1854,1351.0
STAT,1809,53,35-39,1862,0.0696563789216488
SIM,1893,73,na,1966,1380
STAT,1860,49,na,1909,1797.080681285219
SIM,1932,35,35-39,1967,16
STAT,1848,15,na,1863,2694.431468152801
STAT,1857,25,25-29,1882,33.92014306294905
SIM,1875,32,25-29,1907,37
STAT,1888,28,15-19,1916,0.5218037655990131
STAT,1913,44,25-29,1957,0.06853478490802359
SIM,1822,44,na,1866,1537
STAT,1822,94,na,1916,11.524977893869796
SIM,1948,18,na,1966,5701
STAT,1883,34,25-29,1917,9.769463258833277
STAT,1805,49,30-34,1854,0.11578780485013031
STAT,1870,27,15-19,1897,0.4523110940542497
STAT,1861,2,na,1863,2862.6936677860404
STAT,1833,51,50-100,1884,0.006804481818514982
STAT,1842,12,na,1854,761.0
SIM,1824,31,25-29,1855,12
STAT,1848,49,45-49,1897,0.21623176560424678
SIM,1889,59,na,1948,2954
STAT,1844,20,20-24,1864,86.47796146224152
SIM,1916,27,50-100,1943,17
SIM,1911,38,na,1949,2516
STAT,1892,73,na,1965,1761.380497852343
STAT,1863,103,na,1966,0.7148746636099417
STAT,1912,11,na,1923,3953.021038824571
SIM,1817,41,35-39,1858,3
STAT,1866,25,35-39,1891,8.86747694120668
STAT,1816,43,25-29,1859,2.0553585076040273
STAT,1902,22,45-49,1924,0.9819406452376015
STAT,1904,44,15-19,1948,0.0013516012588883847
STAT,1874,36,40-44,1910,4.539618830926311
STAT,1942,29,50-100,1971,1.0317191996426178
STAT,1873,15,25-29,1888,5.881899293177405
STAT,1884,3,na,1887,2832.0948012434546
STAT,1912,17,20-24,1929,27.096452784652847
STAT,1924,35,35-39,1959,2.8296317900548993
STAT,1903,27,15-19,1930,0.6440358433295115
STAT,1855,21,35-39,1876,4.5445602615353975
STAT,1937,23,45-49,1960,1.084013102604185
STAT,1918,45,20-24,1963,0.011656107863837153
SIM,1929,16,20-24,1945,990
STAT,1889,20,45-49,1909,0.8447424013980606
SIM,1855,37,na,1892,3086
STAT,1876,32,35-39,1908,10.237532372050161
STAT,1922,27,25-29,1949,73.64877688736397
STAT,1848,42,25-29,1890,0.6001743877565969
STAT,1955,13,na,1968,5168.221769893777
SIM,1857,5,na,1862,1543
SIM,1942,15,na,1957,3646
STAT,1857,50,50-100,1907,0.011755809995063959
STAT,1909,32,40-44,1941,3.696369135679762
SIM,1897,54,na,1951,2042
SIM,1963,3,na,1966,5558
STAT,1919,46,50-100,1965,0.2426666992009289
SIM,1815,45,40-44,1860,2
STAT,1836,27,na,1863,2142.1671980680135
STAT,1930,34,15-19,1964,0.1644631374435604
STAT,1833,21,15-19,1854,3.6751333957835817
STAT,1912,33,na,1945,3662.7622532957444
STAT,1855,29,30-34,1884,17.12327386385604
STAT,1892,70,na,1962,1927.3285260175
SIM,1929,36,na,1965,6115
STAT,1822,39,20-24,1861,1.4483865374406724
STAT,1885,31,50-100,1916,0.9043034944837259
STAT,1942,18,45-49,1960,0.515911206331979
STAT,1888,23,20-24,1911,79.29053192371843
STAT,1823,54,30-34,1877,0.008588762776218686
STAT,1883,15,25-29,1898,5.476966647080099
SIM,1891,60,na,1951,1305
STAT,1823,57,na,1880,1725.2827313802666
STAT,1909,44,40-44,1953,0.22872533193553993
SIM,1950,10,na,1960,4854
SIM,1939,20,25-29,1959,362
STAT,1877,23,45-49,1900,0.7056780136939325
STAT,1830,36,na,1866,1971.960302540553
STAT,1835,43,35-39,1878,1.620768412697651
STAT,1889,32,45-49,1921,2.0999543062064783
STAT,1862,51,40-44,1913,0.009009733845777839
STAT,1882,43,15-19,1925,0.013126162132759125
SIM,1896,23,20-24,1919,2
STAT,1859,77,na,1936,685.1108342014609
STAT,1903,39,15-19,1942,0.017031979320278386
STAT,1955,17,35-39,1972,5.521762178380209
SIM,1858,42,na,1900,2320
STAT,1884,44,na,1928,2182.6216194438416
STAT,1942,24,30-34,1966,29.770476640070875
SIM,1883,38,50-100,1921,1
STAT,1868,38,15-19,1906,0.053969034000609616
STAT,1898,26,25-29,1924,57.07864001144006
STAT,1929,24,30-34,1953,35.86499825620218
STAT,1930,30,na,1960,4852.090894543156
STAT,1898,45,25-29,1943,0.044127042821422914
STAT,1847,27,15-19,1874,0.49303965439004716
STAT,1893,22,25-29,1915,71.58722982774178
SIM,1866,93,na,1959,180
STAT,1861,27,40-44,1888,2.509339009719195
STAT,1919,43,20-24,1962,0.018854212221279573
STAT,1904,38,na,1942,3375.7080450001276
STAT,1929,29,25-29,1958,81.7175704715719
SIM,1929,33,na,1962,6215
STAT,1901,17,45-49,1918,0.09133491849540037
STAT,1847,25,25-29,1872,46.63635080344105
STAT,1847,25,50-100,1872,0.7052462548588512
STAT,1948,23,20-24,1971,126.32543577049695
STAT,1936,3,na,1939,3844.718823197444
STAT,1791,97,na,1888,1.2742505417985242
STAT,1833,38,45-49,1871,1.0654108254416454
SIM,1855,31,na,1886,3231
STAT,1846,46,15-19,1892,2.3757676087505294E-4
STAT,1841,42,15-19,1883,0.01597981540806567
STAT,1900,23,na,1923,3266.1436933003747
SIM,1846,54,na,1900,901
SIM,1889,26,25-29,1915,302
STAT,1920,18,25-29,1938,47.86857410423728
STAT,1838,25,15-19,1863,0.24994231375509188
STAT,1916,34,30-34,1950,15.906805460730123
STAT,1857,38,30-34,1895,4.0694274187162085
STAT,1883,19,40-44,1902,0.17501700184591654
STAT,1889,43,25-29,1932,0.7677154057898543
STAT,1811,54,na,1865,1624.9537024437896
STAT,1835,31,35-39,1866,9.857021428460794
STAT,1851,16,25-29,1867,5.473677401826502
STAT,1945,5,na,1950,4294.451292413911
STAT,1910,19,45-49,1929,0.09735006430333576
STAT,1859,31,20-24,1890,2.1511797074638714
STAT,1878,49,30-34,1927,0.0975150837017615
SIM,1839,42,25-29,1881,1
STAT,1916,22,30-34,1938,29.70611169092879
STAT,1872,37,na,1909,2359.18033983691
STAT,1852,31,35-39,1883,10.664609886121402
STAT,1861,96,na,1957,9.544648269755019
STAT,1836,104,na,1940,0.05104800803266615
STAT,1842,21,25-29,1863,18.053765889774272
SIM,1867,31,20-24,1898,2
STAT,1838,102,na,1940,0.12503099540463894
STAT,1891,16,50-100,1907,0.060394688689968286
STAT,1924,36,na,1960,4397.693690193694
STAT,1832,40,15-19,1872,0.0011821017115859107
SIM,1908,34,na,1942,2457
SIM,1905,28,35-39,1933,9
STAT,1888,16,15-19,1904,6.866265443080185
SIM,1860,31,35-39,1891,7
STAT,1893,36,na,1929,2960.395282952936
STAT,1800,91,na,1891,39.98256215452321
STAT,1842,33,25-29,1875,3.0398784861535884
STAT,1893,58,na,1951,2473.040664178221
STAT,1884,22,na,1906,2263.9957490440065
SIM,1865,25,25-29,1890,112
STAT,1936,31,50-100,1967,0.7955665309945819
SIM,1900,34,45-49,1934,1
STAT,1797,60,na,1857,39.5772768397994
STAT,1872,59,na,1931,1946.106469698547
STAT,1916,16,45-49,1932,0.10479606316568048
STAT,1898,39,30-34,1937,1.53131622695839
STAT,1952,15,35-39,1967,4.985246312383372
SIM,1848,25,25-29,1873,3
SIM,1834,54,na,1888,727
SIM,1879,44,na,1923,1068
SIM,1892,23,na,1915,3001
STAT,1888,15,45-49,1903,0.07574315037768717
SIM,1850,21,25-29,1871,243
STAT,1904,16,na,1920,3617.1853137302323
STAT,1836,22,45-49,1858,0.7051987871201719
SIM,1900,60,na,1960,3838
STAT,1807,48,45-49,1855,0.8024000945907029
STAT,1817,54,na,1871,817.5386113105486
SIM,1907,34,30-34,1941,58
STAT,1930,41,20-24,1971,0.02310667611567271
SIM,1850,9,na,1859,2440
STAT,1827,43,50-100,1870,0.9892183564921212
SIM,1809,62,na,1871,235
STAT,1949,10,na,1959,4524.731338276407
SIM,1869,30,35-39,1899,5
SIM,1924,34,30-34,1958,5
STAT,1861,33,35-39,1894,8.386561846509197
STAT,1901,24,45-49,1925,0.9689019089758236
SIM,1889,33,30-34,1922,13
STAT,1874,39,45-49,1913,2.036703945024485
SIM,1855,25,25-29,1880,158
STAT,1891,29,50-100,1920,0.7810257993042559
STAT,1897,11,na,1908,3434.824139830183
STAT,1943,28,na,1971,3942.2504446180797
STAT,1861,21,35-39,1882,5.02176897541528
STAT,1822,37,30-34,1859,10.751928334294616
STAT,1802,77,na,1879,502.2924870772733
STAT,1847,67,na,1914,1433.222321061686
STAT,1898,73,na,1971,2024.6761529628932
STAT,1937,2,na,1939,3937.6177135046923
STAT,1859,71,na,1930,1057.953113127527
STAT,1860,31,na,1891,1954.6894542040038
SIM,1850,33,25-29,1883,17
STAT,1826,31,25-29,1857,22.017072320234448
STAT,1935,34,40-44,1969,5.368172941488736
SIM,1895,6,na,1901,4648
STAT,1877,74,na,1951,1126.5689631526882
STAT,1831,39,30-34,1870,5.280075162209372
SIM,1810,44,45-49,1854,2
STAT,1873,81,na,1954,554.7052107306359
STAT,1841,76,na,1917,1054.9955739965399
STAT,1935,22,40-44,1957,4.5457458638310735
SIM,1860,83,na,1943,1638
SIM,1910,53,na,1963,3794
SIM,1935,14,na,1949,5853
STAT,1852,44,40-44,1896,2.2335328905149336
SIM,1821,81,na,1902,446
SIM,1908,32,30-34,1940,1
STAT,1833,31,25-29,1864,5.879803459331137
STAT,1907,26,45-49,1933,1.6255993526223644
STAT,1937,25,na,1962,3617.1136634685977
STAT,1851,57,na,1908,1587.1916389842668
STAT,1902,41,45-49,1943,0.14701197971533878
STAT,1914,1,na,1915,4245.8473268633925
SIM,1879,66,na,1945,798
STAT,1890,19,40-44,1909,0.22023632137355173
STAT,1926,20,40-44,1946,4.074006496053735
STAT,1860,34,na,1894,1930.0667098826643
STAT,1863,23,na,1886,2044.5231435588025
STAT,1879,26,15-19,1905,0.46702336236410624
STAT,1862,24,50-100,1886,0.35047220689477654
STAT,1848,32,15-19,1880,0.15540658185896977
STAT,1926,25,35-39,1951,17.964514694603313
SIM,1955,9,na,1964,3826
STAT,1779,97,na,1876,1.486979967204518
STAT,1842,27,30-34,1869,7.730626829489249
STAT,1893,45,40-44,1938,0.12196876680802068
STAT,1922,37,35-39,1959,2.7215228174164077
SIM,1879,41,na,1920,1224
STAT,1892,15,35-39,1907,0.6825097800561196
STAT,1808,108,na,1916,4.2899650765826667E-4
STAT,1873,41,15-19,1914,0.014229938893983055
SIM,1856,19,na,1875,1075
SIM,1926,26,20-24,1952,33
STAT,1809,47,40-44,1856,1.5061418438192675
STAT,1853,106,na,1959,0.02175541440784145
STAT,1863,38,30-34,1901,4.527358450203702
STAT,1826,54,40-44,1880,0.01397887206427811
STAT,1866,22,30-34,1888,16.39214496342643
STAT,1888,26,25-29,1914,48.99031137910867
STAT,1911,24,45-49,1935,1.0484835383517215
SIM,1905,23,na,1928,3604
SIM,1950,19,15-19,1969,1123
STAT,1826,36,50-100,1862,2.0586378819706503
STAT,1928,29,na,1957,4575.594493342249
STAT,1938,16,20-24,1954,132.63018986697602
SIM,1824,33,15-19,1857,1
STAT,1871,45,20-24,1916,0.01208986498821517
STAT,1827,37,15-19,1864,0.05537257984666816
STAT,1935,29,25-29,1964,88.98790700216068
SIM,1899,30,20-24,1929,2
STAT,1943,23,45-49,1966,1.1830497719658544
STAT,1889,47,40-44,1936,0.11575111771155279
STAT,1802,55,na,1857,1563.302435172076
STAT,1864,19,30-34,1883,1.4813490766058448
STAT,1900,45,35-39,1945,0.1104889423356894
STAT,1913,37,25-29,1950,0.9594790089786516
STAT,1928,33,20-24,1961,3.0248432162230174
STAT,1847,52,na,1899,1936.3520542025199
SIM,1880,38,na,1918,3291
STAT,1804,54,20-24,1858,0.004476488193479916
STAT,1905,49,50-100,1954,0.19510281242468047
STAT,1942,19,15-19,1961,46.854137889886395
STAT,1835,37,40-44,1872,4.094765214745231
SIM,1918,7,na,1925,4480
STAT,1934,11,na,1945,5331.029626183006
STAT,1861,38,20-24,1899,0.6378913356121648
STAT,1866,27,25-29,1893,38.613528629044126
SIM,1876,52,na,1928,3199
STAT,1867,51,25-29,1918,0.003365815534143112
STAT,1887,47,15-19,1934,4.3821634871106334E-4
SIM,1850,27,30-34,1877,7
STAT,1918,34,40-44,1952,4.067241655723735
STAT,1871,74,na,1945,1107.0625211025806
STAT,1811,51,na,1862,1724.4250828250829
STAT,1848,46,40-44,1894,0.1606594540733092
STAT,1792,79,na,1871,363.64374850589473
SIM,1936,33,20-24,1969,9
STAT,1896,47,na,1943,2952.526639643652
SIM,1880,23,na,1903,3268
STAT,1894,28,15-19,1922,0.5749238275968799
STAT,1874,22,15-19,1896,3.4048122206114013
STAT,1879,29,na,1908,2430.6929499919634
STAT,1913,41,20-24,1954,0.017104052483872628
STAT,1776,98,na,1874,1.0818410217590713
SIM,1946,16,20-24,1962,134
STAT,1802,104,na,1906,0.03379472066745985
SIM,1941,16,45-49,1957,183
STAT,1916,29,15-19,1945,0.7148286735616128
STAT,1933,16,45-49,1949,0.6658001889757674
STAT,1865,89,na,1954,95.91292708815483
SIM,1874,34,25-29,1908,7
STAT,1942,27,35-39,1969,15.577561445575704
SIM,1864,67,na,1931,1421
STAT,1852,21,25-29,1873,68.94816870095866
STAT,1868,33,50-100,1901,0.8812402843234487
STAT,1922,26,na,1948,4206.094868082956
SIM,1800,66,na,1866,216
SIM,1893,34,35-39,1927,1
STAT,1842,18,40-44,1860,0.057962146780888686
STAT,1866,34,25-29,1900,9.269593025346532
STAT,1883,28,30-34,1911,24.14079951366261
STAT,1883,24,15-19,1907,3.1539350564989483
SIM,1932,22,na,1954,6352
SIM,1871,38,30-34,1909,1
SIM,1856,16,na,1872,1192
STAT,1902,18,50-100,1920,0.06880767527896278
STAT,1935,24,50-100,1959,0.8889737010122746
STAT,1838,56,na,1894,869.8472951252648
STAT,1871,71,na,1942,1331.5218484406817
STAT,1838,29,30-34,1867,13.478424648019224
STAT,1885,34,35-39,1919,9.869167506448521
STAT,1882,53,50-100,1935,0.014227364099716608
STAT,1914,16,35-39,1930,0.8580351513814723
SIM,1856,49,45-49,1905,5
SIM,1941,25,35-39,1966,53
STAT,1921,19,20-24,1940,151.88703238341412
STAT,1934,14,na,1948,5305.853535954588
SIM,1790,65,na,1855,1351
STAT,1844,34,50-100,1878,1.0631645816681161
STAT,1805,69,na,1874,283.71384277063515
SIM,1793,76,na,1869,591
STAT,1807,95,na,1902,5.3907165322908375
SIM,1829,35,25-29,1864,12
SIM,1827,44,50-100,1871,4
STAT,1857,48,40-44,1905,0.12972157831820877
SIM,1839,60,na,1899,334
SIM,1842,16,25-29,1858,3
STAT,1869,19,15-19,1888,6.000062675495586
STAT,1842,23,15-19,1865,1.0255388565646413
SIM,1893,70,na,1963,1380
STAT,1836,19,50-100,1855,0.08872370116228963
SIM,1902,27,na,1929,3526
STAT,1849,93,na,1942,24.625079374344303
STAT,1835,48,20-24,1883,0.009448576638939133
SIM,1878,32,35-39,1910,32
SIM,1872,71,na,1943,1751
SIM,1915,22,20-24,1937,9
STAT,1925,15,40-44,1940,1.6819616844700551
STAT,1816,47,40-44,1863,0.5207273120725386
STAT,1903,18,25-29,1921,8.022909340684022
SIM,1849,49,50-100,1898,6
STAT,1848,31,45-49,1879,1.9228606429027526
STAT,1847,22,20-24,1869,76.37979909559468
STAT,1929,16,50-100,1945,0.4759533786087004
STAT,1796,106,na,1902,0.004754925810958651
SIM,1891,28,30-34,1919,109
SIM,1846,79,na,1925,319
SIM,1911,18,25-29,1929,28
STAT,1919,46,25-29,1965,0.05691205934595698
STAT,1822,91,na,1913,33.41562644428867
STAT,1931,26,20-24,1957,23.411526969362935
STAT,1924,23,35-39,1947,10.969915360292443
STAT,1826,50,25-29,1876,0.00509153332997407
SIM,1956,10,na,1966,4927
STAT,1929,27,35-39,1956,18.65819530619209
SIM,1852,42,na,1894,2039
SIM,1853,27,na,1880,3303
SIM,1893,21,20-24,1914,1
STAT,1835,42,na,1877,1906.0672881320902
STAT,1899,4,na,1903,3593.1703470078974
SIM,1923,26,na,1949,3329
SIM,1948,22,25-29,1970,20
STAT,1830,44,20-24,1874,0.13684324659401262
STAT,1907,22,20-24,1929,100.55000369414687
STAT,1893,41,25-29,1934,0.8066687786569398
STAT,1828,94,na,1922,13.529179889617449
STAT,1818,43,35-39,1861,3.4424200129371
STAT,1903,34,20-24,1937,2.184355201790697
SIM,1920,12,na,1932,4786
STAT,1890,45,30-34,1935,0.118355085572588
STAT,1923,47,50-100,1970,0.26180725364199975
STAT,1953,18,20-24,1971,162.48206776682204
STAT,1857,29,40-44,1886,2.333798613621854
STAT,1916,18,35-39,1934,0.8758296886858143
STAT,1916,37,35-39,1953,2.4431493878846724
STAT,1883,38,40-44,1921,4.190458514162772
STAT,1889,33,15-19,1922,0.17076719171368665
SIM,1914,12,na,1926,5124
SIM,1917,48,na,1965,1988
STAT,1911,40,50-100,1951,0.1121213485671116
STAT,1917,33,45-49,1950,1.6189227329297164
STAT,1814,65,na,1879,1364.3805328024782
STAT,1829,79,na,1908,255.29189658509222
STAT,1779,94,na,1873,6.481383311857696
STAT,1887,33,na,1920,2615.464559360098
STAT,1838,39,40-44,1877,2.2084936952215575
STAT,1872,36,15-19,1908,0.05650155157315284
STAT,1858,53,40-44,1911,0.007910505832508
SIM,1826,30,20-24,1856,7
SIM,1831,43,na,1874,2117
STAT,1855,19,na,1874,1785.7225710760283
STAT,1857,45,na,1902,1743.6528945875734
SIM,1944,25,na,1969,2490
STAT,1909,44,na,1953,3396.1845288375225
STAT,1909,47,45-49,1956,0.19767840403729153
SIM,1790,87,na,1877,101
SIM,1855,22,20-24,1877,579
SIM,1903,41,45-49,1944,5
STAT,1922,24,20-24,1946,125.30303263478673
STAT,1938,29,35-39,1967,14.700177902009385
STAT,1920,16,50-100,1936,0.4159554846028635
STAT,1926,36,15-19,1962,0.023288996859405102
STAT,1874,21,45-49,1895,0.7218550266059922
SIM,1840,57,na,1897,2500
SIM,1860,86,na,1946,295
STAT,1938,15,50-100,1953,0.3673174151927341
STAT,1944,16,20-24,1960,144.29858375623914
SIM,1935,11,na,1946,5881
STAT,1864,15,15-19,1879,6.206022647704231
STAT,1907,35,35-39,1942,2.2486528883319132
STAT,1898,35,15-19,1933,0.07622912873758864
SIM,1924,37,35-39,1961,2
STAT,1790,108,na,1898,5.326112232315244E-4
STAT,1799,101,na,1900,0.03794573752205012
STAT,1872,34,na,1906,2369.097044083662
STAT,1785,72,na,1857,236.72021510392
STAT,1895,62,na,1957,2425.1939927830676
STAT,1918,26,20-24,1944,19.229971617717126
STAT,1875,48,na,1923,2281.2255817200466
STAT,1789,107,na,1896,0.0020053737715239797
STAT,1920,27,15-19,1947,0.7644548570558354
STAT,1873,17,15-19,1890,6.087541261234993
STAT,1860,25,50-100,1885,0.5351040718446924
STAT,1903,23,40-44,1926,2.948849825335144
STAT,1880,47,20-24,1927,0.012399774745094233
SIM,1867,56,na,1923,1867
SIM,1892,48,na,1940,3507
STAT,1837,90,na,1927,63.217016701519185
STAT,1926,35,45-49,1961,0.8274377891741053
STAT,1842,37,40-44,1879,1.2747703736615739
STAT,1853,2,na,1855,2793.4074
STAT,1921,31,45-49,1952,1.7374565844064398
STAT,1835,64,na,1899,1315.337789733641
STAT,1897,38,50-100,1935,1.622418847944188
STAT,1933,35,45-49,1968,0.9238438595536528
STAT,1802,52,50-100,1854,0.07672236337596768
STAT,1876,38,40-44,1914,4.403303500125699
STAT,1894,30,50-100,1924,1.1745171329256299
STAT,1946,7,na,1953,4329.252953321993
STAT,1913,22,20-24,1935,106.39657815572325
STAT,1885,21,20-24,1906,67.94199713842664
SIM,1846,57,na,1903,833
SIM,1856,31,45-49,1887,1
STAT,1822,33,15-19,1855,0.33027612156608527
STAT,1862,4,na,1866,2600.1087109489144
SIM,1937,27,35-39,1964,3
STAT,1880,85,na,1965,530.5105901648417
SIM,1858,42,35-39,1900,3
STAT,1905,63,na,1968,2848.080692940231
STAT,1853,27,15-19,1880,0.40753974901226303
STAT,1905,36,20-24,1941,0.24046095993351194
STAT,1909,48,15-19,1957,3.3411642737974495E-4
SIM,1833,50,na,1883,2017
SIM,1812,51,na,1863,1467
STAT,1833,35,40-44,1868,2.4299227786753828
STAT,1852,40,25-29,1892,0.6529098014030139
SIM,1837,31,35-39,1868,12
STAT,1935,37,45-49,1972,0.9464003785515606
STAT,1814,43,na,1857,2162.9719393720056
SIM,1832,28,na,1860,2408
STAT,1923,44,25-29,1967,0.0823100181052006
SIM,1906,33,35-39,1939,95
STAT,1811,43,40-44,1854,11.534577058004892
STAT,1859,44,35-39,1903,1.4158646210539434
STAT,1887,20,35-39,1907,6.461279471742427
STAT,1927,28,20-24,1955,21.93328715967034
STAT,1849,24,20-24,1873,69.19797119999689
SIM,1889,36,35-39,1925,1
STAT,1820,65,na,1885,1162.663644435965
STAT,1831,35,15-19,1866,0.05850697693283024
STAT,1884,24,50-100,1908,0.3879227402300088
STAT,1867,32,25-29,1899,9.68673883602704
SIM,1867,44,35-39,1911,2
SIM,1913,36,20-24,1949,2
STAT,1901,21,40-44,1922,2.922409618282166
STAT,1840,94,na,1934,7.869609923239306
STAT,1899,37,50-100,1936,0.36195140338755377
STAT,1890,42,20-24,1932,0.1920235067625599
STAT,1858,28,40-44,1886,2.3249969743857863
STAT,1802,110,na,1912,1.400114350122423E-4
STAT,1878,45,50-100,1923,0.25520949665992315
STAT,1898,24,50-100,1922,0.5449297662030679
STAT,1887,18,50-100,1905,0.05378276635551197
STAT,1819,80,na,1899,143.88077360724995
STAT,1873,45,25-29,1918,0.059673956978019485
STAT,1879,18,30-34,1897,1.6307709380937816
STAT,1837,93,na,1930,23.433903001424433
SIM,1858,36,na,1894,2371
STAT,1808,51,25-29,1859,0.00465789931241528
SIM,1908,35,50-100,1943,1
STAT,1854,43,50-100,1897,0.5831626370784033
STAT,1844,15,35-39,1859,0.6992214641756126
STAT,1941,28,35-39,1969,15.347135574891725
STAT,1898,48,35-39,1946,0.10486017861901348
SIM,1840,26,na,1866,2222
SIM,1919,41,50-100,1960,4
SIM,1928,27,30-34,1955,1
SIM,1897,37,30-34,1934,3
STAT,1869,39,na,1908,2353.446667811695
STAT,1902,21,30-34,1923,25.158278679989866
STAT,1782,86,na,1868,213.63125123652074
SIM,1941,7,na,1948,3904
STAT,1843,37,50-100,1880,1.41614570238709
STAT,1805,60,na,1865,396.8448496563611
STAT,1824,38,40-44,1862,0.6996467927175213
STAT,1900,42,30-34,1942,0.11045854579842969
STAT,1809,48,50-100,1857,2.1128644200853293
STAT,1868,31,25-29,1899,9.933462220178477
STAT,1902,38,25-29,1940,0.8707599780577466
STAT,1904,17,25-29,1921,8.096031892879285
SIM,1883,24,25-29,1907,1
STAT,1869,18,45-49,1887,0.06643490601411978
STAT,1875,42,25-29,1917,0.6585885484472201
SIM,1907,37,40-44,1944,3
STAT,1930,38,30-34,1968,2.358224893367161
STAT,1823,51,20-24,1874,0.001130224620456842
STAT,1833,25,30-34,1858,16.581520025142797
SIM,1827,44,na,1871,1979
STAT,1873,44,na,1917,2338.8209980260635
STAT,1918,48,30-34,1966,0.09332529940040225
STAT,1900,24,30-34,1924,24.520625785704787
STAT,1794,71,na,1865,7.517679275171824
STAT,1838,18,15-19,1856,3.3265552100922084
STAT,1903,28,na,1931,3375.7718105959716
STAT,1934,30,35-39,1964,12.40652226653563
STAT,1943,25,35-39,1968,15.820823255270886
STAT,1806,54,25-29,1860,0.008965224963871626
STAT,1836,39,15-19,1875,0.05173133824093678
STAT,1919,15,na,1934,4244.917350315288
SIM,1845,69,na,1914,1416
STAT,1867,39,50-100,1906,1.1494271528043114
STAT,1891,29,40-44,1920,3.6574027320769207
STAT,1913,40,45-49,1953,0.1620801623830822
STAT,1832,62,na,1894,1551.5141914447813
STAT,1861,30,30-34,1891,14.636966845447446
STAT,1883,19,35-39,1902,0.5250509751379228
STAT,1927,38,50-100,1965,0.5172309265070505
STAT,1947,17,50-100,1964,0.41759025169697905
SIM,1870,36,na,1906,2118
SIM,1905,21,20-24,1926,1
STAT,1924,40,20-24,1964,0.020862369537692212
SIM,1897,24,25-29,1921,4
STAT,1899,40,15-19,1939,0.0013230601684804028
SIM,1848,44,25-29,1892,2
STAT,1831,80,na,1911,484.14441297544226
SIM,1924,32,40-44,1956,1
SIM,1871,18,na,1889,1903
STAT,1809,50,na,1859,2969.53636051181
STAT,1946,17,30-34,1963,13.373036696619696
STAT,1811,54,35-39,1865,0.037210629285515356
STAT,1872,47,50-100,1919,0.24478735918016956
STAT,1827,75,na,1902,725.9679631872132
STAT,1857,7,na,1864,2232.3519290544573
STAT,1934,32,30-34,1966,21.365484071439347
STAT,1823,85,na,1908,216.55989054025224
STAT,1876,80,na,1956,662.9703232114492
STAT,1917,35,35-39,1952,2.5022782750270123
SIM,1883,42,25-29,1925,6
STAT,1872,90,na,1962,161.31019286531296
STAT,1907,43,25-29,1950,0.0645950557990384
STAT,1852,15,50-100,1867,0.060353045538255344
SIM,1923,38,35-39,1961,4
STAT,1909,40,25-29,1949,0.0668613440545497
STAT,1930,25,25-29,1955,83.17803969843881
STAT,1872,48,15-19,1920,3.9551065724697626E-4
STAT,1856,72,na,1928,907.0787549229847
STAT,1916,32,40-44,1948,3.9851168173334535
STAT,1833,109,na,1942,2.9272101272349773E-4
STAT,1830,49,20-24,1879,0.009995736666209912
STAT,1786,109,na,1895,7.007549562790168E-4
STAT,1902,26,50-100,1928,0.9038807808762712
STAT,1932,35,30-34,1967,2.4359871084630242
STAT,1940,1,na,1941,4175.392745952396
STAT,1910,16,40-44,1926,0.27472299120253607
STAT,1872,18,50-100,1890,0.04892995449979092
SIM,1877,15,na,1892,173
STAT,1833,43,30-34,1876,0.5904479790654288
STAT,1835,22,30-34,1857,17.914832718502755
STAT,1904,49,50-100,1953,0.19379727099262703
STAT,1900,40,35-39,1940,0.1759526551052301
STAT,1849,35,50-100,1884,1.0807661407259823
STAT,1822,104,na,1926,0.03846259924647573
STAT,1869,31,45-49,1900,1.7668504631924742
STAT,1885,16,35-39,1901,0.5406779616943306
STAT,1913,22,15-19,1935,5.093486652542543
SIM,1913,3,na,1916,3719
STAT,1877,34,na,1911,2401.6533437809408
STAT,1816,46,35-39,1862,0.4320019304567952
STAT,1864,52,20-24,1916,6.672757897823668E-4
STAT,1915,38,35-39,1953,2.39696412086571
STAT,1917,17,35-39,1934,0.8909216342576294
STAT,1881,79,na,1960,823.2865858218244
STAT,1907,25,25-29,1932,62.14061193482836
STAT,1835,40,30-34,1875,1.0693303259355336
STAT,1912,27,30-34,1939,38.164294947473415
STAT,1944,22,45-49,1966,1.201188678753966
STAT,1825,80,na,1905,380.9394206812584
STAT,1892,11,na,1903,3202.159833260552
SIM,1906,17,na,1923,3403
STAT,1917,49,25-29,1966,0.05434619935656563
STAT,1851,23,25-29,1874,53.6044726268467
STAT,1927,22,45-49,1949,1.3749814315075692
SIM,1864,36,na,1900,2407
SIM,1872,31,na,1903,2405
STAT,1820,53,50-100,1873,0.022458924766467818
SIM,1821,59,na,1880,1753
SIM,1872,2,na,1874,3761
STAT,1871,20,45-49,1891,0.6997590897086874
SIM,1867,26,35-39,1893,92
STAT,1922,30,15-19,1952,0.14472884019047697
STAT,1807,109,na,1916,2.8846352899011986E-4
STAT,1839,17,20-24,1856,21.54643110623213
STAT,1860,47,40-44,1907,0.13901250021153114
STAT,1871,49,na,1920,2197.454759425296
STAT,1839,33,25-29,1872,11.58963491100016
STAT,1852,39,50-100,1891,1.223392954801279
STAT,1834,23,25-29,1857,33.49921591759473
STAT,1944,10,na,1954,4186.752547450844
SIM,1862,20,45-49,1882,11
STAT,1814,49,35-39,1863,0.46582159067886736
STAT,1927,35,20-24,1962,0.32563934004509304
STAT,1860,31,25-29,1891,8.389983632415545
STAT,1866,37,35-39,1903,6.4562950851904
STAT,1877,2,na,1879,3298.6708597489906
SIM,1929,25,25-29,1954,818
SIM,1895,28,na,1923,4563
STAT,1818,39,na,1857,1837.4067650978636
STAT,1920,6,na,1926,4438.989695493204
SIM,1856,49,50-100,1905,1
SIM,1915,25,25-29,1940,34
STAT,1899,29,40-44,1928,4.062299733216387
SIM,1920,27,30-34,1947,397
SIM,1882,61,na,1943,1326
STAT,1889,24,25-29,1913,68.50504245550277
SIM,1906,38,35-39,1944,5
STAT,1869,30,30-34,1899,17.759902787606084
STAT,1910,32,45-49,1942,1.5002862399834767
SIM,1916,0,na,1916,5355
STAT,1904,48,30-34,1952,0.07703124099932414
STAT,1822,60,na,1882,1187.51441815131
SIM,1874,37,35-39,1911,30
SIM,1884,23,30-34,1907,13
STAT,1830,47,25-29,1877,0.04922482066898661
STAT,1854,20,45-49,1874,0.46217403475227053
STAT,1891,40,15-19,1931,0.01715370246595261
SIM,1856,36,30-34,1892,3
SIM,1925,32,30-34,1957,9
SIM,1901,16,40-44,1917,1
SIM,1893,31,30-34,1924,20
SIM,1907,58,na,1965,4311
STAT,1855,111,na,1966,4.525088855050071E-4
SIM,1802,52,na,1854,1006
STAT,1922,43,20-24,1965,0.02001275065148016
SIM,1878,56,na,1934,3439
STAT,1885,69,na,1954,1442.5208309196441
STAT,1885,31,30-34,1916,17.232152892038968
SIM,1886,23,na,1909,2721
SIM,1946,25,25-29,1971,522
STAT,1848,77,na,1925,808.8761750414994
STAT,1818,40,30-34,1858,2.3737534937916935
STAT,1892,26,50-100,1918,0.7947171325562604
STAT,1848,36,30-34,1884,5.193138621916829
STAT,1903,19,30-34,1922,2.2503821439221667
SIM,1856,41,na,1897,641
STAT,1865,23,25-29,1888,52.52023176176333
STAT,1917,32,30-34,1949,16.277875849660198
STAT,1834,41,25-29,1875,0.3455773689096043
STAT,1848,23,25-29,1871,64.75740466609882
STAT,1883,74,na,1957,1132.4401867968338
STAT,1908,24,30-34,1932,26.05417063511414
SIM,1859,42,50-100,1901,21
STAT,1809,50,30-34,1859,0.05120168970830191
STAT,1851,41,25-29,1892,0.5094656842427794
STAT,1825,33,25-29,1858,16.790241708316596
STAT,1865,39,40-44,1904,3.956396756193256
STAT,1925,15,na,1940,4426.130228179807
STAT,1854,77,na,1931,480.6173149653109
STAT,1855,47,30-34,1902,0.06376709262928783
STAT,1932,25,na,1957,4876.785172865925
STAT,1810,75,na,1885,30.936387471982073
SIM,1961,2,na,1963,4660
STAT,1828,57,na,1885,1414.641218624491
STAT,1928,33,15-19,1961,0.15936053450792206
STAT,1936,25,20-24,1961,17.31101484813595
STAT,1828,30,45-49,1858,2.8158998292623285
STAT,1855,18,15-19,1873,4.644094141141991
STAT,1933,15,25-29,1948,57.884365968691085
STAT,1878,16,50-100,1894,0.050530035202918606
SIM,1815,59,na,1874,1018
STAT,1938,25,25-29,1963,64.56637984480054
SIM,1833,33,25-29,1866,3
SIM,1938,10,na,1948,4250
STAT,1895,21,45-49,1916,0.9098651366739584
SIM,1926,37,na,1963,5885
STAT,1894,46,na,1940,2869.6856740779567
SIM,1873,39,40-44,1912,2
STAT,1904,35,25-29,1939,0.8962943893301166
STAT,1908,40,35-39,1948,0.18695691292208524
SIM,1874,38,na,1912,2526
STAT,1865,49,na,1914,2011.1968139811893
STAT,1857,14,na,1871,2133.5775410555566
STAT,1859,41,30-34,1900,0.9153416025473042
SIM,1833,44,na,1877,2127
STAT,1923,46,45-49,1969,0.252199199784954
STAT,1876,41,30-34,1917,1.1674675707910598
STAT,1790,81,na,1871,280.38351328925773
STAT,1840,39,35-39,1879,3.2262662049590607
STAT,1942,22,40-44,1964,3.4851337068296777
STAT,1838,29,50-100,1867,0.34239059587527104
STAT,1941,19,50-100,1960,0.38125940277242504
SIM,1844,16,na,1860,3028
STAT,1900,27,35-39,1927,13.366519921881208
STAT,1870,95,na,1965,44.459986869149944
STAT,1889,37,30-34,1926,6.418010887469922
STAT,1871,48,25-29,1919,0.05673654431885284
STAT,1892,24,25-29,1916,70.43174603325323
STAT,1840,51,20-24,1891,2.9194936344964604E-4
STAT,1803,65,na,1868,607.6186815680408
STAT,1879,69,na,1948,1505.4644774122012
SIM,1912,17,na,1929,4794
SIM,1856,23,25-29,1879,22
STAT,1818,102,na,1920,0.17844279631334994
STAT,1845,30,45-49,1875,1.0504526624554602
STAT,1908,42,30-34,1950,0.11736673547771515
STAT,1839,15,25-29,1854,6.9689299729086285
STAT,1933,33,25-29,1966,12.363429399277736
STAT,1858,37,50-100,1895,0.9375833169564458
STAT,1902,35,20-24,1937,0.23651617510103445
STAT,1919,43,na,1962,3964.988987734015
STAT,1947,15,25-29,1962,48.32689206475866
STAT,1930,40,45-49,1970,0.21804530316413448
STAT,1943,22,30-34,1965,30.229630985297653
SIM,1898,48,na,1946,4036
STAT,1882,80,na,1962,807.4945307428103
SIM,1932,25,na,1957,6279
SIM,1814,77,na,1891,23
SIM,1846,17,30-34,1863,12
STAT,1842,52,na,1894,531.6664903514547
STAT,1884,18,40-44,1902,0.17462931842136314
SIM,1810,87,na,1897,418
STAT,1874,29,40-44,1903,3.0695247895855347
STAT,1859,49,na,1908,1745.975183519088
STAT,1853,39,15-19,1892,0.043103385572492776
SIM,1850,16,na,1866,2259
SIM,1876,21,na,1897,3938
SIM,1931,12,na,1943,5228
SIM,1944,10,na,1954,2516
STAT,1920,15,15-19,1935,10.131005077022978
STAT,1819,40,na,1859,684.7660962419726
STAT,1840,36,30-34,1876,2.507973543672857
STAT,1791,101,na,1892,0.14388427788491442
STAT,1842,33,30-34,1875,5.1818285267499435
SIM,1854,8,na,1862,2666
STAT,1894,21,25-29,1915,73.01665086737582
STAT,1820,37,na,1857,1958.524953379288
STAT,1807,55,na,1862,1255.9321154068305
STAT,1879,19,15-19,1898,6.055250485678916
STAT,1857,103,na,1960,0.2686949220101773
STAT,1901,33,na,1934,3322.4960020679137
STAT,1924,43,25-29,1967,0.08399011618298645
STAT,1930,22,20-24,1952,141.44759971679835
SIM,1950,19,na,1969,3146
STAT,1833,28,35-39,1861,5.769044090035186
STAT,1843,35,40-44,1878,5.15520782769995
STAT,1883,24,50-100,1907,0.3898560469208676
SIM,1851,35,40-44,1886,6
SIM,1862,48,25-29,1910,1
STAT,1902,24,35-39,1926,8.165850442531617
STAT,1825,36,35-39,1861,10.441841961206396
STAT,1829,70,na,1899,512.3598688917524
STAT,1854,48,25-29,1902,0.03162420246333525
STAT,1921,35,25-29,1956,1.0882419659157332
STAT,1939,24,30-34,1963,28.527707921316374
STAT,1903,68,na,1971,2543.659624947893
STAT,1962,9,na,1971,4987.7315984744555
STAT,1813,49,20-24,1862,0.042391199160865804
STAT,1901,22,25-29,1923,80.04168359715722
STAT,1929,42,50-100,1971,0.15107408431333585
SIM,1831,49,na,1880,2128
STAT,1835,25,35-39,1860,9.652977942233512
STAT,1925,24,30-34,1949,33.87488497709908
STAT,1909,34,50-100,1943,0.7742690834727008
STAT,1918,32,45-49,1950,1.6495876988603364
STAT,1848,20,15-19,1868,3.813477267990253
STAT,1922,49,35-39,1971,0.1456051697181633
STAT,1938,22,20-24,1960,108.87112521805393
SIM,1833,36,35-39,1869,50
SIM,1850,33,30-34,1883,1
STAT,1883,34,na,1917,2276.0791488906516
STAT,1893,20,50-100,1913,0.5129959220151088
STAT,1961,4,na,1965,5034.032941754879
STAT,1914,31,na,1945,3769.4188001304638
STAT,1843,93,na,1936,28.87599639633352
STAT,1898,48,50-100,1946,0.18395471279021866
SIM,1919,43,na,1962,4902
STAT,1890,56,na,1946,2469.1957629084372
STAT,1896,19,15-19,1915,7.781141081547914
STAT,1905,43,20-24,1948,0.015747649080483907
SIM,1843,25,35-39,1868,3
STAT,1843,17,40-44,1860,0.23094313002305844
SIM,1889,28,na,1917,3861
STAT,1908,43,45-49,1951,0.15187149845212658
STAT,1795,65,na,1860,972.299333314845
STAT,1905,16,30-34,1921,2.2981255629219084
SIM,1861,52,45-49,1913,1
STAT,1830,67,na,1897,1147.336798058017
STAT,1921,17,25-29,1938,48.810767554133605
STAT,1869,15,35-39,1884,0.5680314266824417
STAT,1841,38,40-44,1879,5.683949165122574
SIM,1915,53,na,1968,2750
STAT,1829,28,15-19,1857,0.30240402253525184
STAT,1867,44,na,1911,2156.304608109315
STAT,1827,49,15-19,1876,3.5689567879287405E-4
STAT,1881,37,30-34,1918,5.032974870446672
STAT,1897,31,20-24,1928,3.604472611228868
STAT,1889,21,20-24,1910,83.2366914657842
STAT,1859,26,35-39,1885,7.835937815753486
SIM,1897,23,na,1920,2953
SIM,1891,78,na,1969,78
STAT,1899,47,40-44,1946,0.13128830889383572
STAT,1951,17,40-44,1968,1.6500935558324494
STAT,1838,17,30-34,1855,0.898721617865998
STAT,1816,60,na,1876,1987.413690798077
SIM,1862,41,na,1903,3548
STAT,1814,46,30-34,1860,0.33539011936511043
SIM,1937,3,na,1940,2988
STAT,1876,23,30-34,1899,17.950939755658183
SIM,1868,66,na,1934,502
STAT,1906,45,30-34,1951,0.07985770878475384
STAT,1856,30,20-24,1886,2.0064917622504552
SIM,1842,20,20-24,1862,2
SIM,1904,22,15-19,1926,17
STAT,1947,19,40-44,1966,1.5579596273843648
SIM,1825,49,na,1874,14
SIM,1903,68,na,1971,1652
STAT,1904,13,na,1917,3683.901374833305
SIM,1824,43,30-34,1867,7
STAT,1853,52,45-49,1905,0.01119285759943891
STAT,1833,46,35-39,1879,0.07121206338728017
STAT,1853,20,25-29,1873,53.20712995382169
STAT,1788,71,na,1859,237.413452787393
STAT,1883,34,30-34,1917,16.653193091843875
STAT,1871,18,na,1889,2520.7384153224452
STAT,1964,1,na,1965,4910.773981725796
STAT,1841,111,na,1952,1.1952169163810547E-4
SIM,1886,51,na,1937,2887
STAT,1848,39,35-39,1887,6.680472238563372
SIM,1841,46,35-39,1887,1
STAT,1816,43,30-34,1859,3.6797547324289313
STAT,1942,25,45-49,1967,1.7940719945061352
STAT,1834,35,50-100,1869,0.6871600469491556
STAT,1853,24,na,1877,1930.8269788505243
STAT,1869,43,50-100,1912,1.058345578427611
STAT,1935,30,25-29,1965,12.709462236367946
STAT,1840,54,30-34,1894,0.0022793895537168386
SIM,1933,19,na,1952,4431
STAT,1908,25,45-49,1933,1.645367731128593
SIM,1879,69,na,1948,798
STAT,1920,33,15-19,1953,0.13836032269441334
STAT,1876,26,35-39,1902,9.787653037911372
SIM,1838,28,na,1866,2258
STAT,1917,46,20-24,1963,0.011417194932063182
STAT,1862,72,na,1934,1075.6594001285239
STAT,1849,52,25-29,1901,0.0029685834211363215
SIM,1862,46,50-100,1908,1
STAT,1936,15,na,1951,3505.1778755906657
STAT,1923,43,40-44,1966,0.2888117466044741
STAT,1884,16,na,1900,2423.630930839034
STAT,1919,30,50-100,1949,0.8872429397035093
STAT,1916,35,45-49,1951,0.6951357357658475
SIM,1910,50,na,1960,3794
SIM,1869,23,35-39,1892,236
STAT,1789,96,na,1885,2.7568939639093877
STAT,1808,49,40-44,1857,0.2376362174231409
SIM,1837,34,na,1871,2115
STAT,1853,52,na,1905,1660.6540645839134
STAT,1812,70,na,1882,132.08163455595945
STAT,1894,74,na,1968,1780.5306801382353
STAT,1921,16,50-100,1937,0.4230314504201767
SIM,1874,66,na,1940,1948
STAT,1817,45,40-44,1862,0.1231585055981709
SIM,1819,49,na,1868,1879
SIM,1842,39,40-44,1881,37
STAT,1861,59,na,1920,1616.268271348827
STAT,1892,27,35-39,1919,11.946278778855497
STAT,1936,28,25-29,1964,62.33605475445794
STAT,1831,47,15-19,1878,3.772005396588342E-4
STAT,1871,50,45-49,1921,0.014684803381429955
STAT,1925,27,40-44,1952,5.454862354934102
STAT,1869,15,40-44,1884,0.18934381985692855
SIM,1897,21,15-19,1918,1
STAT,1838,87,na,1925,75.13621414171777
STAT,1922,46,25-29,1968,0.06040914567978594
STAT,1851,53,25-29,1904,0.002752539325966416
SIM,1858,33,30-34,1891,6
STAT,1850,87,na,1937,81.35353105515348
STAT,1933,19,40-44,1952,1.8497005438207401
STAT,1889,21,15-19,1910,3.984761393005081
STAT,1863,45,50-100,1908,0.21176207672080288
STAT,1827,30,25-29,1857,10.895846371835598
SIM,1885,38,na,1923,1547
STAT,1909,36,15-19,1945,0.018078224560840715
SIM,1912,32,20-24,1944,18
STAT,1832,44,25-29,1876,0.05744289967653032
SIM,1840,44,25-29,1884,3
STAT,1846,18,50-100,1864,0.03623523140229796
SIM,1906,35,30-34,1941,9
STAT,1896,48,30-34,1944,0.07107515659941846
SIM,1856,20,20-24,1876,205
STAT,1890,16,na,1906,3065.026451366301
STAT,1834,39,40-44,1873,2.3503826573969406
STAT,1855,6,na,1861,1963.8467886156745
STAT,1834,20,20-24,1854,41.2077457617314
STAT,1918,21,na,1939,3897.1695215766654
STAT,1907,58,na,1965,3084.107443267923
STAT,1813,55,na,1868,1970.6985875350076
STAT,1812,51,45-49,1863,0.003643108688139784
STAT,1851,26,35-39,1877,8.98725313304751
STAT,1874,15,15-19,1889,6.176272098203876
STAT,1920,33,45-49,1953,1.694261233945573
STAT,1904,32,20-24,1936,2.2174738477918052
SIM,1891,38,na,1929,2132
STAT,1884,36,40-44,1920,4.210631536560161
STAT,1912,42,20-24,1954,0.016835008588547324
SIM,1866,31,na,1897,3157
STAT,1848,20,20-24,1868,79.65877990202702
STAT,1913,32,50-100,1945,0.8122781802911454
STAT,1912,24,20-24,1936,109.07362617602796
STAT,1914,36,25-29,1950,0.9740665038827657
STAT,1857,44,30-34,1901,0.8703028584767365
STAT,1923,44,50-100,1967,0.1354132547412333
SIM,1816,44,na,1860,93
STAT,1903,36,50-100,1939,0.37797741979620775
SIM,1808,77,na,1885,985
STAT,1844,87,na,1931,174.54034586136814
STAT,1934,33,45-49,1967,2.1325949732171865
STAT,1836,52,na,1888,1667.3343511656492
STAT,1897,26,na,1923,3180.303455121865
STAT,1903,21,45-49,1924,0.992844253773458
STAT,1962,0,na,1962,5027.48116336598
STAT,1912,36,na,1948,3646.779283412753
SIM,1817,82,na,1899,183
STAT,1840,54,25-29,1894,0.0013563309610403768
SIM,1814,49,na,1863,2439
SIM,1835,70,na,1905,796
STAT,1855,87,na,1942,116.60286832272527
STAT,1903,15,15-19,1918,8.4633012599139
STAT,1815,59,na,1874,172.65851868926703
STAT,1951,17,35-39,1968,4.950280380882002
SIM,1901,16,35-39,1917,2
STAT,1821,39,30-34,1860,6.235348380548025
SIM,1875,39,50-100,1914,21
STAT,1933,37,40-44,1970,2.0251631254295708
STAT,1834,27,40-44,1861,1.7311336901647838
SIM,1898,20,20-24,1918,193
SIM,1917,17,na,1934,2095
STAT,1860,35,40-44,1895,3.605047991473839
STAT,1859,31,50-100,1890,0.7291772127197387
STAT,1920,31,na,1951,4106.089361457742
STAT,1897,34,25-29,1931,13.486249566664522
STAT,1900,25,45-49,1925,1.5485216159789545
SIM,1852,30,25-29,1882,6
STAT,1923,23,50-100,1946,0.7552106601790134
STAT,1868,16,35-39,1884,0.5427748865228117
STAT,1830,27,na,1857,2077.904901769105
STAT,1909,42,45-49,1951,0.1540834574204544
STAT,1941,9,na,1950,4030.4043064474404
STAT,1847,52,20-24,1899,6.636137650942102E-4
STAT,1914,45,50-100,1959,0.22223730652298213
STAT,1906,41,15-19,1947,0.001394959125169309
STAT,1818,40,25-29,1858,1.3258803352904627
STAT,1924,21,na,1945,4280.5603757031795
SIM,1827,75,na,1902,974
STAT,1912,27,25-29,1939,64.10969463083734
STAT,1883,16,30-34,1899,1.537137240074734
STAT,1920,37,30-34,1957,1.9698455295279256
SIM,1929,29,40-44,1958,4
SIM,1908,40,na,1948,2519
STAT,1922,28,30-34,1950,43.688552986448556
SIM,1866,62,na,1928,2670
STAT,1826,50,30-34,1876,0.008556604706451525
STAT,1836,52,45-49,1888,0.011251927482774425
SIM,1912,32,15-19,1944,2
STAT,1868,54,50-100,1922,0.014186164334091722
STAT,1935,32,45-49,1967,2.1613648661749925
STAT,1895,49,25-29,1944,0.04138440275268552
SIM,1906,23,30-34,1929,28
STAT,1893,41,30-34,1934,1.4441973236220473
SIM,1890,28,na,1918,3436
STAT,1828,85,na,1913,185.56987875520926
SIM,1853,36,na,1889,3259
SIM,1841,48,na,1889,244
STAT,1828,88,na,1916,92.93141028344178
SIM,1877,3,na,1880,1289
STAT,1844,47,na,1891,2218.5010593462544
SIM,1904,50,na,1954,3954
STAT,1898,64,na,1962,2503.1012750235573
STAT,1904,32,15-19,1936,0.11682516824216996
STAT,1899,43,25-29,1942,0.06046772919098537
STAT,1911,25,20-24,1936,17.7203820759152
STAT,1930,40,15-19,1970,0.002011952188905536
SIM,1898,39,40-44,1937,39
STAT,1872,43,15-19,1915,0.0137287105972454
STAT,1849,31,20-24,1880,2.6648866208065
STAT,1858,36,na,1894,1807.8351838266242
SIM,1917,8,na,1925,2494
STAT,1876,24,na,1900,2375.8795169781974
STAT,1892,24,30-34,1916,21.915220504664827
STAT,1909,53,na,1962,3270.387663919272
STAT,1841,22,25-29,1863,80.75439012220644
STAT,1857,32,30-34,1889,13.480629295004269
STAT,1848,25,15-19,1873,0.5142058211343666
SIM,1908,43,na,1951,2422
STAT,1893,39,50-100,1932,1.5198741017214714
STAT,1861,42,30-34,1903,0.9549363564594957
STAT,1885,31,25-29,1916,10.109105420258617
STAT,1832,93,na,1925,24.80868880490462
STAT,1841,67,na,1908,1765.243134072876
STAT,1845,17,45-49,1862,0.04096864101884771
STAT,1867,72,na,1939,1194.3576781500828
STAT,1825,40,na,1865,1725.7977216805612
STAT,1831,42,15-19,1873,0.013496567365613896
STAT,1873,13,na,1886,2678.7494571808634
SIM,1917,42,45-49,1959,2
SIM,1907,33,25-29,1940,4
STAT,1874,54,na,1928,2161.1028967912544
STAT,1908,40,40-44,1948,0.23222579371200822
STAT,1924,25,30-34,1949,45.48993700398629
STAT,1860,17,40-44,1877,0.17208797300208561
STAT,1847,109,na,1956,7.345432082723467E-4
STAT,1840,26,na,1866,1069.7481541964291
STAT,1922,46,30-34,1968,0.10152092635697317
STAT,1825,33,30-34,1858,28.620931346920234
STAT,1899,25,25-29,1924,58.17011298708796
SIM,1857,31,20-24,1888,12
STAT,1925,27,35-39,1952,17.570507014540212
STAT,1903,33,15-19,1936,0.11558429637326953
STAT,1858,46,40-44,1904,0.13111052111632654
STAT,1928,20,na,1948,4551.78267622897
STAT,1935,26,15-19,1961,0.9558126678382542
STAT,1857,26,30-34,1883,20.047569507265315
STAT,1907,28,35-39,1935,14.029164125877063
STAT,1842,101,na,1943,0.1416541510125788
SIM,1900,51,na,1951,4006
STAT,1932,31,15-19,1963,0.16973844037283428
STAT,1795,96,na,1891,2.0931665187484656
SIM,1837,74,na,1911,1470
SIM,1828,69,na,1897,830
SIM,1939,26,25-29,1965,12
STAT,1860,29,40-44,1889,2.4346006288073956
SIM,1925,43,na,1968,4696
STAT,1916,33,25-29,1949,9.372464838908584
STAT,1877,50,40-44,1927,0.010840405479116808
STAT,1859,41,25-29,1900,0.5112718881993698
STAT,1826,32,30-34,1858,34.630737526565454
STAT,1845,20,50-100,1865,0.25485418623773304
SIM,1845,20,45-49,1865,200
STAT,1827,47,na,1874,1781.744591491596
STAT,1912,29,20-24,1941,17.652465257461586
STAT,1804,75,na,1879,803.6894105169556
STAT,1813,43,50-100,1856,4.745821856628121
STAT,1912,45,25-29,1957,0.05062400369471711
STAT,1852,11,na,1863,2919.5490239010373
STAT,1875,21,20-24,1896,70.97658716784349
STAT,1843,62,na,1905,1805.8801314869418
STAT,1920,19,30-34,1939,13.426872951552804
SIM,1887,64,na,1951,2486
STAT,1930,22,15-19,1952,6.771472106341778
STAT,1797,91,na,1888,0.779557487079509
STAT,1833,28,40-44,1861,1.7910320632549779
STAT,1893,23,30-34,1916,22.205926571524326
STAT,1796,103,na,1899,0.056203319574421325
SIM,1933,10,na,1943,4542
STAT,1906,18,40-44,1924,0.26416276083062074
SIM,1851,31,25-29,1882,2
STAT,1813,47,25-29,1860,0.21184330356739192
SIM,1839,24,30-34,1863,297
SIM,1850,56,na,1906,1110
SIM,1876,61,na,1937,3039
SIM,1865,32,30-34,1897,1
SIM,1908,49,25-29,1957,1
SIM,1902,55,na,1957,2948
STAT,1898,27,30-34,1925,33.86252349505254
STAT,1848,46,na,1894,2111.3212085347946
STAT,1898,15,30-34,1913,2.153261108424602
STAT,1905,43,50-100,1948,0.10475609840802827
STAT,1901,26,40-44,1927,4.202816573692
STAT,1925,40,40-44,1965,0.30088592840746936
STAT,1926,20,35-39,1946,11.408812206750039
STAT,1914,33,20-24,1947,2.4109025329171767
SIM,1895,68,na,1963,4126
STAT,1852,43,35-39,1895,1.8095762004134321
SIM,1810,56,na,1866,3098
SIM,1878,87,na,1965,482
STAT,1880,38,25-29,1918,2.9742256738170956
SIM,1934,6,na,1940,5336
STAT,1897,16,25-29,1913,7.544192978360981
STAT,1921,47,25-29,1968,0.05908994263456514
SIM,1864,17,20-24,1881,71
STAT,1856,17,20-24,1873,15.056627724030294
STAT,1925,22,40-44,1947,3.987892289222114
STAT,1817,45,na,1862,942.8347788237213
STAT,1831,49,35-39,1880,0.12866500152278124
STAT,1849,38,40-44,1887,3.735269983419007
SIM,1856,9,na,1865,1362
STAT,1843,31,25-29,1874,12.293355486496463
STAT,1786,100,na,1886,0.42597716282880116
STAT,1820,41,30-34,1861,1.9327191011259517
STAT,1879,60,na,1939,1956.460897414729
STAT,1905,31,20-24,1936,2.2415352074874604
STAT,1905,19,35-39,1924,0.7849872063101339
SIM,1838,25,25-29,1863,262
SIM,1848,26,30-34,1874,2
STAT,1861,28,na,1889,1984.800839477595
STAT,1834,26,na,1860,1259.1461866965012
STAT,1889,26,15-19,1915,0.5482349113657796
SIM,1911,32,na,1943,2510
STAT,1880,57,na,1937,2086.307369406242
STAT,1832,22,na,1854,2387.260101994488
STAT,1856,15,25-29,1871,4.869882335482095
STAT,1906,17,50-100,1923,0.070943737751707
SIM,1893,64,na,1957,1626
SIM,1871,38,25-29,1909,13
STAT,1846,11,na,1857,1784.2031155898026
STAT,1852,25,35-39,1877,11.476757342727876
SIM,1920,27,25-29,1947,156
SIM,1822,41,na,1863,1532
SIM,1924,15,25-29,1939,490
STAT,1861,87,na,1948,146.51950793476465
STAT,1878,23,35-39,1901,5.985393703945622
SIM,1875,51,30-34,1926,1
STAT,1942,23,25-29,1965,95.71068572318005
STAT,1898,33,30-34,1931,23.379296466214786
STAT,1931,21,20-24,1952,143.63583469609787
STAT,1884,32,25-29,1916,9.804962399981582
STAT,1916,21,25-29,1937,95.75856238974627
SIM,1913,58,na,1971,2906
SIM,1889,68,na,1957,1966
STAT,1867,51,30-34,1918,0.005656440049395349
STAT,1817,41,25-29,1858,0.4793061540824731
STAT,1934,30,40-44,1964,5.3128487321863656
STAT,1842,15,30-34,1857,0.5141299602352725
STAT,1865,40,na,1905,2131.4333453458785
STAT,1839,32,na,1871,2477.8698014819424
STAT,1867,33,30-34,1900,16.442498236862185
SIM,1826,34,na,1860,1939
STAT,1898,45,30-34,1943,0.07415794767850382
STAT,1847,27,20-24,1874,12.74859667558134
STAT,1856,50,50-100,1906,0.011003488140370067
SIM,1828,29,na,1857,2210
SIM,1938,19,na,1957,3568
STAT,1864,39,na,1903,2120.276736817566
STAT,1919,43,15-19,1962,0.0016394968034445178
SIM,1944,19,na,1963,1503
STAT,1837,20,45-49,1857,0.7425727239078189
STAT,1858,34,50-100,1892,0.6937134315213355
SIM,1769,85,na,1854,862
STAT,1886,15,40-44,1901,0.19028528487678986
STAT,1933,32,50-100,1965,1.1066487118449753
SIM,1847,33,na,1880,1582
STAT,1950,15,30-34,1965,14.282482988017616
SIM,1889,27,30-34,1916,137
STAT,1886,79,na,1965,1025.2792679331203
STAT,1851,23,30-34,1874,16.67932294478365
STAT,1863,14,na,1877,2304.4973488466585
STAT,1910,45,20-24,1955,0.010243337689812403
SIM,1933,23,25-29,1956,121
STAT,1832,29,35-39,1861,11.41314416647995
STAT,1925,23,25-29,1948,109.2153536358828
STAT,1897,18,20-24,1915,23.48272416348181
STAT,1916,15,25-29,1931,9.110922124687324
STAT,1856,33,25-29,1889,7.369932498265376
STAT,1848,25,50-100,1873,0.7249982556444777
STAT,1915,36,45-49,1951,0.6822142242963338
SIM,1875,33,30-34,1908,1
SIM,1942,24,na,1966,3642
STAT,1868,30,50-100,1898,0.8920884321470898
STAT,1926,39,25-29,1965,1.1904638675464356
STAT,1863,38,25-29,1901,2.445814321741557
SIM,1864,33,25-29,1897,57
STAT,1876,53,30-34,1929,0.005920862997559937
STAT,1832,41,20-24,1873,0.013802655821708004
STAT,1931,33,20-24,1964,3.1716733447195002
SIM,1915,25,30-34,1940,4
STAT,1915,18,45-49,1933,0.10280429686573286
STAT,1923,41,15-19,1964,0.0017785784141708492
STAT,1883,7,na,1890,2506.465186523222
STAT,1916,37,40-44,1953,1.512089928176373
STAT,1941,26,45-49,1967,1.7676398871754495
STAT,1805,54,50-100,1859,0.016977556914626817
STAT,1823,54,25-29,1877,0.005110668710146966
STAT,1830,47,30-34,1877,0.08272504664378344
STAT,1838,47,na,1885,987.1233836049615
SIM,1875,76,na,1951,2443
STAT,1924,28,35-39,1952,17.251945217717463
SIM,1835,48,na,1883,1203
STAT,1834,88,na,1922,60.501601195195036
STAT,1842,21,30-34,1863,5.617527360846609
STAT,1915,53,na,1968,3572.0142565051183
SIM,1919,18,25-29,1937,114
STAT,1853,40,45-49,1893,1.1721875197566307
STAT,1873,42,20-24,1915,0.1627066066694609
SIM,1892,32,25-29,1924,30
STAT,1893,44,35-39,1937,0.15512707612921892
STAT,1799,55,na,1854,216.0
STAT,1867,36,35-39,1903,6.721269346626216
STAT,1917,30,35-39,1947,9.517461482650718
SIM,1875,36,35-39,1911,5
SIM,1832,34,na,1866,1699
STAT,1934,17,35-39,1951,5.637281481804424
STAT,1860,3,na,1863,2658.263979324726
STAT,1926,36,20-24,1962,0.31969437121105687
SIM,1940,20,na,1960,3942
STAT,1892,42,na,1934,2858.0086755579987
SIM,1793,67,na,1860,938
STAT,1863,53,20-24,1916,6.198559952020396E-4
SIM,1871,21,na,1892,1831
STAT,1852,14,na,1866,2879.9650227238303
STAT,1899,40,20-24,1939,0.015215191115738947
STAT,1806,51,20-24,1857,0.0019957674474053765
STAT,1843,47,40-44,1890,0.16836465752145066
STAT,1951,15,45-49,1966,0.5896314471681424
SIM,1929,42,na,1971,6204
STAT,1863,54,na,1917,1787.6368376480718
STAT,1876,38,50-100,1914,1.2349789914294111
STAT,1926,40,25-29,1966,0.08752047347202073
STAT,1843,29,40-44,1872,3.5903837508465264
STAT,1857,47,35-39,1904,0.10692975241189948
STAT,1846,73,na,1919,703.4594149924601
STAT,1921,29,25-29,1950,71.96913134492972
STAT,1887,44,50-100,1931,1.1471125392964783
STAT,1939,18,30-34,1957,12.062740009774208
SIM,1850,21,30-34,1871,33
STAT,1867,13,na,1880,2524.78025937417
STAT,1843,100,na,1943,1.0489527925345505
STAT,1849,34,25-29,1883,8.90730355083565
SIM,1923,17,na,1940,4291
STAT,1862,42,45-49,1904,1.2731804126094868
STAT,1896,17,50-100,1913,0.06458249712570911
SIM,1816,41,na,1857,231
STAT,1827,49,50-100,1876,0.21913413086041697
STAT,1865,25,15-19,1890,0.41703661416017246
STAT,1879,20,45-49,1899,0.7196083803740719
SIM,1914,43,na,1957,4868
STAT,1821,59,na,1880,1057.3977930921199
STAT,1841,53,30-34,1894,0.006522122428178755
STAT,1857,29,35-39,1886,7.517334488573425
STAT,1911,28,25-29,1939,63.24241341917826
STAT,1913,40,15-19,1953,0.00149554946954916
STAT,1851,29,na,1880,1971.8335906565833
STAT,1944,6,na,1950,4222.3618032149525
SIM,1812,42,na,1854,1911
STAT,1857,24,50-100,1881,0.32403483647692616
STAT,1917,23,50-100,1940,0.6878594007444537
SIM,1896,13,na,1909,4047
STAT,1852,22,30-34,1874,21.299560526939857
STAT,1932,22,50-100,1954,0.8573417124904678
STAT,1849,87,na,1936,148.44849757713527
STAT,1861,45,35-39,1906,0.11759077141602485
SIM,1858,51,30-34,1909,1
SIM,1901,33,na,1934,3178
STAT,1901,29,45-49,1930,1.541347089681651
STAT,1848,24,30-34,1872,20.004944094097922
STAT,1799,58,na,1857,203.5402808903969
STAT,1827,50,45-49,1877,0.013362074270244953
STAT,1851,50,20-24,1901,5.911783787194446E-4
STAT,1961,1,na,1962,5040.330856646059
STAT,1871,48,30-34,1919,0.09534891567703124
STAT,1919,49,50-100,1968,0.24064604429312314
STAT,1835,52,30-34,1887,0.004589918679241053
SIM,1860,22,30-34,1882,44
STAT,1929,17,30-34,1946,15.446416400520135
SIM,1934,3,na,1937,5392
STAT,1868,54,na,1922,2022.492044385123
SIM,1896,5,na,1901,4130
STAT,1847,28,50-100,1875,0.6901640608960347
STAT,1903,37,30-34,1940,1.6329241392366884
STAT,1878,20,30-34,1898,18.43585646057318
STAT,1908,22,40-44,1930,3.06720528344497
STAT,1826,53,35-39,1879,0.011660329943603094
STAT,1872,47,30-34,1919,0.09647970859060101
STAT,1944,16,15-19,1960,48.30333954017869
STAT,1858,42,25-29,1900,0.4897886476293742
STAT,1913,38,30-34,1951,1.7672476564922999
STAT,1939,3,na,1942,4006.685118256667
STAT,1907,25,30-34,1932,36.99210635385772
STAT,1893,26,35-39,1919,12.107661639213601
SIM,1872,62,na,1934,2049
SIM,1887,61,na,1948,3006
STAT,1817,85,na,1902,86.84288928532489
STAT,1922,26,50-100,1948,1.1175567850223649
STAT,1858,39,na,1897,1781.067750619
STAT,1873,17,20-24,1890,18.18556627587224
SIM,1926,44,45-49,1970,1
SIM,1824,31,30-34,1855,20
SIM,1824,46,35-39,1870,3
STAT,1934,35,35-39,1969,3.320945074834036
STAT,1943,20,35-39,1963,9.910362973179584
STAT,1899,22,20-24,1921,94.12532148661393
STAT,1888,40,45-49,1928,1.744797533203746
STAT,1837,22,35-39,1859,6.125245732195399
SIM,1845,22,35-39,1867,3
STAT,1902,43,na,1945,3242.2446125657116
STAT,1883,37,35-39,1920,6.804455972391037
STAT,1814,42,15-19,1856,0.04833195291370332
STAT,1888,22,45-49,1910,0.8048232479590509
SIM,1921,38,30-34,1959,10
STAT,1826,35,35-39,1861,12.178324996257542
SIM,1820,49,na,1869,511
STAT,1853,55,na,1908,1603.2817296451815
STAT,1912,38,50-100,1950,0.40301571264137054
STAT,1918,44,45-49,1962,0.17398371273529473
SIM,1891,37,35-39,1928,24
STAT,1905,54,na,1959,3087.3825884614125
STAT,1839,17,15-19,1856,7.212576523699924
STAT,1881,33,15-19,1914,0.13391485300682449
STAT,1883,22,30-34,1905,17.136185783947525
STAT,1866,34,30-34,1900,15.801105797120377
SIM,1829,70,na,1899,1463
SIM,1837,31,40-44,1868,7
STAT,1871,80,na,1951,617.0767883751621
SIM,1848,36,50-100,1884,9
STAT,1875,24,25-29,1899,58.41479318382715
STAT,1884,48,40-44,1932,0.1618258131402446
STAT,1923,45,30-34,1968,0.1036735361511398
STAT,1945,23,na,1968,3956.817667438511
STAT,1901,36,na,1937,3336.1365203704854
STAT,1822,52,20-24,1874,0.0011890817655267744
SIM,1847,36,na,1883,1516
STAT,1852,40,30-34,1892,1.1689191557937373
STAT,1832,107,na,1939,0.004003252465311712
STAT,1870,20,25-29,1890,57.410559296869415
STAT,1914,42,50-100,1956,0.11479015299086623
STAT,1931,36,25-29,1967,1.2959993521434563
STAT,1908,24,50-100,1932,0.5964783301456329
STAT,1920,21,45-49,1941,1.2385206973469856
STAT,1934,20,na,1954,4890.2977553217725
STAT,1877,53,45-49,1930,0.014495311188834854
SIM,1865,21,na,1886,1859
STAT,1850,28,40-44,1878,1.6161054018142336
STAT,1820,44,35-39,1864,2.885361820387219
STAT,1875,79,na,1954,717.8777821589356
STAT,1875,46,40-44,1921,0.1762962212499055
STAT,1917,7,na,1924,4230.234206930151
STAT,1908,45,35-39,1953,0.11739903304529768
STAT,1880,54,na,1934,2173.850782837929
STAT,1844,49,15-19,1893,3.8800129989887045E-4
STAT,1918,26,15-19,1944,0.7437005657642174
STAT,1875,39,na,1914,2394.8918176109537
SIM,1847,30,20-24,1877,4
SIM,1863,51,na,1914,416
SIM,1871,35,20-24,1906,1
STAT,1831,46,30-34,1877,0.09246519485202896
STAT,1939,20,15-19,1959,5.290879296721989
SIM,1881,17,na,1898,3187
STAT,1908,27,35-39,1935,14.202475658079361
SIM,1873,25,15-19,1898,1
SIM,1874,34,30-34,1908,82
STAT,1861,38,50-100,1899,1.0159792458704844
STAT,1942,27,40-44,1969,4.8361412360397615
STAT,1829,31,40-44,1860,2.453148452614412
STAT,1896,22,40-44,1918,2.7469364689169073
SIM,1878,8,na,1886,4386
STAT,1927,38,25-29,1965,1.2129656698904918
SIM,1847,49,40-44,1896,1
STAT,1839,30,20-24,1869,3.1553215693475356
STAT,1868,51,45-49,1919,0.014084184380899353
SIM,1862,43,50-100,1905,11
STAT,1820,34,na,1854,1932.6009374764596
STAT,1905,46,25-29,1951,0.04686543831129877
STAT,1887,64,na,1951,1913.3644977174024
STAT,1900,42,25-29,1942,0.061697566374080685
SIM,1851,47,40-44,1898,1
STAT,1834,45,40-44,1879,0.09021280380478279
STAT,1941,16,35-39,1957,4.2741652788091535
STAT,1856,19,40-44,1875,0.15351287450945314
SIM,1920,43,na,1963,3697
SIM,1933,20,20-24,1953,199
STAT,1839,49,40-44,1888,0.1579578870879028
SIM,1911,2,na,1913,2769
STAT,1909,13,na,1922,3827.535921112534
SIM,1852,11,na,1863,2630
STAT,1809,59,na,1868,2485.1506953616968
STAT,1925,43,45-49,1968,0.19933611978227445
STAT,1776,106,na,1882,0.02455585990304251
STAT,1822,34,20-24,1856,6.03607197864197
STAT,1822,63,na,1885,1061.8393541468408
STAT,1921,19,15-19,1940,50.84354056696653
SIM,1903,24,20-24,1927,15
STAT,1842,36,35-39,1878,2.0812006765812967
STAT,1865,20,20-24,1885,64.60570190985375
SIM,1902,58,na,1960,2895
STAT,1881,17,50-100,1898,0.04626537118126144
STAT,1938,29,40-44,1967,4.563752598723943
STAT,1821,41,45-49,1862,1.7174966351597283
SIM,1878,28,na,1906,4341
STAT,1847,21,45-49,1868,0.7784722362623915
STAT,1940,20,na,1960,3680.8672547639453
STAT,1918,44,15-19,1962,0.001605386158711197
SIM,1860,77,na,1937,1638
STAT,1803,93,na,1896,7.372150975608406
SIM,1799,55,na,1854,1587
STAT,1875,28,40-44,1903,3.065173928941914
STAT,1811,60,na,1871,1443.1198149484499
STAT,1866,22,25-29,1888,52.68153203197617
STAT,1869,79,na,1948,705.4544434509613
STAT,1921,32,20-24,1953,2.6822302715905892
STAT,1827,44,na,1871,1844.5480060100765
SIM,1821,56,na,1877,1823
STAT,1815,50,50-100,1865,0.0015377402505978184
STAT,1855,21,40-44,1876,1.6228304657559975
STAT,1925,20,20-24,1945,132.66826803475763
SIM,1839,20,15-19,1859,1
STAT,1925,25,45-49,1950,2.0355567548427405
STAT,1817,39,40-44,1856,3.310443320778128
SIM,1859,21,na,1880,2245
SIM,1934,18,20-24,1952,1293
STAT,1950,18,35-39,1968,4.91274207999443
STAT,1903,39,50-100,1942,0.3723809553458538
STAT,1886,18,45-49,1904,0.06746749733897174
SIM,1884,28,na,1912,3228
STAT,1898,67,na,1965,2374.9342056481823
STAT,1903,33,45-49,1936,1.415362358113477
SIM,1957,7,na,1964,6080
STAT,1862,69,na,1931,1249.9669068381284
STAT,1916,2,na,1918,4266.006921335913
STAT,1844,30,25-29,1874,12.389032548605295
STAT,1889,25,50-100,1914,0.7755597723845027
STAT,1916,19,40-44,1935,0.29114040253732487
STAT,1919,47,30-34,1966,0.09540668161524164
STAT,1926,18,20-24,1944,164.36531399304326
SIM,1875,54,35-39,1929,1
SIM,1882,25,25-29,1907,534
SIM,1800,57,na,1857,216
STAT,1842,18,35-39,1860,0.1738864302748485
STAT,1890,45,25-29,1935,0.07042616594294801
STAT,1922,35,na,1957,4240.479356253306
STAT,1867,54,35-39,1921,0.007917950690972324
STAT,1886,33,35-39,1919,10.442828724100442
STAT,1889,43,30-34,1932,1.3744582208711509
STAT,1857,40,15-19,1897,0.01070405936927791
STAT,1872,44,50-100,1916,1.0436087274295436
SIM,1855,7,na,1862,3430
STAT,1849,38,50-100,1887,1.0476179887912953
STAT,1883,50,50-100,1933,0.014738292379787576
STAT,1884,21,50-100,1905,0.3915450529901098
STAT,1913,29,35-39,1942,14.6663729061264
STAT,1941,23,40-44,1964,3.4340963159133073
SIM,1876,24,na,1900,3935
STAT,1878,46,20-24,1924,0.012381485064165086
STAT,1850,53,40-44,1903,0.0047832120798265805
STAT,1852,50,40-44,1902,0.010749288311087101
STAT,1915,26,35-39,1941,15.14899328596874
STAT,1870,24,40-44,1894,2.0644130733549115
STAT,1855,43,15-19,1898,0.009073824673849793
SIM,1827,42,35-39,1869,10
STAT,1798,70,na,1868,1009.8080714111475
SIM,1848,16,20-24,1864,33
STAT,1850,21,20-24,1871,38.469623057120764
STAT,1904,29,25-29,1933,60.00392154180442
SIM,1878,25,na,1903,4302
STAT,1819,42,35-39,1861,0.42438915278923345
SIM,1860,43,35-39,1903,5
STAT,1932,23,30-34,1955,37.33296551297502
SIM,1814,42,25-29,1856,16
STAT,1860,40,20-24,1900,0.13086571900469932
SIM,1865,86,na,1951,254
SIM,1917,18,20-24,1935,157
SIM,1878,32,40-44,1910,3
STAT,1853,27,45-49,1880,0.997333309845783
STAT,1923,45,na,1968,4272.497828431435
STAT,1929,39,40-44,1968,1.9043506029833062
STAT,1832,33,50-100,1865,0.06103877989268629
STAT,1828,42,45-49,1870,1.871511311800181
STAT,1874,17,35-39,1891,0.5663043312306769
SIM,1903,65,na,1968,1652
SIM,1872,34,na,1906,2377
SIM,1864,39,na,1903,2386
STAT,1921,37,15-19,1958,0.02118787726945323
SIM,1783,77,na,1860,1461
SIM,1909,44,45-49,1953,1
STAT,1895,33,45-49,1928,2.2589172683212957
SIM,1829,48,na,1877,1870
SIM,1895,39,25-29,1934,16
SIM,1900,39,45-49,1939,1
SIM,1913,0,na,1913,4288
STAT,1929,36,na,1965,4800.556191220617
STAT,1810,44,40-44,1854,0.011969988605550642
STAT,1901,20,35-39,1921,8.207939632093485
STAT,1918,0,na,1918,4837.442534275891
STAT,1841,36,na,1877,2839.376495019277
STAT,1821,81,na,1902,273.0953329648953
STAT,1864,27,20-24,1891,10.665134534464448
STAT,1931,40,na,1971,4940.32798489716
STAT,1872,21,40-44,1893,2.092941725314631
STAT,1899,17,40-44,1916,0.24982130509571857
SIM,1935,34,45-49,1969,1
STAT,1920,3,na,1923,4492.1488231164785
STAT,1930,19,25-29,1949,55.33388729283013
SIM,1879,72,na,1951,463
STAT,1949,16,35-39,1965,4.833479374926541
STAT,1892,20,15-19,1912,4.108871758315091
SIM,1855,37,30-34,1892,1
SIM,1924,33,na,1957,5258
STAT,1886,40,40-44,1926,2.3527406715837937
STAT,1866,49,35-39,1915,0.12512636607480757
STAT,1929,31,45-49,1960,1.9859326017616847
STAT,1950,18,50-100,1968,0.43863760444466754
STAT,1839,42,20-24,1881,0.15550891413478776
STAT,1851,48,45-49,1899,0.1840490373952102
STAT,1932,16,25-29,1948,57.12301737367454
STAT,1838,53,25-29,1891,0.001487739720788191
STAT,1937,31,na,1968,3705.252279380012
SIM,1899,15,25-29,1914,161
SIM,1915,50,na,1965,2886
STAT,1883,46,30-34,1929,0.09339018281412564
STAT,1915,16,na,1931,3995.0179175896874
SIM,1911,60,na,1971,2132
STAT,1869,43,45-49,1912,1.499322907068952
SIM,1857,57,na,1914,1397
STAT,1875,54,25-29,1929,0.003537105305757393
STAT,1833,31,30-34,1864,10.022812897300035
STAT,1849,16,30-34,1865,1.6628979239888793
STAT,1813,100,na,1913,0.777682641971012
STAT,1848,27,35-39,1875,10.779184327883627
STAT,1843,53,35-39,1896,0.00836956048479452
SIM,1830,39,na,1869,542
STAT,1927,16,15-19,1943,56.106525309109564
STAT,1864,40,20-24,1904,0.1458347293477787
STAT,1909,16,na,1925,3758.2186147015523
STAT,1913,21,na,1934,3662.511205757843
SIM,1841,31,30-34,1872,23
STAT,1843,37,na,1880,2470.475768113592
SIM,1827,41,50-100,1868,25
STAT,1927,35,50-100,1962,0.5186507366607762
STAT,1949,23,40-44,1972,3.883479611041814
SIM,1923,26,35-39,1949,49
STAT,1868,35,40-44,1903,4.268257197413091
STAT,1923,11,na,1934,4610.576036704773
STAT,1940,18,40-44,1958,1.4037871905174901
SIM,1910,13,na,1923,4577
STAT,1852,73,na,1925,1195.577487321086
SIM,1849,21,20-24,1870,377
STAT,1822,69,na,1891,846.2593468334624
STAT,1831,27,25-29,1858,50.21859575329348
STAT,1852,19,40-44,1871,0.22005631388782787
STAT,1935,30,na,1965,5200.669026350785
SIM,1840,16,20-24,1856,33
STAT,1845,32,35-39,1877,5.975011395962544
SIM,1865,52,na,1917,1665
STAT,1847,37,30-34,1884,4.99947208768221
STAT,1812,79,na,1891,55.365345912295844
STAT,1898,27,50-100,1925,0.8602050981540551
STAT,1809,81,na,1890,526.3672246390196
STAT,1881,51,45-49,1932,0.013770337866812268
STAT,1878,19,50-100,1897,0.050135918302974765
STAT,1878,1,na,1879,3533.3222737689684
STAT,1879,38,20-24,1917,0.7868452951569124
STAT,1889,18,25-29,1907,6.806137228751559
STAT,1890,49,40-44,1939,0.11446864007683895
STAT,1847,21,na,1868,2386.9519863408045
STAT,1923,18,40-44,1941,1.6208888657386722
STAT,1830,64,na,1894,1258.175712625908
STAT,1870,46,20-24,1916,0.011997163780141528
STAT,1792,85,na,1877,114.83121383738134
STAT,1864,51,45-49,1915,0.013256449920562427
STAT,1905,26,na,1931,3444.3651160695636
STAT,1861,56,na,1917,1696.247263932561
STAT,1827,78,na,1905,550.9892256021554
STAT,1882,5,na,1887,2548.5307464695634
STAT,1892,48,na,1940,2751.025297633345
SIM,1905,33,20-24,1938,11
STAT,1854,38,15-19,1892,0.031068063370646437
STAT,1942,18,na,1960,3801.3791473186743
STAT,1956,16,50-100,1972,0.4915643835506282
STAT,1776,103,na,1879,0.09977883597208957
STAT,1823,32,15-19,1855,0.3936331992273873
SIM,1905,60,na,1965,2506
STAT,1889,22,na,1911,2848.0506939060624
SIM,1880,69,na,1949,3193
STAT,1839,35,15-19,1874,0.06365364688223075
STAT,1894,41,45-49,1935,1.9118268580338418
STAT,1879,51,20-24,1930,7.606090030951426E-4
STAT,1910,44,45-49,1954,0.15361957910369486
STAT,1885,32,na,1917,2345.622918980769
STAT,1909,20,35-39,1929,8.713873033420422
STAT,1818,44,40-44,1862,4.147081475122185
STAT,1878,84,na,1962,537.1474310615448
STAT,1950,21,25-29,1971,108.571726900084
STAT,1919,46,na,1965,3941.5870055329992
STAT,1963,2,na,1965,4951.584270317474
SIM,1874,69,na,1943,1948
SIM,1901,70,na,1971,2332
SIM,1823,51,na,1874,1228
STAT,1867,36,50-100,1903,1.1667017424593236
STAT,1848,42,30-34,1890,1.0745057543291856
STAT,1927,34,45-49,1961,1.91744124797453
STAT,1872,28,25-29,1900,42.20983015131203
SIM,1859,52,na,1911,1707
STAT,1890,23,15-19,1913,3.981481553745377
STAT,1915,31,15-19,1946,0.12955541597005674
STAT,1840,32,15-19,1872,0.06829734766458692
STAT,1858,21,20-24,1879,60.8175964413494
STAT,1818,47,50-100,1865,0.43802414506239234
STAT,1851,51,35-39,1902,0.006831903419058003
SIM,1873,1,na,1874,3629
STAT,1929,30,na,1959,4775.7729333922
STAT,1907,31,25-29,1938,8.616460851079545
STAT,1837,45,20-24,1882,0.01024736788140014
STAT,1881,70,na,1951,1324.9899902980167
STAT,1815,81,na,1896,38.126923823751085
SIM,1886,54,na,1940,2794
STAT,1820,48,15-19,1868,6.202274199378447E-4
SIM,1932,31,25-29,1963,2
STAT,1901,29,50-100,1930,0.8880349715247041
STAT,1839,45,25-29,1884,0.05593920294045097
STAT,1914,28,40-44,1942,4.61714808947339
STAT,1811,52,45-49,1863,0.06528776902811967
STAT,1921,37,50-100,1958,0.4632439853867041
SIM,1875,2,na,1877,3301
STAT,1823,103,na,1926,0.1133735632570931
SIM,1877,19,20-24,1896,1
STAT,1888,28,20-24,1916,13.492354402306859
STAT,1809,87,na,1896,171.49015749705913
STAT,1824,31,20-24,1855,1.2517078762197622
STAT,1835,36,na,1871,2024.3807952237755
STAT,1890,41,45-49,1931,1.8200416393170553
STAT,1812,49,50-100,1861,0.06125625642985472
STAT,1840,88,na,1928,54.05604438066766
STAT,1870,39,15-19,1909,0.05541890576365411
STAT,1890,30,20-24,1920,3.29864611486041
STAT,1911,26,na,1937,3624.5439772598484
STAT,1827,34,40-44,1861,4.342546885779192
STAT,1891,15,15-19,1906,7.331794749596269
STAT,1879,44,15-19,1923,0.013975449945268625
STAT,1869,19,20-24,1888,17.924237842862034
STAT,1853,21,na,1874,1973.0214491998713
STAT,1903,39,20-24,1942,0.23380259579867596
SIM,1791,72,na,1863,338
SIM,1871,28,15-19,1899,2
STAT,1824,64,na,1888,341.7453055402837
STAT,1803,96,na,1899,2.165997706294886
STAT,1863,35,20-24,1898,0.6643330687705091
STAT,1928,15,20-24,1943,170.3176370001544
STAT,1863,28,15-19,1891,0.3859680301183092
STAT,1863,19,50-100,1882,0.042920754700681726
STAT,1894,25,40-44,1919,3.835178183582411
SIM,1912,48,na,1960,4528
SIM,1916,9,na,1925,4921
STAT,1925,46,na,1971,4421.987019695494
STAT,1891,22,20-24,1913,84.74367490608375
STAT,1924,31,25-29,1955,10.685777332524088
STAT,1889,49,50-100,1938,0.1633486286596306
STAT,1848,17,25-29,1865,6.573581440587238
STAT,1845,42,45-49,1887,0.7562627256873423
STAT,1840,50,45-49,1890,0.005796447020959758
STAT,1854,32,45-49,1886,0.9929248091006566
SIM,1912,29,25-29,1941,1
STAT,1838,37,20-24,1875,0.3970618562934251
STAT,1933,21,25-29,1954,122.05924797847062
STAT,1916,29,50-100,1945,1.007864011094891
SIM,1854,43,na,1897,1607
STAT,1858,16,40-44,1874,0.16412746288093039
STAT,1830,29,30-34,1859,23.867498641459434
STAT,1834,53,25-29,1887,0.0015692052166633283
STAT,1839,52,30-34,1891,0.00550087123650363
STAT,1902,47,20-24,1949,0.009487399478019388
SIM,1852,34,40-44,1886,43
STAT,1896,44,15-19,1940,0.0012470949434179035
STAT,1923,23,20-24,1946,127.62303593767356
STAT,1900,15,35-39,1915,0.7636504003360354
SIM,1931,23,20-24,1954,1188
STAT,1884,51,30-34,1935,0.005725475099607256
STAT,1844,34,40-44,1878,5.032104513568818
STAT,1810,44,na,1854,94.93129162018813
STAT,1936,18,na,1954,3479.8265280089786
STAT,1892,49,45-49,1941,0.16137826764793078
SIM,1899,25,35-39,1924,6
SIM,1941,21,25-29,1962,7
SIM,1892,54,na,1946,3403
STAT,1912,20,40-44,1932,3.2039158714040434
STAT,1869,33,35-39,1902,10.175914497106064
STAT,1914,20,45-49,1934,1.0942440794829453
STAT,1883,30,15-19,1913,0.13810357787245459
STAT,1859,18,na,1877,2099.445863846562
STAT,1915,23,30-34,1938,29.199319681451144
STAT,1878,49,25-29,1927,0.05802550379221995
STAT,1938,13,na,1951,3860.7049778286205
SIM,1900,36,40-44,1936,1
STAT,1836,110,na,1946,2.1149175723331347E-4
STAT,1878,33,45-49,1911,1.7865936234191062
STAT,1941,30,na,1971,3930.1567865530997
SIM,1921,26,30-34,1947,1
SIM,1883,71,na,1954,1622
STAT,1843,16,50-100,1859,0.06222626462636316
STAT,1892,30,25-29,1922,12.783239363413443
STAT,1884,44,25-29,1928,0.6064216479627126
STAT,1898,33,na,1931,3195.3709363128837
STAT,1857,17,35-39,1874,0.49488853918117504
STAT,1836,42,35-39,1878,1.6507082121999153
STAT,1897,57,na,1954,2668.894346657903
STAT,1920,42,50-100,1962,0.12808059054066964
STAT,1939,19,45-49,1958,0.49420145898157875
SIM,1841,42,na,1883,480
STAT,1831,24,20-24,1855,111.41800346281155
STAT,1866,16,30-34,1882,1.5021988559330746
SIM,1817,45,45-49,1862,10
STAT,1836,89,na,1925,80.4013452532936
STAT,1913,26,30-34,1939,38.68433096556518
SIM,1845,32,na,1877,2500
SIM,1900,23,na,1923,2573
STAT,1823,50,45-49,1873,0.02267452805973963
STAT,1849,26,40-44,1875,3.0136480119744538
STAT,1858,19,45-49,1877,0.05758726415823678
STAT,1897,36,15-19,1933,0.07493511387442642
STAT,1900,22,40-44,1922,2.886670008291408
SIM,1810,50,na,1860,3098
STAT,1864,43,25-29,1907,0.5795717486400996
SIM,1928,41,45-49,1969,1
STAT,1876,36,45-49,1912,2.024931143135245
STAT,1894,43,na,1937,2927.953346511453
STAT,1929,29,30-34,1958,48.646206783956416
SIM,1881,30,20-24,1911,6
STAT,1836,27,45-49,1863,1.1009056787951776
STAT,1852,53,45-49,1905,0.014373473338047785
SIM,1867,16,na,1883,2410
STAT,1921,16,na,1937,4156.019910791777
STAT,1940,23,20-24,1963,111.96553812514072
STAT,1938,18,50-100,1956,0.3655016994195375
STAT,1852,36,50-100,1888,1.2555061050408773
STAT,1932,26,35-39,1958,19.536628623517796
SIM,1828,60,na,1888,1344
SIM,1844,42,35-39,1886,5
STAT,1818,95,na,1913,8.09241282257123
STAT,1811,91,na,1902,35.106575941440965
SIM,1940,26,35-39,1966,6
STAT,1791,66,na,1857,982.6924476622963
STAT,1904,19,15-19,1923,8.433199201806103
STAT,1817,103,na,1920,0.045464041274016445
STAT,1873,30,20-24,1903,2.795030280412442
STAT,1817,53,25-29,1870,0.0023487489698556605
STAT,1860,50,30-34,1910,0.004925826644655269
STAT,1886,43,45-49,1929,1.538650145408964
SIM,1882,24,na,1906,2017
STAT,1872,99,na,1971,14.048982782517534
STAT,1853,92,na,1945,32.29448475943901
STAT,1883,49,35-39,1932,0.1318739056543917
STAT,1887,32,40-44,1919,4.773307578286202
STAT,1822,37,25-29,1859,5.808512976297123
STAT,1862,17,45-49,1879,0.06372207510168922
STAT,1920,39,20-24,1959,0.28430406846459993
STAT,1844,19,na,1863,2856.779397722851
STAT,1866,40,25-29,1906,0.5920876549097778
STAT,1859,46,na,1905,1788.2700456250875
SIM,1836,32,35-39,1868,129
STAT,1809,45,45-49,1854,2.1719002051368634
STAT,1810,47,45-49,1857,0.0012392695254121882
STAT,1802,52,35-39,1854,0.043734246356881605
SIM,1878,39,25-29,1917,21
SIM,1838,59,na,1897,1518
STAT,1858,54,25-29,1912,0.002630525581281704
STAT,1923,33,30-34,1956,17.860631916508098
STAT,1895,23,35-39,1918,7.567758564854468
STAT,1862,32,35-39,1894,8.62563757718458
SIM,1904,13,na,1917,4192
STAT,1831,77,na,1908,676.5165500694526
STAT,1829,53,50-100,1882,0.006022276204769508
SIM,1907,27,na,1934,4408
STAT,1843,50,30-34,1893,0.005965903172559641
STAT,1861,50,na,1911,1816.3993800805636
STAT,1912,35,50-100,1947,0.40887120286534173
STAT,1857,21,50-100,1878,0.36386372458961874
STAT,1887,36,20-24,1923,0.8525363520408609
STAT,1906,36,35-39,1942,2.2213063263115878
STAT,1908,15,35-39,1923,0.8114098722361143
SIM,1898,23,25-29,1921,2
SIM,1923,23,30-34,1946,42
SIM,1899,2,na,1901,2393
SIM,1817,51,na,1868,2447
STAT,1870,27,45-49,1897,1.1068979691095564
SIM,1863,26,na,1889,1135
SIM,1860,15,na,1875,2608
STAT,1873,27,30-34,1900,25.83107964421436
SIM,1915,22,na,1937,3561
STAT,1850,24,25-29,1874,31.273300328302703
STAT,1923,48,35-39,1971,0.14882377946965508
STAT,1903,49,30-34,1952,0.07589159356110367
STAT,1933,31,35-39,1964,12.238649793124253
STAT,1837,38,15-19,1875,0.0542540019077936
STAT,1885,60,na,1945,1874.6610376697386
STAT,1838,50,20-24,1888,3.259864117681562E-4
STAT,1819,52,45-49,1871,0.002548919522218105
STAT,1903,45,15-19,1948,3.234818880893665E-4
SIM,1844,84,na,1928,55
STAT,1924,21,15-19,1945,6.239724440229166
STAT,1847,92,na,1939,37.655941256507134
STAT,1914,18,30-34,1932,2.4797674577863558
SIM,1829,47,30-34,1876,1
SIM,1887,40,35-39,1927,4
SIM,1909,26,15-19,1935,2
STAT,1856,35,15-19,1891,0.04071626302741438
STAT,1901,41,30-34,1942,0.11213204341203357
STAT,1867,75,na,1942,973.5932347290346
STAT,1845,63,na,1908,885.4021210297853
SIM,1885,41,45-49,1926,10
SIM,1877,9,na,1886,213
STAT,1835,35,45-49,1870,1.9038604145589095
STAT,1858,24,25-29,1882,44.99108094783708
STAT,1830,31,45-49,1861,1.6550776684591673
SIM,1847,67,na,1914,1382
STAT,1888,38,30-34,1926,6.120695247242811
STAT,1950,13,na,1963,4599.667133964696
SIM,1924,30,20-24,1954,14
STAT,1877,28,45-49,1905,1.1231239303528497
SIM,1837,38,25-29,1875,14
STAT,1898,18,35-39,1916,0.7359252109848442
STAT,1927,31,40-44,1958,4.777418450255398
STAT,1850,19,na,1869,1280.02565861636
SIM,1813,61,na,1874,35
SIM,1896,38,30-34,1934,3
SIM,1832,34,25-29,1866,28
STAT,1912,47,15-19,1959,3.4990842087415276E-4
STAT,1849,22,na,1871,2178.1511607463185
STAT,1882,23,25-29,1905,54.63818059744474
SIM,1890,53,na,1943,3400
SIM,1931,33,30-34,1964,11
STAT,1867,21,30-34,1888,17.037336544172952
SIM,1914,2,na,1916,5181
STAT,1905,34,25-29,1939,8.38677567599405
STAT,1879,40,35-39,1919,1.8763488292121822
SIM,1948,16,25-29,1964,55
SIM,1815,41,30-34,1856,7
SIM,1854,15,na,1869,2352
STAT,1842,48,35-39,1890,0.03431753776030354
STAT,1899,15,15-19,1914,8.143469570377032
STAT,1910,48,25-29,1958,0.048801643311857115
STAT,1844,37,45-49,1881,2.086952926601038
STAT,1824,34,25-29,1858,4.200144966312864
STAT,1854,22,35-39,1876,3.8123263119603856
SIM,1923,33,40-44,1956,25
STAT,1854,46,50-100,1900,0.13694565508933249
STAT,1849,22,25-29,1871,58.31718603035946
STAT,1878,42,50-100,1920,1.0856126275583948
STAT,1874,32,30-34,1906,18.01958962801578
STAT,1925,45,35-39,1970,0.1555310328959432
STAT,1818,47,45-49,1865,0.42090268080007637
STAT,1907,47,40-44,1954,0.14024961334289712
STAT,1837,37,na,1874,2090.914975154264
STAT,1891,25,25-29,1916,52.37218918746539
STAT,1839,63,na,1902,1657.7365831337338
STAT,1874,23,na,1897,2433.3451223008005
STAT,1816,69,na,1885,1420.8494223360906
STAT,1916,30,20-24,1946,2.5038740176000935
SIM,1801,76,na,1877,1570
SIM,1839,27,35-39,1866,7
STAT,1841,46,25-29,1887,0.06526291992171585
STAT,1879,54,25-29,1933,0.0035336180492201324
STAT,1870,49,25-29,1919,0.05622439221247234
STAT,1918,6,na,1924,4303.705762227248
STAT,1932,28,na,1960,4870.204470698019
STAT,1840,17,25-29,1857,2.8889263998914094
STAT,1882,58,na,1940,1893.3721177508428
STAT,1888,74,na,1962,1502.9936208550873
SIM,1869,42,na,1911,3598
SIM,1919,12,na,1931,5211
STAT,1851,45,40-44,1896,0.1365604989689688
STAT,1823,31,50-100,1854,3.9855221501683684
STAT,1865,29,50-100,1894,0.5798592408797268
SIM,1882,32,30-34,1914,1
STAT,1910,34,35-39,1944,8.638161155500596
STAT,1909,18,20-24,1927,26.247292166959472
STAT,1931,24,25-29,1955,118.21444102007067
STAT,1878,39,15-19,1917,0.057194214112575956
STAT,1885,38,45-49,1923,1.9497773776551588
STAT,1915,33,40-44,1948,3.912689877175139
STAT,1865,35,25-29,1900,2.6536462113998533
STAT,1939,32,15-19,1971,0.1296745242797943
STAT,1832,26,30-34,1858,31.01436562180224
STAT,1873,75,na,1948,1056.0012218853226
STAT,1823,42,25-29,1865,1.078531408465429
STAT,1944,13,na,1957,4179.00921167095
STAT,1928,37,30-34,1965,2.285836748808552
STAT,1910,30,50-100,1940,0.794622340410942
SIM,1895,65,na,1960,4126
STAT,1839,19,40-44,1858,0.2196809694151229
SIM,1914,26,25-29,1940,5
STAT,1889,28,na,1917,2863.794818091313
STAT,1876,89,na,1965,251.71392811611588
SIM,1916,38,na,1954,4588
STAT,1866,46,30-34,1912,0.08861172454555519
STAT,1826,29,40-44,1855,9.459197108888013
SIM,1853,67,na,1920,2333
STAT,1912,23,45-49,1935,1.0624994971284152
SIM,1795,62,na,1857,12
STAT,1907,41,35-39,1948,0.18430669212157103
SIM,1840,26,30-34,1866,69
STAT,1828,54,na,1882,1501.1789862696712
STAT,1847,47,40-44,1894,0.15406320795514652
STAT,1890,33,25-29,1923,12.347444204546814
SIM,1814,46,na,1860,2442
STAT,1892,46,40-44,1938,0.11990349478561409
SIM,1808,46,na,1854,1441
SIM,1870,39,na,1909,1879
STAT,1834,54,na,1888,935.1705857366936
SIM,1830,33,na,1863,826
SIM,1900,20,25-29,1920,591
STAT,1898,41,15-19,1939,0.0012953953649833103
STAT,1871,32,45-49,1903,1.7395387177308756
STAT,1837,48,25-29,1885,0.04733270951727405
STAT,1846,31,40-44,1877,3.06696979542979
STAT,1882,47,25-29,1929,0.05488973311239958
SIM,1851,32,na,1883,1263
STAT,1829,38,25-29,1867,1.4358982028655274
STAT,1942,20,20-24,1962,115.3345036118646
STAT,1902,43,40-44,1945,0.21835782741732937
STAT,1844,19,15-19,1863,7.385810735170631
STAT,1894,33,50-100,1927,1.1602345405051557
STAT,1943,7,na,1950,4154.39255669488
SIM,1834,60,na,1894,511
STAT,1835,32,50-100,1867,0.8826008580493763
SIM,1905,43,30-34,1948,1
SIM,1894,30,30-34,1924,48
SIM,1777,77,na,1854,550
STAT,1886,30,30-34,1916,18.225745019810105
SIM,1823,32,25-29,1855,14
STAT,1865,54,30-34,1919,0.005285175930382367
STAT,1896,29,25-29,1925,55.364395858563206
STAT,1921,44,20-24,1965,0.01959004193858841
STAT,1862,104,na,1966,0.3556892728916929
STAT,1928,18,25-29,1946,54.046403129205636
STAT,1845,44,50-100,1889,0.5203276441036652
STAT,1906,26,25-29,1932,61.465689849244015
STAT,1865,32,20-24,1897,2.467868489956249
STAT,1874,28,50-100,1902,0.6578811700506558
STAT,1860,41,35-39,1901,1.483931896997154
STAT,1816,110,na,1926,2.3329192438080936E-4
STAT,1872,25,20-24,1897,11.82709952390766
STAT,1836,80,na,1916,473.4346176008095
STAT,1823,36,30-34,1859,10.056523611094992
STAT,1914,37,na,1951,3704.09474364738
SIM,1880,44,50-100,1924,3
SIM,1831,29,25-29,1860,182
STAT,1888,34,15-19,1922,0.16295456824075663
STAT,1920,49,30-34,1969,0.09670531387741638
STAT,1836,40,45-49,1876,1.399722810949744
STAT,1836,24,40-44,1860,2.0771954658772662
STAT,1832,36,40-44,1868,0.3226051769529966
SIM,1913,27,na,1940,3448
SIM,1838,53,na,1891,1620
STAT,1919,18,15-19,1937,49.35655875906654
SIM,1914,8,na,1922,5124
STAT,1884,41,20-24,1925,0.15271521940070473
SIM,1818,39,na,1857,929
STAT,1819,49,na,1868,611.7352133511976
STAT,1919,8,na,1927,4348.986302380038
STAT,1882,89,na,1971,306.58630280910035
STAT,1905,38,40-44,1943,1.352250127552219
SIM,1862,72,na,1934,2633
SIM,1829,76,na,1905,1137
STAT,1863,82,na,1945,398.3271577050682
STAT,1934,15,45-49,1949,0.6742228648100315
STAT,1874,54,40-44,1928,0.010566447709317828
STAT,1878,42,40-44,1920,2.311361533704282
STAT,1865,42,30-34,1907,1.0483445532374944
SIM,1939,32,na,1971,4676
STAT,1896,72,na,1968,2017.5865972824904
STAT,1832,90,na,1922,66.92573978936055
STAT,1862,38,na,1900,1996.7292624749452
STAT,1880,53,20-24,1933,7.537741514599566E-4
STAT,1875,19,45-49,1894,0.06671684165100901
STAT,1874,47,35-39,1921,0.1438156952261542
STAT,1852,42,na,1894,2323.601781611558
STAT,1929,19,50-100,1948,0.47224110591105106
SIM,1940,29,na,1969,3437
STAT,1825,43,na,1868,1660.8385267713252
STAT,1888,43,na,1931,2648.279260353329
STAT,1911,37,20-24,1948,0.25174418406578775
STAT,1924,41,35-39,1965,0.23755998637326134
STAT,1846,28,15-19,1874,0.3227389615023834
STAT,1940,26,25-29,1966,66.39555351345318
STAT,1947,24,20-24,1971,124.26227368054948
STAT,1919,25,20-24,1944,19.593307532675883
SIM,1921,22,na,1943,3925
STAT,1869,70,na,1939,1415.816761090039
STAT,1900,37,45-49,1937,0.5960558908292732
STAT,1881,27,20-24,1908,11.078569814289482
STAT,1832,48,40-44,1880,0.015324532994618167
STAT,1915,41,25-29,1956,0.07097964102800704
STAT,1866,19,35-39,1885,0.5080660860565878
STAT,1806,50,45-49,1856,0.040131300471201344
STAT,1813,58,na,1871,1857.0210373017765
STAT,1873,41,45-49,1914,1.542169519362929
STAT,1890,27,30-34,1917,30.485390841083866
STAT,1959,12,na,1971,5092.3772764125815
STAT,1865,47,25-29,1912,0.05234311578453517
SIM,1842,58,na,1900,2787
SIM,1853,9,na,1862,3646
STAT,1883,40,25-29,1923,0.6240164562600727
STAT,1859,23,30-34,1882,14.542612300797979
STAT,1861,25,45-49,1886,0.9435855387345501
STAT,1888,48,40-44,1936,0.11005832522916549
SIM,1829,79,na,1908,1137
STAT,1931,28,40-44,1959,5.972451052320664
STAT,1858,51,20-24,1909,5.662189325856891E-4
SIM,1887,30,na,1917,3777
STAT,1847,40,20-24,1887,0.1481338455507949
STAT,1907,52,na,1959,3196.4237249289213
STAT,1847,45,15-19,1892,3.652519382716714E-4
STAT,1860,53,35-39,1913,0.006910438008729274
STAT,1891,44,30-34,1935,1.3946967009942035
STAT,1819,41,50-100,1860,0.2520625097669563
SIM,1886,42,40-44,1928,1
SIM,1845,41,40-44,1886,1
SIM,1927,25,20-24,1952,2
STAT,1910,31,30-34,1941,15.082742656905642
STAT,1824,53,30-34,1877,9.841737147190787E-4
SIM,1807,61,na,1868,622
STAT,1865,52,50-100,1917,0.013715271203502471
SIM,1850,53,na,1903,1110
STAT,1817,50,20-24,1867,5.193207403255738E-4
STAT,1852,45,na,1897,2287.240277649887
STAT,1836,45,50-100,1881,0.2020649353794628
STAT,1888,41,20-24,1929,0.1841256088521993
SIM,1845,38,na,1883,2335
SIM,1958,6,na,1964,4197
STAT,1878,30,40-44,1908,4.497779674258848
STAT,1897,46,25-29,1943,0.04327250752013882
SIM,1874,3,na,1877,2818
SIM,1900,30,35-39,1930,1
STAT,1891,32,30-34,1923,21.470716431421533
STAT,1847,33,15-19,1880,0.14961103964508476
STAT,1941,6,na,1947,4057.936410781489
STAT,1890,42,50-100,1932,1.2773737380268877
STAT,1849,56,na,1905,1718.579057487875
SIM,1887,33,na,1920,3529
STAT,1877,41,45-49,1918,1.5261442348083474
STAT,1824,95,na,1919,2.573002016951965
SIM,1925,12,na,1937,5239
SIM,1913,24,15-19,1937,36
STAT,1923,36,35-39,1959,2.775612628444223
STAT,1942,30,30-34,1972,16.60994831149956
STAT,1841,53,50-100,1894,0.016547864299821958
STAT,1870,30,na,1900,2398.1152307356415
SIM,1931,36,35-39,1967,1
STAT,1885,34,50-100,1919,0.892912204841436
STAT,1840,57,na,1897,791.3014385552441
STAT,1865,18,na,1883,2362.146942074959
STAT,1905,24,15-19,1929,4.7153491491647115
STAT,1840,26,20-24,1866,5.8012618333270245
STAT,1882,20,20-24,1902,66.3711881811067
STAT,1915,48,45-49,1963,0.21530997660542972
STAT,1850,52,50-100,1902,0.006936745178770227
SIM,1872,37,30-34,1909,2
STAT,1827,46,50-100,1873,0.22776850246440153
SIM,1805,66,na,1871,2097
STAT,1926,25,na,1951,4482.466487683425
STAT,1937,23,15-19,1960,5.1284592541672085
STAT,1863,34,45-49,1897,1.47597659953137
STAT,1882,25,15-19,1907,0.4373264393273626
STAT,1801,54,40-44,1855,0.02617017446377778
STAT,1856,49,40-44,1905,0.12039759290459669
STAT,1839,23,50-100,1862,0.4833004281594833
SIM,1826,65,na,1891,1080
STAT,1850,43,30-34,1893,0.5270378050827107
STAT,1837,106,na,1943,0.009735615053686841
STAT,1906,48,35-39,1954,0.11291970543167813
STAT,1856,53,50-100,1909,0.010673433607442164
STAT,1841,41,30-34,1882,1.3474728680397219
STAT,1863,85,na,1948,234.03193370423443
STAT,1903,15,50-100,1918,0.06986763522824946
STAT,1921,19,na,1940,4123.6043845256945
STAT,1870,64,na,1934,1733.0270973005902
STAT,1883,52,25-29,1935,0.00338942915618784
STAT,1815,41,20-24,1856,0.017159973386007176
SIM,1869,11,na,1880,3826
STAT,1873,49,40-44,1922,0.17194679613601657
STAT,1947,24,na,1971,4080.957047322895
STAT,1864,37,30-34,1901,4.845151946658122
SIM,1891,40,25-29,1931,2
STAT,1896,26,20-24,1922,15.517805856983808
SIM,1838,50,na,1888,1642
STAT,1906,46,45-49,1952,0.1933198712347665
STAT,1929,35,25-29,1964,1.2573873270404925
STAT,1836,83,na,1919,303.8288284234406
STAT,1877,25,40-44,1902,3.0614880472787234
STAT,1931,20,45-49,1951,1.4577138734289246
STAT,1811,46,15-19,1857,0.0019104580804237936
STAT,1876,55,na,1931,2090.2682521165975
STAT,1828,32,35-39,1860,15.338525636490747
STAT,1819,43,na,1862,658.9982196678741
STAT,1828,40,50-100,1868,1.366116674162348
STAT,1905,30,45-49,1935,2.5283363411849584
STAT,1855,56,na,1911,1349.9041809993862
SIM,1881,49,40-44,1930,2
STAT,1830,95,na,1925,9.622942718853219
STAT,1914,21,50-100,1935,0.6380339098840525
STAT,1841,31,20-24,1872,3.6901865205914497
STAT,1894,77,na,1971,1562.0900188990213
STAT,1925,42,30-34,1967,0.15336556521227873
STAT,1900,20,15-19,1920,4.59735765677782
STAT,1832,34,15-19,1866,0.009684641001477185
STAT,1901,64,na,1965,2662.3741249152617
STAT,1829,47,20-24,1876,0.005550487475571479
SIM,1857,26,na,1883,1468
SIM,1837,35,20-24,1872,5
STAT,1849,53,na,1902,1785.1120159582815
SIM,1914,48,35-39,1962,1
STAT,1896,38,20-24,1934,1.011114943213069
SIM,1832,65,na,1897,729
STAT,1879,50,45-49,1929,0.01510135092610476
STAT,1882,39,40-44,1921,4.148884887329786
STAT,1923,20,50-100,1943,0.7620714779383575
SIM,1885,31,35-39,1916,1
STAT,1832,22,15-19,1854,5.073502864552175
STAT,1859,8,na,1867,2259.2791884954895
STAT,1850,31,30-34,1881,8.521930161499265
SIM,1940,26,na,1966,4220
STAT,1837,44,45-49,1881,1.25601753798891
STAT,1799,86,na,1885,14.673477643596147
STAT,1829,35,20-24,1864,0.40507293121248233
STAT,1867,18,40-44,1885,0.1757927530791653
STAT,1855,37,20-24,1892,0.5101759079749127
STAT,1932,36,45-49,1968,0.9104146904721137
STAT,1922,19,35-39,1941,4.776329518647276
STAT,1916,40,30-34,1956,0.1295848399973917
SIM,1818,36,na,1854,1028
STAT,1832,40,45-49,1872,0.12811026399877035
STAT,1914,21,20-24,1935,107.82133900398776
STAT,1826,28,na,1854,2174.1339262850875
STAT,1826,90,na,1916,62.854545248498106
STAT,1874,40,15-19,1914,0.014396477175078753
STAT,1832,54,50-100,1886,0.0011617507717903129
STAT,1821,50,na,1871,1263.6498964427255
STAT,1882,32,20-24,1914,2.587936173456091
STAT,1845,23,50-100,1868,0.24940394776770733
STAT,1862,30,45-49,1892,1.4972238314665112
STAT,1876,35,50-100,1911,1.2529222308225598
SIM,1881,48,na,1929,2699
STAT,1936,24,45-49,1960,1.0643189148644916
STAT,1768,94,na,1862,10.72444217817736
SIM,1906,48,na,1954,3180
STAT,1877,31,35-39,1908,10.322202134620106
STAT,1873,37,40-44,1910,4.490353188069669
STAT,1901,42,45-49,1943,0.14513726697196389
STAT,1911,49,20-24,1960,0.010283627417286745
STAT,1945,15,20-24,1960,146.54169497713337
SIM,1898,6,na,1904,4434
SIM,1849,34,35-39,1883,27
SIM,1890,20,20-24,1910,556
STAT,1841,24,15-19,1865,4.587229357804529
STAT,1877,21,25-29,1898,58.286627943317114
STAT,1815,48,40-44,1863,0.017124540813491098
STAT,1941,31,25-29,1972,9.599285478495009
SIM,1863,20,na,1883,480
SIM,1890,39,40-44,1929,39
STAT,1831,43,na,1874,1980.1238736996622
STAT,1846,42,na,1888,1385.4283522138358
STAT,1872,18,15-19,1890,5.927049687781252
STAT,1922,30,45-49,1952,1.7722455295959652
SIM,1894,18,na,1912,1764
STAT,1846,35,20-24,1881,0.48676440353208894
STAT,1884,84,na,1968,612.6210699445019
STAT,1842,51,25-29,1893,8.834921561964245E-4
STAT,1888,46,15-19,1934,4.629758452422522E-4
STAT,1886,48,na,1934,2300.5485342034845
SIM,1801,73,na,1874,1783
SIM,1848,19,25-29,1867,18
STAT,1789,93,na,1882,12.01662895555734
STAT,1863,16,15-19,1879,5.8154910082979745
SIM,1935,2,na,1937,5974
SIM,1818,40,35-39,1858,4
STAT,1848,22,50-100,1870,0.46463692967431053
STAT,1818,64,na,1882,1162.0563988270546
STAT,1937,27,30-34,1964,37.80002443528708
SIM,1918,33,na,1951,4158
SIM,1827,28,20-24,1855,2
SIM,1840,38,30-34,1878,14
STAT,1852,52,30-34,1904,0.005959867223409107
SIM,1839,38,na,1877,999
STAT,1854,22,50-100,1876,0.2664099761123491
STAT,1830,98,na,1928,2.3512042118167087
STAT,1861,15,35-39,1876,0.5307322844243291
STAT,1825,51,25-29,1876,0.004431587170085421
STAT,1880,23,na,1903,2447.698907295201
SIM,1814,40,na,1854,2442
STAT,1900,34,40-44,1934,5.9561555628333585
SIM,1836,24,na,1860,2355
STAT,1834,57,na,1891,885.654964383138
STAT,1945,18,25-29,1963,46.80062445240406
STAT,1849,19,35-39,1868,0.5624169106611907
STAT,1913,52,na,1965,3481.217385538225
STAT,1872,96,na,1968,39.585131730337025
STAT,1886,31,45-49,1917,1.8131949490597434
STAT,1815,50,na,1865,206.34099002287655
STAT,1906,23,20-24,1929,99.48185888206392
STAT,1856,45,25-29,1901,0.04178385954666299
STAT,1941,0,na,1941,4561.193371347561
STAT,1925,28,50-100,1953,1.1607667996337023
STAT,1819,40,45-49,1859,0.33580988889190827
STAT,1895,30,40-44,1925,5.6868624415236955
STAT,1870,15,45-49,1885,0.06652386689772528
STAT,1846,15,50-100,1861,0.03688312510019305
SIM,1831,26,20-24,1857,52
STAT,1847,43,25-29,1890,0.5763910457214905
STAT,1892,42,25-29,1934,0.7940718242153407
STAT,1899,19,30-34,1918,2.1653392627709005
STAT,1875,16,40-44,1891,0.18827568767536088
STAT,1834,50,20-24,1884,3.469300412424619E-4
STAT,1823,39,35-39,1862,12.541524376315861
STAT,1845,97,na,1942,2.665798010406465
STAT,1848,54,30-34,1902,0.005417066299720108
SIM,1914,23,20-24,1937,64
STAT,1923,26,25-29,1949,75.03045912375306
SIM,1845,44,45-49,1889,24
STAT,1832,38,30-34,1870,0.419935702340709
SIM,1824,39,na,1863,2082
STAT,1844,25,45-49,1869,1.3660894351320492
STAT,1867,41,na,1908,2195.699192393163
STAT,1883,42,15-19,1925,0.013269295787869369
SIM,1835,19,15-19,1854,8
SIM,1888,18,na,1906,577
STAT,1869,40,40-44,1909,2.292605628266964
STAT,1874,51,50-100,1925,0.015661620065806174
STAT,1838,43,15-19,1881,0.006193886910321893
STAT,1874,44,30-34,1918,1.1705181002103648
SIM,1893,33,na,1926,3164
STAT,1941,25,30-34,1966,40.10727579449442
STAT,1853,24,40-44,1877,1.8817744962922096
STAT,1803,103,na,1906,0.0362018869948803
STAT,1888,44,25-29,1932,0.731150147250964
SIM,1855,47,40-44,1902,2
STAT,1858,18,30-34,1876,1.4134547797911774
STAT,1913,19,25-29,1932,8.70215461712278
SIM,1890,59,na,1949,3139
STAT,1836,30,35-39,1866,10.014760857188838
STAT,1875,51,20-24,1926,7.613596328127288E-4
STAT,1850,36,25-29,1886,1.3646531494186558
SIM,1873,32,20-24,1905,2
STAT,1908,37,na,1945,3495.179612107755
STAT,1895,22,na,1917,3076.626642049545
STAT,1868,38,45-49,1906,1.9159004791742196
STAT,1905,23,na,1928,3391.1867342298683
STAT,1842,45,30-34,1887,0.024657873515162125
SIM,1903,34,na,1937,2900
STAT,1915,35,30-34,1950,1.8323990057574857
STAT,1818,61,na,1879,1299.592751881828
STAT,1842,41,15-19,1883,0.003592592840196466
STAT,1932,38,35-39,1970,3.2239663649141783
STAT,1840,29,25-29,1869,20.4709139394033
STAT,1938,10,na,1948,3878.4022936200895
STAT,1837,26,15-19,1863,0.4703029627784742
SIM,1876,38,45-49,1914,14
SIM,1854,46,na,1900,1521
SIM,1900,20,na,1920,3518
STAT,1890,17,20-24,1907,21.462288964393803
STAT,1883,27,50-100,1910,0.6154117097404922
STAT,1864,33,15-19,1897,0.1289173555271235
STAT,1891,47,35-39,1938,0.09666097051160108
STAT,1837,68,na,1905,1225.3601597318607
STAT,1911,47,30-34,1958,0.08344368908630813
STAT,1946,25,15-19,1971,0.7785664408831098
STAT,1811,51,30-34,1862,0.027320310145252935
STAT,1861,49,15-19,1910,3.2571128044163217E-4
STAT,1872,20,50-100,1892,0.4107812559260637
STAT,1799,89,na,1888,7.777887834835084
STAT,1834,38,50-100,1872,0.6660841779138653
STAT,1897,43,20-24,1940,0.014540358264300253
SIM,1847,64,na,1911,1382
STAT,1842,83,na,1925,98.54982608484436
STAT,1857,82,na,1939,358.037357769047
STAT,1942,8,na,1950,4090.591658330686
STAT,1901,44,35-39,1945,0.1734475879953008
STAT,1929,32,20-24,1961,3.0765630888415334
STAT,1806,48,30-34,1854,0.3098477571456482
SIM,1874,60,na,1934,2153
SIM,1913,28,30-34,1941,1
STAT,1875,70,na,1945,1440.7498681598681
STAT,1905,28,30-34,1933,36.0921504113865
STAT,1911,43,15-19,1954,0.0014405158787386334
STAT,1866,52,25-29,1918,0.003216003585222263
SIM,1881,23,15-19,1904,3
STAT,1868,29,na,1897,2288.598458777277
STAT,1873,39,30-34,1912,5.411949649153742
SIM,1842,38,50-100,1880,2
STAT,1907,40,20-24,1947,0.016253729588719408
SIM,1869,45,na,1914,3594
STAT,1867,24,35-39,1891,5.484240355203711
STAT,1878,45,45-49,1923,0.2452338815580567
STAT,1806,76,na,1882,341.16100543962995
STAT,1835,19,40-44,1854,0.185087013742117
STAT,1850,46,35-39,1896,0.06483017620857999
SIM,1906,45,na,1951,3320
SIM,1830,33,45-49,1863,3
SIM,1898,3,na,1901,4491
STAT,1890,19,50-100,1909,0.05899185745113924
STAT,1832,32,25-29,1864,0.6693259303147425
STAT,1836,20,25-29,1856,90.99289185155864
STAT,1931,18,30-34,1949,15.800306162040787
STAT,1859,33,40-44,1892,3.422744290319027
STAT,1894,28,45-49,1922,1.4069564632066085
SIM,1925,15,na,1940,4174
STAT,1805,91,na,1896,7.774449397138393
STAT,1902,12,na,1914,3636.587157613622
STAT,1824,41,30-34,1865,0.19464546384704184
STAT,1793,61,na,1854,829.9999999999999
STAT,1824,46,25-29,1870,0.010109656308641626
STAT,1938,34,20-24,1972,2.4231953018196317
STAT,1920,45,15-19,1965,4.038563496585365E-4
SIM,1884,59,na,1943,3654
STAT,1941,21,15-19,1962,5.44034894560759
SIM,1909,59,na,1968,3677
STAT,1861,111,na,1972,0.0014506371174147163
STAT,1906,43,40-44,1949,0.2245466606177756
STAT,1933,30,20-24,1963,3.268468310610603
STAT,1887,29,15-19,1916,0.49580907165298094
STAT,1857,50,25-29,1907,0.002757062910988461
SIM,1881,45,na,1926,2813
STAT,1871,22,35-39,1893,5.821145963848935
STAT,1841,34,25-29,1875,13.554217402948423
STAT,1879,0,na,1879,3722.8724527550658
SIM,1826,35,45-49,1861,19
STAT,1841,44,35-39,1885,2.0423450158632783
STAT,1781,76,na,1857,386.7866734285114
STAT,1891,37,25-29,1928,3.5406315426048813
SIM,1875,45,na,1920,2769
STAT,1847,100,na,1947,0.9598512810848833
STAT,1943,26,50-100,1969,1.0484282980040756
STAT,1922,16,30-34,1938,13.983164152875561
STAT,1838,47,30-34,1885,0.0425119368644022
STAT,1845,18,20-24,1863,11.053401137718001
STAT,1880,22,45-49,1902,0.7239274953592585
SIM,1896,44,na,1940,3237
STAT,1858,30,na,1888,1860.5816322973653
SIM,1840,32,25-29,1872,5
STAT,1844,16,na,1860,2907.85922518447
SIM,1880,60,na,1940,3193
STAT,1856,42,20-24,1898,0.11392758825923144
STAT,1858,67,na,1925,1210.5742645208982
STAT,1796,75,na,1871,742.6763438483611
STAT,1917,11,na,1928,4199.395264021745
SIM,1820,40,na,1860,724
SIM,1946,14,na,1960,3790
SIM,1860,46,na,1906,1999
SIM,1910,16,na,1926,4175
STAT,1909,37,50-100,1946,0.3933624032441897
STAT,1915,45,40-44,1960,0.15736355991188644
STAT,1803,62,na,1865,679.5340013366603
SIM,1886,27,15-19,1913,2
STAT,1812,76,na,1888,74.792698255787
STAT,1837,41,40-44,1878,2.155617842868042
STAT,1881,6,na,1887,2509.0086826530305
STAT,1878,27,15-19,1905,0.4668005837061933
STAT,1887,39,25-29,1926,3.1371600080716378
STAT,1936,21,40-44,1957,3.183722938084426
SIM,1846,47,30-34,1893,1
STAT,1906,33,30-34,1939,14.456188258785737
STAT,1895,20,30-34,1915,23.309763322328955
STAT,1865,15,na,1880,2401.3913974825637
STAT,1877,37,na,1914,2391.600363480714
STAT,1822,33,45-49,1855,4.0443244014630215
STAT,1905,22,50-100,1927,0.5865333199302215
SIM,1868,41,45-49,1909,3
SIM,1905,36,25-29,1941,19
STAT,1862,20,35-39,1882,5.161917950588464
STAT,1807,53,30-34,1860,0.01858697764853771
STAT,1879,48,30-34,1927,0.09805357270791108
SIM,1952,14,na,1966,6372
STAT,1882,35,25-29,1917,2.7827524237963503
SIM,1823,54,na,1877,1119
STAT,1919,28,25-29,1947,69.92671207212618
STAT,1914,24,25-29,1938,92.47447208929323
SIM,1928,39,30-34,1967,4
STAT,1858,6,na,1864,2225.4795698303474
STAT,1934,27,50-100,1961,1.3299242901227857
SIM,1934,29,na,1963,5191
SIM,1936,4,na,1940,4057
STAT,1924,47,40-44,1971,0.18589678410308158
STAT,1898,36,na,1934,3183.3704103280024
STAT,1900,37,50-100,1937,0.3670971592165615
SIM,1931,26,25-29,1957,49
SIM,1931,15,na,1946,5173
STAT,1918,36,50-100,1954,0.43866907965767177
SIM,1844,53,na,1897,2112
STAT,1827,37,45-49,1864,1.9657263507837828
STAT,1866,96,na,1962,19.90202062978189
STAT,1846,38,25-29,1884,1.7623500948800432
SIM,1919,37,30-34,1956,19
STAT,1864,30,na,1894,2186.848082142014
STAT,1873,33,25-29,1906,10.462316731078586
SIM,1883,74,na,1957,1568
STAT,1850,29,50-100,1879,0.3426358444276108
STAT,1885,26,45-49,1911,1.0951170428067205
STAT,1843,31,na,1874,2601.1750125747812
STAT,1859,15,na,1874,2136.9844055259678
STAT,1833,53,40-44,1886,0.004558948197736346
STAT,1863,31,40-44,1894,3.7174381711712963
SIM,1878,59,na,1937,3020
STAT,1837,103,na,1940,0.11507516749364198
STAT,1901,67,na,1968,2526.051758506811
STAT,1860,43,25-29,1903,0.5200823832553899
STAT,1838,16,na,1854,1300.7173247306378
STAT,1849,29,45-49,1878,1.0931180128495745
STAT,1825,39,50-100,1864,1.6829946069963773
STAT,1917,15,45-49,1932,0.10655485955584108
SIM,1899,58,na,1957,1469
STAT,1883,37,na,1920,2266.551804361601
STAT,1863,21,50-100,1884,0.35764152073294436
STAT,1910,41,40-44,1951,0.23509025145764606
STAT,1896,40,35-39,1936,0.16743540609873653
STAT,1851,97,na,1948,4.242957059097359
STAT,1815,44,25-29,1859,0.06595911660350623
STAT,1886,19,20-24,1905,18.260328082632437
SIM,1900,32,25-29,1932,18
STAT,1932,33,40-44,1965,5.162814690293918
SIM,1870,46,na,1916,1580
STAT,1953,16,20-24,1969,162.57960096026596
STAT,1928,42,15-19,1970,0.0019428306988746324
STAT,1950,15,40-44,1965,1.6389735229786395
STAT,1837,23,35-39,1860,6.081266467838236
SIM,1838,33,45-49,1871,3
STAT,1900,33,30-34,1933,24.084624166558292
SIM,1823,68,na,1891,681
STAT,1932,39,35-39,1971,3.220355522585474
STAT,1920,32,45-49,1952,1.7014413163003608
SIM,1914,29,40-44,1943,55
STAT,1803,71,na,1874,458.6701270283815
STAT,1839,31,45-49,1870,2.014562512
STAT,1906,29,40-44,1935,4.306787372719546
STAT,1897,24,45-49,1921,0.9202818500065764
STAT,1883,76,na,1959,1041.752712630533
STAT,1824,65,na,1889,329.2374273575093
STAT,1932,19,na,1951,4814.011999766621
SIM,1903,37,50-100,1940,1
STAT,1894,28,na,1922,3024.160006003252
STAT,1921,25,15-19,1946,0.7827338078772541
STAT,1807,85,na,1892,111.14863998425498
STAT,1890,14,na,1904,3116.2829546178646
STAT,1898,17,15-19,1915,7.980290093365989
STAT,1902,41,40-44,1943,0.2209418796842015
SIM,1885,12,na,1897,1861
SIM,1919,38,30-34,1957,1
STAT,1915,27,40-44,1942,4.687005282221958
STAT,1918,28,20-24,1946,19.096747112780488
STAT,1932,31,25-29,1963,12.208356732118123
SIM,1845,23,35-39,1868,1
STAT,1942,19,50-100,1961,0.38679797805732224
STAT,1888,31,40-44,1919,5.025735513648893
STAT,1906,21,30-34,1927,25.87133024403214
STAT,1930,23,15-19,1953,6.750548257533184
STAT,1940,30,20-24,1970,2.4989336880995388
SIM,1876,22,25-29,1898,1
STAT,1831,48,40-44,1879,0.15937722477178617
SIM,1862,20,30-34,1882,44
STAT,1854,63,na,1917,992.1047061627328
STAT,1933,18,45-49,1951,0.6624288557890733
STAT,1858,77,na,1935,660.1054226157158
STAT,1877,20,25-29,1897,58.45790961849931
STAT,1925,41,35-39,1966,0.24191063069282912
STAT,1941,17,40-44,1958,1.42432291997696
STAT,1923,33,25-29,1956,10.47779764070166
STAT,1854,20,30-34,1874,11.805707846650327
STAT,1816,46,na,1862,2547.1305771482334
SIM,1931,33,25-29,1964,19
STAT,1845,27,na,1872,1306.5821317604143
STAT,1781,104,na,1885,0.03637964074081885
SIM,1787,68,na,1855,1329
STAT,1914,35,25-29,1949,0.9786072414832481
STAT,1865,21,45-49,1886,0.6490475283998884
STAT,1922,17,30-34,1939,13.948905400701019
STAT,1919,44,15-19,1963,0.00163662768403849
STAT,1847,30,40-44,1877,4.700240319716321
STAT,1947,25,35-39,1972,16.821027546249876
STAT,1860,16,na,1876,2172.5085281247343
STAT,1896,19,na,1915,3311.4718134527434
STAT,1912,27,15-19,1939,0.6876064842684996
STAT,1931,32,20-24,1963,3.173641002140828
SIM,1936,21,na,1957,3065
STAT,1909,17,15-19,1926,8.80925008212537
STAT,1796,84,na,1880,198.34369110811704
STAT,1846,21,35-39,1867,4.29522231299426
SIM,1928,34,na,1962,4610
STAT,1929,34,30-34,1963,19.846646316880527
SIM,1924,20,na,1944,3462
STAT,1924,25,40-44,1949,5.4113476157737725
STAT,1841,45,na,1886,2582.021557607118
SIM,1854,21,35-39,1875,1
STAT,1786,74,na,1860,844.2727573992062
SIM,1907,26,45-49,1933,13
STAT,1858,20,15-19,1878,2.9325555459311534
SIM,1930,17,30-34,1947,73
STAT,1944,18,20-24,1962,144.21201753513856
SIM,1832,72,na,1904,167
STAT,1903,40,45-49,1943,0.1490180916157502
STAT,1870,26,na,1896,2387.3688896082595
STAT,1873,66,na,1939,1681.2632099458237
SIM,1907,40,na,1947,4474
SIM,1953,17,25-29,1970,7
STAT,1915,47,35-39,1962,0.12808232635363098
STAT,1835,20,20-24,1855,70.31534306691236
STAT,1914,40,20-24,1954,0.01737666635722952
STAT,1857,16,15-19,1873,5.3841680537080565
STAT,1875,57,na,1932,2063.5940616000526
STAT,1930,36,20-24,1966,0.34174007575668114
STAT,1794,93,na,1887,0.08858124059009546
SIM,1937,34,30-34,1971,6
STAT,1850,52,35-39,1902,0.003954170716517263
SIM,1808,79,na,1887,985
STAT,1860,39,20-24,1899,0.6225233650877631
STAT,1913,39,25-29,1952,0.9498222795295442
SIM,1848,24,15-19,1872,1
SIM,1925,39,50-100,1964,7
SIM,1804,65,na,1869,845
STAT,1929,29,35-39,1958,18.639728260365178
STAT,1945,17,25-29,1962,46.81560544614683
STAT,1946,26,30-34,1972,43.194705578095906
SIM,1917,17,15-19,1934,74
STAT,1900,20,25-29,1920,79.77466931286243
STAT,1902,36,45-49,1938,0.6088146928641772
STAT,1887,58,na,1945,2176.6885258923935
STAT,1883,44,na,1927,2193.4992415651477
STAT,1872,49,40-44,1921,0.1678533769418016
SIM,1856,31,na,1887,765
STAT,1873,20,40-44,1893,2.1502823592739007
STAT,1855,49,40-44,1904,0.11094065261956397
STAT,1891,63,na,1954,2194.2102296496405
SIM,1823,36,na,1859,1642
STAT,1879,39,na,1918,2392.5306772362514
STAT,1895,77,na,1972,1613.3884297688146
STAT,1933,23,40-44,1956,4.428267291735885
STAT,1931,23,50-100,1954,0.8447896749946333
STAT,1800,104,na,1904,0.04602138067232247
STAT,1916,23,40-44,1939,3.4644958701912643
STAT,1938,32,30-34,1970,15.672221647538214
STAT,1920,29,15-19,1949,0.7589911550865079
STAT,1903,29,15-19,1932,0.6394327985937259
SIM,1935,26,20-24,1961,47
STAT,1919,27,25-29,1946,70.17372357912467
STAT,1859,24,25-29,1883,46.401877539679774
STAT,1910,30,35-39,1940,8.782790670079793
STAT,1914,18,35-39,1932,0.8536904208916052
STAT,1832,52,na,1884,1890.5450044745207
SIM,1930,21,15-19,1951,28
STAT,1865,47,na,1912,2044.5082843202213
SIM,1862,59,na,1921,3270
SIM,1919,41,na,1960,4891
STAT,1922,34,20-24,1956,2.711892890566304
STAT,1887,22,35-39,1909,6.422956455642322
STAT,1903,38,na,1941,3354.006483769645
SIM,1843,20,20-24,1863,2
STAT,1910,38,45-49,1948,0.6415004593100283
SIM,1929,32,30-34,1961,1
SIM,1959,5,na,1964,5267
SIM,1890,66,na,1956,3078
STAT,1904,46,20-24,1950,0.009698299535210581
STAT,1918,48,15-19,1966,3.856414081085474E-4
SIM,1836,30,30-34,1866,1
STAT,1858,33,20-24,1891,2.055518412633713
STAT,1875,25,na,1900,2467.2324172542976
SIM,1848,12,na,1860,2793
STAT,1927,26,20-24,1953,22.08630019933741
STAT,1925,24,45-49,1949,1.3261460024251839
STAT,1870,45,15-19,1915,4.027485120630577E-4
SIM,1828,31,35-39,1859,4
STAT,1782,92,na,1874,34.34481803894617
STAT,1890,20,50-100,1910,0.49661957317724675
STAT,1932,19,40-44,1951,1.8293595793082453
STAT,1907,45,35-39,1952,0.11637606696693402
SIM,1879,34,45-49,1913,1
SIM,1904,0,na,1904,4312
SIM,1943,23,na,1966,4371
STAT,1906,7,na,1913,3772.7417395667326
SIM,1926,28,20-24,1954,3
STAT,1896,20,35-39,1916,7.738394711538017
STAT,1860,54,45-49,1914,0.011513545905851269
STAT,1837,83,na,1920,318.3175164584149
SIM,1900,31,30-34,1931,450
STAT,1880,52,20-24,1932,7.619960892631056E-4
STAT,1779,110,na,1889,0.0031866295196072993
STAT,1825,82,na,1907,287.3273627193972
STAT,1868,22,25-29,1890,55.29186801155514
STAT,1907,25,40-44,1932,4.40047095477086
STAT,1829,96,na,1925,3.1355852103421293
STAT,1915,39,na,1954,3709.1909062389864
SIM,1911,29,15-19,1940,5
STAT,1864,30,40-44,1894,3.9742263079355054
STAT,1911,25,na,1936,3636.6540351970543
STAT,1828,107,na,1935,0.003192371594083963
SIM,1824,85,na,1909,857
SIM,1902,19,20-24,1921,8
STAT,1852,29,na,1881,2509.7429283000083
STAT,1908,24,45-49,1932,1.019977905684954
STAT,1895,21,30-34,1916,23.241465715794526
SIM,1791,73,na,1864,338
SIM,1939,18,na,1957,4716
SIM,1921,23,15-19,1944,1
STAT,1834,49,20-24,1883,0.005466773592178741
STAT,1867,23,20-24,1890,64.97123381182416
STAT,1828,30,30-34,1858,28.193708887506332
STAT,1933,35,35-39,1968,3.2778122117581154
SIM,1925,3,na,1928,5488
STAT,1927,38,15-19,1965,0.023657134763765252
STAT,1817,49,20-24,1866,0.008186847484405908
STAT,1913,19,30-34,1932,2.4476377287893194
STAT,1878,0,na,1878,3745.3066289685903
STAT,1889,22,45-49,1911,0.8397320815704167
SIM,1799,69,na,1868,771
STAT,1898,10,na,1908,3483.254880148743
STAT,1820,51,na,1871,1674.2000252421715
SIM,1882,47,na,1929,1699
STAT,1911,57,na,1968,3287.819148981835
STAT,1938,27,35-39,1965,14.714741894315937
STAT,1924,45,35-39,1969,0.15273388337486885
SIM,1815,49,na,1864,1989
SIM,1902,42,45-49,1944,1
STAT,1914,23,30-34,1937,28.86572751075633
STAT,1824,33,na,1857,570.9210268607634
SIM,1845,20,30-34,1865,10
SIM,1869,81,na,1950,3268
SIM,1908,5,na,1913,2941
STAT,1937,28,30-34,1965,37.78188042355814
SIM,1874,28,na,1902,2546
SIM,1909,28,20-24,1937,5
STAT,1923,46,30-34,1969,0.10344441763624583
STAT,1849,22,15-19,1871,3.360778101968036
STAT,1923,5,na,1928,4671.677586169989
STAT,1828,47,na,1875,1687.5304594338893
STAT,1904,33,15-19,1937,0.11633216603218806
STAT,1806,68,na,1874,649.126494089457
STAT,1802,54,na,1856,1594.2845394092242
SIM,1812,52,na,1864,1467
STAT,1836,34,na,1870,2053.4009075097038
STAT,1852,15,25-29,1867,6.980837009521599
STAT,1925,17,na,1942,4405.66088518488
STAT,1938,24,30-34,1962,28.121531175460277
STAT,1928,38,30-34,1966,2.283528053692257
STAT,1887,26,na,1913,2635.796568586
STAT,1877,16,40-44,1893,0.1861246215139185
STAT,1787,91,na,1878,8.694300796853566
STAT,1891,31,50-100,1922,1.1313380433656208
STAT,1891,31,na,1922,2946.5075894579195
STAT,1950,18,45-49,1968,0.5848501392595569
STAT,1832,39,45-49,1871,0.1618795454726325
STAT,1895,45,na,1940,2956.4840328704217
SIM,1923,39,35-39,1962,25
STAT,1808,109,na,1917,1.6662653353954735E-4
STAT,1915,39,35-39,1954,2.38466769492567
SIM,1844,30,na,1874,2932
STAT,1935,21,50-100,1956,0.8898721694698062
SIM,1848,44,na,1892,2299
STAT,1915,31,25-29,1946,9.318211780821464
SIM,1878,42,na,1920,3989
STAT,1956,15,35-39,1971,5.506898840519347
STAT,1814,48,40-44,1862,0.5774213363444095
STAT,1899,34,20-24,1933,3.6604099314349634
STAT,1901,24,35-39,1925,8.108178492944912
STAT,1912,15,20-24,1927,27.222346856041764
SIM,1921,44,20-24,1965,1
STAT,1795,67,na,1862,902.4294754111338
STAT,1816,50,50-100,1866,0.04599038915840612
STAT,1854,23,35-39,1877,3.7849538090405095
STAT,1803,102,na,1905,0.07395384661480695
STAT,1923,30,20-24,1953,2.7890827891591465
STAT,1831,67,na,1898,1240.6708034472756
STAT,1914,0,na,1914,4580.399722602262
SIM,1932,39,na,1971,6220
STAT,1901,15,45-49,1916,0.0917592738470305
SIM,1948,22,na,1970,4109
STAT,1847,33,45-49,1880,1.832029440989417
STAT,1922,29,25-29,1951,73.12239529189894
STAT,1930,19,30-34,1949,15.563652471999745
STAT,1913,23,15-19,1936,5.291521123945364
STAT,1944,20,na,1964,3901.2029086288303
STAT,1868,12,na,1880,2579.6821891118684
STAT,1930,28,20-24,1958,23.036634808422757
STAT,1906,46,30-34,1952,0.07929391336073348
STAT,1852,49,15-19,1901,3.942281242144199E-4
STAT,1903,37,15-19,1940,0.01720514141578133
STAT,1910,43,40-44,1953,0.2323407252108929
SIM,1817,83,na,1900,20
SIM,1855,33,45-49,1888,2
STAT,1861,65,na,1926,1405.445422884192
SIM,1899,15,30-34,1914,20
STAT,1865,79,na,1944,638.2768500683932
SIM,1852,17,na,1869,2522
STAT,1902,44,45-49,1946,0.14437433433764077
STAT,1848,26,15-19,1874,0.5105138233386218
STAT,1893,6,na,1899,3266.8254743837315
STAT,1928,17,25-29,1945,54.18837667609701
SIM,1865,24,na,1889,1858
STAT,1908,49,45-49,1957,0.19389101860968186
STAT,1874,51,na,1925,2232.8447097679414
STAT,1907,20,na,1927,3471.4246495885086
STAT,1844,85,na,1929,271.58193560287714
STAT,1888,34,45-49,1922,1.995424717781467
SIM,1844,49,30-34,1893,2
STAT,1848,99,na,1947,1.772232571277149
STAT,1840,71,na,1911,525.5838741087221
SIM,1906,27,40-44,1933,8
STAT,1905,25,30-34,1930,36.46536951140085
STAT,1907,33,40-44,1940,3.618026713932736
SIM,1866,33,20-24,1899,2
SIM,1866,8,na,1874,3337
STAT,1816,78,na,1894,659.621742371553
STAT,1913,44,20-24,1957,0.01694946315080169
STAT,1923,16,35-39,1939,4.887414133016494
SIM,1873,11,na,1884,2483
SIM,1899,24,20-24,1923,15
STAT,1881,39,40-44,1920,4.092279285347295
STAT,1931,40,20-24,1971,0.023492118782203832
STAT,1889,81,na,1970,1092.6587128990845
STAT,1900,41,na,1941,3227.32116035126
STAT,1922,21,15-19,1943,6.054601945060265
STAT,1847,61,na,1908,1689.4651053740995
STAT,1871,49,25-29,1920,0.05625882261568812
STAT,1925,46,40-44,1971,0.1897719092368444
SIM,1849,61,na,1910,1530
SIM,1829,43,45-49,1872,4
STAT,1924,28,45-49,1952,1.9851829923476572
SIM,1878,30,35-39,1908,110
SIM,1913,25,30-34,1938,86
STAT,1874,16,15-19,1890,6.139893855545455
STAT,1936,33,na,1969,3634.8437913084863
STAT,1935,16,50-100,1951,0.5097407203282811
SIM,1920,38,na,1958,3734
STAT,1897,21,40-44,1918,2.7757614110107336
STAT,1908,41,35-39,1949,0.18592678033188453
SIM,1882,16,15-19,1898,7
SIM,1916,49,45-49,1965,4
STAT,1941,21,25-29,1962,94.40249606044509
SIM,1907,23,40-44,1930,11
SIM,1852,49,na,1901,1881
SIM,1871,63,na,1934,1578
STAT,1846,44,na,1890,1350.3798590486883
STAT,1904,16,25-29,1920,8.115915886801949
STAT,1842,30,na,1872,663.5660223440208
SIM,1875,77,na,1952,2443
STAT,1936,36,15-19,1972,0.018682232183780692
SIM,1878,10,na,1888,4386
STAT,1869,17,45-49,1886,0.06682852603245094
STAT,1916,18,45-49,1934,0.10426541981135994
STAT,1838,40,40-44,1878,1.1520422794726468
STAT,1904,55,na,1959,3032.6504833780637
STAT,1941,29,35-39,1970,15.339308535748527
SIM,1834,20,na,1854,1322
STAT,1919,49,20-24,1968,0.011757950512423275
STAT,1852,26,50-100,1878,0.7554084077020243
STAT,1841,30,50-100,1871,1.2639046401340108
STAT,1924,42,30-34,1966,0.15060736056787288
STAT,1931,15,30-34,1946,15.915415076288918
STAT,1940,25,25-29,1965,66.42345136302568
STAT,1916,26,45-49,1942,1.7679715725845924
STAT,1839,23,45-49,1862,0.8264437006628451
SIM,1863,33,na,1896,950
STAT,1852,52,45-49,1904,0.014530254787201694
STAT,1873,23,45-49,1896,0.7130879889213245
STAT,1920,24,45-49,1944,1.2270627328256907
SIM,1896,39,na,1935,3380
SIM,1892,25,na,1917,3414
STAT,1920,18,na,1938,4065.8106252474477
STAT,1882,27,na,1909,2284.8818341728415
SIM,1887,41,40-44,1928,2
STAT,1899,3,na,1902,3610.863578542757
STAT,1900,28,35-39,1928,13.31946977175619
STAT,1892,80,na,1972,1250.7447392700706
STAT,1879,41,40-44,1920,2.31783719963452
STAT,1912,48,20-24,1960,0.010468079471994953
SIM,1914,37,40-44,1951,1
STAT,1876,21,20-24,1897,69.87451589646587
STAT,1901,32,35-39,1933,14.159817500703634
STAT,1956,6,na,1962,5156.423752223184
STAT,1853,37,50-100,1890,0.9519778628376292
STAT,1807,53,na,1860,1306.4932653875858
STAT,1913,27,30-34,1940,38.55203055366295
STAT,1887,5,na,1892,2884.4665529537388
SIM,1859,26,40-44,1885,99
STAT,1857,105,na,1962,0.08333378390413637
SIM,1883,64,na,1947,1967
STAT,1906,37,40-44,1943,1.3682037686697803
STAT,1880,7,na,1887,2753.662118684765
STAT,1884,23,20-24,1907,65.76418703847567
STAT,1849,30,15-19,1879,0.14186205259227488
SIM,1921,27,30-34,1948,162
STAT,1862,21,50-100,1883,0.35813109570463525
STAT,1889,30,45-49,1919,2.116834037347921
STAT,1901,1,na,1902,3805.755053143884
SIM,1887,78,na,1965,1759
STAT,1858,16,30-34,1874,1.4302535480885443
STAT,1917,19,15-19,1936,47.7700539706929
STAT,1905,17,30-34,1922,2.29249515529275
SIM,1848,16,15-19,1864,71
STAT,1866,51,50-100,1917,0.013852033507478835
STAT,1836,98,na,1934,2.486228705314469
SIM,1857,48,na,1905,1397
STAT,1928,34,15-19,1962,0.15925376294980165
SIM,1892,23,20-24,1915,621
STAT,1911,43,50-100,1954,0.11019945667084217
STAT,1832,84,na,1916,282.3892708709184
SIM,1895,4,na,1899,4648
STAT,1936,32,50-100,1968,0.795105102406605
STAT,1923,49,35-39,1972,0.1483639139910938
SIM,1906,55,na,1961,3086
SIM,1902,41,na,1943,3333
STAT,1943,17,15-19,1960,47.57630008087378
SIM,1928,36,30-34,1964,11
STAT,1830,48,25-29,1878,0.04859818870187041
STAT,1821,38,30-34,1859,6.40300494560342
STAT,1912,42,na,1954,3540.3560158647447
STAT,1916,43,35-39,1959,0.20321927491389208
STAT,1935,3,na,1938,5504.990946575608
STAT,1878,20,40-44,1898,2.1567589257470385
STAT,1899,17,30-34,1916,2.1770141433337
SIM,1937,1,na,1938,3036
STAT,1908,16,45-49,1924,0.09638581532231395
STAT,1811,48,15-19,1859,0.001850144346304354
STAT,1889,27,15-19,1916,0.5463599479689089
SIM,1832,29,na,1861,2299
STAT,1877,80,na,1957,702.1087052102233
STAT,1942,16,45-49,1958,0.5162208926141558
STAT,1916,56,na,1972,3578.2368631599493
SIM,1882,5,na,1887,2492
STAT,1873,17,50-100,1890,0.05025487090851958
STAT,1890,20,40-44,1910,2.537725834306548
STAT,1862,50,na,1912,1860.2957624279677
SIM,1898,30,na,1928,4204
STAT,1904,38,20-24,1942,0.23652877060417118
STAT,1853,46,na,1899,1749.454071340781
STAT,1866,64,na,1930,1586.8060923800142
STAT,1862,39,30-34,1901,4.49373279682437
SIM,1897,27,15-19,1924,1
STAT,1856,11,na,1867,2036.6984932719413
STAT,1868,30,25-29,1898,9.972554634345107
STAT,1925,21,40-44,1946,3.999932084797354
STAT,1919,21,na,1940,3957.580845556996
STAT,1843,22,20-24,1865,85.46516172176857
STAT,1861,33,na,1894,1976.183940887934
SIM,1851,22,20-24,1873,12
STAT,1895,24,35-39,1919,7.543693092618228
STAT,1934,31,35-39,1965,12.399698679289038
STAT,1867,26,25-29,1893,40.14301453026335
SIM,1840,16,na,1856,2818
STAT,1806,49,45-49,1855,0.6728833709757603
STAT,1924,17,40-44,1941,1.6496361529840655
SIM,1927,24,20-24,1951,2
STAT,1837,41,50-100,1878,1.0124620991928033
STAT,1923,41,25-29,1964,0.08270389073534734
STAT,1924,43,na,1967,4368.241789955223
STAT,1890,78,na,1968,1348.6084157862488
STAT,1932,27,40-44,1959,6.062526460027337
SIM,1861,2,na,1863,2919
STAT,1927,34,20-24,1961,2.972181655976156
STAT,1824,97,na,1921,1.0396563021102498
STAT,1879,20,35-39,1899,6.021985444594229
STAT,1922,37,25-29,1959,1.1078591566924694
SIM,1944,19,25-29,1963,107
STAT,1910,35,40-44,1945,1.429139447667964
STAT,1932,34,50-100,1966,1.090049725337175
STAT,1820,83,na,1903,273.01275786912225
STAT,1936,19,25-29,1955,40.85685977988889
SIM,1903,26,na,1929,2295
SIM,1829,84,na,1913,1137
STAT,1914,27,25-29,1941,65.43070271912758
SIM,1858,31,20-24,1889,5
STAT,1905,42,20-24,1947,0.01584270531235805
SIM,1922,27,25-29,1949,43
STAT,1828,33,35-39,1861,14.83803657008501
SIM,1790,88,na,1878,101
SIM,1828,67,na,1895,830
STAT,1919,24,20-24,1943,119.39071831684673
SIM,1914,42,na,1956,4867
SIM,1824,53,na,1877,2003
SIM,1868,0,na,1868,2801
STAT,1840,38,40-44,1878,2.0176107860003274
STAT,1866,2,na,1868,3083.4748975621505
STAT,1896,40,50-100,1936,0.09768395443667648
STAT,1919,16,20-24,1935,29.732305148546757
STAT,1860,48,na,1908,1812.3405890449774
SIM,1849,29,na,1878,2472
SIM,1938,2,na,1940,4282
STAT,1914,26,35-39,1940,14.975921255207773
STAT,1882,52,50-100,1934,0.014382551834005525
STAT,1940,17,25-29,1957,43.50625548112709
STAT,1851,52,50-100,1903,0.011864540321078886
STAT,1926,42,40-44,1968,0.30570835081272146
STAT,1894,60,na,1954,2425.281313454669
SIM,1906,39,35-39,1945,4
STAT,1871,46,50-100,1917,0.24569230601968525
STAT,1874,53,35-39,1927,0.008742461525650428
STAT,1834,22,50-100,1856,0.24035819395023436
SIM,1826,33,na,1859,1901
SIM,1955,0,na,1955,3839
STAT,1898,74,na,1972,1950.9779409950436
SIM,1834,52,na,1886,727
STAT,1870,49,30-34,1919,0.09448821560106868
SIM,1809,64,na,1873,179
SIM,1805,50,na,1855,2285
SIM,1834,39,20-24,1873,4
STAT,1829,32,na,1861,1040.167930537738
SIM,1946,6,na,1952,3823
STAT,1827,30,na,1857,2112.523992756523
STAT,1830,28,30-34,1858,24.040106606896973
SIM,1845,15,na,1860,2866
SIM,1877,25,na,1902,43
STAT,1906,43,50-100,1949,0.10546627461263045
SIM,1942,17,na,1959,3646
STAT,1887,30,35-39,1917,11.236187913439714
STAT,1905,61,na,1966,2920.286478053052
STAT,1854,54,20-24,1908,3.9901334868993346E-4
STAT,1888,16,50-100,1904,0.05668352273239788
STAT,1914,30,50-100,1944,0.8272744563985878
STAT,1826,35,50-100,1861,2.1139567930723744
STAT,1851,109,na,1960,0.0015297279379152217
STAT,1920,37,15-19,1957,0.02075507985240222
STAT,1855,40,40-44,1895,1.5036738303745791
STAT,1876,24,25-29,1900,57.507772038401754
SIM,1930,25,30-34,1955,10
SIM,1831,38,40-44,1869,2
STAT,1926,34,na,1960,4528.107137201481
STAT,1901,41,25-29,1942,0.06263231279271098
STAT,1901,21,30-34,1922,24.98059639326031
STAT,1913,47,25-29,1960,0.05112509755758674
STAT,1902,28,45-49,1930,1.557981454308766
SIM,1889,3,na,1892,3895
STAT,1842,41,50-100,1883,0.27483333219198813
SIM,1834,63,na,1897,44
SIM,1879,27,na,1906,760
STAT,1825,109,na,1934,4.3812592227781877E-4
STAT,1936,28,15-19,1964,0.6685833663644403
STAT,1823,38,40-44,1861,8.016379972130505
STAT,1856,43,na,1899,1648.0642990844703
STAT,1859,15,35-39,1874,0.5108309111692007
STAT,1924,21,25-29,1945,108.27348903098915
SIM,1875,26,25-29,1901,9
SIM,1884,24,25-29,1908,981
STAT,1881,10,na,1891,2446.168573613068
STAT,1815,39,45-49,1854,0.21817294553409367
SIM,1794,70,na,1864,657
STAT,1851,53,40-44,1904,0.008181158615867603
STAT,1929,43,20-24,1972,0.022674601131472034
STAT,1921,16,25-29,1937,48.9306476408537
SIM,1932,21,25-29,1953,416
STAT,1851,98,na,1949,2.565673704065581
SIM,1870,14,na,1884,2671
STAT,1907,41,40-44,1948,0.22893386072439004
STAT,1919,48,30-34,1967,0.0951414510403513
STAT,1785,89,na,1874,16.51620376687761
STAT,1922,25,30-34,1947,44.14032441709699
STAT,1848,24,na,1872,2401.3275760526476
STAT,1907,17,50-100,1924,0.07148389654423178
SIM,1917,39,na,1956,2036
STAT,1900,24,40-44,1924,2.8685989523362556
STAT,1940,16,35-39,1956,4.213889283725416
SIM,1913,25,na,1938,2556
STAT,1781,75,na,1856,425.24123863860007
STAT,1859,62,na,1921,1448.6462083884835
SIM,1839,62,na,1901,334
STAT,1834,49,50-100,1883,0.11188662842337385
STAT,1830,29,na,1859,2048.1733083643558
STAT,1929,30,15-19,1959,0.16226865086525938
STAT,1909,54,na,1963,3254.2646527361503
STAT,1939,28,40-44,1967,4.632032049179075
SIM,1847,81,na,1928,1382
STAT,1907,36,45-49,1943,0.6308369345926956
STAT,1905,40,na,1945,3369.443529554692
STAT,1841,29,45-49,1870,1.5136889220496834
STAT,1929,38,25-29,1967,1.2539452201120567
STAT,1822,51,20-24,1873,0.0012129483539555623
STAT,1921,46,20-24,1967,0.012341010997053283
STAT,1819,49,30-34,1868,0.017217255376645337
STAT,1854,49,25-29,1903,0.03135792667859397
SIM,1898,19,na,1917,4214
STAT,1865,26,15-19,1891,0.4156478822350193
STAT,1876,36,50-100,1912,1.247108671671543
STAT,1910,46,45-49,1956,0.20100709067090983
STAT,1912,22,45-49,1934,1.0657927968707464
SIM,1895,30,35-39,1925,2
SIM,1892,14,na,1906,3700
STAT,1905,29,25-29,1934,60.4081460453656
STAT,1926,37,50-100,1963,0.5087187385459818
STAT,1899,37,25-29,1936,0.8488174313989
STAT,1876,31,na,1907,2422.199360530546
STAT,1852,29,20-24,1881,12.337163297774312
SIM,1809,53,na,1862,612
STAT,1811,51,45-49,1862,0.06660736764682904
STAT,1938,16,30-34,1954,11.924011201278686
STAT,1940,22,20-24,1962,112.00249894979417
SIM,1923,35,na,1958,4239
STAT,1917,27,15-19,1944,0.7304619391568897
STAT,1906,30,20-24,1936,2.2656125163709175
STAT,1884,61,na,1945,1788.7932536890926
STAT,1864,39,40-44,1903,3.9395616819182444
SIM,1913,29,25-29,1942,1
STAT,1918,36,20-24,1954,0.2754221665963664
STAT,1905,21,15-19,1926,4.759379745002487
STAT,1888,75,na,1963,1443.8057320658138
STAT,1903,24,50-100,1927,0.5752392752932197
SIM,1873,43,na,1916,2017
SIM,1952,16,na,1968,6372
STAT,1902,33,40-44,1935,6.081021903122498
SIM,1853,39,30-34,1892,35
STAT,1838,52,50-100,1890,0.006412750487539267
STAT,1856,19,50-100,1875,0.04111950995865037
STAT,1835,23,25-29,1858,57.16179849628529
STAT,1926,38,20-24,1964,0.3190808518494282
STAT,1846,33,na,1879,1501.2008694890487
STAT,1866,32,na,1898,2178.2693870109783
STAT,1884,23,50-100,1907,0.3891602698882536
STAT,1836,40,30-34,1876,1.0752195980009225
STAT,1873,54,30-34,1927,0.005938092897796998
STAT,1845,59,na,1904,964.3799716287326
STAT,1876,42,na,1918,2333.5742850981555
STAT,1830,101,na,1931,0.41300156464205673
STAT,1858,13,na,1871,2119.8940175591715
STAT,1901,16,35-39,1917,0.7690977469878723
SIM,1897,56,na,1953,1894
SIM,1893,42,na,1935,3177
STAT,1856,20,40-44,1876,1.7635138064435538
SIM,1881,62,na,1943,1473
STAT,1898,25,15-19,1923,0.61424055332472
STAT,1921,17,15-19,1938,51.117674174440836
SIM,1927,17,na,1944,353
STAT,1889,27,50-100,1916,0.7703335764609314
STAT,1929,37,35-39,1966,3.0835063819951696
STAT,1946,18,30-34,1964,13.36875732487678
STAT,1915,35,40-44,1950,1.505059523894477
SIM,1913,36,na,1949,3076
STAT,1893,16,25-29,1909,7.103805887695993
STAT,1935,36,20-24,1971,0.36629095902744424
SIM,1876,30,25-29,1906,24
STAT,1925,30,30-34,1955,18.55895521145825
STAT,1841,51,30-34,1892,0.006660266020138856
SIM,1908,57,na,1965,1915
STAT,1875,39,50-100,1914,1.2480218982476394
SIM,1910,33,40-44,1943,11
STAT,1920,40,45-49,1960,0.18195116002632103
STAT,1941,28,45-49,1969,1.765996363890592
STAT,1895,13,na,1908,3354.3077972536007
STAT,1922,39,50-100,1961,0.4714058690528675
SIM,1904,43,na,1947,4027
STAT,1936,27,25-29,1963,62.365990429864276
STAT,1911,31,40-44,1942,3.7831298777507794
STAT,1941,23,na,1964,3729.7119409239954
STAT,1843,25,25-29,1868,52.183735892532695
STAT,1847,50,na,1897,1974.6905387072545
STAT,1881,8,na,1889,2469.672286207948
STAT,1949,17,45-49,1966,0.5752529887409107
STAT,1839,20,40-44,1859,2.5236347362684373
STAT,1802,86,na,1888,106.19945987350405
STAT,1880,79,na,1959,873.976051689042
SIM,1845,47,na,1892,2172
STAT,1926,23,na,1949,4384.8722045345685
SIM,1841,33,na,1874,977
SIM,1897,45,na,1942,2310
STAT,1836,49,30-34,1885,0.07566267890294363
SIM,1893,31,na,1924,3409
STAT,1888,42,45-49,1930,1.7252410962016929
STAT,1937,32,15-19,1969,0.12582205519898612
STAT,1950,19,35-39,1969,4.911022620266431
STAT,1827,62,na,1889,1306.0787705495418
SIM,1910,16,15-19,1926,62
STAT,1905,46,50-100,1951,0.19982902309816938
STAT,1902,20,35-39,1922,8.266321163911599
STAT,1882,52,30-34,1934,0.0056686930827696096
STAT,1949,19,na,1968,4235.786717304158
STAT,1949,22,40-44,1971,3.884761582363994
STAT,1863,52,20-24,1915,6.266171947332108E-4
SIM,1870,7,na,1877,2710
STAT,1822,85,na,1907,158.0797038601841
STAT,1808,70,na,1878,430.4689572589861
STAT,1826,99,na,1925,1.5098591393165837
SIM,1810,100,na,1910,76
SIM,1913,57,na,1970,2906
SIM,1928,28,30-34,1956,1127
STAT,1862,30,30-34,1892,14.990694059902651
STAT,1921,20,45-49,1941,1.2632910536184943
SIM,1880,13,na,1893,3337
STAT,1894,20,25-29,1914,73.23121833710348
STAT,1826,39,20-24,1865,1.1981614938456493
STAT,1919,6,na,1925,4370.418940003703
STAT,1931,19,25-29,1950,56.02078676198748
STAT,1939,32,25-29,1971,9.32677858944679
STAT,1822,42,50-100,1864,1.8835283474975926
STAT,1919,34,50-100,1953,0.8726323767852453
STAT,1847,41,45-49,1888,1.37822937084244
STAT,1884,26,25-29,1910,40.63294724404686
STAT,1910,32,50-100,1942,0.7882859856337264
SIM,1862,70,na,1932,2633
SIM,1862,3,na,1865,4009
STAT,1867,17,35-39,1884,0.5305028907293194
STAT,1813,49,na,1862,2200.500049543654
STAT,1944,26,20-24,1970,19.51570147636726
STAT,1914,54,na,1968,3499.08915263142
STAT,1927,37,25-29,1964,1.2141920038143437
SIM,1923,35,40-44,1958,4
STAT,1912,19,15-19,1931,9.021779948055459
STAT,1901,40,35-39,1941,0.17759493496556758
STAT,1932,23,25-29,1955,119.98172435081655
STAT,1802,53,45-49,1855,0.07219322487221926
STAT,1902,16,15-19,1918,8.377324010766955
STAT,1910,40,na,1950,3510.0331065331757
STAT,1863,32,50-100,1895,0.7822100943496625
STAT,1845,39,30-34,1884,2.7215744165391564
STAT,1929,18,30-34,1947,15.405946789550768
SIM,1919,49,35-39,1968,1
SIM,1866,84,na,1950,637
SIM,1834,25,25-29,1859,25
STAT,1898,42,na,1940,3114.8568010051495
SIM,1827,82,na,1909,332
SIM,1938,22,30-34,1960,38
SIM,1858,65,na,1923,2126
STAT,1879,82,na,1961,671.6614198721448
SIM,1854,51,na,1905,1118
STAT,1862,48,20-24,1910,0.010092466809287439
STAT,1846,29,50-100,1875,0.45177468038633783
STAT,1899,59,na,1958,2721.075186600482
STAT,1920,21,40-44,1941,3.7010763416040273
STAT,1879,37,50-100,1916,1.2594674444605523
STAT,1901,48,45-49,1949,0.18379671549935264
STAT,1859,43,50-100,1902,0.8312872389808632
SIM,1912,37,30-34,1949,2
STAT,1923,17,25-29,1940,50.35052669743843
STAT,1880,25,50-100,1905,0.6686049703778393
SIM,1789,70,na,1859,303
STAT,1821,47,20-24,1868,0.012834074924744265
STAT,1905,26,20-24,1931,16.931493028607118
SIM,1867,58,na,1925,1697
SIM,1863,44,na,1907,703
STAT,1768,101,na,1869,0.3537434758611896
SIM,1867,43,50-100,1910,3
STAT,1882,27,40-44,1909,2.8679836113893673
STAT,1872,28,na,1900,2381.3559576219245
STAT,1837,20,30-34,1857,18.968172104358956
STAT,1934,27,15-19,1961,0.9432502855351326
STAT,1919,19,25-29,1938,46.99952499776748
STAT,1873,98,na,1971,22.57869003525987
SIM,1801,68,na,1869,1783
STAT,1905,45,25-29,1950,0.047198660856948835
SIM,1892,46,na,1938,3563
STAT,1900,36,35-39,1936,2.1249941832640182
STAT,1856,16,20-24,1872,15.145836702206287
STAT,1906,33,25-29,1939,8.480607849683386
STAT,1948,18,40-44,1966,1.58382687691781
STAT,1911,27,20-24,1938,17.600971307246084
SIM,1935,18,20-24,1953,463
STAT,1951,20,30-34,1971,34.04217867234458
SIM,1952,7,na,1959,6372
STAT,1849,84,na,1933,280.29930418107443
STAT,1845,16,45-49,1861,0.04121137602362688
STAT,1861,42,45-49,1903,1.2431378702794487
STAT,1950,16,na,1966,4311.927401582803
STAT,1879,16,15-19,1895,6.102850622079681
STAT,1845,70,na,1915,696.229288763775
STAT,1922,28,35-39,1950,16.74010800826793
STAT,1825,38,50-100,1863,1.724051249861467
STAT,1843,39,20-24,1882,0.792486752794864
STAT,1881,30,40-44,1911,4.1282876899461725
STAT,1910,22,35-39,1932,8.74349975388753
STAT,1904,21,50-100,1925,0.5843674452732147
SIM,1886,61,na,1947,2614
SIM,1865,24,15-19,1889,1
STAT,1853,15,40-44,1868,0.17262896984647497
SIM,1931,17,25-29,1948,58
STAT,1947,22,30-34,1969,32.14077088859775
STAT,1924,15,50-100,1939,0.44391969646071355
STAT,1857,24,15-19,1881,2.621441525309782
SIM,1893,10,na,1903,3562
STAT,1957,7,na,1964,5136.916398770864
STAT,1897,27,50-100,1924,0.8495447174442999
STAT,1902,21,na,1923,3340.4225325022203
SIM,1897,24,na,1921,2910
SIM,1892,57,na,1949,3403
SIM,1918,34,20-24,1952,10
STAT,1872,43,50-100,1915,1.05024628394407
STAT,1903,32,45-49,1935,2.4753751580415813
STAT,1915,40,15-19,1955,0.0015284768692591121
STAT,1906,35,na,1941,3471.1996032833636
SIM,1923,38,45-49,1961,3
STAT,1871,54,20-24,1925,7.158643310612268E-4
STAT,1873,49,35-39,1922,0.1406106980990443
STAT,1876,20,30-34,1896,18.114017599717414
STAT,1897,17,20-24,1914,23.5444105190417
STAT,1919,53,na,1972,3848.1805995503287
STAT,1931,35,25-29,1966,1.2970629437573367
STAT,1865,52,30-34,1917,0.0054056932244652325
STAT,1921,49,25-29,1970,0.05874359226572545
SIM,1835,26,na,1861,1173
STAT,1885,20,50-100,1905,0.4032289449152328
STAT,1900,27,45-49,1927,1.5380867305643724
STAT,1806,100,na,1906,0.319680865335281
STAT,1912,35,15-19,1947,0.018700972141263383
STAT,1928,39,20-24,1967,0.3299104817055922
STAT,1832,100,na,1932,0.9012033054668749
SIM,1838,66,na,1904,1075
STAT,1889,60,na,1949,2296.6734710126652
STAT,1843,28,50-100,1871,0.7722589451329702
STAT,1820,41,45-49,1861,2.5160172099113427
SIM,1933,24,na,1957,4329
STAT,1827,108,na,1935,0.0012917160152798274
STAT,1848,21,45-49,1869,0.8002750946488151
STAT,1832,48,35-39,1880,0.012531744300199541
STAT,1902,49,15-19,1951,3.110937230431488E-4
STAT,1908,37,15-19,1945,0.017840391750673753
STAT,1836,66,na,1902,1254.3950766779722
STAT,1901,58,na,1959,2851.889262801268
STAT,1916,27,35-39,1943,15.311754931042039
STAT,1838,25,na,1863,1190.5444390923792
STAT,1838,49,40-44,1887,0.07328433901115432
STAT,1851,15,50-100,1866,0.047603232872313744
STAT,1847,26,50-100,1873,0.7001825867489647
SIM,1854,29,na,1883,1984
SIM,1850,15,na,1865,2299
SIM,1846,49,40-44,1895,1
STAT,1915,19,40-44,1934,0.2870605079441219
STAT,1916,28,50-100,1944,1.0115460386756703
STAT,1925,38,na,1963,4469.638420098781
STAT,1926,45,45-49,1971,0.2671223818135229
SIM,1859,22,25-29,1881,425
STAT,1921,41,15-19,1962,0.0017116335583060097
STAT,1936,31,45-49,1967,1.5141427618848347
STAT,1817,52,na,1869,850.5709114549105
SIM,1840,30,45-49,1870,1
STAT,1842,51,na,1893,537.0694086019912
STAT,1930,27,30-34,1957,49.472550185362984
STAT,1927,18,20-24,1945,166.76066292570684
STAT,1921,24,na,1945,4050.2344344082544
SIM,1867,47,na,1914,2091
STAT,1855,80,na,1935,409.4095864257411
STAT,1906,24,35-39,1930,8.397292048845232
STAT,1941,25,40-44,1966,4.771042246699524
STAT,1859,94,na,1953,15.84081766494238
STAT,1811,90,na,1901,47.76404889991968
STAT,1817,63,na,1880,649.1451451710428
STAT,1822,54,25-29,1876,0.005485191130643171
STAT,1866,30,15-19,1896,0.13103728713697946
STAT,1931,39,40-44,1970,1.9644405076559535
STAT,1832,30,45-49,1862,0.2822236618737182
STAT,1854,48,50-100,1902,0.13484208645464552
STAT,1891,16,15-19,1907,7.31581143704215
STAT,1877,41,30-34,1918,1.1723322487890593
SIM,1849,27,35-39,1876,1
STAT,1841,26,40-44,1867,4.1731318641352635
STAT,1880,30,50-100,1910,0.9588503163547368
STAT,1955,15,na,1970,4846.126700102252
STAT,1850,15,15-19,1865,3.388460088696896
STAT,1936,24,20-24,1960,105.18084281516497
STAT,1859,40,25-29,1899,0.5141046045705534
STAT,1830,24,50-100,1854,0.9577793361470052
SIM,1819,63,na,1882,1387
STAT,1920,17,50-100,1937,0.4149363936655864
STAT,1850,81,na,1931,249.70431528596492
STAT,1789,109,na,1898,3.025353558827851E-4
STAT,1841,54,35-39,1895,0.009323117981574851
STAT,1942,17,35-39,1959,4.3350421495995874
SIM,1886,24,35-39,1910,33
STAT,1859,21,20-24,1880,62.72466904276122
STAT,1896,41,40-44,1937,0.2068314839701259
STAT,1925,33,35-39,1958,10.74582384299595
SIM,1931,37,40-44,1968,4
STAT,1867,25,50-100,1892,0.6090806809896574
SIM,1933,33,35-39,1966,86
STAT,1875,16,30-34,1891,1.6406880700510895
SIM,1855,14,na,1869,3381
STAT,1904,17,15-19,1921,8.478668563183396
SIM,1859,28,na,1887,2088
STAT,1905,49,40-44,1954,0.13600000615431135
STAT,1923,37,40-44,1960,1.71629155086222
STAT,1941,30,15-19,1971,0.13353675904141668
SIM,1838,47,40-44,1885,1
STAT,1932,20,20-24,1952,145.74661011963013
SIM,1903,26,25-29,1929,364
SIM,1939,30,25-29,1969,158
STAT,1854,95,na,1949,7.3925543714915
STAT,1820,38,15-19,1858,0.09948572201228936
SIM,1821,34,na,1855,1769
SIM,1953,8,na,1961,4654
STAT,1822,37,50-100,1859,2.4768570314357055
STAT,1878,24,35-39,1902,5.966360151967074
STAT,1889,15,20-24,1904,21.448332225337897
SIM,1825,48,na,1873,156
STAT,1907,42,30-34,1949,0.11634405082684875
SIM,1905,27,25-29,1932,2
STAT,1829,50,40-44,1879,0.004895662112882543
STAT,1833,52,35-39,1885,0.0038026979717313315
STAT,1924,29,35-39,1953,17.189148137124974
SIM,1914,10,na,1924,5124
SIM,1918,24,na,1942,3086
STAT,1901,45,40-44,1946,0.13637328145081842
SIM,1868,43,na,1911,1154
SIM,1805,71,na,1876,1785
SIM,1839,51,na,1890,523
STAT,1855,45,50-100,1900,0.16416756145175762
STAT,1915,44,30-34,1959,0.12647125911246299
STAT,1938,19,35-39,1957,4.092187025021929
SIM,1904,15,15-19,1919,29
STAT,1917,39,45-49,1956,0.694382688948732
STAT,1890,46,na,1936,2731.9144495882283
STAT,1795,99,na,1894,0.4616673061195353
STAT,1915,38,45-49,1953,0.6755788439278712
SIM,1940,20,20-24,1960,306
STAT,1935,16,na,1951,5007.884356875792
STAT,1917,31,35-39,1948,9.480153033638727
STAT,1897,38,40-44,1935,5.784715886991575
SIM,1914,21,na,1935,5056
STAT,1854,107,na,1961,0.009275367455891487
STAT,1868,26,40-44,1894,2.903257013419539
SIM,1903,58,na,1961,2024
SIM,1918,35,na,1953,4351
STAT,1813,48,25-29,1861,0.20761048556673883
STAT,1911,34,45-49,1945,1.5020589221498115
STAT,1924,41,40-44,1965,0.2950816609425709
SIM,1960,0,na,1960,6453
STAT,1933,32,30-34,1965,21.08798640790144
STAT,1931,16,20-24,1947,176.6404612646704
STAT,1874,83,na,1957,473.71186800454154
SIM,1887,46,na,1933,3563
STAT,1823,48,na,1871,2031.7998335992409
STAT,1903,25,20-24,1928,16.765905595142975
SIM,1906,31,25-29,1937,33
STAT,1829,41,50-100,1870,0.5157426091003444
STAT,1880,39,25-29,1919,2.9589678961104138
SIM,1814,86,na,1900,16
SIM,1870,30,30-34,1900,1
STAT,1914,32,20-24,1946,2.421119657873403
STAT,1830,53,20-24,1883,5.439561451637408E-4
SIM,1840,48,na,1888,2572
STAT,1858,36,25-29,1894,2.2093227502878685
STAT,1918,43,45-49,1961,0.17428871799178042
STAT,1943,29,45-49,1972,1.8171198709603098
SIM,1793,85,na,1878,591
STAT,1849,26,30-34,1875,25.333921963781233
STAT,1873,31,45-49,1904,1.79608734795158
STAT,1907,17,40-44,1924,0.2668732786620388
SIM,1853,66,na,1919,2333
SIM,1927,19,25-29,1946,2
STAT,1937,19,50-100,1956,0.3596395105173061
SIM,1911,25,20-24,1936,36
STAT,1839,95,na,1934,12.352433919829144
STAT,1835,81,na,1916,409.1722303796618
STAT,1890,29,40-44,1919,3.6005325015601692
STAT,1892,37,50-100,1929,1.5200607414095249
SIM,1852,81,na,1933,1138
STAT,1913,28,20-24,1941,17.89695290844043
STAT,1804,101,na,1905,0.36154733353821017
STAT,1837,51,na,1888,1767.3994546390059
STAT,1908,21,40-44,1929,3.0764654444327117
SIM,1879,27,20-24,1906,70
STAT,1851,66,na,1917,1294.478040520785
STAT,1871,29,30-34,1900,24.940505994420064
STAT,1904,37,30-34,1941,1.6434897130851194
STAT,1943,21,35-39,1964,9.906795242509238
SIM,1834,22,20-24,1856,1
STAT,1965,0,na,1965,4895.701189530356
STAT,1868,48,15-19,1916,3.8149354172803743E-4
STAT,1839,36,15-19,1875,0.06299610470993733
STAT,1923,42,15-19,1965,0.0017760172612544436
STAT,1861,17,40-44,1878,0.17483290023304807
STAT,1861,39,15-19,1900,0.04623052557590094
STAT,1869,30,40-44,1899,4.411277782342221
STAT,1889,38,na,1927,2823.0544941537123
SIM,1857,26,30-34,1883,2
SIM,1883,32,na,1915,2198
STAT,1893,75,na,1968,1664.9191585204321
STAT,1916,24,na,1940,3750.762888887894
SIM,1859,39,na,1898,1870
STAT,1878,21,30-34,1899,18.381839401143704
STAT,1869,61,na,1930,1885.606301943715
STAT,1857,28,na,1885,1872.7505779837425
STAT,1856,23,45-49,1879,0.5775181548349889
STAT,1912,10,na,1922,3959.078428820667
STAT,1933,26,45-49,1959,2.279371682056326
SIM,1929,35,35-39,1964,2
STAT,1868,22,50-100,1890,0.393872872113342
STAT,1878,15,45-49,1893,0.06752057512432919
STAT,1885,24,na,1909,2310.1698419343707
STAT,1852,31,25-29,1883,10.78628096866194
STAT,1853,14,na,1867,2206.504554640131
STAT,1900,21,15-19,1921,4.583887398843463
STAT,1835,27,40-44,1862,2.9539412328560304
SIM,1855,39,40-44,1894,13
SIM,1909,42,na,1951,3844
STAT,1864,94,na,1958,27.068552734979935
STAT,1850,23,15-19,1873,1.8152919308250726
STAT,1875,36,25-29,1911,2.970739869545813
STAT,1822,38,25-29,1860,5.602851981839319
STAT,1805,83,na,1888,56.1535305256589
SIM,1847,59,na,1906,1382
SIM,1866,30,na,1896,3178
STAT,1858,27,35-39,1885,7.543143541276194
STAT,1822,53,na,1875,1364.0085833624937
STAT,1905,18,na,1923,3623.1136716164206
STAT,1913,37,na,1950,3666.1837163274613
STAT,1854,29,30-34,1883,14.46819939245223
STAT,1856,37,40-44,1893,3.1441569560122127
STAT,1898,21,20-24,1919,92.94756004443107
SIM,1920,49,50-100,1969,1
STAT,1814,42,45-49,1856,5.237975029275368
SIM,1855,78,na,1933,1575
SIM,1858,11,na,1869,2521
SIM,1890,39,35-39,1929,19
STAT,1849,21,25-29,1870,58.73893155895273
STAT,1889,23,20-24,1912,82.72972182398655
STAT,1856,75,na,1931,739.4147961834262
STAT,1881,64,na,1945,1641.6148829042538
STAT,1864,48,30-34,1912,0.08689573394084613
SIM,1848,23,25-29,1871,41
STAT,1861,37,50-100,1898,1.021043622236779
STAT,1877,44,35-39,1921,1.8133817479308314
SIM,1929,33,20-24,1962,1
STAT,1942,29,15-19,1971,0.7317479926358291
STAT,1873,16,20-24,1889,18.293313894712092
STAT,1817,43,25-29,1860,0.4634541923434912
STAT,1945,21,45-49,1966,1.219958692428325
STAT,1867,25,35-39,1892,9.187190611124699
STAT,1883,65,na,1948,1625.8169381639834
SIM,1918,33,45-49,1951,9
SIM,1883,36,25-29,1919,20
STAT,1882,26,15-19,1908,0.4358701422844024
SIM,1872,48,na,1920,2326
SIM,1865,48,50-100,1913,2
STAT,1892,33,20-24,1925,3.3325175328755097
STAT,1871,38,20-24,1909,0.7651413775842165
STAT,1869,52,50-100,1921,0.015158781040874465
SIM,1901,31,25-29,1932,20
STAT,1894,38,15-19,1932,0.07105523712329714
STAT,1871,32,na,1903,2380.4493857154853
STAT,1818,49,15-19,1867,6.919597773612833E-4
STAT,1845,48,na,1893,1102.3815440630262
STAT,1864,19,50-100,1883,0.04553326153993033
STAT,1884,34,25-29,1918,9.721016226053935
SIM,1926,22,na,1948,6037
STAT,1848,42,15-19,1890,0.012906976942813429
STAT,1856,65,na,1921,1213.8215837022237
STAT,1827,47,15-19,1874,3.6621004568270903E-4
STAT,1825,42,20-24,1867,0.21120968673491294
SIM,1910,39,na,1949,4073
STAT,1865,17,25-29,1882,5.331375185607276
STAT,1875,24,30-34,1899,18.17608032539121
STAT,1890,25,na,1915,2908.743268930292
SIM,1879,80,na,1959,63
SIM,1889,24,25-29,1913,64
SIM,1909,52,na,1961,3730
STAT,1880,19,30-34,1899,1.6458089362913193
STAT,1944,27,50-100,1971,1.063672989864283
SIM,1832,26,40-44,1858,1
STAT,1916,24,30-34,1940,29.520146268821353
STAT,1918,32,40-44,1950,4.1023644625885245
STAT,1870,15,na,1885,2572.055162291977
STAT,1930,39,50-100,1969,0.542641638152998
STAT,1790,90,na,1880,41.757869894233714
STAT,1837,22,45-49,1859,0.7319476609985949
STAT,1912,39,30-34,1951,1.7404988295301336
STAT,1855,106,na,1961,0.02669655717876124
STAT,1861,19,20-24,1880,16.74726300350527
STAT,1950,16,30-34,1966,14.278912367270614
STAT,1815,48,35-39,1863,0.014003713314354644
STAT,1830,37,20-24,1867,0.7031143151474604
SIM,1942,20,30-34,1962,108
STAT,1889,43,15-19,1932,0.016510009829327956
STAT,1788,86,na,1874,28.42416504622951
STAT,1858,46,50-100,1904,0.18808845772577817
STAT,1900,62,na,1962,2691.830894130827
STAT,1835,28,na,1863,2117.8958547825846
SIM,1855,26,20-24,1881,92
STAT,1899,28,35-39,1927,13.132765141942176
STAT,1837,29,na,1866,2194.4661007383934
STAT,1856,97,na,1953,3.858632117393346
STAT,1925,42,25-29,1967,0.08566364938798139
STAT,1939,24,25-29,1963,91.68314226166672
SIM,1874,43,20-24,1917,1
STAT,1863,39,25-29,1902,2.433267294271023
STAT,1849,34,30-34,1883,15.183541002174529
STAT,1853,37,15-19,1890,0.04354161253535183
STAT,1866,43,20-24,1909,0.14392029471388262
STAT,1876,23,35-39,1899,5.880905350200255
SIM,1926,32,40-44,1958,14
STAT,1919,31,45-49,1950,1.6820042650736862
STAT,1934,15,35-39,1949,5.663473113711005
STAT,1891,17,40-44,1908,0.2249211490518622
STAT,1841,25,15-19,1866,0.6366257675896116
SIM,1888,25,20-24,1913,4
STAT,1886,22,40-44,1908,2.1578884506366642
STAT,1847,39,40-44,1886,4.021967789039388
STAT,1850,49,40-44,1899,0.07740301724983968
STAT,1870,15,40-44,1885,0.1862668726090757
STAT,1915,15,25-29,1930,8.983246262485961
SIM,1849,50,na,1899,2155
STAT,1836,26,45-49,1862,1.1088673463419125
STAT,1935,27,45-49,1962,2.3380169546695178
STAT,1777,111,na,1888,0.0032576258357991097
STAT,1853,23,40-44,1876,1.895383348736135
STAT,1843,47,na,1890,2212.5798587024547
STAT,1917,23,35-39,1940,9.84326687256449
STAT,1882,39,35-39,1921,6.7035335557776525
STAT,1859,30,na,1889,1918.9243564638189
STAT,1847,26,20-24,1873,12.840793573438626
STAT,1873,45,na,1918,2330.8490060459003
SIM,1860,47,na,1907,2000
STAT,1843,33,25-29,1876,12.040686572586724
STAT,1848,78,na,1926,731.1512633817617
STAT,1934,20,30-34,1954,38.488784631755586
SIM,1827,31,40-44,1858,34
SIM,1851,33,25-29,1884,8
STAT,1798,86,na,1884,109.96572896532052
SIM,1924,24,30-34,1948,2
STAT,1805,51,na,1856,474.2051737528017
STAT,1900,23,50-100,1923,0.5631605493802414
STAT,1944,25,45-49,1969,1.8478062319462278
STAT,1871,64,na,1935,1734.0883594929574
STAT,1927,25,45-49,1952,2.09730409095598
SIM,1838,21,15-19,1859,1
SIM,1868,11,na,1879,1405
STAT,1938,20,15-19,1958,5.215547898160728
STAT,1813,70,na,1883,1229.3654088681624
STAT,1880,21,35-39,1901,6.076419637621003
SIM,1933,7,na,1940,4589
STAT,1868,21,35-39,1889,5.677081586036038
SIM,1881,4,na,1885,3275
STAT,1886,17,45-49,1903,0.06764472652246056
SIM,1866,32,30-34,1898,1
SIM,1925,40,25-29,1965,1
SIM,1890,77,na,1967,2452
STAT,1924,30,15-19,1954,0.14915399716397892
STAT,1896,44,45-49,1940,0.1351539050040433
STAT,1850,19,45-49,1869,0.03642630545576779
STAT,1839,27,25-29,1866,49.510202866651035
STAT,1865,22,20-24,1887,63.681294609415424
STAT,1930,39,na,1969,4862.458258958867
STAT,1820,72,na,1892,868.5081003358891
STAT,1829,53,45-49,1882,0.005786877795846024
STAT,1835,29,20-24,1864,11.402918993993977
STAT,1909,37,45-49,1946,0.6387027842570167
STAT,1947,23,20-24,1970,124.30578070379585
STAT,1808,48,na,1856,780.1659331851613
STAT,1868,76,na,1944,915.0695806761825
STAT,1873,77,na,1950,886.675850812331
STAT,1844,39,15-19,1883,0.057579138554288346
STAT,1915,18,na,1933,3974.788820767521
SIM,1946,20,15-19,1966,28
SIM,1856,22,20-24,1878,3
STAT,1796,73,na,1869,897.6919594162019
STAT,1851,35,25-29,1886,2.3465494222145282
STAT,1847,29,na,1876,2317.194530592623
STAT,1917,36,40-44,1953,1.5414994957216406
STAT,1903,21,40-44,1924,2.966920445019395
STAT,1860,27,na,1887,1967.7674611245347
STAT,1859,39,45-49,1898,1.564120619683568
SIM,1855,46,na,1901,3003
SIM,1882,15,25-29,1897,9
SIM,1826,35,40-44,1861,22
STAT,1876,28,40-44,1904,3.0175802045370705
STAT,1828,39,30-34,1867,6.861860960283928
SIM,1889,80,na,1969,431
STAT,1839,44,15-19,1883,0.013180423133749324
STAT,1858,32,30-34,1890,13.333362848787386
SIM,1898,22,25-29,1920,10
STAT,1834,48,45-49,1882,0.10889950054124867
STAT,1924,26,30-34,1950,45.338455513763
STAT,1848,22,20-24,1870,78.51898642391896
SIM,1919,52,na,1971,4729
STAT,1857,20,20-24,1877,61.9340104968934
STAT,1899,45,25-29,1944,0.044821098964925324
STAT,1796,110,na,1906,1.0821945839783445E-4
STAT,1891,24,15-19,1915,4.031507762499849
SIM,1833,25,30-34,1858,33
STAT,1929,22,15-19,1951,6.684424273946099
SIM,1858,4,na,1862,2651
STAT,1865,58,na,1923,1805.528836871958
STAT,1874,15,25-29,1889,5.8975410482828
STAT,1876,95,na,1971,69.78923740109033
SIM,1836,39,30-34,1875,39
STAT,1812,53,na,1865,220.27025340605857
STAT,1885,26,40-44,1911,2.9545923224174686
STAT,1824,33,15-19,1857,0.06041836358639578
SIM,1862,48,na,1910,3425
STAT,1923,37,na,1960,4313.35084564401
SIM,1850,47,na,1897,1227
SIM,1883,10,na,1893,2241
SIM,1946,20,na,1966,1713
STAT,1894,16,40-44,1910,0.2331614812255139
STAT,1845,81,na,1926,268.33654663682614
SIM,1858,33,35-39,1891,3
STAT,1828,30,50-100,1858,1.4795405791233158
SIM,1869,60,na,1929,3598
STAT,1899,25,30-34,1924,34.62848110493461
STAT,1860,70,na,1930,1144.6169487361842
STAT,1814,42,50-100,1856,3.697394127716665
STAT,1904,20,45-49,1924,1.0022047532692935
STAT,1954,16,15-19,1970,55.62400426109684
STAT,1868,98,na,1966,13.65104400543346
STAT,1877,27,45-49,1904,1.1270912916996325
SIM,1886,44,50-100,1930,38
STAT,1880,25,na,1905,2494.3884409923476
STAT,1938,33,20-24,1971,2.424819931173518
SIM,1916,22,na,1938,4796
STAT,1855,15,15-19,1870,4.727131539001316
STAT,1915,1,na,1916,4294.915254414477
STAT,1886,4,na,1890,2724.2089563067307
SIM,1917,37,45-49,1954,2
STAT,1805,73,na,1878,205.6816517637583
STAT,1903,59,na,1962,2907.820225652857
STAT,1800,54,50-100,1854,0.08805267020364227
STAT,1835,49,15-19,1884,3.109429350948478E-4
STAT,1855,26,na,1881,1658.2592485457521
STAT,1875,49,45-49,1924,0.2372773106326465
SIM,1862,29,30-34,1891,21
STAT,1840,32,45-49,1872,0.8363203140612878
SIM,1836,43,50-100,1879,19
STAT,1850,41,50-100,1891,0.49003628721471965
STAT,1953,15,45-49,1968,0.5991902112283433
STAT,1881,33,45-49,1914,1.639825201912049
STAT,1929,20,na,1949,4612.992752753705
STAT,1844,25,40-44,1869,3.6856675579005955
STAT,1932,20,50-100,1952,0.8624571014048988
SIM,1818,36,45-49,1854,2
STAT,1917,40,25-29,1957,0.07373104502871551
STAT,1908,30,30-34,1938,14.875184356828091
SIM,1868,32,40-44,1900,1
SIM,1842,28,na,1870,3218
STAT,1895,15,45-49,1910,0.0853710609486223
SIM,1910,1,na,1911,4577
STAT,1890,38,30-34,1928,6.420023550983654
STAT,1856,49,35-39,1905,0.09845597573314623
SIM,1863,37,25-29,1900,3
STAT,1949,21,15-19,1970,6.152268970825586
STAT,1930,17,na,1947,4725.231999462181
SIM,1856,10,na,1866,1321
STAT,1834,35,25-29,1869,1.6114688893381601
STAT,1927,30,40-44,1957,4.7800474763674
STAT,1884,31,20-24,1915,2.5981379453879443
STAT,1948,22,25-29,1970,104.973186038715
STAT,1869,42,35-39,1911,1.8250097239122132
STAT,1869,6,na,1875,2804.700827579254
STAT,1823,47,30-34,1870,0.15103072400686196
STAT,1880,48,15-19,1928,4.100436570989009E-4
STAT,1903,28,25-29,1931,59.83597466761646
SIM,1842,18,na,1860,3413
STAT,1845,24,45-49,1869,0.42341860275941634
STAT,1855,16,na,1871,1817.6516730912513
STAT,1867,22,30-34,1889,16.91500846778579
STAT,1943,26,40-44,1969,4.909600329365161
STAT,1910,31,25-29,1941,8.848171003388167
STAT,1837,29,30-34,1866,25.54503761978038
SIM,1842,35,25-29,1877,102
STAT,1908,25,35-39,1933,14.29882991636041
STAT,1839,32,20-24,1871,3.0904693266186256
SIM,1892,31,20-24,1923,28
SIM,1870,33,35-39,1903,7
STAT,1849,46,25-29,1895,0.04867108682946436
STAT,1927,33,45-49,1960,1.9187267949271312
STAT,1902,25,40-44,1927,4.246852436622655
SIM,1882,26,na,1908,1962
SIM,1855,48,30-34,1903,1
STAT,1860,38,45-49,1898,1.61820453989908
STAT,1892,36,25-29,1928,3.581873436823868
STAT,1817,40,20-24,1857,0.12055731698222456
STAT,1880,47,na,1927,2324.793146376567
STAT,1886,25,45-49,1911,1.1575749569865226
STAT,1839,37,40-44,1876,4.8601032223465115
STAT,1852,27,40-44,1879,3.51204228757648
STAT,1849,17,40-44,1866,0.1897004040626235
SIM,1922,18,na,1940,3673
SIM,1846,32,na,1878,1213
SIM,1908,25,na,1933,2778
STAT,1870,18,45-49,1888,0.06535530013431883
STAT,1966,1,na,1967,4868.548994481504
SIM,1933,25,35-39,1958,35
STAT,1874,50,30-34,1924,0.006231710619286955
STAT,1920,16,45-49,1936,0.5546073128038179
STAT,1942,22,30-34,1964,29.790730896250913
STAT,1815,51,na,1866,202.29464338591833
STAT,1825,45,25-29,1870,0.07513969044345896
STAT,1835,31,25-29,1866,9.969478844215576
STAT,1917,41,na,1958,3829.5776567094695
STAT,1898,33,15-19,1931,0.19068986916606795
STAT,1877,38,15-19,1915,0.05672090023893806
STAT,1897,45,15-19,1942,3.0263991190821637E-4
STAT,1845,48,20-24,1893,0.00587978455237435
STAT,1893,43,na,1936,2879.30053843168
STAT,1868,34,40-44,1902,4.15284603908617
SIM,1929,36,25-29,1965,13
STAT,1925,25,35-39,1950,17.689711103444594
STAT,1929,2,na,1931,5182.912354206559
STAT,1873,29,40-44,1902,3.050826617057617
STAT,1878,76,na,1954,974.754470549766
SIM,1917,42,40-44,1959,2
STAT,1825,71,na,1896,821.9871029422891
STAT,1895,32,35-39,1927,13.17402146064454
STAT,1768,88,na,1856,116.58403521999999
STAT,1844,39,50-100,1883,1.25888918836984
STAT,1932,15,25-29,1947,57.2478176160776
SIM,1892,0,na,1892,4214
STAT,1925,29,15-19,1954,0.820278425273492
STAT,1812,49,20-24,1861,0.0029929768170268837
STAT,1832,31,na,1863,2451.7471591917333
SIM,1814,64,na,1878,2442
STAT,1863,77,na,1940,737.9422035900996
STAT,1908,22,30-34,1930,26.218301760878084
STAT,1886,31,50-100,1917,0.9526956453199195
SIM,1961,1,na,1962,4670
STAT,1885,2,na,1887,3067.9667460728447
STAT,1838,46,na,1884,999.8514931122814
STAT,1856,36,15-19,1892,0.04052733956696718
SIM,1842,71,na,1913,1595
SIM,1792,68,na,1860,879
SIM,1827,29,na,1856,2503
STAT,1889,39,30-34,1928,6.353416462618782
STAT,1900,30,na,1930,3332.29377747077
STAT,1940,21,50-100,1961,0.6629947561981075
STAT,1909,42,40-44,1951,0.23156948689919474
STAT,1884,17,35-39,1901,0.5252641169179268
STAT,1834,23,30-34,1857,10.42346306764641
STAT,1868,44,na,1912,2202.226473696842
STAT,1855,43,45-49,1898,0.983375679987729
SIM,1822,36,25-29,1858,7
SIM,1836,41,35-39,1877,2
STAT,1865,27,40-44,1892,2.7349230853737025
SIM,1848,76,na,1924,1297
STAT,1856,6,na,1862,2118.770082749812
STAT,1843,30,20-24,1873,3.2781220758020826
STAT,1935,24,40-44,1959,4.542655281677316
STAT,1935,32,40-44,1967,5.375104593596027
STAT,1863,19,30-34,1882,1.3963555034888926
SIM,1929,19,na,1948,6195
SIM,1850,21,15-19,1871,9
STAT,1844,19,20-24,1863,22.063940901855247
STAT,1828,41,35-39,1869,2.302617862833915
STAT,1826,37,40-44,1863,7.152661612459195
SIM,1840,70,na,1910,2259
STAT,1863,13,na,1876,2315.0074828186553
STAT,1857,15,25-29,1872,5.171645121994584
STAT,1793,87,na,1880,52.29569395644786
STAT,1892,16,30-34,1908,1.9782065324784877
STAT,1857,16,50-100,1873,0.04444826882930732
STAT,1840,26,25-29,1866,20.918265970787488
STAT,1934,21,na,1955,4875.969182898683
STAT,1881,27,25-29,1908,39.9472522718975
STAT,1918,39,25-29,1957,1.0216220033820125
SIM,1865,46,na,1911,1705
SIM,1876,62,na,1938,3039
STAT,1842,21,15-19,1863,1.0404257336563543
STAT,1898,38,50-100,1936,0.3545790953812563
STAT,1876,15,35-39,1891,0.5572716715970092
STAT,1839,26,50-100,1865,0.754119926742508
SIM,1879,7,na,1886,2178
STAT,1910,62,na,1972,3085.177244183278
STAT,1934,23,35-39,1957,12.564064738399379
STAT,1882,17,25-29,1899,5.4253839532161665
STAT,1893,28,40-44,1921,3.73284994310754
SIM,1869,27,na,1896,3425
STAT,1868,41,50-100,1909,1.0250131414186776
STAT,1909,39,50-100,1948,0.3894033856231339
STAT,1946,22,15-19,1968,5.859670712185001
STAT,1848,38,30-34,1886,5.086402532097919
SIM,1864,29,na,1893,2415
STAT,1838,78,na,1916,333.2167118475976
STAT,1860,25,25-29,1885,35.38523039146569
STAT,1858,24,30-34,1882,13.999219318651495
STAT,1837,49,25-29,1886,0.04673016412511913
STAT,1836,37,15-19,1873,0.052816899348240555
STAT,1951,19,15-19,1970,53.50377494734811
STAT,1826,49,50-100,1875,0.3422563548105379
STAT,1908,28,50-100,1936,0.9303659577332395
STAT,1884,82,na,1966,735.0179995139933
STAT,1930,26,50-100,1956,1.2573102816416146
STAT,1951,15,35-39,1966,4.952905073867797
SIM,1908,31,35-39,1939,2
SIM,1856,38,30-34,1894,14
STAT,1866,46,25-29,1912,0.052727637237934125
SIM,1884,32,25-29,1916,5
STAT,1876,32,25-29,1908,10.354330985365788
SIM,1866,36,25-29,1902,34
SIM,1844,26,45-49,1870,12
SIM,1852,19,20-24,1871,52
STAT,1898,24,25-29,1922,76.4972325887864
STAT,1929,35,20-24,1964,0.3366409322753991
STAT,1928,26,15-19,1954,0.8660759569837008
STAT,1833,47,na,1880,986.5244873205932
STAT,1899,42,20-24,1941,0.015044652746176503
STAT,1854,31,35-39,1885,5.826495252587499
STAT,1833,27,30-34,1860,15.477951494509913
STAT,1883,22,15-19,1905,3.173803618759452
STAT,1807,64,na,1871,979.9120489692373
STAT,1833,43,50-100,1876,0.5425738174100401
STAT,1858,44,25-29,1902,0.4837730242760984
STAT,1886,49,20-24,1935,0.012167143709251937
STAT,1841,38,35-39,1879,9.18380359843058
STAT,1859,36,40-44,1895,3.4862756741359857
STAT,1915,20,20-24,1935,109.3879029997691
STAT,1843,16,35-39,1859,0.6969342929406005
STAT,1810,52,na,1862,84.53372776173187
STAT,1830,40,na,1870,1904.914142592497
SIM,1867,9,na,1876,2872
STAT,1896,38,25-29,1934,3.7766147663151792
STAT,1927,22,40-44,1949,4.108862497977124
SIM,1804,54,na,1858,875
STAT,1910,18,15-19,1928,8.86864390237645
SIM,1857,59,na,1916,1397
STAT,1831,49,30-34,1880,0.08896265815543591
STAT,1845,21,40-44,1866,1.2929542484852636
STAT,1897,37,15-19,1934,0.07457617467896793
STAT,1818,38,45-49,1856,4.665897110945502
STAT,1829,47,25-29,1876,0.026642338639951996
STAT,1932,32,15-19,1964,0.1696399920774181
STAT,1872,3,na,1875,3119.201567199277
STAT,1888,27,20-24,1915,13.540015256008004
STAT,1923,22,20-24,1945,128.0186134532441
SIM,1922,39,40-44,1961,9
STAT,1850,16,40-44,1866,0.1038173489220331
STAT,1869,93,na,1962,67.95770573458252
STAT,1876,10,na,1886,2658.9197597940606
STAT,1846,65,na,1911,1000.898658269103
SIM,1852,71,na,1923,1423
STAT,1879,24,15-19,1903,3.3630841729620586
SIM,1858,33,na,1891,2417
STAT,1906,42,15-19,1948,0.0013869660093820896
STAT,1827,33,40-44,1860,4.402118698588554
STAT,1862,33,35-39,1895,8.589237386608861
STAT,1869,25,45-49,1894,1.127987837155758
STAT,1939,20,na,1959,3629.6359698449555
STAT,1851,15,30-34,1866,1.5486921576442567
SIM,1897,39,30-34,1936,1
STAT,1866,48,40-44,1914,0.15431096851638157
STAT,1847,34,20-24,1881,2.5575110880540963
SIM,1900,39,na,1939,4146
SIM,1850,69,na,1919,719
SIM,1909,20,na,1929,4132
SIM,1930,27,na,1957,5355
SIM,1899,57,na,1956,1502
SIM,1859,50,na,1909,1706
STAT,1839,24,20-24,1863,81.08651905624481
STAT,1866,26,30-34,1892,23.06539300193063
STAT,1894,24,40-44,1918,2.633304506424974
STAT,1908,33,35-39,1941,8.523053642467362
STAT,1898,16,25-29,1914,7.638860119060923
STAT,1800,74,na,1874,797.0234723376307
SIM,1890,9,na,1899,4046
SIM,1915,38,na,1953,3110
STAT,1844,28,45-49,1872,1.3368746386134356
SIM,1858,25,35-39,1883,1
STAT,1838,23,15-19,1861,1.8139925988218721
STAT,1950,20,15-19,1970,6.2591649766577095
SIM,1892,34,25-29,1926,25
SIM,1891,51,na,1942,1774
SIM,1835,33,40-44,1868,1
SIM,1797,67,na,1864,1152
STAT,1865,54,50-100,1919,0.013409495920958156
STAT,1861,21,25-29,1882,49.26316824880573
STAT,1916,32,30-34,1948,16.044169232869592
SIM,1852,28,na,1880,2090
STAT,1857,23,25-29,1880,50.348320489900956
STAT,1919,23,45-49,1942,1.2119618686746787
STAT,1879,1,na,1880,3512.157871929129
STAT,1922,4,na,1926,4619.030306386134
SIM,1846,10,na,1856,1528
SIM,1917,34,40-44,1951,1
STAT,1893,65,na,1958,2188.7890045703866
SIM,1839,25,25-29,1864,8
SIM,1924,2,na,1926,5361
STAT,1850,17,na,1867,1295.2386351906496
STAT,1907,21,25-29,1928,83.77906735389305
STAT,1881,42,na,1923,2179.926948405216
STAT,1908,20,15-19,1928,4.884881075513508
SIM,1921,15,15-19,1936,196
STAT,1873,24,20-24,1897,70.24650644622326
STAT,1917,44,40-44,1961,0.2566850790286678
STAT,1878,23,45-49,1901,0.7152357820897554
STAT,1836,43,35-39,1879,1.62969469665861
SIM,1915,21,25-29,1936,273
SIM,1891,22,15-19,1913,4
STAT,1885,29,45-49,1914,1.0835715043717382
STAT,1863,99,na,1962,4.557262204484478
STAT,1887,42,50-100,1929,1.1613766603490177
STAT,1913,15,15-19,1928,9.205145681511377
STAT,1862,16,45-49,1878,0.06409962187453015
SIM,1941,21,na,1962,3835
STAT,1851,32,20-24,1883,2.2220021759803306
SIM,1808,90,na,1898,138
SIM,1945,5,na,1950,6372
STAT,1855,48,na,1903,1470.3170086568416
SIM,1896,27,20-24,1923,143
STAT,1926,21,35-39,1947,11.375384386984262
STAT,1815,53,50-100,1868,0.0014489065088296527
STAT,1909,34,40-44,1943,3.664722298730632
STAT,1835,71,na,1906,1009.9837159521231
STAT,1919,20,50-100,1939,0.7151883940396271
STAT,1858,35,35-39,1893,5.452634773811211
STAT,1920,40,na,1960,4060.290995424143
SIM,1846,23,15-19,1869,24
SIM,1880,77,na,1957,3051
STAT,1832,28,40-44,1860,3.588622173951111
STAT,1858,41,20-24,1899,0.12182860521333085
SIM,1824,49,40-44,1873,2
SIM,1853,34,na,1887,3268
STAT,1843,79,na,1922,690.7472635685249
STAT,1886,41,na,1927,2404.234154381221
STAT,1866,17,40-44,1883,0.17136814343321094
SIM,1824,32,na,1856,2242
STAT,1945,26,15-19,1971,0.7662918199484635
STAT,1883,26,30-34,1909,24.309212806512363
STAT,1912,49,50-100,1961,0.21358466245515312
SIM,1868,41,30-34,1909,5
STAT,1888,49,30-34,1937,0.061705269879845655
STAT,1942,25,35-39,1967,15.59112277566833
SIM,1887,56,na,1943,3006
STAT,1878,22,na,1900,2433.325743006026
STAT,1900,42,50-100,1942,0.10150244726771195
SIM,1924,15,40-44,1939,45
SIM,1880,26,20-24,1906,25
STAT,1926,30,25-29,1956,11.092666739235288
SIM,1872,16,na,1888,2500
STAT,1825,47,40-44,1872,0.21749242989994377
STAT,1874,24,15-19,1898,3.3834975043540108
SIM,1882,28,30-34,1910,48
SIM,1929,8,na,1937,6274
SIM,1832,51,na,1883,1617
STAT,1843,38,45-49,1881,2.070835967993235
STAT,1812,47,50-100,1859,0.06349668490151553
SIM,1886,32,35-39,1918,10
STAT,1922,26,20-24,1948,20.49510549769344
STAT,1882,21,45-49,1903,0.6696384395946932
SIM,1944,18,na,1962,2509
STAT,1899,49,40-44,1948,0.12914920941396604
STAT,1911,39,15-19,1950,0.018154408900791306
SIM,1958,4,na,1962,4197
STAT,1816,49,40-44,1865,0.5059569957581795
STAT,1909,45,45-49,1954,0.19957889228275988
STAT,1878,32,35-39,1910,10.419426628167365
SIM,1874,1,na,1875,2819
STAT,1916,15,40-44,1931,0.294070121082471
STAT,1849,48,50-100,1897,0.20434034972731108
STAT,1903,60,na,1963,2879.5852912617675
STAT,1839,49,35-39,1888,0.12917116964546763
SIM,1911,3,na,1914,2769
SIM,1893,22,25-29,1915,12
STAT,1854,31,na,1885,1372.937630528042
STAT,1889,28,40-44,1917,3.594635171862622
STAT,1839,35,25-29,1874,3.2636956758490037
STAT,1811,69,na,1880,1031.7207559377719
STAT,1905,28,35-39,1933,13.829400491352283
SIM,1904,53,na,1957,3928
STAT,1857,39,35-39,1896,5.3728618406252755
STAT,1933,27,35-39,1960,19.799635561678947
STAT,1823,39,30-34,1862,9.45027171231133
SIM,1796,72,na,1868,846
STAT,1854,38,20-24,1892,0.42647972533917866
STAT,1893,21,20-24,1914,86.43716654046777
SIM,1858,22,30-34,1880,29
SIM,1835,36,45-49,1871,16
STAT,1863,48,15-19,1911,3.371938645747331E-4
STAT,1935,35,45-49,1970,0.948039779943579
STAT,1943,25,na,1968,3947.5772797034247
STAT,1890,16,20-24,1906,21.515000716148364
SIM,1897,28,40-44,1925,117
SIM,1920,18,25-29,1938,32
STAT,1867,81,na,1948,511.4172495672915
STAT,1846,25,15-19,1871,0.3297917941439693
STAT,1855,37,25-29,1892,1.9055577018312302
STAT,1885,22,25-29,1907,56.269537269332176
STAT,1837,27,15-19,1864,0.46692618750572495
STAT,1846,39,25-29,1885,1.7441450183999325
STAT,1912,18,25-29,1930,8.638388590979357
STAT,1897,28,25-29,1925,55.980735766408394
STAT,1940,29,40-44,1969,4.69501619113362
STAT,1914,39,40-44,1953,1.4590334232041882
STAT,1933,20,15-19,1953,7.0548586944812
SIM,1868,64,na,1932,502
STAT,1911,26,45-49,1937,1.6715304287550172
STAT,1875,27,35-39,1902,9.908023632606145
STAT,1809,45,40-44,1854,1.575547943984384
STAT,1860,51,40-44,1911,0.008629466122297246
STAT,1900,19,45-49,1919,0.09000503290267582
STAT,1853,29,15-19,1882,0.3655547208192085
SIM,1915,37,35-39,1952,2
STAT,1886,63,na,1949,1847.7364417843264
STAT,1919,36,15-19,1955,0.02037488568680537
STAT,1904,49,25-29,1953,0.04545082544962016
STAT,1861,28,45-49,1889,0.9234062892629574
STAT,1858,18,45-49,1876,0.05792846280415322
STAT,1952,20,25-29,1972,110.12009397680507
SIM,1921,23,na,1944,5271
SIM,1909,39,25-29,1948,2
STAT,1886,28,15-19,1914,0.4681779028695376
STAT,1869,34,35-39,1903,10.131547509898683
SIM,1879,38,25-29,1917,6
STAT,1800,84,na,1884,193.60922191704594
STAT,1843,37,40-44,1880,5.049251340536236
STAT,1857,48,50-100,1905,0.18609590894675598
SIM,1861,31,na,1892,2233
STAT,1838,43,45-49,1881,0.6712624467782078
STAT,1827,36,45-49,1863,1.9899779764405607
STAT,1874,28,30-34,1902,25.89791274848185
STAT,1878,44,na,1922,2345.865435514544
STAT,1859,20,30-34,1879,16.330124052596915
STAT,1894,27,45-49,1921,1.4119264442905115
STAT,1892,38,40-44,1930,5.392877220510164
SIM,1831,25,20-24,1856,6
SIM,1827,40,30-34,1867,1
STAT,1863,17,15-19,1880,5.781237766259098
SIM,1865,37,35-39,1902,4
SIM,1911,23,na,1934,1790
SIM,1817,45,40-44,1862,6
STAT,1917,32,25-29,1949,9.549286384182382
STAT,1919,40,35-39,1959,0.21591688392384614
STAT,1839,48,30-34,1887,0.09046424712312641
STAT,1865,25,25-29,1890,38.882835743077386
SIM,1941,20,15-19,1961,10
STAT,1882,48,25-29,1930,0.054453908631487115
STAT,1857,35,50-100,1892,0.951069885162393
STAT,1846,12,na,1858,1776.1028334450248
STAT,1842,39,40-44,1881,1.1361983844219077
STAT,1890,17,25-29,1907,6.860182642174369
STAT,1842,25,30-34,1867,7.842845777329045
STAT,1899,49,50-100,1948,0.18527480028566165
STAT,1932,40,na,1972,5012.429980625491
STAT,1862,48,50-100,1910,0.20655914585186577
STAT,1907,41,na,1948,3399.2808288429355
SIM,1831,26,25-29,1857,144
SIM,1902,27,20-24,1929,9
STAT,1875,15,40-44,1890,0.18868702539071266
STAT,1876,36,40-44,1912,4.446551736602798
STAT,1908,46,40-44,1954,0.1425486963375952
STAT,1923,25,25-29,1948,75.2811453377277
SIM,1850,39,40-44,1889,1
STAT,1939,15,35-39,1954,4.164317469178706
STAT,1785,101,na,1886,0.06192272326134851
STAT,1871,23,35-39,1894,5.803158622820641
STAT,1874,29,35-39,1903,9.887161826903556
SIM,1919,19,na,1938,5208
SIM,1860,20,20-24,1880,66
STAT,1871,11,na,1882,2645.8067196762236
STAT,1907,37,35-39,1944,2.2274980692545774
STAT,1924,34,30-34,1958,18.18111647955928
STAT,1848,37,50-100,1885,1.1839541910609674
SIM,1836,32,na,1868,2007
STAT,1848,34,15-19,1882,0.13851334168159019
STAT,1849,43,20-24,1892,0.13284792430452413
STAT,1841,16,25-29,1857,8.186812223235764
SIM,1873,25,25-29,1898,2
SIM,1902,63,na,1965,2613
STAT,1833,69,na,1902,603.8019407099164
STAT,1841,98,na,1939,3.6174618461969708
SIM,1870,27,15-19,1897,3
STAT,1852,23,25-29,1875,67.96162744198504
STAT,1827,39,15-19,1866,0.05403006070409483
STAT,1891,26,30-34,1917,31.07317632548341
STAT,1832,22,45-49,1854,1.0723968561913637
STAT,1907,30,15-19,1937,0.12027010645578187
STAT,1944,8,na,1952,4201.655241284248
STAT,1905,34,20-24,1939,2.2132991374649102
SIM,1822,51,na,1873,1444
SIM,1862,20,50-100,1882,180
STAT,1819,40,30-34,1859,0.2579577691486632
SIM,1875,25,35-39,1900,1
STAT,1846,107,na,1953,0.00279307484769265
SIM,1838,45,na,1883,1872
STAT,1931,18,35-39,1949,5.439449564246573
SIM,1908,40,25-29,1948,1
STAT,1861,24,50-100,1885,0.34342246267082527
STAT,1925,26,50-100,1951,1.1688646490378343
STAT,1833,79,na,1912,287.63790663719305
SIM,1854,38,20-24,1892,1
STAT,1941,26,30-34,1967,40.09043073866071
STAT,1921,29,30-34,1950,42.84299233645371
STAT,1906,25,25-29,1931,61.67105446059779
SIM,1854,61,na,1915,633
STAT,1838,39,25-29,1877,1.4525836044638416
STAT,1809,108,na,1917,0.0017829559057048103
STAT,1885,14,na,1899,2530.257677539033
STAT,1839,15,30-34,1854,1.9601370788584813
STAT,1835,35,40-44,1870,4.180692198500512
STAT,1936,20,40-44,1956,3.184869491101221
STAT,1845,27,15-19,1872,0.27402936529364297
STAT,1873,36,15-19,1909,0.05787944780572409
SIM,1932,18,na,1950,6458
STAT,1873,38,30-34,1911,5.439856111003188
STAT,1886,31,30-34,1917,18.154300099332442
STAT,1862,27,15-19,1889,0.38786165423151253
STAT,1910,30,na,1940,3634.890464294581
STAT,1856,15,30-34,1871,1.3697421229033124
STAT,1926,37,45-49,1963,0.8260069392329126
STAT,1937,18,na,1955,3534.4707402523654
STAT,1869,22,40-44,1891,2.1027337465848284
STAT,1915,23,25-29,1938,93.84158684189302
SIM,1907,35,35-39,1942,3
STAT,1930,39,25-29,1969,1.2725566945072317
STAT,1842,26,35-39,1868,2.983560078812915
STAT,1875,20,15-19,1895,3.4078225728994864
STAT,1900,19,na,1919,3479.922624845225
STAT,1911,19,20-24,1930,26.68045804028025
STAT,1887,37,20-24,1924,0.8484527029145849
STAT,1841,20,45-49,1861,0.9979666036892353
STAT,1856,29,40-44,1885,2.197622685809177
STAT,1934,36,40-44,1970,2.053681178536506
STAT,1955,16,30-34,1971,16.043897003330386
STAT,1899,19,45-49,1918,0.08874339436619852
STAT,1847,17,30-34,1864,1.7985653330587446
SIM,1865,36,30-34,1901,14
SIM,1872,26,na,1898,2454
STAT,1817,37,50-100,1854,0.9707762394981786
STAT,1858,49,45-49,1907,0.17646181878185582
STAT,1817,47,40-44,1864,0.11993647012204736
STAT,1870,35,50-100,1905,1.2356017006871933
STAT,1904,29,30-34,1933,35.720141437469316
STAT,1893,48,50-100,1941,0.1710698391410299
SIM,1853,12,na,1865,3646
STAT,1826,30,20-24,1856,6.461308591124384
STAT,1879,44,45-49,1923,1.514589281482353
SIM,1848,32,15-19,1880,4
STAT,1950,9,na,1959,4602.197825988605
SIM,1850,26,35-39,1876,27
STAT,1884,38,40-44,1922,4.169677916946998
STAT,1917,51,na,1968,3737.842092728899
SIM,1935,36,na,1971,5661
STAT,1814,87,na,1901,119.2364321675857
STAT,1878,31,50-100,1909,0.9465493141479074
STAT,1878,28,15-19,1906,0.46515744565154754
STAT,1920,17,20-24,1937,150.15167984438517
STAT,1845,30,30-34,1875,10.517475180618778
STAT,1840,17,na,1857,1170.2279232534083
STAT,1851,37,40-44,1888,3.49434308250369
STAT,1830,72,na,1902,914.0483834236421
SIM,1923,23,25-29,1946,905
STAT,1931,24,20-24,1955,142.30701209227712
STAT,1864,43,50-100,1907,0.9534889998337288
SIM,1875,38,40-44,1913,2
STAT,1866,22,15-19,1888,3.0359993559878196
STAT,1817,48,45-49,1865,0.16315610843581713
SIM,1881,38,30-34,1919,11
STAT,1916,35,35-39,1951,2.4663522736662515
STAT,1832,37,30-34,1869,0.4064990124731172
STAT,1883,27,35-39,1910,9.28268595306187
STAT,1841,47,25-29,1888,0.06443212295111242
STAT,1889,35,15-19,1924,0.0682649492509876
STAT,1914,24,20-24,1938,111.32113559293242
STAT,1822,47,15-19,1869,6.688802499308793E-4
SIM,1875,31,20-24,1906,13
STAT,1860,5,na,1865,2365.8644050187722
SIM,1912,41,na,1953,4585
SIM,1829,27,30-34,1856,39
STAT,1900,40,40-44,1940,0.21855701588620108
SIM,1840,37,30-34,1877,8
STAT,1872,15,15-19,1887,6.033026605582338
STAT,1947,17,35-39,1964,4.677011685545087
STAT,1867,38,40-44,1905,4.119401927731071
STAT,1828,43,50-100,1871,1.2991782359557185
SIM,1824,36,35-39,1860,1
STAT,1847,37,25-29,1884,2.700864216450575
STAT,1840,49,na,1889,870.7446831165578
STAT,1951,0,na,1951,5178.437418649804
STAT,1915,36,30-34,1951,1.8238966743707705
SIM,1924,35,35-39,1959,1
SIM,1893,63,na,1956,1671
STAT,1884,39,45-49,1923,1.889103508676452
SIM,1831,32,45-49,1863,4
STAT,1873,5,na,1878,2834.4772559487906
SIM,1891,26,30-34,1917,4
STAT,1897,32,45-49,1929,2.3158864448155096
STAT,1858,104,na,1962,0.17844609080580293
STAT,1836,30,50-100,1866,0.9060847525497252
STAT,1831,25,20-24,1856,15.758156921429096
STAT,1890,23,45-49,1913,0.8415740397137487
SIM,1823,37,30-34,1860,12
STAT,1855,32,50-100,1887,0.6174451149145889
STAT,1867,39,45-49,1906,1.8663255988422254
SIM,1905,38,na,1943,3135
STAT,1846,38,20-24,1884,0.4718348643869782
SIM,1859,34,40-44,1893,5
STAT,1834,97,na,1931,2.3675754652153276
STAT,1856,27,25-29,1883,31.48389547907832
STAT,1877,20,50-100,1897,0.41642624109513937
SIM,1885,20,25-29,1905,202
STAT,1868,37,45-49,1905,1.9254507147192277
SIM,1904,23,15-19,1927,7
STAT,1871,17,15-19,1888,5.958206683933859
STAT,1888,18,30-34,1906,1.8347665429171296
SIM,1922,43,50-100,1965,1
STAT,1909,38,20-24,1947,0.24575097803887805
STAT,1882,28,30-34,1910,24.02454404618111
STAT,1919,20,40-44,1939,3.654612427655574
SIM,1885,44,na,1929,1284
SIM,1890,28,30-34,1918,1
STAT,1823,32,45-49,1855,4.820149713859154
STAT,1902,21,25-29,1923,80.85437672168
SIM,1825,48,45-49,1873,1
STAT,1857,32,15-19,1889,0.10995281403165433
SIM,1889,37,na,1926,3846
SIM,1839,22,20-24,1861,2
STAT,1878,44,50-100,1922,1.072279046417712
STAT,1918,36,na,1954,3930.7895660043832
SIM,1857,27,na,1884,1470
SIM,1864,27,25-29,1891,140
STAT,1928,0,na,1928,5633.44021114395
SIM,1862,27,15-19,1889,7
STAT,1816,38,35-39,1854,27.548272570504317
STAT,1849,30,na,1879,2158.9489644035307
STAT,1856,31,45-49,1887,1.2810748432535957
STAT,1857,36,30-34,1893,4.10939640094194
STAT,1872,29,25-29,1901,42.05618636956126
SIM,1908,44,40-44,1952,1
STAT,1909,30,25-29,1939,8.800384844470678
STAT,1889,26,25-29,1915,51.1152433226617
STAT,1933,15,40-44,1948,1.8683139067857233
STAT,1907,34,30-34,1941,14.502747407706655
STAT,1833,23,15-19,1856,2.6362966022543075
SIM,1797,57,na,1854,1802
STAT,1808,47,40-44,1855,0.312908749490217
STAT,1923,29,40-44,1952,5.257245704328561
STAT,1829,25,15-19,1854,0.45383651519263085
STAT,1917,47,45-49,1964,0.22398130384293571
STAT,1917,20,30-34,1937,30.31864972325681
STAT,1819,64,na,1883,426.9095509578827
STAT,1859,32,25-29,1891,8.118212577868814
STAT,1864,27,25-29,1891,38.456481919936486
STAT,1927,18,na,1945,4527.410865932146
STAT,1854,27,15-19,1881,0.26445767209046067
SIM,1869,59,na,1928,3598
STAT,1878,26,15-19,1904,0.4684025203257074
SIM,1930,37,na,1967,5299
STAT,1846,36,20-24,1882,0.4817361272436024
STAT,1936,16,20-24,1952,128.8267261937593
STAT,1871,96,na,1967,36.36565650928619
STAT,1875,33,20-24,1908,2.7639286746134517
SIM,1841,23,15-19,1864,3
SIM,1929,40,na,1969,6204
SIM,1808,47,na,1855,1441
SIM,1860,79,na,1939,1638
STAT,1902,29,20-24,1931,16.401695633330466
STAT,1924,37,35-39,1961,2.8247386385293467
STAT,1831,27,20-24,1858,13.927121075604752
STAT,1832,32,50-100,1864,0.05987411868504462
STAT,1840,39,30-34,1879,2.4310515483020567
STAT,1871,20,30-34,1891,17.874546718243895
STAT,1928,20,40-44,1948,4.191010020844527
STAT,1903,38,50-100,1941,0.37430112009192523
STAT,1932,36,30-34,1968,2.4339895990340845
SIM,1834,33,25-29,1867,25
STAT,1893,15,35-39,1908,0.6893641217849471
STAT,1840,50,na,1890,860.0031957866288
SIM,1933,20,15-19,1953,26
STAT,1876,39,45-49,1915,1.994949312043109
STAT,1865,39,35-39,1904,6.392522119884782
STAT,1888,47,15-19,1935,4.5951278591984014E-4
SIM,1932,5,na,1937,6513
STAT,1953,19,25-29,1972,51.9174135142714
STAT,1941,22,15-19,1963,5.438553630455538
SIM,1863,12,na,1875,1606
SIM,1880,29,25-29,1909,150
SIM,1814,54,na,1868,2442
STAT,1937,5,na,1942,3871.1136758385655
SIM,1908,27,15-19,1935,2
STAT,1863,67,na,1930,1353.3199543038377
SIM,1925,20,30-34,1945,38
STAT,1841,18,40-44,1859,0.26113932676582047
STAT,1861,25,40-44,1886,2.545764954167822
STAT,1880,15,na,1895,2634.151300243501
SIM,1891,29,35-39,1920,7
SIM,1846,64,na,1910,602
STAT,1833,49,40-44,1882,0.07624127526345964
STAT,1850,27,na,1877,1175.523719511756
SIM,1883,6,na,1889,2272
STAT,1910,19,na,1929,3763.9083101678834
SIM,1873,39,35-39,1912,47
STAT,1883,29,35-39,1912,9.216340858836531
STAT,1934,32,25-29,1966,12.533891277904074
SIM,1874,27,35-39,1901,4
STAT,1851,39,40-44,1890,3.422522831925722
STAT,1904,25,15-19,1929,0.6526005958149365
SIM,1890,45,na,1935,3577
STAT,1928,32,50-100,1960,1.0259557056162294
STAT,1895,19,50-100,1914,0.06339040402539717
STAT,1849,37,35-39,1886,6.098232730633925
SIM,1876,30,na,1906,3806
STAT,1897,25,20-24,1922,15.685676321308515
SIM,1861,53,na,1914,1784
STAT,1925,20,15-19,1945,6.35118219179895
STAT,1933,24,30-34,1957,37.83933640899183
STAT,1875,18,45-49,1893,0.06690081890299222
SIM,1883,38,40-44,1921,42
STAT,1842,28,35-39,1870,2.940869965763769
STAT,1926,17,15-19,1943,55.165125094864614
STAT,1898,20,45-49,1918,0.9432948822611321
SIM,1943,28,20-24,1971,5
STAT,1880,28,20-24,1908,12.136188105563319
STAT,1848,24,50-100,1872,0.45798869651304075
STAT,1904,23,na,1927,3368.494417648958
SIM,1924,41,na,1965,5147
STAT,1900,16,40-44,1916,0.25399522886045506
SIM,1858,49,45-49,1907,3
STAT,1809,48,45-49,1857,2.0302768890841403
SIM,1850,28,35-39,1878,20
STAT,1918,35,45-49,1953,0.7155875899741594
STAT,1836,23,40-44,1859,2.0922175881602567
STAT,1943,16,50-100,1959,0.39286969355434875
STAT,1867,38,50-100,1905,1.1553541194370232
STAT,1929,26,30-34,1955,48.716324667965935
STAT,1913,36,20-24,1949,0.2581181766928738
STAT,1894,7,na,1901,3313.1234308982
STAT,1864,26,20-24,1890,10.70173446633933
STAT,1876,63,na,1939,1803.7674955063437
STAT,1844,31,na,1875,2594.34024483071
STAT,1896,16,15-19,1912,7.8423083904332
STAT,1801,69,na,1870,626.7081294550999
STAT,1826,33,25-29,1859,19.048123569941005
STAT,1935,28,20-24,1963,24.691605273565013
STAT,1903,17,20-24,1920,25.165849146032528
STAT,1908,42,25-29,1950,0.06555619485937902
STAT,1875,25,50-100,1900,0.6613259707847629
SIM,1827,72,na,1899,974
SIM,1906,23,25-29,1929,123
STAT,1804,99,na,1903,1.1999548968234586
STAT,1887,39,20-24,1926,0.8399134038515119
SIM,1857,37,35-39,1894,5
STAT,1814,49,30-34,1863,0.3220823568377139
STAT,1869,31,30-34,1900,17.690283968678667
STAT,1893,24,25-29,1917,71.1390813271595
STAT,1875,38,40-44,1913,4.472753058729234
STAT,1865,38,30-34,1903,4.841722262931218
SIM,1833,46,na,1879,2131
SIM,1867,32,25-29,1899,7
STAT,1858,15,40-44,1873,0.165099901299585
STAT,1909,22,na,1931,3510.679311522394
STAT,1865,48,25-29,1913,0.05192751144520596
STAT,1939,21,20-24,1960,110.48007694343138
STAT,1898,38,35-39,1936,2.0426999617887187
STAT,1928,21,45-49,1949,1.3983618719646553
STAT,1952,17,na,1969,4370.622269631629
SIM,1899,25,na,1924,2039
STAT,1846,97,na,1943,3.181768853766338
STAT,1810,84,na,1894,10.35732673076443
STAT,1831,35,na,1866,2151.720179744939
STAT,1832,35,15-19,1867,0.003993342359855685
STAT,1921,28,50-100,1949,1.0923107429614747
SIM,1878,74,na,1952,1359
STAT,1844,26,50-100,1870,0.781410553150221
SIM,1837,25,15-19,1862,2
SIM,1926,35,45-49,1961,1
STAT,1911,23,40-44,1934,3.1431828626296268
SIM,1899,23,30-34,1922,371
SIM,1844,20,na,1864,3007
SIM,1931,25,25-29,1956,27
STAT,1859,23,35-39,1882,4.764303576847198
STAT,1786,101,na,1887,0.2669471086299248
STAT,1837,31,35-39,1868,10.28725391601618
STAT,1870,29,15-19,1899,0.4490783419924074
SIM,1884,81,na,1965,1367
STAT,1874,26,30-34,1900,26.07858417825115
STAT,1824,38,35-39,1862,1.1304497183079614
STAT,1830,49,15-19,1879,3.3319092912090323E-4
STAT,1899,16,40-44,1915,0.2504348705285134
STAT,1905,32,50-100,1937,0.756712268265637
SIM,1902,31,na,1933,3447
STAT,1893,11,na,1904,3234.318636561054
SIM,1929,29,na,1958,4960
STAT,1917,39,50-100,1956,0.42765438014142365
SIM,1921,39,25-29,1960,3
STAT,1850,27,30-34,1877,13.683874008246423
STAT,1874,17,40-44,1891,0.1887681213396747
STAT,1829,64,na,1893,634.7954266329164
STAT,1863,45,na,1908,1939.865453853844
STAT,1900,25,30-34,1925,35.12078395782506
STAT,1944,22,40-44,1966,3.5895169214870166
SIM,1887,1,na,1888,5050
STAT,1837,25,15-19,1862,0.47370415863749155
STAT,1869,49,20-24,1918,0.011856156730178969
SIM,1894,26,na,1920,1649
SIM,1880,45,na,1925,3256
STAT,1834,32,20-24,1866,1.5259373630184572
STAT,1825,49,40-44,1874,0.21180440398225275
STAT,1905,37,25-29,1942,0.8938434576406606
STAT,1852,20,20-24,1872,83.6003287979019
STAT,1843,90,na,1933,77.89800727386567
SIM,1847,49,na,1896,1421
SIM,1852,8,na,1860,2713
STAT,1934,19,15-19,1953,60.64291569406463
STAT,1926,34,40-44,1960,4.685277184122004
SIM,1864,24,20-24,1888,1
SIM,1833,49,40-44,1882,6
STAT,1877,26,na,1903,2430.92205482741
STAT,1882,19,40-44,1901,0.17417416798056368
STAT,1848,25,25-29,1873,47.94250625107641
STAT,1891,29,35-39,1920,11.780759289155768
SIM,1853,33,35-39,1886,2
STAT,1819,43,35-39,1862,0.3800372059495754
STAT,1881,41,50-100,1922,1.0021721452610322
STAT,1927,29,25-29,1956,79.04699983625751
STAT,1831,28,25-29,1859,48.18513802976574
SIM,1865,78,na,1943,1399
STAT,1898,37,30-34,1935,7.166772751583234
STAT,1906,22,20-24,1928,99.79021063291965
SIM,1871,31,na,1902,1863
SIM,1879,59,na,1938,798
STAT,1819,37,15-19,1856,0.015063645628804663
STAT,1907,28,45-49,1935,1.6143372627304118
STAT,1865,34,15-19,1899,0.1289037811926722
SIM,1949,17,na,1966,4479
STAT,1822,101,na,1923,0.32905027057722647
SIM,1867,37,45-49,1904,2
STAT,1880,17,15-19,1897,6.160980308795313
SIM,1876,3,na,1879,5328
SIM,1882,26,30-34,1908,18
STAT,1864,0,na,1864,3477.565591541624
STAT,1863,9,na,1872,2373.381799873312
STAT,1867,36,40-44,1903,4.159861748115846
STAT,1914,15,30-34,1929,2.497833141876667
SIM,1913,37,25-29,1950,2
STAT,1830,50,na,1880,1682.6421460593322
STAT,1860,16,35-39,1876,0.5193226998171148
STAT,1815,83,na,1898,27.989804756395014
STAT,1860,22,20-24,1882,57.953007755668956
STAT,1853,26,45-49,1879,1.0045459497650968
STAT,1936,23,45-49,1959,1.0646915569094095
STAT,1909,21,35-39,1930,8.688341385432503
SIM,1844,83,na,1927,55
STAT,1879,38,25-29,1917,2.938945349825596
STAT,1838,36,20-24,1874,0.40120631755375535
STAT,1847,48,30-34,1895,0.08641884817957701
SIM,1875,34,25-29,1909,11
SIM,1833,21,15-19,1854,14
STAT,1848,27,40-44,1875,3.346458173256462
STAT,1925,16,45-49,1941,0.5993909285280498
STAT,1841,13,na,1854,3413.0
STAT,1862,29,15-19,1891,0.3836751279746332
STAT,1811,47,na,1858,1823.6145518571373
SIM,1898,62,na,1960,3708
STAT,1913,59,na,1972,3329.5708489452686
STAT,1824,37,30-34,1861,0.841541363109946
STAT,1906,49,35-39,1955,0.11196892151194333
STAT,1931,27,25-29,1958,84.3796029458126
STAT,1877,24,40-44,1901,2.1020745022424925
STAT,1898,25,50-100,1923,0.8660410119903206
STAT,1863,21,35-39,1884,5.117849562678327
STAT,1886,34,35-39,1920,10.397297990863361
SIM,1945,24,15-19,1969,16
STAT,1906,16,35-39,1922,0.796521487678838
SIM,1894,34,35-39,1928,4
STAT,1850,49,na,1899,1017.1989744817691
STAT,1928,36,na,1964,4722.782524308524
STAT,1867,31,20-24,1898,2.566810836214136
STAT,1856,18,35-39,1874,0.4632672409126982
STAT,1857,8,na,1865,2214.783319372799
STAT,1809,98,na,1907,3.162052227882953
STAT,1841,110,na,1951,3.077204285113808E-4
STAT,1845,33,35-39,1878,5.913289528242249
STAT,1838,37,25-29,1875,1.4830654810155155
STAT,1824,87,na,1911,34.095160353195716
STAT,1891,28,30-34,1919,30.857902553110428
SIM,1859,60,na,1919,1535
SIM,1880,67,na,1947,3193
STAT,1846,53,50-100,1899,0.008801149625490588
STAT,1899,21,15-19,1920,4.51963311435798
SIM,1910,60,na,1970,3129
STAT,1921,38,20-24,1959,0.2905579729455028
SIM,1911,45,na,1956,2353
STAT,1857,37,35-39,1894,5.427487083979268
STAT,1865,26,na,1891,2186.351724695704
SIM,1865,35,50-100,1900,80
STAT,1930,15,15-19,1945,58.532227484512624
STAT,1873,54,50-100,1927,0.015066070371193613
STAT,1823,53,50-100,1876,0.022229329377462102
STAT,1864,33,45-49,1897,1.5786294336331703
STAT,1946,22,50-100,1968,0.724310430997358
SIM,1827,50,na,1877,1988
STAT,1834,26,35-39,1860,5.616433078370694
STAT,1915,32,15-19,1947,0.1290281254270587
STAT,1856,24,20-24,1880,56.66319052319688
STAT,1879,37,20-24,1916,0.7907675019666671
SIM,1895,44,na,1939,4510
SIM,1879,37,na,1916,1312
STAT,1908,29,15-19,1937,0.6574611911525317
STAT,1862,82,na,1944,397.4073971985748
SIM,1847,27,na,1874,1712
STAT,1937,24,15-19,1961,5.126664293428252
STAT,1782,103,na,1885,0.1667289556759154
STAT,1821,39,20-24,1860,0.9018559362252414
STAT,1872,28,20-24,1900,11.706050443664207
STAT,1828,48,20-24,1876,0.014139271532573423
STAT,1829,42,na,1871,952.4861516521701
STAT,1844,21,25-29,1865,71.32145485010666
STAT,1867,34,25-29,1901,9.603804845059116
STAT,1909,20,30-34,1929,26.59832126971028
STAT,1835,38,45-49,1873,1.8454671582325757
STAT,1960,5,na,1965,5074.566959695598
SIM,1907,19,na,1926,4839
STAT,1903,24,45-49,1927,0.9836591232711773
STAT,1882,59,na,1941,1860.6925149984627
STAT,1895,39,20-24,1934,0.9926836071890873
STAT,1925,22,30-34,1947,34.08828355670775
STAT,1847,46,15-19,1893,3.6267325958747347E-4
STAT,1850,28,35-39,1878,5.205592634822102
STAT,1872,26,20-24,1898,11.787715282493046
STAT,1824,32,25-29,1856,4.571361952538114
STAT,1833,91,na,1924,23.841887445728478
STAT,1893,26,40-44,1919,3.758891398374045
STAT,1939,23,20-24,1962,110.40717212392909
STAT,1834,54,30-34,1888,0.0025854223219472583
STAT,1884,20,30-34,1904,17.152944186239917
SIM,1783,76,na,1859,1461
SIM,1821,67,na,1888,1505
STAT,1919,25,45-49,1944,1.854375045658535
STAT,1835,46,45-49,1881,0.19064492541859543
STAT,1838,47,25-29,1885,0.025296358882122612
STAT,1829,86,na,1915,81.02240923905305
STAT,1852,43,40-44,1895,2.247738598457183
STAT,1855,44,20-24,1899,0.1036894925716176
STAT,1870,48,50-100,1918,0.24177026859206974
STAT,1878,49,20-24,1927,0.012088647187280947
SIM,1834,35,40-44,1869,24
SIM,1902,19,na,1921,3611
STAT,1868,50,40-44,1918,0.01031447331439257
STAT,1931,8,na,1939,5183.7467354831615
STAT,1936,22,40-44,1958,3.182672309514859
STAT,1875,48,40-44,1923,0.1735882039623674
STAT,1876,29,45-49,1905,1.114392238911065
STAT,1916,30,15-19,1946,0.1319138458632197
STAT,1881,54,50-100,1935,0.0138700453381945
STAT,1841,31,15-19,1872,0.19441341395858477
STAT,1827,33,50-100,1860,0.9300634897423989
STAT,1889,42,25-29,1931,0.7723495028066947
SIM,1823,34,25-29,1857,21
STAT,1885,77,na,1962,1065.522453234446
STAT,1898,35,30-34,1933,7.234836460827594
STAT,1845,17,20-24,1862,11.11889140811178
STAT,1891,23,25-29,1914,70.17904894737032
STAT,1826,35,40-44,1861,7.537288820821319
SIM,1813,48,na,1861,213
SIM,1857,35,35-39,1892,1
STAT,1868,52,35-39,1920,0.008270973096462067
SIM,1840,31,20-24,1871,19
STAT,1858,33,35-39,1891,7.701042641728609
SIM,1890,25,25-29,1915,1
STAT,1850,37,25-29,1887,1.350556282385161
STAT,1893,39,45-49,1932,2.4678205453382396
STAT,1806,49,30-34,1855,0.27599623038873006
SIM,1883,11,na,1894,2241
SIM,1909,41,na,1950,3844
STAT,1870,31,40-44,1901,4.34108457675994
STAT,1842,16,40-44,1858,0.05865102108214786
STAT,1849,35,35-39,1884,6.226201665920899
STAT,1866,32,30-34,1898,15.937556796136223
STAT,1884,28,40-44,1912,2.8574767878515406
STAT,1829,49,25-29,1878,0.02595937601653392
STAT,1873,34,15-19,1907,0.1448282209867718
STAT,1855,31,50-100,1886,0.6238898975563457
STAT,1912,45,30-34,1957,0.0850764514735764
SIM,1851,45,40-44,1896,1
STAT,1919,48,50-100,1967,0.24139194540442283
SIM,1832,32,25-29,1864,7
STAT,1843,52,30-34,1895,0.005850075562179907
STAT,1874,5,na,1879,2842.0149911053227
STAT,1846,46,20-24,1892,0.007127309095669998
STAT,1844,44,45-49,1888,1.4801212310207323
STAT,1911,35,na,1946,3626.982290621831
SIM,1928,24,na,1952,4614
STAT,1867,44,50-100,1911,0.985632088680493
STAT,1943,6,na,1949,4165.556247438014
STAT,1815,41,15-19,1856,0.0014921716793767166
STAT,1819,50,45-49,1869,0.0026283567394706953
STAT,1960,4,na,1964,5075.632842592542
SIM,1853,76,na,1929,2003
STAT,1886,41,45-49,1927,1.5568585716568046
SIM,1880,78,na,1958,3051
STAT,1847,27,25-29,1874,45.96905702171481
STAT,1824,55,na,1879,438.0075793220871
SIM,1800,73,na,1873,216
STAT,1824,47,25-29,1871,0.009996924180182805
SIM,1846,29,25-29,1875,25
STAT,1798,85,na,1883,135.87758428928768
STAT,1877,43,45-49,1920,1.508295031772838
STAT,1895,8,na,1903,3381.6781565875017
STAT,1817,37,40-44,1854,3.4612916032471
STAT,1885,27,45-49,1912,1.0913717425203213
STAT,1910,45,50-100,1955,0.2096469697510218
STAT,1883,66,na,1949,1576.7985574783393
SIM,1823,46,na,1869,1328
STAT,1832,31,20-24,1863,0.17348242656530682
STAT,1829,54,20-24,1883,2.884749419362947E-4
STAT,1942,20,15-19,1962,5.52136887207826
STAT,1835,28,45-49,1863,1.0870145093857493
STAT,1876,51,30-34,1927,0.006046271450252074
SIM,1860,42,30-34,1902,5
STAT,1861,36,45-49,1897,1.6658485933926879
STAT,1833,30,25-29,1863,5.9650752646143275
STAT,1851,29,40-44,1880,2.730473893878835
STAT,1849,40,30-34,1889,0.9856313465777609
STAT,1901,20,50-100,1921,0.5735807542122987
STAT,1878,50,50-100,1928,0.015762052713353642
SIM,1837,29,30-34,1866,19
STAT,1886,18,20-24,1904,18.31068245939578
STAT,1835,47,50-100,1882,0.19587434125129566
STAT,1880,53,45-49,1933,0.014824224416128977
SIM,1889,36,40-44,1925,11
STAT,1859,54,35-39,1913,0.006635835648972707
STAT,1886,19,na,1905,2601.365871295905
SIM,1869,39,20-24,1908,9
STAT,1873,17,25-29,1890,5.8128145749422435
SIM,1868,10,na,1878,1405
STAT,1877,50,35-39,1927,0.008864817585141613
STAT,1786,84,na,1870,205.0867977155077
STAT,1849,48,40-44,1897,0.1424392015426066
STAT,1832,39,30-34,1871,0.43278424008341654
STAT,1852,25,40-44,1877,3.563023624403824
STAT,1898,28,40-44,1926,4.014005873982477
STAT,1807,63,na,1870,1017.139349148056
STAT,1865,29,40-44,1894,2.715376078104936
SIM,1909,21,na,1930,4182
STAT,1875,47,na,1922,2299.4834805556566
STAT,1870,33,35-39,1903,10.053402483813159
STAT,1882,25,25-29,1907,40.77457836817121
STAT,1818,36,45-49,1854,5.648881402368834
STAT,1882,30,20-24,1912,2.6087383721944404
SIM,1840,39,30-34,1879,21
STAT,1892,15,40-44,1907,0.22750327319087466
STAT,1855,39,25-29,1894,1.8863791111543635
STAT,1827,51,35-39,1878,0.007771177727409077
STAT,1816,68,na,1884,1474.8281319660475
STAT,1867,49,45-49,1916,0.2185322100265181
STAT,1835,51,40-44,1886,0.00828007976533499
STAT,1856,42,50-100,1898,0.7578661161470741
STAT,1858,99,na,1957,1.9973275554331988
STAT,1884,46,40-44,1930,0.16435033433206872
STAT,1829,36,20-24,1865,0.39783057305958597
STAT,1884,36,50-100,1920,1.1809409658347412
STAT,1863,46,50-100,1909,0.210267036459154
STAT,1796,74,na,1870,816.5136755261949
SIM,1862,49,na,1911,3416
STAT,1894,42,35-39,1936,0.1597098963132414
STAT,1894,38,na,1932,2981.1383280864593
STAT,1896,27,20-24,1923,15.464734960952923
SIM,1853,40,45-49,1893,3
SIM,1910,38,na,1948,4110
SIM,1890,30,20-24,1920,1
STAT,1925,39,50-100,1964,0.4982449871783121
STAT,1812,54,na,1866,215.95075799885953
STAT,1815,82,na,1897,32.89667241360891
STAT,1890,24,na,1914,2845.2212454876626
STAT,1849,28,45-49,1877,1.1010233605785282
SIM,1910,2,na,1912,4577
STAT,1885,42,40-44,1927,2.2082022359560196
STAT,1918,37,50-100,1955,0.4365678547661115
STAT,1834,24,35-39,1858,3.3903110845741984
STAT,1843,27,40-44,1870,3.6425023041990374
SIM,1867,47,45-49,1914,1
SIM,1814,85,na,1899,16
STAT,1891,30,15-19,1921,0.17653047264703203
STAT,1923,36,na,1959,4317.279570052758
STAT,1838,52,20-24,1890,3.13326583457826E-4
STAT,1866,27,50-100,1893,0.5839231840264201
STAT,1956,15,20-24,1971,177.92528201325302
STAT,1850,52,20-24,1902,3.3892893094857263E-4
STAT,1929,43,50-100,1972,0.15083538726012072
STAT,1801,90,na,1891,26.155211377542777
STAT,1834,21,30-34,1855,10.574771633445533
STAT,1840,32,50-100,1872,0.4394225351840663
STAT,1860,27,40-44,1887,2.469941659619111
STAT,1874,30,15-19,1904,0.14815559062034409
SIM,1847,39,40-44,1886,5
STAT,1848,41,25-29,1889,0.6079131217970737
STAT,1852,82,na,1934,469.656241867109
STAT,1942,19,na,1961,3800.0486646171134
SIM,1842,21,30-34,1863,3
SIM,1951,20,na,1971,2365
SIM,1878,37,20-24,1915,3
STAT,1871,30,45-49,1901,1.7535213771528673
STAT,1864,19,25-29,1883,5.2666816477503735
STAT,1888,43,20-24,1931,0.1819721456987954
STAT,1817,38,50-100,1855,0.9491931279594622
STAT,1820,73,na,1893,816.8318683659039
STAT,1844,51,35-39,1895,0.008569706872090637
STAT,1930,38,na,1968,4867.910318515602
STAT,1821,90,na,1911,39.81583609969717
SIM,1847,43,25-29,1890,6
STAT,1874,52,50-100,1926,0.015504064167944163
STAT,1885,47,50-100,1932,0.24028688540884124
SIM,1968,0,na,1968,3309
STAT,1834,47,40-44,1881,0.08001689677243164
STAT,1915,17,na,1932,3985.230123691594
SIM,1829,31,na,1860,2101
STAT,1881,29,25-29,1910,39.661741781784606
SIM,1847,7,na,1854,1827
SIM,1898,36,35-39,1934,10
STAT,1820,35,45-49,1855,4.185726679187546
STAT,1856,44,na,1900,1637.6485327142566
STAT,1859,47,45-49,1906,0.18617981244821472
STAT,1903,37,50-100,1940,0.37616690795538393
SIM,1893,42,40-44,1935,2
STAT,1813,71,na,1884,1118.1938949442142
STAT,1835,53,35-39,1888,0.006508134841293943
STAT,1896,45,20-24,1941,0.009012048445457204
SIM,1865,27,40-44,1892,13
STAT,1818,51,40-44,1869,0.018378071499642424
STAT,1870,16,45-49,1886,0.06613204132169771
STAT,1879,45,20-24,1924,0.012432804791049664
STAT,1899,31,30-34,1930,23.945113548132397
STAT,1825,39,40-44,1864,6.000698064590036
STAT,1922,19,na,1941,4189.682773681808
STAT,1835,27,na,1862,2133.212319234689
STAT,1840,35,15-19,1875,0.02670083128805551
STAT,1915,2,na,1917,4206.225254410818
STAT,1900,63,na,1963,2656.7832558892446
SIM,1875,12,na,1887,3165
STAT,1860,41,25-29,1901,0.526237051843674
STAT,1857,34,30-34,1891,13.283206002027349
STAT,1894,40,40-44,1934,2.8891723935692393
SIM,1933,6,na,1939,4652
STAT,1903,47,30-34,1950,0.07714858668595267
STAT,1848,37,40-44,1885,4.22137515671677
SIM,1857,40,30-34,1897,7
STAT,1820,34,35-39,1854,28.33846616653858
STAT,1928,30,35-39,1958,11.352493543904973
STAT,1837,17,50-100,1854,0.05235569736583537
STAT,1840,15,20-24,1855,9.145510488818118
SIM,1791,63,na,1854,1118
STAT,1882,32,15-19,1914,0.13634256799243716
SIM,1896,25,20-24,1921,110
SIM,1947,15,na,1962,4369
SIM,1852,44,45-49,1896,3
STAT,1837,48,20-24,1885,0.009860981609419475
STAT,1839,39,40-44,1878,4.760212106041575
STAT,1844,63,na,1907,1767.6904022311705
STAT,1848,19,40-44,1867,0.20968120252754058
STAT,1948,16,25-29,1964,49.09980401581723
STAT,1843,46,na,1889,2241.109178545337
STAT,1855,29,25-29,1884,28.764264085132382
STAT,1880,20,45-49,1900,0.728246859074638
STAT,1850,22,25-29,1872,31.727268284035976
STAT,1834,37,40-44,1871,2.3997044821730165
STAT,1891,38,25-29,1929,3.5230700101535617
STAT,1887,36,na,1923,2605.6419281123626
STAT,1937,20,35-39,1957,9.080736558224963
SIM,1830,48,na,1878,378
SIM,1855,47,na,1902,2996
STAT,1847,28,na,1875,2333.952308165251
STAT,1838,79,na,1917,298.1489850927565
STAT,1888,25,20-24,1913,13.631875165400954
STAT,1838,29,25-29,1867,22.641521072996245
STAT,1853,41,35-39,1894,1.4104376891541122
SIM,1880,19,50-100,1899,4
STAT,1839,46,30-34,1885,0.09281220538519537
STAT,1859,52,40-44,1911,0.008299717149535805
STAT,1855,27,na,1882,1646.3529471411944
STAT,1851,13,na,1864,2281.921273265761
SIM,1944,4,na,1948,2673
STAT,1857,27,40-44,1884,2.36767638714102
STAT,1928,23,45-49,1951,1.389844870569606
SIM,1842,49,na,1891,3011
STAT,1876,52,40-44,1928,0.01058583002439323
STAT,1864,83,na,1947,360.9033192123576
STAT,1864,63,na,1927,1622.1219671216
SIM,1842,29,na,1871,3218
STAT,1843,45,40-44,1888,0.1727344853953274
SIM,1879,8,na,1887,2049
STAT,1805,52,na,1857,464.9060603014399
SIM,1850,48,na,1898,1227
STAT,1847,42,20-24,1889,0.14438636336233124
SIM,1873,32,15-19,1905,3
STAT,1797,68,na,1865,29.369668499418065
STAT,1876,47,45-49,1923,0.2374620499760573
STAT,1840,33,20-24,1873,1.282969509478526
STAT,1844,26,45-49,1870,1.3562809129878013
STAT,1949,4,na,1953,4558.759524023352
SIM,1875,3,na,1878,3301
STAT,1948,23,15-19,1971,6.04753397268007
SIM,1817,38,45-49,1855,69
STAT,1818,53,35-39,1871,0.014440580971059882
STAT,1852,50,na,1902,2198.498373966254
STAT,1811,44,35-39,1855,8.895820353830313
SIM,1892,45,30-34,1937,1
STAT,1823,33,20-24,1856,6.249403322809082
STAT,1914,43,50-100,1957,0.11460878454914065
STAT,1861,40,30-34,1901,0.9657610190166218
STAT,1896,47,15-19,1943,2.960493788023527E-4
SIM,1924,42,na,1966,5123
STAT,1929,21,na,1950,4599.476683988137
SIM,1916,23,na,1939,4782
SIM,1792,69,na,1861,853
STAT,1845,36,50-100,1881,0.6467904144877706
STAT,1890,24,20-24,1914,82.90370490625169
STAT,1892,59,na,1951,2406.190972997874
SIM,1919,51,na,1970,4729
STAT,1948,12,na,1960,4449.438560810418
STAT,1885,44,35-39,1929,1.7559124204654375
STAT,1850,18,40-44,1868,0.10259798219358215
STAT,1856,64,na,1920,1248.5821096344469
STAT,1857,49,50-100,1906,0.1845289813934243
STAT,1840,28,25-29,1868,20.618958058261615
SIM,1858,5,na,1863,2651
STAT,1826,38,45-49,1864,3.1760046561886774
STAT,1829,39,25-29,1868,1.4126688235886913
STAT,1891,22,15-19,1913,4.056904690955264
SIM,1908,30,30-34,1938,1
STAT,1818,46,45-49,1864,0.4273656783296864
STAT,1819,39,15-19,1858,0.01279820517607814
SIM,1883,25,35-39,1908,1
STAT,1885,50,40-44,1935,0.01049685354194313
STAT,1860,19,40-44,1879,0.17006674677328926
STAT,1876,26,40-44,1902,3.038631728468442
SIM,1870,17,20-24,1887,181
SIM,1807,49,40-44,1856,1
SIM,1929,41,na,1970,6204
STAT,1820,42,35-39,1862,2.9896343761601294
STAT,1936,25,45-49,1961,1.6383713620516829
STAT,1939,26,25-29,1965,65.47144262219528
STAT,1868,53,45-49,1921,0.013792057938153267
STAT,1835,43,40-44,1878,2.0132137677033786
SIM,1878,29,20-24,1907,2
SIM,1912,3,na,1915,4905
STAT,1872,51,45-49,1923,0.014601675813553372
STAT,1839,25,25-29,1864,50.22890045684339
SIM,1855,24,20-24,1879,16
SIM,1898,26,40-44,1924,32
STAT,1858,48,40-44,1906,0.1290965836918945
STAT,1917,26,50-100,1943,1.033440310011429
STAT,1856,38,50-100,1894,0.8774567245025766
STAT,1862,17,20-24,1879,17.294174659815297
SIM,1860,78,na,1938,1638
STAT,1882,49,na,1931,2109.0463320976332
STAT,1830,39,20-24,1869,0.6886630019516575
SIM,1918,34,na,1952,4290
STAT,1850,25,30-34,1875,13.882511192196379
STAT,1840,25,20-24,1865,5.843216125105281
STAT,1891,19,40-44,1910,0.22371494303833261
STAT,1846,49,25-29,1895,0.03340194643985632
STAT,1914,44,50-100,1958,0.11440821917617966
STAT,1878,39,20-24,1917,0.7851204767648201
STAT,1844,43,35-39,1887,1.8139183686842058
STAT,1898,36,40-44,1934,5.914833601723194
STAT,1885,37,45-49,1922,1.959496480196935
SIM,1831,33,na,1864,2063
STAT,1882,22,20-24,1904,65.97752867073083
STAT,1847,83,na,1930,358.92267360040745
STAT,1865,33,25-29,1898,9.311943331780402
STAT,1847,44,15-19,1891,0.012317167582043693
SIM,1835,47,na,1882,1206
STAT,1849,34,50-100,1883,0.7967970846664604
STAT,1902,48,25-29,1950,0.04517793161816174
STAT,1873,35,25-29,1908,2.9814708022480834
STAT,1873,41,50-100,1914,1.0885902458425725
SIM,1894,40,35-39,1934,2
STAT,1886,40,35-39,1926,1.894109718970442
STAT,1823,41,20-24,1864,0.2727688353873618
STAT,1876,54,35-39,1930,0.008463641228275228
SIM,1904,22,na,1926,3289
SIM,1895,12,na,1907,4648
STAT,1866,54,25-29,1920,0.003144304353734681
STAT,1894,17,45-49,1911,0.08306792108442262
SIM,1911,55,na,1966,2221
STAT,1919,22,40-44,1941,3.632936260958684
STAT,1893,29,45-49,1922,1.3785413224026706
SIM,1890,22,20-24,1912,1
STAT,1935,37,na,1972,5222.900059588438
STAT,1849,31,na,1880,2136.6470216012394
STAT,1890,32,20-24,1922,3.2723425603222505
STAT,1875,25,35-39,1900,9.975242918252853
STAT,1859,37,45-49,1896,1.5800228468428785
STAT,1894,35,45-49,1929,2.5591099172276417
STAT,1859,30,50-100,1889,0.7367882351892436
SIM,1863,11,na,1874,1639
SIM,1901,57,na,1958,2890
STAT,1856,105,na,1961,0.06617817684579516
STAT,1880,15,15-19,1895,6.189605121828427
STAT,1880,50,40-44,1930,0.011086385210414995
STAT,1836,27,20-24,1863,11.632158003637834
STAT,1852,28,45-49,1880,1.2923889215226017
SIM,1859,61,na,1920,1535
STAT,1846,98,na,1944,1.9239838081839673
STAT,1842,84,na,1926,82.58179776431703
STAT,1810,83,na,1893,12.360020920515566
STAT,1815,42,25-29,1857,0.06822435232163963
STAT,1885,19,45-49,1904,0.06386437620364158
SIM,1867,25,na,1892,2317
SIM,1867,48,na,1915,2094
STAT,1857,81,na,1938,414.96182027427164
STAT,1817,53,na,1870,833.8912169894253
SIM,1849,33,35-39,1882,5
STAT,1827,44,45-49,1871,1.3826401290707635
STAT,1910,47,20-24,1957,0.010195352577732394
STAT,1913,33,50-100,1946,0.8088503663703163
SIM,1878,64,na,1942,2163
SIM,1829,29,25-29,1858,13
SIM,1898,33,30-34,1931,58
STAT,1807,47,25-29,1854,0.20261791555117337
STAT,1928,15,45-49,1943,0.6275519629904089
STAT,1840,18,25-29,1858,2.8719106233960487
SIM,1930,38,na,1968,5256
STAT,1791,75,na,1866,527.0172433320396
STAT,1831,49,50-100,1880,0.22571517341459735
STAT,1877,40,40-44,1917,2.3063248501214826
STAT,1852,109,na,1961,0.002389219130326081
STAT,1874,38,25-29,1912,2.9567842329112914
STAT,1821,35,na,1856,1482.0987342661147
SIM,1844,52,na,1896,2237
STAT,1832,41,15-19,1873,0.0012002310058436033
STAT,1842,24,40-44,1866,0.6431244699565069
STAT,1831,45,na,1876,1937.1643925894048
STAT,1861,11,na,1872,2292.313358067038
SIM,1894,58,na,1952,1169
STAT,1910,18,na,1928,3774.2876010708314
STAT,1933,26,na,1959,4942.586003826049
STAT,1888,38,25-29,1926,3.3065824717387664
SIM,1822,38,25-29,1860,21
STAT,1824,31,15-19,1855,0.06594485133389147
STAT,1814,45,15-19,1859,0.0014044996490676623
STAT,1918,21,35-39,1939,10.04859152363691
SIM,1882,38,25-29,1920,5
STAT,1849,43,35-39,1892,1.5147551128855914
STAT,1849,105,na,1954,0.024705359286275458
STAT,1839,43,25-29,1882,0.6207923210326406
STAT,1832,34,25-29,1866,0.6965632057701752
SIM,1847,25,25-29,1872,200
SIM,1861,41,35-39,1902,7
SIM,1926,21,35-39,1947,1002
STAT,1881,36,15-19,1917,0.05328466849258809
STAT,1947,25,20-24,1972,20.45150055060199
STAT,1861,33,40-44,1894,3.5913798820006315
STAT,1856,40,20-24,1896,0.11521901222744822
STAT,1879,53,20-24,1932,7.448328675103115E-4
SIM,1896,38,25-29,1934,5
STAT,1834,29,40-44,1863,1.7063638544704667
STAT,1881,26,20-24,1907,11.116588547120635
STAT,1916,20,15-19,1936,5.534714801499358
SIM,1871,28,20-24,1899,68
STAT,1866,28,45-49,1894,1.0099379297415103
STAT,1844,36,45-49,1880,2.31729248451174
SIM,1840,34,25-29,1874,1
SIM,1890,44,na,1934,3570
STAT,1824,35,30-34,1859,0.8254355028908053
STAT,1852,46,45-49,1898,0.23822921308757725
STAT,1863,28,20-24,1891,9.980030413039094
STAT,1865,57,na,1922,1834.7751528077122
STAT,1896,48,25-29,1944,0.042292654758985596
SIM,1865,77,na,1942,1399
STAT,1845,17,na,1862,1439.6439893265156
STAT,1888,45,15-19,1933,4.662676951701534E-4
STAT,1851,65,na,1916,1334.7198438117075
STAT,1855,36,20-24,1891,0.5126314124405027
STAT,1837,30,na,1867,2224.512970904233
STAT,1834,65,na,1899,744.7753797953592
STAT,1881,31,na,1912,2262.716766356689
SIM,1830,27,20-24,1857,1
SIM,1898,72,na,1970,2931
STAT,1859,104,na,1963,0.2157966484573075
STAT,1839,50,50-100,1889,0.014380591094773059
SIM,1850,49,40-44,1899,2
STAT,1874,93,na,1967,104.67614392896289
STAT,1916,34,na,1950,3818.4595716032154
STAT,1866,36,25-29,1902,2.6408346651205923
STAT,1893,76,na,1969,1594.3765337739212
SIM,1849,49,45-49,1898,3
STAT,1930,25,50-100,1955,1.2578385738426285
STAT,1829,28,20-24,1857,7.819303948573354
STAT,1842,49,40-44,1891,0.04161209702269728
STAT,1871,19,15-19,1890,5.888225711899219
STAT,1892,44,25-29,1936,0.05446471836744916
STAT,1845,40,45-49,1885,0.7758911797069249
STAT,1857,17,40-44,1874,0.1649628559448776
STAT,1910,46,50-100,1956,0.20918364994787195
STAT,1864,42,20-24,1906,0.14420015132773503
STAT,1875,22,30-34,1897,18.290582551064112
STAT,1829,29,30-34,1858,15.363404977063555
STAT,1857,38,na,1895,1798.9188786021682
STAT,1955,14,na,1969,5167.1881255397975
SIM,1827,42,45-49,1869,3
STAT,1870,48,na,1918,2214.758180847816
SIM,1872,42,20-24,1914,1
STAT,1898,43,30-34,1941,0.10658038145664694
STAT,1844,18,45-49,1862,0.0817784194210287
STAT,1891,15,25-29,1906,7.0009157313361925
SIM,1917,40,na,1957,2043
STAT,1912,20,na,1932,3636.3300833575995
STAT,1911,49,30-34,1960,0.08295459142934952
STAT,1808,49,na,1857,770.372013725682
SIM,1837,28,20-24,1865,7
STAT,1926,20,30-34,1946,34.82438305183977
STAT,1870,26,45-49,1896,1.1106965513150537
STAT,1854,25,15-19,1879,0.2948314087329671
STAT,1863,38,20-24,1901,0.6548190805943165
STAT,1881,16,20-24,1897,16.78301741028906
STAT,1853,42,45-49,1895,1.1590491406905963
SIM,1836,64,na,1900,1264
STAT,1825,53,25-29,1878,0.0042592422984425865
STAT,1835,25,40-44,1860,2.9968210903945165
STAT,1883,24,30-34,1907,17.02891028267092
STAT,1863,46,na,1909,1926.1700037496364
STAT,1832,26,25-29,1858,52.09899755568558
STAT,1876,44,40-44,1920,2.2431188336461387
STAT,1815,39,30-34,1854,0.5832843931211582
STAT,1855,26,20-24,1881,8.15151819282582
STAT,1888,46,25-29,1934,0.06666857724888359
STAT,1852,38,45-49,1890,1.9966668193572674
SIM,1884,44,40-44,1928,18
STAT,1850,48,na,1898,1025.8365179630173
STAT,1868,45,45-49,1913,0.23021804151188682
SIM,1876,45,45-49,1921,3
STAT,1860,37,40-44,1897,3.5711325132688803
STAT,1896,19,20-24,1915,23.24492775786041
STAT,1849,25,40-44,1874,3.0354424890458014
STAT,1880,38,50-100,1918,1.268264666590571
SIM,1962,2,na,1964,4683
STAT,1893,46,35-39,1939,0.09903664406022311
STAT,1777,112,na,1889,0.002041456382520228
STAT,1965,1,na,1966,4866.767595500231
STAT,1831,50,45-49,1881,0.01252480242051533
STAT,1861,43,35-39,1904,1.49507187613228
STAT,1839,18,35-39,1857,0.6629476316379176
STAT,1850,21,15-19,1871,1.8416429829444407
SIM,1823,39,30-34,1862,12
SIM,1840,26,25-29,1866,193
SIM,1824,33,30-34,1857,117
SIM,1907,18,na,1925,4701
STAT,1840,36,25-29,1876,1.3548822517881276
STAT,1900,43,45-49,1943,0.14293236323707412
SIM,1897,6,na,1903,3017
STAT,1809,53,40-44,1862,0.08517980031346757
STAT,1921,25,na,1946,4153.589084067567
STAT,1888,28,25-29,1916,48.65090838310216
SIM,1848,65,na,1913,2307
STAT,1862,29,na,1891,2018.1716631383563
STAT,1804,102,na,1906,0.18575578902526166
STAT,1832,33,15-19,1865,0.009486966274059573
STAT,1887,19,50-100,1906,0.0536348637480343
STAT,1843,53,40-44,1896,0.010234776797803302
STAT,1860,22,35-39,1882,4.907435539451466
STAT,1881,19,25-29,1900,5.322664087452622
STAT,1855,46,15-19,1901,2.6548599598387435E-4
STAT,1829,46,20-24,1875,0.005623031731404223
STAT,1822,37,20-24,1859,1.5551160580541186
SIM,1805,72,na,1877,1785
STAT,1845,29,15-19,1874,0.27010843047947775
STAT,1857,35,40-44,1892,3.3910288217555338
STAT,1865,15,25-29,1880,5.928283599123476
STAT,1813,44,50-100,1857,4.297287509860264
SIM,1899,26,na,1925,2090
STAT,1894,43,45-49,1937,0.13120845488687838
STAT,1904,48,50-100,1952,0.1954429002124155
STAT,1903,39,30-34,1942,1.6164894840999284
STAT,1873,27,25-29,1900,43.39193558415402
STAT,1897,41,20-24,1938,0.01471242924603881
STAT,1827,107,na,1934,0.003325650769238247
STAT,1842,23,30-34,1865,5.537149264962371
SIM,1801,67,na,1868,1783
STAT,1826,48,45-49,1874,0.33327841529950636
SIM,1839,27,40-44,1866,1
SIM,1789,69,na,1858,303
STAT,1837,38,20-24,1875,0.7447593870317784
STAT,1839,96,na,1935,7.977572398443256
STAT,1835,82,na,1917,353.0419838161798
STAT,1811,68,na,1879,1070.9162922335188
SIM,1834,22,35-39,1856,1
STAT,1865,36,30-34,1901,4.889276547885165
SIM,1810,44,40-44,1854,6
STAT,1847,45,25-29,1892,0.05259632292312747
STAT,1884,37,50-100,1921,1.1752842586083918
STAT,1896,37,20-24,1933,1.0161550723720343
SIM,1873,36,30-34,1909,5
STAT,1886,15,45-49,1901,0.06795901378720272
STAT,1819,42,45-49,1861,0.3507582415096545
STAT,1893,12,na,1905,3229.499501792578
STAT,1857,42,30-34,1899,0.8811249050505597
STAT,1849,32,30-34,1881,15.502161438907589
SIM,1887,25,na,1912,3785
STAT,1827,52,45-49,1879,0.012843037038394007
STAT,1921,38,35-39,1959,2.666013739687273
STAT,1938,22,15-19,1960,5.211949789718088
SIM,1874,29,35-39,1903,1
SIM,1863,19,30-34,1882,4
STAT,1880,14,na,1894,2672.3637881314066
SIM,1857,32,30-34,1889,1
STAT,1852,45,35-39,1897,0.14232724509083572
STAT,1898,18,40-44,1916,0.24530841786467952
STAT,1839,42,15-19,1881,0.01352251500295299
STAT,1874,31,25-29,1905,10.61424891078902
SIM,1859,38,20-24,1897,3
STAT,1850,28,na,1878,1167.0834592056608
SIM,1949,21,30-34,1970,25
STAT,1883,17,40-44,1900,0.17596064270078904
STAT,1886,33,45-49,1919,1.7981947052805665
STAT,1855,19,30-34,1874,1.2399390921055164
STAT,1896,61,na,1957,2509.755042114137
STAT,1876,22,50-100,1898,0.41223859983960837
STAT,1835,50,30-34,1885,0.004775372405497859
SIM,1874,2,na,1876,2818
STAT,1848,14,na,1862,2744.1817893478365
STAT,1885,34,40-44,1919,4.226276546151825
STAT,1949,23,30-34,1972,33.195769736727016
STAT,1862,31,35-39,1893,8.66088738885723
STAT,1883,28,25-29,1911,40.552544913911376
SIM,1847,47,40-44,1894,1
STAT,1841,28,40-44,1869,4.113420825529395
STAT,1781,85,na,1866,91.91020085503469
STAT,1888,42,na,1930,2664.2648494500277
STAT,1919,49,35-39,1968,0.13717608429696987
SIM,1891,61,na,1952,1306
STAT,1860,47,35-39,1907,0.11367844669681886
STAT,1858,105,na,1963,0.09717103428739195
STAT,1848,47,35-39,1895,0.13039766963457713
STAT,1868,27,45-49,1895,1.0724094291044226
SIM,1847,28,na,1875,962
SIM,1843,14,na,1857,761
SIM,1851,33,na,1884,1232
STAT,1844,40,30-34,1884,1.1967643897853864
STAT,1947,20,15-19,1967,5.956921719273287
STAT,1874,34,30-34,1908,17.865313095040896
SIM,1882,34,30-34,1916,10
STAT,1924,22,15-19,1946,6.220942869664073
SIM,1942,16,na,1958,2960
STAT,1911,43,20-24,1954,0.01656593171075392
SIM,1838,24,20-24,1862,2
STAT,1905,62,na,1967,2885.6518804233424
STAT,1848,33,25-29,1881,10.066493209258004
STAT,1888,35,20-24,1923,0.8981352595191429
STAT,1840,41,20-24,1881,0.06607251535652166
SIM,1891,0,na,1891,2852
STAT,1818,48,50-100,1866,0.4313956952870528
STAT,1854,48,20-24,1902,0.006588375820524264
STAT,1829,54,50-100,1883,0.005904120244536593
SIM,1931,5,na,1936,5411
SIM,1828,45,na,1873,1714
SIM,1824,31,na,1855,2442
STAT,1935,21,35-39,1956,12.734069254675173
STAT,1852,17,40-44,1869,0.22267166110814748
STAT,1902,45,20-24,1947,0.009626865722396474
STAT,1836,34,45-49,1870,1.6543247427065702
STAT,1865,41,25-29,1906,0.5889364306726281
STAT,1892,26,25-29,1918,52.55285898798045
STAT,1856,32,20-24,1888,1.9652517529711704
SIM,1891,28,25-29,1919,107
STAT,1857,38,45-49,1895,1.5221373605209756
STAT,1870,79,na,1949,696.9611877167292
STAT,1928,35,na,1963,4726.658384183555
STAT,1802,52,40-44,1854,0.05348073542165392
STAT,1895,26,15-19,1921,0.5922345897910705
SIM,1923,1,na,1924,4291
STAT,1845,32,45-49,1877,1.0288624030972429
SIM,1833,35,25-29,1868,8
STAT,1947,18,na,1965,4101.250709831978
SIM,1854,53,45-49,1907,1
STAT,1830,29,20-24,1859,11.119113358047926
STAT,1828,35,15-19,1863,0.07882452804545494
SIM,1807,52,na,1859,1094
STAT,1928,1,na,1929,5221.973738121997
STAT,1883,20,15-19,1903,3.1927403386360824
STAT,1825,35,25-29,1860,4.3633067937627885
STAT,1853,27,20-24,1880,10.537813425681875
SIM,1917,31,35-39,1948,3
SIM,1815,71,na,1886,482
SIM,1852,33,40-44,1885,72
STAT,1877,35,45-49,1912,2.0428475675011653
SIM,1954,9,na,1963,5556
STAT,1872,46,15-19,1918,4.0168071761272853E-4
STAT,1843,15,50-100,1858,0.06259494887523831
STAT,1836,41,35-39,1877,1.671992679003631
STAT,1951,16,50-100,1967,0.4421130294797627
STAT,1839,54,30-34,1893,0.005378231995060683
STAT,1850,26,40-44,1876,1.6395650321637414
STAT,1848,48,25-29,1896,0.05322335074242355
STAT,1869,36,15-19,1905,0.056937280517843254
STAT,1843,69,na,1912,1449.9985177851036
SIM,1834,62,na,1896,44
STAT,1841,29,30-34,1870,34.33077140292407
STAT,1859,44,40-44,1903,1.7586955211976152
STAT,1825,34,35-39,1859,15.757838444038834
STAT,1902,47,15-19,1949,3.162463710862296E-4
SIM,1849,48,50-100,1897,2
SIM,1847,80,na,1927,1382
SIM,1875,20,30-34,1895,892
STAT,1869,40,35-39,1909,1.8456970862596556
SIM,1946,5,na,1951,3823
STAT,1909,31,35-39,1940,8.667006636899522
STAT,1871,22,45-49,1893,0.6956086921011574
SIM,1927,39,na,1966,1617
SIM,1927,38,na,1965,1625
STAT,1860,58,na,1918,1613.308538324044
SIM,1812,47,50-100,1859,3
SIM,1923,25,na,1948,4291
STAT,1851,88,na,1939,108.42556009275881
STAT,1924,15,25-29,1939,51.346721920507825
STAT,1849,54,25-29,1903,0.002902400301540222
STAT,1851,25,25-29,1876,39.68554294677653
STAT,1844,33,40-44,1877,5.0846287283324925
SIM,1833,28,35-39,1861,1
STAT,1839,47,40-44,1886,0.16205761198300106
STAT,1831,45,15-19,1876,3.8703735387857425E-4
STAT,1851,43,25-29,1894,0.5035071671968357
STAT,1889,16,25-29,1905,6.8407760523957215
SIM,1844,41,35-39,1885,12
SIM,1865,38,25-29,1903,1
STAT,1857,50,na,1907,1676.001463847572
SIM,1870,6,na,1876,2833
STAT,1862,35,50-100,1897,1.0556501979889468
SIM,1838,44,na,1882,1870
STAT,1862,40,45-49,1902,1.2876125244959145
STAT,1892,25,35-39,1917,12.027326256680283
STAT,1872,39,25-29,1911,2.854094477752303
STAT,1912,37,30-34,1949,1.7581942728414708
SIM,1896,17,20-24,1913,257
STAT,1882,29,40-44,1911,2.847485595632234
STAT,1892,19,35-39,1911,0.6757101720153104
STAT,1888,17,20-24,1905,20.461627440477184
STAT,1841,99,na,1940,2.108944081714372
STAT,1848,40,15-19,1888,0.013241971640884215
SIM,1853,8,na,1861,3646
STAT,1895,24,na,1919,3057.366424552605
STAT,1860,40,15-19,1900,0.011379628354162655
STAT,1915,17,25-29,1932,8.941701811808938
SIM,1917,49,na,1966,1988
STAT,1841,21,20-24,1862,97.91548772486288
STAT,1852,2,na,1854,3645.9999999999995
SIM,1913,35,na,1948,3110
STAT,1827,37,20-24,1864,0.7601144095335161
STAT,1831,38,25-29,1869,2.887903985105803
STAT,1850,18,50-100,1868,0.027481595690442555
STAT,1892,18,45-49,1910,0.08066349685710732
STAT,1950,19,50-100,1969,0.43848408128311195
STAT,1852,35,40-44,1887,4.523217526496759
SIM,1921,13,na,1934,5331
STAT,1857,53,20-24,1910,5.571591050885994E-4
STAT,1932,17,25-29,1949,56.98306598110904
STAT,1826,77,na,1903,689.1246133580165
STAT,1834,96,na,1930,3.784185191745109
STAT,1814,97,na,1911,3.6358505682332884
STAT,1858,8,na,1866,2190.5883607067863
SIM,1903,37,30-34,1940,5
STAT,1889,34,25-29,1923,12.228798141416856
SIM,1929,30,15-19,1959,2
STAT,1853,16,45-49,1869,0.061290051243674225
SIM,1893,47,50-100,1940,1
STAT,1839,29,40-44,1868,3.4558857264365446
STAT,1872,43,45-49,1915,1.4878489065177216
STAT,1841,35,30-34,1876,7.139130806921047
STAT,1893,18,40-44,1911,0.2281261020581075
SIM,1890,13,na,1903,4013
STAT,1877,28,20-24,1905,11.86691581955378
STAT,1803,51,45-49,1854,0.0324030607225589
STAT,1856,39,40-44,1895,3.112512414770964
STAT,1891,10,na,1901,3185.3983558223945
STAT,1898,31,15-19,1929,0.19228057261731857
STAT,1844,32,na,1876,2567.540710101611
STAT,1821,49,20-24,1870,0.01249450281146715
SIM,1844,51,na,1895,2237
SIM,1894,27,na,1921,1475
STAT,1810,46,40-44,1856,9.110232033618916E-4
SIM,1880,14,na,1894,3338
STAT,1811,50,40-44,1861,0.04929518284734428
STAT,1870,23,40-44,1893,2.0709988496969474
STAT,1899,37,na,1936,3243.3441649152196
SIM,1919,16,20-24,1935,961
STAT,1873,40,20-24,1913,0.1645509642552815
STAT,1889,48,35-39,1937,0.09390471713927255
STAT,1861,15,40-44,1876,0.176910771717699
STAT,1862,24,45-49,1886,0.5993074509547383
STAT,1902,11,na,1913,3642.0137581132103
STAT,1842,27,25-29,1869,12.986172704765892
STAT,1917,15,35-39,1932,0.8950609861025574
SIM,1912,35,30-34,1947,2
STAT,1851,18,35-39,1869,0.5237908149997313
STAT,1893,7,na,1900,3258.070382112383
STAT,1894,28,20-24,1922,14.865887422952975
SIM,1866,94,na,1960,134
STAT,1861,98,na,1959,4.929779380757953
SIM,1826,66,na,1892,1048
STAT,1895,23,na,1918,3067.119865725612
STAT,1898,46,35-39,1944,0.10649602235719842
STAT,1884,83,na,1967,674.1879098742153
SIM,1862,80,na,1942,1477
STAT,1883,46,25-29,1929,0.055571017337282695
STAT,1889,49,25-29,1938,0.03830977583232402
STAT,1851,24,35-39,1875,5.425077356335965
STAT,1939,33,15-19,1972,0.1295941260747408
STAT,1833,29,45-49,1862,0.6480428333490489
STAT,1842,27,45-49,1869,0.3408535175327073
STAT,1904,35,30-34,1939,1.6590981340376065
STAT,1874,15,50-100,1889,0.050987376293882926
SIM,1841,36,35-39,1877,6
SIM,1881,24,20-24,1905,1
STAT,1876,64,na,1940,1757.3204824970553
STAT,1872,50,na,1922,2187.0791178627937
STAT,1805,101,na,1906,0.07655653806108977
STAT,1897,33,20-24,1930,3.574653441540667
STAT,1906,24,na,1930,3403.3196276800372
SIM,1849,39,na,1888,2280
STAT,1930,25,30-34,1955,49.5156194158027
STAT,1909,21,na,1930,3521.2783593841423
SIM,1889,39,45-49,1928,5
STAT,1847,49,40-44,1896,0.15155303373795553
STAT,1902,10,na,1912,3647.594577817271
STAT,1877,51,45-49,1928,0.01480233307875731
STAT,1833,22,25-29,1855,53.49623463173848
STAT,1879,61,na,1940,1916.9208226779774
STAT,1919,7,na,1926,4358.706217244493
STAT,1870,42,45-49,1912,1.4902132222385809
SIM,1916,54,na,1970,4520
STAT,1832,42,25-29,1874,0.05650863660191444
STAT,1897,47,30-34,1944,0.07217789415161885
SIM,1912,40,na,1952,4587
SIM,1815,39,45-49,1854,6
STAT,1936,5,na,1941,3811.2648405060945
SIM,1850,27,25-29,1877,6
STAT,1832,23,20-24,1855,90.20653355194347
STAT,1802,54,35-39,1856,0.04193763399170411
SIM,1874,32,30-34,1906,2
STAT,1889,41,15-19,1930,0.01670538971943841
STAT,1910,39,20-24,1949,0.24678525785122948
SIM,1873,32,na,1905,1982
STAT,1851,17,45-49,1868,0.06272549099359069
STAT,1852,42,30-34,1894,1.1558174099488778
STAT,1883,26,50-100,1909,0.6175236405913148
STAT,1868,38,20-24,1906,0.7408475553435139
STAT,1922,10,na,1932,4548.162108130453
STAT,1833,36,35-39,1869,3.8764369309323246
STAT,1926,24,na,1950,4370.928310924144
STAT,1949,16,40-44,1965,1.6111598849264162
STAT,1859,61,na,1920,1481.0667597596216
SIM,1865,49,50-100,1914,5
STAT,1867,28,na,1895,2249.0621098807287
STAT,1942,6,na,1948,4110.750877648395
SIM,1846,63,na,1909,602
STAT,1833,37,25-29,1870,1.5581833185937337
SIM,1862,81,na,1943,1477
SIM,1848,39,35-39,1887,45
SIM,1908,35,na,1943,2644
SIM,1858,44,na,1902,2325
SIM,1904,21,na,1925,4172
STAT,1842,45,25-29,1887,0.01467245352050366
STAT,1867,80,na,1947,585.0251087502478
STAT,1831,42,45-49,1873,1.462690385555984
STAT,1897,15,20-24,1912,23.65380128403411
SIM,1893,32,na,1925,3235
STAT,1790,89,na,1879,51.597516241484875
STAT,1853,34,45-49,1887,1.3638052717732219
SIM,1838,49,40-44,1887,1
STAT,1865,19,40-44,1884,0.17005785508968438
STAT,1898,39,45-49,1937,0.5727768061681539
STAT,1892,48,40-44,1940,0.1180617041084594
STAT,1907,10,na,1917,3779.5365471255654
STAT,1895,49,20-24,1944,0.008621750975656869
STAT,1848,44,30-34,1892,1.061308588694054
STAT,1858,30,30-34,1888,13.613158048957928
STAT,1879,27,20-24,1906,12.034590158668264
STAT,1850,19,30-34,1869,0.888802033823294
STAT,1866,21,25-29,1887,53.06252093226987
SIM,1939,20,30-34,1959,28
STAT,1860,44,30-34,1904,0.9252305824700202
STAT,1855,47,na,1902,1482.084761664458
SIM,1831,34,na,1865,2047
SIM,1864,35,25-29,1899,6
STAT,1890,79,na,1969,1272.6143315566935
STAT,1920,39,na,1959,4057.5509215676493
STAT,1878,75,na,1953,1059.181856316776
STAT,1885,3,na,1888,2894.3198282451217
SIM,1824,34,20-24,1858,3
STAT,1889,38,40-44,1927,5.245351759048228
SIM,1844,31,40-44,1875,22
SIM,1897,38,40-44,1935,1
STAT,1828,32,45-49,1860,2.641205397029416
STAT,1856,35,25-29,1891,2.0876335934869847
SIM,1790,78,na,1868,1197
STAT,1820,40,40-44,1860,3.851496174260833
STAT,1823,43,15-19,1866,0.022640611611090936
SIM,1903,36,na,1939,2833
STAT,1812,85,na,1897,21.70996073761682
SIM,1869,91,na,1960,1043
SIM,1891,25,20-24,1916,65
STAT,1897,18,25-29,1915,7.505992346135419
STAT,1887,18,15-19,1905,6.514887082856604
STAT,1847,53,25-29,1900,0.0031509760413461698
SIM,1833,31,30-34,1864,53
SIM,1907,42,30-34,1949,2
SIM,1886,39,na,1925,2990
SIM,1882,25,na,1907,1352
SIM,1882,37,35-39,1919,7
STAT,1839,51,25-29,1890,0.0033065091448990546
STAT,1840,18,na,1858,1163.3352807854453
SIM,1919,20,na,1939,5177
STAT,1834,43,25-29,1877,0.33683497091197195
STAT,1883,25,20-24,1908,11.36273192583925
STAT,1892,22,30-34,1914,22.053277856908778
SIM,1907,24,30-34,1931,1
STAT,1860,33,25-29,1893,8.3205747694277
STAT,1895,23,45-49,1918,0.9043234219048969
STAT,1855,58,na,1913,1308.8461398743643
STAT,1936,23,na,1959,3455.504032619775
STAT,1861,29,20-24,1890,9.686648176352415
STAT,1919,46,30-34,1965,0.09564387843375736
STAT,1911,46,25-29,1957,0.04977588681343345
STAT,1884,23,35-39,1907,5.568882810300372
STAT,1836,31,40-44,1867,4.2443225439512275
SIM,1903,9,na,1912,3057
STAT,1899,39,40-44,1938,1.2775449514841208
STAT,1870,30,30-34,1900,17.546084024976462
STAT,1822,53,20-24,1875,0.0011656847963112513
STAT,1866,10,na,1876,2488.690803922794
STAT,1864,37,25-29,1901,2.6174958648607167
STAT,1933,30,15-19,1963,0.17219565437559783
SIM,1890,36,30-34,1926,2
SIM,1903,25,na,1928,2940
STAT,1884,50,25-29,1934,0.0034393965386010903
STAT,1819,96,na,1915,1.9971909743598164
STAT,1893,36,40-44,1929,5.5005366127621595
STAT,1874,37,35-39,1911,7.2997253870625105
STAT,1836,44,na,1880,1865.7385135508155
STAT,1832,30,na,1862,2472.714291351404
STAT,1806,78,na,1884,282.2484990823704
STAT,1825,31,30-34,1856,32.129414216818674
STAT,1925,32,30-34,1957,18.537989512376015
SIM,1846,26,20-24,1872,9
SIM,1864,17,25-29,1881,8
STAT,1872,18,20-24,1890,17.706123095035405
STAT,1872,36,20-24,1908,0.775612110374496
STAT,1850,59,na,1909,897.4172303743976
STAT,1855,52,20-24,1907,4.8578205510669105E-4
STAT,1882,36,30-34,1918,5.127151504141477
STAT,1884,49,45-49,1933,0.22119932608544488
SIM,1860,14,na,1874,2608
STAT,1839,39,50-100,1878,1.3350798884386414
STAT,1883,43,20-24,1926,0.15168131195869528
STAT,1895,43,50-100,1938,0.09474544920810363
STAT,1846,43,na,1889,1367.7918492901524
STAT,1886,36,15-19,1922,0.058430745328392125
STAT,1893,43,30-34,1936,0.09911509433395542
STAT,1850,29,45-49,1879,0.5947071664557985
SIM,1885,32,40-44,1917,17
STAT,1802,64,na,1866,1219.7306475532266
STAT,1826,45,40-44,1871,0.2516038766420206
STAT,1880,6,na,1886,2775.505345755864
SIM,1917,0,na,1917,2533
SIM,1896,38,na,1934,3522
STAT,1899,36,50-100,1935,1.6850048579867944
STAT,1917,20,na,1937,3852.218928308288
SIM,1892,49,45-49,1941,2
SIM,1939,19,na,1958,4716
STAT,1866,29,35-39,1895,8.744772018774153
STAT,1849,62,na,1911,1540.0314146064836
SIM,1778,85,na,1863,124
STAT,1867,46,40-44,1913,0.16236867632368163
STAT,1877,32,40-44,1909,4.402289161775317
STAT,1836,50,45-49,1886,0.011706556861872044
SIM,1889,31,50-100,1920,3
SIM,1886,83,na,1969,1187
STAT,1856,17,25-29,1873,4.812684068015084
STAT,1864,44,15-19,1908,0.012385137497898581
STAT,1816,52,20-24,1868,0.0021593860668024734
SIM,1832,29,30-34,1861,1
SIM,1920,28,na,1948,4110
STAT,1846,17,15-19,1863,4.415301377176215
STAT,1858,38,40-44,1896,3.3263616213495455
STAT,1826,52,30-34,1878,0.008223801052112728
STAT,1873,76,na,1949,971.8273644888434
SIM,1852,59,na,1911,1806
SIM,1842,25,25-29,1867,24
STAT,1826,108,na,1934,0.0014603161580162534
STAT,1851,47,40-44,1898,0.13458212091003793
STAT,1907,40,50-100,1947,0.10812263389863713
STAT,1865,16,50-100,1881,0.046365665321352514
STAT,1906,57,na,1963,3068.402362240451
STAT,1844,15,40-44,1859,0.23307383488656788
STAT,1853,24,50-100,1877,0.36825335287640776
STAT,1873,43,25-29,1916,0.6539532148506071
SIM,1802,53,na,1855,1007
SIM,1881,43,25-29,1924,1
STAT,1861,41,40-44,1902,1.8790584071695766
SIM,1849,51,na,1900,2045
SIM,1873,65,na,1938,1011
STAT,1806,52,25-29,1858,0.009369837339018342
STAT,1823,70,na,1893,1108.3963295836213
STAT,1859,51,30-34,1910,0.004740520368338547
STAT,1838,44,20-24,1882,0.07032294159626205
STAT,1834,25,25-29,1859,24.800814313304635
STAT,1850,30,25-29,1880,5.551104002041143
STAT,1931,24,na,1955,4673.572973358094
STAT,1851,51,25-29,1902,0.00281084023547673
STAT,1854,22,45-49,1876,0.45556104179393714
STAT,1802,102,na,1904,0.1485421405174177
STAT,1824,40,25-29,1864,0.10799198195428164
STAT,1828,44,50-100,1872,1.2777021924391723
STAT,1851,21,30-34,1872,16.92144251837421
STAT,1846,28,20-24,1874,8.345107366221855
SIM,1836,44,50-100,1880,1
STAT,1850,109,na,1959,7.219997382478996E-4
STAT,1860,26,50-100,1886,0.5312620246088472
SIM,1887,24,na,1911,3773
STAT,1848,23,50-100,1871,0.4613008365192489
SIM,1893,41,30-34,1934,4
SIM,1915,40,15-19,1955,2
STAT,1881,42,20-24,1923,0.1497900883062457
STAT,1808,50,50-100,1858,0.02030849679677765
SIM,1863,43,45-49,1906,5
STAT,1867,53,30-34,1920,0.005539117266226075
STAT,1899,34,35-39,1933,13.71380221891047
STAT,1863,54,20-24,1917,6.126470699778397E-4
STAT,1829,107,na,1936,0.001722122353140352
SIM,1856,23,50-100,1879,6
STAT,1891,31,25-29,1922,12.647098696507355
STAT,1846,53,45-49,1899,0.008457130761510686
STAT,1883,18,30-34,1901,1.5293538211514994
SIM,1909,10,na,1919,4275
STAT,1854,19,15-19,1873,3.9008849339827623
STAT,1900,40,na,1940,3245.2022246088563
STAT,1885,41,30-34,1926,1.1351789323509867
SIM,1857,58,na,1915,1397
STAT,1866,25,40-44,1891,2.7529579032526477
STAT,1831,35,20-24,1866,0.8031411277573924
SIM,1867,44,40-44,1911,8
STAT,1877,42,35-39,1919,1.8359307968522345
STAT,1875,24,na,1899,2413.352242568112
STAT,1883,40,30-34,1923,1.1171907477656018
STAT,1871,65,na,1936,1685.8113395646744
STAT,1904,38,35-39,1942,2.1702689685969587
STAT,1943,20,30-34,1963,30.25050023670155
STAT,1879,48,25-29,1927,0.05834592699940258
STAT,1894,46,50-100,1940,0.1766743063885564
STAT,1930,7,na,1937,5131.629704321929
STAT,1838,26,20-24,1864,6.416391199633531
STAT,1847,50,20-24,1897,6.767528768559253E-4
STAT,1889,45,30-34,1934,0.11773112432066518
SIM,1839,29,na,1868,1007
STAT,1907,15,25-29,1922,8.306721456538218
STAT,1861,18,45-49,1879,0.06207253292360713
STAT,1811,53,45-49,1864,0.06399431558905719
STAT,1893,32,25-29,1925,12.808661646018729
STAT,1902,27,50-100,1929,0.9007895086056747
STAT,1941,31,50-100,1972,0.8586978809572895
STAT,1810,49,45-49,1859,0.0012067628936209835
STAT,1869,33,45-49,1902,1.7522336192160546
STAT,1898,36,20-24,1934,1.0415625291929291
SIM,1808,78,na,1886,985
SIM,1922,39,na,1961,3319
STAT,1939,28,50-100,1967,0.9891545445307357
STAT,1871,10,na,1881,2666.794391537625
STAT,1871,25,15-19,1896,0.45565858411779164
STAT,1874,27,40-44,1901,3.091621184945828
SIM,1948,21,15-19,1969,48
STAT,1841,24,25-29,1865,79.59892016267291
SIM,1848,42,30-34,1890,23
SIM,1836,33,na,1869,2138
STAT,1815,45,30-34,1860,0.010076118312933395
SIM,1824,52,na,1876,2003
STAT,1930,28,35-39,1958,18.947258550863253
STAT,1945,15,45-49,1960,0.539947183172571
STAT,1854,21,50-100,1875,0.26833663313828193
SIM,1831,36,25-29,1867,2
STAT,1848,15,25-29,1863,6.651707796720555
STAT,1939,22,30-34,1961,28.547116663455544
STAT,1838,19,30-34,1857,0.8881658557477758
SIM,1852,70,na,1922,1423
SIM,1859,6,na,1865,2466
STAT,1926,9,na,1935,4838.90211565453
SIM,1874,35,35-39,1909,3
STAT,1885,16,40-44,1901,0.18022599766631384
STAT,1807,53,50-100,1860,0.04715869523438451
STAT,1856,42,15-19,1898,0.009906747340222564
SIM,1864,39,40-44,1903,12
STAT,1828,29,15-19,1857,0.774468470974256
STAT,1843,22,35-39,1865,7.237152794323209
STAT,1866,35,35-39,1901,6.5176113019459985
STAT,1819,45,50-100,1864,0.04458770414016377
STAT,1897,43,15-19,1940,0.001264379047794577
STAT,1877,33,50-100,1910,0.9261744846698412
STAT,1920,39,30-34,1959,1.965651986839295
SIM,1936,20,na,1956,2495
STAT,1929,32,15-19,1961,0.1620853390534812
STAT,1833,26,40-44,1859,1.9008812593035602
STAT,1850,70,na,1920,647.8858732131183
STAT,1864,34,20-24,1898,2.4363283333694894
SIM,1841,33,30-34,1874,1
STAT,1879,2,na,1881,3313.369736377941
STAT,1818,50,30-34,1868,0.010600864643662772
STAT,1791,74,na,1865,579.4136166892484
STAT,1890,27,25-29,1917,51.21040753441192
SIM,1909,7,na,1916,4317
STAT,1795,88,na,1883,57.553375291062025
SIM,1852,40,30-34,1892,5
SIM,1915,15,25-29,1930,161
STAT,1887,47,20-24,1934,0.013146502025432839
STAT,1907,40,15-19,1947,0.0014133678666606482
STAT,1949,19,45-49,1968,0.5748676336667891
STAT,1875,26,25-29,1901,43.58637350197625
STAT,1845,35,15-19,1880,0.03284803798477345
STAT,1814,51,20-24,1865,0.0024819195706266848
STAT,1844,25,50-100,1869,0.7870616558391459
STAT,1890,34,15-19,1924,0.17092374699055637
STAT,1842,42,20-24,1884,0.040788877830376095
SIM,1868,65,na,1933,502
STAT,1842,29,na,1871,654.6031246758043
STAT,1852,108,na,1960,0.005386704987884025
STAT,1787,70,na,1857,304.01768171536
STAT,1910,49,15-19,1959,3.3785281742044435E-4
STAT,1823,36,25-29,1859,5.432834564676799
SIM,1836,32,45-49,1868,1
STAT,1835,39,20-24,1874,0.7062405222923371
SIM,1864,51,na,1915,2415
STAT,1808,53,25-29,1861,0.004455281459723241
STAT,1889,82,na,1971,1011.1135931554257
STAT,1917,30,30-34,1947,16.408719729016997
STAT,1919,18,20-24,1937,147.44490951998804
STAT,1833,33,30-34,1866,9.74258695324466
SIM,1860,31,25-29,1891,39
STAT,1866,43,na,1909,2094.5025963786147
STAT,1901,25,na,1926,3359.5114814524663
STAT,1844,52,45-49,1896,0.014300749741105928
STAT,1856,46,30-34,1902,0.06972434407879718
STAT,1813,47,20-24,1860,0.04413402363526952
SIM,1851,22,35-39,1873,14
STAT,1875,44,25-29,1919,0.6504997112081077
STAT,1818,70,na,1888,929.1098372387507
STAT,1842,24,20-24,1866,21.26841498365109
STAT,1862,21,40-44,1883,1.8300497659076223
SIM,1892,79,na,1971,2903
STAT,1887,29,20-24,1916,12.820205892805893
STAT,1907,22,15-19,1929,4.813595611878156
STAT,1832,85,na,1917,232.70570255388898
SIM,1915,8,na,1923,3758
STAT,1874,23,25-29,1897,58.89871754187757
SIM,1870,21,40-44,1891,2
STAT,1857,50,30-34,1907,0.004633397436733848
STAT,1880,38,20-24,1918,0.796290913785367
STAT,1818,43,40-44,1861,4.275951647359405
STAT,1843,48,45-49,1891,0.2302486611049241
STAT,1864,16,20-24,1880,18.43031295258776
STAT,1895,30,35-39,1925,13.27991611732829
STAT,1897,36,25-29,1933,3.8421271851666656
STAT,1910,21,30-34,1931,26.76932987794831
STAT,1818,48,na,1866,1685.4113749308913
STAT,1824,66,na,1890,317.1873375162245
STAT,1860,80,na,1940,504.6460094352764
STAT,1934,33,35-39,1967,12.384823499805536
STAT,1879,52,45-49,1931,0.014808159209664948
STAT,1909,49,25-29,1958,0.04796413705061665
STAT,1824,44,40-44,1868,0.3863410504025215
STAT,1916,42,30-34,1958,0.12922613817148443
STAT,1807,47,45-49,1854,0.8301706334365578
STAT,1834,40,20-24,1874,0.08656737457592355
STAT,1858,76,na,1934,723.4983478547491
STAT,1826,67,na,1893,1263.7928630754263
STAT,1862,81,na,1943,460.59131359794014
STAT,1891,37,35-39,1928,8.697774868812385
SIM,1851,64,na,1915,979
STAT,1915,38,na,1953,3728.317173338211
SIM,1832,46,35-39,1878,2
STAT,1921,31,15-19,1952,0.1418878322123793
STAT,1885,78,na,1963,1011.0529454251013
STAT,1857,35,20-24,1892,0.5971374334393497
STAT,1841,43,30-34,1884,1.3133845707053673
SIM,1832,44,40-44,1876,1
STAT,1906,48,45-49,1954,0.19035036031946292
STAT,1885,38,20-24,1923,0.7539472010166763
STAT,1923,45,40-44,1968,0.18335650161350714
STAT,1858,33,50-100,1891,0.6967512670456547
STAT,1807,84,na,1891,134.879304885876
STAT,1913,47,50-100,1960,0.21799173695700028
STAT,1850,41,30-34,1891,0.5332747843156483
STAT,1922,25,50-100,1947,1.121290682996744
STAT,1873,46,30-34,1919,0.09957738595766129
STAT,1824,46,35-39,1870,0.02457208155368382
STAT,1874,38,45-49,1912,2.0472061123809997
STAT,1912,33,15-19,1945,0.12445137102871712
STAT,1884,16,25-29,1900,5.437925643642626
STAT,1933,31,50-100,1964,1.1072909405905185
SIM,1839,30,na,1869,982
SIM,1783,75,na,1858,1461
STAT,1842,17,30-34,1859,0.5080913455516942
STAT,1847,39,na,1886,2164.627800719574
STAT,1882,37,40-44,1919,4.1910661034750625
STAT,1836,45,15-19,1881,3.2909570950600923E-4
SIM,1823,46,40-44,1869,4
STAT,1900,0,na,1900,4067.6641507593868
STAT,1846,20,45-49,1866,0.5169774983701226
STAT,1815,46,40-44,1861,0.017585474263850404
STAT,1891,35,40-44,1926,5.434265399238749
STAT,1892,18,50-100,1910,0.06049762264283046
SIM,1891,29,na,1920,2117
STAT,1869,15,45-49,1884,0.06762277636187393
STAT,1914,21,15-19,1935,5.1616937367316496
STAT,1827,84,na,1911,234.59127397886263
STAT,1841,34,na,1875,2867.9632393518077
STAT,1907,19,na,1926,3665.3415252932805
SIM,1888,31,na,1919,382
STAT,1923,4,na,1927,4689.591826948934
STAT,1859,48,20-24,1907,0.009391604326111103
SIM,1841,44,35-39,1885,2
STAT,1848,52,30-34,1900,0.005540591075604442
STAT,1914,47,40-44,1961,0.15418890422021003
SIM,1891,40,30-34,1931,7
STAT,1833,37,45-49,1870,1.0788485607197513
STAT,1823,40,45-49,1863,2.6220688862279378
STAT,1826,41,25-29,1867,0.9819676395262701
STAT,1847,39,50-100,1886,1.128027110447337
STAT,1879,19,20-24,1898,18.089102693323117
STAT,1882,44,30-34,1926,1.0858467216437975
STAT,1832,45,30-34,1877,0.008961263092690705
SIM,1874,43,35-39,1917,2
STAT,1860,30,20-24,1890,2.222859336871619
STAT,1911,58,na,1969,3262.1412814282867
STAT,1850,34,40-44,1884,2.051790478028699
STAT,1792,91,na,1883,24.405448584076503
STAT,1932,38,45-49,1970,0.9086675310285492
STAT,1937,16,15-19,1953,43.801386248042064
STAT,1958,8,na,1966,5116.231983975357
STAT,1856,47,40-44,1903,0.12239173928403199
STAT,1866,43,35-39,1909,1.6410042039206385
STAT,1832,51,na,1883,1928.3601473738818
STAT,1833,44,35-39,1877,0.9175456388547307
STAT,1851,17,25-29,1868,5.441437441929745
SIM,1852,37,20-24,1889,3
STAT,1809,49,20-24,1858,0.10095982277078332
STAT,1892,26,na,1918,2964.879588296616
STAT,1911,19,50-100,1930,0.07373006450579424
STAT,1841,14,na,1855,3397.50498
SIM,1907,27,35-39,1934,1
STAT,1948,20,30-34,1968,32.68552639087053
STAT,1917,29,na,1946,3848.503621115151
STAT,1904,22,50-100,1926,0.5826084992629424
STAT,1915,46,45-49,1961,0.21644699552975022
STAT,1865,47,35-39,1912,0.12722285214899945
STAT,1898,29,30-34,1927,33.62050170056901
STAT,1933,19,35-39,1952,5.549101310175855
STAT,1880,49,25-29,1929,0.05854916565952461
STAT,1902,37,20-24,1939,0.23429108428373305
STAT,1815,53,30-34,1868,5.710673876914575E-4
STAT,1926,46,20-24,1972,0.013552477193119387
STAT,1886,32,50-100,1918,0.9488181740434675
STAT,1877,59,na,1936,1972.8500029060797
SIM,1919,19,25-29,1938,1
STAT,1900,34,35-39,1934,13.908767280643513
STAT,1816,47,na,1863,2514.7102256184144
STAT,1794,72,na,1866,6.837855538318036
STAT,1872,40,40-44,1912,2.2750608031205837
STAT,1887,21,45-49,1908,0.7698403786011939
SIM,1800,72,na,1872,216
STAT,1822,43,50-100,1865,1.841873478222823
STAT,1888,11,na,1899,2985.0860702552563
SIM,1920,26,25-29,1946,379
STAT,1809,65,na,1874,2022.0170412444356
STAT,1928,18,15-19,1946,56.60075765854759
STAT,1860,15,25-29,1875,5.395020115483197
STAT,1875,78,na,1953,802.3132260706062
STAT,1881,45,25-29,1926,0.054936719954337056
STAT,1848,38,50-100,1886,1.171723944267307
STAT,1923,36,50-100,1959,0.48180067231251034
SIM,1882,46,na,1928,1700
SIM,1815,51,30-34,1866,1
STAT,1912,26,25-29,1938,64.32970221240379
STAT,1891,42,30-34,1933,1.4120394828861704
STAT,1843,15,25-29,1858,7.240150547836088
STAT,1830,24,15-19,1854,7.748433937405309
SIM,1875,13,na,1888,3165
STAT,1844,37,20-24,1881,0.8069907547889796
STAT,1907,26,30-34,1933,36.86892263969938
STAT,1889,49,45-49,1938,0.15696366623365335
SIM,1883,41,20-24,1924,8
STAT,1874,42,30-34,1916,1.1850732648551772
STAT,1864,62,na,1926,1661.6016216520522
SIM,1840,38,40-44,1878,1
STAT,1854,47,50-100,1901,0.13592130158926427
STAT,1814,54,25-29,1868,0.011223978117335203
STAT,1840,47,30-34,1887,0.03843638411672133
SIM,1799,70,na,1869,771
SIM,1829,30,na,1859,2015
SIM,1888,41,na,1929,139
STAT,1877,46,15-19,1923,4.072006425385038E-4
STAT,1945,18,15-19,1963,49.01252719013558
STAT,1854,35,50-100,1889,0.6930919371627726
STAT,1915,40,50-100,1955,0.11692847195394594
STAT,1794,62,na,1856,11.137674720000001
STAT,1875,41,20-24,1916,0.16381540212322607
STAT,1867,42,25-29,1909,0.6065595172441474
STAT,1865,45,40-44,1910,0.15786235525007775
STAT,1906,8,na,1914,3764.328525487499
STAT,1837,84,na,1921,266.7405292666579
STAT,1929,40,15-19,1969,0.0019803064319880086
STAT,1841,39,45-49,1880,2.561695472923425
STAT,1846,16,50-100,1862,0.03666588349335293
STAT,1856,54,30-34,1910,0.0041578680580538485
STAT,1843,15,na,1858,2932.7941133961467
STAT,1851,34,na,1885,1921.3074185867017
STAT,1828,48,na,1876,1666.0486617644892
STAT,1824,32,na,1856,576.0403789066318
STAT,1865,53,50-100,1918,0.013567283427216683
SIM,1901,8,na,1909,4179
SIM,1849,30,na,1879,2427
STAT,1857,28,30-34,1885,19.760719909463248
STAT,1868,16,40-44,1884,0.18092497264961066
SIM,1865,28,30-34,1893,2
SIM,1874,27,na,1901,2580
STAT,1915,17,50-100,1932,0.07730576375032547
STAT,1816,67,na,1883,1530.8575170916004
STAT,1872,81,na,1953,541.4997250352837
STAT,1850,36,35-39,1886,3.3523527440889187
STAT,1920,28,25-29,1948,71.02384430166897
STAT,1849,29,35-39,1878,9.499583739572175
STAT,1853,108,na,1961,0.005036781920033068
SIM,1888,2,na,1890,815
STAT,1797,69,na,1866,28.294738632339364
STAT,1898,11,na,1909,3477.9255001821152
STAT,1852,51,na,1903,2177.7225643322754
STAT,1899,27,25-29,1926,57.7781272005739
SIM,1869,31,45-49,1900,96
SIM,1902,38,25-29,1940,1
STAT,1903,33,20-24,1936,2.1939206960253683
SIM,1833,27,25-29,1860,5
SIM,1883,18,25-29,1901,30
SIM,1906,21,30-34,1927,6
STAT,1927,44,15-19,1971,0.0019039305528872786
STAT,1849,95,na,1944,11.202712634951926
STAT,1920,35,15-19,1955,0.020791032824920626
SIM,1897,14,na,1911,3016
SIM,1851,54,na,1905,1100
STAT,1818,47,20-24,1865,0.02140183203932806
STAT,1908,43,35-39,1951,0.18375225136129933
STAT,1859,26,40-44,1885,2.4327108017649195
STAT,1808,50,20-24,1858,9.922718697480868E-4
STAT,1821,34,15-19,1855,0.189685172032826
SIM,1828,78,na,1906,713
STAT,1907,44,45-49,1951,0.1495966893948416
STAT,1874,20,20-24,1894,71.54663319408965
STAT,1807,51,30-34,1858,0.01938588547231274
STAT,1882,15,50-100,1897,0.04712325629583751
STAT,1860,48,45-49,1908,0.19010784401990705
STAT,1824,51,30-34,1875,0.001023736680830384
SIM,1896,60,na,1956,2510
STAT,1924,44,30-34,1968,0.15010625448653384
STAT,1838,51,45-49,1889,0.0062853448533925806
SIM,1860,1,na,1861,2680
STAT,1851,44,na,1895,1800.7605262183808
STAT,1849,36,25-29,1885,2.5083385959706725
STAT,1800,105,na,1905,0.020230538729746242
STAT,1918,47,25-29,1965,0.05568721949555422
SIM,1823,69,na,1892,681
SIM,1893,30,25-29,1923,9
STAT,1909,38,50-100,1947,0.39141132572409854
STAT,1824,39,45-49,1863,0.32268828307989494
SIM,1866,9,na,1875,3337
STAT,1924,44,45-49,1968,0.19540859268345334
STAT,1864,52,na,1916,1947.0374398898473
STAT,1842,18,50-100,1860,0.015525571255163632
STAT,1919,28,15-19,1947,0.74999671923632
STAT,1895,20,40-44,1915,2.7269435629420657
SIM,1867,26,40-44,1893,4
SIM,1915,26,30-34,1941,2
STAT,1892,18,25-29,1910,6.997559764659244
STAT,1900,35,45-49,1935,2.78777483179828
STAT,1904,34,50-100,1938,0.7452133696153347
STAT,1885,30,25-29,1915,10.148889065394965
STAT,1917,48,20-24,1965,0.011357219201429269
SIM,1832,39,45-49,1871,2
SIM,1876,38,20-24,1914,4
STAT,1857,38,25-29,1895,2.1984262945948223
STAT,1848,30,20-24,1878,3.0116929235306475
STAT,1844,47,15-19,1891,3.944277688069542E-4
STAT,1831,99,na,1930,1.482235108457262
STAT,1849,85,na,1934,230.98344460345623
STAT,1858,45,50-100,1903,0.1894258039013215
SIM,1873,37,40-44,1910,3
STAT,1891,34,30-34,1925,21.2868927284457
STAT,1869,51,50-100,1920,0.015312828091474698
STAT,1904,31,15-19,1935,0.20428871974423782
SIM,1886,60,na,1946,2614
SIM,1884,27,na,1911,3396
STAT,1841,46,35-39,1887,0.15862515418819528
SIM,1904,11,na,1915,4192
STAT,1824,47,45-49,1871,0.04095962026113903
STAT,1934,30,30-34,1964,21.389647549873136
STAT,1819,65,na,1884,411.2846613928244
SIM,1860,37,na,1897,1987
STAT,1873,97,na,1970,31.867849480261206
STAT,1851,40,20-24,1891,0.1266949806044029
STAT,1905,31,15-19,1936,0.11809281448628668
STAT,1857,59,na,1916,1491.3394149203414
STAT,1911,42,50-100,1953,0.11086464453807061
SIM,1874,28,25-29,1902,2
SIM,1808,48,na,1856,1411
STAT,1844,96,na,1940,8.506706255570894
STAT,1848,48,45-49,1896,0.21806789729950873
STAT,1857,53,35-39,1910,0.006500189321744836
STAT,1897,40,45-49,1937,0.13941683840692184
STAT,1874,62,na,1936,1886.3401009101751
SIM,1861,54,na,1915,1736
STAT,1927,34,50-100,1961,1.0074691240726243
STAT,1881,48,30-34,1929,0.09026425798162037
SIM,1902,10,na,1912,3754
STAT,1871,48,20-24,1919,0.01182011395113647
STAT,1887,25,na,1912,2644.603096898674
STAT,1834,32,na,1866,1223.4181427634408
STAT,1900,42,35-39,1942,0.17398050249186
STAT,1816,44,35-39,1860,5.645415653901895
STAT,1869,28,50-100,1897,0.6432298331382981
STAT,1909,46,20-24,1955,0.010076434211381997
SIM,1932,36,45-49,1968,3
STAT,1908,40,30-34,1948,0.11869714383255886
SIM,1857,28,25-29,1885,1
STAT,1918,40,40-44,1958,0.26307837626810116
STAT,1832,53,30-34,1885,4.6700714059533894E-4
STAT,1836,44,50-100,1880,0.9386812115775622
SIM,1919,10,na,1929,5211
SIM,1869,21,30-34,1890,28
SIM,1844,62,na,1906,1796
STAT,1863,49,25-29,1912,0.04814711578772102
STAT,1907,19,40-44,1926,0.2654420919775966
STAT,1824,43,30-34,1867,0.19673139331698794
SIM,1857,34,50-100,1891,15
STAT,1853,15,na,1868,2166.5019896723984
STAT,1883,35,35-39,1918,6.869078715280233
STAT,1924,36,45-49,1960,0.7968712641767618
STAT,1817,84,na,1901,105.38418232328334
STAT,1850,37,45-49,1887,0.935092606906637
STAT,1920,33,20-24,1953,2.626235440216967
SIM,1833,45,na,1878,2137
STAT,1924,43,35-39,1967,0.236843095710895
STAT,1950,15,na,1965,4313.005652996052
SIM,1842,40,na,1882,2876
SIM,1837,35,45-49,1872,35
SIM,1954,0,na,1954,5845
STAT,1884,22,50-100,1906,0.3903665023806097
STAT,1920,49,na,1969,3985.329900744386
STAT,1822,48,25-29,1870,0.0949919039880004
STAT,1865,44,30-34,1909,1.0354687015670672
STAT,1831,34,na,1865,2149.8876413109015
STAT,1896,26,45-49,1922,1.468656167243586
STAT,1933,16,30-34,1949,16.245527913890996
SIM,1923,43,40-44,1966,1
SIM,1875,23,na,1898,2616
STAT,1927,19,na,1946,4514.960486050831
STAT,1928,44,15-19,1972,0.001936366444574262
STAT,1883,28,45-49,1911,1.0643996420698287
STAT,1871,32,50-100,1903,0.9139949138436502
STAT,1837,30,45-49,1867,1.789895241008115
STAT,1897,35,na,1932,3158.575211881397
STAT,1938,30,15-19,1968,0.12797279028528222
SIM,1941,16,30-34,1957,66
STAT,1805,52,45-49,1857,0.01699763218622887
STAT,1912,41,15-19,1953,0.001472350437381916
STAT,1865,37,40-44,1902,3.9966209685446503
STAT,1887,59,na,1946,2139.1188819354916
STAT,1900,31,30-34,1931,24.285534130739226
SIM,1903,59,na,1962,1936
STAT,1891,38,45-49,1929,2.4392887309301834
SIM,1898,29,25-29,1927,1
STAT,1832,38,40-44,1870,0.3449184518466434
STAT,1944,7,na,1951,4211.045873582337
SIM,1819,64,na,1883,1387
STAT,1829,35,45-49,1864,1.0475561637652309
STAT,1926,31,35-39,1957,10.961507426364767
STAT,1846,50,40-44,1896,0.006324716003013725
SIM,1810,72,na,1882,2853
STAT,1898,39,25-29,1937,0.8272627847352269
STAT,1814,66,na,1880,1314.4442053019077
STAT,1931,21,15-19,1952,6.876228724015851
STAT,1842,34,35-39,1876,2.9745404146902663
STAT,1915,43,40-44,1958,0.24786928300938812
STAT,1878,21,na,1899,2440.672166226368
STAT,1883,43,35-39,1926,1.7294966708847828
STAT,1873,47,40-44,1920,0.17479475241735046
STAT,1890,45,na,1935,2750.827449706558
STAT,1957,6,na,1963,5137.635667764352
SIM,1883,5,na,1888,2272
STAT,1840,44,25-29,1884,0.2570891620223006
SIM,1892,56,na,1948,3403
STAT,1850,44,35-39,1894,0.8248777268633746
STAT,1804,66,na,1870,1498.583820498614
STAT,1929,18,50-100,1947,0.4735433501238916
STAT,1816,52,35-39,1868,0.02519283652507473
STAT,1849,51,20-24,1900,6.247397905454902E-4
STAT,1861,51,35-39,1912,0.007193919708634003
STAT,1948,23,35-39,1971,10.697183063396539
STAT,1950,8,na,1958,4602.750156007325
SIM,1865,13,na,1878,1931
STAT,1925,17,35-39,1942,5.022549264885318
STAT,1857,45,35-39,1902,0.10850163636340902
STAT,1891,45,35-39,1936,0.098081901775888
SIM,1871,30,na,1901,1868
SIM,1897,31,20-24,1928,9
STAT,1875,19,35-39,1894,0.5604215737012517
SIM,1914,11,na,1925,5124
STAT,1824,36,40-44,1860,0.6837695736539964
STAT,1861,44,45-49,1905,1.2278695515056468
STAT,1910,31,50-100,1941,0.7915074208365308
SIM,1895,43,na,1938,4507
SIM,1845,19,15-19,1864,1
STAT,1820,50,35-39,1870,0.013587311894314603
STAT,1888,21,na,1909,2737.8943169355307
STAT,1824,54,35-39,1878,0.0013956166776187742
STAT,1821,99,na,1920,0.9564352711007067
SIM,1859,29,na,1888,1690
STAT,1875,18,25-29,1893,5.803647211174491
SIM,1808,68,na,1876,1261
STAT,1830,47,20-24,1877,0.010255171451080784
STAT,1917,19,na,1936,3874.3329399558197
STAT,1847,16,20-24,1863,20.123883373691662
STAT,1866,40,30-34,1906,1.0600278939691166
SIM,1872,70,na,1942,1751
STAT,1889,31,20-24,1920,3.268393318030909
SIM,1945,13,na,1958,6340
STAT,1789,108,na,1897,7.789072265976291E-4
STAT,1907,29,35-39,1936,13.860444343730238
STAT,1882,71,na,1953,1277.9518024280624
SIM,1833,24,20-24,1857,24
STAT,1922,49,40-44,1971,0.17805432141616892
STAT,1846,54,20-24,1900,4.2502243972739805E-4
SIM,1898,61,na,1959,3708
STAT,1890,31,45-49,1921,2.119711043486856
STAT,1901,31,30-34,1932,24.512206718183837
STAT,1839,17,25-29,1856,6.8870777446432765
STAT,1837,39,na,1876,2047.939791004568
STAT,1919,42,15-19,1961,0.001642091307710701
STAT,1787,69,na,1856,315.5674504
STAT,1883,12,na,1895,2484.4853308199567
SIM,1793,75,na,1868,591
STAT,1881,15,45-49,1896,0.061973769124159236
STAT,1849,28,25-29,1877,41.94787137874408
STAT,1873,39,40-44,1912,4.445159780540847
STAT,1867,28,40-44,1895,2.823022694506131
STAT,1826,49,20-24,1875,0.01672262386130436
STAT,1859,95,na,1954,10.537945543426268
SIM,1851,41,25-29,1892,3
STAT,1806,48,40-44,1854,0.5479952058372315
STAT,1881,44,15-19,1925,0.012865248908642482
SIM,1911,24,na,1935,2581
STAT,1920,25,20-24,1945,19.90072151712391
SIM,1922,40,na,1962,3334
STAT,1859,18,40-44,1877,0.1672858730118581
SIM,1824,44,35-39,1868,6
STAT,1900,32,40-44,1932,6.007590151480345
STAT,1911,20,35-39,1931,8.88210613304658
STAT,1843,41,25-29,1884,0.6616921031897719
STAT,1870,27,20-24,1897,11.69547248105683
STAT,1824,86,na,1910,42.938304078075326
STAT,1836,67,na,1903,1213.2258302614016
SIM,1840,46,50-100,1886,1
STAT,1842,42,35-39,1884,0.46508187136442775
STAT,1885,33,50-100,1918,0.8968223502886948
STAT,1896,30,na,1926,3170.989159199828
STAT,1832,46,40-44,1878,0.01567256339673014
STAT,1853,31,40-44,1884,3.498968075080842
STAT,1851,54,30-34,1905,0.004571997301373371
STAT,1877,17,45-49,1894,0.06631020394330196
SIM,1915,29,35-39,1944,21
STAT,1855,25,45-49,1880,0.8539184860995223
STAT,1881,35,50-100,1916,1.1704272508775915
STAT,1852,39,20-24,1891,0.7681178223754614
STAT,1854,108,na,1962,0.004347179219227223
STAT,1850,33,30-34,1883,8.346776450156103
STAT,1904,22,na,1926,3378.935327811897
STAT,1892,15,20-24,1907,22.051566337077645
STAT,1919,52,na,1971,3865.653352704552
STAT,1862,35,15-19,1897,0.048283383141590974
STAT,1864,41,45-49,1905,1.3667612066725894
STAT,1924,40,15-19,1964,0.0018141191882162539
SIM,1898,41,na,1939,4193
STAT,1823,49,na,1872,2005.9371967289453
STAT,1948,2,na,1950,4555.294693174121
STAT,1885,48,15-19,1933,3.882390998218611E-4
STAT,1840,43,15-19,1883,0.005600088681445505
STAT,1891,27,40-44,1918,3.683731047467623
STAT,1863,20,45-49,1883,0.6159897837985557
STAT,1850,80,na,1930,285.64404960759214
STAT,1832,46,50-100,1878,0.02248353719290784
STAT,1795,98,na,1893,0.7918957548492003
STAT,1930,21,15-19,1951,6.791915772817959
STAT,1839,85,na,1924,254.68900515548685
STAT,1865,48,45-49,1913,0.212758555688345
STAT,1837,19,15-19,1856,6.267532429923728
STAT,1820,43,45-49,1863,2.4272419752504617
SIM,1893,62,na,1955,1701
STAT,1837,50,na,1887,1802.7514097848882
STAT,1846,13,na,1859,1768.0393265811845
STAT,1911,45,15-19,1956,3.464312056785134E-4
STAT,1843,19,40-44,1862,0.22823063185354783
SIM,1854,0,na,1854,3850
STAT,1916,34,45-49,1950,1.5887221847859814
STAT,1877,47,50-100,1924,0.24815124444079115
STAT,1865,30,20-24,1895,2.487705567591599
STAT,1816,41,30-34,1857,3.881199711343176
STAT,1881,37,25-29,1918,2.7189634208331737
SIM,1845,16,na,1861,2766
STAT,1830,28,na,1858,2062.9855445744015
STAT,1856,33,na,1889,1717.0390269768732
SIM,1879,26,na,1905,1596
STAT,1829,31,na,1860,1050.6164115885927
SIM,1883,42,na,1925,2164
STAT,1799,71,na,1870,122.56053910814501
STAT,1910,32,35-39,1942,8.712756296781324
STAT,1851,29,50-100,1880,0.5830833276145944
STAT,1879,92,na,1971,169.87455795876562
SIM,1832,50,na,1882,1751
STAT,1858,52,25-29,1910,0.0026905091710898296
STAT,1831,43,20-24,1874,0.1531421246874142
STAT,1933,31,40-44,1964,5.240960652805869
STAT,1814,46,25-29,1860,0.19957097819464595
SIM,1850,31,30-34,1881,33
STAT,1951,21,na,1972,4323.764962688499
STAT,1863,46,20-24,1909,0.010273634109976037
STAT,1834,32,35-39,1866,5.716956184379407
SIM,1853,45,na,1898,3150
SIM,1868,75,na,1943,328
STAT,1823,44,25-29,1867,1.026521873497317
SIM,1853,35,na,1888,3271
STAT,1886,30,na,1916,2491.008059763893
SIM,1938,3,na,1941,4282
SIM,1851,10,na,1861,1504
SIM,1960,1,na,1961,6451
STAT,1826,98,na,1924,2.589854267340063
SIM,1917,18,na,1935,2206
STAT,1831,35,50-100,1866,1.2791751067185444
STAT,1920,41,50-100,1961,0.12826529256195887
STAT,1833,52,20-24,1885,3.259455523494414E-4
SIM,1895,5,na,1900,4648
STAT,1922,45,25-29,1967,0.06054294558953883
STAT,1860,45,40-44,1905,0.14105600553360467
STAT,1855,51,45-49,1906,0.009650800440294838
STAT,1785,102,na,1887,0.03880511298618927
STAT,1913,33,15-19,1946,0.12571575251023936
STAT,1893,21,50-100,1914,0.5114928439636047
SIM,1898,26,20-24,1924,37
STAT,1838,25,45-49,1863,0.6116600789298178
STAT,1859,44,50-100,1903,0.8260335036305044
STAT,1881,49,40-44,1930,0.15829674224300674
STAT,1859,29,45-49,1888,0.8823990017735049
STAT,1922,31,15-19,1953,0.14416150313693032
STAT,1839,41,na,1880,2291.4942701099403
STAT,1872,44,20-24,1916,0.15688236070876171
STAT,1883,25,40-44,1908,2.9014133646860945
STAT,1945,25,50-100,1970,1.0808778183236538
SIM,1826,43,na,1869,1920
STAT,1939,33,35-39,1972,9.215853567813893
STAT,1822,45,20-24,1867,0.02063105723386704
STAT,1842,31,30-34,1873,5.290567092281689
STAT,1942,24,45-49,1966,1.1654651702348964
STAT,1912,22,50-100,1934,0.6232706651932766
STAT,1866,51,20-24,1917,6.768094815594668E-4
STAT,1918,23,50-100,1941,0.69793079980746
STAT,1920,43,15-19,1963,0.0016716108830343598
SIM,1925,37,na,1962,4734
SIM,1831,44,25-29,1875,6
STAT,1863,50,40-44,1913,0.009116739177756244
SIM,1892,15,na,1907,3699
SIM,1855,13,na,1868,3381
STAT,1890,34,50-100,1924,1.099716882046571
STAT,1839,40,20-24,1879,0.17532424481932074
SIM,1921,44,na,1965,5172
STAT,1843,52,50-100,1895,0.014842753660742006
STAT,1879,26,45-49,1905,1.142901905619727
SIM,1817,73,na,1890,1947
STAT,1890,35,25-29,1925,3.5186799754291536
STAT,1811,52,35-39,1863,0.03873003252830154
STAT,1924,33,40-44,1957,4.518928255465021
STAT,1873,12,na,1885,2690.9664448404387
STAT,1888,65,na,1953,1950.493392565792
SIM,1890,8,na,1898,4046
SIM,1882,20,20-24,1902,2
STAT,1907,22,35-39,1929,8.514530664240876
STAT,1867,50,25-29,1917,0.003397925934221504
STAT,1894,32,50-100,1926,1.1651514797496996
STAT,1840,48,40-44,1888,0.06711303321977515
SIM,1900,41,30-34,1941,1
STAT,1855,47,25-29,1902,0.0379440547525546
SIM,1839,61,na,1900,334
STAT,1875,33,35-39,1908,10.355116476248062
STAT,1867,16,25-29,1883,5.511166309145693
STAT,1892,30,30-34,1922,21.790527055383688
SIM,1917,9,na,1926,2454
STAT,1805,53,20-24,1858,8.467257042735299E-4
STAT,1890,49,35-39,1939,0.09360753298898569
STAT,1855,18,20-24,1873,13.873496403701417
STAT,1817,51,25-29,1868,0.0024437875964944066
STAT,1811,45,45-49,1856,1.1454084056378815
STAT,1949,23,50-100,1972,0.7599764958081582
STAT,1924,40,30-34,1964,0.1510254117144534
STAT,1894,32,40-44,1926,5.514822560247904
STAT,1894,46,15-19,1940,2.8774292829795685E-4
STAT,1870,37,15-19,1907,0.05598234314647718
SIM,1888,10,na,1898,676
STAT,1882,40,15-19,1922,0.013355083993122012
STAT,1884,42,25-29,1926,0.6139623830685513
STAT,1800,73,na,1873,876.2640284284121
STAT,1827,41,40-44,1868,2.1636709811903696
STAT,1899,22,50-100,1921,0.5569875818828085
STAT,1920,36,25-29,1956,1.0651386943681085
STAT,1935,17,na,1952,4995.615040201449
SIM,1838,19,25-29,1857,41
SIM,1839,16,20-24,1855,145
STAT,1839,31,na,1870,2503.733367164753
STAT,1939,15,20-24,1954,134.5471165449011
SIM,1890,33,25-29,1923,85
STAT,1790,68,na,1858,963.0933218917592
STAT,1868,42,40-44,1910,2.169835269639676
SIM,1842,50,na,1892,3011
SIM,1924,41,35-39,1965,1
STAT,1835,54,45-49,1889,0.010755717376614512
SIM,1954,17,na,1971,5548
STAT,1869,16,40-44,1885,0.18822858475797127
SIM,1855,19,25-29,1874,36
SIM,1866,53,na,1919,2670
STAT,1828,40,45-49,1868,1.9353319606092696
SIM,1830,43,50-100,1873,1
STAT,1808,80,na,1888,166.84112736917498
STAT,1864,45,25-29,1909,0.05288656559617298
SIM,1858,75,na,1933,334
STAT,1921,3,na,1924,4568.5663550285835
STAT,1858,19,35-39,1877,0.4837331085534179
STAT,1797,90,na,1887,1.273412210590854
STAT,1949,18,35-39,1967,4.830579720381339
STAT,1927,41,45-49,1968,0.2073258368249207
STAT,1820,36,20-24,1856,1.512865590147383
STAT,1912,23,20-24,1935,105.00103966759265
STAT,1921,35,30-34,1956,2.0144053522209653
SIM,1834,31,na,1865,1067
STAT,1901,20,40-44,1921,2.930997440783663
STAT,1874,53,20-24,1927,7.493538724492728E-4
STAT,1835,33,50-100,1868,0.8734835911857263
STAT,1901,49,20-24,1950,0.009266906139216342
STAT,1893,47,45-49,1940,0.16569871827747237
SIM,1837,28,na,1865,2197
SIM,1876,42,40-44,1918,1
SIM,1897,55,na,1952,1894
STAT,1789,71,na,1860,1019.8227283206959
SIM,1889,26,na,1915,3362
STAT,1849,25,20-24,1874,11.88762680255362
STAT,1890,42,15-19,1932,0.016697697142079675
STAT,1842,50,20-24,1892,1.8581684363251053E-4
STAT,1882,33,25-29,1915,9.764991567243099
SIM,1803,70,na,1873,373
STAT,1886,30,40-44,1916,4.526985594123284
STAT,1866,25,20-24,1891,10.781339549376703
STAT,1822,52,45-49,1874,0.023385273834548827
SIM,1822,50,na,1872,1444
STAT,1878,31,45-49,1909,1.8014970928859608
STAT,1932,35,40-44,1967,2.0008227390195774
STAT,1910,5,na,1915,3926.5924921058313
STAT,1866,33,na,1899,2169.07709019779
STAT,1932,21,30-34,1953,37.561742785955886
SIM,1834,21,na,1855,1278
STAT,1898,32,25-29,1930,13.773402057027727
STAT,1934,19,50-100,1953,0.5006293623220847
STAT,1884,62,na,1946,1749.6365693658383
STAT,1882,47,35-39,1929,0.13341254710557474
SIM,1889,36,na,1925,3830
STAT,1916,16,30-34,1932,2.557024461111875
STAT,1873,22,na,1895,2426.018669537016
STAT,1857,31,25-29,1888,7.9908494181941006
STAT,1901,16,50-100,1917,0.06866942897253298
STAT,1866,18,30-34,1884,1.4845550678431132
SIM,1904,42,na,1946,4093
STAT,1849,18,30-34,1867,1.643366675865359
STAT,1883,51,20-24,1934,7.133069753165377E-4
STAT,1810,102,na,1912,0.00912787835244613
STAT,1834,86,na,1920,97.78200261650125
STAT,1938,17,50-100,1955,0.36561869740270636
SIM,1866,63,na,1929,2408
SIM,1929,9,na,1938,6275
STAT,1934,22,na,1956,4874.360113068327
STAT,1876,48,20-24,1924,0.011978471707090476
STAT,1830,102,na,1932,0.21219194388179596
SIM,1865,35,40-44,1900,34
SIM,1857,43,35-39,1900,7
STAT,1880,24,50-100,1904,0.4206991876203172
STAT,1917,40,na,1957,3834.6777781544156
STAT,1922,41,na,1963,4221.365352950597
STAT,1915,21,30-34,1936,29.37825378534108
STAT,1852,50,30-34,1902,0.006077868635755091
STAT,1887,80,na,1967,1040.1202525736726
SIM,1873,42,na,1915,2165
STAT,1886,40,na,1926,2417.5548817798276
SIM,1865,31,25-29,1896,7
STAT,1793,86,na,1879,64.61842821753103
STAT,1883,32,30-34,1915,16.797002320347364
STAT,1830,73,na,1903,859.6625046099355
SIM,1903,19,15-19,1922,30
STAT,1840,28,na,1868,1054.4417187869126
STAT,1916,41,35-39,1957,0.20383439101073805
STAT,1873,42,15-19,1915,0.014148401344120527
STAT,1893,40,25-29,1933,0.8111381498626827
STAT,1821,102,na,1923,0.14805838861545167
SIM,1810,48,20-24,1858,1
STAT,1821,68,na,1889,769.2905689319022
STAT,1911,38,25-29,1949,0.9356257019487045
STAT,1869,41,45-49,1910,1.517065933744979
SIM,1901,24,na,1925,3888
STAT,1906,45,40-44,1951,0.14123594750637541
STAT,1812,44,15-19,1856,0.004159594744353803
STAT,1906,31,30-34,1937,14.57677939797811
SIM,1881,30,na,1911,3039
STAT,1914,22,na,1936,3678.9819787903857
SIM,1912,30,na,1942,4560
STAT,1892,41,20-24,1933,0.19751511851406656
STAT,1868,45,na,1913,2194.7200711967653
SIM,1851,52,50-100,1903,1
STAT,1847,19,25-29,1866,6.319384195726503
STAT,1856,7,na,1863,2102.095362198571
STAT,1825,50,20-24,1875,9.417411557829026E-4
STAT,1925,43,35-39,1968,0.24118061098320367
STAT,1841,32,25-29,1873,13.838647146173916
STAT,1875,15,20-24,1890,18.289163048033227
STAT,1832,49,45-49,1881,0.019008251164917448
SIM,1824,41,30-34,1865,11
SIM,1860,43,40-44,1903,1
STAT,1931,36,50-100,1967,0.5526380196087622
SIM,1872,45,25-29,1917,1
SIM,1840,49,45-49,1889,8
STAT,1864,49,40-44,1913,0.15238934995124953
STAT,1922,42,20-24,1964,0.020044420836401677
SIM,1833,35,na,1868,2213
STAT,1845,108,na,1953,9.089324109620817E-4
STAT,1895,44,na,1939,2976.2877425015827
STAT,1817,94,na,1911,6.3313781264315745
STAT,1874,35,40-44,1909,4.560780854089288
STAT,1881,34,20-24,1915,2.5307729072281018
SIM,1878,41,na,1919,4037
STAT,1930,33,15-19,1963,0.16457340162264758
STAT,1901,30,35-39,1931,14.273636126050564
STAT,1810,73,na,1883,37.393605595511936
STAT,1831,46,25-29,1877,0.055020611282496835
STAT,1879,51,na,1930,2219.3735016619517
SIM,1899,36,na,1935,1795
STAT,1912,48,35-39,1960,0.1221275893754217
STAT,1922,5,na,1927,4601.385610615738
SIM,1924,31,40-44,1955,2
STAT,1853,49,30-34,1902,0.07349048006250547
STAT,1847,60,na,1907,1724.3134808215018
STAT,1908,59,na,1967,3100.0974598411444
SIM,1782,80,na,1862,514
STAT,1865,1,na,1866,3282.0278780455064
SIM,1844,31,na,1875,2880
STAT,1820,46,15-19,1866,6.369624744237146E-4
STAT,1830,46,25-29,1876,0.04985953251793998
STAT,1861,34,na,1895,1967.5677789056622
SIM,1943,22,na,1965,3698
STAT,1880,48,na,1928,2306.334288794337
STAT,1787,90,na,1877,14.202196734381339
STAT,1815,49,45-49,1864,0.02329483307444079
STAT,1870,21,50-100,1891,0.4077671487219675
STAT,1918,44,20-24,1962,0.018461939828033357
STAT,1844,41,40-44,1885,2.3116111764960836
STAT,1890,46,30-34,1936,0.06629078417933046
STAT,1847,50,50-100,1897,0.013850874997925557
STAT,1903,23,50-100,1926,0.5770743717955298
STAT,1880,46,20-24,1926,0.012493224061071043
STAT,1882,81,na,1963,752.8190760662147
STAT,1834,108,na,1942,8.072502370142892E-4
SIM,1797,68,na,1865,1152
STAT,1900,43,30-34,1943,0.10979579452363915
STAT,1875,52,25-29,1927,0.0036177615347933096
STAT,1891,41,na,1932,2855.0582522050468
STAT,1876,40,25-29,1916,0.655711979178248
SIM,1803,69,na,1872,751
STAT,1939,30,30-34,1969,15.916565923597963
STAT,1776,112,na,1888,0.0014872657427905827
STAT,1833,41,30-34,1874,0.6066065027447314
STAT,1835,47,20-24,1882,0.009570407931912382
STAT,1897,44,25-29,1941,0.05842204610601171
STAT,1902,30,35-39,1932,14.375161816906633
SIM,1940,9,na,1949,4338
STAT,1911,42,45-49,1953,0.15705824687900402
STAT,1912,30,45-49,1942,1.5427020585423676
STAT,1858,26,25-29,1884,33.30870317430438
STAT,1923,48,45-49,1971,0.25087437075624786
STAT,1814,43,20-24,1857,0.5394524680343892
STAT,1891,20,20-24,1911,85.24930393225517
STAT,1924,22,35-39,1946,11.003917465260095
STAT,1933,34,45-49,1967,2.1034862738817153
STAT,1863,53,45-49,1916,0.012190500776340497
STAT,1903,36,25-29,1939,0.8864002725102655
STAT,1820,52,50-100,1872,0.022908883720131938
STAT,1914,43,25-29,1957,0.06966416359522239
SIM,1852,41,40-44,1893,4
STAT,1875,88,na,1963,280.63260157701535
STAT,1897,48,40-44,1945,0.12663989693740826
STAT,1904,43,15-19,1947,0.0013601977084055068
STAT,1904,56,na,1960,3014.242294943959
STAT,1931,24,50-100,1955,0.84210324382815
STAT,1871,47,25-29,1918,0.05719063798444939
STAT,1825,42,35-39,1867,2.408249542080187
STAT,1838,45,na,1883,1012.7437206764929
STAT,1825,72,na,1897,777.706657706788
SIM,1884,37,na,1921,3665
STAT,1861,47,15-19,1908,3.3110603921516173E-4
SIM,1871,64,na,1935,1577
STAT,1840,40,45-49,1880,0.6930662203610232
STAT,1882,26,na,1908,2292.722946650385
STAT,1868,11,na,1879,2591.447360126844
STAT,1920,47,30-34,1967,0.0972754853606088
STAT,1824,50,50-100,1874,0.0026491068864191343
STAT,1900,9,na,1909,3594.307405028733
STAT,1926,23,50-100,1949,0.7900839739231187
SIM,1841,34,40-44,1875,3
STAT,1916,19,35-39,1935,0.8734211570419286
STAT,1875,30,30-34,1905,18.072661874744007
STAT,1833,34,40-44,1867,2.3863459057947103
STAT,1848,45,na,1893,2126.333120364566
SIM,1804,55,na,1859,875
STAT,1838,18,20-24,1856,9.937557323629076
STAT,1815,72,na,1887,96.45518062960578
STAT,1865,40,15-19,1905,0.01273547288584399
STAT,1867,54,40-44,1921,0.00968252253691715
SIM,1927,18,na,1945,1936
SIM,1865,23,na,1888,1859
SIM,1904,1,na,1905,4312
STAT,1838,28,50-100,1866,0.3448667390617345
SIM,1913,56,na,1969,2906
STAT,1823,48,40-44,1871,0.26331821934488026
STAT,1842,20,25-29,1862,18.18432937468451
STAT,1829,40,50-100,1869,0.5233741539739977
SIM,1922,43,25-29,1965,1
SIM,1922,19,na,1941,3673
SIM,1893,45,45-49,1938,1
STAT,1862,32,45-49,1894,1.4852849003609911
SIM,1875,67,na,1942,2443
STAT,1895,31,45-49,1926,2.277760783766151
STAT,1863,12,na,1875,2325.565550417551
STAT,1878,11,na,1889,2669.182267033495
STAT,1885,45,45-49,1930,0.23428875045817832
STAT,1892,41,50-100,1933,1.313904893764442
SIM,1903,45,30-34,1948,1
SIM,1827,28,na,1855,2478
STAT,1865,78,na,1943,713.3497810232836
STAT,1890,39,40-44,1929,5.246100245415269
SIM,1848,34,na,1882,2202
STAT,1933,36,na,1969,5094.236689010633
STAT,1782,91,na,1873,56.10248299347606
SIM,1860,68,na,1928,1638
STAT,1901,23,45-49,1924,0.9719928462268247
SIM,1912,19,na,1931,4760
STAT,1820,39,25-29,1859,4.937632216205751
STAT,1940,23,30-34,1963,28.940497622530213
STAT,1818,54,45-49,1872,0.02386156040132141
STAT,1843,29,50-100,1872,0.7667141259069151
STAT,1949,15,30-34,1964,14.043617913417426
STAT,1869,92,na,1961,84.80085070076932
STAT,1897,25,na,1922,3190.929249522777
STAT,1908,15,na,1923,3734.768725862667
STAT,1867,59,na,1926,1837.9924718031793
STAT,1841,36,40-44,1877,5.803224528168684
SIM,1922,30,na,1952,3409
SIM,1844,42,45-49,1886,1
STAT,1908,17,35-39,1925,0.8076573782677887
STAT,1860,52,30-34,1912,0.004830192050379675
STAT,1885,21,50-100,1906,0.4020474841066313
SIM,1840,17,na,1857,2831
STAT,1874,45,35-39,1919,0.1459298082601991
STAT,1868,19,45-49,1887,0.06348099221123982
STAT,1814,50,45-49,1864,0.04979039313271873
STAT,1909,55,na,1964,3236.593995671792
SIM,1843,35,na,1878,278
STAT,1842,20,na,1862,679.1860312711706
STAT,1936,26,50-100,1962,0.9435382883807024
STAT,1911,35,20-24,1946,0.2541350290865717
STAT,1917,41,35-39,1958,0.20763709315862808
STAT,1939,18,25-29,1957,42.886995667913126
SIM,1883,30,30-34,1913,38
STAT,1889,46,40-44,1935,0.20674865839999595
STAT,1787,79,na,1866,129.54599549825292
SIM,1914,52,na,1966,4713
STAT,1864,15,45-49,1879,0.06831063722486708
STAT,1861,37,20-24,1898,0.6410710480102958
STAT,1834,51,25-29,1885,0.0016326082908851047
STAT,1869,19,45-49,1888,0.0660436044176966
STAT,1872,4,na,1876,2942.654758495798
STAT,1856,43,25-29,1899,0.4578997382303869
SIM,1961,10,na,1971,4639
SIM,1915,37,na,1952,3217
STAT,1842,61,na,1903,463.8784466884728
STAT,1857,60,na,1917,1463.496108043779
STAT,1892,33,35-39,1925,12.48534650297766
STAT,1870,41,35-39,1911,1.813428628460688
STAT,1866,74,na,1940,1013.0357795866904
SIM,1835,57,na,1892,1190
STAT,1842,53,25-29,1895,8.651672455162046E-4
SIM,1861,3,na,1864,2725
STAT,1872,47,25-29,1919,0.057409412822921745
STAT,1942,21,40-44,1963,3.486284180609279
SIM,1809,54,na,1863,612
STAT,1818,79,na,1897,425.51479691702747
SIM,1828,68,na,1896,830
STAT,1844,86,na,1930,219.8102712189007
SIM,1861,64,na,1925,1395
STAT,1876,18,40-44,1894,0.18441373754651266
STAT,1883,21,25-29,1904,55.23902059573507
STAT,1854,30,45-49,1884,1.0137609326553287
STAT,1924,22,na,1946,4267.6758889723105
STAT,1881,41,na,1922,2192.4899156217302
SIM,1918,49,50-100,1967,7
STAT,1840,46,50-100,1886,0.09877785442862157
SIM,1881,32,20-24,1913,6
SIM,1852,50,na,1902,1883
STAT,1839,18,20-24,1857,21.419522627016427
STAT,1866,28,25-29,1894,38.47760900826986
STAT,1870,34,45-49,1904,1.7235899985030236
STAT,1843,49,20-24,1892,0.011608981832687207
STAT,1903,43,15-19,1946,0.001351453346197333
SIM,1889,4,na,1893,3895
STAT,1836,42,45-49,1878,1.364312697323674
STAT,1853,45,15-19,1898,3.132473325661906E-4
SIM,1906,23,na,1929,2227
STAT,1881,41,45-49,1922,1.4197438765215875
STAT,1956,7,na,1963,5155.701852897872
SIM,1876,63,na,1939,3039
STAT,1925,40,30-34,1965,0.15379127249604765
SIM,1891,30,na,1921,2271
STAT,1874,52,na,1926,2210.382291987675
STAT,1828,79,na,1907,473.24546793781025
STAT,1912,41,na,1953,3560.759165885266
STAT,1858,45,na,1903,1735.2520278743948
SIM,1839,20,na,1859,1218
STAT,1873,32,20-24,1905,2.7727425815030524
STAT,1906,41,25-29,1947,0.06486559498815324
SIM,1879,81,na,1960,63
STAT,1905,6,na,1911,3757.407152973151
STAT,1927,40,na,1967,4632.6954859734515
STAT,1896,16,50-100,1912,0.064741112852197
STAT,1847,27,50-100,1874,0.6951552757761074
STAT,1916,31,40-44,1947,4.001402525612697
STAT,1807,54,35-39,1861,0.026322339996870357
STAT,1896,40,na,1936,3088.113402011154
SIM,1878,39,50-100,1917,6
STAT,1893,44,40-44,1937,0.19268882769445544
STAT,1848,45,40-44,1893,0.1618017746019993
STAT,1852,53,35-39,1905,0.008526636737847466
STAT,1812,48,30-34,1860,0.02457901771706664
STAT,1851,32,35-39,1883,8.324777536443083
SIM,1882,15,na,1897,2093
STAT,1831,68,na,1899,1196.0438746472769
SIM,1882,45,35-39,1927,2
SIM,1848,75,na,1923,1297
STAT,1826,53,40-44,1879,0.014258917726723363
STAT,1867,19,35-39,1886,0.5242719709358636
STAT,1929,16,30-34,1945,15.48435306553068
SIM,1839,24,20-24,1863,325
SIM,1896,51,na,1947,2833
STAT,1839,19,na,1858,2757.0068787081036
SIM,1938,32,na,1970,4204
STAT,1954,10,na,1964,4814.481524198996
STAT,1831,90,na,1921,61.70457314025292
STAT,1908,42,45-49,1950,0.15278822781904083
STAT,1898,15,20-24,1913,23.95061735709414
STAT,1950,17,35-39,1967,4.914314660685848
STAT,1909,35,15-19,1944,0.018162498554131903
STAT,1843,24,na,1867,2613.76081100002
STAT,1901,25,45-49,1926,1.5629749691363632
STAT,1905,44,15-19,1949,0.001360706502909914
SIM,1924,30,30-34,1954,43
STAT,1903,22,45-49,1925,0.9898557925695999
SIM,1855,77,na,1932,1575
STAT,1904,15,15-19,1919,8.518061693858456
STAT,1913,36,na,1949,3683.8292584755604
STAT,1835,80,na,1915,468.0640490284173
STAT,1860,49,20-24,1909,0.009585108972567383
STAT,1923,31,30-34,1954,17.944747500509646
STAT,1932,37,40-44,1969,1.997362808695002
STAT,1927,19,30-34,1946,14.951254767959329
SIM,1907,33,35-39,1940,10
STAT,1864,54,30-34,1918,0.0052626866971665085
SIM,1876,32,25-29,1908,6
SIM,1945,22,15-19,1967,34
STAT,1868,32,25-29,1900,9.893033028942352
SIM,1909,43,na,1952,3844
STAT,1853,48,20-24,1901,0.009187751293453885
SIM,1920,25,20-24,1945,33
STAT,1911,41,35-39,1952,0.19112293259510083
STAT,1855,105,na,1960,0.05140774716212136
STAT,1903,47,15-19,1950,3.187955441268789E-4
STAT,1943,27,45-49,1970,1.8189201566437327
STAT,1900,61,na,1961,2724.1391848633066
STAT,1835,29,na,1864,2102.689362545246
STAT,1801,102,na,1903,0.09726025696808023
STAT,1873,46,na,1919,2314.393212063217
STAT,1866,32,15-19,1898,0.12999238983404887
STAT,1844,65,na,1909,1674.2270954711535
SIM,1910,18,15-19,1928,9
SIM,1880,76,na,1956,3051
STAT,1848,79,na,1927,654.204904423465
STAT,1902,18,15-19,1920,8.33490475207519
STAT,1935,22,50-100,1957,0.889578511653881
SIM,1947,17,na,1964,4369
SIM,1848,17,25-29,1865,11
STAT,1830,25,50-100,1855,0.6240329620443075
STAT,1906,47,40-44,1953,0.13918983533053744
STAT,1886,16,40-44,1902,0.18987046295575838
STAT,1787,109,na,1896,1.2809040375726832E-4
STAT,1832,109,na,1941,6.039399868889893E-4
STAT,1912,25,20-24,1937,17.900161180866952
STAT,1934,32,45-49,1966,2.1339180023786617
STAT,1896,39,na,1935,3074.458899022631
STAT,1841,31,50-100,1872,1.2508485052014262
STAT,1900,1,na,1901,3770.561961187921
STAT,1838,51,50-100,1889,0.0065410198875338055
STAT,1927,39,25-29,1966,1.2116071483402135
STAT,1929,36,25-29,1965,1.2563562694323196
SIM,1867,22,30-34,1889,53
STAT,1930,41,45-49,1971,0.2177553029109262
SIM,1840,31,50-100,1871,6
STAT,1937,22,15-19,1959,5.130152204394659
SIM,1941,9,na,1950,3904
SIM,1884,58,na,1942,3654
STAT,1826,44,na,1870,2105.4056114704476
STAT,1913,24,25-29,1937,91.52800541378903
SIM,1813,46,na,1859,259
STAT,1885,79,na,1964,954.0801119503966
STAT,1922,45,50-100,1967,0.25814839482097424
SIM,1921,24,25-29,1945,9
STAT,1829,105,na,1934,0.010707014003762842
STAT,1936,33,50-100,1969,0.7946121372431133
STAT,1849,20,20-24,1869,71.22152892651994
STAT,1930,21,20-24,1951,141.87464239039346
SIM,1880,68,na,1948,3193
STAT,1923,40,15-19,1963,0.001780947073778976
STAT,1942,17,na,1959,3802.595978031643
SIM,1955,12,na,1967,3822
STAT,1951,9,na,1960,4635.879299546048
SIM,1906,34,30-34,1940,21
SIM,1850,46,na,1896,1225
STAT,1928,37,20-24,1965,0.330614316208201
STAT,1900,40,20-24,1940,0.015431500978445704
STAT,1818,49,na,1867,1663.9601530181696
STAT,1813,46,25-29,1859,0.2161787816206057
STAT,1933,36,45-49,1969,0.9230863075888189
STAT,1805,50,na,1855,483.690289233738
SIM,1835,31,25-29,1866,4
STAT,1914,22,20-24,1936,112.02241538272406
STAT,1822,54,na,1876,1337.2603812411276
SIM,1880,44,na,1924,3228
STAT,1917,10,na,1927,4205.830184203576
STAT,1916,38,40-44,1954,1.5045899621326178
STAT,1838,20,45-49,1858,0.39180644999778147
SIM,1909,29,30-34,1938,27
STAT,1887,15,45-49,1902,0.07223278179722574
STAT,1894,22,25-29,1916,72.79687074826505
STAT,1845,19,50-100,1864,0.03036558878687758
SIM,1905,36,35-39,1941,1
STAT,1948,16,40-44,1964,1.5847776014826265
SIM,1922,22,20-24,1944,483
STAT,1852,52,na,1904,2155.814675335094
STAT,1827,85,na,1912,193.31728523502153
STAT,1880,37,25-29,1917,2.9890513686053786
SIM,1905,25,25-29,1930,379
STAT,1917,37,45-49,1954,0.6986264567963613
STAT,1837,21,40-44,1858,2.203100376551356
STAT,1872,80,na,1952,619.4373298808985
STAT,1934,34,40-44,1968,5.300003279870734
STAT,1915,21,25-29,1936,94.4166502485871
STAT,1916,30,30-34,1946,16.173134545228177
SIM,1830,26,na,1856,737
STAT,1844,31,25-29,1875,12.261053842378201
STAT,1917,18,na,1935,4090.0026218331195
STAT,1924,44,25-29,1968,0.08384313347966622
SIM,1901,55,na,1956,2912
STAT,1812,47,20-24,1859,0.003102444010530071
STAT,1856,25,50-100,1881,0.48301837830823585
STAT,1838,69,na,1907,625.8665206000369
STAT,1913,26,20-24,1939,18.02180729735913
STAT,1814,67,na,1881,1266.3355473878576
STAT,1946,19,40-44,1965,1.5335828122619892
SIM,1921,37,30-34,1958,8
STAT,1845,18,45-49,1863,0.04072733572324671
STAT,1921,23,na,1944,4063.155268161006
STAT,1935,33,45-49,1968,2.160024819957964
STAT,1906,66,na,1972,2749.109295667913
STAT,1913,37,30-34,1950,1.7760568987099017
STAT,1896,30,35-39,1926,13.457095844170519
STAT,1918,46,20-24,1964,0.011630347865458076
SIM,1867,8,na,1875,2873
STAT,1867,31,50-100,1898,0.8700621173746729
STAT,1907,15,40-44,1922,0.2681132108355483
STAT,1929,43,na,1972,4768.40627083205
STAT,1942,28,40-44,1970,4.833819888246461
STAT,1851,11,na,1862,2302.7830795846667
STAT,1942,20,30-34,1962,29.8112971497021
SIM,1867,0,na,1867,3840
SIM,1889,81,na,1970,431
STAT,1864,85,na,1949,249.21729679517657
STAT,1922,47,25-29,1969,0.06025933099850007
SIM,1904,37,30-34,1941,9
SIM,1905,61,na,1966,2470
STAT,1946,23,na,1969,4018.510308096091
STAT,1889,40,45-49,1929,1.8204773137351722
STAT,1940,26,35-39,1966,15.144785485489185
STAT,1868,75,na,1943,994.3274192658641
SIM,1850,38,na,1888,1568
SIM,1915,27,35-39,1942,11
STAT,1875,77,na,1952,887.6029981642047
STAT,1859,39,na,1898,1848.5362649509175
STAT,1924,43,40-44,1967,0.29419118569631914
STAT,1917,29,15-19,1946,0.7252411909352606
STAT,1955,6,na,1961,5173.082515571035
STAT,1809,88,na,1897,133.62856052485841
STAT,1948,19,45-49,1967,0.5654543401780734
SIM,1906,21,25-29,1927,52
SIM,1884,6,na,1890,3872
SIM,1833,66,na,1899,1813
STAT,1859,25,35-39,1884,7.8926067320898925
STAT,1904,31,20-24,1935,3.877630995511779
STAT,1859,31,na,1890,1899.1018678615478
STAT,1863,44,na,1907,1946.500200163283
SIM,1866,26,30-34,1892,5
SIM,1855,69,na,1924,2860
STAT,1930,41,15-19,1971,0.0020092762924942926
SIM,1860,48,na,1908,1999
STAT,1928,35,25-29,1963,1.2370164326571342
STAT,1902,23,40-44,1925,2.9252700463383725
SIM,1921,26,20-24,1947,2
STAT,1869,32,50-100,1901,0.9245667881236204
SIM,1912,31,20-24,1943,7
STAT,1794,73,na,1867,6.2195082619879365
STAT,1918,33,45-49,1951,1.6426264387711451
STAT,1819,98,na,1917,0.755585874345209
SIM,1902,24,15-19,1926,1
STAT,1890,44,30-34,1934,1.3730100756218178
STAT,1909,43,45-49,1952,0.15315895667593168
STAT,1870,21,25-29,1891,57.24234635812959
STAT,1888,17,50-100,1905,0.056544648101703496
STAT,1899,23,50-100,1922,0.5552664902547906
STAT,1859,42,50-100,1901,0.8363050693972466
STAT,1853,21,25-29,1874,52.825102760753275
STAT,1851,21,15-19,1872,3.1340308850850045
STAT,1920,18,50-100,1938,0.4138492603141826
STAT,1898,3,na,1901,3554.94924114559
STAT,1801,60,na,1861,876.6082436558846
STAT,1892,49,na,1941,2727.8616646272717
STAT,1840,53,30-34,1893,0.002306210785148111
STAT,1885,35,50-100,1920,1.218270173740453
SIM,1896,4,na,1900,4130
STAT,1852,60,na,1912,1919.7440355772942
STAT,1908,44,40-44,1952,0.22680266077099262
STAT,1903,25,50-100,1928,0.9142110323367283
STAT,1808,47,na,1855,789.9793258302718
STAT,1907,27,35-39,1934,14.07872122458761
STAT,1858,26,30-34,1884,19.828563832380766
STAT,1907,43,40-44,1950,0.22625633728422465
STAT,1817,83,na,1900,125.76128300927643
STAT,1940,15,25-29,1955,43.52932297525136
STAT,1919,45,25-29,1964,0.05703811357696206
STAT,1895,48,25-29,1943,0.04173581834313472
STAT,1900,29,45-49,1929,1.527093736771193
SIM,1932,27,35-39,1959,118
STAT,1923,28,30-34,1951,44.35595080058502
STAT,1920,47,15-19,1967,4.019644768345193E-4
STAT,1869,16,35-39,1885,0.5646857215792823
STAT,1823,53,30-34,1876,0.008761396943391554
STAT,1922,27,30-34,1949,43.84287992378026
STAT,1913,41,15-19,1954,0.0014873089919719444
STAT,1923,15,25-29,1938,50.58446258760438
STAT,1848,55,na,1903,1934.9137393826632
STAT,1922,16,20-24,1938,155.53404682629778
STAT,1944,19,30-34,1963,12.960728316627776
SIM,1930,16,20-24,1946,684
STAT,1826,34,50-100,1860,1.6149676234090593
STAT,1879,18,15-19,1897,6.071948343623883
SIM,1862,44,20-24,1906,3
SIM,1831,67,na,1898,1502
SIM,1897,25,na,1922,2911
STAT,1871,31,na,1902,2390.1774077650884
SIM,1893,11,na,1904,3561
SIM,1898,21,20-24,1919,259
STAT,1834,21,15-19,1855,1.9585600261887899
STAT,1924,27,35-39,1951,17.312886578473694
SIM,1857,49,50-100,1906,6
STAT,1923,26,35-39,1949,17.114402217864818
SIM,1878,40,35-39,1918,1
STAT,1812,52,na,1864,224.67614831753414
STAT,1868,15,35-39,1883,0.5459907721708985
STAT,1923,38,na,1961,4308.994361289911
STAT,1934,29,15-19,1963,0.9423166986601231
STAT,1852,39,15-19,1891,0.055955609994601356
SIM,1852,80,na,1932,1138
SIM,1899,17,25-29,1916,1
STAT,1933,17,35-39,1950,5.579020453166998
STAT,1922,44,15-19,1966,0.001737193862335177
SIM,1863,13,na,1876,1563
STAT,1909,23,na,1932,3499.831312449791
SIM,1919,37,20-24,1956,2
STAT,1917,34,40-44,1951,4.008549857322265
STAT,1867,16,30-34,1883,1.5501147912673612
STAT,1842,82,na,1924,115.82650802130173
STAT,1910,17,40-44,1927,0.27404991987408994
STAT,1877,26,40-44,1903,3.0512932920812856
SIM,1901,23,na,1924,3964
STAT,1872,29,na,1901,2372.6878219361815
STAT,1894,49,20-24,1943,0.008428130670614672
STAT,1848,36,50-100,1884,1.1963120950023418
STAT,1916,33,35-39,1949,9.266741842600933
STAT,1876,62,na,1938,1847.6680893083096
STAT,1946,16,30-34,1962,13.376782195634474
STAT,1880,34,20-24,1914,2.7821669699629656
STAT,1907,48,40-44,1955,0.13913603141295444
STAT,1936,29,25-29,1965,62.30426336653317
SIM,1858,32,30-34,1890,12
STAT,1914,53,na,1967,3516.4251285149985
STAT,1934,3,na,1937,5449.093065142301
SIM,1801,69,na,1870,1783
STAT,1931,22,20-24,1953,143.20349083366267
STAT,1887,40,35-39,1927,2.01322541935063
STAT,1933,30,30-34,1963,21.11183604795994
STAT,1797,78,na,1875,12.770307371501506
STAT,1863,36,na,1899,2021.007302128121
SIM,1862,79,na,1941,1477
SIM,1919,48,30-34,1967,3
STAT,1906,19,40-44,1925,0.2634363132383364
SIM,1928,8,na,1936,4638
STAT,1920,38,na,1958,4062.1004740986373
SIM,1915,48,40-44,1963,4
STAT,1921,15,15-19,1936,51.35517434366583
STAT,1813,43,20-24,1856,0.7134242142693499
STAT,1907,40,30-34,1947,0.11766286655965746
SIM,1835,49,na,1884,1204
SIM,1888,3,na,1891,814
STAT,1843,15,30-34,1858,2.0364227507666963
STAT,1919,47,20-24,1966,0.011827275018121797
SIM,1869,69,na,1938,3598
STAT,1942,26,45-49,1968,1.793318484268443
STAT,1906,58,na,1964,3044.4381397913526
SIM,1916,45,na,1961,4551
STAT,1842,50,na,1892,542.1931337156035
SIM,1821,43,20-24,1864,1
STAT,1927,28,na,1955,4501.244776361928
SIM,1907,30,30-34,1937,4
SIM,1895,10,na,1905,4648
STAT,1842,53,40-44,1895,0.0025714693330807278
STAT,1789,94,na,1883,7.356339914013091
STAT,1901,42,35-39,1943,0.17560437497711975
SIM,1894,36,na,1930,1368
STAT,1923,34,35-39,1957,10.352665366307006
STAT,1879,23,40-44,1902,2.1310487811026877
STAT,1902,44,na,1946,3221.7536266142956
STAT,1868,67,na,1935,1531.115707308999
STAT,1903,19,15-19,1922,8.378984327057688
STAT,1851,67,na,1918,1251.9932712308928
STAT,1846,40,50-100,1886,0.6497060537692496
STAT,1943,24,40-44,1967,3.5340749946336185
STAT,1896,41,50-100,1937,0.09714571584773035
SIM,1907,38,40-44,1945,14
STAT,1838,22,40-44,1860,1.1540839211599085
STAT,1933,38,40-44,1971,2.0231177106728864
SIM,1904,24,25-29,1928,1190
STAT,1855,57,na,1912,1330.047090496885
SIM,1924,40,na,1964,5178
STAT,1837,40,50-100,1877,1.025516929707986
STAT,1939,26,40-44,1965,4.636342846576332
STAT,1860,4,na,1864,2507.8062380949464
STAT,1870,48,20-24,1918,0.011812880040605244
STAT,1871,95,na,1966,48.58146618033024
SIM,1854,28,na,1882,1998
STAT,1905,32,20-24,1937,2.232412159192987
STAT,1860,79,na,1939,570.324589118119
SIM,1845,40,50-100,1885,4
SIM,1933,20,30-34,1953,80
STAT,1877,0,na,1877,3706.356927099247
STAT,1916,36,45-49,1952,0.691910305951894
STAT,1906,42,50-100,1948,0.10610289196441698
STAT,1897,24,na,1921,3121.244762494639
SIM,1875,1,na,1876,3301
STAT,1884,38,na,1922,2244.1255655171954
STAT,1902,21,45-49,1923,0.9849052099194591
STAT,1913,41,45-49,1954,0.16118710068835146
STAT,1830,49,35-39,1879,0.11661692350937851
SIM,1933,25,na,1958,4119
STAT,1937,27,20-24,1964,17.60983683069514
SIM,1905,33,30-34,1938,191
STAT,1942,18,50-100,1960,0.3869334047489843
STAT,1899,27,30-34,1926,34.39513322739622
STAT,1880,24,na,1904,2439.9152247700003
STAT,1849,23,25-29,1872,57.89846863466145
STAT,1908,8,na,1916,3826.33080715404
SIM,1901,33,40-44,1934,36
STAT,1880,16,na,1896,2628.40885040897
SIM,1903,8,na,1911,3058
STAT,1850,26,na,1876,1184.0250191492476
STAT,1827,31,25-29,1858,10.70906316180881
STAT,1919,35,50-100,1954,0.4475456471061647
SIM,1928,26,30-34,1954,1
STAT,1885,47,na,1932,2201.169516453642
SIM,1863,3,na,1866,1920
STAT,1930,6,na,1936,5145.419428390014
STAT,1804,100,na,1904,0.6726587165123261
STAT,1924,12,na,1936,4673.079716362238
STAT,1798,63,na,1861,1310.9687634507864
SIM,1859,59,na,1918,1535
SIM,1934,10,na,1944,5336
SIM,1907,5,na,1912,4894
SIM,1941,12,na,1953,3876
SIM,1908,58,na,1966,1884
STAT,1904,34,25-29,1938,8.330655095310085
STAT,1923,23,30-34,1946,32.98759805902275
STAT,1921,18,25-29,1939,48.68288334314176
STAT,1911,29,20-24,1940,17.475173870411368
STAT,1924,41,20-24,1965,0.020834622586207076
STAT,1857,9,na,1866,2197.352974649335
SIM,1852,9,na,1861,2630
STAT,1843,110,na,1953,2.7303439217984374E-4
STAT,1862,38,20-24,1900,0.6533070653636723
STAT,1875,50,50-100,1925,0.015731152593288743
STAT,1878,22,40-44,1900,2.1439667988320967
SIM,1857,23,25-29,1880,34
STAT,1827,93,na,1920,20.609500830320265
STAT,1830,100,na,1930,0.768389299600098
SIM,1801,80,na,1881,1570
SIM,1912,34,25-29,1946,7
STAT,1791,73,na,1864,637.019269203303
STAT,1862,22,50-100,1884,0.3555597144374762
STAT,1897,19,20-24,1916,23.41814667203223
STAT,1809,107,na,1916,0.004590396502934555
STAT,1936,26,15-19,1962,0.6692055830082322
STAT,1891,27,50-100,1918,0.7866481206833076
STAT,1932,34,30-34,1966,20.77168079247461
SIM,1876,31,na,1907,3831
STAT,1905,18,40-44,1923,0.26238397317956363
STAT,1908,23,35-39,1931,8.562833716567262
STAT,1918,30,40-44,1948,4.135339851132956
STAT,1940,24,15-19,1964,5.358211519827779
STAT,1842,39,na,1881,611.503308593067
STAT,1886,30,50-100,1916,0.9564449093646291
STAT,1855,48,30-34,1903,0.06326078191381129
STAT,1876,22,30-34,1898,18.006580088130516
STAT,1901,35,na,1936,3351.688354334599
STAT,1822,62,na,1884,1102.179109556613
STAT,1830,49,na,1879,1703.5904283504449
SIM,1802,54,na,1856,1007
STAT,1853,38,50-100,1891,0.9472560526379549
STAT,1898,37,50-100,1935,1.6509663132557806
SIM,1883,33,na,1916,2194
STAT,1836,25,40-44,1861,3.0133259012135554
STAT,1893,74,na,1967,1733.1714502305094
STAT,1832,46,35-39,1878,0.01281634860164838
SIM,1931,23,30-34,1954,1032
SIM,1873,66,na,1939,733
SIM,1820,48,na,1868,514
SIM,1900,37,40-44,1937,7
SIM,1915,40,30-34,1955,1
STAT,1893,34,na,1927,2958.599266495537
STAT,1918,49,25-29,1967,0.05536081388146823
STAT,1829,30,45-49,1859,1.0132178009634014
STAT,1877,46,50-100,1923,0.2500214045468012
STAT,1884,16,30-34,1900,1.529514534887842
SIM,1865,79,na,1944,1165
STAT,1935,25,15-19,1960,0.956214277834945
SIM,1821,57,na,1878,1753
STAT,1827,45,50-100,1872,0.2307217852619955
SIM,1828,36,na,1864,1799
SIM,1911,19,20-24,1930,159
STAT,1856,18,20-24,1874,14.967944186735757
SIM,1868,44,na,1912,1153
STAT,1882,82,na,1964,696.6361884193931
SIM,1847,26,na,1873,1053
STAT,1870,46,na,1916,2249.308935476009
STAT,1919,42,20-24,1961,0.018884049018729164
STAT,1924,24,30-34,1948,33.37820820890558
STAT,1895,45,20-24,1940,0.008893393402768571
STAT,1902,26,45-49,1928,1.5688503895638097
STAT,1873,47,35-39,1920,0.1429396343157863
SIM,1898,24,25-29,1922,8
STAT,1926,40,40-44,1966,0.3065569263809715
STAT,1911,39,50-100,1950,0.39692134443628707
STAT,1928,16,15-19,1944,56.88881880053843
STAT,1854,47,25-29,1901,0.03187730829116711
STAT,1828,54,20-24,1882,7.440627631167389E-4
STAT,1804,57,na,1861,1989.0448190774423
STAT,1826,49,15-19,1875,5.574203050509191E-4
STAT,1927,33,50-100,1960,1.0081445809418557
STAT,1914,34,15-19,1948,0.1264619569032721
STAT,1922,19,25-29,1941,49.326975309635394
SIM,1909,51,na,1960,3774
SIM,1891,20,na,1911,2586
STAT,1870,36,50-100,1906,1.2298685087960046
STAT,1909,24,50-100,1933,0.6015348479208199
SIM,1805,59,na,1864,2097
STAT,1903,19,20-24,1922,25.030889856061435
STAT,1862,15,40-44,1877,0.18054237950879162
SIM,1839,39,na,1878,1000
STAT,1866,49,45-49,1915,0.21092730251776648
SIM,1925,14,na,1939,5189
STAT,1918,49,50-100,1967,0.2360523608542944
SIM,1846,41,na,1887,1032
STAT,1856,42,na,1898,1658.0123733244163
STAT,1874,17,25-29,1891,5.848440660406217
STAT,1885,87,na,1972,454.0662135157784
STAT,1920,31,35-39,1951,9.921323266428507
STAT,1935,15,na,1950,5018.825396239595
STAT,1877,36,na,1913,2403.111266446995
STAT,1942,23,35-39,1965,9.756517277835451
STAT,1903,61,na,1964,2848.6009535277913
SIM,1911,14,na,1925,2607
SIM,1896,29,20-24,1925,16
STAT,1924,20,na,1944,4293.139273775341
STAT,1910,33,40-44,1943,3.7153211292885477
SIM,1851,18,35-39,1869,71
STAT,1867,21,20-24,1888,65.91436606474883
STAT,1821,77,na,1898,436.53283225982125
SIM,1866,61,na,1927,2670
SIM,1856,54,na,1910,258
STAT,1894,44,50-100,1938,0.09203238852591174
SIM,1944,26,20-24,1970,6
STAT,1814,43,50-100,1857,3.5885315667783257
STAT,1825,108,na,1933,0.001127998564089026
SIM,1938,1,na,1939,4282
STAT,1914,13,na,1927,4022.2192677300827
SIM,1911,18,30-34,1929,5
STAT,1843,18,35-39,1861,0.6887485850839442
STAT,1912,40,45-49,1952,0.16045004720859296
STAT,1925,26,45-49,1951,2.0287783508491146
STAT,1860,39,50-100,1899,0.9915024451486852
STAT,1938,23,20-24,1961,108.83519774673196
STAT,1938,29,50-100,1967,0.974573702257047
SIM,1877,24,na,1901,21
STAT,1867,32,30-34,1899,16.51217963492156
STAT,1883,46,40-44,1929,0.16516941392719814
SIM,1829,38,20-24,1867,1
STAT,1829,32,40-44,1861,2.391020157200119
STAT,1873,14,na,1887,2666.587934645262
SIM,1828,47,na,1875,1713
STAT,1785,88,na,1873,20.4080115740487
SIM,1940,27,na,1967,4270
STAT,1897,48,35-39,1945,0.10356066362221736
STAT,1860,47,na,1907,1826.845744254357
SIM,1822,42,na,1864,1542
SIM,1926,3,na,1929,6370
STAT,1781,74,na,1855,467.5189800000001
STAT,1854,24,45-49,1878,0.44904267049882707
STAT,1854,33,50-100,1887,0.5163170268212993
STAT,1871,21,40-44,1892,2.0849659776911516
STAT,1836,20,35-39,1856,9.275596708998771
STAT,1836,106,na,1942,0.00929248427373211
STAT,1839,18,15-19,1857,7.170094447975334
STAT,1931,37,25-29,1968,1.2948199927330055
SIM,1910,39,20-24,1949,1
STAT,1890,47,40-44,1937,0.11636458515897184
STAT,1882,50,na,1932,2091.0889551418577
STAT,1824,96,na,1920,1.6617218926080877
SIM,1858,66,na,1924,2126
STAT,1933,33,35-39,1966,12.223967814390962
STAT,1798,110,na,1908,1.1729666009445073E-4
STAT,1907,24,30-34,1931,25.82714548790243
STAT,1928,39,40-44,1967,1.8734982759652161
STAT,1886,64,na,1950,1800.15722840838
STAT,1896,21,45-49,1917,0.922004494705656
STAT,1785,100,na,1885,0.09881233067060574
STAT,1854,44,20-24,1898,0.08711093062708605
STAT,1840,45,50-100,1885,0.10005151015286755
STAT,1855,22,40-44,1877,1.6111785430118697
STAT,1837,47,25-29,1884,0.04794302421553784
STAT,1855,17,15-19,1872,4.671609923591947
STAT,1926,24,40-44,1950,4.024490107390758
STAT,1937,19,na,1956,3533.233675493277
SIM,1859,33,30-34,1892,24
SIM,1842,59,na,1901,2590
STAT,1856,44,30-34,1900,0.8146071760091289
STAT,1902,39,20-24,1941,0.23193304873309162
SIM,1828,44,na,1872,1711
STAT,1816,41,15-19,1857,0.04662102085812891
STAT,1907,43,35-39,1950,0.18215111108706014
STAT,1937,25,25-29,1962,63.553059652269354
STAT,1900,18,na,1918,3489.518801549485
SIM,1810,49,na,1859,3168
SIM,1875,46,na,1921,2727
STAT,1842,45,40-44,1887,0.043609792747662274
STAT,1864,1,na,1865,3280.735379060369
STAT,1947,16,25-29,1963,48.31481034174247
STAT,1859,102,na,1961,0.6376468105073283
SIM,1847,18,na,1865,1776
STAT,1835,41,25-29,1876,0.5896801875924502
SIM,1879,28,na,1907,1550
STAT,1856,21,45-49,1877,0.5859014956847557
SIM,1843,36,na,1879,292
SIM,1955,16,25-29,1971,95
STAT,1841,19,50-100,1860,0.06953602312570895
SIM,1818,37,na,1855,1016
SIM,1862,2,na,1864,4008
STAT,1866,23,25-29,1889,52.303278631986586
STAT,1841,89,na,1930,116.98392759080937
SIM,1837,32,40-44,1869,3
SIM,1902,7,na,1909,3754
STAT,1800,83,na,1883,239.23047314598526
STAT,1896,23,40-44,1919,2.7384484352279546
STAT,1938,34,30-34,1972,15.652010991853768
STAT,1877,29,45-49,1906,1.1190357592463658
STAT,1901,33,50-100,1934,1.275702170093899
STAT,1896,15,50-100,1911,0.06488255682607784
STAT,1841,36,35-39,1877,9.37652198427902
STAT,1957,15,na,1972,4812.920209567184
STAT,1802,85,na,1887,131.22384761337463
SIM,1875,21,20-24,1896,36
STAT,1905,47,25-29,1952,0.04651488483273023
STAT,1851,99,na,1950,1.4957621127331933
STAT,1888,29,20-24,1917,13.443242232282463
STAT,1910,31,45-49,1941,1.5064173586331133
STAT,1828,34,45-49,1862,2.4719687069557867
STAT,1883,13,na,1896,2480.6343785571858
STAT,1864,44,50-100,1908,0.9474629493547796
STAT,1832,31,50-100,1863,0.058804679041846955
STAT,1883,38,50-100,1921,1.1752831094426708
SIM,1844,31,50-100,1875,5
SIM,1899,56,na,1955,1506
STAT,1922,32,20-24,1954,2.725211469388705
STAT,1834,95,na,1929,5.859413764837663
SIM,1845,48,na,1893,2172
SIM,1857,25,na,1882,1363
STAT,1822,33,20-24,1855,6.269014401115467
STAT,1920,19,15-19,1939,49.99309042968787
SIM,1853,11,na,1864,3646
STAT,1845,31,40-44,1876,2.58538797071691
SIM,1900,30,na,1930,4146
STAT,1906,44,30-34,1950,0.11404676280943805
STAT,1936,26,20-24,1962,17.303744221899738
STAT,1939,29,45-49,1968,1.715983002670997
STAT,1921,34,25-29,1955,10.076662370143547
SIM,1911,22,na,1933,2582
STAT,1867,45,45-49,1912,0.2254174262779845
STAT,1862,18,45-49,1880,0.06334675207934026
STAT,1895,25,45-49,1920,1.4541618057456946
STAT,1906,26,35-39,1932,14.020286573795834
STAT,1861,31,25-29,1892,8.553000461673323
STAT,1909,31,na,1940,3586.971494808234
STAT,1921,15,20-24,1936,153.4154573346156
STAT,1886,61,na,1947,1935.065753341638
SIM,1890,34,30-34,1924,38
STAT,1952,17,45-49,1969,0.5931670901960784
STAT,1906,31,25-29,1937,8.551351682243503
STAT,1900,43,25-29,1943,0.06132738097583622
SIM,1881,21,na,1902,2448
STAT,1892,6,na,1898,3234.343455865149
SIM,1874,23,25-29,1897,70
STAT,1858,14,na,1872,2110.269698719453
STAT,1895,18,50-100,1913,0.06356520834835512
STAT,1908,29,50-100,1937,0.9269794256470909
STAT,1928,13,na,1941,4946.9332663384685
STAT,1855,20,45-49,1875,0.5469880774490147
SIM,1849,31,20-24,1880,8
SIM,1881,61,na,1942,1753
STAT,1911,32,45-49,1943,1.5150300042461897
STAT,1835,21,30-34,1856,18.044391449107348
STAT,1848,47,na,1895,2095.5285258949516
STAT,1867,90,na,1957,94.36432883057485
SIM,1916,53,na,1969,4520
STAT,1953,1,na,1954,4817.203985969783
SIM,1928,25,25-29,1953,9
SIM,1853,43,na,1896,3110
SIM,1842,51,na,1893,3011
SIM,1932,16,na,1948,6500
STAT,1883,32,15-19,1915,0.13700233364497647
STAT,1835,40,na,1875,1955.5383950008409
STAT,1822,36,25-29,1858,6.063098634826483
STAT,1886,72,na,1958,1400.2637730398699
STAT,1925,44,40-44,1969,0.2990547036305564
SIM,1921,24,na,1945,5263
STAT,1905,44,20-24,1949,0.015648123938295243
SIM,1943,18,20-24,1961,968
STAT,1914,21,na,1935,3700.3842566261446
SIM,1901,15,na,1916,4147
STAT,1925,39,15-19,1964,0.02278875489261208
STAT,1935,18,20-24,1953,183.52419331747367
STAT,1879,30,35-39,1909,10.472254042466366
STAT,1922,24,50-100,1946,0.7414820161836904
SIM,1859,15,35-39,1874,8
SIM,1853,14,na,1867,3603
STAT,1857,83,na,1940,304.632505484216
STAT,1906,15,25-29,1921,8.243952793262746
SIM,1857,28,na,1885,1412
STAT,1853,77,na,1930,670.2399009286468
STAT,1920,34,45-49,1954,1.68687425496557
SIM,1862,28,na,1890,3771
STAT,1937,27,na,1964,3613.967458215863
STAT,1836,28,45-49,1864,1.0930011760214284
STAT,1898,43,15-19,1941,0.0012802449130447041
STAT,1926,43,45-49,1969,0.20309314071480594
STAT,1845,49,50-100,1894,0.11932632642876591
STAT,1836,22,30-34,1858,18.013497575681374
STAT,1901,34,35-39,1935,14.03858679586175
STAT,1914,41,30-34,1955,0.1250988385033915
STAT,1935,29,30-34,1964,52.974214729065494
STAT,1951,16,45-49,1967,0.5894840393063503
SIM,1834,44,45-49,1878,28
STAT,1932,16,35-39,1948,5.5312200345433995
STAT,1801,68,na,1869,650.5170536175002
STAT,1847,23,15-19,1870,3.630250054975999
STAT,1844,54,na,1898,2074.459945867999
STAT,1911,18,50-100,1929,0.0739333813043813
STAT,1901,23,25-29,1924,79.794354794842
STAT,1872,22,40-44,1894,2.0866419707214345
STAT,1895,46,na,1941,2935.6112555983577
SIM,1937,19,35-39,1956,84
STAT,1914,38,30-34,1952,1.7855222928363461
STAT,1884,19,35-39,1903,0.5224472331380398
STAT,1894,6,na,1900,3322.0264618158667
SIM,1940,16,35-39,1956,9
STAT,1941,27,40-44,1968,4.766892341671879
STAT,1837,21,35-39,1858,6.16954305130376
SIM,1894,28,na,1922,1647
SIM,1908,34,40-44,1942,4
STAT,1948,19,50-100,1967,0.42409075513355493
SIM,1890,35,na,1925,3674
STAT,1869,35,45-49,1904,2.030695645801136
SIM,1890,46,na,1936,3578
STAT,1875,24,50-100,1899,0.4161191001977464
SIM,1848,30,20-24,1878,42
STAT,1828,70,na,1898,949.7833231279758
STAT,1861,36,50-100,1897,1.0259579608693425
STAT,1921,27,50-100,1948,1.096169258752283
STAT,1815,43,30-34,1858,0.12009872959781744
STAT,1866,46,40-44,1912,0.15671825634389833
SIM,1892,19,35-39,1911,23
STAT,1878,48,25-29,1926,0.058518227265797945
STAT,1946,19,35-39,1965,4.600748170408122
STAT,1898,30,45-49,1928,2.363796005411513
SIM,1952,19,30-34,1971,32
STAT,1912,37,15-19,1949,0.01852503761429769
STAT,1832,29,na,1861,2387.106356152543
SIM,1907,33,40-44,1940,6
STAT,1901,22,35-39,1923,8.159256858960848
SIM,1899,22,20-24,1921,833
STAT,1903,69,na,1972,2485.333509747838
STAT,1852,21,30-34,1873,21.453597355955623
SIM,1935,35,na,1970,5677
STAT,1840,59,na,1899,765.2479371287113
STAT,1842,31,15-19,1873,0.04315174958747757
STAT,1882,34,30-34,1916,16.572995882681177
STAT,1831,47,30-34,1878,0.09128260751435052
STAT,1925,42,45-49,1967,0.199651569261708
SIM,1854,9,na,1863,2511
STAT,1925,23,40-44,1948,3.975569702048418
STAT,1838,77,na,1915,368.63925816463757
SIM,1941,20,na,1961,3838
SIM,1792,67,na,1859,879
STAT,1932,30,15-19,1962,0.16983184788917333
STAT,1863,37,25-29,1900,2.4580060316585848
SIM,1852,18,na,1870,2522
STAT,1898,18,25-29,1916,7.600180132100388
SIM,1920,28,25-29,1948,12
STAT,1854,21,40-44,1875,1.3712000955766115
STAT,1821,37,na,1858,1452.6400516818965
STAT,1929,19,35-39,1948,5.289101366148341
STAT,1894,9,na,1903,3299.4873261842235
STAT,1837,44,20-24,1881,0.13327983317947548
STAT,1931,34,20-24,1965,3.1695483235785384
STAT,1825,31,15-19,1856,0.2620589461381472
SIM,1889,34,25-29,1923,13
STAT,1872,72,na,1944,1264.6119286341207
SIM,1931,13,na,1944,5184
STAT,1804,97,na,1901,3.4038548354271003
STAT,1942,24,25-29,1966,95.67718698317691
SIM,1935,27,na,1962,5716
STAT,1795,66,na,1861,936.7131777155217
STAT,1892,22,15-19,1914,4.084501297443398
STAT,1951,1,na,1952,4800.204349591622
SIM,1855,23,15-19,1878,6
STAT,1802,53,na,1855,1626.1734650064798
STAT,1857,29,50-100,1886,0.4983746831140162
STAT,1823,54,50-100,1877,0.02179132368171693
STAT,1840,70,na,1910,552.4669141513257
STAT,1912,28,25-29,1940,63.884028505736794
SIM,1920,50,na,1970,3607
STAT,1927,36,20-24,1963,0.32537231578625603
STAT,1920,22,45-49,1942,1.2347927500479714
STAT,1813,93,na,1906,21.408362060589496
STAT,1841,33,30-34,1874,23.345912600628083
STAT,1940,28,30-34,1968,39.48830961796585
STAT,1885,32,25-29,1917,10.067961361198165
SIM,1880,36,na,1916,3290
SIM,1846,33,na,1879,1154
STAT,1826,44,45-49,1870,2.1714363897278517
STAT,1867,24,25-29,1891,53.799976991762804
STAT,1886,19,45-49,1905,0.06728196172128956
STAT,1900,36,50-100,1936,0.36886401786212086
STAT,1881,54,30-34,1935,0.0054666954080030625
STAT,1845,22,50-100,1867,0.2512076184683098
SIM,1893,32,25-29,1925,25
STAT,1856,47,35-39,1903,0.10008670291635159
STAT,1883,49,45-49,1932,0.22230172636463694
STAT,1865,41,50-100,1906,0.9688954121129809
STAT,1877,21,35-39,1898,5.941598770282485
STAT,1893,35,45-49,1928,2.5165860553613775
SIM,1890,43,na,1933,3562
STAT,1835,34,50-100,1869,0.8644605056887781
STAT,1925,40,25-29,1965,0.08590143183574415
STAT,1940,31,30-34,1971,16.132346075876754
STAT,1827,29,na,1856,2077.2949922413727
STAT,1866,20,20-24,1886,64.33882553173062
SIM,1925,4,na,1929,5404
STAT,1937,29,40-44,1966,4.492127974993768
SIM,1924,34,25-29,1958,4
STAT,1818,41,25-29,1859,1.2902986491595014
STAT,1922,35,25-29,1957,1.1097782449396882
SIM,1896,24,15-19,1920,34
SIM,1920,39,na,1959,3726
STAT,1827,47,50-100,1874,0.22485315693499036
SIM,1817,52,na,1869,2447
STAT,1874,29,50-100,1903,0.6554864825916713
STAT,1918,29,30-34,1947,40.84251052892455
STAT,1842,48,45-49,1890,0.0578495635724355
STAT,1793,88,na,1881,42.32290511895326
STAT,1923,44,30-34,1967,0.1473614834241239
STAT,1926,27,45-49,1953,2.0532485183205362
STAT,1828,31,40-44,1859,6.786086441424396
SIM,1833,22,25-29,1855,14
STAT,1896,31,na,1927,3158.5588816957643
STAT,1908,39,15-19,1947,0.017660836143109482
STAT,1909,26,50-100,1935,0.9528183342658428
STAT,1932,21,25-29,1953,120.71697512255021
STAT,1857,42,15-19,1899,0.010584083693740854
STAT,1874,27,50-100,1901,0.6602050919744057
STAT,1918,18,20-24,1936,145.19420573253095
SIM,1830,36,25-29,1866,2
STAT,1897,56,na,1953,2708.739910744962
STAT,1918,25,15-19,1943,0.7461853630230846
SIM,1926,29,30-34,1955,22
STAT,1872,2,na,1874,3306.3404358694906
STAT,1893,42,na,1935,2886.7112212191278
STAT,1916,45,35-39,1961,0.13105076566011126
STAT,1863,34,20-24,1897,2.2878774400056487
STAT,1912,43,na,1955,3519.1138797695544
SIM,1874,20,20-24,1894,2
STAT,1877,23,30-34,1900,18.025738871160474
STAT,1911,45,20-24,1956,0.010392945312336168
STAT,1852,34,45-49,1886,1.780060445492185
STAT,1928,32,15-19,1960,0.15945939933551
STAT,1800,103,na,1903,0.09902181915896906
SIM,1904,49,50-100,1953,3
STAT,1897,45,30-34,1942,0.07323892039465785
STAT,1839,62,na,1901,1698.0830360707753
STAT,1906,40,15-19,1946,0.0014026879356949886
STAT,1921,31,20-24,1952,2.693191561244857
STAT,1916,34,25-29,1950,9.331600892210945
STAT,1915,37,40-44,1952,1.4909002634351063
STAT,1825,59,na,1884,1279.067884443461
SIM,1910,51,na,1961,3794
STAT,1888,24,15-19,1912,3.783777462196878
STAT,1839,21,45-49,1860,0.8384404823705633
STAT,1856,34,20-24,1890,1.924859361607568
STAT,1938,26,25-29,1964,64.53926196526574
SIM,1907,17,na,1924,4865
STAT,1907,18,45-49,1925,0.09506214498038121
STAT,1946,18,50-100,1964,0.4109248342276058
STAT,1882,37,35-39,1919,6.771687579215826
SIM,1907,36,45-49,1943,1
SIM,1849,34,25-29,1883,4
SIM,1859,51,na,1910,1707
STAT,1815,46,35-39,1861,0.014380644875097161
STAT,1836,31,50-100,1867,0.8967248970558869
STAT,1900,26,40-44,1926,4.163951720834536
SIM,1845,70,na,1915,1119
STAT,1906,23,30-34,1929,25.713755756199017
STAT,1893,49,50-100,1942,0.16962943109546244
STAT,1779,81,na,1860,309.8598418653471
STAT,1850,18,na,1868,1287.6096796293778
SIM,1929,20,na,1949,6274
STAT,1907,7,na,1914,3801.4670321314497
STAT,1911,16,45-49,1927,0.09907953901039686
STAT,1845,34,45-49,1879,1.0077158946245397
SIM,1924,3,na,1927,5320
STAT,1895,22,40-44,1917,2.7107695679115555
STAT,1922,18,40-44,1940,1.5965003075761923
STAT,1935,30,40-44,1965,5.38118361448282
STAT,1923,35,na,1958,4320.822644621349
SIM,1855,28,20-24,1883,34
STAT,1904,19,30-34,1923,2.2649428807974976
STAT,1897,35,20-24,1932,1.0334498227601197
STAT,1881,42,50-100,1923,0.9964296988686865
STAT,1913,28,na,1941,3672.8906709450866
STAT,1852,24,35-39,1876,6.8781030400549055
STAT,1839,104,na,1943,0.06196874676867626
STAT,1843,49,15-19,1892,3.869657207013409E-4
STAT,1919,26,15-19,1945,0.7552289161667328
STAT,1902,65,na,1967,2657.159304534835
STAT,1847,28,20-24,1875,12.657061751450664
STAT,1830,46,30-34,1876,0.08379171517799937
STAT,1878,45,20-24,1923,0.012469519874478904
STAT,1816,39,50-100,1855,4.299885953134447
STAT,1815,40,50-100,1855,0.11609472629100928
SIM,1867,42,25-29,1909,5
STAT,1913,21,15-19,1934,5.1088643341884525
STAT,1834,55,na,1889,916.8570178170014
SIM,1879,68,na,1947,798
STAT,1869,32,40-44,1901,4.376102052151558
STAT,1943,8,na,1951,4145.128261293451
STAT,1858,26,50-100,1884,0.5037023215407761
STAT,1860,45,35-39,1905,0.11534953750143366
SIM,1928,19,20-24,1947,184
STAT,1815,52,na,1867,198.3276456030269
SIM,1891,39,na,1930,2076
STAT,1862,51,na,1913,1842.7159674730237
SIM,1832,52,na,1884,1517
STAT,1811,67,na,1878,1111.600884610254
STAT,1871,98,na,1969,18.78274175857156
STAT,1857,17,25-29,1874,5.1109025576872265
STAT,1874,39,na,1913,2407.052919044077
STAT,1873,18,20-24,1891,18.137920092229457
STAT,1896,71,na,1967,2078.379188547505
SIM,1958,5,na,1963,4197
SIM,1911,25,na,1936,2472
STAT,1871,24,45-49,1895,0.6912540607918135
STAT,1922,23,15-19,1945,6.017725186442629
STAT,1838,17,15-19,1855,3.3462647092295703
STAT,1938,12,na,1950,3866.6983602870655
SIM,1922,17,na,1939,3674
STAT,1903,18,30-34,1921,2.256587760262891
STAT,1923,19,40-44,1942,1.6164314213578905
SIM,1890,37,35-39,1927,2
STAT,1845,15,40-44,1860,0.11607556601037586
STAT,1879,16,na,1895,2597.2306124424013
STAT,1857,80,na,1937,474.6869297790747
STAT,1879,21,45-49,1900,0.7174999278195757
STAT,1923,24,15-19,1947,6.090224839236581
SIM,1902,29,15-19,1931,7
SIM,1919,39,40-44,1958,9
STAT,1841,23,20-24,1864,96.5144690995233
STAT,1871,47,30-34,1918,0.09611204531684701
STAT,1913,29,25-29,1942,64.29816705360365
STAT,1859,42,25-29,1901,0.5083423002799874
STAT,1872,25,45-49,1897,1.1193555852210446
STAT,1909,40,40-44,1949,0.23419443832894682
SIM,1878,33,40-44,1911,1
STAT,1914,44,35-39,1958,0.19610167042546112
STAT,1945,16,15-19,1961,49.04194796475588
STAT,1863,47,na,1910,1911.7622521215897
STAT,1849,32,na,1881,2118.7616224251415
SIM,1895,13,na,1908,4648
SIM,1928,22,20-24,1950,1275
STAT,1910,15,45-49,1925,0.0983296888634278
STAT,1858,29,35-39,1887,7.435212867176567
SIM,1832,41,na,1873,1962
STAT,1925,27,50-100,1952,1.1648671319381245
STAT,1872,48,30-34,1920,0.09571365970439166
STAT,1871,87,na,1958,234.13736217268635
STAT,1901,27,40-44,1928,4.18844294100997
STAT,1930,38,50-100,1968,0.5432500782406278
STAT,1794,70,na,1864,8.265091499468786
STAT,1944,15,15-19,1959,48.31541839477737
STAT,1843,48,50-100,1891,0.2396147079427834
STAT,1811,78,na,1889,465.64809613842726
STAT,1800,75,na,1875,724.9486397341387
STAT,1908,23,40-44,1931,3.0577276191191234
SIM,1879,82,na,1961,63
STAT,1790,80,na,1870,346.4518884088196
STAT,1820,52,na,1872,1641.3689656002266
STAT,1887,35,20-24,1922,0.8565105610441055
STAT,1856,17,30-34,1873,1.3536540799262136
STAT,1930,17,15-19,1947,58.26153589188636
STAT,1937,34,15-19,1971,0.12565979701426114
STAT,1823,101,na,1924,0.450779504505339
SIM,1840,25,na,1865,2488
STAT,1850,54,50-100,1904,0.00678209382806017
STAT,1881,50,20-24,1931,7.068665870134027E-4
SIM,1874,20,15-19,1894,10
SIM,1935,32,35-39,1967,1
STAT,1864,53,25-29,1917,0.0031683640954555652
STAT,1840,16,25-29,1856,2.906042993120891
STAT,1866,95,na,1961,26.58742987079272
STAT,1911,24,na,1935,3556.0559546173513
STAT,1828,56,na,1884,1442.9372174588602
STAT,1868,33,30-34,1901,16.792666849922075
STAT,1906,35,40-44,1941,1.3811977656508077
SIM,1853,65,na,1918,2608
STAT,1804,52,15-19,1856,1.5536769642415246E-4
STAT,1824,33,30-34,1857,7.407519027975999
STAT,1871,28,20-24,1899,11.661441220733089
STAT,1886,10,na,1896,2682.412352344525
SIM,1832,26,25-29,1858,270
STAT,1905,45,50-100,1950,0.20124984701811724
STAT,1808,100,na,1908,0.24864123267918178
STAT,1921,39,25-29,1960,1.0840474011971823
STAT,1836,43,50-100,1879,0.950784700818988
SIM,1871,44,50-100,1915,5
STAT,1890,15,na,1905,3071.7228070857473
STAT,1888,32,45-49,1920,2.012656277375975
STAT,1916,31,20-24,1947,2.4940588314511007
SIM,1828,76,na,1904,713
STAT,1825,37,50-100,1862,1.7671360004067937
STAT,1855,38,20-24,1893,0.5076454354713573
SIM,1881,28,30-34,1909,12
STAT,1863,32,40-44,1895,3.70230819781463
SIM,1914,35,40-44,1949,2
SIM,1933,35,35-39,1968,1
STAT,1849,49,45-49,1898,0.19469981196428693
STAT,1923,47,35-39,1970,0.14923866295266347
STAT,1942,21,20-24,1963,115.29298319056436
STAT,1843,20,20-24,1863,86.70578693068299
STAT,1844,38,45-49,1882,2.06539470286925
SIM,1869,26,20-24,1895,12
SIM,1940,25,40-44,1965,15
STAT,1891,24,30-34,1915,21.767152069297598
STAT,1915,28,45-49,1943,1.731119315960035
STAT,1813,47,15-19,1860,0.0014711328271170912
STAT,1846,35,45-49,1881,1.2588178866833961
STAT,1923,27,25-29,1950,74.77385495354983
STAT,1843,13,na,1856,3000.5681719248
SIM,1919,50,na,1969,4729
STAT,1833,39,40-44,1872,2.310618352318268
STAT,1876,16,45-49,1892,0.06619722813438532
STAT,1931,21,45-49,1952,1.4534427717797778
SIM,1834,23,25-29,1857,36
STAT,1899,50,na,1949,2983.2856462765276
STAT,1828,31,35-39,1859,15.846815292917316
SIM,1867,30,25-29,1897,1
STAT,1925,35,35-39,1960,2.8814533180058564
STAT,1871,3,na,1874,3117.1297436214627
STAT,1876,49,50-100,1925,0.24309513593671073
STAT,1895,22,35-39,1917,7.591215420503824
SIM,1837,37,25-29,1874,6
STAT,1952,0,na,1952,5188.163981705818
SIM,1910,37,na,1947,4181
STAT,1873,28,30-34,1901,25.740154243866716
STAT,1839,25,50-100,1864,0.759573665661961
STAT,1887,28,15-19,1915,0.4976204099451814
STAT,1932,25,40-44,1957,6.067804302955895
STAT,1922,18,35-39,1940,4.789500645422186
STAT,1900,47,40-44,1947,0.1331547958709498
STAT,1958,11,na,1969,5114.441511515126
STAT,1866,97,na,1963,14.508374018904702
STAT,1903,34,45-49,1937,1.4091913782321015
SIM,1845,56,na,1901,2062
STAT,1943,20,25-29,1963,97.21990018748458
STAT,1882,46,25-29,1928,0.05530340256357512
SIM,1934,28,20-24,1962,13
STAT,1884,21,20-24,1905,66.16719149214639
STAT,1856,37,25-29,1893,2.0679936076095986
STAT,1831,23,20-24,1854,173.0464509684175
STAT,1952,2,na,1954,4709.91008147747
STAT,1896,39,20-24,1935,1.0059279235543857
STAT,1850,51,30-34,1901,0.0027618104213055607
SIM,1909,20,30-34,1929,99
STAT,1851,28,35-39,1879,8.858659492525359
SIM,1919,39,35-39,1958,34
STAT,1883,67,na,1950,1525.0480288219
STAT,1898,47,30-34,1945,0.07308360731148573
SIM,1924,31,20-24,1955,14
STAT,1850,19,50-100,1869,0.027319729091825846
STAT,1896,28,25-29,1924,55.56665849548678
STAT,1835,34,45-49,1869,1.6452635532412574
STAT,1859,30,25-29,1889,8.236471480392368
STAT,1929,28,30-34,1957,48.67102900875086
STAT,1870,50,45-49,1920,0.014675816280775163
STAT,1912,44,25-29,1956,0.06754514721006076
STAT,1807,108,na,1915,7.426779150642873E-4
STAT,1881,86,na,1967,444.91001489258474
STAT,1890,43,25-29,1933,0.7717842080584233
SIM,1886,30,na,1916,2933
STAT,1903,15,na,1918,3601.783244545505
STAT,1880,38,15-19,1918,0.05800795466016274
STAT,1869,20,40-44,1889,2.1243348075750226
STAT,1881,47,20-24,1928,0.011279342440411996
STAT,1919,38,15-19,1957,0.02033578463284414
SIM,1841,39,40-44,1880,5
SIM,1938,24,30-34,1962,1
STAT,1917,16,45-49,1933,0.10632256996200934
STAT,1837,42,40-44,1879,2.128176827728332
STAT,1905,33,50-100,1938,0.7535189424935561
STAT,1921,34,na,1955,4123.336212246867
STAT,1927,32,35-39,1959,11.149719124266161
STAT,1829,48,20-24,1877,0.005478882161726211
STAT,1928,36,30-34,1964,2.287918754875489
SIM,1873,27,25-29,1900,367
SIM,1787,69,na,1856,1329
STAT,1841,45,25-29,1886,0.06610442930679129
STAT,1939,31,15-19,1970,0.1297497791517023
STAT,1926,28,20-24,1954,21.618237584632798
SIM,1831,49,25-29,1880,1
STAT,1854,106,na,1960,0.01877680767620448
STAT,1866,36,30-34,1902,4.888353555886952
STAT,1887,43,50-100,1930,1.1544084003869233
STAT,1874,92,na,1966,130.61986065157961
STAT,1900,45,45-49,1945,0.18625278824908004
STAT,1912,46,20-24,1958,0.01052335979225044
SIM,1933,5,na,1938,4652
SIM,1848,13,na,1861,2793
STAT,1885,39,45-49,1924,1.9397750197077879
STAT,1814,56,na,1870,1779.5361431903273
STAT,1803,80,na,1883,195.44546842125263
STAT,1833,26,35-39,1859,6.122876312394998
STAT,1929,15,25-29,1944,55.17222735908785
STAT,1884,29,45-49,1913,1.0552660540596266
STAT,1823,92,na,1915,32.902078346049755
STAT,1849,27,40-44,1876,2.9920100192484775
STAT,1905,31,45-49,1936,1.44607987098689
STAT,1870,47,45-49,1917,0.23417934934912693
STAT,1928,16,20-24,1944,169.946344551494
STAT,1852,54,45-49,1906,0.014206309843126295
STAT,1850,23,30-34,1873,9.80123016901662
STAT,1818,48,45-49,1866,0.4145333235136379
STAT,1914,34,20-24,1948,2.4003909978736564
STAT,1845,38,20-24,1883,0.397746395927577
STAT,1858,34,25-29,1892,7.754943172814137
SIM,1896,62,na,1958,2219
STAT,1781,105,na,1886,0.022798029463048947
SIM,1831,33,50-100,1864,14
STAT,1845,28,na,1873,1297.200872054374
SIM,1925,2,na,1927,5488
STAT,1839,47,35-39,1886,0.1325237484225551
STAT,1907,16,50-100,1923,0.07165946222668715
STAT,1865,24,15-19,1889,3.0049720029052454
STAT,1834,38,45-49,1872,1.081521303191336
STAT,1918,22,50-100,1940,0.7000940905472508
SIM,1959,6,na,1965,5267
STAT,1840,49,25-29,1889,0.022292641275499868
STAT,1864,31,45-49,1895,1.5917981001140262
STAT,1844,109,na,1953,7.048352869191301E-4
STAT,1923,42,50-100,1965,0.13586531055780718
STAT,1937,30,50-100,1967,0.8104498636357788
SIM,1875,4,na,1879,3301
SIM,1873,34,30-34,1907,76
SIM,1893,36,40-44,1929,13
STAT,1840,27,20-24,1867,5.759608773363735
STAT,1911,56,na,1967,3310.662721761993
STAT,1819,48,20-24,1867,0.002186153895315095
STAT,1890,18,20-24,1908,21.40605776730708
STAT,1943,15,50-100,1958,0.3929679355382332
SIM,1842,35,40-44,1877,162
SIM,1886,52,na,1938,2887
STAT,1858,68,na,1926,1167.0299082260817
STAT,1835,26,na,1861,2148.6395512123945
STAT,1879,24,50-100,1903,0.41570884550442905
STAT,1900,64,na,1964,2618.844390995146
STAT,1900,17,45-49,1917,0.09049031390563739
SIM,1887,49,30-34,1936,1
STAT,1879,30,na,1909,2467.650110066841
STAT,1844,32,30-34,1876,20.684499602614498
SIM,1873,12,na,1885,2483
SIM,1815,58,na,1873,1018
STAT,1879,49,30-34,1928,0.09722796162571044
SIM,1919,42,na,1961,4901
STAT,1927,1,na,1928,5150.1649687736935
STAT,1947,24,30-34,1971,32.11891887665253
STAT,1881,34,15-19,1915,0.13333098424771472
STAT,1910,24,35-39,1934,8.688763925807931
STAT,1823,49,25-29,1872,0.08733470052495848
STAT,1889,26,50-100,1915,0.7729771583424624
STAT,1887,36,45-49,1923,2.2047380646767043
STAT,1833,70,na,1903,577.2769214545301
STAT,1886,18,na,1904,2608.539354520837
STAT,1922,48,30-34,1970,0.10098762621021017
STAT,1814,43,15-19,1857,0.046908912797450936
STAT,1937,29,35-39,1966,14.46946979761028
STAT,1823,52,25-29,1875,0.005318182409840988
STAT,1886,39,20-24,1925,0.7902185845844519
SIM,1943,24,na,1967,4975
STAT,1933,17,40-44,1950,1.8596735920618817
SIM,1847,47,35-39,1894,6
STAT,1857,22,50-100,1879,0.3612511830470652
STAT,1897,38,25-29,1935,3.8047577279058076
STAT,1918,45,45-49,1963,0.22923677928919683
STAT,1849,41,20-24,1890,0.13442005013124003
STAT,1885,36,40-44,1921,4.323573501557719
SIM,1835,32,30-34,1867,1
STAT,1840,52,25-29,1892,0.0013872592289842544
STAT,1829,37,25-29,1866,1.4602826813132728
STAT,1891,62,na,1953,2247.613527052406
STAT,1883,21,na,1904,2282.1481848350063
STAT,1891,64,na,1955,2137.709316236161
STAT,1916,17,40-44,1933,0.29271014705037574
SIM,1936,22,na,1958,3835
STAT,1894,23,30-34,1917,22.581149883331282
STAT,1928,19,25-29,1947,53.89777552060032
STAT,1964,0,na,1964,4939.969199695999
STAT,1860,40,35-39,1900,1.4921536636840533
STAT,1907,20,15-19,1927,4.842316264650347
STAT,1824,34,na,1858,565.4912927027149
STAT,1889,38,35-39,1927,8.475142715098944
SIM,1887,39,20-24,1926,1
SIM,1897,38,35-39,1935,23
SIM,1904,25,30-34,1929,4
STAT,1870,22,30-34,1892,17.75765521044947
STAT,1850,16,25-29,1866,3.216483802361099
SIM,1906,33,25-29,1939,12
STAT,1827,32,30-34,1859,17.974041581876623
STAT,1825,45,40-44,1870,0.22333185944556747
STAT,1943,28,20-24,1971,19.20946657049648
SIM,1912,18,na,1930,4794
SIM,1869,80,na,1949,3268
STAT,1820,50,na,1870,1707.687779691196
STAT,1865,46,25-29,1911,0.05273759298002576
STAT,1834,28,35-39,1862,5.536070639969922
STAT,1870,28,45-49,1898,1.1030016882582907
STAT,1893,22,50-100,1915,0.5099532505032742
STAT,1873,21,45-49,1894,0.7174578085501492
STAT,1871,42,na,1913,2302.723973290739
STAT,1871,21,35-39,1892,5.838720512591838
STAT,1876,35,45-49,1911,2.0343706228251546
STAT,1913,25,30-34,1938,38.813580187589864
STAT,1830,42,15-19,1872,0.012208257235735907
SIM,1831,56,na,1887,2133
SIM,1857,41,20-24,1898,2
STAT,1848,37,35-39,1885,6.820659233278855
SIM,1867,35,45-49,1902,1
STAT,1881,28,20-24,1909,11.03957324854318
STAT,1903,35,15-19,1938,0.017368540728613328
STAT,1873,99,na,1972,15.514721070828466
STAT,1924,20,15-19,1944,6.258060557663114
STAT,1875,36,40-44,1911,4.516683412833164
STAT,1923,27,na,1950,4255.7436872836115
STAT,1831,24,45-49,1855,1.1274323856702386
STAT,1871,43,15-19,1914,0.013676393454539023
STAT,1865,48,na,1913,2028.2748885427177
SIM,1852,32,30-34,1884,122
SIM,1882,48,na,1930,1695
STAT,1853,22,30-34,1875,16.318801424218798
SIM,1883,36,40-44,1919,51
STAT,1830,27,20-24,1857,11.280520088636935
STAT,1892,29,35-39,1921,11.860896488079632
STAT,1895,49,15-19,1944,2.8739144638925397E-4
STAT,1841,26,25-29,1867,58.93027596079191
STAT,1870,19,15-19,1889,5.902558165708783
SIM,1848,11,na,1859,2793
SIM,1824,86,na,1910,857
STAT,1875,29,35-39,1904,9.837209132921885
STAT,1952,18,20-24,1970,160.93406526163565
STAT,1869,39,20-24,1908,0.7700209362045475
STAT,1934,38,50-100,1972,0.5748833428384448
STAT,1842,85,na,1927,68.05235626566311
STAT,1934,25,50-100,1959,1.3310820799578362
STAT,1914,17,30-34,1931,2.486281515356589
STAT,1891,17,25-29,1908,6.968538883391027
STAT,1860,20,20-24,1880,64.60907981528692
STAT,1940,27,25-29,1967,66.36567551437217
STAT,1854,21,35-39,1875,3.839896770774546
STAT,1929,21,45-49,1950,1.4171663367821925
STAT,1776,113,na,1889,9.320248230345744E-4
SIM,1951,11,na,1962,2373
STAT,1838,48,30-34,1886,0.041970759908118375
SIM,1928,25,na,1953,4602
STAT,1899,32,20-24,1931,3.692019528786236
STAT,1825,38,35-39,1863,9.932112377993203
STAT,1859,46,40-44,1905,0.1360771104388989
STAT,1904,27,15-19,1931,0.6482029740003312
SIM,1873,63,na,1936,1011
SIM,1878,49,20-24,1927,1
STAT,1844,62,na,1906,1810.7129417265949
STAT,1781,103,na,1884,0.05805230941455448
STAT,1860,28,45-49,1888,0.9089085427560863
STAT,1782,93,na,1875,21.025210707082067
STAT,1906,55,na,1961,3108.5905850288023
SIM,1912,39,25-29,1951,3
STAT,1803,101,na,1904,0.14394068787186529
STAT,1844,35,40-44,1879,5.141662161605045
STAT,1905,18,35-39,1923,0.7871518739635338
SIM,1874,39,35-39,1913,11
STAT,1896,45,15-19,1941,3.004013506053101E-4
STAT,1866,12,na,1878,2457.895071470798
STAT,1843,23,25-29,1866,70.48616283187518
STAT,1876,25,35-39,1901,9.820354819460178
STAT,1942,7,na,1949,4099.734065296297
STAT,1839,17,30-34,1856,1.937114665341082
STAT,1908,26,45-49,1934,1.639888656583934
STAT,1818,39,15-19,1857,0.12148656217055837
STAT,1887,16,20-24,1903,19.561244242991595
STAT,1870,44,40-44,1914,2.2121097203910653
STAT,1860,18,35-39,1878,0.5132230948083034
SIM,1903,35,na,1938,2817
STAT,1864,50,20-24,1914,6.80487407200508E-4
STAT,1836,65,na,1901,1293.390809587021
SIM,1924,0,na,1924,5495
STAT,1917,38,20-24,1955,0.2688075569316036
STAT,1883,17,35-39,1900,0.5278818975386331
STAT,1845,31,35-39,1876,6.037377505595344
STAT,1910,36,45-49,1946,0.6478011296053225
STAT,1946,15,25-29,1961,47.570739150013736
STAT,1909,19,15-19,1928,8.762007879831199
SIM,1939,17,na,1956,4734
SIM,1833,77,na,1910,1615
STAT,1914,37,25-29,1951,0.9694007253291672
STAT,1832,75,na,1907,873.8840124912506
SIM,1862,26,na,1888,3418
STAT,1904,39,25-29,1943,0.8789263152547457
STAT,1906,47,35-39,1953,0.11382346373372385
STAT,1824,36,35-39,1860,1.1047962057003196
STAT,1932,28,45-49,1960,2.245991500752827
STAT,1940,19,40-44,1959,1.4032958650008096
STAT,1866,39,35-39,1905,6.391315346918013
STAT,1888,39,30-34,1927,6.089296080624455
STAT,1844,94,na,1938,19.79998524646707
STAT,1929,0,na,1929,5709.195872375849
STAT,1803,53,40-44,1856,0.022500871044564368
SIM,1906,24,na,1930,3537
SIM,1868,33,na,1901,1169
STAT,1864,47,20-24,1911,0.010858414633279419
STAT,1849,49,50-100,1898,0.20261980398260707
STAT,1857,30,15-19,1887,0.11226012914489288
STAT,1866,27,40-44,1893,2.7344067897420694
STAT,1933,37,na,1970,5089.600933623632
STAT,1810,74,na,1884,34.0121018415098
STAT,1843,28,45-49,1871,1.340396623702349
STAT,1911,29,15-19,1940,0.6758354589706801
STAT,1879,39,20-24,1918,0.7828087787927576
STAT,1921,36,20-24,1957,0.29111664934693654
SIM,1842,73,na,1915,1595
STAT,1851,25,30-34,1876,23.62467603211576
STAT,1859,93,na,1952,23.16383128848358
STAT,1912,24,45-49,1936,1.1037097663878732
STAT,1949,20,na,1969,4222.084340577404
SIM,1949,20,25-29,1969,3
STAT,1900,32,na,1932,3305.72191493662
SIM,1899,59,na,1958,1469
STAT,1839,34,15-19,1873,0.15947152866659306
STAT,1934,16,45-49,1950,0.6727530589647457
STAT,1849,20,15-19,1869,3.4095636650076635
STAT,1812,48,50-100,1860,0.06236163983179235
STAT,1808,58,na,1866,650.2459754998878
STAT,1873,17,30-34,1890,1.634958799294378
STAT,1790,88,na,1878,63.75573488383155
STAT,1918,20,30-34,1938,30.762564889763155
SIM,1863,38,20-24,1901,4
SIM,1886,38,na,1924,2708
STAT,1898,17,35-39,1915,0.7378583999928255
STAT,1912,41,20-24,1953,0.016932029115378434
STAT,1848,45,20-24,1893,0.011341246324064667
STAT,1840,33,15-19,1873,0.06759183606321177
STAT,1852,51,40-44,1903,0.010647707536547327
STAT,1858,31,20-24,1889,2.0857755221022765
STAT,1858,46,na,1904,1723.0011485576017
STAT,1855,28,50-100,1883,0.43812595119244035
SIM,1837,59,na,1896,1649
STAT,1819,41,35-39,1860,0.4320483228640779
STAT,1892,36,40-44,1928,5.445844822974525
STAT,1915,25,40-44,1940,4.718803465045874
STAT,1838,41,45-49,1879,0.7567963689525343
STAT,1818,45,40-44,1863,0.3147782595265309
STAT,1890,69,na,1959,1886.3257725845742
STAT,1849,40,na,1889,1981.4676031066033
SIM,1926,20,30-34,1946,27
STAT,1964,8,na,1972,4901.499724370989
STAT,1912,49,25-29,1961,0.05009151657421703
STAT,1875,51,35-39,1926,0.008882528724770421
STAT,1891,27,35-39,1918,11.865564701309742
STAT,1779,111,na,1890,0.0019969651210523065
STAT,1885,20,25-29,1905,56.60527337428797
STAT,1861,74,na,1935,922.9478510519682
STAT,1893,45,na,1938,2842.0660665863184
STAT,1872,24,20-24,1896,68.57419614864692
STAT,1928,39,35-39,1967,3.0270925563585314
STAT,1906,27,25-29,1933,61.25547718995959
STAT,1850,26,35-39,1876,5.281157804535631
SIM,1893,20,25-29,1913,30
STAT,1834,30,20-24,1864,1.5579585383795023
SIM,1880,24,20-24,1904,33
STAT,1899,68,na,1967,2380.301583826146
SIM,1839,26,35-39,1865,5
STAT,1868,78,na,1946,754.6664901451093
STAT,1877,22,25-29,1899,58.11118519320772
STAT,1884,24,25-29,1908,54.456588585025024
STAT,1924,23,25-29,1947,107.61402778879422
STAT,1855,51,50-100,1906,0.010043375356964793
STAT,1851,50,35-39,1901,0.006897080832929187
SIM,1906,46,na,1952,3320
STAT,1832,27,30-34,1859,30.575188913626558
STAT,1899,18,40-44,1917,0.24916677327636777
STAT,1854,42,40-44,1896,1.2490973927802311
STAT,1846,48,20-24,1894,0.007017829288854731
STAT,1868,24,40-44,1892,2.000090439422538
STAT,1949,21,30-34,1970,33.21768979458503
STAT,1822,37,15-19,1859,0.11328661450883935
SIM,1941,23,na,1964,3829
STAT,1870,25,35-39,1895,9.684597190290498
STAT,1878,38,15-19,1916,0.05748913336674738
SIM,1825,33,25-29,1858,2
SIM,1850,49,35-39,1899,2
STAT,1909,28,20-24,1937,17.20681506075235
STAT,1838,38,20-24,1876,0.39296020731791403
STAT,1880,54,20-24,1934,7.450077580784774E-4
SIM,1827,41,35-39,1868,18
SIM,1901,26,na,1927,3510
STAT,1908,38,na,1946,3477.843521231699
STAT,1846,32,40-44,1878,3.035287997443001
STAT,1842,49,35-39,1891,0.0340285840923618
STAT,1823,47,na,1870,2057.995915240179
STAT,1828,42,50-100,1870,1.3210668045438518
SIM,1893,39,45-49,1932,6
SIM,1842,30,20-24,1872,3
SIM,1888,19,na,1907,553
STAT,1819,52,50-100,1871,0.0026526043797823785
STAT,1886,32,35-39,1918,10.487084219506755
SIM,1846,38,20-24,1884,1
STAT,1878,22,35-39,1900,6.003945896766629
STAT,1894,59,na,1953,2471.4227766955746
SIM,1888,0,na,1888,1522
SIM,1801,58,na,1859,1904
STAT,1844,29,15-19,1873,0.5423639952047813
STAT,1918,46,15-19,1964,3.8767792116722736E-4
STAT,1881,7,na,1888,2489.262784320551
STAT,1890,40,20-24,1930,0.1942001855010753
STAT,1837,45,45-49,1882,0.20153156068602315
STAT,1876,73,na,1949,1200.7087024695538
SIM,1959,4,na,1963,5267
STAT,1926,20,25-29,1946,111.91957216902388
SIM,1947,6,na,1953,4409
STAT,1830,47,15-19,1877,3.4183874767634983E-4
STAT,1906,38,45-49,1944,0.6199807880950982
STAT,1900,10,na,1910,3588.340854736385
STAT,1849,5,na,1854,2608.0
STAT,1865,37,35-39,1902,6.457514127273507
STAT,1912,36,50-100,1948,0.4069740404840467
STAT,1896,18,15-19,1914,7.802598226671261
SIM,1863,27,25-29,1890,8
STAT,1792,69,na,1861,885.817659809111
STAT,1931,38,50-100,1969,0.5515774625407173
STAT,1858,17,40-44,1875,0.16316075212456174
STAT,1890,21,45-49,1911,0.8467312248227182
STAT,1864,31,na,1895,2178.275637660017
STAT,1902,27,20-24,1929,16.519765489786074
STAT,1817,86,na,1903,70.28802930086337
SIM,1855,15,na,1870,3381
STAT,1892,26,30-34,1918,31.284547872195482
SIM,1826,48,45-49,1874,1
STAT,1944,11,na,1955,4180.346816053244
STAT,1887,33,40-44,1920,4.753164220305833
STAT,1817,38,45-49,1855,1.5412054853879587
STAT,1863,27,15-19,1890,0.38733143677575965
SIM,1875,44,na,1919,2850
STAT,1900,42,40-44,1942,0.2161073353753128
STAT,1871,48,15-19,1919,3.9400345179235486E-4
STAT,1890,37,20-24,1927,0.9331952652943092
STAT,1934,30,25-29,1964,12.54806659031789
SIM,1833,35,30-34,1868,13
STAT,1864,28,20-24,1892,10.627593260903144
STAT,1930,29,25-29,1959,83.02343623520443
SIM,1892,24,25-29,1916,1358
STAT,1829,108,na,1937,6.688895431832438E-4
STAT,1862,49,50-100,1911,0.20481991784379308
STAT,1840,19,35-39,1859,0.2764490857587672
STAT,1851,35,40-44,1886,3.5676704518494198
STAT,1818,36,50-100,1854,3.4790165611412887
STAT,1878,43,50-100,1921,1.0790989517930443
STAT,1829,27,15-19,1856,0.3384157590545651
STAT,1869,53,50-100,1922,0.014995217793443436
STAT,1924,18,45-49,1942,0.5876120379157165
STAT,1825,35,30-34,1860,8.076759428535455
STAT,1897,22,45-49,1919,0.9260792671716479
STAT,1828,78,na,1906,528.9077159660808
STAT,1855,27,25-29,1882,29.181810491422027
SIM,1828,42,40-44,1870,15
STAT,1924,23,na,1947,4254.488770475388
STAT,1846,15,20-24,1861,13.346776219798013
STAT,1886,32,na,1918,2471.144647905367
STAT,1806,77,na,1883,310.3098157177243
SIM,1910,27,20-24,1937,3
STAT,1846,34,20-24,1880,1.8529989259610433
SIM,1855,27,30-34,1882,2
SIM,1952,15,na,1967,6372
STAT,1807,49,40-44,1856,0.5629316888609958
STAT,1849,39,35-39,1888,5.972893978125654
STAT,1905,23,15-19,1928,4.730391795073042
STAT,1921,19,30-34,1940,13.65528223465026
STAT,1927,15,15-19,1942,56.22910475748086
SIM,1883,31,20-24,1914,22
STAT,1833,25,na,1858,1179.7481981208005
SIM,1899,36,35-39,1935,2
STAT,1839,44,30-34,1883,1.0972701481110785
STAT,1939,17,35-39,1956,4.154075790103911
STAT,1914,29,40-44,1943,4.600341670427707
SIM,1808,70,na,1878,1101
STAT,1875,31,20-24,1906,2.7869849119528842
STAT,1820,103,na,1923,0.09869701544933573
STAT,1867,20,30-34,1887,17.160549288061233
SIM,1915,9,na,1924,3758
STAT,1884,60,na,1944,1825.6904578420806
STAT,1834,50,35-39,1884,0.004047516999866921
STAT,1861,24,45-49,1885,0.5872523887911139
SIM,1810,44,35-39,1854,13
STAT,1812,55,na,1867,211.72963610419768
STAT,1895,43,40-44,1938,0.20172111233236745
SIM,1891,31,na,1922,2311
STAT,1901,20,20-24,1921,96.92940138138732
STAT,1940,24,20-24,1964,111.92635018679692
SIM,1887,42,45-49,1929,33
STAT,1850,54,35-39,1904,0.0038660144088415696
STAT,1861,25,50-100,1886,0.5436393675575862
STAT,1870,25,40-44,1895,3.006637463124945
STAT,1899,35,25-29,1934,3.9699496447444624
SIM,1873,43,20-24,1916,1
SIM,1883,73,na,1956,1568
STAT,1877,89,na,1966,266.57383289329925
STAT,1858,22,15-19,1880,2.89059522856811
SIM,1863,17,15-19,1880,1
STAT,1863,38,15-19,1901,0.047702058230395694
SIM,1884,29,na,1913,3627
STAT,1892,24,50-100,1916,0.5017221355639037
SIM,1840,47,na,1887,2572
STAT,1852,25,50-100,1877,0.7608714648194275
SIM,1846,30,na,1876,1245
SIM,1867,49,45-49,1916,1
STAT,1838,53,50-100,1891,0.006343556909778719
STAT,1859,49,45-49,1908,0.18314635773068721
STAT,1908,40,25-29,1948,0.06629930583539526
STAT,1847,27,30-34,1874,27.365231744374537
STAT,1848,44,na,1892,2133.605625163776
STAT,1862,59,na,1921,1655.3281448508537
STAT,1828,52,40-44,1880,0.01213708074742313
STAT,1837,37,15-19,1874,0.054820295560938065
STAT,1861,110,na,1971,0.0036795787272085943
STAT,1869,38,na,1907,2365.582104005242
STAT,1865,34,30-34,1899,15.804089274900143
STAT,1863,35,45-49,1898,1.7180269214744621
SIM,1865,68,na,1933,1523
SIM,1908,30,25-29,1938,17
STAT,1870,15,50-100,1885,0.04989290017329396
SIM,1819,62,na,1881,1462
STAT,1844,35,35-39,1879,8.307606927840018
STAT,1889,46,20-24,1935,0.014491728955705054
STAT,1855,44,15-19,1899,0.00901647810191106
SIM,1892,16,na,1908,3699
STAT,1908,36,na,1944,3512.0021021771795
STAT,1879,42,45-49,1921,1.533422904266385
STAT,1835,24,35-39,1859,5.785098956730074
STAT,1913,28,35-39,1941,14.719953537001087
SIM,1848,49,50-100,1897,1
SIM,1860,45,na,1905,1999
STAT,1881,17,25-29,1898,5.35136234668863
STAT,1804,68,na,1872,1390.894927780702
STAT,1865,43,20-24,1908,0.14394746895135999
STAT,1791,84,na,1875,140.74845144312877
STAT,1857,16,35-39,1873,0.497820703122567
STAT,1865,16,na,1881,2390.220821573329
STAT,1912,21,35-39,1933,8.945929422568085
STAT,1876,24,50-100,1900,0.40965791455754375
STAT,1819,95,na,1914,3.092440695476854
STAT,1827,35,40-44,1862,4.4235333756748165
SIM,1927,29,25-29,1956,1
STAT,1924,48,40-44,1972,0.18537999104327493
STAT,1844,54,40-44,1898,0.01014281762133316
STAT,1915,30,15-19,1945,0.13006527183565253
STAT,1814,47,30-34,1861,0.33092211347079153
SIM,1865,8,na,1873,2035
STAT,1860,23,25-29,1883,47.79590957262014
STAT,1885,36,35-39,1921,6.985785538922674
SIM,1960,2,na,1962,6451
STAT,1826,97,na,1923,4.282945422183372
STAT,1835,39,15-19,1874,0.05144799154062179
STAT,1889,39,50-100,1928,1.4635983192785196
STAT,1842,46,30-34,1888,0.024343978785314115
STAT,1839,22,20-24,1861,82.26358322622555
STAT,1848,27,25-29,1875,47.25652341257022
STAT,1879,45,15-19,1924,4.1442646182468566E-4
STAT,1843,27,50-100,1870,0.7778438640770433
STAT,1920,30,na,1950,4122.248575875173
STAT,1887,30,50-100,1917,1.0165932756989513
STAT,1822,34,45-49,1856,3.8940464370069434
STAT,1931,25,25-29,1956,84.45306114738223
SIM,1913,45,50-100,1958,1
SIM,1862,71,na,1933,2633
SIM,1827,31,50-100,1858,12
SIM,1861,44,40-44,1905,9
STAT,1845,79,na,1924,346.90791839543147
SIM,1946,7,na,1953,3798
STAT,1887,19,25-29,1906,6.203767158951386
SIM,1862,4,na,1866,4008
STAT,1888,41,na,1929,2679.619066702236
STAT,1905,27,30-34,1932,36.219643556706124
SIM,1840,79,na,1919,1993
STAT,1865,24,20-24,1889,62.77011414239642
STAT,1894,48,45-49,1942,0.16716072352377678
STAT,1891,33,20-24,1924,3.3100016445767033
SIM,1866,22,15-19,1888,8
STAT,1822,84,na,1906,191.8303325730944
STAT,1859,35,45-49,1894,1.5950285152761638
STAT,1932,33,50-100,1965,1.0907805483045387
SIM,1893,36,35-39,1929,48
STAT,1833,34,20-24,1867,1.487400241077508
STAT,1907,51,na,1958,3209.711932328763
STAT,1818,45,35-39,1863,0.25741212871111213
SIM,1875,46,35-39,1921,2
STAT,1843,25,40-44,1868,3.695377418351747
SIM,1925,36,na,1961,4717
STAT,1874,24,30-34,1898,18.268377252905125
STAT,1900,26,35-39,1926,13.41239029669591
STAT,1931,17,30-34,1948,15.841811708717625
STAT,1881,38,30-34,1919,5.008011315089259
SIM,1855,24,na,1879,3279
STAT,1874,36,25-29,1910,2.9858250891032507
SIM,1813,43,50-100,1856,13
STAT,1918,14,na,1932,4240.7591005280665
SIM,1841,34,20-24,1875,1
SIM,1850,46,30-34,1896,2
STAT,1835,42,30-34,1877,1.0422784639175908
STAT,1821,37,20-24,1858,0.9512812652686135
STAT,1867,46,35-39,1913,0.13277812346809073
STAT,1908,32,30-34,1940,14.756568958458335
SIM,1932,27,40-44,1959,709
SIM,1935,23,45-49,1958,150
STAT,1906,24,20-24,1930,99.16550657081895
SIM,1851,31,na,1882,1241
SIM,1915,23,25-29,1938,671
SIM,1826,35,na,1861,1872
STAT,1855,89,na,1944,69.52825223266453
SIM,1938,4,na,1942,4282
STAT,1888,44,na,1932,2631.5421354278956
STAT,1825,48,45-49,1873,0.2958680918097114
STAT,1898,51,na,1949,2909.3338785515043
STAT,1927,36,15-19,1963,0.023702622012950234
STAT,1876,43,30-34,1919,1.1538133137207647
SIM,1946,4,na,1950,3869
STAT,1840,37,30-34,1877,2.4820661769667183
STAT,1861,29,15-19,1890,0.3746217556803359
STAT,1897,35,15-19,1932,0.07528443364654641
STAT,1823,33,15-19,1856,0.32924293349722245
STAT,1824,42,20-24,1866,0.027045201124173083
STAT,1837,52,na,1889,1732.7407513335356
STAT,1836,21,25-29,1857,58.310952856116465
STAT,1904,36,20-24,1940,0.23885190190875527
SIM,1883,41,na,1924,2088
STAT,1933,34,25-29,1967,12.355145901580222
STAT,1859,34,40-44,1893,3.407821125213236
STAT,1890,24,15-19,1914,3.9688204424044655
STAT,1809,52,30-34,1861,0.049154890636654854
STAT,1839,34,20-24,1873,3.026950010913015
STAT,1924,27,40-44,1951,5.374882647040757
STAT,1929,24,15-19,1953,6.642578616238257
STAT,1927,35,45-49,1962,0.8421335308869117
SIM,1841,24,na,1865,1160
SIM,1877,27,na,1904,46
STAT,1884,51,na,1935,2071.0299039075944
SIM,1884,43,30-34,1927,3
SIM,1881,63,na,1944,1140
SIM,1857,36,30-34,1893,4
SIM,1836,42,na,1878,1982
STAT,1859,46,35-39,1905,0.1112780111295512
STAT,1889,28,25-29,1917,50.761118879747656
SIM,1873,34,na,1907,2128
STAT,1892,39,45-49,1931,2.443283026183089
STAT,1899,23,15-19,1922,4.492105389016028
SIM,1835,35,40-44,1870,4
STAT,1860,15,30-34,1875,1.5174465822810232
STAT,1851,64,na,1915,1372.9425648161903
STAT,1874,53,50-100,1927,0.015336775315572045
STAT,1919,29,25-29,1948,69.67217884018363
STAT,1868,20,25-29,1888,56.094493127113
STAT,1812,43,40-44,1855,0.7447610161403134
STAT,1856,34,na,1890,1699.3020138282031
STAT,1907,23,25-29,1930,83.26879426376183
STAT,1823,33,50-100,1856,2.1183365017234084
SIM,1854,1,na,1855,2961
STAT,1921,4,na,1925,4546.180379888943
STAT,1894,26,40-44,1920,3.8224070402310812
STAT,1925,47,45-49,1972,0.2609526922757118
SIM,1826,32,na,1858,1923
SIM,1851,34,na,1885,1255
STAT,1927,23,45-49,1950,1.370732738884211
STAT,1905,20,50-100,1925,0.5900329117487507
STAT,1823,46,20-24,1869,0.018992577714529123
STAT,1855,24,20-24,1879,52.52000943739878
SIM,1859,37,na,1896,1874
STAT,1823,41,50-100,1864,1.814505696465753
STAT,1929,19,40-44,1948,1.763033890793673
STAT,1965,2,na,1967,4863.8962026188865
SIM,1903,0,na,1903,3667
SIM,1916,20,30-34,1936,6
STAT,1944,20,40-44,1964,3.591994971288204
STAT,1874,35,20-24,1909,0.8031229213440574
STAT,1905,35,25-29,1940,0.9023323972679684
STAT,1894,15,45-49,1909,0.08345386676042096
STAT,1924,46,50-100,1970,0.26734672397811493
SIM,1920,25,15-19,1945,5
STAT,1907,44,25-29,1951,0.06418681504638848
STAT,1884,26,40-44,1910,2.877411383423301
SIM,1876,20,25-29,1896,25
STAT,1891,19,na,1910,3089.154641744722
STAT,1821,69,na,1890,741.1345341089946
STAT,1789,72,na,1861,927.6001589986555
STAT,1922,11,na,1933,4541.203420105013
STAT,1952,15,50-100,1967,0.4451111954228491
STAT,1840,27,na,1867,1062.0673624492983
STAT,1930,26,20-24,1956,23.05807383654679
STAT,1867,29,na,1896,2240.875523800762
STAT,1896,49,30-34,1945,0.07047670378085137
STAT,1908,20,30-34,1928,26.37473508055549
STAT,1941,15,40-44,1956,1.4250781116206515
STAT,1851,38,45-49,1889,1.5748632852345286
SIM,1868,42,na,1910,1154
STAT,1849,36,30-34,1885,4.643094873348233
STAT,1878,25,45-49,1903,1.1501068436630089
STAT,1881,18,50-100,1899,0.046144155908766554
STAT,1925,20,30-34,1945,34.29167366974846
SIM,1918,35,45-49,1953,2
STAT,1836,48,20-24,1884,0.009500614103048937
SIM,1858,74,na,1932,334
SIM,1847,82,na,1929,1018
SIM,1905,16,na,1921,3866
STAT,1839,30,na,1869,2529.8668921607727
SIM,1817,50,na,1867,2640
STAT,1915,37,35-39,1952,2.408912326002684
STAT,1944,28,50-100,1972,1.0631624268291482
STAT,1850,32,20-24,1882,1.3057097602184176
SIM,1876,36,40-44,1912,17
STAT,1841,49,40-44,1890,0.18666186558946746
STAT,1893,36,35-39,1929,8.8874559694439
SIM,1848,67,na,1915,2307
SIM,1839,26,50-100,1865,25
STAT,1921,15,50-100,1936,0.4239556737890366
STAT,1880,56,na,1936,2117.4551344337624
SIM,1849,60,na,1909,1530
STAT,1805,102,na,1907,0.0393332181250267
STAT,1899,39,na,1938,3210.7013485348325
SIM,1881,24,15-19,1905,13
SIM,1885,22,na,1907,1802
STAT,1945,19,25-29,1964,46.784244233845726
SIM,1866,64,na,1930,2408
STAT,1872,19,50-100,1891,0.0487953971249165
STAT,1881,21,50-100,1902,0.3862585998476794
SIM,1826,64,na,1890,1131
STAT,1868,36,40-44,1904,4.2484524840170925
SIM,1897,28,25-29,1925,266
STAT,1904,15,20-24,1919,25.446361482929074
STAT,1934,22,30-34,1956,38.36334840866192
STAT,1836,29,20-24,1865,11.46571988036787
STAT,1893,28,50-100,1921,0.7971372922453144
STAT,1813,79,na,1892,512.1128049702234
STAT,1924,15,40-44,1939,1.6573006031340551
STAT,1905,48,30-34,1953,0.07755017233500298
SIM,1888,11,na,1899,667
STAT,1829,42,50-100,1871,0.5082520607563129
STAT,1853,79,na,1932,542.0783104476062
STAT,1931,25,na,1956,4806.63437872793
STAT,1946,24,15-19,1970,5.855686812892682
STAT,1888,76,na,1964,1382.6316831981853
STAT,1843,45,35-39,1888,0.14125483651351753
STAT,1915,16,35-39,1931,0.8679511948477298
STAT,1921,27,15-19,1948,0.7774592689163269
STAT,1941,27,35-39,1968,15.354505737645791
STAT,1821,46,50-100,1867,0.26621635197598864
SIM,1838,35,na,1873,2133
SIM,1908,56,na,1964,1915
STAT,1819,42,na,1861,667.3085581556306
STAT,1931,41,30-34,1972,0.16983632604790513
STAT,1918,38,50-100,1956,0.43612692123279784
SIM,1917,19,na,1936,2359
SIM,1859,32,25-29,1891,1
STAT,1846,18,25-29,1864,4.191209278103531
STAT,1867,23,35-39,1890,5.501735875287122
STAT,1878,46,45-49,1924,0.2435025303542569
STAT,1858,12,na,1870,2129.5622300837517
STAT,1862,19,20-24,1881,15.552854733624734
STAT,1856,34,15-19,1890,0.10140909620478775
STAT,1931,38,30-34,1969,2.39437370537784
STAT,1884,46,35-39,1930,0.13439863819831263
SIM,1815,72,na,1887,482
STAT,1900,23,30-34,1923,24.598850129115384
STAT,1839,53,20-24,1892,6.745682277581216E-4
STAT,1831,26,25-29,1857,52.98851392085429
SIM,1837,27,na,1864,2248
STAT,1873,11,na,1884,2703.2391505840906
STAT,1866,24,30-34,1890,16.15759881616563
STAT,1880,70,na,1950,1456.6077327642406
STAT,1912,25,15-19,1937,0.6922714324350003
STAT,1883,47,30-34,1930,0.09269162424667594
STAT,1826,45,35-39,1871,0.2057508341770719
STAT,1835,107,na,1942,0.003568350549791233
SIM,1913,26,na,1939,3448
STAT,1861,32,30-34,1893,14.520251004376169
STAT,1950,17,40-44,1967,1.6381049817396072
STAT,1834,87,na,1921,77.64379917763281
SIM,1866,36,40-44,1902,7
SIM,1867,49,na,1916,2094
SIM,1860,13,na,1873,2608
STAT,1905,15,30-34,1920,2.303146422122135
STAT,1926,19,15-19,1945,54.86928583783149
STAT,1802,87,na,1889,85.9472228756268
STAT,1932,37,35-39,1969,3.227225863035845
STAT,1853,28,45-49,1881,0.9010569278369868
STAT,1845,19,20-24,1864,10.98829660501684
STAT,1941,20,15-19,1961,5.442308176551148
STAT,1880,78,na,1958,926.1654762772661
STAT,1877,49,20-24,1926,0.01192710536718735
STAT,1827,54,40-44,1881,0.00814883028390902
STAT,1853,90,na,1943,61.13208462397823
STAT,1865,27,25-29,1892,38.62081942287477
STAT,1881,53,25-29,1934,0.0032911861275789537
SIM,1893,33,30-34,1926,58
STAT,1904,45,na,1949,3246.9875311626383
SIM,1922,25,25-29,1947,45
SIM,1912,2,na,1914,4905
STAT,1849,32,15-19,1881,0.12644115022230856
SIM,1928,22,15-19,1950,26
STAT,1850,39,40-44,1889,2.0111688073591467
STAT,1808,46,50-100,1854,0.4768457200888919
STAT,1831,98,na,1929,2.5424708973691863
STAT,1897,58,na,1955,2626.3521707721757
STAT,1922,15,30-34,1937,14.013714049503482
STAT,1827,38,45-49,1865,1.9417386990223804
STAT,1927,20,40-44,1947,4.133378311644952
STAT,1835,45,35-39,1880,0.125882018975526
SIM,1904,12,na,1916,4192
STAT,1859,16,45-49,1875,0.06045500273988873
STAT,1891,30,na,1921,2958.103354607983
STAT,1912,29,30-34,1941,37.89152758712781
STAT,1901,41,45-49,1942,0.14597369625148482
STAT,1885,33,30-34,1918,17.08959431368275
SIM,1848,45,na,1893,2306
STAT,1894,45,40-44,1939,0.12402972672659503
SIM,1920,29,30-34,1949,3
STAT,1887,38,25-29,1925,3.153336624957671
STAT,1934,37,45-49,1971,0.9343821752886979
SIM,1841,23,30-34,1864,8
STAT,1837,24,45-49,1861,0.7214746262452539
STAT,1930,9,na,1939,5110.509018219838
SIM,1887,15,na,1902,3965
STAT,1919,44,na,1963,3958.050257005479
STAT,1920,19,20-24,1939,149.34644716647415
STAT,1860,25,40-44,1885,2.5057957061772544
SIM,1937,2,na,1939,3036
STAT,1943,19,15-19,1962,47.54442928836523
STAT,1875,39,45-49,1914,2.0264139497075035
STAT,1895,46,45-49,1941,0.1736685789676805
SIM,1815,40,na,1855,2266
STAT,1901,29,20-24,1930,16.285857390840125
STAT,1879,62,na,1941,1874.959425869557
STAT,1874,33,20-24,1907,2.7779637206722017
STAT,1894,29,45-49,1923,1.4018351416805368
STAT,1850,42,50-100,1892,0.48722837928897916
SIM,1889,35,30-34,1924,2
STAT,1844,23,40-44,1867,2.559038995963148
STAT,1890,40,50-100,1930,1.2918533832722958
STAT,1853,47,45-49,1900,0.18213861585717006
SIM,1875,78,na,1953,2443
SIM,1927,40,na,1967,1568
SIM,1932,20,15-19,1952,5
SIM,1867,25,35-39,1892,11
STAT,1914,25,25-29,1939,65.87460609070088
STAT,1853,50,45-49,1903,0.011414468745360685
STAT,1885,25,45-49,1910,1.098775966776085
SIM,1897,47,na,1944,2248
SIM,1897,22,na,1919,2953
STAT,1888,20,35-39,1908,6.775284718153362
STAT,1899,36,na,1935,3233.4403368189573
SIM,1880,17,15-19,1897,41
STAT,1808,48,45-49,1856,0.36608187221247396
STAT,1948,24,25-29,1972,104.90181639661166
SIM,1832,44,20-24,1876,3
STAT,1833,23,30-34,1856,14.234046520961952
STAT,1891,35,20-24,1926,0.9569376916854845
STAT,1804,65,na,1869,1555.5156949331667
STAT,1914,55,na,1969,3480.0890985326314
SIM,1917,30,na,1947,2192
STAT,1822,32,45-49,1854,4.881544719980634
SIM,1900,33,25-29,1933,23
STAT,1867,43,30-34,1910,1.0794215726096124
STAT,1890,28,30-34,1918,30.37808226532324
STAT,1905,39,40-44,1944,1.3453130843978762
SIM,1837,18,25-29,1855,2
SIM,1919,36,30-34,1955,4
STAT,1923,24,20-24,1947,127.21719468339171
STAT,1908,35,35-39,1943,2.2684189423559884
STAT,1868,18,50-100,1886,0.04789283294447278
STAT,1853,44,40-44,1897,1.7205214879794528
STAT,1889,29,na,1918,2853.370604953457
STAT,1870,49,na,1919,2196.1099169650806
STAT,1919,26,20-24,1945,19.52806181859206
STAT,1832,52,50-100,1884,0.0012084815927997392
STAT,1812,46,45-49,1858,0.06213496415691311
STAT,1944,23,45-49,1967,1.2007922864899774
STAT,1823,37,30-34,1860,10.013765100092716
STAT,1918,42,35-39,1960,0.21120898728792994
STAT,1922,31,45-49,1953,1.7652983271199492
STAT,1824,44,20-24,1868,0.027278109893321714
SIM,1854,37,25-29,1891,43
STAT,1872,17,15-19,1889,5.96216685053088
STAT,1824,49,40-44,1873,0.02905286651673499
STAT,1818,42,30-34,1860,2.2483464493556267
STAT,1866,41,na,1907,2119.288995135908
STAT,1933,31,20-24,1964,3.266670653039767
STAT,1818,49,50-100,1867,0.4248636602026017
SIM,1869,29,25-29,1898,2
STAT,1848,24,20-24,1872,77.39550162106721
STAT,1824,45,25-29,1869,0.010223513095848425
SIM,1884,26,na,1910,3790
SIM,1842,38,45-49,1880,11
SIM,1866,7,na,1873,3337
SIM,1871,53,na,1924,1773
STAT,1867,26,na,1893,2264.752226338315
SIM,1906,30,15-19,1936,1
STAT,1875,34,25-29,1909,10.427593191868086
STAT,1846,37,25-29,1883,1.7807451927208495
STAT,1814,54,50-100,1868,0.047857795921255476
STAT,1891,36,25-29,1927,3.5576727952943417
STAT,1923,19,50-100,1942,0.43297259686130246
STAT,1914,31,50-100,1945,0.8240315405295053
STAT,1869,23,45-49,1892,0.7014802731947077
STAT,1885,24,40-44,1909,2.0354559824168263
STAT,1876,46,35-39,1922,0.1419289464985984
SIM,1937,19,40-44,1956,2
STAT,1875,26,na,1901,2459.016533304842
SIM,1848,34,30-34,1882,294
STAT,1890,1,na,1891,3295.111344356434
SIM,1947,14,na,1961,4369
SIM,1856,24,20-24,1880,60
STAT,1806,91,na,1897,17.449154408635238
STAT,1907,27,40-44,1934,4.370817891029672
STAT,1847,31,45-49,1878,1.8704738341986356
STAT,1834,35,40-44,1869,2.4500613053956593
STAT,1893,5,na,1898,3277.181367505047
STAT,1839,37,25-29,1876,3.19661598856147
STAT,1833,32,20-24,1865,1.5297442608218514
STAT,1889,35,30-34,1924,6.47896351456074
STAT,1932,21,50-100,1953,0.8599301020977822
STAT,1934,25,35-39,1959,20.077643519664733
STAT,1878,44,45-49,1922,1.5190619867781594
STAT,1915,34,30-34,1949,15.683895520959588
SIM,1902,29,20-24,1931,3
STAT,1917,30,25-29,1947,9.626044905204129
SIM,1860,16,na,1876,2550
STAT,1941,18,45-49,1959,0.5085238537120326
SIM,1876,39,45-49,1915,4
STAT,1916,33,na,1949,3835.1809605913927
STAT,1841,23,15-19,1864,4.620403857501389
STAT,1843,16,na,1859,2915.5199560682436
STAT,1854,45,45-49,1899,0.13252838104674278
STAT,1880,8,na,1888,2731.990797810716
STAT,1840,46,20-24,1886,0.00482627972342811
STAT,1855,71,na,1926,883.4197292080156
STAT,1872,42,50-100,1914,1.0565857987364893
STAT,1945,16,20-24,1961,146.50505955338912
STAT,1836,68,na,1904,1169.586097146898
SIM,1866,47,50-100,1913,1
STAT,1931,29,40-44,1960,5.969405102283977
STAT,1905,41,na,1946,3350.877895706847
STAT,1904,18,25-29,1922,8.074820289319941
STAT,1906,26,na,1932,3467.715605278001
STAT,1868,39,45-49,1907,1.9060719097160561
STAT,1838,44,15-19,1882,0.006115038729953495
STAT,1875,17,40-44,1892,0.18781441224055626
STAT,1919,22,na,1941,3945.6685272118684
STAT,1844,24,45-49,1868,0.8502030263511952
SIM,1870,23,na,1893,2472
STAT,1829,34,20-24,1863,1.4203649906333664
STAT,1849,36,50-100,1885,1.0696018264922829
STAT,1869,52,na,1921,2161.1559922555725
STAT,1891,44,50-100,1935,1.281613181885004
STAT,1850,100,na,1950,0.49022697490540035
STAT,1853,23,na,1876,1944.7905751803182
STAT,1872,27,25-29,1899,42.35893359757551
SIM,1842,33,25-29,1875,11
STAT,1854,53,na,1907,1177.976983538957
SIM,1903,67,na,1970,1652
STAT,1846,75,na,1921,609.7100985360883
STAT,1861,35,35-39,1896,5.938008771592769
STAT,1859,22,30-34,1881,14.647783385505909
STAT,1868,22,na,1890,2284.331526117784
STAT,1939,22,25-29,1961,91.74551861771937
STAT,1925,23,35-39,1948,11.133150668623127
STAT,1908,47,45-49,1955,0.19503419394540855
SIM,1886,44,45-49,1930,3
STAT,1849,44,25-29,1893,0.533772787281481
STAT,1869,32,35-39,1901,10.219038841015148
STAT,1866,63,na,1929,1628.7463098588807
STAT,1950,14,na,1964,4598.747200537903
STAT,1826,46,na,1872,2062.881745742024
STAT,1907,41,20-24,1948,0.016164171538685546
STAT,1876,37,50-100,1913,1.241135021134237
STAT,1850,35,25-29,1885,1.3788971570509925
STAT,1877,81,na,1958,654.5689247804391
SIM,1834,61,na,1895,279
SIM,1895,66,na,1961,4126
STAT,1923,22,50-100,1945,0.757551494296389
SIM,1896,29,na,1925,3692
STAT,1937,26,30-34,1963,37.81704210423399
STAT,1864,34,15-19,1898,0.12835527585702516
STAT,1866,34,50-100,1900,0.8292054555553734
STAT,1840,72,na,1912,497.2706708104852
STAT,1916,27,50-100,1943,1.0151192584654687
STAT,1935,29,50-100,1964,1.3456968021685554
STAT,1897,18,30-34,1915,2.111195544866025
STAT,1786,83,na,1869,253.41257594897777
SIM,1824,54,na,1878,1861
STAT,1875,26,30-34,1901,25.946827911110184
SIM,1914,41,na,1955,4878
STAT,1834,33,25-29,1867,5.7224502382581415
STAT,1863,31,50-100,1894,0.7854066996171043
STAT,1875,22,15-19,1897,3.3876101614260796
STAT,1809,49,15-19,1858,0.0033653244654387147
STAT,1807,54,na,1861,1280.8731551943813
STAT,1929,33,20-24,1962,3.0746556197264527
STAT,1859,43,30-34,1902,0.9046361149937202
STAT,1889,25,20-24,1914,14.223151402968211
STAT,1817,61,na,1878,699.404672688494
STAT,1911,17,20-24,1928,26.82431132292125
STAT,1941,24,30-34,1965,29.34419202770956
STAT,1857,104,na,1961,0.1530351928308965
STAT,1868,19,15-19,1887,5.767249309427838
SIM,1842,25,30-34,1867,2
SIM,1864,38,na,1902,2405
STAT,1811,101,na,1912,0.34570138410634255
STAT,1818,46,na,1864,1729.147027864341
STAT,1849,46,40-44,1895,0.1446612869804174
SIM,1835,46,na,1881,1205
STAT,1903,31,35-39,1934,14.434231091800765
STAT,1874,27,35-39,1901,9.958335917909334
STAT,1904,20,50-100,1924,0.5860846733661779
STAT,1831,76,na,1907,741.485510499411
STAT,1896,25,20-24,1921,15.56965280081051
STAT,1853,25,40-44,1878,2.7298344922612356
STAT,1853,45,na,1898,1761.8930361761836
SIM,1948,21,20-24,1969,8
SIM,1882,27,35-39,1909,29
STAT,1882,15,25-29,1897,5.450591078301751
STAT,1907,9,na,1916,3785.821010002169
STAT,1918,23,35-39,1941,9.987388576287627
STAT,1834,25,30-34,1859,14.763844966673739
STAT,1885,15,35-39,1900,0.5418592147825564
STAT,1946,21,na,1967,4021.163838324644
STAT,1866,20,15-19,1886,3.0800703816479404
STAT,1850,34,20-24,1884,1.2788731274245366
STAT,1921,48,50-100,1969,0.2512525224165236
SIM,1837,72,na,1909,1470
STAT,1902,39,15-19,1941,0.01689578713280269
SIM,1937,33,20-24,1970,4
STAT,1934,17,50-100,1951,0.5033286104777113
SIM,1902,9,na,1911,3754
STAT,1842,53,na,1895,525.9298089205624
STAT,1847,107,na,1954,0.004263773761177023
STAT,1848,34,30-34,1882,16.982257599011696
SIM,1829,41,45-49,1870,19
SIM,1833,23,30-34,1856,17
STAT,1878,66,na,1944,1686.3271090617197
SIM,1839,31,na,1870,976
STAT,1846,27,15-19,1873,0.32507298553855024
STAT,1826,42,30-34,1868,1.7273509166705519
STAT,1839,64,na,1903,1615.0498661180397
STAT,1882,24,15-19,1906,3.1387465705421342
STAT,1787,68,na,1855,327.55600000000004
STAT,1858,47,50-100,1905,0.1866815560619894
SIM,1872,38,30-34,1910,42
STAT,1864,38,30-34,1902,4.821119993002696
STAT,1931,34,15-19,1965,0.16698416376927475
STAT,1852,38,50-100,1890,1.2297013225861453
STAT,1893,33,30-34,1926,21.741723411385614
SIM,1926,44,na,1970,5848
SIM,1907,23,25-29,1930,33
STAT,1878,43,40-44,1921,2.2974933645020554
STAT,1888,73,na,1961,1559.7692204805799
SIM,1897,5,na,1902,3017
STAT,1854,48,15-19,1902,2.1961233417231696E-4
STAT,1931,22,na,1953,4703.014662529476
SIM,1918,32,40-44,1950,15
STAT,1845,25,na,1870,1325.5486755254185
STAT,1892,27,na,1919,2954.7397001046406
STAT,1796,82,na,1878,302.8302884749371
SIM,1825,31,25-29,1856,4
STAT,1870,44,45-49,1914,1.4719103042259887
SIM,1872,47,na,1919,2326
STAT,1826,40,35-39,1866,2.8185009772730543
STAT,1889,31,15-19,1920,0.1721917034741031
STAT,1898,37,25-29,1935,3.871704798567639
STAT,1896,17,na,1913,3329.3263079302806
STAT,1884,22,25-29,1906,54.79964387989126
STAT,1805,50,45-49,1855,0.01771002591338187
SIM,1832,27,30-34,1859,122
SIM,1832,29,25-29,1861,4
SIM,1898,40,na,1938,4193
STAT,1828,109,na,1937,4.8160861084381505E-4
STAT,1876,19,45-49,1895,0.0656809125167051
SIM,1891,41,20-24,1932,2
STAT,1866,44,25-29,1910,0.5782607237408314
STAT,1850,35,30-34,1885,2.552426666424733
STAT,1877,45,40-44,1922,0.17552120121835563
STAT,1887,34,15-19,1921,0.155402326308085
STAT,1813,45,50-100,1858,0.9406971730649228
STAT,1830,37,50-100,1867,1.1198608787791724
STAT,1871,25,20-24,1896,11.782029009148689
STAT,1833,38,35-39,1871,3.78009398239563
STAT,1850,9,na,1859,1374.731981826405
STAT,1871,27,15-19,1898,0.4525880779883476
STAT,1845,19,15-19,1864,3.678285732706448
STAT,1859,19,50-100,1878,0.04454478181598607
STAT,1881,63,na,1944,1685.0037289240488
SIM,1858,12,na,1870,2521
SIM,1841,38,35-39,1879,16
STAT,1854,28,25-29,1882,24.479944717358265
SIM,1869,29,20-24,1898,19
SIM,1948,15,35-39,1963,54
STAT,1809,74,na,1883,1148.5833920756834
STAT,1820,41,na,1861,1902.0794748453432
STAT,1864,47,25-29,1911,0.052120387808469865
STAT,1854,61,na,1915,1038.9944134947452
STAT,1815,52,25-29,1867,3.466160649874567E-4
STAT,1820,52,35-39,1872,0.013058809977838069
STAT,1872,27,na,1899,2389.767940773448
STAT,1872,41,45-49,1913,1.5054561495697534
STAT,1822,76,na,1898,546.3206101088832
STAT,1837,43,45-49,1880,1.3980359266423656
STAT,1908,17,40-44,1925,0.2692191416767301
STAT,1893,31,35-39,1924,12.715931607359916
SIM,1827,47,45-49,1874,4
STAT,1879,28,30-34,1907,25.741665352225667
SIM,1957,13,na,1970,6080
STAT,1910,37,20-24,1947,0.2492942940345855
STAT,1801,104,na,1905,0.02212761445898396
SIM,1841,36,40-44,1877,1
SIM,1908,40,30-34,1948,1
STAT,1816,39,45-49,1855,6.981727556076934
STAT,1788,87,na,1875,23.00367677191354
STAT,1792,92,na,1884,14.940527514199953
STAT,1905,19,na,1924,3613.1501090194724
SIM,1862,28,25-29,1890,5
SIM,1885,32,35-39,1917,169
STAT,1816,50,20-24,1866,0.0022470875071312364
STAT,1877,58,na,1935,2007.4994432973926
STAT,1841,43,50-100,1884,1.2068939271889565
STAT,1886,38,45-49,1924,2.0541161549926885
STAT,1849,46,45-49,1895,0.19941626027169987
STAT,1841,44,20-24,1885,0.1791189174824852
STAT,1886,3,na,1889,2887.6499430853623
STAT,1915,49,na,1964,3628.2516351752747
SIM,1844,44,40-44,1888,13
STAT,1845,37,15-19,1882,0.02927734159880725
STAT,1856,25,25-29,1881,31.94092046585984
STAT,1873,22,20-24,1895,70.68903207275248
STAT,1948,21,20-24,1969,126.40885184679186
STAT,1888,10,na,1898,2989.660250438427
STAT,1833,36,40-44,1869,2.399166121212392
STAT,1883,41,20-24,1924,0.15347631258974612
SIM,1857,43,40-44,1900,25
STAT,1891,18,30-34,1909,1.9548918069433086
STAT,1877,32,35-39,1909,10.280190771932203
SIM,1821,43,na,1864,1880
STAT,1845,35,20-24,1880,0.45091391924071506
STAT,1831,40,45-49,1871,1.5025449328887954
SIM,1837,18,20-24,1855,19
STAT,1863,15,15-19,1878,5.849947197290011
STAT,1846,66,na,1912,970.7215637222894
SIM,1874,26,25-29,1900,2
STAT,1882,43,25-29,1925,0.6103664984083651
SIM,1855,55,na,1910,2860
STAT,1906,19,50-100,1925,0.07056328102961079
STAT,1913,14,na,1927,3974.324290412641
STAT,1890,32,50-100,1922,1.109213525453464
SIM,1888,42,na,1930,140
STAT,1882,27,20-24,1909,11.231811826800289
STAT,1821,33,40-44,1854,6.050073338382061
STAT,1847,32,20-24,1879,2.8694279658240847
STAT,1931,35,50-100,1966,0.5530915546836026
SIM,1818,41,35-39,1859,13
STAT,1871,42,40-44,1913,2.240988359033067
STAT,1850,71,na,1921,616.3597466225681
STAT,1876,21,50-100,1897,0.41348318422412295
STAT,1814,53,20-24,1867,0.00238524554244311
SIM,1824,39,45-49,1863,5
SIM,1885,14,na,1899,1861
STAT,1841,42,25-29,1883,0.7430613668477429
STAT,1881,44,20-24,1925,0.14795035445846136
STAT,1843,21,25-29,1864,71.50935062824949
STAT,1850,17,30-34,1867,0.8993653568541388
STAT,1895,29,25-29,1924,54.635453399610974
STAT,1827,39,20-24,1866,0.741685285440502
STAT,1867,41,35-39,1908,1.7202898728758629
STAT,1892,34,25-29,1926,12.572732956813248
STAT,1887,49,15-19,1936,2.431630040291665E-4
SIM,1836,38,25-29,1874,6
STAT,1858,43,na,1901,1752.261244459608
STAT,1920,29,30-34,1949,42.12636583271968
STAT,1835,33,40-44,1868,4.134318239644016
STAT,1857,36,25-29,1893,2.2200187331499652
STAT,1927,42,na,1969,4619.8717920157
STAT,1871,33,na,1904,2370.403889307766
STAT,1820,50,40-44,1870,0.016615341363873548
STAT,1803,53,45-49,1856,0.03101755590747792
STAT,1825,43,25-29,1868,0.8401723880210545
STAT,1867,26,40-44,1893,2.8427169282245406
STAT,1863,33,45-49,1896,1.4824400380974752
STAT,1824,31,na,1855,581.4759751630698
STAT,1866,42,30-34,1908,1.0481466479595798
SIM,1831,65,na,1896,1553
SIM,1869,83,na,1952,2525
STAT,1935,5,na,1940,5457.090467942007
SIM,1894,50,na,1944,1273
STAT,1828,38,25-29,1866,3.787054248094231
STAT,1841,35,na,1876,2869.0134034771972
STAT,1877,34,50-100,1911,0.9221363639166805
STAT,1884,26,45-49,1910,1.0665099957257944
SIM,1926,21,na,1947,3488
STAT,1802,54,40-44,1856,0.05128373516301774
STAT,1851,16,35-39,1867,0.530016016303143
STAT,1852,48,45-49,1900,0.23456986734060703
STAT,1910,39,15-19,1949,0.01797773627753501
SIM,1861,63,na,1924,1395
STAT,1840,46,25-29,1886,0.023166141591818765
STAT,1856,53,25-29,1909,0.002503215681806065
STAT,1876,34,40-44,1910,4.3464873001197875
SIM,1783,84,na,1867,400
SIM,1916,8,na,1924,4921
STAT,1882,45,20-24,1927,0.011603463188302176
SIM,1810,71,na,1881,2853
STAT,1864,17,30-34,1881,1.4989547618114918
STAT,1829,94,na,1923,7.2983054825898614
STAT,1906,30,50-100,1936,0.7679660672041011
STAT,1949,22,50-100,1971,0.7602273708405356
STAT,1823,46,25-29,1869,0.09116436877717517
STAT,1842,40,20-24,1882,0.04184753454557548
STAT,1819,45,20-24,1864,0.0021785524058065635
SIM,1838,35,25-29,1873,2
STAT,1824,100,na,1924,0.20545349540550623
STAT,1834,41,na,1875,1131.398209260764
STAT,1901,49,na,1950,3080.6531088766424
STAT,1888,40,50-100,1928,1.2316217846144504
STAT,1856,96,na,1952,6.1673972946429245
STAT,1880,48,20-24,1928,0.012301320533618184
STAT,1886,23,45-49,1909,0.7198801000530028
STAT,1886,38,15-19,1924,0.057862433782460115
STAT,1897,26,25-29,1923,56.371273786544634
SIM,1842,35,45-49,1877,33
STAT,1917,22,30-34,1939,30.138824333168188
SIM,1833,26,35-39,1859,9
STAT,1834,35,45-49,1869,1.1157422051444896
SIM,1842,34,35-39,1876,282
STAT,1840,45,15-19,1885,1.6295020538359167E-4
STAT,1854,20,50-100,1874,0.2702772236037569
STAT,1870,29,20-24,1899,11.611882749842277
STAT,1804,51,40-44,1855,0.06785430943580893
STAT,1830,44,45-49,1874,1.2895988356015555
STAT,1947,22,15-19,1969,5.952812150969287
STAT,1862,34,40-44,1896,3.662134860449857
STAT,1851,34,35-39,1885,8.15367596039383
STAT,1899,33,25-29,1932,13.931000282958145
STAT,1865,46,30-34,1911,0.08862845572339824
STAT,1900,48,15-19,1948,3.086388685232345E-4
STAT,1886,36,20-24,1922,0.8020946758644925
STAT,1813,44,45-49,1857,6.087823989747486
STAT,1831,37,15-19,1868,0.05703305481233208
STAT,1855,107,na,1962,0.013187565315164478
STAT,1892,17,35-39,1909,0.6793534050591947
STAT,1848,47,40-44,1895,0.15945772135684086
SIM,1880,22,na,1902,3337
SIM,1882,57,na,1939,1326
STAT,1834,34,35-39,1868,5.599453919715912
STAT,1899,35,50-100,1934,1.6928597271206332
STAT,1825,42,40-44,1867,2.99137192963399
SIM,1873,28,30-34,1901,113
STAT,1868,22,40-44,1890,2.0126902300683276
STAT,1902,42,na,1944,3261.8155055993047
STAT,1890,37,25-29,1927,3.4855770280345175
STAT,1917,25,50-100,1942,1.036893164248376
STAT,1949,20,25-29,1969,106.79438260751624
STAT,1926,30,30-34,1956,18.908748230864486
STAT,1865,45,20-24,1910,0.011065118788666315
SIM,1892,55,na,1947,3403
STAT,1881,28,15-19,1909,0.4269448251901138
STAT,1878,12,na,1890,2657.064179541163
STAT,1850,19,25-29,1869,3.1599826360615966
SIM,1900,16,na,1916,4167
STAT,1819,47,45-49,1866,0.043963059307137134
STAT,1909,16,45-49,1925,0.09720290550618398
STAT,1874,20,15-19,1894,3.4251272693665125
STAT,1871,40,45-49,1911,1.5080284188248692
STAT,1880,35,45-49,1915,2.0892018387233198
STAT,1894,31,50-100,1925,1.1699130257645616
STAT,1880,18,25-29,1898,5.867526066012699
STAT,1833,48,na,1881,974.008876062341
STAT,1889,44,20-24,1933,0.18866515533290698
STAT,1869,38,15-19,1907,0.05638349477147975
STAT,1925,47,na,1972,4411.020491886653
SIM,1833,44,35-39,1877,32
STAT,1838,27,30-34,1865,13.674079497994509
SIM,1894,36,20-24,1930,6
STAT,1892,35,35-39,1927,8.840106161253132
STAT,1824,45,30-34,1869,0.017181181896112802
STAT,1875,35,35-39,1910,7.331821262657202
STAT,1881,46,15-19,1927,3.7881125884035253E-4
STAT,1800,106,na,1906,0.008377466087987912
STAT,1861,53,35-39,1914,0.007044707363989164
STAT,1895,55,na,1950,2689.8316714551625
STAT,1802,56,na,1858,1532.6460744183519
STAT,1839,51,50-100,1890,0.014098587703404556
STAT,1875,33,40-44,1908,4.434374618491614
STAT,1851,33,na,1884,1941.361684790587
SIM,1873,43,25-29,1916,1
STAT,1828,37,15-19,1865,0.07547333503825822
STAT,1865,43,25-29,1908,0.5820484539753246
STAT,1891,36,30-34,1927,6.585479465737477
SIM,1862,57,na,1919,3270
STAT,1865,15,50-100,1880,0.05125316198237825
STAT,1929,29,na,1958,4650.944302531718
STAT,1928,31,50-100,1959,1.0265511052572789
STAT,1963,9,na,1972,4944.557161338552
STAT,1895,28,15-19,1923,0.5881316112948062
STAT,1860,111,na,1971,0.0012339715030462775
STAT,1890,19,25-29,1909,6.8233928890018305
STAT,1918,20,25-29,1938,98.86558783134673
STAT,1861,51,40-44,1912,0.008797136080556663
STAT,1798,77,na,1875,520.1058419793046
STAT,1809,66,na,1875,1948.0112175348893
STAT,1871,73,na,1944,1184.8350968605039
STAT,1848,30,15-19,1878,0.15866772581583763
STAT,1830,24,20-24,1854,161.85511286145794
STAT,1933,34,na,1967,5055.683978707472
SIM,1832,45,30-34,1877,1
STAT,1861,26,45-49,1887,0.9368105945664361
STAT,1853,29,20-24,1882,9.452200562537355
STAT,1847,20,na,1867,2404.214244617156
STAT,1865,30,15-19,1895,0.131062028875913
SIM,1920,36,na,1956,3788
STAT,1805,84,na,1889,45.44505225441575
STAT,1869,36,20-24,1905,0.7815934796808774
STAT,1874,36,30-34,1910,5.526952854849717
SIM,1926,20,25-29,1946,576
SIM,1846,27,30-34,1873,5
SIM,1851,65,na,1916,979
STAT,1952,20,30-34,1972,34.26446563395848
STAT,1848,43,20-24,1891,0.14753964546455586
STAT,1873,40,50-100,1913,1.0946216109187346
STAT,1830,26,45-49,1856,1.0753464982277183
SIM,1837,50,na,1887,1802
STAT,1841,29,25-29,1870,57.67000999525218
STAT,1855,54,20-24,1909,4.7495178110399576E-4
STAT,1824,51,50-100,1875,0.0025974145471326063
STAT,1872,38,15-19,1910,0.05595200383177751
STAT,1889,48,40-44,1937,0.11483205383692309
STAT,1938,26,na,1964,3673.24323269471
STAT,1825,44,35-39,1869,2.3304101171187006
STAT,1876,96,na,1972,52.24073365658617
STAT,1860,25,45-49,1885,0.9287709721594818
STAT,1848,49,35-39,1897,0.12827308146947936
STAT,1873,68,na,1941,1567.5939044697093
STAT,1856,22,20-24,1878,57.48572196366211
STAT,1893,30,25-29,1923,12.911619488590595
SIM,1839,43,20-24,1882,3
STAT,1912,40,na,1952,3580.4876528524846
STAT,1862,52,40-44,1914,0.008919095923289318
STAT,1885,25,na,1910,2361.746380345413
SIM,1831,49,30-34,1880,2
SIM,1810,63,na,1873,3098
STAT,1957,15,35-39,1972,5.4868337555896405
STAT,1889,83,na,1972,927.4338321858826
STAT,1851,15,25-29,1866,5.5061083801857995
STAT,1858,32,25-29,1890,7.821911254467917
SIM,1852,39,20-24,1891,10
STAT,1883,42,30-34,1925,1.1046687960421626
STAT,1898,34,20-24,1932,3.6037283671868914
SIM,1814,53,na,1867,2442
STAT,1871,28,25-29,1899,42.04897763045832
STAT,1847,17,25-29,1864,6.394489443099
STAT,1907,20,20-24,1927,101.1499422796018
SIM,1832,42,25-29,1874,3
STAT,1901,57,na,1958,2874.33784134215
STAT,1859,19,45-49,1878,0.05939304242131478
STAT,1812,86,na,1898,17.57139092220493
STAT,1820,53,45-49,1873,0.02158105152113714
STAT,1876,16,40-44,1892,0.18535228384931862
SIM,1891,42,30-34,1933,6
STAT,1844,54,45-49,1898,0.013981921500103625
STAT,1850,36,40-44,1886,2.074805104087463
STAT,1861,35,na,1896,1977.939830925127
SIM,1855,47,25-29,1902,3
STAT,1789,80,na,1869,434.56008817191787
STAT,1872,40,35-39,1912,1.831572357500226
STAT,1841,27,30-34,1868,34.829122071031414
STAT,1853,107,na,1960,0.010746739609185516
SIM,1861,44,45-49,1905,2
STAT,1855,30,50-100,1885,0.6304019496967127
STAT,1914,2,na,1916,4158.1705795636635
SIM,1863,27,30-34,1890,1
STAT,1833,39,45-49,1872,1.0522407786227135
STAT,1816,51,30-34,1867,0.017769255482308448
STAT,1860,22,40-44,1882,1.7524106720646524
SIM,1866,32,25-29,1898,8
SIM,1840,61,na,1901,2500
STAT,1799,79,na,1878,57.41689257441199
STAT,1875,36,45-49,1911,2.0568686587049263
STAT,1849,86,na,1935,186.95107055869934
STAT,1825,110,na,1935,1.7017248947192763E-4
STAT,1909,15,35-39,1924,0.8182884263001359
STAT,1861,63,na,1924,1483.9040603347592
STAT,1874,19,40-44,1893,0.18775579660239494
STAT,1822,47,20-24,1869,0.02006642514902212
STAT,1835,36,45-49,1871,1.8841935364765163
SIM,1915,20,20-24,1935,67
SIM,1841,35,30-34,1876,2
STAT,1848,46,25-29,1894,0.054053647678627983
SIM,1829,63,na,1892,1687
SIM,1883,36,45-49,1919,25
STAT,1833,35,30-34,1868,2.9584132806859147
STAT,1823,49,30-34,1872,0.14677081757455557
STAT,1832,86,na,1918,188.34501447604106
STAT,1782,90,na,1872,91.64376979560924
STAT,1844,39,20-24,1883,0.7904044388907934
STAT,1855,27,30-34,1882,17.371837896108193
STAT,1901,49,15-19,1950,3.088965995912375E-4
STAT,1846,51,45-49,1897,0.008636259324940245
STAT,1854,25,20-24,1879,7.62349779325568
SIM,1845,45,na,1890,2233
STAT,1867,29,45-49,1896,1.0425421588786097
STAT,1873,29,50-100,1902,0.651493552030302
STAT,1839,33,na,1872,2452.273406432634
STAT,1853,48,na,1901,1722.581391737347
STAT,1885,48,50-100,1933,0.2383790075386951
STAT,1938,32,15-19,1970,0.1278282218555799
SIM,1819,53,na,1872,1842
STAT,1893,49,45-49,1942,0.16299896500112357
STAT,1935,20,25-29,1955,124.96522958381733
STAT,1862,35,20-24,1897,0.6627990851894413
STAT,1857,52,30-34,1909,0.004543440335937286
STAT,1872,30,50-100,1902,0.9248661996287456
STAT,1845,22,45-49,1867,0.42956501121315316
SIM,1870,34,40-44,1904,5
STAT,1815,39,25-29,1854,0.31510765892192016
SIM,1908,36,na,1944,2631
SIM,1869,26,15-19,1895,3
STAT,1842,22,20-24,1864,21.57715051109643
STAT,1826,109,na,1935,5.67201398935093E-4
STAT,1948,22,30-34,1970,32.66297726070135
STAT,1882,25,na,1907,2300.3832227822504
SIM,1855,17,25-29,1872,6
STAT,1895,26,20-24,1921,15.313494270385268
SIM,1850,22,20-24,1872,409
STAT,1838,24,20-24,1862,37.61997619305562
STAT,1861,50,30-34,1911,0.005021535131854545
SIM,1874,50,na,1924,2446
STAT,1795,89,na,1884,46.5779466230565
STAT,1868,53,na,1921,2046.2904017575636
STAT,1818,49,20-24,1867,0.02075881158098041
SIM,1846,39,25-29,1885,30
STAT,1846,33,45-49,1879,1.2079013821184712
SIM,1833,25,25-29,1858,1
STAT,1865,25,na,1890,2193.6566011776254
STAT,1812,43,45-49,1855,0.4955547203368155
SIM,1823,39,25-29,1862,28
STAT,1828,35,20-24,1863,1.0820456579401057
STAT,1872,23,15-19,1895,3.2933015157464487
STAT,1897,39,30-34,1936,1.512338876090052
STAT,1925,17,40-44,1942,1.6741831852283158
STAT,1868,42,35-39,1910,1.746858938780828
STAT,1883,27,40-44,1910,2.881861867510707
STAT,1847,35,25-29,1882,2.757540754293687
STAT,1851,28,50-100,1879,0.5873001426387406
STAT,1881,47,25-29,1928,0.0541408411884577
SIM,1909,29,na,1938,3559
STAT,1821,51,40-44,1872,0.01108347166005582
STAT,1866,66,na,1932,1496.1191340334954
STAT,1891,37,40-44,1928,5.383141056332983
STAT,1832,52,25-29,1884,2.8342239110017994E-4
STAT,1849,94,na,1943,16.840106780939095
STAT,1864,32,20-24,1896,2.457367331480588
SIM,1916,31,na,1947,4698
STAT,1848,29,40-44,1877,3.2985755518388293
SIM,1864,22,20-24,1886,664
STAT,1836,76,na,1912,725.083053137775
STAT,1889,47,30-34,1936,0.06544806200490624
STAT,1894,30,na,1924,3058.9651487528936
STAT,1914,48,45-49,1962,0.2119592358223348
STAT,1824,42,25-29,1866,0.10935668140921438
SIM,1890,0,na,1890,4211
STAT,1873,37,25-29,1910,2.9534217975603467
SIM,1914,44,na,1958,4827
STAT,1861,43,na,1904,1908.2412579140148
SIM,1930,5,na,1935,5653
STAT,1889,15,na,1904,3055.52885987176
STAT,1891,33,25-29,1924,12.542471467292255
SIM,1878,19,20-24,1897,1
SIM,1833,68,na,1901,1813
STAT,1856,37,20-24,1893,0.5536649535380926
SIM,1876,42,35-39,1918,1
STAT,1834,32,40-44,1866,2.4481738527219457
STAT,1807,49,45-49,1856,0.7760039643245266
STAT,1824,46,40-44,1870,0.030048145373496045
SIM,1865,22,na,1887,1853
SIM,1898,32,na,1930,4265
STAT,1858,36,40-44,1894,3.359032381837521
STAT,1874,53,na,1927,2186.532267057131
STAT,1909,33,35-39,1942,8.595306011185416
STAT,1917,25,35-39,1942,15.640186005971568
STAT,1885,45,na,1930,2233.527049875561
SIM,1769,92,na,1861,178
SIM,1854,30,na,1884,1869
STAT,1902,45,15-19,1947,3.2089524180949406E-4
SIM,1851,42,30-34,1893,2
STAT,1840,43,20-24,1883,0.06440101635826842
STAT,1866,27,35-39,1893,8.807722460001433
STAT,1910,19,20-24,1929,26.420812764170464
STAT,1883,23,20-24,1906,66.09193875198697
STAT,1859,84,na,1943,263.66639041554896
STAT,1876,37,45-49,1913,2.0152317229596277
SIM,1857,50,na,1907,1397
STAT,1853,32,45-49,1885,1.3924241710964436
STAT,1845,37,45-49,1882,1.0393455031540588
STAT,1912,29,na,1941,3622.7158497319233
STAT,1863,48,20-24,1911,0.010115824835458358
STAT,1881,17,30-34,1898,1.5051670484462545
STAT,1833,35,25-29,1868,1.5982232578042226
SIM,1896,6,na,1902,4131
STAT,1841,43,na,1884,2640.3675028282432
STAT,1880,32,40-44,1912,4.502181541926275
STAT,1883,25,50-100,1908,0.6195868648512697
SIM,1850,71,na,1921,644
STAT,1809,46,45-49,1855,2.1234190931276444
SIM,1939,25,35-39,1964,30
SIM,1821,35,na,1856,2066
STAT,1868,25,45-49,1893,1.0796850067996515
SIM,1953,9,na,1962,4654
SIM,1907,62,na,1969,4004
SIM,1935,32,40-44,1967,34
STAT,1937,21,45-49,1958,1.084728905554873
STAT,1869,39,25-29,1908,2.8761046976526834
SIM,1859,5,na,1864,2466
STAT,1816,99,na,1915,1.5988526521126578
STAT,1889,29,30-34,1918,30.107937482569834
STAT,1845,50,45-49,1895,0.007304792528542822
SIM,1922,31,na,1953,3353
SIM,1824,32,20-24,1856,6
STAT,1880,50,35-39,1930,0.009065969235031576
STAT,1821,110,na,1931,1.3955546475526186E-4
STAT,1900,32,35-39,1932,14.028876924543791
STAT,1897,38,20-24,1935,1.0186496722684022
STAT,1838,42,20-24,1880,0.0792836648460639
STAT,1850,32,25-29,1882,4.947679539355289
STAT,1887,16,15-19,1903,6.548043632179681
STAT,1856,50,20-24,1906,5.376297349850304E-4
STAT,1892,16,25-29,1908,7.033172804843564
STAT,1916,15,50-100,1931,0.07876876327820684
SIM,1846,24,20-24,1870,2
STAT,1840,33,50-100,1873,0.43488330039561496
STAT,1861,54,45-49,1915,0.011737253344306114
STAT,1853,31,35-39,1884,8.17076252715433
STAT,1884,43,30-34,1927,1.0925955692955467
SIM,1832,27,na,1859,2260
STAT,1897,23,20-24,1920,91.2365763337186
STAT,1818,71,na,1889,845.0904346572502
STAT,1889,47,50-100,1936,0.16605417341819936
STAT,1875,32,30-34,1907,17.928549644841418
STAT,1836,44,40-44,1880,1.9985320636246966
STAT,1851,19,45-49,1870,0.0619887607886923
STAT,1834,36,50-100,1870,0.6800616836641712
STAT,1782,104,na,1886,0.1044840346534259
STAT,1864,29,25-29,1893,38.18162624460126
STAT,1817,52,30-34,1869,0.00402627010934376
STAT,1927,32,40-44,1959,4.774647547554249
STAT,1817,39,50-100,1856,0.9284683541259633
STAT,1837,18,50-100,1855,0.05204732230835056
STAT,1846,15,15-19,1861,4.46777679121754
STAT,1925,39,na,1964,4464.632425068266
SIM,1871,22,na,1893,1947
SIM,1871,18,20-24,1889,16
SIM,1848,36,25-29,1884,5
SIM,1841,39,45-49,1880,1
STAT,1839,53,25-29,1892,0.0032379273421986655
STAT,1846,48,15-19,1894,2.3392743719128015E-4
STAT,1849,43,40-44,1892,1.8815308985968238
STAT,1865,47,40-44,1912,0.15557537312628753
SIM,1932,6,na,1938,6513
SIM,1949,18,na,1967,4479
STAT,1912,16,50-100,1928,0.07506355014302792
STAT,1807,48,35-39,1855,0.4760000567767169
STAT,1834,31,30-34,1865,9.959281943554112
STAT,1935,23,35-39,1958,12.72566615570723
STAT,1852,100,na,1952,1.068639080073793
STAT,1894,32,35-39,1926,12.878169949618012
STAT,1889,47,25-29,1936,0.038944300982951756
STAT,1848,46,30-34,1894,0.09084015877986525
STAT,1899,5,na,1904,3579.444436282327
STAT,1882,40,20-24,1922,0.15358345762572714
SIM,1890,40,20-24,1930,3
SIM,1892,47,na,1939,3503
STAT,1851,33,25-29,1884,8.332777733547733
STAT,1920,16,na,1936,4086.502964012464
STAT,1943,15,35-39,1958,4.40124169347352
STAT,1795,80,na,1875,312.74795263863524
STAT,1863,18,20-24,1881,15.623616659303847
STAT,1843,42,30-34,1885,1.1695618123356226
STAT,1811,47,45-49,1858,1.1092321096854365
SIM,1879,33,20-24,1912,17
STAT,1880,15,20-24,1895,18.49046590965587
STAT,1825,29,45-49,1854,2.608315995683311
STAT,1857,51,20-24,1908,5.68960165390331E-4
STAT,1827,41,35-39,1868,1.7418962844588328
STAT,1852,30,35-39,1882,10.77592519336891
SIM,1856,28,30-34,1884,1
STAT,1842,41,30-34,1883,0.2990833327475897
STAT,1854,43,15-19,1897,0.007623041564603342
STAT,1874,39,35-39,1913,7.226256897959582
STAT,1875,50,25-29,1925,0.0036893908101838443
STAT,1871,27,45-49,1898,1.1075758055768885
STAT,1841,26,20-24,1867,16.343130985914176
STAT,1920,29,50-100,1949,1.070130365839471
SIM,1891,62,na,1953,1305
SIM,1945,18,15-19,1963,1
STAT,1923,21,15-19,1944,6.147093635157052
SIM,1878,40,na,1918,4065
STAT,1873,25,25-29,1898,43.68632072300209
SIM,1875,75,na,1950,2443
STAT,1837,61,na,1898,1498.3348114824337
SIM,1933,23,na,1956,4254
STAT,1856,38,30-34,1894,3.809001366876631
SIM,1909,24,40-44,1933,26
STAT,1861,23,40-44,1884,1.7675798801123153
STAT,1899,37,40-44,1936,1.2905335981198534
SIM,1885,30,40-44,1915,128
STAT,1819,56,na,1875,536.4309314682099
STAT,1877,30,40-44,1907,4.437675387674632
SIM,1931,21,15-19,1952,13
SIM,1880,90,na,1970,1627
STAT,1887,34,45-49,1921,1.9029453820389204
SIM,1809,55,na,1864,612
STAT,1830,51,na,1881,1649.650009371277
STAT,1846,33,15-19,1879,0.0986421820109403
SIM,1804,63,na,1867,845
STAT,1867,40,25-29,1907,0.6134351608936619
SIM,1878,12,na,1890,4386
STAT,1937,18,15-19,1955,43.579594380862815
STAT,1879,25,20-24,1904,12.116236769890953
SIM,1842,31,30-34,1873,173
STAT,1914,47,35-39,1961,0.12608905748019988
SIM,1943,23,35-39,1966,14
STAT,1848,28,30-34,1876,27.929671052007816
STAT,1858,53,30-34,1911,0.004472762651902094
STAT,1869,18,20-24,1887,18.030437117484016
SIM,1803,61,na,1864,965
STAT,1785,99,na,1884,0.1614105829504488
STAT,1832,24,25-29,1856,72.37322557679079
SIM,1895,75,na,1970,3703
SIM,1861,43,35-39,1904,1
STAT,1863,36,20-24,1899,0.6612505633314141
STAT,1876,30,25-29,1906,10.437560569298132
SIM,1889,2,na,1891,3939
STAT,1818,51,35-39,1869,0.01502879682174889
STAT,1945,16,na,1961,3977.488377049388
STAT,1837,28,20-24,1865,11.986690190144456
STAT,1820,37,45-49,1857,3.7089773280098606
STAT,1922,25,15-19,1947,0.7952766670702088
STAT,1846,37,30-34,1883,3.2962730344074975
STAT,1869,53,40-44,1922,0.010452692541174093
STAT,1888,48,25-29,1936,0.03702896894771346
STAT,1954,18,15-19,1972,55.590634842450996
SIM,1860,70,na,1930,1638
SIM,1861,41,40-44,1902,1
STAT,1856,40,15-19,1896,0.010019045082654535
SIM,1921,46,na,1967,5139
STAT,1843,24,35-39,1867,7.133600372792443
SIM,1809,63,na,1872,179
SIM,1929,7,na,1936,6274
STAT,1820,51,50-100,1871,0.023367857618579183
STAT,1860,21,30-34,1881,15.08784056279373
STAT,1841,66,na,1907,1825.1443723741966
STAT,1912,21,40-44,1933,3.194528397900829
SIM,1951,8,na,1959,2373
STAT,1849,33,50-100,1882,0.8051139113709218
STAT,1877,48,15-19,1925,4.0094579276536127E-4
STAT,1848,13,na,1861,2756.697194611372
SIM,1904,49,40-44,1953,1
STAT,1896,24,45-49,1920,0.913474726239581
SIM,1868,73,na,1941,328
STAT,1885,42,35-39,1927,1.7777468494906292
STAT,1869,83,na,1952,400.59238459474074
SIM,1796,74,na,1870,658
STAT,1891,30,20-24,1921,3.350748065020284
STAT,1854,33,na,1887,1344.719243745655
STAT,1936,20,50-100,1956,0.623262176675648
STAT,1871,24,40-44,1895,2.065677267981524
STAT,1864,17,25-29,1881,5.32927563091949
SIM,1876,17,na,1893,3778
STAT,1872,58,na,1930,1980.2862096775825
SIM,1917,16,na,1933,2245
STAT,1953,11,na,1964,4709.950018480817
STAT,1833,51,30-34,1884,0.002681896749730334
SIM,1887,57,na,1944,3006
SIM,1923,43,35-39,1966,1
STAT,1893,16,45-49,1909,0.08188823578037281
STAT,1883,10,na,1893,2492.005506424405
STAT,1908,48,20-24,1956,0.009889424047488138
STAT,1821,34,20-24,1855,3.600439140175368
STAT,1844,51,40-44,1895,0.010479527236560987
SIM,1858,43,na,1901,2325
STAT,1838,27,50-100,1865,0.3473607895305638
STAT,1875,17,35-39,1892,0.5634432040989774
SIM,1902,62,na,1964,2613
SIM,1837,19,na,1856,2382
STAT,1851,30,20-24,1881,2.268629988532836
SIM,1889,35,na,1924,3845
STAT,1869,94,na,1963,53.33048915227098
STAT,1855,7,na,1862,1948.3913143892692
STAT,1893,19,45-49,1912,0.0812495356983715
STAT,1922,39,40-44,1961,1.680792246334285
STAT,1872,27,30-34,1899,25.216136885180443
STAT,1838,91,na,1929,24.713135440822732
SIM,1893,42,35-39,1935,4
STAT,1869,51,45-49,1920,0.014714281089263608
STAT,1837,53,50-100,1890,0.011915454887118723
STAT,1894,50,na,1944,2777.5177583564723
SIM,1932,20,20-24,1952,27
STAT,1837,46,20-24,1883,0.010116918888269918
STAT,1825,45,45-49,1870,0.3078640121333136
STAT,1895,44,15-19,1939,0.00123067535749983
STAT,1876,49,45-49,1925,0.23359304631630778
STAT,1813,41,40-44,1854,14.011761387233944
STAT,1821,54,45-49,1875,0.014395637046184065
STAT,1879,39,15-19,1918,0.05702581225236392
STAT,1913,20,45-49,1933,1.0830446042905018
STAT,1849,42,30-34,1891,0.9675084867286858
SIM,1956,11,na,1967,4928
STAT,1867,22,25-29,1889,54.361925324904995
STAT,1899,36,35-39,1935,9.707169440777408
STAT,1841,48,35-39,1889,0.15461226342881298
STAT,1826,28,45-49,1854,3.9530988446222874
SIM,1834,30,na,1864,1129
STAT,1831,101,na,1932,0.44659857846164197
STAT,1923,38,45-49,1961,0.7807987608751332
STAT,1935,35,50-100,1970,0.5838759676670409
STAT,1956,8,na,1964,5155.031611656996
SIM,1894,5,na,1899,1764
SIM,1898,25,30-34,1923,11
SIM,1923,24,na,1947,4291
STAT,1857,19,40-44,1876,0.16302531640974177
STAT,1872,38,20-24,1910,0.7680683196011079
STAT,1866,28,50-100,1894,0.581867774418647
SIM,1881,19,25-29,1900,13
STAT,1872,5,na,1877,2776.1004991649356
STAT,1821,36,15-19,1857,0.07120267611388073
STAT,1799,70,na,1869,134.7455820971943
STAT,1838,27,25-29,1865,22.970188816032557
STAT,1890,18,15-19,1908,7.1655871432362925
STAT,1845,34,40-44,1879,2.506091599342925
STAT,1840,49,30-34,1889,0.03746402250462123
STAT,1894,61,na,1955,2376.26637810975
SIM,1847,29,na,1876,1656
STAT,1909,30,30-34,1939,15.001285558343868
STAT,1837,25,20-24,1862,12.248636003702522
STAT,1880,30,45-49,1910,1.824908677875736
STAT,1948,4,na,1952,4495.53138600936
STAT,1934,38,20-24,1972,0.3609454670210354
STAT,1855,41,45-49,1896,0.9950129736222851
STAT,1892,36,45-49,1928,2.4800028057579806
STAT,1912,48,40-44,1960,0.14934459466325276
STAT,1847,47,25-29,1894,0.05183434993652318
SIM,1790,86,na,1876,101
SIM,1929,36,30-34,1965,22
SIM,1881,32,na,1913,3051
STAT,1821,66,na,1887,828.852256800585
STAT,1897,41,15-19,1938,0.0012793417426669477
STAT,1924,20,20-24,1944,130.72307333804116
STAT,1846,46,50-100,1892,0.14587225371591506
SIM,1845,25,20-24,1870,93
SIM,1850,60,na,1910,1110
STAT,1914,24,na,1938,3655.9509121960878
STAT,1857,37,40-44,1894,3.3591267876165594
STAT,1874,52,30-34,1926,0.0061107223751381105
SIM,1885,42,na,1927,1433
STAT,1826,46,45-49,1872,0.342257040894629
STAT,1884,20,na,1904,2277.504037032624
STAT,1830,82,na,1912,337.699451077685
STAT,1836,47,15-19,1883,3.2077026365608916E-4
STAT,1855,23,45-49,1878,0.5352903474396787
STAT,1887,49,20-24,1936,0.0072948965377088995
STAT,1793,85,na,1878,79.84483901832576
STAT,1939,31,20-24,1970,2.4627975833875677
STAT,1932,15,30-34,1947,16.101979849019315
SIM,1862,17,na,1879,3819
SIM,1862,40,45-49,1902,9
SIM,1881,25,25-29,1906,26
STAT,1898,38,40-44,1936,1.2642477180575848
STAT,1893,34,40-44,1927,5.376753481672197
STAT,1907,42,na,1949,3379.8029496936624
SIM,1895,38,30-34,1933,28
STAT,1812,42,35-39,1854,0.8776079922808558
STAT,1851,35,45-49,1886,1.6246942427150748
STAT,1926,46,15-19,1972,4.5174884239697225E-4
SIM,1925,39,na,1964,4721
SIM,1861,32,na,1893,2211
STAT,1836,45,20-24,1881,0.00987287996969425
STAT,1858,39,45-49,1897,1.5070328056942803
STAT,1888,18,25-29,1906,6.523196613203949
STAT,1878,43,na,1921,2360.785600509769
STAT,1826,43,40-44,1869,3.3207975357916224
STAT,1827,51,na,1878,1681.7153019740258
STAT,1873,37,20-24,1910,0.7907210816839905
SIM,1875,26,40-44,1901,29
STAT,1851,16,40-44,1867,0.17667201566348004
STAT,1835,48,45-49,1883,0.18582200018047226
SIM,1884,80,na,1964,1367
STAT,1840,16,30-34,1856,0.817376935299537
STAT,1904,14,na,1918,3677.675581509837
SIM,1863,10,na,1873,1639
STAT,1884,38,50-100,1922,1.1694548486856944
STAT,1841,46,40-44,1887,0.19397590238851953
SIM,1886,29,20-24,1915,16
SIM,1874,73,na,1947,1948
STAT,1821,36,45-49,1857,2.527694701438049
STAT,1936,22,35-39,1958,8.912727736210147
SIM,1829,39,25-29,1868,11
SIM,1892,24,na,1916,2018
STAT,1825,73,na,1898,731.4331115732346
STAT,1859,52,35-39,1911,0.006787151890272353
STAT,1911,39,30-34,1950,1.7230182427029634
STAT,1880,51,45-49,1931,0.015138212942320832
STAT,1878,29,20-24,1907,11.98386180840421
SIM,1872,24,na,1896,2452
SIM,1829,27,25-29,1856,3
STAT,1860,51,25-29,1911,0.0029033717568619864
STAT,1890,36,15-19,1926,0.06830831743491679
STAT,1857,33,20-24,1890,2.0654697833473814
STAT,1858,51,35-39,1909,0.006605887305346963
STAT,1887,38,30-34,1925,5.837027401644051
STAT,1849,24,30-34,1873,17.886072398090455
STAT,1945,7,na,1952,4269.408065715318
STAT,1823,45,15-19,1868,6.422066274468972E-4
STAT,1836,96,na,1932,6.5716865534992035
STAT,1872,23,45-49,1895,0.6961119932842457
STAT,1878,26,20-24,1904,12.11155078559697
STAT,1928,9,na,1937,4977.873078071402
SIM,1889,27,na,1916,3659
STAT,1888,36,25-29,1924,3.339058965958322
STAT,1826,47,50-100,1873,0.3514762270391838
STAT,1907,65,na,1972,2834.0155876541057
STAT,1846,19,30-34,1865,1.1719096565277174
STAT,1882,27,25-29,1909,40.499814329549274
STAT,1840,41,na,1881,961.5673400240149
STAT,1870,31,35-39,1901,10.137266309918601
STAT,1832,39,25-29,1871,0.2338029789915201
STAT,1831,37,20-24,1868,0.7829081993761752
STAT,1873,4,na,1877,3004.5338731702254
STAT,1910,17,na,1927,3784.202210863292
STAT,1892,17,40-44,1909,0.22645114813098302
STAT,1813,42,15-19,1855,0.06913852433270684
STAT,1879,28,25-29,1907,43.24173438266668
STAT,1842,26,40-44,1868,0.9262629441559509
SIM,1871,18,25-29,1889,1
SIM,1862,42,40-44,1904,1
SIM,1905,39,na,1944,3097
SIM,1899,34,na,1933,1797
STAT,1829,66,na,1895,598.5164718884987
SIM,1866,95,na,1961,104
STAT,1863,18,25-29,1881,4.993915793043179
STAT,1915,43,35-39,1958,0.1995509422915996
STAT,1836,29,15-19,1865,0.4434256342878526
STAT,1852,36,45-49,1888,2.038566061036327
STAT,1832,36,25-29,1868,0.21218579512859692
STAT,1879,93,na,1972,136.13407325699558
SIM,1840,36,25-29,1876,4
SIM,1899,23,25-29,1922,537
SIM,1919,28,na,1947,5081
STAT,1865,0,na,1865,3478.935634985697
SIM,1837,37,30-34,1874,5
STAT,1842,29,40-44,1871,0.9064541507194999
STAT,1884,35,50-100,1919,1.1864460756256439
STAT,1864,46,15-19,1910,3.646746020854772E-4
STAT,1914,44,30-34,1958,0.12450306231787563
STAT,1922,42,na,1964,4215.286586842351
SIM,1845,14,na,1859,2914
SIM,1850,29,40-44,1879,1
STAT,1813,48,na,1861,2228.8484699521227
STAT,1797,92,na,1889,0.4772295024403338
STAT,1939,15,15-19,1954,45.03907720673899
STAT,1896,28,30-34,1924,33.07865302242804
SIM,1875,44,40-44,1919,4
STAT,1839,50,20-24,1889,7.026347718634344E-4
STAT,1909,20,na,1929,3531.6260236333856
STAT,1919,47,50-100,1966,0.24206488578691046
STAT,1939,26,50-100,1965,0.9900751005179953
STAT,1876,65,na,1941,1708.3966802643374
STAT,1878,47,20-24,1925,0.012288871555885126
STAT,1935,20,30-34,1955,38.883610246612605
SIM,1914,25,30-34,1939,56
STAT,1884,25,35-39,1909,9.299317348013426
SIM,1874,43,40-44,1917,1
STAT,1863,47,50-100,1910,0.20869423902643952
SIM,1954,16,na,1970,5552
STAT,1852,15,45-49,1867,0.0804707273843405
SIM,1938,23,20-24,1961,123
SIM,1817,81,na,1898,449
STAT,1877,48,45-49,1925,0.2365582168386045
STAT,1880,33,15-19,1913,0.14721727096055578
SIM,1925,28,na,1953,4764
SIM,1825,34,35-39,1859,4
STAT,1847,51,na,1898,1956.0297131164716
SIM,1845,25,na,1870,2606
SIM,1854,37,30-34,1891,4
STAT,1785,103,na,1888,0.02431800015505524
STAT,1861,38,45-49,1899,1.6496461475043305
STAT,1906,25,30-34,1931,36.71258030020052
STAT,1867,44,40-44,1911,2.098494470614619
SIM,1834,22,na,1856,705
STAT,1853,99,na,1952,1.468483087580589
SIM,1859,22,40-44,1881,10
STAT,1866,43,40-44,1909,2.038349359667861
SIM,1892,25,35-39,1917,13
STAT,1877,46,20-24,1923,0.0122160300217819
STAT,1852,18,45-49,1870,0.07905716828391941
SIM,1881,40,50-100,1921,3
STAT,1857,54,25-29,1911,0.0026432607312420393
SIM,1861,55,na,1916,1737
STAT,1843,21,30-34,1864,22.250523030106038
SIM,1865,14,na,1879,1931
STAT,1875,53,30-34,1928,0.006014247730572503
STAT,1894,44,35-39,1938,0.15774832658993043
STAT,1874,61,na,1935,1928.556196041524
STAT,1830,74,na,1904,803.2342578073394
STAT,1902,49,30-34,1951,0.07528474441317183
STAT,1868,13,na,1881,2567.9704319733005
STAT,1949,3,na,1952,4581.207440481713
STAT,1850,38,35-39,1888,3.2834508622697745
SIM,1895,35,na,1930,4508
STAT,1837,28,25-29,1865,43.22176462824316
STAT,1913,17,15-19,1930,9.162575021689062
SIM,1902,11,na,1913,3754
STAT,1833,54,35-39,1887,0.0036549886670116665
STAT,1829,37,30-34,1866,2.703076467481883
STAT,1854,28,20-24,1882,6.789022052262381
STAT,1870,41,40-44,1911,2.2525238355848693
STAT,1873,19,25-29,1892,5.781641642003816
STAT,1843,40,35-39,1883,1.8899597633441918
SIM,1810,94,na,1904,258
STAT,1834,33,na,1867,1210.7802333486945
SIM,1871,62,na,1933,1634
STAT,1868,36,35-39,1904,6.864409247339938
STAT,1793,77,na,1870,305.6263285996784
STAT,1878,20,na,1898,2447.8443501723737
STAT,1894,46,20-24,1940,0.00863229544219322
STAT,1883,44,25-29,1927,0.6094438967455317
SIM,1865,36,25-29,1901,3
SIM,1901,37,20-24,1938,1
STAT,1877,33,45-49,1910,1.76271919138188
SIM,1862,28,20-24,1890,43
STAT,1840,81,na,1921,212.92850827591323
STAT,1865,28,30-34,1893,22.909921753579262
STAT,1854,40,45-49,1894,0.8405551767370175
STAT,1910,44,50-100,1954,0.10843734964480811
SIM,1879,9,na,1888,1960
SIM,1918,32,35-39,1950,104
STAT,1815,74,na,1889,79.7990670895787
SIM,1844,47,45-49,1891,3
STAT,1898,20,na,1918,3199.296183799035
STAT,1822,35,20-24,1857,1.6984620867310394
STAT,1938,18,30-34,1956,11.89099103867593
STAT,1893,20,na,1913,2975.205555897634
STAT,1832,36,20-24,1868,0.05680860809676933
STAT,1867,68,na,1935,1445.2623619785174
SIM,1891,8,na,1899,2765
STAT,1925,16,na,1941,4416.481264282374
STAT,1776,110,na,1886,0.0037871348145279266
STAT,1776,85,na,1861,157.97292041885774
STAT,1846,52,50-100,1898,0.008897149872616115
STAT,1839,40,15-19,1879,0.015245587329455261
STAT,1872,54,20-24,1926,7.186027705841196E-4
STAT,1867,47,45-49,1914,0.2221517609236833
STAT,1888,13,na,1901,2976.01830265796
STAT,1949,18,40-44,1967,1.6101933333553862
STAT,1887,71,na,1958,1559.9258471724575
SIM,1883,4,na,1887,2348
SIM,1918,9,na,1927,4480
STAT,1842,47,40-44,1889,0.04250655451768996
STAT,1896,39,15-19,1935,0.07327952682964144
SIM,1940,7,na,1947,4338
SIM,1928,19,25-29,1947,17
STAT,1911,35,15-19,1946,0.018513150143499604
STAT,1889,20,50-100,1909,0.494001423149219
STAT,1911,22,35-39,1933,8.829424756574902
STAT,1852,33,40-44,1885,4.473044062131509
STAT,1827,53,35-39,1880,0.007469313629466463
STAT,1835,46,50-100,1881,0.19839997290639408
STAT,1872,83,na,1955,397.5267359476162
SIM,1860,33,40-44,1893,134
SIM,1915,46,na,1961,2962
STAT,1899,33,30-34,1932,23.747019823721594
SIM,1840,36,20-24,1876,1
STAT,1828,38,20-24,1866,1.013909910843961
STAT,1895,41,50-100,1936,0.09586666934340977
STAT,1901,28,15-19,1929,0.6321407861075237
STAT,1836,47,45-49,1883,0.18925461484949396
STAT,1956,16,25-29,1972,56.85762517283054
STAT,1892,33,40-44,1925,5.346603658478337
STAT,1847,29,25-29,1876,45.31131117809817
STAT,1833,50,50-100,1883,0.00694061504981691
STAT,1845,42,50-100,1887,0.5338325107201229
STAT,1871,45,45-49,1916,0.2377673357448941
STAT,1838,45,25-29,1883,0.02595291433608779
STAT,1877,15,45-49,1892,0.0666182908215143
STAT,1868,54,35-39,1922,0.008086575785030027
STAT,1817,50,35-39,1867,0.006058741748980513
STAT,1845,52,40-44,1897,0.005196188743731341
STAT,1862,37,15-19,1899,0.047829143965726115
STAT,1865,3,na,1868,2921.0164954797465
STAT,1830,26,15-19,1856,0.4394182342678456
STAT,1878,29,25-29,1907,43.21156601228526
SIM,1866,35,35-39,1901,1
SIM,1878,43,na,1921,4034
STAT,1857,58,na,1915,1517.532017543136
STAT,1948,21,15-19,1969,6.051527321701068
STAT,1816,53,25-29,1869,0.010160771329427326
STAT,1895,29,20-24,1924,15.152048023306987
STAT,1927,21,50-100,1948,0.8065103352308569
STAT,1867,26,45-49,1893,1.053650526454593
STAT,1861,32,na,1893,1984.5587789350402
STAT,1898,12,na,1910,3472.743391186844
STAT,1882,47,40-44,1929,0.16314448579858723
SIM,1841,55,na,1896,77
SIM,1870,35,20-24,1905,4
SIM,1898,28,35-39,1926,1
STAT,1856,106,na,1962,0.03436698901778988
SIM,1855,29,25-29,1884,10
STAT,1920,40,50-100,1960,0.12843611259170587
SIM,1882,17,na,1899,2232
STAT,1830,71,na,1901,966.0917457681735
STAT,1883,26,25-29,1909,40.835451352802245
STAT,1919,32,50-100,1951,0.8801680240440352
STAT,1892,31,20-24,1923,3.3603168447324077
STAT,1893,16,40-44,1909,0.22928711594193588
SIM,1860,3,na,1863,2680
STAT,1879,15,45-49,1894,0.06732176846827222
STAT,1905,8,na,1913,3738.9807396201622
SIM,1881,22,20-24,1903,303
STAT,1860,24,35-39,1884,4.837217755184847
SIM,1905,36,na,1941,3141
STAT,1881,31,45-49,1912,1.6535043534030893
STAT,1903,31,40-44,1934,6.1811750874786116
SIM,1834,25,40-44,1859,1
SIM,1912,32,na,1944,4248
STAT,1816,39,40-44,1855,15.331194294782017
SIM,1824,39,40-44,1863,31
STAT,1893,37,45-49,1930,2.492910581494353
STAT,1913,49,40-44,1962,0.15106448083829752
STAT,1840,27,15-19,1867,0.2227473024133182
STAT,1804,54,45-49,1858,0.08803759779738664
STAT,1853,45,20-24,1898,0.009397428243276525
STAT,1862,19,15-19,1881,5.206252226885545
STAT,1836,32,45-49,1868,1.68904007504861
STAT,1922,50,na,1972,4135.7953064769845
SIM,1878,32,na,1910,4129
STAT,1814,40,45-49,1854,6.056320909056995
SIM,1917,30,30-34,1947,38
STAT,1831,53,20-24,1884,6.001118689650469E-4
STAT,1806,49,25-29,1855,0.16422916030138598
STAT,1892,35,na,1927,2944.6231486888
STAT,1906,45,50-100,1951,0.2026141862279971
STAT,1926,24,50-100,1950,0.7875715068860436
STAT,1882,28,na,1910,2276.839050116553
STAT,1926,33,35-39,1959,10.9483575592112
SIM,1896,15,20-24,1911,13
STAT,1855,38,15-19,1893,0.03698079796525012
STAT,1938,16,50-100,1954,0.3665166632276141
STAT,1825,40,20-24,1865,0.21811135879874177
STAT,1863,98,na,1961,6.632217895166165
SIM,1847,40,na,1887,1520
STAT,1824,109,na,1933,1.3768433889311702E-4
STAT,1847,47,20-24,1894,0.010798823407177426
STAT,1883,48,40-44,1931,0.16263231117413715
SIM,1906,30,20-24,1936,9
STAT,1862,73,na,1935,1011.6576658208769
SIM,1892,41,35-39,1933,2
STAT,1876,50,40-44,1926,0.010795422427530428
STAT,1886,86,na,1972,554.0683186400227
SIM,1827,37,na,1864,2243
STAT,1829,33,15-19,1862,0.0766107810465531
STAT,1849,27,35-39,1876,9.63748113336492
SIM,1886,29,25-29,1915,2
STAT,1840,30,45-49,1870,0.8538701559378815
STAT,1851,32,40-44,1883,3.5649219684651716
SIM,1846,55,na,1901,833
SIM,1906,21,na,1927,3471
STAT,1884,41,35-39,1925,1.7412854631616144
STAT,1938,34,na,1972,3757.295664062232
STAT,1956,5,na,1961,5157.248912049113
SIM,1914,21,15-19,1935,31
SIM,1850,25,25-29,1875,1
STAT,1864,35,25-29,1899,2.642354540260303
STAT,1888,15,20-24,1903,20.556695145692967
STAT,1881,32,na,1913,2253.507509117613
SIM,1825,31,30-34,1856,1
STAT,1822,103,na,1925,0.08275798099336375
STAT,1928,28,15-19,1956,0.862699682501755
STAT,1842,43,25-29,1885,0.16282939329567023
STAT,1823,110,na,1933,2.1830072859075557E-4
STAT,1928,31,45-49,1959,1.9537585672275737
SIM,1934,33,35-39,1967,59
SIM,1939,3,na,1942,4904
STAT,1863,50,35-39,1913,0.007455277382180311
STAT,1928,27,na,1955,4580.12769854855
SIM,1819,38,25-29,1857,2
STAT,1853,25,35-39,1878,8.792994758414812
STAT,1824,48,35-39,1872,0.024026788688203585
STAT,1839,38,30-34,1877,5.856016207672764
STAT,1833,31,15-19,1864,0.08174963189435792
STAT,1904,54,na,1958,3049.207681086363
SIM,1861,25,35-39,1886,10
STAT,1862,37,45-49,1899,1.6979344088573514
STAT,1940,16,na,1956,3696.3235625390553
STAT,1850,40,na,1890,1078.0107635365173
STAT,1854,41,50-100,1895,0.5900637990478231
STAT,1886,20,40-44,1906,2.1707636420546814
STAT,1830,41,40-44,1871,2.014058726471394
STAT,1891,39,35-39,1930,8.610235633528049
STAT,1897,27,na,1924,3169.426817305348
SIM,1847,38,30-34,1885,17
SIM,1940,13,na,1953,4298
SIM,1906,32,na,1938,3503
STAT,1829,48,15-19,1877,1.8262924474396746E-4
STAT,1862,22,45-49,1884,0.6080070885212734
STAT,1823,78,na,1901,617.2348542976774
STAT,1855,23,15-19,1878,2.5324553083338386
STAT,1809,63,na,1872,2178.5700431133805
STAT,1849,45,35-39,1894,0.1191389023324955
STAT,1844,41,35-39,1885,1.8609977923892858
STAT,1888,4,na,1892,3036.244305779473
STAT,1842,25,25-29,1867,13.17468195111002
STAT,1918,24,40-44,1942,3.5550848924594933
STAT,1854,84,na,1938,184.96661603055756
STAT,1894,26,35-39,1920,12.312250125259016
SIM,1878,34,45-49,1912,72
STAT,1829,33,45-49,1862,0.9381206541137108
SIM,1873,49,35-39,1922,1
SIM,1855,0,na,1855,3430
STAT,1888,33,20-24,1921,3.1066068479595046
SIM,1833,37,na,1870,2070
STAT,1906,21,15-19,1927,4.791645152887395
STAT,1852,15,40-44,1867,0.22531809146787804
STAT,1874,32,15-19,1906,0.1469741911848425
STAT,1922,3,na,1925,4641.77500390527
STAT,1819,44,40-44,1863,0.4274063214166242
STAT,1880,18,20-24,1898,18.356732831090195
STAT,1902,30,50-100,1932,1.3005917089257661
STAT,1891,20,15-19,1911,4.081110494756333
SIM,1782,82,na,1864,514
STAT,1853,43,35-39,1896,1.3939417459080876
STAT,1886,35,40-44,1921,4.576175097909551
SIM,1824,63,na,1887,1811
STAT,1896,42,45-49,1938,0.13683451749467435
STAT,1896,24,15-19,1920,4.3216432550278965
STAT,1828,92,na,1920,28.193746654743478
STAT,1865,49,35-39,1914,0.1251499917461777
SIM,1852,41,35-39,1893,11
STAT,1866,46,45-49,1912,0.21603684889539507
STAT,1827,35,35-39,1862,7.147295050170294
STAT,1863,15,20-24,1878,17.47579160475179
STAT,1834,52,30-34,1886,0.002689885219235873
STAT,1866,41,20-24,1907,0.14562345126294243
STAT,1905,39,na,1944,3381.014914003598
STAT,1888,48,20-24,1936,0.007714368890627506
SIM,1872,58,na,1930,2110
SIM,1898,49,na,1947,4037
STAT,1939,19,30-34,1958,12.058518050770783
STAT,1884,22,30-34,1906,17.051206974734313
STAT,1826,66,na,1892,1306.6780362243073
SIM,1937,16,na,1953,2988
STAT,1905,10,na,1915,3725.719088672683
STAT,1829,51,45-49,1880,0.006616278382385759
STAT,1810,82,na,1892,14.526845141878107
STAT,1842,29,45-49,1871,0.335976432837815
STAT,1895,41,45-49,1936,0.13581111529234802
STAT,1947,15,50-100,1962,0.41781166263135733
SIM,1793,74,na,1867,740
STAT,1926,15,35-39,1941,5.124270849356558
SIM,1962,3,na,1965,4683
STAT,1836,99,na,1935,1.4494464729112826
STAT,1916,39,15-19,1955,0.019201851370173204
STAT,1918,42,40-44,1960,0.26235015301354464
STAT,1844,40,na,1884,2405.9196931439114
STAT,1865,40,20-24,1905,0.14645793027688583
STAT,1828,50,45-49,1878,0.017407949431803665
STAT,1799,62,na,1861,181.57723522505003
STAT,1827,32,50-100,1859,0.9432360955894241
STAT,1786,75,na,1861,767.9251719475958
STAT,1898,34,25-29,1932,13.65547968695756
STAT,1871,56,na,1927,2034.623917572565
STAT,1904,38,40-44,1942,1.3432014698415542
STAT,1877,42,40-44,1919,2.280474574786184
STAT,1910,49,20-24,1959,0.010135593438218817
STAT,1822,36,30-34,1858,11.223182640967769
STAT,1842,29,50-100,1871,0.1935701724585107
STAT,1875,46,na,1921,2316.813243617919
SIM,1892,47,45-49,1939,3
STAT,1958,6,na,1964,5117.6136465193495
STAT,1894,49,25-29,1943,0.04045502533183585
STAT,1900,72,na,1972,2189.9295414433927
SIM,1931,25,30-34,1956,3
STAT,1837,92,na,1929,33.39589995927666
STAT,1894,41,30-34,1935,1.4686005612409223
STAT,1853,35,50-100,1888,0.9719547313674466
STAT,1896,46,25-29,1942,0.04295243023686335
STAT,1856,99,na,1955,1.3602767239412665
STAT,1861,41,35-39,1902,1.5127645959965088
STAT,1819,46,50-100,1865,0.04672269876001016
STAT,1858,16,25-29,1874,5.085020291508294
STAT,1844,45,50-100,1889,0.24715022580778126
STAT,1861,35,40-44,1896,3.6750938364527967
STAT,1957,15,30-34,1972,15.93794595842428
STAT,1914,41,25-29,1955,0.06987502719769757
STAT,1847,37,na,1884,2210.0516353264675
STAT,1835,52,45-49,1887,0.011190297595885006
STAT,1921,37,30-34,1958,2.010921934110898
SIM,1821,66,na,1887,1505
STAT,1884,47,45-49,1931,0.22486305244911364
STAT,1935,2,na,1937,5550.840892346389
SIM,1898,63,na,1961,3640
STAT,1846,17,45-49,1863,0.04859989525276944
STAT,1811,48,20-24,1859,0.05550437921263076
STAT,1846,52,20-24,1898,4.3471418036861045E-4
STAT,1905,41,15-19,1946,0.0013855659160062228
STAT,1837,40,45-49,1877,1.4528156545828768
STAT,1856,19,25-29,1875,4.756157611810823
SIM,1926,24,na,1950,6030
STAT,1941,23,25-29,1964,94.34020069347697
STAT,1886,35,45-49,1921,2.0839607905420814
SIM,1789,78,na,1867,187
SIM,1860,41,25-29,1901,1
STAT,1894,39,na,1933,2965.8450884633744
STAT,1903,16,45-49,1919,0.09295376504460251
STAT,1889,41,20-24,1930,0.19211197139740727
STAT,1873,40,15-19,1913,0.014308780273288874
STAT,1906,17,40-44,1923,0.26485668534622786
SIM,1905,35,30-34,1940,1
STAT,1831,29,35-39,1860,10.642955886696164
STAT,1826,69,na,1895,1169.9785480514538
STAT,1914,16,20-24,1930,27.72270759061828
STAT,1858,54,na,1912,1599.080205005548
STAT,1879,18,50-100,1897,0.050126145692869106
STAT,1878,48,30-34,1926,0.09834313288061625
SIM,1847,57,na,1904,1382
STAT,1849,23,20-24,1872,69.69840575330562
STAT,1868,51,30-34,1919,0.005776902751499382
SIM,1844,29,na,1873,2978
STAT,1905,16,na,1921,3641.552970046036
STAT,1842,17,50-100,1859,0.015617558675763877
STAT,1863,30,45-49,1893,1.5006890094155678
SIM,1890,24,20-24,1914,17
STAT,1812,100,na,1912,0.08407653170323819
STAT,1867,37,na,1904,2228.118436355633
STAT,1854,64,na,1918,966.5580099790427
STAT,1880,36,20-24,1916,0.8041119004021131
STAT,1805,81,na,1886,85.73496718230406
STAT,1882,24,20-24,1906,65.56449787435761
STAT,1912,28,20-24,1940,17.71695497356536
STAT,1850,53,25-29,1903,0.0016093049862918524
STAT,1901,46,45-49,1947,0.18666398799600725
STAT,1925,30,na,1955,4455.113274698676
SIM,1865,33,25-29,1898,2
SIM,1922,16,20-24,1938,1049
STAT,1813,45,20-24,1858,0.04596240441252048
SIM,1867,71,na,1938,408
STAT,1920,31,40-44,1951,4.248611222810834
SIM,1838,29,25-29,1867,3
STAT,1834,53,40-44,1887,0.004664026652502841
SIM,1916,14,na,1930,4860
STAT,1827,50,30-34,1877,0.005480715214308212
STAT,1852,83,na,1935,399.60231683021107
STAT,1877,9,na,1886,2683.4958484949852
SIM,1829,32,na,1861,2111
STAT,1807,62,na,1869,1055.7809312311144
STAT,1940,22,50-100,1962,0.6627759679285624
STAT,1881,32,20-24,1913,2.552627484743584
STAT,1843,51,25-29,1894,0.0035164117669827565
STAT,1857,33,25-29,1890,7.826611163965697
STAT,1895,40,35-39,1935,2.3794070462519494
SIM,1938,23,na,1961,3172
SIM,1939,25,30-34,1964,379
STAT,1889,25,15-19,1914,0.5500666332545173
STAT,1903,1,na,1904,3863.7199950586296
STAT,1870,32,45-49,1902,1.7384741199189004
STAT,1893,34,50-100,1927,1.1359807513259497
SIM,1823,67,na,1890,708
STAT,1960,3,na,1963,5077.054417829534
STAT,1862,38,25-29,1900,2.4401667946376673
STAT,1932,30,20-24,1962,3.2236005895214173
STAT,1829,97,na,1926,1.9617788868505537
STAT,1902,42,45-49,1944,0.14616960107156984
SIM,1906,31,30-34,1937,16
STAT,1867,23,40-44,1890,1.9646311368181066
SIM,1870,38,25-29,1908,13
SIM,1840,39,na,1879,2544
STAT,1782,101,na,1883,0.42455427733135903
STAT,1835,45,40-44,1880,0.1539357257065069
STAT,1837,24,40-44,1861,2.1559855043066927
STAT,1862,28,na,1890,2025.5446456485158
STAT,1873,18,15-19,1891,6.071591903130554
STAT,1887,18,45-49,1905,0.07171035514068264
STAT,1930,42,20-24,1972,0.023073402502066135
STAT,1876,53,45-49,1929,0.014435161839972946
SIM,1850,49,na,1899,1218
STAT,1859,53,45-49,1912,0.011317748348827806
STAT,1848,24,15-19,1872,3.705128128244557
SIM,1854,39,na,1893,1662
STAT,1884,29,na,1913,2268.224696240196
STAT,1814,41,20-24,1855,0.5884359333614152
STAT,1843,46,45-49,1889,0.2350840877933378
SIM,1917,22,45-49,1939,208
STAT,1788,84,na,1872,43.39789207571446
SIM,1924,43,na,1967,5122
STAT,1886,6,na,1892,2705.226862262863
STAT,1852,49,20-24,1901,0.011826854129727312
STAT,1915,33,25-29,1948,9.241123849173078
STAT,1859,45,50-100,1904,0.1966014307470212
STAT,1904,45,15-19,1949,3.255749257848197E-4
STAT,1947,25,15-19,1972,0.7909420165860612
SIM,1917,41,na,1958,2000
STAT,1913,42,20-24,1955,0.017006046263140024
SIM,1910,29,na,1939,4286
SIM,1800,64,na,1864,216
STAT,1904,30,45-49,1934,2.5114178364921678
STAT,1819,87,na,1906,40.978304991744544
STAT,1899,15,30-34,1914,2.187128868539752
SIM,1923,33,25-29,1956,85
SIM,1865,76,na,1941,1399
STAT,1890,25,25-29,1915,51.557835754184396
STAT,1862,31,40-44,1893,3.7088543908564526
SIM,1793,77,na,1870,591
SIM,1834,39,na,1873,981
STAT,1838,20,40-44,1858,1.17083677784384
STAT,1834,30,na,1864,1249.09107524333
STAT,1899,2,na,1901,3640.937724144188
STAT,1909,22,45-49,1931,1.03510448472661
SIM,1823,47,na,1870,1328
STAT,1879,41,50-100,1920,1.08865415291183
STAT,1918,27,45-49,1945,1.8137633819849857
SIM,1877,16,na,1893,129
STAT,1913,43,30-34,1956,0.12291447280588028
STAT,1892,58,na,1950,2448.451241424867
STAT,1930,35,15-19,1965,0.02491540617135659
STAT,1823,34,25-29,1857,20.8985826931143
STAT,1946,20,50-100,1966,0.7248104641101107
SIM,1831,34,25-29,1865,19
SIM,1908,4,na,1912,2977
STAT,1820,40,35-39,1860,3.100705668225661
STAT,1831,43,15-19,1874,0.013316707213804641
STAT,1890,23,na,1913,2854.297912850528
STAT,1819,44,45-49,1863,0.2843908522192285
SIM,1858,6,na,1864,2651
STAT,1777,92,na,1869,28.212407853844944
STAT,1895,47,20-24,1942,0.008764553112125843
SIM,1898,24,20-24,1922,1
STAT,1907,24,35-39,1931,8.4612282224573
STAT,1805,53,na,1858,455.78930140286724
STAT,1869,31,25-29,1900,10.37786437214715
STAT,1910,42,35-39,1952,0.18817851134417726
SIM,1799,68,na,1867,771
SIM,1924,29,na,1953,3642
SIM,1953,6,na,1959,4654
STAT,1853,23,50-100,1876,0.37091653358756654
SIM,1909,12,na,1921,4275
STAT,1924,24,35-39,1948,10.935031029446712
SIM,1883,7,na,1890,2272
SIM,1858,22,25-29,1880,373
STAT,1828,106,na,1934,0.008219076733564952
STAT,1899,30,25-29,1929,14.102492159906042
STAT,1881,66,na,1947,1547.795567978589
STAT,1840,34,25-29,1874,4.8112913105886905
STAT,1879,21,40-44,1900,2.144107897142114
STAT,1885,43,45-49,1928,1.4604944507896627
STAT,1876,46,40-44,1922,0.17355882560375374
STAT,1923,25,30-34,1948,44.814623610306356
SIM,1829,52,na,1881,1785
STAT,1848,40,20-24,1888,0.1522826656452494
SIM,1882,17,20-24,1899,3
STAT,1883,75,na,1958,1087.8446922407747
STAT,1930,37,na,1967,4872.831878713105
STAT,1837,47,30-34,1884,0.08057091647208753
STAT,1874,17,20-24,1891,18.29702356218374
STAT,1913,35,15-19,1948,0.018890967339117975
STAT,1812,63,na,1875,171.47307694462287
SIM,1874,59,na,1933,2272
STAT,1887,57,na,1944,2211.946960441837
STAT,1860,42,30-34,1902,0.936735644595797
STAT,1872,44,15-19,1916,0.01364194514627081
STAT,1865,9,na,1874,2518.8370999583967
SIM,1814,84,na,1898,16
STAT,1825,81,na,1906,333.00962277114246
STAT,1868,35,50-100,1903,1.1971030315471254
STAT,1818,52,45-49,1870,0.02483352743529811
STAT,1801,91,na,1892,19.224080362493947
STAT,1846,89,na,1935,62.21908953624592
STAT,1861,66,na,1927,1363.0712433842339
STAT,1879,46,25-29,1925,0.05925613734414505
STAT,1898,29,na,1927,3186.2611423226367
STAT,1875,54,40-44,1929,0.010513063073955572
SIM,1887,46,25-29,1933,3
STAT,1909,32,50-100,1941,0.7809553110888835
STAT,1816,45,na,1861,2579.968881002256
STAT,1853,40,30-34,1893,0.9004347031532913
STAT,1922,33,30-34,1955,17.528523422703177
STAT,1923,49,50-100,1972,0.2602726940397916
STAT,1952,18,na,1970,4369.223670505349
STAT,1862,15,35-39,1877,0.5416271071668096
STAT,1813,62,na,1875,1656.6388934561005
STAT,1840,19,na,1859,1156.4832359816196
STAT,1931,26,35-39,1957,19.255601273708702
STAT,1797,67,na,1864,30.485435436389935
STAT,1882,30,15-19,1912,0.13743850892983972
STAT,1919,30,na,1949,4058.570640454362
STAT,1921,38,40-44,1959,1.650022935212853
SIM,1836,30,25-29,1866,6
STAT,1919,41,45-49,1960,0.17821826728372303
STAT,1927,17,na,1944,4539.303841998181
SIM,1917,1,na,1918,2533
STAT,1822,39,35-39,1861,13.28966598317766
STAT,1835,51,35-39,1886,0.006771093281659889
STAT,1854,24,40-44,1878,1.3418760039407645
SIM,1869,58,na,1927,3598
STAT,1820,34,40-44,1854,12.135389822424605
STAT,1827,51,40-44,1878,0.009503040170459425
STAT,1877,49,25-29,1926,0.05725010309194096
STAT,1944,17,45-49,1961,0.5315333498445836
STAT,1815,52,50-100,1867,0.0014779323986366367
STAT,1894,42,40-44,1936,0.1983813107272576
SIM,1932,38,na,1970,6211
STAT,1900,20,30-34,1920,24.822321852601483
STAT,1941,20,20-24,1961,113.68302437092117
STAT,1832,33,20-24,1865,0.18007335169423092
STAT,1850,50,20-24,1900,3.456394986571549E-4
STAT,1836,45,na,1881,1848.7225569642756
STAT,1908,26,50-100,1934,0.9448089182521365
STAT,1856,18,15-19,1874,5.010455899495823
SIM,1844,60,na,1904,1796
SIM,1818,47,50-100,1865,3
STAT,1887,15,40-44,1902,0.20225183821482076
STAT,1907,11,na,1918,3773.7538562084633
STAT,1831,34,50-100,1865,0.9465856156759036
STAT,1874,30,20-24,1904,2.8121607060196214
STAT,1929,27,20-24,1956,22.685183204690674
STAT,1940,25,30-34,1965,39.541666885873866
SIM,1901,46,na,1947,3323
STAT,1926,36,50-100,1962,0.5091820942517504
STAT,1900,22,25-29,1922,79.30151133388514
STAT,1885,4,na,1889,2730.501325966448
SIM,1867,57,na,1924,1697
STAT,1878,74,na,1952,1141.8273175619067
STAT,1859,31,35-39,1890,8.059439679732321
STAT,1864,28,15-19,1892,0.411011897363577
STAT,1937,22,20-24,1959,107.16247576562648
STAT,1927,39,20-24,1966,0.32438418234165334
STAT,1895,21,25-29,1916,74.69406983091805
STAT,1914,19,25-29,1933,8.79214127544617
STAT,1805,51,20-24,1856,8.822119257276411E-4
STAT,1884,44,40-44,1928,2.124105927623479
STAT,1872,42,20-24,1914,0.1588331623149672
STAT,1828,30,25-29,1858,16.539615050859737
SIM,1849,52,na,1901,2017
STAT,1875,27,50-100,1902,0.6568695520589164
STAT,1895,48,30-34,1943,0.07013936205820558
SIM,1827,51,na,1878,1988
STAT,1849,63,na,1912,1503.4402681954336
STAT,1836,44,45-49,1880,1.3297983868789216
STAT,1860,43,40-44,1903,1.8216864071997072
STAT,1913,28,40-44,1941,4.569892055415313
STAT,1857,52,50-100,1909,0.011527571731649056
STAT,1809,97,na,1906,5.229212039033145
STAT,1936,22,na,1958,3456.64472537915
STAT,1852,45,40-44,1897,0.1740458878811379
SIM,1844,44,45-49,1888,2
SIM,1895,21,na,1916,4563
SIM,1869,48,30-34,1917,2
SIM,1859,36,35-39,1895,1
STAT,1837,27,45-49,1864,1.1426640988208119
STAT,1933,30,50-100,1963,1.1079002857476794
SIM,1824,32,25-29,1856,20
STAT,1837,21,na,1858,2260.5289063820715
STAT,1864,18,50-100,1882,0.045803041454094945
STAT,1915,40,na,1955,3696.4963529577467
STAT,1883,23,25-29,1906,54.90257634270779
SIM,1830,49,na,1879,377
STAT,1931,41,25-29,1972,0.09486353385633291
SIM,1921,45,25-29,1966,1
SIM,1874,23,20-24,1897,771
STAT,1947,18,40-44,1965,1.5585051041708249
STAT,1802,103,na,1905,0.07271434862608629
STAT,1878,40,35-39,1918,1.8818898398662287
STAT,1955,17,20-24,1972,178.4055093893387
STAT,1853,41,40-44,1894,1.751954537148608
STAT,1855,18,na,1873,1796.3027945358442
STAT,1918,34,na,1952,3930.8039303243604
STAT,1885,18,40-44,1903,0.17931340872882462
STAT,1923,35,40-44,1958,1.7192645956975354
SIM,1862,20,25-29,1882,304
STAT,1848,27,20-24,1875,13.105649676312439
STAT,1923,31,25-29,1954,10.527143378955351
STAT,1876,52,35-39,1928,0.00865663672215392
STAT,1839,87,na,1926,163.68359312354607
STAT,1836,48,25-29,1884,0.045602945567384146
STAT,1901,43,40-44,1944,0.2168156583924004
STAT,1864,41,50-100,1905,0.964772613710089
SIM,1851,43,40-44,1894,4
STAT,1866,23,20-24,1889,62.962893877611364
STAT,1853,37,na,1890,1826.7980693750735
STAT,1831,26,30-34,1857,31.54389185206093
STAT,1913,45,25-29,1958,0.051365721265074854
SIM,1953,0,na,1953,4746
STAT,1842,28,na,1870,659.3371655242684
STAT,1838,23,45-49,1861,0.38342738972764656
SIM,1907,39,45-49,1946,17
STAT,1899,18,35-39,1917,0.7475002765497264
SIM,1892,78,na,1970,2903
STAT,1895,25,40-44,1920,3.9232841229439632
STAT,1932,33,25-29,1965,12.193711094164659
SIM,1933,34,na,1967,4270
STAT,1838,38,15-19,1876,0.028626243869825013
STAT,1831,36,na,1867,2129.553041897016
STAT,1847,44,20-24,1891,0.14164741954300228
STAT,1907,49,15-19,1956,3.2407940293415264E-4
SIM,1831,42,na,1873,2113
STAT,1951,17,50-100,1968,0.4419892378315085
STAT,1824,88,na,1912,26.567630850417167
STAT,1886,45,50-100,1931,0.2568666761235483
STAT,1831,41,20-24,1872,0.1573094880009194
STAT,1911,48,25-29,1959,0.04951440882366883
STAT,1859,50,40-44,1909,0.008464046036238284
STAT,1867,51,na,1918,2046.0584122987245
STAT,1854,20,25-29,1874,37.94151268617489
SIM,1852,20,35-39,1872,5
STAT,1925,20,35-39,1945,11.234291346121827
STAT,1816,90,na,1906,66.55929268566338
SIM,1865,48,na,1913,1702
STAT,1877,27,na,1904,2422.6083013998987
STAT,1878,41,45-49,1919,1.5468144737159817
STAT,1915,18,50-100,1933,0.07710322264929961
STAT,1850,31,15-19,1881,0.06950789771997641
STAT,1900,29,40-44,1929,4.120052244563861
SIM,1886,40,35-39,1926,1
STAT,1924,40,50-100,1964,0.13878010775739114
STAT,1876,93,na,1969,115.92496302066283
SIM,1897,28,20-24,1925,67
STAT,1888,19,na,1907,2899.3305728938153
STAT,1899,17,25-29,1916,7.739999043209555
STAT,1915,30,20-24,1945,2.4687859914194665
STAT,1915,40,30-34,1955,0.1272456903467573
SIM,1777,81,na,1858,215
STAT,1828,34,40-44,1862,6.147546191725642
STAT,1932,32,na,1964,4992.720887640353
STAT,1844,20,35-39,1864,7.322916236691874
SIM,1850,22,25-29,1872,395
STAT,1911,47,15-19,1958,3.448083420440331E-4
STAT,1849,18,na,1867,2366.726708054484
STAT,1919,23,15-19,1942,5.73378407158604
STAT,1841,49,45-49,1890,0.2573142542014657
STAT,1804,88,na,1892,86.98293710380922
STAT,1858,32,50-100,1890,0.6997040180016213
STAT,1880,23,50-100,1903,0.4220412788871785
STAT,1854,46,20-24,1900,0.0066911560510441006
STAT,1877,26,35-39,1903,9.828436852020506
STAT,1862,34,45-49,1896,1.4725684839698316
STAT,1882,16,50-100,1898,0.04702052759711257
STAT,1930,20,45-49,1950,1.4398400993583136
STAT,1857,27,na,1884,1886.2941701252403
STAT,1868,52,40-44,1920,0.010114218506063349
STAT,1913,9,na,1922,4005.951130539064
STAT,1915,31,30-34,1946,15.883982153923
STAT,1923,40,20-24,1963,0.020480890242267548
STAT,1871,33,50-100,1904,0.9101378553072302
SIM,1945,22,20-24,1967,5
STAT,1827,82,na,1909,329.0299898143037
STAT,1854,47,30-34,1901,0.05357158806119331
STAT,1824,41,15-19,1865,0.0023380838155356493
STAT,1882,51,50-100,1933,0.014528710663278106
STAT,1842,22,25-29,1864,17.92413985068569
SIM,1827,41,40-44,1868,4
STAT,1813,46,30-34,1859,0.36330045594717747
STAT,1885,21,35-39,1906,5.753298824180694
STAT,1869,35,40-44,1904,4.4592100234914955
STAT,1822,44,50-100,1866,1.801382134240666
STAT,1889,28,20-24,1917,14.077578991743255
SIM,1907,31,na,1938,4715
STAT,1814,64,na,1878,1416.2139638805043
SIM,1838,43,na,1881,1868
STAT,1787,100,na,1887,0.10498974834277702
SIM,1933,20,35-39,1953,7
STAT,1941,21,30-34,1962,29.373849632786783
STAT,1901,26,na,1927,3348.324308219229
SIM,1852,58,na,1910,1806
SIM,1893,40,40-44,1933,12
STAT,1844,17,40-44,1861,0.23033631093239132
STAT,1933,39,15-19,1972,0.025923466679467665
STAT,1803,72,na,1875,417.19258744120515
STAT,1836,25,35-39,1861,9.706141134152979
STAT,1870,47,15-19,1917,3.9691381736328473E-4
STAT,1886,32,40-44,1918,4.490887204565202
STAT,1821,37,25-29,1858,3.553130034767344
SIM,1845,40,45-49,1885,14
STAT,1846,35,na,1881,1487.7180731585104
STAT,1819,41,40-44,1860,0.5366625022358305
SIM,1937,27,20-24,1964,29
STAT,1845,50,na,1895,1083.792346654614
SIM,1888,17,20-24,1905,240
STAT,1890,40,15-19,1930,0.016886973564347485
SIM,1894,25,na,1919,1675
STAT,1880,37,30-34,1917,5.532924904173675
STAT,1885,76,na,1961,1117.2628980428087
STAT,1906,24,15-19,1930,4.747316059091852
STAT,1798,94,na,1892,8.483449357357927
STAT,1885,56,na,1941,2004.8569489454617
STAT,1904,23,50-100,1927,0.5808082390002199
STAT,1876,42,25-29,1918,0.648362478867605
STAT,1941,30,30-34,1971,16.372109815901577
STAT,1858,17,35-39,1875,0.48948222803324637
STAT,1888,45,20-24,1933,0.013988043159453147
STAT,1863,17,45-49,1880,0.06363496528774631
STAT,1931,31,15-19,1962,0.16729681418553585
STAT,1829,63,na,1892,651.5734427846203
STAT,1874,84,na,1958,430.4525002183668
STAT,1891,32,15-19,1923,0.1751228106083551
STAT,1879,24,45-49,1903,0.7108620987266924
STAT,1913,46,35-39,1959,0.12457132804439809
SIM,1810,74,na,1884,2853
STAT,1809,51,25-29,1860,0.02985193922485227
STAT,1833,39,50-100,1872,0.6480509740568281
SIM,1849,33,40-44,1882,3
STAT,1843,78,na,1921,771.9916665569817
SIM,1913,36,35-39,1949,2
SIM,1836,34,na,1870,2138
STAT,1844,53,35-39,1897,0.008391958703207279
STAT,1915,41,50-100,1956,0.11677295708624716
SIM,1796,71,na,1867,846
STAT,1905,36,35-39,1941,2.2063487590525463
SIM,1934,19,na,1953,5257
STAT,1777,103,na,1880,0.136958806805747
SIM,1848,18,30-34,1866,2
STAT,1870,57,na,1927,2003.4677265155135
STAT,1882,49,35-39,1931,0.1312388371040818
STAT,1931,40,15-19,1971,0.0020427930479159635
STAT,1912,18,na,1930,3850.04635107153
STAT,1897,19,15-19,1916,7.839125379163454
SIM,1839,43,25-29,1882,2
SIM,1890,49,35-39,1939,1
STAT,1910,18,45-49,1928,0.09761851522019128
STAT,1885,40,40-44,1925,2.2332332695955155
STAT,1882,28,50-100,1910,0.6102922386269007
SIM,1864,60,na,1924,1986
STAT,1879,43,20-24,1922,0.16173986161549836
STAT,1816,54,35-39,1870,0.024209588470567582
STAT,1904,47,50-100,1951,0.19700713687923666
STAT,1845,15,35-39,1860,0.348226677869217
STAT,1865,70,na,1935,1280.9942171771202
STAT,1883,45,35-39,1928,0.13602880967630118
STAT,1875,15,na,1890,2605.473699728897
STAT,1872,45,25-29,1917,0.05825334009897424
STAT,1916,17,35-39,1933,0.8781303903084222
STAT,1827,54,45-49,1881,0.011233200635259712
STAT,1929,42,15-19,1971,0.0019748247758542784
STAT,1931,23,30-34,1954,36.90040900181381
STAT,1865,27,20-24,1892,10.710710247332406
STAT,1859,28,40-44,1887,2.3979024867319136
SIM,1842,15,25-29,1857,5
STAT,1827,31,na,1858,2091.0471007589244
STAT,1905,17,25-29,1922,8.150571902742383
STAT,1894,33,45-49,1927,2.2081883326570244
SIM,1915,15,na,1930,3418
STAT,1851,107,na,1958,0.007358765863280535
STAT,1926,32,na,1958,4533.954054527307
STAT,1830,27,25-29,1857,40.675447218625294
STAT,1942,23,40-44,1965,3.4839836127064236
STAT,1870,40,30-34,1910,1.1577073424186293
STAT,1805,54,25-29,1859,0.003981707131041346
SIM,1909,6,na,1915,4317
STAT,1820,49,50-100,1869,0.37578477962679474
SIM,1891,45,35-39,1936,1
STAT,1874,33,25-29,1907,10.526439091289317
STAT,1859,53,na,1912,1679.1837679022112
SIM,1805,73,na,1878,1568
STAT,1869,60,na,1929,1924.5004561627645
SIM,1895,52,na,1947,4395
STAT,1843,22,40-44,1865,2.5843362974772983
STAT,1880,17,45-49,1897,0.06781484933500097
STAT,1865,42,15-19,1907,0.012592728258777698
STAT,1920,35,20-24,1955,0.2854041419610217
STAT,1858,40,15-19,1898,0.01065248753618522
SIM,1826,30,35-39,1856,25
STAT,1900,23,35-39,1923,8.058826518399433
SIM,1885,45,na,1930,1284
STAT,1894,45,45-49,1939,0.17097555802670716
STAT,1916,25,na,1941,3846.4755669103974
STAT,1854,27,45-49,1881,0.6471821363666628
STAT,1907,21,30-34,1928,26.06831206298474
STAT,1895,15,na,1910,3300.7563790726535
SIM,1881,52,na,1933,2701
SIM,1815,80,na,1895,339
STAT,1896,62,na,1958,2479.9893473146626
STAT,1918,37,na,1955,3911.9610839832235
STAT,1825,29,40-44,1854,7.037156864560572
STAT,1874,18,30-34,1892,1.6406694318190673
STAT,1811,44,40-44,1855,11.049813083128015
STAT,1853,44,45-49,1897,1.1448136064207028
SIM,1915,21,30-34,1936,22
SIM,1894,39,25-29,1933,20
STAT,1860,46,45-49,1906,0.19307357162323016
STAT,1939,16,25-29,1955,42.91273946661164
STAT,1826,100,na,1926,0.8463817377266973
STAT,1928,44,na,1972,4682.9439452545
STAT,1827,42,45-49,1869,1.4204057746531236
SIM,1845,20,25-29,1865,128
STAT,1949,21,35-39,1970,10.882443609822305
SIM,1900,61,na,1961,3838
STAT,1890,22,20-24,1912,83.42596595254753
STAT,1938,17,20-24,1955,132.30524590180192
STAT,1893,46,40-44,1939,0.1211076673143561
STAT,1839,37,20-24,1876,0.8558315829765988
STAT,1901,71,na,1972,2293.412276053202
STAT,1924,46,45-49,1970,0.2568966895865483
STAT,1904,35,50-100,1939,0.38219645363758814
SIM,1841,32,25-29,1873,1
STAT,1874,30,na,1904,2482.6283136637517
STAT,1903,38,25-29,1941,0.8777789293055247
SIM,1893,40,na,1933,3156
STAT,1886,39,25-29,1925,2.951544920970908
STAT,1866,26,25-29,1892,38.74604008613869
SIM,1963,2,na,1965,5558
STAT,1823,31,20-24,1854,11.757874798516577
STAT,1917,43,35-39,1960,0.20701050155320336
SIM,1902,42,na,1944,3332
STAT,1859,16,40-44,1875,0.1692740488349036
STAT,1936,29,20-24,1965,17.278838773088655
SIM,1878,18,na,1896,4356
STAT,1804,103,na,1907,0.09093117384364606
STAT,1839,16,20-24,1855,21.67409150519774
STAT,1833,53,25-29,1886,0.0015338517181386097
SIM,1887,23,na,1910,3814
STAT,1922,44,20-24,1966,0.01997772833784008
STAT,1925,29,45-49,1954,2.0073894604290046
STAT,1898,40,na,1938,3150.1651998911852
STAT,1828,37,45-49,1865,2.679303075223506
SIM,1855,38,na,1893,2998
STAT,1835,49,20-24,1884,0.009328296258325442
STAT,1837,20,25-29,1857,60.96043980414792
SIM,1858,41,35-39,1899,3
SIM,1872,27,na,1899,2419
STAT,1871,46,20-24,1917,0.012004510541398367
SIM,1908,33,na,1941,2645
STAT,1843,43,40-44,1886,2.2590680171247963
STAT,1943,22,45-49,1965,1.1834403072672517
STAT,1823,43,20-24,1866,0.2603670194648969
SIM,1854,53,na,1907,984
SIM,1807,51,na,1858,1094
STAT,1869,63,na,1932,1800.5090901655058
STAT,1912,12,na,1924,3947.131037476722
STAT,1927,17,45-49,1944,0.6160600219750582
SIM,1870,15,na,1885,2638
STAT,1913,0,na,1913,4533.519804285501
SIM,1929,39,30-34,1968,2
STAT,1867,82,na,1949,441.26103127165055
SIM,1815,49,45-49,1864,2
STAT,1933,28,50-100,1961,1.312020989355898
STAT,1902,28,50-100,1930,0.8976187295353824
STAT,1822,32,15-19,1854,0.39864696728664445
STAT,1895,28,45-49,1923,1.4392786174580796
STAT,1910,31,na,1941,3620.6416936745477
STAT,1921,18,20-24,1939,152.3058735356371
STAT,1904,18,20-24,1922,25.262319594745495
STAT,1911,41,40-44,1952,0.23740055408895722
STAT,1858,36,45-49,1894,1.52968180372038
SIM,1913,45,30-34,1958,1
STAT,1861,97,na,1958,6.95795314216871
STAT,1851,19,40-44,1870,0.1735685724158743
STAT,1873,34,20-24,1907,2.7490034663990612
SIM,1871,51,45-49,1922,1
STAT,1857,30,20-24,1887,2.130824241678034
STAT,1878,28,45-49,1906,1.1383356249186591
STAT,1884,23,40-44,1907,1.9886088344501378
SIM,1805,70,na,1875,1785
STAT,1880,44,50-100,1924,1.081956026556126
STAT,1915,18,30-34,1933,2.508425353512456
STAT,1899,41,15-19,1940,0.001315770106952076
STAT,1936,4,na,1940,3825.8797009637765
STAT,1921,33,15-19,1954,0.14071401906361208
STAT,1863,51,45-49,1914,0.012448705001051184
SIM,1869,38,na,1907,3598
STAT,1915,34,35-39,1949,9.097045594281317
STAT,1926,22,45-49,1948,1.35523120836375
SIM,1853,38,25-29,1891,16
STAT,1939,29,50-100,1968,0.9886500757130248
STAT,1849,21,50-100,1870,0.41842810724279994
STAT,1919,22,35-39,1941,10.173642972959946
SIM,1836,31,na,1867,2212
STAT,1831,44,25-29,1875,0.610984776470968
STAT,1806,53,30-34,1859,0.01540240445455824
STAT,1813,49,35-39,1862,0.4945639721307263
SIM,1849,38,na,1887,2296
STAT,1848,106,na,1954,0.011361884419857925
STAT,1821,33,45-49,1854,2.4327742323266524
SIM,1913,33,30-34,1946,140
STAT,1852,51,35-39,1903,0.008707237491555508
SIM,1807,54,na,1861,1092
STAT,1932,18,30-34,1950,15.985521597143292
SIM,1928,28,25-29,1956,706
STAT,1814,98,na,1912,2.1985624801049872
SIM,1854,50,na,1904,1152
STAT,1821,46,na,1867,1329.1226026614959
STAT,1901,3,na,1904,3696.379818391154
STAT,1863,75,na,1938,878.8644327664542
STAT,1905,45,30-34,1950,0.07931997248240233
SIM,1847,71,na,1918,1382
STAT,1898,15,15-19,1913,8.017367684986672
STAT,1860,49,15-19,1909,3.195033513728786E-4
STAT,1898,43,na,1941,3096.1676601991176
SIM,1904,20,na,1924,4172
STAT,1895,44,50-100,1939,0.0941466579691084
STAT,1914,44,na,1958,3616.8228136916723
STAT,1916,33,40-44,1949,3.9682996243643043
SIM,1930,29,na,1959,5249
SIM,1931,22,na,1953,5009
STAT,1913,34,50-100,1947,0.8053237787729417
SIM,1865,30,20-24,1895,15
STAT,1859,70,na,1929,1112.066257203026
STAT,1872,20,45-49,1892,0.7024359208687493
SIM,1931,4,na,1935,5411
STAT,1899,28,na,1927,3248.19998389193
STAT,1841,45,30-34,1886,0.1110921669890479
STAT,1941,24,35-39,1965,9.613447442976694
STAT,1906,43,25-29,1949,0.06410695163809786
STAT,1817,53,40-44,1870,0.006981003936973083
STAT,1848,16,na,1864,2678.561266805382
STAT,1905,33,30-34,1938,14.358844904729215
STAT,1858,103,na,1961,0.31331066773031857
STAT,1868,43,45-49,1911,1.4351187218431722
STAT,1912,43,15-19,1955,0.001455130386159464
STAT,1830,45,20-24,1875,0.010521339747432459
STAT,1930,24,25-29,1954,116.76495340169045
STAT,1873,44,30-34,1917,1.163387827322833
STAT,1874,54,25-29,1928,0.003555066491346923
SIM,1876,43,45-49,1919,36
STAT,1917,32,45-49,1949,1.625783539466264
SIM,1896,37,na,1933,3637
STAT,1951,19,45-49,1970,0.5889242060599413
STAT,1812,83,na,1895,31.439217867030155
STAT,1842,44,35-39,1886,0.4533162547854815
STAT,1860,27,50-100,1887,0.5274475632721558
STAT,1869,38,45-49,1907,2.0016138263466954
SIM,1890,15,na,1905,3965
SIM,1830,40,na,1870,517
STAT,1931,35,30-34,1966,2.400946313326223
STAT,1902,2,na,1904,3753.6768439898838
STAT,1853,68,na,1921,1184.9471058285387
STAT,1832,43,30-34,1875,0.10214428604390902
SIM,1812,46,50-100,1858,1
STAT,1841,97,na,1938,5.982341110646731
STAT,1882,46,30-34,1928,0.09294044131508812
STAT,1899,37,45-49,1936,0.587700723817916
STAT,1914,35,30-34,1949,1.8114644782212854
STAT,1926,37,15-19,1963,0.02326780387226305
STAT,1956,15,15-19,1971,59.55973431025859
STAT,1906,28,30-34,1934,36.33683102458818
STAT,1921,45,15-19,1966,4.1227780533275465E-4
SIM,1831,25,na,1856,2212
STAT,1877,45,45-49,1922,0.24195679629270242
SIM,1838,46,na,1884,1872
SIM,1834,53,na,1887,727
STAT,1870,43,35-39,1913,1.7922194563250908
SIM,1818,46,na,1864,874
STAT,1902,32,35-39,1934,14.260533621071243
STAT,1854,30,na,1884,1387.26811010543
SIM,1939,28,na,1967,4686
STAT,1858,23,na,1881,1872.2066399174098
SIM,1889,58,na,1947,3162
STAT,1844,23,na,1867,2625.74582824452
STAT,1898,31,20-24,1929,3.6497027792289476
STAT,1900,41,30-34,1941,0.11109512084084772
SIM,1841,32,na,1873,974
STAT,1803,52,35-39,1855,0.018806665813028086
STAT,1924,29,50-100,1953,1.1395842860073722
SIM,1859,8,na,1867,2404
STAT,1811,50,35-39,1861,0.0403114813933613
STAT,1911,26,15-19,1937,0.6830365382126024
SIM,1894,59,na,1953,1169
STAT,1946,18,25-29,1964,47.53031541861974
STAT,1855,45,25-29,1900,0.03850183824475785
STAT,1850,57,na,1907,927.9705451333781
STAT,1863,78,na,1941,667.0333372471268
SIM,1852,42,45-49,1894,25
STAT,1936,27,30-34,1963,37.12627344682076
STAT,1887,19,20-24,1906,19.40867326398607
STAT,1896,43,20-24,1939,0.014432806411223027
STAT,1898,19,30-34,1917,2.1318089153943416
SIM,1878,66,na,1944,1640
STAT,1816,76,na,1892,799.8232319561025
STAT,1849,60,na,1909,1606.974104023889
STAT,1901,22,40-44,1923,2.9136131653311366
STAT,1908,29,45-49,1937,1.6089423116555306
STAT,1847,54,30-34,1901,0.005233804953056863
STAT,1866,45,35-39,1911,0.12906867777833472
STAT,1936,25,na,1961,3552.64190868629
STAT,1838,23,na,1861,1174.4582550093585
STAT,1876,31,35-39,1907,10.279369405530668
SIM,1865,45,na,1910,1705
STAT,1785,90,na,1875,13.366563708534052
STAT,1791,76,na,1867,479.35907401752337
STAT,1839,19,25-29,1858,6.806186896001208
STAT,1894,48,15-19,1942,2.833230217414055E-4
STAT,1824,30,50-100,1854,0.4669707462097374
STAT,1868,40,40-44,1908,2.1944313952762386
SIM,1874,45,35-39,1919,1
SIM,1946,21,na,1967,3761
STAT,1806,69,na,1875,625.3684644057829
STAT,1837,43,15-19,1880,0.012899986387963398
STAT,1913,46,50-100,1959,0.2185337005343255
STAT,1843,25,45-49,1868,1.369688386358806
STAT,1844,50,30-34,1894,0.0059818688379647865
STAT,1920,38,25-29,1958,1.0630946070438958
STAT,1882,42,15-19,1924,0.01320539449975768
STAT,1858,54,40-44,1912,0.007818506649675932
STAT,1891,17,20-24,1908,21.801284743571816
SIM,1948,15,30-34,1963,956
STAT,1894,30,40-44,1924,5.5591514877081964
SIM,1867,26,na,1893,2068
STAT,1851,52,30-34,1903,0.004676252060453041
STAT,1881,48,50-100,1929,0.22901757957663368
STAT,1893,42,25-29,1935,0.8020465665552353
STAT,1848,43,25-29,1891,0.5965733414300572
STAT,1875,16,25-29,1891,5.833184010901591
STAT,1931,38,35-39,1969,3.1775907726426027
STAT,1934,19,45-49,1953,0.6675058164294464
STAT,1884,30,15-19,1914,0.13741871849104667
SIM,1832,26,20-24,1858,47
STAT,1870,71,na,1941,1330.7069569800908
SIM,1839,28,30-34,1867,1
STAT,1864,44,20-24,1908,0.1424290735331157
SIM,1881,44,30-34,1925,22
STAT,1826,51,25-29,1877,0.00499153537663751
STAT,1865,56,na,1921,1862.167638774079
STAT,1844,24,50-100,1868,0.49719477119670424
SIM,1846,72,na,1918,319
SIM,1919,16,15-19,1935,309
STAT,1868,18,40-44,1886,0.1787999531390419
STAT,1917,40,30-34,1957,0.13200235426938758
STAT,1851,51,50-100,1902,0.011985110533041281
STAT,1828,45,50-100,1873,0.30109440567887386
STAT,1846,30,45-49,1876,1.2461211329866075
STAT,1878,44,15-19,1922,0.014016720585267014
SIM,1836,65,na,1901,1264
STAT,1924,4,na,1928,4760.259477740098
SIM,1887,26,na,1913,3785
SIM,1881,6,na,1887,3275
STAT,1923,47,40-44,1970,0.1824975645612538
SIM,1878,42,50-100,1920,13
STAT,1890,77,na,1967,1421.2634008370385
SIM,1921,21,20-24,1942,3
SIM,1910,20,na,1930,3753
SIM,1884,31,35-39,1915,3
STAT,1933,33,40-44,1966,5.23467338467195
STAT,1861,39,20-24,1900,0.634618953060474
STAT,1845,38,25-29,1883,1.4856223045575057
STAT,1881,35,25-29,1916,2.7447857459070013
SIM,1852,27,na,1879,2384
SIM,1878,63,na,1941,2163
STAT,1852,41,25-29,1893,0.6493122683972834
SIM,1906,34,35-39,1940,40
STAT,1878,21,25-29,1899,59.07606743221319
SIM,1873,27,20-24,1900,32
STAT,1833,50,20-24,1883,3.39118012603291E-4
STAT,1923,43,25-29,1966,0.08245431315321877
STAT,1847,82,na,1929,421.84508673829083
STAT,1855,42,20-24,1897,0.10497885122061733
STAT,1913,21,20-24,1934,106.71779872990025
SIM,1920,6,na,1926,4900
STAT,1842,40,50-100,1882,0.27837707232265546
SIM,1925,40,30-34,1965,2
STAT,1835,49,na,1884,1748.9317067880622
SIM,1918,33,15-19,1951,1
STAT,1901,47,20-24,1948,0.009420393986275942
STAT,1921,30,45-49,1951,1.7442942177399812
SIM,1817,40,35-39,1857,12
STAT,1814,44,25-29,1858,2.184988038671578
STAT,1911,44,45-49,1955,0.15512924492617627
STAT,1852,38,na,1890,2359.7355460685694
STAT,1885,22,na,1907,2324.7230120265167
SIM,1908,7,na,1915,2908
STAT,1822,50,45-49,1872,0.024333447504630415
SIM,1794,79,na,1873,275
STAT,1849,26,25-29,1875,42.556793021719415
STAT,1903,35,20-24,1938,0.2384226654590871
STAT,1844,42,45-49,1886,1.5185371023042118
STAT,1939,32,30-34,1971,15.898585281488831
STAT,1832,83,na,1915,336.99210099516483
STAT,1905,48,35-39,1953,0.1121593402047578
SIM,1852,72,na,1924,1423
STAT,1890,34,20-24,1924,3.2443260696399223
STAT,1821,91,na,1912,29.26463953327742
STAT,1876,11,na,1887,2637.994061284481
SIM,1870,5,na,1875,2834
STAT,1825,50,na,1875,1528.5594822662313
STAT,1789,100,na,1889,0.38720112517996685
SIM,1868,23,30-34,1891,32
STAT,1888,29,15-19,1917,0.5199043998922326
STAT,1867,52,25-29,1919,0.003331955429869632
STAT,1928,32,20-24,1960,3.02671978248816
STAT,1861,20,35-39,1881,5.058086033133177
SIM,1914,19,na,1933,5124
STAT,1819,48,25-29,1867,0.010493538208018044
STAT,1800,54,40-44,1854,0.06137873432358597
SIM,1928,33,na,1961,4608
SIM,1890,12,na,1902,4012
STAT,1833,32,25-29,1865,5.796605501706885
STAT,1878,25,40-44,1903,3.102953125026153
STAT,1936,23,15-19,1959,5.037049141517156
STAT,1824,49,45-49,1873,0.040049512290903734
STAT,1825,41,30-34,1866,1.5539050414755973
SIM,1845,79,na,1924,320
STAT,1883,20,20-24,1903,66.69236029136464
STAT,1850,16,20-24,1866,10.062866896745712
STAT,1900,44,35-39,1944,0.1718436600418148
STAT,1836,42,na,1878,1914.162905474288
STAT,1940,31,25-29,1971,9.463912500014786
SIM,1866,40,15-19,1906,2
STAT,1874,37,40-44,1911,4.5178740567261775
STAT,1897,28,50-100,1925,0.846554320038896
STAT,1921,16,30-34,1937,13.76262598508595
SIM,1918,26,na,1944,4443
STAT,1869,50,35-39,1919,0.008812085031380156
STAT,1940,21,15-19,1961,5.363626960165175
STAT,1834,64,na,1898,766.1037069981886
SIM,1954,8,na,1962,5556
STAT,1836,41,40-44,1877,2.076841240548842
STAT,1914,45,40-44,1959,0.15491460466010068
SIM,1913,34,na,1947,3218
STAT,1803,58,na,1861,761.7284255661906
SIM,1929,18,na,1947,6272
STAT,1888,29,50-100,1917,0.733032897589976
STAT,1907,46,45-49,1953,0.19479179013171954
STAT,1840,21,50-100,1861,0.2056731679121353
STAT,1863,33,15-19,1896,0.12106213489204704
STAT,1858,50,25-29,1908,0.002743779465580857
STAT,1932,40,30-34,1972,0.17254449952023668
SIM,1870,12,na,1882,2672
STAT,1905,30,na,1935,3459.8693486436114
STAT,1908,20,35-39,1928,8.640623987190578
STAT,1851,31,30-34,1882,14.502263779690399
SIM,1815,46,40-44,1861,1
SIM,1829,83,na,1912,1137
SIM,1903,27,na,1930,2772
STAT,1858,33,40-44,1891,3.297819788385054
STAT,1812,46,15-19,1858,1.0531340993045254E-4
STAT,1858,20,50-100,1878,0.36249145655576304
STAT,1846,18,20-24,1864,13.112325039846942
SIM,1841,35,na,1876,820
STAT,1890,47,50-100,1937,0.1669342412042746
STAT,1768,87,na,1855,144.0554
STAT,1878,77,na,1955,889.3464838401956
STAT,1848,39,50-100,1887,1.1596200359230262
SIM,1898,18,na,1916,4177
STAT,1836,90,na,1926,60.339601585691796
STAT,1871,45,50-100,1916,0.24743922696203727
STAT,1840,31,20-24,1871,1.3098921031848756
STAT,1861,12,na,1873,2281.9062554214133
STAT,1841,41,15-19,1882,0.016185861423993097
SIM,1790,80,na,1870,1197
STAT,1889,69,na,1958,1851.8828901962922
STAT,1857,18,30-34,1875,1.4290663299056365
STAT,1855,49,na,1904,1457.9369394439518
STAT,1906,40,20-24,1946,0.016130910389247882
STAT,1922,36,35-39,1958,2.7240016589260305
STAT,1892,32,30-34,1924,21.616768398996033
STAT,1924,21,30-34,1945,33.689884470608455
STAT,1838,54,20-24,1892,3.063411200890086E-4
STAT,1890,47,35-39,1937,0.09515795537281002
SIM,1843,30,35-39,1873,1
STAT,1799,93,na,1892,1.9434512230647791
STAT,1884,40,25-29,1924,0.6209219417601132
SIM,1922,48,na,1970,3202
SIM,1801,66,na,1867,1783
SIM,1941,0,na,1941,4031
STAT,1806,109,na,1915,2.1423363235361208E-4
STAT,1810,51,na,1861,86.22459200168404
STAT,1853,47,15-19,1900,3.087092585664143E-4
STAT,1889,44,25-29,1933,0.7628634444252625
SIM,1885,11,na,1896,1861
STAT,1847,28,15-19,1875,0.48949962967152666
STAT,1886,33,50-100,1919,0.9448141613490043
SIM,1932,21,30-34,1953,38
STAT,1932,18,na,1950,4827.287039124209
STAT,1931,33,na,1964,4917.851440611355
STAT,1930,28,40-44,1958,5.882282583694235
STAT,1862,34,50-100,1896,0.7737224190045929
STAT,1921,26,na,1947,4139.757632417623
STAT,1887,31,45-49,1918,1.9272221271687655
STAT,1818,57,na,1875,1431.5417556480656
STAT,1914,31,15-19,1945,0.128075289963348
STAT,1886,16,35-39,1902,0.5696113558874552
STAT,1919,49,40-44,1968,0.1677467541248799
STAT,1850,39,45-49,1889,0.9158733763514271
STAT,1899,34,40-44,1933,5.872665616271703
SIM,1843,13,na,1856,761
STAT,1863,37,30-34,1900,4.5499260835782485
SIM,1903,26,30-34,1929,29
STAT,1874,51,20-24,1925,7.652257664115975E-4
STAT,1829,52,20-24,1881,3.0013666177098415E-4
SIM,1887,77,na,1964,1759
STAT,1901,0,na,1901,4105.630289488095
STAT,1826,35,na,1861,2307.1878318603917
STAT,1860,50,50-100,1910,0.012497758479361173
STAT,1835,30,35-39,1865,9.959907270565742
SIM,1911,56,na,1967,2132
STAT,1912,47,30-34,1959,0.08467790920318055
SIM,1918,0,na,1918,4571
SIM,1875,31,50-100,1906,122
STAT,1823,72,na,1895,997.6579089493786
SIM,1883,19,na,1902,2234
STAT,1947,17,na,1964,4102.563530161629
STAT,1869,15,50-100,1884,0.05071708227140544
STAT,1820,38,20-24,1858,1.3656674667098259
STAT,1851,16,50-100,1867,0.047322849830695804
STAT,1838,17,50-100,1855,0.027624634277049746
STAT,1887,66,na,1953,1804.0145227334058
SIM,1865,32,20-24,1897,24
STAT,1906,18,30-34,1924,2.301989681184299
STAT,1846,68,na,1914,905.0915985233505
STAT,1860,52,50-100,1912,0.0122551153358342
STAT,1898,20,15-19,1918,4.462722227913039
SIM,1903,40,40-44,1943,1
STAT,1842,38,45-49,1880,0.5745254576278988
SIM,1876,30,30-34,1906,1
STAT,1827,48,20-24,1875,0.01084569444965478
STAT,1824,47,40-44,1871,0.029713080433523886
STAT,1850,73,na,1923,548.4586384712256
STAT,1891,71,na,1962,1841.4574956272731
STAT,1845,48,50-100,1893,0.12033958574070261
STAT,1849,23,50-100,1872,0.4124410505959493
STAT,1838,27,15-19,1865,0.24636602725570445
STAT,1951,19,20-24,1970,159.83406166136746
STAT,1902,30,30-34,1932,24.78370957874295
STAT,1822,35,50-100,1857,2.7051664345943878
STAT,1824,41,na,1865,541.2527270926456
STAT,1857,5,na,1862,2267.9083390998812
STAT,1948,23,30-34,1971,32.65219847820532
STAT,1900,22,20-24,1922,95.46347328589941
STAT,1887,40,50-100,1927,1.174541422969021
SIM,1827,58,na,1885,1562
STAT,1821,47,50-100,1868,0.26267072305994466
SIM,1874,36,na,1910,2510
STAT,1803,95,na,1898,3.353820210109294
STAT,1930,34,25-29,1964,11.8289330736404
STAT,1911,49,na,1960,3418.647852655656
STAT,1857,32,20-24,1889,2.0870287907558884
STAT,1828,55,na,1883,1471.7991997662764
STAT,1920,21,35-39,1941,10.364461859623125
STAT,1878,28,50-100,1906,0.6558430940230243
STAT,1915,43,50-100,1958,0.11642056843767867
STAT,1847,25,15-19,1872,0.5001966925551661
STAT,1926,45,15-19,1971,4.52749418612105E-4
STAT,1836,23,50-100,1859,0.4094359570209441
STAT,1846,32,45-49,1878,1.220509242594472
STAT,1854,31,40-44,1885,2.49508180058611
STAT,1923,44,35-39,1967,0.23210539980184552
STAT,1889,35,20-24,1924,0.9370914581808513
STAT,1898,28,25-29,1926,56.683201385260574
SIM,1840,24,na,1864,2831
STAT,1844,24,35-39,1868,7.114856343078426
STAT,1861,21,30-34,1882,15.32850249688909
STAT,1830,45,15-19,1875,3.507110164170558E-4
STAT,1940,19,45-49,1959,0.5011769727694113
STAT,1873,54,25-29,1927,0.0035334106158742902
STAT,1914,24,15-19,1938,5.329238290526542
STAT,1941,26,25-29,1967,67.345283747851
STAT,1862,46,50-100,1908,0.20978151767839384
STAT,1891,38,40-44,1929,5.356440676693573
SIM,1962,0,na,1962,4683
STAT,1837,34,45-49,1871,1.717074884517395
STAT,1918,39,30-34,1957,1.891087548556079
SIM,1886,21,na,1907,3138
STAT,1876,34,50-100,1910,0.9183098919542021
STAT,1832,60,na,1892,1618.9560187084953
SIM,1897,35,20-24,1932,5
STAT,1967,0,na,1967,4897.569020564195
STAT,1832,53,50-100,1885,0.001184885882581862
STAT,1822,39,30-34,1861,10.014010317921425
STAT,1919,13,na,1932,4313.786820843785
STAT,1831,37,30-34,1868,5.412954749214827
STAT,1900,44,40-44,1944,0.2134530877936464
SIM,1917,42,35-39,1959,1
STAT,1829,72,na,1901,461.1706677341171
SIM,1824,77,na,1901,1465
STAT,1922,28,40-44,1950,5.197060330488203
STAT,1879,16,20-24,1895,18.2313005689694
SIM,1932,31,20-24,1963,2
STAT,1850,37,40-44,1887,2.0533723673622384
SIM,1903,66,na,1969,1652
STAT,1837,91,na,1928,46.46450727561658
STAT,1833,45,40-44,1878,0.08821123545002153
STAT,1807,107,na,1914,0.0019120978220547552
STAT,1843,49,50-100,1892,0.23759715210190518
STAT,1909,42,35-39,1951,0.18642854312434642
SIM,1849,69,na,1918,283
STAT,1883,39,45-49,1922,1.89851831238423
STAT,1782,84,na,1866,326.17126906220915
STAT,1907,28,na,1935,3469.9113397037377
STAT,1903,14,na,1917,3654.0327484347977
SIM,1795,63,na,1858,12
STAT,1917,19,45-49,1936,0.525812265318024
STAT,1863,24,45-49,1887,0.5984881813301383
STAT,1879,28,15-19,1907,0.4637878424433448
STAT,1816,48,45-49,1864,0.7075698757493816
STAT,1853,22,na,1875,1958.8551551946168
SIM,1920,30,na,1950,3909
STAT,1808,94,na,1902,4.680814038374791
STAT,1882,19,na,1901,2405.0737611970367
STAT,1918,48,50-100,1966,0.23678402348686883
STAT,1858,53,na,1911,1617.896339433156
SIM,1879,83,na,1962,63
STAT,1851,50,30-34,1901,0.004768838745178486
STAT,1929,23,20-24,1952,139.19782468413155
STAT,1935,15,45-49,1950,0.6811391771772881
STAT,1833,23,20-24,1856,55.06894522701907
STAT,1875,40,15-19,1915,0.014323742164634813
STAT,1889,34,50-100,1923,1.0939192374488516
STAT,1900,31,35-39,1931,14.086207790250107
SIM,1865,27,25-29,1892,386
SIM,1866,33,na,1899,3152
SIM,1924,44,na,1968,5123
STAT,1894,39,20-24,1933,0.9703907222081805
STAT,1946,15,20-24,1961,148.8264967773208
SIM,1836,19,na,1855,2355
STAT,1849,17,na,1866,2380.7493215584636
STAT,1847,52,50-100,1899,0.013581961187849458
STAT,1928,19,20-24,1947,168.6208214996606
STAT,1873,15,15-19,1888,6.1598910785834144
STAT,1835,31,30-34,1866,16.994143057722283
STAT,1908,61,na,1969,3036.9623617807624
SIM,1841,23,20-24,1864,386
STAT,1811,98,na,1909,1.9680665157919075
SIM,1899,30,25-29,1929,21
STAT,1915,36,25-29,1951,0.9853234853432287
STAT,1913,42,25-29,1955,0.06876357748977274
STAT,1859,35,35-39,1894,5.65918568533928
STAT,1879,31,na,1910,2457.9769216353784
STAT,1910,41,45-49,1951,0.15642613038308753
SIM,1929,29,30-34,1958,53
SIM,1874,68,na,1942,1948
STAT,1779,80,na,1859,382.8738933218177
STAT,1858,25,50-100,1883,0.5073450590648616
STAT,1847,19,50-100,1866,0.054634434469420456
STAT,1914,29,45-49,1943,1.7051125895762376
STAT,1776,104,na,1880,0.06252840313862938
STAT,1869,42,40-44,1911,2.266909123837921
STAT,1856,103,na,1959,0.21337972708418004
SIM,1856,39,na,1895,713
STAT,1861,57,na,1918,1671.2954666801131
STAT,1872,38,30-34,1910,5.310353195456375
SIM,1852,25,na,1877,2390
SIM,1925,41,30-34,1966,1
STAT,1839,39,na,1878,2329.055906693635
STAT,1885,22,30-34,1907,17.50857229026601
SIM,1837,20,na,1857,1915
SIM,1778,83,na,1861,124
STAT,1938,29,30-34,1967,38.3647166950751
STAT,1887,33,45-49,1920,1.911278556545459
STAT,1912,18,30-34,1930,2.429702385386377
STAT,1781,112,na,1893,2.060269992768221E-4
STAT,1830,49,50-100,1879,0.20457940233526228
SIM,1920,14,na,1934,4767
STAT,1918,23,45-49,1941,1.1934616221964516
STAT,1900,65,na,1965,2577.7809109443424
STAT,1904,33,45-49,1937,1.4245202333372018
SIM,1924,28,na,1952,5277
STAT,1866,88,na,1954,125.31503045645555
SIM,1845,55,na,1900,2062
STAT,1920,4,na,1924,4470.137293883207
SIM,1827,42,na,1869,1954
STAT,1904,19,35-39,1923,0.7797344203111352
STAT,1865,48,40-44,1913,0.15434010466366482
STAT,1860,43,35-39,1903,1.4665763934239964
STAT,1917,41,30-34,1958,0.1318267911382093
STAT,1857,49,45-49,1906,0.17731612247707612
STAT,1858,69,na,1927,1120.7104911685888
STAT,1839,28,50-100,1867,0.7433296412865966
STAT,1862,74,na,1936,945.2524566363945
STAT,1894,20,30-34,1914,22.78629152435267
STAT,1907,34,25-29,1941,8.507921404041209
STAT,1909,25,45-49,1934,1.6593159850025259
SIM,1813,47,30-34,1860,1
STAT,1820,36,50-100,1856,2.4095640676891996
SIM,1894,72,na,1966,812
STAT,1835,25,na,1860,2164.17835177816
STAT,1917,47,15-19,1964,3.7962900901977774E-4
STAT,1839,19,30-34,1858,1.9143626571590462
STAT,1887,50,na,1937,2404.05677969655
STAT,1878,14,na,1892,2648.462251779068
SIM,1828,42,45-49,1870,1
STAT,1851,3,na,1854,2713.0
STAT,1881,17,15-19,1898,5.604279763148994
STAT,1844,61,na,1905,1851.2365089065595
STAT,1878,32,40-44,1910,4.461914174037555
STAT,1848,75,na,1923,963.3444154537364
STAT,1919,45,na,1964,3950.3172065594977
SIM,1861,61,na,1922,1689
STAT,1895,32,40-44,1927,5.641515141094059
SIM,1869,89,na,1958,1586
SIM,1936,13,na,1949,3982
STAT,1878,73,na,1951,1222.0421652916511
STAT,1871,46,15-19,1917,4.001499993943721E-4
STAT,1913,31,45-49,1944,1.5522665290640516
STAT,1876,32,30-34,1908,17.650168557648215
SIM,1884,32,30-34,1916,7
STAT,1859,23,40-44,1882,1.7012992561805602
STAT,1938,16,25-29,1954,42.39376926958726
STAT,1923,19,45-49,1942,0.57729679581507
SIM,1946,16,25-29,1962,8
STAT,1924,34,25-29,1958,10.665807360308227
SIM,1857,56,na,1913,1397
STAT,1848,34,20-24,1882,2.6291399136911844
STAT,1853,38,20-24,1891,0.5947428857822954
STAT,1901,32,50-100,1933,1.2811084477433767
STAT,1919,16,15-19,1935,9.952763177000751
STAT,1924,45,50-100,1969,0.26793886887833623
STAT,1904,37,50-100,1941,0.3786008356252857
SIM,1815,47,40-44,1862,1
SIM,1869,43,45-49,1912,30
STAT,1895,31,50-100,1926,1.196789556963959
STAT,1874,38,40-44,1912,4.495465401404815
STAT,1833,107,na,1940,0.0019403188086124844
STAT,1831,42,50-100,1873,1.0324873280219695
STAT,1898,36,50-100,1934,1.6589125041506623
STAT,1865,52,25-29,1917,0.0032166108133086587
STAT,1828,41,40-44,1869,2.8601630849291086
STAT,1933,24,25-29,1957,121.60911323970748
SIM,1909,39,30-34,1948,13
SIM,1886,53,na,1939,2887
STAT,1899,51,na,1950,2955.093596919214
STAT,1858,19,40-44,1877,0.16124437885366316
STAT,1892,15,25-29,1907,7.048538619033058
STAT,1904,44,25-29,1948,0.06284945434074353
SIM,1833,24,25-29,1857,2
STAT,1864,17,15-19,1881,5.581149179533028
STAT,1833,41,50-100,1874,0.5574221904881678
STAT,1952,15,na,1967,4372.939621525265
STAT,1836,46,50-100,1882,0.19949264875208225
STAT,1922,46,50-100,1968,0.2575778868684199
STAT,1930,31,45-49,1961,2.017668266179466
SIM,1873,52,25-29,1925,1
STAT,1841,37,na,1878,2810.0457358257277
STAT,1815,80,na,1895,43.61450024451611
STAT,1894,36,na,1930,3010.4183846122787
SIM,1877,17,na,1894,1
SIM,1865,75,na,1940,1399
STAT,1803,79,na,1882,214.8767752028461
STAT,1807,47,40-44,1854,0.6022254759098186
STAT,1824,51,25-29,1875,6.091656223916574E-4
STAT,1883,36,na,1919,2277.4608417937925
STAT,1921,27,na,1948,4125.599661314756
STAT,1841,47,40-44,1888,0.19150658915111368
STAT,1887,25,45-49,1912,1.2303718759627713
STAT,1915,42,35-39,1957,0.19986673172772942
STAT,1855,27,15-19,1882,0.3129885773460631
STAT,1839,44,20-24,1883,0.15157485785142746
SIM,1878,49,30-34,1927,2
STAT,1868,33,35-39,1901,9.740160266890827
STAT,1825,38,45-49,1863,2.799343110593966
STAT,1844,48,20-24,1892,0.011738890695597953
STAT,1939,16,50-100,1955,0.37100343635973093
STAT,1888,18,15-19,1906,6.83149755184165
STAT,1865,23,na,1888,2169.8239811202598
STAT,1926,16,50-100,1942,0.45652669567582743
STAT,1854,34,45-49,1888,0.972516936458799
STAT,1890,54,na,1944,2535.0290351673343
STAT,1791,77,na,1868,436.0106329541187
SIM,1804,57,na,1861,875
STAT,1892,29,45-49,1921,1.3648344975006257
STAT,1847,85,na,1932,247.84958661064087
STAT,1877,39,20-24,1916,0.7746288320965244
STAT,1849,16,35-39,1865,0.5724730454754392
SIM,1903,43,45-49,1946,7
SIM,1939,23,30-34,1962,1
STAT,1853,105,na,1958,0.04189292408742649
STAT,1904,41,45-49,1945,0.14915588687262596
SIM,1844,54,na,1898,1986
STAT,1937,26,na,1963,3615.5944757299394
STAT,1842,35,40-44,1877,1.301520911835261
STAT,1883,22,20-24,1905,66.29679585116703
STAT,1902,33,35-39,1935,14.200354169190316
STAT,1880,49,20-24,1929,0.012197743414725121
STAT,1875,19,40-44,1894,0.18680720204966467
SIM,1918,32,na,1950,4197
SIM,1879,67,na,1946,798
SIM,1902,23,35-39,1925,33
STAT,1912,40,40-44,1952,0.24113772968929445
STAT,1931,18,40-44,1949,1.8131499597280774
STAT,1894,15,35-39,1909,0.7010126106684841
STAT,1919,29,20-24,1948,19.322182465541903
SIM,1875,53,na,1928,2579
STAT,1895,21,na,1916,3085.915246942843
STAT,1899,35,na,1934,3248.5134391767365
SIM,1921,34,25-29,1955,30
STAT,1933,12,na,1945,5268.072554301513
STAT,1779,102,na,1881,0.13397394259992615
STAT,1840,95,na,1935,5.235179305335717
STAT,1920,24,15-19,1944,5.805226166072843
STAT,1882,31,50-100,1913,0.880807780346627
SIM,1865,16,na,1881,1859
STAT,1894,38,50-100,1932,1.5535256698437014
SIM,1927,29,20-24,1956,4
SIM,1910,52,na,1962,3794
STAT,1910,18,20-24,1928,26.49367035765401
STAT,1913,34,25-29,1947,9.002622489814126
STAT,1930,31,20-24,1961,3.1275412557847964
SIM,1837,36,na,1873,2025
STAT,1883,36,40-44,1919,4.231616236032913
STAT,1836,38,20-24,1874,0.7175423113104
STAT,1812,50,50-100,1862,0.0038683261783238813
STAT,1917,16,40-44,1933,0.29770326828761545
STAT,1842,54,na,1896,519.8132452428167
STAT,1856,54,50-100,1910,0.010549301574587616
SIM,1913,36,40-44,1949,3
STAT,1848,37,25-29,1885,2.7765079674916655
SIM,1910,33,35-39,1943,212
SIM,1819,41,40-44,1860,10
SIM,1906,15,na,1921,3602
STAT,1922,32,25-29,1954,10.326546862340495
STAT,1908,45,na,1953,3345.2284374828573
STAT,1905,28,40-44,1933,4.293414872385733
STAT,1923,41,30-34,1964,0.14806664248488852
STAT,1799,57,na,1856,207.6115432536
STAT,1852,80,na,1932,622.6715583329838
SIM,1885,20,30-34,1905,535
STAT,1840,44,50-100,1884,0.42295313486192004
STAT,1854,46,15-19,1900,2.2303833884268116E-4
STAT,1856,19,30-34,1875,1.3377549959673891
SIM,1885,39,20-24,1924,1
SIM,1930,32,25-29,1962,1
STAT,1905,36,40-44,1941,1.3655316179811428
STAT,1825,50,50-100,1875,0.019274301558570038
STAT,1869,53,na,1922,2137.8371190991365
STAT,1833,37,40-44,1870,2.3690464524992683
STAT,1928,42,45-49,1970,0.21055426220796553
STAT,1881,28,30-34,1909,23.69676349429306
SIM,1870,22,na,1892,2492
SIM,1907,39,20-24,1946,6
STAT,1881,20,50-100,1901,0.38739366328109315
SIM,1891,36,40-44,1927,60
STAT,1792,78,na,1870,399.7974301108158
STAT,1864,22,na,1886,2184.6553054603514
STAT,1846,24,45-49,1870,0.5022890491465075
SIM,1851,9,na,1860,1504
STAT,1891,42,25-29,1933,0.7887067414156611
STAT,1913,39,50-100,1952,0.405021732974898
SIM,1874,39,45-49,1913,4
STAT,1907,22,30-34,1929,25.98984644367515
SIM,1840,56,na,1896,2500
STAT,1803,63,na,1866,654.6630568877387
STAT,1874,24,20-24,1898,70.67703936791445
STAT,1896,28,15-19,1924,0.5959784227743247
STAT,1816,45,40-44,1861,0.535937647675809
STAT,1924,17,50-100,1941,0.44186671924119925
SIM,1935,12,na,1947,5854
STAT,1856,9,na,1865,2069.138578467804
STAT,1911,39,20-24,1950,0.2492104908289789
STAT,1853,21,50-100,1874,0.37630081406748844
STAT,1921,33,45-49,1954,1.7230829108335306
STAT,1921,19,35-39,1940,4.70099871731464
STAT,1827,44,50-100,1871,0.9759812647825632
STAT,1829,37,15-19,1866,0.02848069408933846
SIM,1816,42,na,1858,128
STAT,1866,39,45-49,1905,1.8013775824436886
STAT,1850,89,na,1939,48.509688557277315
STAT,1888,26,15-19,1914,0.5254440216036326
STAT,1917,44,35-39,1961,0.20664823317548525
SIM,1841,26,25-29,1867,2
SIM,1878,30,40-44,1908,141
STAT,1863,1,na,1864,3092.500595833962
STAT,1850,49,35-39,1899,0.06329686004653969
STAT,1835,41,na,1876,1930.64439123248
STAT,1918,20,40-44,1938,3.598825828719129
STAT,1829,48,30-34,1877,0.04419631446891385
STAT,1887,34,na,1921,2604.06113388129
STAT,1868,16,45-49,1884,0.06461604594756508
STAT,1898,66,na,1964,2421.1787191846083
SIM,1811,43,na,1854,220
SIM,1899,28,na,1927,2101
SIM,1906,33,20-24,1939,6
STAT,1896,42,50-100,1938,0.09658907089592289
STAT,1822,47,30-34,1869,0.16186915687810355
STAT,1904,16,30-34,1920,2.2827475265872783
SIM,1815,57,na,1872,1279
SIM,1961,4,na,1965,4649
STAT,1903,37,20-24,1940,0.23617963881060122
SIM,1881,22,na,1903,2828
STAT,1889,49,40-44,1938,0.11386516794361616
STAT,1932,33,20-24,1965,3.2179625746353504
SIM,1923,27,na,1950,4291
STAT,1900,39,45-49,1939,0.5900568534137366
SIM,1915,51,na,1966,2848
SIM,1885,36,na,1921,1666
STAT,1883,20,na,1903,2288.8545286038143
STAT,1857,46,40-44,1903,0.13174526580753027
SIM,1852,41,na,1893,2059
STAT,1925,18,40-44,1943,1.6697968252830175
STAT,1952,20,40-44,1972,4.008503334251662
SIM,1801,65,na,1866,1783
STAT,1839,55,na,1894,1921.042572686998
STAT,1935,35,15-19,1970,0.026705349089822365
STAT,1885,49,20-24,1934,0.011549113957026038
SIM,1859,15,30-34,1874,53
SIM,1960,11,na,1971,6452
STAT,1880,44,15-19,1924,0.014143217066908133
SIM,1866,92,na,1958,231
STAT,1896,39,30-34,1935,6.954892458030401
STAT,1926,22,40-44,1948,4.049842827352668
STAT,1833,26,25-29,1859,26.84301882290714
STAT,1851,28,45-49,1879,1.019366798214724
STAT,1869,45,45-49,1914,0.24051751120353826
SIM,1933,29,20-24,1962,6
STAT,1893,19,na,1912,3141.403190648985
STAT,1906,41,50-100,1947,0.10671436527745684
SIM,1869,35,45-49,1904,28
STAT,1852,49,45-49,1901,0.23259478905759917
STAT,1945,19,20-24,1964,146.36592363513483
SIM,1892,49,na,1941,3500
SIM,1796,80,na,1876,580
SIM,1924,15,35-39,1939,458
STAT,1871,48,50-100,1919,0.24191832262174698
STAT,1837,104,na,1941,0.05348233484434505
STAT,1849,33,na,1882,2096.8748148654895
SIM,1895,14,na,1909,4648
STAT,1840,16,15-19,1856,3.0433891188971964
STAT,1853,22,35-39,1875,5.346200695386661
SIM,1848,27,25-29,1875,3
STAT,1904,30,40-44,1934,6.245652347101261
STAT,1898,33,20-24,1931,3.6195094282942533
STAT,1913,38,40-44,1951,1.451546801830099
STAT,1823,46,50-100,1869,0.38871474183379556
STAT,1857,68,na,1925,1172.6798441154015
STAT,1891,28,50-100,1919,0.7838791192985021
STAT,1868,30,30-34,1898,16.999386101846614
STAT,1924,31,20-24,1955,2.82001363419255
STAT,1928,20,50-100,1948,0.8201585764689642
STAT,1853,54,na,1907,1623.6305921150029
SIM,1947,13,na,1960,4369
STAT,1850,41,25-29,1891,0.2978651960616887
STAT,1852,37,na,1889,2384.366047337566
STAT,1817,49,50-100,1866,0.1675574718801355
STAT,1916,15,35-39,1931,0.8822103121684851
STAT,1873,42,na,1915,2367.9037817052713
STAT,1946,23,20-24,1969,122.36081436346372
STAT,1828,44,45-49,1872,1.8100781111425066
SIM,1902,17,na,1919,3591
STAT,1904,41,20-24,1945,0.015827383869138158
STAT,1925,29,20-24,1954,21.210056254866295
STAT,1833,48,45-49,1881,0.10646089524676308
STAT,1902,43,50-100,1945,0.10255947038737823
STAT,1879,15,na,1894,2602.904945222986
STAT,1806,53,50-100,1859,0.03907882773003619
STAT,1914,38,35-39,1952,2.3695796313337465
STAT,1906,43,20-24,1949,0.015854407596936324
STAT,1878,40,40-44,1918,2.3375619275636503
SIM,1925,45,na,1970,4696
STAT,1911,47,20-24,1958,0.010344259360475977
STAT,1880,32,50-100,1912,0.9512044002085493
STAT,1889,30,15-19,1919,0.17286935133132186
STAT,1921,35,50-100,1956,0.46404643945550894
STAT,1902,36,15-19,1938,0.017149711697665722
STAT,1929,35,15-19,1964,0.02452351470815581
SIM,1845,71,na,1916,906
STAT,1832,53,25-29,1885,2.77888543791704E-4
SIM,1846,56,na,1902,833
SIM,1912,30,40-44,1942,4
SIM,1931,14,na,1945,5184
SIM,1860,76,na,1936,1638
STAT,1841,69,na,1910,1634.2049866736108
STAT,1820,75,na,1895,707.9735210511475
SIM,1935,28,na,1963,5727
STAT,1893,27,50-100,1920,0.7999531272532457
STAT,1933,28,40-44,1961,6.143957287053961
SIM,1887,16,20-24,1903,111
SIM,1895,25,45-49,1920,21
STAT,1849,92,na,1941,35.09345785142412
STAT,1909,45,15-19,1954,3.3826902423828687E-4
STAT,1840,27,30-34,1867,12.363166931300233
STAT,1869,69,na,1938,1480.871443607727
STAT,1935,32,35-39,1967,12.551901660856059
STAT,1821,92,na,1913,21.033667018147806
STAT,1914,16,15-19,1930,9.280058908858301
STAT,1931,26,40-44,1957,5.9780093097287015
STAT,1922,26,15-19,1948,0.7926283957688653
STAT,1894,23,35-39,1917,7.397807968281918
STAT,1889,38,25-29,1927,3.4500039467283385
STAT,1871,35,na,1906,2372.510053864235
STAT,1860,51,35-39,1911,0.007056806424694451
SIM,1840,40,na,1880,2565
STAT,1872,22,45-49,1894,0.6982696464919058
STAT,1950,21,20-24,1971,130.69907466065382
SIM,1860,41,35-39,1901,15
STAT,1864,17,50-100,1881,0.04607441978663826
STAT,1827,32,35-39,1859,10.425386700984339
STAT,1875,49,na,1924,2262.0176623219636
STAT,1895,35,45-49,1930,2.617900610226473
STAT,1796,76,na,1872,675.5161220741538
STAT,1866,25,25-29,1891,38.87549548610744
STAT,1923,16,40-44,1939,1.629138138663986
SIM,1928,25,20-24,1953,3
STAT,1848,48,40-44,1896,0.15819162704926756
STAT,1792,62,na,1854,1150.0
STAT,1842,21,20-24,1863,21.733194850120285
STAT,1923,34,na,1957,4284.606799091599
SIM,1850,21,20-24,1871,240
SIM,1894,56,na,1950,1169
STAT,1831,49,25-29,1880,0.05293645723518939
SIM,1897,21,na,1918,2952
SIM,1890,42,na,1932,3513
STAT,1867,32,50-100,1899,0.8665209645569582
STAT,1943,27,na,1970,3944.1436335621884
STAT,1804,104,na,1908,0.04226117235557296
STAT,1814,49,25-29,1863,0.19165230965962154
STAT,1891,39,na,1930,2868.053697508744
STAT,1902,29,na,1931,3336.58869825501
SIM,1824,34,25-29,1858,33
SIM,1805,74,na,1879,1167
STAT,1870,38,20-24,1908,0.7646731110097936
STAT,1875,29,45-49,1904,1.131968599273545
STAT,1890,18,30-34,1908,1.9244945125132684
SIM,1818,38,na,1856,939
STAT,1914,15,25-29,1929,8.880615767896307
STAT,1883,25,25-29,1908,40.97188773897304
STAT,1944,22,35-39,1966,10.052051833953856
SIM,1828,31,40-44,1859,1
STAT,1913,31,20-24,1944,2.4061327082347397
STAT,1839,47,25-29,1886,0.054524055943647266
STAT,1847,69,na,1916,1326.8308590935667
STAT,1880,87,na,1967,415.9430550152226
STAT,1917,19,20-24,1936,142.70547750008834
STAT,1931,22,25-29,1953,118.9591459488098
STAT,1872,57,na,1929,2012.3632803666267
STAT,1869,50,40-44,1919,0.010775921099237225
STAT,1926,31,30-34,1957,18.898348419337513
STAT,1937,32,45-49,1969,1.5407266067876102
SIM,1904,46,40-44,1950,1
STAT,1863,48,30-34,1911,0.08160098398603005
SIM,1836,41,50-100,1877,1
SIM,1882,27,25-29,1909,52
SIM,1937,30,na,1967,2780
STAT,1867,52,35-39,1919,0.00809850286265538
STAT,1921,41,45-49,1962,0.1854982738579694
STAT,1838,92,na,1930,17.762318966736927
SIM,1932,32,35-39,1964,129
STAT,1878,46,na,1924,2321.3640740145593
STAT,1768,109,na,1877,0.008413945134942832
STAT,1902,31,45-49,1933,2.4656164660646906
SIM,1815,51,25-29,1866,1
SIM,1904,51,na,1955,3954
STAT,1865,44,25-29,1909,0.5783699077462006
STAT,1882,41,20-24,1923,0.1527372127742094
SIM,1891,25,25-29,1916,425
STAT,1920,29,20-24,1949,19.625342567023395
SIM,1940,1,na,1941,4541
STAT,1839,15,15-19,1854,7.298297272308923
STAT,1866,16,35-39,1882,0.5171504164867062
STAT,1874,42,25-29,1916,0.6619328173120873
STAT,1781,99,na,1880,0.38532186217932773
STAT,1838,22,45-49,1860,0.3862003079386461
STAT,1876,35,35-39,1911,7.217978234936774
SIM,1853,10,na,1863,3646
STAT,1838,17,na,1855,1293.0560996879742
STAT,1919,27,30-34,1946,41.774191870007435
STAT,1808,47,50-100,1855,0.4488924580529942
SIM,1882,42,25-29,1924,5
STAT,1913,36,15-19,1949,0.018803313250664457
STAT,1919,41,40-44,1960,0.2678412945936191
STAT,1807,51,25-29,1858,0.011535402814497137
SIM,1857,24,na,1881,1470
SIM,1927,27,30-34,1954,1
STAT,1907,38,40-44,1945,1.371783179649115
STAT,1883,28,40-44,1911,2.87171771373707
SIM,1873,44,25-29,1917,2
SIM,1882,49,45-49,1931,1
SIM,1898,5,na,1903,4492
STAT,1822,48,20-24,1870,0.019789980920647692
STAT,1846,37,15-19,1883,0.03473085022095274
STAT,1846,109,na,1955,4.213697740804663E-4
STAT,1906,41,30-34,1947,0.11613033893912766
STAT,1891,24,20-24,1915,84.21316477272099
STAT,1851,17,50-100,1868,0.04704411824519302
STAT,1924,32,35-39,1956,10.55911210891069
STAT,1822,93,na,1915,16.852832295893585
STAT,1929,27,15-19,1956,0.8773275342876566
SIM,1876,16,na,1892,3981
SIM,1827,74,na,1901,974
SIM,1934,31,30-34,1965,3
STAT,1819,38,20-24,1857,0.188815798496046
STAT,1918,48,20-24,1966,0.011569252419956088
STAT,1901,50,na,1951,3053.938930543284
STAT,1836,105,na,1941,0.02244019385107972
STAT,1930,20,40-44,1950,4.302679913902867
STAT,1866,17,25-29,1883,5.309352081486593
SIM,1857,6,na,1863,1543
STAT,1879,23,45-49,1902,0.7131298516549552
STAT,1914,14,na,1928,4015.421717167619
STAT,1833,41,25-29,1874,0.3388252551716473
STAT,1886,29,20-24,1915,12.061677916126385
STAT,1937,28,25-29,1965,63.46730156725926
STAT,1830,26,na,1856,2092.9321546394135
STAT,1872,6,na,1878,2754.2525882365076
STAT,1874,27,25-29,1901,43.6578798673645
STAT,1879,36,15-19,1915,0.057882845692021206
STAT,1905,64,na,1969,2807.410100645045
STAT,1918,28,na,1946,3919.1176662732364
STAT,1824,33,20-24,1857,1.1468088871182847
STAT,1896,20,40-44,1916,2.763326256275933
STAT,1768,96,na,1864,4.019138627755883
STAT,1874,49,45-49,1923,0.23848218904141774
SIM,1830,41,na,1871,465
SIM,1865,35,25-29,1900,19
STAT,1879,90,na,1969,249.99358040386952
STAT,1890,15,15-19,1905,7.2177901162388
STAT,1797,98,na,1895,0.03247389845148596
STAT,1851,74,na,1925,876.502773814178
STAT,1856,51,20-24,1907,5.325491339894219E-4
STAT,1940,28,35-39,1968,15.13070410626135
STAT,1793,84,na,1877,98.65913631326546
STAT,1910,40,30-34,1950,0.12082700566535433
STAT,1855,88,na,1943,90.85928705443398
STAT,1829,40,na,1869,977.1918197387092
SIM,1856,55,na,1911,258
STAT,1848,91,na,1939,54.2260923814239
STAT,1907,25,35-39,1932,14.174235892156785
STAT,1951,19,50-100,1970,0.44169315454495595
SIM,1894,29,20-24,1923,9
SIM,1913,28,na,1941,3391
STAT,1855,15,20-24,1870,14.121557490656649
STAT,1913,23,45-49,1936,1.1184798292786777
SIM,1834,55,na,1889,727
STAT,1905,32,25-29,1937,8.459199969217869
SIM,1859,30,30-34,1889,23
STAT,1811,48,45-49,1859,1.0915860830890718
STAT,1899,40,25-29,1939,0.06152229372541031
STAT,1851,95,na,1946,10.500717447428482
STAT,1855,38,30-34,1893,3.5098135043692475
STAT,1914,18,40-44,1932,0.2845634901064217
STAT,1926,30,40-44,1956,4.696632744010569
STAT,1891,46,40-44,1937,0.1190933764085624
STAT,1905,21,45-49,1926,1.0059999988611488
SIM,1777,82,na,1859,215
STAT,1826,51,35-39,1877,0.012132204162864858
STAT,1872,36,na,1908,2370.5352034614903
STAT,1862,28,20-24,1890,9.95698594406438
STAT,1938,27,40-44,1965,4.568274071741475
STAT,1950,22,35-39,1972,11.063888617527093
SIM,1870,28,20-24,1898,3
STAT,1955,17,15-19,1972,59.72048838974938
SIM,1853,28,20-24,1881,17
STAT,1845,28,20-24,1873,7.03474166296691
STAT,1817,55,na,1872,801.5442879715677
SIM,1937,26,25-29,1963,10
STAT,1805,59,na,1864,404.78263717129016
STAT,1926,25,45-49,1951,2.0671784304578544
STAT,1946,26,25-29,1972,72.5599513391242
STAT,1813,41,na,1854,2388.322688700094
STAT,1836,51,40-44,1887,0.008325681803618642
STAT,1841,40,20-24,1881,0.1885374784228004
STAT,1835,34,35-39,1869,9.554696964710852
SIM,1845,43,50-100,1888,16
STAT,1930,31,na,1961,4849.422244551153
STAT,1922,49,na,1971,4148.94860503476
STAT,1892,40,15-19,1932,0.017270388464966285
STAT,1811,53,40-44,1864,0.04642299499514668
STAT,1850,23,20-24,1873,37.91918247141619
STAT,1928,42,20-24,1970,0.02234255183031764
STAT,1866,22,20-24,1888,63.41823681796435
SIM,1851,40,na,1891,1161
STAT,1937,3,na,1940,3905.0929911911435
STAT,1842,24,25-29,1866,17.667673234857087
STAT,1900,40,25-29,1940,0.06239693794170164
SIM,1919,19,20-24,1938,2
STAT,1846,21,40-44,1867,1.5337936402161476
SIM,1895,7,na,1902,4648
SIM,1916,39,50-100,1955,6
STAT,1929,26,25-29,1955,81.83535690358111
SIM,1794,78,na,1872,275
STAT,1823,56,na,1879,1759.7922575508385
STAT,1841,48,30-34,1889,0.10690333637947615
STAT,1936,16,15-19,1952,43.124200773160545
SIM,1848,23,30-34,1871,5
STAT,1861,4,na,1865,2547.8075555190335
SIM,1890,49,30-34,1939,2
SIM,1906,47,na,1953,3320
STAT,1862,23,50-100,1885,0.35300679568781496
STAT,1841,96,na,1937,9.56180150347116
STAT,1911,20,30-34,1931,27.111837821408223
STAT,1865,28,50-100,1893,0.5819776394874613
STAT,1871,94,na,1965,63.328031624384394
STAT,1777,78,na,1855,754.9431000000003
STAT,1858,54,35-39,1912,0.0063936386301336615
SIM,1790,64,na,1854,1351
SIM,1855,17,15-19,1872,69
SIM,1907,23,35-39,1930,178
STAT,1850,45,40-44,1895,0.07984172645529938
STAT,1906,46,25-29,1952,0.04718315460288208
STAT,1949,11,na,1960,4524.188370515813
STAT,1955,12,na,1967,5169.1005169816635
SIM,1917,31,30-34,1948,19
SIM,1824,37,40-44,1861,6
STAT,1901,27,45-49,1928,1.552442688191426
SIM,1866,54,35-39,1920,1
STAT,1866,21,50-100,1887,0.3779920677811016
SIM,1836,62,na,1898,1299
STAT,1847,17,15-19,1864,6.696707391493476
STAT,1945,17,30-34,1962,13.167732271802619
STAT,1922,39,45-49,1961,0.7654220093125093
SIM,1850,24,25-29,1874,14
STAT,1929,29,40-44,1958,5.786808081834289
STAT,1882,49,30-34,1931,0.09074228161370006
STAT,1819,53,50-100,1872,0.002609114877400394
STAT,1837,31,40-44,1868,4.405313814073977
STAT,1832,92,na,1924,35.35512156891067
STAT,1833,77,na,1910,355.6430839091268
STAT,1950,22,50-100,1972,0.7731579254005139
STAT,1906,19,45-49,1925,0.09408437470614775
STAT,1848,52,25-29,1900,0.003296880608254228
STAT,1861,24,35-39,1885,4.914374865624757
SIM,1955,8,na,1963,3825
SIM,1911,21,na,1932,2168
STAT,1884,21,na,1905,2270.83095020412
STAT,1863,49,20-24,1912,0.010030649590343802
STAT,1949,19,40-44,1968,1.6096297656887115
STAT,1888,35,na,1923,2745.007745085563
STAT,1905,34,15-19,1939,0.11660522822493483
STAT,1808,78,na,1886,201.66515303713925
SIM,1950,12,na,1962,4854
SIM,1917,7,na,1924,2494
STAT,1893,42,35-39,1935,2.2616850691500243
SIM,1908,35,45-49,1943,3
STAT,1955,16,25-29,1971,57.04131405640353
SIM,1888,17,na,1905,381
STAT,1878,8,na,1886,2733.2067516641137
STAT,1872,27,15-19,1899,0.4543193907896377
STAT,1932,34,35-39,1966,12.048086330750932
SIM,1857,40,na,1897,1408
STAT,1857,84,na,1941,255.2729006206085
STAT,1892,72,na,1964,1820.9435617574288
STAT,1804,64,na,1868,1614.610436924607
STAT,1902,41,35-39,1943,0.17787262603648132
STAT,1922,21,45-49,1943,1.2797738100707388
SIM,1868,40,na,1908,1154
STAT,1847,16,25-29,1863,6.43237613855509
STAT,1887,22,40-44,1909,2.293592518656347
STAT,1883,16,35-39,1899,0.5291783845808563
STAT,1882,48,40-44,1930,0.16184911858134646
STAT,1822,43,15-19,1865,0.02407677925248391
SIM,1875,0,na,1875,3302
STAT,1903,21,35-39,1924,8.308538099382321
STAT,1864,28,30-34,1892,22.812436526964305
SIM,1930,17,25-29,1947,648
STAT,1922,28,na,1950,4176.95520435092
SIM,1928,9,na,1937,4638
STAT,1911,38,30-34,1949,1.7319029046035792
STAT,1820,47,20-24,1867,0.018856180484244946
SIM,1888,4,na,1892,781
STAT,1919,44,45-49,1963,0.1773695128049302
STAT,1894,20,na,1914,3025.47891325539
STAT,1838,50,50-100,1888,0.006671854963365402
STAT,1869,32,na,1901,2407.983249694865
STAT,1927,26,15-19,1953,0.8541663129004423
STAT,1898,34,na,1932,3181.439119030561
STAT,1920,15,50-100,1935,0.08363513781195421
SIM,1934,27,na,1961,4597
STAT,1857,102,na,1959,0.45219609897370794
STAT,1844,21,30-34,1865,22.192058237710405
SIM,1864,69,na,1933,1174
STAT,1900,47,45-49,1947,0.18355450849418248
SIM,1845,20,50-100,1865,41
SIM,1841,41,na,1882,477
SIM,1848,32,20-24,1880,12
SIM,1849,21,na,1870,1684
STAT,1861,39,45-49,1900,1.6411834627676332
STAT,1849,39,45-49,1888,1.6834464786183359
STAT,1909,46,50-100,1955,0.20623101202772615
STAT,1821,40,40-44,1861,2.6295472020789163
SIM,1853,1,na,1854,3646
SIM,1896,17,25-29,1913,35
STAT,1884,25,50-100,1909,0.6165143168150238
STAT,1906,44,35-39,1950,0.17963221367556773
STAT,1922,17,25-29,1939,49.592932037602004
STAT,1898,39,40-44,1937,1.2577621272639494
SIM,1932,3,na,1935,6551
STAT,1864,25,15-19,1889,0.4168723805154271
STAT,1947,19,30-34,1966,13.576504783125442
STAT,1917,40,40-44,1957,0.25825685860904163
STAT,1854,39,na,1893,1296.7807425089763
STAT,1865,37,25-29,1902,2.6286813065055896
SIM,1878,26,20-24,1904,39
STAT,1814,63,na,1877,1470.016570355517
STAT,1906,16,40-44,1922,0.26550717793216155
STAT,1779,96,na,1875,2.4289914195245164
SIM,1930,13,na,1943,5600
STAT,1802,78,na,1880,456.8701774708752
STAT,1900,25,25-29,1925,58.99710024332147
SIM,1939,20,15-19,1959,40
SIM,1860,44,na,1904,1991
SIM,1882,24,20-24,1906,42
STAT,1859,91,na,1950,45.92901179839642
SIM,1876,54,na,1930,3199
STAT,1937,22,50-100,1959,0.6341350797272968
STAT,1909,46,na,1955,3349.7693743027335
STAT,1950,20,30-34,1970,33.794848949825145
STAT,1886,49,na,1935,2281.177915545491
STAT,1882,35,na,1917,2277.0587678791444
STAT,1847,41,15-19,1888,0.012717226921384373
STAT,1811,93,na,1904,17.705645525172546
STAT,1923,28,35-39,1951,16.995834296492493
STAT,1952,15,45-49,1967,0.5934815938971324
STAT,1857,35,25-29,1892,2.2303676389949008
STAT,1937,25,20-24,1962,17.625167395172294
SIM,1917,10,na,1927,2454
STAT,1927,29,30-34,1956,47.0564246770366
STAT,1885,16,45-49,1901,0.0643664120856638
STAT,1888,17,25-29,1905,6.540332283787472
STAT,1838,38,30-34,1876,2.716890463209874
STAT,1852,41,35-39,1893,1.8309907727146086
STAT,1912,50,na,1962,3458.2149057488477
SIM,1946,12,na,1958,3798
STAT,1852,54,40-44,1906,0.010305594249682503
STAT,1797,77,na,1874,14.039939060766633
STAT,1913,20,40-44,1933,3.2364665123706566
STAT,1916,38,45-49,1954,0.6851806191506755
STAT,1831,29,30-34,1860,27.776125575695744
STAT,1792,99,na,1891,0.4584604319548131
STAT,1865,34,20-24,1899,2.4467395851183453
STAT,1793,63,na,1856,770.3558348000001
STAT,1856,54,25-29,1910,0.0024741032834266602
SIM,1797,59,na,1856,1587
STAT,1830,96,na,1926,6.214785096116977
STAT,1877,72,na,1949,1281.9903154976646
STAT,1891,27,25-29,1918,52.01927335636375
STAT,1908,29,20-24,1937,17.00006780635151
STAT,1843,92,na,1935,41.1514841047934
STAT,1861,48,20-24,1909,0.009854320386102145
STAT,1865,41,20-24,1906,0.14565094708106016
SIM,1904,27,25-29,1931,1
STAT,1875,54,35-39,1929,0.008597131038247585
STAT,1869,31,50-100,1900,0.9283451528959066
STAT,1855,15,50-100,1870,0.03902419303058788
STAT,1820,49,25-29,1869,0.0881319346653298
STAT,1860,18,45-49,1878,0.06109797615717641
SIM,1850,18,na,1868,2299
STAT,1896,23,45-49,1919,0.9163888427595565
SIM,1859,33,35-39,1892,20
STAT,1891,49,45-49,1940,0.16028792828366048
STAT,1827,92,na,1919,29.370814921362772
STAT,1941,23,20-24,1964,113.56710707277394
STAT,1829,32,45-49,1861,0.9614449118340154
STAT,1953,16,15-19,1969,54.422832595201626
STAT,1880,48,30-34,1928,0.0992306486320566
STAT,1842,27,40-44,1869,0.9196123762169109
STAT,1863,21,40-44,1884,1.8275480379842923
STAT,1898,36,25-29,1934,3.8903395248918713
SIM,1883,72,na,1955,1622
STAT,1867,31,15-19,1898,0.13522960285874608
STAT,1910,29,50-100,1939,0.9436128342930268
STAT,1877,52,40-44,1929,0.010629939733046921
STAT,1931,24,15-19,1955,6.812614458280244
STAT,1941,31,na,1972,3927.995200320493
STAT,1931,28,30-34,1959,50.20679531610722
STAT,1897,49,na,1946,2926.064151594368
SIM,1837,32,45-49,1869,17
STAT,1905,37,30-34,1942,1.6545613030130697
SIM,1832,36,25-29,1868,2
STAT,1849,17,25-29,1866,5.877324775717599
STAT,1813,78,na,1891,572.3465565852557
STAT,1824,36,25-29,1860,0.44973298953492585
STAT,1926,34,35-39,1960,10.94102215964653
STAT,1789,95,na,1884,4.503404168560534
STAT,1893,35,na,1928,2974.195550306357
STAT,1868,68,na,1936,1476.0414753170946
STAT,1885,25,35-39,1910,9.54875336854884
STAT,1911,34,15-19,1945,0.1226642934458753
STAT,1932,31,30-34,1963,20.81057235260592
STAT,1862,41,40-44,1903,1.9244690515459049
STAT,1934,26,50-100,1960,1.3305230254842535
SIM,1923,33,20-24,1956,3
STAT,1926,39,50-100,1965,0.5076357430955157
STAT,1930,38,40-44,1968,1.9369519542934213
STAT,1917,42,45-49,1959,0.1713652325544054
SIM,1932,30,30-34,1962,2
STAT,1899,15,35-39,1914,0.752945990344851
STAT,1953,19,30-34,1972,14.60270768444499
STAT,1932,36,25-29,1968,1.3149139140992265
STAT,1879,39,50-100,1918,1.246791464843176
STAT,1932,27,na,1959,4872.543291477935
STAT,1942,28,45-49,1970,1.791651085434866
SIM,1858,41,40-44,1899,1
STAT,1861,73,na,1934,987.7861328095897
STAT,1907,31,20-24,1938,2.2739138503825704
STAT,1863,30,50-100,1893,0.7884976102492816
STAT,1865,87,na,1952,160.85148193115563
STAT,1833,49,35-39,1882,0.0623468373919352
STAT,1890,41,50-100,1931,1.284735271130465
STAT,1862,58,na,1920,1684.4009044618656
SIM,1963,1,na,1964,5558
STAT,1888,42,15-19,1930,0.015919180782719713
STAT,1850,26,25-29,1876,23.15287964692558
SIM,1833,21,20-24,1854,885
STAT,1901,9,na,1910,3627.8553992866814
STAT,1918,32,35-39,1950,9.579808990647479
STAT,1887,38,15-19,1925,0.061501253781465426
SIM,1898,18,25-29,1916,17
STAT,1930,23,45-49,1953,1.4268774300939842
STAT,1781,78,na,1859,319.99541653238106
STAT,1931,27,30-34,1958,50.23090615105971
SIM,1819,44,45-49,1863,11
STAT,1851,36,na,1887,1900.2895533664116
STAT,1801,106,na,1907,0.0040279830163742515
STAT,1844,18,na,1862,2873.705523254823
STAT,1863,44,15-19,1907,0.011630483578385914
SIM,1945,25,20-24,1970,51
STAT,1874,46,40-44,1920,0.17719144174092344
SIM,1846,38,30-34,1884,2
STAT,1844,15,45-49,1859,0.08324063507458583
STAT,1869,52,45-49,1921,0.014566255421505619
STAT,1922,36,40-44,1958,1.6859122463911387
SIM,1846,40,na,1886,1033
STAT,1859,32,30-34,1891,13.838443119958123
STAT,1842,59,na,1901,482.4542270702896
STAT,1829,25,20-24,1854,11.734915513032991
SIM,1926,32,35-39,1958,1
STAT,1877,23,35-39,1900,5.905410279999766
STAT,1885,86,na,1971,515.5917807076186
STAT,1841,43,25-29,1884,0.7336021956477706
STAT,1851,50,50-100,1901,0.012099450338742402
STAT,1896,16,20-24,1912,23.42765541454727
STAT,1915,33,20-24,1948,2.438764578278401
STAT,1834,53,35-39,1887,0.003814040495655415
STAT,1840,74,na,1914,436.9843494517652
SIM,1925,42,45-49,1967,1
SIM,1866,17,na,1883,3273
STAT,1881,72,na,1953,1192.611981669187
STAT,1844,88,na,1932,136.00532830209534
STAT,1840,39,25-29,1879,1.313326691298682
STAT,1871,20,25-29,1891,57.44571607896438
STAT,1859,26,45-49,1885,0.9016821166897834
STAT,1897,71,na,1968,2112.0414415290065
SIM,1913,38,30-34,1951,5
SIM,1846,18,na,1864,1437
SIM,1910,4,na,1914,4577
STAT,1880,31,45-49,1911,1.8177550358584627
STAT,1895,40,40-44,1935,2.9555456454829505
STAT,1850,48,45-49,1898,0.10760646752915504
STAT,1849,15,20-24,1864,18.605920657769726
SIM,1925,13,na,1938,5239
STAT,1859,54,na,1913,1659.6548606815081
STAT,1952,16,50-100,1968,0.44499991762399344
STAT,1815,53,25-29,1868,3.3980869022732764E-4
STAT,1863,21,na,1884,2074.2017506193674
STAT,1877,20,30-34,1897,18.189496238334343
STAT,1855,22,45-49,1877,0.5391615272050106
STAT,1878,35,45-49,1913,2.0705160842173673
STAT,1911,23,35-39,1934,8.802141834077087
STAT,1842,22,na,1864,669.4679335320753
SIM,1889,27,35-39,1916,56
STAT,1933,21,20-24,1954,146.935405929783
STAT,1905,48,50-100,1953,0.19675952764747223
STAT,1868,15,30-34,1883,1.5859732239550912
STAT,1904,48,40-44,1952,0.13623707060586984
STAT,1924,38,40-44,1962,1.7464936424995972
STAT,1845,110,na,1955,1.3712365960328563E-4
SIM,1922,15,25-29,1937,16
STAT,1857,38,40-44,1895,3.3424655187499823
STAT,1924,30,30-34,1954,18.286842054418564
SIM,1897,53,na,1950,2171
SIM,1932,38,40-44,1970,1
STAT,1832,30,15-19,1862,0.02304754198849896
STAT,1834,52,50-100,1886,0.00682475008406759
STAT,1836,22,35-39,1858,5.901399910567509
STAT,1905,38,30-34,1943,1.6463546789501244
STAT,1858,51,30-34,1909,0.004567499220484305
STAT,1831,26,15-19,1857,0.5683266153978122
STAT,1842,81,na,1923,134.2417978504227
STAT,1909,22,40-44,1931,3.093206861795854
STAT,1882,44,25-29,1926,0.606508982138424
SIM,1870,41,40-44,1911,12
STAT,1935,23,50-100,1958,0.8892849507450356
STAT,1854,18,50-100,1872,0.0323940271098462
SIM,1907,32,na,1939,4715
STAT,1860,52,25-29,1912,0.0028741638369879537
STAT,1879,16,45-49,1895,0.06717500701301142
STAT,1944,12,na,1956,4179.719764030836
STAT,1787,99,na,1886,0.17150143477862237
STAT,1879,39,30-34,1918,5.412267364513004
SIM,1900,23,25-29,1923,49
STAT,1912,27,20-24,1939,17.779538950671718
STAT,1933,15,35-39,1948,5.604941395837731
SIM,1831,63,na,1894,1741
STAT,1838,35,15-19,1873,0.02953201972635757
STAT,1934,19,20-24,1953,181.1611150037302
STAT,1812,56,na,1868,207.5776179401944
SIM,1783,78,na,1861,1461
SIM,1942,19,20-24,1961,4
STAT,1861,20,40-44,1881,1.8062069024496057
SIM,1921,31,20-24,1952,25
SIM,1913,48,50-100,1961,1
SIM,1917,22,40-44,1939,299
STAT,1807,93,na,1900,11.849524915785862
SIM,1887,39,30-34,1926,32
SIM,1910,36,na,1946,4203
STAT,1834,28,45-49,1862,0.6370361799906962
STAT,1925,42,40-44,1967,0.30005305064251075
STAT,1908,18,40-44,1926,0.26851378752553706
SIM,1920,27,20-24,1947,72
STAT,1809,73,na,1882,1262.77624820045
SIM,1914,28,35-39,1942,3
STAT,1843,40,30-34,1883,1.1999172555919655
STAT,1889,30,na,1919,2896.7543133731365
STAT,1843,22,50-100,1865,0.5057409952050036
SIM,1842,26,na,1868,3212
STAT,1822,77,na,1899,498.4519982511426
STAT,1852,46,40-44,1898,0.17281712391269713
SIM,1850,45,na,1895,1287
SIM,1853,30,25-29,1883,2
STAT,1910,17,45-49,1927,0.09787494758285835
STAT,1938,19,40-44,1957,1.3640624206515637
STAT,1828,51,45-49,1879,0.01706613001857956
STAT,1928,43,20-24,1971,0.02230725059842573
STAT,1889,45,25-29,1934,0.07005488321810947
SIM,1835,40,na,1875,1267
SIM,1837,41,na,1878,1976
STAT,1829,44,15-19,1873,0.0064533173131000295
STAT,1868,29,15-19,1897,0.43508603484624486
STAT,1921,49,50-100,1970,0.2504761521222565
STAT,1827,48,50-100,1875,0.2219752042810218
STAT,1941,25,35-39,1966,15.367872882525617
STAT,1861,31,35-39,1892,8.456521162815356
SIM,1857,36,40-44,1893,9
STAT,1909,38,15-19,1947,0.017902391381062945
STAT,1887,37,15-19,1924,0.06180782057150007
STAT,1835,30,40-44,1865,4.265134062415623
STAT,1894,5,na,1899,3332.557343019809
SIM,1791,70,na,1861,859
STAT,1839,93,na,1932,27.152322446717925
SIM,1871,17,na,1888,1894
STAT,1895,42,45-49,1937,0.1350329176017229
STAT,1834,62,na,1896,805.4907380980394
SIM,1858,35,na,1893,2375
STAT,1842,28,40-44,1870,0.9130095593556738
STAT,1870,34,40-44,1904,4.286400997544337
STAT,1901,19,45-49,1920,0.09084510805116781
STAT,1841,41,20-24,1882,0.18613739632247822
STAT,1873,31,15-19,1904,0.146675860883161
SIM,1810,80,na,1890,1727
SIM,1898,65,na,1963,3479
SIM,1943,28,15-19,1971,8
STAT,1893,34,35-39,1927,12.555752131227647
STAT,1843,23,na,1866,2632.663333736246
STAT,1913,49,45-49,1962,0.2082430929343046
STAT,1849,18,25-29,1867,5.84270733278862
STAT,1903,17,50-100,1920,0.0695445212401824
STAT,1894,34,50-100,1928,1.1551759179085535
STAT,1827,86,na,1913,156.4652111506694
SIM,1851,62,na,1913,979
STAT,1921,48,40-44,1969,0.1751401949068516
STAT,1880,47,30-34,1927,0.10002484590857062
STAT,1900,21,30-34,1921,24.749592449573363
SIM,1884,67,na,1951,3083
STAT,1947,17,40-44,1964,1.559003985446167
SIM,1913,2,na,1915,3815
STAT,1944,26,15-19,1970,0.7547508918779626
STAT,1834,51,30-34,1885,0.002743688959736302
STAT,1835,41,35-39,1876,1.6628347174148552
STAT,1942,26,na,1968,3888.629007074204
SIM,1905,52,na,1957,2842
STAT,1935,28,15-19,1963,0.9549239685127008
STAT,1826,43,35-39,1869,2.6734586447395423
STAT,1877,35,na,1912,2414.3136819311567
SIM,1808,76,na,1884,985
SIM,1874,32,25-29,1906,18
SIM,1881,31,15-19,1912,1
STAT,1844,47,45-49,1891,0.23271257946633658
STAT,1855,29,50-100,1884,0.4349802068628787
STAT,1921,17,20-24,1938,152.70596315911402
STAT,1917,43,45-49,1960,0.17109447548696943
STAT,1856,73,na,1929,853.107569005067
STAT,1831,38,na,1869,2085.88868631908
SIM,1922,27,30-34,1949,2
STAT,1854,60,na,1914,1060.4256151774823
STAT,1855,34,15-19,1889,0.093994119295721
STAT,1857,42,25-29,1899,0.49215985888875696
STAT,1913,27,25-29,1940,64.76102623134317
STAT,1934,35,45-49,1969,0.936000758156543
STAT,1923,48,50-100,1971,0.26107942947687496
STAT,1833,33,25-29,1866,5.71541113831964
STAT,1817,50,30-34,1867,0.004189187150253801
STAT,1845,21,50-100,1866,0.25302433318054607
STAT,1822,55,na,1877,1311.1262949298641
STAT,1850,30,20-24,1880,1.4649555650884192
SIM,1811,43,40-44,1854,6
SIM,1921,27,25-29,1948,429
STAT,1879,20,40-44,1899,2.1504085943234825
STAT,1864,60,na,1924,1733.8287725002267
SIM,1884,57,na,1941,3654
STAT,1831,25,15-19,1856,0.6094314880356226
STAT,1806,108,na,1914,5.515656969532505E-4
STAT,1914,27,30-34,1941,38.950686812226685
STAT,1826,30,15-19,1856,0.34040692925166594
SIM,1867,1,na,1868,3840
STAT,1938,19,50-100,1957,0.3653737738247406
STAT,1881,34,50-100,1915,0.8578464775008621
STAT,1917,49,na,1966,3763.8819548209262
STAT,1930,24,20-24,1954,140.56211315897835
STAT,1864,29,30-34,1893,22.729399258006147
STAT,1914,23,50-100,1937,0.6608454817153065
SIM,1896,52,na,1948,2599
SIM,1866,38,na,1904,3117
STAT,1932,18,35-39,1950,5.503212253869668
STAT,1878,20,35-39,1898,6.039768857245181
STAT,1862,52,35-39,1914,0.007293653225117342
STAT,1881,40,na,1921,2204.6374680708
STAT,1845,30,25-29,1875,6.169993153028971
STAT,1954,11,na,1965,4813.903786416093
SIM,1821,58,na,1879,1753
SIM,1907,6,na,1913,4894
STAT,1800,107,na,1907,0.003253891603235385
STAT,1943,9,na,1952,4137.293968879607
STAT,1839,51,20-24,1890,6.888561039871925E-4
STAT,1820,35,40-44,1855,9.191448458572564
STAT,1884,41,30-34,1925,1.1055253739698563
STAT,1879,36,na,1915,2428.4877064272273
STAT,1900,35,50-100,1935,1.7169266121416487
STAT,1902,48,30-34,1950,0.0759240247011555
SIM,1906,48,40-44,1954,1
SIM,1907,38,45-49,1945,1
STAT,1890,49,na,1939,2667.301196565622
STAT,1833,46,30-34,1879,0.04923805523403452
STAT,1935,30,45-49,1965,2.1638092804066917
SIM,1876,38,na,1914,3545
STAT,1939,22,15-19,1961,5.287229218563711
STAT,1932,32,30-34,1964,20.798502220641414
STAT,1919,19,30-34,1938,13.219462958444627
STAT,1849,36,40-44,1885,3.8136531058581262
STAT,1815,41,50-100,1856,0.11415112513089322
STAT,1816,43,na,1859,2622.5582630682766
STAT,1831,47,35-39,1878,0.13202030018388905
STAT,1912,15,15-19,1927,9.112565272914852
STAT,1915,35,35-39,1950,2.4317900582589473
STAT,1845,52,45-49,1897,0.007162970471022262
STAT,1838,54,50-100,1892,0.006269781342917992
STAT,1927,38,20-24,1965,0.3247478999896419
SIM,1875,44,35-39,1919,2
STAT,1829,28,25-29,1857,28.194948685651894
SIM,1833,43,na,1876,2194
SIM,1932,33,35-39,1965,11
STAT,1874,31,20-24,1905,2.801137036052025
STAT,1841,51,50-100,1892,0.01689836085041861
STAT,1882,42,20-24,1924,0.15186202854501316
STAT,1809,51,35-39,1860,0.0725567974592444
STAT,1918,50,na,1968,3821.996314997249
STAT,1809,89,na,1898,102.25658337043744
STAT,1857,39,40-44,1896,3.3253186706387967
STAT,1839,61,na,1900,1736.085957684489
STAT,1835,54,40-44,1889,0.007802452598292478
STAT,1807,88,na,1895,55.66204997336296
STAT,1834,25,40-44,1859,1.7562630885389576
STAT,1908,39,50-100,1947,0.38613005050725935
STAT,1844,33,50-100,1877,1.0742617050816088
SIM,1930,22,20-24,1952,588
STAT,1867,44,35-39,1911,1.689424941730267
STAT,1876,42,35-39,1918,1.8283124683770755
STAT,1872,48,35-39,1920,0.1384288467426379
SIM,1889,82,na,1971,431
STAT,1907,37,40-44,1944,1.3786211405060247
STAT,1848,44,25-29,1892,0.5928029979122194
STAT,1896,19,25-29,1915,7.429983362334962
STAT,1840,23,15-19,1863,1.6400879718936205
STAT,1854,104,na,1958,0.06639957282342866
STAT,1884,15,na,1899,2428.9259894961365
STAT,1920,17,15-19,1937,50.262638656964214
SIM,1830,25,na,1855,787
SIM,1837,28,25-29,1865,28
STAT,1807,102,na,1909,0.11886869259457075
STAT,1896,48,20-24,1944,0.0088109701524626
STAT,1891,43,15-19,1934,0.016859667813483224
STAT,1907,33,35-39,1940,8.448787317318386
STAT,1850,47,45-49,1897,0.10846770107569603
STAT,1928,38,25-29,1966,1.2336300911998372
STAT,1892,18,na,1910,3118.7447930351686
STAT,1885,32,50-100,1917,0.9006229792611772
STAT,1898,4,na,1902,3537.529989863977
STAT,1904,34,20-24,1938,2.1984887219225717
STAT,1897,65,na,1962,2413.3799251659043
SIM,1900,37,na,1937,4139
STAT,1879,68,na,1947,1567.685932055483
STAT,1876,31,40-44,1907,4.401937427796104
STAT,1846,32,50-100,1878,0.6412845133367697
STAT,1938,17,15-19,1955,44.288620507443106
STAT,1859,42,35-39,1901,1.43347062190989
STAT,1885,45,40-44,1930,0.16995861882143512
STAT,1935,6,na,1941,5439.8460620633105
STAT,1820,46,20-24,1866,0.019108891041528294
STAT,1897,39,50-100,1936,0.34838840649722064
STAT,1830,45,50-100,1875,0.21533674497170582
STAT,1818,54,40-44,1872,0.017309742105849672
STAT,1899,20,50-100,1919,0.5603108870017933
STAT,1874,26,50-100,1900,0.6624707419117439
STAT,1913,32,20-24,1945,2.396339748112223
STAT,1912,19,20-24,1931,26.951140063141583
STAT,1860,15,40-44,1875,0.17413322130189524
STAT,1925,19,50-100,1944,0.4460369140385647
STAT,1886,31,25-29,1917,10.650075744160139
SIM,1905,30,na,1935,3318
SIM,1957,12,na,1969,6080
STAT,1854,41,45-49,1895,0.8359237177131964
STAT,1951,8,na,1959,4636.435671826667
STAT,1936,28,20-24,1964,17.287655477382117
SIM,1898,19,25-29,1917,3
STAT,1846,45,50-100,1891,0.14690943432223
STAT,1906,65,na,1971,2797.5630883582794
SIM,1884,42,35-39,1926,3
STAT,1839,71,na,1910,1240.117997035722
STAT,1875,52,30-34,1927,0.0060798493045688025
STAT,1818,41,35-39,1859,3.6385034376274126
STAT,1909,40,45-49,1949,0.15583006746512332
STAT,1929,17,50-100,1946,0.47478729283110915
STAT,1929,28,na,1957,4653.317494453885
SIM,1867,7,na,1874,2919
STAT,1827,76,na,1903,668.1010568415606
SIM,1905,62,na,1967,2259
STAT,1856,52,20-24,1908,5.271916897014883E-4
SIM,1873,73,na,1946,344
STAT,1857,28,50-100,1885,0.5019788915553839
STAT,1885,32,35-39,1917,9.954393045913932
STAT,1877,29,na,1906,2405.2934663575184
SIM,1842,20,na,1862,3352
SIM,1884,5,na,1889,3913
STAT,1882,7,na,1889,2508.574720614123
STAT,1918,36,15-19,1954,0.020063868965145802
STAT,1896,35,15-19,1931,0.07472757114017776
STAT,1830,41,45-49,1871,1.34012963529017
STAT,1879,35,15-19,1914,0.05815267409984449
STAT,1823,32,50-100,1855,2.532621020461693
STAT,1854,17,na,1871,1526.7670747618974
STAT,1919,48,25-29,1967,0.05661309428829918
SIM,1855,60,na,1915,2860
STAT,1868,18,35-39,1886,0.5363998283602136
STAT,1928,17,30-34,1945,15.241456978170229
STAT,1840,36,20-24,1876,0.36274329680011064
STAT,1819,40,25-29,1859,0.14408452029417987
STAT,1900,24,35-39,1924,8.033199450070924
STAT,1826,37,50-100,1863,2.0060817574665384
SIM,1893,32,35-39,1925,2
STAT,1922,22,20-24,1944,126.09239292938254
STAT,1834,40,na,1874,1145.9866189196098
STAT,1861,47,20-24,1908,0.009933189914019465
SIM,1860,23,na,1883,2217
STAT,1842,75,na,1917,255.55826737486163
SIM,1935,26,15-19,1961,15
STAT,1819,73,na,1892,276.26219871629183
STAT,1891,48,45-49,1939,0.1616490129728922
STAT,1908,45,45-49,1953,0.19790122685760936
STAT,1911,41,50-100,1952,0.11150355993650679
STAT,1913,44,15-19,1957,0.00147386644054408
STAT,1824,40,20-24,1864,0.02670769480304952
SIM,1869,68,na,1937,3598
SIM,1846,39,30-34,1885,9
STAT,1838,39,30-34,1877,2.6888249847249157
SIM,1878,29,25-29,1907,27
STAT,1929,40,50-100,1969,0.15149343097692292
SIM,1900,15,na,1915,4167
STAT,1860,88,na,1948,111.99487787389901
STAT,1891,31,20-24,1922,3.337613132605406
STAT,1924,33,35-39,1957,10.55256545940317
SIM,1827,40,25-29,1867,6
STAT,1847,90,na,1937,71.28109349431637
STAT,1908,42,40-44,1950,0.22962290769311203
STAT,1943,28,50-100,1971,1.047453486147444
STAT,1811,61,na,1872,1390.3016297213371
STAT,1831,44,30-34,1875,1.0938598372708883
STAT,1881,37,20-24,1918,0.7279494242767336
STAT,1913,46,40-44,1959,0.15233293794299524
STAT,1903,40,50-100,1943,0.10518924083909625
SIM,1826,73,na,1899,427
STAT,1860,41,30-34,1901,0.9421340728331311
STAT,1861,40,25-29,1901,0.5394340849010608
STAT,1930,36,15-19,1966,0.02489497553829607
STAT,1875,26,40-44,1901,3.086557480644007
STAT,1823,40,15-19,1863,0.024194408953336945
STAT,1903,29,20-24,1932,16.53390508821151
SIM,1829,39,30-34,1868,25
STAT,1846,41,na,1887,1403.2922627182384
STAT,1893,31,30-34,1924,21.923089283719964
STAT,1843,43,35-39,1886,1.818697121502524
STAT,1922,6,na,1928,4586.8452320861925
STAT,1925,45,45-49,1970,0.2621808836590857
STAT,1900,37,40-44,1937,1.3088807318038327
SIM,1886,16,na,1902,3080
STAT,1826,40,30-34,1866,1.7894391315233757
STAT,1926,33,45-49,1959,1.8852438467229526
STAT,1872,73,na,1945,1189.3675188803907
STAT,1811,45,40-44,1856,0.8309064358744206
STAT,1941,22,30-34,1963,29.364156262407953
STAT,1951,18,45-49,1969,0.5891304017005365
STAT,1852,59,na,1911,1956.2675507497925
STAT,1837,46,15-19,1883,3.372303329697061E-4
STAT,1891,45,40-44,1936,0.11994015389506156
STAT,1882,45,15-19,1927,3.867817660503192E-4
STAT,1877,15,35-39,1892,0.5595937465801195
STAT,1963,0,na,1963,4983.96264895633
STAT,1820,43,40-44,1863,3.6478619327393322
STAT,1839,54,25-29,1893,0.0032002702472088947
STAT,1874,47,30-34,1921,0.0994382806541636
STAT,1931,15,25-29,1946,56.58451868122609
SIM,1896,36,na,1932,3644
STAT,1879,52,na,1931,2197.0466042352323
SIM,1845,41,45-49,1886,21
STAT,1814,46,20-24,1860,0.041577289063349544
STAT,1824,54,40-44,1878,0.0017066398189809647
SIM,1908,8,na,1916,2908
STAT,1836,40,25-29,1876,0.6005731112505499
STAT,1853,51,40-44,1904,0.00820207738697187
STAT,1901,16,40-44,1917,0.2563659305059056
STAT,1859,20,25-29,1879,52.4822075013667
STAT,1924,25,35-39,1949,17.430342885749507
STAT,1892,56,na,1948,2525.2582920784153
STAT,1911,49,25-29,1960,0.049361409300403725
STAT,1929,38,30-34,1967,2.3211326542255573
STAT,1938,27,na,1965,3671.5902732399963
STAT,1852,30,40-44,1882,4.614577660989578
SIM,1920,5,na,1925,4900
STAT,1858,39,50-100,1897,0.9281469579083387
STAT,1880,49,na,1929,2286.914954082687
SIM,1855,17,na,1872,3186
SIM,1903,19,20-24,1922,15
STAT,1848,70,na,1918,1312.9611379851412
SIM,1852,44,40-44,1896,14
STAT,1850,33,25-29,1883,4.8965700097137494
SIM,1920,51,na,1971,3607
STAT,1883,32,25-29,1915,9.853827798798532
STAT,1878,47,15-19,1925,4.096286915394835E-4
SIM,1876,22,30-34,1898,1
STAT,1932,35,35-39,1967,3.232816222773778
STAT,1855,18,25-29,1873,4.434509262867398
STAT,1877,31,50-100,1908,0.933900479530856
STAT,1904,46,15-19,1950,3.23276366808779E-4
STAT,1851,18,40-44,1869,0.1745969484421989
STAT,1933,27,40-44,1960,6.146907802799304
STAT,1871,42,45-49,1913,1.4911257913229254
STAT,1834,56,na,1890,898.8774516976104
STAT,1811,49,20-24,1860,0.0546217759523918
SIM,1857,18,na,1875,1465
STAT,1809,100,na,1909,1.0333798674189008
STAT,1923,46,25-29,1969,0.061553702463032794
STAT,1848,16,50-100,1864,0.05716882913431744
STAT,1858,41,15-19,1899,0.01059379232986084
STAT,1915,32,30-34,1947,15.819334346556545
STAT,1844,44,40-44,1888,2.2244497868502253
STAT,1855,47,20-24,1902,0.007905011775529035
SIM,1824,41,25-29,1865,8
STAT,1897,55,na,1952,2746.0310118863777
SIM,1813,42,50-100,1855,4
SIM,1859,25,35-39,1884,22
SIM,1928,36,25-29,1964,5
STAT,1876,34,35-39,1910,10.149882706703591
STAT,1864,41,15-19,1905,0.012611407636724565
STAT,1878,42,45-49,1920,1.5379512267815894
STAT,1899,33,50-100,1932,1.2461886303299168
STAT,1817,53,35-39,1870,0.005708764914895394
STAT,1926,26,na,1952,4467.53987427944
STAT,1804,51,45-49,1855,0.09353748271878315
STAT,1826,40,40-44,1866,3.5009597467951488
SIM,1859,29,15-19,1888,2
STAT,1862,30,25-29,1892,8.794171426160645
STAT,1829,93,na,1922,10.67222162809619
STAT,1868,22,30-34,1890,17.204365188049632
STAT,1926,38,15-19,1964,0.023244303390352064
SIM,1945,7,na,1952,6372
STAT,1885,48,45-49,1933,0.22906126169187938
STAT,1918,34,50-100,1952,0.8593118966012755
STAT,1816,41,25-29,1857,2.167877325115595
STAT,1914,20,na,1934,3711.2582432789527
SIM,1818,44,na,1862,859
SIM,1883,22,25-29,1905,13
STAT,1835,39,50-100,1874,1.1248400365136768
STAT,1861,44,40-44,1905,1.845344898027721
STAT,1843,101,na,1944,0.5638016364593956
STAT,1870,72,na,1942,1259.0217732075735
STAT,1905,44,50-100,1949,0.10409403986608953
STAT,1842,23,25-29,1865,17.79544452655777
SIM,1893,34,na,1927,3251
STAT,1913,24,20-24,1937,110.18177526204828
SIM,1911,29,20-24,1940,1
STAT,1931,21,50-100,1952,0.8499665655907066
STAT,1818,56,na,1874,1460.1758031477943
STAT,1860,72,na,1932,1030.2597736435466
STAT,1859,38,na,1897,1858.0681545839334
STAT,1928,35,20-24,1963,0.33118702262558697
STAT,1936,19,30-34,1955,11.49172772457302
SIM,1835,56,na,1891,1190
STAT,1861,23,35-39,1884,4.949915257171243
STAT,1910,43,35-39,1953,0.18704944027611223
STAT,1812,50,40-44,1862,0.0026964879568921107
STAT,1843,35,50-100,1878,1.445862944373501
STAT,1925,28,45-49,1953,2.0147230523395203
STAT,1877,67,na,1944,1609.186877192646
STAT,1850,44,40-44,1894,1.0246097982802942
STAT,1902,13,na,1915,3630.9504475193207
STAT,1884,44,35-39,1928,1.7100438353564902
SIM,1913,25,25-29,1938,804
STAT,1824,62,na,1886,368.2046539857472
STAT,1824,43,25-29,1867,0.10988600392395166
STAT,1898,13,na,1911,3467.360638930504
STAT,1843,30,15-19,1873,0.17270425236595888
SIM,1943,26,na,1969,4946
SIM,1847,41,na,1888,1514
STAT,1824,53,50-100,1877,0.002497035782134303
STAT,1891,34,25-29,1925,12.487786291694862
STAT,1842,31,25-29,1873,3.1036691006574753
STAT,1863,36,15-19,1899,0.048170576899329944
STAT,1867,41,30-34,1908,1.092195475861002
STAT,1895,48,na,1943,2890.5184795122345
SIM,1901,32,na,1933,3790
SIM,1867,18,na,1885,2488
SIM,1869,40,50-100,1909,4
STAT,1842,91,na,1933,14.385225048487746
STAT,1947,4,na,1951,4432.968555677287
STAT,1889,52,na,1941,2579.1657493920766
STAT,1939,22,na,1961,3627.131952226517
STAT,1901,66,na,1967,2575.2388199682036
STAT,1907,30,30-34,1937,14.745568221058306
STAT,1901,46,50-100,1947,0.1942570990530809
STAT,1850,30,50-100,1880,0.4965704222678864
SIM,1832,42,na,1874,1874
STAT,1919,45,50-100,1964,0.24320418043970055
STAT,1915,48,40-44,1963,0.15619096593742124
STAT,1922,38,30-34,1960,2.048646799504196
SIM,1930,38,30-34,1968,5
STAT,1830,49,30-34,1879,0.08063227278994399
STAT,1959,10,na,1969,5093.752497899469
STAT,1821,51,35-39,1872,0.009063586658797786
STAT,1835,33,35-39,1868,9.654427197662704
STAT,1883,24,25-29,1907,54.727986149937934
STAT,1859,16,na,1875,2124.397567377419
STAT,1934,32,40-44,1966,5.30684690791774
STAT,1902,35,na,1937,3375.528283607211
SIM,1877,2,na,1879,1289
STAT,1836,18,15-19,1854,14.390123933612758
STAT,1841,44,15-19,1885,0.015575558883204657
STAT,1892,19,40-44,1911,0.22523673704604197
STAT,1913,35,25-29,1948,0.9685912973903027
STAT,1913,51,na,1964,3495.6895402347973
SIM,1820,57,na,1877,318
STAT,1855,52,50-100,1907,0.009942339000873726
STAT,1870,37,45-49,1907,1.9873729453526936
STAT,1931,32,na,1963,4920.902400099414
SIM,1900,21,na,1921,4149
STAT,1897,40,15-19,1937,0.0012864299718116296
SIM,1817,53,na,1870,2447
SIM,1955,11,na,1966,3825
STAT,1944,5,na,1949,4235.746762985988
STAT,1860,94,na,1954,16.30448569380733
STAT,1938,11,na,1949,3872.4683381108507
STAT,1899,42,15-19,1941,0.0013082307442392408
STAT,1910,46,15-19,1956,3.40689697434998E-4
STAT,1892,34,na,1926,2929.1819385981785
STAT,1906,28,35-39,1934,13.923154566791581
STAT,1888,3,na,1891,3051.195162073634
STAT,1890,31,15-19,1921,0.173104299454906
STAT,1875,37,50-100,1912,1.260710387534191
STAT,1857,0,na,1857,3034.912248305241
SIM,1796,58,na,1854,1195
STAT,1905,25,25-29,1930,61.25578127918024
STAT,1893,47,40-44,1940,0.12020178196284469
STAT,1950,15,35-39,1965,4.916920284252083
STAT,1881,5,na,1886,2528.9112139064746
STAT,1872,45,30-34,1917,0.09789797527652491
STAT,1926,1,na,1927,5076.188037136706
STAT,1940,17,30-34,1957,12.236917986313845
STAT,1876,51,25-29,1927,0.0035977813241527823
STAT,1857,90,na,1947,60.499209723939835
STAT,1857,51,50-100,1908,0.011644717590610603
STAT,1911,22,45-49,1933,1.0550885762132107
SIM,1910,15,na,1925,4385
STAT,1942,17,50-100,1959,0.38705726307316773
SIM,1883,3,na,1886,2348
STAT,1882,51,na,1933,2071.3281645157654
STAT,1812,77,na,1889,68.02919455251616
STAT,1833,45,na,1878,1012.1292108118563
STAT,1898,43,25-29,1941,0.05953138448061842
STAT,1907,15,50-100,1922,0.0718160211528003
SIM,1850,23,na,1873,1890
STAT,1858,15,25-29,1873,5.1151485162691195
STAT,1805,54,30-34,1859,0.006691480104158228
STAT,1896,30,45-49,1926,2.317234068925614
SIM,1823,41,50-100,1864,3
STAT,1825,42,na,1867,1682.2133279855634
STAT,1953,10,na,1963,4710.515280314455
SIM,1861,39,na,1900,2179
SIM,1826,57,na,1883,1370
STAT,1907,15,30-34,1922,2.3364150298548827
STAT,1869,45,50-100,1914,0.25030127396006147
STAT,1933,20,30-34,1953,38.09100492341775
STAT,1894,22,35-39,1916,7.4207380488528765
SIM,1895,51,na,1946,4395
STAT,1912,43,45-49,1955,0.15769974452826382
SIM,1850,20,20-24,1870,2
STAT,1915,44,25-29,1959,0.070641604477973
SIM,1817,40,30-34,1857,4
STAT,1890,17,50-100,1907,0.059309924417254474
SIM,1882,7,na,1889,2356
SIM,1877,17,15-19,1894,85
STAT,1840,40,15-19,1880,0.006395075146664338
STAT,1869,17,15-19,1886,6.071372818626042
STAT,1919,9,na,1928,4340.76671826854
STAT,1890,70,na,1960,1839.6014831976538
STAT,1913,48,30-34,1961,0.08567971393898503
STAT,1882,88,na,1970,356.7487436543365
SIM,1852,89,na,1941,906
STAT,1831,46,20-24,1877,0.011462627885219902
STAT,1909,51,na,1960,3298.894357504931
STAT,1830,41,35-39,1871,1.6214486596258213
STAT,1802,94,na,1896,10.126289336976285
SIM,1845,39,na,1884,2421
STAT,1835,50,25-29,1885,0.0028415438833230802
STAT,1872,34,15-19,1906,0.14138039507216574
STAT,1896,18,50-100,1914,0.06441329098323977
STAT,1862,52,45-49,1914,0.012295015419485994
STAT,1910,48,na,1958,3379.8798591591876
SIM,1915,29,na,1944,2785
STAT,1899,29,na,1928,3236.3765359505633
STAT,1857,89,na,1946,80.61401999245791
STAT,1828,87,na,1915,119.2620957925128
STAT,1827,31,35-39,1858,10.588263109253349
SIM,1883,66,na,1949,1771
SIM,1921,20,na,1941,5255
STAT,1825,35,40-44,1860,6.633928343077601
STAT,1834,21,25-29,1855,33.98549560055531
SIM,1889,25,20-24,1914,35
STAT,1941,25,na,1966,3834.558091546658
STAT,1942,17,40-44,1959,1.4450141335311235
STAT,1892,26,40-44,1918,3.721516772466194
STAT,1916,27,40-44,1943,4.753620114217492
SIM,1854,54,na,1908,986
SIM,1842,21,25-29,1863,16
SIM,1906,53,na,1959,3086
STAT,1870,56,na,1926,2033.3787275984869
STAT,1873,52,20-24,1925,7.529130758082037E-4
STAT,1833,61,na,1894,768.826186393837
SIM,1915,15,30-34,1930,19
SIM,1898,23,20-24,1921,9
STAT,1844,24,na,1868,2606.892973197726
SIM,1870,16,na,1886,2423
SIM,1843,30,30-34,1873,14
SIM,1894,19,na,1913,1764
STAT,1922,34,15-19,1956,0.14287309115760022
STAT,1887,32,45-49,1919,1.9193783331111884
STAT,1804,51,35-39,1855,0.055488337283413666
SIM,1874,4,na,1878,2818
SIM,1927,14,na,1941,1973
STAT,1941,7,na,1948,4047.0611412005946
SIM,1895,73,na,1968,3703
STAT,1824,94,na,1918,3.8677800747879933
SIM,1835,72,na,1907,796
STAT,1866,36,40-44,1902,4.015098814359875
STAT,1872,47,20-24,1919,0.011960294896023212
STAT,1938,28,30-34,1966,38.38429268434413
STAT,1896,15,45-49,1911,0.08651007576810378
STAT,1899,16,25-29,1915,7.7590086143146255
STAT,1902,19,na,1921,3537.3860542971156
STAT,1900,30,50-100,1930,1.2794641139264076
STAT,1946,19,50-100,1965,0.41078101053562616
STAT,1882,51,25-29,1933,0.0034073848872196513
STAT,1884,31,15-19,1915,0.13688003711456176
STAT,1831,33,15-19,1864,0.14924898703123612
SIM,1887,22,na,1909,3817
STAT,1843,76,na,1919,936.0771941337567
STAT,1869,30,35-39,1899,10.3011809274646
STAT,1902,21,40-44,1923,2.943196168593549
STAT,1901,39,15-19,1940,0.01677645933092727
SIM,1914,9,na,1923,5124
STAT,1870,30,25-29,1900,10.29327062221853
STAT,1880,43,15-19,1923,0.014233170705768588
SIM,1954,10,na,1964,5556
STAT,1868,25,35-39,1893,9.382846146425418
STAT,1919,28,20-24,1947,19.39277215619043
SIM,1899,66,na,1965,1469
STAT,1820,110,na,1930,1.9004104451991863E-4
STAT,1902,44,15-19,1946,0.0013321738821117388
STAT,1941,20,50-100,1961,0.6727204948191212
STAT,1851,106,na,1957,0.014896890285599693
STAT,1895,47,15-19,1942,2.921515134177693E-4
STAT,1853,40,25-29,1893,0.5029455119272049
STAT,1896,70,na,1966,2135.4600352908283
STAT,1842,20,20-24,1862,21.89036769013546
STAT,1917,48,15-19,1965,3.7857364037470264E-4
STAT,1891,47,30-34,1938,0.06683415672344799
STAT,1853,21,35-39,1874,5.384864019043393
STAT,1920,25,15-19,1945,0.7696411698166714
STAT,1898,32,20-24,1930,3.634848488917486
STAT,1817,40,15-19,1857,0.010483245521185217
STAT,1873,19,50-100,1892,0.04998536433808571
STAT,1924,22,30-34,1946,33.58847791835192
STAT,1863,16,na,1879,2249.390824630215
STAT,1873,19,30-34,1892,1.6261908504203162
STAT,1821,76,na,1897,478.4550650604147
SIM,1851,24,na,1875,1351
STAT,1867,53,25-29,1920,0.003296003630781339
STAT,1939,26,30-34,1965,38.97493914544648
SIM,1901,16,na,1917,4013
STAT,1843,40,40-44,1883,2.3475858649274755
STAT,1838,18,25-29,1856,3.176429987047215
STAT,1846,17,50-100,1863,0.03644992143957708
STAT,1919,15,15-19,1934,9.974507603576548
STAT,1909,33,45-49,1942,1.4800619801328063
STAT,1833,42,15-19,1875,0.007188820093078579
STAT,1943,25,45-49,1968,1.8205036507446901
STAT,1876,31,30-34,1907,17.72229831177714
STAT,1813,57,na,1870,1894.1656252121875
STAT,1922,33,na,1955,4207.756120783028
SIM,1906,31,na,1937,3335
STAT,1808,72,na,1880,356.13453809392576
SIM,1864,74,na,1938,620
STAT,1920,39,25-29,1959,1.0619039410840074
STAT,1888,30,45-49,1918,2.028834294555604
STAT,1822,35,15-19,1857,0.12372904175276817
STAT,1852,42,25-29,1894,0.6455917090993669
SIM,1812,44,na,1856,1918
STAT,1863,40,35-39,1903,1.561512819332449
STAT,1873,53,25-29,1926,0.0035749877230938725
STAT,1921,37,25-29,1958,1.0863601193608543
SIM,1868,23,35-39,1891,43
SIM,1901,43,35-39,1944,1
SIM,1911,0,na,1911,2903
STAT,1832,29,50-100,1861,0.7566541193490846
STAT,1882,56,na,1938,1952.7665323479964
STAT,1915,15,30-34,1930,2.526699817054751
STAT,1850,46,30-34,1896,0.04482543610104723
STAT,1876,20,50-100,1896,0.4146982500969068
STAT,1930,42,25-29,1972,0.09329680022936657
STAT,1909,46,15-19,1955,3.358808449271646E-4
STAT,1866,32,25-29,1898,9.349640918514197
STAT,1809,95,na,1904,12.941558759555308
STAT,1887,45,15-19,1932,4.4465819703008556E-4
STAT,1900,30,20-24,1930,3.7746067626562096
STAT,1893,31,40-44,1924,5.445347186532345
STAT,1883,14,na,1897,2476.442106457424
STAT,1857,24,20-24,1881,54.75864121270532
STAT,1846,31,45-49,1877,1.2332487016828557
SIM,1848,39,40-44,1887,92
STAT,1829,35,na,1864,1021.2842664689235
STAT,1820,39,20-24,1859,1.3219547205147073
SIM,1848,24,20-24,1872,1
STAT,1874,37,na,1911,2431.525138015824
STAT,1877,41,25-29,1918,0.6548162137145078
STAT,1876,66,na,1942,1656.8885203543675
STAT,1849,22,20-24,1871,70.20245941188294
STAT,1947,25,na,1972,4197.146070810115
SIM,1958,7,na,1965,4197
STAT,1847,29,30-34,1876,26.97367775989829
SIM,1896,30,45-49,1926,63
STAT,1920,28,50-100,1948,1.0740398709698011
STAT,1935,23,45-49,1958,1.5206772078318553
STAT,1845,89,na,1934,52.1293446249841
STAT,1861,20,30-34,1881,15.439357080728723
STAT,1921,44,25-29,1965,0.07921190769613339
STAT,1821,51,45-49,1872,0.015278617489245042
STAT,1810,101,na,1911,0.017766122372311358
STAT,1835,30,30-34,1865,17.17152491004304
STAT,1898,21,15-19,1919,4.449646451785251
STAT,1817,50,40-44,1867,0.007408975607381649
STAT,1845,52,35-39,1897,0.004249219776869213
STAT,1905,22,20-24,1927,99.11825523007603
STAT,1884,85,na,1969,551.2977008430574
SIM,1838,39,50-100,1877,4
STAT,1863,31,45-49,1894,1.4948063084986583
STAT,1914,36,50-100,1950,0.41535991725821214
SIM,1907,16,na,1923,4865
STAT,1867,89,na,1956,111.5773696458383
STAT,1926,40,45-49,1966,0.20397916731374002
STAT,1917,35,45-49,1952,0.7052613969115338
SIM,1855,29,30-34,1884,166
STAT,1935,36,15-19,1971,0.026683450703568708
SIM,1854,7,na,1861,2666
STAT,1867,41,40-44,1908,2.1368328932015364
STAT,1826,52,25-29,1878,0.004893501405333971
STAT,1900,48,20-24,1948,0.009259174200374976
STAT,1939,33,30-34,1972,15.888728158614306
STAT,1883,21,20-24,1904,66.49695167571092
STAT,1930,27,25-29,1957,83.10569052455064
STAT,1912,37,50-100,1949,0.40502463483012796
STAT,1908,29,na,1937,3488.8280016614012
SIM,1925,29,na,1954,4749
STAT,1911,31,35-39,1942,8.834334917379847
STAT,1843,52,25-29,1895,0.003481036664606909
STAT,1874,43,15-19,1917,0.014149704609718022
STAT,1832,39,na,1871,2257.2013556101583
STAT,1857,20,15-19,1877,2.964945501749552
STAT,1868,32,35-39,1900,9.781437934976429
STAT,1826,91,na,1917,46.19809075764611
SIM,1848,42,na,1890,2305
SIM,1844,76,na,1920,720
STAT,1907,44,na,1951,3338.291939481291
STAT,1857,74,na,1931,851.6089393013673
SIM,1889,0,na,1889,3967
STAT,1877,19,15-19,1896,5.991976251220814
STAT,1837,41,45-49,1878,1.4343213113000366
STAT,1849,29,40-44,1878,2.9491990006693842
STAT,1870,51,50-100,1921,0.015128470665984519
STAT,1841,50,25-29,1891,0.004000942366756496
SIM,1894,29,na,1923,1574
STAT,1860,78,na,1938,637.4051020587856
STAT,1842,15,50-100,1857,0.015803171794284344
SIM,1915,45,na,1960,3022
STAT,1876,20,25-29,1896,58.215334267506535
STAT,1946,16,20-24,1962,148.78929015312642
STAT,1857,52,na,1909,1643.4620077190693
STAT,1898,47,40-44,1945,0.1292553052535387
SIM,1875,37,na,1912,2985
STAT,1859,7,na,1866,2277.200758464606
SIM,1838,26,50-100,1864,4
SIM,1871,40,35-39,1911,1
STAT,1851,25,40-44,1876,2.810321199359204
STAT,1929,16,20-24,1945,172.23169723527226
STAT,1870,54,45-49,1924,0.014070048499541812
STAT,1893,43,25-29,1936,0.055361584449081326
SIM,1839,34,20-24,1873,7
STAT,1880,36,15-19,1916,0.058577695478760385
STAT,1928,43,na,1971,4691.153463816183
STAT,1894,41,25-29,1935,0.8202994159412706
STAT,1916,23,35-39,1939,9.701943973913545
STAT,1897,20,45-49,1917,0.9316047834834724
STAT,1813,45,15-19,1858,0.0015320787994153016
STAT,1852,30,30-34,1882,18.578392635595687
SIM,1865,20,15-19,1885,3
STAT,1945,18,20-24,1963,146.41716964451044
STAT,1888,27,50-100,1915,0.7383097354810415
STAT,1844,46,50-100,1890,0.24400400343324818
STAT,1934,15,40-44,1949,1.8878244805397875
STAT,1866,29,40-44,1895,2.7148634725348306
STAT,1898,25,20-24,1923,15.882505608621582
STAT,1827,50,25-29,1877,0.0032612519969172117
STAT,1911,27,15-19,1938,0.6807005532519154
STAT,1809,57,na,1866,2585.562159915298
SIM,1805,58,na,1863,2097
STAT,1806,102,na,1908,0.08828038635182892
STAT,1867,67,na,1934,1499.1881600972144
STAT,1916,20,30-34,1936,29.883355270963165
STAT,1785,109,na,1894,2.317299163127581E-4
STAT,1891,55,na,1946,2542.7268164728835
SIM,1885,15,na,1900,1861
STAT,1879,30,45-49,1909,1.803261574908016
STAT,1912,37,25-29,1949,0.9498290847118964
STAT,1816,38,50-100,1854,4.7819267391634845
STAT,1924,29,na,1953,4288.998716989283
STAT,1932,11,na,1943,5217.914801352701
STAT,1859,48,na,1907,1760.8011290254826
STAT,1872,22,50-100,1894,0.4083448380689932
SIM,1874,52,na,1926,2445
SIM,1913,47,35-39,1960,1
SIM,1848,20,na,1868,2702
STAT,1850,42,15-19,1892,0.006368998887483353
SIM,1852,31,35-39,1883,9
SIM,1907,26,na,1933,4054
STAT,1791,100,na,1891,0.26769666018886756
STAT,1812,62,na,1874,177.9874163842877
SIM,1854,45,50-100,1899,3
STAT,1851,90,na,1941,62.267694348184264
STAT,1794,79,na,1873,3.521865899843603
SIM,1924,20,30-34,1944,17
STAT,1907,28,50-100,1935,0.9300876841673361
STAT,1903,25,15-19,1928,0.648405193961359
STAT,1878,51,35-39,1929,0.008899976346770628
STAT,1833,30,20-24,1863,1.5742040145266343
STAT,1933,23,35-39,1956,12.400881044653568
STAT,1893,40,20-24,1933,0.20060406113126125
SIM,1836,35,na,1871,2008
STAT,1905,47,35-39,1952,0.11305701288708127
STAT,1818,50,25-29,1868,0.006307952454442215
SIM,1890,1,na,1891,4120
STAT,1889,14,na,1903,3099.854088850901
SIM,1930,6,na,1936,5653
STAT,1853,38,na,1891,1817.7371509509721
STAT,1880,92,na,1972,178.88906222269034
STAT,1884,41,40-44,1925,2.1629122584539613
STAT,1875,41,15-19,1916,0.014244818345307672
STAT,1846,44,15-19,1890,0.00806862016964159
STAT,1885,41,25-29,1926,0.6340639107542798
STAT,1948,16,30-34,1964,13.810204262379633
STAT,1851,42,40-44,1893,1.7742742395628064
STAT,1838,49,na,1887,962.1511884653502
STAT,1863,43,50-100,1906,0.895390798577681
STAT,1777,94,na,1871,10.573004758990873
STAT,1920,36,20-24,1956,0.28517011056461383
STAT,1868,15,na,1883,2513.0939741883035
STAT,1799,78,na,1877,63.125314790958356
SIM,1871,60,na,1931,1634
STAT,1932,33,na,1965,4989.625400690016
SIM,1884,20,25-29,1904,5
STAT,1901,34,na,1935,3308.0099194988975
STAT,1881,24,15-19,1905,3.0959228615405636
SIM,1874,74,na,1948,1948
STAT,1895,20,35-39,1915,7.636508934913965
STAT,1787,94,na,1881,1.9946746692360078
STAT,1865,51,25-29,1916,0.0032492987588224127
STAT,1891,33,na,1924,2922.1316489877645
STAT,1914,30,na,1944,3784.2530721733856
STAT,1918,21,50-100,1939,0.7022077358321055
STAT,1886,43,50-100,1929,1.0861059818821863
STAT,1909,30,40-44,1939,3.7260810760898004
STAT,1856,15,15-19,1871,5.10004392405743
STAT,1934,4,na,1938,5422.392509123104
STAT,1790,98,na,1888,0.8237044895837803
SIM,1868,67,na,1935,502
SIM,1898,26,25-29,1924,7
STAT,1902,24,45-49,1926,0.9757935261371299
STAT,1831,109,na,1940,5.568240143568699E-4
STAT,1915,41,20-24,1956,0.017554104994652004
SIM,1922,15,na,1937,3053
STAT,1871,19,na,1890,2505.8912660561955
STAT,1889,42,20-24,1931,0.19101116980130017
STAT,1867,50,20-24,1917,7.079012693177734E-4
SIM,1937,14,na,1951,2988
STAT,1844,31,35-39,1875,12.122747071172792
STAT,1844,40,25-29,1884,0.6684629952277511
STAT,1938,17,25-29,1955,42.2899045348768
STAT,1834,40,15-19,1874,0.007527598195782839
STAT,1828,49,na,1877,1644.8403207836063
STAT,1800,77,na,1877,599.7627578013879
STAT,1874,22,na,1896,2440.887464566312
STAT,1889,36,na,1925,2850.781887540837
SIM,1872,23,na,1895,2119
STAT,1916,0,na,1916,4699.185987015658
SIM,1957,5,na,1962,6080
STAT,1879,19,25-29,1898,5.781981060599794
SIM,1836,57,na,1893,1387
SIM,1873,2,na,1875,3414
SIM,1852,40,25-29,1892,1
STAT,1918,7,na,1925,4292.1718307844785
STAT,1937,33,20-24,1970,2.3867642277963665
SIM,1919,11,na,1930,5211
STAT,1853,16,na,1869,2153.7412929532284
STAT,1861,89,na,1950,87.36702150841317
SIM,1800,59,na,1859,216
SIM,1892,8,na,1900,3699
STAT,1878,2,na,1880,3333.3362330736445
STAT,1861,47,45-49,1908,0.1953527275620249
STAT,1818,72,na,1890,768.6689066511951
SIM,1833,31,25-29,1864,22
STAT,1857,27,25-29,1884,33.43479847334836
SIM,1870,38,na,1908,2027
STAT,1919,51,na,1970,3881.723688776086
STAT,1825,52,40-44,1877,0.012912998575915633
STAT,1848,41,20-24,1889,0.15034410731158537
SIM,1893,66,na,1959,1626
STAT,1931,37,35-39,1968,3.1808033840605034
STAT,1904,37,25-29,1941,0.8878622539193135
SIM,1891,37,na,1928,2047
STAT,1899,14,na,1913,3515.9453246666835
STAT,1892,22,25-29,1914,70.87543859702183
STAT,1939,29,35-39,1968,14.912501704240839
STAT,1873,50,20-24,1923,7.678202546074503E-4
STAT,1883,17,25-29,1900,5.451637543982979
STAT,1846,48,30-34,1894,0.05661048750164321
SIM,1801,81,na,1882,1570
SIM,1889,66,na,1955,2045
SIM,1853,68,na,1921,2333
STAT,1921,30,40-44,1951,4.337890380789625
SIM,1912,37,25-29,1949,1
STAT,1852,106,na,1958,0.02326684005080651
STAT,1849,23,na,1872,2162.5120354121577
STAT,1857,23,50-100,1880,0.3586573995527874
SIM,1890,52,na,1942,3400
STAT,1943,22,40-44,1965,3.5364793921569158
SIM,1874,36,40-44,1910,13
STAT,1825,31,25-29,1856,18.84846527557385
STAT,1855,23,na,1878,1641.3075490331746
STAT,1875,15,25-29,1890,5.845928134234225
SIM,1896,3,na,1899,4173
STAT,1923,17,30-34,1940,14.16199254453277
STAT,1868,49,20-24,1917,0.011348450965675978
STAT,1849,25,25-29,1874,42.864560566587514
STAT,1926,42,35-39,1968,0.24611516493868632
STAT,1904,52,na,1956,3078.2283449368697
STAT,1834,24,na,1858,1242.1670013348019
STAT,1887,29,na,1916,2608.008040602355
STAT,1931,34,50-100,1965,1.0743697535582737
STAT,1915,18,35-39,1933,0.8635562536685716
STAT,1935,20,40-44,1955,4.548884053420508
STAT,1819,57,na,1876,525.9115209021186
STAT,1870,28,50-100,1898,0.6354857250396847
SIM,1841,33,25-29,1874,7
STAT,1957,5,na,1962,5138.457821015714
STAT,1852,53,na,1905,2132.553434988228
STAT,1948,18,50-100,1966,0.42423923886715853
STAT,1795,97,na,1892,1.3095896324549778
STAT,1871,42,35-39,1913,1.8041418173328745
STAT,1899,30,20-24,1929,3.721696506437933
STAT,1881,41,15-19,1922,0.013100290437820761
STAT,1888,51,na,1939,2497.0667238648534
STAT,1870,21,35-39,1891,5.83514721524635
STAT,1873,2,na,1875,3375.867252902028
STAT,1946,19,25-29,1965,47.51367980822322
SIM,1845,49,na,1894,2063
SIM,1900,31,na,1931,3538
SIM,1893,36,50-100,1929,6
SIM,1850,61,na,1911,954
STAT,1921,46,15-19,1967,4.1136667138296927E-4
STAT,1908,28,45-49,1936,1.6148202573924402
STAT,1885,36,50-100,1921,1.212617400134297
STAT,1852,33,35-39,1885,10.445417054664011
STAT,1859,22,50-100,1881,0.335343062593834
STAT,1917,44,na,1961,3811.3395084121157
STAT,1923,43,20-24,1966,0.0203919271694034
SIM,1859,22,30-34,1881,29
STAT,1939,28,na,1967,3722.8335143689387
STAT,1802,84,na,1886,162.1448753408804
STAT,1884,51,35-39,1935,0.008280645808969695
STAT,1921,41,20-24,1962,0.019683784857380787
SIM,1838,25,15-19,1863,4
SIM,1855,9,na,1864,3430
STAT,1792,83,na,1875,175.3237999052155
STAT,1843,38,na,1881,2447.39142072986
STAT,1882,41,na,1923,2222.8170763213134
STAT,1870,51,40-44,1921,0.010545578908420405
SIM,1915,30,na,1945,3392
SIM,1860,38,na,1898,1731
STAT,1813,47,50-100,1860,0.9032763146387763
STAT,1822,54,30-34,1876,0.009218168516729823
STAT,1867,52,na,1919,2025.4750646710002
STAT,1913,49,35-39,1962,0.12353403835358491
STAT,1915,15,na,1930,4003.746084052922
SIM,1857,34,na,1891,1405
STAT,1822,39,na,1861,1618.1030715526308
SIM,1850,16,25-29,1866,4
STAT,1804,58,na,1862,1950.0396501753344
STAT,1919,45,20-24,1964,0.011882940882839928
STAT,1859,51,25-29,1910,0.002820805481246339
STAT,1851,51,30-34,1902,0.004723773219036549
SIM,1882,23,na,1905,2064
STAT,1934,18,45-49,1952,0.6693465193576797
STAT,1932,18,50-100,1950,0.49135814591566496
STAT,1941,31,20-24,1972,2.533284672278328
STAT,1956,16,30-34,1972,15.992231196231556
SIM,1884,52,na,1936,3654
STAT,1851,21,25-29,1872,54.38260325588511
SIM,1858,19,na,1877,2443
STAT,1922,25,25-29,1947,74.14843437251872
STAT,1860,30,15-19,1890,0.11710889680494067
SIM,1875,15,na,1890,2970
STAT,1873,74,na,1947,1138.3985057300647
SIM,1838,42,na,1880,1859
STAT,1842,16,25-29,1858,1.8171342387517933
STAT,1900,33,25-29,1933,14.129053185195914
STAT,1819,35,na,1854,705.334275849248
STAT,1841,54,40-44,1895,0.011400841391177023
SIM,1860,42,25-29,1902,14
STAT,1858,37,na,1895,1799.1756532960949
STAT,1892,43,40-44,1935,2.764697662747415
STAT,1904,17,20-24,1921,25.32868073827979
STAT,1900,71,na,1971,2255.915056856444
SIM,1860,33,35-39,1893,74
STAT,1813,49,30-34,1862,0.3419556605754218
STAT,1920,48,na,1968,3997.682740412261
STAT,1837,38,na,1875,2069.3158234609195
STAT,1874,34,25-29,1908,10.480543816851295
STAT,1918,16,45-49,1934,0.10787930819998773
SIM,1900,53,na,1953,4006
STAT,1897,16,15-19,1913,7.900748500815216
STAT,1917,32,40-44,1949,4.043165829119385
SIM,1820,47,na,1867,514
STAT,1837,50,35-39,1887,0.007207981824831971
STAT,1820,46,45-49,1866,0.3758081762213632
STAT,1887,49,30-34,1936,0.0588454965596839
STAT,1852,75,na,1927,1036.2440989006898
SIM,1817,43,na,1860,2812
STAT,1902,45,na,1947,3200.316628970047
SIM,1865,85,na,1950,254
STAT,1865,40,45-49,1905,1.3802067771019213
STAT,1868,41,25-29,1909,0.623047207523841
STAT,1893,28,35-39,1921,12.023780224311334
STAT,1921,45,25-29,1966,0.05936805342068097
STAT,1923,44,na,1967,4280.861572280348
SIM,1867,43,25-29,1910,3
STAT,1889,67,na,1956,1936.038639864775
SIM,1853,42,40-44,1895,1
STAT,1896,29,15-19,1925,0.593809061315426
SIM,1802,60,na,1862,935
STAT,1840,89,na,1929,41.3653068414183
STAT,1941,15,30-34,1956,12.418537334775168
STAT,1866,21,20-24,1887,63.87687276441284
STAT,1829,38,15-19,1867,0.02800511023144202
SIM,1848,24,30-34,1872,3
STAT,1869,54,20-24,1923,7.241444949821271E-4
STAT,1882,49,40-44,1931,0.1604863490028915
STAT,1871,100,na,1971,8.582092840711333
STAT,1848,69,na,1917,1373.2897570106181
SIM,1791,71,na,1862,508
SIM,1915,30,20-24,1945,2
STAT,1849,24,25-29,1873,57.482757629864615
STAT,1871,57,na,1928,2004.6945997450725
STAT,1845,48,25-29,1893,0.02822296453487397
STAT,1897,50,na,1947,2900.6905062023247
SIM,1881,25,30-34,1906,3
STAT,1925,21,25-29,1946,109.88462783977036
SIM,1842,25,na,1867,3261
STAT,1882,17,20-24,1899,16.973477853324898
STAT,1813,42,20-24,1855,0.7950929868824661
STAT,1850,48,35-39,1898,0.06383434523340492
STAT,1826,37,35-39,1863,11.556866106039934
STAT,1843,34,30-34,1877,20.312738189360072
STAT,1777,104,na,1881,0.0858279754609575
STAT,1923,31,15-19,1954,0.14636375213579414
SIM,1855,8,na,1863,3430
STAT,1847,38,35-39,1885,6.5662979440712705
STAT,1858,75,na,1933,786.1634352809973
STAT,1852,74,na,1926,1117.0997810533295
STAT,1873,19,20-24,1892,18.088040811975823
SIM,1855,38,35-39,1893,1
SIM,1910,14,na,1924,4579
STAT,1894,14,na,1908,3273.437992389593
SIM,1900,36,45-49,1936,2
STAT,1871,35,20-24,1906,0.7762582589262275
STAT,1852,32,30-34,1884,18.196545523586195
STAT,1840,26,30-34,1866,12.452576430068126
SIM,1853,43,50-100,1896,2
STAT,1898,28,na,1926,3197.9015037964537
SIM,1860,32,30-34,1892,1
SIM,1834,37,35-39,1871,22
STAT,1835,35,35-39,1870,6.754926010266609
STAT,1893,20,25-29,1913,72.01436000995562
STAT,1845,42,40-44,1887,1.1365747775929407
STAT,1855,21,45-49,1876,0.5430607030529306
STAT,1781,106,na,1887,0.014286841123608885
SIM,1856,33,na,1889,775
SIM,1874,58,na,1932,2345
STAT,1880,33,20-24,1913,2.7943503374341785
SIM,1870,44,na,1914,1695
SIM,1866,22,25-29,1888,406
STAT,1864,35,30-34,1899,4.891166941799307
STAT,1887,56,na,1943,2244.9704761459434
STAT,1879,21,na,1900,2433.4858845484464
STAT,1867,38,35-39,1905,6.655896657102253
STAT,1898,17,30-34,1915,2.1433030100601758
STAT,1817,53,45-49,1870,0.009623346557407831
STAT,1886,43,40-44,1929,2.3124119269822816
STAT,1861,32,25-29,1893,8.518189749794317
STAT,1932,17,na,1949,4839.967754641372
STAT,1894,31,25-29,1925,13.078324016363206
STAT,1847,29,20-24,1876,12.566184048075252
STAT,1883,42,na,1925,2220.7749775008115
STAT,1891,61,na,1952,2297.914883860103
STAT,1871,17,45-49,1888,0.06558288913875415
STAT,1912,47,25-29,1959,0.05038685457742834
SIM,1837,42,na,1879,1976
STAT,1880,28,25-29,1908,43.760826171517195
STAT,1884,44,45-49,1928,1.4133536746919533
STAT,1803,73,na,1876,379.46586175889695
STAT,1861,25,35-39,1886,8.200093434826316
STAT,1879,40,45-49,1919,1.5508049898721665
STAT,1851,45,45-49,1896,0.1882492861335839
STAT,1819,52,40-44,1871,0.0018490467025667609
STAT,1858,22,25-29,1880,50.15843788798855
SIM,1889,25,30-34,1914,192
STAT,1876,40,20-24,1916,0.16216533025581606
SIM,1949,20,20-24,1969,19
STAT,1933,16,35-39,1949,5.592722623594804
SIM,1894,43,40-44,1937,1
STAT,1922,20,45-49,1942,1.2835345663501452
STAT,1824,63,na,1887,354.72836364986887
SIM,1855,29,20-24,1884,28
STAT,1807,87,na,1894,71.43303556551801
STAT,1798,93,na,1891,12.405242823615836
STAT,1829,47,30-34,1876,0.04477393064588846
SIM,1846,19,na,1865,1431
STAT,1843,50,35-39,1893,0.008628372360917914
SIM,1919,41,45-49,1960,3
STAT,1866,98,na,1964,10.279328076134172
SIM,1875,38,35-39,1913,5
STAT,1827,40,25-29,1867,0.6261016312580475
STAT,1859,43,25-29,1902,0.5052922464783075
STAT,1817,44,30-34,1861,0.8159563351408691
SIM,1941,16,35-39,1957,59
SIM,1924,34,na,1958,5229
SIM,1903,37,25-29,1940,11
STAT,1853,26,40-44,1879,2.7102342806067994
STAT,1862,39,15-19,1901,0.04734776490611434
STAT,1866,94,na,1960,34.65785889250036
STAT,1830,34,20-24,1864,2.4868115716254144
STAT,1886,25,40-44,1911,3.1231018665999706
STAT,1840,19,40-44,1859,0.09214970058828016
STAT,1896,38,30-34,1934,6.990755031341178
STAT,1836,29,45-49,1865,1.0851534275775945
STAT,1859,49,50-100,1908,0.19059637874908197
STAT,1858,40,25-29,1898,0.4953406373499833
SIM,1920,29,25-29,1949,34
STAT,1911,59,na,1970,3233.662788041418
SIM,1861,26,40-44,1887,4
STAT,1884,35,30-34,1919,5.150310662153029
STAT,1917,20,35-39,1937,9.932689418789206
SIM,1916,49,50-100,1965,1
STAT,1855,28,15-19,1883,0.3107413193607183
SIM,1821,37,25-29,1858,11
STAT,1912,29,25-29,1941,63.651490641975926
SIM,1817,45,35-39,1862,5
STAT,1886,49,25-29,1935,0.0584022870801048
STAT,1896,22,45-49,1918,0.9192292611765923
STAT,1830,31,40-44,1861,4.116017484006237
STAT,1928,41,45-49,1969,0.2108578975804814
STAT,1833,71,na,1904,549.1866264565527
STAT,1831,40,15-19,1871,0.013864314079624646
STAT,1818,42,25-29,1860,1.2558331570305674
STAT,1912,15,50-100,1927,0.07522754619373026
STAT,1844,50,25-29,1894,0.003559459108946221
STAT,1807,101,na,1908,0.23136107398997777
STAT,1876,36,35-39,1912,7.184486815926666
STAT,1843,43,45-49,1886,1.5031557710281795
STAT,1869,49,25-29,1918,0.0569095496501866
STAT,1892,19,na,1911,3110.168244854321
STAT,1838,55,na,1893,881.8224439136117
SIM,1936,23,na,1959,3835
STAT,1907,23,30-34,1930,25.909537818164193
STAT,1878,83,na,1961,591.1293646405168
SIM,1875,30,25-29,1905,4
STAT,1873,36,na,1909,2428.345147349456
STAT,1911,27,na,1938,3612.1480368576176
STAT,1947,18,30-34,1965,13.581258223503665
STAT,1881,31,15-19,1912,0.13503194863326368
STAT,1879,46,30-34,1925,0.09958323177423482
STAT,1899,20,20-24,1919,94.68692675915007
SIM,1887,46,30-34,1933,4
SIM,1817,58,na,1875,2170
SIM,1822,36,30-34,1858,2
SIM,1876,69,na,1945,1427
STAT,1835,42,25-29,1877,0.5821735588043981
STAT,1839,32,15-19,1871,0.16281797388006206
STAT,1814,40,15-19,1854,0.0558830111580953
SIM,1884,36,35-39,1920,16
STAT,1829,31,45-49,1860,0.986427107541199
SIM,1905,31,na,1936,3277
STAT,1853,30,25-29,1883,8.35023961990872
STAT,1874,54,30-34,1928,0.005974486799983709
STAT,1933,20,20-24,1953,147.36719180176217
STAT,1857,16,30-34,1873,1.4460506399103754
STAT,1903,36,na,1939,3386.948765752171
STAT,1903,29,30-34,1932,35.490505809555636
SIM,1959,7,na,1966,5267
STAT,1862,33,50-100,1895,0.7771106213135198
STAT,1828,27,45-49,1855,2.3231723520434113
STAT,1848,26,30-34,1874,28.335102379647633
STAT,1895,44,20-24,1939,0.014152765846844866
STAT,1905,15,na,1920,3649.508899446832
STAT,1849,17,35-39,1866,0.5691011792375892
STAT,1854,17,45-49,1871,0.04344794453980104
STAT,1885,21,na,1906,2331.741554104371
STAT,1781,102,na,1883,0.09263617121380385
STAT,1828,53,20-24,1881,7.589638758879567E-4
STAT,1913,46,30-34,1959,0.08613217535166508
STAT,1819,72,na,1891,293.73971155373926
SIM,1865,53,na,1918,1665
STAT,1933,29,50-100,1962,1.3113518586513269
STAT,1841,90,na,1931,87.79409797835062
STAT,1860,21,25-29,1881,48.48972222217467
SIM,1852,32,25-29,1884,20
SIM,1857,17,35-39,1874,1
STAT,1782,94,na,1876,12.871213490661496
STAT,1847,91,na,1938,52.39160371832254
STAT,1924,23,30-34,1947,33.484689521584215
STAT,1834,45,45-49,1879,0.1243587717134691
STAT,1879,22,45-49,1901,0.7153402530368392
SIM,1941,20,20-24,1961,1
SIM,1893,26,35-39,1919,11
STAT,1840,17,15-19,1857,3.025463556986893
SIM,1793,78,na,1871,591
SIM,1923,33,50-100,1956,61
STAT,1891,49,35-39,1940,0.09508605928388272
STAT,1833,53,30-34,1886,0.0025777230511599965
STAT,1890,17,30-34,1907,1.9295499333386161
STAT,1869,44,50-100,1913,1.051656834371949
STAT,1963,1,na,1964,4954.507429700998
SIM,1866,39,na,1905,3116
STAT,1865,8,na,1873,2538.8175944265336
SIM,1912,49,na,1961,4528
SIM,1859,53,na,1912,1707
STAT,1891,30,45-49,1921,2.161665502013406
STAT,1913,39,40-44,1952,1.4441003667367107
STAT,1879,37,na,1916,2416.8552503134397
STAT,1862,37,na,1899,2006.6824072147294
STAT,1903,36,20-24,1939,0.23731638429135682
STAT,1882,6,na,1888,2528.473809494848
STAT,1895,18,45-49,1913,0.08475361113114017
SIM,1831,26,30-34,1857,164
STAT,1839,92,na,1931,38.695058353595456
STAT,1895,39,25-29,1934,3.707771895127965
SIM,1831,57,na,1888,2133
STAT,1907,47,45-49,1954,0.19333474754153432
SIM,1878,48,30-34,1926,2
STAT,1875,46,45-49,1921,0.24302516502875718
STAT,1939,19,35-39,1958,4.1512930245810304
STAT,1819,88,na,1907,31.93111481566718
STAT,1851,27,50-100,1878,0.5915474533538212
STAT,1885,26,35-39,1911,9.516956019831575
SIM,1921,39,40-44,1960,6
STAT,1845,27,45-49,1872,0.670606031793538
STAT,1924,18,35-39,1942,4.935942033004569
SIM,1915,23,30-34,1938,45
STAT,1838,21,45-49,1859,0.38899327968679726
STAT,1860,34,30-34,1894,14.121553556466399
STAT,1809,45,35-39,1854,1.2884153777248177
STAT,1872,41,15-19,1913,0.013891176519166496
SIM,1898,30,20-24,1928,17
STAT,1892,46,45-49,1938,0.16528752800941957
STAT,1907,30,20-24,1937,2.282862672057034
SIM,1913,50,na,1963,2906
STAT,1871,41,na,1912,2315.9946224775354
STAT,1823,102,na,1925,0.23160149382475312
STAT,1899,46,30-34,1945,0.07479255770353696
STAT,1867,36,na,1903,2238.842491891795
STAT,1924,30,20-24,1954,2.8311115916317466
STAT,1849,42,25-29,1891,0.5404101479514324
STAT,1881,27,30-34,1908,23.78047075133777
STAT,1862,50,45-49,1912,0.012538448558166746
SIM,1826,35,35-39,1861,7
STAT,1934,12,na,1946,5323.086392039993
STAT,1937,31,45-49,1968,1.541620746820766
STAT,1811,92,na,1903,25.232500392151284
STAT,1838,45,30-34,1883,0.043615314790727874
SIM,1882,16,30-34,1898,2
STAT,1791,67,na,1858,946.7259040778563
STAT,1885,33,25-29,1918,10.025474564253908
STAT,1899,15,25-29,1914,7.775960207567121
STAT,1874,16,30-34,1890,1.6490193749949227
STAT,1823,52,30-34,1875,0.00893750108045445
STAT,1839,50,45-49,1889,0.013818483322232195
STAT,1821,44,20-24,1865,0.17242064846928776
STAT,1841,16,20-24,1857,25.612689748537914
SIM,1857,21,20-24,1878,11
STAT,1879,29,15-19,1908,0.4620996546968512
STAT,1866,24,25-29,1890,51.92774109140891
STAT,1901,44,45-49,1945,0.14335467944803282
STAT,1888,14,na,1902,2970.9888317264686
STAT,1846,38,15-19,1884,0.03437208053817032
SIM,1836,25,na,1861,2355
SIM,1860,54,na,1914,1914
STAT,1869,31,na,1900,2417.8237925304647
STAT,1893,41,35-39,1934,2.2747192102246117
STAT,1926,26,50-100,1952,1.1870225602244968
SIM,1864,68,na,1932,1174
SIM,1842,31,25-29,1873,109
STAT,1856,19,20-24,1875,14.879782995475884
STAT,1870,22,25-29,1892,57.0700468955916
STAT,1835,32,30-34,1867,16.81859355993602
STAT,1922,27,na,1949,4191.710023634114
SIM,1881,28,35-39,1909,5
STAT,1942,21,25-29,1963,95.77388605820231
STAT,1918,47,20-24,1965,0.011601504602751741
STAT,1845,19,45-49,1864,0.04048745171583678
STAT,1836,34,40-44,1870,4.114145030754702
STAT,1822,32,20-24,1854,7.566770395119005
STAT,1941,18,35-39,1959,4.271601162607077
STAT,1924,3,na,1927,4783.699605808561
SIM,1880,26,25-29,1906,16
STAT,1890,43,30-34,1933,1.3817426894189455
STAT,1867,44,45-49,1911,1.3963121296320105
STAT,1871,32,40-44,1903,4.326063913938139
STAT,1867,30,25-29,1897,9.76460221939032
STAT,1896,40,45-49,1936,0.13838560251518675
STAT,1868,51,25-29,1919,0.003437495819001774
STAT,1903,39,25-29,1942,0.8732759233981877
SIM,1852,19,na,1871,2350
SIM,1875,44,45-49,1919,1
STAT,1880,5,na,1885,2797.521842657579
STAT,1863,22,na,1885,2059.308982049919
STAT,1844,32,25-29,1876,12.134397156186434
STAT,1924,32,50-100,1956,0.9553348920438175
STAT,1933,37,45-49,1970,0.9222462990489132
STAT,1862,16,40-44,1878,0.17947898489348488
STAT,1876,43,25-29,1919,0.6444723039943991
SIM,1890,20,na,1910,3381
SIM,1957,6,na,1963,6080
STAT,1865,22,15-19,1887,3.0485926308170375
STAT,1809,52,25-29,1861,0.029249190840738126
STAT,1875,22,25-29,1897,58.78278362577226
SIM,1841,31,na,1872,928
SIM,1874,24,25-29,1898,2
STAT,1853,49,15-19,1902,3.036794137920074E-4
STAT,1887,44,15-19,1931,0.01499493624993517
STAT,1853,31,50-100,1884,0.7392491391589103
STAT,1903,20,na,1923,3377.2440640196387
STAT,1861,22,30-34,1883,15.218443848961423
STAT,1880,25,20-24,1905,12.261685122247979
STAT,1854,43,20-24,1897,0.08766497325807705
SIM,1848,10,na,1858,2793
STAT,1897,28,20-24,1925,15.525135126246035
SIM,1924,31,25-29,1955,33
STAT,1864,29,20-24,1893,10.588908821433447
SIM,1812,50,na,1862,1720
SIM,1839,34,30-34,1873,5
STAT,1874,49,35-39,1923,0.14147248522179548
STAT,1803,57,na,1860,776.9647033998615
STAT,1887,28,na,1915,2617.5358711734275
STAT,1877,35,40-44,1912,4.485894460995217
STAT,1891,65,na,1956,2104.190034157579
STAT,1812,48,15-19,1860,1.0156610333139366E-4
STAT,1890,25,30-34,1915,30.692213742500307
STAT,1840,29,35-39,1869,4.66940305334385
STAT,1928,28,na,1956,4577.929237253246
SIM,1934,28,na,1962,5190
STAT,1787,93,na,1880,3.2583140077036297
STAT,1873,28,35-39,1901,9.862834375069838
STAT,1823,34,30-34,1857,35.624079206155145
STAT,1858,18,40-44,1876,0.16219973529454804
STAT,1872,21,45-49,1893,0.7003777836206038
SIM,1831,34,30-34,1865,5
STAT,1916,16,35-39,1932,0.880287093687958
STAT,1895,47,25-29,1942,0.042069852975762254
SIM,1821,34,20-24,1855,16
SIM,1930,34,na,1964,5309
STAT,1908,25,40-44,1933,4.439151867718657
STAT,1826,50,35-39,1876,0.012375254746343836
SIM,1882,49,35-39,1931,2
SIM,1860,35,35-39,1895,1
STAT,1808,107,na,1915,0.0011044939822822959
SIM,1800,65,na,1865,216
STAT,1944,19,15-19,1963,48.25746583778125
SIM,1849,22,25-29,1871,2
STAT,1825,40,50-100,1865,1.4509146634811634
STAT,1832,54,na,1886,1817.124841664904
STAT,1857,54,30-34,1911,0.004442146549483417
SIM,1895,36,na,1931,4504
STAT,1836,26,40-44,1862,2.991690221242844
STAT,1809,58,na,1867,2534.859285959358
STAT,1849,53,40-44,1902,0.008728086385846927
STAT,1916,31,25-29,1947,9.450648395440338
STAT,1866,17,35-39,1883,0.5141044005335996
STAT,1939,27,na,1966,3724.62133260859
STAT,1836,52,40-44,1888,0.008162415183449678
STAT,1911,55,na,1966,3330.881170466726
SIM,1839,37,na,1876,998
STAT,1814,73,na,1887,852.0735954182139
STAT,1852,35,35-39,1887,7.308359063311468
STAT,1950,20,20-24,1970,130.7461432722318
STAT,1834,31,25-29,1865,5.8425335306756265
STAT,1890,76,na,1966,1490.278183515648
STAT,1908,21,25-29,1929,84.51550007767916
STAT,1834,89,na,1923,46.29764028259909
STAT,1768,115,na,1883,5.096043229734131E-4
STAT,1898,44,na,1942,3076.5998805866598
STAT,1843,36,50-100,1879,1.4309271801581236
STAT,1844,25,35-39,1869,11.871802341772929
STAT,1901,26,45-49,1927,1.5577702624891399
STAT,1881,71,na,1952,1260.515977370115
STAT,1856,40,na,1896,1676.806740441528
STAT,1838,39,20-24,1877,0.3889009283763201
SIM,1844,26,40-44,1870,147
STAT,1870,15,35-39,1885,0.5588005854733378
STAT,1781,77,na,1858,351.8095545503711
STAT,1906,18,50-100,1924,0.0707578651587975
STAT,1934,28,na,1962,5002.9696821188845
STAT,1900,3,na,1903,3662.198155873136
STAT,1931,34,30-34,1965,20.472887663082645
STAT,1808,52,40-44,1860,0.01353960100339134
SIM,1906,25,30-34,1931,250
STAT,1873,25,30-34,1898,26.0063261702171
STAT,1899,19,40-44,1918,0.24848156464985774
STAT,1853,29,45-49,1882,0.8945873390951172
STAT,1874,19,35-39,1893,0.5632673571946747
STAT,1889,18,20-24,1907,21.293206253249984
STAT,1858,101,na,1959,0.852668220256146
STAT,1869,46,20-24,1915,0.01214336271039189
STAT,1856,27,20-24,1883,8.73142742626474
STAT,1849,32,25-29,1881,9.094219695565972
STAT,1855,37,30-34,1892,3.5273089567949514
SIM,1940,25,30-34,1965,85
STAT,1924,26,35-39,1950,17.37229984393997
SIM,1861,29,45-49,1890,56
STAT,1858,45,30-34,1903,0.07465968186081223
STAT,1871,29,15-19,1900,0.4493533462704766
STAT,1876,33,30-34,1909,17.575684846334937
SIM,1846,39,20-24,1885,5
STAT,1882,29,na,1911,2268.5513559741266
SIM,1903,29,25-29,1932,4
STAT,1831,25,25-29,1856,56.82096881030019
STAT,1872,33,15-19,1905,0.14199951294862173
STAT,1895,15,40-44,1910,0.2390390287844559
STAT,1906,17,30-34,1923,2.308036737436384
STAT,1880,9,na,1889,2710.490030231945
STAT,1864,18,15-19,1882,5.548276210865579
SIM,1903,49,50-100,1952,2
STAT,1793,62,na,1855,799.6220000000001
STAT,1852,27,35-39,1879,11.312542761671542
SIM,1847,56,na,1903,1382
STAT,1792,84,na,1876,141.8895512632909
STAT,1858,7,na,1865,2207.9650456157824
STAT,1803,104,na,1907,0.016825188999740563
STAT,1875,71,na,1946,1370.6429795752083
STAT,1918,29,15-19,1947,0.7358599212207428
SIM,1838,29,20-24,1867,22
SIM,1849,40,25-29,1889,1
STAT,1875,43,40-44,1918,2.292989330535002
SIM,1817,42,30-34,1859,14
STAT,1869,47,na,1916,2259.6894336547743
STAT,1916,23,25-29,1939,95.17532579998168
SIM,1853,7,na,1860,3646
STAT,1938,15,25-29,1953,42.486389598912915
STAT,1888,20,45-49,1908,0.8096252818047233
STAT,1832,27,35-39,1859,11.71547075377082
STAT,1923,12,na,1935,4603.7062784100835
SIM,1937,19,25-29,1956,73
SIM,1936,3,na,1939,4134
SIM,1818,36,40-44,1854,7
STAT,1846,74,na,1920,657.284338992355
STAT,1905,44,30-34,1949,0.11327880833814707
SIM,1875,16,na,1891,3156
STAT,1910,33,na,1943,3590.688760003328
STAT,1799,94,na,1893,1.3290485534050798
STAT,1898,25,30-34,1923,34.09225797328307
STAT,1851,37,na,1888,1880.6595622801383
SIM,1896,39,35-39,1935,7
STAT,1877,27,40-44,1904,3.040857869022366
STAT,1867,51,35-39,1918,0.00818080172803946
STAT,1813,45,25-29,1858,0.22061953088880984
STAT,1848,29,35-39,1877,10.624950933757365
STAT,1880,36,25-29,1916,3.0034378358390468
STAT,1834,42,40-44,1876,1.19504073377073
STAT,1875,32,25-29,1907,10.517641035774085
STAT,1857,24,30-34,1881,14.153840122288894
STAT,1823,77,na,1900,682.84990131504
SIM,1876,41,25-29,1917,8
SIM,1946,13,na,1959,3798
STAT,1929,19,25-29,1948,54.622565608087974
STAT,1836,91,na,1927,44.34960716548346
STAT,1881,54,20-24,1935,6.776895384696689E-4
STAT,1866,47,35-39,1913,0.12719883516542882
STAT,1921,6,na,1927,4514.50291868992
STAT,1939,16,30-34,1955,12.06998091685403
STAT,1899,13,na,1912,3521.8973311563373
SIM,1842,42,40-44,1884,15
STAT,1848,17,20-24,1865,20.56564843354404
STAT,1859,36,35-39,1895,5.632927063759306
STAT,1864,53,30-34,1917,0.005324611933958447
STAT,1880,22,na,1902,2455.28574023252
STAT,1932,25,30-34,1957,51.008372607478776
SIM,1866,70,na,1936,2225
STAT,1882,41,50-100,1923,1.0160344829992471
SIM,1884,20,na,1904,3796
STAT,1828,45,20-24,1873,0.014711453628663973
STAT,1909,45,na,1954,3373.586897801212
STAT,1841,48,40-44,1889,0.18906871027122008
STAT,1905,31,na,1936,3475.6218409680496
STAT,1834,93,na,1927,12.879784901031897
STAT,1849,21,20-24,1870,70.7101583488275
STAT,1850,53,30-34,1903,0.0027045264613618663
SIM,1881,16,na,1897,3187
STAT,1861,50,25-29,1911,0.0029880208761070685
STAT,1917,12,na,1929,4193.138165078352
STAT,1815,42,na,1857,227.70680260694516
STAT,1862,24,40-44,1886,1.7909128469366034
STAT,1818,46,40-44,1864,0.31002120365811053
STAT,1857,31,20-24,1888,2.108812827261499
STAT,1924,15,30-34,1939,14.442190394433828
SIM,1876,53,na,1929,3199
STAT,1895,36,20-24,1931,1.0076025186917532
STAT,1896,19,50-100,1915,0.06423615443303585
STAT,1831,32,15-19,1863,0.1514437296966945
SIM,1918,30,50-100,1948,8
STAT,1830,28,15-19,1858,0.43313084148833964
STAT,1918,22,45-49,1940,1.1971608492205432
STAT,1901,8,na,1909,3634.7250295926115
STAT,1888,39,35-39,1927,8.081149151538835
STAT,1921,27,25-29,1948,72.4872110116358
STAT,1937,21,15-19,1958,5.131845713480108
SIM,1840,16,30-34,1856,11
STAT,1852,43,na,1895,2309.6601709218876
SIM,1940,28,na,1968,4267
STAT,1867,83,na,1950,375.44253584717103
STAT,1908,22,50-100,1930,0.6002359112711918
SIM,1865,27,35-39,1892,75
STAT,1900,17,35-39,1917,0.7601187776392679
SIM,1861,34,40-44,1895,1
STAT,1924,33,25-29,1957,10.672958242330592
STAT,1863,44,50-100,1907,0.8897319287306701
STAT,1814,44,30-34,1858,3.911833408068063
STAT,1840,52,30-34,1892,0.002331366226734577
STAT,1843,35,45-49,1878,2.347648582094237
SIM,1921,21,na,1942,5269
STAT,1825,46,35-39,1871,0.18022790053306606
STAT,1916,37,45-49,1953,0.6885960555863846
SIM,1880,23,20-24,1903,64
SIM,1887,32,na,1919,3782
STAT,1860,32,40-44,1892,3.537859358604756
STAT,1907,50,na,1957,3221.825998081549
STAT,1874,50,50-100,1924,0.015811034340322213
STAT,1863,33,20-24,1896,2.2978962677329653
STAT,1903,18,15-19,1921,8.40209007476329
STAT,1951,15,40-44,1966,1.6509684535450357
STAT,1907,29,50-100,1936,0.9189021145894091
STAT,1851,31,25-29,1882,8.507637687512512
STAT,1860,37,35-39,1897,5.7700339452497404
STAT,1872,28,15-19,1900,0.4527201865340581
STAT,1879,42,15-19,1921,0.014149231943942681
STAT,1919,38,25-29,1957,1.0426710113562636
STAT,1834,37,50-100,1871,0.6730366464719201
STAT,1946,21,45-49,1967,1.2389796530979114
STAT,1858,38,50-100,1896,0.9329329037043418
STAT,1852,37,50-100,1889,1.2425367269758056
STAT,1883,39,35-39,1922,6.735972149650935
STAT,1892,37,35-39,1929,8.756940436816018
SIM,1952,13,na,1965,6372
SIM,1911,18,15-19,1929,154
SIM,1866,40,25-29,1906,4
SIM,1835,71,na,1906,796
STAT,1853,34,40-44,1887,3.391651310614581
STAT,1825,41,na,1866,1703.865111496465
STAT,1922,32,50-100,1954,0.923754578209312
STAT,1915,21,15-19,1936,5.4411646414392445
STAT,1916,27,na,1943,3820.555662805395
SIM,1932,33,25-29,1965,155
STAT,1951,20,35-39,1971,11.152554318141538
SIM,1838,52,na,1890,1642
SIM,1875,47,na,1922,2642
SIM,1835,19,na,1854,1250
SIM,1820,42,na,1862,567
STAT,1881,35,30-34,1916,5.080773642654229
STAT,1918,35,50-100,1953,0.44071399258325816
SIM,1900,52,na,1952,4006
STAT,1809,50,35-39,1859,0.07405203060341682
STAT,1913,42,15-19,1955,0.0014787867114479446
STAT,1912,13,na,1925,3941.012984368633
SIM,1837,73,na,1910,1470
STAT,1857,27,35-39,1884,7.626457252545112
STAT,1937,17,30-34,1954,11.735116990641957
STAT,1825,41,25-29,1866,0.8679469636546876
STAT,1898,49,50-100,1947,0.18240581410852505
STAT,1913,1,na,1914,4202.391517780488
STAT,1851,96,na,1947,6.781678349072735
STAT,1892,71,na,1963,1875.811034517052
STAT,1922,48,25-29,1970,0.06009181005832423
STAT,1911,26,50-100,1937,0.963039075779305
STAT,1876,41,35-39,1917,1.838849073568623
STAT,1840,58,na,1898,778.6880936246735
SIM,1856,22,15-19,1878,2
SIM,1896,28,30-34,1924,26
STAT,1837,43,20-24,1880,0.1483498354490756
SIM,1893,72,na,1965,1380
STAT,1813,56,na,1869,1932.0531882334462
STAT,1849,50,25-29,1899,0.003027359401075115
STAT,1849,55,na,1904,1742.238658469896
STAT,1840,25,na,1865,1077.4844928551286
SIM,1878,17,na,1895,4145
STAT,1861,95,na,1956,12.750849335054461
STAT,1851,36,35-39,1887,5.7048934755401985
STAT,1840,53,20-24,1893,2.858939095660551E-4
STAT,1844,22,30-34,1866,22.03271925956364
SIM,1805,64,na,1869,2097
STAT,1881,47,50-100,1928,0.23085053280712217
SIM,1826,67,na,1893,971
STAT,1923,43,50-100,1966,0.1356506433671258
STAT,1840,34,30-34,1874,8.201408930413725
SIM,1835,44,40-44,1879,14
STAT,1899,47,45-49,1946,0.18098154747198245
SIM,1870,42,40-44,1912,11
STAT,1942,27,45-49,1969,1.7925114909505222
SIM,1818,41,50-100,1859,1
STAT,1869,20,30-34,1889,18.158696884997106
SIM,1862,73,na,1935,2633
SIM,1956,12,na,1968,4927
STAT,1859,47,40-44,1906,0.1350592536528159
STAT,1909,20,25-29,1929,85.482425704106
STAT,1848,22,15-19,1870,3.758912328327425
STAT,1920,32,na,1952,4089.3775777566107
SIM,1889,67,na,1956,2001
STAT,1922,47,35-39,1969,0.1464636532104348
SIM,1912,24,20-24,1936,898
STAT,1862,42,40-44,1904,1.9134418438805465
STAT,1852,105,na,1957,0.04480337380525411
STAT,1890,21,15-19,1911,4.005880164457748
STAT,1836,30,25-29,1866,10.12901790061473
SIM,1909,4,na,1913,4331
STAT,1880,86,na,1966,472.30296821195515
SIM,1939,31,20-24,1970,16
SIM,1851,30,na,1881,1251
STAT,1888,28,30-34,1916,28.961729231231054
STAT,1928,33,50-100,1961,1.0253196130787474
SIM,1893,65,na,1958,1626
STAT,1897,29,50-100,1926,0.8434728623139544
SIM,1843,11,na,1854,813
STAT,1841,19,25-29,1860,8.043001631511878
SIM,1847,25,na,1872,1407
STAT,1858,43,40-44,1901,1.7052834366453116
STAT,1827,44,40-44,1871,2.0779470464598377
STAT,1838,70,na,1908,598.3722043500775
STAT,1837,105,na,1942,0.023510299574225645
STAT,1845,16,40-44,1861,0.11539188092657475
STAT,1908,49,50-100,1957,0.20177811056072248
SIM,1866,43,40-44,1909,10
STAT,1904,42,20-24,1946,0.015736692959567998
STAT,1925,30,35-39,1955,10.764651008752129
STAT,1826,43,45-49,1869,2.2096173919962068
STAT,1912,19,30-34,1931,2.4230207038265625
STAT,1910,34,45-49,1944,1.4874413881110047
STAT,1947,19,na,1966,4099.815272083537
SIM,1820,41,na,1861,689
SIM,1877,20,30-34,1897,1
SIM,1929,30,45-49,1959,122
STAT,1857,49,35-39,1906,0.10518753042965233
SIM,1885,46,na,1931,1215
STAT,1839,36,30-34,1875,5.978902327671872
SIM,1801,75,na,1876,1570
SIM,1892,30,25-29,1922,2
STAT,1894,35,40-44,1929,5.619556341549135
STAT,1889,41,45-49,1930,1.810446483736491
STAT,1918,38,na,1956,3908.010003288399
STAT,1821,47,25-29,1868,0.06160355676513766
STAT,1904,49,40-44,1953,0.13508995447136846
STAT,1931,41,15-19,1972,0.002040076133162234
STAT,1842,16,35-39,1858,0.1759530530589711
STAT,1893,34,45-49,1927,2.162027894901975
STAT,1815,54,25-29,1869,3.3313500907175314E-4
STAT,1837,69,na,1906,1176.7256149921031
STAT,1921,34,20-24,1955,2.659266086751555
STAT,1908,39,na,1947,3460.002183967781
STAT,1834,25,na,1859,1268.2522377636421
STAT,1835,40,35-39,1875,1.6842755451040297
STAT,1896,46,30-34,1942,0.07218394595487158
SIM,1871,54,na,1925,1742
STAT,1855,55,na,1910,1368.4882514541334
SIM,1831,26,na,1857,1782
SIM,1903,26,20-24,1929,147
STAT,1932,28,35-39,1960,19.518463778809704
SIM,1855,39,na,1894,2982
STAT,1877,53,40-44,1930,0.010515242683327347
STAT,1842,38,35-39,1880,2.038425153238005
STAT,1882,45,25-29,1927,0.055696620705757774
STAT,1863,20,50-100,1883,0.3602279574675614
STAT,1912,26,20-24,1938,17.840553644134673
STAT,1892,25,50-100,1917,0.7973723825902861
SIM,1920,26,20-24,1946,89
SIM,1923,28,35-39,1951,35
SIM,1864,25,30-34,1889,9
STAT,1915,28,35-39,1943,15.044041642204887
STAT,1898,26,50-100,1924,0.8631570954203928
STAT,1883,20,45-49,1903,0.6748561680551849
STAT,1921,49,40-44,1970,0.17459901170458947
SIM,1850,55,na,1905,1110
STAT,1856,25,30-34,1881,19.01432718674211
STAT,1916,20,20-24,1936,115.61328341822842
STAT,1797,99,na,1896,0.0189319580582318
SIM,1862,18,na,1880,3726
SIM,1919,27,30-34,1946,1
SIM,1868,27,40-44,1895,15
STAT,1868,45,40-44,1913,0.16700562996139465
SIM,1848,34,25-29,1882,83
STAT,1896,64,na,1960,2412.746731640366
STAT,1892,50,na,1942,2704.206751074166
STAT,1925,25,40-44,1950,5.491869932266996
STAT,1869,25,40-44,1894,3.0432767212708707
STAT,1848,17,na,1865,2662.784540943897
STAT,1888,45,na,1933,2622.572388355847
STAT,1904,24,20-24,1928,97.83865444523053
STAT,1879,40,50-100,1919,1.0946858720669188
STAT,1878,49,15-19,1927,4.0295455179014474E-4
SIM,1867,24,na,1891,2408
STAT,1890,47,25-29,1937,0.039150701244028
STAT,1910,16,45-49,1926,0.09811533014170551
STAT,1865,26,30-34,1891,23.069748082415916
SIM,1849,45,30-34,1894,1
SIM,1790,85,na,1875,101
SIM,1883,35,na,1918,2199
STAT,1833,40,na,1873,1075.0261813926568
STAT,1887,34,20-24,1921,2.94971194699977
STAT,1888,19,15-19,1907,6.812710933574083
SIM,1810,79,na,1889,1727
SIM,1935,34,na,1969,5688
STAT,1858,48,35-39,1906,0.10556963644009844
STAT,1852,40,35-39,1892,1.841135428928002
SIM,1931,20,na,1951,4998
STAT,1904,24,50-100,1928,0.5789612688001993
SIM,1903,29,na,1932,2898
STAT,1812,53,45-49,1865,0.003499481443849577
STAT,1889,23,15-19,1912,3.9604914103749893
STAT,1898,35,25-29,1933,3.908474848187461
STAT,1832,82,na,1914,396.06988504908657
SIM,1862,40,na,1902,3587
STAT,1831,27,15-19,1858,0.5386179464691072
STAT,1858,46,45-49,1904,0.18073646618967848
STAT,1859,40,20-24,1899,0.12714415114193958
SIM,1933,25,40-44,1958,5
STAT,1880,40,35-39,1920,1.898873302019955
SIM,1889,28,35-39,1917,1
STAT,1950,16,35-39,1966,4.915691054181021
STAT,1832,54,25-29,1886,2.724627198006924E-4
STAT,1865,72,na,1937,1153.0117684215545
SIM,1818,44,40-44,1862,1
SIM,1852,74,na,1926,1138
STAT,1898,28,35-39,1926,12.92940385588642
SIM,1869,39,25-29,1908,1
STAT,1849,37,50-100,1886,1.0585528396246175
STAT,1929,22,20-24,1951,139.6292791567258
STAT,1905,40,15-19,1945,0.0013932426831906027
STAT,1903,51,na,1954,3071.1537810550167
STAT,1817,45,45-49,1862,0.1697745756289524
SIM,1924,20,20-24,1944,1470
STAT,1861,30,35-39,1891,8.4898011834545
STAT,1922,40,15-19,1962,0.0017478313557582519
STAT,1886,71,na,1957,1442.4555993199788
STAT,1874,30,45-49,1904,1.814207056561705
STAT,1841,44,25-29,1885,0.7242634396971749
SIM,1871,5,na,1876,2177
STAT,1916,31,na,1947,3867.1734078926734
STAT,1821,41,40-44,1862,2.5811973667605086
STAT,1857,34,25-29,1891,7.792487139290805
STAT,1930,39,40-44,1969,1.9347825681046131
SIM,1915,14,na,1929,3758
STAT,1844,55,na,1899,2048.460866802464
STAT,1940,31,15-19,1971,0.13158116057924
STAT,1929,15,30-34,1944,15.51818270382502
STAT,1816,48,35-39,1864,0.4197448421314063
STAT,1853,54,45-49,1907,0.010943318298016072
SIM,1895,20,na,1915,4562
STAT,1822,46,30-34,1868,0.16413056843000748
SIM,1870,20,25-29,1890,4
STAT,1928,12,na,1940,4954.612916358825
STAT,1852,33,45-49,1885,1.7986404008327872
STAT,1930,32,20-24,1962,3.1257272818564403
STAT,1854,50,35-39,1904,0.004855577280054057
SIM,1860,33,45-49,1893,16
STAT,1820,97,na,1917,3.694555993053636
STAT,1869,16,na,1885,2599.1433491972625
STAT,1837,48,15-19,1885,3.286990978457231E-4
STAT,1884,36,45-49,1920,1.9174945970969854
STAT,1878,44,20-24,1922,0.16119227802443567
STAT,1872,51,na,1923,2166.4112201989915
SIM,1841,19,na,1860,1206
STAT,1853,91,na,1944,44.932082198624
STAT,1856,36,na,1892,1700.3335744107712
STAT,1859,33,30-34,1892,13.780044889991895
STAT,1846,10,na,1856,1798.3561787162998
STAT,1875,16,na,1891,2599.793767063489
SIM,1921,14,na,1935,5331
STAT,1853,37,45-49,1890,1.5457270611802407
STAT,1822,39,40-44,1861,8.225109025932268
STAT,1837,17,45-49,1854,0.06980759648778048
STAT,1862,20,25-29,1882,50.63801893939992
STAT,1897,26,30-34,1923,33.55763791642891
STAT,1852,24,30-34,1876,20.99479688123712
STAT,1849,54,na,1903,1764.3511632126863
STAT,1833,48,35-39,1881,0.06315476845476739
SIM,1924,37,45-49,1961,1
STAT,1887,39,15-19,1926,0.0611857523495665
STAT,1808,46,35-39,1854,0.27181759370990166
STAT,1860,35,45-49,1895,1.6417157345412519
STAT,1863,36,25-29,1899,2.4698365487269855
SIM,1844,55,na,1899,1935
STAT,1839,39,35-39,1878,7.691281501426781
STAT,1835,46,40-44,1881,0.1382983525504091
STAT,1919,35,20-24,1954,0.280995396057879
STAT,1889,27,30-34,1916,30.32467360157922
STAT,1904,45,25-29,1949,0.046882828365759195
STAT,1907,33,25-29,1940,8.545178381785796
STAT,1807,56,na,1863,1231.3032866237024
SIM,1894,6,na,1900,1764
STAT,1843,70,na,1913,1386.3000828988033
STAT,1895,20,na,1915,3094.983548740653
STAT,1831,44,na,1875,1954.921696278952
SIM,1851,37,35-39,1888,1
SIM,1891,36,30-34,1927,9
STAT,1801,78,na,1879,282.85313214425986
STAT,1908,35,na,1943,3528.373756406908
STAT,1792,77,na,1869,439.54553262620334
STAT,1878,21,35-39,1899,6.022072334493455
STAT,1879,38,30-34,1917,5.440175464646641
STAT,1779,112,na,1891,7.756412226679264E-4
SIM,1887,38,30-34,1925,2
STAT,1920,18,15-19,1938,50.130950543682985
SIM,1888,26,30-34,1914,1
STAT,1847,84,na,1931,300.7664327969333
STAT,1845,45,20-24,1890,0.006013969213144883
SIM,1828,38,25-29,1866,1
STAT,1871,38,25-29,1909,2.857879061425724
SIM,1838,38,35-39,1876,19
STAT,1888,82,na,1970,955.5255166160068
STAT,1800,54,30-34,1854,0.03470479844352973
STAT,1930,42,15-19,1972,0.0020063829346331
SIM,1856,40,na,1896,689
SIM,1812,47,25-29,1859,1
STAT,1906,43,30-34,1949,0.1147721226244244
STAT,1934,20,35-39,1954,12.609306395351865
STAT,1826,34,30-34,1860,30.77436853007599
STAT,1836,49,15-19,1885,3.126554344948643E-4
STAT,1902,32,45-49,1934,2.455581407047806
STAT,1893,25,30-34,1918,31.704309169262757
STAT,1853,34,50-100,1887,0.7165756468472755
STAT,1819,41,na,1860,675.9025699979361
STAT,1875,37,35-39,1912,7.262845142277001
STAT,1809,49,50-100,1858,2.066310957564709
STAT,1897,29,35-39,1926,12.722692088670644
STAT,1901,46,15-19,1947,3.163793743798179E-4
STAT,1887,29,25-29,1916,46.227266475950735
SIM,1896,46,na,1942,3239
STAT,1838,104,na,1942,0.028445716143283728
STAT,1896,42,15-19,1938,0.0012626023261964345
STAT,1905,20,45-49,1925,1.0089562406462425
STAT,1913,20,15-19,1933,5.123877294661812
STAT,1843,32,40-44,1875,5.15123641246372
SIM,1935,13,na,1948,5853
STAT,1851,40,50-100,1891,0.8427970288242054
SIM,1939,27,na,1966,4703
SIM,1851,32,40-44,1883,1
SIM,1959,3,na,1962,5267
STAT,1883,36,30-34,1919,5.1519619394120335
STAT,1835,33,45-49,1868,1.662436522518877
STAT,1922,44,30-34,1966,0.1446213787887661
SIM,1817,49,50-100,1866,2
SIM,1937,4,na,1941,2988
STAT,1882,15,30-34,1897,1.5330769165148246
STAT,1912,44,20-24,1956,0.016704714039576258
STAT,1921,17,na,1938,4145.837662010336
STAT,1830,37,25-29,1867,2.626201820888252
STAT,1869,16,50-100,1885,0.050418358656826874
SIM,1826,63,na,1889,1287
STAT,1835,26,50-100,1861,0.6353659382321818
SIM,1857,37,50-100,1894,33
SIM,1907,35,40-44,1942,1
STAT,1816,45,30-34,1861,0.30303016583613607
STAT,1867,35,30-34,1902,5.088210670626906
STAT,1850,53,50-100,1903,0.0068618976982912985
STAT,1883,51,50-100,1934,0.014599015516798583
STAT,1933,23,25-29,1956,121.65169133167355
STAT,1837,46,25-29,1883,0.04856120839845011
SIM,1930,35,na,1965,5318
STAT,1899,6,na,1905,3568.1333918636747
STAT,1817,47,35-39,1864,0.09807888934467784
STAT,1827,47,45-49,1874,0.21606410881029625
SIM,1856,26,30-34,1882,8
STAT,1850,18,35-39,1868,0.30779392875984407
STAT,1945,25,20-24,1970,19.822442325574258
SIM,1827,52,na,1879,1988
STAT,1909,36,50-100,1945,0.3952556779415295
SIM,1923,28,na,1951,3052
SIM,1845,77,na,1922,553
STAT,1857,46,30-34,1903,0.07449148220677189
STAT,1894,38,45-49,1932,2.5224606178947915
STAT,1884,38,35-39,1922,6.737129757058368
SIM,1847,39,35-39,1886,1
SIM,1890,42,20-24,1932,1
STAT,1910,31,40-44,1941,3.746313725637318
STAT,1859,17,na,1876,2111.8848657055673
STAT,1813,63,na,1876,1596.005909955608
STAT,1882,57,na,1939,1924.0413366571572
SIM,1892,38,35-39,1930,5
STAT,1817,77,na,1894,273.8302934604353
STAT,1883,35,na,1918,2288.0775214935243
STAT,1936,2,na,1938,3876.7407013909333
SIM,1906,21,15-19,1927,28
STAT,1861,36,40-44,1897,3.6580414010516558
STAT,1840,96,na,1936,3.3810358507649667
STAT,1847,18,15-19,1865,6.657263784957582
SIM,1916,46,na,1962,4553
SIM,1881,19,20-24,1900,182
STAT,1901,65,na,1966,2620.6280986365896
STAT,1863,47,30-34,1910,0.0822540813922848
STAT,1899,44,40-44,1943,0.21046102576549575
SIM,1832,26,na,1858,2011
STAT,1840,30,15-19,1870,0.06973053974655806
STAT,1914,41,15-19,1955,0.0015026888573007595
STAT,1856,28,35-39,1884,7.129894598251174
STAT,1864,32,na,1896,2169.4100558147393
STAT,1834,36,35-39,1870,3.917777424924321
STAT,1846,28,25-29,1874,30.090897542077233
STAT,1863,43,15-19,1906,0.011704455738654215
SIM,1865,39,40-44,1904,2
STAT,1782,105,na,1887,0.06547700999626241
STAT,1936,33,15-19,1969,0.12350277250360107
SIM,1898,16,na,1914,4409
STAT,1812,78,na,1890,61.87731448913213
STAT,1896,49,na,1945,2904.4206943970694
STAT,1870,40,25-29,1910,0.6466473470597633
STAT,1885,30,20-24,1915,2.6783269616905954
STAT,1955,15,25-29,1970,57.05557795089125
SIM,1876,32,na,1908,3825
STAT,1884,30,25-29,1914,9.883776081152886
STAT,1923,21,50-100,1944,0.7598386085079979
STAT,1821,38,15-19,1859,0.06746461940758045
STAT,1842,35,30-34,1877,1.5845922283846627
STAT,1882,18,35-39,1900,0.523963372963912
STAT,1842,44,na,1886,578.5921025432901
STAT,1803,105,na,1908,0.007396184832395953
STAT,1893,21,15-19,1914,4.137976631288746
STAT,1935,29,15-19,1964,0.9544369572887597
STAT,1911,28,na,1939,3599.43327576788
STAT,1855,41,15-19,1896,0.009181204553449201
STAT,1866,42,25-29,1908,0.5854512832376589
STAT,1881,19,50-100,1900,0.04601725948001745
SIM,1813,60,na,1873,35
SIM,1897,31,na,1928,2274
STAT,1883,29,40-44,1912,2.861264661259068
STAT,1921,40,45-49,1961,0.18574531512708845
SIM,1825,41,na,1866,454
STAT,1876,34,45-49,1910,1.747751095475847
STAT,1816,38,40-44,1854,17.049905216227142
STAT,1839,27,20-24,1866,13.73066250575874
SIM,1936,2,na,1938,4134
STAT,1930,17,25-29,1947,55.63223154600389
STAT,1929,18,35-39,1947,5.3036865040344345
SIM,1828,37,na,1865,1763
SIM,1898,71,na,1969,3069
STAT,1868,34,50-100,1902,0.8773980766837987
SIM,1849,36,na,1885,2281
SIM,1944,27,na,1971,2488
STAT,1860,73,na,1933,968.9593171117554
STAT,1855,45,30-34,1900,0.0647044787849416
STAT,1798,62,na,1860,1360.7730573497884
STAT,1890,44,20-24,1934,0.18966505869062156
SIM,1831,41,na,1872,2131
SIM,1875,43,na,1918,2857
STAT,1908,30,35-39,1938,8.627973205799961
SIM,1833,41,25-29,1874,2
STAT,1864,54,50-100,1918,0.013352436461623991
STAT,1964,2,na,1966,4907.876625076578
STAT,1864,54,20-24,1918,6.523992014795713E-4
STAT,1876,47,40-44,1923,0.1722606055882377
STAT,1928,31,15-19,1959,0.15955193946039703
SIM,1796,70,na,1866,846
SIM,1908,32,na,1940,2634
STAT,1886,17,40-44,1903,0.18940528032151674
STAT,1940,0,na,1940,4504.393658790449
STAT,1869,28,45-49,1897,1.1164430040428293
SIM,1848,31,20-24,1879,1
STAT,1838,37,30-34,1875,2.74524888418349
SIM,1848,14,na,1862,2793
STAT,1886,46,20-24,1932,0.012461883102036138
STAT,1877,31,25-29,1908,10.43996673373178
SIM,1917,20,25-29,1937,1
STAT,1907,26,35-39,1933,14.127035686635908
STAT,1868,48,45-49,1916,0.2250813790667236
STAT,1899,49,35-39,1948,0.10561267149329354
STAT,1899,23,25-29,1922,77.9483017595904
SIM,1916,30,35-39,1946,12
STAT,1878,15,50-100,1893,0.050640431343246875
SIM,1954,6,na,1960,5556
STAT,1865,17,na,1882,2376.1424209342613
STAT,1892,32,25-29,1924,12.68130522981387
STAT,1878,47,25-29,1925,0.058986580716688435
STAT,1915,25,30-34,1940,39.66813585093163
STAT,1872,18,25-29,1890,5.659565879402717
SIM,1866,91,na,1957,287
STAT,1823,53,20-24,1876,0.0010861236282204926
STAT,1889,20,na,1909,2865.043786316115
STAT,1865,29,35-39,1894,8.746423158469193
SIM,1879,39,35-39,1918,50
STAT,1829,62,na,1891,667.4316180289887
STAT,1947,20,45-49,1967,1.259126937516886
STAT,1909,39,15-19,1948,0.01781055211327809
STAT,1929,25,25-29,1954,82.10877913811102
STAT,1959,6,na,1965,5096.300171520658
SIM,1867,17,na,1884,2548
STAT,1930,35,25-29,1965,1.2774806686869964
STAT,1904,27,25-29,1931,60.43586800402367
STAT,1839,24,50-100,1863,0.47983033108529827
STAT,1822,42,15-19,1864,0.024621287387368063
SIM,1825,42,40-44,1867,7
STAT,1848,40,45-49,1888,1.4350985758255685
SIM,1904,14,na,1918,4192
STAT,1913,50,na,1963,3508.882940089535
STAT,1927,36,50-100,1963,0.5182254430567147
SIM,1858,51,35-39,1909,1
STAT,1902,14,na,1916,3624.8141412630125
STAT,1862,19,45-49,1881,0.0573060118147484
SIM,1807,60,na,1867,760
STAT,1899,41,25-29,1940,0.06118330588698329
SIM,1928,31,na,1959,4607
SIM,1953,1,na,1954,4746
STAT,1841,17,35-39,1858,0.7880596060179403
STAT,1865,51,50-100,1916,0.01385464897216243
STAT,1948,24,30-34,1972,32.640770208737955
STAT,1881,53,30-34,1934,0.00553102118437737
STAT,1865,17,20-24,1882,16.679368579439874
STAT,1914,22,50-100,1936,0.6628938236303242
STAT,1830,59,na,1889,1407.974243707089
STAT,1909,24,na,1933,3488.7018488761996
SIM,1892,33,40-44,1925,64
SIM,1814,78,na,1892,23
STAT,1873,43,na,1916,2353.696359015041
STAT,1843,37,35-39,1880,8.158294749562057
STAT,1817,42,40-44,1859,1.6508234792296557
STAT,1864,27,30-34,1891,22.89301995721368
STAT,1867,37,50-100,1904,1.1611132411129432
STAT,1852,20,15-19,1872,4.002169677459461
STAT,1885,23,30-34,1908,17.454470801889084
STAT,1927,37,20-24,1964,0.32507622697889055
SIM,1890,21,na,1911,2522
STAT,1884,33,40-44,1917,4.1339000117855775
STAT,1937,32,50-100,1969,0.809534313823377
STAT,1821,82,na,1903,235.63211518877105
STAT,1822,35,25-29,1857,6.343924634712121
STAT,1923,13,na,1936,4596.570533678548
STAT,1880,45,50-100,1925,0.257512681860234
STAT,1959,11,na,1970,5093.141247599721
STAT,1864,37,20-24,1901,0.7007834652252204
SIM,1961,9,na,1970,4644
STAT,1788,88,na,1876,18.61687561150963
STAT,1872,26,na,1898,2397.9689947354427
STAT,1873,21,15-19,1894,3.394288435162069
SIM,1920,45,na,1965,3607
SIM,1859,26,35-39,1885,7
STAT,1815,46,25-29,1861,0.005916608117478152
STAT,1832,43,20-24,1875,0.014110021733566507
STAT,1901,28,na,1929,3325.127245987539
STAT,1893,23,40-44,1916,2.5978088102411614
STAT,1914,45,30-34,1959,0.08759190279721914
SIM,1909,24,35-39,1933,314
STAT,1875,34,30-34,1909,17.775052559859304
STAT,1866,50,25-29,1916,0.003279678320067934
STAT,1927,33,na,1960,4611.618548253628
STAT,1882,37,25-29,1919,2.7565729167822197
SIM,1869,74,na,1943,3598
STAT,1900,32,25-29,1932,14.188930471786858
STAT,1857,6,na,1863,2250.0599004711653
STAT,1838,33,15-19,1871,0.07475884980601535
STAT,1807,60,na,1867,1137.5238991333536
STAT,1932,36,35-39,1968,3.230165313471103
SIM,1926,21,30-34,1947,21
STAT,1826,32,40-44,1858,8.601725181945937
STAT,1850,34,25-29,1884,4.8459884415134065
STAT,1870,20,35-39,1890,5.852294437949541
STAT,1937,32,20-24,1969,2.388244939658956
STAT,1876,26,45-49,1902,1.1262661746634202
STAT,1803,94,na,1897,5.041519166179566
STAT,1820,76,na,1896,651.5409516881606
SIM,1857,55,na,1912,1397
SIM,1941,8,na,1949,3904
STAT,1811,99,na,1910,1.147363098041524
STAT,1857,52,25-29,1909,0.0027035347192948347
STAT,1828,41,50-100,1869,1.343376670675647
STAT,1851,17,40-44,1868,0.17563141749122207
STAT,1846,49,20-24,1895,0.006958739166242574
SIM,1931,36,25-29,1967,3
STAT,1946,25,25-29,1971,72.59043932364013
SIM,1846,26,25-29,1872,174
STAT,1824,44,25-29,1868,0.11029844294200013
STAT,1952,10,na,1962,4665.63716204044
SIM,1840,43,20-24,1883,12
SIM,1912,16,na,1928,4794
STAT,1835,49,45-49,1884,0.18345648611817486
STAT,1914,38,25-29,1952,0.9645924977315347
STAT,1883,28,50-100,1911,0.6132454605222056
STAT,1923,36,25-29,1959,1.1298776722262898
SIM,1799,60,na,1859,1306
SIM,1894,51,na,1945,1272
SIM,1858,8,na,1866,2591
STAT,1837,20,35-39,1857,6.214160725311496
STAT,1820,42,na,1862,1877.9408030567697
SIM,1895,29,na,1924,4563
SIM,1842,33,30-34,1875,33
STAT,1884,15,50-100,1899,0.04711647078916464
SIM,1924,35,40-44,1959,4
SIM,1867,25,30-34,1892,67
STAT,1786,77,na,1863,635.3179986396023
SIM,1920,35,na,1955,3773
STAT,1866,48,50-100,1914,0.2213713425230456
SIM,1882,56,na,1938,1326
STAT,1841,36,25-29,1877,3.8169313414293335
STAT,1931,35,20-24,1966,0.3472633048036771
STAT,1833,108,na,1941,7.536392284531752E-4
STAT,1943,27,50-100,1970,1.0479565052699735
SIM,1866,32,na,1898,3171
STAT,1929,33,25-29,1962,11.650683148557931
STAT,1861,58,na,1919,1644.6550169412324
STAT,1821,43,45-49,1864,1.6551152278843322
SIM,1862,42,45-49,1904,13
STAT,1837,43,50-100,1880,0.9868488865666688
STAT,1918,21,30-34,1939,30.672430574636145
STAT,1845,34,na,1879,1252.4068600328162
STAT,1907,29,na,1936,3458.42781346251
STAT,1904,16,20-24,1920,25.390888414896285
STAT,1942,16,na,1958,3803.6610031125133
STAT,1834,33,30-34,1867,9.754585922621269
SIM,1787,75,na,1862,365
STAT,1885,24,45-49,1909,0.6811408709471294
STAT,1827,29,15-19,1856,0.48998597119520537
STAT,1890,17,na,1907,3057.5171365604533
STAT,1929,17,20-24,1946,171.8097295770459
SIM,1874,37,na,1911,2435
SIM,1870,37,na,1907,1989
STAT,1852,22,40-44,1874,2.491775599316996
STAT,1884,39,50-100,1923,1.163455545311937
SIM,1905,48,35-39,1953,1
STAT,1886,20,30-34,1906,18.5555680039156
SIM,1889,31,45-49,1920,25
STAT,1883,73,na,1956,1175.2181266052655
SIM,1916,7,na,1923,4952
SIM,1941,13,na,1954,3876
STAT,1801,93,na,1894,9.69546996020078
STAT,1877,16,35-39,1893,0.5583738322125747
STAT,1917,25,45-49,1942,1.7997177051270803
STAT,1776,105,na,1881,0.03918467439488488
STAT,1905,17,35-39,1922,0.7892196293925422
STAT,1820,53,40-44,1873,0.015655406851902753
STAT,1916,35,40-44,1951,1.5264504294494163
SIM,1937,17,20-24,1954,1165
STAT,1835,25,45-49,1860,1.1107690984752867
SIM,1878,9,na,1887,4386
SIM,1936,27,30-34,1963,2
STAT,1892,40,25-29,1932,0.8030730099855858
STAT,1928,25,20-24,1953,22.469071573647053
STAT,1845,24,na,1869,1298.2863457825076
STAT,1940,15,na,1955,3697.247874507682
STAT,1915,48,na,1963,3639.4976830157943
STAT,1829,33,20-24,1862,1.454159287641528
STAT,1881,29,20-24,1910,10.999389201918481
STAT,1943,5,na,1948,4178.7611326170845
STAT,1832,61,na,1893,1586.2369175703968
STAT,1874,42,15-19,1916,0.014235115301527186
SIM,1897,3,na,1900,3075
STAT,1879,27,25-29,1906,43.39448296269535
STAT,1896,24,20-24,1920,90.27373304594893
STAT,1910,36,15-19,1946,0.01824792131393575
STAT,1903,29,na,1932,3363.4840012053996
STAT,1924,37,40-44,1961,1.74825938447792
SIM,1861,19,15-19,1880,17
STAT,1892,18,40-44,1910,0.22585784612287993
SIM,1880,6,na,1886,3342
STAT,1895,19,20-24,1914,22.938878815481136
STAT,1942,10,na,1952,4076.0828917658814
STAT,1786,108,na,1894,0.0018041630140290333
STAT,1954,18,25-29,1972,53.081866483634414
SIM,1880,21,na,1901,3265
STAT,1918,17,45-49,1935,0.10761500389489775
STAT,1870,52,40-44,1922,0.010439490384601697
STAT,1863,25,20-24,1888,10.160667593310405
STAT,1865,42,20-24,1907,0.1448163671542857
STAT,1934,17,45-49,1951,0.6711048139702819
STAT,1937,18,25-29,1955,41.61287628558249
STAT,1818,46,50-100,1864,0.44475004417538083
SIM,1876,2,na,1878,5328
SIM,1797,65,na,1862,1360
SIM,1899,29,na,1928,2041
STAT,1852,81,na,1933,544.3270228635276
SIM,1822,38,20-24,1860,6
STAT,1856,102,na,1958,0.35910421925981156
STAT,1864,16,25-29,1880,5.891045135816675
SIM,1886,19,20-24,1905,3
SIM,1817,59,na,1876,2170
SIM,1878,34,20-24,1912,17
STAT,1881,16,25-29,1897,5.364505384881587
SIM,1868,31,25-29,1899,45
STAT,1862,44,45-49,1906,1.2575431089273843
SIM,1853,69,na,1922,2333
SIM,1914,35,na,1949,5006
STAT,1853,19,15-19,1872,5.470390528023277
STAT,1885,15,30-34,1900,1.573972033229668
SIM,1852,30,35-39,1882,16
STAT,1890,21,na,1911,2871.789116236176
SIM,1821,64,na,1885,1753
STAT,1868,90,na,1958,107.70305627621401
STAT,1887,35,na,1922,2617.7884665973734
STAT,1918,30,45-49,1948,1.6628473192095508
STAT,1802,57,na,1859,1502.5908848990077
STAT,1810,76,na,1886,28.138809952890735
STAT,1879,48,20-24,1927,0.01215540202522459
STAT,1885,6,na,1891,2567.81493327185
STAT,1874,21,na,1895,2448.25671728534
STAT,1905,24,25-29,1929,81.8220915474624
STAT,1907,13,na,1920,3762.2903599701203
STAT,1927,43,na,1970,4612.572394584314
STAT,1880,32,45-49,1912,1.810356772862519
STAT,1853,48,50-100,1901,0.18804263569425614
STAT,1859,28,35-39,1887,7.723817710119921
STAT,1828,28,20-24,1856,21.886596979598114
STAT,1909,19,45-49,1928,0.09644475626623611
STAT,1933,35,40-44,1968,2.028671212833314
STAT,1820,38,45-49,1858,3.5317427114256916
STAT,1884,16,40-44,1900,0.17551806837755643
SIM,1926,20,na,1946,5102
STAT,1918,8,na,1926,4282.600287601829
STAT,1813,41,45-49,1854,9.323251815275931
SIM,1832,44,25-29,1876,6
SIM,1912,10,na,1922,4883
SIM,1925,40,40-44,1965,1
STAT,1925,27,45-49,1952,2.021839928889211
STAT,1844,30,35-39,1874,12.24928215584265
STAT,1932,40,20-24,1972,0.023834976311756923
STAT,1923,38,35-39,1961,2.770286003263176
STAT,1914,3,na,1917,4123.824090576468
STAT,1790,82,na,1872,226.91437730499626
STAT,1843,15,40-44,1858,0.23368786596126748
STAT,1908,27,45-49,1935,1.6342802373784175
SIM,1845,18,20-24,1863,115
STAT,1833,41,15-19,1874,0.007286565113999667
SIM,1916,1,na,1917,4952
STAT,1891,35,25-29,1926,3.5742573493955376
STAT,1858,29,45-49,1887,0.8555706583884138
STAT,1863,43,na,1906,1958.8803238097616
STAT,1838,26,25-29,1864,23.136307503910636
STAT,1902,51,na,1953,3046.59602745217
STAT,1862,36,na,1898,2016.340679067462
STAT,1845,22,35-39,1867,3.594780599536455
SIM,1856,18,na,1874,1074
STAT,1925,14,na,1939,4727.2627529090305
STAT,1868,23,30-34,1891,17.151203699618552
SIM,1831,36,20-24,1867,1
SIM,1926,30,na,1956,5872
STAT,1861,54,40-44,1915,0.008514482079290557
SIM,1894,41,na,1935,1457
STAT,1854,18,20-24,1872,11.722320967073491
STAT,1798,78,na,1876,473.0726706891161
STAT,1833,39,na,1872,1078.3687400445863
STAT,1886,16,na,1902,2621.8151277874135
STAT,1861,23,45-49,1884,0.5914993541539392
STAT,1860,33,40-44,1893,3.5229295921114434
STAT,1837,18,20-24,1855,18.834194819506223
STAT,1905,21,50-100,1926,0.5883041153173267
SIM,1932,30,na,1962,6257
STAT,1856,47,25-29,1903,0.04117852878433654
SIM,1925,22,25-29,1947,3
SIM,1906,16,na,1922,3572
SIM,1916,27,45-49,1943,146
STAT,1844,23,45-49,1867,0.8563516310622219
STAT,1937,25,30-34,1962,37.83293193564694
SIM,1876,23,30-34,1899,2
STAT,1899,20,na,1919,3249.61660024379
STAT,1960,1,na,1961,5081.982801766704
STAT,1874,90,na,1964,192.22493955845462
STAT,1802,105,na,1907,0.01485582125820868
STAT,1913,13,na,1926,3981.052268746823
STAT,1942,25,40-44,1967,4.840351426954794
STAT,1943,15,45-49,1958,0.5239572473843112
STAT,1823,36,20-24,1859,1.454535490711139
STAT,1890,27,20-24,1917,14.202180195690593
STAT,1868,30,20-24,1898,2.6317916948340923
STAT,1913,16,30-34,1929,2.4668785331169993
SIM,1865,54,na,1919,1665
STAT,1871,50,35-39,1921,0.008711324051975715
STAT,1850,41,15-19,1891,0.006405703568933344
STAT,1877,54,50-100,1931,0.014909512961786721
STAT,1902,41,na,1943,3280.6134204987616
SIM,1886,22,na,1908,3141
STAT,1829,52,50-100,1881,0.006142796767703408
STAT,1855,26,25-29,1881,29.392851162770718
STAT,1917,22,25-29,1939,96.86099305834931
STAT,1919,14,na,1933,4306.496521116559
SIM,1945,25,30-34,1970,15
STAT,1869,53,45-49,1922,0.014409085525507574
STAT,1948,20,15-19,1968,6.053706656097261
STAT,1864,23,15-19,1887,3.025511786222126
STAT,1903,17,15-19,1920,8.42416137757253
STAT,1833,49,na,1882,961.6097702874785
STAT,1848,76,na,1924,886.5562320979191
STAT,1914,46,50-100,1960,0.2217461620755664
STAT,1855,48,35-39,1903,0.09149286644573486
SIM,1922,22,25-29,1944,28
STAT,1838,47,20-24,1885,0.005270075012943229
SIM,1867,41,35-39,1908,2
SIM,1929,25,15-19,1954,14
STAT,1871,72,na,1943,1259.7927664651825
SIM,1807,59,na,1866,1094
STAT,1827,39,na,1866,1947.4223124119392
STAT,1892,34,30-34,1926,21.43169425737777
STAT,1879,24,20-24,1903,70.25063035636273
STAT,1899,27,40-44,1926,4.091542755224783
STAT,1904,46,na,1950,3224.0637991926296
STAT,1914,48,35-39,1962,0.125738529900405
STAT,1840,54,20-24,1894,2.825689633978019E-4
STAT,1835,20,15-19,1855,3.3661821422120854
STAT,1856,21,15-19,1877,2.7718963362678597
STAT,1806,52,50-100,1858,0.03995194560238174
STAT,1845,20,25-29,1865,35.77642692689447
STAT,1944,21,50-100,1965,0.7026814313768537
STAT,1825,43,30-34,1868,1.5041795917543193
STAT,1814,47,35-39,1861,0.4786063626746494
SIM,1915,49,20-24,1964,1
STAT,1846,33,20-24,1879,1.8723402002294127
SIM,1805,49,25-29,1854,1
STAT,1905,48,25-29,1953,0.046145556647158366
STAT,1873,73,na,1946,1218.3724749882963
STAT,1906,36,25-29,1942,0.9042344005623203
STAT,1899,43,50-100,1942,0.09947916675340226
SIM,1850,17,na,1867,2299
STAT,1881,38,35-39,1919,6.646168268710662
STAT,1876,87,na,1963,336.3477728827904
STAT,1840,34,50-100,1874,0.4303909559025284
SIM,1833,43,30-34,1876,1
STAT,1911,21,45-49,1932,1.0582739808957067
STAT,1839,24,na,1863,2515.8476936969323
STAT,1871,18,20-24,1889,17.694362404836433
STAT,1909,31,30-34,1940,14.94248051895516
STAT,1904,22,15-19,1926,4.713302216427105
STAT,1824,41,20-24,1865,0.02688796242641776
STAT,1944,20,45-49,1964,1.202017928324781
STAT,1851,58,na,1909,1561.8918042588573
STAT,1917,43,na,1960,3818.0210452412894
STAT,1877,20,20-24,1897,70.37186302438818
STAT,1785,108,na,1893,5.966116122467447E-4
STAT,1836,22,25-29,1858,57.892280214609556
STAT,1831,75,na,1906,805.7085380688816
STAT,1932,33,30-34,1965,20.78560714926461
STAT,1861,88,na,1949,114.17093097292735
STAT,1883,50,25-29,1933,0.0034565376021454763
SIM,1892,22,na,1914,3671
STAT,1838,48,na,1886,974.5573029316706
STAT,1818,93,na,1911,17.788219208983865
STAT,1937,19,20-24,1956,130.14157703917155
STAT,1897,15,50-100,1912,0.06536605525460293
STAT,1839,65,na,1904,1570.0868778453137
STAT,1929,30,20-24,1959,3.0800425543944256
STAT,1931,31,50-100,1962,1.0763813344356825
SIM,1864,21,15-19,1885,6
SIM,1913,24,25-29,1937,983
STAT,1877,73,na,1950,1205.7118917255534
SIM,1867,28,35-39,1895,9
STAT,1786,102,na,1888,0.16728774456511503
STAT,1952,16,na,1968,4371.846386619884
STAT,1872,39,20-24,1911,0.7641281291215545
SIM,1930,21,20-24,1951,3
SIM,1881,27,20-24,1908,10
STAT,1858,90,na,1948,60.207726368094654
SIM,1880,39,20-24,1919,2
STAT,1812,51,40-44,1863,0.002642797486613145
STAT,1872,15,20-24,1887,18.022712368057153
SIM,1873,3,na,1876,3414
STAT,1888,72,na,1960,1612.5145721351203
STAT,1903,35,45-49,1938,0.6165831225389611
STAT,1834,43,40-44,1877,1.1798278652298284
STAT,1914,22,25-29,1936,93.05702524061043
SIM,1853,20,25-29,1873,180
STAT,1928,28,25-29,1956,80.43468825362493
STAT,1840,37,35-39,1877,3.293968089986667
SIM,1908,11,na,1919,2882
STAT,1875,44,40-44,1919,2.2784976379660207
STAT,1943,16,40-44,1959,1.4667138792710352
STAT,1828,52,45-49,1880,0.01673102254091245
STAT,1918,28,15-19,1946,0.7385482368027049
STAT,1900,19,40-44,1919,0.25201415341103145
STAT,1898,31,45-49,1929,2.354529925070301
STAT,1895,54,na,1949,2724.045685262054
STAT,1864,31,15-19,1895,0.1299927628534797
STAT,1906,38,35-39,1944,2.199701364314272
SIM,1877,21,25-29,1898,1
STAT,1891,32,20-24,1923,3.3240290471557
STAT,1779,95,na,1874,3.967773235853044
STAT,1872,20,na,1892,2382.394522921444
STAT,1813,108,na,1921,0.0013417852456615168
STAT,1834,50,30-34,1884,0.0027985688957825987
SIM,1868,30,30-34,1898,127
STAT,1897,59,na,1956,2603.424116321335
SIM,1826,30,40-44,1856,11
STAT,1848,26,50-100,1874,0.7197927681689504
SIM,1914,38,35-39,1952,1
STAT,1816,92,na,1908,35.16153712829685
STAT,1926,19,45-49,1945,0.6039545925669776
STAT,1865,88,na,1953,125.33869175039509
SIM,1832,36,na,1868,2165
SIM,1846,23,20-24,1869,371
STAT,1909,24,40-44,1933,3.0738428492416605
STAT,1861,53,45-49,1914,0.011875363825597817
STAT,1886,23,35-39,1909,6.0242593090963075
SIM,1893,31,35-39,1924,2
SIM,1824,62,na,1886,1811
STAT,1875,40,25-29,1915,0.6660539661713499
STAT,1891,42,15-19,1933,0.016961436432075667
STAT,1889,48,50-100,1937,0.16473570328125886
STAT,1848,49,40-44,1897,0.1568596535495127
STAT,1895,43,45-49,1938,0.13422272009611258
STAT,1842,41,25-29,1883,0.1670555559118903
STAT,1808,53,40-44,1861,0.013242086663932624
STAT,1847,54,20-24,1901,6.488188198458682E-4
SIM,1936,28,25-29,1964,232
SIM,1812,43,na,1855,1925
STAT,1921,16,20-24,1937,153.08101163762618
STAT,1832,23,na,1855,2404.166120549565
SIM,1873,45,25-29,1918,1
STAT,1907,49,20-24,1956,0.009722390640163132
STAT,1865,45,25-29,1910,0.05311256770804455
STAT,1903,16,50-100,1919,0.06971532378345188
STAT,1885,31,35-39,1916,9.995072992995427
STAT,1869,21,25-29,1890,57.93990871169453
STAT,1853,1,na,1854,2961.0
STAT,1935,21,30-34,1956,38.86961214692383
SIM,1847,35,na,1882,1569
SIM,1827,32,35-39,1859,1
SIM,1880,37,na,1917,3291
STAT,1874,86,na,1960,344.8626043797773
SIM,1914,36,25-29,1950,4
STAT,1851,33,30-34,1884,14.204194530617432
STAT,1886,21,25-29,1907,59.459672458756735
STAT,1931,38,25-29,1969,1.293512224540345
STAT,1885,21,40-44,1906,2.0544624943149437
STAT,1924,41,25-29,1965,0.08424434242438023
SIM,1830,31,na,1861,927
STAT,1938,23,25-29,1961,90.40940341433107
STAT,1868,21,na,1889,2300.8516408994433
STAT,1879,54,50-100,1933,0.01506695484393837
SIM,1852,56,na,1908,1806
STAT,1814,42,na,1856,2190.353409462799
STAT,1866,28,40-44,1894,2.7247816778421763
SIM,1875,84,na,1959,542
STAT,1896,49,35-39,1945,0.1019291170846132
STAT,1818,40,35-39,1858,3.738839966219781
STAT,1855,24,na,1879,1629.5229608311158
SIM,1859,20,na,1879,2218
STAT,1880,55,na,1935,2146.6060445183207
SIM,1884,51,na,1935,3654
SIM,1919,29,20-24,1948,24
STAT,1816,51,25-29,1867,0.010573441176823689
SIM,1895,67,na,1962,4126
STAT,1897,48,25-29,1945,0.042607815460326895
SIM,1838,21,na,1859,1372
STAT,1839,52,20-24,1891,6.819262115810814E-4
STAT,1944,18,15-19,1962,48.27436186443379
STAT,1928,27,30-34,1955,47.905505769922094
STAT,1900,22,30-34,1922,24.675096176300148
STAT,1853,52,40-44,1905,0.008119564488458934
STAT,1879,8,na,1887,2716.834996833532
STAT,1838,41,15-19,1879,0.006983127308748499
STAT,1879,34,15-19,1913,0.14483672331093325
STAT,1883,69,na,1952,1411.8401287120494
STAT,1824,43,50-100,1867,0.18078019886755503
STAT,1917,26,40-44,1943,4.839414289055772
STAT,1913,29,na,1942,3659.5213489028483
SIM,1917,25,na,1942,2056
SIM,1827,30,25-29,1857,1
STAT,1909,33,50-100,1942,0.7776596796760888
STAT,1831,38,20-24,1869,0.7731799652825264
STAT,1951,17,45-49,1968,0.589318983775345
SIM,1867,47,40-44,1914,3
STAT,1891,34,na,1925,2909.391154998179
SIM,1854,25,20-24,1879,11
STAT,1863,28,25-29,1891,35.98612449746526
STAT,1922,2,na,1924,4680.435400311846
STAT,1846,25,20-24,1871,8.527473465920647
STAT,1936,27,20-24,1963,17.29595753699988
STAT,1946,18,35-39,1964,4.602358996056742
STAT,1828,93,na,1921,19.783552027633505
STAT,1882,20,na,1902,2277.832033136363
SIM,1882,22,na,1904,2116
SIM,1871,28,25-29,1899,182
STAT,1859,25,30-34,1884,20.598228353473292
SIM,1859,33,25-29,1892,15
STAT,1861,15,45-49,1876,0.06318240310622279
STAT,1832,108,na,1940,0.0015549032900517216
STAT,1954,15,20-24,1969,166.20946361458414
STAT,1838,23,20-24,1861,37.892041047778676
STAT,1843,18,45-49,1861,0.08199386398514619
SIM,1911,1,na,1912,2769
STAT,1822,92,na,1914,24.017147350568045
STAT,1858,26,40-44,1884,2.358746981979093
STAT,1847,59,na,1906,1757.118890507273
STAT,1911,28,15-19,1939,0.6783044873044685
STAT,1844,32,50-100,1876,1.0854746583018673
STAT,1895,45,50-100,1940,0.18201811110342347
STAT,1807,48,40-44,1855,0.5820800680874706
STAT,1914,28,30-34,1942,38.81358039464764
STAT,1844,17,35-39,1861,0.6910088927885811
SIM,1864,37,na,1901,2415
SIM,1867,55,na,1922,1867
STAT,1854,42,45-49,1896,0.8311338748106998
STAT,1829,41,na,1870,964.7600353909751
STAT,1933,39,20-24,1972,0.35585845237281305
STAT,1807,94,na,1901,8.10341610890932
SIM,1844,21,na,1865,3007
SIM,1869,84,na,1953,2525
STAT,1922,21,20-24,1943,126.47307689082388
STAT,1867,33,40-44,1900,4.084055415499726
STAT,1916,1,na,1917,4355.957442524034
STAT,1875,51,30-34,1926,0.006141634144058023
STAT,1908,60,na,1968,3069.9955135060873
SIM,1859,44,50-100,1903,14
STAT,1871,88,na,1959,203.89149772721876
SIM,1836,56,na,1892,1500
STAT,1910,28,15-19,1938,0.6717034553571608
STAT,1922,34,na,1956,4204.936924182106
SIM,1800,58,na,1858,216
SIM,1849,54,na,1903,1972
STAT,1947,15,15-19,1962,50.610929641496675
STAT,1878,3,na,1881,3144.6694022816764
STAT,1878,18,50-100,1896,0.0502741722767358
STAT,1933,38,45-49,1971,0.9213148302868736
STAT,1926,39,15-19,1965,0.02321826977055486
STAT,1867,73,na,1940,1123.2933963001528
STAT,1926,32,45-49,1958,1.8864134230452398
STAT,1909,16,40-44,1925,0.27216820160181493
SIM,1929,10,na,1939,6274
SIM,1899,50,na,1949,1549
STAT,1813,94,na,1907,14.64032247875474
STAT,1843,60,na,1903,1884.3788371760613
STAT,1847,108,na,1955,0.0016560923665787674
STAT,1872,45,50-100,1917,0.24838577134094542
STAT,1844,20,40-44,1864,2.614961818785042
STAT,1788,78,na,1866,122.28078508685783
STAT,1928,17,20-24,1945,169.52997600734298
STAT,1820,52,45-49,1872,0.022013422503381157
SIM,1879,36,na,1915,1308
STAT,1860,19,50-100,1879,0.04555358180820799
SIM,1858,72,na,1930,1695
STAT,1871,31,40-44,1902,4.3437429477354215
STAT,1918,46,45-49,1964,0.2287301660069678
STAT,1954,17,30-34,1971,14.935010259423269
STAT,1925,47,15-19,1972,4.4229232650212536E-4
SIM,1937,30,20-24,1967,3
STAT,1878,19,20-24,1897,18.142521284357674
STAT,1885,18,35-39,1903,0.5379401950403766
STAT,1914,35,20-24,1949,0.2620030017956177
SIM,1954,11,na,1965,5556
STAT,1884,19,45-49,1903,0.06219608765964346
STAT,1913,19,35-39,1932,0.8426293668462002
STAT,1833,45,30-34,1878,0.049876446304813374
SIM,1855,54,na,1909,2860
SIM,1910,5,na,1915,4577
STAT,1915,14,na,1929,4061.8266881279346
SIM,1944,27,20-24,1971,2
STAT,1909,14,na,1923,3821.067385405854
STAT,1838,76,na,1914,404.04136233218355
STAT,1857,30,45-49,1887,1.3746569914265987
STAT,1883,40,15-19,1923,0.013419709633046359
SIM,1860,17,na,1877,2416
STAT,1908,24,40-44,1932,3.0480040452903254
SIM,1904,24,30-34,1928,64
STAT,1859,41,35-39,1900,1.441731744807638
STAT,1843,39,na,1882,2422.1098673537203
STAT,1883,42,25-29,1925,0.6170222129264717
STAT,1894,20,20-24,1914,88.15603054504169
SIM,1831,39,25-29,1870,1
STAT,1823,39,25-29,1862,5.105319172878879
STAT,1897,22,15-19,1919,4.381275259873864
STAT,1849,54,40-44,1903,0.008626578741179523
SIM,1895,26,20-24,1921,6
STAT,1873,44,20-24,1917,0.16070823110981805
STAT,1885,37,40-44,1922,4.302863584485259
SIM,1918,8,na,1926,4480
SIM,1928,28,35-39,1956,26
STAT,1887,26,20-24,1913,12.956806181095676
STAT,1906,46,35-39,1952,0.11468127970592418
STAT,1904,40,45-49,1944,0.14998228928659518
STAT,1927,22,35-39,1949,11.506422650083213
STAT,1833,38,40-44,1871,2.3395384935054824
STAT,1872,23,20-24,1895,68.79295775430565
STAT,1806,53,20-24,1859,0.0019093890526353065
STAT,1822,49,35-39,1871,0.2277027359318191
STAT,1850,31,20-24,1881,1.3193385272044384
SIM,1841,38,40-44,1879,3
STAT,1836,54,45-49,1890,0.010814953839242561
STAT,1913,17,25-29,1930,8.749074108003812
STAT,1825,75,na,1900,633.9557691962292
STAT,1901,24,40-44,1925,2.895373440530197
SIM,1844,82,na,1926,591
SIM,1873,34,20-24,1907,3
SIM,1925,26,40-44,1951,2
SIM,1889,33,na,1922,3838
STAT,1907,48,45-49,1955,0.19179966964605452
STAT,1846,36,25-29,1882,1.799332295331625
SIM,1892,18,na,1910,3699
SIM,1946,20,20-24,1966,788
SIM,1849,21,30-34,1870,21
STAT,1871,20,35-39,1891,5.8558782358227965
SIM,1822,43,na,1865,1541
STAT,1842,43,30-34,1885,0.29151713841724936
STAT,1945,23,15-19,1968,5.767808356397927
STAT,1940,18,30-34,1958,12.233002172558223
SIM,1911,4,na,1915,2769
STAT,1797,83,na,1880,5.600183107001563
STAT,1864,38,na,1902,2131.2098433137626
STAT,1924,45,40-44,1969,0.18677171981055116
SIM,1904,52,na,1956,3928
SIM,1950,11,na,1961,4854
STAT,1889,24,50-100,1913,0.48799721905862253
STAT,1842,23,na,1865,664.6611537693153
STAT,1845,43,50-100,1888,0.5270368228586558
STAT,1909,52,na,1961,3285.2369348648617
STAT,1888,38,20-24,1926,0.8852729640210417
STAT,1881,23,15-19,1904,3.105799303325137
STAT,1851,43,40-44,1894,1.7636285941254295
SIM,1897,52,na,1949,2249
SIM,1944,17,na,1961,2509
STAT,1841,65,na,1906,1881.8831493263874
STAT,1884,52,na,1936,2050.251530001787
STAT,1929,41,50-100,1970,0.15129194471372362
STAT,1897,18,na,1915,3345.348283311394
STAT,1873,15,na,1888,2621.5056978005773
STAT,1815,58,na,1873,176.1120765096207
STAT,1894,16,35-39,1910,0.6994844031772268
STAT,1823,40,na,1863,2237.7002745182253
STAT,1864,38,35-39,1902,6.398143434819698
STAT,1934,37,15-19,1971,0.026320627786185623
STAT,1872,37,30-34,1909,5.336823841711261
STAT,1836,32,35-39,1868,9.808924561994154
STAT,1884,4,na,1888,2671.798235493075
SIM,1886,43,45-49,1929,3
STAT,1777,79,na,1856,686.6735954670002
STAT,1935,24,35-39,1959,12.72121217255273
SIM,1866,60,na,1926,2670
SIM,1810,48,na,1858,3163
STAT,1836,37,45-49,1873,1.87499970387922
SIM,1858,68,na,1926,2126
STAT,1930,19,35-39,1949,5.357978623242682
SIM,1810,58,na,1868,3098
STAT,1933,31,25-29,1964,12.378278882707903
STAT,1901,41,40-44,1942,0.219381460590512
STAT,1837,38,25-29,1875,2.7817503017788474
STAT,1930,30,45-49,1960,2.0187785944063905
SIM,1845,38,25-29,1883,3
STAT,1868,24,45-49,1892,0.6693062172062775
STAT,1870,38,50-100,1908,1.2179065105432232
STAT,1890,19,20-24,1909,21.347191108446996
STAT,1850,42,na,1892,1065.9279578335959
STAT,1941,30,20-24,1971,2.5346787455884026
SIM,1835,25,35-39,1860,7
STAT,1808,73,na,1881,323.92929181409187
STAT,1815,51,50-100,1866,0.0015075397630066464
STAT,1876,21,15-19,1897,3.345078575277243
STAT,1848,38,na,1886,2248.4798468398285
STAT,1905,39,45-49,1944,0.6126469505437219
STAT,1854,35,20-24,1889,0.4351637528973148
STAT,1871,25,50-100,1896,0.6424502895086974
STAT,1823,37,35-39,1860,13.289340552812288
STAT,1874,39,40-44,1913,4.472403663895609
STAT,1879,38,50-100,1917,1.2532204859360268
STAT,1797,93,na,1890,0.29215035680392354
STAT,1892,44,40-44,1936,0.1907729242834609
SIM,1920,25,45-49,1945,6
STAT,1904,27,50-100,1931,0.9139259147573936
STAT,1898,72,na,1970,2093.1428557753034
SIM,1852,36,40-44,1888,2
STAT,1827,39,45-49,1866,1.9180669268903006
STAT,1848,45,25-29,1893,0.05443797981612985
STAT,1921,19,25-29,1940,48.54900541394814
STAT,1837,60,na,1897,1529.240767391414
STAT,1919,33,15-19,1952,0.13622301837344156
STAT,1868,31,35-39,1899,9.821411078064148
STAT,1922,24,25-29,1946,104.0892345588419
SIM,1861,30,na,1891,2257
STAT,1859,31,40-44,1890,3.4512962589116394
STAT,1825,53,40-44,1878,0.012659414707812396
STAT,1890,28,35-39,1918,11.639945556523642
STAT,1902,38,15-19,1940,0.016982909458323883
STAT,1909,34,35-39,1943,8.55783047697665
SIM,1818,47,45-49,1865,1
STAT,1829,34,na,1863,1019.4824729287091
STAT,1860,40,30-34,1900,0.9473539933364147
STAT,1844,36,40-44,1880,5.088548791475666
STAT,1830,25,na,1855,2108.06808347879
STAT,1841,68,na,1909,1701.747338540274
SIM,1909,28,15-19,1937,2
STAT,1930,37,50-100,1967,0.5437993155493325
STAT,1910,49,na,1959,3369.4360303943863
STAT,1861,17,35-39,1878,0.524498670331295
STAT,1875,23,50-100,1898,0.41744658032317405
STAT,1802,54,50-100,1856,0.07357059197919778
STAT,1900,49,na,1949,3052.165277518301
STAT,1912,25,45-49,1937,1.6941301080334747
STAT,1855,8,na,1863,1933.0574747450255
STAT,1887,37,25-29,1924,3.1690551384443544
SIM,1826,36,na,1862,1942
STAT,1938,20,20-24,1958,108.94628521203158
STAT,1905,46,35-39,1951,0.11390905260053327
SIM,1858,38,35-39,1896,16
STAT,1861,50,40-44,1911,0.008881062117567678
SIM,1924,39,20-24,1963,2
STAT,1810,80,na,1890,19.25973189708958
STAT,1898,65,na,1963,2463.852647031188
STAT,1836,19,15-19,1855,10.747399842258032
STAT,1870,49,15-19,1919,3.9044684290509855E-4
SIM,1938,0,na,1938,4282
STAT,1906,35,30-34,1941,1.6815982174472777
STAT,1943,19,45-49,1962,0.5233287800492162
STAT,1874,32,20-24,1906,2.789736408315293
SIM,1882,32,20-24,1914,2
SIM,1855,23,na,1878,3321
STAT,1875,18,40-44,1893,0.18732233848048604
STAT,1940,25,20-24,1965,18.421213009161686
STAT,1876,25,30-34,1901,25.629290543633914
STAT,1830,30,40-44,1860,4.158979744769709
STAT,1877,38,45-49,1915,2.013591719017002
STAT,1897,28,na,1925,3158.2704349084356
STAT,1900,36,40-44,1936,1.3151804461408467
STAT,1909,27,45-49,1936,1.6342621543589324
STAT,1908,25,50-100,1933,0.9479656438461442
STAT,1874,46,30-34,1920,0.1001876845344815
STAT,1927,20,45-49,1947,1.383185353782447
STAT,1928,30,50-100,1958,1.027116019067766
STAT,1853,22,25-29,1875,52.445818522931035
STAT,1872,67,na,1939,1587.3730836331085
STAT,1880,24,45-49,1904,0.7193955834197112
STAT,1912,44,na,1956,3512.955430479959
STAT,1935,17,45-49,1952,0.6779891407513027
STAT,1923,28,25-29,1951,74.51065098411334
STAT,1931,29,45-49,1960,2.2125547451432492
STAT,1910,15,na,1925,3801.784166223675
STAT,1940,23,50-100,1963,0.662557251859146
STAT,1831,36,30-34,1867,5.481964511017074
SIM,1885,30,30-34,1915,7
STAT,1863,15,na,1878,2262.7182350345674
SIM,1896,15,na,1911,3916
STAT,1905,47,50-100,1952,0.19833430200539504
SIM,1917,6,na,1923,2494
SIM,1830,27,25-29,1857,1
STAT,1819,51,40-44,1870,0.0018782859893627269
STAT,1843,51,35-39,1894,0.00854683424210724
STAT,1907,41,25-29,1948,0.06535947538655895
SIM,1840,26,20-24,1866,21
STAT,1864,40,50-100,1904,0.970117963690021
SIM,1934,5,na,1939,5392
STAT,1941,23,30-34,1964,29.354466090841363
STAT,1909,15,45-49,1924,0.09741527079652038
STAT,1947,16,50-100,1963,0.41770720971569936
STAT,1823,46,na,1869,2084.5297410177077
SIM,1848,41,na,1889,2344
SIM,1876,60,na,1936,3039
STAT,1835,24,30-34,1859,17.658499273287298
STAT,1846,43,15-19,1889,0.008172658107348133
STAT,1873,47,25-29,1920,0.05880944895361834
SIM,1927,15,na,1942,1973
STAT,1838,28,15-19,1866,0.24459711918000845
STAT,1892,40,na,1932,2890.4055774970516
STAT,1889,46,25-29,1935,0.06956029574258966
STAT,1846,108,na,1954,0.0010848582015923025
STAT,1870,26,40-44,1896,2.9966253603727404
STAT,1917,29,45-49,1946,1.774813865751771
STAT,1904,26,30-34,1930,36.10074231540436
STAT,1939,30,15-19,1969,0.1298211808011429
STAT,1915,26,25-29,1941,66.41400073690062
STAT,1866,44,30-34,1910,1.0352732269776093
STAT,1941,16,25-29,1957,44.140933818324676
STAT,1862,27,45-49,1889,0.9491769779868402
SIM,1827,73,na,1900,974
STAT,1912,49,30-34,1961,0.08418157727633353
STAT,1802,88,na,1890,69.5570874732448
SIM,1949,21,35-39,1970,1
STAT,1876,23,40-44,1899,2.1000298861276496
STAT,1873,27,20-24,1900,12.033883694283134
STAT,1917,17,45-49,1934,0.10606207966560242
STAT,1868,33,25-29,1901,9.851284429560216
STAT,1897,45,20-24,1942,0.009079205343617839
STAT,1878,9,na,1887,2711.696414528517
STAT,1841,75,na,1916,1146.3729628666397
STAT,1877,30,30-34,1907,17.86618013572637
STAT,1946,15,30-34,1961,13.380127227441337
STAT,1822,36,50-100,1858,2.585417050325968
STAT,1886,42,40-44,1928,2.326370147869499
STAT,1926,15,45-49,1941,0.6100321309465666
STAT,1912,34,na,1946,3646.792609871375
SIM,1872,38,35-39,1910,35
SIM,1876,26,35-39,1902,1
STAT,1877,23,25-29,1900,57.93162163096072
SIM,1900,37,45-49,1937,1
SIM,1923,26,25-29,1949,358
STAT,1847,35,30-34,1882,5.104383977457062
SIM,1835,32,25-29,1867,27
STAT,1854,42,50-100,1896,0.586682733479279
STAT,1854,38,na,1892,1303.4675309427114
STAT,1946,22,20-24,1968,122.40120676169508
SIM,1840,62,na,1902,2500
STAT,1901,20,25-29,1921,80.5192578653867
SIM,1817,80,na,1897,767
STAT,1915,47,40-44,1962,0.15662638729409886
STAT,1904,15,na,1919,3625.088005582401
STAT,1894,23,25-29,1917,72.57192841765287
STAT,1905,16,20-24,1921,25.561937556365102
STAT,1929,39,30-34,1968,2.318532985652824
STAT,1845,41,40-44,1886,1.1512299346611785
STAT,1857,53,na,1910,1625.7290526557804
STAT,1832,26,20-24,1858,14.448612829403588
STAT,1878,43,45-49,1921,1.5287235194208995
STAT,1791,98,na,1889,0.7800706966782205
STAT,1872,26,25-29,1898,42.50429829775383
SIM,1809,61,na,1870,235
STAT,1846,19,na,1865,1687.748646887097
STAT,1829,29,50-100,1858,0.390274495880566
SIM,1944,11,na,1955,2516
STAT,1840,80,na,1920,243.57513129551495
STAT,1868,48,50-100,1916,0.2342372313898267
STAT,1827,32,25-29,1859,10.544328518768339
STAT,1903,30,na,1933,3414.623663515384
STAT,1898,23,50-100,1921,0.5466681709868061
STAT,1848,48,na,1896,2078.890029399345
STAT,1853,60,na,1913,1478.805563445115
SIM,1870,27,45-49,1897,32
STAT,1915,40,20-24,1955,0.01757748304710466
STAT,1915,33,50-100,1948,0.8266587637930009
STAT,1919,31,50-100,1950,0.8837649473798714
SIM,1911,31,na,1942,2516
STAT,1860,42,50-100,1902,0.8607841039558816
STAT,1833,34,25-29,1867,5.636152814221345
SIM,1843,38,na,1881,38
STAT,1901,28,20-24,1929,16.34535448115151
STAT,1785,98,na,1883,0.26366523400053715
STAT,1867,36,45-49,1903,1.8943743610486747
STAT,1862,22,35-39,1884,5.088058918076971
STAT,1915,33,30-34,1948,15.75257675561407
STAT,1931,36,35-39,1967,3.183700551562426
SIM,1923,33,30-34,1956,178
STAT,1811,53,50-100,1864,0.0665974740799147
STAT,1861,3,na,1864,2700.6652061893506
SIM,1853,41,40-44,1894,5
STAT,1883,44,30-34,1927,1.0911011655156688
STAT,1853,20,35-39,1873,5.423806952965687
SIM,1940,6,na,1946,4338
STAT,1878,50,35-39,1928,0.008984883495806
STAT,1878,52,na,1930,2203.5346614940804
STAT,1867,19,45-49,1886,0.062413318309612914
STAT,1932,26,25-29,1958,85.64962986686623
STAT,1945,6,na,1951,4280.880826329882
STAT,1816,53,30-34,1869,0.017075740870972238
STAT,1828,86,na,1914,150.1946927681037
STAT,1878,39,25-29,1917,2.9325029817718837
SIM,1841,34,25-29,1875,5
STAT,1949,21,na,1970,4220.564390214794
STAT,1854,20,35-39,1874,3.867666617085218
STAT,1916,49,15-19,1965,3.7049200755252495E-4
STAT,1832,46,25-29,1878,0.005273011942896631
STAT,1927,36,45-49,1963,0.8414429813915846
STAT,1882,34,20-24,1916,2.5657792970430804
SIM,1863,37,30-34,1900,7
SIM,1923,36,35-39,1959,9
STAT,1893,26,45-49,1919,1.3932297871304677
STAT,1933,15,50-100,1948,0.5004411033371002
STAT,1876,28,35-39,1904,9.719844553510603
SIM,1868,34,na,1902,1186
STAT,1924,48,45-49,1972,0.2555471841478598
STAT,1866,67,na,1933,1447.016504054516
STAT,1886,28,45-49,1914,1.1457273029126869
STAT,1863,53,na,1916,1808.671689395745
SIM,1961,0,na,1961,4686
SIM,1849,20,na,1869,2533
STAT,1961,3,na,1964,5035.442865757291
STAT,1815,43,20-24,1858,0.016590215179246248
STAT,1935,22,45-49,1957,1.5211791969668544
STAT,1944,4,na,1948,4251.989362350167
STAT,1896,33,na,1929,3132.428678078725
STAT,1896,27,25-29,1923,55.76294405857296
STAT,1890,55,na,1945,2503.1890704856314
SIM,1884,28,35-39,1912,30
SIM,1886,15,na,1901,2998
STAT,1868,37,40-44,1905,4.228102396618651
SIM,1906,33,30-34,1939,1
STAT,1907,45,40-44,1952,0.14231130441995024
SIM,1804,58,na,1862,875
SIM,1876,22,na,1898,3951
STAT,1818,49,45-49,1867,0.40825661226582743
STAT,1829,36,25-29,1865,1.4859367145084863
STAT,1828,48,25-29,1876,0.06786850019047534
STAT,1874,52,25-29,1926,0.0036361322873517126
SIM,1889,29,na,1918,3869
STAT,1838,48,35-39,1886,0.060701512291316
STAT,1830,33,45-49,1863,1.6210603753462165
STAT,1878,36,20-24,1914,0.7969199492522852
STAT,1932,21,15-19,1953,6.956833725078593
SIM,1862,20,35-39,1882,84
STAT,1805,49,35-39,1854,0.16746170130541693
STAT,1840,28,20-24,1868,5.718254782370986
STAT,1819,37,45-49,1856,0.5347593562266002
STAT,1880,21,40-44,1901,2.169846661317636
SIM,1819,54,na,1873,1842
STAT,1846,47,30-34,1893,0.05706357226543075
STAT,1913,30,45-49,1943,1.5583753604771216
SIM,1856,49,na,1905,324
STAT,1888,36,30-34,1924,6.180811311340925
SIM,1919,38,35-39,1957,2
STAT,1940,16,40-44,1956,1.4046298425681976
STAT,1891,46,30-34,1937,0.06733784379503487
STAT,1930,16,30-34,1946,15.685997861726133
STAT,1915,36,35-39,1951,2.420506552388625
STAT,1855,33,15-19,1888,0.09497521324857883
STAT,1910,42,45-49,1952,0.15552980865599245
STAT,1913,26,50-100,1939,0.9826928202831599
SIM,1834,35,45-49,1869,2
STAT,1866,40,15-19,1906,0.012733068697933583
STAT,1843,102,na,1945,0.2896700047801083
SIM,1861,23,na,1884,2459
SIM,1845,61,na,1906,1724
STAT,1888,37,50-100,1925,1.4170161332962559
STAT,1921,42,20-24,1963,0.019655440207186164
STAT,1833,46,na,1879,999.2448402967268
SIM,1914,45,na,1959,4827
STAT,1881,34,na,1915,2234.21387742475
STAT,1826,35,45-49,1861,3.4324329890169882
STAT,1914,36,35-39,1950,2.3928530986848626
STAT,1866,20,45-49,1886,0.6510408848303544
STAT,1831,29,40-44,1860,3.304165290365269
SIM,1816,43,na,1859,127
STAT,1856,33,15-19,1889,0.1024675863720106
STAT,1868,26,35-39,1894,9.351601268757827
SIM,1919,25,20-24,1944,116
STAT,1844,39,45-49,1883,2.0440591755886106
STAT,1856,26,50-100,1882,0.479550306351983
STAT,1919,37,30-34,1956,1.9320019280313125
SIM,1875,74,na,1949,2443
STAT,1929,37,40-44,1966,1.908413364652819
STAT,1859,34,45-49,1893,1.370307260442937
STAT,1874,35,25-29,1909,2.999743900802977
STAT,1945,17,20-24,1962,146.4640381367142
STAT,1808,79,na,1887,183.42857324799078
STAT,1933,33,na,1966,5059.073557991329
STAT,1848,42,20-24,1890,0.14843022682550894
STAT,1887,48,30-34,1935,0.10520642108780767
SIM,1936,29,na,1965,3807
SIM,1878,88,na,1966,482
STAT,1871,34,45-49,1905,1.72464548165352
STAT,1850,79,na,1929,322.8200009126985
SIM,1923,23,20-24,1946,2
SIM,1961,3,na,1964,4649
STAT,1842,25,50-100,1867,0.19923074908106397
STAT,1966,0,na,1966,4897.493179170401
STAT,1894,21,35-39,1915,7.4431419059899016
STAT,1852,25,45-49,1877,1.3206315691685728
STAT,1893,66,na,1959,2150.8791790112273
STAT,1805,58,na,1863,412.87919824895226
STAT,1840,15,25-29,1855,2.923261000413326
STAT,1795,64,na,1859,1009.2374229965177
STAT,1851,53,35-39,1904,0.006690199818123834
SIM,1928,32,20-24,1960,19
STAT,1827,30,35-39,1857,10.772939372925746
STAT,1861,39,50-100,1900,1.0107672723391687
STAT,1877,1,na,1878,3496.5771250254297
STAT,1922,17,35-39,1939,4.8020821005255625
STAT,1832,24,30-34,1856,22.519322414644932
SIM,1840,46,25-29,1886,1
SIM,1852,39,45-49,1891,16
STAT,1839,34,na,1873,2426.9414221441834
STAT,1906,31,15-19,1937,0.11889340469589915
STAT,1851,68,na,1919,1206.9590732647175
STAT,1918,24,35-39,1942,9.955628680615028
STAT,1868,21,40-44,1889,2.0272458553094492
STAT,1858,21,30-34,1879,15.719939676900136
SIM,1858,41,na,1899,2312
STAT,1854,38,25-29,1892,1.5929441445418113
STAT,1870,93,na,1963,73.85124878330936
STAT,1837,42,45-49,1879,1.4160624010071878
SIM,1835,30,35-39,1865,5
STAT,1829,43,15-19,1872,0.006547695491474225
SIM,1930,17,35-39,1947,2
STAT,1941,26,35-39,1967,15.361418375914957
STAT,1859,21,15-19,1880,3.002796425340368
STAT,1903,67,na,1970,2598.275373294545
SIM,1827,80,na,1907,783
SIM,1838,49,50-100,1887,2
STAT,1824,35,na,1859,575.324590148656
STAT,1865,49,40-44,1914,0.1530405609823967
STAT,1904,19,25-29,1923,8.052614533524316
SIM,1834,24,na,1858,1245
STAT,1841,33,20-24,1874,3.614341042820439
STAT,1913,18,20-24,1931,27.300029100540094
SIM,1926,29,na,1955,5873
STAT,1923,18,30-34,1941,14.124888124066095
STAT,1842,46,35-39,1888,0.03520823379636849
SIM,1871,25,20-24,1896,27
STAT,1887,17,50-100,1904,0.053924047359594086
STAT,1928,23,15-19,1951,6.575347448482036
SIM,1837,35,na,1872,1969
SIM,1848,30,45-49,1878,2
STAT,1877,33,35-39,1910,10.236808366874648
SIM,1862,42,50-100,1904,8
SIM,1904,17,25-29,1921,148
STAT,1945,27,30-34,1972,42.51243619274864
STAT,1900,25,35-39,1925,13.457202781959836
SIM,1830,24,20-24,1854,1
STAT,1896,34,15-19,1930,0.18611863878082532
STAT,1869,29,20-24,1898,11.753386597529152
SIM,1945,15,20-24,1960,441
STAT,1879,49,35-39,1928,0.1406189528281824
STAT,1849,28,40-44,1877,2.970527387310272
SIM,1895,30,40-44,1925,73
STAT,1940,28,25-29,1968,66.33381999012526
STAT,1904,29,35-39,1933,13.686858109475953
STAT,1927,18,15-19,1945,55.822425373578334
STAT,1822,61,na,1883,1144.0513904469724
STAT,1917,24,50-100,1941,0.6856720078500863
STAT,1833,51,25-29,1884,0.0015958393728888192
STAT,1853,15,35-39,1868,0.5178868795543905
STAT,1877,66,na,1943,1663.7925486389772
STAT,1915,23,20-24,1938,112.9668737443036
SIM,1905,28,30-34,1933,189
STAT,1859,85,na,1944,217.27692568583726
SIM,1877,1,na,1878,1727
STAT,1819,54,45-49,1873,0.0024638700018794995
STAT,1801,62,na,1863,813.6147895591462
STAT,1868,52,na,1920,2068.6107113328444
STAT,1855,39,20-24,1894,0.5050412143873888
STAT,1916,39,20-24,1955,0.2635890174632666
STAT,1845,24,40-44,1869,1.265303500074547
STAT,1897,34,15-19,1931,0.18750557656151387
SIM,1896,7,na,1903,4109
SIM,1860,75,na,1935,1638
STAT,1921,48,na,1969,4081.0448270216043
STAT,1923,25,20-24,1948,20.877716911468415
SIM,1857,28,40-44,1885,1
STAT,1892,30,15-19,1922,0.17773129996685183
STAT,1816,98,na,1914,2.7425044205091984
STAT,1928,29,20-24,1957,22.295572210537447
STAT,1883,47,35-39,1930,0.13405813430181218
STAT,1870,29,45-49,1899,1.0989867621130307
STAT,1855,23,20-24,1878,52.89983021836665
SIM,1925,44,na,1969,4696
STAT,1823,87,na,1910,139.1787642675421
SIM,1871,23,na,1894,1124
STAT,1867,16,40-44,1883,0.17788203231862526
STAT,1850,38,40-44,1888,2.032161030807387
SIM,1953,17,20-24,1970,850
SIM,1902,16,na,1918,3472
STAT,1914,26,40-44,1940,4.649358667788457
STAT,1937,15,20-24,1952,131.13558622572376
STAT,1833,26,50-100,1859,0.4059266680995138
STAT,1831,39,35-39,1870,7.007226180529868
STAT,1905,26,15-19,1931,0.6548091279035837
STAT,1956,15,50-100,1971,0.4916873053769725
STAT,1835,22,40-44,1857,2.0958058255404017
STAT,1866,54,40-44,1920,0.009345571346354798
STAT,1931,16,15-19,1947,59.1296460082702
STAT,1827,36,40-44,1863,4.369797983966361
STAT,1869,31,35-39,1900,10.26080029822894
SIM,1904,45,na,1949,3984
STAT,1856,44,20-24,1900,0.11252832050602452
STAT,1902,49,20-24,1951,0.009332819900753617
STAT,1847,53,na,1900,1915.4588155376757
STAT,1847,37,20-24,1884,0.7231037153167573
STAT,1801,99,na,1900,0.6282868610855741
STAT,1842,102,na,1944,0.07277906970724274
STAT,1835,72,na,1907,955.5758931737821
STAT,1890,48,na,1938,2689.950580453036
SIM,1843,22,40-44,1865,9
SIM,1850,24,na,1874,1878
STAT,1946,17,20-24,1963,148.74762915188361
STAT,1887,30,40-44,1917,4.811676102943503
STAT,1804,80,na,1884,500.3442172782822
STAT,1888,32,15-19,1920,0.16436176808589018
STAT,1856,67,na,1923,1138.5883429514645
SIM,1878,37,25-29,1915,20
STAT,1926,16,40-44,1942,1.7043667449824556
SIM,1935,18,15-19,1953,697
STAT,1832,29,25-29,1861,50.03583741666967
STAT,1923,35,30-34,1958,2.0931921201616803
STAT,1905,19,25-29,1924,8.10686205649521
STAT,1909,32,45-49,1941,1.486334310924909
STAT,1847,31,15-19,1878,0.15275056650413416
SIM,1863,23,20-24,1886,13
STAT,1837,35,20-24,1872,0.7683246537418291
STAT,1900,15,25-29,1915,7.8865087292463585
STAT,1845,44,45-49,1889,0.7371308312592023
STAT,1894,27,40-44,1921,3.8093344081534903
STAT,1828,30,35-39,1858,16.353045382047227
STAT,1840,22,15-19,1862,1.6519489654656634
SIM,1885,20,20-24,1905,375
SIM,1916,30,na,1946,4684
SIM,1928,21,15-19,1949,6
SIM,1796,79,na,1875,580
STAT,1937,28,35-39,1965,14.476852992636523
SIM,1843,27,35-39,1870,3
SIM,1917,15,na,1932,2415
SIM,1869,40,40-44,1909,2
STAT,1836,20,na,1856,2102.6527618110526
STAT,1824,48,40-44,1872,0.02938133009953224
SIM,1907,63,na,1970,3919
STAT,1833,31,20-24,1864,1.5517004898856235
SIM,1919,44,na,1963,4904
SIM,1833,76,na,1909,1615
STAT,1869,37,na,1906,2377.373878442315
STAT,1881,18,15-19,1899,5.589596550169545
STAT,1891,39,40-44,1930,5.3289621360221355
STAT,1863,32,45-49,1895,1.4887224468230693
STAT,1886,45,45-49,1931,0.2468262852797907
STAT,1905,21,20-24,1926,99.41750191082758
SIM,1904,38,40-44,1942,5
STAT,1835,27,35-39,1862,9.514858813163116
SIM,1914,34,35-39,1948,72
SIM,1845,35,20-24,1880,1
STAT,1817,87,na,1904,55.81220966635057
STAT,1808,101,na,1909,0.1336421761527334
SIM,1935,36,45-49,1971,3
STAT,1908,47,15-19,1955,3.305661521837855E-4
STAT,1901,38,15-19,1939,0.016862966348294012
STAT,1838,86,na,1924,94.62403392949788
STAT,1889,43,20-24,1932,0.18986510278249236
STAT,1938,3,na,1941,3958.2298065920727
STAT,1938,25,15-19,1963,0.6925046469597881
STAT,1895,21,35-39,1916,7.614133963734665
SIM,1933,3,na,1936,4652
SIM,1851,61,na,1912,979
STAT,1889,51,na,1940,2605.375830244334
SIM,1901,31,na,1932,3770
STAT,1939,21,na,1960,3628.3293008958076
STAT,1920,37,20-24,1957,0.284910605764
STAT,1829,49,20-24,1878,0.005408203589055567
STAT,1850,45,30-34,1895,0.04514415382706629
STAT,1917,49,15-19,1966,3.774038478259448E-4
STAT,1857,19,35-39,1876,0.4890759209123111
STAT,1859,32,50-100,1891,0.7262094614639697
STAT,1915,43,25-29,1958,0.07076544400498176
STAT,1853,53,na,1906,1642.7356072270536
STAT,1937,35,25-29,1972,0.9760725960365415
STAT,1942,29,20-24,1971,18.920912229303973
STAT,1919,27,20-24,1946,19.46127584717248
SIM,1871,16,na,1887,2013
STAT,1859,50,30-34,1909,0.004785745664871583
STAT,1906,50,na,1956,3180.3852909668935
STAT,1880,31,50-100,1911,0.9550916231146259
STAT,1847,38,na,1885,2187.2218019335464
STAT,1904,26,25-29,1930,60.64326798051703
SIM,1881,36,25-29,1917,2
STAT,1906,34,35-39,1940,8.348386790930554
STAT,1851,43,na,1894,1812.2137169092468
SIM,1916,39,45-49,1955,17
STAT,1862,46,20-24,1908,0.010249911693038754
STAT,1923,20,20-24,1943,128.78244540794648
STAT,1930,18,20-24,1948,173.5911162010275
STAT,1921,23,20-24,1944,123.72022201752928
SIM,1793,84,na,1877,591
STAT,1877,30,25-29,1907,10.48105245937252
SIM,1850,39,50-100,1889,9
SIM,1935,33,40-44,1968,1
STAT,1932,26,30-34,1958,50.98694909098365
STAT,1869,27,45-49,1896,1.1203867654572393
STAT,1927,33,40-44,1960,4.771687266074766
STAT,1875,21,30-34,1896,18.34580341935638
STAT,1893,17,40-44,1910,0.22872536250787817
SIM,1914,14,na,1928,5124
STAT,1858,49,50-100,1907,0.1836399263629095
SIM,1918,28,na,1946,4408
STAT,1852,27,50-100,1879,0.7499845753347233
STAT,1914,42,15-19,1956,0.001500524985346247
SIM,1884,42,na,1926,3678
SIM,1839,55,na,1894,346
SIM,1876,43,35-39,1919,34
SIM,1899,25,30-34,1924,60
STAT,1859,23,na,1882,1930.9138923589114
STAT,1943,16,35-39,1959,4.400141383050152
STAT,1811,109,na,1920,4.310242838879819E-4
STAT,1924,16,50-100,1940,0.4429519515224291
STAT,1836,48,15-19,1884,3.166868581997472E-4
STAT,1843,48,na,1891,2195.0119746243586
STAT,1838,61,na,1899,796.921205087149
STAT,1902,29,25-29,1931,59.14144913420423
STAT,1875,33,25-29,1908,10.47325659060312
STAT,1934,21,35-39,1955,12.572361127613481
SIM,1928,0,na,1928,4662
SIM,1941,28,na,1969,3817
STAT,1892,30,20-24,1922,3.3735411259461157
STAT,1912,45,15-19,1957,3.5155528837239473E-4
SIM,1920,36,30-34,1956,2
STAT,1810,47,40-44,1857,8.989955193096153E-4
STAT,1910,23,45-49,1933,1.0415923114898793
STAT,1864,93,na,1957,34.49277834622042
SIM,1800,71,na,1871,216
STAT,1892,38,50-100,1930,1.5125212401321333
STAT,1911,16,15-19,1927,9.001377940576136
STAT,1930,29,30-34,1959,49.423584471559785
STAT,1904,39,30-34,1943,1.626948720147142
STAT,1796,80,na,1876,462.3599727597318
STAT,1892,25,na,1917,2974.7856244259556
STAT,1913,20,50-100,1933,0.6333594418465507
SIM,1858,34,na,1892,2407
SIM,1854,20,na,1874,1631
STAT,1911,16,50-100,1927,0.07430965425779765
SIM,1857,31,30-34,1888,85
STAT,1939,27,25-29,1966,65.44198047301532
STAT,1932,24,35-39,1956,12.226367897095692
STAT,1916,41,40-44,1957,0.253189906157681
STAT,1876,17,35-39,1893,0.5546944801455128
STAT,1937,19,15-19,1956,43.56434152282953
STAT,1896,15,na,1911,3344.7948435064563
STAT,1866,46,35-39,1912,0.12815745291321967
SIM,1858,10,na,1868,2521
STAT,1894,37,50-100,1931,1.561269566895503
STAT,1914,44,40-44,1958,0.24358482043283539
STAT,1849,31,30-34,1880,17.213154321315237
STAT,1866,40,20-24,1906,0.14643028211740938
STAT,1881,65,na,1946,1595.9123245641995
STAT,1856,98,na,1954,2.333276255066582
STAT,1870,40,40-44,1910,2.2650040076671147
STAT,1818,43,50-100,1861,2.00835180282809
STAT,1843,25,50-100,1868,0.7891351632091388
SIM,1829,37,na,1866,2121
SIM,1940,24,35-39,1964,51
STAT,1883,43,30-34,1926,1.0980407832659096
SIM,1907,46,40-44,1953,2
SIM,1825,47,na,1872,164
SIM,1925,26,35-39,1951,18
SIM,1821,33,na,1854,2066
SIM,1953,7,na,1960,4654
STAT,1914,33,30-34,1947,15.572608991595233
STAT,1852,84,na,1936,334.85475343421194
SIM,1922,44,40-44,1966,5
SIM,1905,47,45-49,1952,1
STAT,1863,33,50-100,1896,0.7789091677515066
STAT,1940,32,15-19,1972,0.1315048435061041
STAT,1794,97,na,1891,0.012714831768416883
STAT,1870,22,na,1892,2357.7953143738173
STAT,1809,64,na,1873,2098.834379535432
STAT,1866,50,50-100,1916,0.013984184046720341
STAT,1864,49,35-39,1913,0.12461745935966564
STAT,1840,20,50-100,1860,0.20716058088287434
STAT,1865,27,30-34,1892,22.99084954397405
STAT,1868,99,na,1967,9.380178377893547
STAT,1934,23,30-34,1957,38.350688503687046
STAT,1863,19,20-24,1882,15.531593557180544
STAT,1915,29,35-39,1944,14.989281330627268
SIM,1885,30,25-29,1915,57
SIM,1838,73,na,1911,713
SIM,1940,26,30-34,1966,44
STAT,1917,26,35-39,1943,15.588104186571682
STAT,1958,7,na,1965,5116.897180608837
STAT,1864,43,20-24,1907,0.14333495041976865
STAT,1881,46,30-34,1927,0.09167240188472807
SIM,1888,32,na,1920,324
STAT,1930,16,25-29,1946,55.76886526590533
SIM,1906,23,20-24,1929,1109
STAT,1866,17,na,1883,2366.3269361634534
SIM,1871,19,20-24,1890,2
STAT,1835,19,45-49,1854,0.06610248883342296
STAT,1818,104,na,1922,0.04059739839162334
STAT,1844,89,na,1933,104.07535737661237
SIM,1934,34,na,1968,5205
SIM,1804,61,na,1865,845
SIM,1892,77,na,1969,2903
STAT,1876,94,na,1970,90.97327398009534
STAT,1830,27,15-19,1857,0.43626321134580265
STAT,1890,9,na,1899,3141.081681544137
STAT,1938,34,25-29,1972,9.182127743817524
STAT,1849,40,15-19,1889,0.011839416413675106
SIM,1859,75,na,1934,136
STAT,1896,41,45-49,1937,0.13762309784532803
STAT,1831,82,na,1913,365.1707589274662
STAT,1869,7,na,1876,2782.6278320662054
STAT,1777,110,na,1887,0.005198311449086615
STAT,1869,21,30-34,1890,18.028317441362834
STAT,1852,16,40-44,1868,0.2239909679091322
STAT,1910,25,40-44,1935,4.51880652349011
STAT,1894,33,35-39,1927,12.823824072430625
STAT,1865,16,20-24,1881,16.778192131092002
SIM,1905,30,20-24,1935,1
STAT,1909,39,na,1948,3489.333614233064
STAT,1908,33,30-34,1941,14.694296237453644
STAT,1861,29,50-100,1890,0.5281933969466746
STAT,1899,38,40-44,1937,1.2841325514731787
STAT,1894,44,45-49,1938,0.13037921745199332
SIM,1852,42,35-39,1894,7
SIM,1926,39,na,1965,5881
STAT,1877,49,15-19,1926,3.9756982919027695E-4
STAT,1830,38,25-29,1868,2.5990731560784766
STAT,1879,54,20-24,1933,7.361704612611666E-4
STAT,1839,37,30-34,1876,5.9171402666270225
SIM,1905,21,na,1926,3670
STAT,1934,29,45-49,1963,2.3060421327623017
STAT,1851,32,25-29,1883,8.419753790200506
SIM,1846,25,na,1871,1254
STAT,1945,24,15-19,1969,5.765789623473188
STAT,1867,58,na,1925,1870.2733905236173
STAT,1944,24,50-100,1968,0.701971961945799
STAT,1805,74,na,1879,187.08185999476163
SIM,1881,5,na,1886,3275
STAT,1907,16,25-29,1923,8.288612803762964
STAT,1928,24,15-19,1952,6.554437843595862
STAT,1792,90,na,1882,39.86645853192934
STAT,1848,27,30-34,1875,28.131656344561776
STAT,1904,28,20-24,1932,16.701679182552077
STAT,1871,63,na,1934,1779.9213338393201
STAT,1886,5,na,1891,2713.802478093639
SIM,1851,55,na,1906,1078
STAT,1844,42,35-39,1886,1.8373072904921706
STAT,1788,85,na,1873,35.12191405687572
SIM,1842,19,na,1861,3255
STAT,1912,36,30-34,1948,1.7666565577531081
SIM,1856,27,30-34,1883,17
STAT,1862,27,na,1889,2040.1932330619002
SIM,1896,67,na,1963,1991
STAT,1889,15,25-29,1904,6.855721525320921
STAT,1848,16,20-24,1864,20.6874977955599
STAT,1844,53,45-49,1897,0.014146444651399396
SIM,1901,25,40-44,1926,10
SIM,1912,28,20-24,1940,186
STAT,1798,87,na,1885,88.99526445163389
STAT,1936,34,20-24,1970,2.3426517015283155
STAT,1899,31,15-19,1930,0.19530487481770128
STAT,1927,31,45-49,1958,1.9210313417343419
STAT,1823,42,20-24,1865,0.2667335775446036
STAT,1930,16,na,1946,4736.837250726462
SIM,1898,34,na,1932,4237
STAT,1899,22,30-34,1921,24.329214938070198
SIM,1821,73,na,1894,1347
STAT,1885,40,30-34,1925,1.1414684233637207
STAT,1889,17,20-24,1906,21.349141002677
SIM,1916,20,25-29,1936,47
STAT,1823,48,35-39,1871,0.21533032005430558
STAT,1852,68,na,1920,1538.2652020793146
STAT,1840,48,35-39,1888,0.05488215346049281
STAT,1840,42,20-24,1882,0.06523141223603313
STAT,1914,47,45-49,1961,0.21255012517030827
SIM,1814,63,na,1877,2442
STAT,1834,20,30-34,1854,10.651247591149986
STAT,1821,48,25-29,1869,0.06078310818111607
STAT,1829,39,50-100,1868,0.6023880334044164
STAT,1889,45,na,1934,2736.325244490458
STAT,1839,26,20-24,1865,13.829961630264041
SIM,1876,47,na,1923,3637
STAT,1890,33,20-24,1923,3.2585332747176916
STAT,1890,39,35-39,1929,8.476352077039259
STAT,1923,39,40-44,1962,1.7126377913278856
STAT,1858,30,15-19,1888,0.11103376575270736
STAT,1856,74,na,1930,797.1095881755746
STAT,1881,30,45-49,1911,1.6600115988706627
SIM,1850,30,na,1880,1847
STAT,1853,32,35-39,1885,8.08635855024883
SIM,1894,20,na,1914,1585
STAT,1821,37,15-19,1858,0.06929864393710485
STAT,1927,12,na,1939,4886.480697783383
STAT,1810,45,45-49,1855,0.00127265178995279
STAT,1924,16,25-29,1940,51.2347860667211
STAT,1825,42,25-29,1867,0.8540217658860567
STAT,1839,24,25-29,1863,67.35857484156601
SIM,1897,17,20-24,1914,5
STAT,1908,20,25-29,1928,84.76385818215286
STAT,1834,32,25-29,1866,5.782180159303748
SIM,1893,19,na,1912,3489
STAT,1858,37,40-44,1895,3.342942616728519
STAT,1822,46,na,1868,1522.0972659482993
SIM,1875,22,na,1897,3098
SIM,1868,12,na,1880,1405
SIM,1880,52,na,1932,3193
SIM,1797,74,na,1871,803
SIM,1959,10,na,1969,5256
STAT,1889,28,30-34,1917,30.217930750501658
STAT,1901,19,na,1920,3512.40299201501
STAT,1947,24,25-29,1971,103.22467605112752
STAT,1871,39,25-29,1910,2.843218141840611
SIM,1897,28,30-34,1925,217
STAT,1845,21,45-49,1866,0.43267159325270743
STAT,1908,31,35-39,1939,8.594151550833226
STAT,1913,44,na,1957,3564.4254955973583
SIM,1817,68,na,1885,1947
STAT,1919,34,15-19,1953,0.13562908601333337
STAT,1911,3,na,1914,3999.985297970297
STAT,1835,96,na,1931,6.497138364668631
SIM,1931,20,20-24,1951,6
STAT,1906,34,na,1940,3455.10586310269
STAT,1908,39,45-49,1947,0.6269596085195562
STAT,1923,37,45-49,1960,0.7815881649217045
STAT,1900,18,35-39,1918,0.7581272664418531
STAT,1849,47,50-100,1896,0.20597579755993695
STAT,1893,50,na,1943,2731.3646874421133
STAT,1815,39,40-44,1854,0.47908655715686127
STAT,1895,17,45-49,1912,0.08497624890326674
STAT,1906,20,20-24,1926,100.38561586026769
STAT,1921,26,25-29,1947,72.73596802227193
SIM,1932,4,na,1936,6551
STAT,1851,46,45-49,1897,0.18692024617348077
STAT,1905,7,na,1912,3747.337301803183
STAT,1846,96,na,1942,5.085541203174841
SIM,1905,37,na,1942,3114
SIM,1867,27,na,1894,1738
STAT,1920,14,na,1934,4374.064350201066
STAT,1851,100,na,1951,0.8384793675348462
STAT,1887,15,15-19,1902,6.562349554207852
STAT,1918,24,50-100,1942,0.695711379864072
STAT,1853,43,45-49,1896,1.1520948458464528
STAT,1874,17,30-34,1891,1.644979277526185
STAT,1865,2,na,1867,3096.265100148131
STAT,1875,24,35-39,1899,5.954663626876145
STAT,1850,16,30-34,1866,0.9046940045408846
STAT,1932,6,na,1938,5270.357967682308
STAT,1875,47,50-100,1922,0.251019160251685
STAT,1845,38,15-19,1883,0.028974906660091563
STAT,1875,30,20-24,1905,2.797952887270986
SIM,1910,26,20-24,1936,4
STAT,1917,23,30-34,1940,30.045695365978695
STAT,1910,20,40-44,1930,3.1408712637833016
SIM,1836,66,na,1902,1188
SIM,1914,20,20-24,1934,365
STAT,1916,44,45-49,1960,0.1676670894622525
SIM,1859,7,na,1866,2403
SIM,1862,39,25-29,1901,2
STAT,1902,26,20-24,1928,16.57645697263247
STAT,1923,23,25-29,1946,106.01646140158974
STAT,1847,46,25-29,1893,0.052224992883290196
STAT,1939,15,30-34,1954,12.096350961951082
SIM,1879,12,na,1891,1848
SIM,1851,26,40-44,1877,16
STAT,1828,26,45-49,1854,2.5213251193756845
SIM,1797,58,na,1855,1802
SIM,1910,15,35-39,1925,4
STAT,1826,29,45-49,1855,3.5060430796542423
SIM,1831,35,na,1866,2016
STAT,1838,21,na,1859,1191.5068686038176
STAT,1862,49,25-29,1911,0.048035941305272285
STAT,1864,53,na,1917,1926.0289059134352
SIM,1839,15,na,1854,1250
STAT,1806,99,na,1905,0.5702782263326273
STAT,1862,38,15-19,1900,0.04759191141165613
STAT,1931,33,30-34,1964,20.486613694257798
SIM,1912,31,na,1943,4647
STAT,1894,30,25-29,1924,13.129792804155503
STAT,1823,71,na,1894,1054.4617641860816
SIM,1894,20,25-29,1914,6
SIM,1925,23,30-34,1948,2
STAT,1886,46,50-100,1932,0.25505319739011617
SIM,1884,82,na,1966,466
STAT,1902,18,45-49,1920,0.09174356703861707
STAT,1886,39,15-19,1925,0.05756559949715607
STAT,1930,32,na,1962,4846.609579649315
SIM,1939,2,na,1941,4904
STAT,1921,35,15-19,1956,0.021224579954993793
SIM,1906,26,25-29,1932,498
SIM,1902,16,15-19,1918,36
STAT,1885,71,na,1956,1342.2861875057963
STAT,1888,47,25-29,1935,0.06616989629106196
STAT,1883,40,20-24,1923,0.15432665244471652
STAT,1901,59,na,1960,2826.992269537013
SIM,1860,2,na,1862,2680
STAT,1841,29,40-44,1870,4.083886464002094
STAT,1878,17,45-49,1895,0.06720831548889528
STAT,1928,44,50-100,1972,0.14813202218540136
STAT,1842,42,30-34,1884,0.2952760019217129
STAT,1937,4,na,1941,3885.958035534307
SIM,1847,10,na,1857,1827
STAT,1897,22,20-24,1919,91.51937119069791
SIM,1913,43,30-34,1956,1
STAT,1913,16,25-29,1929,8.770561984866738
STAT,1814,94,na,1908,13.526268589124607
STAT,1891,17,30-34,1908,1.960027077887373
STAT,1881,49,35-39,1930,0.12944827082434585
STAT,1896,6,na,1902,3443.6841823084224
STAT,1843,26,40-44,1869,3.6688446084879813
STAT,1847,81,na,1928,488.91435842735535
STAT,1825,45,35-39,1870,0.18263119389301102
STAT,1908,36,50-100,1944,0.3919331483022856
SIM,1850,14,na,1864,2299
STAT,1833,42,50-100,1875,0.5499446969341114
STAT,1841,41,na,1882,2708.897036763637
STAT,1872,88,na,1960,221.94214462116662
STAT,1949,2,na,1951,4619.363382017175
STAT,1827,53,45-49,1880,0.012591128672118854
STAT,1893,10,na,1903,3239.2747268932003
STAT,1928,24,45-49,1952,1.3854251638811943
STAT,1827,42,35-39,1869,1.718576306938698
STAT,1943,27,15-19,1970,0.7432643197554052
SIM,1909,11,na,1920,4275
STAT,1918,41,45-49,1959,0.17481626537123446
STAT,1868,40,25-29,1908,0.626499218216212
STAT,1927,44,20-24,1971,0.021895200175624914
STAT,1939,24,20-24,1963,110.3685296136857
STAT,1905,43,30-34,1948,0.11399928381183788
STAT,1776,84,na,1860,195.19698556636322
STAT,1875,53,na,1928,2175.4852973473676
SIM,1853,19,na,1872,3603
STAT,1859,17,35-39,1876,0.504831044832681
SIM,1832,26,30-34,1858,43
STAT,1854,16,45-49,1870,0.043705369164178054
STAT,1900,43,50-100,1943,0.10089343258410567
STAT,1849,34,35-39,1883,8.806827652915315
STAT,1832,35,25-29,1867,0.2047495285880297
STAT,1873,16,50-100,1889,0.05055262587492286
STAT,1917,34,na,1951,3874.080978662601
SIM,1882,16,na,1898,2221
SIM,1938,24,na,1962,3121
STAT,1840,43,na,1883,937.2416603229993
STAT,1920,42,15-19,1962,0.0016742562078427517
STAT,1834,71,na,1905,588.2536598871794
STAT,1822,102,na,1924,0.16905944801716738
SIM,1855,45,na,1900,3004
STAT,1921,29,35-39,1950,16.416115208303925
SIM,1905,33,25-29,1938,29
STAT,1902,26,15-19,1928,0.6410784515955766
STAT,1848,19,25-29,1867,6.496372702561815
STAT,1908,34,45-49,1942,1.461221714590068
STAT,1862,49,30-34,1911,0.08072706880495176
STAT,1816,52,30-34,1868,0.017419046960872056
STAT,1846,50,45-49,1896,0.008718650572853709
STAT,1843,91,na,1934,57.25503534629129
STAT,1852,19,45-49,1871,0.07859152156272713
STAT,1914,45,25-29,1959,0.05212080116212822
STAT,1869,24,35-39,1893,5.851614326609105
SIM,1861,43,45-49,1904,1
SIM,1864,22,na,1886,871
SIM,1866,37,40-44,1903,6
STAT,1909,27,15-19,1936,0.6678076242241087
STAT,1904,23,15-19,1927,4.698738112578346
STAT,1882,16,20-24,1898,17.015165007593495
STAT,1923,34,40-44,1957,4.433324978950169
STAT,1837,29,20-24,1866,11.90062575457922
SIM,1849,21,25-29,1870,451
SIM,1867,70,na,1937,408
STAT,1875,49,40-44,1924,0.17212659128500432
STAT,1938,31,20-24,1969,2.427732336965328
STAT,1905,49,na,1954,3169.016238026612
STAT,1933,18,50-100,1951,0.49682164184180505
STAT,1845,74,na,1919,550.6959693451777
STAT,1892,36,35-39,1928,8.799088068664922
STAT,1872,35,50-100,1907,1.241087869154756
STAT,1912,22,40-44,1934,3.184912867423148
SIM,1887,47,na,1934,3453
STAT,1925,47,20-24,1972,0.013268781466725771
STAT,1782,102,na,1884,0.26605542897524276
STAT,1915,24,35-39,1939,9.5355659950075
STAT,1948,17,25-29,1965,49.086056070692784
STAT,1826,36,na,1862,2284.00110625469
STAT,1871,28,15-19,1899,0.45099496795382854
STAT,1864,51,50-100,1915,0.013795695318402735
STAT,1906,36,30-34,1942,1.6737956017183218
STAT,1910,55,na,1965,3282.932759516156
STAT,1938,32,50-100,1970,0.8224419137285971
STAT,1892,47,45-49,1939,0.16405117729990912
SIM,1847,50,na,1897,1426
SIM,1873,27,30-34,1900,47
STAT,1912,33,20-24,1945,2.362227803566731
STAT,1858,34,30-34,1892,13.219207918754524
SIM,1872,57,na,1929,2166
STAT,1920,42,45-49,1962,0.18144750378590982
STAT,1934,24,45-49,1958,1.5008408668989253
SIM,1931,8,na,1939,5309
STAT,1868,54,45-49,1922,0.013631656304332548
STAT,1878,45,na,1923,2337.869432205934
STAT,1949,21,25-29,1970,106.75593662977757
STAT,1834,48,40-44,1882,0.07899828167651858
STAT,1922,22,50-100,1944,0.7461530640460207
STAT,1886,20,25-29,1906,59.634401254432234
STAT,1901,31,25-29,1932,14.37989108788437
STAT,1840,45,30-34,1885,0.039433982930848224
STAT,1863,68,na,1931,1304.6410355475282
STAT,1845,49,25-29,1894,0.027985327173490337
STAT,1942,30,50-100,1972,0.8716516383871199
SIM,1966,1,na,1967,5088
STAT,1941,19,35-39,1960,4.270106102200165
SIM,1898,10,na,1908,4434
STAT,1889,61,na,1950,2250.2577001634995
STAT,1919,39,20-24,1958,0.2788421732501977
SIM,1818,53,na,1871,672
SIM,1936,27,25-29,1963,4
STAT,1868,43,35-39,1911,1.7363777851481428
SIM,1825,36,40-44,1861,1
STAT,1858,23,20-24,1881,54.552125619543844
SIM,1922,49,na,1971,3201
STAT,1902,15,35-39,1917,0.7762604424652251
STAT,1874,31,na,1905,2472.8964106741914
STAT,1892,65,na,1957,2143.445012532898
SIM,1931,23,25-29,1954,742
STAT,1917,37,15-19,1954,0.019679620841693866
SIM,1869,53,na,1922,3598
STAT,1926,30,na,1956,4539.081768959148
STAT,1925,36,40-44,1961,1.7818983189042714
STAT,1873,36,25-29,1909,2.9676367777256516
SIM,1929,28,na,1957,6252
STAT,1855,33,na,1888,1591.4900849836522
STAT,1839,27,50-100,1866,0.7487053456684967
SIM,1835,25,na,1860,1192
STAT,1860,63,na,1923,1455.6214318089587
STAT,1834,23,35-39,1857,3.414829560820892
STAT,1781,90,na,1871,31.908869449359962
STAT,1844,38,50-100,1882,1.2720292505277926
STAT,1939,18,40-44,1957,1.3842489087633871
STAT,1856,21,20-24,1877,57.9014544062993
STAT,1928,27,25-29,1955,80.47331544503855
STAT,1839,33,15-19,1872,0.1611360642098811
STAT,1857,36,50-100,1893,0.9466569208952398
SIM,1851,71,na,1922,979
STAT,1903,30,45-49,1933,2.4952725753417866
SIM,1912,23,20-24,1935,1
STAT,1859,35,50-100,1894,0.9823414982320876
STAT,1851,35,35-39,1886,5.764440142209223
STAT,1869,24,40-44,1893,2.0895702678760832
STAT,1857,53,30-34,1910,0.004494416614712524
STAT,1904,23,20-24,1927,98.15077390625238
SIM,1926,23,na,1949,4595
STAT,1876,19,na,1895,2539.463473498344
STAT,1812,42,45-49,1854,0.725344260295291
STAT,1821,45,20-24,1866,0.013182897091697435
STAT,1875,30,15-19,1905,0.14740706733231673
STAT,1884,27,40-44,1911,2.867570636491992
STAT,1875,93,na,1968,111.07034917537834
SIM,1927,24,na,1951,1732
STAT,1853,40,40-44,1893,1.7616612908612537
STAT,1938,31,15-19,1969,0.12790240525062527
STAT,1939,18,35-39,1957,4.152746485851079
STAT,1897,37,25-29,1934,3.8237233959497168
SIM,1844,31,45-49,1875,21
STAT,1830,32,50-100,1862,0.8606339302884082
STAT,1854,32,na,1886,1358.7551848046862
STAT,1826,102,na,1928,0.23372968140986503
STAT,1928,34,na,1962,4687.0409446372705
STAT,1865,94,na,1959,30.76033842037025
STAT,1847,23,45-49,1870,0.7673335070617762
SIM,1796,73,na,1869,658
SIM,1829,41,20-24,1870,2
STAT,1850,19,35-39,1869,0.30598102251944864
STAT,1889,19,40-44,1908,0.21907524806488632
STAT,1910,22,30-34,1932,26.688754195015672
STAT,1955,11,na,1966,5169.875998381421
SIM,1900,62,na,1962,3838
STAT,1831,52,20-24,1883,6.121175880668654E-4
STAT,1825,30,30-34,1855,34.28638839755849
SIM,1872,17,na,1889,2500
STAT,1842,39,50-100,1881,0.31866555072050734
STAT,1862,20,50-100,1882,0.36072107300883877
STAT,1839,21,15-19,1860,3.9666567134214774
STAT,1888,32,20-24,1920,3.119772287010689
SIM,1842,23,35-39,1865,3
STAT,1828,31,50-100,1859,1.4337394490131297
STAT,1834,35,35-39,1869,3.9586704910973554
STAT,1838,40,45-49,1878,0.7665546091267172
STAT,1845,55,na,1900,1026.0346461259026
STAT,1862,23,40-44,1885,1.8038645947267413
STAT,1946,21,50-100,1967,0.7245495323430314
STAT,1834,46,45-49,1880,0.12277568454955665
STAT,1936,34,15-19,1970,0.12342002564602361
STAT,1928,28,30-34,1956,47.8825111271525
STAT,1940,23,25-29,1963,93.00977730030789
SIM,1915,39,na,1954,3104
STAT,1811,46,na,1857,1847.1137112138797
STAT,1932,27,45-49,1959,2.2470700943981377
STAT,1899,35,30-34,1934,7.3486302338024405
STAT,1876,53,35-39,1929,0.00856323161192188
STAT,1868,42,50-100,1910,1.0191398161183491
SIM,1842,35,35-39,1877,237
STAT,1880,40,na,1920,2423.634900978703
SIM,1808,94,na,1902,19
STAT,1846,19,15-19,1865,4.363442303029985
STAT,1816,52,25-29,1868,0.01036505263715096
STAT,1874,68,na,1942,1577.201510852714
STAT,1820,82,na,1902,320.8743804582792
STAT,1895,17,na,1912,3285.491506377366
SIM,1889,42,30-34,1931,1
STAT,1814,44,15-19,1858,0.046988993217242155
STAT,1899,24,20-24,1923,93.53608061512686
SIM,1889,57,na,1946,3316
STAT,1948,15,50-100,1963,0.4246000471826034
SIM,1885,43,na,1928,1431
STAT,1864,20,40-44,1884,1.9528086682434818
STAT,1832,39,40-44,1871,0.35547172874595356
STAT,1917,37,20-24,1954,0.2701474884744368
STAT,1947,16,na,1963,4103.7125696811445
STAT,1931,40,25-29,1971,0.09498987038394358
STAT,1903,27,50-100,1930,0.9080505194522184
STAT,1883,43,25-29,1926,0.613320079648913
SIM,1902,19,25-29,1921,7
SIM,1871,32,na,1903,1879
STAT,1891,30,50-100,1921,1.1357903415043176
STAT,1910,39,25-29,1949,0.9217674559809689
STAT,1827,50,40-44,1877,0.009693165732964427
STAT,1841,25,25-29,1866,59.35645530991708
STAT,1904,35,15-19,1939,0.01748092108682975
SIM,1818,41,45-49,1859,4
STAT,1890,36,30-34,1926,6.4830795489891395
SIM,1862,29,20-24,1891,51
STAT,1855,73,na,1928,786.0980288460431
SIM,1873,58,na,1931,1459
STAT,1866,38,50-100,1904,1.115147866925745
SIM,1906,62,na,1968,3009
SIM,1836,63,na,1899,1299
STAT,1919,34,20-24,1953,2.574393478390129
STAT,1823,45,30-34,1868,0.1554141347978236
STAT,1886,56,na,1942,2112.143209001053
STAT,1892,21,30-34,1913,22.119858631389253
STAT,1931,17,na,1948,4783.889713764796
STAT,1854,29,20-24,1883,6.740276873927136
SIM,1863,37,na,1900,879
STAT,1886,47,20-24,1933,0.012368668216432906
SIM,1904,17,30-34,1921,16
STAT,1876,35,na,1911,2404.295311575064
STAT,1899,22,25-29,1921,78.18990857709363
STAT,1894,41,40-44,1935,2.8732530536806737
STAT,1954,18,30-34,1972,14.930231056140256
STAT,1825,51,na,1876,1498.584432917439
STAT,1830,81,na,1911,391.3903839476194
STAT,1843,29,45-49,1872,1.3307725759441658
STAT,1905,65,na,1970,2763.3899102669297
STAT,1928,2,na,1930,5114.139980429777
STAT,1843,23,30-34,1866,21.93215258725717
STAT,1922,43,30-34,1965,0.14487490988105792
STAT,1875,47,45-49,1922,0.24120733679434206
STAT,1829,65,na,1894,617.1227219554555
SIM,1895,42,na,1937,4508
STAT,1845,20,30-34,1865,11.132029647564671
STAT,1865,23,15-19,1888,3.0267037357277706
SIM,1940,0,na,1940,4989
SIM,1923,2,na,1925,4291
STAT,1872,53,20-24,1925,7.270584604794964E-4
STAT,1901,2,na,1903,3727.1662112964627
SIM,1895,8,na,1903,4649
SIM,1833,30,30-34,1863,2
SIM,1848,51,na,1899,2307
STAT,1877,32,45-49,1909,1.7701893906102555
STAT,1943,26,na,1969,3945.9192972459514
STAT,1797,62,na,1859,36.73323631208961
STAT,1950,0,na,1950,5159.443551890325
SIM,1841,34,na,1875,966
STAT,1902,15,40-44,1917,0.2587534958032603
STAT,1835,52,35-39,1887,0.006638312142406537
STAT,1910,39,na,1949,3522.0873054380777
SIM,1923,31,na,1954,4244
STAT,1875,36,35-39,1911,7.297801611998474
STAT,1910,20,35-39,1930,8.795668452858726
STAT,1894,21,50-100,1915,0.5201357636030711
SIM,1883,36,35-39,1919,60
SIM,1866,36,35-39,1902,169
STAT,1882,23,20-24,1905,65.7736581071383
STAT,1865,19,25-29,1884,5.268756542521898
STAT,1879,41,45-49,1920,1.5422600543779703
STAT,1912,48,25-29,1960,0.05024677912170309
SIM,1933,33,30-34,1966,120
STAT,1901,33,45-49,1934,2.427949306456694
STAT,1930,25,15-19,1955,0.8921234108932801
SIM,1937,23,na,1960,2982
STAT,1898,41,na,1939,3132.807789639786
STAT,1894,30,30-34,1924,22.381267939751325
SIM,1848,41,30-34,1889,6
STAT,1837,33,50-100,1870,0.9116088018289302
SIM,1942,13,na,1955,3646
STAT,1906,37,45-49,1943,0.623071221353009
STAT,1878,42,na,1920,2375.0358154021824
SIM,1866,47,45-49,1913,1
STAT,1877,34,40-44,1911,4.364598519366031
STAT,1817,56,na,1873,785.8260044844451
STAT,1890,46,50-100,1936,0.1681923197560498
STAT,1910,28,45-49,1938,1.6437960517712564
STAT,1844,33,na,1877,2541.0180145662594
SIM,1861,33,na,1894,2218
STAT,1888,24,45-49,1912,0.7997849145485469
STAT,1906,39,35-39,1945,2.18841689631534
SIM,1915,36,na,1951,3182
STAT,1871,22,50-100,1893,0.40678872433090063
STAT,1906,20,15-19,1926,4.805725929861891
STAT,1844,92,na,1936,41.26161174299649
STAT,1790,67,na,1857,999.6816710522722
SIM,1872,46,30-34,1918,2
STAT,1822,86,na,1908,127.94496991331718
STAT,1862,21,45-49,1883,0.6124041503205749
STAT,1864,46,30-34,1910,0.08825132806736943
STAT,1918,35,na,1953,3949.11345242363
SIM,1907,49,45-49,1956,1
STAT,1787,84,na,1871,50.54733718021129
STAT,1857,43,na,1900,1760.7444578055135
STAT,1866,36,na,1902,2160.930910457491
STAT,1879,83,na,1962,616.074720763526
STAT,1862,43,na,1905,1954.3571555448384
STAT,1915,17,40-44,1932,0.2886082548501912
STAT,1873,24,25-29,1897,58.353775903666296
STAT,1925,33,30-34,1958,18.52649595887835
STAT,1880,19,20-24,1899,18.306251815804703
STAT,1884,24,30-34,1908,16.9444634555727
SIM,1890,7,na,1897,4061
SIM,1938,24,25-29,1962,106
SIM,1883,57,na,1940,1967
STAT,1917,38,50-100,1955,0.4281338900983337
STAT,1881,25,na,1906,2268.9977829225736
SIM,1828,52,na,1880,1714
STAT,1845,46,20-24,1891,0.005971510590500078
SIM,1908,23,30-34,1931,41
STAT,1866,57,na,1923,1834.428786066547
SIM,1825,33,30-34,1858,1
STAT,1916,43,30-34,1959,0.12902196087317344
SIM,1807,53,na,1860,1094
STAT,1941,16,30-34,1957,12.415432700441473
STAT,1868,40,30-34,1908,1.1216356925398585
STAT,1845,58,na,1903,981.3175118838478
SIM,1925,38,na,1963,4741
SIM,1855,34,25-29,1889,9
SIM,1890,14,na,1904,4012
STAT,1806,49,40-44,1855,0.4881255635846917
STAT,1862,47,50-100,1909,0.20821235192615944
STAT,1847,34,25-29,1881,9.691085773857456
STAT,1836,31,45-49,1867,1.7066699758996537
STAT,1914,30,20-24,1944,2.4405809617529117
SIM,1918,47,30-34,1965,1
STAT,1867,98,na,1965,11.960399731886357
STAT,1817,39,45-49,1856,1.5075546569371896
STAT,1833,30,na,1863,1169.9818848982702
STAT,1919,46,15-19,1965,3.95222305131956E-4
STAT,1867,27,40-44,1894,2.8329948363300113
STAT,1916,49,na,1965,3694.949560438637
SIM,1834,22,25-29,1856,4
SIM,1823,39,40-44,1862,5
SIM,1890,23,20-24,1913,2
STAT,1868,51,40-44,1919,0.01021700154157156
STAT,1921,26,30-34,1947,43.299487743258396
STAT,1890,20,45-49,1910,0.8492194377754
STAT,1914,49,40-44,1963,0.15328513986596243
SIM,1803,60,na,1863,965
STAT,1842,42,25-29,1884,0.16492893868513198
STAT,1850,51,25-29,1901,0.0016433913092356153
STAT,1935,15,50-100,1950,0.510854382882966
STAT,1925,20,25-29,1945,110.20753592001597
STAT,1851,20,30-34,1871,17.04381712533411
STAT,1829,25,na,1854,1034.6849861226615
SIM,1859,35,na,1894,1943
STAT,1846,42,50-100,1888,0.6332698243904455
SIM,1850,42,25-29,1892,2
STAT,1836,33,40-44,1869,4.157087747183106
STAT,1901,45,45-49,1946,0.18799120590972995
STAT,1917,50,na,1967,3751.949422557716
STAT,1856,36,25-29,1892,2.0779469736132055
SIM,1868,31,30-34,1899,3
SIM,1933,20,25-29,1953,11
STAT,1945,24,20-24,1969,120.44014800688615
SIM,1874,21,na,1895,2679
STAT,1892,17,50-100,1909,0.06065654278492696
STAT,1928,29,15-19,1957,0.8622597056636792
STAT,1869,68,na,1937,1542.076458235077
STAT,1768,89,na,1857,94.351459703546
SIM,1904,36,na,1940,4085
SIM,1901,47,na,1948,3322
STAT,1865,54,na,1919,1911.7640385835145
SIM,1948,23,na,1971,5718
STAT,1868,43,na,1911,2216.2330666782477
STAT,1849,44,30-34,1893,0.9556254700940049
SIM,1916,36,40-44,1952,17
STAT,1914,49,50-100,1963,0.21989970983403306
STAT,1915,26,30-34,1941,39.53604095854804
STAT,1892,33,25-29,1925,12.627790121744052
STAT,1928,24,20-24,1952,136.9140248840875
SIM,1922,3,na,1925,3868
STAT,1814,52,20-24,1866,0.0024331028241177995
STAT,1915,8,na,1923,4101.902449634407
STAT,1789,105,na,1894,0.012468083359658962
SIM,1827,31,45-49,1858,20
STAT,1925,39,45-49,1964,0.8090007024777605
STAT,1847,20,40-44,1867,2.343135401928339
STAT,1877,20,na,1897,2415.1335575165363
SIM,1853,81,na,1934,425
SIM,1862,55,na,1917,3426
STAT,1920,25,50-100,1945,1.0851462248294044
STAT,1874,53,30-34,1927,0.006044787680710369
SIM,1922,49,50-100,1971,1
STAT,1925,31,35-39,1956,10.758730450697312
STAT,1841,81,na,1922,602.1764395381535
SIM,1903,11,na,1914,3027
STAT,1864,23,45-49,1887,0.6395087210029426
SIM,1889,48,50-100,1937,7
STAT,1926,16,35-39,1942,5.113099938904963
STAT,1855,40,45-49,1895,1.0005258711724454
STAT,1881,43,20-24,1924,0.14889134777640825
STAT,1932,29,35-39,1961,19.508509362282506
SIM,1913,32,na,1945,3263
SIM,1840,71,na,1911,2259
STAT,1875,3,na,1878,3165.3163451300247
SIM,1917,46,na,1963,2000
STAT,1854,91,na,1945,32.220010584541875
SIM,1840,55,na,1895,2500
SIM,1940,29,35-39,1969,291
STAT,1855,17,na,1872,1806.945704736744
STAT,1940,20,20-24,1960,112.07982071100206
SIM,1856,23,15-19,1879,5
STAT,1929,30,50-100,1959,1.0440303230264785
STAT,1821,103,na,1924,0.07247754239503588
STAT,1875,23,20-24,1898,70.54429013225929
SIM,1842,20,30-34,1862,57
SIM,1853,59,na,1912,2608
STAT,1886,22,45-49,1908,0.7221114243542578
STAT,1841,22,20-24,1863,97.21245452299841
SIM,1894,57,na,1951,1169
STAT,1906,10,na,1916,3750.976969426334
SIM,1897,49,na,1946,2249
STAT,1922,46,35-39,1968,0.1468277861200125
STAT,1873,53,50-100,1926,0.01524335053794997
STAT,1848,23,15-19,1871,3.7319233378100334
STAT,1825,33,35-39,1858,16.600844928212
STAT,1952,17,15-19,1969,53.88924104911751
STAT,1866,43,25-29,1909,0.5819385755382331
STAT,1818,52,35-39,1870,0.014731753583849852
SIM,1783,82,na,1865,783
STAT,1929,41,20-24,1970,0.022743233952603012
SIM,1872,73,na,1945,1216
STAT,1831,66,na,1897,1282.7713594649135
STAT,1905,31,50-100,1936,0.7598046732859105
SIM,1835,22,na,1857,1372
STAT,1918,43,40-44,1961,0.2619356397717833
SIM,1903,36,30-34,1939,3
SIM,1852,40,na,1892,2089
STAT,1818,41,na,1859,1828.15600925449
STAT,1844,50,40-44,1894,0.01057950354506182
STAT,1899,46,50-100,1945,0.1897629351708349
STAT,1885,43,35-39,1928,1.767080368393685
SIM,1850,70,na,1920,644
STAT,1816,74,na,1890,936.9128770992443
STAT,1853,69,na,1922,1137.9165551982044
STAT,1905,19,30-34,1924,2.2802009737364215
SIM,1936,29,15-19,1965,2
SIM,1812,53,na,1865,1143
SIM,1874,43,25-29,1917,1
SIM,1829,44,25-29,1873,6
SIM,1923,26,30-34,1949,505
SIM,1916,21,na,1937,4818
STAT,1951,21,35-39,1972,11.148539398587005
STAT,1866,31,30-34,1897,16.00268773521856
STAT,1888,35,25-29,1923,3.3546244232823534
STAT,1921,23,15-19,1944,5.922815474136447
STAT,1849,46,35-39,1895,0.11829778168202809
STAT,1825,53,50-100,1878,0.018160936039533147
STAT,1864,9,na,1873,2517.8451539675652
STAT,1937,18,30-34,1955,11.704370984126477
STAT,1829,50,45-49,1879,0.006748693105689311
SIM,1863,40,na,1903,878
STAT,1921,28,20-24,1949,20.032113100016932
STAT,1821,45,na,1866,1346.2598698894542
SIM,1930,28,na,1958,5346
SIM,1874,43,na,1917,2466
SIM,1883,17,na,1900,2234
STAT,1833,52,30-34,1885,0.0026292940249769883
STAT,1835,36,50-100,1871,1.1604316059898698
STAT,1907,35,na,1942,3497.62898303897
SIM,1845,40,na,1885,2401
STAT,1921,39,30-34,1960,2.0066409451461324
STAT,1897,34,20-24,1931,3.55906795253555
STAT,1789,70,na,1859,1121.214121310835
STAT,1828,62,na,1890,1237.246432870378
SIM,1837,29,na,1866,2193
SIM,1922,33,25-29,1955,3
SIM,1914,34,40-44,1948,6
STAT,1845,23,35-39,1868,3.568970074831783
STAT,1858,21,25-29,1879,50.521179960102074
STAT,1908,47,20-24,1955,0.009916993288831083
STAT,1879,17,50-100,1896,0.05025782118437213
STAT,1882,26,25-29,1908,40.6387990222052
STAT,1912,45,20-24,1957,0.010546667928372144
STAT,1902,40,50-100,1942,0.10434811999580537
SIM,1898,31,na,1929,4244
STAT,1855,53,20-24,1908,4.805404667320899E-4
STAT,1927,26,50-100,1953,1.2043214242828946
STAT,1841,44,na,1885,2606.7556245172386
STAT,1872,45,15-19,1917,4.045367470468795E-4
STAT,1856,33,20-24,1889,1.9449507023629773
STAT,1919,37,25-29,1956,1.0437251737817839
SIM,1864,33,20-24,1897,1
SIM,1866,44,40-44,1910,16
STAT,1847,31,20-24,1878,2.8993785462063975
STAT,1860,23,30-34,1883,14.871956986703841
STAT,1801,53,30-34,1854,0.01509588949646686
SIM,1905,8,na,1913,3894
SIM,1824,78,na,1902,857
STAT,1900,15,30-34,1915,2.2182226314558426
STAT,1830,35,20-24,1865,0.7178688832770863
STAT,1906,34,40-44,1940,3.575032166559116
SIM,1829,30,40-44,1859,1
SIM,1932,7,na,1939,6513
SIM,1814,60,na,1874,2442
STAT,1848,18,40-44,1866,0.2109235421910458
STAT,1832,23,25-29,1855,74.93457127247179
STAT,1870,43,45-49,1913,1.481271942905149
STAT,1926,27,15-19,1953,0.8390177862860538
STAT,1876,31,50-100,1907,0.9300251915143505
STAT,1881,47,15-19,1928,3.759777506242268E-4
STAT,1883,41,50-100,1924,1.0209511034175724
STAT,1891,24,na,1915,2890.1613725471816
STAT,1870,32,35-39,1902,10.096007636037232
STAT,1903,43,20-24,1946,0.015541712641847926
STAT,1843,51,50-100,1894,0.014993589167769775
STAT,1890,61,na,1951,2262.183803985619
STAT,1893,24,50-100,1917,0.5067608545252485
STAT,1934,26,40-44,1960,6.230598979998183
STAT,1860,16,50-100,1876,0.04636808960705193
STAT,1819,103,na,1922,0.03338049793443573
STAT,1851,48,40-44,1899,0.13351353887001222
STAT,1860,36,45-49,1896,1.634098173532981
STAT,1888,21,40-44,1909,2.4123175991099997
STAT,1858,44,40-44,1902,1.694506045325713
SIM,1886,46,na,1932,2972
SIM,1882,32,na,1914,1806
STAT,1860,25,35-39,1885,8.071349590071199
STAT,1919,42,50-100,1961,0.12561997586037355
STAT,1839,29,25-29,1868,48.801788723268174
STAT,1917,24,45-49,1941,1.1724990887480757
STAT,1912,20,45-49,1932,1.072151923667873
STAT,1934,37,20-24,1971,0.36131039051545605
SIM,1857,33,20-24,1890,17
STAT,1803,52,45-49,1855,0.0317026651834795
SIM,1870,3,na,1873,2985
SIM,1949,3,na,1952,4543
STAT,1812,43,35-39,1855,0.5995812016256158
STAT,1892,24,35-39,1916,7.179642919590212
SIM,1919,28,30-34,1947,10
STAT,1947,21,15-19,1968,5.95477722745435
STAT,1877,18,50-100,1895,0.04960235340672789
STAT,1884,20,15-19,1904,3.1769074528629577
STAT,1919,20,na,1939,3969.210632710839
STAT,1916,46,35-39,1962,0.13076114346800233
STAT,1831,44,15-19,1875,0.01313945843606873
STAT,1777,113,na,1890,0.0012793194712339515
SIM,1881,24,25-29,1905,467
STAT,1889,24,15-19,1913,3.947897047689997
STAT,1941,16,na,1957,3749.1962333384486
STAT,1819,66,na,1885,396.23164278584704
STAT,1888,20,na,1908,2745.9399209037774
STAT,1830,41,na,1871,1880.6645855572933
SIM,1891,41,50-100,1932,6
STAT,1920,17,na,1937,4076.4910317506333
SIM,1828,74,na,1902,713
STAT,1871,36,20-24,1907,0.7726564206048102
STAT,1913,18,15-19,1931,9.138569075132237
STAT,1925,24,40-44,1949,3.9629273903959046
STAT,1908,36,40-44,1944,1.3974331674559362
STAT,1912,39,35-39,1951,2.3098286654620024
STAT,1812,54,45-49,1866,0.0034298084112586347
STAT,1856,58,na,1914,1420.4164208743598
SIM,1865,47,na,1912,1701
STAT,1808,63,na,1871,558.8501147679906
STAT,1923,35,25-29,1958,1.130804932270752
STAT,1892,49,40-44,1941,0.11706762455986615
STAT,1777,85,na,1862,216.83739319466497
STAT,1903,32,40-44,1935,6.156017704872574
STAT,1952,19,na,1971,4367.694442220666
STAT,1867,23,25-29,1890,53.97160670107219
STAT,1873,21,20-24,1894,70.9024484425646
STAT,1849,33,20-24,1882,2.3752041041958223
STAT,1945,27,25-29,1972,71.4138517711698
STAT,1854,31,50-100,1885,0.5271517297772803
SIM,1901,39,25-29,1940,1
STAT,1851,23,35-39,1874,5.4643111101065305
STAT,1932,24,40-44,1956,4.365949875696996
SIM,1865,0,na,1865,2546
STAT,1901,30,40-44,1931,6.1124034573754
STAT,1840,46,15-19,1886,1.6087584926905853E-4
STAT,1923,1,na,1924,4852.131476206676
STAT,1804,89,na,1893,66.5619529599479
STAT,1879,86,na,1965,448.50287072186427
SIM,1906,24,35-39,1930,2
STAT,1828,39,20-24,1867,0.9924722185355098
SIM,1836,39,20-24,1875,7
SIM,1875,23,25-29,1898,425
STAT,1798,84,na,1882,167.8951986769896
STAT,1859,53,35-39,1912,0.006713918521376315
STAT,1849,20,50-100,1869,0.42145414802562403
STAT,1914,33,25-29,1947,9.135547191972273
SIM,1849,14,na,1863,2604
STAT,1895,7,na,1902,3389.236153209158
SIM,1873,38,50-100,1911,4
STAT,1868,83,na,1951,383.4381694891789
STAT,1831,45,50-100,1876,0.23764113490967376
SIM,1905,37,40-44,1942,31
STAT,1890,45,20-24,1935,0.014672118589194387
STAT,1825,51,20-24,1876,9.232473701680532E-4
STAT,1867,37,45-49,1904,1.8853003078592512
STAT,1870,25,na,1895,2395.345389756148
SIM,1869,50,na,1919,3598
STAT,1861,52,45-49,1913,0.012004896660565319
SIM,1886,68,na,1954,2499
SIM,1950,1,na,1951,4943
STAT,1838,44,25-29,1882,0.2843492819518218
STAT,1929,22,na,1951,4585.632259169337
STAT,1842,51,50-100,1893,0.0037671124148019133
STAT,1874,4,na,1878,3012.52384047628
STAT,1932,25,25-29,1957,85.68561782635331
STAT,1792,93,na,1885,9.146292133642925
STAT,1905,45,20-24,1950,0.009833054803882343
STAT,1914,9,na,1923,4047.3756020067044
STAT,1934,22,25-29,1956,123.29319759885342
STAT,1874,15,na,1889,2628.4770769569586
STAT,1920,35,45-49,1955,0.7380815775087325
STAT,1936,30,35-39,1966,8.798065542581355
STAT,1884,34,40-44,1918,4.1158762077341935
STAT,1903,48,20-24,1951,0.00948793757110117
STAT,1803,70,na,1873,504.27138870937
STAT,1898,45,35-39,1943,0.10725323016214311
STAT,1849,47,35-39,1896,0.11741291427504649
STAT,1925,32,na,1957,4450.080417879404
STAT,1921,22,15-19,1943,5.941173700872145
STAT,1930,27,50-100,1957,1.2567444920148756
STAT,1885,52,na,1937,2105.2455218833034
STAT,1840,41,45-49,1881,0.6226616291984722
STAT,1820,39,50-100,1859,2.105497417886304
SIM,1848,29,na,1877,2590
SIM,1915,40,25-29,1955,1
SIM,1865,60,na,1925,1665
STAT,1880,19,15-19,1899,6.127940234400211
STAT,1852,52,35-39,1904,0.00861964268239046
SIM,1922,46,na,1968,3315
STAT,1886,24,35-39,1910,6.0051021644933815
STAT,1796,83,na,1879,245.0805524627666
SIM,1854,23,na,1877,2112
STAT,1912,48,30-34,1960,0.0844425046155957
STAT,1915,24,na,1939,3698.201591667054
STAT,1854,88,na,1942,76.3321032356154
STAT,1860,17,na,1877,2159.7124528940794
STAT,1896,18,na,1914,3320.603473003503
STAT,1923,30,25-29,1953,10.568572181908433
SIM,1823,43,na,1866,1459
SIM,1830,25,20-24,1855,47
STAT,1847,39,25-29,1886,2.645352567988293
STAT,1844,41,45-49,1885,1.5381173359913822
STAT,1892,42,20-24,1934,0.1963833568849809
SIM,1907,34,40-44,1941,3
SIM,1815,48,na,1863,2000
STAT,1823,54,20-24,1877,0.0010647226976136387
STAT,1882,26,30-34,1908,24.19214630681632
STAT,1855,41,20-24,1896,0.10558384666199053
SIM,1894,24,35-39,1918,318
STAT,1873,48,25-29,1921,0.05834250192892659
STAT,1914,30,15-19,1944,0.12857932090128107
SIM,1940,25,25-29,1965,468
STAT,1856,39,35-39,1895,5.029021527907526
SIM,1853,30,40-44,1883,7
STAT,1814,51,45-49,1865,0.048811083036597064
SIM,1857,65,na,1922,658
STAT,1866,1,na,1867,3268.4703175346094
SIM,1840,25,20-24,1865,28
STAT,1824,56,na,1880,429.418250691581
STAT,1908,15,50-100,1923,0.07244729659831978
SIM,1891,15,na,1906,2430
STAT,1829,51,20-24,1880,3.364209474648505E-4
STAT,1919,21,50-100,1940,0.713092892045091
STAT,1867,18,45-49,1885,0.06278311083241586
STAT,1863,29,25-29,1892,35.85513500429449
STAT,1834,22,20-24,1856,40.61812689078554
SIM,1840,15,na,1855,2862
STAT,1882,19,25-29,1901,5.396288731278779
STAT,1914,49,35-39,1963,0.1253499978430127
STAT,1858,78,na,1936,596.6758925565716
STAT,1907,40,25-29,1947,0.06572160141032989
STAT,1847,46,30-34,1893,0.0877670027747484
STAT,1853,36,45-49,1889,1.5618610862006936
STAT,1848,18,35-39,1866,0.6327705899364731
SIM,1887,34,45-49,1921,45
STAT,1896,42,20-24,1938,0.014519925967025178
STAT,1940,20,15-19,1960,5.3655585612472265
STAT,1958,4,na,1962,5119.507692350061
STAT,1884,15,40-44,1899,0.17590153372106831
STAT,1879,34,45-49,1913,1.7735665888796293
STAT,1866,73,na,1939,1084.2028549881095
STAT,1924,19,40-44,1943,1.640789492471023
SIM,1837,40,40-44,1877,7
STAT,1899,60,na,1959,2694.6535465385914
STAT,1903,39,na,1942,3336.8004305079066
SIM,1846,44,25-29,1890,3
STAT,1884,27,35-39,1911,9.23665286211988
STAT,1880,50,45-49,1930,0.015282633832033548
STAT,1892,48,35-39,1940,0.09654578629264748
SIM,1861,70,na,1931,1395
STAT,1833,92,na,1925,17.136118182742884
STAT,1860,48,15-19,1908,3.2221641357518165E-4
SIM,1808,54,na,1862,1372
SIM,1858,13,na,1871,2490
SIM,1870,47,na,1917,1579
STAT,1829,100,na,1929,0.3876803600363571
STAT,1846,59,na,1905,1151.0377549034592
STAT,1832,25,20-24,1857,14.67060502585254
STAT,1902,22,35-39,1924,8.217292119364203
STAT,1929,40,45-49,1969,0.214615694498983
STAT,1817,43,40-44,1860,1.623335513245549
STAT,1833,40,30-34,1873,0.6148616904694439
STAT,1886,2,na,1888,3060.8966960836997
SIM,1912,27,30-34,1939,43
STAT,1849,48,na,1897,1871.8780595783753
STAT,1879,46,na,1925,2314.5290814482846
STAT,1865,15,30-34,1880,1.667436542166972
SIM,1890,19,25-29,1909,156
STAT,1904,27,30-34,1931,35.97727777668571
SIM,1884,44,50-100,1928,2
STAT,1902,19,20-24,1921,24.83073627556116
STAT,1918,45,50-100,1963,0.2385616648345865
STAT,1816,43,35-39,1859,5.795889967292025
STAT,1818,51,45-49,1869,0.02533425746420128
STAT,1913,25,15-19,1938,0.6993046629420048
STAT,1911,34,na,1945,3610.1662854085457
STAT,1844,51,30-34,1895,0.005925340177446021
STAT,1844,101,na,1945,0.5653104554968866
SIM,1853,75,na,1928,2003
STAT,1874,53,25-29,1927,0.003596898419971188
STAT,1819,40,40-44,1859,0.5046831435913236
STAT,1878,37,20-24,1915,0.7931027026953665
STAT,1882,10,na,1892,2480.004691581804
STAT,1886,31,40-44,1917,4.5092398105943206
STAT,1884,28,50-100,1912,0.6102043596817025
STAT,1889,16,30-34,1905,1.924091480412959
SIM,1851,26,35-39,1877,40
STAT,1933,30,25-29,1963,12.385090682583327
SIM,1832,73,na,1905,167
SIM,1859,4,na,1863,2466
SIM,1917,22,50-100,1939,29
STAT,1842,54,30-34,1896,0.0014370520611355587
STAT,1831,54,25-29,1885,0.0028240396605954117
STAT,1871,23,45-49,1894,0.6934592612425646
STAT,1832,45,50-100,1877,0.02273642778801029
STAT,1837,36,20-24,1873,0.7603878600686756
STAT,1856,95,na,1951,9.549567679796422
SIM,1910,21,na,1931,4348
SIM,1847,25,30-34,1872,35
SIM,1877,20,25-29,1897,10
SIM,1944,5,na,1949,2649
STAT,1859,17,40-44,1876,0.16827702468726602
STAT,1862,20,30-34,1882,15.756294760212185
SIM,1863,18,na,1881,1516
STAT,1942,30,35-39,1972,9.634179015439052
SIM,1778,82,na,1860,830
STAT,1841,28,na,1869,2970.53979328217
STAT,1840,30,20-24,1870,1.3235645247252876
STAT,1866,34,35-39,1900,9.165030440579741
STAT,1821,39,50-100,1860,1.4363996856778543
STAT,1860,26,35-39,1886,8.013397300014486
STAT,1915,22,15-19,1937,5.424786735868512
SIM,1874,34,35-39,1908,12
STAT,1908,32,25-29,1940,8.656823797755909
SIM,1856,30,na,1886,752
STAT,1829,43,45-49,1872,0.70960644906854
STAT,1923,27,40-44,1950,5.295090708865804
STAT,1939,19,50-100,1958,0.37065109423618386
STAT,1820,51,45-49,1871,0.02245445605473069
STAT,1841,28,35-39,1869,13.24962662043066
SIM,1896,30,na,1926,3259
STAT,1843,26,35-39,1869,11.817614402384832
STAT,1849,52,20-24,1901,6.184549082526026E-4
STAT,1867,21,na,1888,2262.154084939236
STAT,1849,43,30-34,1892,0.9617034358083135
STAT,1866,52,20-24,1918,6.700007781749788E-4
STAT,1888,37,20-24,1925,0.8896858056169016
STAT,1894,35,na,1929,3024.4518411552403
STAT,1899,26,40-44,1925,4.105583851998615
STAT,1899,45,40-44,1944,0.13321826740506568
STAT,1855,33,45-49,1888,1.162998313817018
SIM,1887,42,20-24,1929,2
STAT,1948,11,na,1959,4450.106076721926
STAT,1887,27,50-100,1914,0.7040922612255084
STAT,1908,20,na,1928,3501.939082260763
STAT,1840,49,40-44,1889,0.0662586843068874
STAT,1839,25,30-34,1864,29.90110283570408
STAT,1862,36,50-100,1898,1.0507519810702781
STAT,1879,42,20-24,1921,0.16271615856689975
SIM,1789,76,na,1865,215
STAT,1881,42,45-49,1923,1.4116087441091185
SIM,1916,24,na,1940,4795
STAT,1870,48,15-19,1918,3.937623216534203E-4
SIM,1860,69,na,1929,1638
SIM,1878,33,na,1911,4192
STAT,1854,29,15-19,1883,0.2606736933469364
STAT,1828,40,na,1868,1836.0267704793064
STAT,1873,67,na,1940,1626.0841513954022
STAT,1830,39,15-19,1869,0.05016750976529532
STAT,1878,18,20-24,1896,18.192550799055084
STAT,1948,15,35-39,1963,4.755521409530061
STAT,1828,46,na,1874,1709.289239685581
SIM,1835,62,na,1897,1160
STAT,1848,51,30-34,1899,0.005596895847833647
SIM,1890,67,na,1957,3078
STAT,1891,19,35-39,1910,0.6711447902565129
SIM,1871,26,20-24,1897,8
STAT,1845,33,45-49,1878,1.0182342544732486
STAT,1896,34,45-49,1930,2.279075304684903
STAT,1927,3,na,1930,5002.152158015004
STAT,1939,25,35-39,1964,14.940271265626286
STAT,1924,40,25-29,1964,0.08435653661808226
STAT,1809,67,na,1876,1876.714006973112
STAT,1906,32,20-24,1938,2.247546418853444
STAT,1860,22,30-34,1882,14.97950986755287
STAT,1864,34,25-29,1898,9.231892273017388
SIM,1831,30,20-24,1861,6
STAT,1840,110,na,1950,1.0880939124620413E-4
STAT,1816,77,na,1893,729.7427203721089
STAT,1847,16,50-100,1863,0.05561130985867367
STAT,1869,29,50-100,1898,0.6408884765456747
STAT,1928,36,15-19,1964,0.02410642648950724
STAT,1851,44,25-29,1895,0.5003250019001518
STAT,1878,15,40-44,1893,0.18905765632221538
STAT,1923,49,45-49,1972,0.25009916895061124
STAT,1833,52,25-29,1885,0.0015645385782959394
STAT,1838,46,20-24,1884,0.005338028110793633
STAT,1893,35,50-100,1928,1.5499076614474483
STAT,1860,110,na,1970,0.003130000768684754
SIM,1798,59,na,1857,42
STAT,1881,20,40-44,1901,1.9795814753443226
STAT,1898,33,50-100,1931,1.2268913597404525
STAT,1920,46,25-29,1966,0.05802683944166559
SIM,1830,47,na,1877,378
STAT,1853,47,na,1900,1736.368154887151
STAT,1899,38,35-39,1937,2.074828751010988
SIM,1872,54,na,1926,2166
STAT,1843,45,na,1888,2270.0063595017955
STAT,1843,33,40-44,1876,5.098024140322971
SIM,1810,70,na,1880,2853
STAT,1914,37,40-44,1951,1.4738672414128589
STAT,1892,28,na,1920,2944.339016360273
STAT,1823,49,40-44,1872,0.25957813969219856
STAT,1869,28,20-24,1897,11.796325221334808
STAT,1902,38,20-24,1940,0.23312900050568572
STAT,1869,20,25-29,1889,58.35892579893084
SIM,1883,23,20-24,1906,6
SIM,1925,33,35-39,1958,1
STAT,1940,30,25-29,1970,9.469120516298752
SIM,1862,36,20-24,1898,2
SIM,1931,29,na,1960,4996
STAT,1944,27,na,1971,4003.2950127872778
STAT,1957,8,na,1965,5136.248599639024
SIM,1952,8,na,1960,6372
STAT,1890,21,20-24,1911,83.67783623962885
STAT,1895,34,50-100,1929,1.181713892026905
STAT,1854,36,20-24,1890,0.4306685113298855
STAT,1890,32,45-49,1922,2.1110838195398642
STAT,1875,26,50-100,1901,0.6591237553020496
SIM,1902,45,45-49,1947,1
SIM,1911,52,na,1963,2293
STAT,1810,46,35-39,1856,7.449956119438914E-4
STAT,1838,33,45-49,1871,0.9154432329594848
STAT,1858,25,40-44,1883,2.375805263772982
STAT,1839,89,na,1928,97.60166548857288
STAT,1916,34,40-44,1950,3.9509978380020776
SIM,1949,22,35-39,1971,99
STAT,1790,64,na,1854,1118.0
STAT,1845,71,na,1916,662.3507715725298
STAT,1917,33,35-39,1950,9.401725390410276
STAT,1863,19,15-19,1882,5.199135138151381
STAT,1895,21,50-100,1916,0.532084895521886
STAT,1834,32,30-34,1866,9.856402561077196
STAT,1867,34,40-44,1901,4.066248933888149
STAT,1819,43,45-49,1862,0.31410129403877
STAT,1826,39,na,1865,2215.6317464151357
STAT,1827,40,30-34,1867,1.1209238836337976
STAT,1873,45,20-24,1918,0.012432074950342467
STAT,1919,30,35-39,1949,9.806506332168118
STAT,1924,42,50-100,1966,0.1383959526505655
SIM,1909,14,na,1923,4248
STAT,1796,67,na,1863,1334.1326910324476
STAT,1921,27,30-34,1948,43.15140349517648
STAT,1856,48,25-29,1904,0.04085157126578889
STAT,1806,54,20-24,1860,0.0018677552879321822
STAT,1932,22,20-24,1954,144.8821606385981
STAT,1858,28,45-49,1886,0.8617580814129587
STAT,1837,23,na,1860,2228.1842469768208
STAT,1849,61,na,1910,1574.4971573815662
STAT,1887,81,na,1968,969.6937102719091
SIM,1865,44,na,1909,1704
STAT,1825,32,20-24,1857,4.684870586105178
STAT,1864,30,50-100,1894,0.8396599551415281
SIM,1946,22,na,1968,3763
STAT,1922,45,20-24,1967,0.012613114252853979
STAT,1931,30,15-19,1961,0.16738887806847347
STAT,1863,26,20-24,1889,10.087713999990441
STAT,1814,40,20-24,1854,0.6426545936077622
STAT,1832,35,30-34,1867,0.3790044486157815
STAT,1837,76,na,1913,759.6600951218186
STAT,1906,30,25-29,1936,8.585004901457214
STAT,1856,18,na,1874,1938.008933632375
STAT,1892,45,25-29,1937,0.040628197491846756
STAT,1869,47,20-24,1916,0.012052530357318155
SIM,1865,44,35-39,1909,1
STAT,1892,23,20-24,1915,85.05649435504675
STAT,1840,40,na,1880,973.608433919034
SIM,1927,1,na,1928,2247
SIM,1863,43,na,1906,780
STAT,1834,34,na,1868,1198.2728735382038
STAT,1857,44,35-39,1901,1.3707923415377545
STAT,1825,54,25-29,1879,0.00417559980117332
STAT,1898,59,na,1957,2657.8713668144082
STAT,1920,48,20-24,1968,0.012025421045628358
STAT,1842,28,50-100,1870,0.1949700574711536
SIM,1892,24,30-34,1916,234
SIM,1949,11,na,1960,4480
STAT,1911,18,na,1929,3811.378660874512
STAT,1817,46,45-49,1863,0.1675390097673347
STAT,1881,31,20-24,1912,2.563059135424763
STAT,1862,45,45-49,1907,0.20301487399005366
STAT,1816,105,na,1921,0.024753286253239255
SIM,1881,37,na,1918,3009
SIM,1872,34,25-29,1906,25
STAT,1920,32,40-44,1952,4.231319375133995
STAT,1874,41,30-34,1915,1.1919028682904813
STAT,1884,37,45-49,1921,1.9083097979768908
STAT,1846,51,20-24,1897,4.3913184674688414E-4
STAT,1851,22,20-24,1873,64.99594726118093
STAT,1853,30,30-34,1883,14.233960358853126
STAT,1863,50,45-49,1913,0.012567467569583744
STAT,1873,36,30-34,1909,5.49328512934892
STAT,1945,20,35-39,1965,10.212803808516014
STAT,1837,29,15-19,1866,0.4602451986187315
STAT,1949,5,na,1954,4541.345062641582
STAT,1865,18,35-39,1883,0.5131962617120962
STAT,1912,32,15-19,1944,0.12497878148659054
STAT,1851,53,50-100,1904,0.01173652193101445
STAT,1861,42,35-39,1903,1.5040964548614484
SIM,1886,62,na,1948,2614
STAT,1858,47,45-49,1905,0.1793845574225797
STAT,1912,2,na,1914,4074.2195177559743
STAT,1943,23,35-39,1966,9.900257836499188
SIM,1878,67,na,1945,1639
SIM,1864,48,25-29,1912,3
STAT,1838,24,na,1862,1166.0256447383922
STAT,1875,33,30-34,1908,17.852891165340186
STAT,1936,26,na,1962,3551.1497990846415
STAT,1882,29,50-100,1911,0.608070774878299
STAT,1895,37,20-24,1932,1.0027761026272202
SIM,1931,20,15-19,1951,4
STAT,1856,29,25-29,1885,31.03340981037206
STAT,1811,83,na,1894,240.50697446871683
SIM,1830,28,25-29,1858,3
STAT,1913,17,30-34,1930,2.4608346807108616
STAT,1914,40,25-29,1954,0.07026217176411788
STAT,1836,33,35-39,1869,9.707598371268753
STAT,1828,46,20-24,1874,0.014518192384519788
STAT,1864,42,45-49,1906,1.3589296649583549
STAT,1960,11,na,1971,5070.610079589231
STAT,1883,45,na,1928,2186.022586285837
STAT,1803,88,na,1891,34.62999900264585
STAT,1886,34,45-49,1920,1.7903545763655433
SIM,1881,36,30-34,1917,10
STAT,1844,54,35-39,1898,0.008294360223488978
STAT,1879,31,40-44,1910,4.4669570904501805
SIM,1866,48,na,1914,2839
STAT,1845,109,na,1954,3.530384377417822E-4
STAT,1901,32,30-34,1933,24.412442036840826
STAT,1850,58,na,1908,913.1786946439522
STAT,1875,48,35-39,1923,0.14195297085733313
SIM,1872,42,45-49,1914,2
STAT,1842,52,35-39,1894,0.0021257741796927893
STAT,1923,20,15-19,1943,6.165157546769086
STAT,1940,27,40-44,1967,4.6996677116895365
STAT,1833,86,na,1919,91.28811566666894
STAT,1928,17,15-19,1945,56.74944119447713
STAT,1859,46,50-100,1905,0.19521342464594724
SIM,1899,35,na,1934,1799
SIM,1846,71,na,1917,319
STAT,1838,41,20-24,1879,0.0803059597132131
STAT,1862,26,45-49,1888,0.9560413549151299
STAT,1891,40,na,1931,2870.876783280924
STAT,1806,53,na,1859,1004.6576394371592
STAT,1941,19,40-44,1960,1.423368783144743
STAT,1887,41,40-44,1928,2.486919647121231
STAT,1776,111,na,1887,0.0023732837742202165
SIM,1931,39,35-39,1970,11
STAT,1892,45,30-34,1937,0.06827794366518432
STAT,1885,42,45-49,1927,1.4693103126656564
SIM,1791,64,na,1855,1118
STAT,1858,22,50-100,1880,0.35730476654418725
SIM,1931,23,na,1954,1959
STAT,1923,24,30-34,1947,32.88269749719505
SIM,1824,43,35-39,1867,13
SIM,1841,40,30-34,1881,1
SIM,1844,45,na,1889,2608
SIM,1819,78,na,1897,45
SIM,1876,41,30-34,1917,10
SIM,1918,25,na,1943,4443
STAT,1850,52,25-29,1902,0.0016268587926647042
STAT,1862,23,35-39,1885,5.051526655045178
STAT,1839,28,35-39,1867,11.21216172921905
SIM,1868,44,45-49,1912,1
SIM,1858,23,25-29,1881,3
STAT,1837,39,25-29,1876,2.7530148211614702
STAT,1883,34,35-39,1917,9.659262052875844
STAT,1803,53,35-39,1856,0.018400245055511428
STAT,1858,44,na,1902,1741.1869533946228
STAT,1939,15,25-29,1954,43.00649362270914
STAT,1826,48,50-100,1874,0.34683550280986647
STAT,1854,17,20-24,1871,11.791774518990342
STAT,1844,22,50-100,1866,0.504412125665595
STAT,1825,54,30-34,1879,0.0070173275112704854
STAT,1846,40,40-44,1886,1.383279397066771
STAT,1862,48,25-29,1910,0.0484438384248092
STAT,1854,94,na,1948,11.112612548090164
STAT,1857,53,25-29,1910,0.0026743635796736436
SIM,1883,33,30-34,1916,5
STAT,1880,26,20-24,1906,12.220853710790893
STAT,1938,33,na,1971,3759.8147399379905
STAT,1899,48,45-49,1947,0.1795445539850549
STAT,1901,42,40-44,1943,0.21812440482132842
SIM,1853,20,30-34,1873,10
STAT,1836,41,na,1877,1938.844394617771
SIM,1853,41,na,1894,3213
SIM,1861,17,na,1878,2483
STAT,1886,34,na,1920,2449.987693910944
SIM,1914,51,na,1965,4713
STAT,1768,86,na,1854,178.0
STAT,1879,45,25-29,1924,0.05967746021325061
STAT,1868,41,30-34,1909,1.1154554798739638
SIM,1847,28,35-39,1875,274
STAT,1867,17,30-34,1884,1.5409846151467967
STAT,1908,14,na,1922,3788.9473923227
STAT,1841,37,25-29,1878,3.77750244067237
STAT,1914,46,30-34,1960,0.08739832469203732
STAT,1871,20,40-44,1891,2.091092879829051
STAT,1847,35,na,1882,2256.42867064053
STAT,1899,29,45-49,1928,1.5056878192909227
STAT,1831,51,20-24,1882,6.243634915580276E-4
STAT,1870,44,35-39,1914,1.780892629361116
STAT,1824,101,na,1925,0.11042919924550555
STAT,1841,18,25-29,1859,8.09065559295438
STAT,1845,30,40-44,1875,2.612373791988147
STAT,1818,39,20-24,1857,1.6676789617937073
SIM,1831,72,na,1903,850
STAT,1877,37,45-49,1914,2.0236289184525265
STAT,1942,24,40-44,1966,3.482764218441976
STAT,1807,50,30-34,1857,0.01979819278533728
STAT,1882,18,50-100,1900,0.04678243534696186
STAT,1863,90,na,1953,67.30716147303421
STAT,1938,30,45-49,1968,1.56706296543608
STAT,1922,19,30-34,1941,13.874100280562669
STAT,1853,13,na,1866,2216.5677723264935
SIM,1848,35,na,1883,2624
STAT,1927,43,15-19,1970,0.0019072682723639154
STAT,1869,62,na,1931,1844.330379994167
STAT,1801,54,45-49,1855,0.03607570782175441
STAT,1850,15,30-34,1865,0.9100542239197721
STAT,1814,41,50-100,1855,3.9143780907857355
SIM,1936,28,30-34,1964,37
SIM,1841,56,na,1897,77
STAT,1836,36,45-49,1872,1.8945706183669504
STAT,1851,41,20-24,1892,0.12599689126127264
STAT,1872,52,20-24,1924,7.349889916999384E-4
SIM,1857,43,30-34,1900,3
SIM,1893,56,na,1949,2792
STAT,1828,27,20-24,1855,24.54661501812416
STAT,1876,27,45-49,1903,1.122414344346071
STAT,1906,35,25-29,1941,0.9084496067375826
SIM,1831,33,25-29,1864,17
SIM,1851,58,na,1909,1047
STAT,1895,30,na,1925,3129.2390669397582
SIM,1827,27,na,1854,2509
STAT,1881,46,25-29,1927,0.054548866711459434
SIM,1823,47,25-29,1870,1
SIM,1829,56,na,1885,1785
SIM,1852,29,20-24,1881,1
SIM,1782,81,na,1863,514
STAT,1842,33,35-39,1875,3.005588140178308
SIM,1832,25,30-34,1857,1
SIM,1890,11,na,1901,4046
STAT,1886,21,30-34,1907,18.501200189664132
STAT,1859,52,45-49,1911,0.011441198884794742
STAT,1890,24,25-29,1914,68.86811120474151
STAT,1843,36,45-49,1879,2.323397372241204
STAT,1835,26,45-49,1861,1.1027937763482338
STAT,1870,31,45-49,1901,1.7455786249223342
SIM,1906,22,na,1928,3557
STAT,1895,18,20-24,1913,23.00213468586726
STAT,1881,62,na,1943,1726.0138172212244
SIM,1890,41,50-100,1931,5
STAT,1838,30,40-44,1868,2.348653955934153
STAT,1814,47,50-100,1861,0.8396123022569636
STAT,1790,100,na,1890,0.30869507960783793
STAT,1815,73,na,1888,87.73273864527053
STAT,1838,49,25-29,1887,0.024656412933300058
SIM,1903,57,na,1960,2024
STAT,1820,41,35-39,1861,3.044177686379512
STAT,1878,18,45-49,1896,0.06703222970231441
STAT,1904,22,45-49,1926,0.9962604957792545
STAT,1927,40,35-39,1967,0.25118159505430854
STAT,1917,27,50-100,1944,1.0299059441511897
STAT,1935,36,50-100,1971,0.5833971893735541
STAT,1823,33,25-29,1856,23.68064166746307
SIM,1881,26,20-24,1907,4
STAT,1888,47,30-34,1935,0.11120218789422975
STAT,1821,44,45-49,1865,1.624877171756515
STAT,1866,33,20-24,1899,2.456990169575484
STAT,1937,35,50-100,1972,0.4162153519412477
STAT,1864,31,20-24,1895,2.46740968891447
STAT,1887,19,na,1906,2764.9590964407284
SIM,1836,27,20-24,1863,14
STAT,1894,31,30-34,1925,22.293533369427504
STAT,1920,43,20-24,1963,0.019223524116615896
STAT,1891,16,30-34,1907,1.964840938185928
SIM,1892,40,na,1932,3638
STAT,1815,47,25-29,1862,0.005838553039180242
STAT,1890,48,25-29,1938,0.03883984467615042
SIM,1812,59,na,1871,1074
STAT,1818,78,na,1896,475.5630525694351
SIM,1888,29,35-39,1917,1
STAT,1882,38,25-29,1920,2.7429003151149813
SIM,1870,13,na,1883,2671
SIM,1868,74,na,1942,328
STAT,1881,34,25-29,1915,9.58976773655472
STAT,1851,32,30-34,1883,14.35245539484619
STAT,1869,84,na,1953,335.68440051885494
STAT,1920,46,30-34,1966,0.09751732833487929
STAT,1856,45,20-24,1901,0.008704971144950831
STAT,1933,34,40-44,1967,5.231166153504221
STAT,1836,21,40-44,1857,2.1225885349895153
STAT,1832,38,35-39,1870,0.5572997272163317
STAT,1795,82,na,1877,204.8394287944132
STAT,1897,26,50-100,1923,0.8524601310926365
STAT,1864,3,na,1867,2919.8661667816773
SIM,1933,30,na,1963,4371
STAT,1871,26,na,1897,2388.830854251354
STAT,1846,37,na,1883,1457.1405705261536
SIM,1929,38,40-44,1967,4
SIM,1812,44,45-49,1856,7
STAT,1845,26,45-49,1871,0.67545580446963
STAT,1799,72,na,1871,111.47738955659544
SIM,1921,45,na,1966,5171
SIM,1850,76,na,1926,121
SIM,1904,29,30-34,1933,5
STAT,1853,45,50-100,1898,0.1923340237640522
SIM,1906,25,25-29,1931,40
STAT,1814,43,25-29,1857,2.181264299399986
STAT,1899,23,30-34,1922,24.254037663911557
STAT,1844,29,20-24,1873,14.023983192136257
SIM,1919,29,na,1948,4910
STAT,1873,42,50-100,1915,1.0823526237338936
STAT,1926,33,na,1959,4531.143003013496
STAT,1887,44,45-49,1931,1.6250761019935418
STAT,1888,66,na,1954,1891.6860167799332
STAT,1900,18,40-44,1918,0.2527091034455067
STAT,1813,47,na,1860,2257.561639409555
STAT,1910,21,25-29,1931,86.0320179321357
STAT,1857,99,na,1956,1.7129061567665504
STAT,1861,51,30-34,1912,0.004974081624858521
STAT,1947,21,20-24,1968,124.38786314763502
STAT,1827,43,35-39,1870,1.6955719922963668
SIM,1908,33,35-39,1941,1
STAT,1840,45,25-29,1885,0.02346484912113076
STAT,1867,20,15-19,1887,3.1783159984976654
STAT,1903,49,35-39,1952,0.10976056924968419
STAT,1906,32,15-19,1938,0.11840950853878685
STAT,1881,19,na,1900,2372.2599686330104
STAT,1814,107,na,1921,0.0031916846379586835
STAT,1914,23,na,1937,3667.613924475923
STAT,1954,17,25-29,1971,53.09885811823224
SIM,1881,31,na,1912,3092
STAT,1842,32,20-24,1874,0.8106080381521518
STAT,1851,44,30-34,1895,0.8957431448982466
STAT,1942,20,25-29,1962,95.80837707394888
STAT,1858,22,na,1880,1873.4213212905777
STAT,1828,49,25-29,1877,0.06697701371356171
SIM,1836,49,25-29,1885,1
STAT,1901,35,40-44,1936,1.3336439834188554
SIM,1807,50,na,1857,1094
STAT,1894,34,35-39,1928,12.76791219947483
STAT,1836,43,45-49,1879,1.346944996686744
STAT,1914,48,na,1962,3582.8583506972127
SIM,1868,9,na,1877,1405
STAT,1939,19,40-44,1958,1.3837644216453195
SIM,1875,20,15-19,1895,36
STAT,1834,47,35-39,1881,0.06543437835265406
STAT,1923,35,50-100,1958,0.4821960730924461
STAT,1870,19,20-24,1889,17.63295854817933
STAT,1825,42,30-34,1867,1.528974445572471
STAT,1906,31,50-100,1937,0.7649556402206613
STAT,1932,17,40-44,1949,1.8392229549750712
STAT,1907,44,40-44,1951,0.22482639723258832
STAT,1807,53,35-39,1860,0.02688199247907565
STAT,1888,44,20-24,1932,0.18082208173797892
SIM,1882,4,na,1886,2492
STAT,1874,44,35-39,1918,1.843653886427606
STAT,1940,24,30-34,1964,28.93036844836233
SIM,1912,23,15-19,1935,16
STAT,1852,8,na,1860,2989.5789442694336
STAT,1873,39,35-39,1912,7.182237772045512
STAT,1868,37,na,1905,2275.569689282802
SIM,1921,48,na,1969,5137
STAT,1889,21,50-100,1910,0.49255399897939184
STAT,1847,43,20-24,1890,0.14254832495672878
STAT,1876,24,40-44,1900,2.093351791089763
STAT,1831,32,45-49,1863,1.8544712483501722
STAT,1806,48,35-39,1854,0.4481269216947201
STAT,1870,41,na,1911,2314.5772336131745
STAT,1900,22,50-100,1922,0.564906109257848
SIM,1906,56,na,1962,3086
STAT,1868,21,50-100,1889,0.39672133127187414
STAT,1872,52,45-49,1924,0.014454782954869027
STAT,1909,16,35-39,1925,0.8165045575308019
STAT,1910,29,20-24,1939,17.30511133483573
STAT,1894,51,na,1945,2751.270215540004
STAT,1851,89,na,1940,82.97049134978181
STAT,1892,33,30-34,1925,21.525545636352263
STAT,1890,46,35-39,1936,0.09587510112925679
SIM,1826,42,na,1868,1917
STAT,1845,39,15-19,1884,0.02867559587429283
STAT,1853,33,35-39,1886,8.00282646642476
STAT,1949,22,25-29,1971,106.7207071706897
STAT,1898,44,20-24,1942,0.014629767509567551
STAT,1932,22,15-19,1954,6.935893655566108
STAT,1894,49,15-19,1943,2.8093744189834293E-4
STAT,1923,39,35-39,1962,2.767183282939522
STAT,1857,17,30-34,1874,1.437533401641304
SIM,1881,53,na,1934,2493
STAT,1855,44,50-100,1899,0.6897605243929599
STAT,1914,45,na,1959,3609.756437204169
SIM,1861,33,35-39,1894,3
STAT,1935,17,15-19,1952,61.59532590143105
STAT,1927,9,na,1936,4909.421002738501
STAT,1820,50,30-34,1870,0.009394655648382952
STAT,1932,29,40-44,1961,6.056526042938387
STAT,1867,27,35-39,1894,9.125281703738606
STAT,1919,33,45-49,1952,1.6680893388122795
STAT,1857,50,20-24,1907,5.743881332495393E-4
STAT,1914,29,na,1943,3697.363482459393
STAT,1827,31,50-100,1858,0.9579723266574561
STAT,1883,50,30-34,1933,0.005808903526257632
STAT,1915,29,40-44,1944,4.653506378062528
STAT,1937,26,15-19,1963,0.6813500263142592
STAT,1941,22,na,1963,3730.9431521642064
STAT,1815,54,50-100,1869,0.0014204506737016671
STAT,1868,44,35-39,1912,1.7254038775460065
SIM,1899,32,na,1931,1869
STAT,1839,38,50-100,1877,1.3490152156159538
STAT,1832,32,20-24,1864,0.1766374303403473
STAT,1853,48,15-19,1901,3.0625810705339697E-4
STAT,1893,17,35-39,1910,0.6861760477948574
STAT,1901,46,20-24,1947,0.00949138958033686
SIM,1859,44,35-39,1903,5
STAT,1872,40,45-49,1912,1.5137971719874035
SIM,1834,23,30-34,1857,2
STAT,1831,32,50-100,1863,0.9743831922708447
STAT,1915,30,50-100,1945,0.8368350081486706
SIM,1918,41,na,1959,4369
SIM,1919,26,na,1945,5127
SIM,1940,29,40-44,1969,14
SIM,1890,22,15-19,1912,21
STAT,1882,22,15-19,1904,3.158519451257687
STAT,1883,29,na,1912,2279.5289419748296
STAT,1857,41,30-34,1898,0.8862028473659666
SIM,1913,37,50-100,1950,3
STAT,1916,30,25-29,1946,9.487840731106271
STAT,1922,40,na,1962,4226.987245987763
SIM,1782,84,na,1866,514
SIM,1893,41,na,1934,3176
STAT,1858,25,35-39,1883,7.652640953358943
STAT,1874,50,20-24,1924,7.725261384196632E-4
SIM,1839,27,30-34,1866,38
STAT,1871,16,45-49,1887,0.06597146104430511
STAT,1815,44,20-24,1859,0.01631246990606191
SIM,1924,30,25-29,1954,13
STAT,1916,42,25-29,1958,0.07218036576047909
STAT,1893,24,40-44,1917,2.589547778224594
STAT,1800,99,na,1899,1.3067214660231155
STAT,1841,15,20-24,1856,25.764442313765993
STAT,1901,23,40-44,1924,2.9046101006502627
SIM,1929,24,15-19,1953,26
SIM,1900,68,na,1968,3491
STAT,1898,18,30-34,1916,2.137687556173819
STAT,1877,41,40-44,1918,2.2936170001973144
STAT,1901,41,na,1942,3257.443834779311
STAT,1841,34,20-24,1875,3.5770048998481037
STAT,1876,17,40-44,1893,0.18489817075388787
STAT,1867,15,40-44,1882,0.17893596515337873
SIM,1818,47,na,1865,842
STAT,1826,33,40-44,1859,8.064971478329278
STAT,1909,22,50-100,1931,0.6053242831386283
SIM,1848,29,30-34,1877,2
STAT,1834,49,na,1883,1024.9108888642547
STAT,1821,61,na,1882,998.7203850308566
STAT,1877,44,50-100,1921,1.0579500726191555
STAT,1912,38,20-24,1950,0.25303689249008976
SIM,1845,24,na,1869,2549
STAT,1856,26,20-24,1882,8.79457245650243
STAT,1926,23,35-39,1949,11.306100343536299
SIM,1885,41,40-44,1926,30
STAT,1880,29,25-29,1909,43.60153676425287
STAT,1919,21,45-49,1940,1.2193887989349017
SIM,1889,51,na,1940,3740
STAT,1886,24,40-44,1910,2.1443796938946664
STAT,1897,5,na,1902,3480.344065195983
STAT,1916,49,45-49,1965,0.2185904684398818
STAT,1911,45,45-49,1956,0.2043945833857791
STAT,1831,51,45-49,1882,0.012279148201310734
STAT,1848,107,na,1955,0.0044130695275170165
STAT,1831,69,na,1900,1148.5728932625261
STAT,1945,23,45-49,1968,1.219153652544825
STAT,1882,66,na,1948,1569.2051282168068
STAT,1895,14,na,1909,3348.639017076242
STAT,1806,62,na,1868,811.8755887319172
SIM,1868,71,na,1939,328
STAT,1887,1,na,1888,3269.4087385689895
STAT,1852,23,40-44,1875,2.473884650513901
STAT,1812,84,na,1896,26.34512139603526
SIM,1894,24,40-44,1918,27
STAT,1812,54,20-24,1866,1.743970444790254E-4
STAT,1847,24,20-24,1871,75.28692274253689
STAT,1917,21,35-39,1938,9.90358663879215
STAT,1902,1,na,1903,3832.8246734976096
STAT,1910,36,20-24,1946,0.2504941610660921
SIM,1869,37,na,1906,3598
STAT,1862,33,45-49,1895,1.479016998081467
STAT,1882,35,20-24,1917,0.7450276856562125
STAT,1853,31,45-49,1884,1.4069580477294892
STAT,1846,43,45-49,1889,0.8857117601998908
STAT,1781,84,na,1865,113.56752854940649
STAT,1925,32,25-29,1957,10.875164086249223
STAT,1841,21,15-19,1862,4.687474338449436
STAT,1849,64,na,1913,1464.726681289401
STAT,1883,33,20-24,1916,2.5894853337517363
STAT,1842,54,25-29,1896,8.551053504508512E-4
STAT,1862,45,20-24,1907,0.010322790594636888
STAT,1948,6,na,1954,4464.206843393482
STAT,1812,47,15-19,1859,1.0341470938390039E-4
STAT,1897,27,20-24,1924,15.579976644033028
STAT,1910,48,20-24,1958,0.010167009497566295
STAT,1857,15,50-100,1872,0.044711620272713616
STAT,1906,27,40-44,1933,4.337790372546494
STAT,1852,16,35-39,1868,0.6719728648209671
SIM,1943,6,na,1949,4986
STAT,1940,20,50-100,1960,0.6632335202654035
STAT,1936,21,45-49,1957,1.0653946013248126
STAT,1908,11,na,1919,3806.9258157325135
STAT,1816,42,20-24,1858,0.5219817204894112
STAT,1841,103,na,1944,0.1598133075072669
SIM,1840,38,35-39,1878,21
SIM,1847,72,na,1919,1382
STAT,1880,18,na,1898,2615.0996892938074
STAT,1863,74,na,1937,947.4401508877064
STAT,1877,34,35-39,1911,10.19217588239507
STAT,1876,50,30-34,1926,0.006103953813792412
STAT,1850,24,na,1874,1168.0600530862212
STAT,1915,22,20-24,1937,113.3170233464441
SIM,1871,29,25-29,1900,2
STAT,1906,39,40-44,1945,1.3544334063151549
STAT,1821,49,15-19,1870,4.164830606962144E-4
STAT,1827,61,na,1888,1355.697291415344
STAT,1832,44,20-24,1876,0.014206308703663321
STAT,1898,42,30-34,1940,0.10722372379944362
SIM,1845,46,na,1891,2224
STAT,1835,23,40-44,1858,2.080757939713022
STAT,1848,54,35-39,1902,0.007834600023806806
STAT,1855,44,25-29,1899,0.41926620373706636
STAT,1848,60,na,1908,1784.6902073902597
STAT,1801,53,25-29,1854,0.008982677960910665
SIM,1900,33,40-44,1933,19
SIM,1844,61,na,1905,1796
STAT,1913,36,50-100,1949,0.41110875138353165
STAT,1847,36,20-24,1883,0.7306513436971485
STAT,1902,20,na,1922,3350.238731986942
STAT,1842,19,45-49,1861,0.020578834187294285
STAT,1840,22,45-49,1862,0.3491758898041587
STAT,1903,46,30-34,1949,0.07773000713935506
STAT,1913,29,30-34,1942,38.27649197435581
STAT,1842,51,20-24,1893,1.8406087446018332E-4
STAT,1920,49,35-39,1969,0.1398630573241087
STAT,1894,69,na,1963,2073.2333359256068
SIM,1900,46,na,1946,4063
STAT,1845,45,45-49,1890,0.11827472336995684
STAT,1901,56,na,1957,2894.308570478451
STAT,1882,29,35-39,1911,9.171957489743622
STAT,1866,19,30-34,1885,1.4758110384935175
SIM,1869,8,na,1877,3913
SIM,1869,34,na,1903,3575
STAT,1856,36,30-34,1892,3.8464125041856025
STAT,1836,40,40-44,1876,2.1036203273155687
STAT,1915,25,25-29,1940,66.6358982781669
SIM,1861,19,20-24,1880,4
SIM,1890,29,35-39,1919,1
STAT,1845,23,40-44,1868,1.2744540803716147
STAT,1897,33,15-19,1930,0.18832668089019508
STAT,1827,41,45-49,1868,1.439679769412999
STAT,1922,15,15-19,1937,52.17811148288197
STAT,1923,32,15-19,1955,0.14576805166460144
STAT,1916,46,40-44,1962,0.15990219792926152
STAT,1898,47,25-29,1945,0.043487765914978396
STAT,1836,24,45-49,1860,0.6951084872270793
STAT,1873,33,20-24,1906,2.7610416078091102
SIM,1823,38,35-39,1861,2
SIM,1878,11,na,1889,4386
STAT,1836,75,na,1911,787.885398230748
SIM,1881,29,25-29,1910,10
STAT,1861,42,na,1903,1919.7598168149048
STAT,1912,19,na,1931,3839.458723606084
STAT,1873,29,25-29,1902,43.081805297563726
SIM,1919,27,25-29,1946,6
STAT,1852,21,50-100,1873,0.49115383888868563
STAT,1842,30,30-34,1872,5.345789093618771
SIM,1837,43,45-49,1880,3
STAT,1853,19,20-24,1872,16.34192611321847
STAT,1840,31,50-100,1871,0.4440091497004721
STAT,1918,17,15-19,1935,9.77682508224932
SIM,1829,34,20-24,1863,29
STAT,1873,26,20-24,1899,12.075180812662442
STAT,1832,28,25-29,1860,50.67620720242387
SIM,1810,73,na,1883,2853
STAT,1858,37,35-39,1895,5.401337615973602
STAT,1810,44,45-49,1854,0.007964681592223627
STAT,1834,31,na,1865,1236.1879644360663
STAT,1944,21,na,1965,3899.7984755817233
SIM,1840,28,25-29,1868,590
SIM,1850,30,30-34,1880,2
STAT,1894,32,45-49,1926,2.2175463783737612
STAT,1846,19,20-24,1865,13.035093445362241
SIM,1888,26,na,1914,426
STAT,1864,46,25-29,1910,0.05251318644306399
STAT,1923,36,30-34,1959,2.0914757026231476
STAT,1901,38,45-49,1939,0.598635234172068
SIM,1829,53,na,1882,1785
SIM,1832,76,na,1908,167
SIM,1808,69,na,1877,1101
STAT,1834,44,30-34,1878,0.5953665113105312
STAT,1938,24,15-19,1962,5.208406265841279
SIM,1832,57,na,1889,1048
STAT,1871,35,50-100,1906,1.2363583520816273
STAT,1904,30,na,1934,3436.717438489117
STAT,1815,76,na,1891,66.79725947931594
STAT,1848,15,30-34,1863,1.8709126280174437
STAT,1816,40,30-34,1856,3.976283861382366
STAT,1842,35,25-29,1877,0.8560440727040729
STAT,1848,29,50-100,1877,0.7043994866481159
SIM,1864,39,35-39,1903,3
STAT,1847,49,35-39,1896,0.12393355591263779
STAT,1838,53,20-24,1891,3.099457896223161E-4
STAT,1855,52,45-49,1907,0.009553713387865476
STAT,1829,54,25-29,1883,0.001384679656702754
STAT,1861,64,na,1925,1445.693530781139
STAT,1941,15,25-29,1956,44.151971811277505
SIM,1868,6,na,1874,1405
STAT,1787,101,na,1888,0.06579392559396809
STAT,1870,41,30-34,1911,1.1513283749619028
STAT,1886,46,45-49,1932,0.2450836917057154
STAT,1861,54,35-39,1915,0.006962777417345972
SIM,1889,73,na,1962,986
STAT,1896,45,25-29,1941,0.043257830520336917
STAT,1836,97,na,1933,4.1115756921967765
SIM,1833,21,na,1854,1668
STAT,1883,46,35-39,1929,0.13506844627998651
STAT,1883,52,20-24,1935,7.061311071448537E-4
STAT,1903,42,15-19,1945,0.0013596110122709585
STAT,1887,4,na,1891,2895.5274678810447
STAT,1884,49,50-100,1933,0.2301972643956055
STAT,1883,31,30-34,1914,16.86564549752228
SIM,1913,19,na,1932,3570
STAT,1833,43,35-39,1876,0.9299998958936768
STAT,1856,32,15-19,1888,0.10353712487193775
STAT,1868,42,45-49,1910,1.4437814103050024
SIM,1883,63,na,1946,1967
STAT,1820,53,35-39,1873,0.012802318716827266
STAT,1829,40,40-44,1869,1.114308047384471
SIM,1909,29,15-19,1938,3
STAT,1867,24,30-34,1891,16.740155190298882
STAT,1873,52,na,1925,2196.9176314029296
STAT,1815,98,na,1913,0.22904033301445564
SIM,1833,39,na,1872,2192
SIM,1931,36,30-34,1967,8
STAT,1876,41,na,1917,2347.0227253142075
STAT,1818,87,na,1905,107.23353927124977
STAT,1877,25,45-49,1902,1.1347378491056277
STAT,1877,44,45-49,1921,1.498762607172034
STAT,1846,34,na,1880,1485.6934645072247
STAT,1828,39,15-19,1867,0.07229930978440981
STAT,1856,12,na,1868,2027.4518821124866
SIM,1892,49,50-100,1941,3
STAT,1854,39,25-29,1893,1.5847723410803118
STAT,1912,44,15-19,1956,0.001452583907983685
STAT,1883,36,25-29,1919,2.7832437910707983
STAT,1896,31,40-44,1927,5.740146243036315
SIM,1880,19,30-34,1899,39
SIM,1866,22,30-34,1888,21
STAT,1866,43,30-34,1909,1.041857768071823
SIM,1891,6,na,1897,2810
STAT,1929,41,15-19,1970,0.0019776726244334643
SIM,1876,42,45-49,1918,3
SIM,1908,63,na,1971,1851
STAT,1842,45,35-39,1887,0.03566221377775937
STAT,1852,26,45-49,1878,1.3111494345019434
STAT,1897,37,30-34,1934,7.077956112207193
SIM,1921,30,na,1951,5199
STAT,1811,51,35-39,1862,0.03951284526930514
STAT,1837,17,20-24,1854,18.94578549607813
STAT,1846,29,30-34,1875,17.78439904841444
STAT,1881,23,45-49,1904,0.6564792605357469
SIM,1934,18,na,1952,3737
STAT,1889,19,35-39,1908,0.6572257061420724
STAT,1914,34,30-34,1948,15.504712416391884
STAT,1923,46,40-44,1969,0.18295128374494132
STAT,1875,45,30-34,1920,0.10039026372340669
SIM,1882,19,na,1901,2151
STAT,1837,54,50-100,1891,0.011776878146781532
STAT,1830,34,45-49,1864,1.6043148216688907
STAT,1858,22,30-34,1880,15.607070510019991
STAT,1897,40,na,1937,3111.1257191888176
STAT,1906,44,50-100,1950,0.10479972775707865
SIM,1854,38,na,1892,1661
STAT,1824,72,na,1896,244.40011780730896
STAT,1836,30,30-34,1866,17.266096044443785
STAT,1839,86,na,1925,206.13764010269637
STAT,1840,33,25-29,1873,4.861510716287942
STAT,1947,10,na,1957,4379.484587115143
STAT,1825,35,na,1860,1794.2460345836894
STAT,1916,40,35-39,1956,0.2041058517936237
STAT,1808,54,30-34,1862,0.007323091042869722
SIM,1881,56,na,1937,2349
STAT,1847,53,30-34,1900,0.005295390342742965
SIM,1944,8,na,1952,2552
STAT,1893,27,45-49,1920,1.3884649412584813
STAT,1864,56,na,1920,1854.2438302070507
STAT,1930,17,30-34,1947,15.647567166964915
SIM,1900,42,30-34,1942,1
SIM,1792,65,na,1857,1099
SIM,1905,46,30-34,1951,1
STAT,1855,30,40-44,1885,2.983779323662308
STAT,1912,29,50-100,1941,0.9625533434345068
STAT,1948,3,na,1951,4517.667959008502
STAT,1851,47,35-39,1898,0.11005547296060728
STAT,1870,78,na,1948,778.9364608573574
STAT,1832,47,25-29,1879,0.005214210880199209
STAT,1911,42,40-44,1953,0.23604024891402742
STAT,1834,23,50-100,1857,0.23863242211767177
STAT,1872,19,30-34,1891,1.587477242547672
STAT,1824,40,50-100,1864,0.17766422725962017
STAT,1937,17,25-29,1954,41.722188419240915
STAT,1837,20,na,1857,2276.8768823976893
SIM,1885,31,30-34,1916,13
STAT,1885,55,na,1940,2032.45772484891
SIM,1821,36,na,1857,2015
STAT,1927,20,50-100,1947,0.8088803546700402
SIM,1865,41,30-34,1906,1
SIM,1842,35,na,1877,2305
STAT,1826,36,45-49,1862,3.3426116378880035
STAT,1812,87,na,1899,13.952562961776826
STAT,1816,45,25-29,1861,0.18031546884232566
SIM,1835,29,20-24,1864,29
STAT,1841,25,30-34,1866,35.33470687278197
SIM,1933,33,na,1966,4005
STAT,1877,31,30-34,1908,17.79614470959432
SIM,1827,36,45-49,1863,30
SIM,1860,5,na,1865,2680
SIM,1863,34,na,1897,896
STAT,1904,8,na,1912,3713.9611399098417
SIM,1891,36,25-29,1927,13
STAT,1805,80,na,1885,105.93718915396525
STAT,1890,36,25-29,1926,3.502353300343161
STAT,1916,55,na,1971,3600.089405853479
STAT,1810,58,na,1868,75.06280587266708
STAT,1877,22,40-44,1899,2.1153167527568004
STAT,1883,11,na,1894,2488.192737999576
SIM,1914,23,25-29,1937,10
STAT,1886,27,45-49,1913,1.149774509185018
SIM,1912,34,na,1946,4580
STAT,1901,49,25-29,1950,0.04448114739331647
STAT,1919,38,30-34,1957,1.9300506060840013
STAT,1906,23,25-29,1929,82.63958442016188
STAT,1825,57,na,1882,1330.7480822600983
STAT,1827,83,na,1910,279.9518765336021
STAT,1871,35,45-49,1906,2.007475842381783
STAT,1823,45,25-29,1868,0.09247783138510283
STAT,1862,30,40-44,1892,3.723450316095548
STAT,1819,36,45-49,1855,1.0521670805820187
STAT,1827,29,20-24,1856,12.669637153604953
SIM,1857,49,na,1906,1386
STAT,1852,50,50-100,1902,0.015420707986419107
SIM,1824,87,na,1911,857
STAT,1848,53,20-24,1901,6.794390455462691E-4
STAT,1837,46,50-100,1883,0.207059598381893
SIM,1864,1,na,1865,4116
STAT,1886,30,35-39,1916,10.571380892800923
STAT,1895,42,50-100,1937,0.09531735332807205
STAT,1895,36,45-49,1931,2.6057535513950207
STAT,1851,27,45-49,1878,1.026738782674326
STAT,1898,46,40-44,1944,0.13022942132505005
STAT,1866,70,na,1936,1280.7523925634732
STAT,1890,44,15-19,1934,0.01649261468996488
STAT,1826,42,na,1868,2159.9308221430924
STAT,1849,39,na,1888,1989.5600292383315
STAT,1787,107,na,1894,8.490549322052276E-4
STAT,1904,61,na,1965,2884.1776827826097
STAT,1917,15,40-44,1932,0.2983536793085079
SIM,1869,99,na,1968,175
SIM,1899,36,25-29,1935,1
STAT,1836,37,20-24,1873,0.7250318907417623
STAT,1941,26,40-44,1967,4.76903840895591
STAT,1853,44,na,1897,1767.9190795268566
SIM,1890,36,35-39,1926,70
STAT,1855,103,na,1958,0.1657551111603788
SIM,1928,29,25-29,1957,1
SIM,1897,39,25-29,1936,3
STAT,1873,43,30-34,1916,1.1707872024422685
STAT,1850,40,25-29,1890,0.2995155266133281
STAT,1881,87,na,1968,391.81890281545265
STAT,1815,47,30-34,1862,0.00981201284096689
STAT,1852,53,40-44,1905,0.010426858615379368
STAT,1892,41,15-19,1933,0.01717522862452432
STAT,1924,29,45-49,1953,1.9779569262555114
SIM,1886,31,na,1917,3079
SIM,1943,17,na,1960,4981
STAT,1853,24,45-49,1877,0.6297132094247812
SIM,1915,41,30-34,1956,1
SIM,1945,26,20-24,1971,39
STAT,1870,21,40-44,1891,2.083689978372903
STAT,1908,51,na,1959,3254.7672825487584
STAT,1857,34,na,1891,1815.4853573661453
SIM,1919,18,20-24,1937,713
STAT,1850,24,20-24,1874,37.64692274127143
STAT,1806,52,30-34,1858,0.01574653234650196
STAT,1880,40,40-44,1920,2.358657686564927
STAT,1884,17,30-34,1901,1.5257672242773674
SIM,1904,6,na,1910,4201
STAT,1863,43,45-49,1906,1.2684703016200132
SIM,1828,77,na,1905,713
STAT,1852,21,20-24,1873,83.00007843713296
STAT,1840,37,40-44,1877,2.0386702496795173
SIM,1894,30,35-39,1924,10
SIM,1921,4,na,1925,5456
STAT,1833,27,25-29,1860,26.000395007680744
STAT,1884,33,35-39,1917,9.653450555281232
STAT,1909,39,20-24,1948,0.2444902755215385
STAT,1831,29,na,1860,2205.227481604302
STAT,1854,17,15-19,1871,3.9472465601894022
SIM,1879,39,50-100,1918,1
STAT,1828,45,45-49,1873,0.2893252437170835
STAT,1864,24,20-24,1888,62.745394575153
STAT,1872,30,35-39,1902,10.222348172303729
STAT,1814,57,na,1871,1744.6394394223653
SIM,1951,12,na,1963,2373
SIM,1924,10,na,1934,5281
STAT,1864,36,15-19,1900,0.051296166168018874
STAT,1893,72,na,1965,1859.4651239539196
STAT,1845,100,na,1945,0.5268063283715585
SIM,1872,24,20-24,1896,2
SIM,1836,72,na,1908,570
STAT,1835,24,25-29,1859,56.75137678308198
STAT,1910,16,50-100,1926,0.07358649760627917
STAT,1862,27,20-24,1889,10.028994121859332
SIM,1859,69,na,1928,581
STAT,1921,22,50-100,1943,0.7343849672235659
STAT,1857,46,25-29,1903,0.04432550964624817
STAT,1815,45,35-39,1860,0.014572898393078007
STAT,1950,19,45-49,1969,0.584645441710816
STAT,1917,28,na,1945,3862.5633517153956
SIM,1890,38,30-34,1928,5
STAT,1903,0,na,1903,4168.162590682046
SIM,1901,53,na,1954,3151
STAT,1941,30,50-100,1971,0.8591704246908695
STAT,1892,23,15-19,1915,4.071880188434298
STAT,1841,53,35-39,1894,0.009432821697921685
STAT,1776,78,na,1854,550.0000000000001
STAT,1929,16,15-19,1945,57.65383092872453
STAT,1901,23,35-39,1924,8.134044755266657
STAT,1810,67,na,1877,55.57366437033716
STAT,1909,6,na,1915,3877.784456651181
SIM,1867,64,na,1931,1139
SIM,1887,17,20-24,1904,36
STAT,1903,20,35-39,1923,8.332953653587326
STAT,1939,21,25-29,1960,91.77580463324836
STAT,1817,42,35-39,1859,1.3290205903605155
STAT,1889,39,25-29,1928,3.4323054264816246
STAT,1831,48,25-29,1879,0.05362224343100669
STAT,1952,16,45-49,1968,0.5933332234986579
STAT,1877,22,35-39,1899,5.923714557983935
STAT,1839,45,20-24,1884,0.011654001156220712
SIM,1912,25,na,1937,4712
SIM,1840,42,30-34,1882,2
SIM,1831,35,15-19,1866,2
STAT,1849,37,30-34,1886,4.595131703306547
STAT,1869,46,45-49,1915,0.23881945757444129
STAT,1876,39,15-19,1915,0.05619576195186958
STAT,1882,38,30-34,1920,5.077283589892396
SIM,1851,32,35-39,1883,4
SIM,1916,15,na,1931,4736
STAT,1836,60,na,1896,1459.6351338227273
STAT,1842,54,50-100,1896,0.003646074228338439
STAT,1835,23,50-100,1858,0.4071933642066647
SIM,1938,30,na,1968,4216
STAT,1866,53,40-44,1919,0.009455539268042127
SIM,1882,41,na,1923,1731
SIM,1870,27,20-24,1897,60
STAT,1896,49,40-44,1945,0.12464474860459622
STAT,1849,19,30-34,1868,1.6336872461445122
STAT,1947,16,35-39,1963,4.678321615597455
SIM,1922,37,35-39,1959,2
STAT,1870,16,na,1886,2556.9057573860773
STAT,1828,27,15-19,1855,0.9493166105225145
STAT,1927,19,15-19,1946,55.66891370380098
STAT,1860,29,50-100,1889,0.5199006074513284
STAT,1897,33,45-49,1930,2.3061134040183884
STAT,1849,109,na,1958,0.0010505457831000904
STAT,1879,28,50-100,1907,0.6539120386050178
STAT,1862,80,na,1942,526.8838381087879
STAT,1939,27,50-100,1966,0.9896295667227625
STAT,1919,30,40-44,1949,4.199443132792231
STAT,1821,98,na,1919,1.6405689138762365
STAT,1882,36,35-39,1918,6.804280080802872
STAT,1920,18,20-24,1938,149.7582824431929
STAT,1832,42,30-34,1874,0.10116868769594792
STAT,1868,32,40-44,1900,4.188708085582662
STAT,1925,23,na,1948,4317.796714377285
STAT,1854,85,na,1939,152.42358960614126
STAT,1871,4,na,1875,2940.700200132488
SIM,1878,36,na,1914,4228
STAT,1845,49,na,1894,1093.0994914620162
STAT,1854,50,40-44,1904,0.005937677345915996
SIM,1848,38,na,1886,2518
STAT,1958,10,na,1968,5115.055318153304
STAT,1825,32,15-19,1857,0.2468172488074893
SIM,1920,20,na,1940,3207
STAT,1895,18,15-19,1913,7.699867129377329
SIM,1838,42,45-49,1880,7
STAT,1864,38,40-44,1902,3.959875845003111
STAT,1915,33,na,1948,3781.4366711396247
STAT,1879,35,20-24,1914,0.7982775167528702
SIM,1882,41,25-29,1923,4
STAT,1906,9,na,1915,3757.2139445743273
SIM,1882,25,20-24,1907,70
STAT,1881,38,40-44,1919,4.113380929515712
STAT,1867,32,20-24,1899,2.556363916110745
STAT,1843,16,30-34,1859,2.0244282207646798
SIM,1911,18,20-24,1929,16
STAT,1837,85,na,1922,219.8102005474821
SIM,1898,56,na,1954,3899
STAT,1914,37,35-39,1951,2.381391332342163
STAT,1848,38,25-29,1886,2.747826640187475
STAT,1820,45,45-49,1865,0.38084532428556817
SIM,1879,43,45-49,1922,19
STAT,1881,31,50-100,1912,0.8687904176114866
STAT,1870,49,20-24,1919,0.01171341559066335
STAT,1933,31,30-34,1964,21.10022453813356
STAT,1929,34,15-19,1963,0.16187631629635213
STAT,1878,21,40-44,1899,2.1504396220946003
STAT,1869,28,15-19,1897,0.4562114763062183
STAT,1809,48,15-19,1857,0.003441144373278808
STAT,1859,27,45-49,1886,0.895208039091951
STAT,1925,16,50-100,1941,0.44954319639603724
STAT,1823,35,15-19,1858,0.10709099512329764
STAT,1843,32,35-39,1875,12.02912645794833
SIM,1897,15,na,1912,3016
SIM,1813,44,na,1857,258
STAT,1820,57,na,1877,1486.7031594910486
STAT,1897,15,15-19,1912,7.918009762096586
STAT,1861,46,15-19,1907,3.336013775190039E-4
SIM,1867,27,45-49,1894,2
STAT,1919,23,na,1942,3933.476411462784
STAT,1876,25,25-29,1901,43.05296331607336
STAT,1935,28,50-100,1963,1.3463834577319989
STAT,1860,16,30-34,1876,1.5085088219113885
STAT,1910,47,45-49,1957,0.20050859308604596
STAT,1917,33,40-44,1950,4.026103669320501
SIM,1884,25,25-29,1909,8
STAT,1854,35,15-19,1889,0.03170067472930842
SIM,1872,38,40-44,1910,5
SIM,1890,76,na,1966,2452
STAT,1866,38,45-49,1904,1.81066630056559
SIM,1909,45,na,1954,3844
STAT,1841,21,45-49,1862,0.9908012034747465
STAT,1872,11,na,1883,2647.5652748840653
STAT,1918,31,35-39,1949,9.618958150319273
SIM,1844,36,na,1880,2883
SIM,1866,23,na,1889,3264
STAT,1905,18,25-29,1923,8.129217404357195
STAT,1890,26,15-19,1916,0.5511404925671617
STAT,1905,37,50-100,1942,0.3811513311745117
SIM,1884,36,na,1920,3660
STAT,1860,32,35-39,1892,8.26158114430985
STAT,1892,28,45-49,1920,1.3698206446471413
STAT,1906,56,na,1962,3089.7214401776773
STAT,1814,48,25-29,1862,0.1942725976315172
STAT,1851,54,35-39,1905,0.006612392794239055
SIM,1880,30,35-39,1910,39
STAT,1818,41,40-44,1859,4.519513804119313
STAT,1903,18,20-24,1921,25.099914621269935
STAT,1856,48,30-34,1904,0.06865333570556618
STAT,1857,111,na,1968,7.335329743288395E-4
SIM,1880,74,na,1954,3193
STAT,1824,50,25-29,1874,6.212889070899435E-4
SIM,1864,48,30-34,1912,2
STAT,1861,67,na,1928,1318.3352451763633
SIM,1888,1,na,1889,1522
STAT,1874,43,20-24,1917,0.16272159422302257
SIM,1857,37,30-34,1894,45
STAT,1885,32,40-44,1917,4.262772704347587
STAT,1881,39,25-29,1920,2.6915982633974176
STAT,1891,41,25-29,1932,0.7932520758100527
STAT,1823,93,na,1916,23.08738837542313
STAT,1807,52,20-24,1859,0.002353166318544612
SIM,1801,59,na,1860,1846
SIM,1896,61,na,1957,2510
STAT,1850,42,20-24,1892,0.0732434832501144
SIM,1885,41,50-100,1926,6
STAT,1885,15,25-29,1900,5.595986626242532
STAT,1839,48,25-29,1887,0.053829964711484636
STAT,1921,33,na,1954,4141.392684350637
STAT,1820,45,15-19,1865,6.455000063296847E-4
SIM,1866,40,30-34,1906,8
STAT,1869,43,40-44,1912,2.253307669094893
STAT,1827,31,40-44,1858,4.534215070712204
STAT,1825,37,45-49,1862,2.869299847448752
STAT,1899,28,30-34,1927,34.274062358435785
STAT,1891,43,20-24,1934,0.1938861693830966
STAT,1859,29,40-44,1888,2.3806855468771784
SIM,1843,24,25-29,1867,1
STAT,1864,28,50-100,1892,0.5795012354787302
STAT,1844,31,40-44,1875,5.191327595600329
STAT,1930,24,50-100,1954,0.831777786000883
STAT,1850,95,na,1945,6.139369849640682
STAT,1776,114,na,1890,5.84071995851077E-4
STAT,1843,14,na,1857,2986.9455924242616
STAT,1879,47,15-19,1926,4.0842258643389203E-4
SIM,1855,79,na,1934,1208
STAT,1899,44,35-39,1943,0.1694348549254109
STAT,1841,15,50-100,1856,0.07119870246912104
STAT,1844,110,na,1954,2.737650737922593E-4
STAT,1833,42,20-24,1875,0.08267142660524808
SIM,1926,31,35-39,1957,21
STAT,1794,63,na,1857,10.730035825248002
STAT,1825,29,na,1854,1720.672676497696
STAT,1910,61,na,1971,3122.2066146328248
STAT,1924,41,30-34,1965,0.1508245479168732
STAT,1899,69,na,1968,2325.721268509012
STAT,1938,23,30-34,1961,28.131377157465376
STAT,1868,77,na,1945,834.8911840173351
STAT,1948,15,40-44,1963,1.585173894956365
STAT,1855,49,25-29,1904,0.037325826758994464
SIM,1901,47,45-49,1948,1
STAT,1946,25,na,1971,4131.474886517924
STAT,1856,46,35-39,1902,0.10084099354809133
STAT,1875,87,na,1962,322.26246707358047
STAT,1924,47,45-49,1971,0.25625958579637376
SIM,1933,27,na,1960,4364
STAT,1868,17,45-49,1885,0.06423545743693396
STAT,1824,52,20-24,1876,1.2443310282273735E-4
STAT,1854,35,45-49,1889,1.1253738190559806
SIM,1833,37,45-49,1870,3
SIM,1887,5,na,1892,4012
STAT,1937,26,20-24,1963,17.617764824866327
STAT,1880,37,50-100,1917,1.2745866162069577
STAT,1954,8,na,1962,4815.589046113827
STAT,1838,34,20-24,1872,1.4043491898959142
STAT,1894,22,40-44,1916,2.649893299028348
STAT,1909,23,35-39,1932,8.635423312375753
STAT,1891,25,20-24,1916,14.524377053304441
STAT,1838,16,20-24,1854,10.05566419574713
STAT,1814,47,40-44,1861,0.585267207863878
STAT,1880,22,40-44,1902,2.1633154228670697
SIM,1846,16,20-24,1862,19
STAT,1824,34,20-24,1858,1.108432798289434
SIM,1832,34,20-24,1866,3
STAT,1943,23,40-44,1966,3.535312353957505
STAT,1872,49,25-29,1921,0.05647403292395115
STAT,1882,22,45-49,1904,0.6676228278915133
STAT,1821,36,50-100,1857,1.5567492219122139
STAT,1907,41,30-34,1948,0.11701454416491372
STAT,1922,47,40-44,1969,0.17910412408429702
STAT,1875,28,45-49,1903,1.136104017898696
SIM,1880,49,25-29,1929,1
SIM,1918,10,na,1928,4480
STAT,1777,91,na,1868,46.08515118730593
STAT,1808,57,na,1865,663.2523541650648
STAT,1861,46,45-49,1907,0.19682497840046034
STAT,1872,82,na,1954,467.21679275494364
STAT,1907,29,45-49,1936,1.5949226612020864
STAT,1831,48,50-100,1879,0.2286392895757247
SIM,1852,31,40-44,1883,3
STAT,1875,40,30-34,1915,1.1924514506859274
STAT,1885,49,na,1934,2165.305541912248
SIM,1865,45,40-44,1910,1
STAT,1897,30,40-44,1927,5.805679511650532
STAT,1865,53,20-24,1918,6.628966106375051E-4
SIM,1902,35,na,1937,3436
STAT,1833,24,20-24,1857,48.740049701256076
STAT,1895,4,na,1899,3422.189285646158
STAT,1930,37,20-24,1967,0.34142909228774254
STAT,1833,40,25-29,1873,0.3434362609466591
STAT,1899,26,35-39,1925,13.224383160662931
STAT,1902,37,15-19,1939,0.017067564578633905
STAT,1866,42,na,1908,2107.1454691937765
STAT,1812,50,35-39,1862,0.0022050719324501937
STAT,1937,29,25-29,1966,63.434933243459966
SIM,1846,62,na,1908,602
SIM,1849,45,25-29,1894,2
STAT,1878,51,50-100,1929,0.015613101315212449
STAT,1873,44,15-19,1917,0.013974629546939937
STAT,1894,8,na,1902,3305.735165647297
SIM,1842,42,35-39,1884,5
STAT,1867,33,35-39,1900,9.53705384894542
STAT,1862,52,na,1914,1824.1782448402453
STAT,1867,49,15-19,1916,3.7039326456213755E-4
STAT,1871,97,na,1968,26.510199938704545
STAT,1922,29,40-44,1951,5.178143030885227
STAT,1859,42,40-44,1901,1.7805645575384672
STAT,1910,29,15-19,1939,0.6692584547796613
STAT,1882,40,45-49,1922,1.4473571261386922
STAT,1848,85,na,1933,256.52802408005107
STAT,1909,26,45-49,1935,1.6537904627724678
STAT,1926,23,40-44,1949,4.037328813016147
SIM,1930,29,40-44,1959,7
STAT,1923,28,na,1951,4240.763469504369
STAT,1895,33,40-44,1928,5.61770794719864
STAT,1804,98,na,1902,2.058276980434414
STAT,1867,45,50-100,1912,0.23458694831758148
SIM,1841,24,20-24,1865,1
SIM,1831,23,20-24,1854,12
STAT,1943,26,45-49,1969,1.8197390392113781
STAT,1926,39,20-24,1965,0.3187234812953569
STAT,1928,18,20-24,1946,169.08580747020366
SIM,1833,36,na,1869,2082
STAT,1873,46,35-39,1919,0.1440168805825437
SIM,1851,49,na,1900,1151
STAT,1880,46,na,1926,2342.3136524972465
SIM,1890,33,30-34,1923,62
SIM,1914,20,na,1934,4729
STAT,1863,40,40-44,1903,1.939610299470863
STAT,1855,16,20-24,1871,14.038381517036681
SIM,1838,67,na,1905,1075
STAT,1882,51,30-34,1933,0.005726299657322272
SIM,1810,95,na,1905,258
STAT,1935,16,45-49,1951,0.6796542937710417
SIM,1863,16,20-24,1879,267
SIM,1855,42,45-49,1897,2
STAT,1865,54,35-39,1919,0.007643849489554209
STAT,1919,15,45-49,1934,0.10979092553854125
STAT,1793,78,na,1871,277.9885397044095
STAT,1846,40,35-39,1886,1.1136301512873423
STAT,1854,57,na,1911,1117.3903638404533
STAT,1941,29,45-49,1970,1.7650957057450078
STAT,1899,43,20-24,1942,0.014954384829699446
STAT,1865,36,35-39,1901,6.4885944949041
STAT,1889,39,na,1928,2808.5722245987054
STAT,1838,46,15-19,1884,1.7793411384287855E-4
STAT,1841,19,na,1860,3258.007921670038
STAT,1928,36,20-24,1964,0.330915449267034
STAT,1827,34,50-100,1861,0.9174773756674829
SIM,1873,64,na,1937,1011
SIM,1835,34,50-100,1869,21
SIM,1823,42,30-34,1865,2
STAT,1851,9,na,1860,2339.461301489426
STAT,1847,42,45-49,1889,1.360684510951616
STAT,1853,21,40-44,1874,1.9228970199868123
STAT,1931,23,na,1954,4688.48234722226
STAT,1824,53,35-39,1877,0.0014233917368090033
STAT,1818,110,na,1928,1.6819491016086338E-4
STAT,1832,45,35-39,1877,0.012960504478773163
STAT,1843,54,na,1897,2068.923192340086
STAT,1889,36,20-24,1925,0.9327433538148926
STAT,1882,33,30-34,1915,16.645570570367983
STAT,1933,19,45-49,1952,0.660607176435653
SIM,1893,32,40-44,1925,18
STAT,1866,33,15-19,1899,0.12944382194894918
STAT,1868,35,45-49,1903,1.94373695347042
STAT,1854,53,45-49,1907,0.007939599771775288
SIM,1896,21,na,1917,3916
STAT,1857,43,20-24,1900,0.12098665416855739
STAT,1894,54,na,1948,2662.8712720809613
STAT,1865,35,20-24,1900,0.7104620154215686
SIM,1865,43,20-24,1908,1
SIM,1892,31,na,1923,3641
SIM,1937,17,na,1954,1703
STAT,1871,50,40-44,1921,0.010652704816135374
STAT,1828,45,15-19,1873,4.903813562659833E-4
STAT,1850,17,50-100,1867,0.027644421332088543
STAT,1935,31,35-39,1966,12.559185988729524
STAT,1950,16,40-44,1966,1.6385637795978951
STAT,1807,50,25-29,1857,0.011780742700874468
SIM,1905,15,na,1920,3866
STAT,1852,24,25-29,1876,67.47366295695159
SIM,1868,18,na,1886,1315
SIM,1927,30,na,1957,1684
STAT,1942,24,35-39,1966,9.753102496788205
SIM,1815,79,na,1894,339
STAT,1914,51,na,1965,3547.07643470766
STAT,1895,36,15-19,1931,0.07340151721923502
SIM,1830,49,50-100,1879,1
STAT,1844,18,40-44,1862,0.22897963006099958
STAT,1900,49,50-100,1949,0.18790879721070564
STAT,1952,7,na,1959,4667.317195077306
SIM,1897,36,20-24,1933,10
STAT,1857,45,40-44,1902,0.1326820007327031
STAT,1828,42,40-44,1870,2.8126634841598213
STAT,1830,75,na,1905,745.0961622272441
STAT,1874,41,25-29,1915,0.6657475507780456
SIM,1885,4,na,1889,1920
STAT,1845,80,na,1925,306.9580025130135
STAT,1871,47,15-19,1918,3.971568773989023E-4
STAT,1790,73,na,1863,672.6513817639086
STAT,1835,59,na,1894,1470.5320943809504
STAT,1891,44,35-39,1935,2.196752013244054
STAT,1893,23,35-39,1916,7.27488110139018
STAT,1897,46,20-24,1943,0.009015106153891898
STAT,1893,39,15-19,1932,0.06951607996682968
STAT,1830,38,50-100,1868,1.1082927159013836
SIM,1861,4,na,1865,2725
SIM,1910,30,na,1940,4259
STAT,1894,48,50-100,1942,0.17396048148311052
SIM,1840,18,na,1858,2831
STAT,1856,50,45-49,1906,0.010573384386776005
STAT,1834,42,35-39,1876,0.9620857478002292
STAT,1847,24,15-19,1871,3.604184859581272
STAT,1935,13,na,1948,5369.3562498445035
STAT,1826,48,15-19,1874,5.648781945503615E-4
STAT,1936,27,15-19,1963,0.6689044404958782
SIM,1858,34,40-44,1892,3
STAT,1936,22,50-100,1958,0.6228321998172887
STAT,1826,32,35-39,1858,20.086680494762685
STAT,1841,50,30-34,1891,0.006723805986713292
STAT,1887,72,na,1959,1514.2980161426628
SIM,1925,9,na,1934,5336
STAT,1886,40,50-100,1926,1.1050478019975427
STAT,1931,4,na,1935,5245.845913253663
SIM,1906,7,na,1913,3722
STAT,1849,53,35-39,1902,0.0071374538366617115
STAT,1850,43,35-39,1893,0.8301241112464519
SIM,1814,57,na,1871,2442
STAT,1855,79,na,1934,462.69335295165354
STAT,1910,44,40-44,1954,0.2308723318275601
STAT,1905,15,20-24,1920,25.617784326196205
STAT,1830,46,15-19,1876,3.4624646517806656E-4
STAT,1897,49,30-34,1946,0.0710018892419763
STAT,1860,26,na,1886,1981.9982082598408
STAT,1841,19,30-34,1860,2.262239078959446
SIM,1862,9,na,1871,3926
STAT,1891,26,35-39,1917,11.90628419325066
STAT,1833,95,na,1928,5.470279061487606
STAT,1842,52,40-44,1894,0.0025995181337438228
STAT,1816,44,40-44,1860,7.01237044713041
STAT,1877,82,na,1959,605.7184459240751
STAT,1878,67,na,1945,1630.981853342314
STAT,1901,41,35-39,1942,0.17661638687390727
STAT,1854,32,40-44,1886,2.4693076055860566
SIM,1839,21,na,1860,1217
SIM,1880,46,na,1926,3249
STAT,1920,48,15-19,1968,4.008470155889192E-4
SIM,1862,0,na,1862,4008
STAT,1849,21,15-19,1870,3.385082997892907
STAT,1824,35,35-39,1859,1.0954414640898869
STAT,1900,21,25-29,1921,79.54092953177575
STAT,1855,70,na,1925,928.6056816784911
STAT,1887,26,15-19,1913,0.5010919557728446
STAT,1853,51,35-39,1904,0.0067073062898607
STAT,1906,46,40-44,1952,0.14023882171698046
STAT,1887,41,35-39,1928,2.0021325472900076
STAT,1865,22,45-49,1887,0.6443873671459774
STAT,1845,35,50-100,1880,0.7181774669866665
STAT,1883,35,40-44,1918,4.251342465070841
STAT,1916,43,50-100,1959,0.11856072054220596
STAT,1880,25,15-19,1905,0.47420882068473225
STAT,1855,46,20-24,1901,0.007964586885432064
STAT,1851,80,na,1931,488.5627562646546
STAT,1916,34,35-39,1950,9.226338848167194
STAT,1851,22,15-19,1873,3.1115285433300945
SIM,1840,77,na,1917,1993
STAT,1880,25,45-49,1905,1.160486195120414
SIM,1919,39,25-29,1958,7
STAT,1860,19,35-39,1879,0.5102002107798824
STAT,1848,35,20-24,1883,0.7589548747472233
STAT,1938,26,35-39,1964,14.721366509245101
STAT,1796,98,na,1894,1.2721929566524968
SIM,1824,44,40-44,1868,19
SIM,1900,30,30-34,1930,2
STAT,1852,38,15-19,1890,0.05624414244534599
STAT,1820,42,40-44,1862,3.7135305940884344
STAT,1929,13,na,1942,5013.457128599435
STAT,1815,42,30-34,1857,0.12214359801157264
STAT,1917,36,45-49,1953,0.7019889840298642
STAT,1849,70,na,1919,1182.2189305432134
STAT,1864,16,na,1880,2386.3070777220105
STAT,1799,63,na,1862,174.9315084158132
STAT,1817,41,20-24,1858,0.11853808263170397
STAT,1851,40,15-19,1891,0.011016955430200773
SIM,1884,22,20-24,1906,10
SIM,1926,45,na,1971,5849
SIM,1925,36,45-49,1961,5
STAT,1833,45,25-29,1878,0.029678546275504303
STAT,1877,38,20-24,1915,0.7786231689532545
STAT,1884,15,35-39,1899,0.5277045706097382
SIM,1924,34,35-39,1958,2
STAT,1839,32,45-49,1871,1.9937520812510399
STAT,1944,19,20-24,1963,144.16154332900135
STAT,1859,25,25-29,1884,34.601612095675634
STAT,1918,47,15-19,1965,3.867164799227326E-4
STAT,1921,16,15-19,1937,51.24322006359667
STAT,1930,8,na,1938,5120.1861700812915
STAT,1841,37,30-34,1878,6.992398173245424
STAT,1883,82,na,1965,719.9468311183881
SIM,1934,12,na,1946,5305
STAT,1842,60,na,1902,473.4468066508873
STAT,1885,19,40-44,1904,0.17882029685482032
SIM,1908,51,na,1959,1972
SIM,1843,21,20-24,1864,4
STAT,1834,107,na,1941,0.002078345657975565
STAT,1842,34,40-44,1876,1.273788329357278
STAT,1814,45,20-24,1859,0.04213502653540226
STAT,1836,19,20-24,1855,32.10615644928402
STAT,1847,44,na,1891,2061.4249615939066
STAT,1940,27,35-39,1967,15.137970332020721
STAT,1895,39,na,1934,3033.9797500127443
STAT,1858,16,na,1874,2059.807662686342
STAT,1881,36,20-24,1917,0.7314530845517365
SIM,1827,36,na,1863,2126
STAT,1787,78,na,1865,142.42553679018977
STAT,1913,25,20-24,1938,18.082020425375628
STAT,1823,40,50-100,1863,1.8508721496805143
STAT,1904,47,20-24,1951,0.009625756254687206
STAT,1918,29,20-24,1947,19.027234953289955
STAT,1875,43,35-39,1918,1.8460059916158038
STAT,1867,0,na,1867,3575.074586142476
STAT,1924,44,40-44,1968,0.29367635112135054
STAT,1874,46,25-29,1920,0.05961581171041212
SIM,1935,23,50-100,1958,5
STAT,1861,43,40-44,1904,1.8570816540815165
STAT,1837,20,40-44,1857,2.2190330337335618
SIM,1819,69,na,1888,1056
STAT,1875,25,40-44,1900,3.0968700579369366
STAT,1830,107,na,1937,0.003413276825865233
STAT,1818,47,na,1865,1707.1391443271352
STAT,1827,34,45-49,1861,1.7461666289848903
SIM,1803,54,na,1857,1659
SIM,1797,80,na,1877,564
STAT,1835,21,20-24,1856,69.81047890369196
STAT,1945,20,40-44,1965,3.64692031955787
STAT,1913,38,na,1951,3647.9994450944773
SIM,1895,76,na,1971,3703
STAT,1879,50,40-44,1929,0.010954878288945915
STAT,1894,25,45-49,1919,1.4215054168979826
STAT,1808,52,35-39,1860,0.011072103649802163
STAT,1863,29,30-34,1892,21.344446507894723
STAT,1917,18,45-49,1935,0.10578419701687854
STAT,1849,50,30-34,1899,0.00508764570917412
STAT,1835,19,na,1854,2322.851048068206
STAT,1843,31,20-24,1874,3.244259074759047
SIM,1879,40,40-44,1919,2
STAT,1872,33,45-49,1905,1.7388241465681153
STAT,1884,36,na,1920,2266.166851823945
STAT,1880,43,45-49,1923,1.5425197669405957
SIM,1882,28,25-29,1910,543
STAT,1821,106,na,1927,0.006131761249309701
SIM,1892,71,na,1963,3096
STAT,1874,28,25-29,1902,43.504204130231365
STAT,1902,66,na,1968,2611.1373053802927
STAT,1932,36,40-44,1968,1.9991820643735816
STAT,1869,46,15-19,1915,4.047784009561898E-4
STAT,1813,52,45-49,1865,0.05044091501491341
SIM,1845,21,na,1866,2231
SIM,1851,31,20-24,1882,3
SIM,1940,12,na,1952,4298
STAT,1924,26,40-44,1950,5.393327828213245
STAT,1850,25,35-39,1875,5.319350742869434
SIM,1904,28,25-29,1932,1
STAT,1816,40,25-29,1856,2.220987391120551
STAT,1873,32,45-49,1905,1.7887772724454163
SIM,1849,27,30-34,1876,9
STAT,1923,15,35-39,1938,4.898091973518767
STAT,1857,16,25-29,1873,5.141184132226037
STAT,1827,55,na,1882,1553.6805265761716
STAT,1888,37,15-19,1925,0.06481155690786433
STAT,1860,44,35-39,1904,1.4573076306175567
SIM,1790,70,na,1860,1197
SIM,1925,35,na,1960,4732
STAT,1831,60,na,1891,1492.6542520361047
STAT,1856,44,15-19,1900,0.009785071876850163
STAT,1884,49,15-19,1933,3.7491379645037553E-4
STAT,1840,35,20-24,1875,0.3665295470208359
STAT,1885,49,50-100,1934,0.23637185629521926
SIM,1896,25,15-19,1921,2
STAT,1945,15,na,1960,3978.482997798838
STAT,1900,28,45-49,1928,1.5326726652727856
STAT,1878,33,40-44,1911,4.443084896223117
SIM,1880,16,20-24,1896,81
SIM,1794,60,na,1854,999
STAT,1831,100,na,1931,0.8308965347478873
STAT,1911,46,20-24,1957,0.010369976903195903
STAT,1868,19,50-100,1887,0.047610744158429856
STAT,1858,42,20-24,1900,0.12113052730545845
STAT,1956,9,na,1965,5154.413007863597
STAT,1823,38,25-29,1861,5.27258109899241
SIM,1836,41,na,1877,1987
STAT,1922,43,na,1965,4208.62643403514
STAT,1947,15,20-24,1962,151.19214404999755
SIM,1873,36,na,1909,2221
SIM,1831,38,25-29,1869,27
STAT,1836,33,50-100,1869,0.8782942492100795
STAT,1919,27,15-19,1946,0.7526460332734426
STAT,1910,1,na,1911,4078.2658207377117
SIM,1815,70,na,1885,482
SIM,1881,32,45-49,1913,4
STAT,1837,50,40-44,1887,0.008814332039753377
STAT,1805,100,na,1905,0.1424334184098119
STAT,1825,52,35-39,1877,0.010559695121479137
STAT,1870,22,50-100,1892,0.40653976960431437
STAT,1945,17,15-19,1962,49.02821621932576
STAT,1883,31,25-29,1914,9.89409677266327
SIM,1866,42,20-24,1908,4
SIM,1899,41,na,1940,1799
SIM,1909,29,20-24,1938,193
STAT,1812,48,20-24,1860,0.0030469857801719642
STAT,1874,45,40-44,1919,0.17845130797522854
STAT,1881,24,20-24,1905,64.66996404860798
STAT,1943,17,50-100,1960,0.39275969004015354
STAT,1876,32,na,1908,2412.3410091331857
STAT,1933,5,na,1938,5345.852881549845
STAT,1950,3,na,1953,4645.148655534116
STAT,1909,23,40-44,1932,3.0836488525929058
STAT,1893,0,na,1893,3671.9704772896675
STAT,1884,18,45-49,1902,0.062367598555671554
STAT,1931,23,15-19,1954,6.834347683915095
SIM,1824,56,na,1880,1862
STAT,1931,37,40-44,1968,1.9686314657621127
SIM,1903,1,na,1904,3368
STAT,1884,32,20-24,1916,2.587563523950216
STAT,1915,32,25-29,1947,9.280286658873527
STAT,1924,44,35-39,1968,0.23642862029340092
STAT,1834,24,40-44,1858,1.2106562131004572
STAT,1856,43,30-34,1899,0.8197882376712107
SIM,1891,31,25-29,1922,2
SIM,1885,21,na,1906,1799
SIM,1881,68,na,1949,1140
STAT,1802,60,na,1862,1415.9156054430277
STAT,1847,42,15-19,1889,0.012555336622675146
SIM,1873,33,na,1906,2138
STAT,1923,27,35-39,1950,17.055870962279716
SIM,1878,39,20-24,1917,12
STAT,1844,39,na,1883,2415.7456056973706
STAT,1886,31,na,1917,2481.2433081696154
SIM,1926,2,na,1928,6476
STAT,1878,51,40-44,1929,0.01088339962180972
STAT,1892,43,35-39,1935,2.2257619704000753
STAT,1896,47,20-24,1943,0.0088814891765242
STAT,1911,28,20-24,1939,17.539015888244574
STAT,1870,25,50-100,1895,0.6420571098884094
STAT,1807,54,40-44,1861,0.032188461407656924
STAT,1867,9,na,1876,2588.4441241555487
STAT,1860,50,35-39,1910,0.007124129447977841
STAT,1872,16,20-24,1888,17.916558592209288
STAT,1891,41,30-34,1932,1.4201770976557377
STAT,1824,50,30-34,1874,0.00104411053447803
STAT,1931,37,50-100,1968,0.5521351190109183
STAT,1827,52,na,1879,1648.7368651362915
SIM,1826,35,50-100,1861,4
STAT,1832,27,40-44,1859,3.6371335404374623
STAT,1851,42,35-39,1893,1.428406505597788
STAT,1889,23,45-49,1912,0.8371373094383637
SIM,1819,60,na,1879,1842
STAT,1878,18,15-19,1896,6.089879300778034
STAT,1914,22,30-34,1936,28.955199075900868
STAT,1839,18,30-34,1857,1.925705059962223
STAT,1840,17,20-24,1857,9.038093652224275
STAT,1837,39,30-34,1876,5.09600618629399
SIM,1900,33,35-39,1933,281
STAT,1798,103,na,1901,0.06091752601519771
STAT,1882,34,15-19,1916,0.13517525735323901
STAT,1855,30,35-39,1885,6.9676978366013245
STAT,1897,49,25-29,1946,0.04224905765415095
STAT,1922,18,25-29,1940,49.462998555663454
STAT,1850,43,50-100,1893,0.4843050090132454
STAT,1847,36,15-19,1883,0.05322626352232282
STAT,1905,15,15-19,1920,8.575444764348344
SIM,1929,25,20-24,1954,118
STAT,1884,50,20-24,1934,7.165409789665388E-4
STAT,1848,51,25-29,1899,0.0033303842740511837
SIM,1951,9,na,1960,2373
STAT,1876,44,50-100,1920,1.0535600317868161
SIM,1896,39,40-44,1935,1
STAT,1903,36,15-19,1939,0.01728795069963257
STAT,1890,29,25-29,1919,50.84439716517519
STAT,1815,43,15-19,1858,0.0014426274848085383
STAT,1843,17,45-49,1860,0.08247966923695187
STAT,1820,104,na,1924,0.04587042490023328
SIM,1918,50,na,1968,4369
SIM,1967,0,na,1967,6524
STAT,1918,13,na,1931,4247.938115944012
SIM,1878,27,20-24,1905,55
STAT,1840,23,20-24,1863,34.25939047012819
STAT,1839,40,na,1879,2321.0411236135405
STAT,1838,52,45-49,1890,0.006162089240817552
STAT,1894,24,50-100,1918,0.5153238156571172
STAT,1942,21,30-34,1963,29.800565082728216
STAT,1859,45,45-49,1904,0.18891668457857458
STAT,1861,16,45-49,1877,0.0628102587519272
STAT,1887,27,20-24,1914,12.912493903956328
STAT,1936,33,45-49,1969,1.5123263350563105
STAT,1941,22,25-29,1963,94.37134323674509
STAT,1899,38,na,1937,3227.2571778572415
STAT,1842,49,45-49,1891,0.05736247024715561
SIM,1854,69,na,1923,147
SIM,1900,1,na,1901,4181
STAT,1815,67,na,1882,130.38672505942986
STAT,1916,31,30-34,1947,16.109735857810882
SIM,1932,17,na,1949,6500
STAT,1873,48,30-34,1921,0.09804781668663905
STAT,1838,39,na,1877,1079.516957340633
STAT,1910,4,na,1914,3941.649593553205
SIM,1875,68,na,1943,2443
STAT,1906,45,35-39,1951,0.11549668631128181
STAT,1872,30,40-44,1902,4.37751920807674
SIM,1897,71,na,1968,1237
STAT,1859,69,na,1928,1163.1640540996225
STAT,1871,17,20-24,1888,17.79919969101652
SIM,1879,21,na,1900,1758
STAT,1915,20,25-29,1935,90.86853569162372
STAT,1945,21,50-100,1966,0.7134261631065756
STAT,1846,44,20-24,1890,0.09278912693925694
STAT,1841,32,30-34,1873,23.589593097323437
STAT,1833,47,45-49,1880,0.1185067198853444
STAT,1853,49,20-24,1902,0.009110390427563004
STAT,1888,43,45-49,1931,1.714889649624483
SIM,1890,36,na,1926,3553
STAT,1828,77,na,1905,585.1331614497914
STAT,1898,42,25-29,1940,0.059890728853740846
SIM,1896,43,45-49,1939,1
SIM,1905,37,35-39,1942,2
STAT,1869,87,na,1956,197.17429601402318
STAT,1836,36,50-100,1872,1.1668226128426606
STAT,1789,73,na,1862,843.7172766204071
STAT,1927,21,35-39,1948,11.541161546337687
SIM,1866,54,na,1920,2669
STAT,1931,19,40-44,1950,1.8081637973388252
STAT,1832,31,45-49,1863,0.11191858338341758
STAT,1861,18,40-44,1879,0.1738031344506754
STAT,1832,31,15-19,1863,0.009139730640221158
SIM,1822,52,na,1874,1219
STAT,1832,43,15-19,1875,0.0012269584778835684
STAT,1925,42,50-100,1967,0.14093051907499815
SIM,1860,22,35-39,1882,1
SIM,1887,53,na,1940,3112
STAT,1856,15,50-100,1871,0.042102720627685615
STAT,1877,41,50-100,1918,1.0772782803070482
STAT,1896,29,20-24,1925,15.354205605188605
STAT,1873,50,45-49,1923,0.015100464434212965
SIM,1850,49,45-49,1899,2
STAT,1909,61,na,1970,3078.1365085456987
STAT,1850,40,30-34,1890,0.5362294083556882
STAT,1829,44,20-24,1873,0.07421314509233391
STAT,1837,54,na,1891,1679.0051065684092
STAT,1866,50,30-34,1916,0.005511681674346073
STAT,1879,53,45-49,1932,0.014648379171792668
SIM,1866,2,na,1868,3647
STAT,1843,85,na,1928,270.8570808072656
STAT,1811,49,15-19,1860,0.0018207242635086276
STAT,1829,38,20-24,1867,0.3844337375365121
STAT,1868,46,na,1914,2179.225347494114
SIM,1905,25,35-39,1930,263
STAT,1796,58,na,1854,1802.0
STAT,1861,23,50-100,1884,0.34590606824079423
STAT,1863,25,45-49,1888,0.9616389882537081
SIM,1857,35,40-44,1892,3
STAT,1896,35,20-24,1931,1.0258056202253663
SIM,1902,66,na,1968,2337
STAT,1910,47,15-19,1957,3.3984478698535916E-4
STAT,1906,49,45-49,1955,0.18874761028557302
STAT,1951,15,na,1966,4344.570655489894
SIM,1853,44,na,1897,3151
SIM,1845,35,45-49,1880,33
STAT,1852,22,35-39,1874,6.977946623675359
SIM,1840,31,45-49,1871,1
SIM,1867,22,20-24,1889,204
STAT,1891,49,na,1940,2709.431085364171
STAT,1832,25,15-19,1857,0.5673714696374131
STAT,1900,43,40-44,1943,0.21481069136306102
STAT,1916,19,45-49,1935,0.10397868990687872
STAT,1849,35,40-44,1884,3.8534593408490987
STAT,1821,67,na,1888,798.5162642016837
SIM,1940,20,25-29,1960,22
SIM,1837,26,20-24,1863,11
STAT,1837,30,50-100,1867,0.9404534259107369
SIM,1901,25,na,1926,3226
STAT,1835,106,na,1941,0.009187071779282801
SIM,1880,30,40-44,1910,4
STAT,1885,25,50-100,1910,0.6330511089293726
STAT,1859,22,20-24,1881,56.669618141668934
STAT,1809,109,na,1918,6.925179033348056E-4
STAT,1892,40,30-34,1932,1.4377597378012847
SIM,1909,31,35-39,1940,36
STAT,1888,25,15-19,1913,0.5271995962591758
STAT,1896,17,20-24,1913,23.370257658781636
STAT,1905,47,40-44,1952,0.13825257544023303
STAT,1898,17,25-29,1915,7.620144911769225
SIM,1891,9,na,1900,2758
STAT,1801,54,50-100,1855,0.0375431941799639
STAT,1841,33,15-19,1874,0.19041757846774923
STAT,1897,44,30-34,1941,0.10459430792313841
STAT,1841,44,50-100,1885,1.191530167495841
SIM,1837,26,na,1863,2220
STAT,1842,30,25-29,1872,3.136064648476234
SIM,1848,69,na,1917,1928
STAT,1837,35,45-49,1872,1.9869588036674943
STAT,1864,39,25-29,1903,2.5911519332430557
STAT,1932,39,45-49,1971,0.9076498233937972
STAT,1855,34,20-24,1889,1.7841147119294138
STAT,1905,29,40-44,1934,4.277786842250249
STAT,1808,88,na,1896,32.152329513670324
STAT,1846,26,20-24,1872,8.466246206435333
SIM,1924,31,30-34,1955,76
STAT,1852,22,na,1874,2556.729067102624
SIM,1948,23,35-39,1971,10
SIM,1842,41,na,1883,3114
STAT,1817,93,na,1910,9.258295742449588
STAT,1929,33,30-34,1962,19.85995248504551
STAT,1907,17,45-49,1924,0.0953118620589757
SIM,1838,36,na,1874,2117
STAT,1945,24,50-100,1969,0.7127058451481986
STAT,1915,39,45-49,1954,0.6721131244585214
SIM,1885,40,35-39,1925,1
STAT,1857,43,15-19,1900,0.010520579191578406
SIM,1850,30,25-29,1880,39
STAT,1823,41,45-49,1864,2.570549744026056
STAT,1885,22,50-100,1907,0.40083732117947024
SIM,1848,16,25-29,1864,2
STAT,1876,22,20-24,1898,69.6641936036175
STAT,1873,28,40-44,1901,3.0619721958505113
STAT,1795,73,na,1868,607.2137272866313
STAT,1936,15,45-49,1951,0.47571170254871376
SIM,1829,62,na,1891,1687
STAT,1877,40,35-39,1917,1.8567419548102815
SIM,1782,75,na,1857,514
STAT,1821,33,50-100,1854,1.2782373006200927
STAT,1888,43,15-19,1931,0.0158236656980234
STAT,1806,93,na,1899,8.800304056671171
STAT,1874,46,na,1920,2328.577867243108
STAT,1898,48,30-34,1946,0.07250332346943254
SIM,1830,28,30-34,1858,1
STAT,1873,21,na,1894,2433.3430320635266
SIM,1897,46,na,1943,2249
STAT,1928,8,na,1936,4987.299073319977
STAT,1932,20,25-29,1952,121.0717152482275
SIM,1861,48,na,1909,2099
SIM,1865,69,na,1934,1399
SIM,1880,19,25-29,1899,37
SIM,1869,28,na,1897,3636
STAT,1905,46,na,1951,3245.783139448923
STAT,1840,38,25-29,1878,1.327034962460903
STAT,1904,21,na,1925,3389.1366290653855
SIM,1891,21,na,1912,2539
STAT,1834,27,45-49,1861,0.6416431780087996
STAT,1827,28,15-19,1855,0.530148389468062
STAT,1844,95,na,1939,13.171742185359756
STAT,1883,33,15-19,1916,0.1364241837969947
STAT,1819,37,20-24,1856,0.20678274579705996
STAT,1890,33,50-100,1923,1.1045326443760504
SIM,1906,25,na,1931,2995
STAT,1876,29,40-44,1905,3.006596212592556
STAT,1874,48,45-49,1922,0.2405072601720666
STAT,1817,46,50-100,1863,0.17435415564101403
STAT,1890,26,20-24,1916,14.250918336401087
STAT,1878,36,45-49,1914,2.0609088895865995
STAT,1869,31,40-44,1900,4.39398557343544
SIM,1876,47,45-49,1923,1
SIM,1901,22,na,1923,3964
STAT,1912,23,50-100,1935,0.6213447588378291
STAT,1934,18,50-100,1952,0.5020098895182598
STAT,1837,17,15-19,1854,6.3420214242600625
STAT,1863,25,15-19,1888,0.3929539984721083
SIM,1899,34,35-39,1933,2
STAT,1936,15,15-19,1951,43.21841692205063
STAT,1868,47,45-49,1915,0.22688282872681445
STAT,1855,28,20-24,1883,8.034882621903328
STAT,1834,54,35-39,1888,0.0037392471615356137
STAT,1897,34,na,1931,3142.012065777151
STAT,1829,26,20-24,1855,10.034187345923192
SIM,1887,49,40-44,1936,1
SIM,1817,38,40-44,1855,68
STAT,1940,15,35-39,1955,4.214943019480284
SIM,1855,70,na,1925,2860
SIM,1853,27,20-24,1880,22
STAT,1856,80,na,1936,444.3089846132134
STAT,1823,37,40-44,1860,8.224907613779472
STAT,1850,22,30-34,1872,9.872111932693358
STAT,1866,18,25-29,1884,5.278079997726639
STAT,1838,40,50-100,1878,0.5410973695976871
SIM,1851,18,na,1869,1295
STAT,1816,42,15-19,1858,0.045389717276704114
STAT,1844,16,45-49,1860,0.08275034773399657
STAT,1890,28,40-44,1918,3.613686319764112
STAT,1832,47,30-34,1879,0.008762771147011326
STAT,1894,19,15-19,1913,7.506250633789858
STAT,1820,107,na,1927,0.0032432184397603856
SIM,1831,35,20-24,1866,5
SIM,1919,35,na,1954,4934
STAT,1845,40,na,1885,1198.1975166500495
STAT,1940,31,na,1971,3872.6010346907005
STAT,1823,35,20-24,1858,1.4700671117349078
STAT,1804,67,na,1871,1443.7356526683643
STAT,1862,21,na,1883,2077.0411224609234
STAT,1876,72,na,1948,1276.6706033700727
STAT,1904,16,15-19,1920,8.499492319365846
STAT,1913,28,25-29,1941,64.53306741900884
STAT,1842,36,30-34,1878,1.5682233906654488
STAT,1900,25,40-44,1925,4.177864007981113
SIM,1833,67,na,1900,1813
SIM,1882,48,45-49,1930,4
STAT,1837,53,45-49,1890,0.011449704226296173
SIM,1825,46,50-100,1871,2
STAT,1845,27,20-24,1872,7.0856163886373285
STAT,1854,39,30-34,1893,2.9335147751241277
STAT,1883,47,40-44,1930,0.16393394671102268
STAT,1921,22,45-49,1943,1.255798246102789
SIM,1823,74,na,1897,102
STAT,1838,34,15-19,1872,0.0739865908875192
STAT,1946,16,15-19,1962,49.806584480063385
STAT,1873,32,15-19,1905,0.14607889012936653
STAT,1835,22,35-39,1857,5.869076327827189
SIM,1882,72,na,1954,1035
SIM,1842,44,na,1886,3113
STAT,1938,25,20-24,1963,17.906191442102394
SIM,1830,56,na,1886,157
SIM,1864,28,na,1892,2432
STAT,1911,15,45-49,1926,0.09929600429977035
SIM,1945,12,na,1957,6346
STAT,1895,21,40-44,1916,2.7189536183026464
STAT,1800,110,na,1910,1.9066645386954932E-4
STAT,1867,15,35-39,1882,0.5368078643795993
STAT,1939,12,na,1951,3914.03317491775
STAT,1878,54,45-49,1932,0.014520773287892903
SIM,1889,9,na,1898,3895
STAT,1843,111,na,1954,1.0604928826657312E-4
SIM,1843,22,35-39,1865,135
STAT,1828,49,30-34,1877,0.11255859357567025
STAT,1842,32,15-19,1874,0.04270599201423893
STAT,1925,43,40-44,1968,0.29957896682249563
STAT,1866,35,50-100,1901,1.1313500576300977
STAT,1861,36,na,1897,1968.7621901096352
STAT,1897,31,na,1928,3182.0961516556636
SIM,1848,66,na,1914,2307
STAT,1914,23,15-19,1937,5.346239331601033
STAT,1845,18,na,1863,1431.1644862293824
STAT,1849,6,na,1855,2587.47504
STAT,1858,47,na,1905,1710.1130999663908
STAT,1926,29,50-100,1955,1.1745080854637557
SIM,1901,9,na,1910,4179
STAT,1881,20,35-39,1901,5.543602672710777
STAT,1933,34,35-39,1967,12.215777755955322
STAT,1837,35,15-19,1872,0.055970677182126456
STAT,1836,21,35-39,1857,5.944078393432353
STAT,1850,27,25-29,1877,22.986641971060642
SIM,1906,32,25-29,1938,15
STAT,1901,20,30-34,1921,25.054004626816884
STAT,1870,24,45-49,1894,0.6908310132602254
STAT,1879,49,40-44,1928,0.17195689049048216
STAT,1851,18,na,1869,2191.200217015471
STAT,1914,25,35-39,1939,15.025957694329898
STAT,1879,47,20-24,1926,0.012252688370889447
STAT,1903,48,15-19,1951,3.162643075065115E-4
SIM,1913,10,na,1923,3676
STAT,1869,90,na,1959,124.79601738316339
STAT,1872,19,25-29,1891,5.644002073234361
STAT,1858,27,30-34,1885,19.686194744064263
STAT,1875,42,20-24,1917,0.16287673986905996
STAT,1782,78,na,1860,919.0418461827348
STAT,1891,23,30-34,1914,21.83659243323528
STAT,1891,43,50-100,1934,1.289764493483822
STAT,1881,18,20-24,1899,16.698035242207652
SIM,1886,36,45-49,1922,11
SIM,1866,27,30-34,1893,7
STAT,1944,21,35-39,1965,10.055370106088871
STAT,1812,93,na,1905,2.3144927433890787
STAT,1808,51,20-24,1859,9.703957353527808E-4
STAT,1923,45,35-39,1968,0.1499410647493503
STAT,1824,32,30-34,1856,7.792421269356124
SIM,1862,20,40-44,1882,89
STAT,1927,19,20-24,1946,166.30207110266116
SIM,1832,32,30-34,1864,32
SIM,1939,12,na,1951,4753
STAT,1866,53,35-39,1919,0.007732333531417501
STAT,1882,44,50-100,1926,0.9978050933749869
STAT,1922,15,20-24,1937,155.8738518232726
SIM,1908,36,45-49,1944,8
STAT,1846,47,25-29,1893,0.033955183169530063
STAT,1882,72,na,1954,1209.1085388312633
SIM,1858,28,na,1886,2435
STAT,1841,35,35-39,1876,9.474392458374018
STAT,1864,24,15-19,1888,3.0037886115970514
STAT,1827,46,45-49,1873,0.21886549947019446
STAT,1822,42,45-49,1864,2.668331833268036
STAT,1816,46,30-34,1862,0.2986984774947639
STAT,1956,15,na,1971,4830.52082534427
STAT,1927,0,na,1927,5555.973255344021
STAT,1917,49,20-24,1966,0.011322125394096853
STAT,1850,45,25-29,1895,0.02686263672910818
STAT,1870,47,na,1917,2232.4841046386487
SIM,1817,74,na,1891,1796
STAT,1898,44,15-19,1942,0.0012721537651942613
SIM,1852,34,45-49,1886,3
SIM,1794,63,na,1857,745
SIM,1946,25,20-24,1971,77
STAT,1912,28,na,1940,3635.9507103174783
STAT,1864,87,na,1951,160.16703423482232
STAT,1842,46,40-44,1888,0.043054640085984544
STAT,1839,20,45-49,1859,0.8445040212430888
STAT,1883,37,30-34,1920,5.12728404172225
STAT,1901,35,35-39,1936,2.15482652257029
STAT,1843,48,15-19,1891,3.902516395059811E-4
STAT,1859,24,40-44,1883,1.6890839275211833
STAT,1924,13,na,1937,4665.836442801877
STAT,1919,19,50-100,1938,0.4063358689792736
SIM,1891,37,30-34,1928,12
STAT,1864,47,na,1911,2035.808588373768
SIM,1923,36,40-44,1959,1
STAT,1824,37,25-29,1861,0.45462579136838843
STAT,1920,36,15-19,1956,0.020773984178004194
STAT,1818,44,45-49,1862,2.7594164518285957
STAT,1828,30,40-44,1858,7.002869503546721
STAT,1844,34,45-49,1878,2.0234422808267425
STAT,1873,26,15-19,1899,0.46699594677552503
STAT,1945,12,na,1957,4243.632037167086
STAT,1870,87,na,1957,214.2739786636938
SIM,1861,1,na,1862,2919
STAT,1933,27,na,1960,4940.361840124329
SIM,1907,10,na,1917,4894
STAT,1906,42,30-34,1948,0.11546491209700646
STAT,1901,39,20-24,1940,0.23029500365889366
STAT,1860,31,20-24,1891,2.214145728271082
SIM,1888,35,na,1923,322
SIM,1896,40,40-44,1936,2
SIM,1923,5,na,1928,4291
SIM,1824,46,30-34,1870,1
STAT,1936,30,40-44,1966,3.7675982325583854
STAT,1870,51,35-39,1921,0.00862372108985725
STAT,1891,28,25-29,1919,51.83616551414936
STAT,1835,28,40-44,1863,2.9327319348041243
STAT,1888,40,40-44,1928,2.622227436164319
STAT,1837,32,40-44,1869,4.35980692237459
SIM,1945,4,na,1949,6372
SIM,1804,64,na,1868,845
STAT,1860,17,45-49,1877,0.0614599754123552
STAT,1885,46,na,1931,2217.75834890344
STAT,1900,46,45-49,1946,0.1849378435640415
STAT,1838,48,40-44,1886,0.0742292777164852
STAT,1885,35,45-49,1920,1.978106055708313
STAT,1896,31,35-39,1927,13.404344028461368
STAT,1878,36,15-19,1914,0.05805377844166385
STAT,1901,43,50-100,1944,0.10183513620474212
STAT,1865,38,25-29,1903,2.6156430472253196
SIM,1871,69,na,1940,1433
STAT,1875,15,30-34,1890,1.6442725842848307
STAT,1893,13,na,1906,3224.4937775647995
STAT,1833,55,na,1888,860.2449480775539
STAT,1891,46,25-29,1937,0.040068799227397145
STAT,1915,36,40-44,1951,1.4980760477036066
STAT,1897,47,35-39,1944,0.10438951638229274
STAT,1827,28,45-49,1855,1.2973817873202935
STAT,1853,18,15-19,1871,5.502802031991706
SIM,1854,29,25-29,1883,12
STAT,1817,37,na,1854,1019.0279424958906
SIM,1845,18,na,1863,2632
STAT,1894,19,45-49,1913,0.0826224448525707
STAT,1846,29,25-29,1875,29.874844897725133
STAT,1870,49,50-100,1919,0.2397345629305246
SIM,1824,49,50-100,1873,1
STAT,1864,36,20-24,1900,0.7041563742579159
STAT,1929,36,35-39,1965,3.0863149285801774
STAT,1834,41,20-24,1875,0.085465371897572
STAT,1809,106,na,1915,0.011818430274541214
SIM,1840,29,30-34,1869,40
STAT,1906,28,na,1934,3443.6914047249143
STAT,1816,52,na,1868,2328.440199128021
STAT,1863,22,40-44,1885,1.8144262430715643
STAT,1832,29,30-34,1861,29.786173029048882
STAT,1928,39,25-29,1967,1.2322484254976929
STAT,1928,20,35-39,1948,11.736467855595702
SIM,1841,44,40-44,1885,20
STAT,1926,26,45-49,1952,2.0602947262844276
STAT,1949,15,25-29,1964,49.92966607309264
SIM,1935,19,20-24,1954,353
STAT,1918,17,20-24,1935,29.206717929462545
SIM,1805,49,na,1854,2283
STAT,1841,59,na,1900,2164.1737025976818
STAT,1854,20,40-44,1874,1.3811165121337317
STAT,1930,13,na,1943,5078.744812021064
STAT,1843,19,35-39,1862,0.6846918559177996
STAT,1894,37,45-49,1931,2.5350343884615616
STAT,1829,40,35-39,1869,0.8970906687548759
STAT,1848,22,45-49,1870,0.7945291194692369
STAT,1849,38,45-49,1887,1.701017994501537
STAT,1907,44,35-39,1951,0.18099991606498986
STAT,1822,52,na,1874,1391.2918094218296
SIM,1810,64,na,1874,3098
STAT,1883,18,50-100,1901,0.047008816912444615
STAT,1851,40,na,1891,1843.8189440315487
STAT,1865,38,50-100,1903,1.1153584230048472
STAT,1886,28,20-24,1914,12.105742819991146
STAT,1865,51,30-34,1916,0.005460627133427515
STAT,1857,47,30-34,1904,0.07393428591986526
STAT,1816,49,50-100,1865,0.72583550273048
STAT,1927,27,na,1954,4517.145127209709
STAT,1910,32,40-44,1942,3.731066228773974
STAT,1877,57,na,1934,2040.0173193681205
STAT,1948,18,45-49,1966,0.5656523184895448
SIM,1894,35,na,1929,1505
STAT,1921,47,20-24,1968,0.012310405289780595
STAT,1834,29,50-100,1863,0.3643881439834988
STAT,1811,52,40-44,1863,0.04736129681110243
STAT,1875,34,50-100,1909,0.9327936123372413
STAT,1885,17,45-49,1902,0.06420871437605391
STAT,1833,44,40-44,1877,1.139715889183688
STAT,1838,28,20-24,1866,6.324582602372473
STAT,1826,54,45-49,1880,0.01926994048001407
STAT,1825,97,na,1922,3.3082947550599786
SIM,1890,73,na,1963,2631
STAT,1823,43,50-100,1866,1.732006661684616
STAT,1898,39,50-100,1937,0.35276010462195045
STAT,1817,54,35-39,1871,0.005596657552217848
STAT,1855,15,45-49,1870,0.052032257374117166
STAT,1862,45,15-19,1907,3.440927171455516E-4
STAT,1878,30,50-100,1908,0.9502743897557501
STAT,1826,38,40-44,1864,6.974197155943051
STAT,1835,20,50-100,1855,0.4160917836511131
SIM,1907,41,na,1948,4474
STAT,1907,39,50-100,1946,0.3827654747244814
STAT,1953,15,15-19,1968,54.436441705628006
STAT,1849,25,30-34,1874,25.517134993031195
SIM,1860,41,40-44,1901,7
STAT,1906,17,25-29,1923,8.205827322781811
STAT,1847,28,30-34,1875,27.16874938044992
STAT,1801,103,na,1904,0.04761084099101465
STAT,1921,28,15-19,1949,0.7747226122897412
STAT,1782,111,na,1893,9.442277529674674E-4
STAT,1853,18,45-49,1871,0.06057018072061048
STAT,1893,29,40-44,1922,3.7192623693146296
STAT,1902,40,35-39,1942,0.1788581343567872
STAT,1915,24,40-44,1939,3.405083465588576
SIM,1853,41,35-39,1894,6
SIM,1844,39,na,1883,2804
SIM,1903,51,na,1954,2415
STAT,1887,41,na,1928,2555.430271643506
STAT,1890,39,na,1929,2823.4573303979446
STAT,1863,37,na,1900,2011.326677150927
SIM,1838,30,45-49,1868,2
STAT,1893,45,45-49,1938,0.16813451514570746
STAT,1915,17,35-39,1932,0.8658247144203528
STAT,1786,99,na,1885,0.6958364579515848
STAT,1856,28,40-44,1884,2.2135157287415415
SIM,1840,49,na,1889,2557
SIM,1897,34,30-34,1931,3
STAT,1808,54,25-29,1862,0.004357541735578011
STAT,1888,21,35-39,1909,6.7554331339291736
STAT,1878,48,15-19,1926,4.0637623972866006E-4
STAT,1894,29,na,1923,3013.152063581402
STAT,1897,21,45-49,1918,0.9288751814678661
STAT,1906,6,na,1912,3782.8798575850606
STAT,1887,48,25-29,1935,0.06260216731666714
STAT,1839,18,na,1857,2773.341862276915
SIM,1876,42,50-100,1918,12
STAT,1924,17,45-49,1941,0.5891556256549323
SIM,1938,33,na,1971,4204
STAT,1911,24,40-44,1935,3.1331875411264636
STAT,1892,40,50-100,1932,1.3211846210262972
STAT,1906,24,30-34,1930,25.631986012894306
STAT,1788,100,na,1888,0.09013993657849917
STAT,1901,40,50-100,1941,0.10361115333713121
SIM,1874,15,20-24,1889,128
STAT,1843,51,40-44,1894,0.010451557277674365
STAT,1833,22,30-34,1855,16.64564410443999
STAT,1883,51,na,1934,2081.3513817560433
STAT,1930,35,30-34,1965,2.364698272039593
STAT,1794,94,na,1888,0.054227663864444636
STAT,1866,15,20-24,1881,16.80788238561188
SIM,1837,51,na,1888,1802
STAT,1864,42,15-19,1906,0.012539144270966127
SIM,1910,40,35-39,1950,4
STAT,1884,45,35-39,1929,0.13535423912654607
SIM,1848,25,20-24,1873,34
SIM,1852,34,na,1886,1643
STAT,1909,27,20-24,1936,17.267597002200095
STAT,1917,21,40-44,1938,3.5365010458142785
SIM,1917,27,20-24,1944,11
SIM,1893,16,na,1909,3526
SIM,1825,32,na,1857,615
STAT,1852,99,na,1951,1.9063436860227858
SIM,1899,31,30-34,1930,8
STAT,1871,29,20-24,1900,11.618993574689625
SIM,1875,90,na,1965,236
STAT,1866,47,40-44,1913,0.155546003786446
STAT,1915,46,50-100,1961,0.22525161870678462
STAT,1895,70,na,1965,2088.2770545056437
STAT,1927,25,15-19,1952,0.8570201901335872
STAT,1843,44,35-39,1887,1.7955451071457973
STAT,1864,18,20-24,1882,16.57459726672502
STAT,1837,54,20-24,1891,5.754175218106982E-4
SIM,1880,43,na,1923,3256
STAT,1852,28,40-44,1880,3.4868258239516816
STAT,1837,82,na,1919,374.12147578676934
STAT,1845,49,30-34,1894,0.04703089750872605
STAT,1862,83,na,1945,338.1301098324354
STAT,1936,25,50-100,1961,0.9439347409719105
STAT,1851,39,45-49,1890,1.5585949474980563
STAT,1868,74,na,1942,1071.9124418036092
SIM,1855,76,na,1931,1575
SIM,1824,84,na,1908,857
SIM,1926,14,na,1940,6267
SIM,1808,60,na,1868,1261
STAT,1948,17,30-34,1965,13.806337405186163
STAT,1823,41,15-19,1864,0.023719030445203772
STAT,1875,45,25-29,1920,0.059736354697701693
STAT,1883,15,50-100,1898,0.047351287103805886
STAT,1857,31,15-19,1888,0.1111004820108261
STAT,1913,35,na,1948,3701.0019073255476
SIM,1857,25,30-34,1882,105
SIM,1948,4,na,1952,5825
STAT,1890,32,15-19,1922,0.1723997649561245
STAT,1913,38,35-39,1951,2.345327228423618
STAT,1856,26,15-19,1882,0.34012158944266396
STAT,1876,50,25-29,1926,0.0036321047136972213
SIM,1921,38,35-39,1959,1
STAT,1927,43,45-49,1970,0.20670018450545333
SIM,1904,9,na,1913,4201
STAT,1831,36,25-29,1867,2.9615210414190303
STAT,1930,28,25-29,1958,83.06579979309885
STAT,1863,54,50-100,1917,0.01253884286910085
STAT,1939,33,25-29,1972,9.32099598672133
STAT,1868,44,40-44,1912,2.143185179271139
STAT,1831,91,na,1922,45.352861258085895
STAT,1829,87,na,1916,64.33584405627006
STAT,1869,34,45-49,1903,1.7445938806362724
STAT,1921,30,na,1951,4192.373603896405
STAT,1931,7,na,1938,5195.332326571415
STAT,1920,17,45-49,1937,0.5532485248874486
SIM,1849,30,20-24,1879,4
STAT,1858,23,15-19,1881,2.611555075618042
STAT,1845,41,35-39,1886,0.9268151965696926
STAT,1847,20,35-39,1867,6.561695913220163
SIM,1848,41,25-29,1889,3
STAT,1837,47,15-19,1884,3.329373908310019E-4
STAT,1925,28,15-19,1953,0.8232751468078726
STAT,1933,22,35-39,1955,12.40497468630005
SIM,1924,13,na,1937,5281
STAT,1823,96,na,1919,6.7832618229008395
STAT,1916,17,50-100,1933,0.07840448460819342
SIM,1855,28,30-34,1883,29
STAT,1844,64,na,1908,1722.172374373718
STAT,1889,37,50-100,1926,1.4784785482392901
STAT,1955,7,na,1962,5172.358284018856
STAT,1860,34,25-29,1894,8.284297063432994
SIM,1898,26,30-34,1924,35
SIM,1837,57,na,1894,1649
STAT,1872,37,25-29,1909,2.8831117147532033
STAT,1844,43,40-44,1887,2.253132159237316
SIM,1912,45,30-34,1957,1
STAT,1827,43,40-44,1870,2.1061299395276896
STAT,1788,106,na,1894,0.0014660449134099062
STAT,1924,22,25-29,1946,107.94758582900587
STAT,1825,49,45-49,1874,0.2919733608960274
STAT,1852,24,50-100,1876,0.4806501638777726
STAT,1865,33,30-34,1898,15.873296849162495
STAT,1922,33,15-19,1955,0.14296888030740618
STAT,1858,84,na,1942,254.04300353486548
STAT,1854,54,na,1908,1164.277111220397
STAT,1840,47,50-100,1887,0.09752041234174522
STAT,1841,18,50-100,1859,0.06994801694551801
STAT,1907,22,25-29,1929,83.52689236115779
SIM,1953,16,na,1969,4649
STAT,1851,20,25-29,1871,54.77589417606928
STAT,1854,23,45-49,1877,0.45229011351385656
STAT,1808,49,45-49,1857,0.3275826364661768
STAT,1917,45,40-44,1962,0.16324608187494646
STAT,1910,42,50-100,1952,0.10978574697197771
SIM,1889,42,25-29,1931,4
STAT,1830,30,35-39,1860,9.71201654904299
STAT,1839,36,25-29,1875,3.229981699517484
STAT,1864,20,35-39,1884,5.468628337555222
STAT,1894,34,40-44,1928,5.467606851004228
SIM,1924,4,na,1928,5320
SIM,1875,20,20-24,1895,10
SIM,1868,49,na,1917,1047
STAT,1904,45,30-34,1949,0.07878919842959314
SIM,1902,16,20-24,1918,162
STAT,1879,29,20-24,1908,11.948576689928988
STAT,1889,27,25-29,1916,50.9404291904982
STAT,1811,43,45-49,1854,7.674964162069084
STAT,1834,20,25-29,1854,34.23127616340858
STAT,1938,28,25-29,1966,64.47925439211862
STAT,1895,76,na,1971,1691.7325648468727
STAT,1910,35,45-49,1945,0.6508209387611744
SIM,1901,0,na,1901,4317
STAT,1914,19,40-44,1933,0.2837809405086291
STAT,1922,40,20-24,1962,0.02010005950559822
STAT,1896,24,na,1920,3098.1575969646055
STAT,1848,54,na,1902,1959.4716775451452
STAT,1865,32,na,1897,2178.680675840879
STAT,1910,19,50-100,1929,0.07301254822750182
STAT,1868,8,na,1876,2653.607252213905
STAT,1906,0,na,1906,4252.024867905278
STAT,1878,54,50-100,1932,0.015111448786650154
STAT,1850,64,na,1914,802.7072654721363
SIM,1847,36,25-29,1883,4
STAT,1897,27,15-19,1924,0.6025405380258271
SIM,1831,66,na,1897,1553
STAT,1858,52,30-34,1910,0.004521550178326234
STAT,1848,33,30-34,1881,17.159515393021607
STAT,1840,41,15-19,1881,0.005745436428274398
STAT,1858,30,20-24,1888,2.107546477211875
SIM,1856,33,30-34,1889,2
STAT,1807,78,na,1885,367.04217657930747
STAT,1800,54,25-29,1854,0.02065078895745115
SIM,1906,27,45-49,1933,1
SIM,1846,34,na,1880,1141
SIM,1918,19,na,1937,4461
STAT,1813,72,na,1885,1017.0756210244091
STAT,1901,10,na,1911,3621.8331593238654
STAT,1828,33,45-49,1861,2.555024074608165
STAT,1926,35,40-44,1961,1.8169728639198275
STAT,1848,26,25-29,1874,47.59827905619369
STAT,1923,32,20-24,1955,2.766842515816217
STAT,1875,56,na,1931,2094.4027256950258
STAT,1922,18,na,1940,4201.236173157993
STAT,1870,5,na,1875,2781.009350725004
STAT,1884,39,na,1923,2232.6132013660917
STAT,1859,32,na,1891,1891.372523259351
STAT,1788,94,na,1882,1.712546710681226
STAT,1908,21,30-34,1929,26.297457106769446
STAT,1904,38,25-29,1942,0.8834584571398735
STAT,1867,20,20-24,1887,66.39105383125728
STAT,1839,43,30-34,1882,1.1114185056884927
STAT,1865,26,25-29,1891,38.753355900052945
STAT,1829,25,45-49,1854,1.1106309873403857
SIM,1793,81,na,1874,591
STAT,1867,48,50-100,1915,0.2293528061120665
STAT,1826,73,na,1899,946.9192828282708
STAT,1851,12,na,1863,2292.3284444033525
STAT,1853,33,40-44,1886,3.4270527656841
STAT,1819,63,na,1882,443.12803711634086
SIM,1907,47,na,1954,4404
SIM,1833,30,25-29,1863,22
STAT,1873,18,30-34,1891,1.6306752072402273
STAT,1895,24,45-49,1919,0.9014476734232392
STAT,1898,19,na,1917,3378.0117208019933
STAT,1864,84,na,1948,302.4261544003793
STAT,1870,37,20-24,1907,0.7684847955959496
SIM,1862,58,na,1920,3270
SIM,1817,37,na,1854,2803
STAT,1886,42,35-39,1928,1.8728797271294952
STAT,1880,29,30-34,1909,25.955854552357245
SIM,1848,60,na,1908,2307
SIM,1823,37,na,1860,1642
SIM,1846,28,20-24,1874,46
STAT,1896,16,45-49,1912,0.08632148380292934
SIM,1901,56,na,1957,2890
STAT,1885,50,35-39,1935,0.008583875579795626
SIM,1931,32,20-24,1963,1
STAT,1852,48,50-100,1900,0.2441116920518543
STAT,1846,99,na,1945,1.1216633203331712
STAT,1889,76,na,1965,1463.0668306588602
STAT,1903,46,25-29,1949,0.046252565785906787
STAT,1891,8,na,1899,3196.7367418139797
STAT,1819,51,35-39,1870,0.00153598153689952
STAT,1889,34,30-34,1923,20.845417126274885
SIM,1833,49,45-49,1882,1
STAT,1947,18,25-29,1965,48.285825784544436
STAT,1841,15,15-19,1856,8.624537904318656
STAT,1820,39,15-19,1859,0.09630134937226559
STAT,1868,29,45-49,1897,1.0647447181595682
STAT,1825,30,25-29,1855,20.11383702096664
STAT,1910,17,15-19,1927,8.891940787239017
SIM,1821,42,na,1863,1970
STAT,1881,56,na,1937,1926.123825187724
SIM,1947,16,na,1963,4370
STAT,1830,38,30-34,1868,4.811050336597415
SIM,1800,74,na,1874,216
SIM,1847,43,30-34,1890,1
STAT,1834,44,25-29,1878,0.3325470617322626
STAT,1892,21,25-29,1913,71.08941774443257
SIM,1838,36,50-100,1874,14
SIM,1924,19,na,1943,5183
SIM,1847,28,40-44,1875,21
SIM,1887,16,na,1903,3815
STAT,1843,54,45-49,1897,0.013944603617274941
SIM,1920,29,na,1949,4007
STAT,1893,42,40-44,1935,2.809319014209708
STAT,1901,17,50-100,1918,0.06850118887155027
STAT,1828,52,50-100,1880,0.017411606480082702
SIM,1869,90,na,1959,1317
STAT,1904,28,15-19,1932,0.64592129953185
SIM,1851,80,na,1931,592
SIM,1849,40,30-34,1889,7
STAT,1866,25,30-34,1891,23.14245738502276
SIM,1853,39,20-24,1892,1
STAT,1830,44,na,1874,1809.7524267990912
STAT,1911,40,na,1951,3544.5272579143275
STAT,1845,39,20-24,1884,0.3936376756576452
SIM,1860,44,45-49,1904,8
STAT,1817,51,30-34,1868,0.004106920861468345
STAT,1852,28,na,1880,2518.0391945332535
SIM,1790,79,na,1869,1197
STAT,1845,51,45-49,1896,0.007235762239148092
STAT,1888,19,20-24,1907,20.351895927147535
SIM,1886,24,45-49,1910,22
STAT,1876,45,45-49,1921,0.24095277895494893
SIM,1794,69,na,1863,657
STAT,1884,42,30-34,1926,1.0991907135770091
STAT,1850,15,25-29,1865,3.235541139673777
SIM,1882,16,25-29,1898,17
STAT,1911,27,45-49,1938,1.6658137946886764
STAT,1951,2,na,1953,4701.080129772555
STAT,1874,16,25-29,1890,5.862804531508413
SIM,1912,28,15-19,1940,9
STAT,1809,54,45-49,1863,0.11504997157650938
STAT,1850,52,30-34,1902,0.0027340266084672268
SIM,1815,42,na,1857,2183
STAT,1798,56,na,1854,1587.0
STAT,1826,51,40-44,1877,0.01483595248494704
SIM,1857,31,25-29,1888,43
SIM,1862,24,na,1886,3819
SIM,1917,31,na,1948,2112
SIM,1932,14,na,1946,6513
STAT,1859,109,na,1968,0.0062664235713673945
STAT,1860,29,45-49,1889,0.9023825794190974
STAT,1932,17,35-39,1949,5.517668545458768
STAT,1835,87,na,1922,133.30809166424214
STAT,1883,39,50-100,1922,1.1692539070912302
SIM,1855,48,na,1903,2992
STAT,1910,25,35-39,1935,14.555403335982461
STAT,1817,62,na,1879,673.8064616680952
STAT,1831,33,20-24,1864,2.8329146067663897
STAT,1851,36,40-44,1887,3.5308164160818145
STAT,1849,31,25-29,1880,10.097960059868443
STAT,1905,34,50-100,1939,0.750233599904284
STAT,1836,18,45-49,1854,0.1583942875254467
STAT,1834,39,45-49,1873,1.0703491881293694
STAT,1832,45,na,1877,2096.9702037705547
STAT,1857,41,25-29,1898,0.49499618704049897
STAT,1861,26,50-100,1887,0.5397360368985228
STAT,1833,21,na,1854,1103.8841752053524
STAT,1896,29,50-100,1925,0.8372338778464982
STAT,1947,25,30-34,1972,43.89973785580646
STAT,1836,51,35-39,1887,0.006808384668192797
STAT,1838,30,35-39,1868,5.484558109881064
SIM,1850,39,na,1889,1434
STAT,1867,52,40-44,1919,0.009903312049208976
STAT,1953,0,na,1953,5196.776544802132
STAT,1885,48,20-24,1933,0.011647183239906047
STAT,1927,40,40-44,1967,0.31200154284556786
STAT,1860,54,na,1914,1708.2337228415968
STAT,1835,56,na,1891,1543.2995164454123
STAT,1867,27,na,1894,2257.0067737242375
STAT,1906,27,35-39,1933,13.972337193713459
STAT,1891,16,25-29,1907,6.985653735041877
SIM,1842,75,na,1917,1031
STAT,1908,24,35-39,1932,8.535603905348582
STAT,1822,49,50-100,1871,0.3994556555360451
STAT,1937,11,na,1948,3820.4828179964184
STAT,1878,24,45-49,1902,0.7129613323027101
SIM,1874,31,25-29,1905,1
STAT,1906,25,na,1931,3479.301679871975
STAT,1912,38,15-19,1950,0.01843315342773077
STAT,1857,26,35-39,1883,7.681611221112702
STAT,1838,43,50-100,1881,0.47383231401502524
STAT,1848,20,na,1868,2471.549648841312
STAT,1887,23,40-44,1910,2.2865053177737
STAT,1913,43,15-19,1956,0.0014764502284438574
SIM,1851,41,30-34,1892,2
STAT,1893,41,na,1934,2903.347401831625
STAT,1946,22,na,1968,4019.8368542579947
STAT,1768,100,na,1868,0.5644812674313269
STAT,1911,30,35-39,1941,8.86910179642182
STAT,1859,39,15-19,1898,0.044059741005514415
STAT,1922,12,na,1934,4534.437027009057
SIM,1902,32,na,1934,3479
STAT,1877,51,na,1928,2196.1821969213197
STAT,1883,21,15-19,1904,3.1833856094438775
STAT,1843,41,30-34,1884,1.1846423089282792
STAT,1887,45,20-24,1932,0.013339757644997582
STAT,1904,24,na,1928,3357.7826054008337
STAT,1811,100,na,1911,0.6431773318691372
STAT,1913,35,30-34,1948,1.7929243262878893
STAT,1871,31,35-39,1902,10.143474116758687
STAT,1889,20,40-44,1909,2.5243470886366803
STAT,1879,25,50-100,1904,0.6606739649450929
SIM,1867,33,na,1900,2318
STAT,1863,37,15-19,1900,0.04793983983598217
SIM,1846,65,na,1911,602
SIM,1889,26,20-24,1915,52
SIM,1828,32,40-44,1860,73
STAT,1858,45,25-29,1903,0.04442559538983649
STAT,1921,45,30-34,1966,0.09977131296022596
STAT,1816,49,35-39,1865,0.41374988066294643
STAT,1871,38,50-100,1909,1.2186523258484137
STAT,1819,97,na,1916,1.2495425331082188
STAT,1925,36,35-39,1961,2.8790905262850908
SIM,1858,50,na,1908,2325
STAT,1875,21,25-29,1896,58.960253990283036
SIM,1833,46,40-44,1879,3
STAT,1866,37,30-34,1903,4.864938342354256
STAT,1856,20,45-49,1876,0.5901386914896517
SIM,1879,58,na,1937,798
STAT,1899,66,na,1965,2478.754019986555
STAT,1838,30,na,1868,1172.580538991885
STAT,1848,7,na,1855,2871.22422
SIM,1866,23,15-19,1889,9
SIM,1858,59,na,1917,2126
STAT,1779,89,na,1868,57.02189132189508
STAT,1839,33,20-24,1872,3.0585447784746567
STAT,1867,30,30-34,1897,16.64490688140161
STAT,1912,32,45-49,1944,1.5304004819803365
SIM,1887,2,na,1889,4022
STAT,1905,33,15-19,1938,0.11711585334552133
STAT,1836,69,na,1905,1123.1652249511383
STAT,1890,48,30-34,1938,0.06527251737650656
STAT,1919,49,25-29,1968,0.05643815982694834
STAT,1921,25,50-100,1946,1.1036060309334397
STAT,1844,46,45-49,1890,0.23446638804894263
STAT,1931,33,25-29,1964,12.01830896214042
STAT,1823,62,na,1885,1508.9337684990178
SIM,1911,46,na,1957,2318
STAT,1907,8,na,1915,3792.9897606497966
STAT,1923,42,30-34,1965,0.1478534265197103
SIM,1910,61,na,1971,3130
SIM,1933,36,35-39,1969,3
STAT,1830,28,20-24,1858,11.199525954400519
STAT,1850,101,na,1951,0.2634920967419036
STAT,1888,39,40-44,1927,5.001505147711308
STAT,1928,37,na,1965,4718.484792211402
SIM,1874,37,30-34,1911,1
STAT,1939,23,15-19,1962,5.285484432921587
STAT,1861,34,45-49,1895,1.4378210902969502
STAT,1865,18,40-44,1883,0.1710654304751832
STAT,1821,44,15-19,1865,0.014993100676684938
STAT,1843,17,na,1860,2898.3475435270025
STAT,1898,27,35-39,1925,12.975076123842346
SIM,1788,69,na,1857,325
SIM,1905,46,na,1951,2964
SIM,1908,29,na,1937,2780
STAT,1946,22,45-49,1968,1.2385707898123894
SIM,1850,20,15-19,1870,12
SIM,1896,29,30-34,1925,9
STAT,1802,63,na,1865,1266.0687643276171
STAT,1856,39,50-100,1895,0.8729553715058782
STAT,1871,7,na,1878,2730.761599263675
STAT,1905,43,25-29,1948,0.06367527590317525
STAT,1888,29,30-34,1917,28.85630853682937
STAT,1919,39,15-19,1958,0.02031300855405536
STAT,1922,27,20-24,1949,20.425012236891327
SIM,1878,73,na,1951,1359
STAT,1867,39,40-44,1906,4.098269395841812
SIM,1832,25,25-29,1857,6
SIM,1899,72,na,1971,1470
STAT,1806,90,na,1896,23.7403461341976
STAT,1830,40,45-49,1870,1.3574094576865199
SIM,1827,67,na,1894,1208
STAT,1916,21,20-24,1937,115.27453649781306
STAT,1811,77,na,1888,511.9431117323871
STAT,1890,0,na,1890,3554.7503067623566
STAT,1842,20,15-19,1862,1.0479500147623484
STAT,1918,10,na,1928,4267.4104928109855
SIM,1925,0,na,1925,5488
STAT,1870,18,15-19,1888,5.937530218696908
STAT,1840,104,na,1944,0.026263447573694934
STAT,1871,66,na,1937,1634.9841276767986
STAT,1925,46,45-49,1971,0.2616014639061991
STAT,1823,31,na,1854,2266.040268630111
SIM,1895,45,na,1940,4505
STAT,1880,44,20-24,1924,0.16264698748473844
STAT,1879,31,35-39,1910,10.431202806619895
STAT,1898,32,15-19,1930,0.1914979906867661
SIM,1866,33,25-29,1899,2
STAT,1842,39,35-39,1881,1.8358050904841103
STAT,1846,22,40-44,1868,1.5227810018793955
STAT,1884,67,na,1951,1517.48527436089
STAT,1927,23,50-100,1950,0.8015981234579257
STAT,1939,28,45-49,1967,1.7168586005572806
SIM,1837,29,25-29,1866,4
SIM,1902,8,na,1910,3754
STAT,1865,23,20-24,1888,63.22406291411979
STAT,1819,49,20-24,1868,0.002134370580228725
SIM,1839,52,na,1891,511
STAT,1909,49,50-100,1958,0.20451375247803208
STAT,1847,38,40-44,1885,4.063948375760998
SIM,1838,39,na,1877,2096
STAT,1907,32,35-39,1939,8.484592296810927
SIM,1850,39,35-39,1889,13
SIM,1915,32,35-39,1947,27
STAT,1829,106,na,1935,0.004433774498958193
STAT,1831,97,na,1928,4.2045856511091415
STAT,1858,33,25-29,1891,7.788902788974065
STAT,1842,69,na,1911,364.3095296711487
STAT,1926,38,45-49,1964,0.825172672224287
SIM,1855,38,40-44,1893,19
STAT,1826,45,na,1871,2089.4801578853157
STAT,1899,24,15-19,1923,4.477820493878959
STAT,1805,77,na,1882,140.77970872800066
SIM,1829,38,30-34,1867,14
SIM,1870,39,50-100,1909,17
STAT,1844,30,na,1874,2621.419508351987
STAT,1949,22,30-34,1971,33.206727956952804
STAT,1822,36,15-19,1858,0.11825193824573857
STAT,1935,17,20-24,1952,184.0062897967411
STAT,1862,39,50-100,1901,1.0351941836987597
SIM,1946,3,na,1949,3975
SIM,1884,73,na,1957,2682
STAT,1839,28,40-44,1867,3.4808784335897185
STAT,1951,18,15-19,1969,53.52250782508691
STAT,1934,37,na,1971,5156.575197552966
STAT,1844,47,20-24,1891,0.011832843472771762
STAT,1921,35,20-24,1956,0.29135556090688025
SIM,1819,38,na,1857,1926
STAT,1911,40,45-49,1951,0.15883857759191378
STAT,1825,46,40-44,1871,0.22039297500075494
SIM,1856,24,na,1880,873
STAT,1842,15,35-39,1857,0.17699555688904767
STAT,1813,53,20-24,1866,0.002513349796551919
STAT,1930,18,15-19,1948,58.1088906678496
SIM,1866,88,na,1954,402
STAT,1839,103,na,1942,0.13333494011678346
STAT,1854,34,50-100,1888,0.5109834719342354
STAT,1834,26,50-100,1860,0.37235113854768204
SIM,1914,29,na,1943,4686
STAT,1916,16,40-44,1932,0.2934290482185113
STAT,1858,110,na,1968,0.00216957505310194
STAT,1886,65,na,1951,1750.04085116949
SIM,1864,59,na,1923,1986
STAT,1922,38,50-100,1960,0.4719344356207629
STAT,1864,30,45-49,1894,1.598062505134153
SIM,1951,15,na,1966,1107
STAT,1829,29,25-29,1858,25.807975829896385
STAT,1835,44,45-49,1879,1.3225147170992726
STAT,1902,34,40-44,1936,3.4764990701229768
STAT,1892,37,40-44,1929,5.419759226272475
STAT,1882,16,15-19,1898,5.695754395499523
STAT,1872,34,20-24,1906,2.683559830302348
SIM,1929,38,35-39,1967,8
STAT,1867,42,30-34,1909,1.0859371957843187
SIM,1831,43,50-100,1874,7
STAT,1844,28,15-19,1872,0.546286331061805
STAT,1877,19,45-49,1896,0.06595459591314584
SIM,1828,46,na,1874,1714
STAT,1804,95,na,1899,8.424058353889407
STAT,1865,40,50-100,1905,0.9742636045741846
STAT,1913,37,20-24,1950,0.256881790626515
STAT,1943,27,20-24,1970,19.218691542436847
STAT,1924,44,na,1968,4360.597366822802
STAT,1829,56,na,1885,766.684960848742
SIM,1929,25,na,1954,5235
SIM,1866,85,na,1951,637
SIM,1863,19,25-29,1882,34
STAT,1860,38,40-44,1898,3.553419696003067
STAT,1892,15,30-34,1907,1.9825284444874705
STAT,1822,83,na,1905,228.92267333328678
STAT,1891,15,na,1906,3120.2405149655756
STAT,1886,46,15-19,1932,4.1539573800496E-4
STAT,1857,48,45-49,1905,0.17882180205033996
STAT,1859,100,na,1959,1.6061124218424978
STAT,1922,37,30-34,1959,2.050718024709151
STAT,1871,41,45-49,1912,1.4997191822371447
STAT,1907,26,40-44,1933,4.385817386491477
SIM,1841,25,na,1866,1155
STAT,1848,16,15-19,1864,6.925052237128563
SIM,1875,35,25-29,1910,4
STAT,1834,29,35-39,1863,5.496321652774937
STAT,1834,36,40-44,1870,2.4247521721109244
STAT,1855,19,25-29,1874,4.40839000330911
STAT,1804,50,45-49,1854,0.0954461308461222
STAT,1926,41,35-39,1967,0.2464700818565598
SIM,1852,28,15-19,1880,3
SIM,1852,65,na,1917,1806
SIM,1911,15,na,1926,2607
SIM,1865,9,na,1874,1987
SIM,1906,26,30-34,1932,143
STAT,1830,52,45-49,1882,0.010911783863804774
STAT,1854,47,15-19,1901,2.2137001206813791E-4
STAT,1904,41,15-19,1945,0.0013762943238251227
STAT,1853,75,na,1928,798.2332593004749
STAT,1876,23,50-100,1899,0.41096478256610386
STAT,1865,17,50-100,1882,0.04609257155260976
STAT,1821,48,30-34,1869,0.10214939112221004
STAT,1867,35,25-29,1902,2.7488034506517938
STAT,1893,9,na,1902,3244.6608639273195
STAT,1810,98,na,1908,0.10114194551691981
STAT,1862,41,35-39,1903,1.5493231270308756
STAT,1939,25,40-44,1964,4.6382909287664145
SIM,1880,12,na,1892,3337
SIM,1911,42,45-49,1953,3
STAT,1874,25,20-24,1899,12.189780203146535
STAT,1912,59,na,1971,3281.492069175601
STAT,1885,47,45-49,1932,0.23089456453428142
SIM,1893,47,45-49,1940,1
SIM,1859,38,na,1897,1857
SIM,1939,30,30-34,1969,240
STAT,1839,46,35-39,1885,0.13423252851049372
STAT,1835,50,na,1885,1727.356923578206
STAT,1878,36,na,1914,2435.659228078767
SIM,1923,34,na,1957,4244
STAT,1897,25,25-29,1922,56.55961731219429
STAT,1902,25,45-49,1927,1.5740921163111263
SIM,1870,41,35-39,1911,2
STAT,1882,53,20-24,1935,6.951481105707744E-4
STAT,1909,25,50-100,1934,0.956001820327534
STAT,1880,77,na,1957,976.0617530955085
STAT,1821,40,35-39,1861,2.1169570331762846
STAT,1842,38,na,1880,617.2711455979271
STAT,1924,16,30-34,1940,14.410706419373957
SIM,1833,36,30-34,1869,27
STAT,1849,33,15-19,1882,0.1251350131405121
STAT,1884,30,na,1914,2302.7116285304382
SIM,1822,58,na,1880,1154
STAT,1900,16,45-49,1916,0.09071255967684565
STAT,1872,42,na,1914,2311.5327238670147
SIM,1864,50,na,1914,2415
STAT,1949,15,50-100,1964,0.4316684956415783
SIM,1889,11,na,1900,3895
STAT,1899,46,25-29,1945,0.04450466200623297
STAT,1868,48,20-24,1916,0.011444816319082654
STAT,1953,9,na,1962,4711.033493998795
SIM,1902,30,35-39,1932,21
STAT,1893,32,30-34,1925,21.833862310335224
SIM,1901,25,35-39,1926,110
STAT,1876,54,40-44,1930,0.010349824106708684
STAT,1903,24,15-19,1927,4.65368520137535
STAT,1892,7,na,1899,3225.67541540343
SIM,1877,23,na,1900,46
SIM,1911,24,15-19,1935,5
SIM,1879,35,25-29,1914,2
SIM,1877,26,na,1903,45
STAT,1857,35,30-34,1892,4.12855288633453
STAT,1892,27,30-34,1919,31.17755471847257
STAT,1907,19,35-39,1926,0.796326229826448
SIM,1878,70,na,1948,1639
STAT,1932,40,15-19,1972,0.002072606747748235
STAT,1814,88,na,1902,92.9114126736261
STAT,1858,49,40-44,1907,0.12800959045720878
STAT,1826,76,na,1902,755.3043834345516
STAT,1885,29,15-19,1914,0.4427792138986942
STAT,1917,18,15-19,1935,9.61049624372366
SIM,1882,26,35-39,1908,3
STAT,1830,35,50-100,1865,1.1433607041641591
STAT,1885,40,25-29,1925,0.6375769598027932
STAT,1849,40,20-24,1889,0.1361532814035067
STAT,1825,36,30-34,1861,7.868121988166291
STAT,1859,63,na,1922,1414.2263744771726
SIM,1902,38,30-34,1940,5
STAT,1898,50,na,1948,2937.0893731275596
STAT,1850,40,50-100,1890,0.4927513471374469
SIM,1860,60,na,1920,1743
STAT,1857,23,30-34,1880,15.666153513427934
STAT,1956,15,30-34,1971,15.996230253795005
STAT,1876,42,40-44,1918,2.271011579547062
STAT,1908,43,40-44,1951,0.22824517024695334
STAT,1899,34,25-29,1933,13.870261121724448
STAT,1809,51,40-44,1860,0.08872659783126234
STAT,1874,26,35-39,1900,9.992510303146096
STAT,1925,24,35-39,1949,11.097747249496903
STAT,1818,38,15-19,1856,0.13143373706576844
STAT,1845,45,15-19,1890,2.0046546410191018E-4
SIM,1939,23,25-29,1962,2
STAT,1860,26,40-44,1886,2.4878040930069005
SIM,1864,24,25-29,1888,19
SIM,1880,15,na,1895,3337
SIM,1897,17,15-19,1914,35
STAT,1919,46,20-24,1965,0.01185667958348885
STAT,1937,17,na,1954,3543.7553793462534
STAT,1805,103,na,1908,0.019254396936563074
STAT,1899,30,50-100,1929,1.261529325391695
STAT,1888,24,50-100,1912,0.46771049416528776
STAT,1914,42,20-24,1956,0.017256036399468315
STAT,1880,71,na,1951,1385.7292004879325
STAT,1870,36,45-49,1906,1.996938279712517
STAT,1893,25,25-29,1918,53.25798844497329
STAT,1856,41,50-100,1897,0.7622337153359489
STAT,1916,18,na,1934,4031.2811593866977
STAT,1936,32,na,1968,3637.0987925598743
SIM,1907,24,25-29,1931,22
STAT,1825,103,na,1928,0.08837836513102507
STAT,1807,52,50-100,1859,0.048161468746041124
STAT,1843,34,25-29,1877,11.916306280291897
STAT,1898,29,25-29,1927,56.47687453221825
STAT,1877,52,35-39,1929,0.008692707745668863
STAT,1921,48,35-39,1969,0.14322212233355322
STAT,1874,77,na,1951,892.1101871794414
STAT,1891,18,na,1909,3097.6732431634214
STAT,1893,20,30-34,1913,22.407659443447095
SIM,1920,36,25-29,1956,2
STAT,1901,17,40-44,1918,0.2557378339761662
STAT,1908,31,40-44,1939,3.6802760830260963
SIM,1854,60,na,1914,711
STAT,1875,23,15-19,1898,3.377142446027274
SIM,1851,34,25-29,1885,8
STAT,1898,24,30-34,1922,23.802529606299622
STAT,1835,41,40-44,1876,2.065465812566546
STAT,1948,20,20-24,1968,126.45437542194375
STAT,1859,60,na,1919,1511.6165298274339
STAT,1911,16,20-24,1927,26.89019229404165
STAT,1930,31,15-19,1961,0.16477106765215427
STAT,1943,11,na,1954,4124.106509018103
SIM,1815,73,na,1888,482
SIM,1924,24,25-29,1948,2
SIM,1876,40,25-29,1916,2
STAT,1859,50,25-29,1909,0.0028477164012380377
STAT,1909,30,na,1939,3601.0877588228213
STAT,1911,20,25-29,1931,87.13277950024339
STAT,1889,17,15-19,1906,7.1465344974244704
SIM,1828,43,na,1871,1714
STAT,1934,33,40-44,1967,5.303556662834833
STAT,1826,41,30-34,1867,1.7580388313137032
STAT,1905,40,20-24,1945,0.016022289991314127
STAT,1930,5,na,1935,5161.730496759776
STAT,1873,92,na,1965,121.04877125872879
STAT,1868,50,35-39,1918,0.008434732870006135
STAT,1886,62,na,1948,1892.7071640009897
STAT,1896,31,50-100,1927,1.212757040863486
SIM,1847,19,na,1866,1712
STAT,1887,26,45-49,1913,1.226274737615815
STAT,1934,15,50-100,1949,0.5056671486075234
STAT,1846,90,na,1936,46.69418231516183
STAT,1822,46,25-29,1868,0.09766446952947218
STAT,1861,31,40-44,1892,3.6213385808976115
SIM,1860,34,35-39,1894,1
STAT,1920,20,35-39,1940,10.394918972211707
STAT,1843,22,25-29,1865,70.99591349073866
STAT,1852,34,35-39,1886,10.337515896489334
SIM,1851,22,25-29,1873,1
STAT,1849,47,40-44,1896,0.14357922055380387
STAT,1856,18,30-34,1874,1.3456810573954483
STAT,1847,42,50-100,1889,0.9604831814487528
STAT,1789,79,na,1868,477.7643151950018
STAT,1925,31,40-44,1956,4.607214351204576
SIM,1778,79,na,1857,830
STAT,1940,32,20-24,1972,2.496110690191833
STAT,1811,43,na,1854,1880.2653940939801
SIM,1910,19,15-19,1929,1
SIM,1834,41,30-34,1875,6
STAT,1914,33,50-100,1947,0.8172144721298368
STAT,1785,80,na,1865,110.89816722183636
SIM,1892,23,25-29,1915,49
STAT,1835,53,40-44,1888,0.007958519159000478
STAT,1896,55,na,1951,2725.719220487055
STAT,1817,44,25-29,1861,0.4557593962677453
STAT,1867,24,50-100,1891,0.3832453526972336
STAT,1898,36,30-34,1934,7.201266819649354
STAT,1902,37,45-49,1939,0.6058984704853578
STAT,1951,21,40-44,1972,3.981064909148223
SIM,1843,20,na,1863,672
STAT,1847,18,20-24,1865,19.88752216732396
SIM,1891,55,na,1946,1537
STAT,1862,39,20-24,1901,0.6499556001183568
SIM,1889,36,30-34,1925,3
STAT,1894,40,35-39,1934,2.325972248678274
STAT,1934,21,40-44,1955,4.489501621766242
STAT,1880,47,25-29,1927,0.059518916000060186
SIM,1916,55,na,1971,4520
STAT,1912,36,25-29,1948,0.954400663891939
STAT,1924,47,na,1971,4331.690446772212
STAT,1846,25,45-49,1871,0.8070681262643827
STAT,1863,47,25-29,1910,0.048944576885671824
STAT,1866,48,na,1914,2027.8919931441949
STAT,1902,19,15-19,1921,8.311983764006984
STAT,1857,28,25-29,1885,33.19473662030971
STAT,1884,35,25-29,1919,2.782351721751864
SIM,1911,49,na,1960,2289
STAT,1907,5,na,1912,3823.765439593923
STAT,1920,28,30-34,1948,42.280266000963174
STAT,1836,35,na,1871,2054.180855484593
STAT,1852,41,40-44,1893,2.274338396089252
SIM,1874,12,na,1886,2759
STAT,1841,41,50-100,1882,1.2382183084544907
STAT,1916,24,25-29,1940,94.8726682639378
STAT,1887,10,na,1897,2851.102382736039
SIM,1796,64,na,1860,998
STAT,1860,57,na,1917,1639.4412315550317
STAT,1884,23,25-29,1907,54.63031298030239
STAT,1885,18,na,1903,2476.03866500238
STAT,1909,49,30-34,1958,0.08060639776471472
STAT,1851,26,30-34,1877,23.455050858205166
STAT,1866,11,na,1877,2469.1048072959215
STAT,1841,52,20-24,1893,8.173467753705088E-4
STAT,1856,24,25-29,1880,47.070114786543265
SIM,1860,48,50-100,1908,1
STAT,1815,106,na,1921,8.560570827766996E-4
STAT,1839,35,50-100,1874,1.3917000127537305
SIM,1891,15,20-24,1906,34
STAT,1931,26,na,1957,4804.615592288865
STAT,1816,47,45-49,1863,0.7178250336518637
STAT,1837,23,45-49,1860,0.7266922767926247
STAT,1816,51,50-100,1867,0.04508397866922848
STAT,1915,27,45-49,1942,1.7372343809810897
SIM,1853,13,na,1866,3646
STAT,1841,50,na,1891,2432.148079294128
STAT,1883,38,45-49,1921,1.9083079320757783
STAT,1826,34,25-29,1860,18.05353850221189
STAT,1890,30,50-100,1920,1.118129541403321
STAT,1853,78,na,1931,605.836548848413
STAT,1791,80,na,1871,328.09942081669897
STAT,1931,30,20-24,1961,3.1772302587968158
STAT,1909,41,35-39,1950,0.1875029349415616
STAT,1821,50,45-49,1871,0.01558481972080825
STAT,1903,45,na,1948,3226.1134811017896
STAT,1843,38,40-44,1881,4.5473542648185
SIM,1928,40,na,1968,4609
STAT,1849,43,25-29,1892,0.5371676870637236
STAT,1828,71,na,1899,903.5668666245687
SIM,1849,45,na,1894,2223
STAT,1872,15,45-49,1887,0.06640644342062786
STAT,1906,15,35-39,1921,0.7982616981808724
STAT,1898,49,45-49,1947,0.17527594544100464
STAT,1902,22,40-44,1924,2.934337148126081
SIM,1902,40,45-49,1942,3
SIM,1808,91,na,1899,95
SIM,1905,12,na,1917,3866
SIM,1942,18,15-19,1960,479
STAT,1861,28,15-19,1889,0.37733099220436306
STAT,1907,18,50-100,1925,0.07129660873528587
STAT,1926,27,20-24,1953,21.694602585734582
STAT,1897,19,30-34,1916,2.1053897571176425
SIM,1846,31,na,1877,1215
SIM,1883,26,na,1909,2234
SIM,1908,26,na,1934,2774
STAT,1821,36,na,1857,1467.3039787847654
STAT,1916,40,50-100,1956,0.11907796081737952
SIM,1887,84,na,1971,1759
SIM,1902,2,na,1904,3827
STAT,1851,24,40-44,1875,1.9372569195441918
SIM,1861,79,na,1940,364
STAT,1890,30,na,1920,2912.106773976185
STAT,1893,44,na,1937,2861.1033590287916
STAT,1929,1,na,1930,5292.196205857517
STAT,1899,31,20-24,1930,3.707107456132696
SIM,1898,25,na,1923,4322
STAT,1930,38,35-39,1968,3.129617421102228
STAT,1915,30,na,1945,3827.9864995167445
STAT,1838,19,25-29,1857,3.1577208144235067
STAT,1833,25,35-39,1858,6.353527805057943
STAT,1939,27,30-34,1966,38.95740042283106
STAT,1882,18,40-44,1900,0.17465446776692276
STAT,1884,30,30-34,1914,16.848052671385346
STAT,1930,25,20-24,1955,23.067762296711404
STAT,1860,23,na,1883,1974.6430529963961
SIM,1842,26,30-34,1868,6
STAT,1921,38,25-29,1959,1.0852628956402997
STAT,1874,16,50-100,1890,0.05068706064751194
STAT,1865,16,15-19,1881,5.61642872911044
SIM,1947,5,na,1952,4409
STAT,1912,26,15-19,1938,0.6899661685649924
STAT,1862,89,na,1951,89.47839427298503
SIM,1920,26,15-19,1946,8
STAT,1814,44,50-100,1858,3.594657718444698
STAT,1895,48,15-19,1943,2.8983183040123226E-4
SIM,1851,38,40-44,1889,2
STAT,1853,37,20-24,1890,0.5977075150569776
STAT,1883,18,25-29,1901,5.437354253617744
SIM,1903,7,na,1910,3076
STAT,1839,49,na,1888,2075.8183138843283
STAT,1819,94,na,1913,4.648609066617842
STAT,1859,54,40-44,1913,0.008114679003458957
STAT,1924,19,35-39,1943,4.922368192413807
STAT,1834,26,30-34,1860,14.657840559813023
STAT,1934,18,15-19,1952,60.81014358893419
SIM,1863,2,na,1865,1920
STAT,1863,49,15-19,1912,3.3435469223501386E-4
SIM,1862,27,na,1889,3536
SIM,1929,16,25-29,1945,92
STAT,1804,110,na,1914,1.7508792112907922E-4
SIM,1947,2,na,1949,4477
STAT,1826,44,35-39,1870,2.627262714643726
STAT,1842,17,25-29,1859,1.806431318085546
STAT,1842,37,45-49,1879,0.5805222524961838
STAT,1885,15,na,1900,2494.077183967891
SIM,1911,28,30-34,1939,2
STAT,1925,21,30-34,1946,34.19119906589609
STAT,1944,25,15-19,1969,0.7550680204465501
STAT,1870,19,na,1889,2511.9908234746504
STAT,1893,35,35-39,1928,8.928886000486155
STAT,1913,47,30-34,1960,0.08591856755679292
STAT,1875,27,30-34,1902,25.85808975965419
STAT,1900,34,na,1934,3277.4196435451195
SIM,1866,30,20-24,1896,1
STAT,1907,16,30-34,1923,2.3313216450897984
SIM,1916,28,15-19,1944,1
SIM,1913,41,na,1954,2912
STAT,1825,39,35-39,1864,9.695588556075519
SIM,1879,52,na,1931,1081
STAT,1849,106,na,1955,0.010230489280446666
STAT,1903,28,30-34,1931,35.62016320361681
STAT,1832,42,50-100,1874,0.09296582092200197
STAT,1871,39,30-34,1910,5.262978291446414
STAT,1829,109,na,1938,2.598033874678039E-4
STAT,1835,38,15-19,1873,0.0519849965550353
STAT,1856,18,50-100,1874,0.041363138846456
SIM,1883,23,15-19,1906,2
STAT,1871,35,15-19,1906,0.05654862200337338
STAT,1934,26,35-39,1960,20.069210909386477
STAT,1874,23,30-34,1897,18.326656019045682
STAT,1818,53,40-44,1871,0.017658767546744353
STAT,1885,44,40-44,1929,2.1810809194378287
STAT,1894,45,50-100,1939,0.17793049568811456
SIM,1921,31,15-19,1952,3
STAT,1908,28,15-19,1936,0.6598630928103614
STAT,1908,46,45-49,1954,0.19650404419599463
STAT,1821,39,na,1860,1423.7022722944498
STAT,1873,51,20-24,1924,7.605643532014098E-4
STAT,1883,15,20-24,1898,17.134855871814306
STAT,1832,76,na,1908,804.2267178555733
STAT,1918,44,na,1962,3882.4951820443857
SIM,1820,39,25-29,1859,5
SIM,1888,25,25-29,1913,2
SIM,1864,53,na,1917,2415
SIM,1875,32,20-24,1907,15
STAT,1911,19,25-29,1930,8.52811251571749
STAT,1792,68,na,1860,919.4702717553569
STAT,1865,63,na,1928,1629.0538407675851
STAT,1821,38,20-24,1859,0.9261051135308814
STAT,1847,75,na,1922,930.7541193213659
SIM,1879,39,40-44,1918,30
STAT,1923,32,50-100,1955,0.9378660958529992
STAT,1941,17,45-49,1958,0.5086866334347316
STAT,1881,42,15-19,1923,0.013025225773612047
STAT,1860,22,25-29,1882,48.14156601661946
STAT,1889,24,20-24,1913,82.46664130858626
STAT,1825,100,na,1925,0.6537744443804635
STAT,1852,90,na,1942,79.35996302710974
SIM,1842,72,na,1914,1595
STAT,1839,26,15-19,1865,0.5348603988291175
STAT,1904,48,35-39,1952,0.11140881967760946
SIM,1895,11,na,1906,4649
STAT,1866,21,15-19,1887,3.0579554763077095
STAT,1900,31,na,1931,3319.2311858630837
STAT,1913,31,15-19,1944,0.1267644525920484
SIM,1906,42,50-100,1948,1
STAT,1857,38,35-39,1895,5.400566748042734
SIM,1897,24,20-24,1921,39
STAT,1888,31,45-49,1919,2.020881264120947
SIM,1916,52,na,1968,4520
SIM,1948,22,20-24,1970,1659
SIM,1860,31,30-34,1891,88
STAT,1841,17,40-44,1858,0.2626865505485515
STAT,1836,38,na,1874,1991.1771245820064
SIM,1929,26,35-39,1955,1
STAT,1816,83,na,1899,335.14692483772296
SIM,1891,28,35-39,1919,14
STAT,1870,101,na,1971,5.042358428687621
STAT,1876,47,50-100,1923,0.2471215227895662
STAT,1813,46,15-19,1859,0.0015012402885186235
STAT,1875,37,40-44,1912,4.4950484992856925
STAT,1898,26,20-24,1924,15.829616864944866
STAT,1848,36,35-39,1884,6.891852065111456
SIM,1886,3,na,1889,3180
STAT,1873,20,45-49,1893,0.719566137332533
STAT,1870,33,40-44,1903,4.30517154548264
STAT,1893,22,20-24,1915,86.17699066918092
SIM,1871,38,na,1909,1849
SIM,1840,46,na,1886,2570
STAT,1894,38,20-24,1932,0.9753944959725191
STAT,1927,37,15-19,1964,0.02368105262691845
SIM,1842,22,15-19,1864,23
SIM,1939,20,20-24,1959,345
STAT,1920,30,45-49,1950,1.7151177433955662
STAT,1929,22,45-49,1951,1.4129006661084775
SIM,1885,52,na,1937,1103
STAT,1925,34,45-49,1959,1.8491289652024516
STAT,1857,37,na,1894,1807.8859931280854
STAT,1883,28,35-39,1911,9.250010898507098
STAT,1916,22,35-39,1938,9.732015903053988
SIM,1870,53,na,1923,1021
STAT,1852,31,30-34,1883,18.386477839669976
STAT,1808,46,40-44,1854,0.332394085255855
STAT,1786,68,na,1854,1328.9999999999998
STAT,1952,17,20-24,1969,160.9855806474428
SIM,1886,37,na,1923,3045
STAT,1875,22,na,1897,2428.5554215901984
STAT,1822,48,15-19,1870,6.5966545042405E-4
STAT,1862,51,45-49,1913,0.012419960219292068
SIM,1903,33,20-24,1936,4
SIM,1916,36,35-39,1952,27
SIM,1933,34,45-49,1967,3
SIM,1891,52,na,1943,1774
STAT,1834,22,15-19,1856,1.9444975652007537
STAT,1942,18,40-44,1960,1.444551729008394
STAT,1850,19,40-44,1869,0.10199368007846196
STAT,1869,22,45-49,1891,0.7036545658030389
STAT,1866,35,40-44,1901,4.033815719297412
STAT,1859,103,na,1962,0.37888973480345445
STAT,1884,20,20-24,1904,66.36163107118497
STAT,1918,35,15-19,1953,0.020157399297888005
STAT,1880,37,15-19,1917,0.058297108317417155
STAT,1948,23,25-29,1971,104.93854488732222
STAT,1908,7,na,1915,3834.8825953416517
SIM,1865,38,na,1903,1745
STAT,1839,21,20-24,1860,82.858507308702
STAT,1933,16,40-44,1949,1.8642409824689306
STAT,1791,83,na,1874,173.91381619069418
STAT,1908,36,35-39,1944,2.2578934784634557
STAT,1917,48,45-49,1965,0.22335863581825233
SIM,1838,38,40-44,1876,15
STAT,1926,31,25-29,1957,11.086565772528706
STAT,1808,54,na,1862,703.7807542452922
STAT,1899,41,30-34,1940,0.10953785363981265
STAT,1919,29,na,1948,3965.382491816143
STAT,1817,48,40-44,1865,0.11835731245227532
STAT,1836,49,20-24,1885,0.009379671285517121
STAT,1871,53,45-49,1924,0.01424432615644765
STAT,1831,45,20-24,1876,0.01161113082989453
SIM,1833,61,na,1894,1984
SIM,1834,46,na,1880,778
STAT,1898,39,35-39,1937,2.032220910984742
STAT,1850,107,na,1957,0.0034731842803086563
SIM,1831,32,na,1863,2145
SIM,1941,22,na,1963,3706
STAT,1922,43,25-29,1965,0.08092112116555314
SIM,1941,16,40-44,1957,10
STAT,1863,44,20-24,1907,0.13375055392745439
STAT,1892,25,40-44,1917,3.7339508287258525
STAT,1838,110,na,1948,1.1785052394313579E-4
STAT,1858,43,35-39,1901,1.3728644087131219
STAT,1801,84,na,1885,100.38559773193403
STAT,1866,31,25-29,1897,9.387849465840167
STAT,1856,32,45-49,1888,1.2678413401227864
STAT,1897,29,40-44,1926,3.949831047588785
SIM,1866,43,35-39,1909,12
SIM,1907,34,35-39,1941,6
SIM,1865,25,20-24,1890,13
SIM,1856,23,20-24,1879,188
STAT,1830,34,15-19,1864,0.13101492968272008
STAT,1847,30,45-49,1877,1.8899975084610385
STAT,1852,44,45-49,1896,1.4861650152666932
SIM,1924,1,na,1925,5494
STAT,1858,40,30-34,1898,0.8868195245304237
STAT,1849,26,50-100,1875,0.6435541885313291
SIM,1813,47,na,1860,258
STAT,1872,32,50-100,1904,0.9174912743790072
STAT,1827,47,20-24,1874,0.010986311034406285
STAT,1903,42,45-49,1945,0.1473478331098831
STAT,1848,23,20-24,1871,77.95522010139523
STAT,1822,43,20-24,1865,0.27688294644887634
SIM,1921,37,20-24,1958,2
STAT,1872,46,20-24,1918,0.01205043212834322
STAT,1904,35,20-24,1939,0.23996534109141943
SIM,1799,75,na,1874,105
SIM,1894,66,na,1960,1042
STAT,1826,31,20-24,1857,5.810381612490383
STAT,1860,104,na,1964,0.25744046079087596
STAT,1888,29,na,1917,2734.7520099682583
STAT,1907,41,50-100,1948,0.10752687818585563
STAT,1952,1,na,1953,4809.220484482024
STAT,1848,23,na,1871,2418.6937975188316
STAT,1889,37,35-39,1926,8.517388964362176
STAT,1867,45,35-39,1912,0.1337222022157339
STAT,1916,28,40-44,1944,4.736887371415445
STAT,1854,23,na,1877,1386.812187468072
STAT,1884,39,40-44,1923,4.148287469233062
STAT,1877,88,na,1965,310.18959133024504
STAT,1935,29,20-24,1964,24.6790125548755
SIM,1904,67,na,1971,3720
STAT,1851,29,35-39,1880,8.795054317369026
STAT,1825,34,40-44,1859,6.7479838588793175
STAT,1833,24,na,1857,1140.1229664174912
STAT,1856,89,na,1945,75.45506547885823
STAT,1885,46,50-100,1931,0.24209777677914932
STAT,1906,59,na,1965,3017.8601948309743
SIM,1829,30,35-39,1859,60
STAT,1934,36,45-49,1970,0.9352332375348544
STAT,1869,22,na,1891,2386.5277013802684
STAT,1785,83,na,1868,58.78316829116966
STAT,1879,17,20-24,1896,18.18663388257541
SIM,1778,76,na,1854,1171
SIM,1873,67,na,1940,733
STAT,1857,25,20-24,1882,9.407071867566984
STAT,1932,31,50-100,1963,1.0920906643859996
